name,realm,rating,cls,spec,play,win,lose
Phearbunny,bleeding-hollow,1547,deathknight,blood,114,59,55
Pagumon,moon-guard,1421,deathknight,blood,126,65,61
Warlôck,chogall,1399,deathknight,blood,36,19,17
Réndwarchièf,garrosh,1227,deathknight,blood,51,23,28
Kayn,malganis,1146,deathknight,blood,24,12,12
Tiumau,goldrinn,1121,deathknight,blood,66,30,36
Nbayoungboy,kiljaeden,1099,deathknight,blood,51,21,30
Corndead,area-52,1045,deathknight,blood,30,11,19
Tragül,sargeras,987,deathknight,blood,48,21,27
Bloodbukkaky,bleeding-hollow,946,deathknight,blood,61,16,45
Insonne,dalaran,921,deathknight,blood,24,11,13
Valind,eredar,854,deathknight,blood,18,9,9
Kult,azralon,841,deathknight,blood,12,9,3
Yafa,bonechewer,779,deathknight,blood,42,16,26
Jakeboyswag,shandris,767,deathknight,blood,24,8,16
He,echo-isles,668,deathknight,blood,12,7,5
Eremeir,moon-guard,576,deathknight,blood,12,6,6
Blasphemus,malganis,575,deathknight,blood,12,6,6
Kaîne,dalaran,480,deathknight,blood,12,5,7
Belfknightt,area-52,479,deathknight,blood,15,5,10
Humber,area-52,384,deathknight,blood,6,4,2
Tristam,area-52,384,deathknight,blood,6,4,2
Jennitha,zuljin,384,deathknight,blood,6,4,2
Pride,ragnaros,384,deathknight,blood,12,4,8
Mïïkes,area-52,288,deathknight,blood,6,3,3
ßläzë,baelgun,288,deathknight,blood,15,4,11
Kaloesh,drenden,288,deathknight,blood,12,3,9
Kimbøslîce,area-52,288,deathknight,blood,12,3,9
Aborblood,hyjal,286,deathknight,blood,12,3,9
Neroxzdvm,area-52,192,deathknight,blood,6,2,4
Sharnathos,stormrage,192,deathknight,blood,6,2,4
Sorvett,azralon,192,deathknight,blood,12,2,10
Cerbeefquake,wyrmrest-accord,192,deathknight,blood,12,2,10
Eteson,tichondrius,191,deathknight,blood,6,2,4
Unhølydøøm,misha,191,deathknight,blood,12,2,10
Cosmiclord,sargeras,191,deathknight,blood,18,2,16
Killteam,tichondrius,96,deathknight,blood,6,1,5
Ðrift,azralon,96,deathknight,blood,6,1,5
Plagueghoul,wyrmrest-accord,96,deathknight,blood,6,1,5
Gnargnarr,firetree,96,deathknight,blood,6,1,5
Determinate,deathwing,96,deathknight,blood,6,1,5
Lunatick,darkspear,96,deathknight,blood,6,1,5
Wowattorney,tichondrius,96,deathknight,blood,6,1,5
Boneherr,sargeras,96,deathknight,blood,6,1,5
Cozzasad,barthilas,96,deathknight,blood,6,1,5
Zerhistran,proudmoore,64,deathknight,blood,4,1,3
Hulmorr,bleeding-hollow,64,deathknight,blood,4,1,3
Partywaffles,illidan,2179,deathknight,unholy,288,149,139
Pwaff,illidan,2125,deathknight,unholy,89,45,44
Thorediks,stormrage,2106,deathknight,unholy,144,72,72
Neroxz,area-52,2105,deathknight,unholy,83,43,40
Qipara,zuljin,2104,deathknight,unholy,163,87,76
Níngjìng,tichondrius,2074,deathknight,unholy,84,43,41
Graphics,moon-guard,2062,deathknight,unholy,466,233,233
Toxicwaste,malganis,2052,deathknight,unholy,118,61,57
Spaidzz,malganis,2035,deathknight,unholy,252,125,127
Búddy,zuljin,2022,deathknight,unholy,100,49,51
Pookr,area-52,2016,deathknight,unholy,215,105,110
Flarkness,area-52,2010,deathknight,unholy,78,37,41
Veilsidé,kelthuzad,2007,deathknight,unholy,432,219,213
Vuittons,area-52,1991,deathknight,unholy,316,159,157
Andeadx,tichondrius,1984,deathknight,unholy,60,30,30
Achílles,sargeras,1979,deathknight,unholy,175,85,90
Scriptløl,sargeras,1975,deathknight,unholy,138,66,72
Ningjinglol,tichondrius,1969,deathknight,unholy,72,40,32
Darkcata,tichondrius,1962,deathknight,unholy,66,28,38
Roidboy,illidan,1956,deathknight,unholy,121,60,61
Gutterboy,malganis,1948,deathknight,unholy,99,44,55
Cardii,area-52,1946,deathknight,unholy,159,83,76
Nixonxx,tichondrius,1933,deathknight,unholy,126,78,48
Dkya,tichondrius,1928,deathknight,unholy,394,200,194
Renaming,area-52,1928,deathknight,unholy,105,52,53
Bukum,zuljin,1928,deathknight,unholy,89,39,50
Hrsb,tichondrius,1927,deathknight,unholy,142,81,61
Ceomdae,tichondrius,1927,deathknight,unholy,72,34,38
Dahnga,frostmourne,1925,deathknight,unholy,66,41,25
Ilceses,area-52,1925,deathknight,unholy,78,37,41
Harókz,azralon,1924,deathknight,unholy,125,65,60
Pradas,area-52,1924,deathknight,unholy,238,121,117
Serwestley,stormrage,1918,deathknight,unholy,125,63,62
Mårlbørø,tichondrius,1915,deathknight,unholy,41,21,20
Éternalnight,tichondrius,1913,deathknight,unholy,76,32,44
Zynyzter,malganis,1912,deathknight,unholy,72,41,31
Barakhenaku,illidan,1911,deathknight,unholy,63,33,30
Skideroth,kelthuzad,1911,deathknight,unholy,84,40,44
Killinois,tichondrius,1910,deathknight,unholy,47,21,26
Geomdae,tichondrius,1901,deathknight,unholy,71,31,40
Barelyviable,tichondrius,1898,deathknight,unholy,72,32,40
Skippee,tichondrius,1890,deathknight,unholy,69,36,33
Steamerboy,stormrage,1887,deathknight,unholy,60,28,32
Keetor,tichondrius,1883,deathknight,unholy,54,35,19
Malhandir,bleeding-hollow,1880,deathknight,unholy,41,23,18
Catarïa,tichondrius,1869,deathknight,unholy,90,44,46
Iato,sargeras,1868,deathknight,unholy,60,39,21
Juelzjerk,tichondrius,1868,deathknight,unholy,229,116,113
Bbidd,tichondrius,1867,deathknight,unholy,48,30,18
Annoyed,wyrmrest-accord,1867,deathknight,unholy,125,68,57
Evilduck,ragnaros,1866,deathknight,unholy,90,51,39
Bloodbruh,blackrock,1863,deathknight,unholy,90,49,41
Goonaa,tichondrius,1861,deathknight,unholy,66,33,33
Cavaliers,ragnaros,1860,deathknight,unholy,66,32,34
Lattè,area-52,1859,deathknight,unholy,55,30,25
Chimps,illidan,1858,deathknight,unholy,58,32,26
Nürgle,black-dragonflight,1856,deathknight,unholy,280,143,137
Lagérthâ,ragnaros,1855,deathknight,unholy,72,35,37
Claudio,tichondrius,1853,deathknight,unholy,93,37,56
Brutos,thrall,1851,deathknight,unholy,104,56,48
Tduggylolz,tichondrius,1851,deathknight,unholy,60,26,34
Sagadk,hyjal,1850,deathknight,unholy,112,56,56
Morbiddesire,stormrage,1849,deathknight,unholy,87,49,38
Thotiannaqt,area-52,1847,deathknight,unholy,124,61,63
Deuter,quelthalas,1845,deathknight,unholy,315,168,147
Keomdae,tichondrius,1844,deathknight,unholy,65,32,33
Tokyotimxx,malganis,1842,deathknight,unholy,48,30,18
Cloüd,wyrmrest-accord,1841,deathknight,unholy,64,31,33
Bicepsüal,zuljin,1840,deathknight,unholy,36,28,8
Nevermore,hyjal,1840,deathknight,unholy,125,67,58
Bruceleedk,tichondrius,1839,deathknight,unholy,100,51,49
Warrcc,steamwheedle-cartel,1839,deathknight,unholy,54,26,28
Siêgfriëd,ragnaros,1839,deathknight,unholy,72,33,39
Blackfyré,sargeras,1837,deathknight,unholy,62,32,30
Aidsbenedict,malganis,1837,deathknight,unholy,126,59,67
Vigarst,azralon,1835,deathknight,unholy,60,30,30
Haldevarik,doomhammer,1834,deathknight,unholy,78,43,35
Vaizard,malganis,1832,deathknight,unholy,42,26,16
Dazarune,burning-blade,1832,deathknight,unholy,46,25,21
Starshopping,proudmoore,1832,deathknight,unholy,109,54,55
Orphanmakerx,area-52,1832,deathknight,unholy,123,60,63
Goonà,tichondrius,1831,deathknight,unholy,63,29,34
Didri,quelthalas,1831,deathknight,unholy,84,37,47
Aurious,lightnings-blade,1830,deathknight,unholy,84,47,37
Kortingert,nagrand,1830,deathknight,unholy,59,33,26
Drauguss,azralon,1830,deathknight,unholy,124,61,63
Anatøly,ragnaros,1827,deathknight,unholy,42,21,21
Daoniancc,tichondrius,1825,deathknight,unholy,399,208,191
Demonboyjr,tichondrius,1825,deathknight,unholy,87,39,48
Arthez,frostmourne,1824,deathknight,unholy,72,38,34
Sadboy,grizzly-hills,1822,deathknight,unholy,65,27,38
Áethros,malganis,1821,deathknight,unholy,108,52,56
Goldênboy,blades-edge,1820,deathknight,unholy,66,42,24
Kilohotel,stormrage,1820,deathknight,unholy,48,26,22
Einherjiar,tichondrius,1820,deathknight,unholy,48,25,23
Volyant,frostmourne,1820,deathknight,unholy,60,30,30
Kciktep,tichondrius,1819,deathknight,unholy,36,19,17
Datnai,barthilas,1819,deathknight,unholy,54,25,29
Sussybakadk,sargeras,1817,deathknight,unholy,70,34,36
Lighostx,tichondrius,1817,deathknight,unholy,165,79,86
Dkcane,kelthuzad,1816,deathknight,unholy,80,44,36
Flizzycash,malganis,1816,deathknight,unholy,56,27,29
Õdin,area-52,1815,deathknight,unholy,203,103,100
Wowattorney,tichondrius,1815,deathknight,unholy,82,33,49
Xebane,frostmourne,1813,deathknight,unholy,450,233,217
Plagueflavor,tichondrius,1813,deathknight,unholy,318,158,160
Ddibb,tichondrius,1812,deathknight,unholy,75,37,38
Ravindrannor,saurfang,1812,deathknight,unholy,65,32,33
Muspel,sargeras,1811,deathknight,unholy,65,32,33
Fatzilla,tichondrius,1811,deathknight,unholy,66,26,40
Carryme,quelthalas,1809,deathknight,unholy,139,71,68
Exaar,tichondrius,1809,deathknight,unholy,87,40,47
Dreadfang,the-venture-co,1808,deathknight,unholy,30,19,11
Floreon,tichondrius,1808,deathknight,unholy,65,34,31
Infectik,tichondrius,1807,deathknight,unholy,59,35,24
Brocigar,tichondrius,1806,deathknight,unholy,84,43,41
Necrôtic,area-52,1806,deathknight,unholy,76,35,41
Twindleroot,aggramar,1804,deathknight,unholy,77,45,32
Mûs,tichondrius,1804,deathknight,unholy,66,36,30
Asukka,tichondrius,1804,deathknight,unholy,78,32,46
Darkdj,kelthuzad,1803,deathknight,unholy,169,78,91
Kaeligh,ragnaros,1803,deathknight,unholy,66,29,37
Ziskon,illidan,1802,deathknight,unholy,100,53,47
Dtcfasd,tichondrius,1801,deathknight,unholy,32,20,12
Zìlêán,tichondrius,1800,deathknight,unholy,70,39,31
Azre,tichondrius,1800,deathknight,unholy,160,74,86
Xiaodabaolol,tichondrius,1800,deathknight,unholy,90,41,49
Zerøimperial,quelthalas,1795,deathknight,unholy,227,119,108
Avengering,tichondrius,1794,deathknight,unholy,75,40,35
Sithdog,blackrock,1794,deathknight,unholy,84,37,47
Milleh,bleeding-hollow,1793,deathknight,unholy,102,45,57
Muspellheim,azralon,1791,deathknight,unholy,54,29,25
Altareon,ragnaros,1788,deathknight,unholy,168,87,81
Attack,grizzly-hills,1787,deathknight,unholy,60,28,32
Stankybreath,bleeding-hollow,1786,deathknight,unholy,82,40,42
Poesoul,tichondrius,1784,deathknight,unholy,291,145,146
Sinell,kargath,1781,deathknight,unholy,276,144,132
Chillbaynê,the-scryers,1777,deathknight,unholy,131,67,64
Hhasaki,area-52,1776,deathknight,unholy,228,121,107
Aerd,sargeras,1776,deathknight,unholy,385,192,193
Grimiz,tichondrius,1774,deathknight,unholy,145,71,74
Vad,skullcrusher,1771,deathknight,unholy,52,22,30
Azhid,tichondrius,1769,deathknight,unholy,136,70,66
Longlnus,malganis,1767,deathknight,unholy,79,34,45
Apøçálýpsé,firetree,1765,deathknight,unholy,97,50,47
Standalizer,gilneas,1760,deathknight,unholy,84,47,37
Doombeast,area-52,1760,deathknight,unholy,108,51,57
Ålastor,stormrage,1754,deathknight,unholy,63,35,28
Soulhand,tichondrius,1754,deathknight,unholy,110,57,53
Nabbiby,tichondrius,1753,deathknight,unholy,84,38,46
Ðomìnus,moon-guard,1752,deathknight,unholy,156,88,68
Boofcigars,stormrage,1750,deathknight,unholy,66,41,25
Linyive,malganis,1750,deathknight,unholy,54,30,24
Cesaroo,aegwynn,1749,deathknight,unholy,130,64,66
Anhedonía,illidan,1747,deathknight,unholy,180,93,87
Deadsamurai,illidan,1745,deathknight,unholy,81,42,39
Slîckhuman,spinebreaker,1745,deathknight,unholy,108,48,60
Dunduner,tichondrius,1742,deathknight,unholy,186,95,91
Jakeboyswag,shandris,1742,deathknight,unholy,161,79,82
Brandonsdk,tichondrius,1742,deathknight,unholy,179,87,92
Xibbas,illidan,1741,deathknight,unholy,48,27,21
Brß,tichondrius,1740,deathknight,unholy,72,38,34
Tkyo,tichondrius,1739,deathknight,unholy,79,37,42
Frozenkappa,hyjal,1737,deathknight,unholy,35,21,14
Nh,malganis,1737,deathknight,unholy,54,28,26
Greenduck,malganis,1736,deathknight,unholy,42,21,21
Teksurugi,korgath,1734,deathknight,unholy,60,32,28
Howdoulose,illidan,1732,deathknight,unholy,54,25,29
Zìlêáns,tichondrius,1730,deathknight,unholy,84,50,34
Infection,steamwheedle-cartel,1729,deathknight,unholy,42,20,22
Supblood,tichondrius,1725,deathknight,unholy,54,26,28
Killìan,kelthuzad,1724,deathknight,unholy,76,39,37
Hatrèd,quelthalas,1724,deathknight,unholy,71,36,35
Darione,twisting-nether,1719,deathknight,unholy,60,25,35
Zerhistran,proudmoore,1718,deathknight,unholy,266,138,128
Noik,azralon,1716,deathknight,unholy,94,46,48
Properterps,bonechewer,1714,deathknight,unholy,140,78,62
Lazarise,area-52,1713,deathknight,unholy,71,34,37
Bedstains,thunderlord,1708,deathknight,unholy,155,80,75
Kinkysgnome,tichondrius,1706,deathknight,unholy,137,64,73
Goonazz,tichondrius,1705,deathknight,unholy,72,50,22
Muscleface,moon-guard,1701,deathknight,unholy,80,45,35
Bagul,azralon,1701,deathknight,unholy,51,25,26
Koda,thrall,1701,deathknight,unholy,77,36,41
Justafkdk,gorefiend,1700,deathknight,unholy,84,43,41
Onefire,illidan,1698,deathknight,unholy,70,35,35
Xarielle,tichondrius,1698,deathknight,unholy,66,32,34
Hwml,barthilas,1696,deathknight,unholy,153,80,73
Jongro,tichondrius,1693,deathknight,unholy,78,47,31
Justtaki,zuljin,1693,deathknight,unholy,54,23,31
Ligmagooch,tichondrius,1689,deathknight,unholy,124,65,59
Arroyo,borean-tundra,1689,deathknight,unholy,120,61,59
Bigdekay,illidan,1687,deathknight,unholy,30,18,12
Khaíne,wyrmrest-accord,1687,deathknight,unholy,264,136,128
Lichanis,bonechewer,1686,deathknight,unholy,126,65,61
Landez,ragnaros,1684,deathknight,unholy,72,42,30
Ayooplaguez,guldan,1684,deathknight,unholy,48,24,24
Clearlol,bleeding-hollow,1684,deathknight,unholy,48,23,25
Bellum,moon-guard,1681,deathknight,unholy,129,72,57
Billieeilish,sargeras,1681,deathknight,unholy,98,53,45
Hanung,tichondrius,1681,deathknight,unholy,35,18,17
Fakiez,kelthuzad,1679,deathknight,unholy,68,30,38
Kwolve,proudmoore,1678,deathknight,unholy,249,126,123
Krätos,zuljin,1677,deathknight,unholy,42,25,17
Dâki,blades-edge,1675,deathknight,unholy,114,63,51
Blacklabel,andorhal,1675,deathknight,unholy,72,31,41
Fasterjake,sargeras,1674,deathknight,unholy,134,73,61
Giveretms,azralon,1672,deathknight,unholy,42,19,23
Dill,madoran,1671,deathknight,unholy,48,20,28
Moonjae,illidan,1669,deathknight,unholy,30,18,12
Cantmove,area-52,1669,deathknight,unholy,50,22,28
Dreadrend,sargeras,1668,deathknight,unholy,72,35,37
Malhandir,azgalor,1668,deathknight,unholy,54,20,34
Spacealien,malganis,1667,deathknight,unholy,60,32,28
Malsedius,kelthuzad,1666,deathknight,unholy,122,56,66
Darktone,tichondrius,1665,deathknight,unholy,35,18,17
Slty,tichondrius,1664,deathknight,unholy,42,18,24
Ludgan,stormrage,1663,deathknight,unholy,198,95,103
Takeurcheeks,tichondrius,1662,deathknight,unholy,109,55,54
Lichtborne,illidan,1662,deathknight,unholy,73,33,40
Nevmic,emerald-dream,1661,deathknight,unholy,184,88,96
Bannedforevr,dalaran,1661,deathknight,unholy,69,29,40
Earthican,bleeding-hollow,1660,deathknight,unholy,50,26,24
Krargosh,quelthalas,1660,deathknight,unholy,185,96,89
Neaz,moon-guard,1659,deathknight,unholy,78,41,37
Mephostophel,sargeras,1659,deathknight,unholy,210,108,102
Ståtìc,tichondrius,1659,deathknight,unholy,84,43,41
Imadkloldie,frostmourne,1659,deathknight,unholy,90,46,44
Bopalop,malganis,1657,deathknight,unholy,69,28,41
Banjingquan,tichondrius,1656,deathknight,unholy,94,57,37
Kakarotó,azralon,1656,deathknight,unholy,65,37,28
Kjarnda,malganis,1653,deathknight,unholy,48,21,27
Skynyght,area-52,1652,deathknight,unholy,42,26,16
Pooseunpoose,velen,1652,deathknight,unholy,86,41,45
Jacklinn,ysondre,1651,deathknight,unholy,36,24,12
Ullísés,ragnaros,1651,deathknight,unholy,45,24,21
Merados,quelthalas,1651,deathknight,unholy,84,33,51
Jeremiahe,hyjal,1650,deathknight,unholy,90,49,41
Komplex,kelthuzad,1649,deathknight,unholy,76,40,36
Falkorn,korgath,1648,deathknight,unholy,99,47,52
Lickblood,sargeras,1646,deathknight,unholy,36,20,16
Orcsexual,azralon,1646,deathknight,unholy,54,28,26
Libitina,tichondrius,1645,deathknight,unholy,36,22,14
Tråuma,uther,1645,deathknight,unholy,48,25,23
Apoz,tichondrius,1644,deathknight,unholy,30,18,12
Vexxan,thrall,1644,deathknight,unholy,41,23,18
Galarick,area-52,1643,deathknight,unholy,41,22,19
Boneyards,bleeding-hollow,1643,deathknight,unholy,132,56,76
Beanboyx,tichondrius,1642,deathknight,unholy,34,18,16
Boofcigars,sargeras,1642,deathknight,unholy,52,27,25
Vleryan,ragnaros,1641,deathknight,unholy,44,22,22
Kurnoth,barthilas,1641,deathknight,unholy,110,53,57
Tailm,ragnaros,1639,deathknight,unholy,36,20,16
Raíndrop,tichondrius,1639,deathknight,unholy,156,85,71
Puppykisses,perenolde,1638,deathknight,unholy,143,67,76
Dkdanim,tichondrius,1637,deathknight,unholy,130,71,59
Vynox,frostmourne,1637,deathknight,unholy,56,27,29
Xhoul,sargeras,1636,deathknight,unholy,255,136,119
Virulous,zuljin,1634,deathknight,unholy,47,26,21
Rycerzfrost,ragnaros,1634,deathknight,unholy,113,59,54
Unholykevin,sargeras,1633,deathknight,unholy,48,23,25
Alexeous,wyrmrest-accord,1632,deathknight,unholy,250,136,114
Azibar,moon-guard,1632,deathknight,unholy,47,24,23
Raps,frostmourne,1632,deathknight,unholy,56,23,33
Reizu,ragnaros,1631,deathknight,unholy,45,27,18
Lùcius,garrosh,1631,deathknight,unholy,154,82,72
Azynks,azralon,1631,deathknight,unholy,135,62,73
Ermanotruta,azralon,1631,deathknight,unholy,94,41,53
Kenishii,kiljaeden,1629,deathknight,unholy,66,39,27
Zerochillz,sargeras,1628,deathknight,unholy,30,17,13
Cliffdk,kelthuzad,1628,deathknight,unholy,63,21,42
Asastac,tichondrius,1627,deathknight,unholy,42,24,18
Elyxoxo,tichondrius,1627,deathknight,unholy,84,44,40
Littlekims,emerald-dream,1627,deathknight,unholy,46,24,22
Wastethis,sargeras,1626,deathknight,unholy,71,40,31
Paratekdk,thrall,1625,deathknight,unholy,71,39,32
Megatroun,stormreaver,1625,deathknight,unholy,42,23,19
Bladê,tichondrius,1624,deathknight,unholy,61,26,35
Pettyk,tichondrius,1624,deathknight,unholy,42,17,25
Chachio,kiljaeden,1623,deathknight,unholy,36,20,16
Auniel,gorefiend,1622,deathknight,unholy,54,22,32
Puppykiss,perenolde,1622,deathknight,unholy,57,22,35
Asterend,proudmoore,1621,deathknight,unholy,52,23,29
Xraduky,dawnbringer,1620,deathknight,unholy,38,26,12
Yikk,illidan,1620,deathknight,unholy,66,33,33
Kallgìn,emerald-dream,1620,deathknight,unholy,71,33,38
Arcticc,area-52,1620,deathknight,unholy,54,24,30
Jacklynn,ragnaros,1619,deathknight,unholy,42,27,15
Struggler,velen,1619,deathknight,unholy,60,34,26
Annerito,area-52,1619,deathknight,unholy,47,19,28
Wheatasil,garona,1618,deathknight,unholy,70,36,34
Reapsouls,stormrage,1617,deathknight,unholy,42,30,12
Shadow,ragnaros,1616,deathknight,unholy,79,43,36
Søad,quelthalas,1615,deathknight,unholy,135,72,63
Loongdk,kiljaeden,1615,deathknight,unholy,249,124,125
Yamanji,wyrmrest-accord,1614,deathknight,unholy,110,61,49
Nøsfferatus,azralon,1613,deathknight,unholy,77,41,36
Kterrorblade,sargeras,1613,deathknight,unholy,180,92,88
Emopalli,tichondrius,1612,deathknight,unholy,182,93,89
Shakefknzula,tichondrius,1612,deathknight,unholy,104,51,53
Rezøk,ragnaros,1612,deathknight,unholy,54,20,34
Alistra,frostmourne,1611,deathknight,unholy,42,20,22
Irreversible,zuljin,1611,deathknight,unholy,56,22,34
Ðogmá,vashj,1610,deathknight,unholy,35,22,13
Mikoaa,bladefist,1610,deathknight,unholy,30,17,13
Regiknight,stormrage,1610,deathknight,unholy,245,138,107
Lichkong,dalaran,1609,deathknight,unholy,76,43,33
Lagmasterx,sargeras,1609,deathknight,unholy,42,20,22
Ousted,daggerspine,1608,deathknight,unholy,36,20,16
Drneroxz,area-52,1608,deathknight,unholy,41,17,24
Deathscyythe,illidan,1607,deathknight,unholy,42,23,19
Lemuriön,nemesis,1607,deathknight,unholy,43,20,23
Ultimatdeath,jubeithos,1606,deathknight,unholy,66,30,36
Kkoduck,tichondrius,1605,deathknight,unholy,62,41,21
Ædolph,barthilas,1605,deathknight,unholy,30,17,13
Ãstaroth,stormrage,1605,deathknight,unholy,48,22,26
Notorious,garrosh,1605,deathknight,unholy,42,18,24
Boofcigars,kelthuzad,1604,deathknight,unholy,77,41,36
Idodamn,tichondrius,1604,deathknight,unholy,102,54,48
Kalgor,illidan,1604,deathknight,unholy,144,76,68
Dóm,proudmoore,1604,deathknight,unholy,132,65,67
Dominos,tichondrius,1604,deathknight,unholy,42,20,22
Berodox,malganis,1604,deathknight,unholy,72,30,42
Kellydean,moon-guard,1603,deathknight,unholy,129,68,61
Wednesdæ,moon-guard,1603,deathknight,unholy,54,28,26
Wisdôm,frostmourne,1603,deathknight,unholy,59,30,29
Kranaz,frostmourne,1603,deathknight,unholy,36,17,19
Voncleaver,tichondrius,1603,deathknight,unholy,70,23,47
Gargoylepowa,nemesis,1602,deathknight,unholy,42,20,22
Nofoamlattes,thrall,1602,deathknight,unholy,42,19,23
Zedsdead,mannoroth,1601,deathknight,unholy,54,29,25
Yubell,barthilas,1601,deathknight,unholy,390,194,196
Nalz,drakkari,1601,deathknight,unholy,196,97,99
Originalcimm,stormrage,1601,deathknight,unholy,66,28,38
Promotheseis,sargeras,1600,deathknight,unholy,66,41,25
Aldebamuu,ragnaros,1600,deathknight,unholy,161,83,78
Giznator,malganis,1598,deathknight,unholy,108,50,58
Ilikelydead,tichondrius,1597,deathknight,unholy,131,64,67
Byres,kelthuzad,1595,deathknight,unholy,58,29,29
Orkky,jubeithos,1595,deathknight,unholy,156,77,79
Wittlewanka,zuljin,1592,deathknight,unholy,136,63,73
Ulísés,ragnaros,1591,deathknight,unholy,58,20,38
Gripyourhoe,tichondrius,1589,deathknight,unholy,48,28,20
Trumps,stormrage,1588,deathknight,unholy,72,37,35
Eyir,thaurissan,1588,deathknight,unholy,104,50,54
Morrticia,malganis,1587,deathknight,unholy,61,38,23
Onlyfunss,moon-guard,1584,deathknight,unholy,119,58,61
Fuzzknight,ravenholdt,1583,deathknight,unholy,54,27,27
Stangz,bonechewer,1583,deathknight,unholy,60,29,31
Raahjx,sargeras,1582,deathknight,unholy,36,20,16
Agohnim,moon-guard,1582,deathknight,unholy,67,36,31
Burbash,moon-guard,1580,deathknight,unholy,205,105,100
Divinium,bleeding-hollow,1579,deathknight,unholy,42,18,24
Níce,tichondrius,1578,deathknight,unholy,72,27,45
Poefather,tichondrius,1575,deathknight,unholy,30,20,10
Daethiel,demon-soul,1574,deathknight,unholy,77,36,41
Kaaizer,azralon,1572,deathknight,unholy,120,68,52
Fydedk,stormrage,1572,deathknight,unholy,96,47,49
Kel,stormreaver,1570,deathknight,unholy,47,17,30
Blackary,emerald-dream,1569,deathknight,unholy,77,48,29
Rongkhun,proudmoore,1569,deathknight,unholy,54,18,36
Evilbot,tichondrius,1564,deathknight,unholy,60,40,20
Grimnuts,thrall,1564,deathknight,unholy,92,49,43
Allianknight,windrunner,1563,deathknight,unholy,54,27,27
Howlex,barthilas,1563,deathknight,unholy,48,24,24
Axeldrion,tichondrius,1561,deathknight,unholy,58,27,31
Zukcho,tichondrius,1559,deathknight,unholy,66,28,38
Bulí,barthilas,1557,deathknight,unholy,65,27,38
Joeyxdk,tichondrius,1555,deathknight,unholy,35,19,16
Sonoftwodads,thrall,1555,deathknight,unholy,42,17,25
Drpepp,bleeding-hollow,1554,deathknight,unholy,167,88,79
Toophus,sargeras,1553,deathknight,unholy,86,41,45
Icytoast,tichondrius,1553,deathknight,unholy,42,19,23
Pue,hyjal,1553,deathknight,unholy,42,18,24
Aryêl,ragnaros,1552,deathknight,unholy,36,18,18
Gottajuice,moonrunner,1551,deathknight,unholy,81,45,36
Siphilusxo,dalaran,1551,deathknight,unholy,36,20,16
Tuicca,frostmane,1551,deathknight,unholy,91,40,51
Arc,maiev,1551,deathknight,unholy,93,39,54
Buttrfingrz,cenarius,1550,deathknight,unholy,96,46,50
Obedient,firetree,1549,deathknight,unholy,138,79,59
Kuwarerubana,proudmoore,1549,deathknight,unholy,74,41,33
Rxzo,frostmourne,1549,deathknight,unholy,48,18,30
Thenin,crushridge,1544,deathknight,unholy,60,37,23
Läskö,area-52,1541,deathknight,unholy,73,42,31
Zzdk,thrall,1541,deathknight,unholy,57,27,30
Quiet,darkspear,1539,deathknight,unholy,48,22,26
Rixin,agamaggan,1538,deathknight,unholy,66,28,38
Rhaeisxalnym,sargeras,1536,deathknight,unholy,166,84,82
Garht,azralon,1533,deathknight,unholy,40,22,18
Huuzzha,tichondrius,1533,deathknight,unholy,166,84,82
Althamon,tanaris,1533,deathknight,unholy,96,44,52
Arthyius,kiljaeden,1533,deathknight,unholy,42,19,23
Urp,aggramar,1533,deathknight,unholy,57,24,33
Telrenaur,proudmoore,1532,deathknight,unholy,72,35,37
Arktoz,tichondrius,1531,deathknight,unholy,30,16,14
Annubarak,malganis,1531,deathknight,unholy,42,19,23
Eldavò,quelthalas,1530,deathknight,unholy,78,39,39
Dialysis,emerald-dream,1530,deathknight,unholy,137,68,69
Kindaholy,malganis,1528,deathknight,unholy,23,17,6
Feej,malganis,1528,deathknight,unholy,48,26,22
Deezwaz,draka,1526,deathknight,unholy,46,25,21
Menethiljr,boulderfist,1525,deathknight,unholy,77,38,39
Nymppho,kelthuzad,1524,deathknight,unholy,403,190,213
Mehithee,kiljaeden,1524,deathknight,unholy,169,75,94
Deathboost,stormrage,1524,deathknight,unholy,60,22,38
Deathbloss,illidan,1523,deathknight,unholy,32,17,15
Tigs,proudmoore,1522,deathknight,unholy,126,65,61
Drfauci,boulderfist,1521,deathknight,unholy,42,20,22
Degrease,bonechewer,1520,deathknight,unholy,91,44,47
Hooterzqt,tichondrius,1518,deathknight,unholy,106,47,59
Grimmdreamer,stormrage,1516,deathknight,unholy,100,45,55
Unholyreap,arthas,1515,deathknight,unholy,54,36,18
Takeoverr,ragnaros,1515,deathknight,unholy,90,53,37
Deathzpeckt,tichondrius,1513,deathknight,unholy,36,17,19
Nightskull,malganis,1510,deathknight,unholy,84,45,39
Devillele,proudmoore,1509,deathknight,unholy,78,36,42
Akilol,tichondrius,1508,deathknight,unholy,54,24,30
Tragdore,thrall,1507,deathknight,unholy,49,21,28
Sandrexx,tichondrius,1506,deathknight,unholy,46,22,24
Dexarax,norgannon,1505,deathknight,unholy,87,49,38
Frostbite,the-venture-co,1505,deathknight,unholy,90,48,42
Kangadeath,frostmourne,1505,deathknight,unholy,83,36,47
Coldsleeps,saurfang,1503,deathknight,unholy,30,16,14
Scythê,barthilas,1502,deathknight,unholy,58,26,32
Unfórgíven,arthas,1501,deathknight,unholy,48,17,31
Cammy,frostmourne,1500,deathknight,unholy,29,16,13
Dmtdeaths,kelthuzad,1500,deathknight,unholy,48,26,22
Deathwavez,cenarius,1500,deathknight,unholy,59,28,31
Revvun,tichondrius,1499,deathknight,unholy,36,17,19
Abroham,arthas,1498,deathknight,unholy,59,30,29
Hooker,dragonmaw,1497,deathknight,unholy,61,35,26
Stoicïsm,tichondrius,1496,deathknight,unholy,114,63,51
Naxn,tichondrius,1495,deathknight,unholy,54,25,29
Zifandel,tichondrius,1494,deathknight,unholy,36,17,19
Apocxo,lightnings-blade,1491,deathknight,unholy,119,58,61
Zaxrree,malganis,1490,deathknight,unholy,66,39,27
Ghoulslasher,bleeding-hollow,1490,deathknight,unholy,62,28,34
Shezoe,drakkari,1489,deathknight,unholy,42,19,23
Kcorides,tichondrius,1488,deathknight,unholy,49,28,21
Laxatives,tichondrius,1488,deathknight,unholy,45,19,26
Monstrosìty,bleeding-hollow,1486,deathknight,unholy,24,16,8
Lazenca,malganis,1485,deathknight,unholy,44,30,14
Desen,arthas,1485,deathknight,unholy,44,18,26
Typhøn,illidan,1484,deathknight,unholy,157,78,79
Gripd,area-52,1484,deathknight,unholy,78,37,41
Saighast,illidan,1482,deathknight,unholy,78,42,36
Unholyfish,malganis,1482,deathknight,unholy,145,75,70
Deadspellz,bleeding-hollow,1479,deathknight,unholy,58,17,41
Brounlyii,drakkari,1478,deathknight,unholy,54,35,19
Ellipsoro,onyxia,1478,deathknight,unholy,66,26,40
Rhors,nemesis,1477,deathknight,unholy,70,34,36
Nialich,kelthuzad,1476,deathknight,unholy,41,16,25
Fugs,ghostlands,1475,deathknight,unholy,96,52,44
Papalich,stormrage,1473,deathknight,unholy,198,94,104
Asheravon,moon-guard,1472,deathknight,unholy,372,179,193
Biefeile,tichondrius,1472,deathknight,unholy,58,25,33
Grayfoxx,twisting-nether,1469,deathknight,unholy,41,18,23
Reinhartlol,sargeras,1468,deathknight,unholy,99,49,50
Tenóry,nemesis,1466,deathknight,unholy,108,52,56
Xlive,tichondrius,1466,deathknight,unholy,42,17,25
Deathpool,shadowmoon,1466,deathknight,unholy,60,24,36
Câpîrota,nemesis,1465,deathknight,unholy,52,25,27
Coldrhelx,quelthalas,1465,deathknight,unholy,104,48,56
Böffa,dalaran,1465,deathknight,unholy,59,21,38
Rognarash,emerald-dream,1464,deathknight,unholy,48,25,23
Dkfenix,ragnaros,1462,deathknight,unholy,142,69,73
Jaxxftw,azralon,1461,deathknight,unholy,106,56,50
Fallen,nazjatar,1460,deathknight,unholy,36,23,13
Darthsydius,azralon,1460,deathknight,unholy,51,26,25
Dreadcowpie,dalaran,1459,deathknight,unholy,30,18,12
Dlaron,ragnaros,1459,deathknight,unholy,58,28,30
Rk,blackhand,1457,deathknight,unholy,97,58,39
Grizzdk,blackrock,1457,deathknight,unholy,36,18,18
Rhaenyrà,tichondrius,1456,deathknight,unholy,49,32,17
Garù,ragnaros,1455,deathknight,unholy,80,42,38
Mortarion,icecrown,1455,deathknight,unholy,196,95,101
Asthenophoba,bloodscalp,1453,deathknight,unholy,42,24,18
Aundethell,moon-guard,1453,deathknight,unholy,51,16,35
Deathsatan,barthilas,1451,deathknight,unholy,92,51,41
Ams,moon-guard,1450,deathknight,unholy,60,32,28
Libramontes,ragnaros,1450,deathknight,unholy,48,25,23
Chainsawmàn,tichondrius,1450,deathknight,unholy,118,61,57
Catena,blood-furnace,1449,deathknight,unholy,90,38,52
Tiansama,ragnaros,1448,deathknight,unholy,36,20,16
Balboskina,shattered-hand,1448,deathknight,unholy,87,45,42
Witdk,illidan,1448,deathknight,unholy,115,53,62
Asana,illidan,1446,deathknight,unholy,59,28,31
Janco,runetotem,1445,deathknight,unholy,30,18,12
Chocodilez,tichondrius,1444,deathknight,unholy,40,17,23
Tracyminaj,tichondrius,1441,deathknight,unholy,90,42,48
Yareyare,tichondrius,1440,deathknight,unholy,61,33,28
Brisblade,shattered-hand,1440,deathknight,unholy,60,31,29
Gerometal,ragnaros,1440,deathknight,unholy,42,18,24
Breadtruck,area-52,1440,deathknight,unholy,75,31,44
Felerin,kiljaeden,1438,deathknight,unholy,36,22,14
Plagueghoul,wyrmrest-accord,1438,deathknight,unholy,209,108,101
Corrpsse,tichondrius,1438,deathknight,unholy,157,81,76
Redbr,tichondrius,1437,deathknight,unholy,78,37,41
Flavorchops,kelthuzad,1437,deathknight,unholy,48,16,32
Dkani,nemesis,1436,deathknight,unholy,101,55,46
Earador,dalaran,1434,deathknight,unholy,73,38,35
Paíín,illidan,1433,deathknight,unholy,78,39,39
Demonnation,illidan,1433,deathknight,unholy,144,60,84
Exin,cenarion-circle,1432,deathknight,unholy,24,15,9
Mordumi,stormrage,1431,deathknight,unholy,67,28,39
Hatreon,sargeras,1430,deathknight,unholy,42,27,15
Binicius,tichondrius,1430,deathknight,unholy,30,17,13
Unrealzrotz,tichondrius,1429,deathknight,unholy,76,48,28
Happynaru,tichondrius,1429,deathknight,unholy,96,47,49
Bébøp,malganis,1429,deathknight,unholy,40,17,23
Sgtdead,thrall,1428,deathknight,unholy,92,51,41
Seiyokú,ragnaros,1428,deathknight,unholy,163,83,80
Kryptikkyt,blackrock,1428,deathknight,unholy,36,15,21
Arkhän,ragnaros,1428,deathknight,unholy,58,21,37
Dûsk,thunderlord,1427,deathknight,unholy,74,32,42
Släke,azralon,1426,deathknight,unholy,172,83,89
Coffeebagel,bleeding-hollow,1426,deathknight,unholy,149,65,84
Clapt,kelthuzad,1425,deathknight,unholy,30,15,15
Wndypefrcorn,sargeras,1424,deathknight,unholy,65,39,26
Wryu,malganis,1424,deathknight,unholy,59,32,27
Anexdk,korgath,1423,deathknight,unholy,24,15,9
Friezen,illidan,1422,deathknight,unholy,24,15,9
Allhejluya,illidan,1422,deathknight,unholy,211,106,105
Jarah,destromath,1422,deathknight,unholy,54,25,29
Gilden,malfurion,1422,deathknight,unholy,98,45,53
Urieen,gorefiend,1420,deathknight,unholy,100,51,49
Sannistus,ysera,1420,deathknight,unholy,97,43,54
Hornpipe,borean-tundra,1418,deathknight,unholy,126,61,65
Fellenn,stormrage,1417,deathknight,unholy,144,78,66
Pmpfrmdwntwn,stormrage,1417,deathknight,unholy,67,28,39
Deathofchaos,smolderthorn,1417,deathknight,unholy,65,25,40
Seranta,wyrmrest-accord,1417,deathknight,unholy,54,19,35
Holsey,moon-guard,1416,deathknight,unholy,78,39,39
Sniperlord,uldaman,1415,deathknight,unholy,90,51,39
Vamplyz,kelthuzad,1415,deathknight,unholy,74,38,36
Subparatbest,chogall,1414,deathknight,unholy,30,15,15
Fanggrief,proudmoore,1414,deathknight,unholy,121,57,64
Knownkilla,hyjal,1413,deathknight,unholy,83,47,36
Bloodramen,dalaran,1413,deathknight,unholy,357,182,175
Tonylin,tichondrius,1411,deathknight,unholy,38,17,21
Rimothedk,illidan,1407,deathknight,unholy,36,17,19
Nokenoke,illidan,1406,deathknight,unholy,281,138,143
Mords,area-52,1406,deathknight,unholy,36,16,20
Dezmond,quelthalas,1404,deathknight,unholy,48,21,27
Hipower,moon-guard,1401,deathknight,unholy,138,72,66
Sílthree,barthilas,1401,deathknight,unholy,42,17,25
Yadaddy,hydraxis,1400,deathknight,unholy,42,23,19
Putrefactive,frostmourne,1400,deathknight,unholy,179,89,90
Fruitvender,kelthuzad,1400,deathknight,unholy,36,15,21
Cadavr,tichondrius,1399,deathknight,unholy,18,15,3
Ventuss,bleeding-hollow,1399,deathknight,unholy,60,31,29
Gankstagrip,anvilmar,1399,deathknight,unholy,114,55,59
Ganancïa,nemesis,1397,deathknight,unholy,75,39,36
Dazerl,stormrage,1396,deathknight,unholy,120,59,61
Unknowndk,kul-tiras,1396,deathknight,unholy,64,29,35
Ðaz,zuljin,1394,deathknight,unholy,48,26,22
Fadedlight,zuljin,1392,deathknight,unholy,130,64,66
Paulpatine,tichondrius,1391,deathknight,unholy,66,25,41
Hydree,bleeding-hollow,1390,deathknight,unholy,54,24,30
Shhnitzle,stormrage,1390,deathknight,unholy,54,22,32
Draenor,shadowmoon,1389,deathknight,unholy,24,15,9
Coolk,tichondrius,1389,deathknight,unholy,96,52,44
Luckyson,tichondrius,1387,deathknight,unholy,52,26,26
Sammåel,malganis,1387,deathknight,unholy,36,18,18
Xènia,exodar,1387,deathknight,unholy,34,16,18
Wrothgarr,stormreaver,1386,deathknight,unholy,48,27,21
Any,the-venture-co,1383,deathknight,unholy,63,27,36
Madmaxxy,barthilas,1382,deathknight,unholy,188,94,94
Egirlgripper,area-52,1382,deathknight,unholy,30,15,15
Frosstbeach,hyjal,1382,deathknight,unholy,60,25,35
Anonymousix,kelthuzad,1381,deathknight,unholy,41,21,20
Risottonero,kelthuzad,1381,deathknight,unholy,221,110,111
Starms,ragnaros,1381,deathknight,unholy,73,30,43
Gêralt,darkspear,1379,deathknight,unholy,42,19,23
Silanvia,wyrmrest-accord,1377,deathknight,unholy,66,30,36
Mèrc,ragnaros,1376,deathknight,unholy,89,38,51
Sparklekitty,illidan,1374,deathknight,unholy,24,16,8
Greeasy,bleeding-hollow,1374,deathknight,unholy,41,23,18
Volcolm,kelthuzad,1373,deathknight,unholy,54,26,28
Zetarexia,area-52,1373,deathknight,unholy,79,38,41
Midway,drakkari,1372,deathknight,unholy,48,27,21
Flo,ghostlands,1371,deathknight,unholy,45,26,19
Àrchøn,kelthuzad,1370,deathknight,unholy,36,18,18
Pacedd,silvermoon,1370,deathknight,unholy,30,15,15
Beby,wyrmrest-accord,1370,deathknight,unholy,32,15,17
Zuly,moon-guard,1369,deathknight,unholy,113,54,59
Nawis,quelthalas,1367,deathknight,unholy,59,26,33
Darkunral,stormrage,1365,deathknight,unholy,86,36,50
Zeban,area-52,1364,deathknight,unholy,84,40,44
Warstompgød,tichondrius,1364,deathknight,unholy,36,16,20
Viràlyourz,bleeding-hollow,1362,deathknight,unholy,42,23,19
Waremoto,ragnaros,1361,deathknight,unholy,81,47,34
Nytrø,illidan,1361,deathknight,unholy,42,18,24
Necrósy,azralon,1360,deathknight,unholy,54,23,31
Cimitiere,stormrage,1360,deathknight,unholy,49,19,30
Krixia,ragnaros,1359,deathknight,unholy,52,25,27
Awzy,azralon,1358,deathknight,unholy,48,26,22
Shélly,ragnaros,1358,deathknight,unholy,89,44,45
Lücìfër,illidan,1358,deathknight,unholy,59,26,33
Dravoc,kelthuzad,1355,deathknight,unholy,66,26,40
Voldrezhul,area-52,1353,deathknight,unholy,66,36,30
Shargan,illidan,1350,deathknight,unholy,54,31,23
Humber,area-52,1350,deathknight,unholy,107,56,51
Killos,proudmoore,1350,deathknight,unholy,36,16,20
Dredrikbane,moon-guard,1349,deathknight,unholy,41,22,19
Bumbleton,blackrock,1349,deathknight,unholy,45,24,21
Nappão,azralon,1349,deathknight,unholy,91,33,58
Seíver,ragnaros,1346,deathknight,unholy,29,15,14
Atrahazis,quelthalas,1343,deathknight,unholy,29,19,10
Dethcro,shandris,1343,deathknight,unholy,93,47,46
Deathwardenn,ghostlands,1343,deathknight,unholy,36,17,19
Feorlar,dalaran,1342,deathknight,unholy,48,21,27
Darktonelol,tichondrius,1342,deathknight,unholy,36,14,22
Shadowsdk,tichondrius,1342,deathknight,unholy,36,14,22
Afterdeath,frostmourne,1340,deathknight,unholy,48,22,26
Wolfsnight,frostmourne,1340,deathknight,unholy,42,14,28
Belegos,quelthalas,1339,deathknight,unholy,98,46,52
Golurun,tichondrius,1338,deathknight,unholy,31,19,12
Tötenkaiser,quelthalas,1337,deathknight,unholy,30,14,16
Ksoldier,illidan,1336,deathknight,unholy,42,20,22
Cswildwind,aerie-peak,1336,deathknight,unholy,48,21,27
Oomak,bonechewer,1336,deathknight,unholy,36,14,22
Terracundo,quelthalas,1335,deathknight,unholy,42,26,16
Ântipaladin,arthas,1335,deathknight,unholy,46,19,27
Fzero,frostmourne,1335,deathknight,unholy,72,24,48
Bhyrnam,ragnaros,1335,deathknight,unholy,42,14,28
Lockstocked,dathremar,1334,deathknight,unholy,37,22,15
Fiddleop,thrall,1333,deathknight,unholy,24,14,10
Søldier,proudmoore,1333,deathknight,unholy,24,14,10
Beeftip,area-52,1333,deathknight,unholy,209,99,110
Aradorn,azralon,1333,deathknight,unholy,209,96,113
Salahzar,stormrage,1333,deathknight,unholy,42,17,25
Scorpíøn,azralon,1332,deathknight,unholy,30,18,12
Negril,tichondrius,1332,deathknight,unholy,78,38,40
Gromhal,azralon,1331,deathknight,unholy,24,14,10
Erodin,moon-guard,1330,deathknight,unholy,30,14,16
Vazarus,darrowmere,1328,deathknight,unholy,92,41,51
Zxy,hyjal,1327,deathknight,unholy,23,17,6
Ez,moknathal,1327,deathknight,unholy,23,15,8
Vynkys,shadow-council,1327,deathknight,unholy,59,33,26
Rekbari,sargeras,1325,deathknight,unholy,24,15,9
Ñovacaine,moon-guard,1325,deathknight,unholy,83,40,43
Unholychillz,ghostlands,1324,deathknight,unholy,44,20,24
Kordrâk,quelthalas,1322,deathknight,unholy,47,23,24
Esquinência,azralon,1322,deathknight,unholy,36,17,19
Tronnie,kelthuzad,1322,deathknight,unholy,110,51,59
Asylïthcc,sargeras,1321,deathknight,unholy,60,34,26
Menethïl,quelthalas,1321,deathknight,unholy,36,14,22
Darknessice,tichondrius,1320,deathknight,unholy,78,40,38
Demona,ragnaros,1313,deathknight,unholy,64,25,39
Thaladius,emerald-dream,1312,deathknight,unholy,59,31,28
Genjírou,frostwolf,1312,deathknight,unholy,298,145,153
Maligned,uldum,1312,deathknight,unholy,49,18,31
Zevrynn,barthilas,1311,deathknight,unholy,36,18,18
Sheipadinho,nemesis,1310,deathknight,unholy,63,41,22
Frðst,executus,1310,deathknight,unholy,24,14,10
Aretos,dreadmaul,1308,deathknight,unholy,56,27,29
Mëgazørd,azralon,1307,deathknight,unholy,72,38,34
Chad,ysondre,1306,deathknight,unholy,36,14,22
Pugnation,uther,1305,deathknight,unholy,42,27,15
Arcainian,tichondrius,1305,deathknight,unholy,171,77,94
Gwiffhm,tichondrius,1304,deathknight,unholy,40,14,26
Rottenwiener,sargeras,1303,deathknight,unholy,35,22,13
Deephideblue,proudmoore,1300,deathknight,unholy,43,14,29
Killerundead,area-52,1298,deathknight,unholy,40,17,23
Skppee,tichondrius,1295,deathknight,unholy,27,14,13
Attackondude,illidan,1292,deathknight,unholy,30,18,12
Sabotdk,tichondrius,1291,deathknight,unholy,42,23,19
Unholycube,zuljin,1290,deathknight,unholy,35,14,21
Cripticknigt,spinebreaker,1289,deathknight,unholy,48,22,26
Deliriioh,ragnaros,1286,deathknight,unholy,252,129,123
Koltíra,azralon,1286,deathknight,unholy,60,29,31
Digitalsammy,area-52,1286,deathknight,unholy,77,31,46
Xijiñpiñg,hyjal,1285,deathknight,unholy,36,18,18
Bloodserfer,sargeras,1285,deathknight,unholy,66,31,35
Mainxx,stormrage,1282,deathknight,unholy,29,14,15
Frostbytez,barthilas,1281,deathknight,unholy,35,15,20
Zaluster,malganis,1277,deathknight,unholy,247,124,123
Isaarid,proudmoore,1275,deathknight,unholy,34,20,14
Harlthas,ragnaros,1274,deathknight,unholy,30,17,13
Ometecuhtli,kelthuzad,1273,deathknight,unholy,60,35,25
Kromgarath,stormrage,1271,deathknight,unholy,60,28,32
Nekrosys,eitrigg,1270,deathknight,unholy,40,14,26
Tëte,quelthalas,1269,deathknight,unholy,35,14,21
Nukydoe,azralon,1260,deathknight,unholy,42,19,23
Jukpark,tichondrius,1256,deathknight,unholy,78,48,30
Abruptdk,bonechewer,1254,deathknight,unholy,61,29,32
Leiry,darkspear,1253,deathknight,unholy,32,20,12
Xtador,quelthalas,1252,deathknight,unholy,29,15,14
Unleud,tichondrius,1251,deathknight,unholy,66,36,30
Shargan,tichondrius,1251,deathknight,unholy,90,46,44
Ownaron,moon-guard,1249,deathknight,unholy,51,27,24
Resumen,steamwheedle-cartel,1249,deathknight,unholy,32,15,17
Darkàn,lightnings-blade,1249,deathknight,unholy,54,24,30
Ekirei,daggerspine,1248,deathknight,unholy,23,14,9
Mesx,illidan,1247,deathknight,unholy,24,13,11
Clowngodx,illidan,1247,deathknight,unholy,24,13,11
Shxtlørdx,stormrage,1247,deathknight,unholy,24,13,11
Artyboy,icecrown,1247,deathknight,unholy,30,13,17
Poubelle,malganis,1247,deathknight,unholy,36,13,23
Buldrokastee,tichondrius,1247,deathknight,unholy,36,13,23
Hotdk,thrall,1247,deathknight,unholy,36,13,23
Bloodyloco,malganis,1246,deathknight,unholy,64,32,32
Lr,hyjal,1246,deathknight,unholy,36,17,19
Metinchaff,shadowmoon,1245,deathknight,unholy,18,13,5
Daixks,proudmoore,1245,deathknight,unholy,42,22,20
Hanmayuziro,tichondrius,1244,deathknight,unholy,29,14,15
Richiex,tichondrius,1244,deathknight,unholy,36,13,23
Aisö,bleeding-hollow,1244,deathknight,unholy,36,13,23
Magipierrot,ragnaros,1243,deathknight,unholy,102,51,51
Mopglad,tichondrius,1242,deathknight,unholy,24,13,11
Lovedaddy,frostmourne,1242,deathknight,unholy,30,13,17
Bubblesdk,whisperwind,1242,deathknight,unholy,66,27,39
Youngmoneyyd,illidan,1241,deathknight,unholy,18,13,5
Hobdk,malganis,1241,deathknight,unholy,39,15,24
Deathstrikex,tichondrius,1240,deathknight,unholy,24,13,11
Mightyfails,frostmourne,1239,deathknight,unholy,30,13,17
Frostyclaws,blackrock,1237,deathknight,unholy,24,13,11
Lebrônjames,tichondrius,1236,deathknight,unholy,24,13,11
Neipum,stormrage,1234,deathknight,unholy,18,13,5
Vynlerran,skullcrusher,1234,deathknight,unholy,24,13,11
Rarum,bleeding-hollow,1233,deathknight,unholy,24,13,11
Artous,stormrage,1231,deathknight,unholy,45,14,31
Treikorh,quelthalas,1230,deathknight,unholy,150,67,83
Deathdra,illidan,1229,deathknight,unholy,24,16,8
Niennahh,sargeras,1229,deathknight,unholy,36,16,20
Soulhuntress,doomhammer,1227,deathknight,unholy,114,58,56
Dkjs,anetheron,1227,deathknight,unholy,42,17,25
Unhølydøøm,misha,1226,deathknight,unholy,78,39,39
Acerbus,mannoroth,1225,deathknight,unholy,29,13,16
Sokthr,proudmoore,1224,deathknight,unholy,38,17,21
Potatobob,dalaran,1222,deathknight,unholy,30,13,17
Trüppen,area-52,1221,deathknight,unholy,83,46,37
Möchi,ragnaros,1221,deathknight,unholy,87,43,44
Vaske,azjolnerub,1215,deathknight,unholy,91,42,49
Cizzorz,tichondrius,1214,deathknight,unholy,29,13,16
Hellzkknight,tichondrius,1213,deathknight,unholy,43,20,23
Moxtexd,drakkari,1212,deathknight,unholy,78,49,29
Mazey,moon-guard,1209,deathknight,unholy,199,98,101
Nevarro,lightbringer,1209,deathknight,unholy,234,114,120
Heärt,bleeding-hollow,1208,deathknight,unholy,86,40,46
Lieyanyanwan,tichondrius,1207,deathknight,unholy,48,19,29
Volardan,trollbane,1206,deathknight,unholy,33,20,13
Kentolos,proudmoore,1204,deathknight,unholy,30,19,11
Enjal,stormrage,1203,deathknight,unholy,71,30,41
Deathafter,tichondrius,1202,deathknight,unholy,63,28,35
Tugs,nathrezim,1202,deathknight,unholy,36,16,20
Yosemithe,quelthalas,1201,deathknight,unholy,24,13,11
Dalrin,emerald-dream,1201,deathknight,unholy,36,13,23
Lorð,malganis,1195,deathknight,unholy,48,24,24
Gothywaifu,thunderhorn,1194,deathknight,unholy,39,18,21
Agrip,proudmoore,1194,deathknight,unholy,30,13,17
Gatrars,sargeras,1192,deathknight,unholy,96,44,52
Masochrist,baelgun,1192,deathknight,unholy,45,20,25
Dkzote,quelthalas,1187,deathknight,unholy,66,23,43
Leviiathan,tichondrius,1185,deathknight,unholy,30,14,16
Edhral,ragnaros,1184,deathknight,unholy,36,16,20
Toroandmoi,area-52,1184,deathknight,unholy,36,16,20
Lunaxx,ragnaros,1183,deathknight,unholy,30,14,16
Exur,stormrage,1183,deathknight,unholy,34,13,21
Sne,dragonmaw,1180,deathknight,unholy,30,17,13
Muffinstomp,eredar,1180,deathknight,unholy,88,45,43
Unhøøly,nemesis,1179,deathknight,unholy,78,42,36
Kehin,azralon,1179,deathknight,unholy,79,35,44
Coffïnfeeder,dalaran,1178,deathknight,unholy,78,31,47
Darthblade,darkspear,1177,deathknight,unholy,66,43,23
Drowhd,nemesis,1177,deathknight,unholy,60,27,33
Deadwait,rivendare,1175,deathknight,unholy,22,13,9
Exequias,zuljin,1175,deathknight,unholy,54,31,23
Jhiv,tichondrius,1172,deathknight,unholy,28,14,14
Blightrish,icecrown,1172,deathknight,unholy,66,32,34
Furcht,gundrak,1171,deathknight,unholy,26,13,13
Càsshêrn,lightbringer,1170,deathknight,unholy,20,13,7
Omegaseven,gorgonnash,1170,deathknight,unholy,190,98,92
Jinus,earthen-ring,1159,deathknight,unholy,42,22,20
Zeeroo,moon-guard,1157,deathknight,unholy,52,25,27
Oql,tichondrius,1152,deathknight,unholy,24,12,12
Diviniumx,bleeding-hollow,1152,deathknight,unholy,27,13,14
Akmy,illidan,1151,deathknight,unholy,24,12,12
Méthmonster,stormrage,1150,deathknight,unholy,39,23,16
Zeenki,ragnaros,1150,deathknight,unholy,24,12,12
Balakk,tichondrius,1150,deathknight,unholy,34,15,19
Nihlan,sargeras,1150,deathknight,unholy,30,12,18
Vesel,tichondrius,1149,deathknight,unholy,36,12,24
Bazzingaxd,hyjal,1148,deathknight,unholy,54,34,20
Azgaroth,dathremar,1148,deathknight,unholy,38,20,18
Migwel,emerald-dream,1147,deathknight,unholy,24,12,12
Zign,malganis,1147,deathknight,unholy,30,12,18
Vaseline,zangarmarsh,1146,deathknight,unholy,113,58,55
Oldskul,sargeras,1146,deathknight,unholy,34,17,17
Dkbunny,thaurissan,1146,deathknight,unholy,24,12,12
Chalamander,tichondrius,1146,deathknight,unholy,24,12,12
Iamthedanger,aerie-peak,1145,deathknight,unholy,24,12,12
Dravix,azshara,1143,deathknight,unholy,18,12,6
Trentus,illidan,1142,deathknight,unholy,72,36,36
Skeleton,lightnings-blade,1141,deathknight,unholy,33,13,20
Croaker,gurubashi,1140,deathknight,unholy,47,27,20
Wacktony,illidan,1139,deathknight,unholy,24,12,12
Ahrímán,illidan,1139,deathknight,unholy,175,77,98
Skellig,wyrmrest-accord,1137,deathknight,unholy,60,24,36
Deadlyforce,sargeras,1136,deathknight,unholy,18,12,6
Noahmelo,nemesis,1136,deathknight,unholy,25,13,12
Araris,stormrage,1135,deathknight,unholy,36,12,24
Shinici,kelthuzad,1132,deathknight,unholy,24,12,12
Deathsmog,quelthalas,1127,deathknight,unholy,37,22,15
Darktrinnity,nemesis,1127,deathknight,unholy,95,48,47
Mordekaiseer,azralon,1123,deathknight,unholy,178,91,87
Vampirecarti,tichondrius,1122,deathknight,unholy,38,18,20
Nicrack,malganis,1120,deathknight,unholy,24,13,11
Aquafina,nemesis,1120,deathknight,unholy,24,12,12
Carecaa,azralon,1119,deathknight,unholy,44,19,25
Umbranox,arthas,1116,deathknight,unholy,66,23,43
Frostcleave,emerald-dream,1115,deathknight,unholy,24,16,8
Latroz,gundrak,1114,deathknight,unholy,108,44,64
Druncker,blackrock,1114,deathknight,unholy,53,20,33
Mordeo,bleeding-hollow,1114,deathknight,unholy,34,12,22
Pántera,darkspear,1113,deathknight,unholy,24,12,12
Festers,burning-legion,1112,deathknight,unholy,38,14,24
Mandrágor,quelthalas,1111,deathknight,unholy,52,20,32
Kalëndar,drakkari,1100,deathknight,unholy,60,31,29
Morghulas,moon-guard,1098,deathknight,unholy,30,12,18
Zebirock,stormrage,1098,deathknight,unholy,54,19,35
Maripaula,ragnaros,1097,deathknight,unholy,35,14,21
Scaista,tichondrius,1095,deathknight,unholy,24,13,11
Polydeuces,queldorei,1091,deathknight,unholy,66,26,40
Hentaideath,kiljaeden,1088,deathknight,unholy,42,19,23
Déká,tichondrius,1087,deathknight,unholy,46,20,26
Fuzzyrump,eitrigg,1086,deathknight,unholy,48,27,21
Zebastion,amanthul,1086,deathknight,unholy,54,22,32
Kanthrix,illidan,1084,deathknight,unholy,32,12,20
Lòthlòria,mannoroth,1080,deathknight,unholy,67,26,41
Zillachilla,azshara,1079,deathknight,unholy,21,13,8
Honustustere,stormrage,1076,deathknight,unholy,29,12,17
Kayzark,tichondrius,1075,deathknight,unholy,78,43,35
Frostkane,stormrage,1071,deathknight,unholy,36,17,19
Froznorbs,tichondrius,1068,deathknight,unholy,26,13,13
Dankbro,tichondrius,1067,deathknight,unholy,48,18,30
Zaelize,sargeras,1065,deathknight,unholy,60,27,33
Ragsec,bleeding-hollow,1056,deathknight,unholy,18,11,7
Mossó,tichondrius,1056,deathknight,unholy,18,11,7
Neroxzdvm,area-52,1056,deathknight,unholy,30,11,19
Cptsäveähöe,tichondrius,1056,deathknight,unholy,30,11,19
Dreâmer,tichondrius,1056,deathknight,unholy,30,11,19
Sleezyfbaby,sargeras,1055,deathknight,unholy,18,11,7
Troyy,sargeras,1055,deathknight,unholy,30,11,19
Rytex,moon-guard,1055,deathknight,unholy,30,11,19
Saltank,frostmourne,1054,deathknight,unholy,18,11,7
Eightamdk,tichondrius,1054,deathknight,unholy,30,11,19
Sommeliergg,stormrage,1053,deathknight,unholy,18,11,7
Plaguebreak,darrowmere,1053,deathknight,unholy,114,62,52
Xaldalas,kelthuzad,1053,deathknight,unholy,24,11,13
Nwnqt,frostmourne,1053,deathknight,unholy,27,12,15
Boomxic,shuhalo,1053,deathknight,unholy,38,13,25
Polpop,zuljin,1051,deathknight,unholy,18,11,7
Acidirin,tichondrius,1049,deathknight,unholy,18,11,7
Xány,ragnaros,1049,deathknight,unholy,27,12,15
Logann,azralon,1049,deathknight,unholy,40,16,24
Runicblade,jaedenar,1048,deathknight,unholy,18,11,7
Raull,ragnaros,1048,deathknight,unholy,30,11,19
Rulord,wyrmrest-accord,1047,deathknight,unholy,24,11,13
Darthkeefers,zuljin,1047,deathknight,unholy,30,11,19
Horîzon,sargeras,1047,deathknight,unholy,30,11,19
Atheion,the-underbog,1046,deathknight,unholy,24,11,13
Alphabro,zuluhed,1045,deathknight,unholy,54,26,28
Kreandria,dalaran,1045,deathknight,unholy,57,15,42
Umbrha,quelthalas,1044,deathknight,unholy,24,11,13
Lazta,azralon,1044,deathknight,unholy,40,17,23
Orphnoch,illidan,1043,deathknight,unholy,30,11,19
Arthureon,kelthuzad,1041,deathknight,unholy,38,14,24
Alayka,stormrage,1040,deathknight,unholy,25,11,14
Stemen,quelthalas,1036,deathknight,unholy,24,11,13
Mercysparx,thrall,1033,deathknight,unholy,132,61,71
Olblueyes,hyjal,1027,deathknight,unholy,30,11,19
Deathcometh,tichondrius,1027,deathknight,unholy,30,11,19
Jman,kaelthas,1026,deathknight,unholy,63,31,32
Argar,crushridge,1023,deathknight,unholy,36,20,16
Poonen,area-52,1021,deathknight,unholy,23,11,12
Rulotauro,blackrock,1019,deathknight,unholy,28,11,17
Bloopdabloop,sargeras,1015,deathknight,unholy,55,31,24
Mmrhostage,kelthuzad,1015,deathknight,unholy,35,15,20
Tandarilada,shadowmoon,1009,deathknight,unholy,60,30,30
Modok,malganis,1006,deathknight,unholy,17,11,6
Mëllowhypë,sargeras,1000,deathknight,unholy,44,17,27
Galaxrz,bonechewer,990,deathknight,unholy,36,14,22
Raizzhít,ragnaros,989,deathknight,unholy,22,11,11
Kowell,drakkari,989,deathknight,unholy,30,11,19
Dàndàn,lightbringer,983,deathknight,unholy,30,12,18
Hansmclroy,trollbane,979,deathknight,unholy,35,19,16
Shadowzombie,lethon,975,deathknight,unholy,28,11,17
Maalevolent,thunderlord,972,deathknight,unholy,31,11,20
Cishei,quelthalas,970,deathknight,unholy,39,23,16
Fendos,turalyon,963,deathknight,unholy,24,14,10
Wölf,durotan,960,deathknight,unholy,12,10,2
Bernaldino,illidan,960,deathknight,unholy,12,10,2
Ragrek,bleeding-hollow,960,deathknight,unholy,24,10,14
Rängi,caelestrasz,960,deathknight,unholy,78,26,52
Immadkx,area-52,960,deathknight,unholy,30,10,20
Eks,barthilas,959,deathknight,unholy,12,10,2
Awshuks,illidan,959,deathknight,unholy,18,10,8
Gurnok,barthilas,959,deathknight,unholy,18,10,8
Saco,malganis,959,deathknight,unholy,18,10,8
Turbokitten,tichondrius,959,deathknight,unholy,18,10,8
Distorted,emerald-dream,959,deathknight,unholy,24,10,14
Emarose,illidan,959,deathknight,unholy,24,10,14
Ohia,baelgun,959,deathknight,unholy,30,10,20
Galaxyboom,tichondrius,958,deathknight,unholy,12,10,2
Ghouldruis,barthilas,958,deathknight,unholy,18,10,8
Khørne,area-52,958,deathknight,unholy,18,10,8
Polepounder,malganis,957,deathknight,unholy,12,10,2
Iðûnn,barthilas,957,deathknight,unholy,18,10,8
Aborter,arthas,957,deathknight,unholy,24,11,13
Aldoraenna,illidan,957,deathknight,unholy,24,10,14
Biukanon,ragnaros,956,deathknight,unholy,24,10,14
Mëlødy,quelthalas,955,deathknight,unholy,18,10,8
Gobaiakun,proudmoore,955,deathknight,unholy,18,10,8
Bigdollars,eredar,954,deathknight,unholy,18,10,8
Noolore,firetree,952,deathknight,unholy,12,10,2
Hyondeath,tichondrius,952,deathknight,unholy,24,10,14
Sylneria,elune,952,deathknight,unholy,24,10,14
Vërmilliøn,ragnaros,951,deathknight,unholy,24,10,14
Thaylenaar,eredar,947,deathknight,unholy,18,10,8
Bahtman,hakkar,946,deathknight,unholy,30,15,15
Ghorzul,thrall,945,deathknight,unholy,24,10,14
Morhtzen,moon-guard,944,deathknight,unholy,13,10,3
Sübzerö,quelthalas,940,deathknight,unholy,48,14,34
Delamuerte,ragnaros,935,deathknight,unholy,42,18,24
Draxsos,quelthalas,931,deathknight,unholy,54,25,29
Maverax,executus,931,deathknight,unholy,37,17,20
Soulfarm,tichondrius,929,deathknight,unholy,42,22,20
Deathnorris,zuljin,919,deathknight,unholy,148,69,79
Tasila,tichondrius,907,deathknight,unholy,17,10,7
Jaydkx,tichondrius,906,deathknight,unholy,28,11,17
Reighart,kiljaeden,894,deathknight,unholy,20,10,10
Dragoroth,zuluhed,893,deathknight,unholy,31,15,16
Carmii,wyrmrest-accord,879,deathknight,unholy,25,10,15
Zareon,zuluhed,876,deathknight,unholy,24,12,12
Dandandor,muradin,876,deathknight,unholy,38,17,21
Grimmtidings,dentarg,869,deathknight,unholy,59,26,33
Nerfdklul,illidan,864,deathknight,unholy,12,9,3
Rizzchimp,tichondrius,864,deathknight,unholy,12,9,3
Zakka,korgath,864,deathknight,unholy,18,9,9
Sickly,arthas,864,deathknight,unholy,18,9,9
Utthrity,ysera,864,deathknight,unholy,18,9,9
Jbot,dunemaul,864,deathknight,unholy,18,9,9
Skullash,stormrage,864,deathknight,unholy,18,9,9
Rockadeath,sargeras,864,deathknight,unholy,18,9,9
Agrithomqt,frostmourne,864,deathknight,unholy,18,9,9
Methyldk,frostmourne,864,deathknight,unholy,21,10,11
Shinukishin,stormrage,864,deathknight,unholy,24,9,15
Fortissax,area-52,864,deathknight,unholy,30,9,21
Sçythe,hyjal,863,deathknight,unholy,12,9,3
Kasteny,frostmourne,863,deathknight,unholy,18,9,9
Anaksunamooñ,sargeras,863,deathknight,unholy,18,9,9
Spurzilla,emerald-dream,863,deathknight,unholy,18,9,9
Valandiel,jubeithos,863,deathknight,unholy,18,9,9
Bmminitian,illidan,863,deathknight,unholy,18,9,9
Azzandraza,wyrmrest-accord,863,deathknight,unholy,18,9,9
Sbplaysdk,akama,863,deathknight,unholy,30,9,21
Tharegorn,azralon,862,deathknight,unholy,18,9,9
Maiatsu,illidan,862,deathknight,unholy,18,9,9
Cowthàs,emerald-dream,862,deathknight,unholy,22,10,12
Monglord,arthas,861,deathknight,unholy,18,9,9
Runeswanson,area-52,861,deathknight,unholy,18,9,9
Cosanostrá,malganis,860,deathknight,unholy,12,9,3
Rinthosaka,ragnaros,860,deathknight,unholy,18,9,9
Velyssiah,stormrage,860,deathknight,unholy,24,9,15
Smerknight,proudmoore,860,deathknight,unholy,30,9,21
Ðerion,stormrage,859,deathknight,unholy,18,9,9
Sidbane,kalecgos,859,deathknight,unholy,19,9,10
Kaórii,stormrage,858,deathknight,unholy,30,9,21
Deäthcrüsh,tichondrius,856,deathknight,unholy,12,9,3
Tinytanx,aerie-peak,856,deathknight,unholy,30,9,21
Thedarksoul,agamaggan,853,deathknight,unholy,74,27,47
Zathog,lightbringer,853,deathknight,unholy,30,9,21
Revendra,emerald-dream,852,deathknight,unholy,20,10,10
Ulyssess,jubeithos,851,deathknight,unholy,76,35,41
Pwnface,aerie-peak,851,deathknight,unholy,25,9,16
Ulerin,illidan,850,deathknight,unholy,18,9,9
Henritoxic,azralon,848,deathknight,unholy,16,11,5
Plaza,thorium-brotherhood,844,deathknight,unholy,18,9,9
Destruktion,uldaman,838,deathknight,unholy,12,9,3
Handler,nemesis,830,deathknight,unholy,20,10,10
Vynjonc,drenden,820,deathknight,unholy,18,9,9
Alderma,zuljin,814,deathknight,unholy,29,10,19
Stygiansiix,draenor,791,deathknight,unholy,42,17,25
Wuhán,proudmoore,787,deathknight,unholy,38,9,29
Poderrosodk,azralon,768,deathknight,unholy,12,8,4
Vitad,tichondrius,768,deathknight,unholy,12,8,4
Jamjae,tichondrius,768,deathknight,unholy,12,8,4
Dendra,barthilas,768,deathknight,unholy,12,8,4
Xhín,bleeding-hollow,768,deathknight,unholy,12,8,4
Liqùid,moon-guard,768,deathknight,unholy,12,8,4
Imrealgày,zuljin,768,deathknight,unholy,12,8,4
Ghostriderr,tichondrius,768,deathknight,unholy,12,8,4
Dicromick,illidan,768,deathknight,unholy,15,9,6
Piratehookah,sargeras,768,deathknight,unholy,18,8,10
Toxicbooger,thrall,768,deathknight,unholy,18,8,10
Slissy,hyjal,768,deathknight,unholy,18,8,10
Sinnan,turalyon,768,deathknight,unholy,18,8,10
Maltendis,malganis,768,deathknight,unholy,18,8,10
Darkathås,tichondrius,768,deathknight,unholy,24,8,16
Novädk,ragnaros,768,deathknight,unholy,24,8,16
Thraximundar,stormrage,768,deathknight,unholy,24,8,16
Loomoros,sargeras,768,deathknight,unholy,24,8,16
Akrylo,ragnaros,767,deathknight,unholy,12,8,4
Bojaçk,stormrage,767,deathknight,unholy,12,8,4
Ørcrist,area-52,767,deathknight,unholy,12,8,4
Darik,the-venture-co,767,deathknight,unholy,12,8,4
Deathsloot,sargeras,767,deathknight,unholy,12,8,4
Trydeath,azralon,767,deathknight,unholy,13,8,5
Bloodygrip,bleeding-hollow,767,deathknight,unholy,18,8,10
Fluffymoo,frostmourne,767,deathknight,unholy,18,8,10
Almostdead,proudmoore,767,deathknight,unholy,18,8,10
Traitre,onyxia,767,deathknight,unholy,18,8,10
Hædës,area-52,767,deathknight,unholy,18,8,10
Nattór,dalaran,767,deathknight,unholy,18,8,10
Gorillagrip,sargeras,767,deathknight,unholy,18,8,10
Apocalipsis,bleeding-hollow,767,deathknight,unholy,18,8,10
Deathlyvoid,sargeras,767,deathknight,unholy,18,8,10
Sujudk,emerald-dream,767,deathknight,unholy,18,8,10
Zuckdk,illidan,767,deathknight,unholy,18,8,10
Skulm,emerald-dream,767,deathknight,unholy,20,8,12
Deadkaiser,ragnaros,767,deathknight,unholy,24,8,16
Sicklecell,laughing-skull,767,deathknight,unholy,24,8,16
Sahaile,moon-guard,767,deathknight,unholy,30,8,22
Tragül,sargeras,766,deathknight,unholy,12,8,4
Ðrëssa,azralon,766,deathknight,unholy,12,8,4
Raynorr,dawnbringer,766,deathknight,unholy,12,8,4
Redcancer,tichondrius,766,deathknight,unholy,12,8,4
Bànished,moon-guard,766,deathknight,unholy,13,8,5
Archaná,stormrage,766,deathknight,unholy,18,8,10
Katakuri,azralon,766,deathknight,unholy,18,8,10
Hellhämmer,ragnaros,766,deathknight,unholy,18,8,10
Riparonii,illidan,766,deathknight,unholy,21,8,13
Ltoblivious,thrall,766,deathknight,unholy,24,8,16
Shadowghast,saurfang,765,deathknight,unholy,12,8,4
Hildolfr,shattered-hand,765,deathknight,unholy,18,8,10
Bloodydebt,malganis,765,deathknight,unholy,18,8,10
Wickedknîght,kelthuzad,765,deathknight,unholy,24,8,16
Abadena,illidan,765,deathknight,unholy,27,8,19
Maggotmulch,zuljin,764,deathknight,unholy,30,8,22
Yafa,bonechewer,764,deathknight,unholy,39,10,29
Primoverdino,azralon,762,deathknight,unholy,18,8,10
Azombie,burning-blade,762,deathknight,unholy,18,8,10
Spotsdk,hyjal,761,deathknight,unholy,18,8,10
Iamlrr,maelstrom,761,deathknight,unholy,24,8,16
Liltinktink,stormreaver,760,deathknight,unholy,18,8,10
Jojomcdeath,senjin,760,deathknight,unholy,18,8,10
Kaciann,dalaran,758,deathknight,unholy,12,8,4
Lepanda,skywall,758,deathknight,unholy,18,8,10
Rinngar,quelthalas,751,deathknight,unholy,14,8,6
Flexyoo,kelthuzad,751,deathknight,unholy,17,8,9
Silvorus,moon-guard,735,deathknight,unholy,17,8,9
Starset,burning-legion,728,deathknight,unholy,24,9,15
Hadianton,stormrage,718,deathknight,unholy,21,9,12
Droko,thunderlord,714,deathknight,unholy,27,9,18
Somethingdum,sargeras,703,deathknight,unholy,16,8,8
Lolcàtxo,tichondrius,703,deathknight,unholy,17,8,9
Pharyngitis,emerald-dream,672,deathknight,unholy,12,7,5
Liverkick,zuljin,672,deathknight,unholy,12,7,5
Bkb,sargeras,672,deathknight,unholy,12,7,5
Penguinlolx,sargeras,672,deathknight,unholy,12,7,5
Ripcrawford,proudmoore,672,deathknight,unholy,12,7,5
Plag,bleeding-hollow,672,deathknight,unholy,12,7,5
Karthayne,area-52,672,deathknight,unholy,12,7,5
Mcdeathturds,tichondrius,672,deathknight,unholy,12,7,5
Jbert,sargeras,672,deathknight,unholy,12,7,5
Cgg,tichondrius,672,deathknight,unholy,12,7,5
Beforelunch,tichondrius,672,deathknight,unholy,12,7,5
Bukumo,zuljin,672,deathknight,unholy,12,7,5
Donrhythmic,ysera,672,deathknight,unholy,12,7,5
Inemia,wyrmrest-accord,672,deathknight,unholy,16,7,9
Worgenracist,tichondrius,672,deathknight,unholy,18,7,11
Chibalaloca,quelthalas,672,deathknight,unholy,18,7,11
Dreadwraith,malganis,672,deathknight,unholy,18,7,11
Umbramane,tichondrius,672,deathknight,unholy,18,7,11
Deathup,sargeras,672,deathknight,unholy,18,7,11
Ebolaxd,area-52,672,deathknight,unholy,18,7,11
Dxssxe,tichondrius,672,deathknight,unholy,18,7,11
Bryku,tichondrius,672,deathknight,unholy,18,7,11
Cali,bladefist,672,deathknight,unholy,18,7,11
Meisterdeath,stormrage,672,deathknight,unholy,18,7,11
Notiniquity,tichondrius,672,deathknight,unholy,18,7,11
Kûri,runetotem,672,deathknight,unholy,18,7,11
Bellybuster,malganis,672,deathknight,unholy,18,7,11
Mmaximus,darkspear,672,deathknight,unholy,18,7,11
Zoomoth,illidan,672,deathknight,unholy,24,7,17
Xenocrates,illidan,672,deathknight,unholy,24,7,17
Zenan,area-52,672,deathknight,unholy,24,7,17
Ceedog,crushridge,672,deathknight,unholy,30,7,23
Sevexi,moon-guard,671,deathknight,unholy,12,7,5
Deatheey,area-52,671,deathknight,unholy,12,7,5
Buhc,tichondrius,671,deathknight,unholy,12,7,5
Fligdeath,llane,671,deathknight,unholy,12,7,5
Tailzy,proudmoore,671,deathknight,unholy,12,7,5
Gâbriel,cairne,671,deathknight,unholy,12,7,5
Zzed,azralon,671,deathknight,unholy,12,7,5
Tiller,mannoroth,671,deathknight,unholy,12,7,5
Rihàn,drakkari,671,deathknight,unholy,12,7,5
Fallenelfie,frostmourne,671,deathknight,unholy,12,7,5
Samsoníte,illidan,671,deathknight,unholy,12,7,5
Effendi,tichondrius,671,deathknight,unholy,12,7,5
Noitrox,azralon,671,deathknight,unholy,18,7,11
Mfknight,archimonde,671,deathknight,unholy,18,7,11
Nolderosdk,nemesis,671,deathknight,unholy,18,7,11
Woahwtf,area-52,671,deathknight,unholy,18,7,11
Kidek,proudmoore,671,deathknight,unholy,18,7,11
Deadlungs,area-52,671,deathknight,unholy,20,7,13
Demonstalker,boulderfist,671,deathknight,unholy,24,7,17
Kralos,khadgar,670,deathknight,unholy,12,7,5
Onslàught,sargeras,670,deathknight,unholy,12,7,5
Étérnaldeath,ragnaros,670,deathknight,unholy,18,7,11
Emberwarden,stormrage,670,deathknight,unholy,18,7,11
Adralin,sargeras,670,deathknight,unholy,18,7,11
Irokthefrost,frostmourne,669,deathknight,unholy,12,7,5
Bnasty,arthas,669,deathknight,unholy,18,7,11
Cowmedian,norgannon,669,deathknight,unholy,24,7,17
Boneguard,stormrage,668,deathknight,unholy,18,7,11
Grtmisdirect,illidan,666,deathknight,unholy,21,8,13
Arthasnet,quelthalas,666,deathknight,unholy,24,7,17
Zàkgor,moon-guard,665,deathknight,unholy,12,7,5
Zëb,sargeras,665,deathknight,unholy,12,7,5
Thepanzer,elune,665,deathknight,unholy,12,7,5
Runíc,demon-soul,664,deathknight,unholy,18,7,11
Heldwynd,bonechewer,664,deathknight,unholy,24,7,17
Garshna,ragnaros,658,deathknight,unholy,12,7,5
Mortorum,skullcrusher,655,deathknight,unholy,15,9,6
Dreekon,bleeding-hollow,647,deathknight,unholy,30,15,15
Papparoach,ysera,641,deathknight,unholy,24,7,17
Dbg,frostmane,639,deathknight,unholy,11,7,4
Athropos,sargeras,639,deathknight,unholy,14,8,6
Alzenth,quelthalas,639,deathknight,unholy,16,7,9
Hardtoplaydk,chogall,639,deathknight,unholy,17,7,10
Ghostdeath,blackhand,622,deathknight,unholy,15,7,8
Bonalumë,azralon,620,deathknight,unholy,17,7,10
Ahirek,quelthalas,608,deathknight,unholy,16,7,9
Soulkiti,blackwater-raiders,608,deathknight,unholy,16,7,9
Bingoez,frostmourne,607,deathknight,unholy,11,7,4
Plutonyus,stonemaul,607,deathknight,unholy,16,7,9
Bosleigor,elune,592,deathknight,unholy,19,7,12
Arcänn,drenden,576,deathknight,unholy,6,6,0
Remõrse,moon-guard,576,deathknight,unholy,12,6,6
Mizzri,frostmourne,576,deathknight,unholy,12,6,6
Mts,thunderhorn,576,deathknight,unholy,12,6,6
Zyzz,frostmourne,576,deathknight,unholy,12,6,6
Sanezarro,bleeding-hollow,576,deathknight,unholy,12,6,6
Palliote,frostmane,576,deathknight,unholy,12,6,6
Càvic,malganis,576,deathknight,unholy,12,6,6
Raaizz,ragnaros,576,deathknight,unholy,12,6,6
Demonicrunes,windrunner,576,deathknight,unholy,12,6,6
Ralphpootawn,illidan,576,deathknight,unholy,12,6,6
Ðecaying,area-52,576,deathknight,unholy,12,6,6
Salusx,area-52,576,deathknight,unholy,12,6,6
Jonahdk,sargeras,576,deathknight,unholy,12,6,6
Svlla,doomhammer,576,deathknight,unholy,12,6,6
Bøoth,area-52,576,deathknight,unholy,12,6,6
Hickish,tichondrius,576,deathknight,unholy,12,6,6
Chubingus,the-venture-co,576,deathknight,unholy,12,6,6
Nøzawkolypse,area-52,576,deathknight,unholy,12,6,6
Lilwayne,archimonde,576,deathknight,unholy,12,6,6
Surkk,tichondrius,576,deathknight,unholy,12,6,6
Bossdk,tichondrius,576,deathknight,unholy,12,6,6
Ridesatenspd,caelestrasz,576,deathknight,unholy,12,6,6
Xhan,tichondrius,576,deathknight,unholy,12,6,6
Delwrath,proudmoore,576,deathknight,unholy,12,6,6
Tyrsfaith,tichondrius,576,deathknight,unholy,12,6,6
Chainsharder,stormrage,576,deathknight,unholy,12,6,6
Sweatynation,tichondrius,576,deathknight,unholy,12,6,6
Doomdk,azralon,576,deathknight,unholy,15,7,8
Cirillan,bleeding-hollow,576,deathknight,unholy,18,6,12
Icycrazy,azralon,576,deathknight,unholy,18,6,12
Joystickwrld,silvermoon,576,deathknight,unholy,18,6,12
Nethaar,tichondrius,576,deathknight,unholy,18,6,12
Boltman,malganis,576,deathknight,unholy,18,6,12
Blackùla,tichondrius,576,deathknight,unholy,18,6,12
Bøngripx,tichondrius,576,deathknight,unholy,18,6,12
Laeroth,zuluhed,576,deathknight,unholy,18,6,12
Lainmortal,ragnaros,576,deathknight,unholy,18,6,12
Baldlord,tichondrius,576,deathknight,unholy,24,6,18
Conquest,drenden,576,deathknight,unholy,24,6,18
Monesy,tichondrius,576,deathknight,unholy,24,6,18
Granknight,azralon,576,deathknight,unholy,24,6,18
Abombinator,stormrage,575,deathknight,unholy,6,6,0
Peteargryphn,illidan,575,deathknight,unholy,12,6,6
Åkatsukii,uther,575,deathknight,unholy,12,6,6
Christophe,skullcrusher,575,deathknight,unholy,12,6,6
Isaiahstolt,area-52,575,deathknight,unholy,12,6,6
Agamoth,ragnaros,575,deathknight,unholy,12,6,6
Sephirott,boulderfist,575,deathknight,unholy,12,6,6
Iceclaw,bleeding-hollow,575,deathknight,unholy,12,6,6
Galthro,tichondrius,575,deathknight,unholy,12,6,6
Römulus,area-52,575,deathknight,unholy,18,6,12
Corpsepetal,muradin,575,deathknight,unholy,18,6,12
Vicentão,tichondrius,574,deathknight,unholy,12,6,6
Robacalzónes,ragnaros,574,deathknight,unholy,12,6,6
Hordbadia,garrosh,574,deathknight,unholy,12,6,6
Fraänrisco,ragnaros,574,deathknight,unholy,18,6,12
Vapelounge,darkspear,574,deathknight,unholy,18,6,12
Coldmilk,wyrmrest-accord,574,deathknight,unholy,24,6,18
Baracka,sargeras,573,deathknight,unholy,30,6,24
Juggérnaút,bonechewer,572,deathknight,unholy,12,6,6
Tormentsoul,ragnaros,572,deathknight,unholy,12,6,6
Lowan,stormrage,566,deathknight,unholy,12,6,6
Waterboy,malganis,566,deathknight,unholy,12,6,6
Syzurp,barthilas,558,deathknight,unholy,13,7,6
Janoh,the-scryers,553,deathknight,unholy,23,6,17
Caohiyan,tichondrius,542,deathknight,unholy,11,6,5
Herstôry,kelthuzad,527,deathknight,unholy,11,6,5
Cheliä,quelthalas,527,deathknight,unholy,15,6,9
Gkdm,tichondrius,522,deathknight,unholy,21,8,13
Chës,tichondrius,522,deathknight,unholy,22,7,15
Abømination,zuljin,510,deathknight,unholy,20,6,14
Bawlsauce,area-52,496,deathknight,unholy,13,6,7
Beedamoniv,tichondrius,495,deathknight,unholy,17,7,10
Tummystix,arthas,494,deathknight,unholy,16,6,10
Depthknight,barthilas,480,deathknight,unholy,6,5,1
Superzach,muradin,480,deathknight,unholy,6,5,1
Alophedes,frostmourne,480,deathknight,unholy,6,5,1
Solø,proudmoore,480,deathknight,unholy,6,5,1
Lastboyscout,silvermoon,480,deathknight,unholy,6,5,1
Wâggies,moon-guard,480,deathknight,unholy,6,5,1
Devilwarship,daggerspine,480,deathknight,unholy,6,5,1
Andariel,ragnaros,480,deathknight,unholy,6,5,1
Rahdigga,bloodscalp,480,deathknight,unholy,6,5,1
Deadntaxes,thunderlord,480,deathknight,unholy,12,5,7
Darkwraith,illidan,480,deathknight,unholy,12,5,7
Pathæs,bleeding-hollow,480,deathknight,unholy,12,5,7
Rayzuul,queldorei,480,deathknight,unholy,12,5,7
Coachclaudio,tichondrius,480,deathknight,unholy,12,5,7
Bot,icecrown,480,deathknight,unholy,12,5,7
Gneanderthal,bloodscalp,480,deathknight,unholy,12,5,7
Serathai,tichondrius,480,deathknight,unholy,12,5,7
Andem,elune,480,deathknight,unholy,12,5,7
Lilpootie,tichondrius,480,deathknight,unholy,12,5,7
Clovermoon,tichondrius,480,deathknight,unholy,12,5,7
Süzuki,tichondrius,480,deathknight,unholy,12,5,7
Zacharya,nemesis,480,deathknight,unholy,12,5,7
Cosmicrune,turalyon,480,deathknight,unholy,12,5,7
Jayzhou,proudmoore,480,deathknight,unholy,12,5,7
Skotch,lightninghoof,480,deathknight,unholy,12,5,7
Initiative,moon-guard,480,deathknight,unholy,12,5,7
Lîch,azralon,480,deathknight,unholy,12,5,7
Birnolan,proudmoore,480,deathknight,unholy,12,5,7
Ghrat,bleeding-hollow,480,deathknight,unholy,12,5,7
Feki,frostmourne,480,deathknight,unholy,12,5,7
Wapman,bloodhoof,480,deathknight,unholy,12,5,7
Scursy,tichondrius,480,deathknight,unholy,12,5,7
Deathpair,bleeding-hollow,480,deathknight,unholy,12,5,7
Aoshië,area-52,480,deathknight,unholy,12,5,7
Defekaite,kiljaeden,480,deathknight,unholy,12,5,7
Gusabio,drakkari,480,deathknight,unholy,12,5,7
Cammykickbot,frostmourne,480,deathknight,unholy,12,5,7
Drakkala,silvermoon,480,deathknight,unholy,12,5,7
Nordiin,stormrage,480,deathknight,unholy,12,5,7
Römney,stormrage,480,deathknight,unholy,12,5,7
Swänsz,stormrage,480,deathknight,unholy,12,5,7
Defaultz,turalyon,480,deathknight,unholy,12,5,7
Schreit,zuljin,480,deathknight,unholy,12,5,7
Darkfög,sargeras,480,deathknight,unholy,12,5,7
Qberks,elune,480,deathknight,unholy,12,5,7
Zaratose,area-52,480,deathknight,unholy,12,5,7
Infestation,muradin,480,deathknight,unholy,12,5,7
Sindragosa,dragonmaw,480,deathknight,unholy,12,5,7
Xariuz,quelthalas,480,deathknight,unholy,12,5,7
Vläad,ragnaros,480,deathknight,unholy,12,5,7
Laboön,stormrage,480,deathknight,unholy,12,5,7
Hemorrhoids,blackrock,480,deathknight,unholy,12,5,7
Gatitos,ragnaros,480,deathknight,unholy,12,5,7
Yeahgood,frostmourne,480,deathknight,unholy,12,5,7
Kárd,tichondrius,480,deathknight,unholy,18,5,13
Chainsadeath,stormrage,480,deathknight,unholy,18,5,13
Dkinaboxx,hyjal,480,deathknight,unholy,18,5,13
Nurglet,proudmoore,480,deathknight,unholy,18,5,13
Maskofwintrs,zuljin,480,deathknight,unholy,18,5,13
Sylèss,tichondrius,480,deathknight,unholy,18,5,13
Sevendeadly,frostmourne,480,deathknight,unholy,18,5,13
Deathgimbo,hellscream,480,deathknight,unholy,18,5,13
Gazco,frostmourne,480,deathknight,unholy,18,5,13
Dementrius,zuljin,480,deathknight,unholy,25,5,20
Extremepvp,aegwynn,479,deathknight,unholy,6,5,1
Valkzy,malganis,479,deathknight,unholy,6,5,1
Wolfsdeath,shattered-hand,479,deathknight,unholy,6,5,1
Ahwooh,kelthuzad,479,deathknight,unholy,6,5,1
Mefistô,quelthalas,479,deathknight,unholy,10,6,4
Itired,tichondrius,479,deathknight,unholy,12,5,7
Xadrisill,winterhoof,479,deathknight,unholy,12,5,7
Kramy,barthilas,479,deathknight,unholy,12,5,7
Vorlakesh,boulderfist,479,deathknight,unholy,12,5,7
Lubmuscle,illidan,479,deathknight,unholy,12,5,7
Jessefur,undermine,479,deathknight,unholy,12,5,7
Dijkstrap,tichondrius,479,deathknight,unholy,12,5,7
Deathfearsme,kiljaeden,479,deathknight,unholy,12,5,7
Amaethyst,kelthuzad,479,deathknight,unholy,12,5,7
Borgin,emerald-dream,479,deathknight,unholy,12,5,7
Joelfromuber,stormrage,479,deathknight,unholy,12,5,7
Nekrofeelyak,kelthuzad,479,deathknight,unholy,12,5,7
Caqw,akama,479,deathknight,unholy,14,5,9
Futurism,shadowmoon,478,deathknight,unholy,6,5,1
Jonnii,area-52,477,deathknight,unholy,12,5,7
Drdeathz,sargeras,476,deathknight,unholy,12,5,7
Headbustr,sargeras,473,deathknight,unholy,12,5,7
Ghoulorama,illidan,471,deathknight,unholy,18,5,13
Fishtouching,illidan,463,deathknight,unholy,17,5,12
Megatrôn,malganis,463,deathknight,unholy,17,5,12
Prettyliched,area-52,447,deathknight,unholy,11,5,6
Lenos,tichondrius,447,deathknight,unholy,11,5,6
Faelmo,malganis,447,deathknight,unholy,11,5,6
Iloveenzley,tichondrius,447,deathknight,unholy,11,5,6
Fearfull,hyjal,447,deathknight,unholy,16,5,11
Sorry,ysera,432,deathknight,unholy,9,6,3
Zytira,wyrmrest-accord,431,deathknight,unholy,11,5,6
Furiel,mugthol,430,deathknight,unholy,9,6,3
Spôôn,aggramar,430,deathknight,unholy,11,5,6
Dtrayn,tichondrius,416,deathknight,unholy,10,5,5
Higeki,area-52,415,deathknight,unholy,8,5,3
Testifier,illidan,415,deathknight,unholy,8,5,3
Shiminy,chogall,415,deathknight,unholy,10,5,5
Frostology,echo-isles,399,deathknight,unholy,5,5,0
Chooksknight,tichondrius,384,deathknight,unholy,6,4,2
Zèro,moonrunner,384,deathknight,unholy,6,4,2
Zeathial,moon-guard,384,deathknight,unholy,6,4,2
Hlw,tichondrius,384,deathknight,unholy,6,4,2
Peacebringer,frostmourne,384,deathknight,unholy,6,4,2
Beerknight,frostmourne,384,deathknight,unholy,6,4,2
Whaleofwales,ysondre,384,deathknight,unholy,6,4,2
Vampygeizt,zuljin,384,deathknight,unholy,6,4,2
Frøstfinger,azralon,384,deathknight,unholy,6,4,2
Keator,tichondrius,384,deathknight,unholy,6,4,2
Lxsol,illidan,384,deathknight,unholy,6,4,2
Darkmancers,tichondrius,384,deathknight,unholy,6,4,2
Hiki,ragnaros,384,deathknight,unholy,6,4,2
Tibocourtois,tichondrius,384,deathknight,unholy,6,4,2
Koreandk,tichondrius,384,deathknight,unholy,6,4,2
Chillbruh,garrosh,384,deathknight,unholy,6,4,2
Futruth,khaz-modan,384,deathknight,unholy,6,4,2
Ragnarøs,stormrage,384,deathknight,unholy,6,4,2
Easyunholy,tichondrius,384,deathknight,unholy,6,4,2
Darkswar,barthilas,384,deathknight,unholy,6,4,2
Nbahooper,area-52,384,deathknight,unholy,6,4,2
Janaru,bloodscalp,384,deathknight,unholy,6,4,2
Murphu,stormrage,384,deathknight,unholy,6,4,2
Mistmoorex,stormscale,384,deathknight,unholy,6,4,2
Ðrift,azralon,384,deathknight,unholy,6,4,2
Pleasecakes,blood-furnace,384,deathknight,unholy,9,5,4
Kobrex,kelthuzad,384,deathknight,unholy,12,4,8
Assidik,dathremar,384,deathknight,unholy,12,4,8
Hounura,dathremar,384,deathknight,unholy,12,4,8
Noiksnow,azralon,384,deathknight,unholy,12,4,8
Azryull,perenolde,384,deathknight,unholy,12,4,8
Shehanshah,area-52,384,deathknight,unholy,12,4,8
Çorn,sargeras,384,deathknight,unholy,12,4,8
Deathhimself,moonrunner,384,deathknight,unholy,12,4,8
Lìlith,dreadmaul,384,deathknight,unholy,12,4,8
Bjorstad,moon-guard,384,deathknight,unholy,12,4,8
Ändead,tichondrius,384,deathknight,unholy,12,4,8
Plaguetongue,magtheridon,384,deathknight,unholy,12,4,8
Øzzy,tichondrius,384,deathknight,unholy,12,4,8
Yeetmaster,area-52,384,deathknight,unholy,12,4,8
Saberest,tichondrius,384,deathknight,unholy,12,4,8
Wúhan,moon-guard,384,deathknight,unholy,12,4,8
Froztknight,anubarak,384,deathknight,unholy,12,4,8
Raakaa,ghostlands,384,deathknight,unholy,12,4,8
Mardrank,stormrage,384,deathknight,unholy,12,4,8
Pharoahx,gurubashi,384,deathknight,unholy,12,4,8
Cald,bonechewer,384,deathknight,unholy,12,4,8
Grýmm,bonechewer,384,deathknight,unholy,12,4,8
Kìrìtó,malygos,384,deathknight,unholy,12,4,8
Ambagrips,frostmourne,384,deathknight,unholy,12,4,8
Wankekong,zuljin,384,deathknight,unholy,12,4,8
Tirdinn,madoran,384,deathknight,unholy,12,4,8
Threehunned,frostmourne,384,deathknight,unholy,12,4,8
Mournehowl,stormrage,384,deathknight,unholy,12,4,8
Annuvyz,darkspear,384,deathknight,unholy,12,4,8
Capergrip,tichondrius,384,deathknight,unholy,12,4,8
Dalka,laughing-skull,384,deathknight,unholy,12,4,8
Gröxxigor,azralon,384,deathknight,unholy,12,4,8
Cäin,dreadmaul,384,deathknight,unholy,12,4,8
Hikikomori,hydraxis,384,deathknight,unholy,12,4,8
Tyrien,frostmane,384,deathknight,unholy,12,4,8
Danteloki,proudmoore,384,deathknight,unholy,12,4,8
Reizü,ragnaros,384,deathknight,unholy,12,4,8
Cokedrip,bleeding-hollow,384,deathknight,unholy,12,4,8
Coronä,malfurion,384,deathknight,unholy,12,4,8
Bealzabub,sargeras,384,deathknight,unholy,12,4,8
Daellius,ragnaros,384,deathknight,unholy,12,4,8
Sandooñ,tichondrius,384,deathknight,unholy,12,4,8
Testamentxx,thunderlord,384,deathknight,unholy,12,4,8
Dkekk,illidan,384,deathknight,unholy,12,4,8
Keralius,stormrage,384,deathknight,unholy,18,4,14
Drzièglér,tichondrius,384,deathknight,unholy,18,4,14
Lho,caelestrasz,384,deathknight,unholy,18,4,14
Golgothic,sargeras,384,deathknight,unholy,18,4,14
Avengis,bleeding-hollow,384,deathknight,unholy,18,4,14
Bultek,sargeras,384,deathknight,unholy,18,4,14
Turbotoxic,illidan,383,deathknight,unholy,6,4,2
Flazzul,kiljaeden,383,deathknight,unholy,6,4,2
Deathbring,turalyon,383,deathknight,unholy,6,4,2
Hitsüyi,quelthalas,383,deathknight,unholy,11,6,5
Plaguedoctor,moon-guard,383,deathknight,unholy,12,4,8
Demher,ragnaros,383,deathknight,unholy,12,4,8
Optics,bleeding-hollow,383,deathknight,unholy,12,4,8
Superjessdk,area-52,383,deathknight,unholy,12,4,8
Maligolde,nemesis,383,deathknight,unholy,12,4,8
Ziona,archimonde,383,deathknight,unholy,18,4,14
Urineman,tichondrius,382,deathknight,unholy,6,4,2
Jinxtar,wyrmrest-accord,382,deathknight,unholy,6,4,2
Hobyrt,bleeding-hollow,382,deathknight,unholy,6,4,2
Eyedeas,emerald-dream,382,deathknight,unholy,12,4,8
Brantodne,galakrond,379,deathknight,unholy,12,4,8
Atakan,burning-blade,367,deathknight,unholy,11,4,7
Whosdead,area-52,351,deathknight,unholy,11,4,7
Azupo,aerie-peak,351,deathknight,unholy,14,5,9
Zuum,kelthuzad,351,deathknight,unholy,17,4,13
Stëroids,shuhalo,336,deathknight,unholy,9,5,4
Zygon,thrall,336,deathknight,unholy,9,4,5
Icecreamlife,chogall,330,deathknight,unholy,15,5,10
Ekaj,azuremyst,319,deathknight,unholy,5,4,1
Rodeon,azgalor,291,deathknight,unholy,13,5,8
Vexmaw,twisting-nether,288,deathknight,unholy,6,3,3
Lafourche,sargeras,288,deathknight,unholy,6,3,3
Mawvac,quelthalas,288,deathknight,unholy,6,3,3
Forgos,ragnaros,288,deathknight,unholy,6,3,3
Graciemacie,area-52,288,deathknight,unholy,6,3,3
Malairia,area-52,288,deathknight,unholy,6,3,3
Outbrèak,sargeras,288,deathknight,unholy,6,3,3
Matea,ragnaros,288,deathknight,unholy,6,3,3
Northwing,sargeras,288,deathknight,unholy,6,3,3
Jorich,ragnaros,288,deathknight,unholy,6,3,3
Martinnash,emerald-dream,288,deathknight,unholy,6,3,3
Llok,area-52,288,deathknight,unholy,6,3,3
Céle,area-52,288,deathknight,unholy,6,3,3
Rennoc,emerald-dream,288,deathknight,unholy,6,3,3
Jerkin,area-52,288,deathknight,unholy,6,3,3
Reapar,amanthul,288,deathknight,unholy,6,3,3
Mindflayers,area-52,288,deathknight,unholy,6,3,3
Vcadk,ragnaros,288,deathknight,unholy,6,3,3
Legendåryx,sargeras,288,deathknight,unholy,6,3,3
Greizul,area-52,288,deathknight,unholy,6,3,3
Blitzcreig,sargeras,288,deathknight,unholy,6,3,3
Almatafh,azralon,288,deathknight,unholy,6,3,3
Ariacy,sargeras,288,deathknight,unholy,6,3,3
Xathrrid,stormrage,288,deathknight,unholy,6,3,3
Syringe,bloodhoof,288,deathknight,unholy,6,3,3
Sherank,akama,288,deathknight,unholy,6,3,3
Dizzyswiftz,tichondrius,288,deathknight,unholy,6,3,3
Mýrrh,wyrmrest-accord,288,deathknight,unholy,6,3,3
Petkick,tichondrius,288,deathknight,unholy,6,3,3
Katnajs,zuljin,288,deathknight,unholy,6,3,3
Krumpous,tichondrius,288,deathknight,unholy,6,3,3
Vinaroth,kiljaeden,288,deathknight,unholy,6,3,3
Adavynn,darkspear,288,deathknight,unholy,6,3,3
Disritmia,stormrage,288,deathknight,unholy,6,3,3
Hellrusher,magtheridon,288,deathknight,unholy,6,3,3
Mikeoxmaul,frostmourne,288,deathknight,unholy,6,3,3
Viscerus,stormrage,288,deathknight,unholy,6,3,3
Pizy,frostmourne,288,deathknight,unholy,6,3,3
Frostdest,kiljaeden,288,deathknight,unholy,6,3,3
Barricus,stonemaul,288,deathknight,unholy,6,3,3
Wakkaflaca,bleeding-hollow,288,deathknight,unholy,6,3,3
Smokeyjoe,aegwynn,288,deathknight,unholy,6,3,3
Drippedout,illidan,288,deathknight,unholy,6,3,3
Leinandk,illidan,288,deathknight,unholy,6,3,3
Kossero,thunderlord,288,deathknight,unholy,6,3,3
Anderius,tichondrius,288,deathknight,unholy,6,3,3
Pepecoomer,frostmourne,288,deathknight,unholy,6,3,3
Zarataylor,frostmourne,288,deathknight,unholy,6,3,3
Alivaron,lothar,288,deathknight,unholy,6,3,3
Ödens,dalaran,288,deathknight,unholy,6,3,3
Ego,blackrock,288,deathknight,unholy,6,3,3
Trant,tichondrius,288,deathknight,unholy,6,3,3
Necrotictko,tichondrius,288,deathknight,unholy,6,3,3
Shookdnation,suramar,288,deathknight,unholy,6,3,3
Nalec,tichondrius,288,deathknight,unholy,6,3,3
Mendoh,tichondrius,288,deathknight,unholy,6,3,3
Frenzza,frostmourne,288,deathknight,unholy,6,3,3
Redrox,tichondrius,288,deathknight,unholy,6,3,3
Chrønnøz,nemesis,288,deathknight,unholy,6,3,3
Marash,moon-guard,288,deathknight,unholy,6,3,3
Icefrost,ghostlands,288,deathknight,unholy,6,3,3
Válak,stormrage,288,deathknight,unholy,6,3,3
Nifftybear,tichondrius,288,deathknight,unholy,6,3,3
Larímar,tichondrius,288,deathknight,unholy,6,3,3
Plaguewar,thrall,288,deathknight,unholy,6,3,3
Micteca,moonrunner,288,deathknight,unholy,7,3,4
Oroborus,korgath,288,deathknight,unholy,8,3,5
Boneherr,sargeras,288,deathknight,unholy,16,4,12
Bloodemperor,malfurion,288,deathknight,unholy,12,3,9
Rottenqunt,tichondrius,288,deathknight,unholy,12,3,9
Gersinhu,azralon,288,deathknight,unholy,12,3,9
Chosenhero,stormrage,288,deathknight,unholy,12,3,9
Fokit,barthilas,288,deathknight,unholy,12,3,9
Inigomontana,moon-guard,288,deathknight,unholy,12,3,9
Zerky,stormrage,288,deathknight,unholy,12,3,9
Supermane,jubeithos,288,deathknight,unholy,12,3,9
Danlorinis,moon-guard,288,deathknight,unholy,12,3,9
Malthis,antonidas,288,deathknight,unholy,12,3,9
Techneeq,tichondrius,288,deathknight,unholy,12,3,9
Shmeckla,tichondrius,288,deathknight,unholy,12,3,9
Garonse,wyrmrest-accord,288,deathknight,unholy,12,3,9
Chosenrune,stormrage,288,deathknight,unholy,12,3,9
Gigabone,tichondrius,288,deathknight,unholy,12,3,9
Morbo,proudmoore,288,deathknight,unholy,12,3,9
Socalaj,malorne,288,deathknight,unholy,12,3,9
Kaspbrak,destromath,288,deathknight,unholy,12,3,9
Lolgriped,tichondrius,288,deathknight,unholy,12,3,9
Emotionaldam,area-52,288,deathknight,unholy,12,3,9
Hynzst,barthilas,288,deathknight,unholy,12,3,9
Lsdee,maiev,288,deathknight,unholy,12,3,9
Monöri,ragnaros,288,deathknight,unholy,12,3,9
Belfknightt,area-52,288,deathknight,unholy,12,3,9
Mongomongo,malganis,288,deathknight,unholy,12,3,9
Torsophuk,stormrage,288,deathknight,unholy,12,3,9
Shmoe,auchindoun,288,deathknight,unholy,12,3,9
Coffeemilk,kiljaeden,288,deathknight,unholy,13,3,10
Angerforge,illidan,288,deathknight,unholy,18,3,15
Deathsent,malganis,288,deathknight,unholy,18,3,15
Malovv,nemesis,287,deathknight,unholy,6,3,3
Livor,ragnaros,287,deathknight,unholy,6,3,3
Deadmedic,quelthalas,287,deathknight,unholy,6,3,3
Chanskey,stormrage,287,deathknight,unholy,9,3,6
Zedknight,emerald-dream,287,deathknight,unholy,15,4,11
Kreachuer,lightbringer,287,deathknight,unholy,12,3,9
Morthul,tol-barad,287,deathknight,unholy,12,3,9
Trukutruu,drakkari,286,deathknight,unholy,6,3,3
Soulgrinder,earthen-ring,286,deathknight,unholy,6,3,3
Orthason,moon-guard,286,deathknight,unholy,6,3,3
Tyrondious,tichondrius,271,deathknight,unholy,11,3,8
Copy,suramar,271,deathknight,unholy,11,3,8
Milkdrugs,daggerspine,256,deathknight,unholy,10,3,7
Guffles,tichondrius,256,deathknight,unholy,16,3,13
Baskel,frostmane,255,deathknight,unholy,11,3,8
Deathrowe,blackhand,240,deathknight,unholy,9,3,6
Cryodemic,illidan,240,deathknight,unholy,9,3,6
Dairboi,sargeras,239,deathknight,unholy,5,3,2
Leoprime,area-52,239,deathknight,unholy,5,3,2
Originalsin,tichondrius,239,deathknight,unholy,11,3,8
Rompeimën,ragnaros,234,deathknight,unholy,11,6,5
Elrog,nemesis,234,deathknight,unholy,13,4,9
Tinylich,arthas,234,deathknight,unholy,16,4,12
Ðëthbringër,jubeithos,223,deathknight,unholy,14,3,11
Crypton,tichondrius,208,deathknight,unholy,13,3,10
Gankhiss,emerald-dream,201,deathknight,unholy,11,4,7
Charabone,ragnaros,192,deathknight,unholy,4,3,1
Chunkdk,stormrage,192,deathknight,unholy,4,3,1
Mesx,tichondrius,192,deathknight,unholy,6,2,4
Supfam,tichondrius,192,deathknight,unholy,6,2,4
Uncoachablex,illidan,192,deathknight,unholy,6,2,4
Mkownz,tichondrius,192,deathknight,unholy,6,2,4
Dkgrrick,bleeding-hollow,192,deathknight,unholy,6,2,4
Twocolors,gilneas,192,deathknight,unholy,6,2,4
Tanskeey,sargeras,192,deathknight,unholy,6,2,4
Spaxz,illidan,192,deathknight,unholy,6,2,4
Questíonable,arthas,192,deathknight,unholy,6,2,4
Válhállá,ragnaros,192,deathknight,unholy,6,2,4
Orbo,elune,192,deathknight,unholy,6,2,4
Eastcoast,azuremyst,192,deathknight,unholy,6,2,4
Kmardk,area-52,192,deathknight,unholy,6,2,4
Tbop,ragnaros,192,deathknight,unholy,6,2,4
Kangsewooks,tichondrius,192,deathknight,unholy,6,2,4
Gooré,ragnaros,192,deathknight,unholy,6,2,4
Afkftwok,illidan,192,deathknight,unholy,6,2,4
Kookx,tichondrius,192,deathknight,unholy,6,2,4
Sieg,goldrinn,192,deathknight,unholy,6,2,4
Disturbedtwo,azralon,192,deathknight,unholy,6,2,4
Orcazmic,area-52,192,deathknight,unholy,6,2,4
Ahmisu,tichondrius,192,deathknight,unholy,6,2,4
Bealzabubb,sargeras,192,deathknight,unholy,6,2,4
Onsslaught,sargeras,192,deathknight,unholy,6,2,4
Izanagidk,nemesis,192,deathknight,unholy,6,2,4
Pandauh,proudmoore,192,deathknight,unholy,6,2,4
Rakelan,area-52,192,deathknight,unholy,6,2,4
Dustknight,sargeras,192,deathknight,unholy,6,2,4
Cailras,argent-dawn,192,deathknight,unholy,6,2,4
Nightdaddyy,laughing-skull,192,deathknight,unholy,6,2,4
Weedseagull,dragonmaw,192,deathknight,unholy,6,2,4
Havasu,proudmoore,192,deathknight,unholy,6,2,4
Mistake,ragnaros,192,deathknight,unholy,6,2,4
Chandsformer,tichondrius,192,deathknight,unholy,6,2,4
Boogers,cenarion-circle,192,deathknight,unholy,6,2,4
Balstan,tichondrius,192,deathknight,unholy,6,2,4
Geth,sargeras,192,deathknight,unholy,6,2,4
Hastë,proudmoore,192,deathknight,unholy,6,2,4
Dhaarok,malganis,192,deathknight,unholy,6,2,4
Fizzease,illidan,192,deathknight,unholy,6,2,4
Mako,garithos,192,deathknight,unholy,6,2,4
Otr,wyrmrest-accord,192,deathknight,unholy,6,2,4
Corscadden,zuljin,192,deathknight,unholy,6,2,4
Kniightdkk,kelthuzad,192,deathknight,unholy,6,2,4
Semisoftbody,malganis,192,deathknight,unholy,6,2,4
Hurstules,barthilas,192,deathknight,unholy,6,2,4
Menalise,moon-guard,192,deathknight,unholy,6,2,4
Fatmamma,ragnaros,192,deathknight,unholy,6,2,4
Zilli,blackrock,192,deathknight,unholy,6,2,4
Vlladimir,kelthuzad,192,deathknight,unholy,6,2,4
Murumuru,bleeding-hollow,192,deathknight,unholy,6,2,4
Dkdkdkdkdk,chromaggus,192,deathknight,unholy,6,2,4
Blooddisease,frostmourne,192,deathknight,unholy,6,2,4
Lunatick,darkspear,192,deathknight,unholy,6,2,4
Slapbag,kelthuzad,192,deathknight,unholy,6,2,4
Junepí,stormrage,192,deathknight,unholy,6,2,4
Deathscythè,barthilas,192,deathknight,unholy,6,2,4
Teedk,drakthul,192,deathknight,unholy,6,2,4
Kranaz,barthilas,192,deathknight,unholy,6,2,4
Jelcox,quelthalas,192,deathknight,unholy,6,2,4
Dkb,drakthul,192,deathknight,unholy,6,2,4
Saraphdk,area-52,192,deathknight,unholy,6,2,4
Mythandour,shandris,192,deathknight,unholy,6,2,4
Wheybolic,quelthalas,192,deathknight,unholy,6,2,4
Moonkhink,stormrage,192,deathknight,unholy,6,2,4
Tristam,area-52,192,deathknight,unholy,6,2,4
Grimreminder,zuljin,192,deathknight,unholy,6,2,4
Benweth,dalaran,192,deathknight,unholy,6,2,4
Astaxstaria,bladefist,192,deathknight,unholy,6,2,4
Bogoraptor,emerald-dream,192,deathknight,unholy,6,2,4
Tèrok,stormrage,192,deathknight,unholy,6,2,4
Daddyspankme,frostmane,192,deathknight,unholy,6,2,4
Ðreak,azralon,192,deathknight,unholy,12,2,10
Giraldus,stormrage,192,deathknight,unholy,12,2,10
Rykard,hyjal,192,deathknight,unholy,12,2,10
Dixqt,deathwing,192,deathknight,unholy,12,2,10
Geliòn,quelthalas,192,deathknight,unholy,12,2,10
Corzmaen,illidan,192,deathknight,unholy,12,2,10
Ðìvíne,illidan,192,deathknight,unholy,12,2,10
Nubsz,zuljin,192,deathknight,unholy,12,2,10
Cow,sargeras,192,deathknight,unholy,12,2,10
Víní,azralon,192,deathknight,unholy,12,2,10
Zerodk,kelthuzad,192,deathknight,unholy,12,2,10
Maliceborn,stormrage,192,deathknight,unholy,12,2,10
Taelse,medivh,192,deathknight,unholy,12,2,10
Nightrose,skullcrusher,192,deathknight,unholy,12,2,10
Tacofoxlol,tichondrius,192,deathknight,unholy,12,2,10
Kzen,skullcrusher,192,deathknight,unholy,12,2,10
Chachea,kiljaeden,192,deathknight,unholy,12,2,10
Mystery,wyrmrest-accord,192,deathknight,unholy,12,2,10
Stteve,proudmoore,192,deathknight,unholy,12,2,10
Ovulating,malganis,192,deathknight,unholy,12,2,10
Katiaany,quelthalas,192,deathknight,unholy,18,2,16
Calabrass,mannoroth,192,deathknight,unholy,18,2,16
Dxn,nemesis,192,deathknight,unholy,18,2,16
Mormonpest,illidan,191,deathknight,unholy,6,2,4
Larrisey,illidan,191,deathknight,unholy,6,2,4
Kaýlea,azralon,191,deathknight,unholy,6,2,4
Malkiss,kirin-tor,191,deathknight,unholy,6,2,4
Bulfstone,quelthalas,159,deathknight,unholy,5,2,3
Glacíuss,ragnaros,138,deathknight,unholy,9,4,5
Undêrtaker,sargeras,138,deathknight,unholy,9,3,6
Patchi,area-52,138,deathknight,unholy,14,4,10
Caotix,bleeding-hollow,96,deathknight,unholy,3,2,1
Hunwild,emerald-dream,96,deathknight,unholy,6,1,5
Requísition,barthilas,96,deathknight,unholy,6,1,5
Dontbanmepls,zuljin,96,deathknight,unholy,6,1,5
Amö,emerald-dream,96,deathknight,unholy,6,1,5
Tìtø,ragnaros,96,deathknight,unholy,6,1,5
Dakiroenus,thrall,96,deathknight,unholy,6,1,5
Report,dathremar,96,deathknight,unholy,6,1,5
Snipestrike,area-52,96,deathknight,unholy,6,1,5
Vicesquad,tichondrius,96,deathknight,unholy,6,1,5
Veslemes,tichondrius,96,deathknight,unholy,6,1,5
Tarone,zuljin,96,deathknight,unholy,6,1,5
Rotfang,elune,96,deathknight,unholy,6,1,5
Lichhbanne,doomhammer,96,deathknight,unholy,6,1,5
Lazynome,azshara,96,deathknight,unholy,6,1,5
Dknightor,dalaran,96,deathknight,unholy,6,1,5
Râzôr,korgath,96,deathknight,unholy,6,1,5
Sandolorian,area-52,96,deathknight,unholy,6,1,5
Alayssia,darkspear,96,deathknight,unholy,6,1,5
Dethklòk,area-52,96,deathknight,unholy,6,1,5
Istery,thrall,96,deathknight,unholy,6,1,5
Karmakulaz,wildhammer,96,deathknight,unholy,6,1,5
Dekadart,quelthalas,96,deathknight,unholy,6,1,5
Dheyqu,quelthalas,96,deathknight,unholy,6,1,5
Otarin,tichondrius,96,deathknight,unholy,6,1,5
Axiom,nemesis,96,deathknight,unholy,6,1,5
Distrolldk,zuljin,96,deathknight,unholy,6,1,5
Hushima,lightbringer,96,deathknight,unholy,6,1,5
Papileche,tichondrius,96,deathknight,unholy,6,1,5
Iluvbooty,blackrock,96,deathknight,unholy,6,1,5
Rgn,deathwing,96,deathknight,unholy,6,1,5
Elvacci,dreadmaul,96,deathknight,unholy,6,1,5
Apeirøn,quelthalas,96,deathknight,unholy,6,1,5
Terrethess,illidan,96,deathknight,unholy,6,1,5
Percy,thaurissan,96,deathknight,unholy,6,1,5
Bulltille,azralon,96,deathknight,unholy,6,1,5
Raicoron,zuljin,96,deathknight,unholy,6,1,5
Heavic,skywall,96,deathknight,unholy,6,1,5
Zenin,emerald-dream,96,deathknight,unholy,6,1,5
ßlazedkush,kelthuzad,96,deathknight,unholy,6,1,5
Testitickler,gurubashi,96,deathknight,unholy,6,1,5
Neofrank,drakkari,96,deathknight,unholy,6,1,5
Andivh,hydraxis,96,deathknight,unholy,6,1,5
Barrodir,tichondrius,96,deathknight,unholy,6,1,5
Diviniums,bleeding-hollow,96,deathknight,unholy,6,1,5
Jokenpi,illidan,96,deathknight,unholy,6,1,5
Warraxe,draka,96,deathknight,unholy,6,1,5
Killa,maiev,96,deathknight,unholy,6,1,5
Bealzabbub,sargeras,96,deathknight,unholy,6,1,5
Zalåel,area-52,96,deathknight,unholy,6,1,5
Abake,illidan,96,deathknight,unholy,6,1,5
Drip,whisperwind,96,deathknight,unholy,6,1,5
Clave,bleeding-hollow,96,deathknight,unholy,6,1,5
Vicedro,arthas,96,deathknight,unholy,6,1,5
Fantabanana,azralon,96,deathknight,unholy,6,1,5
Sharnathos,stormrage,96,deathknight,unholy,6,1,5
ßornkilla,tichondrius,96,deathknight,unholy,6,1,5
Ishamaael,tichondrius,96,deathknight,unholy,6,1,5
Alexanderz,quelthalas,96,deathknight,unholy,6,1,5
Stormsick,ragnaros,96,deathknight,unholy,6,1,5
Ziedrich,sargeras,96,deathknight,unholy,6,1,5
Grimorra,bleeding-hollow,96,deathknight,unholy,6,1,5
Argy,zuljin,96,deathknight,unholy,6,1,5
Sever,demon-soul,96,deathknight,unholy,6,1,5
Plaguedoctor,thrall,96,deathknight,unholy,6,1,5
Nachohands,laughing-skull,96,deathknight,unholy,6,1,5
Mtridew,moon-guard,96,deathknight,unholy,6,1,5
Jennitha,zuljin,96,deathknight,unholy,6,1,5
Apocalypsis,uldum,96,deathknight,unholy,6,1,5
Goldpowerz,kelthuzad,96,deathknight,unholy,6,1,5
Krw,stormrage,96,deathknight,unholy,6,1,5
Bein,frostmourne,96,deathknight,unholy,6,1,5
Gnargnarr,firetree,96,deathknight,unholy,6,1,5
Moldremover,frostmourne,96,deathknight,unholy,6,1,5
Perculës,sargeras,96,deathknight,unholy,7,1,6
Aqs,sargeras,96,deathknight,unholy,9,1,8
Blowout,barthilas,96,deathknight,unholy,12,1,11
Bloodgorged,frostmane,96,deathknight,unholy,12,1,11
Dípero,azralon,96,deathknight,unholy,12,1,11
Klàssy,stormrage,96,deathknight,unholy,12,1,11
Vinsval,tichondrius,96,deathknight,unholy,12,1,11
Skadattle,emerald-dream,96,deathknight,unholy,12,1,11
Wkxx,tichondrius,96,deathknight,unholy,12,1,11
Xeroxoxo,khadgar,96,deathknight,unholy,12,1,11
Yorishomi,sargeras,96,deathknight,unholy,12,1,11
Darnkiller,kelthuzad,96,deathknight,unholy,18,1,17
Funerall,azralon,95,deathknight,unholy,12,1,11
Explorer,kelthuzad,64,deathknight,unholy,4,1,3
Asfaq,frostmourne,63,deathknight,unholy,2,2,0
Deanz,stormrage,63,deathknight,unholy,2,2,0
Weebfiend,moon-guard,63,deathknight,unholy,8,2,6
Ayçe,proudmoore,58,deathknight,unholy,10,3,7
Spleem,stormrage,48,deathknight,unholy,3,1,2
Lördd,moon-guard,42,deathknight,unholy,11,3,8
Harrypottr,darrowmere,42,deathknight,unholy,8,2,6
Ryannë,azshara,42,deathknight,unholy,12,2,10
Doomstrike,azuremyst,16,deathknight,unholy,1,1,0
Pookr,area-52,2236,deathknight,frost,361,184,177
Yoinkzz,illidan,2167,deathknight,frost,113,58,55
Thânätos,nemesis,1956,deathknight,frost,114,58,56
Xelonith,sargeras,1954,deathknight,frost,66,33,33
Ksmc,tichondrius,1952,deathknight,frost,102,54,48
Runtasticxz,tichondrius,1949,deathknight,frost,83,40,43
Sylèss,tichondrius,1945,deathknight,frost,120,64,56
Axiomqt,tichondrius,1923,deathknight,frost,120,62,58
Duranteh,illidan,1921,deathknight,frost,66,34,32
Plaw,kiljaeden,1916,deathknight,frost,35,21,14
Gkdm,tichondrius,1908,deathknight,frost,72,35,37
Grippygarý,illidan,1878,deathknight,frost,60,32,28
Mikeycal,stormrage,1873,deathknight,frost,90,47,43
Venvicta,tichondrius,1850,deathknight,frost,44,31,13
Saco,malganis,1845,deathknight,frost,110,62,48
Fastapii,tichondrius,1838,deathknight,frost,47,27,20
Scareth,proudmoore,1823,deathknight,frost,46,27,19
Iccyhottie,stormrage,1823,deathknight,frost,322,170,152
Deaddubya,illidan,1815,deathknight,frost,63,40,23
Gràkk,illidan,1810,deathknight,frost,78,44,34
Gladiaturd,hellscream,1809,deathknight,frost,88,45,43
Mikepinkdk,illidan,1808,deathknight,frost,135,74,61
Gkdl,tichondrius,1807,deathknight,frost,36,19,17
Dunduner,tichondrius,1803,deathknight,frost,36,23,13
Dtcfasd,tichondrius,1803,deathknight,frost,110,64,46
Raiekko,dalaran,1797,deathknight,frost,92,42,50
Bellum,moon-guard,1772,deathknight,frost,62,30,32
Bellybuster,malganis,1762,deathknight,frost,48,25,23
Chillbaynê,the-scryers,1754,deathknight,frost,36,22,14
Unhappyvelic,tichondrius,1751,deathknight,frost,63,32,31
Sober,destromath,1742,deathknight,frost,125,64,61
Fastapi,tichondrius,1737,deathknight,frost,90,41,49
Bikfrostyboi,barthilas,1731,deathknight,frost,60,38,22
Dkyeico,ragnaros,1706,deathknight,frost,114,54,60
Devcoil,sargeras,1706,deathknight,frost,54,22,32
Deathboost,stormrage,1695,deathknight,frost,96,45,51
Kryptikkyt,blackrock,1694,deathknight,frost,24,18,6
Whytedk,illidan,1685,deathknight,frost,48,21,27
Skullash,stormrage,1676,deathknight,frost,54,33,21
Frosthana,illidan,1671,deathknight,frost,120,58,62
Jykupajr,proudmoore,1669,deathknight,frost,66,29,37
Remanent,tichondrius,1664,deathknight,frost,77,39,38
Crink,sargeras,1658,deathknight,frost,47,24,23
Onsslaught,sargeras,1658,deathknight,frost,48,18,30
Menalise,moon-guard,1650,deathknight,frost,42,22,20
Børeas,quelthalas,1645,deathknight,frost,96,43,53
Azhid,tichondrius,1644,deathknight,frost,40,24,16
Beliath,crushridge,1633,deathknight,frost,41,18,23
Tzepesci,hyjal,1626,deathknight,frost,58,26,32
Percy,thaurissan,1624,deathknight,frost,277,135,142
Worgenracist,tichondrius,1623,deathknight,frost,65,29,36
Sinizster,kelthuzad,1615,deathknight,frost,31,18,13
Ebolaxd,area-52,1614,deathknight,frost,42,21,21
Rekktless,aerie-peak,1613,deathknight,frost,78,40,38
Legendåryx,sargeras,1609,deathknight,frost,42,28,14
Onsllaught,stormrage,1606,deathknight,frost,30,17,13
Darkwraith,illidan,1606,deathknight,frost,78,42,36
Vãl,sargeras,1601,deathknight,frost,302,152,150
Blooddisease,frostmourne,1600,deathknight,frost,59,30,29
Dromidon,darkspear,1590,deathknight,frost,71,39,32
Deadspellz,bleeding-hollow,1590,deathknight,frost,72,33,39
Icewalløw,darkspear,1580,deathknight,frost,36,21,15
Fußuky,quelthalas,1569,deathknight,frost,91,46,45
Zenin,emerald-dream,1543,deathknight,frost,62,31,31
Grakth,quelthalas,1527,deathknight,frost,66,37,29
Imfrozone,stormrage,1527,deathknight,frost,65,31,34
Gordiie,stormrage,1519,deathknight,frost,122,65,57
Uzgard,zuljin,1517,deathknight,frost,77,44,33
Xhín,bleeding-hollow,1506,deathknight,frost,30,16,14
Rembrandtdk,gorefiend,1499,deathknight,frost,143,75,68
Iriwa,tichondrius,1498,deathknight,frost,42,16,26
Zemzil,tichondrius,1496,deathknight,frost,86,38,48
Report,dathremar,1494,deathknight,frost,75,38,37
Trødz,tichondrius,1468,deathknight,frost,87,42,45
Lho,caelestrasz,1465,deathknight,frost,107,54,53
Algeross,dalaran,1457,deathknight,frost,166,78,88
Bâttalion,illidan,1453,deathknight,frost,48,20,28
Dekanok,korgath,1452,deathknight,frost,30,16,14
Khorvusfel,frostmourne,1452,deathknight,frost,49,23,26
Freshzzk,azralon,1450,deathknight,frost,151,79,72
Lókhä,thrall,1443,deathknight,frost,53,28,25
Jazh,tichondrius,1441,deathknight,frost,59,23,36
Tangarang,dalaran,1440,deathknight,frost,98,47,51
Umbramane,tichondrius,1438,deathknight,frost,45,22,23
Iskandàr,ragnaros,1435,deathknight,frost,32,16,16
Khaíne,wyrmrest-accord,1433,deathknight,frost,39,18,21
Vust,malganis,1428,deathknight,frost,60,31,29
Abrahams,tichondrius,1427,deathknight,frost,100,48,52
Stormitt,illidan,1427,deathknight,frost,48,18,30
Kodokuna,bleeding-hollow,1424,deathknight,frost,30,15,15
Jimmyjohnson,illidan,1423,deathknight,frost,119,63,56
Ron,spirestone,1417,deathknight,frost,34,21,13
Vuldy,blackhand,1417,deathknight,frost,57,30,27
Rylas,destromath,1414,deathknight,frost,157,80,77
Ðerion,stormrage,1414,deathknight,frost,146,65,81
Amarlana,mannoroth,1412,deathknight,frost,24,15,9
Sandooñ,tichondrius,1412,deathknight,frost,156,79,77
Shubertx,tichondrius,1412,deathknight,frost,54,25,29
Tekc,nemesis,1411,deathknight,frost,206,105,101
Deathzpeckt,tichondrius,1397,deathknight,frost,108,46,62
Sécret,tichondrius,1394,deathknight,frost,42,24,18
Eldavò,quelthalas,1393,deathknight,frost,60,25,35
Emanuels,quelthalas,1391,deathknight,frost,128,62,66
Biggil,tichondrius,1389,deathknight,frost,32,20,12
Dkbunny,thaurissan,1388,deathknight,frost,42,15,27
Clongeus,tichondrius,1374,deathknight,frost,54,25,29
Theronguard,area-52,1370,deathknight,frost,60,28,32
Nevermor,malganis,1362,deathknight,frost,104,53,51
Ellipsoro,onyxia,1362,deathknight,frost,78,35,43
Gwab,stormrage,1354,deathknight,frost,48,20,28
Frostunholy,tichondrius,1353,deathknight,frost,30,15,15
Eloton,daggerspine,1350,deathknight,frost,35,18,17
Thetalis,moon-guard,1348,deathknight,frost,90,44,46
Clapdat,malganis,1346,deathknight,frost,126,63,63
Flúrrý,area-52,1342,deathknight,frost,18,14,4
Ariacy,sargeras,1341,deathknight,frost,30,14,16
Laylowk,frostmourne,1338,deathknight,frost,26,16,10
Friggintough,tichondrius,1337,deathknight,frost,86,43,43
Bridenbrad,quelthalas,1330,deathknight,frost,33,20,13
Bizdale,frostmourne,1330,deathknight,frost,24,14,10
Alzenth,quelthalas,1329,deathknight,frost,39,24,15
Sinyay,tichondrius,1328,deathknight,frost,106,60,46
Ântipaladin,arthas,1328,deathknight,frost,36,19,17
Panthir,darkspear,1325,deathknight,frost,60,25,35
Kruspy,area-52,1324,deathknight,frost,53,27,26
Satalas,tichondrius,1321,deathknight,frost,53,21,32
Ruggair,proudmoore,1320,deathknight,frost,30,14,16
Dontbanmepls,zuljin,1318,deathknight,frost,30,14,16
Janzano,deathwing,1314,deathknight,frost,38,20,18
Demønnation,illidan,1312,deathknight,frost,44,21,23
Yödä,barthilas,1308,deathknight,frost,48,20,28
Alexeous,wyrmrest-accord,1304,deathknight,frost,127,57,70
Iceice,emerald-dream,1293,deathknight,frost,114,53,61
Garryxz,quelthalas,1293,deathknight,frost,34,15,19
Lichborn,azralon,1293,deathknight,frost,71,30,41
Jackofblades,veknilash,1291,deathknight,frost,113,59,54
Darkreígn,tichondrius,1286,deathknight,frost,101,52,49
Corrpsse,tichondrius,1283,deathknight,frost,157,79,78
Bossk,emerald-dream,1283,deathknight,frost,36,14,22
Spoon,sargeras,1282,deathknight,frost,118,60,58
Sporkdk,illidan,1277,deathknight,frost,53,20,33
Khalid,azgalor,1275,deathknight,frost,65,25,40
Abake,illidan,1267,deathknight,frost,62,30,32
Alexanderz,quelthalas,1264,deathknight,frost,36,15,21
Darketvam,illidan,1261,deathknight,frost,46,28,18
Himanshu,emerald-dream,1261,deathknight,frost,81,37,44
Verhangnis,azjolnerub,1250,deathknight,frost,55,28,27
Tåx,tanaris,1248,deathknight,frost,27,15,12
Mexe,ragnaros,1242,deathknight,frost,56,28,28
Thetissuebox,emerald-dream,1238,deathknight,frost,24,13,11
Rayden,frostmourne,1235,deathknight,frost,24,13,11
Surcäfauces,ragnaros,1234,deathknight,frost,27,14,13
Ðëthbringër,jubeithos,1220,deathknight,frost,30,13,17
Enjal,stormrage,1215,deathknight,frost,58,26,32
Úndead,barthilas,1214,deathknight,frost,28,17,11
Darkdeviliv,darkspear,1214,deathknight,frost,59,29,30
Biotics,barthilas,1213,deathknight,frost,24,13,11
Soulfang,nemesis,1205,deathknight,frost,84,42,42
Zeró,wyrmrest-accord,1205,deathknight,frost,76,33,43
Flins,nemesis,1199,deathknight,frost,520,259,261
Seeyoudiebr,gallywix,1190,deathknight,frost,42,17,25
Parksy,kelthuzad,1189,deathknight,frost,74,35,39
Zefdk,illidan,1186,deathknight,frost,48,27,21
Barrodir,tichondrius,1183,deathknight,frost,99,49,50
Lospollos,tichondrius,1181,deathknight,frost,60,23,37
Nocreed,illidan,1175,deathknight,frost,54,18,36
Zarathraz,ragnaros,1168,deathknight,frost,40,18,22
Renathâ,ragnaros,1167,deathknight,frost,42,15,27
Jordankg,tanaris,1165,deathknight,frost,41,16,25
Sephirott,boulderfist,1162,deathknight,frost,62,35,27
Kelistros,moon-guard,1160,deathknight,frost,35,13,22
Lîch,azralon,1157,deathknight,frost,63,24,39
Estali,kelthuzad,1152,deathknight,frost,134,59,75
Tìtø,ragnaros,1151,deathknight,frost,24,12,12
Chillpills,stormrage,1151,deathknight,frost,30,12,18
Mörrigham,stormrage,1150,deathknight,frost,24,12,12
Lxsol,illidan,1149,deathknight,frost,18,12,6
Dkapocalypse,azralon,1149,deathknight,frost,38,13,25
Tambaknight,nemesis,1146,deathknight,frost,44,15,29
Laumuelden,ragnaros,1143,deathknight,frost,48,17,31
Janco,runetotem,1141,deathknight,frost,24,12,12
Moonnwater,frostmourne,1139,deathknight,frost,90,48,42
Gripnpull,tichondrius,1137,deathknight,frost,24,12,12
Dkptador,azralon,1137,deathknight,frost,184,89,95
Carecaa,azralon,1136,deathknight,frost,60,25,35
Laboön,stormrage,1136,deathknight,frost,30,12,18
Bluex,silvermoon,1135,deathknight,frost,30,12,18
Hiki,ragnaros,1134,deathknight,frost,30,12,18
Darfik,sargeras,1127,deathknight,frost,138,72,66
Tarknok,moon-guard,1123,deathknight,frost,24,12,12
Metaphysicsx,amanthul,1119,deathknight,frost,54,29,25
Dreekon,bleeding-hollow,1115,deathknight,frost,28,15,13
Achilleo,quelthalas,1115,deathknight,frost,24,12,12
Rohdey,madoran,1114,deathknight,frost,129,54,75
Pembadk,tichondrius,1110,deathknight,frost,33,14,19
Nefarion,nathrezim,1109,deathknight,frost,29,13,16
Panddemonio,gallywix,1107,deathknight,frost,54,21,33
Jawyn,area-52,1096,deathknight,frost,30,12,18
Ârtas,uldum,1090,deathknight,frost,39,16,23
Dantte,stormscale,1080,deathknight,frost,59,31,28
Griswold,windrunner,1069,deathknight,frost,34,18,16
Darkdevilvii,tichondrius,1069,deathknight,frost,66,33,33
Mawvac,quelthalas,1069,deathknight,frost,72,33,39
Wap,bloodhoof,1056,deathknight,frost,18,11,7
Zephyx,lightbringer,1056,deathknight,frost,18,11,7
Vigasick,azralon,1056,deathknight,frost,24,11,13
Toxismall,zuljin,1056,deathknight,frost,24,11,13
Puppykisses,perenolde,1055,deathknight,frost,24,11,13
Beanboyx,tichondrius,1053,deathknight,frost,24,11,13
Jhonnsnow,frostmourne,1051,deathknight,frost,24,11,13
Nalz,drakkari,1050,deathknight,frost,30,11,19
Dregdar,emerald-dream,1049,deathknight,frost,18,11,7
Tightann,stormrage,1047,deathknight,frost,24,11,13
Malovv,nemesis,1042,deathknight,frost,18,12,6
Kace,amanthul,1042,deathknight,frost,93,44,49
Ixiefin,sargeras,1041,deathknight,frost,24,15,9
Ztrain,proudmoore,1034,deathknight,frost,25,12,13
Freemoney,wyrmrest-accord,1034,deathknight,frost,24,11,13
Brutos,thrall,1023,deathknight,frost,23,11,12
Raegywn,blood-furnace,1022,deathknight,frost,29,11,18
Janoh,the-scryers,1021,deathknight,frost,44,19,25
Roarbane,muradin,1004,deathknight,frost,72,37,35
Eliagianluca,caelestrasz,1003,deathknight,frost,71,32,39
Getmad,anvilmar,1001,deathknight,frost,29,12,17
Icedmilk,zuluhed,994,deathknight,frost,37,19,18
ßlazedkush,kelthuzad,989,deathknight,frost,36,18,18
Tarone,zuljin,981,deathknight,frost,27,14,13
Vorlakesh,boulderfist,979,deathknight,frost,22,11,11
Sakaarr,bleeding-hollow,974,deathknight,frost,48,21,27
Vanyor,wyrmrest-accord,972,deathknight,frost,80,29,51
Skittsdk,thrall,966,deathknight,frost,24,12,12
Ciputra,blood-furnace,962,deathknight,frost,53,27,26
Denale,darkspear,959,deathknight,frost,24,10,14
Shobiz,barthilas,958,deathknight,frost,18,10,8
Tokyotimxx,malganis,958,deathknight,frost,18,10,8
Frosqt,queldorei,957,deathknight,frost,12,10,2
Toothstick,stormrage,957,deathknight,frost,18,10,8
Serwestley,stormrage,956,deathknight,frost,18,10,8
Necrósy,azralon,955,deathknight,frost,18,10,8
Ryugetzu,drakkari,955,deathknight,frost,72,23,49
Axylus,kelthuzad,953,deathknight,frost,18,10,8
Bullbanger,runetotem,953,deathknight,frost,42,22,20
Whoopsies,sargeras,942,deathknight,frost,84,35,49
Larrisey,illidan,940,deathknight,frost,33,18,15
Kraige,tichondrius,933,deathknight,frost,30,10,20
Aztecka,illidan,915,deathknight,frost,36,18,18
Grimmr,tichondrius,912,deathknight,frost,23,10,13
Nagaizao,nemesis,912,deathknight,frost,24,10,14
Ðreak,azralon,907,deathknight,frost,23,10,13
Fokit,barthilas,906,deathknight,frost,64,31,33
Sandolorian,area-52,892,deathknight,frost,24,10,14
Kallugrax,kelthuzad,885,deathknight,frost,42,16,26
Pizzathehutt,nordrassil,868,deathknight,frost,30,10,20
Wahpow,frostwolf,864,deathknight,frost,12,9,3
Lokitabeso,ragnaros,864,deathknight,frost,12,9,3
Garbage,sargeras,863,deathknight,frost,18,9,9
Lazenca,malganis,863,deathknight,frost,18,9,9
Zarakas,sargeras,863,deathknight,frost,24,9,15
Zivz,borean-tundra,862,deathknight,frost,12,9,3
Kekkijutsu,bleeding-hollow,862,deathknight,frost,12,9,3
Thesseo,quelthalas,862,deathknight,frost,18,9,9
Chicnchsteak,tichondrius,862,deathknight,frost,30,9,21
Jasmíne,vashj,861,deathknight,frost,12,9,3
Urieen,gorefiend,861,deathknight,frost,18,9,9
Loverianed,aerie-peak,859,deathknight,frost,207,93,114
Gypo,scilla,858,deathknight,frost,18,9,9
Sllice,aegwynn,858,deathknight,frost,24,9,15
Dekafinator,frostmourne,857,deathknight,frost,12,9,3
Helguarde,dragonblight,853,deathknight,frost,30,13,17
Wãrson,bleeding-hollow,851,deathknight,frost,18,9,9
Rensven,frostmourne,846,deathknight,frost,18,9,9
Frrost,earthen-ring,845,deathknight,frost,25,10,15
Wartodeath,illidan,843,deathknight,frost,18,9,9
Krowl,nagrand,834,deathknight,frost,18,9,9
Frostyclaws,blackrock,829,deathknight,frost,23,9,14
Dèadpool,blackhand,828,deathknight,frost,18,9,9
Ryudeus,lothar,826,deathknight,frost,23,9,14
Uncfester,onyxia,823,deathknight,frost,18,9,9
Madorderog,stormrage,823,deathknight,frost,46,20,26
Varrine,hyjal,821,deathknight,frost,54,25,29
Neowolf,azgalor,818,deathknight,frost,71,23,48
Neofrank,drakkari,802,deathknight,frost,60,16,44
Xslaught,maiev,798,deathknight,frost,28,10,18
Incanis,moon-guard,782,deathknight,frost,19,9,10
Havince,drenden,768,deathknight,frost,12,8,4
Lokítabesos,ragnaros,768,deathknight,frost,12,8,4
Skidmarks,whisperwind,768,deathknight,frost,12,8,4
Lokitaßesos,ragnaros,768,deathknight,frost,12,8,4
Satisie,eitrigg,767,deathknight,frost,18,8,10
Artourias,wyrmrest-accord,766,deathknight,frost,12,8,4
Acg,tichondrius,766,deathknight,frost,12,8,4
Kerigann,moon-guard,766,deathknight,frost,12,8,4
Deadbeards,zuluhed,766,deathknight,frost,18,8,10
Deweybrown,smolderthorn,765,deathknight,frost,12,8,4
Dhrogar,moon-guard,762,deathknight,frost,12,8,4
Amauqsun,bleeding-hollow,762,deathknight,frost,18,8,10
Dyingwolf,ragnaros,761,deathknight,frost,18,8,10
Jyantdeck,area-52,760,deathknight,frost,13,8,5
Zarolden,tichondrius,759,deathknight,frost,24,8,16
Ryannë,azshara,759,deathknight,frost,37,8,29
Twicecursed,kelthuzad,758,deathknight,frost,18,8,10
Fexon,queldorei,758,deathknight,frost,33,10,23
Thebigknight,deathwing,749,deathknight,frost,16,9,7
Killa,maiev,745,deathknight,frost,18,8,10
Hansmclroy,trollbane,738,deathknight,frost,24,8,16
Monglord,arthas,733,deathknight,frost,27,9,18
Cowmedian,norgannon,730,deathknight,frost,28,8,20
Biglimb,area-52,719,deathknight,frost,17,8,9
Lafourche,sargeras,718,deathknight,frost,17,8,9
Shioms,quelthalas,711,deathknight,frost,23,9,14
Howlgore,burning-legion,702,deathknight,frost,20,8,12
Russkivolk,frostmourne,688,deathknight,frost,19,8,11
Bigfatdkk,illidan,672,deathknight,frost,12,7,5
Reighart,kiljaeden,672,deathknight,frost,12,7,5
Zerhistran,proudmoore,672,deathknight,frost,12,7,5
Dumbledore,deathwing,672,deathknight,frost,12,7,5
Footodor,bleeding-hollow,672,deathknight,frost,12,7,5
Frøzèñintïmê,tichondrius,672,deathknight,frost,12,7,5
Tofurious,barthilas,672,deathknight,frost,12,7,5
Insanity,boulderfist,672,deathknight,frost,12,7,5
Deathrey,kargath,672,deathknight,frost,18,7,11
Anexdk,korgath,672,deathknight,frost,18,7,11
Kipchipperly,kelthuzad,671,deathknight,frost,12,7,5
Bersolgens,illidan,671,deathknight,frost,12,7,5
Pandauh,proudmoore,671,deathknight,frost,18,7,11
Khutuzun,tichondrius,671,deathknight,frost,18,7,11
Mordekeiser,wyrmrest-accord,671,deathknight,frost,18,7,11
Unintended,barthilas,671,deathknight,frost,24,7,17
Unholycube,zuljin,671,deathknight,frost,30,7,23
Thwap,sargeras,670,deathknight,frost,18,7,11
Zulomón,area-52,670,deathknight,frost,18,7,11
Fåîrÿdûst,skullcrusher,670,deathknight,frost,20,7,13
Elwoodblooz,stormrage,669,deathknight,frost,15,8,7
Winterstone,moon-guard,669,deathknight,frost,18,7,11
Rottenqunt,tichondrius,668,deathknight,frost,12,7,5
Helvegum,tichondrius,668,deathknight,frost,12,7,5
Caravante,azralon,668,deathknight,frost,18,7,11
Cryptgore,moon-guard,665,deathknight,frost,18,7,11
Vayk,bleeding-hollow,639,deathknight,frost,16,7,9
Iiedown,stormrage,623,deathknight,frost,11,7,4
Válhállá,ragnaros,615,deathknight,frost,23,7,16
Dreadmoore,wyrmrest-accord,607,deathknight,frost,16,7,9
Lindrayëda,moon-guard,581,deathknight,frost,13,7,6
Qvox,area-52,576,deathknight,frost,12,6,6
Dreadlight,moon-guard,576,deathknight,frost,12,6,6
Ironslaught,moon-guard,576,deathknight,frost,12,6,6
Otarin,tichondrius,576,deathknight,frost,12,6,6
Riglros,tichondrius,576,deathknight,frost,12,6,6
Inarius,caelestrasz,576,deathknight,frost,12,6,6
Billclintonn,sargeras,576,deathknight,frost,12,6,6
Arnagal,drakkari,576,deathknight,frost,12,6,6
Stëroids,shuhalo,576,deathknight,frost,12,6,6
Hunrune,emerald-dream,576,deathknight,frost,12,6,6
Dementrius,zuljin,576,deathknight,frost,12,6,6
Cozzasad,barthilas,576,deathknight,frost,12,6,6
Xangrim,emerald-dream,576,deathknight,frost,12,6,6
Rennoc,emerald-dream,576,deathknight,frost,12,6,6
Aldrey,bonechewer,576,deathknight,frost,12,6,6
Piratehookah,sargeras,576,deathknight,frost,12,6,6
Sparklekitty,illidan,576,deathknight,frost,12,6,6
Darkxavros,stormrage,576,deathknight,frost,12,6,6
Rotfang,proudmoore,576,deathknight,frost,12,6,6
Soulbone,wyrmrest-accord,576,deathknight,frost,12,6,6
Neaz,moon-guard,576,deathknight,frost,18,6,12
Whosurbobby,area-52,576,deathknight,frost,18,6,12
Chilivibes,boulderfist,576,deathknight,frost,18,6,12
Crimsondk,stormrage,576,deathknight,frost,18,6,12
Dairboi,sargeras,576,deathknight,frost,18,6,12
Xhoul,sargeras,576,deathknight,frost,18,6,12
Flûffÿ,thrall,575,deathknight,frost,12,6,6
Zamerz,malganis,575,deathknight,frost,12,6,6
Astanddra,wyrmrest-accord,575,deathknight,frost,12,6,6
Davenn,stormrage,575,deathknight,frost,12,6,6
Tooe,darrowmere,575,deathknight,frost,12,6,6
Siouxsiie,nemesis,575,deathknight,frost,12,6,6
Kaelhc,illidan,575,deathknight,frost,12,6,6
Enobrah,proudmoore,575,deathknight,frost,24,6,18
Bootyclapztv,tichondrius,574,deathknight,frost,12,6,6
Nezareth,sargeras,574,deathknight,frost,12,6,6
Bloodbanne,darkspear,573,deathknight,frost,12,6,6
Ikaris,wildhammer,569,deathknight,frost,12,6,6
Cailras,argent-dawn,566,deathknight,frost,12,6,6
Ergoth,darkspear,564,deathknight,frost,30,6,24
Busynas,thrall,559,deathknight,frost,11,6,5
Werebuddy,lightnings-blade,528,deathknight,frost,15,6,9
Infadelias,stormrage,527,deathknight,frost,11,6,5
Rakutengirls,tichondrius,527,deathknight,frost,11,6,5
Bigdkk,thaurissan,516,deathknight,frost,29,10,19
Kookx,tichondrius,489,deathknight,frost,13,6,7
Sathanazz,ragnaros,480,deathknight,frost,6,5,1
Necrôtic,area-52,480,deathknight,frost,6,5,1
Lokitaßeso,ragnaros,480,deathknight,frost,6,5,1
Dænish,sargeras,480,deathknight,frost,6,5,1
Vett,antonidas,480,deathknight,frost,6,5,1
Flashofdark,proudmoore,480,deathknight,frost,12,5,7
Redbr,tichondrius,480,deathknight,frost,12,5,7
Sinistarz,illidan,480,deathknight,frost,12,5,7
Dknightkofwa,tichondrius,480,deathknight,frost,12,5,7
Withered,area-52,480,deathknight,frost,12,5,7
Martinnash,emerald-dream,480,deathknight,frost,12,5,7
Hyondeath,tichondrius,480,deathknight,frost,12,5,7
Hoebliterate,proudmoore,480,deathknight,frost,12,5,7
Frozenhawk,lothar,480,deathknight,frost,12,5,7
Dooros,wyrmrest-accord,480,deathknight,frost,12,5,7
Frostpanda,dalaran,480,deathknight,frost,12,5,7
Darknessice,tichondrius,480,deathknight,frost,12,5,7
Subparatbest,chogall,480,deathknight,frost,12,5,7
Stevegates,tichondrius,480,deathknight,frost,12,5,7
Rumblepuppy,hyjal,480,deathknight,frost,12,5,7
Felasrianth,dathremar,480,deathknight,frost,12,5,7
ßlacklìsted,kelthuzad,480,deathknight,frost,12,5,7
Sithdog,blackrock,480,deathknight,frost,12,5,7
Hazerlazer,arthas,480,deathknight,frost,12,5,7
Drzièglér,tichondrius,480,deathknight,frost,18,5,13
Saighast,illidan,480,deathknight,frost,18,5,13
Bëlzëbü,stormrage,479,deathknight,frost,6,5,1
Moovement,illidan,479,deathknight,frost,6,5,1
Bulltille,azralon,479,deathknight,frost,6,5,1
Nalec,tichondrius,479,deathknight,frost,12,5,7
Aradorn,azralon,479,deathknight,frost,18,5,13
Sokthr,proudmoore,479,deathknight,frost,18,5,13
Jessaminne,nordrassil,479,deathknight,frost,24,5,19
Kalahari,perenolde,479,deathknight,frost,30,5,25
Blaid,nemesis,478,deathknight,frost,12,5,7
Venimuos,bleeding-hollow,478,deathknight,frost,15,5,10
Adjudicated,darkspear,477,deathknight,frost,12,5,7
Ðecimate,muradin,476,deathknight,frost,12,5,7
Rogoroth,stormrage,475,deathknight,frost,12,5,7
Greeasy,bleeding-hollow,446,deathknight,frost,17,5,12
Bluemanikin,area-52,416,deathknight,frost,10,5,5
Drizzth,ragnaros,413,deathknight,frost,8,5,3
Dìs,frostmourne,399,deathknight,frost,5,5,0
Tontan,cairne,384,deathknight,frost,6,4,2
Deathguru,tichondrius,384,deathknight,frost,6,4,2
Cesarz,tichondrius,384,deathknight,frost,6,4,2
Khazgrim,chogall,384,deathknight,frost,6,4,2
Well,archimonde,384,deathknight,frost,6,4,2
Anatøly,ragnaros,384,deathknight,frost,6,4,2
Sera,blackrock,384,deathknight,frost,6,4,2
Laxatives,tichondrius,384,deathknight,frost,6,4,2
Orbo,elune,384,deathknight,frost,6,4,2
Tanjus,kelthuzad,384,deathknight,frost,6,4,2
Bigdooks,area-52,384,deathknight,frost,6,4,2
Sauranak,bleeding-hollow,384,deathknight,frost,6,4,2
Nabreus,ragnaros,384,deathknight,frost,6,4,2
Gurrikhog,proudmoore,384,deathknight,frost,6,4,2
Aldebamuu,ragnaros,384,deathknight,frost,6,4,2
Teakillah,zuljin,384,deathknight,frost,6,4,2
Riseup,area-52,384,deathknight,frost,6,4,2
Primillion,tichondrius,384,deathknight,frost,6,4,2
Chachio,kiljaeden,384,deathknight,frost,6,4,2
Ärlo,frostmourne,384,deathknight,frost,6,4,2
Xnightmàre,wildhammer,384,deathknight,frost,6,4,2
Silanvia,wyrmrest-accord,384,deathknight,frost,12,4,8
Zaddix,whisperwind,384,deathknight,frost,12,4,8
Exiledknight,area-52,384,deathknight,frost,12,4,8
Helcurt,hyjal,384,deathknight,frost,12,4,8
Shmacmiller,stormrage,384,deathknight,frost,12,4,8
Thikness,tichondrius,384,deathknight,frost,12,4,8
Hooterzqt,tichondrius,384,deathknight,frost,12,4,8
Pyradine,amanthul,384,deathknight,frost,12,4,8
Deathrowe,blackhand,384,deathknight,frost,12,4,8
Maxymillion,thrall,384,deathknight,frost,12,4,8
Almostdead,proudmoore,384,deathknight,frost,12,4,8
Lichhbanne,doomhammer,384,deathknight,frost,12,4,8
Ðaz,zuljin,384,deathknight,frost,18,4,14
Gerardkyx,drakkari,384,deathknight,frost,18,4,14
Shinici,kelthuzad,383,deathknight,frost,9,5,4
Vithael,stormrage,383,deathknight,frost,12,4,8
Adoran,turalyon,383,deathknight,frost,12,4,8
Bloodmourne,barthilas,383,deathknight,frost,18,4,14
Sindragos,stormrage,382,deathknight,frost,12,4,8
Deathvortex,nemesis,379,deathknight,frost,12,4,8
Brumaks,quelthalas,367,deathknight,frost,11,4,7
Oilasslover,illidan,361,deathknight,frost,15,6,9
Lokitakisses,ragnaros,351,deathknight,frost,11,4,7
Eltillible,ragnaros,336,deathknight,frost,15,4,11
Xaldeth,moon-guard,319,deathknight,frost,14,4,10
Bunghoolio,nerzhul,315,deathknight,frost,16,4,12
Víní,azralon,288,deathknight,frost,6,3,3
Yungdooks,area-52,288,deathknight,frost,6,3,3
Noobender,burning-blade,288,deathknight,frost,6,3,3
Jughéad,thrall,288,deathknight,frost,6,3,3
Gunga,skullcrusher,288,deathknight,frost,6,3,3
Styxîa,sargeras,288,deathknight,frost,6,3,3
Frostybones,guldan,288,deathknight,frost,6,3,3
Saraphdk,area-52,288,deathknight,frost,6,3,3
Démise,malganis,288,deathknight,frost,6,3,3
Zygon,thrall,288,deathknight,frost,6,3,3
Gorsz,tichondrius,288,deathknight,frost,6,3,3
Trant,tichondrius,288,deathknight,frost,6,3,3
Doomdk,azralon,288,deathknight,frost,6,3,3
Yamanji,wyrmrest-accord,288,deathknight,frost,6,3,3
Brojah,bonechewer,288,deathknight,frost,6,3,3
Plaugedone,lightbringer,288,deathknight,frost,6,3,3
Atheion,the-underbog,288,deathknight,frost,6,3,3
Avantee,moon-guard,288,deathknight,frost,6,3,3
Iröñ,baelgun,288,deathknight,frost,6,3,3
Kalevesicant,nesingwary,288,deathknight,frost,6,3,3
Cgg,tichondrius,288,deathknight,frost,6,3,3
Störmrünner,kelthuzad,288,deathknight,frost,6,3,3
Mesx,tichondrius,288,deathknight,frost,6,3,3
Malthis,antonidas,288,deathknight,frost,6,3,3
Clizforden,kelthuzad,288,deathknight,frost,6,3,3
Deathgripx,area-52,288,deathknight,frost,6,3,3
Egirlgripper,area-52,288,deathknight,frost,6,3,3
Supermane,jubeithos,288,deathknight,frost,6,3,3
Sorenbjerg,zuljin,288,deathknight,frost,6,3,3
Ghouldruis,barthilas,288,deathknight,frost,6,3,3
Drpepp,bleeding-hollow,288,deathknight,frost,6,3,3
Alujin,arthas,288,deathknight,frost,6,3,3
Millariel,stormrage,288,deathknight,frost,6,3,3
Zügzug,chogall,288,deathknight,frost,6,3,3
Dalka,laughing-skull,288,deathknight,frost,6,3,3
Fearfull,hyjal,288,deathknight,frost,10,4,6
Deathscyythe,illidan,288,deathknight,frost,12,3,9
Nenó,illidan,288,deathknight,frost,12,3,9
Flarkness,area-52,288,deathknight,frost,12,3,9
Toxicant,zuljin,288,deathknight,frost,12,3,9
Biukanon,ragnaros,288,deathknight,frost,12,3,9
Janus,illidan,288,deathknight,frost,12,3,9
Kendøll,sargeras,288,deathknight,frost,12,3,9
Paíín,illidan,288,deathknight,frost,12,3,9
Lòthlòria,mannoroth,288,deathknight,frost,12,3,9
Dkpeter,quelthalas,288,deathknight,frost,12,3,9
Freyjani,moon-guard,288,deathknight,frost,12,3,9
Moyjô,aggramar,288,deathknight,frost,15,3,12
Sinfulvoid,darkspear,287,deathknight,frost,6,3,3
Letum,lightbringer,287,deathknight,frost,6,3,3
Páthøgen,ravencrest,287,deathknight,frost,12,3,9
Dragoroth,zuluhed,286,deathknight,frost,6,3,3
Gnomey,area-52,255,deathknight,frost,8,4,4
Crukashongal,zuljin,240,deathknight,frost,9,4,5
Unwantedgrab,sargeras,239,deathknight,frost,5,3,2
Hamze,stormrage,239,deathknight,frost,5,3,2
Icycrazy,azralon,239,deathknight,frost,5,3,2
Onìì,aegwynn,234,deathknight,frost,10,5,5
Noplug,area-52,234,deathknight,frost,15,4,11
Bbcobliterat,proudmoore,234,deathknight,frost,22,4,18
Slyphan,area-52,192,deathknight,frost,4,3,1
Drknights,lightninghoof,192,deathknight,frost,9,3,6
Froxe,sargeras,192,deathknight,frost,6,2,4
Kreyun,bleeding-hollow,192,deathknight,frost,6,2,4
Deadlyforce,sargeras,192,deathknight,frost,6,2,4
Pofokut,bleeding-hollow,192,deathknight,frost,6,2,4
Soutennizase,azralon,192,deathknight,frost,6,2,4
Flavorchops,kelthuzad,192,deathknight,frost,6,2,4
Martufe,sargeras,192,deathknight,frost,6,2,4
Unholyreap,arthas,192,deathknight,frost,6,2,4
Oreodeath,sargeras,192,deathknight,frost,6,2,4
Bonusman,sargeras,192,deathknight,frost,6,2,4
Hunwild,emerald-dream,192,deathknight,frost,6,2,4
Oldskul,sargeras,192,deathknight,frost,6,2,4
Rotfang,elune,192,deathknight,frost,6,2,4
Noik,azralon,192,deathknight,frost,6,2,4
Lichkong,dalaran,192,deathknight,frost,6,2,4
Frozenjuice,sargeras,192,deathknight,frost,6,2,4
Chrønnøz,nemesis,192,deathknight,frost,6,2,4
Xorov,illidan,192,deathknight,frost,6,2,4
Sorvett,azralon,192,deathknight,frost,6,2,4
Zëb,sargeras,192,deathknight,frost,6,2,4
Crakdos,illidan,192,deathknight,frost,6,2,4
Baaileyy,illidan,192,deathknight,frost,6,2,4
Dahaaka,malganis,192,deathknight,frost,6,2,4
Khørne,area-52,192,deathknight,frost,6,2,4
Nethaar,tichondrius,192,deathknight,frost,6,2,4
Ironmikebysn,bronzebeard,192,deathknight,frost,6,2,4
Sayâ,frostmane,192,deathknight,frost,6,2,4
Lazynome,azshara,192,deathknight,frost,6,2,4
Ndz,quelthalas,192,deathknight,frost,6,2,4
Deathbringèr,tichondrius,192,deathknight,frost,6,2,4
Envisage,kelthuzad,192,deathknight,frost,6,2,4
Hadeon,boulderfist,192,deathknight,frost,6,2,4
Arthureon,kelthuzad,192,deathknight,frost,6,2,4
Fraýja,tichondrius,192,deathknight,frost,6,2,4
Darkunral,stormrage,192,deathknight,frost,6,2,4
Yourunigrip,tichondrius,192,deathknight,frost,6,2,4
Dkswaag,malganis,192,deathknight,frost,6,2,4
Nebuchadnezz,darkspear,192,deathknight,frost,6,2,4
Madslayer,tichondrius,192,deathknight,frost,6,2,4
Dego,tichondrius,192,deathknight,frost,6,2,4
Sayga,ragnaros,192,deathknight,frost,6,2,4
Edek,frostmourne,192,deathknight,frost,6,2,4
Hiverssalt,stormrage,192,deathknight,frost,6,2,4
Superlast,blackrock,192,deathknight,frost,6,2,4
Azibar,moon-guard,192,deathknight,frost,6,2,4
Frozobagins,tichondrius,192,deathknight,frost,6,2,4
Alderollar,stormrage,192,deathknight,frost,6,2,4
Demise,stormrage,192,deathknight,frost,6,2,4
Rulord,wyrmrest-accord,192,deathknight,frost,6,2,4
Spaidzz,malganis,192,deathknight,frost,9,2,7
Selasia,malygos,192,deathknight,frost,12,2,10
Lillylilly,bleeding-hollow,192,deathknight,frost,12,2,10
Melyrc,quelthalas,192,deathknight,frost,12,2,10
Appledog,ragnaros,192,deathknight,frost,12,2,10
Kóssak,black-dragonflight,192,deathknight,frost,12,2,10
Evangelina,antonidas,192,deathknight,frost,12,2,10
Záiiko,quelthalas,192,deathknight,frost,12,2,10
Shadar,muradin,192,deathknight,frost,12,2,10
Serberiss,barthilas,192,deathknight,frost,12,2,10
Ocriterate,stormrage,192,deathknight,frost,12,2,10
Deathmike,bonechewer,191,deathknight,frost,6,2,4
Ulyssess,jubeithos,191,deathknight,frost,6,2,4
Edhral,ragnaros,191,deathknight,frost,6,2,4
Xepherto,ragnaros,191,deathknight,frost,6,2,4
Sübzerö,quelthalas,191,deathknight,frost,6,2,4
Autolysis,sargeras,191,deathknight,frost,6,2,4
Akmy,illidan,175,deathknight,frost,11,2,9
Nickolas,dalvengyr,159,deathknight,frost,5,2,3
Sathoran,firetree,159,deathknight,frost,8,3,5
Vojac,moon-guard,96,deathknight,frost,3,2,1
Telrenaur,proudmoore,96,deathknight,frost,3,2,1
Takeoverr,ragnaros,96,deathknight,frost,3,2,1
Philyaliora,moon-guard,96,deathknight,frost,11,2,9
Ricedisease,emerald-dream,96,deathknight,frost,6,1,5
Gooré,ragnaros,96,deathknight,frost,6,1,5
Denkot,stormrage,96,deathknight,frost,6,1,5
Kakaih,azralon,96,deathknight,frost,6,1,5
Cellebrok,bleeding-hollow,96,deathknight,frost,6,1,5
Koltíra,azralon,96,deathknight,frost,6,1,5
Icejagan,stormrage,96,deathknight,frost,6,1,5
Einherjiar,tichondrius,96,deathknight,frost,6,1,5
Gnawkick,tichondrius,96,deathknight,frost,6,1,5
Heboriç,stormrage,96,deathknight,frost,6,1,5
Cruzx,tichondrius,96,deathknight,frost,6,1,5
Necrotic,greymane,96,deathknight,frost,6,1,5
Xakri,kelthuzad,96,deathknight,frost,6,1,5
Barricus,stonemaul,96,deathknight,frost,6,1,5
Vrolock,quelthalas,96,deathknight,frost,6,1,5
Varraeda,stonemaul,96,deathknight,frost,6,1,5
Crichtön,proudmoore,96,deathknight,frost,6,1,5
Kireek,stormrage,96,deathknight,frost,6,1,5
Siphilusxo,dalaran,96,deathknight,frost,6,1,5
Druath,proudmoore,96,deathknight,frost,6,1,5
Ophin,silver-hand,96,deathknight,frost,6,1,5
Grimmosh,daggerspine,96,deathknight,frost,6,1,5
Icecreamlife,chogall,96,deathknight,frost,6,1,5
Inertìa,malganis,96,deathknight,frost,6,1,5
Mako,garithos,96,deathknight,frost,6,1,5
Bubblesdk,whisperwind,96,deathknight,frost,6,1,5
Azynks,azralon,96,deathknight,frost,6,1,5
Teksurugi,korgath,96,deathknight,frost,6,1,5
Grayfoxx,twisting-nether,96,deathknight,frost,6,1,5
Mephostophel,sargeras,96,deathknight,frost,6,1,5
Grimorra,bleeding-hollow,96,deathknight,frost,6,1,5
Puppykiss,perenolde,96,deathknight,frost,6,1,5
Guffles,tichondrius,96,deathknight,frost,6,1,5
Renzian,tichondrius,96,deathknight,frost,6,1,5
Undêrtaker,sargeras,96,deathknight,frost,6,1,5
Dotted,tichondrius,96,deathknight,frost,6,1,5
Lücìfër,illidan,96,deathknight,frost,6,1,5
Hadianton,stormrage,96,deathknight,frost,6,1,5
Krargosh,quelthalas,96,deathknight,frost,6,1,5
Bingoez,frostmourne,96,deathknight,frost,6,1,5
Ann,spirestone,96,deathknight,frost,6,1,5
Sidbane,kalecgos,96,deathknight,frost,6,1,5
Owenjak,moon-guard,96,deathknight,frost,6,1,5
Davyjonescx,moon-guard,96,deathknight,frost,6,1,5
Sindragosa,dragonmaw,96,deathknight,frost,6,1,5
Nirkanna,akama,96,deathknight,frost,12,1,11
Skadattle,emerald-dream,96,deathknight,frost,12,1,11
Littlenisman,ragnaros,96,deathknight,frost,12,1,11
Xninjakiller,korgath,95,deathknight,frost,12,1,11
Teedk,drakthul,79,deathknight,frost,5,1,4
Magipierrot,ragnaros,64,deathknight,frost,4,1,3
Agasuko,ghostlands,48,deathknight,frost,3,1,2
Frøstbeard,hyjal,42,deathknight,frost,9,2,7
Kënblock,tichondrius,42,deathknight,frost,14,2,12
Twindleroot,aggramar,31,deathknight,frost,2,1,1
Schwaffles,stormrage,31,deathknight,frost,2,1,1
Sharnathos,stormrage,16,deathknight,frost,1,1,0
Jerric,skullcrusher,16,deathknight,frost,7,1,6
Mvqdh,illidan,2327,demonhunter,havoc,113,67,46
Xiaosu,tichondrius,2219,demonhunter,havoc,734,366,368
Demoncouch,malganis,2191,demonhunter,havoc,102,54,48
Yaboiswift,stormrage,2136,demonhunter,havoc,66,36,30
Ehtend,malganis,2136,demonhunter,havoc,354,177,177
Seorae,tichondrius,2126,demonhunter,havoc,84,45,39
Lighost,tichondrius,2117,demonhunter,havoc,382,192,190
Sadgirlx,area-52,2114,demonhunter,havoc,96,48,48
Zetara,malganis,2112,demonhunter,havoc,137,78,59
Ehtend,sargeras,2106,demonhunter,havoc,78,42,36
Insomniaq,sargeras,2102,demonhunter,havoc,115,62,53
Kohî,sargeras,2102,demonhunter,havoc,79,39,40
Exzyo,area-52,2083,demonhunter,havoc,42,28,14
Brbpetmycat,zuljin,2081,demonhunter,havoc,93,46,47
Dhcn,tichondrius,2073,demonhunter,havoc,64,35,29
Reps,hydraxis,2071,demonhunter,havoc,144,81,63
Calpoot,stormscale,2070,demonhunter,havoc,100,55,45
Medrathis,wyrmrest-accord,2057,demonhunter,havoc,66,35,31
Lifting,illidan,2055,demonhunter,havoc,126,64,62
Solit,illidan,2055,demonhunter,havoc,84,42,42
Fellhamer,malganis,2054,demonhunter,havoc,123,69,54
Nézuko,eldrethalas,2045,demonhunter,havoc,129,68,61
Tendiës,tichondrius,2028,demonhunter,havoc,110,51,59
Xtickles,frostmourne,2021,demonhunter,havoc,160,83,77
Cyrøcryphä,quelthalas,2009,demonhunter,havoc,179,89,90
Sleepyjoeb,illidan,2005,demonhunter,havoc,86,48,38
Nasadh,tichondrius,2004,demonhunter,havoc,126,68,58
Badhábits,sargeras,2002,demonhunter,havoc,90,50,40
Ordorll,area-52,1998,demonhunter,havoc,114,59,55
Lademon,tichondrius,1997,demonhunter,havoc,84,46,38
Taegos,tichondrius,1995,demonhunter,havoc,658,322,336
Glaivezx,stormreaver,1987,demonhunter,havoc,120,60,60
Bløødyrøse,illidan,1978,demonhunter,havoc,66,40,26
Ìke,quelthalas,1972,demonhunter,havoc,181,94,87
Bippy,durotan,1964,demonhunter,havoc,149,78,71
Felz,illidan,1964,demonhunter,havoc,95,48,47
Xxann,tichondrius,1955,demonhunter,havoc,61,30,31
Tømåtøgøðx,sargeras,1953,demonhunter,havoc,180,95,85
Sypï,malganis,1944,demonhunter,havoc,84,45,39
Bigbadmad,stormrage,1944,demonhunter,havoc,239,124,115
Mamazboy,area-52,1940,demonhunter,havoc,52,26,26
Boonchu,frostmourne,1935,demonhunter,havoc,86,45,41
Jøsem,ragnaros,1930,demonhunter,havoc,94,48,46
Chirøn,darkspear,1924,demonhunter,havoc,78,38,40
Animepfp,shadowsong,1922,demonhunter,havoc,66,36,30
Hatréd,quelthalas,1918,demonhunter,havoc,60,33,27
ßöb,aggramar,1918,demonhunter,havoc,146,74,72
Gjoat,tichondrius,1917,demonhunter,havoc,95,45,50
Bitcoingodx,tichondrius,1915,demonhunter,havoc,144,84,60
Soliit,illidan,1915,demonhunter,havoc,66,35,31
Zoenin,illidan,1915,demonhunter,havoc,173,88,85
Rlycoolclass,zuljin,1910,demonhunter,havoc,71,33,38
Blasphemus,illidan,1908,demonhunter,havoc,63,34,29
Oddblindguy,area-52,1904,demonhunter,havoc,72,43,29
Lemilion,wyrmrest-accord,1903,demonhunter,havoc,53,27,26
Maverzz,area-52,1902,demonhunter,havoc,65,35,30
Askvivian,sargeras,1900,demonhunter,havoc,127,76,51
Terrorsong,tichondrius,1898,demonhunter,havoc,83,48,35
Ktsoulhunter,azralon,1896,demonhunter,havoc,156,89,67
Griphunt,tichondrius,1894,demonhunter,havoc,240,126,114
Boos,moon-guard,1893,demonhunter,havoc,172,84,88
Anihilum,zuljin,1891,demonhunter,havoc,99,64,35
Cerebro,stormrage,1890,demonhunter,havoc,54,31,23
Dangerspud,frostmourne,1885,demonhunter,havoc,102,48,54
Felluser,sargeras,1882,demonhunter,havoc,53,32,21
Winsforgold,area-52,1881,demonhunter,havoc,92,52,40
Stellitas,ragnaros,1881,demonhunter,havoc,72,38,34
Xch,aegwynn,1881,demonhunter,havoc,166,87,79
Jelleh,frostmourne,1880,demonhunter,havoc,59,33,26
Dayvenie,area-52,1879,demonhunter,havoc,125,70,55
Rosinanta,malygos,1878,demonhunter,havoc,110,60,50
Soyboycuck,emerald-dream,1874,demonhunter,havoc,54,28,26
Erasér,area-52,1872,demonhunter,havoc,60,32,28
Busting,tichondrius,1872,demonhunter,havoc,48,24,24
Mvqqdh,tichondrius,1872,demonhunter,havoc,42,20,22
Cromega,malganis,1871,demonhunter,havoc,120,55,65
Nåxah,bleeding-hollow,1869,demonhunter,havoc,78,38,40
Furious,tichondrius,1868,demonhunter,havoc,60,31,29
Chainsawz,zuljin,1868,demonhunter,havoc,86,41,45
Dewk,ghostlands,1866,demonhunter,havoc,75,39,36
Amorielel,tichondrius,1866,demonhunter,havoc,63,29,34
Asdazanis,nemesis,1865,demonhunter,havoc,92,47,45
Airmax,tichondrius,1864,demonhunter,havoc,84,44,40
Doejah,stormrage,1864,demonhunter,havoc,92,46,46
Leothero,area-52,1863,demonhunter,havoc,54,28,26
Dewkee,ghostlands,1859,demonhunter,havoc,48,28,20
Lamorty,tichondrius,1859,demonhunter,havoc,150,73,77
Mèw,bleeding-hollow,1857,demonhunter,havoc,119,62,57
Dwilk,sargeras,1855,demonhunter,havoc,172,82,90
Loadingdh,tichondrius,1854,demonhunter,havoc,47,20,27
Nb,silvermoon,1853,demonhunter,havoc,59,32,27
Ragiidh,tichondrius,1853,demonhunter,havoc,57,27,30
Ystkz,tichondrius,1852,demonhunter,havoc,213,110,103
Promitto,tichondrius,1851,demonhunter,havoc,101,49,52
Mizaru,moon-guard,1849,demonhunter,havoc,35,24,11
Oshinoko,area-52,1849,demonhunter,havoc,75,40,35
Flykzuwu,azralon,1848,demonhunter,havoc,89,53,36
Hasbeen,tichondrius,1848,demonhunter,havoc,45,25,20
Írís,blackrock,1847,demonhunter,havoc,130,79,51
Junma,tichondrius,1847,demonhunter,havoc,102,55,47
Okuzén,tichondrius,1846,demonhunter,havoc,55,38,17
Daía,ragnaros,1846,demonhunter,havoc,59,31,28
Ripidan,stormrage,1846,demonhunter,havoc,48,23,25
Leesu,tichondrius,1845,demonhunter,havoc,58,32,26
Wowcoldcold,barthilas,1845,demonhunter,havoc,59,30,29
Chirõn,moonrunner,1843,demonhunter,havoc,48,21,27
Bllackclover,zuljin,1841,demonhunter,havoc,68,39,29
Sacredtree,tichondrius,1839,demonhunter,havoc,116,65,51
Tiristra,cenarion-circle,1839,demonhunter,havoc,65,35,30
Ouru,area-52,1839,demonhunter,havoc,108,52,56
Ökìtycoón,proudmoore,1833,demonhunter,havoc,78,45,33
Evaxaxx,tichondrius,1833,demonhunter,havoc,72,32,40
Divide,tichondrius,1831,demonhunter,havoc,130,70,60
Akurawrath,area-52,1830,demonhunter,havoc,120,84,36
Raiinier,sargeras,1830,demonhunter,havoc,78,48,30
Giselah,malganis,1830,demonhunter,havoc,71,33,38
Brackmagik,barthilas,1828,demonhunter,havoc,36,27,9
Takagi,kirin-tor,1828,demonhunter,havoc,221,120,101
Ubetterun,azralon,1827,demonhunter,havoc,238,125,113
Nephxz,tichondrius,1827,demonhunter,havoc,60,30,30
Potspoon,tichondrius,1826,demonhunter,havoc,186,95,91
Frostchaos,ragnaros,1826,demonhunter,havoc,78,39,39
Devotio,emerald-dream,1825,demonhunter,havoc,102,60,42
Migey,thrall,1825,demonhunter,havoc,112,65,47
Beerdash,area-52,1825,demonhunter,havoc,66,28,38
Ninetalesx,sargeras,1823,demonhunter,havoc,81,48,33
Darkrai,area-52,1823,demonhunter,havoc,132,73,59
Nolabb,tichondrius,1822,demonhunter,havoc,128,72,56
Henry,tichondrius,1820,demonhunter,havoc,237,138,99
Karonisam,dalaran,1820,demonhunter,havoc,61,32,29
Blode,tichondrius,1820,demonhunter,havoc,249,127,122
Dannyolo,hyjal,1820,demonhunter,havoc,78,32,46
Mvpdh,area-52,1819,demonhunter,havoc,242,121,121
Failtimeboat,terenas,1817,demonhunter,havoc,60,34,26
Drachyn,darkspear,1817,demonhunter,havoc,71,34,37
Garbage,illidan,1816,demonhunter,havoc,90,47,43
Helenquinn,kelthuzad,1815,demonhunter,havoc,72,46,26
Mirriana,thunderlord,1815,demonhunter,havoc,98,52,46
Brotherz,tichondrius,1815,demonhunter,havoc,113,56,57
Skyez,moon-guard,1814,demonhunter,havoc,115,54,61
Boatsnhoze,tichondrius,1814,demonhunter,havoc,68,30,38
Nadlli,bleeding-hollow,1813,demonhunter,havoc,223,116,107
Kázeshini,frostmourne,1813,demonhunter,havoc,143,71,72
Rufio,nesingwary,1813,demonhunter,havoc,54,25,29
Jfangio,moon-guard,1812,demonhunter,havoc,54,30,24
Coa,nazjatar,1812,demonhunter,havoc,100,54,46
Mamadorx,azralon,1812,demonhunter,havoc,47,25,22
Eldiablaso,malganis,1812,demonhunter,havoc,36,19,17
Lucifèr,uther,1812,demonhunter,havoc,59,28,31
Vowz,sargeras,1811,demonhunter,havoc,66,34,32
Tyskeram,bleeding-hollow,1810,demonhunter,havoc,81,47,34
Ragiixoxo,tichondrius,1809,demonhunter,havoc,30,19,11
Dãnishroll,illidan,1809,demonhunter,havoc,108,54,54
Gødzîllå,moon-guard,1809,demonhunter,havoc,42,19,23
Gameoverz,tichondrius,1808,demonhunter,havoc,45,23,22
Feldarath,sargeras,1807,demonhunter,havoc,139,79,60
Fenomeno,tichondrius,1807,demonhunter,havoc,58,32,26
Fruitbatx,tichondrius,1807,demonhunter,havoc,138,68,70
Xcf,area-52,1807,demonhunter,havoc,48,22,26
Landorus,barthilas,1806,demonhunter,havoc,155,83,72
Niuzimeile,illidan,1805,demonhunter,havoc,77,33,44
Smqkepvrpp,zuljin,1804,demonhunter,havoc,64,41,23
Fellenkellar,stormrage,1804,demonhunter,havoc,144,80,64
Pythongodx,azralon,1804,demonhunter,havoc,156,83,73
Shadë,stormrage,1802,demonhunter,havoc,60,31,29
Dhkyun,tichondrius,1801,demonhunter,havoc,54,29,25
Wompo,wyrmrest-accord,1801,demonhunter,havoc,36,19,17
Plumkin,kiljaeden,1800,demonhunter,havoc,54,32,22
Icecokelime,black-dragonflight,1800,demonhunter,havoc,38,20,18
Tendies,tichondrius,1800,demonhunter,havoc,60,28,32
Azrethec,wyrmrest-accord,1799,demonhunter,havoc,126,69,57
Donaldjr,area-52,1798,demonhunter,havoc,69,42,27
Chulakels,tichondrius,1796,demonhunter,havoc,87,50,37
Basedmf,emerald-dream,1796,demonhunter,havoc,83,39,44
Vanarion,area-52,1796,demonhunter,havoc,90,38,52
Hueylucifer,ravencrest,1795,demonhunter,havoc,49,23,26
Hogmandh,illidan,1794,demonhunter,havoc,54,27,27
Deathbladezx,tichondrius,1794,demonhunter,havoc,53,24,29
Gtåte,azjolnerub,1793,demonhunter,havoc,78,31,47
Andthrx,area-52,1791,demonhunter,havoc,260,130,130
Nuktukdh,moon-guard,1791,demonhunter,havoc,68,30,38
Axalark,nemesis,1790,demonhunter,havoc,72,37,35
Sáìto,arthas,1788,demonhunter,havoc,53,34,19
Dyllen,tichondrius,1787,demonhunter,havoc,218,119,99
Thundiir,area-52,1786,demonhunter,havoc,113,58,55
Ferano,frostmourne,1783,demonhunter,havoc,259,132,127
Felswamp,zuljin,1782,demonhunter,havoc,132,67,65
Madepp,tichondrius,1782,demonhunter,havoc,54,27,27
Aryapudding,tichondrius,1779,demonhunter,havoc,58,28,30
Joshallen,malganis,1778,demonhunter,havoc,176,88,88
Syrio,frostmourne,1777,demonhunter,havoc,248,134,114
Deathsweep,tichondrius,1773,demonhunter,havoc,60,32,28
Demonsob,illidan,1772,demonhunter,havoc,59,22,37
Mevadow,bleeding-hollow,1768,demonhunter,havoc,126,57,69
Bbteaa,frostmourne,1765,demonhunter,havoc,206,107,99
Busta,dethecus,1765,demonhunter,havoc,71,34,37
Dawgzo,thunderhorn,1764,demonhunter,havoc,132,73,59
Obsidians,korgath,1763,demonhunter,havoc,119,68,51
Juiced,thunderhorn,1760,demonhunter,havoc,113,58,55
Lilise,kiljaeden,1760,demonhunter,havoc,108,54,54
Sucio,khaz-modan,1760,demonhunter,havoc,54,26,28
Tylersdh,illidan,1758,demonhunter,havoc,151,87,64
Ahsref,stormrage,1758,demonhunter,havoc,72,36,36
Tichóndrius,tichondrius,1756,demonhunter,havoc,189,104,85
Biognosis,ragnaros,1756,demonhunter,havoc,114,56,58
Pokemibut,frostmourne,1756,demonhunter,havoc,60,29,31
Bloodgash,tichondrius,1755,demonhunter,havoc,50,24,26
Icantseelol,sargeras,1754,demonhunter,havoc,102,56,46
Baka,grizzly-hills,1754,demonhunter,havoc,54,23,31
Antamoris,sargeras,1753,demonhunter,havoc,64,32,32
Saaldh,zuljin,1753,demonhunter,havoc,71,30,41
Xøtourlife,malganis,1751,demonhunter,havoc,76,38,38
Dhwhat,stormrage,1750,demonhunter,havoc,125,70,55
Gubydal,frostmourne,1750,demonhunter,havoc,53,29,24
Serb,chogall,1748,demonhunter,havoc,72,38,34
Isev,illidan,1748,demonhunter,havoc,42,21,21
Immortalsinz,dalaran,1747,demonhunter,havoc,112,48,64
Hoochee,lightnings-blade,1746,demonhunter,havoc,79,42,37
Noobstaa,area-52,1745,demonhunter,havoc,48,34,14
Decoherence,sargeras,1745,demonhunter,havoc,54,33,21
Ðavid,firetree,1745,demonhunter,havoc,96,48,48
Tenthslayer,frostmourne,1744,demonhunter,havoc,56,34,22
Deathlex,sargeras,1744,demonhunter,havoc,102,55,47
Càrnagex,tichondrius,1740,demonhunter,havoc,331,161,170
Lazydeamon,frostmourne,1740,demonhunter,havoc,60,26,34
Toteschatte,quelthalas,1739,demonhunter,havoc,96,49,47
Progenji,azralon,1738,demonhunter,havoc,60,35,25
Tundies,tichondrius,1738,demonhunter,havoc,48,25,23
Zatharas,stormrage,1738,demonhunter,havoc,128,63,65
Monfel,dalaran,1737,demonhunter,havoc,108,63,45
Praxx,veknilash,1736,demonhunter,havoc,60,26,34
Cheezitzz,tichondrius,1735,demonhunter,havoc,48,20,28
Raenorion,kelthuzad,1734,demonhunter,havoc,78,43,35
Wherwelandin,zuljin,1734,demonhunter,havoc,51,24,27
Dêspacito,tichondrius,1733,demonhunter,havoc,47,20,27
Cromosh,quelthalas,1733,demonhunter,havoc,90,38,52
Nips,lightnings-blade,1731,demonhunter,havoc,78,47,31
Scylus,tichondrius,1731,demonhunter,havoc,132,75,57
Raahjxz,sargeras,1730,demonhunter,havoc,108,61,47
Felnipz,tichondrius,1729,demonhunter,havoc,67,39,28
Beyondjerky,malganis,1726,demonhunter,havoc,52,27,25
Diequickly,tichondrius,1722,demonhunter,havoc,58,29,29
Croches,tichondrius,1721,demonhunter,havoc,36,18,18
Ðrogö,emerald-dream,1719,demonhunter,havoc,42,24,18
Fardyhole,illidan,1719,demonhunter,havoc,36,18,18
Sikarnix,stormrage,1719,demonhunter,havoc,84,38,46
Qixoni,emerald-dream,1719,demonhunter,havoc,66,29,37
Crittic,thrall,1717,demonhunter,havoc,106,48,58
Xeylin,sargeras,1715,demonhunter,havoc,83,48,35
Zcarfacee,frostmourne,1715,demonhunter,havoc,32,18,14
Ibdl,tichondrius,1714,demonhunter,havoc,30,18,12
Irisand,ragnaros,1714,demonhunter,havoc,83,40,43
Doeja,illidan,1713,demonhunter,havoc,30,18,12
Bloodhunter,exodar,1713,demonhunter,havoc,115,66,49
Thehonor,tichondrius,1713,demonhunter,havoc,65,36,29
Ídunno,kiljaeden,1713,demonhunter,havoc,60,30,30
Ilìdarì,zuljin,1710,demonhunter,havoc,39,23,16
Aetheris,bleeding-hollow,1709,demonhunter,havoc,78,34,44
Sheldoncoop,emerald-dream,1706,demonhunter,havoc,36,18,18
Asheng,cairne,1706,demonhunter,havoc,63,30,33
Namaga,illidan,1704,demonhunter,havoc,66,45,21
Firstsol,stormrage,1704,demonhunter,havoc,78,44,34
Rôsè,tichondrius,1704,demonhunter,havoc,88,49,39
Glaivediggar,barthilas,1704,demonhunter,havoc,201,98,103
Wildh,stormrage,1702,demonhunter,havoc,78,41,37
Felgobbler,zuljin,1701,demonhunter,havoc,72,38,34
Gamernation,area-52,1701,demonhunter,havoc,93,47,46
Baikudyn,darkspear,1700,demonhunter,havoc,36,22,14
Ethhunter,proudmoore,1700,demonhunter,havoc,78,39,39
Nopohunter,burning-blade,1699,demonhunter,havoc,47,31,16
Deviljane,illidan,1699,demonhunter,havoc,30,18,12
Stochastic,ragnaros,1699,demonhunter,havoc,115,63,52
Azexion,malganis,1699,demonhunter,havoc,126,64,62
Lazygågå,zuljin,1697,demonhunter,havoc,40,22,18
Vendeem,moonrunner,1697,demonhunter,havoc,104,56,48
Mewmewkitty,tichondrius,1697,demonhunter,havoc,40,21,19
Johnconnor,tichondrius,1696,demonhunter,havoc,53,20,33
Chiesa,sargeras,1695,demonhunter,havoc,34,27,7
Zzoecita,drakkari,1695,demonhunter,havoc,54,28,26
Purplekuush,bleeding-hollow,1695,demonhunter,havoc,90,45,45
Chäos,proudmoore,1695,demonhunter,havoc,153,76,77
Vynthar,wyrmrest-accord,1694,demonhunter,havoc,189,96,93
Remh,bleeding-hollow,1693,demonhunter,havoc,296,150,146
Devirador,ragnaros,1692,demonhunter,havoc,125,60,65
Munyanyô,moon-guard,1691,demonhunter,havoc,41,26,15
Speedh,area-52,1691,demonhunter,havoc,36,18,18
Deaforalive,malganis,1690,demonhunter,havoc,96,54,42
Randomdh,zuljin,1690,demonhunter,havoc,49,27,22
Cöcainë,stormrage,1689,demonhunter,havoc,36,24,12
Idontfaced,area-52,1689,demonhunter,havoc,52,32,20
Fasnk,tichondrius,1689,demonhunter,havoc,48,25,23
Sarÿnrae,malganis,1687,demonhunter,havoc,48,29,19
Bigtitiemilk,tichondrius,1684,demonhunter,havoc,52,31,21
Wickbeams,barthilas,1684,demonhunter,havoc,59,28,31
Blúr,tichondrius,1683,demonhunter,havoc,41,23,18
Sicknizzle,area-52,1682,demonhunter,havoc,132,68,64
Neverblurx,kirin-tor,1681,demonhunter,havoc,42,20,22
Ihuntmufasa,tichondrius,1679,demonhunter,havoc,48,28,20
Xylëm,tichondrius,1678,demonhunter,havoc,72,29,43
Yaety,tichondrius,1677,demonhunter,havoc,70,42,28
Demabrak,azralon,1677,demonhunter,havoc,53,25,28
Icrazedcruxl,gnomeregan,1676,demonhunter,havoc,54,27,27
Skyfly,stormscale,1675,demonhunter,havoc,72,35,37
Buddyyguy,illidan,1675,demonhunter,havoc,102,45,57
Ntts,tichondrius,1674,demonhunter,havoc,53,25,28
Folkmagic,proudmoore,1673,demonhunter,havoc,30,18,12
Atomicsorrow,tichondrius,1673,demonhunter,havoc,62,28,34
Harríson,tichondrius,1672,demonhunter,havoc,120,57,63
Needlepoint,illidan,1671,demonhunter,havoc,119,66,53
Dingowango,illidan,1671,demonhunter,havoc,66,33,33
Felontis,sargeras,1671,demonhunter,havoc,60,28,32
Alast,emerald-dream,1670,demonhunter,havoc,66,35,31
Imaginedmg,illidan,1668,demonhunter,havoc,60,28,32
Ùnlucky,tichondrius,1667,demonhunter,havoc,33,23,10
Gamgeum,tichondrius,1667,demonhunter,havoc,36,23,13
Chingiz,dunemaul,1666,demonhunter,havoc,45,23,22
Sadpepe,bleeding-hollow,1666,demonhunter,havoc,60,29,31
Ravana,khaz-modan,1664,demonhunter,havoc,112,60,52
Stellartv,tichondrius,1664,demonhunter,havoc,174,84,90
Bobbyhill,nordrassil,1664,demonhunter,havoc,59,26,33
Hròðvitnir,quelthalas,1663,demonhunter,havoc,104,63,41
Taylordem,tichondrius,1662,demonhunter,havoc,42,23,19
Larandaa,sargeras,1662,demonhunter,havoc,84,43,41
Sheepone,tichondrius,1661,demonhunter,havoc,42,31,11
Boagz,area-52,1660,demonhunter,havoc,84,48,36
Azinoht,ragnaros,1660,demonhunter,havoc,210,102,108
Allidox,tichondrius,1660,demonhunter,havoc,54,26,28
Kioka,khaz-modan,1659,demonhunter,havoc,34,20,14
Coaa,dalaran,1659,demonhunter,havoc,59,31,28
Churchpls,stormrage,1659,demonhunter,havoc,58,23,35
Dragonÿx,ragnaros,1658,demonhunter,havoc,157,83,74
Achemedåche,dalaran,1657,demonhunter,havoc,33,22,11
Joric,dalaran,1657,demonhunter,havoc,66,40,26
Ethingy,emerald-dream,1656,demonhunter,havoc,36,22,14
Torments,area-52,1655,demonhunter,havoc,60,34,26
Getpoodon,sargeras,1655,demonhunter,havoc,36,18,18
Zikzlol,tichondrius,1654,demonhunter,havoc,44,21,23
Entropics,tichondrius,1653,demonhunter,havoc,47,32,15
Whysoospicy,wyrmrest-accord,1653,demonhunter,havoc,48,29,19
Hundredeye,malganis,1652,demonhunter,havoc,70,32,38
Ðaredevil,azralon,1650,demonhunter,havoc,36,22,14
Chîsäki,quelthalas,1649,demonhunter,havoc,75,40,35
Shadöw,emerald-dream,1649,demonhunter,havoc,45,22,23
Warlasher,zuljin,1648,demonhunter,havoc,252,131,121
Vapegodxqt,aegwynn,1647,demonhunter,havoc,50,25,25
Sätän,malganis,1646,demonhunter,havoc,42,25,17
Shyisback,area-52,1645,demonhunter,havoc,138,77,61
Ironsightsdh,dalaran,1645,demonhunter,havoc,89,47,42
Sarynrae,malganis,1644,demonhunter,havoc,52,24,28
Çhan,tichondrius,1643,demonhunter,havoc,311,157,154
Valerrias,area-52,1643,demonhunter,havoc,42,21,21
Junmà,tichondrius,1642,demonhunter,havoc,72,42,30
Rune,dathremar,1642,demonhunter,havoc,48,23,25
Malthazaan,stormrage,1641,demonhunter,havoc,38,22,16
Demoncastx,tichondrius,1641,demonhunter,havoc,107,60,47
Jpdh,frostmourne,1641,demonhunter,havoc,80,44,36
Imlikethat,gorefiend,1639,demonhunter,havoc,42,23,19
Unkiteable,malganis,1639,demonhunter,havoc,41,20,21
Jcosta,tichondrius,1639,demonhunter,havoc,109,50,59
Snózberry,illidan,1639,demonhunter,havoc,81,37,44
Xenore,emerald-dream,1638,demonhunter,havoc,71,31,40
Viio,proudmoore,1637,demonhunter,havoc,36,21,15
Hisso,nordrassil,1637,demonhunter,havoc,66,36,30
Tychondrius,earthen-ring,1637,demonhunter,havoc,208,111,97
Jaauk,ragnaros,1636,demonhunter,havoc,58,25,33
Blurblurblur,frostmourne,1635,demonhunter,havoc,60,25,35
Synthwäve,area-52,1634,demonhunter,havoc,36,23,13
Tubaki,tichondrius,1634,demonhunter,havoc,47,21,26
Killuaqt,frostmourne,1633,demonhunter,havoc,53,28,25
Luthianna,amanthul,1632,demonhunter,havoc,40,24,16
Bremdh,thrall,1632,demonhunter,havoc,44,25,19
Accidcleaves,sargeras,1632,demonhunter,havoc,60,32,28
Seraphïel,khaz-modan,1631,demonhunter,havoc,36,23,13
Taatted,emerald-dream,1631,demonhunter,havoc,54,28,26
Xanthalos,wyrmrest-accord,1630,demonhunter,havoc,173,83,90
Trindh,thrall,1629,demonhunter,havoc,56,36,20
Cezkia,hyjal,1629,demonhunter,havoc,72,36,36
Iliillii,emerald-dream,1629,demonhunter,havoc,75,31,44
Hoonjojjyana,tichondrius,1628,demonhunter,havoc,52,23,29
Trilidan,proudmoore,1627,demonhunter,havoc,37,21,16
Kìed,kiljaeden,1627,demonhunter,havoc,54,25,29
Stefdh,tichondrius,1627,demonhunter,havoc,51,23,28
Thelor,frostmourne,1626,demonhunter,havoc,48,28,20
Xday,tichondrius,1626,demonhunter,havoc,258,132,126
Rekttx,area-52,1625,demonhunter,havoc,64,34,30
Nåx,bleeding-hollow,1624,demonhunter,havoc,36,21,15
Doomtower,tichondrius,1624,demonhunter,havoc,135,70,65
Gymnast,thaurissan,1624,demonhunter,havoc,54,23,31
Calmbefore,tichondrius,1623,demonhunter,havoc,29,22,7
Cuper,tichondrius,1623,demonhunter,havoc,72,41,31
Perspirant,malganis,1623,demonhunter,havoc,41,23,18
Souliz,tichondrius,1622,demonhunter,havoc,83,43,40
Sivà,tichondrius,1622,demonhunter,havoc,69,35,34
Zeroheaven,stormrage,1621,demonhunter,havoc,48,19,29
Hehehaha,wyrmrest-accord,1620,demonhunter,havoc,30,20,10
Mustardtigër,bleeding-hollow,1620,demonhunter,havoc,35,21,14
Amanthx,tichondrius,1620,demonhunter,havoc,54,27,27
Danloesh,silver-hand,1619,demonhunter,havoc,42,22,20
Ohanadh,ragnaros,1618,demonhunter,havoc,48,19,29
Zachfortnite,emerald-dream,1616,demonhunter,havoc,30,19,11
Flirtyscythe,illidan,1616,demonhunter,havoc,69,33,36
Fingersdh,malganis,1616,demonhunter,havoc,96,45,51
Draenkz,ragnaros,1616,demonhunter,havoc,58,19,39
Glaivia,bleeding-hollow,1615,demonhunter,havoc,36,17,19
Gumeasy,tichondrius,1615,demonhunter,havoc,48,21,27
Cococat,tichondrius,1615,demonhunter,havoc,80,30,50
Velana,tichondrius,1614,demonhunter,havoc,30,21,9
Ptsdh,bloodhoof,1614,demonhunter,havoc,78,43,35
Benová,tichondrius,1614,demonhunter,havoc,49,22,27
Fleetop,tichondrius,1613,demonhunter,havoc,90,51,39
Taszyn,blackrock,1613,demonhunter,havoc,92,51,41
Karmakula,tichondrius,1613,demonhunter,havoc,77,39,38
Neodin,tichondrius,1612,demonhunter,havoc,61,35,26
Ossariss,moon-guard,1610,demonhunter,havoc,30,17,13
Mazakein,tichondrius,1610,demonhunter,havoc,66,37,29
Cots,stormrage,1610,demonhunter,havoc,148,82,66
Bitskii,kelthuzad,1610,demonhunter,havoc,47,21,26
Nistrin,area-52,1609,demonhunter,havoc,72,40,32
Diablitaa,sargeras,1609,demonhunter,havoc,36,17,19
Crixxus,zuljin,1609,demonhunter,havoc,48,20,28
Haades,proudmoore,1608,demonhunter,havoc,106,60,46
Yiptaw,area-52,1608,demonhunter,havoc,55,29,26
Feníxx,ragnaros,1608,demonhunter,havoc,88,45,43
Omygaud,tichondrius,1607,demonhunter,havoc,48,32,16
Balancedtoon,tichondrius,1607,demonhunter,havoc,94,49,45
Turecdh,illidan,1607,demonhunter,havoc,56,19,37
Vândel,kelthuzad,1606,demonhunter,havoc,105,49,56
Dhyzz,proudmoore,1605,demonhunter,havoc,49,28,21
Zeane,tichondrius,1605,demonhunter,havoc,51,29,22
Abigëil,quelthalas,1605,demonhunter,havoc,56,31,25
Mavrush,malganis,1604,demonhunter,havoc,54,31,23
Bigflopper,malganis,1604,demonhunter,havoc,102,55,47
Pragma,thrall,1604,demonhunter,havoc,231,124,107
Daymanhunter,bleeding-hollow,1603,demonhunter,havoc,103,53,50
Kaedri,burning-blade,1603,demonhunter,havoc,141,68,73
Iluvboóty,blackrock,1603,demonhunter,havoc,60,27,33
Sìlençe,illidan,1602,demonhunter,havoc,29,19,10
Hëll,spirestone,1602,demonhunter,havoc,36,21,15
Shale,gilneas,1602,demonhunter,havoc,70,35,35
Ariodh,area-52,1602,demonhunter,havoc,36,17,19
Dantesabyss,proudmoore,1600,demonhunter,havoc,107,53,54
Sävage,zuljin,1599,demonhunter,havoc,37,22,15
Gesture,malganis,1599,demonhunter,havoc,166,91,75
Demonhunter,kirin-tor,1599,demonhunter,havoc,108,54,54
Dadoftheyear,destromath,1598,demonhunter,havoc,72,41,31
Scoplyn,malfurion,1598,demonhunter,havoc,78,41,37
Nichousha,tichondrius,1598,demonhunter,havoc,42,21,21
Steeler,shandris,1597,demonhunter,havoc,78,40,38
Alwaysin,zuljin,1595,demonhunter,havoc,44,27,17
Arête,malganis,1595,demonhunter,havoc,67,31,36
Darkrasta,ragnaros,1594,demonhunter,havoc,108,50,58
Rennae,zuljin,1593,demonhunter,havoc,41,18,23
Netherbane,azgalor,1592,demonhunter,havoc,96,44,52
Italoo,ragnaros,1591,demonhunter,havoc,60,34,26
Eugenyackle,bleeding-hollow,1589,demonhunter,havoc,54,38,16
Nándÿ,tichondrius,1589,demonhunter,havoc,67,36,31
Malefisentt,firetree,1589,demonhunter,havoc,45,22,23
Jk,dreadmaul,1588,demonhunter,havoc,81,45,36
Wsickformula,gilneas,1588,demonhunter,havoc,127,70,57
Shadowmoonz,frostmourne,1588,demonhunter,havoc,59,28,31
Watsinthebox,thrall,1586,demonhunter,havoc,30,20,10
Theprodigy,malganis,1586,demonhunter,havoc,130,60,70
Littlewolfie,illidan,1585,demonhunter,havoc,60,31,29
Demonfarter,tichondrius,1585,demonhunter,havoc,126,64,62
Kryuwu,stormrage,1585,demonhunter,havoc,42,19,23
Gaìjîn,barthilas,1583,demonhunter,havoc,156,87,69
Knuckifubuck,frostwolf,1582,demonhunter,havoc,142,77,65
Ruffolina,azralon,1582,demonhunter,havoc,204,105,99
Chinadh,tichondrius,1581,demonhunter,havoc,35,17,18
Vegêta,malganis,1580,demonhunter,havoc,72,42,30
Supadupä,stormrage,1580,demonhunter,havoc,30,17,13
Nuggetx,lightnings-blade,1580,demonhunter,havoc,54,29,25
Kaelclaira,dalvengyr,1580,demonhunter,havoc,60,29,31
Khaito,illidan,1580,demonhunter,havoc,53,23,30
Jaybeezy,balnazzar,1580,demonhunter,havoc,42,18,24
Phaintx,tichondrius,1579,demonhunter,havoc,60,29,31
Yuppx,tichondrius,1578,demonhunter,havoc,48,29,19
Mcspicyy,tichondrius,1578,demonhunter,havoc,42,22,20
Darknezzl,ragnaros,1578,demonhunter,havoc,134,66,68
Corngodx,sargeras,1578,demonhunter,havoc,102,50,52
Thêdràïñgáñg,jubeithos,1574,demonhunter,havoc,36,18,18
Baalböski,tichondrius,1574,demonhunter,havoc,88,41,47
Reito,ragnaros,1572,demonhunter,havoc,59,31,28
Diiecrux,bleeding-hollow,1571,demonhunter,havoc,36,20,16
Derperhunter,kiljaeden,1570,demonhunter,havoc,102,56,46
Beniesdh,frostmourne,1570,demonhunter,havoc,42,22,20
Velravyn,moon-guard,1570,demonhunter,havoc,73,38,35
Narandra,malganis,1569,demonhunter,havoc,48,19,29
Nuredmyy,illidan,1568,demonhunter,havoc,60,34,26
Kaelthys,nordrassil,1568,demonhunter,havoc,87,48,39
Fourbuttonsx,sargeras,1566,demonhunter,havoc,51,26,25
Babahorns,dalaran,1566,demonhunter,havoc,48,18,30
Stacheaction,sargeras,1565,demonhunter,havoc,48,25,23
Radamanthysi,azralon,1564,demonhunter,havoc,102,64,38
Énchantress,thrall,1564,demonhunter,havoc,60,29,31
Wormli,moon-guard,1562,demonhunter,havoc,88,51,37
Nomfries,malganis,1560,demonhunter,havoc,52,27,25
Imwhack,frostmane,1559,demonhunter,havoc,73,39,34
Mood,stonemaul,1558,demonhunter,havoc,84,47,37
Dankhuntér,zuljin,1558,demonhunter,havoc,54,20,34
Luribel,tichondrius,1556,demonhunter,havoc,77,40,37
Nocturnale,ragnaros,1555,demonhunter,havoc,100,49,51
Gorillidan,kelthuzad,1553,demonhunter,havoc,30,18,12
Rytesx,moon-guard,1552,demonhunter,havoc,75,53,22
Ossivil,ragnaros,1551,demonhunter,havoc,138,64,74
Kuramou,area-52,1547,demonhunter,havoc,36,22,14
Sineex,illidan,1547,demonhunter,havoc,42,24,18
Bromosapien,tichondrius,1547,demonhunter,havoc,39,19,20
Poogzzig,tichondrius,1547,demonhunter,havoc,132,63,69
Magenie,korgath,1544,demonhunter,havoc,41,25,16
Gazza,eldrethalas,1544,demonhunter,havoc,48,28,20
Dealer,frostmourne,1542,demonhunter,havoc,114,51,63
Joegamer,illidan,1541,demonhunter,havoc,66,34,32
Shadevon,wyrmrest-accord,1540,demonhunter,havoc,28,19,9
Anathørn,ragnaros,1540,demonhunter,havoc,54,26,28
Kssmee,korgath,1539,demonhunter,havoc,126,65,61
Blackmvp,tichondrius,1537,demonhunter,havoc,24,17,7
Falaisper,tichondrius,1537,demonhunter,havoc,36,25,11
Cäldo,tichondrius,1537,demonhunter,havoc,36,21,15
Billmcawsom,proudmoore,1537,demonhunter,havoc,78,35,43
Jaysavage,eitrigg,1536,demonhunter,havoc,113,59,54
Surå,tichondrius,1536,demonhunter,havoc,108,51,57
Wikkidd,thrall,1535,demonhunter,havoc,53,24,29
Furiel,quelthalas,1534,demonhunter,havoc,44,26,18
Jhinskui,drakkari,1533,demonhunter,havoc,119,58,61
Kenmu,ragnaros,1533,demonhunter,havoc,97,42,55
Doxdevil,tichondrius,1533,demonhunter,havoc,57,19,38
Karmadh,malganis,1531,demonhunter,havoc,60,30,30
Cavell,tichondrius,1529,demonhunter,havoc,30,16,14
Rôrônôâzôrô,stormrage,1529,demonhunter,havoc,59,30,29
Subieshift,sargeras,1529,demonhunter,havoc,43,20,23
Ezoen,mannoroth,1529,demonhunter,havoc,40,18,22
Papaelf,thunderlord,1528,demonhunter,havoc,48,33,15
Coohiyan,tichondrius,1527,demonhunter,havoc,49,30,19
Beastbringer,proudmoore,1527,demonhunter,havoc,171,96,75
Spasmodiic,illidan,1527,demonhunter,havoc,57,31,26
Dirtylatin,ragnaros,1526,demonhunter,havoc,54,31,23
Brútalgore,area-52,1526,demonhunter,havoc,218,112,106
Crayoz,tichondrius,1525,demonhunter,havoc,137,76,61
Pubelice,draenor,1525,demonhunter,havoc,74,40,34
Emopidgeon,dalaran,1525,demonhunter,havoc,30,16,14
Mattdizzle,illidan,1524,demonhunter,havoc,24,17,7
Fiveiq,malganis,1524,demonhunter,havoc,27,17,10
Knshy,azralon,1524,demonhunter,havoc,69,34,35
Minar,tichondrius,1524,demonhunter,havoc,93,45,48
Ilydos,emerald-dream,1523,demonhunter,havoc,118,61,57
Luminesce,tichondrius,1523,demonhunter,havoc,36,16,20
Raith,khazgoroth,1522,demonhunter,havoc,67,39,28
Gènji,tichondrius,1522,demonhunter,havoc,30,16,14
Demontrue,tichondrius,1522,demonhunter,havoc,80,42,38
Papazaraki,tichondrius,1521,demonhunter,havoc,42,23,19
Yqpro,tichondrius,1521,demonhunter,havoc,131,67,64
Bjj,bonechewer,1520,demonhunter,havoc,118,69,49
Ðemonix,tichondrius,1519,demonhunter,havoc,71,27,44
Noztak,area-52,1519,demonhunter,havoc,48,16,32
Xaneuma,nemesis,1517,demonhunter,havoc,37,19,18
Rêliç,sargeras,1516,demonhunter,havoc,30,18,12
Checkmate,bleeding-hollow,1515,demonhunter,havoc,42,18,24
Eyecandyxo,grizzly-hills,1514,demonhunter,havoc,79,43,36
Sikäria,malganis,1513,demonhunter,havoc,48,27,21
Mileze,area-52,1513,demonhunter,havoc,96,39,57
Deadpixellz,illidan,1511,demonhunter,havoc,76,39,37
Redkin,moon-guard,1510,demonhunter,havoc,86,46,40
Businessmaam,malganis,1508,demonhunter,havoc,36,20,16
Demodorn,frostmane,1507,demonhunter,havoc,72,40,32
Gittgudd,area-52,1507,demonhunter,havoc,87,45,42
Dammitbôbby,tichondrius,1505,demonhunter,havoc,127,66,61
Dirtbag,tichondrius,1503,demonhunter,havoc,30,16,14
Vareon,nesingwary,1502,demonhunter,havoc,29,21,8
Gravebirth,tichondrius,1502,demonhunter,havoc,38,24,14
Enfirok,duskwood,1501,demonhunter,havoc,300,153,147
Kakster,tichondrius,1500,demonhunter,havoc,84,49,35
Macacøbrr,azralon,1498,demonhunter,havoc,76,37,39
Bogdan,azjolnerub,1497,demonhunter,havoc,84,43,41
Vilal,dalaran,1496,demonhunter,havoc,38,28,10
Antaris,stonemaul,1495,demonhunter,havoc,42,20,22
Alli,bleeding-hollow,1494,demonhunter,havoc,69,39,30
Ralløszek,illidan,1494,demonhunter,havoc,48,26,22
Træt,emerald-dream,1494,demonhunter,havoc,83,42,41
Xionas,moon-guard,1494,demonhunter,havoc,180,90,90
Thgyjufdgh,smolderthorn,1493,demonhunter,havoc,109,55,54
Hemmerdainz,kelthuzad,1492,demonhunter,havoc,66,30,36
Sternhunt,khadgar,1491,demonhunter,havoc,78,36,42
Scriptyscrip,dark-iron,1491,demonhunter,havoc,192,86,106
Zigzagrat,sargeras,1490,demonhunter,havoc,89,44,45
Croisoi,ragnaros,1490,demonhunter,havoc,78,38,40
Îllîdàn,tichondrius,1488,demonhunter,havoc,45,22,23
Hellmetal,quelthalas,1488,demonhunter,havoc,36,17,19
Dashxo,tichondrius,1487,demonhunter,havoc,36,17,19
Dmonslayer,daggerspine,1487,demonhunter,havoc,60,23,37
Apõz,tichondrius,1486,demonhunter,havoc,30,16,14
Emeress,illidan,1486,demonhunter,havoc,57,26,31
Orgasmia,tichondrius,1486,demonhunter,havoc,106,32,74
Bofxo,sargeras,1485,demonhunter,havoc,59,29,30
Antistar,emerald-dream,1483,demonhunter,havoc,62,22,40
Exequion,ragnaros,1482,demonhunter,havoc,200,109,91
Kimjonguun,tichondrius,1481,demonhunter,havoc,32,22,10
Sammyvicious,tichondrius,1481,demonhunter,havoc,34,22,12
Órph,sargeras,1481,demonhunter,havoc,48,26,22
Halleblurry,dalaran,1481,demonhunter,havoc,66,34,32
Häruun,quelthalas,1480,demonhunter,havoc,53,29,24
Huntoneshot,bleeding-hollow,1480,demonhunter,havoc,61,33,28
Wowomg,tichondrius,1477,demonhunter,havoc,36,20,16
Nooksuh,bleeding-hollow,1473,demonhunter,havoc,29,16,13
Eazyrat,stormrage,1472,demonhunter,havoc,48,33,15
Sëlene,antonidas,1471,demonhunter,havoc,89,44,45
Røllnautløw,aegwynn,1469,demonhunter,havoc,32,22,10
Kegu,stormrage,1469,demonhunter,havoc,54,20,34
Greent,stormrage,1468,demonhunter,havoc,60,39,21
Elidani,area-52,1468,demonhunter,havoc,78,38,40
Gomesdhunter,azralon,1466,demonhunter,havoc,88,47,41
Sätyr,bleeding-hollow,1466,demonhunter,havoc,54,19,35
Zunfooki,stormrage,1464,demonhunter,havoc,30,17,13
Ïtzpåpåløtl,tichondrius,1464,demonhunter,havoc,77,38,39
Ðarkone,ragnaros,1464,demonhunter,havoc,42,17,25
Hàuntress,saurfang,1463,demonhunter,havoc,90,50,40
Derelikte,shadowmoon,1462,demonhunter,havoc,34,20,14
Vlääd,ragnaros,1462,demonhunter,havoc,198,97,101
Nepzz,stormrage,1461,demonhunter,havoc,78,44,34
Eery,tichondrius,1461,demonhunter,havoc,71,35,36
Doomtots,kelthuzad,1460,demonhunter,havoc,30,17,13
Flyudzhin,azgalor,1460,demonhunter,havoc,153,71,82
Mamif,korgath,1460,demonhunter,havoc,68,31,37
Cocomeld,tichondrius,1459,demonhunter,havoc,30,16,14
Loreney,quelthalas,1459,demonhunter,havoc,138,66,72
Hellnkeller,tichondrius,1459,demonhunter,havoc,36,16,20
Somethingstu,sargeras,1458,demonhunter,havoc,28,18,10
Rem,stormrage,1458,demonhunter,havoc,93,53,40
Savetar,thrall,1458,demonhunter,havoc,30,17,13
Gohamx,illidan,1457,demonhunter,havoc,110,54,56
Felseal,frostmourne,1456,demonhunter,havoc,53,34,19
Tyredris,kelthuzad,1456,demonhunter,havoc,56,30,26
Telmordrin,azralon,1456,demonhunter,havoc,86,45,41
Nekrosdaeva,zuljin,1455,demonhunter,havoc,73,40,33
Sciatic,area-52,1454,demonhunter,havoc,68,33,35
Jiujitsuu,bleeding-hollow,1454,demonhunter,havoc,49,21,28
Metabeam,tichondrius,1451,demonhunter,havoc,54,34,20
Devilkon,tichondrius,1451,demonhunter,havoc,42,22,20
Xillidan,area-52,1450,demonhunter,havoc,112,70,42
Ehrapist,kelthuzad,1450,demonhunter,havoc,36,19,17
Kelmar,stormreaver,1449,demonhunter,havoc,38,16,22
Wokeaf,malganis,1448,demonhunter,havoc,35,16,19
Layli,azralon,1447,demonhunter,havoc,54,34,20
Yukisyn,proudmoore,1447,demonhunter,havoc,126,70,56
Bucx,barthilas,1445,demonhunter,havoc,60,36,24
Nicodine,tichondrius,1445,demonhunter,havoc,63,34,29
Netherbird,malganis,1442,demonhunter,havoc,24,16,8
Faphunter,illidan,1441,demonhunter,havoc,87,50,37
Gwendanzig,zangarmarsh,1440,demonhunter,havoc,72,37,35
Sourlime,stormrage,1440,demonhunter,havoc,41,18,23
Vellestia,argent-dawn,1440,demonhunter,havoc,71,31,40
Zerotwox,thrall,1440,demonhunter,havoc,60,23,37
Absinith,jubeithos,1439,demonhunter,havoc,46,29,17
Allyrian,sargeras,1439,demonhunter,havoc,174,93,81
Catastrophis,tichondrius,1438,demonhunter,havoc,57,32,25
Molchamp,kelthuzad,1438,demonhunter,havoc,60,27,33
Feelmybush,barthilas,1438,demonhunter,havoc,78,32,46
Sorrybadgas,illidan,1438,demonhunter,havoc,48,18,30
Demonfused,illidan,1437,demonhunter,havoc,82,41,41
Lravanal,quelthalas,1435,demonhunter,havoc,24,17,7
Fametrap,tichondrius,1435,demonhunter,havoc,24,15,9
ßlurr,moon-guard,1435,demonhunter,havoc,114,63,51
Genruis,area-52,1435,demonhunter,havoc,73,37,36
Broneill,blood-furnace,1435,demonhunter,havoc,60,27,33
Doomsday,kargath,1434,demonhunter,havoc,18,15,3
Erandrida,frostmourne,1434,demonhunter,havoc,57,25,32
Beastsburdun,zuljin,1433,demonhunter,havoc,24,15,9
Backtolumby,bleeding-hollow,1433,demonhunter,havoc,65,36,29
Ocão,azralon,1433,demonhunter,havoc,48,23,25
Ranir,doomhammer,1433,demonhunter,havoc,104,49,55
Nismoos,daggerspine,1433,demonhunter,havoc,36,16,20
Hollowxo,tichondrius,1432,demonhunter,havoc,30,15,15
Zztzz,illidan,1431,demonhunter,havoc,30,15,15
Kyuno,eitrigg,1431,demonhunter,havoc,60,28,32
Remuko,tichondrius,1430,demonhunter,havoc,30,15,15
Dridri,quelthalas,1430,demonhunter,havoc,44,21,23
Mybus,tichondrius,1430,demonhunter,havoc,90,42,48
Glaivez,korgath,1429,demonhunter,havoc,24,15,9
Raylêy,tichondrius,1429,demonhunter,havoc,30,15,15
Nightcráwler,malganis,1429,demonhunter,havoc,30,15,15
Unjusthunt,magtheridon,1429,demonhunter,havoc,30,15,15
Egirlhunter,echo-isles,1429,demonhunter,havoc,30,15,15
Trillidan,mugthol,1429,demonhunter,havoc,36,15,21
Chimpers,illidan,1429,demonhunter,havoc,42,15,27
Stavroseus,area-52,1428,demonhunter,havoc,30,19,11
Iim,tichondrius,1428,demonhunter,havoc,87,35,52
Mysteryastor,tichondrius,1427,demonhunter,havoc,92,44,48
Crankbaz,malganis,1426,demonhunter,havoc,24,15,9
Rhadê,ragnaros,1426,demonhunter,havoc,30,16,14
Hongnara,tichondrius,1426,demonhunter,havoc,30,16,14
Stalkdemon,azralon,1426,demonhunter,havoc,30,15,15
Demonaco,tichondrius,1426,demonhunter,havoc,52,19,33
Overtakeyou,azralon,1425,demonhunter,havoc,24,15,9
Nowaifai,tichondrius,1425,demonhunter,havoc,36,17,19
Goldsgym,boulderfist,1424,demonhunter,havoc,28,17,11
Wangasaurus,emerald-dream,1424,demonhunter,havoc,60,28,32
Postodesaúde,azralon,1424,demonhunter,havoc,36,15,21
Superlative,area-52,1423,demonhunter,havoc,24,15,9
Nightshadeia,tichondrius,1423,demonhunter,havoc,36,15,21
Thebojanglz,frostmourne,1421,demonhunter,havoc,25,16,9
Nupx,frostmourne,1420,demonhunter,havoc,39,20,19
Odio,chromaggus,1420,demonhunter,havoc,30,15,15
Devastation,tichondrius,1420,demonhunter,havoc,72,34,38
Pigmah,malganis,1420,demonhunter,havoc,40,17,23
Creamboi,stormrage,1419,demonhunter,havoc,34,19,15
Valka,emerald-dream,1419,demonhunter,havoc,141,74,67
Falachio,tichondrius,1419,demonhunter,havoc,129,66,63
Adhdh,haomarush,1418,demonhunter,havoc,24,15,9
Viismoke,thaurissan,1418,demonhunter,havoc,48,28,20
Ylydary,ragnaros,1418,demonhunter,havoc,122,64,58
Talyethsam,shadowsong,1418,demonhunter,havoc,32,16,16
Crtiicosdh,madoran,1418,demonhunter,havoc,36,17,19
Bezmon,silvermoon,1416,demonhunter,havoc,30,19,11
Dèmonhuntèr,tichondrius,1415,demonhunter,havoc,140,67,73
Ikilldemonz,thrall,1415,demonhunter,havoc,42,19,23
Chkclapper,kelthuzad,1414,demonhunter,havoc,36,17,19
Christensen,illidan,1413,demonhunter,havoc,114,66,48
Moredread,sargeras,1413,demonhunter,havoc,48,25,23
Tickelfist,zuljin,1413,demonhunter,havoc,115,59,56
Báléríón,area-52,1412,demonhunter,havoc,65,39,26
Kalmor,barthilas,1412,demonhunter,havoc,87,44,43
Cheriste,malganis,1412,demonhunter,havoc,38,16,22
Miroir,silvermoon,1411,demonhunter,havoc,196,99,97
Grizzop,sargeras,1411,demonhunter,havoc,120,59,61
Mavèrick,thrall,1411,demonhunter,havoc,63,29,34
Oxyoxy,illidan,1410,demonhunter,havoc,37,23,14
Vyndrestan,dalaran,1410,demonhunter,havoc,30,15,15
Colinn,illidan,1409,demonhunter,havoc,42,25,17
Mintjoa,tichondrius,1409,demonhunter,havoc,30,15,15
Bijix,area-52,1408,demonhunter,havoc,55,35,20
Cybertrax,tichondrius,1408,demonhunter,havoc,24,15,9
Tharzadan,quelthalas,1407,demonhunter,havoc,65,33,32
Loadedtruck,frostmourne,1406,demonhunter,havoc,66,39,27
Salomesalvi,proudmoore,1405,demonhunter,havoc,36,24,12
Powertaco,tichondrius,1405,demonhunter,havoc,90,46,44
Grumblepuppy,hyjal,1404,demonhunter,havoc,41,18,23
Narchis,malganis,1403,demonhunter,havoc,30,17,13
Zackfair,burning-legion,1403,demonhunter,havoc,123,60,63
Behemod,thrall,1403,demonhunter,havoc,36,15,21
Naelaksa,tichondrius,1402,demonhunter,havoc,42,17,25
Yodiegang,nazgrel,1400,demonhunter,havoc,24,15,9
Demonicfish,malganis,1400,demonhunter,havoc,72,40,32
Noxon,stormrage,1400,demonhunter,havoc,98,50,48
Intensè,proudmoore,1400,demonhunter,havoc,42,18,24
Illusiondh,tichondrius,1398,demonhunter,havoc,99,58,41
Plasticbagel,frostmourne,1397,demonhunter,havoc,48,25,23
Creãtuss,area-52,1395,demonhunter,havoc,79,39,40
Phoébé,drakkari,1394,demonhunter,havoc,36,19,17
Softkyll,area-52,1394,demonhunter,havoc,369,191,178
Kushidari,tichondrius,1393,demonhunter,havoc,154,83,71
Cherlas,blood-furnace,1393,demonhunter,havoc,99,52,47
Xiaochicken,tichondrius,1393,demonhunter,havoc,73,36,37
Yaakee,tichondrius,1391,demonhunter,havoc,54,33,21
Sekiro,illidan,1391,demonhunter,havoc,41,22,19
Hoein,eldrethalas,1390,demonhunter,havoc,137,76,61
Hugehogger,boulderfist,1390,demonhunter,havoc,30,15,15
Swarlee,kiljaeden,1389,demonhunter,havoc,89,49,40
Siksix,bleeding-hollow,1389,demonhunter,havoc,54,27,27
Yåkuza,daggerspine,1389,demonhunter,havoc,175,83,92
Maisus,illidan,1388,demonhunter,havoc,36,16,20
Roesh,amanthul,1388,demonhunter,havoc,39,15,24
Krelious,barthilas,1387,demonhunter,havoc,31,17,14
Thunderray,ragnaros,1386,demonhunter,havoc,42,25,17
Kúrama,tichondrius,1385,demonhunter,havoc,78,46,32
Chungîe,frostmourne,1385,demonhunter,havoc,86,42,44
Snaped,tichondrius,1384,demonhunter,havoc,42,28,14
Çummins,malganis,1384,demonhunter,havoc,90,54,36
Jackk,nordrassil,1384,demonhunter,havoc,41,21,20
Thèflurry,tichondrius,1384,demonhunter,havoc,35,15,20
Lostsoulzz,tichondrius,1383,demonhunter,havoc,45,28,17
Duhan,tichondrius,1383,demonhunter,havoc,274,142,132
Vegan,magtheridon,1382,demonhunter,havoc,48,29,19
Tøwers,aegwynn,1382,demonhunter,havoc,102,51,51
Telrindyl,moon-guard,1380,demonhunter,havoc,132,75,57
Onií,bleeding-hollow,1379,demonhunter,havoc,35,17,18
Xonu,sargeras,1377,demonhunter,havoc,36,17,19
Anatema,illidan,1376,demonhunter,havoc,120,60,60
Violegrace,area-52,1376,demonhunter,havoc,106,51,55
Sourbooger,illidan,1376,demonhunter,havoc,43,19,24
Blomi,stormrage,1376,demonhunter,havoc,48,21,27
Villumninati,tichondrius,1375,demonhunter,havoc,48,27,21
Omgshesocute,hyjal,1375,demonhunter,havoc,36,18,18
Nisea,malganis,1374,demonhunter,havoc,48,21,27
Ralrdh,ragnaros,1372,demonhunter,havoc,80,42,38
Kellox,ragnaros,1372,demonhunter,havoc,36,15,21
Petty,moon-guard,1371,demonhunter,havoc,48,28,20
Varthalos,thrall,1371,demonhunter,havoc,126,68,58
Fugabag,thrall,1371,demonhunter,havoc,58,28,30
Inntty,barthilas,1369,demonhunter,havoc,152,81,71
Kazdh,sargeras,1367,demonhunter,havoc,66,34,32
Sloôtybag,tichondrius,1367,demonhunter,havoc,54,25,29
Chaz,blood-furnace,1366,demonhunter,havoc,36,16,20
Jellous,rivendare,1366,demonhunter,havoc,42,17,25
Cresslina,tichondrius,1365,demonhunter,havoc,78,38,40
Moylecrumbs,stormrage,1364,demonhunter,havoc,108,51,57
Khatary,ragnaros,1364,demonhunter,havoc,36,16,20
Methany,saurfang,1362,demonhunter,havoc,105,48,57
Ghótam,quelthalas,1361,demonhunter,havoc,36,19,17
Ronkasprince,thunderlord,1361,demonhunter,havoc,92,41,51
Dejay,thunderhorn,1358,demonhunter,havoc,60,35,25
Felbreak,stormrage,1358,demonhunter,havoc,72,35,37
Celestiel,cenarion-circle,1357,demonhunter,havoc,42,23,19
Freyvin,emerald-dream,1357,demonhunter,havoc,106,48,58
Foxdie,bonechewer,1356,demonhunter,havoc,96,47,49
Muerdun,tichondrius,1355,demonhunter,havoc,42,23,19
Hornedelf,frostmourne,1355,demonhunter,havoc,41,22,19
Halftruth,stormrage,1354,demonhunter,havoc,58,30,28
Lonelydusk,zangarmarsh,1353,demonhunter,havoc,64,30,34
Metagoblin,tichondrius,1352,demonhunter,havoc,30,15,15
Blinddh,bleeding-hollow,1351,demonhunter,havoc,44,21,23
Xlash,malganis,1350,demonhunter,havoc,33,15,18
Schrute,bonechewer,1349,demonhunter,havoc,48,25,23
Krizo,frostmourne,1348,demonhunter,havoc,37,19,18
Rânkle,darkspear,1345,demonhunter,havoc,46,25,21
Imrealgez,wyrmrest-accord,1345,demonhunter,havoc,30,16,14
Láskó,area-52,1344,demonhunter,havoc,33,21,12
Soupwoup,moon-guard,1344,demonhunter,havoc,75,36,39
Ergzydh,frostmourne,1344,demonhunter,havoc,72,30,42
Sillyslayadk,moon-guard,1343,demonhunter,havoc,135,76,59
Throniren,stormrage,1343,demonhunter,havoc,30,15,15
Thegoph,bleeding-hollow,1343,demonhunter,havoc,30,14,16
Hellrazer,azgalor,1343,demonhunter,havoc,39,17,22
Kokushiibo,frostwolf,1342,demonhunter,havoc,24,14,10
Skace,jubeithos,1342,demonhunter,havoc,126,66,60
Riskerdog,tichondrius,1342,demonhunter,havoc,30,14,16
Chromatïc,jubeithos,1342,demonhunter,havoc,78,34,44
Theflurry,tichondrius,1342,demonhunter,havoc,36,14,22
Beerbreak,area-52,1342,demonhunter,havoc,42,14,28
Jotalejandro,quelthalas,1341,demonhunter,havoc,78,37,41
Çópê,sargeras,1340,demonhunter,havoc,24,14,10
Jarlzdort,zuljin,1340,demonhunter,havoc,52,23,29
Demondubya,illidan,1339,demonhunter,havoc,28,15,13
Malviciouss,tichondrius,1339,demonhunter,havoc,84,40,44
Cálýpsó,tichondrius,1338,demonhunter,havoc,24,14,10
Refractx,illidan,1338,demonhunter,havoc,135,69,66
Kellytgt,perenolde,1338,demonhunter,havoc,90,46,44
Paypaldh,malganis,1338,demonhunter,havoc,30,14,16
Illidice,tichondrius,1337,demonhunter,havoc,42,21,21
Aiapaec,wyrmrest-accord,1337,demonhunter,havoc,163,78,85
Allenqt,azralon,1336,demonhunter,havoc,60,30,30
Nubishe,jubeithos,1336,demonhunter,havoc,66,29,37
Jambie,fenris,1335,demonhunter,havoc,30,14,16
Mudßutt,malganis,1335,demonhunter,havoc,36,14,22
Dakro,blackrock,1334,demonhunter,havoc,28,17,11
Qualitycaulk,tichondrius,1334,demonhunter,havoc,24,14,10
Durello,stormrage,1334,demonhunter,havoc,84,43,41
Felhunt,ragnaros,1333,demonhunter,havoc,36,15,21
Vespherie,moon-guard,1332,demonhunter,havoc,101,56,45
Smilingbomb,tichondrius,1332,demonhunter,havoc,30,14,16
Melantharia,wyrmrest-accord,1331,demonhunter,havoc,30,14,16
Majnun,moon-guard,1330,demonhunter,havoc,65,30,35
Hellrunner,magtheridon,1329,demonhunter,havoc,72,38,34
Soulsteall,tichondrius,1327,demonhunter,havoc,36,24,12
Alganoth,malfurion,1327,demonhunter,havoc,97,49,48
Mördredd,quelthalas,1327,demonhunter,havoc,40,16,24
Gosrend,durotan,1327,demonhunter,havoc,55,20,35
Véñom,area-52,1327,demonhunter,havoc,78,25,53
Elevateztko,stormrage,1326,demonhunter,havoc,36,16,20
Intensìve,illidan,1326,demonhunter,havoc,101,42,59
Kêrbydh,frostmourne,1325,demonhunter,havoc,36,22,14
Creamin,thrall,1323,demonhunter,havoc,24,15,9
Verméil,tichondrius,1323,demonhunter,havoc,36,17,19
Akiirus,azralon,1322,demonhunter,havoc,30,15,15
Zévron,area-52,1322,demonhunter,havoc,54,26,28
Chaosfienddh,bleeding-hollow,1322,demonhunter,havoc,36,14,22
Alaron,wildhammer,1321,demonhunter,havoc,111,60,51
Hyjixer,stormrage,1321,demonhunter,havoc,36,14,22
Killmongeer,tichondrius,1320,demonhunter,havoc,33,19,14
Kitnix,proudmoore,1319,demonhunter,havoc,43,21,22
Luana,stormscale,1319,demonhunter,havoc,30,14,16
Aleira,frostwolf,1318,demonhunter,havoc,58,32,26
Esomet,stormrage,1317,demonhunter,havoc,45,28,17
Pilyn,ragnaros,1317,demonhunter,havoc,152,78,74
Gigavlad,area-52,1317,demonhunter,havoc,30,14,16
Kaelidan,kelthuzad,1316,demonhunter,havoc,111,58,53
Litzilla,thrall,1315,demonhunter,havoc,42,20,22
Nolights,area-52,1315,demonhunter,havoc,90,37,53
Crypsys,illidan,1314,demonhunter,havoc,42,18,24
Sicklyslick,frostmourne,1313,demonhunter,havoc,25,15,10
Saelila,emerald-dream,1312,demonhunter,havoc,42,21,21
Yedeme,tichondrius,1312,demonhunter,havoc,106,47,59
Valdiran,duskwood,1312,demonhunter,havoc,71,30,41
Ogmon,tichondrius,1310,demonhunter,havoc,30,16,14
Nurzal,malganis,1310,demonhunter,havoc,30,14,16
Thêpunisher,ragnaros,1309,demonhunter,havoc,130,64,66
Jibaiye,tichondrius,1309,demonhunter,havoc,30,14,16
Noctemdh,tichondrius,1309,demonhunter,havoc,69,29,40
Sashasilver,frostmourne,1308,demonhunter,havoc,33,15,18
Taters,gorefiend,1307,demonhunter,havoc,36,19,17
Dömönic,illidan,1306,demonhunter,havoc,30,18,12
Ashtyr,emerald-dream,1306,demonhunter,havoc,28,16,12
Vizionz,emerald-dream,1305,demonhunter,havoc,88,46,42
Aeonys,stormrage,1304,demonhunter,havoc,60,33,27
Tekkamanevil,tichondrius,1304,demonhunter,havoc,228,113,115
Rosamune,kelthuzad,1304,demonhunter,havoc,47,18,29
Felshiv,azralon,1302,demonhunter,havoc,42,19,23
Darthmah,illidan,1300,demonhunter,havoc,42,25,17
Belial,haomarush,1299,demonhunter,havoc,54,28,26
Artemisleto,tichondrius,1299,demonhunter,havoc,42,19,23
Litan,ragnaros,1298,demonhunter,havoc,30,16,14
Nrpx,stormrage,1298,demonhunter,havoc,34,14,20
Thechaz,bleeding-hollow,1297,demonhunter,havoc,54,34,20
Spicywings,arthas,1297,demonhunter,havoc,60,30,30
Airaxx,moon-guard,1294,demonhunter,havoc,39,20,19
Falsewave,sargeras,1292,demonhunter,havoc,42,28,14
Silvs,illidan,1291,demonhunter,havoc,244,131,113
Mursiless,drenden,1290,demonhunter,havoc,24,15,9
Evros,tichondrius,1290,demonhunter,havoc,145,79,66
Szei,tichondrius,1289,demonhunter,havoc,27,16,11
Rustyanchor,malganis,1287,demonhunter,havoc,46,24,22
Chungg,laughing-skull,1287,demonhunter,havoc,30,15,15
Amdusias,darkspear,1285,demonhunter,havoc,55,26,29
Vaxs,moon-guard,1284,demonhunter,havoc,97,54,43
Siicknote,frostmourne,1284,demonhunter,havoc,29,14,15
Vwap,tichondrius,1284,demonhunter,havoc,29,14,15
Adryr,eredar,1283,demonhunter,havoc,46,27,19
Onewhoknox,mannoroth,1282,demonhunter,havoc,144,71,73
Fiziokratdh,ghostlands,1281,demonhunter,havoc,71,33,38
Facerollfel,tichondrius,1280,demonhunter,havoc,30,14,16
Cleår,kelthuzad,1276,demonhunter,havoc,26,15,11
Moorzans,malganis,1274,demonhunter,havoc,23,16,7
Trituone,ragnaros,1274,demonhunter,havoc,97,48,49
Margerie,bleeding-hollow,1274,demonhunter,havoc,97,47,50
Sylenah,hyjal,1273,demonhunter,havoc,30,14,16
Angelawhite,illidan,1271,demonhunter,havoc,54,27,27
Dlone,sargeras,1271,demonhunter,havoc,42,20,22
Kereses,bonechewer,1270,demonhunter,havoc,63,34,29
Revean,darkspear,1270,demonhunter,havoc,126,67,59
Llrebelionll,stormrage,1269,demonhunter,havoc,30,20,10
Strickdaddy,hyjal,1268,demonhunter,havoc,72,34,38
Whataboutbob,korgath,1268,demonhunter,havoc,36,14,22
Mortiria,dalaran,1267,demonhunter,havoc,73,33,40
Dakkemon,zuljin,1267,demonhunter,havoc,62,24,38
Kêydën,ragnaros,1265,demonhunter,havoc,52,33,19
Revvup,tichondrius,1265,demonhunter,havoc,87,40,47
Tattedandfab,stormrage,1265,demonhunter,havoc,102,44,58
Devilspawnss,barthilas,1265,demonhunter,havoc,46,19,27
Yønkou,stormrage,1264,demonhunter,havoc,143,70,73
Skilla,frostmourne,1262,demonhunter,havoc,91,45,46
Wíkkihx,emerald-dream,1262,demonhunter,havoc,67,30,37
Howller,azralon,1261,demonhunter,havoc,39,18,21
Hawkowicz,tichondrius,1257,demonhunter,havoc,205,101,104
Eullz,skullcrusher,1257,demonhunter,havoc,31,14,17
Twodxoxo,kelthuzad,1256,demonhunter,havoc,24,14,10
Rolecheck,tichondrius,1256,demonhunter,havoc,58,29,29
Xà,sargeras,1256,demonhunter,havoc,36,14,22
Ozaiï,tichondrius,1256,demonhunter,havoc,43,15,28
Ziyàl,vashj,1255,demonhunter,havoc,36,15,21
Veladoria,malorne,1251,demonhunter,havoc,42,21,21
Roughins,chogall,1249,demonhunter,havoc,67,35,32
Bodemön,stormrage,1249,demonhunter,havoc,30,14,16
Mårth,caelestrasz,1248,demonhunter,havoc,48,25,23
Ixix,proudmoore,1248,demonhunter,havoc,68,35,33
Ilovenina,sargeras,1247,demonhunter,havoc,24,13,11
Noopstop,tichondrius,1246,demonhunter,havoc,24,13,11
Inkubuz,sargeras,1246,demonhunter,havoc,160,78,82
Thickgary,illidan,1245,demonhunter,havoc,18,13,5
Demonthorne,illidan,1245,demonhunter,havoc,24,13,11
Kalikanzar,sargeras,1245,demonhunter,havoc,24,13,11
Juantty,area-52,1245,demonhunter,havoc,33,15,18
Demonlord,shattered-hand,1245,demonhunter,havoc,61,27,34
Rykidh,tichondrius,1245,demonhunter,havoc,30,13,17
Äòégämîñg,stormrage,1245,demonhunter,havoc,36,13,23
Alizqt,ragnaros,1244,demonhunter,havoc,24,13,11
Hoguriders,tichondrius,1244,demonhunter,havoc,30,13,17
Íllidan,stormrage,1244,demonhunter,havoc,36,13,23
Baejuhyun,kiljaeden,1243,demonhunter,havoc,24,16,8
Furíøus,tichondrius,1242,demonhunter,havoc,18,13,5
Rza,dreadmaul,1242,demonhunter,havoc,34,16,18
Tomhenk,blackrock,1242,demonhunter,havoc,30,13,17
Decoi,tichondrius,1241,demonhunter,havoc,24,13,11
Nightwisty,azralon,1241,demonhunter,havoc,24,13,11
Kimochinchin,ragnaros,1241,demonhunter,havoc,24,13,11
Miltonpickle,tichondrius,1240,demonhunter,havoc,60,27,33
Tydriedian,dalaran,1239,demonhunter,havoc,18,13,5
Harû,tichondrius,1239,demonhunter,havoc,30,13,17
Missjotab,tichondrius,1239,demonhunter,havoc,30,13,17
Necrødh,tichondrius,1238,demonhunter,havoc,28,15,13
Scarshine,frostmourne,1237,demonhunter,havoc,145,67,78
Thegudgud,stormrage,1236,demonhunter,havoc,24,13,11
Moranah,tichondrius,1236,demonhunter,havoc,24,13,11
Zétta,area-52,1236,demonhunter,havoc,24,13,11
Diëgo,gallywix,1235,demonhunter,havoc,19,13,6
Itachiix,sargeras,1234,demonhunter,havoc,48,27,21
Maddummy,tichondrius,1234,demonhunter,havoc,30,13,17
Xein,khazgoroth,1234,demonhunter,havoc,93,40,53
Khaodemus,kaelthas,1232,demonhunter,havoc,18,13,5
Aflex,zuljin,1232,demonhunter,havoc,35,19,16
Mázoku,shuhalo,1232,demonhunter,havoc,32,15,17
Madblader,tichondrius,1232,demonhunter,havoc,30,13,17
Lixthing,ragnaros,1231,demonhunter,havoc,62,40,22
Giantryhard,tichondrius,1231,demonhunter,havoc,30,13,17
Chris,dreadmaul,1230,demonhunter,havoc,24,13,11
Friel,magtheridon,1230,demonhunter,havoc,24,13,11
Syrena,mugthol,1230,demonhunter,havoc,36,18,18
Narene,mannoroth,1230,demonhunter,havoc,51,22,29
Asmoday,warsong,1229,demonhunter,havoc,149,82,67
Felbottom,tichondrius,1228,demonhunter,havoc,32,22,10
Felraven,scarlet-crusade,1227,demonhunter,havoc,39,19,20
Eraticdh,illidan,1226,demonhunter,havoc,31,14,17
Superbug,quelthalas,1224,demonhunter,havoc,78,38,40
Rorac,ragnaros,1223,demonhunter,havoc,30,13,17
Elenamarth,kiljaeden,1222,demonhunter,havoc,84,40,44
Bogged,emerald-dream,1222,demonhunter,havoc,33,14,19
Rewyle,magtheridon,1222,demonhunter,havoc,42,14,28
Tezrian,earthen-ring,1221,demonhunter,havoc,24,13,11
Chupillidan,tichondrius,1221,demonhunter,havoc,30,13,17
Onlypain,korgath,1221,demonhunter,havoc,56,23,33
Jagidan,area-52,1220,demonhunter,havoc,31,13,18
Pariah,saurfang,1220,demonhunter,havoc,53,20,33
Twistéd,gorefiend,1219,demonhunter,havoc,30,18,12
Pokoloko,twisting-nether,1219,demonhunter,havoc,38,15,23
Raradane,illidan,1218,demonhunter,havoc,24,15,9
Shandras,dathremar,1218,demonhunter,havoc,24,13,11
Lachesix,tichondrius,1217,demonhunter,havoc,30,13,17
Devwillhuntu,barthilas,1216,demonhunter,havoc,80,42,38
Axyy,area-52,1215,demonhunter,havoc,24,14,10
Shar,jaedenar,1212,demonhunter,havoc,40,25,15
Keelin,ragnaros,1212,demonhunter,havoc,28,13,15
Drschna,emerald-dream,1210,demonhunter,havoc,27,14,13
Pressinghunt,tichondrius,1209,demonhunter,havoc,23,13,10
Demonbane,moon-guard,1209,demonhunter,havoc,60,29,31
Furxi,illidan,1206,demonhunter,havoc,63,28,35
Itsskaa,illidan,1206,demonhunter,havoc,42,15,27
Zématador,azralon,1205,demonhunter,havoc,112,57,55
Vognum,quelthalas,1204,demonhunter,havoc,27,14,13
Demonkratoz,ragnaros,1203,demonhunter,havoc,61,24,37
Pupupoo,tichondrius,1202,demonhunter,havoc,78,37,41
Hellspawnn,malganis,1200,demonhunter,havoc,50,27,23
Zetsuwaffles,area-52,1198,demonhunter,havoc,29,13,16
Diversityabc,bleeding-hollow,1198,demonhunter,havoc,125,54,71
Fellight,bonechewer,1195,demonhunter,havoc,43,28,15
Rizzaarrdd,tichondrius,1195,demonhunter,havoc,136,70,66
Thelada,illidan,1195,demonhunter,havoc,45,22,23
Etherëäl,stormrage,1194,demonhunter,havoc,53,32,21
Bastaghor,stormrage,1194,demonhunter,havoc,42,19,23
Këÿz,earthen-ring,1194,demonhunter,havoc,30,13,17
Felvanora,amanthul,1190,demonhunter,havoc,24,14,10
Blckreaper,area-52,1188,demonhunter,havoc,35,16,19
Erazuz,stormrage,1188,demonhunter,havoc,30,13,17
Hævenlysinz,tichondrius,1186,demonhunter,havoc,42,15,27
Brunoqt,azralon,1185,demonhunter,havoc,29,13,16
Diizy,illidan,1184,demonhunter,havoc,30,14,16
Cyberpsycho,illidan,1184,demonhunter,havoc,30,14,16
Sleepyjobe,sargeras,1183,demonhunter,havoc,16,13,3
Tyrelara,durotan,1179,demonhunter,havoc,23,13,10
Tosilia,tichondrius,1177,demonhunter,havoc,20,13,7
Spamsamich,stormscale,1177,demonhunter,havoc,89,49,40
Stroonster,aegwynn,1176,demonhunter,havoc,30,18,12
Tyindorin,gurubashi,1176,demonhunter,havoc,30,15,15
Neecro,frostmourne,1175,demonhunter,havoc,92,42,50
Faalleen,quelthalas,1173,demonhunter,havoc,27,18,9
Mitsûri,quelthalas,1173,demonhunter,havoc,57,27,30
Aroncruel,area-52,1172,demonhunter,havoc,77,41,36
Djkelly,tichondrius,1171,demonhunter,havoc,38,13,25
Buzzmezaddy,bleeding-hollow,1170,demonhunter,havoc,63,28,35
Proserpinâ,bleeding-hollow,1170,demonhunter,havoc,77,34,43
Ënky,ragnaros,1170,demonhunter,havoc,54,23,31
Daiks,proudmoore,1166,demonhunter,havoc,48,22,26
Atsudadh,illidan,1166,demonhunter,havoc,36,13,23
Gouge,hakkar,1165,demonhunter,havoc,67,36,31
Xxsozin,skullcrusher,1164,demonhunter,havoc,39,17,22
Lingnafoxy,tichondrius,1162,demonhunter,havoc,33,15,18
Sucubus,eredar,1161,demonhunter,havoc,48,26,22
Bzrp,stormrage,1161,demonhunter,havoc,46,24,22
Aethrys,amanthul,1161,demonhunter,havoc,58,28,30
Lloxly,skullcrusher,1161,demonhunter,havoc,42,18,24
Zoruv,quelthalas,1160,demonhunter,havoc,27,14,13
Diddlemethis,nagrand,1159,demonhunter,havoc,30,15,15
Thedaz,frostmourne,1158,demonhunter,havoc,143,66,77
Hiddenblade,coilfang,1158,demonhunter,havoc,67,29,38
Larayedia,illidan,1156,demonhunter,havoc,24,17,7
Ozark,barthilas,1156,demonhunter,havoc,48,29,19
Falaszun,aegwynn,1154,demonhunter,havoc,26,13,13
Painkiiller,kelthuzad,1152,demonhunter,havoc,64,35,29
Xragii,kelthuzad,1152,demonhunter,havoc,24,12,12
Medusarri,frostmourne,1152,demonhunter,havoc,71,35,36
Kolthis,tichondrius,1151,demonhunter,havoc,27,13,14
Adhdhdh,bloodhoof,1151,demonhunter,havoc,30,12,18
Insomdh,sargeras,1150,demonhunter,havoc,18,12,6
Telarius,emerald-dream,1150,demonhunter,havoc,18,12,6
Draxíus,tichondrius,1149,demonhunter,havoc,25,13,12
Àku,area-52,1149,demonhunter,havoc,24,12,12
Openhard,stormrage,1148,demonhunter,havoc,24,12,12
Worldahmelee,illidan,1147,demonhunter,havoc,24,12,12
Lovedem,area-52,1147,demonhunter,havoc,90,36,54
Demónio,tichondrius,1146,demonhunter,havoc,18,12,6
Qvibes,tichondrius,1146,demonhunter,havoc,24,12,12
Thrania,lothar,1146,demonhunter,havoc,28,13,15
Aeezus,tichondrius,1145,demonhunter,havoc,30,12,18
Deemoogorgon,goldrinn,1144,demonhunter,havoc,18,12,6
Orsova,area-52,1144,demonhunter,havoc,24,12,12
Koodachicken,kul-tiras,1144,demonhunter,havoc,24,12,12
Aliniron,illidan,1143,demonhunter,havoc,32,19,13
Cursesoul,area-52,1143,demonhunter,havoc,78,38,40
Tywín,illidan,1143,demonhunter,havoc,30,12,18
Skinnrd,malganis,1142,demonhunter,havoc,24,12,12
Valàk,bleeding-hollow,1142,demonhunter,havoc,24,12,12
Vandeste,tichondrius,1142,demonhunter,havoc,30,12,18
Kagraxxis,stormrage,1141,demonhunter,havoc,21,13,8
Swoffordsr,tichondrius,1141,demonhunter,havoc,48,23,25
Magoroth,ragnaros,1139,demonhunter,havoc,30,20,10
Timeryus,ragnaros,1139,demonhunter,havoc,41,21,20
Irezumi,icecrown,1139,demonhunter,havoc,24,12,12
Torophz,azralon,1139,demonhunter,havoc,30,12,18
Successful,area-52,1139,demonhunter,havoc,72,26,46
Vivas,tichondrius,1136,demonhunter,havoc,24,12,12
Endyr,area-52,1136,demonhunter,havoc,25,12,13
Jënesis,illidan,1134,demonhunter,havoc,110,54,56
Ovèrrated,area-52,1134,demonhunter,havoc,90,40,50
Tayel,emerald-dream,1133,demonhunter,havoc,34,19,15
Dameon,wildhammer,1133,demonhunter,havoc,90,48,42
Keigna,tichondrius,1132,demonhunter,havoc,18,12,6
Callux,black-dragonflight,1132,demonhunter,havoc,36,12,24
Pvpchump,malygos,1131,demonhunter,havoc,66,35,31
Dandreb,draenor,1130,demonhunter,havoc,29,15,14
Xibir,amanthul,1130,demonhunter,havoc,30,12,18
Sharinne,frostmourne,1129,demonhunter,havoc,36,16,20
Jennesis,tichondrius,1126,demonhunter,havoc,78,36,42
Momysimpypoo,tichondrius,1125,demonhunter,havoc,18,12,6
Ibeatrix,malorne,1124,demonhunter,havoc,24,18,6
Dirtyvitus,gorefiend,1123,demonhunter,havoc,42,29,13
Flyingsky,tichondrius,1121,demonhunter,havoc,24,14,10
Elfofura,azralon,1121,demonhunter,havoc,82,33,49
Attritionx,sargeras,1118,demonhunter,havoc,23,13,10
Zizi,ghostlands,1117,demonhunter,havoc,62,33,29
Dyingslow,stormrage,1117,demonhunter,havoc,114,46,68
Illadra,fizzcrank,1116,demonhunter,havoc,29,14,15
Overwatch,gundrak,1112,demonhunter,havoc,27,15,12
Leonardol,quelthalas,1110,demonhunter,havoc,24,13,11
Demonslaier,dragonblight,1109,demonhunter,havoc,38,20,18
Weedeaterr,arthas,1109,demonhunter,havoc,48,14,34
Glayve,emerald-dream,1107,demonhunter,havoc,121,57,64
Dennfear,skullcrusher,1104,demonhunter,havoc,30,17,13
Keeblerself,tichondrius,1101,demonhunter,havoc,44,27,17
Blazed,thrall,1100,demonhunter,havoc,157,75,82
Lovekills,tichondrius,1098,demonhunter,havoc,24,12,12
Foodtruck,hellscream,1095,demonhunter,havoc,23,13,10
Imjustbad,malganis,1091,demonhunter,havoc,48,27,21
Doublepenn,tichondrius,1090,demonhunter,havoc,28,13,15
Nemoj,hellscream,1088,demonhunter,havoc,30,18,12
Feltini,whisperwind,1085,demonhunter,havoc,23,12,11
Lilliåna,kiljaeden,1085,demonhunter,havoc,56,24,32
Moxí,ragnaros,1082,demonhunter,havoc,36,19,17
Rauwèrs,azralon,1081,demonhunter,havoc,65,34,31
Spicyblades,stormrage,1081,demonhunter,havoc,59,28,31
Pradaboi,tichondrius,1078,demonhunter,havoc,48,17,31
Bhuppz,frostmourne,1076,demonhunter,havoc,22,12,10
Annabow,moon-guard,1075,demonhunter,havoc,150,81,69
Nixsa,area-52,1073,demonhunter,havoc,84,37,47
Kazadin,azralon,1072,demonhunter,havoc,76,33,43
Gravelot,quelthalas,1066,demonhunter,havoc,71,31,40
Skógarmaðr,garrosh,1060,demonhunter,havoc,38,19,19
Syrine,veknilash,1059,demonhunter,havoc,72,41,31
Bobgoulantt,tichondrius,1058,demonhunter,havoc,56,24,32
Syldaeya,silvermoon,1057,demonhunter,havoc,34,20,14
Shakah,dragonmaw,1056,demonhunter,havoc,18,11,7
Zuppashi,area-52,1056,demonhunter,havoc,24,11,13
Fëlla,tanaris,1055,demonhunter,havoc,18,11,7
Gogungho,tichondrius,1055,demonhunter,havoc,24,11,13
Feliodas,tichondrius,1055,demonhunter,havoc,24,11,13
Koverage,frostmourne,1054,demonhunter,havoc,18,11,7
Thumôss,malganis,1054,demonhunter,havoc,18,11,7
Ariaxy,sargeras,1054,demonhunter,havoc,18,11,7
Ravack,stormrage,1054,demonhunter,havoc,18,11,7
Bümb,moon-guard,1054,demonhunter,havoc,24,11,13
Hávok,sargeras,1054,demonhunter,havoc,31,11,20
Agsakim,tichondrius,1053,demonhunter,havoc,18,11,7
Mooneh,emerald-dream,1053,demonhunter,havoc,18,11,7
Xavid,bleeding-hollow,1053,demonhunter,havoc,24,11,13
Cedicdh,illidan,1053,demonhunter,havoc,24,11,13
Thedee,emerald-dream,1053,demonhunter,havoc,30,11,19
Emodan,moon-guard,1053,demonhunter,havoc,30,11,19
Batorr,sargeras,1053,demonhunter,havoc,36,11,25
Dhrongor,drakkari,1052,demonhunter,havoc,18,11,7
Ceried,moon-guard,1052,demonhunter,havoc,43,24,19
Shinitakunai,area-52,1052,demonhunter,havoc,30,11,19
Intrusive,kelthuzad,1051,demonhunter,havoc,18,11,7
Photuris,moon-guard,1051,demonhunter,havoc,24,11,13
Messenoire,area-52,1051,demonhunter,havoc,26,11,15
Loathy,tichondrius,1050,demonhunter,havoc,18,11,7
Ønsen,tichondrius,1049,demonhunter,havoc,29,11,18
Zergedh,kiljaeden,1049,demonhunter,havoc,30,11,19
Apaantuh,sargeras,1048,demonhunter,havoc,30,16,14
Vuse,moon-guard,1048,demonhunter,havoc,24,11,13
Covoth,bleeding-hollow,1048,demonhunter,havoc,27,12,15
Faster,tichondrius,1048,demonhunter,havoc,30,11,19
Brokendh,ragnaros,1048,demonhunter,havoc,30,11,19
Winlegend,gallywix,1048,demonhunter,havoc,32,11,21
Legäult,bleeding-hollow,1047,demonhunter,havoc,33,17,16
Madatya,black-dragonflight,1047,demonhunter,havoc,24,11,13
Cðnstantine,barthilas,1047,demonhunter,havoc,24,11,13
Lory,eldrethalas,1046,demonhunter,havoc,92,43,49
Sektõr,dalaran,1046,demonhunter,havoc,24,11,13
Midewdh,proudmoore,1046,demonhunter,havoc,24,11,13
Jámès,area-52,1045,demonhunter,havoc,24,11,13
Ryutt,illidan,1044,demonhunter,havoc,24,13,11
Xanthee,drakkari,1043,demonhunter,havoc,81,41,40
Darkglaive,ragnaros,1042,demonhunter,havoc,24,11,13
Misfortune,bloodscalp,1042,demonhunter,havoc,72,32,40
Rickinmorty,lightnings-blade,1041,demonhunter,havoc,19,11,8
Creaminbeavr,twisting-nether,1040,demonhunter,havoc,22,12,10
Misriah,sargeras,1039,demonhunter,havoc,30,11,19
Fafix,ragnaros,1038,demonhunter,havoc,24,11,13
Aedice,gurubashi,1038,demonhunter,havoc,24,11,13
Alphmega,malganis,1037,demonhunter,havoc,24,11,13
Gurthbrookz,tichondrius,1036,demonhunter,havoc,24,11,13
Worcraf,ragnaros,1034,demonhunter,havoc,56,21,35
Felbòy,korgath,1029,demonhunter,havoc,24,11,13
Moondh,area-52,1027,demonhunter,havoc,29,11,18
Maelstro,bladefist,1021,demonhunter,havoc,25,15,10
Darkweast,dalaran,1021,demonhunter,havoc,24,11,13
Veridax,quelthalas,1014,demonhunter,havoc,18,11,7
Portgaes,ragnaros,1014,demonhunter,havoc,65,19,46
Hentaidemon,kiljaeden,1013,demonhunter,havoc,54,27,27
Pupariuh,illidan,1013,demonhunter,havoc,47,19,28
Pegásus,kiljaeden,1010,demonhunter,havoc,16,11,5
Chronicsmoke,blood-furnace,1008,demonhunter,havoc,36,16,20
Catfood,icecrown,1008,demonhunter,havoc,27,11,16
Seamenhunter,garrosh,1004,demonhunter,havoc,24,12,12
Highpower,area-52,1002,demonhunter,havoc,32,13,19
Clairconctla,spirestone,1001,demonhunter,havoc,87,40,47
Cuint,barthilas,999,demonhunter,havoc,42,22,20
Midnightlord,tichondrius,996,demonhunter,havoc,24,16,8
Chabashira,tichondrius,995,demonhunter,havoc,37,14,23
Frenchtoast,bonechewer,995,demonhunter,havoc,36,12,24
Funspunk,nagrand,995,demonhunter,havoc,42,11,31
Clorhídrico,quelthalas,991,demonhunter,havoc,116,58,58
Nécô,tichondrius,987,demonhunter,havoc,26,11,15
Lüky,malganis,986,demonhunter,havoc,22,11,11
Quinny,runetotem,986,demonhunter,havoc,27,13,14
Suhui,sargeras,983,demonhunter,havoc,29,11,18
Doomhead,burning-legion,981,demonhunter,havoc,24,15,9
Ghostzface,sargeras,980,demonhunter,havoc,87,42,45
Dbljump,kiljaeden,979,demonhunter,havoc,32,11,21
Grûnt,sargeras,978,demonhunter,havoc,30,12,18
Andarïel,bleeding-hollow,977,demonhunter,havoc,25,12,13
Eikichi,bleeding-hollow,976,demonhunter,havoc,60,28,32
Purpsquirter,stormscale,974,demonhunter,havoc,39,20,19
Jerrickah,skullcrusher,967,demonhunter,havoc,26,11,15
Cercius,dalaran,966,demonhunter,havoc,36,11,25
Swansong,norgannon,964,demonhunter,havoc,66,32,34
Rhaast,executus,963,demonhunter,havoc,91,38,53
Ottonashii,ragnaros,961,demonhunter,havoc,79,33,46
Slayup,area-52,960,demonhunter,havoc,12,10,2
Hypetraindh,kelthuzad,960,demonhunter,havoc,12,10,2
Revzxy,dalaran,960,demonhunter,havoc,18,10,8
Lancee,zuljin,960,demonhunter,havoc,24,10,14
Lakedemon,sargeras,959,demonhunter,havoc,18,10,8
Sourapple,barthilas,959,demonhunter,havoc,18,10,8
Theownz,stormrage,959,demonhunter,havoc,18,10,8
Demonleap,proudmoore,959,demonhunter,havoc,18,10,8
Myelvénlady,shattered-hand,959,demonhunter,havoc,18,10,8
Misakidh,sargeras,959,demonhunter,havoc,24,10,14
Lawimmortal,tichondrius,959,demonhunter,havoc,24,10,14
Dhuck,nemesis,959,demonhunter,havoc,27,11,16
Cyånan,bleeding-hollow,958,demonhunter,havoc,23,14,9
Planeinsky,malganis,958,demonhunter,havoc,18,10,8
Bronaanas,tichondrius,958,demonhunter,havoc,18,10,8
Mybraintiny,illidan,957,demonhunter,havoc,21,11,10
Randôm,kelthuzad,957,demonhunter,havoc,21,11,10
Gilberte,stormrage,957,demonhunter,havoc,24,10,14
Vishì,thrall,957,demonhunter,havoc,30,10,20
Finelsite,area-52,956,demonhunter,havoc,18,10,8
Feldumper,illidan,956,demonhunter,havoc,24,10,14
Tangoh,burning-legion,955,demonhunter,havoc,18,10,8
Heptabase,tichondrius,955,demonhunter,havoc,18,10,8
Adycatt,illidan,955,demonhunter,havoc,18,10,8
Sorrenta,ragnaros,955,demonhunter,havoc,21,11,10
Furfur,undermine,955,demonhunter,havoc,22,10,12
Bukwheat,thunderhorn,953,demonhunter,havoc,96,47,49
Onigirix,area-52,953,demonhunter,havoc,27,11,16
Larnol,moon-guard,952,demonhunter,havoc,18,10,8
Nerco,bleeding-hollow,952,demonhunter,havoc,24,10,14
Rèlentless,moon-guard,951,demonhunter,havoc,24,10,14
Mvrda,area-52,951,demonhunter,havoc,30,10,20
Unóhana,drakkari,950,demonhunter,havoc,24,10,14
Shwagxnugz,area-52,949,demonhunter,havoc,18,10,8
Letzgobrandn,silvermoon,948,demonhunter,havoc,18,10,8
Akalitethi,moon-guard,948,demonhunter,havoc,88,31,57
Kwoop,tichondrius,946,demonhunter,havoc,24,10,14
Halfprepared,kelthuzad,946,demonhunter,havoc,30,10,20
Deepde,tichondrius,945,demonhunter,havoc,24,10,14
Demonizhe,thrall,944,demonhunter,havoc,43,22,21
Rissélys,thrall,942,demonhunter,havoc,36,20,16
Mindburn,shadowmoon,936,demonhunter,havoc,50,26,24
Blops,emerald-dream,936,demonhunter,havoc,87,43,44
Sanllish,illidan,935,demonhunter,havoc,29,11,18
Ethelric,frostmourne,935,demonhunter,havoc,101,37,64
Riicardo,ragnaros,932,demonhunter,havoc,52,26,26
Deegsdh,sargeras,932,demonhunter,havoc,27,10,17
Gozer,korialstrasz,929,demonhunter,havoc,36,12,24
Tättø,area-52,926,demonhunter,havoc,20,11,9
Demonshep,proudmoore,925,demonhunter,havoc,22,10,12
Allukya,azralon,924,demonhunter,havoc,17,10,7
Shawnchad,blood-furnace,923,demonhunter,havoc,187,93,94
Lanathir,kirin-tor,919,demonhunter,havoc,30,11,19
Andyhunter,emerald-dream,918,demonhunter,havoc,102,51,51
Aleymar,tichondrius,918,demonhunter,havoc,36,18,18
Çherrii,moon-guard,912,demonhunter,havoc,48,25,23
Troigh,thunderlord,912,demonhunter,havoc,60,29,31
Romïna,quelthalas,910,demonhunter,havoc,50,24,26
Kslicedevil,dalaran,909,demonhunter,havoc,72,31,41
Sitarok,drakkari,899,demonhunter,havoc,28,11,17
Fingerjamsx,area-52,897,demonhunter,havoc,23,10,13
Demonbanter,emerald-dream,896,demonhunter,havoc,20,11,9
Vladdtepes,cairne,892,demonhunter,havoc,119,60,59
Ilitía,area-52,887,demonhunter,havoc,21,12,9
Tygerion,emerald-dream,885,demonhunter,havoc,22,10,12
Creta,frostmourne,882,demonhunter,havoc,24,13,11
Ripchimmii,illidan,880,demonhunter,havoc,25,10,15
Lillidum,azralon,879,demonhunter,havoc,65,31,34
Blacktocki,barthilas,878,demonhunter,havoc,22,10,12
Äshês,blackhand,876,demonhunter,havoc,20,10,10
Lrianna,senjin,870,demonhunter,havoc,23,10,13
Faarkyou,barthilas,868,demonhunter,havoc,26,10,16
Ravevê,area-52,864,demonhunter,havoc,12,9,3
Cynthadra,frostmourne,864,demonhunter,havoc,12,9,3
Pennyx,barthilas,864,demonhunter,havoc,12,9,3
Plsbegood,area-52,864,demonhunter,havoc,12,9,3
Banaphel,hellscream,864,demonhunter,havoc,12,9,3
Bammski,tichondrius,864,demonhunter,havoc,18,9,9
Seya,tichondrius,864,demonhunter,havoc,18,9,9
Emicruz,quelthalas,864,demonhunter,havoc,18,9,9
Dzdh,stormrage,864,demonhunter,havoc,18,9,9
Slapxy,kelthuzad,864,demonhunter,havoc,18,9,9
Tarro,whisperwind,864,demonhunter,havoc,18,9,9
Vandämn,barthilas,864,demonhunter,havoc,18,9,9
Artee,illidan,864,demonhunter,havoc,22,10,12
Callmerebel,dragonblight,864,demonhunter,havoc,44,19,25
Kronicz,frostmourne,864,demonhunter,havoc,24,9,15
Eibizoudh,sargeras,864,demonhunter,havoc,24,9,15
Noobender,malganis,864,demonhunter,havoc,30,9,21
Jaypx,illidan,864,demonhunter,havoc,30,9,21
Mcgurty,illidan,864,demonhunter,havoc,30,9,21
Ottie,kelthuzad,863,demonhunter,havoc,12,9,3
Dämonjäger,dragonmaw,863,demonhunter,havoc,15,11,4
Rothdh,tichondrius,863,demonhunter,havoc,15,10,5
Jiawen,barthilas,863,demonhunter,havoc,18,9,9
Soñic,frostmourne,863,demonhunter,havoc,18,9,9
Lördvïngadør,azralon,863,demonhunter,havoc,18,9,9
Dogcleave,area-52,863,demonhunter,havoc,18,9,9
Shaydh,frostmourne,863,demonhunter,havoc,18,9,9
Orosz,bleeding-hollow,863,demonhunter,havoc,18,9,9
Llivid,area-52,863,demonhunter,havoc,18,9,9
Mondwin,kelthuzad,863,demonhunter,havoc,18,9,9
Hunttblacke,ragnaros,863,demonhunter,havoc,18,9,9
Phillswift,tichondrius,863,demonhunter,havoc,24,9,15
Dàrk,zuljin,863,demonhunter,havoc,35,11,24
Dragynfíst,malganis,863,demonhunter,havoc,30,9,21
Keepr,tichondrius,862,demonhunter,havoc,12,9,3
Cesilette,frostmourne,862,demonhunter,havoc,18,9,9
Vida,winterhoof,862,demonhunter,havoc,18,9,9
Rizzle,malganis,862,demonhunter,havoc,18,9,9
Shallah,barthilas,862,demonhunter,havoc,18,9,9
Dishdash,agamaggan,862,demonhunter,havoc,18,9,9
Trenbolognie,illidan,862,demonhunter,havoc,18,9,9
Lucipur,thrall,862,demonhunter,havoc,18,9,9
Kickabout,deathwing,862,demonhunter,havoc,24,9,15
Valeriya,frostmourne,862,demonhunter,havoc,24,9,15
Frostidan,sargeras,861,demonhunter,havoc,24,9,15
Psicxs,ragnaros,861,demonhunter,havoc,24,9,15
Hellboss,dalaran,860,demonhunter,havoc,12,9,3
Zirrey,stormrage,860,demonhunter,havoc,18,9,9
Smokahontas,eredar,859,demonhunter,havoc,18,9,9
Bigbubbaa,azgalor,859,demonhunter,havoc,24,9,15
Flarian,skullcrusher,858,demonhunter,havoc,18,9,9
Bazér,frostmourne,858,demonhunter,havoc,24,9,15
Dartanyn,tichondrius,853,demonhunter,havoc,24,9,15
Drackista,stormrage,852,demonhunter,havoc,18,9,9
Dynastyblade,area-52,850,demonhunter,havoc,18,9,9
Tdmturbo,zuluhed,849,demonhunter,havoc,18,9,9
Jakodh,sargeras,848,demonhunter,havoc,18,9,9
Kellndore,emerald-dream,848,demonhunter,havoc,54,26,28
Aussiepleb,nagrand,846,demonhunter,havoc,87,37,50
Kyndris,ghostlands,843,demonhunter,havoc,17,9,8
Dalmandra,arthas,841,demonhunter,havoc,17,9,8
Gretadumberg,area-52,841,demonhunter,havoc,18,9,9
Anaríel,quelthalas,841,demonhunter,havoc,54,22,32
Mikiller,thrall,838,demonhunter,havoc,148,71,77
Abusedchild,dalaran,837,demonhunter,havoc,36,16,20
Ripperxx,zuljin,837,demonhunter,havoc,60,26,34
Funky,draenor,832,demonhunter,havoc,36,18,18
Fckyouscott,illidan,830,demonhunter,havoc,14,10,4
Kreel,ghostlands,830,demonhunter,havoc,18,9,9
Rojoria,tichondrius,830,demonhunter,havoc,23,9,14
Amneshia,ragnaros,828,demonhunter,havoc,18,9,9
Xàsthur,darkspear,818,demonhunter,havoc,24,9,15
Negraxo,ragnaros,818,demonhunter,havoc,29,9,20
Myname,aggramar,818,demonhunter,havoc,62,15,47
Cassiedemonh,tichondrius,815,demonhunter,havoc,27,10,17
Healinfubar,stormrage,814,demonhunter,havoc,15,10,5
Progetto,frostmourne,798,demonhunter,havoc,23,9,14
Demonci,stormrage,795,demonhunter,havoc,20,11,9
Elurandre,moon-guard,794,demonhunter,havoc,28,11,17
Grolschen,proudmoore,789,demonhunter,havoc,60,23,37
Jellehx,frostmourne,784,demonhunter,havoc,13,9,4
Nasolar,illidan,783,demonhunter,havoc,17,9,8
Illistorm,zuljin,782,demonhunter,havoc,11,9,2
Wut,nemesis,777,demonhunter,havoc,101,47,54
Msbadass,demon-soul,773,demonhunter,havoc,25,9,16
Neshaan,stormreaver,770,demonhunter,havoc,48,24,24
Doomanone,sargeras,768,demonhunter,havoc,12,8,4
Dulcibella,tichondrius,768,demonhunter,havoc,12,8,4
Odemy,area-52,768,demonhunter,havoc,12,8,4
Kalachiquez,sargeras,768,demonhunter,havoc,12,8,4
Ðamageinc,emerald-dream,768,demonhunter,havoc,12,8,4
Helltaker,blood-furnace,768,demonhunter,havoc,12,8,4
Humanitydh,sargeras,768,demonhunter,havoc,12,8,4
Whudaz,tichondrius,768,demonhunter,havoc,12,8,4
Thugonomicz,tichondrius,768,demonhunter,havoc,12,8,4
Lxg,kelthuzad,768,demonhunter,havoc,12,8,4
Mesidan,illidan,768,demonhunter,havoc,12,8,4
Squaller,tichondrius,768,demonhunter,havoc,12,8,4
Vàin,ragnaros,768,demonhunter,havoc,12,8,4
Liarsenics,tichondrius,768,demonhunter,havoc,12,8,4
Deuzz,arthas,768,demonhunter,havoc,12,8,4
Surkkdh,tichondrius,768,demonhunter,havoc,12,8,4
Cegocruel,sargeras,768,demonhunter,havoc,13,8,5
Pub,the-scryers,768,demonhunter,havoc,15,9,6
Spinnaz,sargeras,768,demonhunter,havoc,15,8,7
Chaosdmg,lightbringer,768,demonhunter,havoc,18,8,10
Gilarian,stormrage,768,demonhunter,havoc,18,8,10
Sero,malganis,768,demonhunter,havoc,18,8,10
Veilmaya,arthas,768,demonhunter,havoc,18,8,10
Obîtox,illidan,768,demonhunter,havoc,18,8,10
Everdh,barthilas,768,demonhunter,havoc,18,8,10
Fingól,ragnaros,768,demonhunter,havoc,18,8,10
Devssimpspec,sargeras,768,demonhunter,havoc,18,8,10
Fuujiin,tol-barad,768,demonhunter,havoc,24,8,16
Xorothia,moon-guard,768,demonhunter,havoc,24,8,16
Bdwxxnmm,tichondrius,768,demonhunter,havoc,24,8,16
Doomantwo,sargeras,768,demonhunter,havoc,24,8,16
Badwurd,sargeras,767,demonhunter,havoc,12,8,4
Hellrazer,area-52,767,demonhunter,havoc,12,8,4
Myspyhu,malganis,767,demonhunter,havoc,12,8,4
Bigmith,gilneas,767,demonhunter,havoc,12,8,4
Tevodh,malganis,767,demonhunter,havoc,12,8,4
Iyren,sargeras,767,demonhunter,havoc,12,8,4
Prazethesun,emerald-dream,767,demonhunter,havoc,12,8,4
Diemonic,drakkari,767,demonhunter,havoc,12,8,4
Zaelos,tichondrius,767,demonhunter,havoc,12,8,4
Blackblades,blackhand,767,demonhunter,havoc,12,8,4
Lethalblows,darkspear,767,demonhunter,havoc,15,9,6
Linedori,destromath,767,demonhunter,havoc,16,9,7
Acclimate,aggramar,767,demonhunter,havoc,18,8,10
Blurnomnom,bleeding-hollow,767,demonhunter,havoc,18,8,10
Demonqt,blackrock,767,demonhunter,havoc,18,8,10
Xenosa,kiljaeden,767,demonhunter,havoc,18,8,10
Eithelyrana,moon-guard,767,demonhunter,havoc,18,8,10
Oddlysimple,korgath,767,demonhunter,havoc,18,8,10
Devî,ragnaros,767,demonhunter,havoc,18,8,10
ßonècrushèr,tichondrius,767,demonhunter,havoc,18,8,10
Dhfaceguy,agamaggan,767,demonhunter,havoc,18,8,10
Kruptikos,tichondrius,767,demonhunter,havoc,18,8,10
Draagee,lothar,767,demonhunter,havoc,21,9,12
Ragastan,queldorei,767,demonhunter,havoc,24,8,16
Catharsis,onyxia,767,demonhunter,havoc,24,8,16
Zradda,zuljin,767,demonhunter,havoc,24,8,16
Øñî,moon-guard,766,demonhunter,havoc,12,8,4
Andein,dalaran,766,demonhunter,havoc,12,8,4
Wólff,azralon,766,demonhunter,havoc,12,8,4
Thunderrbolt,illidan,766,demonhunter,havoc,12,8,4
Ezuna,proudmoore,766,demonhunter,havoc,18,8,10
Thalkituun,sargeras,766,demonhunter,havoc,18,8,10
Bluefalchon,sargeras,766,demonhunter,havoc,18,8,10
Katchem,barthilas,766,demonhunter,havoc,18,8,10
Touchofchaos,dragonblight,766,demonhunter,havoc,18,8,10
Hyperaids,sargeras,766,demonhunter,havoc,18,8,10
Causinghavoc,dalaran,766,demonhunter,havoc,24,8,16
Shadowdark,aggramar,766,demonhunter,havoc,24,8,16
Accipiter,ragnaros,766,demonhunter,havoc,24,8,16
Lil,anubarak,765,demonhunter,havoc,12,8,4
Bholez,illidan,765,demonhunter,havoc,18,8,10
Sinhful,darkspear,765,demonhunter,havoc,18,8,10
Detrox,ragnaros,765,demonhunter,havoc,20,8,12
Dhunterkofwa,tichondrius,765,demonhunter,havoc,24,8,16
Santaclaus,mugthol,765,demonhunter,havoc,24,8,16
Lû,arthas,765,demonhunter,havoc,24,8,16
Weetbreadsux,illidan,765,demonhunter,havoc,24,8,16
Uchulu,quelthalas,765,demonhunter,havoc,24,8,16
Schishkabob,archimonde,764,demonhunter,havoc,18,8,10
Wabussy,drenden,763,demonhunter,havoc,12,8,4
Sodiaksd,quelthalas,762,demonhunter,havoc,18,8,10
Gentlesoap,blackrock,762,demonhunter,havoc,18,8,10
Raja,anvilmar,761,demonhunter,havoc,18,8,10
Felbarrah,barthilas,761,demonhunter,havoc,18,8,10
Wargeneral,illidan,760,demonhunter,havoc,18,8,10
Akumahanta,aegwynn,759,demonhunter,havoc,12,8,4
Breezoo,tichondrius,759,demonhunter,havoc,12,8,4
Illhuntya,bonechewer,758,demonhunter,havoc,18,8,10
Suyu,ragnaros,758,demonhunter,havoc,21,8,13
Maydemon,ragnaros,757,demonhunter,havoc,30,8,22
Teethdaggers,wyrmrest-accord,756,demonhunter,havoc,12,8,4
Eksorcism,muradin,755,demonhunter,havoc,12,8,4
Rrochy,tichondrius,755,demonhunter,havoc,18,8,10
Covidneitor,drakkari,752,demonhunter,havoc,24,8,16
Bckzy,malygos,751,demonhunter,havoc,18,8,10
Sammblorqt,illidan,751,demonhunter,havoc,36,8,28
Menadori,madoran,748,demonhunter,havoc,18,8,10
Leg,scilla,736,demonhunter,havoc,22,8,14
Elena,the-underbog,735,demonhunter,havoc,16,8,8
Ryoga,malganis,734,demonhunter,havoc,15,9,6
Wuya,thrall,734,demonhunter,havoc,22,8,14
Valeriann,thunderlord,721,demonhunter,havoc,22,11,11
Hiresol,emerald-dream,719,demonhunter,havoc,11,8,3
Mdhunter,tichondrius,719,demonhunter,havoc,11,8,3
Revzdh,illidan,719,demonhunter,havoc,17,8,9
Ulfhednarxz,illidan,715,demonhunter,havoc,27,8,19
Sephmilli,azralon,713,demonhunter,havoc,27,9,18
Sarconys,thrall,702,demonhunter,havoc,14,8,6
Rivent,dethecus,702,demonhunter,havoc,26,8,18
Ryemortis,malganis,698,demonhunter,havoc,26,8,18
Memoryleaky,proudmoore,696,demonhunter,havoc,11,8,3
Tyindron,exodar,672,demonhunter,havoc,12,7,5
Uncledonnie,tanaris,672,demonhunter,havoc,12,7,5
Reddh,bleeding-hollow,672,demonhunter,havoc,12,7,5
Verå,tichondrius,672,demonhunter,havoc,12,7,5
Dabsfordayz,zuluhed,672,demonhunter,havoc,12,7,5
Xenious,terokkar,672,demonhunter,havoc,12,7,5
Slaarky,malganis,672,demonhunter,havoc,12,7,5
Felscream,kelthuzad,672,demonhunter,havoc,12,7,5
Zanoxis,tichondrius,672,demonhunter,havoc,12,7,5
Danyohl,kelthuzad,672,demonhunter,havoc,12,7,5
Stalaias,madoran,672,demonhunter,havoc,12,7,5
Vichopan,tichondrius,672,demonhunter,havoc,12,7,5
Deeploss,malganis,672,demonhunter,havoc,12,7,5
Havocupx,tichondrius,672,demonhunter,havoc,12,7,5
Hydrocodeine,moon-guard,672,demonhunter,havoc,12,7,5
Dryback,illidan,672,demonhunter,havoc,12,7,5
Dæl,quelthalas,672,demonhunter,havoc,12,7,5
Bq,feathermoon,672,demonhunter,havoc,12,7,5
Dimônio,stormrage,672,demonhunter,havoc,12,7,5
Tenth,draka,672,demonhunter,havoc,12,7,5
Darthwhorë,frostmane,672,demonhunter,havoc,12,7,5
Solbiz,tichondrius,672,demonhunter,havoc,12,7,5
Evelynee,illidan,672,demonhunter,havoc,12,7,5
Subsfordubs,illidan,672,demonhunter,havoc,12,7,5
Çreme,tichondrius,672,demonhunter,havoc,12,7,5
Endofdaysx,tichondrius,672,demonhunter,havoc,12,7,5
Smallsuper,azralon,672,demonhunter,havoc,12,7,5
Warassassin,stormrage,672,demonhunter,havoc,12,7,5
Levail,wyrmrest-accord,672,demonhunter,havoc,12,7,5
Nichidah,illidan,672,demonhunter,havoc,12,7,5
Flamehunter,durotan,672,demonhunter,havoc,13,7,6
Igotdc,tichondrius,672,demonhunter,havoc,13,7,6
Darkterrôr,sargeras,672,demonhunter,havoc,15,8,7
Louferrigno,zuljin,672,demonhunter,havoc,18,7,11
Zózo,bleeding-hollow,672,demonhunter,havoc,18,7,11
Machx,illidan,672,demonhunter,havoc,18,7,11
Demonchild,azralon,672,demonhunter,havoc,18,7,11
Blanky,shadowmoon,672,demonhunter,havoc,18,7,11
Vorlimornd,illidan,672,demonhunter,havoc,18,7,11
Dgj,kelthuzad,672,demonhunter,havoc,18,7,11
Pantyogurt,frostmourne,672,demonhunter,havoc,18,7,11
Yasuo,moon-guard,672,demonhunter,havoc,18,7,11
Foxfighter,thrall,672,demonhunter,havoc,18,7,11
Faceurdemons,frostmourne,672,demonhunter,havoc,18,7,11
Elchapotko,tichondrius,672,demonhunter,havoc,18,7,11
Boonchux,frostmourne,672,demonhunter,havoc,18,7,11
Dumbledor,stonemaul,672,demonhunter,havoc,18,7,11
Moistybreeze,frostmourne,672,demonhunter,havoc,18,7,11
Dartro,tichondrius,672,demonhunter,havoc,20,7,13
Zarosong,illidan,672,demonhunter,havoc,24,7,17
Ellguindh,malganis,672,demonhunter,havoc,30,7,23
Logixdh,tichondrius,672,demonhunter,havoc,30,7,23
Alycina,wyrmrest-accord,671,demonhunter,havoc,12,7,5
Dhameer,tichondrius,671,demonhunter,havoc,12,7,5
Jolty,stormrage,671,demonhunter,havoc,12,7,5
Mavrii,executus,671,demonhunter,havoc,12,7,5
Zarroe,stormrage,671,demonhunter,havoc,12,7,5
Stormville,illidan,671,demonhunter,havoc,12,7,5
Illifujitora,wyrmrest-accord,671,demonhunter,havoc,12,7,5
Wìnchester,durotan,671,demonhunter,havoc,12,7,5
Jeeprcreeprs,sargeras,671,demonhunter,havoc,12,7,5
Wheytoohigh,area-52,671,demonhunter,havoc,12,7,5
Cascadingeye,emerald-dream,671,demonhunter,havoc,12,7,5
Seabisciut,silvermoon,671,demonhunter,havoc,12,7,5
Ivalerà,thrall,671,demonhunter,havoc,12,7,5
Relaxnerdss,bleeding-hollow,671,demonhunter,havoc,12,7,5
Wìtchblades,tichondrius,671,demonhunter,havoc,12,7,5
Fiebzz,queldorei,671,demonhunter,havoc,12,7,5
Nightcore,lightnings-blade,671,demonhunter,havoc,12,7,5
Starianor,proudmoore,671,demonhunter,havoc,16,9,7
Nicòrobin,dalaran,671,demonhunter,havoc,18,7,11
Haax,azralon,671,demonhunter,havoc,18,7,11
Älönë,thrall,671,demonhunter,havoc,18,7,11
Untouchèd,bleeding-hollow,671,demonhunter,havoc,18,7,11
Sreedhar,stormrage,671,demonhunter,havoc,18,7,11
Hyphonìc,area-52,671,demonhunter,havoc,18,7,11
Asamir,ragnaros,671,demonhunter,havoc,19,7,12
Veryaverage,kelthuzad,671,demonhunter,havoc,24,7,17
Insañitý,bleeding-hollow,670,demonhunter,havoc,12,7,5
Renshear,cenarius,670,demonhunter,havoc,12,7,5
Ãstoreth,quelthalas,670,demonhunter,havoc,12,7,5
Mattdaemun,korgath,670,demonhunter,havoc,18,7,11
Aphy,thunderhorn,670,demonhunter,havoc,18,7,11
Zanaiahs,sargeras,670,demonhunter,havoc,21,7,14
Warglaîve,illidan,670,demonhunter,havoc,24,7,17
Kylíejennêr,gilneas,669,demonhunter,havoc,12,7,5
Claudija,frostmourne,669,demonhunter,havoc,12,7,5
Fferchu,ragnaros,669,demonhunter,havoc,12,7,5
Stepbroseph,kiljaeden,669,demonhunter,havoc,15,8,7
Denjii,malganis,669,demonhunter,havoc,24,7,17
Spikehed,area-52,669,demonhunter,havoc,24,7,17
Irìs,blood-furnace,668,demonhunter,havoc,24,7,17
Snòòp,uldaman,667,demonhunter,havoc,12,7,5
Pimm,kelthuzad,667,demonhunter,havoc,12,7,5
Ariluci,destromath,667,demonhunter,havoc,12,7,5
Bgeames,area-52,667,demonhunter,havoc,12,7,5
Haterad,bonechewer,667,demonhunter,havoc,24,7,17
Endoshiva,icecrown,666,demonhunter,havoc,18,7,11
Rahgoul,garrosh,666,demonhunter,havoc,18,7,11
Onoky,cairne,666,demonhunter,havoc,18,7,11
Genifer,norgannon,665,demonhunter,havoc,12,7,5
Qtee,cairne,664,demonhunter,havoc,18,7,11
Turbochadbro,spirestone,663,demonhunter,havoc,15,8,7
Chohpz,silvermoon,662,demonhunter,havoc,19,8,11
Rhydonx,korgath,662,demonhunter,havoc,18,7,11
Whitexheart,illidan,661,demonhunter,havoc,12,7,5
Supremetaco,stormrage,659,demonhunter,havoc,12,7,5
Eckerstrom,tichondrius,659,demonhunter,havoc,12,7,5
Malrax,drakkari,658,demonhunter,havoc,18,7,11
Luzev,thrall,657,demonhunter,havoc,12,7,5
Veierax,azralon,656,demonhunter,havoc,18,7,11
Nomakk,greymane,653,demonhunter,havoc,18,7,11
Lëif,stormrage,652,demonhunter,havoc,18,7,11
Forzaken,darkspear,647,demonhunter,havoc,18,7,11
Gwîlym,area-52,644,demonhunter,havoc,14,9,5
Yogo,tichondrius,639,demonhunter,havoc,16,7,9
Darkrais,sargeras,635,demonhunter,havoc,17,7,10
Bliqué,emerald-dream,633,demonhunter,havoc,17,7,10
Agnikai,kelthuzad,624,demonhunter,havoc,21,7,14
Gebblemon,aerie-peak,623,demonhunter,havoc,17,7,10
Hidan,velen,621,demonhunter,havoc,14,8,6
Triplex,moknathal,620,demonhunter,havoc,24,7,17
Mqvdh,area-52,618,demonhunter,havoc,39,8,31
Galaxezz,bonechewer,612,demonhunter,havoc,15,8,7
Flîck,tichondrius,608,demonhunter,havoc,10,7,3
Soure,azralon,607,demonhunter,havoc,20,7,13
Wualicho,ragnaros,603,demonhunter,havoc,24,8,16
Demonicway,stormrage,592,demonhunter,havoc,16,7,9
Runecaster,anvilmar,587,demonhunter,havoc,11,7,4
Ghostatlas,tichondrius,576,demonhunter,havoc,6,6,0
Semteks,sargeras,576,demonhunter,havoc,6,6,0
Rawdogginit,stormscale,576,demonhunter,havoc,6,6,0
Lettüceprey,sargeras,576,demonhunter,havoc,12,6,6
Elillidan,emerald-dream,576,demonhunter,havoc,12,6,6
Twotrucks,kelthuzad,576,demonhunter,havoc,12,6,6
Chicletim,azralon,576,demonhunter,havoc,12,6,6
Morgoph,burning-legion,576,demonhunter,havoc,12,6,6
Numrasiel,drakkari,576,demonhunter,havoc,12,6,6
Grümb,earthen-ring,576,demonhunter,havoc,12,6,6
Zenage,area-52,576,demonhunter,havoc,12,6,6
Solriel,malganis,576,demonhunter,havoc,12,6,6
Ânubîs,quelthalas,576,demonhunter,havoc,12,6,6
Stets,emerald-dream,576,demonhunter,havoc,12,6,6
Aertillian,ragnaros,576,demonhunter,havoc,12,6,6
Aslowbust,tichondrius,576,demonhunter,havoc,12,6,6
Gameoverdh,tichondrius,576,demonhunter,havoc,12,6,6
Deathschosen,malganis,576,demonhunter,havoc,12,6,6
Thunderlor,malganis,576,demonhunter,havoc,12,6,6
Kürosh,kalecgos,576,demonhunter,havoc,12,6,6
Audara,sargeras,576,demonhunter,havoc,12,6,6
Fanc,sargeras,576,demonhunter,havoc,12,6,6
Cassadega,sargeras,576,demonhunter,havoc,12,6,6
Abadina,illidan,576,demonhunter,havoc,12,6,6
Venmora,argent-dawn,576,demonhunter,havoc,12,6,6
Tomglaiven,hyjal,576,demonhunter,havoc,12,6,6
Manmilker,bleeding-hollow,576,demonhunter,havoc,12,6,6
Reenah,exodar,576,demonhunter,havoc,12,6,6
Rugpuller,tichondrius,576,demonhunter,havoc,12,6,6
Pabloh,trollbane,576,demonhunter,havoc,12,6,6
Gommademon,illidan,576,demonhunter,havoc,12,6,6
Basdminority,bleeding-hollow,576,demonhunter,havoc,12,6,6
Carlosjr,stormrage,576,demonhunter,havoc,12,6,6
Beugripperxo,frostmourne,576,demonhunter,havoc,12,6,6
Slapxy,illidan,576,demonhunter,havoc,12,6,6
Khanlu,bleeding-hollow,576,demonhunter,havoc,12,6,6
Teleai,kaelthas,576,demonhunter,havoc,12,6,6
Xxân,tichondrius,576,demonhunter,havoc,12,6,6
Merzinator,korgath,576,demonhunter,havoc,12,6,6
Minhzie,moon-guard,576,demonhunter,havoc,12,6,6
Tink,kilrogg,576,demonhunter,havoc,12,6,6
Jackieburton,stormrage,576,demonhunter,havoc,12,6,6
Demontoid,azgalor,576,demonhunter,havoc,12,6,6
Soloqisthefu,blackrock,576,demonhunter,havoc,12,6,6
Metakigai,ghostlands,576,demonhunter,havoc,12,6,6
Trampstampz,darkspear,576,demonhunter,havoc,12,6,6
Shinigameez,proudmoore,576,demonhunter,havoc,12,6,6
Bossdh,zuljin,576,demonhunter,havoc,12,6,6
Daggertooth,tichondrius,576,demonhunter,havoc,12,6,6
Siqx,arthas,576,demonhunter,havoc,12,6,6
Weskerz,illidan,576,demonhunter,havoc,12,6,6
Felraiser,stormrage,576,demonhunter,havoc,12,6,6
Whatdagoof,tichondrius,576,demonhunter,havoc,12,6,6
Discos,frostmourne,576,demonhunter,havoc,12,6,6
Niteclawla,illidan,576,demonhunter,havoc,12,6,6
Dmgdaddy,darrowmere,576,demonhunter,havoc,12,6,6
Zyer,mannoroth,576,demonhunter,havoc,12,6,6
Yikari,stormrage,576,demonhunter,havoc,12,6,6
Evelynvc,illidan,576,demonhunter,havoc,12,6,6
Ahsoka,arygos,576,demonhunter,havoc,15,7,8
Leeröy,area-52,576,demonhunter,havoc,18,6,12
Kålî,kiljaeden,576,demonhunter,havoc,18,6,12
Vyrai,lightbringer,576,demonhunter,havoc,18,6,12
Kungfudh,illidan,576,demonhunter,havoc,18,6,12
Sailtheskys,tichondrius,576,demonhunter,havoc,18,6,12
Zümanity,zangarmarsh,576,demonhunter,havoc,18,6,12
Mavrel,moon-guard,576,demonhunter,havoc,18,6,12
Pikächú,stormrage,576,demonhunter,havoc,18,6,12
Kyndrellesa,illidan,576,demonhunter,havoc,18,6,12
Tresbotones,kelthuzad,576,demonhunter,havoc,18,6,12
Demondurk,illidan,576,demonhunter,havoc,18,6,12
Kelan,borean-tundra,576,demonhunter,havoc,18,6,12
Gayrio,sargeras,576,demonhunter,havoc,18,6,12
Abscarnage,ragnaros,576,demonhunter,havoc,18,6,12
Projectalice,malganis,576,demonhunter,havoc,24,6,18
Cidolem,area-52,576,demonhunter,havoc,24,6,18
Icanseeyou,aerie-peak,576,demonhunter,havoc,24,6,18
Xyntel,tichondrius,576,demonhunter,havoc,24,6,18
Hootyeahbou,shattered-hand,575,demonhunter,havoc,12,6,6
Liquidblaze,elune,575,demonhunter,havoc,12,6,6
Cholula,korgath,575,demonhunter,havoc,12,6,6
Eyesyk,bonechewer,575,demonhunter,havoc,12,6,6
Tugï,tichondrius,575,demonhunter,havoc,12,6,6
Hottacos,stormrage,575,demonhunter,havoc,12,6,6
Smoothtaco,azshara,575,demonhunter,havoc,12,6,6
Cantc,moon-guard,575,demonhunter,havoc,12,6,6
Lysol,darrowmere,575,demonhunter,havoc,12,6,6
Lucati,nemesis,575,demonhunter,havoc,15,7,8
Finnanutt,tichondrius,575,demonhunter,havoc,18,6,12
Ítachí,eredar,575,demonhunter,havoc,18,6,12
Whezka,ragnaros,575,demonhunter,havoc,18,6,12
Jalet,azralon,575,demonhunter,havoc,18,6,12
ßatmañ,barthilas,575,demonhunter,havoc,18,6,12
Ýizl,ragnaros,575,demonhunter,havoc,18,6,12
Salveya,stormrage,575,demonhunter,havoc,20,6,14
Solorialorth,shadowsong,574,demonhunter,havoc,12,6,6
Casualdemon,emerald-dream,574,demonhunter,havoc,12,6,6
Haikal,proudmoore,574,demonhunter,havoc,12,6,6
Touched,guldan,574,demonhunter,havoc,12,6,6
Toxicimpulse,aegwynn,574,demonhunter,havoc,12,6,6
Kunitsuna,thunderlord,574,demonhunter,havoc,18,6,12
Trekt,blades-edge,574,demonhunter,havoc,18,6,12
Ðruh,kelthuzad,574,demonhunter,havoc,18,6,12
Ignaz,illidan,574,demonhunter,havoc,24,6,18
Trystenn,nagrand,574,demonhunter,havoc,24,6,18
Firesworn,zuljin,573,demonhunter,havoc,12,6,6
Kimchiman,tichondrius,573,demonhunter,havoc,16,7,9
Adayinthelif,proudmoore,573,demonhunter,havoc,18,6,12
Slaytan,darkspear,573,demonhunter,havoc,18,6,12
Edged,warsong,572,demonhunter,havoc,12,6,6
Snazzyy,kelthuzad,572,demonhunter,havoc,18,6,12
Eggandpotato,saurfang,571,demonhunter,havoc,12,6,6
Darckside,sargeras,571,demonhunter,havoc,12,6,6
Lanistus,bloodhoof,570,demonhunter,havoc,18,6,12
Rampyr,terokkar,569,demonhunter,havoc,12,6,6
Thjoannys,illidan,567,demonhunter,havoc,12,6,6
Samirr,proudmoore,567,demonhunter,havoc,19,6,13
Roderika,amanthul,566,demonhunter,havoc,12,6,6
Mayaia,sargeras,565,demonhunter,havoc,12,6,6
Elpis,tanaris,565,demonhunter,havoc,14,6,8
Byzzel,barthilas,559,demonhunter,havoc,17,6,11
Thendoral,ragnaros,543,demonhunter,havoc,22,6,16
Felmilk,demon-soul,541,demonhunter,havoc,16,6,10
Crustorbust,tichondrius,536,demonhunter,havoc,15,7,8
Junsa,darkspear,527,demonhunter,havoc,11,6,5
Pumppimp,stormrage,527,demonhunter,havoc,11,6,5
Shizune,boulderfist,525,demonhunter,havoc,11,6,5
Gulios,azralon,522,demonhunter,havoc,20,7,13
Fifteentolyf,illidan,520,demonhunter,havoc,11,6,5
Wickedlurker,sargeras,519,demonhunter,havoc,17,9,8
Darthrobio,tichondrius,511,demonhunter,havoc,11,6,5
Xytonic,bleeding-hollow,511,demonhunter,havoc,11,6,5
Cloudzzy,illidan,511,demonhunter,havoc,14,6,8
Isedelica,area-52,510,demonhunter,havoc,11,6,5
Vessarin,madoran,510,demonhunter,havoc,20,6,14
Med,wyrmrest-accord,480,demonhunter,havoc,6,5,1
Kyndh,illidan,480,demonhunter,havoc,6,5,1
Tîtø,quelthalas,480,demonhunter,havoc,6,5,1
Plecoptera,wyrmrest-accord,480,demonhunter,havoc,6,5,1
Remix,draka,480,demonhunter,havoc,6,5,1
Ryntx,moon-guard,480,demonhunter,havoc,6,5,1
Milfhuñter,sargeras,480,demonhunter,havoc,6,5,1
Harryunztein,ragnaros,480,demonhunter,havoc,6,5,1
Lumh,quelthalas,480,demonhunter,havoc,6,5,1
Twobuttonszz,tichondrius,480,demonhunter,havoc,6,5,1
Pumpñdump,echo-isles,480,demonhunter,havoc,6,5,1
Pristager,tichondrius,480,demonhunter,havoc,6,5,1
Dryxe,moon-guard,480,demonhunter,havoc,6,5,1
Boreath,stormrage,480,demonhunter,havoc,6,5,1
Ljevilin,gilneas,480,demonhunter,havoc,6,5,1
Twistedways,tichondrius,480,demonhunter,havoc,6,5,1
Isabellaluna,illidan,480,demonhunter,havoc,6,5,1
Ritz,moon-guard,480,demonhunter,havoc,6,5,1
Damador,malganis,480,demonhunter,havoc,6,5,1
Stunnashades,hellscream,480,demonhunter,havoc,6,5,1
Dheria,barthilas,480,demonhunter,havoc,12,5,7
Dontplanahea,tichondrius,480,demonhunter,havoc,12,5,7
Jarenjackson,area-52,480,demonhunter,havoc,12,5,7
Cupernacus,tichondrius,480,demonhunter,havoc,12,5,7
Billmurray,skullcrusher,480,demonhunter,havoc,12,5,7
Mingaming,tichondrius,480,demonhunter,havoc,12,5,7
Uneasydh,tichondrius,480,demonhunter,havoc,12,5,7
Neverfakex,frostmourne,480,demonhunter,havoc,12,5,7
Onbloodfam,kelthuzad,480,demonhunter,havoc,12,5,7
Foozelol,thrall,480,demonhunter,havoc,12,5,7
Clutch,spirestone,480,demonhunter,havoc,12,5,7
Azuki,lightbringer,480,demonhunter,havoc,12,5,7
Anthvedroth,area-52,480,demonhunter,havoc,12,5,7
Xengful,barthilas,480,demonhunter,havoc,12,5,7
Theenemesis,wildhammer,480,demonhunter,havoc,12,5,7
Finagel,destromath,480,demonhunter,havoc,12,5,7
Axldh,tichondrius,480,demonhunter,havoc,12,5,7
Chandrian,gorefiend,480,demonhunter,havoc,12,5,7
Nazeiro,shadowsong,480,demonhunter,havoc,12,5,7
Viewer,frostmourne,480,demonhunter,havoc,12,5,7
Doomanthree,sargeras,480,demonhunter,havoc,12,5,7
Xiaodudh,tichondrius,480,demonhunter,havoc,12,5,7
Laillwina,amanthul,480,demonhunter,havoc,12,5,7
Harahmbae,moon-guard,480,demonhunter,havoc,12,5,7
Sailtheskies,tichondrius,480,demonhunter,havoc,12,5,7
Mjin,tichondrius,480,demonhunter,havoc,12,5,7
Bellysniffer,illidan,480,demonhunter,havoc,12,5,7
Illadorable,muradin,480,demonhunter,havoc,12,5,7
Rizalo,frostmane,480,demonhunter,havoc,12,5,7
Ahurock,ragnaros,480,demonhunter,havoc,12,5,7
Densewench,stormrage,480,demonhunter,havoc,12,5,7
Wwdh,stormrage,480,demonhunter,havoc,12,5,7
Tyrele,drakkari,480,demonhunter,havoc,12,5,7
Extínctíon,moon-guard,480,demonhunter,havoc,12,5,7
Alkain,ragnaros,480,demonhunter,havoc,12,5,7
Lìttlê,runetotem,480,demonhunter,havoc,12,5,7
Cabedh,tichondrius,480,demonhunter,havoc,12,5,7
Zelfyrã,malganis,480,demonhunter,havoc,12,5,7
Cosbied,area-52,480,demonhunter,havoc,12,5,7
Chewyd,illidan,480,demonhunter,havoc,12,5,7
Illidam,arthas,480,demonhunter,havoc,12,5,7
Goodrink,tichondrius,480,demonhunter,havoc,12,5,7
Muffjuice,emerald-dream,480,demonhunter,havoc,12,5,7
Domeemommy,moon-guard,480,demonhunter,havoc,12,5,7
Hippygamer,frostmourne,480,demonhunter,havoc,12,5,7
Slashdh,stormrage,480,demonhunter,havoc,12,5,7
Touchmeweird,area-52,480,demonhunter,havoc,12,5,7
Dhworm,azralon,480,demonhunter,havoc,12,5,7
Zlr,bleeding-hollow,480,demonhunter,havoc,12,5,7
Besoween,tichondrius,480,demonhunter,havoc,12,5,7
Delaían,drakkari,480,demonhunter,havoc,12,5,7
Khelt,dalaran,480,demonhunter,havoc,12,5,7
Køugami,azralon,480,demonhunter,havoc,12,5,7
Drathothian,moon-guard,480,demonhunter,havoc,12,5,7
Fabbris,stormrage,480,demonhunter,havoc,12,5,7
Latchdh,malganis,480,demonhunter,havoc,12,5,7
Borekkarxqt,emerald-dream,480,demonhunter,havoc,12,5,7
Bátmañ,stormrage,480,demonhunter,havoc,12,5,7
Roughcut,blackrock,480,demonhunter,havoc,12,5,7
Chamuki,greymane,480,demonhunter,havoc,12,5,7
Hyptonique,queldorei,480,demonhunter,havoc,12,5,7
Izruul,tichondrius,480,demonhunter,havoc,12,5,7
Feka,darkspear,480,demonhunter,havoc,12,5,7
Slumberz,tichondrius,480,demonhunter,havoc,12,5,7
Wartornx,tichondrius,480,demonhunter,havoc,12,5,7
Fov,crushridge,480,demonhunter,havoc,12,5,7
Efficacious,zuljin,480,demonhunter,havoc,15,6,9
Neverblur,azralon,480,demonhunter,havoc,16,6,10
Keairà,bleeding-hollow,480,demonhunter,havoc,14,5,9
Imissgushing,area-52,480,demonhunter,havoc,18,5,13
Dèvistate,kelthuzad,480,demonhunter,havoc,18,5,13
Eyebeamtowin,stormrage,480,demonhunter,havoc,18,5,13
Blakhaurt,tichondrius,480,demonhunter,havoc,18,5,13
Soulrending,stormrage,480,demonhunter,havoc,18,5,13
Thedh,ragnaros,480,demonhunter,havoc,18,5,13
Barael,tichondrius,480,demonhunter,havoc,18,5,13
Robvyn,tichondrius,480,demonhunter,havoc,18,5,13
Dracxus,sargeras,480,demonhunter,havoc,18,5,13
Roozi,tichondrius,480,demonhunter,havoc,24,5,19
Jizzidan,blackhand,479,demonhunter,havoc,6,5,1
Pwnagextreme,area-52,479,demonhunter,havoc,6,5,1
ßoobiemiles,area-52,479,demonhunter,havoc,12,5,7
Shazun,ragnaros,479,demonhunter,havoc,12,5,7
Denathrion,moon-guard,479,demonhunter,havoc,12,5,7
Horndawgg,zuljin,479,demonhunter,havoc,12,5,7
Elfdiablo,bonechewer,479,demonhunter,havoc,12,5,7
Terruz,arathor,479,demonhunter,havoc,12,5,7
Cantreborn,destromath,479,demonhunter,havoc,12,5,7
Ezymode,stormrage,479,demonhunter,havoc,12,5,7
Pocahotnes,stormrage,479,demonhunter,havoc,12,5,7
Raziel,khazgoroth,479,demonhunter,havoc,12,5,7
Epicfront,darkspear,479,demonhunter,havoc,12,5,7
Fliar,black-dragonflight,479,demonhunter,havoc,12,5,7
Illidunk,tichondrius,479,demonhunter,havoc,18,5,13
Bonebtwo,area-52,479,demonhunter,havoc,18,5,13
Idemonl,barthilas,479,demonhunter,havoc,18,5,13
Kraezyrite,kelthuzad,479,demonhunter,havoc,18,5,13
Kattsparrow,stormrage,479,demonhunter,havoc,18,5,13
Demonlee,jubeithos,479,demonhunter,havoc,18,5,13
Kritik,goldrinn,478,demonhunter,havoc,12,5,7
Cheernobyl,emerald-dream,478,demonhunter,havoc,18,5,13
Devc,stormrage,477,demonhunter,havoc,12,5,7
Zilham,tichondrius,477,demonhunter,havoc,19,5,14
Skydemond,tichondrius,475,demonhunter,havoc,18,5,13
Rouzk,ragnaros,474,demonhunter,havoc,12,5,7
Mentoes,tichondrius,473,demonhunter,havoc,12,5,7
Liriadim,quelthalas,447,demonhunter,havoc,11,5,6
Liptint,area-52,447,demonhunter,havoc,14,6,8
Raum,elune,443,demonhunter,havoc,8,6,2
Bituhvic,stormrage,431,demonhunter,havoc,11,5,6
Verdantveins,frostmourne,431,demonhunter,havoc,24,7,17
Roosterhead,azjolnerub,430,demonhunter,havoc,11,5,6
Annxyìng,tichondrius,426,demonhunter,havoc,14,6,8
Wheredyougo,proudmoore,416,demonhunter,havoc,10,5,5
Blinddude,sargeras,415,demonhunter,havoc,14,5,9
Bladezues,tichondrius,415,demonhunter,havoc,14,5,9
Teenis,malygos,412,demonhunter,havoc,14,5,9
Phaeton,zuluhed,408,demonhunter,havoc,16,5,11
Florks,area-52,400,demonhunter,havoc,7,5,2
Kdemonhunter,tichondrius,384,demonhunter,havoc,6,4,2
Rruaast,bonechewer,384,demonhunter,havoc,6,4,2
Genji,baelgun,384,demonhunter,havoc,6,4,2
Galgy,ragnaros,384,demonhunter,havoc,6,4,2
Buenobunny,tichondrius,384,demonhunter,havoc,6,4,2
Solre,area-52,384,demonhunter,havoc,6,4,2
Abduragozik,stormrage,384,demonhunter,havoc,6,4,2
Khaosx,ragnaros,384,demonhunter,havoc,6,4,2
Jizzy,shadowmoon,384,demonhunter,havoc,6,4,2
Felstaggitha,frostmourne,384,demonhunter,havoc,6,4,2
Yågåmist,dalaran,384,demonhunter,havoc,6,4,2
Jinsha,emerald-dream,384,demonhunter,havoc,6,4,2
Dylle,tichondrius,384,demonhunter,havoc,6,4,2
Shasha,tichondrius,384,demonhunter,havoc,6,4,2
Déörwine,quelthalas,384,demonhunter,havoc,6,4,2
Dareassassin,tichondrius,384,demonhunter,havoc,6,4,2
Nèzúko,stormrage,384,demonhunter,havoc,6,4,2
Bigdingding,area-52,384,demonhunter,havoc,6,4,2
Bopersdh,drakkari,384,demonhunter,havoc,6,4,2
Wogarg,sargeras,384,demonhunter,havoc,6,4,2
Uncleruckus,bloodscalp,384,demonhunter,havoc,6,4,2
Kormraven,moon-guard,384,demonhunter,havoc,6,4,2
Parabolicc,illidan,384,demonhunter,havoc,6,4,2
Kottàs,area-52,384,demonhunter,havoc,6,4,2
Rembestgirl,rivendare,384,demonhunter,havoc,6,4,2
Cwrld,area-52,384,demonhunter,havoc,6,4,2
Heygriffin,proudmoore,384,demonhunter,havoc,6,4,2
Elfro,kelthuzad,384,demonhunter,havoc,6,4,2
Fellsoulz,area-52,384,demonhunter,havoc,6,4,2
Abakkio,kelthuzad,384,demonhunter,havoc,6,4,2
Rykudh,azuremyst,384,demonhunter,havoc,6,4,2
Vynrage,trollbane,384,demonhunter,havoc,6,4,2
Hordesback,illidan,384,demonhunter,havoc,6,4,2
Cyphre,tichondrius,384,demonhunter,havoc,6,4,2
Yolandei,malganis,384,demonhunter,havoc,6,4,2
Darkah,icecrown,384,demonhunter,havoc,6,4,2
Trilldh,illidan,384,demonhunter,havoc,6,4,2
Fluoroh,frostmourne,384,demonhunter,havoc,6,4,2
Bananabrain,mannoroth,384,demonhunter,havoc,6,4,2
Kâirn,area-52,384,demonhunter,havoc,6,4,2
Ineptbb,frostmourne,384,demonhunter,havoc,6,4,2
Doras,kelthuzad,384,demonhunter,havoc,6,4,2
Vázz,quelthalas,384,demonhunter,havoc,6,4,2
Skeethunter,tichondrius,384,demonhunter,havoc,6,4,2
Ultear,the-venture-co,384,demonhunter,havoc,6,4,2
Domoredamage,sargeras,384,demonhunter,havoc,6,4,2
Servilletas,spirestone,384,demonhunter,havoc,6,4,2
Darkrëaper,azralon,384,demonhunter,havoc,6,4,2
Verasu,kiljaeden,384,demonhunter,havoc,6,4,2
Kasseater,stormrage,384,demonhunter,havoc,6,4,2
Lucaria,sargeras,384,demonhunter,havoc,6,4,2
Rynus,tichondrius,384,demonhunter,havoc,6,4,2
Slyblitz,bleeding-hollow,384,demonhunter,havoc,6,4,2
Epicfc,bleeding-hollow,384,demonhunter,havoc,6,4,2
Tußlur,kelthuzad,384,demonhunter,havoc,6,4,2
Hqq,illidan,384,demonhunter,havoc,6,4,2
Tragedydh,sargeras,384,demonhunter,havoc,6,4,2
Nihilist,kaelthas,384,demonhunter,havoc,6,4,2
Monteego,stormrage,384,demonhunter,havoc,6,4,2
Tiriøsh,area-52,384,demonhunter,havoc,6,4,2
Doomkaiser,aerie-peak,384,demonhunter,havoc,6,4,2
Deezhuntz,anvilmar,384,demonhunter,havoc,6,4,2
Krament,ragnaros,384,demonhunter,havoc,6,4,2
Tristanzx,sargeras,384,demonhunter,havoc,6,4,2
Dhibjorf,destromath,384,demonhunter,havoc,12,4,8
Ralphie,ysera,384,demonhunter,havoc,12,4,8
Zoomie,durotan,384,demonhunter,havoc,12,4,8
Adhdh,bloodhoof,384,demonhunter,havoc,12,4,8
Dhsoop,tichondrius,384,demonhunter,havoc,12,4,8
Kelprii,emerald-dream,384,demonhunter,havoc,12,4,8
Thetim,kelthuzad,384,demonhunter,havoc,12,4,8
Dripht,stormrage,384,demonhunter,havoc,12,4,8
Sawsin,illidan,384,demonhunter,havoc,12,4,8
Ahernn,tichondrius,384,demonhunter,havoc,12,4,8
Heallscrean,drakkari,384,demonhunter,havoc,12,4,8
Bleaster,malganis,384,demonhunter,havoc,12,4,8
Overcrisis,quelthalas,384,demonhunter,havoc,12,4,8
Namthar,quelthalas,384,demonhunter,havoc,12,4,8
Blackclóver,drakkari,384,demonhunter,havoc,12,4,8
Kaeldh,illidan,384,demonhunter,havoc,12,4,8
Mommafingers,illidan,384,demonhunter,havoc,12,4,8
Fraxxured,proudmoore,384,demonhunter,havoc,12,4,8
Dkdakìng,thrall,384,demonhunter,havoc,12,4,8
Lìnc,sargeras,384,demonhunter,havoc,12,4,8
Dhtimes,ragnaros,384,demonhunter,havoc,12,4,8
Sathsong,tichondrius,384,demonhunter,havoc,12,4,8
Zarnix,area-52,384,demonhunter,havoc,12,4,8
Zurg,wyrmrest-accord,384,demonhunter,havoc,12,4,8
Dystopik,area-52,384,demonhunter,havoc,12,4,8
Bazul,tichondrius,384,demonhunter,havoc,12,4,8
Separate,stormrage,384,demonhunter,havoc,12,4,8
Drîp,moon-guard,384,demonhunter,havoc,12,4,8
Reapersauce,illidan,384,demonhunter,havoc,12,4,8
Mikemyoffice,illidan,384,demonhunter,havoc,12,4,8
Fenthras,thrall,384,demonhunter,havoc,12,4,8
Noliaclap,sargeras,384,demonhunter,havoc,12,4,8
Temporarý,bleeding-hollow,384,demonhunter,havoc,12,4,8
Anomander,khazgoroth,384,demonhunter,havoc,12,4,8
Inssurgent,nagrand,384,demonhunter,havoc,12,4,8
Vallar,bleeding-hollow,384,demonhunter,havoc,12,4,8
Butterfinger,greymane,384,demonhunter,havoc,12,4,8
Zzatmikaze,area-52,384,demonhunter,havoc,12,4,8
Baalzadreth,bleeding-hollow,384,demonhunter,havoc,12,4,8
Hadgart,ragnaros,384,demonhunter,havoc,12,4,8
Contactfront,whisperwind,384,demonhunter,havoc,12,4,8
Bättousai,kiljaeden,384,demonhunter,havoc,12,4,8
Courtesyrss,nemesis,384,demonhunter,havoc,12,4,8
Mëñâçë,tichondrius,384,demonhunter,havoc,13,4,9
Alphatoo,area-52,384,demonhunter,havoc,15,4,11
Noyan,tichondrius,384,demonhunter,havoc,17,4,13
Roodblurz,zuljin,384,demonhunter,havoc,18,4,14
Felsa,wyrmrest-accord,384,demonhunter,havoc,18,4,14
Zephim,area-52,384,demonhunter,havoc,18,4,14
Ravesx,illidan,384,demonhunter,havoc,18,4,14
Leonardovg,quelthalas,384,demonhunter,havoc,30,4,26
Severon,stormrage,383,demonhunter,havoc,6,4,2
Handael,illidan,383,demonhunter,havoc,6,4,2
Syngoth,wyrmrest-accord,383,demonhunter,havoc,6,4,2
Demondrëad,lightbringer,383,demonhunter,havoc,9,5,4
Ahzalor,azralon,383,demonhunter,havoc,12,4,8
Rarespawnjon,tichondrius,383,demonhunter,havoc,12,4,8
Deathslice,azgalor,383,demonhunter,havoc,12,4,8
Draktyl,bronzebeard,383,demonhunter,havoc,12,4,8
Felieda,malfurion,383,demonhunter,havoc,12,4,8
Flearemedy,moon-guard,383,demonhunter,havoc,12,4,8
Døffy,area-52,383,demonhunter,havoc,12,4,8
Vellinaris,zuljin,383,demonhunter,havoc,12,4,8
Themurderer,area-52,383,demonhunter,havoc,12,4,8
Righton,black-dragonflight,383,demonhunter,havoc,12,4,8
Moongaria,greymane,383,demonhunter,havoc,12,4,8
Ayestar,tichondrius,383,demonhunter,havoc,12,4,8
Zumaldita,quelthalas,382,demonhunter,havoc,6,4,2
Xiin,cenarion-circle,382,demonhunter,havoc,12,4,8
Saladuoduo,illidan,382,demonhunter,havoc,12,4,8
Anguloke,wyrmrest-accord,381,demonhunter,havoc,10,5,5
Killercooter,area-52,381,demonhunter,havoc,12,4,8
Agramun,ragnaros,381,demonhunter,havoc,12,4,8
Yesnah,emerald-dream,378,demonhunter,havoc,13,4,9
Lúcy,malganis,367,demonhunter,havoc,11,4,7
Vipperis,stormrage,352,demonhunter,havoc,10,4,6
Polunochnaya,area-52,352,demonhunter,havoc,16,4,12
Selenerose,stormrage,351,demonhunter,havoc,8,5,3
Viølance,area-52,351,demonhunter,havoc,8,5,3
Findoratoqc,darrowmere,351,demonhunter,havoc,11,4,7
Xiruu,area-52,336,demonhunter,havoc,15,5,10
Unjust,darkspear,336,demonhunter,havoc,15,4,11
Deadlysin,dragonmaw,336,demonhunter,havoc,15,4,11
Cherrycrüsh,sargeras,335,demonhunter,havoc,11,4,7
Lehvi,kiljaeden,335,demonhunter,havoc,11,4,7
Waos,maelstrom,330,demonhunter,havoc,16,5,11
Dearborn,frostmourne,330,demonhunter,havoc,16,5,11
Criyn,kelthuzad,330,demonhunter,havoc,17,5,12
Acelolzz,illidan,320,demonhunter,havoc,10,4,6
Ivexia,blackrock,320,demonhunter,havoc,10,4,6
Rákdos,illidan,319,demonhunter,havoc,8,4,4
Bushwacker,azralon,319,demonhunter,havoc,14,4,10
Gibbz,wyrmrest-accord,304,demonhunter,havoc,11,5,6
Oõp,deathwing,288,demonhunter,havoc,6,3,3
Fahrenhype,shattered-halls,288,demonhunter,havoc,6,3,3
Shacco,bleeding-hollow,288,demonhunter,havoc,6,3,3
Darkstein,nathrezim,288,demonhunter,havoc,6,3,3
Ledge,azuremyst,288,demonhunter,havoc,6,3,3
Illipo,illidan,288,demonhunter,havoc,6,3,3
Kamakhasi,bleeding-hollow,288,demonhunter,havoc,6,3,3
Asukaxox,illidan,288,demonhunter,havoc,6,3,3
Inva,stormrage,288,demonhunter,havoc,6,3,3
Dettlaff,sentinels,288,demonhunter,havoc,6,3,3
Meliodàs,ragnaros,288,demonhunter,havoc,6,3,3
Smokepurppx,zuljin,288,demonhunter,havoc,6,3,3
Miraill,goldrinn,288,demonhunter,havoc,6,3,3
Zalenn,whisperwind,288,demonhunter,havoc,6,3,3
Racktor,tichondrius,288,demonhunter,havoc,6,3,3
Danthedh,illidan,288,demonhunter,havoc,6,3,3
Zeppelìn,stormrage,288,demonhunter,havoc,6,3,3
Slodeath,zuljin,288,demonhunter,havoc,6,3,3
Walk,kul-tiras,288,demonhunter,havoc,6,3,3
Darkrushour,tichondrius,288,demonhunter,havoc,6,3,3
Kawaiiakitty,tichondrius,288,demonhunter,havoc,6,3,3
Cäncèr,area-52,288,demonhunter,havoc,6,3,3
Aventear,wyrmrest-accord,288,demonhunter,havoc,6,3,3
Noóve,area-52,288,demonhunter,havoc,6,3,3
Talsaris,drakthul,288,demonhunter,havoc,6,3,3
Âsmodeus,laughing-skull,288,demonhunter,havoc,6,3,3
Nen,illidan,288,demonhunter,havoc,6,3,3
Ziyutomioka,moon-guard,288,demonhunter,havoc,6,3,3
Smokepurppy,zuljin,288,demonhunter,havoc,6,3,3
Neutrophilia,area-52,288,demonhunter,havoc,6,3,3
Velerolas,area-52,288,demonhunter,havoc,6,3,3
Shamock,aggramar,288,demonhunter,havoc,6,3,3
Inphamy,chogall,288,demonhunter,havoc,6,3,3
Sitchenn,stormrage,288,demonhunter,havoc,6,3,3
Wingsofhavoc,darkspear,288,demonhunter,havoc,6,3,3
Zibbz,illidan,288,demonhunter,havoc,6,3,3
Nocthdh,tichondrius,288,demonhunter,havoc,6,3,3
Gnatman,skywall,288,demonhunter,havoc,6,3,3
Arnethiel,terenas,288,demonhunter,havoc,6,3,3
Namiisann,terenas,288,demonhunter,havoc,6,3,3
Riodh,area-52,288,demonhunter,havoc,6,3,3
Quiksilverv,khazgoroth,288,demonhunter,havoc,6,3,3
Suddensky,sargeras,288,demonhunter,havoc,6,3,3
Lyrndrial,wildhammer,288,demonhunter,havoc,6,3,3
Rartchaser,moon-guard,288,demonhunter,havoc,6,3,3
Gilidar,terenas,288,demonhunter,havoc,6,3,3
Sofedon,kargath,288,demonhunter,havoc,6,3,3
Baalial,eldrethalas,288,demonhunter,havoc,6,3,3
Singueta,stormrage,288,demonhunter,havoc,6,3,3
Treyydh,illidan,288,demonhunter,havoc,6,3,3
Dabsvs,ragnaros,288,demonhunter,havoc,6,3,3
ßeelzëbub,icecrown,288,demonhunter,havoc,6,3,3
Blingtrön,malganis,288,demonhunter,havoc,6,3,3
Fracxures,area-52,288,demonhunter,havoc,6,3,3
Râkê,malganis,288,demonhunter,havoc,6,3,3
Answersz,moon-guard,288,demonhunter,havoc,6,3,3
Felform,area-52,288,demonhunter,havoc,6,3,3
Onedigitiq,thrall,288,demonhunter,havoc,6,3,3
Safiyya,proudmoore,288,demonhunter,havoc,6,3,3
Walluped,malganis,288,demonhunter,havoc,6,3,3
Treeüs,sargeras,288,demonhunter,havoc,6,3,3
Arlequhin,ragnaros,288,demonhunter,havoc,6,3,3
Elgreezy,sargeras,288,demonhunter,havoc,6,3,3
Sxzure,frostmourne,288,demonhunter,havoc,6,3,3
Xetta,burning-legion,288,demonhunter,havoc,6,3,3
Krendron,malganis,288,demonhunter,havoc,6,3,3
Mèrlyn,sargeras,288,demonhunter,havoc,6,3,3
Totheglaive,sargeras,288,demonhunter,havoc,6,3,3
Careestal,stormrage,288,demonhunter,havoc,6,3,3
Celestez,kelthuzad,288,demonhunter,havoc,6,3,3
Songtwo,frostmourne,288,demonhunter,havoc,6,3,3
Demønical,dalaran,288,demonhunter,havoc,6,3,3
Gonpanchirow,moon-guard,288,demonhunter,havoc,6,3,3
Bkeight,dalaran,288,demonhunter,havoc,6,3,3
Rhynóe,illidan,288,demonhunter,havoc,6,3,3
Teufelhundn,tichondrius,288,demonhunter,havoc,6,3,3
Grevdawg,barthilas,288,demonhunter,havoc,6,3,3
Zaveen,kelthuzad,288,demonhunter,havoc,6,3,3
Zïlly,blackrock,288,demonhunter,havoc,6,3,3
Yunjiia,stormrage,288,demonhunter,havoc,6,3,3
Imissher,dalaran,288,demonhunter,havoc,6,3,3
Arthoridan,proudmoore,288,demonhunter,havoc,6,3,3
Youngillidan,draka,288,demonhunter,havoc,6,3,3
Eeresh,argent-dawn,288,demonhunter,havoc,11,4,7
Hisokafreecs,azralon,288,demonhunter,havoc,10,3,7
Inpain,ysera,288,demonhunter,havoc,14,4,10
Wotlkdh,area-52,288,demonhunter,havoc,12,3,9
Tentacruelzz,area-52,288,demonhunter,havoc,12,3,9
Skrimpi,dalaran,288,demonhunter,havoc,12,3,9
Icanmove,area-52,288,demonhunter,havoc,12,3,9
Dmfeetpics,dalaran,288,demonhunter,havoc,12,3,9
Occula,moon-guard,288,demonhunter,havoc,12,3,9
Itsplague,tichondrius,288,demonhunter,havoc,12,3,9
Felfloozy,illidan,288,demonhunter,havoc,12,3,9
Abrams,tichondrius,288,demonhunter,havoc,12,3,9
Missbhavin,kelthuzad,288,demonhunter,havoc,12,3,9
Reflexin,tichondrius,288,demonhunter,havoc,12,3,9
Demonichoov,thrall,288,demonhunter,havoc,12,3,9
Denadiirx,area-52,288,demonhunter,havoc,12,3,9
Demï,moon-guard,288,demonhunter,havoc,12,3,9
Azziria,aerie-peak,288,demonhunter,havoc,12,3,9
Daso,the-forgotten-coast,288,demonhunter,havoc,12,3,9
Felyouup,malygos,288,demonhunter,havoc,12,3,9
Thalnoes,proudmoore,288,demonhunter,havoc,12,3,9
Çløûdïx,tichondrius,288,demonhunter,havoc,12,3,9
Nayton,frostmourne,288,demonhunter,havoc,12,3,9
Atriax,kelthuzad,288,demonhunter,havoc,12,3,9
Shadynãsty,drakthul,288,demonhunter,havoc,12,3,9
Albinohobo,emerald-dream,288,demonhunter,havoc,12,3,9
Shidz,frostmourne,288,demonhunter,havoc,12,3,9
Mirante,illidan,288,demonhunter,havoc,12,3,9
Rasgon,azralon,288,demonhunter,havoc,12,3,9
Valerethis,steamwheedle-cartel,288,demonhunter,havoc,12,3,9
Dirtyd,dragonmaw,288,demonhunter,havoc,12,3,9
Klàus,quelthalas,288,demonhunter,havoc,12,3,9
Félmoose,moon-guard,288,demonhunter,havoc,12,3,9
Nightsatan,stormrage,288,demonhunter,havoc,12,3,9
Elflerri,area-52,288,demonhunter,havoc,12,3,9
Katsuucurry,tichondrius,288,demonhunter,havoc,12,3,9
Kraky,nemesis,288,demonhunter,havoc,12,3,9
Zudo,amanthul,288,demonhunter,havoc,12,3,9
Jxda,tichondrius,288,demonhunter,havoc,15,3,12
Hpmaxin,tichondrius,288,demonhunter,havoc,18,3,15
Roat,malganis,288,demonhunter,havoc,18,3,15
Vellassa,stormscale,288,demonhunter,havoc,18,3,15
Thesituatíon,sargeras,288,demonhunter,havoc,18,3,15
Lavantora,tichondrius,288,demonhunter,havoc,23,3,20
Devilina,khadgar,287,demonhunter,havoc,6,3,3
Illa,dunemaul,287,demonhunter,havoc,6,3,3
Seshirio,tichondrius,287,demonhunter,havoc,6,3,3
Holescrewer,tichondrius,287,demonhunter,havoc,6,3,3
Haydet,stormrage,287,demonhunter,havoc,6,3,3
Kratox,senjin,287,demonhunter,havoc,6,3,3
Axitria,ragnaros,287,demonhunter,havoc,6,3,3
Slixxk,sargeras,287,demonhunter,havoc,9,4,5
Villoria,kul-tiras,287,demonhunter,havoc,12,3,9
Ipoopzonu,tichondrius,286,demonhunter,havoc,6,3,3
Lsnusnul,illidan,286,demonhunter,havoc,6,3,3
Psythe,undermine,286,demonhunter,havoc,12,3,9
Dannaris,maelstrom,285,demonhunter,havoc,12,3,9
Pekkora,illidan,284,demonhunter,havoc,12,3,9
Cbt,grizzly-hills,256,demonhunter,havoc,10,3,7
Elrr,drakkari,255,demonhunter,havoc,11,3,8
Nikator,emerald-dream,255,demonhunter,havoc,11,3,8
Thenydiel,ragnaros,239,demonhunter,havoc,5,3,2
Vickyvette,illidan,239,demonhunter,havoc,5,3,2
Azàzel,quelthalas,239,demonhunter,havoc,5,3,2
Hoppygofast,darkspear,239,demonhunter,havoc,5,3,2
Divinehorse,tichondrius,234,demonhunter,havoc,10,5,5
Kryzthed,drakkari,233,demonhunter,havoc,13,4,9
Onihunter,zangarmarsh,208,demonhunter,havoc,7,3,4
Cobra,quelthalas,208,demonhunter,havoc,7,3,4
Critxclutch,tichondrius,192,demonhunter,havoc,4,3,1
Syrendris,moon-guard,192,demonhunter,havoc,8,3,5
Zanecksbinge,skullcrusher,192,demonhunter,havoc,8,3,5
Thedhdream,frostmourne,192,demonhunter,havoc,9,3,6
Xanthrodril,illidan,192,demonhunter,havoc,6,2,4
Sendingit,vashj,192,demonhunter,havoc,6,2,4
Mäläk,zuluhed,192,demonhunter,havoc,6,2,4
Aleta,firetree,192,demonhunter,havoc,6,2,4
Illimare,tichondrius,192,demonhunter,havoc,6,2,4
Ausä,ragnaros,192,demonhunter,havoc,6,2,4
Texts,norgannon,192,demonhunter,havoc,6,2,4
Cirillas,illidan,192,demonhunter,havoc,6,2,4
Iando,lightnings-blade,192,demonhunter,havoc,6,2,4
Gildarts,illidan,192,demonhunter,havoc,6,2,4
Narilna,stormrage,192,demonhunter,havoc,6,2,4
Slaymore,sargeras,192,demonhunter,havoc,6,2,4
Imagoon,sargeras,192,demonhunter,havoc,6,2,4
Throtegoat,illidan,192,demonhunter,havoc,6,2,4
Elaurenne,sargeras,192,demonhunter,havoc,6,2,4
Downbadsimp,tichondrius,192,demonhunter,havoc,6,2,4
Cryolite,sargeras,192,demonhunter,havoc,6,2,4
Bark,dalvengyr,192,demonhunter,havoc,6,2,4
Renatha,ragnaros,192,demonhunter,havoc,6,2,4
Lookatdishoe,tichondrius,192,demonhunter,havoc,6,2,4
Exhawkdh,tichondrius,192,demonhunter,havoc,6,2,4
Wreckforce,blades-edge,192,demonhunter,havoc,6,2,4
Cursedemon,vashj,192,demonhunter,havoc,6,2,4
Demonwaffle,draka,192,demonhunter,havoc,6,2,4
Zarraessa,trollbane,192,demonhunter,havoc,6,2,4
Trackamp,emerald-dream,192,demonhunter,havoc,6,2,4
Liwx,stormrage,192,demonhunter,havoc,6,2,4
Illdaira,windrunner,192,demonhunter,havoc,6,2,4
Xannaa,illidan,192,demonhunter,havoc,6,2,4
Zach,muradin,192,demonhunter,havoc,6,2,4
Arandë,earthen-ring,192,demonhunter,havoc,6,2,4
Lilyanie,stormrage,192,demonhunter,havoc,6,2,4
Moxy,kaelthas,192,demonhunter,havoc,6,2,4
Frøppy,illidan,192,demonhunter,havoc,6,2,4
Cocopapa,tichondrius,192,demonhunter,havoc,6,2,4
Badservice,frostwolf,192,demonhunter,havoc,6,2,4
Jozeez,emerald-dream,192,demonhunter,havoc,6,2,4
Yhell,darkspear,192,demonhunter,havoc,6,2,4
Ambitiòn,moon-guard,192,demonhunter,havoc,6,2,4
Genobreaker,drenden,192,demonhunter,havoc,6,2,4
Serberius,stormrage,192,demonhunter,havoc,6,2,4
Arkynth,dalaran,192,demonhunter,havoc,6,2,4
Dirtydone,area-52,192,demonhunter,havoc,6,2,4
Hornët,tichondrius,192,demonhunter,havoc,6,2,4
Brokendh,frostmourne,192,demonhunter,havoc,6,2,4
Lvqp,barthilas,192,demonhunter,havoc,6,2,4
Buhnana,stormscale,192,demonhunter,havoc,6,2,4
Kezzaku,frostmourne,192,demonhunter,havoc,6,2,4
Swagidan,khaz-modan,192,demonhunter,havoc,6,2,4
Carlibeth,illidan,192,demonhunter,havoc,6,2,4
Øxxy,azralon,192,demonhunter,havoc,6,2,4
Renoshan,wyrmrest-accord,192,demonhunter,havoc,6,2,4
Tòrment,moon-guard,192,demonhunter,havoc,6,2,4
Kzdh,illidan,192,demonhunter,havoc,6,2,4
Zeldris,duskwood,192,demonhunter,havoc,6,2,4
Cordianx,area-52,192,demonhunter,havoc,6,2,4
Illidanmello,proudmoore,192,demonhunter,havoc,6,2,4
Skol,andorhal,192,demonhunter,havoc,6,2,4
Nhoxell,ragnaros,192,demonhunter,havoc,6,2,4
Clîzzy,tichondrius,192,demonhunter,havoc,6,2,4
Kayanson,azralon,192,demonhunter,havoc,6,2,4
Kuristominen,area-52,192,demonhunter,havoc,6,2,4
Showaitie,thrall,192,demonhunter,havoc,6,2,4
Shankszs,sargeras,192,demonhunter,havoc,6,2,4
Justinthomas,khaz-modan,192,demonhunter,havoc,6,2,4
Krador,wyrmrest-accord,192,demonhunter,havoc,6,2,4
Daabsdh,thrall,192,demonhunter,havoc,6,2,4
Sparklepunch,stormrage,192,demonhunter,havoc,6,2,4
String,tanaris,192,demonhunter,havoc,6,2,4
Jammistraza,skywall,192,demonhunter,havoc,6,2,4
Lilvetis,thrall,192,demonhunter,havoc,6,2,4
Annmílls,quelthalas,192,demonhunter,havoc,6,2,4
Hellishunter,illidan,192,demonhunter,havoc,6,2,4
Glaíve,anvilmar,192,demonhunter,havoc,6,2,4
Kraazi,thrall,192,demonhunter,havoc,6,2,4
Kyndlia,wyrmrest-accord,192,demonhunter,havoc,6,2,4
Falan,drakthul,192,demonhunter,havoc,6,2,4
Lillidanss,the-forgotten-coast,192,demonhunter,havoc,6,2,4
Impaledurgf,tichondrius,192,demonhunter,havoc,6,2,4
Blynx,destromath,192,demonhunter,havoc,6,2,4
Daracu,aerie-peak,192,demonhunter,havoc,6,2,4
Jadyne,frostmourne,192,demonhunter,havoc,6,2,4
Gopump,area-52,192,demonhunter,havoc,6,2,4
Frøstdh,area-52,192,demonhunter,havoc,6,2,4
Vyrthur,area-52,192,demonhunter,havoc,6,2,4
Koogleblitz,sargeras,192,demonhunter,havoc,6,2,4
Rkakda,thunderlord,192,demonhunter,havoc,6,2,4
Gouache,frostmourne,192,demonhunter,havoc,6,2,4
Sarithos,frostmourne,192,demonhunter,havoc,6,2,4
Gogiban,tichondrius,192,demonhunter,havoc,6,2,4
Hoagiedevil,moon-guard,192,demonhunter,havoc,6,2,4
Zusi,frostmane,192,demonhunter,havoc,6,2,4
Ragath,bonechewer,192,demonhunter,havoc,6,2,4
Naresaris,proudmoore,192,demonhunter,havoc,6,2,4
Mybulma,bleeding-hollow,192,demonhunter,havoc,6,2,4
Kiau,chogall,192,demonhunter,havoc,6,2,4
Sodí,moon-guard,192,demonhunter,havoc,6,2,4
Ratcnt,barthilas,192,demonhunter,havoc,6,2,4
Gyutaro,frostmourne,192,demonhunter,havoc,6,2,4
Rykko,borean-tundra,192,demonhunter,havoc,6,2,4
Berquondh,tichondrius,192,demonhunter,havoc,6,2,4
Badalandabad,nemesis,192,demonhunter,havoc,6,2,4
Throwglaive,moon-guard,192,demonhunter,havoc,6,2,4
Lustsama,ragnaros,192,demonhunter,havoc,6,2,4
Freddiedread,bladefist,192,demonhunter,havoc,6,2,4
Zethh,drakkari,192,demonhunter,havoc,6,2,4
Iøst,stormrage,192,demonhunter,havoc,6,2,4
Wïldside,tichondrius,192,demonhunter,havoc,6,2,4
Vulgøre,illidan,192,demonhunter,havoc,6,2,4
Riot,nazgrel,192,demonhunter,havoc,6,2,4
Imleu,stormrage,192,demonhunter,havoc,6,2,4
Devilweef,whisperwind,192,demonhunter,havoc,6,2,4
Metha,kiljaeden,192,demonhunter,havoc,6,2,4
Varaedra,stormreaver,192,demonhunter,havoc,6,2,4
Himawariuzu,hyjal,192,demonhunter,havoc,6,2,4
Frino,steamwheedle-cartel,192,demonhunter,havoc,6,2,4
Ramrodd,nazgrel,192,demonhunter,havoc,6,2,4
Azshada,shadowmoon,192,demonhunter,havoc,6,2,4
Qlmm,stormrage,192,demonhunter,havoc,7,2,5
Politic,area-52,192,demonhunter,havoc,11,2,9
Catastroz,ragnaros,192,demonhunter,havoc,12,2,10
Demonslayyer,saurfang,192,demonhunter,havoc,12,2,10
Gyop,azralon,192,demonhunter,havoc,12,2,10
Cola,illidan,192,demonhunter,havoc,12,2,10
Boofdh,illidan,192,demonhunter,havoc,12,2,10
Reikune,tichondrius,192,demonhunter,havoc,12,2,10
Boredape,windrunner,192,demonhunter,havoc,12,2,10
Righetto,barthilas,192,demonhunter,havoc,12,2,10
Halaena,moon-guard,192,demonhunter,havoc,12,2,10
Ôdh,area-52,192,demonhunter,havoc,12,2,10
Denel,laughing-skull,192,demonhunter,havoc,12,2,10
Daeth,skullcrusher,192,demonhunter,havoc,12,2,10
Hollownight,area-52,192,demonhunter,havoc,12,2,10
Âduka,illidan,192,demonhunter,havoc,12,2,10
Lauriale,moon-guard,192,demonhunter,havoc,12,2,10
Spacéphoenix,stormrage,192,demonhunter,havoc,12,2,10
Smokinops,stormrage,192,demonhunter,havoc,12,2,10
Kushz,dalaran,192,demonhunter,havoc,12,2,10
Garfizzle,grizzly-hills,192,demonhunter,havoc,12,2,10
Chell,stormscale,192,demonhunter,havoc,12,2,10
Kyska,tichondrius,192,demonhunter,havoc,12,2,10
Ticó,stormrage,192,demonhunter,havoc,12,2,10
Asharian,wyrmrest-accord,192,demonhunter,havoc,12,2,10
Beastforlife,sargeras,192,demonhunter,havoc,12,2,10
Ashlanna,tichondrius,192,demonhunter,havoc,12,2,10
Tempésts,tichondrius,192,demonhunter,havoc,12,2,10
Rustiin,barthilas,191,demonhunter,havoc,6,2,4
Pholly,altar-of-storms,191,demonhunter,havoc,6,2,4
Tarasam,burning-blade,191,demonhunter,havoc,12,2,10
Feilixx,moon-guard,190,demonhunter,havoc,12,2,10
Ferunye,stormrage,159,demonhunter,havoc,5,2,3
Ladaris,shadow-council,159,demonhunter,havoc,5,2,3
Theweektwo,drakkari,159,demonhunter,havoc,11,2,9
Raycharlés,sargeras,138,demonhunter,havoc,6,3,3
Refused,nesingwary,138,demonhunter,havoc,11,4,7
Criolex,stormrage,138,demonhunter,havoc,9,3,6
Shanjara,sargeras,138,demonhunter,havoc,15,3,12
Cocolicious,area-52,128,demonhunter,havoc,4,2,2
Xeil,zuljin,128,demonhunter,havoc,4,2,2
Xwingpilot,arthas,127,demonhunter,havoc,8,2,6
Bottleofbirb,tichondrius,127,demonhunter,havoc,8,2,6
Litball,stormrage,96,demonhunter,havoc,3,2,1
Icewings,tichondrius,96,demonhunter,havoc,3,2,1
Blaamy,magtheridon,96,demonhunter,havoc,3,2,1
Kümï,quelthalas,96,demonhunter,havoc,3,2,1
Demønvil,onyxia,96,demonhunter,havoc,6,1,5
Chad,anvilmar,96,demonhunter,havoc,6,1,5
Siegfridemon,ragnaros,96,demonhunter,havoc,6,1,5
Demonleàf,area-52,96,demonhunter,havoc,6,1,5
Llörne,moon-guard,96,demonhunter,havoc,6,1,5
Vaestl,zuljin,96,demonhunter,havoc,6,1,5
Lostpvp,blackrock,96,demonhunter,havoc,6,1,5
Gil,moonrunner,96,demonhunter,havoc,6,1,5
Theysuffer,scilla,96,demonhunter,havoc,6,1,5
Chris,nordrassil,96,demonhunter,havoc,6,1,5
Esøteric,area-52,96,demonhunter,havoc,6,1,5
Phanuh,the-forgotten-coast,96,demonhunter,havoc,6,1,5
Dàwñ,doomhammer,96,demonhunter,havoc,6,1,5
Treblig,nerzhul,96,demonhunter,havoc,6,1,5
Marxefel,ragnaros,96,demonhunter,havoc,6,1,5
Venomis,stormrage,96,demonhunter,havoc,6,1,5
Aithusadh,barthilas,96,demonhunter,havoc,6,1,5
Wubloadz,bleeding-hollow,96,demonhunter,havoc,6,1,5
Terpenese,chogall,96,demonhunter,havoc,6,1,5
Nomedi,aggramar,96,demonhunter,havoc,6,1,5
Zaythan,quelthalas,96,demonhunter,havoc,6,1,5
Mazïkeen,uther,96,demonhunter,havoc,6,1,5
Demonski,area-52,96,demonhunter,havoc,6,1,5
Mythundorn,burning-blade,96,demonhunter,havoc,6,1,5
Vidêl,stormrage,96,demonhunter,havoc,6,1,5
Sado,proudmoore,96,demonhunter,havoc,6,1,5
Arkfall,proudmoore,96,demonhunter,havoc,6,1,5
Painqtxo,area-52,96,demonhunter,havoc,6,1,5
Felblood,saurfang,96,demonhunter,havoc,6,1,5
Hausecat,aegwynn,96,demonhunter,havoc,6,1,5
Kurotoo,ragnaros,96,demonhunter,havoc,6,1,5
Budsturga,arthas,96,demonhunter,havoc,6,1,5
Thêworld,azralon,96,demonhunter,havoc,6,1,5
Akammy,proudmoore,96,demonhunter,havoc,6,1,5
Demonfuji,proudmoore,96,demonhunter,havoc,6,1,5
Bazbeaüx,moon-guard,96,demonhunter,havoc,6,1,5
Ærès,ysondre,96,demonhunter,havoc,6,1,5
Tindoll,dalaran,96,demonhunter,havoc,6,1,5
Xänäx,azralon,96,demonhunter,havoc,6,1,5
Vëngêåncé,tichondrius,96,demonhunter,havoc,6,1,5
Rhyàno,proudmoore,96,demonhunter,havoc,6,1,5
Glimpsê,tichondrius,96,demonhunter,havoc,6,1,5
Pighe,tichondrius,96,demonhunter,havoc,6,1,5
Phosphora,dalaran,96,demonhunter,havoc,6,1,5
Chakan,burning-legion,96,demonhunter,havoc,6,1,5
Glaivee,dalaran,96,demonhunter,havoc,6,1,5
Solcon,exodar,96,demonhunter,havoc,6,1,5
Bensonlove,tichondrius,96,demonhunter,havoc,6,1,5
Reezi,sargeras,96,demonhunter,havoc,6,1,5
Lokydh,tichondrius,96,demonhunter,havoc,6,1,5
Safikins,tichondrius,96,demonhunter,havoc,6,1,5
Jerry,emerald-dream,96,demonhunter,havoc,6,1,5
Varanidae,kelthuzad,96,demonhunter,havoc,6,1,5
Ðemonhunterx,frostmourne,96,demonhunter,havoc,6,1,5
Illìdän,thunderhorn,96,demonhunter,havoc,6,1,5
Musewine,tichondrius,96,demonhunter,havoc,6,1,5
Slycerr,illidan,96,demonhunter,havoc,6,1,5
Suzuha,illidan,96,demonhunter,havoc,6,1,5
Sixxofnine,malganis,96,demonhunter,havoc,6,1,5
Memslaw,tichondrius,96,demonhunter,havoc,6,1,5
Jekyldh,tichondrius,96,demonhunter,havoc,6,1,5
Constantwood,sargeras,96,demonhunter,havoc,6,1,5
Scarolol,malganis,96,demonhunter,havoc,6,1,5
Brgkuma,sargeras,96,demonhunter,havoc,6,1,5
Carrîôn,tichondrius,96,demonhunter,havoc,6,1,5
Skylinetime,sargeras,96,demonhunter,havoc,6,1,5
Anabolicbro,tichondrius,96,demonhunter,havoc,6,1,5
Lantherin,sargeras,96,demonhunter,havoc,11,1,10
Pursephone,bonechewer,96,demonhunter,havoc,12,1,11
Ichigoo,arthas,96,demonhunter,havoc,12,1,11
Moonsocks,proudmoore,96,demonhunter,havoc,12,1,11
Gnocchis,thrall,96,demonhunter,havoc,12,1,11
Aríes,dreadmaul,94,demonhunter,havoc,4,3,1
Miskiiv,malganis,79,demonhunter,havoc,5,1,4
Fellchapo,illidan,79,demonhunter,havoc,5,1,4
Arlén,frostmourne,79,demonhunter,havoc,5,1,4
Demonbluntzz,tichondrius,79,demonhunter,havoc,11,1,10
Mcthiccyy,moon-guard,64,demonhunter,havoc,4,1,3
Blackpøwér,sargeras,64,demonhunter,havoc,5,1,4
Aryía,stormrage,48,demonhunter,havoc,3,1,2
Quoates,dalaran,48,demonhunter,havoc,3,1,2
Celilis,cenarius,48,demonhunter,havoc,3,1,2
Raptorjèsus,azjolnerub,48,demonhunter,havoc,3,1,2
Jizzidari,frostmourne,48,demonhunter,havoc,3,1,2
Lifefery,quelthalas,48,demonhunter,havoc,3,1,2
Xaryic,stormrage,42,demonhunter,havoc,16,5,11
Jamerino,frostmourne,42,demonhunter,havoc,7,2,5
Mythadal,sargeras,42,demonhunter,havoc,9,2,7
Kersplack,tichondrius,42,demonhunter,havoc,14,3,11
Mavlck,azralon,42,demonhunter,havoc,16,2,14
Bladeset,moonrunner,31,demonhunter,havoc,2,1,1
Pooterjuice,shadowmoon,31,demonhunter,havoc,2,1,1
Shortxfuse,illidan,31,demonhunter,havoc,2,1,1
Lathazar,darkspear,16,demonhunter,havoc,1,1,0
Iwasright,stonemaul,1488,demonhunter,vengeance,84,41,43
Slippedinfel,tichondrius,1335,demonhunter,vengeance,47,22,25
Jersey,proudmoore,1036,demonhunter,vengeance,35,18,17
Agricornia,tichondrius,847,demonhunter,vengeance,30,13,17
Methany,saurfang,606,demonhunter,vengeance,16,9,7
Nights,greymane,566,demonhunter,vengeance,12,6,6
Kysaerix,stormrage,479,demonhunter,vengeance,18,5,13
Narilis,illidan,384,demonhunter,vengeance,6,4,2
Irisand,ragnaros,288,demonhunter,vengeance,6,3,3
Sinfulpariah,bladefist,288,demonhunter,vengeance,6,3,3
Ferano,frostmourne,288,demonhunter,vengeance,6,3,3
Çherrii,moon-guard,286,demonhunter,vengeance,6,3,3
Gentlesoap,blackrock,255,demonhunter,vengeance,17,3,14
Tilltheend,illidan,239,demonhunter,vengeance,5,3,2
Asderel,zuljin,192,demonhunter,vengeance,6,2,4
Meliødaz,ragnaros,192,demonhunter,vengeance,12,2,10
Shiningvenus,stormrage,192,demonhunter,vengeance,12,2,10
Dameon,wildhammer,191,demonhunter,vengeance,6,2,4
Daymanhunter,bleeding-hollow,96,demonhunter,vengeance,6,1,5
Aleymar,tichondrius,96,demonhunter,vengeance,6,1,5
Foodtruck,hellscream,96,demonhunter,vengeance,6,1,5
Nubishe,jubeithos,96,demonhunter,vengeance,6,1,5
Mooneh,emerald-dream,96,demonhunter,vengeance,6,1,5
Supersaiyan,sargeras,64,demonhunter,vengeance,4,1,3
Dannypimp,tichondrius,2270,druid,restoration,83,55,28
Grovetenderx,tichondrius,2238,druid,restoration,86,53,33
Flóp,dalaran,2212,druid,restoration,126,70,56
Garbagedruid,scilla,2198,druid,restoration,277,144,133
Linful,tichondrius,2193,druid,restoration,251,131,120
Renner,zuljin,2192,druid,restoration,109,57,52
Angrygochux,tichondrius,2170,druid,restoration,154,84,70
Omkin,tichondrius,2159,druid,restoration,132,69,63
Kobaishome,tichondrius,2154,druid,restoration,166,98,68
Couragé,ragnaros,2137,druid,restoration,153,78,75
Andrwceo,stormrage,2129,druid,restoration,78,48,30
Bemelerberg,sargeras,2117,druid,restoration,113,60,53
Bestrun,tichondrius,2116,druid,restoration,108,58,50
Nersepha,gurubashi,2107,druid,restoration,108,52,56
Iån,dalaran,2055,druid,restoration,47,28,19
Commercii,tichondrius,2043,druid,restoration,72,42,30
Vers,dathremar,2037,druid,restoration,90,43,47
Socialyst,area-52,2036,druid,restoration,77,45,32
Liangpibro,illidan,2027,druid,restoration,150,84,66
Shaylyne,moonrunner,2026,druid,restoration,69,41,28
Dannycarry,tichondrius,2025,druid,restoration,59,32,27
Gotheelsx,illidan,2020,druid,restoration,208,103,105
Lvse,tichondrius,2018,druid,restoration,114,71,43
Racialmotive,illidan,2017,druid,restoration,134,76,58
Druuná,kiljaeden,2010,druid,restoration,197,101,96
Creamyfresh,tichondrius,2007,druid,restoration,105,54,51
Guqingshuang,tichondrius,2004,druid,restoration,109,62,47
Bigtimers,illidan,2000,druid,restoration,70,37,33
Leafynymph,tichondrius,1998,druid,restoration,61,39,22
Hchls,tichondrius,1996,druid,restoration,152,77,75
Taiwanzz,tichondrius,1994,druid,restoration,79,40,39
Szwlol,tichondrius,1992,druid,restoration,399,207,192
Sanlunainiu,tichondrius,1976,druid,restoration,178,82,96
Lenya,bleeding-hollow,1975,druid,restoration,87,49,38
Davidqx,zuljin,1971,druid,restoration,151,84,67
Rindy,rexxar,1971,druid,restoration,156,85,71
Gotheels,illidan,1967,druid,restoration,47,32,15
Brenden,area-52,1958,druid,restoration,150,76,74
Rbavny,tichondrius,1954,druid,restoration,42,25,17
Pornkkimi,tichondrius,1952,druid,restoration,48,29,19
Rorae,tichondrius,1950,druid,restoration,190,94,96
Psam,emerald-dream,1948,druid,restoration,95,54,41
Commerci,tichondrius,1944,druid,restoration,53,29,24
Softpawz,kelthuzad,1944,druid,restoration,89,45,44
Sanitizer,tichondrius,1942,druid,restoration,72,41,31
Currants,lightbringer,1941,druid,restoration,161,81,80
Flowen,spinebreaker,1940,druid,restoration,78,39,39
Shiftýx,tichondrius,1930,druid,restoration,89,46,43
Taaienberg,sargeras,1919,druid,restoration,114,54,60
Disembles,illidan,1909,druid,restoration,78,40,38
Germlol,sargeras,1902,druid,restoration,57,35,22
Larissaelar,tichondrius,1895,druid,restoration,24,20,4
Aljalladtv,bleeding-hollow,1894,druid,restoration,36,24,12
Bobd,proudmoore,1893,druid,restoration,60,32,28
Ymy,tichondrius,1892,druid,restoration,60,30,30
Tizzyy,eredar,1890,druid,restoration,84,45,39
Mengniulol,tichondrius,1889,druid,restoration,191,103,88
Pvpgold,illidan,1888,druid,restoration,95,54,41
Dancesdru,area-52,1888,druid,restoration,36,20,16
Saxhouse,illidan,1888,druid,restoration,102,53,49
Rèmix,bleeding-hollow,1887,druid,restoration,48,26,22
Bigdockepoch,sargeras,1884,druid,restoration,59,33,26
Nikdruidne,tichondrius,1881,druid,restoration,60,29,31
Darkenëd,dalaran,1880,druid,restoration,68,41,27
Ziegey,tichondrius,1877,druid,restoration,78,45,33
Lotiononmyd,illidan,1876,druid,restoration,250,134,116
Thasta,blackrock,1874,druid,restoration,158,90,68
Eddí,illidan,1872,druid,restoration,64,32,32
Bashthecat,tichondrius,1871,druid,restoration,59,39,20
Drøgbä,tichondrius,1870,druid,restoration,30,20,10
Xijinfing,tichondrius,1870,druid,restoration,42,25,17
Ksz,stormrage,1867,druid,restoration,42,25,17
Holydruid,tichondrius,1867,druid,restoration,83,43,40
Udoyu,barthilas,1865,druid,restoration,84,39,45
Represent,tichondrius,1864,druid,restoration,48,26,22
Loudswords,barthilas,1858,druid,restoration,102,50,52
Aryawilliams,area-52,1851,druid,restoration,77,40,37
Bexdru,area-52,1850,druid,restoration,284,151,133
Qdeb,akama,1844,druid,restoration,48,27,21
Vesoween,tichondrius,1843,druid,restoration,55,37,18
Esque,stormrage,1842,druid,restoration,48,24,24
Tokesh,malganis,1840,druid,restoration,72,33,39
Washedgodx,mugthol,1839,druid,restoration,59,34,25
Penguindruid,area-52,1839,druid,restoration,48,27,21
Clameo,barthilas,1839,druid,restoration,102,48,54
Wìms,malganis,1838,druid,restoration,78,39,39
Janzak,thrall,1837,druid,restoration,48,28,20
Gluesmoka,icecrown,1836,druid,restoration,54,31,23
Scätmän,ragnaros,1835,druid,restoration,54,35,19
Caipirinha,tichondrius,1834,druid,restoration,47,27,20
Plorenz,zuljin,1834,druid,restoration,149,78,71
Reehz,stormrage,1834,druid,restoration,53,25,28
Sadbull,tichondrius,1833,druid,restoration,48,27,21
Soreze,kelthuzad,1831,druid,restoration,56,35,21
Spiritot,tichondrius,1829,druid,restoration,59,28,31
Bodytwisting,tichondrius,1828,druid,restoration,48,29,19
Floofi,kelthuzad,1828,druid,restoration,54,31,23
Rerolldr,firetree,1826,druid,restoration,42,24,18
Heymeow,tichondrius,1825,druid,restoration,60,24,36
Naturae,spirestone,1823,druid,restoration,200,112,88
Kellogs,malganis,1820,druid,restoration,107,51,56
Brendenjr,area-52,1819,druid,restoration,45,32,13
Jegara,auchindoun,1818,druid,restoration,155,84,71
Facegotrake,stormrage,1817,druid,restoration,138,80,58
Badtree,tichondrius,1816,druid,restoration,104,63,41
Resto,crushridge,1816,druid,restoration,86,44,42
Maen,kelthuzad,1816,druid,restoration,82,39,43
Oinkme,kiljaeden,1815,druid,restoration,96,45,51
Sakpase,area-52,1813,druid,restoration,66,38,28
Jbdontplay,sargeras,1812,druid,restoration,59,37,22
Tunnaris,ragnaros,1811,druid,restoration,71,33,38
Kenái,nemesis,1810,druid,restoration,30,19,11
Hlchs,tichondrius,1810,druid,restoration,36,22,14
Corcovado,bleeding-hollow,1809,druid,restoration,66,31,35
Xgodhands,sargeras,1808,druid,restoration,30,22,8
Leafowl,tichondrius,1808,druid,restoration,66,37,29
Yggdrasil,ravencrest,1805,druid,restoration,65,31,34
Kayorva,gurubashi,1804,druid,restoration,47,24,23
Dmxx,kiljaeden,1801,druid,restoration,45,27,18
Playstyle,stormrage,1801,druid,restoration,49,25,24
Fruitberry,malganis,1801,druid,restoration,53,24,29
Nayko,sargeras,1801,druid,restoration,72,30,42
Ivý,shadowsong,1800,druid,restoration,41,28,13
Mengyu,tichondrius,1800,druid,restoration,64,41,23
Kobrah,twisting-nether,1800,druid,restoration,36,20,16
Drudma,shadowmoon,1800,druid,restoration,179,97,82
Zyhsul,emerald-dream,1799,druid,restoration,179,97,82
Boonsogan,tichondrius,1799,druid,restoration,66,34,32
Mimidelol,tichondrius,1792,druid,restoration,78,40,38
Geddoff,stormrage,1791,druid,restoration,177,85,92
Hideurkidz,tichondrius,1790,druid,restoration,69,40,29
Hoeba,tichondrius,1789,druid,restoration,30,19,11
Gankstanerdz,tichondrius,1783,druid,restoration,196,96,100
Ekr,tichondrius,1779,druid,restoration,54,29,25
Pineappledûe,tichondrius,1774,druid,restoration,64,33,31
Blueclàssxx,akama,1771,druid,restoration,70,49,21
Kruisberg,sargeras,1769,druid,restoration,29,19,10
Kwd,stormrage,1766,druid,restoration,77,51,26
Hotgoal,frostmourne,1766,druid,restoration,63,37,26
Èmax,barthilas,1763,druid,restoration,55,36,19
Sùlyvahn,tichondrius,1761,druid,restoration,57,30,27
Tweeguy,malganis,1761,druid,restoration,84,36,48
Dsheeps,tichondrius,1760,druid,restoration,48,27,21
Ellystarry,stormrage,1758,druid,restoration,90,46,44
Moldragon,crushridge,1758,druid,restoration,48,24,24
Gloomster,tichondrius,1756,druid,restoration,64,37,27
Treenleaves,stormrage,1751,druid,restoration,585,301,284
Flowdruid,tichondrius,1751,druid,restoration,51,26,25
Anaps,frostmourne,1744,druid,restoration,144,78,66
Wuxidixi,tichondrius,1743,druid,restoration,46,28,18
Légz,area-52,1741,druid,restoration,199,105,94
Dexlol,area-52,1738,druid,restoration,24,22,2
Surefacts,dathremar,1738,druid,restoration,40,21,19
Gsex,nemesis,1738,druid,restoration,46,24,22
Branchmanagr,dark-iron,1736,druid,restoration,54,23,31
Sooey,wyrmrest-accord,1731,druid,restoration,91,56,35
Shapelist,frostmourne,1727,druid,restoration,40,25,15
Fattdiabetic,tichondrius,1726,druid,restoration,42,24,18
Jathel,area-52,1721,druid,restoration,48,25,23
Wëndell,tichondrius,1720,druid,restoration,48,24,24
Zrobloom,stormrage,1720,druid,restoration,69,29,40
Dirtdog,uther,1719,druid,restoration,53,25,28
Reizzy,sargeras,1719,druid,restoration,84,38,46
Lovenug,shadowsong,1715,druid,restoration,179,98,81
Airmeodaddy,barthilas,1714,druid,restoration,103,52,51
Bigmoran,tichondrius,1708,druid,restoration,54,24,30
Drjelly,tichondrius,1707,druid,restoration,76,32,44
Huaxià,tichondrius,1705,druid,restoration,209,114,95
Yungdoinkski,icecrown,1704,druid,restoration,28,19,9
Rdruid,zuluhed,1703,druid,restoration,34,24,10
Pizzatimex,zuluhed,1703,druid,restoration,120,61,59
Treeofangels,nathrezim,1702,druid,restoration,42,24,18
Hoonjojjyanx,tichondrius,1701,druid,restoration,30,18,12
Acdru,tichondrius,1700,druid,restoration,72,38,34
Suekeys,frostmourne,1699,druid,restoration,48,25,23
Héisénbérg,sargeras,1695,druid,restoration,222,111,111
Levican,tichondrius,1695,druid,restoration,72,33,39
Stupidtree,antonidas,1693,druid,restoration,47,28,19
Rapttors,zuljin,1689,druid,restoration,54,23,31
Chimnie,malganis,1686,druid,restoration,96,54,42
Bramii,illidan,1686,druid,restoration,69,35,34
Druinin,archimonde,1685,druid,restoration,140,70,70
Ayalia,saurfang,1684,druid,restoration,48,25,23
Jdown,dalaran,1683,druid,restoration,100,51,49
Minisavage,proudmoore,1682,druid,restoration,48,23,25
Cienza,proudmoore,1680,druid,restoration,264,136,128
Thundercast,quelthalas,1679,druid,restoration,170,84,86
Polyester,frostmourne,1679,druid,restoration,54,25,29
Poliage,moon-guard,1676,druid,restoration,279,141,138
Dabloleu,illidan,1675,druid,restoration,24,19,5
Sanninx,barthilas,1673,druid,restoration,70,40,30
Luckyslot,frostmourne,1672,druid,restoration,42,26,16
Roen,tichondrius,1672,druid,restoration,40,21,19
Hxa,emerald-dream,1672,druid,restoration,70,34,36
Remus,hydraxis,1672,druid,restoration,66,31,35
Woshiyigede,frostmourne,1670,druid,restoration,128,63,65
Enrÿu,nemesis,1668,druid,restoration,42,21,21
Moomooheal,moon-guard,1667,druid,restoration,257,135,122
Afkhottedyou,suramar,1667,druid,restoration,46,24,22
Images,kilrogg,1666,druid,restoration,66,44,22
Lobsterdruid,area-52,1666,druid,restoration,42,24,18
Psyqobloom,dalaran,1665,druid,restoration,152,87,65
Insuranceguy,nagrand,1663,druid,restoration,72,42,30
Zblmystic,tichondrius,1662,druid,restoration,78,43,35
Legitonedge,zuljin,1662,druid,restoration,55,30,25
Chevy,onyxia,1662,druid,restoration,94,39,55
Binionsolboy,illidan,1661,druid,restoration,48,25,23
Zoteqt,kelthuzad,1657,druid,restoration,48,25,23
Lubbeck,stormrage,1653,druid,restoration,157,87,70
Druidstin,tichondrius,1653,druid,restoration,168,87,81
Riiccflaiir,stormrage,1651,druid,restoration,90,52,38
Montage,illidan,1650,druid,restoration,54,26,28
Notpodruida,tichondrius,1649,druid,restoration,48,28,20
Dbk,suramar,1648,druid,restoration,170,102,68
Klamediya,illidan,1648,druid,restoration,53,21,32
Sarrati,emerald-dream,1647,druid,restoration,194,105,89
Staraborn,stormrage,1647,druid,restoration,527,281,246
Corbind,arthas,1647,druid,restoration,292,152,140
Defteras,illidan,1647,druid,restoration,42,21,21
Qidzerker,arathor,1644,druid,restoration,125,66,59
Rizzit,wyrmrest-accord,1643,druid,restoration,392,206,186
Animalge,sargeras,1643,druid,restoration,60,25,35
Sixthsex,tichondrius,1642,druid,restoration,95,51,44
Widescreen,burning-blade,1641,druid,restoration,450,235,215
Dendrix,area-52,1641,druid,restoration,90,46,44
Gsëx,nemesis,1640,druid,restoration,47,22,25
Tayriel,area-52,1640,druid,restoration,57,26,31
Sosaformx,stormrage,1639,druid,restoration,47,21,26
Teslabeam,illidan,1639,druid,restoration,53,21,32
Convokíng,kelthuzad,1639,druid,restoration,53,20,33
Muhu,frostmourne,1637,druid,restoration,96,54,42
Morphiq,tichondrius,1637,druid,restoration,165,89,76
Pkgdbts,tichondrius,1637,druid,restoration,47,22,25
Breaksilence,tichondrius,1636,druid,restoration,59,36,23
Arwëna,tichondrius,1636,druid,restoration,86,50,36
Birdfromtree,dalaran,1636,druid,restoration,48,26,22
Pootyleaf,daggerspine,1636,druid,restoration,60,28,32
Lifeboomer,ragnaros,1634,druid,restoration,79,48,31
Pekazay,illidan,1632,druid,restoration,79,41,38
Durintor,nemesis,1630,druid,restoration,135,72,63
Rowlex,moon-guard,1629,druid,restoration,28,21,7
Pawsbutton,stormrage,1629,druid,restoration,30,20,10
Aiyouyou,tichondrius,1628,druid,restoration,219,123,96
Cheddy,tichondrius,1628,druid,restoration,77,43,34
Rawbacon,blackrock,1628,druid,restoration,62,24,38
Addiedru,zuljin,1627,druid,restoration,69,32,37
Kamisamalee,tichondrius,1626,druid,restoration,41,25,16
Viscentdd,illidan,1626,druid,restoration,36,17,19
Quss,tichondrius,1624,druid,restoration,31,19,12
Elfjane,tichondrius,1624,druid,restoration,30,17,13
Admoney,sargeras,1624,druid,restoration,36,17,19
Venomgtz,laughing-skull,1623,druid,restoration,254,139,115
Wolfis,malganis,1622,druid,restoration,36,20,16
Cybeé,sargeras,1621,druid,restoration,48,19,29
Zhn,sargeras,1619,druid,restoration,47,31,16
Suublime,ragnaros,1618,druid,restoration,72,34,38
Kaperij,sargeras,1617,druid,restoration,30,17,13
Asmitar,illidan,1616,druid,restoration,36,22,14
Gødriç,tichondrius,1614,druid,restoration,221,112,109
Elyl,tichondrius,1614,druid,restoration,48,23,25
Xhoz,tichondrius,1613,druid,restoration,302,166,136
Gulperberg,sargeras,1612,druid,restoration,30,25,5
Soheezy,illidan,1612,druid,restoration,198,111,87
Roachsan,tichondrius,1612,druid,restoration,127,70,57
Drainean,sargeras,1611,druid,restoration,30,17,13
Hxm,tichondrius,1611,druid,restoration,35,17,18
Pigheaddru,tichondrius,1611,druid,restoration,54,22,32
Zulas,thrall,1609,druid,restoration,37,24,13
Hideurchickn,tichondrius,1609,druid,restoration,36,23,13
Maplêleaf,moon-guard,1608,druid,restoration,426,224,202
Douwantoplay,tichondrius,1607,druid,restoration,60,32,28
Maviç,hyjal,1607,druid,restoration,489,260,229
Fhiziod,kelthuzad,1606,druid,restoration,74,44,30
Hoebaz,tichondrius,1606,druid,restoration,30,17,13
Jathy,area-52,1606,druid,restoration,51,21,30
Poscow,tichondrius,1605,druid,restoration,51,29,22
Kurrious,frostmourne,1605,druid,restoration,40,18,22
Kimdeokbae,tichondrius,1604,druid,restoration,30,22,8
Yavannita,quelthalas,1600,druid,restoration,57,36,21
Hehaw,kelthuzad,1600,druid,restoration,152,87,65
Manycyclones,zuluhed,1598,druid,restoration,60,32,28
Erral,malganis,1597,druid,restoration,57,26,31
Opiumheals,sargeras,1595,druid,restoration,95,53,42
Kaleaky,thrall,1595,druid,restoration,99,53,46
Treebag,frostmane,1595,druid,restoration,108,55,53
Terkpla,ragnaros,1594,druid,restoration,130,69,61
Elven,frostmourne,1594,druid,restoration,54,20,34
Kznels,tichondrius,1592,druid,restoration,43,27,16
Shapedance,sargeras,1592,druid,restoration,153,78,75
Imroot,tichondrius,1588,druid,restoration,54,32,22
Errane,eonar,1587,druid,restoration,199,110,89
Tippsyy,frostmane,1586,druid,restoration,214,101,113
Calmd,sargeras,1585,druid,restoration,30,21,9
Áçxpërt,jubeithos,1584,druid,restoration,42,27,15
Dumberdruid,frostmourne,1584,druid,restoration,42,24,18
Shinjis,tichondrius,1582,druid,restoration,108,51,57
Chutney,windrunner,1581,druid,restoration,46,21,25
Relbedo,sargeras,1577,druid,restoration,230,119,111
Armorkits,area-52,1575,druid,restoration,33,17,16
Meniscus,arthas,1575,druid,restoration,65,29,36
Pilcosbie,stormrage,1574,druid,restoration,54,29,25
Ðruìd,gnomeregan,1574,druid,restoration,36,19,17
Boomtastik,frostmourne,1574,druid,restoration,108,46,62
Tondrai,malganis,1572,druid,restoration,125,62,63
Møøncry,ragnaros,1571,druid,restoration,154,73,81
Nerfthedruid,blackrock,1570,druid,restoration,42,28,14
Fanboy,magtheridon,1570,druid,restoration,30,18,12
Gunnymad,tichondrius,1570,druid,restoration,53,31,22
Gìtgoodtrash,frostmourne,1569,druid,restoration,82,41,41
Lauramavra,azralon,1568,druid,restoration,334,179,155
Krevy,nazgrel,1568,druid,restoration,126,57,69
Sombér,eitrigg,1568,druid,restoration,72,24,48
Duragx,bleeding-hollow,1567,druid,restoration,100,62,38
Manzar,illidan,1566,druid,restoration,42,22,20
Moonpaws,frostmourne,1564,druid,restoration,36,22,14
Shìfty,emerald-dream,1564,druid,restoration,62,31,31
Toastsdruid,tichondrius,1560,druid,restoration,30,19,11
Zyzzema,frostmourne,1559,druid,restoration,174,82,92
Ojotasesina,ragnaros,1557,druid,restoration,48,22,26
Naturist,kelthuzad,1557,druid,restoration,53,19,34
Silentbeer,frostmourne,1553,druid,restoration,266,135,131
Veejae,stormreaver,1553,druid,restoration,58,23,35
Aberdare,tichondrius,1552,druid,restoration,147,82,65
Hayase,tichondrius,1551,druid,restoration,42,25,17
Seamandeman,sargeras,1549,druid,restoration,132,72,60
Gonimydear,proudmoore,1549,druid,restoration,216,108,108
Druxe,zuljin,1546,druid,restoration,115,53,62
Rasgabuxoh,azralon,1545,druid,restoration,41,21,20
Bedlam,zuljin,1544,druid,restoration,60,25,35
Tigerpaw,eonar,1543,druid,restoration,77,30,47
Moonyy,emerald-dream,1542,druid,restoration,42,20,22
Leleoceo,azralon,1541,druid,restoration,30,19,11
Ojdidnt,bleeding-hollow,1541,druid,restoration,48,20,28
Varmint,bleeding-hollow,1539,druid,restoration,136,77,59
Bruitzya,barthilas,1537,druid,restoration,45,30,15
Junjunxi,tichondrius,1535,druid,restoration,48,34,14
Frydaze,tichondrius,1535,druid,restoration,54,26,28
Evokade,dalaran,1534,druid,restoration,42,28,14
Unis,tichondrius,1534,druid,restoration,43,22,21
Foxwit,jubeithos,1534,druid,restoration,72,33,39
Jrën,tichondrius,1533,druid,restoration,24,16,8
Nikotser,dreadmaul,1531,druid,restoration,39,18,21
Utterhots,bleeding-hollow,1530,druid,restoration,174,98,76
Ourse,frostmourne,1528,druid,restoration,35,23,12
Creamjr,tichondrius,1528,druid,restoration,30,16,14
Peakedinwod,sargeras,1527,druid,restoration,54,21,33
Spurzky,emerald-dream,1526,druid,restoration,46,26,20
Meruemoo,tichondrius,1524,druid,restoration,410,206,204
Lolomas,proudmoore,1524,druid,restoration,54,26,28
Mortqt,tichondrius,1524,druid,restoration,96,44,52
Dkfm,thrall,1523,druid,restoration,558,286,272
Vinnydruid,tichondrius,1523,druid,restoration,55,24,31
Swiftydel,frostmourne,1522,druid,restoration,109,61,48
Madowl,tichondrius,1522,druid,restoration,48,22,26
Pancitas,quelthalas,1519,druid,restoration,174,92,82
Druidnim,tichondrius,1519,druid,restoration,90,46,44
Buffdisc,darkspear,1518,druid,restoration,18,16,2
Furrytorpedo,tichondrius,1518,druid,restoration,54,30,24
Bfaboomy,stormrage,1517,druid,restoration,30,16,14
Oneinchclaw,malganis,1516,druid,restoration,220,118,102
Lilbigcow,gnomeregan,1515,druid,restoration,176,77,99
Icehulk,kelthuzad,1510,druid,restoration,30,16,14
Hravan,dentarg,1510,druid,restoration,55,28,27
Cndistance,tichondrius,1509,druid,restoration,83,42,41
Methyld,frostmourne,1508,druid,restoration,96,36,60
Cokernut,tichondrius,1507,druid,restoration,30,16,14
Empcassi,wyrmrest-accord,1505,druid,restoration,95,59,36
Baduret,dalaran,1505,druid,restoration,55,33,22
Aristeus,kelthuzad,1504,druid,restoration,293,159,134
Poscod,tichondrius,1504,druid,restoration,60,26,34
Busanmilk,tichondrius,1500,druid,restoration,72,37,35
Naturetazerr,sargeras,1500,druid,restoration,54,27,27
Hdruid,tichondrius,1497,druid,restoration,205,106,99
Redpigo,tichondrius,1497,druid,restoration,36,18,18
Redo,zuluhed,1496,druid,restoration,30,16,14
Pëndulum,illidan,1496,druid,restoration,114,53,61
Erogan,eitrigg,1496,druid,restoration,54,25,29
Anthracnose,zuljin,1496,druid,restoration,66,30,36
Percocetxo,malganis,1496,druid,restoration,60,22,38
Mxlasthope,stormrage,1495,druid,restoration,47,26,21
Overthink,daggerspine,1492,druid,restoration,24,16,8
Akeven,illidan,1491,druid,restoration,68,31,37
Ebyx,frostmourne,1487,druid,restoration,120,67,53
Standee,sargeras,1486,druid,restoration,94,50,44
Lusam,korialstrasz,1485,druid,restoration,70,40,30
Rhorr,frostmourne,1484,druid,restoration,36,17,19
Iâmkyle,darkspear,1481,druid,restoration,30,19,11
Hotemz,dragonmaw,1481,druid,restoration,78,43,35
Knottywood,muradin,1481,druid,restoration,53,28,25
Stonemonkey,sargeras,1480,druid,restoration,85,38,47
Julx,nordrassil,1479,druid,restoration,42,29,13
Counsyl,silvermoon,1478,druid,restoration,30,18,12
Zxxzy,tichondrius,1477,druid,restoration,44,19,25
Zoeishyper,sargeras,1477,druid,restoration,47,18,29
Gizho,dark-iron,1476,druid,restoration,33,19,14
Berzz,frostmourne,1476,druid,restoration,259,127,132
Selling,moon-guard,1476,druid,restoration,60,27,33
Growl,jubeithos,1476,druid,restoration,48,19,29
Grimo,illidan,1474,druid,restoration,50,31,19
Sowo,sargeras,1474,druid,restoration,42,20,22
Rlzdruid,tichondrius,1474,druid,restoration,70,31,39
Lutein,tichondrius,1474,druid,restoration,77,31,46
Saego,draktharon,1472,druid,restoration,78,45,33
Bobx,kelthuzad,1467,druid,restoration,66,26,40
Daltius,illidan,1465,druid,restoration,72,28,44
Opim,sargeras,1465,druid,restoration,42,16,26
Spuncone,frostmourne,1463,druid,restoration,42,24,18
Dolwizz,tichondrius,1463,druid,restoration,274,135,139
Greylyth,moon-guard,1462,druid,restoration,66,33,33
Tandrood,tichondrius,1462,druid,restoration,54,24,30
Rahaab,sargeras,1462,druid,restoration,62,26,36
Barecow,tichondrius,1461,druid,restoration,111,60,51
Unpeelable,stormrage,1460,druid,restoration,24,16,8
Uniquexia,tichondrius,1460,druid,restoration,78,23,55
Gokki,zuljin,1459,druid,restoration,40,25,15
Elliar,akama,1459,druid,restoration,78,38,40
Dypx,tichondrius,1458,druid,restoration,202,98,104
Léaf,velen,1457,druid,restoration,74,40,34
Eviltwín,frostmourne,1456,druid,restoration,48,27,21
Faramar,sargeras,1456,druid,restoration,35,16,19
Carcitox,ragnaros,1456,druid,restoration,54,22,32
Fukwitmefamo,kelthuzad,1455,druid,restoration,64,36,28
Lothail,windrunner,1454,druid,restoration,30,19,11
Chaníng,frostmourne,1452,druid,restoration,36,18,18
Gypsysoul,barthilas,1450,druid,restoration,29,16,13
Sanitaizr,arthas,1446,druid,restoration,66,29,37
Lorca,stormrage,1444,druid,restoration,72,45,27
Weedmunchies,kelthuzad,1443,druid,restoration,48,23,25
Rikishi,executus,1441,druid,restoration,52,27,25
Shiftydon,borean-tundra,1441,druid,restoration,39,18,21
Bitsandbobs,tichondrius,1440,druid,restoration,131,54,77
Volktots,bleeding-hollow,1439,druid,restoration,114,61,53
Evolved,darkspear,1438,druid,restoration,24,15,9
Hotwolf,tichondrius,1438,druid,restoration,48,26,22
Zaelos,proudmoore,1435,druid,restoration,60,23,37
Rougaroux,andorhal,1434,druid,restoration,168,75,93
Arkenix,velen,1433,druid,restoration,42,21,21
Jonnygg,illidan,1433,druid,restoration,36,15,21
Vuru,azralon,1432,druid,restoration,72,33,39
Edraen,zuljin,1431,druid,restoration,155,79,76
Bodyluvlee,zuljin,1430,druid,restoration,104,54,50
Cutely,tichondrius,1430,druid,restoration,177,88,89
Treelomilo,stormrage,1429,druid,restoration,91,52,39
Prevail,nazgrel,1429,druid,restoration,145,77,68
Vakimumu,anubarak,1429,druid,restoration,96,46,50
Thornblade,stormrage,1427,druid,restoration,30,15,15
Strokingmyd,illidan,1427,druid,restoration,63,31,32
Spoogel,area-52,1426,druid,restoration,37,17,20
Hyne,emerald-dream,1425,druid,restoration,114,62,52
Bruujz,moon-guard,1424,druid,restoration,54,33,21
Blinxxy,bleeding-hollow,1423,druid,restoration,42,21,21
Nestaballo,illidan,1422,druid,restoration,136,74,62
Pÿe,bleeding-hollow,1422,druid,restoration,66,30,36
Shirô,bleeding-hollow,1421,druid,restoration,115,59,56
Haymade,sargeras,1419,druid,restoration,84,40,44
Cakeinalake,bleeding-hollow,1417,druid,restoration,24,15,9
Çuradora,tichondrius,1416,druid,restoration,41,24,17
Clubroot,sargeras,1416,druid,restoration,60,24,36
Lucked,tichondrius,1415,druid,restoration,24,15,9
Komaner,frostmourne,1414,druid,restoration,48,21,27
Kaerrort,sargeras,1412,druid,restoration,26,15,11
Magicrock,moon-guard,1411,druid,restoration,72,44,28
Hibernate,illidan,1411,druid,restoration,30,15,15
Brandonxerox,tichondrius,1410,druid,restoration,45,24,21
Verkara,stormrage,1410,druid,restoration,94,42,52
Meepø,mugthol,1409,druid,restoration,115,60,55
Approx,tichondrius,1409,druid,restoration,145,68,77
Tickman,altar-of-storms,1409,druid,restoration,48,22,26
Toslick,kelthuzad,1408,druid,restoration,213,117,96
Fergsy,frostmourne,1407,druid,restoration,42,24,18
Ozanji,wyrmrest-accord,1406,druid,restoration,30,17,13
Isiliar,nerzhul,1405,druid,restoration,66,35,31
Sharkhotzlol,frostmourne,1405,druid,restoration,60,21,39
Twentyfour,laughing-skull,1402,druid,restoration,72,30,42
Gôdôfwow,tichondrius,1402,druid,restoration,77,31,46
Ñazary,thrall,1401,druid,restoration,47,30,17
Lunkz,tichondrius,1401,druid,restoration,350,180,170
Classydruid,spinebreaker,1401,druid,restoration,333,166,167
Wackyoff,malganis,1399,druid,restoration,30,21,9
Biggucci,stonemaul,1399,druid,restoration,30,18,12
Ursiiday,sargeras,1399,druid,restoration,90,32,58
Onblue,tichondrius,1398,druid,restoration,53,31,22
Pouncing,sargeras,1397,druid,restoration,56,29,27
Bobobear,proudmoore,1397,druid,restoration,66,28,38
Cyclone,mugthol,1396,druid,restoration,24,19,5
Horymory,darkspear,1396,druid,restoration,246,126,120
Tigd,alleria,1396,druid,restoration,30,15,15
Bridgerén,tichondrius,1395,druid,restoration,36,15,21
Fryy,balnazzar,1394,druid,restoration,36,17,19
Murkeÿ,frostmourne,1391,druid,restoration,24,15,9
Anotherstar,frostmourne,1391,druid,restoration,186,92,94
Donnà,tichondrius,1390,druid,restoration,63,33,30
Lorern,eldrethalas,1390,druid,restoration,60,30,30
Lexut,ragnaros,1388,druid,restoration,36,16,20
Drchronic,boulderfist,1387,druid,restoration,59,32,27
Taufik,azralon,1387,druid,restoration,54,24,30
Pumma,darkspear,1385,druid,restoration,34,17,17
Kroshape,stormrage,1385,druid,restoration,49,22,27
Cinderellax,illidan,1384,druid,restoration,42,25,17
Darimmx,mannoroth,1384,druid,restoration,134,68,66
Nanniel,tichondrius,1383,druid,restoration,54,24,30
Mkat,illidan,1383,druid,restoration,48,19,29
Haful,emerald-dream,1382,druid,restoration,45,23,22
Icastsmells,tichondrius,1381,druid,restoration,57,36,21
Sheeyts,tichondrius,1381,druid,restoration,31,16,15
Mudpi,illidan,1377,druid,restoration,77,39,38
Shifftycent,trollbane,1376,druid,restoration,84,42,42
Clarice,shattered-halls,1376,druid,restoration,42,17,25
Lostnsauce,tichondrius,1375,druid,restoration,72,30,42
Maaui,sargeras,1374,druid,restoration,48,24,24
Jimjab,stormreaver,1371,druid,restoration,72,42,30
Jijunss,tichondrius,1371,druid,restoration,47,27,20
Azshunara,moon-guard,1369,druid,restoration,84,43,41
Eraticdruid,illidan,1367,druid,restoration,60,24,36
Deamondruidz,kaelthas,1367,druid,restoration,78,31,47
Farmageddon,thunderhorn,1365,druid,restoration,58,33,25
Kupos,lightbringer,1364,druid,restoration,75,37,38
Poutyface,sargeras,1364,druid,restoration,152,67,85
Rawrl,illidan,1363,druid,restoration,36,16,20
Daku,moknathal,1362,druid,restoration,64,31,33
Vallk,area-52,1362,druid,restoration,46,15,31
Twistay,tichondrius,1361,druid,restoration,40,25,15
Fatherbanger,blackrock,1361,druid,restoration,42,20,22
Sorrinn,tichondrius,1361,druid,restoration,36,17,19
Skêet,tichondrius,1359,druid,restoration,49,28,21
Santiagowski,ragnaros,1359,druid,restoration,52,26,26
Ÿozsh,azralon,1358,druid,restoration,82,45,37
Amandi,magtheridon,1358,druid,restoration,48,26,22
Bloodshadez,tichondrius,1358,druid,restoration,38,20,18
Wythrim,quelthalas,1357,druid,restoration,30,17,13
Thõrr,tichondrius,1357,druid,restoration,93,46,47
Mandingodam,auchindoun,1357,druid,restoration,72,33,39
Silit,tichondrius,1355,druid,restoration,78,41,37
Kergai,emerald-dream,1355,druid,restoration,102,53,49
Muatigorn,blackrock,1354,druid,restoration,50,25,25
Duckyy,garithos,1354,druid,restoration,60,24,36
Kronik,jubeithos,1354,druid,restoration,91,32,59
Bigrich,malorne,1352,druid,restoration,48,23,25
Oobuck,kilrogg,1350,druid,restoration,123,63,60
Kevarcen,dalaran,1350,druid,restoration,161,79,82
Jessbearly,kiljaeden,1349,druid,restoration,48,24,24
Heniuhojia,tichondrius,1348,druid,restoration,24,15,9
Feraldudu,illidan,1347,druid,restoration,133,69,64
Bukbukboom,thunderlord,1347,druid,restoration,41,18,23
Malfurionis,tichondrius,1347,druid,restoration,42,17,25
Branu,hyjal,1347,druid,restoration,42,15,27
Corkybucek,frostmourne,1346,druid,restoration,56,32,24
Gladelf,sargeras,1346,druid,restoration,306,154,152
Izzabelle,deathwing,1344,druid,restoration,31,17,14
Phåtkid,darkspear,1344,druid,restoration,66,34,32
Amanthw,tichondrius,1344,druid,restoration,77,34,43
Delody,tichondrius,1343,druid,restoration,38,23,15
Puzzlebox,illidan,1343,druid,restoration,24,14,10
Pollished,kelthuzad,1343,druid,restoration,95,52,43
Kimnim,tichondrius,1343,druid,restoration,108,57,51
Cantmeldthis,zuljin,1340,druid,restoration,30,14,16
Bearthisnut,bonechewer,1340,druid,restoration,36,15,21
Bleedhoof,frostmourne,1340,druid,restoration,48,19,29
Redness,daggerspine,1339,druid,restoration,37,19,18
Lazza,blackhand,1339,druid,restoration,34,17,17
Groschats,area-52,1339,druid,restoration,42,14,28
Veganz,moon-guard,1338,druid,restoration,178,93,85
Ripberg,chogall,1338,druid,restoration,30,14,16
Cznfik,area-52,1338,druid,restoration,78,32,46
Doglightning,illidan,1336,druid,restoration,25,15,10
Boomfire,thaurissan,1335,druid,restoration,24,18,6
Beefyhealz,emerald-dream,1335,druid,restoration,91,56,35
Petmydeadcow,illidan,1335,druid,restoration,157,78,79
Vecuronium,tichondrius,1335,druid,restoration,30,14,16
Joopsy,tichondrius,1332,druid,restoration,305,159,146
Tofumation,gorgonnash,1332,druid,restoration,49,25,24
Anchunlol,tichondrius,1332,druid,restoration,36,18,18
Turftiger,stormrage,1331,druid,restoration,30,16,14
Girthture,tichondrius,1330,druid,restoration,130,63,67
Kritscawk,sargeras,1329,druid,restoration,60,33,27
Bobochi,tichondrius,1329,druid,restoration,36,16,20
Rígo,frostmourne,1328,druid,restoration,39,21,18
Chowyunfats,proudmoore,1328,druid,restoration,407,212,195
Hynz,barthilas,1327,druid,restoration,36,15,21
Treesh,kelthuzad,1327,druid,restoration,38,14,24
Reyvin,illidan,1326,druid,restoration,97,42,55
Ulfaar,frostmourne,1325,druid,restoration,30,21,9
Dokasaurus,lightbringer,1325,druid,restoration,36,17,19
Blizted,tichondrius,1325,druid,restoration,30,14,16
Vondutch,tichondrius,1323,druid,restoration,72,28,44
Hippystick,tichondrius,1321,druid,restoration,52,24,28
Puntcounder,sargeras,1320,druid,restoration,40,21,19
Nxghtfall,tichondrius,1319,druid,restoration,122,65,57
Undaunted,bloodhoof,1319,druid,restoration,30,14,16
Youngteezy,barthilas,1319,druid,restoration,142,53,89
Okiesmokied,proudmoore,1317,druid,restoration,42,20,22
Rwi,tichondrius,1316,druid,restoration,111,51,60
Zelyvia,moon-guard,1313,druid,restoration,24,14,10
Trippyheals,korgath,1313,druid,restoration,36,20,16
Freehealjob,lightnings-blade,1313,druid,restoration,30,14,16
Kzinti,zuluhed,1312,druid,restoration,30,14,16
Drudax,kelthuzad,1311,druid,restoration,42,21,21
Bcktobasics,emerald-dream,1307,druid,restoration,36,14,22
Ghirox,stormrage,1306,druid,restoration,54,26,28
Minokawa,kargath,1305,druid,restoration,44,23,21
Dgdruid,tichondrius,1305,druid,restoration,48,24,24
Benjixx,proudmoore,1304,druid,restoration,60,26,34
Kuwä,proudmoore,1303,druid,restoration,285,141,144
Gaawdx,illidan,1303,druid,restoration,54,25,29
Needabandaid,arthas,1300,druid,restoration,54,26,28
Yoshí,emerald-dream,1299,druid,restoration,51,22,29
Purpleleaves,stormrage,1299,druid,restoration,119,51,68
Bigherbo,zuljin,1298,druid,restoration,187,98,89
Kittyboiz,illidan,1298,druid,restoration,72,37,35
Lahsa,tichondrius,1298,druid,restoration,91,46,45
Caustìk,malganis,1297,druid,restoration,76,41,35
Haohomie,tichondrius,1297,druid,restoration,59,31,28
Controlyolo,stormrage,1297,druid,restoration,79,36,43
Lighthoof,mannoroth,1296,druid,restoration,30,17,13
Rooroo,ragnaros,1296,druid,restoration,28,15,13
Carlo,blackrock,1296,druid,restoration,71,38,33
Pronewb,frostmourne,1295,druid,restoration,24,18,6
Entydruid,khazgoroth,1295,druid,restoration,34,19,15
Plagiarist,stormrage,1295,druid,restoration,44,20,24
Ohhshiift,tichondrius,1295,druid,restoration,33,14,19
Dankmids,hyjal,1294,druid,restoration,30,19,11
Elvishchamp,mugthol,1293,druid,restoration,41,19,22
Catatonik,emerald-dream,1293,druid,restoration,42,18,24
Bosscjp,tichondrius,1291,druid,restoration,52,26,26
Jungleakso,tichondrius,1291,druid,restoration,42,18,24
Haneulso,tichondrius,1290,druid,restoration,55,30,25
Sloptoucher,barthilas,1289,druid,restoration,35,17,18
Flexxfurion,thrall,1288,druid,restoration,48,24,24
Bovindickus,tichondrius,1287,druid,restoration,78,35,43
Apoxi,arygos,1284,druid,restoration,42,24,18
Glenglooie,tichondrius,1283,druid,restoration,48,18,30
Eliaris,rivendare,1282,druid,restoration,30,15,15
Ananan,burning-blade,1282,druid,restoration,101,49,52
Ravendar,moon-guard,1282,druid,restoration,89,39,50
Shallowcat,tichondrius,1281,druid,restoration,65,28,37
Däll,tichondrius,1280,druid,restoration,48,20,28
Chyx,stormreaver,1280,druid,restoration,56,23,33
Nytecrawler,bonechewer,1279,druid,restoration,30,19,11
Nogàrd,arygos,1279,druid,restoration,23,14,9
Birdie,dalvengyr,1279,druid,restoration,37,20,17
Naseebo,frostmourne,1279,druid,restoration,67,25,42
Raghid,kelthuzad,1278,druid,restoration,48,26,22
Zambyr,azralon,1278,druid,restoration,66,28,38
Whispurrz,tichondrius,1277,druid,restoration,391,200,191
Elendriss,quelthalas,1277,druid,restoration,85,42,43
Afonso,frostmourne,1276,druid,restoration,50,26,24
Odcerberus,azralon,1275,druid,restoration,42,21,21
Skymund,tichondrius,1273,druid,restoration,56,30,26
Juuru,stormreaver,1272,druid,restoration,36,27,9
Darksteak,tichondrius,1272,druid,restoration,214,111,103
Tenhoteta,goldrinn,1272,druid,restoration,48,22,26
Jruids,stormrage,1272,druid,restoration,54,23,31
Hellahots,spinebreaker,1271,druid,restoration,29,18,11
Drazibaz,thrall,1271,druid,restoration,42,24,18
Bandruid,tichondrius,1271,druid,restoration,28,14,14
Sxlanderx,malganis,1271,druid,restoration,118,58,60
Longisland,quelthalas,1271,druid,restoration,114,56,58
Diglit,malganis,1271,druid,restoration,70,28,42
Lopper,hyjal,1269,druid,restoration,36,20,16
Tuskdaddie,sargeras,1268,druid,restoration,48,29,19
Ephemere,emerald-dream,1268,druid,restoration,40,20,20
Lynncheeks,spirestone,1267,druid,restoration,77,44,33
Aaughh,sargeras,1266,druid,restoration,94,43,51
Tallenzz,lightninghoof,1265,druid,restoration,96,53,43
Acexten,tichondrius,1265,druid,restoration,42,21,21
Adaralia,tichondrius,1265,druid,restoration,70,28,42
Cleptoresto,dalaran,1265,druid,restoration,46,16,30
Dummedruid,illidan,1264,druid,restoration,42,14,28
Iambeefy,hyjal,1263,druid,restoration,233,116,117
Slév,frostmourne,1263,druid,restoration,35,17,18
Elgatomarica,ragnaros,1262,druid,restoration,65,35,30
Druidlstrudl,moon-guard,1261,druid,restoration,60,22,38
Asaphelps,stormrage,1260,druid,restoration,28,14,14
Madsewerslvt,stormrage,1260,druid,restoration,167,82,85
Ceejaé,tichondrius,1259,druid,restoration,70,36,34
Vexcey,sargeras,1258,druid,restoration,29,16,13
Boomchí,tichondrius,1258,druid,restoration,36,15,21
Lindi,kelthuzad,1257,druid,restoration,78,42,36
Travys,sargeras,1256,druid,restoration,48,23,25
Dolanaar,stormrage,1255,druid,restoration,179,93,86
Crackheads,tichondrius,1255,druid,restoration,91,45,46
Skotty,hyjal,1253,druid,restoration,66,30,36
Rockmeifucan,greymane,1253,druid,restoration,78,33,45
Katherine,moon-guard,1251,druid,restoration,132,62,70
Sarojna,malganis,1250,druid,restoration,19,14,5
Yakuho,proudmoore,1250,druid,restoration,32,20,12
Carlosd,tichondrius,1250,druid,restoration,58,33,25
Romcom,demon-soul,1250,druid,restoration,54,30,24
Jacknit,illidan,1250,druid,restoration,28,15,13
Airmíd,illidan,1250,druid,restoration,68,22,46
Saelyle,illidan,1248,druid,restoration,53,28,25
Thericebags,illidan,1248,druid,restoration,197,103,94
Nogardfan,tichondrius,1247,druid,restoration,24,13,11
Yaato,illidan,1247,druid,restoration,96,46,50
Ninzor,tichondrius,1247,druid,restoration,30,13,17
Cøkelol,zuljin,1246,druid,restoration,52,29,23
Zukrath,shadow-council,1245,druid,restoration,30,13,17
Jnzid,area-52,1244,druid,restoration,29,13,16
Hgoo,tichondrius,1244,druid,restoration,30,13,17
Bunrack,nerzhul,1243,druid,restoration,57,30,27
Wp,proudmoore,1243,druid,restoration,92,47,45
Morphios,barthilas,1243,druid,restoration,100,47,53
Krözjk,quelthalas,1243,druid,restoration,63,29,34
Galadrielcn,tichondrius,1243,druid,restoration,60,24,36
Fórmérfáttý,kelthuzad,1242,druid,restoration,18,13,5
Perilous,malygos,1242,druid,restoration,24,13,11
Goosebümps,stormrage,1242,druid,restoration,24,13,11
Kasannaommi,sargeras,1241,druid,restoration,96,49,47
Speaks,moon-guard,1240,druid,restoration,137,65,72
Sneakysoren,kelthuzad,1240,druid,restoration,53,24,29
Kendoboos,moon-guard,1240,druid,restoration,72,32,40
Cuccii,sargeras,1240,druid,restoration,30,13,17
Socktad,illidan,1240,druid,restoration,36,13,23
Kustumsdog,tichondrius,1239,druid,restoration,24,13,11
Feldstarx,stormrage,1238,druid,restoration,24,13,11
Larc,frostwolf,1238,druid,restoration,76,39,37
Magzally,stormrage,1238,druid,restoration,30,13,17
Tardcakes,tichondrius,1238,druid,restoration,116,50,66
Kyndel,kiljaeden,1237,druid,restoration,44,22,22
Amatxu,ragnaros,1237,druid,restoration,129,64,65
Nanate,sargeras,1237,druid,restoration,59,29,30
Tumultz,frostmourne,1235,druid,restoration,24,13,11
Jonculler,korgath,1235,druid,restoration,75,37,38
Erykk,dalaran,1234,druid,restoration,24,14,10
Lissette,thrall,1234,druid,restoration,24,13,11
Edbtw,azralon,1234,druid,restoration,116,58,58
Svarne,kiljaeden,1232,druid,restoration,59,29,30
Jonoa,nagrand,1232,druid,restoration,36,16,20
Catterpiller,daggerspine,1231,druid,restoration,18,13,5
Shekelsnätch,area-52,1231,druid,restoration,42,21,21
Mhdd,tichondrius,1230,druid,restoration,54,25,29
Kerrzo,frostmourne,1230,druid,restoration,48,22,26
Slev,frostmourne,1229,druid,restoration,24,13,11
Menace,rexxar,1228,druid,restoration,33,19,14
Kastro,frostwolf,1228,druid,restoration,192,103,89
Bhagwan,area-52,1227,druid,restoration,48,18,30
Imakitty,aerie-peak,1226,druid,restoration,121,62,59
Carneluna,area-52,1226,druid,restoration,66,31,35
Suye,tichondrius,1226,druid,restoration,66,30,36
Xay,runetotem,1225,druid,restoration,36,20,16
Wildwhisper,moon-guard,1225,druid,restoration,96,50,46
Tìssuebox,malganis,1225,druid,restoration,81,36,45
Smilax,eonar,1225,druid,restoration,98,42,56
Bumî,zuljin,1223,druid,restoration,30,13,17
Yellowstone,drakthul,1222,druid,restoration,42,23,19
Purrfact,frostmourne,1222,druid,restoration,30,13,17
Torofarmeon,quelthalas,1221,druid,restoration,57,32,25
Anothersalad,stormrage,1221,druid,restoration,66,32,34
Feutrine,zuljin,1221,druid,restoration,51,24,27
Beladrexx,stormrage,1221,druid,restoration,54,21,33
Druidkingdk,stormrage,1218,druid,restoration,29,18,11
Ännä,moon-guard,1217,druid,restoration,30,13,17
Kipsi,frostmourne,1215,druid,restoration,23,18,5
Hotkage,tichondrius,1215,druid,restoration,42,21,21
Junglefists,frostmourne,1215,druid,restoration,179,89,90
Malice,undermine,1215,druid,restoration,54,24,30
Healingcute,tichondrius,1213,druid,restoration,151,79,72
Mcriblet,illidan,1213,druid,restoration,46,23,23
Greemer,sargeras,1213,druid,restoration,39,18,21
Bunnyes,tichondrius,1212,druid,restoration,59,29,30
Kybecruz,stormrage,1212,druid,restoration,156,71,85
Gryel,area-52,1211,druid,restoration,235,122,113
Dalrei,jubeithos,1211,druid,restoration,30,13,17
Cshafty,illidan,1210,druid,restoration,59,29,30
Tworax,frostmourne,1210,druid,restoration,36,14,22
Ulfaren,frostmourne,1209,druid,restoration,24,15,9
Layala,sargeras,1209,druid,restoration,96,48,48
Gossìpgoat,frostmourne,1209,druid,restoration,86,42,44
Pyrogenics,whisperwind,1209,druid,restoration,42,20,22
Trolbearpig,malganis,1208,druid,restoration,24,13,11
Groõt,barthilas,1208,druid,restoration,183,83,100
Beleraine,moon-guard,1208,druid,restoration,40,17,23
Zoeyx,tichondrius,1207,druid,restoration,61,36,25
Prudence,azralon,1205,druid,restoration,48,25,23
Feykurds,sargeras,1205,druid,restoration,60,21,39
Bearuffinz,malganis,1204,druid,restoration,100,48,52
Astrosapien,moon-guard,1203,druid,restoration,72,35,37
Blürry,area-52,1203,druid,restoration,42,13,29
Meôwmix,stormrage,1202,druid,restoration,24,13,11
Bearlielegal,stormrage,1202,druid,restoration,48,24,24
Imrac,boulderfist,1202,druid,restoration,48,17,31
Cuddles,moon-guard,1201,druid,restoration,137,67,70
Driftwood,bonechewer,1201,druid,restoration,64,27,37
Razakka,stormrage,1201,druid,restoration,47,13,34
Bikacat,kelthuzad,1200,druid,restoration,24,13,11
Mf,stormscale,1200,druid,restoration,52,25,27
Seizuressld,stormrage,1198,druid,restoration,106,57,49
Dankcentral,frostwolf,1198,druid,restoration,106,57,49
Dimzim,lightbringer,1198,druid,restoration,66,31,35
Panorämix,nemesis,1197,druid,restoration,18,13,5
Feanah,tichondrius,1197,druid,restoration,32,14,18
Earwën,ragnaros,1196,druid,restoration,60,25,35
Yourka,uther,1195,druid,restoration,74,43,31
Nugren,thrall,1195,druid,restoration,50,22,28
Fermata,aegwynn,1193,druid,restoration,40,24,16
Ruskii,executus,1193,druid,restoration,54,23,31
Clawriander,barthilas,1192,druid,restoration,120,60,60
Sweetcorn,malganis,1192,druid,restoration,40,16,24
Erû,ragnaros,1191,druid,restoration,28,15,13
Tankbaron,bleeding-hollow,1189,druid,restoration,24,14,10
Cheddastov,illidan,1189,druid,restoration,27,14,13
Dunedaddy,silvermoon,1188,druid,restoration,64,35,29
Knowgo,tichondrius,1188,druid,restoration,54,28,26
Kaylabooz,tichondrius,1188,druid,restoration,30,15,15
Ihideuseek,bloodscalp,1187,druid,restoration,54,17,37
Tarzzan,drakkari,1186,druid,restoration,24,18,6
Adarindre,aerie-peak,1185,druid,restoration,93,46,47
Alewild,quelthalas,1185,druid,restoration,54,26,28
Dainehoof,area-52,1185,druid,restoration,66,28,38
Panacaea,windrunner,1184,druid,restoration,48,27,21
Gorillagloo,area-52,1184,druid,restoration,103,49,54
Pawpurrazzi,moon-guard,1183,druid,restoration,17,13,4
Smhyle,frostmourne,1183,druid,restoration,61,33,28
Hadoriss,kelthuzad,1183,druid,restoration,48,18,30
Foxbear,garona,1182,druid,restoration,63,39,24
Burdup,tichondrius,1182,druid,restoration,60,35,25
Frames,area-52,1181,druid,restoration,246,122,124
Worgbearpig,destromath,1180,druid,restoration,32,14,18
Valeñtine,dalaran,1179,druid,restoration,78,39,39
Lewïs,stormrage,1178,druid,restoration,144,79,65
Drexsabex,tichondrius,1176,druid,restoration,42,25,17
Quan,illidan,1176,druid,restoration,66,33,33
Filthyclaws,stormrage,1174,druid,restoration,76,26,50
Deximus,wyrmrest-accord,1173,druid,restoration,24,13,11
Alastras,tichondrius,1173,druid,restoration,36,18,18
Hruke,illidan,1173,druid,restoration,42,17,25
Aterra,ragnaros,1172,druid,restoration,104,47,57
Vacote,aggramar,1172,druid,restoration,75,27,48
Schlotzsky,skullcrusher,1171,druid,restoration,69,37,32
Lizzelune,drakkari,1171,druid,restoration,118,56,62
Psycloned,magtheridon,1171,druid,restoration,34,13,21
Curze,maiev,1170,druid,restoration,42,18,24
Vantorsydmel,proudmoore,1167,druid,restoration,46,24,22
Chixao,tichondrius,1166,druid,restoration,23,13,10
Aramá,drakkari,1166,druid,restoration,43,21,22
Fortnitburgr,tichondrius,1165,druid,restoration,24,13,11
Matpd,norgannon,1165,druid,restoration,124,61,63
Yanga,malfurion,1163,druid,restoration,48,27,21
Sodury,tichondrius,1161,druid,restoration,178,99,79
Höneyfang,moon-guard,1161,druid,restoration,101,56,45
Cocomint,wyrmrest-accord,1161,druid,restoration,33,16,17
Thicclesbean,tichondrius,1160,druid,restoration,43,23,20
Müfasä,azralon,1160,druid,restoration,66,33,33
Muukair,ragnaros,1160,druid,restoration,71,33,38
Sarangzzang,tichondrius,1159,druid,restoration,37,22,15
Pachacamac,dragonmaw,1159,druid,restoration,36,21,15
Bäñgarang,tichondrius,1159,druid,restoration,78,41,37
Lenori,vashj,1159,druid,restoration,48,24,24
Kitiano,thunderlord,1158,druid,restoration,66,25,41
Crunchyleafs,thrall,1157,druid,restoration,29,21,8
Fioryxd,bleeding-hollow,1157,druid,restoration,56,27,29
Goodhealer,akama,1156,druid,restoration,54,36,18
Lünaä,quelthalas,1155,druid,restoration,71,47,24
Sharialawl,stormreaver,1154,druid,restoration,30,13,17
Pekingcuckoo,illidan,1152,druid,restoration,24,12,12
Doah,kelthuzad,1152,druid,restoration,24,12,12
Feroce,executus,1152,druid,restoration,24,12,12
Hoedrufroza,tichondrius,1152,druid,restoration,24,12,12
Rekelberg,sargeras,1151,druid,restoration,18,12,6
Beecammy,frostmourne,1151,druid,restoration,54,31,23
Nìghtshift,moon-guard,1151,druid,restoration,30,12,18
Blackmoomba,kiljaeden,1150,druid,restoration,16,13,3
Tiggor,ghostlands,1150,druid,restoration,18,12,6
Iheartpvp,tichondrius,1150,druid,restoration,63,30,33
Shanê,proudmoore,1150,druid,restoration,85,36,49
Nodab,tichondrius,1150,druid,restoration,30,12,18
Concordya,tichondrius,1149,druid,restoration,59,29,30
Mommymilkers,jubeithos,1149,druid,restoration,54,14,40
Æpex,lightnings-blade,1148,druid,restoration,30,16,14
Melbian,tichondrius,1148,druid,restoration,160,81,79
Gizho,sargeras,1148,druid,restoration,30,12,18
Patada,sargeras,1148,druid,restoration,30,12,18
Dampchamp,illidan,1148,druid,restoration,36,12,24
Iloveweed,tichondrius,1147,druid,restoration,18,12,6
Rudekiller,balnazzar,1147,druid,restoration,24,13,11
Saltyzz,tichondrius,1147,druid,restoration,36,19,17
Idoldeoz,quelthalas,1147,druid,restoration,36,18,18
Dchizzle,tichondrius,1147,druid,restoration,45,20,25
Kassyx,illidan,1147,druid,restoration,36,12,24
Waxedchest,emerald-dream,1146,druid,restoration,24,12,12
Fatshift,chogall,1145,druid,restoration,122,62,60
Sêxcavator,thrall,1145,druid,restoration,24,12,12
Skibbidy,boulderfist,1145,druid,restoration,33,14,19
Hugharection,illidan,1144,druid,restoration,18,12,6
Kismet,andorhal,1142,druid,restoration,18,12,6
Kiraval,stormrage,1142,druid,restoration,66,29,37
Älef,ragnaros,1140,druid,restoration,60,26,34
Tyrs,aggramar,1140,druid,restoration,35,15,20
Guislstwo,azralon,1140,druid,restoration,70,29,41
Alphalemon,ragnaros,1139,druid,restoration,69,33,36
Wildbite,tichondrius,1138,druid,restoration,20,13,7
Adind,tanaris,1138,druid,restoration,60,32,28
Crapster,boulderfist,1137,druid,restoration,24,12,12
Cear,proudmoore,1137,druid,restoration,45,16,29
Miyeonly,dalaran,1137,druid,restoration,36,12,24
Joya,stormrage,1136,druid,restoration,18,12,6
Chocotoqtt,azralon,1136,druid,restoration,30,12,18
Tîgerlily,proudmoore,1136,druid,restoration,74,24,50
Glenkair,lightnings-blade,1134,druid,restoration,36,17,19
Kagoz,darkspear,1134,druid,restoration,30,12,18
Uttress,kalecgos,1132,druid,restoration,30,14,16
Onlypaws,azjolnerub,1132,druid,restoration,42,17,25
Catlypso,tichondrius,1131,druid,restoration,72,43,29
Mithaelar,moon-guard,1130,druid,restoration,36,13,23
Jabawockdeez,area-52,1129,druid,restoration,42,24,18
Sinapticc,proudmoore,1128,druid,restoration,18,12,6
Ctarla,tichondrius,1128,druid,restoration,24,12,12
Tensuen,boulderfist,1128,druid,restoration,51,21,30
Duxz,tichondrius,1127,druid,restoration,23,13,10
Ateoate,stormscale,1127,druid,restoration,51,24,27
Soxyeon,tichondrius,1127,druid,restoration,53,23,30
Sneakydikns,tichondrius,1127,druid,restoration,36,12,24
Ayadel,moon-guard,1126,druid,restoration,154,74,80
Bussincheeks,tichondrius,1124,druid,restoration,24,14,10
Meonk,frostmourne,1124,druid,restoration,57,27,30
Bubbashift,garona,1124,druid,restoration,60,25,35
Delícíous,darkspear,1123,druid,restoration,55,24,31
Gentlesoapp,blackrock,1122,druid,restoration,48,26,22
Würzel,nemesis,1122,druid,restoration,93,45,48
Buffalobillz,lethon,1120,druid,restoration,70,42,28
Julyto,ragnaros,1120,druid,restoration,24,12,12
Hðthead,area-52,1118,druid,restoration,54,26,28
Ahlekleklekk,azralon,1117,druid,restoration,29,18,11
Naturemagic,malganis,1117,druid,restoration,51,27,24
Kandyshop,gorefiend,1116,druid,restoration,30,22,8
Cipozento,azralon,1116,druid,restoration,109,52,57
Feralgodx,sargeras,1114,druid,restoration,23,12,11
Sinseir,stormscale,1114,druid,restoration,111,47,64
Badferal,blackhand,1113,druid,restoration,55,25,30
Queiq,malganis,1112,druid,restoration,18,12,6
Mcy,nerzhul,1112,druid,restoration,25,13,12
Brotø,nemesis,1112,druid,restoration,90,42,48
Kuaite,azralon,1110,druid,restoration,72,25,47
Löthnälar,ragnaros,1109,druid,restoration,48,24,24
Tricknicgg,illidan,1108,druid,restoration,41,15,26
Terokky,azralon,1107,druid,restoration,24,12,12
Chocoo,thaurissan,1106,druid,restoration,26,13,13
Elylaylalar,moon-guard,1106,druid,restoration,80,35,45
Maddoxi,stormrage,1106,druid,restoration,30,12,18
Apox,zuljin,1105,druid,restoration,34,13,21
Furfu,illidan,1104,druid,restoration,74,33,41
Stupidranga,barthilas,1103,druid,restoration,54,19,35
Tuurban,stormrage,1102,druid,restoration,35,14,21
Azyx,stormrage,1101,druid,restoration,123,58,65
Joink,sargeras,1100,druid,restoration,24,12,12
Renlion,malganis,1100,druid,restoration,41,12,29
Astralyte,kiljaeden,1099,druid,restoration,24,13,11
Benngotit,magtheridon,1099,druid,restoration,27,12,15
Carekoala,wyrmrest-accord,1098,druid,restoration,59,30,29
Idracnine,sargeras,1098,druid,restoration,26,13,13
Cannabull,echo-isles,1097,druid,restoration,33,17,16
Dobidas,tichondrius,1097,druid,restoration,131,66,65
Kymopexy,sargeras,1095,druid,restoration,41,14,27
Battiatus,malganis,1093,druid,restoration,42,19,23
Jabina,detheroc,1093,druid,restoration,54,16,38
Vacablancá,tichondrius,1091,druid,restoration,34,14,20
Tyrantha,emerald-dream,1091,druid,restoration,49,19,30
Barugaf,drakkari,1090,druid,restoration,49,28,21
Devilsparda,frostmane,1090,druid,restoration,60,25,35
Kittne,hellscream,1089,druid,restoration,48,24,24
Notcovet,illidan,1085,druid,restoration,44,22,22
Rockcow,tichondrius,1084,druid,restoration,78,33,45
Berchwunden,ragnaros,1083,druid,restoration,58,27,31
Sharinna,andorhal,1083,druid,restoration,50,16,34
Feckzd,blackhand,1082,druid,restoration,26,13,13
Katdog,warsong,1079,druid,restoration,39,24,15
Duedad,gurubashi,1079,druid,restoration,75,41,34
Volgoro,thrall,1078,druid,restoration,60,25,35
Kittzey,stormrage,1077,druid,restoration,28,14,14
Cratose,runetotem,1073,druid,restoration,59,27,32
Mydira,stormrage,1071,druid,restoration,54,30,24
Dehla,goldrinn,1071,druid,restoration,82,37,45
Quarantinia,arathor,1070,druid,restoration,49,28,21
Samerax,vashj,1070,druid,restoration,107,45,62
Slleep,tichondrius,1069,druid,restoration,54,28,26
Anïtra,illidan,1068,druid,restoration,85,24,61
Gimborion,stormrage,1066,druid,restoration,48,23,25
Jimooin,tichondrius,1066,druid,restoration,36,15,21
Nöches,quelthalas,1065,druid,restoration,32,12,20
Quaileggs,illidan,1064,druid,restoration,36,12,24
Aarandiel,borean-tundra,1063,druid,restoration,30,17,13
Shroomkin,area-52,1063,druid,restoration,69,35,34
Hallowbranch,moon-guard,1062,druid,restoration,44,17,27
Rëroll,zuljin,1059,druid,restoration,17,12,5
Spasmm,tichondrius,1059,druid,restoration,18,12,6
Samuelceo,area-52,1056,druid,restoration,12,11,1
Chinadruids,tichondrius,1056,druid,restoration,18,11,7
Fresh,earthen-ring,1056,druid,restoration,18,11,7
Fracxx,area-52,1056,druid,restoration,18,11,7
Whhm,burning-blade,1056,druid,restoration,24,11,13
Slurpi,barthilas,1056,druid,restoration,30,11,19
Apple,saurfang,1055,druid,restoration,24,11,13
Mumblesd,emerald-dream,1055,druid,restoration,24,11,13
Momorabbitd,tichondrius,1055,druid,restoration,30,11,19
Lindsanr,illidan,1055,druid,restoration,36,11,25
Qkskill,nemesis,1055,druid,restoration,42,11,31
Ordono,emerald-dream,1054,druid,restoration,18,11,7
Krobz,bleeding-hollow,1054,druid,restoration,18,11,7
Etaurne,drakkari,1054,druid,restoration,18,11,7
Jethelium,illidan,1054,druid,restoration,190,103,87
Qkdru,nemesis,1054,druid,restoration,30,11,19
Mollytonasty,demon-soul,1053,druid,restoration,24,11,13
Feralscar,elune,1053,druid,restoration,24,11,13
Kitnip,proudmoore,1052,druid,restoration,24,16,8
Maeo,drenden,1052,druid,restoration,18,11,7
Yorch,stormrage,1052,druid,restoration,60,28,32
Onlyforms,illidan,1052,druid,restoration,24,11,13
Deja,frostmourne,1052,druid,restoration,30,11,19
Marminalade,stormrage,1051,druid,restoration,18,11,7
Nastynancy,frostmourne,1051,druid,restoration,21,12,9
Solisuu,frostmane,1051,druid,restoration,30,11,19
Cres,moon-guard,1051,druid,restoration,42,11,31
Tigranesia,proudmoore,1050,druid,restoration,18,11,7
Agranock,nazgrel,1050,druid,restoration,131,65,66
Acerolita,azralon,1050,druid,restoration,30,11,19
Phxburn,illidan,1050,druid,restoration,30,11,19
Naturamuta,alleria,1049,druid,restoration,24,11,13
Catinthebox,illidan,1048,druid,restoration,18,11,7
Dinglebops,stormrage,1047,druid,restoration,28,15,13
Xzerhos,area-52,1047,druid,restoration,151,70,81
Gruulnir,antonidas,1047,druid,restoration,24,11,13
Cenarïus,stormrage,1047,druid,restoration,98,43,55
Edorant,illidan,1047,druid,restoration,30,11,19
Yimii,stormrage,1046,druid,restoration,18,11,7
Scoobyshiftz,frostmourne,1046,druid,restoration,46,28,18
Zzizi,tichondrius,1046,druid,restoration,29,13,16
Zoll,kelthuzad,1046,druid,restoration,66,26,40
Sbc,anvilmar,1046,druid,restoration,60,21,39
Anasia,barthilas,1045,druid,restoration,99,51,48
Battlecát,stormscale,1045,druid,restoration,24,11,13
Zadayos,aerie-peak,1044,druid,restoration,30,16,14
Duducows,tichondrius,1044,druid,restoration,59,23,36
Druilicious,ghostlands,1043,druid,restoration,55,27,28
Lutzenberger,nemesis,1043,druid,restoration,71,31,40
Capizzi,illidan,1043,druid,restoration,28,12,16
Careless,destromath,1043,druid,restoration,78,33,45
Libel,korgath,1042,druid,restoration,18,11,7
Realhötgirl,moon-guard,1042,druid,restoration,18,11,7
Gairen,the-venture-co,1042,druid,restoration,20,12,8
Twigleg,eonar,1042,druid,restoration,36,11,25
Feaveldin,moon-guard,1041,druid,restoration,18,11,7
Ahrilee,area-52,1040,druid,restoration,75,33,42
Jimmycooks,tichondrius,1039,druid,restoration,18,11,7
Chopleaf,khadgar,1039,druid,restoration,180,92,88
Kanabat,drenden,1039,druid,restoration,24,11,13
Seremap,frostmourne,1038,druid,restoration,72,42,30
Sassyfeline,tichondrius,1038,druid,restoration,36,11,25
Leoha,stormrage,1037,druid,restoration,24,15,9
Iiliith,moon-guard,1037,druid,restoration,24,11,13
Taydruid,stormrage,1037,druid,restoration,54,24,30
Slee,eredar,1035,druid,restoration,18,11,7
Erourk,azralon,1035,druid,restoration,24,12,12
Creasir,tichondrius,1035,druid,restoration,35,12,23
Bearkîng,stormrage,1034,druid,restoration,18,11,7
Breezeys,tichondrius,1033,druid,restoration,35,16,19
Toxicshift,malganis,1033,druid,restoration,39,13,26
Tyrannicool,proudmoore,1033,druid,restoration,40,12,28
Beefcurtâins,aggramar,1032,druid,restoration,18,11,7
Nohkotana,illidan,1032,druid,restoration,28,13,15
Bankinbäbe,illidan,1031,druid,restoration,98,53,45
Israh,malygos,1031,druid,restoration,32,17,15
Delicioso,wyrmrest-accord,1030,druid,restoration,33,21,12
Javoh,drakkari,1030,druid,restoration,25,13,12
Boofndergz,area-52,1027,druid,restoration,24,15,9
Mayarí,sargeras,1027,druid,restoration,50,15,35
Chloroforms,khazgoroth,1025,druid,restoration,76,44,32
Sonrius,proudmoore,1024,druid,restoration,76,38,38
Janaki,malygos,1024,druid,restoration,30,13,17
Imcop,tichondrius,1020,druid,restoration,18,11,7
Troply,ragnaros,1020,druid,restoration,20,12,8
Funnydruid,frostmourne,1020,druid,restoration,42,20,22
Xarressian,moon-guard,1019,druid,restoration,24,11,13
Irushbots,tichondrius,1016,druid,restoration,30,11,19
Skaidi,quelthalas,1015,druid,restoration,54,28,26
Pmsprone,tichondrius,1012,druid,restoration,84,40,44
Milkmoneymeo,illidan,1011,druid,restoration,29,11,18
Drucaicer,quelthalas,1010,druid,restoration,101,56,45
Uwakka,hyjal,1009,druid,restoration,20,12,8
Dorzaku,ragnaros,1009,druid,restoration,108,55,53
Sunneater,azuremyst,1009,druid,restoration,37,18,19
Sangsan,tichondrius,1009,druid,restoration,66,22,44
Rivetrix,azralon,1007,druid,restoration,103,49,54
Simperella,dalaran,1007,druid,restoration,30,12,18
Agnala,drakkari,1007,druid,restoration,99,35,64
Macdonah,tichondrius,1006,druid,restoration,66,33,33
Sorio,area-52,1005,druid,restoration,58,21,37
Keladria,bleeding-hollow,1002,druid,restoration,102,55,47
Guron,aegwynn,1001,druid,restoration,57,30,27
Greenvibes,drakkari,1001,druid,restoration,92,44,48
Yeahhots,frostmourne,1000,druid,restoration,15,12,3
Mainera,sargeras,1000,druid,restoration,26,12,14
Dhannar,proudmoore,999,druid,restoration,18,13,5
Kataless,sargeras,999,druid,restoration,126,67,59
Elanni,illidan,999,druid,restoration,59,22,37
Habit,dragonmaw,998,druid,restoration,27,12,15
Phyllostomus,quelthalas,996,druid,restoration,36,15,21
Smorak,area-52,994,druid,restoration,14,12,2
Alfurr,tichondrius,994,druid,restoration,85,43,42
Hashdxm,tichondrius,991,druid,restoration,20,11,9
Asclepïus,tichondrius,991,druid,restoration,23,11,12
Owl,frostwolf,990,druid,restoration,24,13,11
Hewozuoai,area-52,990,druid,restoration,35,11,24
Astharon,drakkari,989,druid,restoration,56,31,25
Marrana,altar-of-storms,989,druid,restoration,24,13,11
Bonemaul,bonechewer,988,druid,restoration,61,30,31
Cpttspitty,kelthuzad,988,druid,restoration,36,14,22
Minnysoda,area-52,987,druid,restoration,30,14,16
Ganizote,ragnaros,987,druid,restoration,60,20,40
Canche,arthas,986,druid,restoration,34,19,15
Chenxguang,tichondrius,986,druid,restoration,86,45,41
Montileven,moon-guard,985,druid,restoration,20,14,6
Feralgød,tichondrius,985,druid,restoration,30,11,19
Madmandan,moon-guard,984,druid,restoration,42,17,25
Cowchicken,zuljin,982,druid,restoration,34,11,23
Bomme,zuljin,980,druid,restoration,76,36,40
Azshaela,dalaran,979,druid,restoration,36,22,14
Nerfmesoon,sargeras,978,druid,restoration,22,11,11
Dwalk,moknathal,977,druid,restoration,109,53,56
Santicow,ragnaros,975,druid,restoration,20,11,9
Polymorphos,mugthol,973,druid,restoration,42,18,24
Locopewpew,malganis,969,druid,restoration,79,29,50
Seceru,proudmoore,968,druid,restoration,58,31,27
Boomshorts,blackrock,968,druid,restoration,29,14,15
Fionnbharr,ragnaros,968,druid,restoration,104,48,56
Sunyatsen,quelthalas,967,druid,restoration,58,25,33
Tiufill,nemesis,965,druid,restoration,36,19,17
Itzreallyhim,kiljaeden,963,druid,restoration,33,12,21
Wiggle,stormscale,962,druid,restoration,44,21,23
Vulgär,kiljaeden,961,druid,restoration,52,21,31
Salzadruid,aggramar,960,druid,restoration,12,10,2
Solushun,sargeras,960,druid,restoration,12,10,2
Baruc,illidan,960,druid,restoration,12,10,2
Aphroditezs,tichondrius,960,druid,restoration,18,10,8
Kurohîme,illidan,960,druid,restoration,18,10,8
Jiywa,lightbringer,960,druid,restoration,18,10,8
Myovo,tichondrius,960,druid,restoration,18,10,8
Nhin,ghostlands,960,druid,restoration,24,10,14
Smeekq,tichondrius,960,druid,restoration,24,10,14
Suekey,frostmourne,960,druid,restoration,24,10,14
Xiaoyi,tichondrius,959,druid,restoration,12,10,2
Ddi,frostmourne,959,druid,restoration,18,10,8
Eldertroll,boulderfist,959,druid,restoration,18,10,8
Cloneandbone,nerzhul,959,druid,restoration,18,10,8
Tumblr,terenas,959,druid,restoration,18,10,8
Slambeezy,emerald-dream,959,druid,restoration,18,10,8
Garbagebutt,burning-legion,959,druid,restoration,18,10,8
Oblackbetty,illidan,959,druid,restoration,39,18,21
Ooh,stormreaver,958,druid,restoration,18,10,8
Uggadruid,malganis,958,druid,restoration,18,10,8
Tlanquility,tichondrius,958,druid,restoration,18,10,8
Nachopuppet,kelthuzad,958,druid,restoration,51,21,30
Shrooming,frostmourne,958,druid,restoration,30,10,20
Tayokou,zuljin,957,druid,restoration,12,10,2
Oswalphis,moon-guard,957,druid,restoration,18,11,7
Simina,kargath,957,druid,restoration,18,10,8
Dreamgaze,zuljin,957,druid,restoration,18,10,8
Iheartmushu,mannoroth,957,druid,restoration,91,47,44
Ñoobdruid,tichondrius,956,druid,restoration,18,10,8
Cranbérry,sargeras,956,druid,restoration,18,10,8
Vêzpêr,kelthuzad,956,druid,restoration,24,10,14
Rlie,quelthalas,954,druid,restoration,30,10,20
Uttress,tichondrius,953,druid,restoration,18,10,8
Science,arthas,953,druid,restoration,30,10,20
Wildartform,malganis,952,druid,restoration,23,12,11
Dietmilk,sargeras,952,druid,restoration,24,11,13
Bainnê,ragnaros,952,druid,restoration,48,11,37
Ishiftalot,bleeding-hollow,951,druid,restoration,24,14,10
Erisya,moon-guard,951,druid,restoration,18,10,8
Wintarz,sargeras,951,druid,restoration,30,10,20
Honeymead,wyrmrest-accord,950,druid,restoration,65,36,29
Judar,barthilas,950,druid,restoration,24,10,14
Arïanny,sargeras,949,druid,restoration,18,10,8
Nightwater,stormrage,949,druid,restoration,21,10,11
Rhatir,stormrage,949,druid,restoration,138,61,77
Noonoo,frostwolf,949,druid,restoration,24,10,14
Alteraim,thrall,949,druid,restoration,30,10,20
Vollzar,sargeras,949,druid,restoration,92,29,63
Immabot,tichondrius,949,druid,restoration,36,10,26
Eredorn,darkspear,948,druid,restoration,33,24,9
Tailwind,caelestrasz,948,druid,restoration,39,14,25
Hpcorrection,bleeding-hollow,946,druid,restoration,18,10,8
Moobees,arthas,946,druid,restoration,30,10,20
Jennafix,dathremar,945,druid,restoration,66,33,33
Vdubz,blackrock,945,druid,restoration,73,35,38
Moosicbear,tichondrius,945,druid,restoration,74,18,56
Xiaoddi,tichondrius,943,druid,restoration,17,10,7
Ryx,llane,943,druid,restoration,24,10,14
Fatjoints,tichondrius,943,druid,restoration,60,21,39
Maxobviously,stormrage,942,druid,restoration,18,10,8
Sliickrick,frostmourne,942,druid,restoration,36,12,24
Cadekey,illidan,942,druid,restoration,42,13,29
Linbiba,area-52,941,druid,restoration,18,10,8
Kg,cenarion-circle,941,druid,restoration,28,13,15
Shiftaholic,azgalor,940,druid,restoration,33,17,16
Modiboom,arthas,940,druid,restoration,60,22,38
Beôrn,mugthol,938,druid,restoration,12,10,2
Lawlz,aegwynn,938,druid,restoration,131,71,60
Ilikecake,bloodscalp,938,druid,restoration,66,32,34
Chupaone,dalaran,937,druid,restoration,66,27,39
Blitzÿ,lothar,935,druid,restoration,21,12,9
Leify,area-52,935,druid,restoration,54,26,28
Browolf,emerald-dream,934,druid,restoration,48,21,27
Katochi,area-52,931,druid,restoration,68,31,37
Ragotø,azralon,929,druid,restoration,29,10,19
Krossus,drakkari,928,druid,restoration,66,24,42
Blooddude,saurfang,927,druid,restoration,30,11,19
Killari,malganis,926,druid,restoration,30,15,15
Pathostos,dalaran,926,druid,restoration,104,43,61
Treewik,emerald-dream,925,druid,restoration,113,60,53
Movom,tichondrius,925,druid,restoration,23,10,13
Goenytz,quelthalas,925,druid,restoration,62,20,42
Blackdawgg,frostmourne,924,druid,restoration,71,26,45
Cloudbreaker,duskwood,923,druid,restoration,18,10,8
Dyfurion,stormrage,922,druid,restoration,18,10,8
Breakthemm,bonechewer,922,druid,restoration,97,46,51
Mielo,illidan,922,druid,restoration,146,67,79
Bblloodd,magtheridon,921,druid,restoration,36,13,23
Moolan,bleeding-hollow,920,druid,restoration,46,23,23
Bindudream,frostmane,920,druid,restoration,78,36,42
Redharp,proudmoore,920,druid,restoration,93,42,51
Cleserio,tichondrius,919,druid,restoration,24,13,11
Sylavien,alterac-mountains,918,druid,restoration,32,17,15
Marakar,nazjatar,917,druid,restoration,48,13,35
Kkrunkk,khadgar,916,druid,restoration,36,17,19
Fovoss,dalaran,914,druid,restoration,36,18,18
Lazypandas,silvermoon,914,druid,restoration,41,17,24
Gouzz,frostmourne,912,druid,restoration,23,10,13
Hornmenow,frostmourne,912,druid,restoration,38,11,27
Nightseekers,grizzly-hills,908,druid,restoration,30,13,17
Aquesadilla,tichondrius,907,druid,restoration,108,36,72
Gromdruid,azralon,905,druid,restoration,66,33,33
Boomsläng,ghostlands,905,druid,restoration,25,12,13
Diaks,proudmoore,900,druid,restoration,24,12,12
Bethemarble,sargeras,900,druid,restoration,47,20,27
Irishdoom,tichondrius,899,druid,restoration,20,11,9
Illur,ragnaros,899,druid,restoration,46,16,30
Merawr,area-52,896,druid,restoration,22,10,12
Theboyz,zuljin,895,druid,restoration,36,15,21
Fongoons,kelthuzad,894,druid,restoration,65,28,37
Hentaiboom,kiljaeden,893,druid,restoration,36,16,20
Royjr,emerald-dream,892,druid,restoration,50,27,23
Vengaul,amanthul,892,druid,restoration,24,10,14
Lâvazza,tichondrius,890,druid,restoration,28,10,18
Givemejuice,tichondrius,888,druid,restoration,23,10,13
Kawanishi,stormrage,884,druid,restoration,24,12,12
Treeoleo,stormrage,884,druid,restoration,36,16,20
Inblooms,blackhand,882,druid,restoration,43,16,27
Kittyz,wyrmrest-accord,881,druid,restoration,36,18,18
Midníght,drakkari,880,druid,restoration,34,18,16
Bunrÿl,thorium-brotherhood,874,druid,restoration,54,24,30
Delanor,cenarius,874,druid,restoration,24,10,14
Dashíng,proudmoore,870,druid,restoration,70,33,37
Augus,hyjal,870,druid,restoration,33,11,22
Cowtox,moon-guard,869,druid,restoration,218,103,115
Theboy,dalaran,869,druid,restoration,48,15,33
Bopplejr,tichondrius,864,druid,restoration,12,9,3
Aiteezy,illidan,864,druid,restoration,12,9,3
Justforgame,sargeras,864,druid,restoration,12,9,3
Spikeleaf,tichondrius,864,druid,restoration,12,9,3
Restokinaja,dreadmaul,864,druid,restoration,12,9,3
Toonah,area-52,864,druid,restoration,12,9,3
Duo,demon-soul,864,druid,restoration,12,9,3
Jockrock,thunderhorn,864,druid,restoration,19,10,9
Hellshifterr,tichondrius,864,druid,restoration,18,9,9
Ppbdru,tichondrius,864,druid,restoration,18,9,9
Bigblackcroc,kiljaeden,864,druid,restoration,18,9,9
Razberriesz,stormrage,864,druid,restoration,18,9,9
Ppbtw,illidan,864,druid,restoration,18,9,9
Rukins,frostmourne,864,druid,restoration,18,9,9
Shwayshift,bleeding-hollow,864,druid,restoration,18,9,9
Mmrborrower,icecrown,864,druid,restoration,18,9,9
Ppb,illidan,864,druid,restoration,18,9,9
Persille,proudmoore,864,druid,restoration,24,9,15
Lackzx,malganis,864,druid,restoration,24,9,15
Proness,garithos,863,druid,restoration,12,9,3
Naturenugget,tichondrius,863,druid,restoration,12,9,3
Rejuvenation,kaelthas,863,druid,restoration,12,9,3
Ilovejuli,illidan,863,druid,restoration,12,9,3
Canek,ghostlands,863,druid,restoration,18,9,9
Dumpesito,frostmourne,863,druid,restoration,18,9,9
Vernaar,laughing-skull,863,druid,restoration,18,9,9
Tricklein,tichondrius,863,druid,restoration,18,9,9
Krunks,frostmourne,863,druid,restoration,18,9,9
Nyxlawl,azralon,863,druid,restoration,18,9,9
Canitöuchit,tichondrius,863,druid,restoration,24,9,15
Mossin,sargeras,863,druid,restoration,24,9,15
Washeddruid,area-52,863,druid,restoration,24,9,15
Guss,mannoroth,863,druid,restoration,24,9,15
Tugginudders,illidan,863,druid,restoration,30,9,21
Jentzull,tichondrius,862,druid,restoration,12,9,3
Shuffleqlol,stormrage,862,druid,restoration,12,9,3
Pawsh,tichondrius,862,druid,restoration,12,9,3
Phylex,frostmourne,862,druid,restoration,18,9,9
Moolord,eonar,862,druid,restoration,18,9,9
Spicyx,moon-guard,862,druid,restoration,18,9,9
Cenarius,frostmourne,862,druid,restoration,18,9,9
Truidy,proudmoore,862,druid,restoration,18,9,9
Elmez,thrall,862,druid,restoration,18,9,9
Pawpa,daggerspine,862,druid,restoration,18,9,9
Duderdude,tichondrius,862,druid,restoration,53,25,28
Shiftycent,tichondrius,862,druid,restoration,24,9,15
Imlordgumper,illidan,862,druid,restoration,24,9,15
Zackfromwow,illidan,862,druid,restoration,30,9,21
Dzone,tichondrius,861,druid,restoration,12,9,3
Seyvyurtoo,black-dragonflight,861,druid,restoration,12,9,3
Monkeyxo,kelthuzad,861,druid,restoration,18,9,9
Alindrä,moon-guard,861,druid,restoration,18,9,9
Alsei,quelthalas,861,druid,restoration,40,18,22
Starkraven,firetree,861,druid,restoration,26,10,16
Loganski,korialstrasz,860,druid,restoration,30,14,16
Topzet,azralon,860,druid,restoration,30,9,21
Stetile,azralon,859,druid,restoration,18,9,9
Papichulo,hydraxis,859,druid,restoration,66,30,36
Reliclol,firetree,859,druid,restoration,24,9,15
Ilikan,ragnaros,857,druid,restoration,12,9,3
Bbkingschair,tichondrius,856,druid,restoration,12,9,3
Hedwíg,ragnaros,856,druid,restoration,36,9,27
Thorfir,gorefiend,854,druid,restoration,24,10,14
Faroo,azralon,854,druid,restoration,24,9,15
Ddizz,cairne,850,druid,restoration,24,9,15
Elauria,stormreaver,848,druid,restoration,72,35,37
Kvacco,kiljaeden,848,druid,restoration,24,9,15
Encosan,azralon,848,druid,restoration,30,9,21
Amazingtom,magtheridon,846,druid,restoration,76,34,42
Kanadae,thrall,846,druid,restoration,24,9,15
Keyli,frostwolf,845,druid,restoration,18,9,9
Érois,azralon,844,druid,restoration,18,9,9
Dragondruid,dawnbringer,844,druid,restoration,47,14,33
Draycø,tichondrius,841,druid,restoration,18,9,9
Ahylen,quelthalas,839,druid,restoration,58,22,36
Kenzié,doomhammer,838,druid,restoration,66,29,37
Fronkysilva,illidan,838,druid,restoration,48,19,29
Baha,azralon,834,druid,restoration,24,9,15
Ånxiety,skullcrusher,830,druid,restoration,42,16,26
Morpheous,emerald-dream,830,druid,restoration,37,10,27
Rhondarootsy,zuljin,829,druid,restoration,24,10,14
Uwupollo,ragnaros,829,druid,restoration,96,38,58
Bigox,area-52,829,druid,restoration,157,62,95
Menapaws,arygos,828,druid,restoration,15,9,6
Treetalker,drenden,827,druid,restoration,18,9,9
Shalandrea,sargeras,824,druid,restoration,60,22,38
Lirranya,wyrmrest-accord,821,druid,restoration,24,10,14
Trôll,mannoroth,818,druid,restoration,26,10,16
Dubya,illidan,809,druid,restoration,27,10,17
Judwen,grizzly-hills,808,druid,restoration,91,38,53
Onyayo,barthilas,807,druid,restoration,42,18,24
Atim,moon-guard,804,druid,restoration,96,28,68
Çura,tichondrius,801,druid,restoration,20,11,9
Restogodx,alexstrasza,799,druid,restoration,16,9,7
Vulkur,illidan,799,druid,restoration,38,9,29
Treesonn,kelthuzad,792,druid,restoration,24,11,13
Cenariun,stormrage,790,druid,restoration,30,9,21
Tftworldcham,blackrock,783,druid,restoration,11,9,2
Bobxd,kelthuzad,768,druid,restoration,12,8,4
Chinadruides,tichondrius,768,druid,restoration,12,8,4
Cntomy,tichondrius,768,druid,restoration,12,8,4
Clydruid,blackrock,768,druid,restoration,12,8,4
Solipsism,barthilas,768,druid,restoration,12,8,4
Xiaootong,tichondrius,768,druid,restoration,12,8,4
Leilani,eredar,768,druid,restoration,12,8,4
Ppm,illidan,768,druid,restoration,12,8,4
Polarîs,stormrage,768,druid,restoration,12,8,4
Albafic,illidan,768,druid,restoration,12,8,4
Nemoo,tichondrius,768,druid,restoration,18,8,10
Lindsay,moonrunner,768,druid,restoration,18,8,10
Restobaby,tichondrius,768,druid,restoration,18,8,10
Leomerchan,stormrage,768,druid,restoration,18,8,10
Taledra,stormrage,768,druid,restoration,18,8,10
Mkong,tichondrius,768,druid,restoration,18,8,10
Somsom,frostmourne,768,druid,restoration,18,8,10
Fastcat,moon-guard,768,druid,restoration,18,8,10
Tyler,emerald-dream,768,druid,restoration,18,8,10
Alend,alexstrasza,767,druid,restoration,12,8,4
Înfamous,thrall,767,druid,restoration,12,8,4
Bringo,executus,767,druid,restoration,21,10,11
Maolfurion,stormrage,767,druid,restoration,18,8,10
Thetakeout,tichondrius,767,druid,restoration,18,8,10
Grubbs,terenas,767,druid,restoration,18,8,10
Junglez,shadowmoon,767,druid,restoration,18,8,10
Kaboomy,moon-guard,767,druid,restoration,18,8,10
Steeples,illidan,767,druid,restoration,18,8,10
Hýovan,stormrage,767,druid,restoration,18,8,10
Lifebloomlol,area-52,767,druid,restoration,24,8,16
Purpyo,bleeding-hollow,766,druid,restoration,12,8,4
Hughcockman,tichondrius,766,druid,restoration,12,8,4
Ortalen,spirestone,766,druid,restoration,12,8,4
Wildsïde,tichondrius,766,druid,restoration,18,8,10
Nahualis,tichondrius,766,druid,restoration,18,8,10
Kyrieirving,illidan,766,druid,restoration,24,8,16
Bumbleebee,azralon,766,druid,restoration,24,8,16
Kellykapore,area-52,766,druid,restoration,81,20,61
Sÿd,sargeras,765,druid,restoration,12,8,4
Giuseppee,hyjal,765,druid,restoration,12,8,4
Imnotinhuman,tichondrius,765,druid,restoration,12,8,4
Louisvuittón,area-52,765,druid,restoration,12,8,4
Dmanrepus,sargeras,765,druid,restoration,12,8,4
Omelet,tichondrius,765,druid,restoration,18,8,10
Guybranch,illidan,765,druid,restoration,24,8,16
Softgrizzly,auchindoun,765,druid,restoration,24,8,16
Jammi,skywall,764,druid,restoration,18,8,10
Leatherpig,proudmoore,764,druid,restoration,18,8,10
Aurajin,spinebreaker,764,druid,restoration,24,8,16
Irontree,dunemaul,764,druid,restoration,30,8,22
Polánd,area-52,763,druid,restoration,12,8,4
Lilbabymint,dalaran,763,druid,restoration,18,8,10
Murrmerly,moon-guard,762,druid,restoration,12,8,4
Studioghibli,bleeding-hollow,762,druid,restoration,12,8,4
Atalìa,moon-guard,762,druid,restoration,18,8,10
Dergmoo,moon-guard,762,druid,restoration,24,8,16
Markóla,stormrage,761,druid,restoration,18,8,10
Hajjima,blackrock,761,druid,restoration,18,8,10
Tristanne,proudmoore,760,druid,restoration,12,8,4
Wortsnom,tol-barad,760,druid,restoration,12,8,4
Cosmes,suramar,759,druid,restoration,12,8,4
Furon,thunderlord,758,druid,restoration,18,8,10
Rairven,stormrage,757,druid,restoration,42,8,34
Xxuan,tichondrius,754,druid,restoration,68,18,50
Breakertime,illidan,753,druid,restoration,18,8,10
Salpicow,nagrand,752,druid,restoration,23,10,13
Hydruidponic,aegwynn,752,druid,restoration,27,9,18
Blazedorange,tichondrius,751,druid,restoration,17,8,9
Stamynn,kelthuzad,750,druid,restoration,558,194,364
Friarpuck,nerzhul,747,druid,restoration,12,8,4
Dytriax,ragnaros,746,druid,restoration,18,8,10
Nodeathz,sargeras,743,druid,restoration,27,10,17
Nattog,area-52,736,druid,restoration,52,12,40
Ekj,tichondrius,735,druid,restoration,14,9,5
Akanx,tichondrius,735,druid,restoration,16,9,7
Kadry,ragnaros,733,druid,restoration,18,8,10
Garritass,moon-guard,732,druid,restoration,53,10,43
Ossiany,stormrage,730,druid,restoration,16,9,7
Aludra,tol-barad,725,druid,restoration,30,10,20
Kataoka,azralon,721,druid,restoration,23,11,12
Rdruidchump,the-forgotten-coast,719,druid,restoration,15,9,6
Ghostmonkey,hakkar,719,druid,restoration,23,8,15
Basulto,tichondrius,718,druid,restoration,23,8,15
Xîstance,barthilas,717,druid,restoration,23,8,15
Goodspeed,thrall,717,druid,restoration,66,19,47
Felinedreams,sargeras,714,druid,restoration,14,9,5
Malthen,quelthalas,712,druid,restoration,15,8,7
Whiskeyblues,ursin,706,druid,restoration,24,8,16
Finntann,moon-guard,704,druid,restoration,24,8,16
Drexldrood,cenarius,697,druid,restoration,15,9,6
Zephiee,kelthuzad,692,druid,restoration,23,8,15
Druidsz,stormrage,688,druid,restoration,13,8,5
Finkledurp,dalaran,687,druid,restoration,19,8,11
Solbinn,nordrassil,683,druid,restoration,78,21,57
Teamwork,moon-guard,681,druid,restoration,20,10,10
Importedalc,zuljin,678,druid,restoration,36,8,28
Hmoobforshoz,wildhammer,672,druid,restoration,12,7,5
Fujimufu,bleeding-hollow,672,druid,restoration,12,7,5
Cuzzidr,tichondrius,672,druid,restoration,12,7,5
Sensations,moon-guard,672,druid,restoration,12,7,5
Blacksimbá,area-52,672,druid,restoration,12,7,5
Mymatejames,tichondrius,672,druid,restoration,12,7,5
Skitzo,akama,672,druid,restoration,12,7,5
Tmdogwater,sargeras,672,druid,restoration,12,7,5
Ishtarí,tichondrius,672,druid,restoration,12,7,5
Cøsmiccow,illidan,672,druid,restoration,12,7,5
Toketree,sargeras,672,druid,restoration,12,7,5
Cameltail,kelthuzad,672,druid,restoration,12,7,5
Esqueue,stormrage,672,druid,restoration,12,7,5
Imaoo,illidan,672,druid,restoration,12,7,5
Motate,malganis,672,druid,restoration,12,7,5
Restokinaka,dreadmaul,672,druid,restoration,12,7,5
Scuzzin,zuljin,672,druid,restoration,12,7,5
Carntko,sargeras,672,druid,restoration,12,7,5
Crusch,shattered-halls,672,druid,restoration,12,7,5
Jurof,malganis,672,druid,restoration,12,7,5
Cyrea,dalaran,672,druid,restoration,12,7,5
Liloudadru,tichondrius,672,druid,restoration,18,7,11
Calimei,bladefist,672,druid,restoration,18,7,11
Restokina,dreadmaul,672,druid,restoration,18,7,11
Greentoë,sargeras,672,druid,restoration,18,7,11
Plantbased,arthas,672,druid,restoration,18,7,11
Dotsbots,barthilas,672,druid,restoration,18,7,11
Jaxoa,zuljin,672,druid,restoration,18,7,11
Wùúkìí,bleeding-hollow,672,druid,restoration,24,7,17
Drop,shadow-council,671,druid,restoration,12,7,5
Ophiophagus,nemesis,671,druid,restoration,12,7,5
Gemroc,kelthuzad,671,druid,restoration,12,7,5
Sroyalbeast,sargeras,671,druid,restoration,12,7,5
Zthatchx,shadowmoon,671,druid,restoration,12,7,5
Nokentil,stormrage,671,druid,restoration,12,7,5
Jillferal,proudmoore,671,druid,restoration,12,7,5
Vadeyr,illidan,671,druid,restoration,12,7,5
Cryel,sargeras,671,druid,restoration,12,7,5
Lolth,turalyon,671,druid,restoration,12,7,5
Lilgee,kelthuzad,671,druid,restoration,18,7,11
Lookhowirun,emerald-dream,671,druid,restoration,18,7,11
Finn,spinebreaker,671,druid,restoration,18,7,11
Kollective,sargeras,671,druid,restoration,18,7,11
Phéônix,zuljin,671,druid,restoration,18,7,11
Wildarumqt,tichondrius,671,druid,restoration,18,7,11
Djdontlose,stormrage,671,druid,restoration,18,7,11
Treebearman,thrall,671,druid,restoration,24,7,17
Dionysus,mannoroth,670,druid,restoration,12,7,5
Scäpeqoat,sargeras,670,druid,restoration,12,7,5
Queiq,kelthuzad,670,druid,restoration,12,7,5
Greenbones,frostmane,670,druid,restoration,12,7,5
Wreckked,sargeras,670,druid,restoration,18,7,11
Frave,dentarg,670,druid,restoration,24,7,17
Hotpocketz,kiljaeden,670,druid,restoration,28,8,20
Dipset,khadgar,670,druid,restoration,30,7,23
Martymoo,bleeding-hollow,670,druid,restoration,30,7,23
Di,nemesis,669,druid,restoration,12,7,5
Dylonomancer,tichondrius,669,druid,restoration,12,7,5
Nayelina,stormrage,669,druid,restoration,12,7,5
Fandren,ravencrest,669,druid,restoration,12,7,5
Zwind,nerzhul,669,druid,restoration,16,8,8
Niensi,wyrmrest-accord,669,druid,restoration,18,7,11
Briallyn,tichondrius,669,druid,restoration,18,7,11
Razorclaws,stormscale,669,druid,restoration,18,7,11
Maggiee,arthas,669,druid,restoration,24,7,17
Bloomcrue,moon-guard,668,druid,restoration,12,7,5
Migdrail,nemesis,668,druid,restoration,18,7,11
Shiftyy,nordrassil,668,druid,restoration,19,7,12
Esyiix,tichondrius,668,druid,restoration,24,7,17
Mukay,stormrage,668,druid,restoration,24,7,17
Bulltdiffrnt,illidan,668,druid,restoration,30,7,23
Mïms,area-52,667,druid,restoration,12,7,5
Gigagato,area-52,667,druid,restoration,18,7,11
Willdathrill,stormrage,667,druid,restoration,36,7,29
Flayde,barthilas,666,druid,restoration,12,7,5
Transpecies,kelthuzad,666,druid,restoration,12,7,5
Kobudo,frostwolf,666,druid,restoration,12,7,5
Darkstarfalz,bleeding-hollow,665,druid,restoration,12,7,5
Megumixd,illidan,665,druid,restoration,12,7,5
Phanah,the-forgotten-coast,665,druid,restoration,12,7,5
Swagbabe,sargeras,665,druid,restoration,18,7,11
Lacarne,tichondrius,665,druid,restoration,30,7,23
Bullshifftt,kelthuzad,664,druid,restoration,12,7,5
Biig,stormreaver,664,druid,restoration,12,7,5
Anakum,azshara,664,druid,restoration,16,8,8
Happylilmoo,kiljaeden,664,druid,restoration,24,7,17
Somars,cenarius,663,druid,restoration,12,7,5
Madambuku,thrall,663,druid,restoration,12,7,5
Shilpá,stormrage,662,druid,restoration,18,7,11
Donutjelly,moknathal,661,druid,restoration,12,7,5
Solá,skywall,660,druid,restoration,18,7,11
Xkcc,perenolde,660,druid,restoration,18,7,11
Snarl,blades-edge,657,druid,restoration,12,7,5
Goochies,aerie-peak,655,druid,restoration,17,7,10
Ikova,frostmourne,650,druid,restoration,18,7,11
Bjorangedru,tichondrius,643,druid,restoration,18,7,11
Adanos,moon-guard,642,druid,restoration,42,7,35
Riddickd,malfurion,639,druid,restoration,14,8,6
Gotdruid,sargeras,639,druid,restoration,14,8,6
Warmkitteh,kiljaeden,639,druid,restoration,17,7,10
Drstudmaster,skullcrusher,639,druid,restoration,20,8,12
Breathe,ysera,639,druid,restoration,28,7,21
Guerrillera,khadgar,630,druid,restoration,159,64,95
Perems,bleeding-hollow,629,druid,restoration,24,7,17
Guavajuice,stormrage,624,druid,restoration,19,8,11
Wolfelord,sargeras,624,druid,restoration,21,7,14
Qij,eonar,622,druid,restoration,17,7,10
Midoriiro,dentarg,612,druid,restoration,25,8,17
Milkz,zuljin,607,druid,restoration,26,7,19
Blackjackz,tichondrius,576,druid,restoration,6,6,0
Masan,burning-blade,576,druid,restoration,6,6,0
Pacetwo,area-52,576,druid,restoration,6,6,0
Nomilk,illidan,576,druid,restoration,12,6,6
Krisdu,kelthuzad,576,druid,restoration,12,6,6
Baobeyingz,tichondrius,576,druid,restoration,12,6,6
Mynameisfish,tichondrius,576,druid,restoration,12,6,6
Naturenugget,sargeras,576,druid,restoration,12,6,6
Injections,kelthuzad,576,druid,restoration,12,6,6
Forèst,sargeras,576,druid,restoration,12,6,6
Hecaf,drakkari,576,druid,restoration,12,6,6
Solushunx,sargeras,576,druid,restoration,12,6,6
Daddypompum,tichondrius,576,druid,restoration,12,6,6
Sawajirii,tichondrius,576,druid,restoration,12,6,6
Connection,emerald-dream,576,druid,restoration,12,6,6
Maèstus,thrall,576,druid,restoration,12,6,6
Zux,drakkari,576,druid,restoration,12,6,6
Bearys,area-52,576,druid,restoration,12,6,6
Xingyejingmi,tichondrius,576,druid,restoration,12,6,6
Häng,tichondrius,576,druid,restoration,12,6,6
Smeekqtwo,tichondrius,576,druid,restoration,12,6,6
Bobblespook,stormrage,576,druid,restoration,12,6,6
Torbock,zuljin,576,druid,restoration,12,6,6
Apriix,saurfang,576,druid,restoration,12,6,6
Realá,kelthuzad,576,druid,restoration,12,6,6
Larryjones,alleria,576,druid,restoration,12,6,6
Fwaffle,bleeding-hollow,576,druid,restoration,12,6,6
Chinadruidss,tichondrius,576,druid,restoration,12,6,6
Floray,tichondrius,576,druid,restoration,12,6,6
Brëed,tichondrius,576,druid,restoration,12,6,6
Dirtydrood,mugthol,576,druid,restoration,12,6,6
Afkifuthrow,ysera,576,druid,restoration,12,6,6
Gemo,tichondrius,576,druid,restoration,12,6,6
Barqskin,malganis,576,druid,restoration,12,6,6
Juicecarton,thrall,576,druid,restoration,12,6,6
Restokin,dreadmaul,576,druid,restoration,15,7,8
Zerocoolx,illidan,576,druid,restoration,21,7,14
Ephemêral,stormrage,576,druid,restoration,18,6,12
Bøo,frostmourne,576,druid,restoration,18,6,12
Sneakiez,tichondrius,576,druid,restoration,18,6,12
Mâckdâddy,kul-tiras,576,druid,restoration,18,6,12
Fidelo,tichondrius,576,druid,restoration,18,6,12
Noctorius,ragnaros,576,druid,restoration,18,6,12
Hawtyforever,tichondrius,576,druid,restoration,18,6,12
Nyxlie,stormrage,576,druid,restoration,18,6,12
Arútam,ragnaros,576,druid,restoration,18,6,12
Axtin,stormreaver,576,druid,restoration,18,6,12
Drwasabi,tichondrius,576,druid,restoration,18,6,12
Shinoßi,area-52,576,druid,restoration,24,6,18
Nerglet,aerie-peak,576,druid,restoration,24,6,18
Fyrleaf,lightnings-blade,576,druid,restoration,24,6,18
Hottietottie,laughing-skull,576,druid,restoration,24,6,18
Gønkh,quelthalas,575,druid,restoration,6,6,0
Anuufal,fizzcrank,575,druid,restoration,12,6,6
Flôkey,tichondrius,575,druid,restoration,12,6,6
Mask,gundrak,575,druid,restoration,12,6,6
Zaknáfein,moon-guard,575,druid,restoration,12,6,6
Ulfvur,nagrand,575,druid,restoration,12,6,6
Spaceships,stormrage,575,druid,restoration,12,6,6
Nrp,stormrage,575,druid,restoration,12,6,6
Bamfferal,tichondrius,575,druid,restoration,12,6,6
Kokushe,burning-legion,575,druid,restoration,12,6,6
Arjác,jubeithos,575,druid,restoration,12,6,6
Miraval,area-52,575,druid,restoration,12,6,6
Nightnes,sargeras,575,druid,restoration,12,6,6
Velauris,sargeras,575,druid,restoration,12,6,6
Lorandros,saurfang,575,druid,restoration,12,6,6
Gosch,stormrage,575,druid,restoration,12,6,6
Keläia,quelthalas,575,druid,restoration,12,6,6
Seralyo,quelthalas,575,druid,restoration,12,6,6
Weltherion,guldan,575,druid,restoration,12,6,6
Illegalsaur,area-52,575,druid,restoration,12,6,6
Pazlife,arthas,575,druid,restoration,12,6,6
Clawandørder,tichondrius,575,druid,restoration,12,6,6
Metaindexqt,quelthalas,575,druid,restoration,12,6,6
Skweeks,eredar,575,druid,restoration,13,6,7
Skullchief,barthilas,575,druid,restoration,16,7,9
Mysteec,bleeding-hollow,575,druid,restoration,17,6,11
Kittysnuggle,emerald-dream,575,druid,restoration,18,6,12
Aligantor,thrall,575,druid,restoration,18,6,12
Sleepypaws,silvermoon,575,druid,restoration,18,6,12
Treynî,tichondrius,575,druid,restoration,18,6,12
Dýreðaguð,gurubashi,575,druid,restoration,18,6,12
Soulshift,sargeras,575,druid,restoration,24,6,18
Elpako,ragnaros,574,druid,restoration,6,6,0
Dibinha,azralon,574,druid,restoration,12,6,6
Carther,korgath,574,druid,restoration,12,6,6
Troky,drakkari,574,druid,restoration,12,6,6
Enkcredible,tichondrius,574,druid,restoration,12,6,6
Throatslash,thrall,574,druid,restoration,12,6,6
Aranuir,emerald-dream,574,druid,restoration,18,6,12
Skishy,tichondrius,574,druid,restoration,18,6,12
Brisketmre,dalaran,574,druid,restoration,36,6,30
Lonewolfdrd,illidan,573,druid,restoration,6,6,0
Kallinia,tichondrius,573,druid,restoration,6,6,0
Pëps,emerald-dream,573,druid,restoration,12,6,6
Quagsire,moon-guard,573,druid,restoration,18,6,12
Glandalf,illidan,573,druid,restoration,18,6,12
Vacagalo,azralon,572,druid,restoration,12,6,6
Modification,eonar,572,druid,restoration,12,6,6
Juucifer,thrall,572,druid,restoration,12,6,6
Nightshiver,bleeding-hollow,572,druid,restoration,12,6,6
Guusx,bonechewer,572,druid,restoration,18,6,12
Kupaloidzki,proudmoore,571,druid,restoration,12,6,6
Marisska,stormrage,571,druid,restoration,12,6,6
Budsmoke,stormrage,571,druid,restoration,18,6,12
Mîløh,area-52,570,druid,restoration,12,6,6
Aokseer,azralon,570,druid,restoration,12,6,6
Healbott,lightnings-blade,569,druid,restoration,12,6,6
Nordway,alexstrasza,569,druid,restoration,12,6,6
Oldcktwist,garrosh,568,druid,restoration,12,6,6
Otixx,wyrmrest-accord,568,druid,restoration,18,6,12
Naachocheeze,tichondrius,566,druid,restoration,12,6,6
Lililililil,stormrage,552,druid,restoration,36,6,30
Istishiã,tichondrius,543,druid,restoration,14,7,7
Enyu,sargeras,542,druid,restoration,23,6,17
Cudbacrakhed,tichondrius,541,druid,restoration,20,7,13
Pahandan,bonechewer,528,druid,restoration,15,7,8
Leafs,tichondrius,528,druid,restoration,21,6,15
Isalien,kelthuzad,521,druid,restoration,21,7,14
Arthemisgodx,azralon,520,druid,restoration,17,10,7
Djimbo,kelthuzad,520,druid,restoration,27,7,20
Rakins,arthas,496,druid,restoration,13,6,7
Awkwarder,emerald-dream,494,druid,restoration,19,7,12
Windù,azralon,488,druid,restoration,16,9,7
Kascatm,area-52,480,druid,restoration,6,5,1
Dëmoníc,ragnaros,480,druid,restoration,6,5,1
Treehealage,sargeras,480,druid,restoration,6,5,1
Caring,malganis,480,druid,restoration,6,5,1
Jaspen,bleeding-hollow,480,druid,restoration,6,5,1
Genghisßong,mannoroth,480,druid,restoration,6,5,1
Roraex,tichondrius,480,druid,restoration,6,5,1
Sevend,tichondrius,480,druid,restoration,6,5,1
Diggsterz,area-52,480,druid,restoration,6,5,1
Flatdaddy,doomhammer,480,druid,restoration,6,5,1
Naakx,tichondrius,480,druid,restoration,6,5,1
Brocolli,sargeras,480,druid,restoration,12,5,7
Twertx,tichondrius,480,druid,restoration,12,5,7
Mclarenz,frostmourne,480,druid,restoration,12,5,7
Yevenbother,tichondrius,480,druid,restoration,12,5,7
Shartah,zuljin,480,druid,restoration,12,5,7
Geranium,guldan,480,druid,restoration,12,5,7
Stormjammer,proudmoore,480,druid,restoration,12,5,7
Afrogx,dalaran,480,druid,restoration,12,5,7
Noah,altar-of-storms,480,druid,restoration,12,5,7
Reconus,frostmourne,480,druid,restoration,12,5,7
Someshta,sargeras,480,druid,restoration,12,5,7
Zemul,ragnaros,480,druid,restoration,12,5,7
Ashstarfall,barthilas,480,druid,restoration,12,5,7
Blàtté,zuljin,480,druid,restoration,12,5,7
Lukass,tichondrius,480,druid,restoration,12,5,7
Stårrysky,illidan,480,druid,restoration,12,5,7
Randoms,perenolde,480,druid,restoration,12,5,7
Moonfannia,malganis,480,druid,restoration,12,5,7
Loveflowers,nemesis,480,druid,restoration,12,5,7
Tydruid,illidan,480,druid,restoration,12,5,7
Skogsbruk,stormrage,480,druid,restoration,12,5,7
Cheeseface,bleeding-hollow,480,druid,restoration,12,5,7
Stamookee,area-52,480,druid,restoration,12,5,7
Tygraz,alleria,480,druid,restoration,12,5,7
Tranqz,moon-guard,480,druid,restoration,12,5,7
Angryalyu,tichondrius,480,druid,restoration,12,5,7
Greeneguy,thrall,480,druid,restoration,12,5,7
Vêrâ,stormrage,480,druid,restoration,12,5,7
Fastyhands,illidan,480,druid,restoration,12,5,7
Hotgoose,malganis,480,druid,restoration,12,5,7
Buckmoon,area-52,480,druid,restoration,12,5,7
Meowmixx,frostmane,480,druid,restoration,12,5,7
Pigdd,tichondrius,480,druid,restoration,12,5,7
Maxspeed,tichondrius,480,druid,restoration,12,5,7
Torilisather,ragnaros,480,druid,restoration,12,5,7
Memoryleaks,proudmoore,480,druid,restoration,12,5,7
Jaydog,emerald-dream,480,druid,restoration,12,5,7
Hudada,emerald-dream,480,druid,restoration,12,5,7
Whìtewölf,emerald-dream,480,druid,restoration,12,5,7
Furrari,baelgun,480,druid,restoration,12,5,7
Reniggen,sargeras,480,druid,restoration,12,5,7
Wizdùm,frostmourne,480,druid,restoration,13,5,8
Duckbillby,bleeding-hollow,480,druid,restoration,14,5,9
Jungledíff,ragnaros,480,druid,restoration,18,5,13
Willowwind,bonechewer,480,druid,restoration,18,5,13
You,draka,480,druid,restoration,18,5,13
Guacisextraa,thrall,480,druid,restoration,18,5,13
Brostoevski,khadgar,480,druid,restoration,24,5,19
Offthemeters,mannoroth,480,druid,restoration,24,5,19
Spacaa,kelthuzad,480,druid,restoration,24,5,19
Treezy,dalaran,480,druid,restoration,24,5,19
Forest,frostmourne,479,druid,restoration,12,5,7
Murkkd,tichondrius,479,druid,restoration,12,5,7
Sønèca,azralon,479,druid,restoration,12,5,7
Mvqxd,tichondrius,479,druid,restoration,12,5,7
Tallais,barthilas,479,druid,restoration,12,5,7
Redfang,jaedenar,479,druid,restoration,12,5,7
Jamona,cenarius,479,druid,restoration,12,5,7
Mînîboss,ragnaros,479,druid,restoration,12,5,7
Pingú,tichondrius,479,druid,restoration,14,5,9
Indicah,barthilas,479,druid,restoration,18,5,13
Komoocha,area-52,479,druid,restoration,18,5,13
Olegoatjames,darkspear,478,druid,restoration,13,6,7
Bloodyhoofs,malganis,478,druid,restoration,12,5,7
Beienus,ragnaros,478,druid,restoration,12,5,7
Natruid,sargeras,478,druid,restoration,12,5,7
Mikewazowsky,stormrage,478,druid,restoration,12,5,7
Jíbóia,azralon,478,druid,restoration,12,5,7
Rònaldò,drakthul,478,druid,restoration,12,5,7
Fastafboy,stormrage,478,druid,restoration,12,5,7
Treemendous,tichondrius,478,druid,restoration,12,5,7
Ohfudge,frostwolf,478,druid,restoration,18,5,13
Scheppke,bleeding-hollow,477,druid,restoration,12,5,7
Fiddy,kelthuzad,477,druid,restoration,12,5,7
Khatzen,nemesis,477,druid,restoration,12,5,7
Byahh,shuhalo,477,druid,restoration,18,5,13
Wraiven,elune,477,druid,restoration,18,5,13
Beanslice,nazgrel,477,druid,restoration,18,5,13
Swiftstrider,frostmourne,476,druid,restoration,10,6,4
Kaldrago,detheroc,476,druid,restoration,12,5,7
Phlap,zuljin,476,druid,restoration,12,5,7
Béren,alterac-mountains,476,druid,restoration,12,5,7
Muphausa,area-52,475,druid,restoration,12,5,7
Apocalyptoe,proudmoore,474,druid,restoration,12,5,7
Finubar,emerald-dream,472,druid,restoration,12,5,7
Vuthryx,tichondrius,472,druid,restoration,18,5,13
Curador,aegwynn,471,druid,restoration,18,5,13
Bobruid,nagrand,469,druid,restoration,19,9,10
Maerk,aerie-peak,469,druid,restoration,18,5,13
Udroth,kelthuzad,468,druid,restoration,17,5,12
Metaldruid,tichondrius,463,druid,restoration,11,5,6
Druidkofwa,tichondrius,462,druid,restoration,11,5,6
Psyz,moon-guard,447,druid,restoration,14,5,9
Fuzzie,icecrown,447,druid,restoration,16,5,11
Chopotron,ragnaros,447,druid,restoration,16,5,11
Bigelbows,area-52,432,druid,restoration,15,6,9
Nexophobia,proudmoore,431,druid,restoration,11,5,6
Pulsarpete,frostmourne,431,druid,restoration,29,5,24
Sïmba,andorhal,426,druid,restoration,15,6,9
Ctoph,illidan,426,druid,restoration,19,6,13
Gankstababy,tichondrius,426,druid,restoration,20,6,14
Indicahigh,moon-guard,424,druid,restoration,16,7,9
Persiancoco,area-52,422,druid,restoration,14,6,8
Oongadunga,tichondrius,415,druid,restoration,14,5,9
Luluid,tichondrius,399,druid,restoration,5,5,0
Zoddyboy,tichondrius,384,druid,restoration,6,4,2
Dengdengya,illidan,384,druid,restoration,6,4,2
Skojin,bleeding-hollow,384,druid,restoration,6,4,2
Euwin,stormrage,384,druid,restoration,6,4,2
Bambi,bleeding-hollow,384,druid,restoration,6,4,2
Music,magtheridon,384,druid,restoration,6,4,2
Volayer,frostmourne,384,druid,restoration,6,4,2
Starshípx,tichondrius,384,druid,restoration,6,4,2
Dpumba,azralon,384,druid,restoration,6,4,2
Gilysel,tichondrius,384,druid,restoration,6,4,2
Thetbones,tichondrius,384,druid,restoration,6,4,2
Shiftedonyou,blackrock,384,druid,restoration,6,4,2
Zbh,tichondrius,384,druid,restoration,6,4,2
Tigresa,perenolde,384,druid,restoration,6,4,2
Nøbuchi,kelthuzad,384,druid,restoration,6,4,2
Peazoepico,tichondrius,384,druid,restoration,6,4,2
Crayolaa,barthilas,384,druid,restoration,6,4,2
Outcastmango,thrall,384,druid,restoration,6,4,2
Faash,illidan,384,druid,restoration,6,4,2
Hottie,kelthuzad,384,druid,restoration,6,4,2
Êhurricane,dalaran,384,druid,restoration,6,4,2
Ráinbow,quelthalas,384,druid,restoration,6,4,2
Ckàíne,stormrage,384,druid,restoration,6,4,2
Relikd,dawnbringer,384,druid,restoration,6,4,2
Lushÿ,tichondrius,384,druid,restoration,6,4,2
Shroomdealer,kelthuzad,384,druid,restoration,6,4,2
Nbendtner,tichondrius,384,druid,restoration,6,4,2
Kushkilla,malganis,384,druid,restoration,6,4,2
Deegawn,proudmoore,384,druid,restoration,6,4,2
Lylek,azshara,384,druid,restoration,6,4,2
Johnnybigg,barthilas,384,druid,restoration,6,4,2
Koan,proudmoore,384,druid,restoration,6,4,2
Clarityx,illidan,384,druid,restoration,6,4,2
Doomky,area-52,384,druid,restoration,6,4,2
Sajia,illidan,384,druid,restoration,12,4,8
Kinatsu,tichondrius,384,druid,restoration,12,4,8
Ellowei,earthen-ring,384,druid,restoration,12,4,8
Saltkin,frostmourne,384,druid,restoration,12,4,8
Flyshles,frostmourne,384,druid,restoration,12,4,8
Mmbessa,tichondrius,384,druid,restoration,12,4,8
Tmkakao,tichondrius,384,druid,restoration,12,4,8
Brittanychan,sargeras,384,druid,restoration,12,4,8
Cakedx,tichondrius,384,druid,restoration,12,4,8
Awguseon,proudmoore,384,druid,restoration,12,4,8
Ebrìthil,hyjal,384,druid,restoration,12,4,8
Metaphysìcs,kelthuzad,384,druid,restoration,12,4,8
Moosesolini,chogall,384,druid,restoration,12,4,8
Hotrecki,kelthuzad,384,druid,restoration,12,4,8
Bigshred,tichondrius,384,druid,restoration,12,4,8
Mastabtw,illidan,384,druid,restoration,12,4,8
Mittns,arthas,384,druid,restoration,12,4,8
Guurgul,bleeding-hollow,384,druid,restoration,12,4,8
Ônlyyou,burning-legion,384,druid,restoration,12,4,8
Py,stormscale,384,druid,restoration,12,4,8
Mé,arthas,384,druid,restoration,12,4,8
Karlmalone,thunderlord,384,druid,restoration,12,4,8
Nocup,illidan,384,druid,restoration,12,4,8
Bwaccowi,sargeras,384,druid,restoration,12,4,8
Taysfriend,tichondrius,384,druid,restoration,12,4,8
Lillenan,illidan,384,druid,restoration,12,4,8
Marisco,malganis,384,druid,restoration,12,4,8
Thebutterboy,stormrage,384,druid,restoration,12,4,8
Shadru,bleeding-hollow,384,druid,restoration,12,4,8
Mastahskills,illidan,384,druid,restoration,12,4,8
Stephonxd,area-52,384,druid,restoration,12,4,8
Bumbally,illidan,384,druid,restoration,12,4,8
Mamazbear,area-52,384,druid,restoration,12,4,8
Allevii,sargeras,384,druid,restoration,12,4,8
Rydërr,area-52,384,druid,restoration,12,4,8
Synthesïs,malganis,384,druid,restoration,12,4,8
Gathmog,boulderfist,384,druid,restoration,12,4,8
Fartsicle,lightnings-blade,384,druid,restoration,12,4,8
Angercow,nordrassil,384,druid,restoration,12,4,8
Chickenwings,ragnaros,384,druid,restoration,12,4,8
Ohioman,bleeding-hollow,384,druid,restoration,12,4,8
Fixn,tichondrius,384,druid,restoration,12,4,8
Faélar,moon-guard,384,druid,restoration,12,4,8
Odenmu,ragnaros,384,druid,restoration,12,4,8
Stamaximdru,lightbringer,384,druid,restoration,12,4,8
Spazer,darkspear,384,druid,restoration,12,4,8
Ursu,nemesis,384,druid,restoration,12,4,8
Ilmoonz,frostmane,384,druid,restoration,12,4,8
Bopple,tichondrius,384,druid,restoration,12,4,8
Figsurine,sargeras,384,druid,restoration,12,4,8
Flompstomper,skullcrusher,384,druid,restoration,12,4,8
Tommyjimmy,andorhal,384,druid,restoration,12,4,8
Narlie,malfurion,384,druid,restoration,12,4,8
Catcat,dalaran,384,druid,restoration,12,4,8
Nazo,moonrunner,384,druid,restoration,12,4,8
Harøs,stormrage,384,druid,restoration,13,4,9
Hippyprotein,tichondrius,384,druid,restoration,13,4,9
Read,eredar,384,druid,restoration,21,5,16
Maviuss,barthilas,384,druid,restoration,17,4,13
Swagglefrag,zuljin,384,druid,restoration,18,4,14
Silasel,sargeras,384,druid,restoration,18,4,14
Tarvosx,thrall,384,druid,restoration,18,4,14
Ternkote,tichondrius,384,druid,restoration,21,4,17
Bryle,kiljaeden,383,druid,restoration,6,4,2
Calleguard,terenas,383,druid,restoration,6,4,2
Seazyn,malganis,383,druid,restoration,6,4,2
Traplordbill,sargeras,383,druid,restoration,6,4,2
Vanfalor,stormrage,383,druid,restoration,9,5,4
Dadboody,sargeras,383,druid,restoration,12,4,8
Linklan,bleeding-hollow,383,druid,restoration,12,4,8
Chuckzilla,korgath,383,druid,restoration,12,4,8
Posmard,ragnaros,383,druid,restoration,12,4,8
Kurnon,shattered-hand,383,druid,restoration,12,4,8
Nightflow,emerald-dream,383,druid,restoration,12,4,8
Hazbekbek,area-52,383,druid,restoration,12,4,8
Norco,dentarg,383,druid,restoration,12,4,8
Moonshire,boulderfist,383,druid,restoration,12,4,8
Jonnyutaa,emerald-dream,383,druid,restoration,12,4,8
Ssuka,tichondrius,383,druid,restoration,12,4,8
Pahrump,stormrage,383,druid,restoration,12,4,8
Zelara,kilrogg,383,druid,restoration,12,4,8
Brazzar,kiljaeden,383,druid,restoration,12,4,8
Morphiius,archimonde,383,druid,restoration,18,4,14
Lulerz,cenarius,383,druid,restoration,18,4,14
Rikey,thaurissan,383,druid,restoration,18,4,14
Hagenws,azralon,382,druid,restoration,12,4,8
Puzzlè,thrall,382,druid,restoration,12,4,8
Guojue,tichondrius,382,druid,restoration,12,4,8
Alcoolânio,stormrage,382,druid,restoration,12,4,8
Infestador,tichondrius,382,druid,restoration,12,4,8
Gardeni,emerald-dream,382,druid,restoration,12,4,8
Maldrake,quelthalas,381,druid,restoration,12,4,8
Rádágast,nemesis,381,druid,restoration,12,4,8
Ceria,hellscream,381,druid,restoration,12,4,8
Meowsz,malganis,381,druid,restoration,12,4,8
Certzu,moon-guard,381,druid,restoration,18,4,14
Bigbadcow,sargeras,380,druid,restoration,12,4,8
Yassi,earthen-ring,379,druid,restoration,12,4,8
Policë,skullcrusher,379,druid,restoration,12,4,8
Metamooseowl,crushridge,379,druid,restoration,12,4,8
Nüg,frostmourne,379,druid,restoration,14,4,10
Irumble,silver-hand,377,druid,restoration,17,4,13
Mxlasthope,azralon,351,druid,restoration,11,4,7
Sertroz,sargeras,351,druid,restoration,11,4,7
Mimics,zuljin,336,druid,restoration,15,4,11
Sndru,illidan,330,druid,restoration,12,5,7
Bottles,quelthalas,330,druid,restoration,15,6,9
Harûko,moon-guard,330,druid,restoration,30,5,25
Greythan,madoran,325,druid,restoration,42,5,37
Alleae,stormrage,319,druid,restoration,5,4,1
Fatloser,hyjal,319,druid,restoration,11,5,6
Semangarbage,tichondrius,307,druid,restoration,18,10,8
Neferpitou,fenris,303,druid,restoration,12,4,8
Ugress,whisperwind,302,druid,restoration,13,4,9
Erwelz,quelthalas,288,druid,restoration,6,3,3
Spinach,moon-guard,288,druid,restoration,6,3,3
Buffjungle,tichondrius,288,druid,restoration,6,3,3
Yllercia,quelthalas,288,druid,restoration,6,3,3
Tziv,area-52,288,druid,restoration,6,3,3
Vadroid,dalaran,288,druid,restoration,6,3,3
Mädnhairy,zuljin,288,druid,restoration,6,3,3
Junglefevers,tichondrius,288,druid,restoration,6,3,3
Bearforcetwo,lightbringer,288,druid,restoration,6,3,3
Asian,moon-guard,288,druid,restoration,6,3,3
Ateup,dawnbringer,288,druid,restoration,6,3,3
Menapaws,muradin,288,druid,restoration,6,3,3
Nightz,icecrown,288,druid,restoration,6,3,3
Idolizeme,skullcrusher,288,druid,restoration,6,3,3
Isunami,emerald-dream,288,druid,restoration,6,3,3
Anaho,korgath,288,druid,restoration,6,3,3
Ømí,quelthalas,288,druid,restoration,6,3,3
Catdruid,the-forgotten-coast,288,druid,restoration,6,3,3
Geno,cenarius,288,druid,restoration,6,3,3
Muffiñ,moon-guard,288,druid,restoration,6,3,3
Eryon,nemesis,288,druid,restoration,6,3,3
Creamsoda,frostmane,288,druid,restoration,6,3,3
Nokash,tichondrius,288,druid,restoration,6,3,3
Antonniel,azralon,288,druid,restoration,6,3,3
Mythicdruid,ragnaros,288,druid,restoration,6,3,3
Xro,frostmourne,288,druid,restoration,6,3,3
Bin,moon-guard,288,druid,restoration,6,3,3
Hotmuztard,sargeras,288,druid,restoration,6,3,3
Anthria,illidan,288,druid,restoration,6,3,3
Moex,illidan,288,druid,restoration,6,3,3
Emiyababmura,tichondrius,288,druid,restoration,6,3,3
Aidoh,kelthuzad,288,druid,restoration,6,3,3
Koratan,frostmourne,288,druid,restoration,6,3,3
Stephenfurry,tichondrius,288,druid,restoration,6,3,3
Lðhnar,malganis,288,druid,restoration,6,3,3
Reptile,terenas,288,druid,restoration,6,3,3
Drunner,lothar,288,druid,restoration,6,3,3
Wolfbeasts,greymane,288,druid,restoration,6,3,3
Bibliopole,tichondrius,288,druid,restoration,6,3,3
Partylord,malganis,288,druid,restoration,6,3,3
Lotsoflovexo,illidan,288,druid,restoration,6,3,3
Seekamp,khazgoroth,288,druid,restoration,6,3,3
Druidma,aegwynn,288,druid,restoration,6,3,3
Flatnose,agamaggan,288,druid,restoration,6,3,3
Zaddy,spinebreaker,288,druid,restoration,6,3,3
Veyx,malganis,288,druid,restoration,6,3,3
Wâggles,moon-guard,288,druid,restoration,6,3,3
Obsesséd,aggramar,288,druid,restoration,6,3,3
Ðeepsixx,burning-legion,288,druid,restoration,6,3,3
Chúcknoúrish,agamaggan,288,druid,restoration,6,3,3
Tarlis,khazgoroth,288,druid,restoration,6,3,3
Fungamezx,bleeding-hollow,288,druid,restoration,6,3,3
Owaru,stormrage,288,druid,restoration,6,3,3
Panterarosa,ragnaros,288,druid,restoration,6,3,3
Càlthar,sargeras,288,druid,restoration,6,3,3
Sevensword,tichondrius,288,druid,restoration,6,3,3
Lemonnz,illidan,288,druid,restoration,6,3,3
Thenog,arthas,288,druid,restoration,6,3,3
Paps,laughing-skull,288,druid,restoration,6,3,3
Wiskees,sargeras,288,druid,restoration,6,3,3
Xötic,stormrage,288,druid,restoration,6,3,3
Azaran,bleeding-hollow,288,druid,restoration,6,3,3
Tronita,frostwolf,288,druid,restoration,6,3,3
Istayfrawsty,darkspear,288,druid,restoration,6,3,3
Juícebox,tichondrius,288,druid,restoration,6,3,3
Catahmine,thrall,288,druid,restoration,6,3,3
Lahgit,frostmourne,288,druid,restoration,6,3,3
Ayra,sargeras,288,druid,restoration,6,3,3
Drmf,frostmourne,288,druid,restoration,6,3,3
Teancookies,tichondrius,288,druid,restoration,6,3,3
Quasiderp,illidan,288,druid,restoration,6,3,3
Cutefeetz,moon-guard,288,druid,restoration,6,3,3
Kcazz,thorium-brotherhood,288,druid,restoration,6,3,3
Sonicphantom,kelthuzad,288,druid,restoration,6,3,3
Afterlîfe,sargeras,288,druid,restoration,6,3,3
Demitassie,wyrmrest-accord,288,druid,restoration,8,3,5
Overgrowth,zuljin,288,druid,restoration,9,3,6
Druidranda,sargeras,288,druid,restoration,12,3,9
Azngødz,tichondrius,288,druid,restoration,12,3,9
Theømega,stormrage,288,druid,restoration,12,3,9
Ttaure,ragnaros,288,druid,restoration,12,3,9
Raptormotoo,lothar,288,druid,restoration,12,3,9
Solushuffle,sargeras,288,druid,restoration,12,3,9
Bearlínwall,sargeras,288,druid,restoration,12,3,9
Noradn,malganis,288,druid,restoration,12,3,9
Krispies,eredar,288,druid,restoration,12,3,9
Møth,anvilmar,288,druid,restoration,12,3,9
Concerneddog,malganis,288,druid,restoration,12,3,9
Qdrui,tichondrius,288,druid,restoration,12,3,9
Nuantar,nemesis,288,druid,restoration,12,3,9
Otckillaa,boulderfist,288,druid,restoration,12,3,9
Bewear,zangarmarsh,288,druid,restoration,12,3,9
Soloqmenace,malganis,288,druid,restoration,12,3,9
Wwkd,illidan,288,druid,restoration,12,3,9
Mattiu,area-52,288,druid,restoration,12,3,9
Biggié,bleeding-hollow,288,druid,restoration,12,3,9
Endworldx,tichondrius,288,druid,restoration,12,3,9
Oflodor,azralon,288,druid,restoration,12,3,9
Zsi,frostmourne,288,druid,restoration,12,3,9
Theblind,korgath,288,druid,restoration,12,3,9
Blacksimba,area-52,288,druid,restoration,12,3,9
Anthren,garona,288,druid,restoration,12,3,9
Bigclapz,stormrage,288,druid,restoration,12,3,9
Monicaduan,frostmourne,288,druid,restoration,12,3,9
Garrodan,aerie-peak,288,druid,restoration,12,3,9
Samsaralol,tichondrius,288,druid,restoration,12,3,9
Quadrivium,stormrage,288,druid,restoration,12,3,9
Kanokoho,wyrmrest-accord,288,druid,restoration,12,3,9
Nesterin,arathor,288,druid,restoration,12,3,9
Madtreé,bleeding-hollow,288,druid,restoration,12,3,9
Deyz,ysera,288,druid,restoration,12,3,9
Shadøwshifta,kelthuzad,288,druid,restoration,12,3,9
Borbys,sargeras,288,druid,restoration,12,3,9
Giddeonv,draenor,288,druid,restoration,18,3,15
Friendly,wyrmrest-accord,288,druid,restoration,18,3,15
Soloqleaver,tichondrius,288,druid,restoration,18,3,15
Reenzy,azralon,288,druid,restoration,18,3,15
Thundyrcat,tichondrius,288,druid,restoration,18,3,15
Killvious,kelthuzad,288,druid,restoration,24,3,21
Jinglebells,kiljaeden,287,druid,restoration,6,3,3
Temujin,shadow-council,287,druid,restoration,6,3,3
Joxor,nordrassil,287,druid,restoration,6,3,3
Boldogs,proudmoore,287,druid,restoration,6,3,3
Moonfires,senjin,287,druid,restoration,6,3,3
Glowstixz,tichondrius,287,druid,restoration,6,3,3
Divitiacus,kiljaeden,287,druid,restoration,6,3,3
Hamfetameme,gundrak,287,druid,restoration,6,3,3
Sefestria,senjin,287,druid,restoration,6,3,3
Harderplease,emerald-dream,287,druid,restoration,6,3,3
Udala,durotan,287,druid,restoration,6,3,3
Ayakuya,veknilash,287,druid,restoration,6,3,3
Iamanoob,sargeras,287,druid,restoration,10,4,6
Lêsly,thrall,287,druid,restoration,12,3,9
Megara,dalaran,287,druid,restoration,12,3,9
Druishcat,dark-iron,287,druid,restoration,12,3,9
Atillah,stormscale,287,druid,restoration,12,3,9
Cieran,senjin,287,druid,restoration,18,3,15
Bullshiftter,ursin,286,druid,restoration,6,3,3
Dcdc,malganis,286,druid,restoration,6,3,3
Twoworldz,tichondrius,286,druid,restoration,6,3,3
Fortunecat,illidan,286,druid,restoration,12,3,9
Cryptalas,tichondrius,286,druid,restoration,12,3,9
Andraste,queldorei,286,druid,restoration,12,3,9
Taiyla,stormrage,286,druid,restoration,12,3,9
Moonbootz,proudmoore,285,druid,restoration,12,3,9
Sabari,area-52,285,druid,restoration,24,3,21
Brbcatsonfir,malganis,270,druid,restoration,28,4,24
Anastasyiar,illidan,256,druid,restoration,10,3,7
Gloomy,andorhal,256,druid,restoration,10,3,7
Mahjongg,stormrage,255,druid,restoration,14,4,10
Thrunirn,dalaran,254,druid,restoration,11,3,8
Stive,nemesis,234,druid,restoration,6,4,2
Yoona,kiljaeden,234,druid,restoration,7,4,3
Restyblazed,sargeras,234,druid,restoration,8,4,4
Donaldsr,area-52,234,druid,restoration,9,4,5
Stormwood,moonrunner,234,druid,restoration,21,4,17
Stèvén,tichondrius,233,druid,restoration,13,4,9
Aegys,medivh,224,druid,restoration,11,3,8
Gavdru,tichondrius,223,druid,restoration,8,3,5
Hotshrillz,illidan,192,druid,restoration,4,3,1
Faentz,stormrage,192,druid,restoration,9,3,6
Batshi,gorefiend,192,druid,restoration,6,2,4
Akinetic,illidan,192,druid,restoration,6,2,4
Ghostti,stormrage,192,druid,restoration,6,2,4
Zils,bleeding-hollow,192,druid,restoration,6,2,4
Kagekuma,bleeding-hollow,192,druid,restoration,6,2,4
Ambassador,kelthuzad,192,druid,restoration,6,2,4
Dustdruid,hakkar,192,druid,restoration,6,2,4
Naturestouch,tichondrius,192,druid,restoration,6,2,4
Katesw,tichondrius,192,druid,restoration,6,2,4
Penumbria,proudmoore,192,druid,restoration,6,2,4
Hyperdryve,bonechewer,192,druid,restoration,6,2,4
Cultnelf,illidan,192,druid,restoration,6,2,4
Firefireahh,sargeras,192,druid,restoration,6,2,4
Sidechonies,tichondrius,192,druid,restoration,6,2,4
Spongedaddy,tichondrius,192,druid,restoration,6,2,4
Ånðrømæðå,sargeras,192,druid,restoration,6,2,4
Sôlemn,barthilas,192,druid,restoration,6,2,4
Hchhi,ragnaros,192,druid,restoration,6,2,4
Bullbuddy,wyrmrest-accord,192,druid,restoration,6,2,4
Loved,stormrage,192,druid,restoration,6,2,4
Freemac,tichondrius,192,druid,restoration,6,2,4
Gêrm,stormrage,192,druid,restoration,6,2,4
Owlgz,barthilas,192,druid,restoration,6,2,4
Bekroh,crushridge,192,druid,restoration,6,2,4
Camthedruid,khadgar,192,druid,restoration,6,2,4
Five,the-underbog,192,druid,restoration,6,2,4
Twinkielol,kiljaeden,192,druid,restoration,6,2,4
Tropikana,burning-legion,192,druid,restoration,6,2,4
Droody,earthen-ring,192,druid,restoration,6,2,4
Cushionmaker,tichondrius,192,druid,restoration,6,2,4
Tynsley,malganis,192,druid,restoration,6,2,4
Noonwalk,illidan,192,druid,restoration,6,2,4
Stratego,drenden,192,druid,restoration,6,2,4
Violyte,tichondrius,192,druid,restoration,6,2,4
Netflixnphil,sargeras,192,druid,restoration,6,2,4
Kassius,alleria,192,druid,restoration,6,2,4
Shiftzy,thrall,192,druid,restoration,6,2,4
Geycat,tichondrius,192,druid,restoration,6,2,4
Niquil,hyjal,192,druid,restoration,6,2,4
Chasmata,malganis,192,druid,restoration,6,2,4
Runningback,emerald-dream,192,druid,restoration,6,2,4
Hotsoncrak,tichondrius,192,druid,restoration,6,2,4
Crazywoodowl,tichondrius,192,druid,restoration,6,2,4
Hawtzi,stormrage,192,druid,restoration,6,2,4
Terminatore,kelthuzad,192,druid,restoration,6,2,4
Pincho,hyjal,192,druid,restoration,6,2,4
Kaisuckslol,stormrage,192,druid,restoration,6,2,4
Epicbehr,kiljaeden,192,druid,restoration,6,2,4
Rubato,dathremar,192,druid,restoration,6,2,4
Bigtonkatruk,tichondrius,192,druid,restoration,6,2,4
Gorfrog,tichondrius,192,druid,restoration,6,2,4
Nacur,bleeding-hollow,192,druid,restoration,6,2,4
Gretatunberg,skywall,192,druid,restoration,6,2,4
Sandiegoo,destromath,192,druid,restoration,6,2,4
Clonkzy,area-52,192,druid,restoration,6,2,4
Destaliyas,sargeras,192,druid,restoration,6,2,4
Tadoo,tichondrius,192,druid,restoration,6,2,4
Tatahe,zuljin,192,druid,restoration,6,2,4
Jxp,tichondrius,192,druid,restoration,6,2,4
Drulícinha,azralon,192,druid,restoration,6,2,4
Relxlol,tichondrius,192,druid,restoration,6,2,4
Snugglin,kelthuzad,192,druid,restoration,6,2,4
Boundless,skullcrusher,192,druid,restoration,6,2,4
Hatricio,ragnaros,192,druid,restoration,6,2,4
Gepardéx,ragnaros,192,druid,restoration,6,2,4
Tagliatélle,emerald-dream,192,druid,restoration,6,2,4
Darinnia,lothar,192,druid,restoration,6,2,4
Murpheey,sargeras,192,druid,restoration,6,2,4
Laesh,nemesis,192,druid,restoration,6,2,4
Jackdr,tichondrius,192,druid,restoration,6,2,4
Megasteak,lightninghoof,192,druid,restoration,6,2,4
Koalla,frostmourne,192,druid,restoration,6,2,4
Lilcocoxoxo,shadowmoon,192,druid,restoration,6,2,4
Leafthief,whisperwind,192,druid,restoration,6,2,4
Bomp,malganis,192,druid,restoration,6,2,4
Barkcheeks,area-52,192,druid,restoration,6,2,4
Levincy,thrall,192,druid,restoration,6,2,4
Zaddychulo,area-52,192,druid,restoration,6,2,4
Hipityhopity,bleeding-hollow,192,druid,restoration,6,2,4
Kornaz,guldan,192,druid,restoration,6,2,4
Whiplash,deathwing,192,druid,restoration,6,2,4
Aewsome,quelthalas,192,druid,restoration,6,2,4
Vaelstrasz,skullcrusher,192,druid,restoration,6,2,4
Feeoria,lothar,192,druid,restoration,6,2,4
Cheesetouchy,illidan,192,druid,restoration,6,2,4
Mcbeef,tichondrius,192,druid,restoration,6,2,4
Hotsx,frostmourne,192,druid,restoration,9,2,7
Sleepyheals,tichondrius,192,druid,restoration,14,3,11
Nakedllove,sargeras,192,druid,restoration,11,2,9
Sírius,stormrage,192,druid,restoration,12,2,10
Bennedïct,tichondrius,192,druid,restoration,12,2,10
Crunchieroll,illidan,192,druid,restoration,12,2,10
Goorybud,tichondrius,192,druid,restoration,12,2,10
Xaric,area-52,192,druid,restoration,12,2,10
Pinchncheeks,bleeding-hollow,192,druid,restoration,12,2,10
Moonkay,tichondrius,192,druid,restoration,12,2,10
Grullandur,hakkar,192,druid,restoration,12,2,10
Glockenstien,proudmoore,192,druid,restoration,12,2,10
Dráz,stormrage,192,druid,restoration,12,2,10
Dodozhou,illidan,192,druid,restoration,12,2,10
Wonderhood,quelthalas,192,druid,restoration,12,2,10
Chaarm,proudmoore,192,druid,restoration,12,2,10
Bboikha,quelthalas,192,druid,restoration,12,2,10
Bossdru,sargeras,192,druid,restoration,12,2,10
Crazystorm,ragnaros,192,druid,restoration,12,2,10
Aelena,whisperwind,192,druid,restoration,12,2,10
Trèè,frostmane,192,druid,restoration,12,2,10
Batlex,thrall,192,druid,restoration,12,2,10
Aelvalus,goldrinn,192,druid,restoration,12,2,10
Moocka,ragnaros,192,druid,restoration,12,2,10
Fribbleog,korgath,192,druid,restoration,12,2,10
Cpksdru,tichondrius,192,druid,restoration,12,2,10
Urhero,sargeras,192,druid,restoration,12,2,10
Actioncat,emerald-dream,192,druid,restoration,12,2,10
Rootslayer,tichondrius,192,druid,restoration,12,2,10
Lunmoon,thrall,192,druid,restoration,12,2,10
Fjv,laughing-skull,192,druid,restoration,12,2,10
Kymolyia,sargeras,192,druid,restoration,12,2,10
Moggwasi,tichondrius,192,druid,restoration,12,2,10
Gradiluth,proudmoore,192,druid,restoration,12,2,10
Jaaodalari,azralon,192,druid,restoration,12,2,10
Iyrnae,zuljin,192,druid,restoration,12,2,10
Daesdaddy,sargeras,192,druid,restoration,12,2,10
Jayto,frostmourne,192,druid,restoration,12,2,10
Gahr,wyrmrest-accord,192,druid,restoration,12,2,10
Pawswap,tichondrius,192,druid,restoration,13,2,11
Devilzown,fenris,192,druid,restoration,18,2,16
Clonemunster,frostmourne,192,druid,restoration,18,2,16
Çarpentree,sargeras,192,druid,restoration,18,2,16
Brutalhealz,aegwynn,192,druid,restoration,18,2,16
Moonkinx,frostwolf,191,druid,restoration,6,2,4
Flusky,moon-guard,191,druid,restoration,6,2,4
Inbreds,jubeithos,191,druid,restoration,6,2,4
Naxanax,stormrage,191,druid,restoration,6,2,4
Samesaras,darkspear,191,druid,restoration,6,2,4
Denyou,aggramar,191,druid,restoration,12,2,10
Grimshifta,kelthuzad,191,druid,restoration,12,2,10
Ellarrya,moon-guard,191,druid,restoration,12,2,10
Daweed,zuluhed,191,druid,restoration,12,2,10
Voodooshiftz,emerald-dream,191,druid,restoration,12,2,10
Äbÿss,tichondrius,191,druid,restoration,12,2,10
Calliecat,moon-guard,191,druid,restoration,12,2,10
Wantto,moknathal,190,druid,restoration,12,2,10
Dreamwalk,stormrage,175,druid,restoration,17,3,14
Vzi,magtheridon,159,druid,restoration,5,2,3
Pvptactician,tichondrius,159,druid,restoration,11,4,7
Acidmoon,tichondrius,159,druid,restoration,14,3,11
Jeppcat,tichondrius,159,druid,restoration,14,3,11
Frenzymoon,zuljin,144,druid,restoration,3,3,0
Vìdá,tichondrius,138,druid,restoration,8,3,5
Jruicy,frostmourne,138,druid,restoration,11,4,7
Teddybëar,illidan,138,druid,restoration,9,3,6
Pokieoaks,zuljin,138,druid,restoration,10,3,7
Mojoforweeks,bleeding-hollow,138,druid,restoration,12,3,9
Galind,rexxar,128,druid,restoration,4,2,2
Alshari,proudmoore,128,druid,restoration,10,2,8
Crunkk,thunderlord,127,druid,restoration,14,2,12
Hille,sargeras,127,druid,restoration,14,2,12
Dotdmage,tichondrius,105,druid,restoration,15,3,12
Forestmaster,area-52,96,druid,restoration,8,2,6
Diligent,dathremar,96,druid,restoration,6,1,5
Arthridas,wyrmrest-accord,96,druid,restoration,6,1,5
Whitehaze,proudmoore,96,druid,restoration,6,1,5
Tyrander,tichondrius,96,druid,restoration,6,1,5
Hòler,sargeras,96,druid,restoration,6,1,5
Kendra,barthilas,96,druid,restoration,6,1,5
Natürëblÿät,illidan,96,druid,restoration,6,1,5
Orakuru,barthilas,96,druid,restoration,6,1,5
Sinistuhd,tichondrius,96,druid,restoration,6,1,5
Ayla,gorefiend,96,druid,restoration,6,1,5
Nutless,illidan,96,druid,restoration,6,1,5
Slickshifter,sargeras,96,druid,restoration,6,1,5
Cbreezyy,tichondrius,96,druid,restoration,6,1,5
Remorphose,tichondrius,96,druid,restoration,6,1,5
Samully,area-52,96,druid,restoration,6,1,5
Chomperz,tichondrius,96,druid,restoration,6,1,5
Beldiin,khazgoroth,96,druid,restoration,6,1,5
Vikkileaks,aegwynn,96,druid,restoration,6,1,5
Rokvaahn,illidan,96,druid,restoration,6,1,5
Ryhighd,sargeras,96,druid,restoration,6,1,5
Moocowbear,illidan,96,druid,restoration,6,1,5
Lokobah,wyrmrest-accord,96,druid,restoration,6,1,5
Soñics,tichondrius,96,druid,restoration,6,1,5
Commandozero,tichondrius,96,druid,restoration,6,1,5
Katastrophý,tichondrius,96,druid,restoration,6,1,5
Framess,area-52,96,druid,restoration,6,1,5
Zabartak,lightnings-blade,96,druid,restoration,6,1,5
Raìñ,tichondrius,96,druid,restoration,6,1,5
Thiccybear,darkspear,96,druid,restoration,6,1,5
Animalstylee,tichondrius,96,druid,restoration,6,1,5
Robomexi,tichondrius,96,druid,restoration,6,1,5
Skéla,emerald-dream,96,druid,restoration,6,1,5
Botdruid,hyjal,96,druid,restoration,6,1,5
Aimafengari,emerald-dream,96,druid,restoration,6,1,5
Macfluff,emerald-dream,96,druid,restoration,6,1,5
Dllz,drakthul,96,druid,restoration,6,1,5
Zeelán,emerald-dream,96,druid,restoration,6,1,5
Shiftingtaco,tichondrius,96,druid,restoration,6,1,5
Leoho,tichondrius,96,druid,restoration,6,1,5
Scorpitary,ysera,96,druid,restoration,6,1,5
Feralgo,tichondrius,96,druid,restoration,6,1,5
Peterdeleter,emerald-dream,96,druid,restoration,6,1,5
Rakroz,emerald-dream,96,druid,restoration,6,1,5
Theßanished,hellscream,96,druid,restoration,6,1,5
Kekepop,emerald-dream,96,druid,restoration,6,1,5
Djsummer,tichondrius,96,druid,restoration,6,1,5
Smitebacklol,tichondrius,96,druid,restoration,6,1,5
Killerskullw,darkspear,96,druid,restoration,6,1,5
Alagorn,zangarmarsh,96,druid,restoration,6,1,5
Baconsniper,illidan,96,druid,restoration,6,1,5
Hammyaki,area-52,96,druid,restoration,6,1,5
Berserkr,lethon,96,druid,restoration,6,1,5
Sheeftah,illidan,96,druid,restoration,6,1,5
Popsiclex,frostmourne,96,druid,restoration,6,1,5
Bërzerk,dalvengyr,96,druid,restoration,6,1,5
Krucífy,dark-iron,96,druid,restoration,6,1,5
Irl,frostmane,96,druid,restoration,6,1,5
Rezl,sargeras,96,druid,restoration,6,1,5
Kazamura,tichondrius,96,druid,restoration,6,1,5
Moonshocka,tichondrius,96,druid,restoration,6,1,5
Feorb,azuremyst,96,druid,restoration,6,1,5
Bùgga,malfurion,96,druid,restoration,6,1,5
Cäirnëhöfblö,quelthalas,96,druid,restoration,6,1,5
Atagoo,tichondrius,96,druid,restoration,6,1,5
Kurzul,area-52,96,druid,restoration,6,1,5
Gúdru,zuljin,96,druid,restoration,6,1,5
Tirazul,area-52,96,druid,restoration,6,1,5
Ðjx,stormrage,96,druid,restoration,6,1,5
Kzdubya,stormrage,96,druid,restoration,6,1,5
Arienne,kelthuzad,96,druid,restoration,6,1,5
Wotermelon,moon-guard,96,druid,restoration,6,1,5
Bluwhale,tichondrius,96,druid,restoration,6,1,5
Caminanube,quelthalas,96,druid,restoration,6,1,5
Fadingfast,frostmourne,96,druid,restoration,6,1,5
Dsoul,tichondrius,96,druid,restoration,6,1,5
Sily,frostmourne,96,druid,restoration,6,1,5
Logyoh,tichondrius,96,druid,restoration,6,1,5
Dedderita,bloodhoof,96,druid,restoration,6,1,5
Suncintus,aggramar,96,druid,restoration,6,1,5
Kitcat,magtheridon,96,druid,restoration,6,1,5
Khenes,ragnaros,96,druid,restoration,6,1,5
Hurbd,frostmourne,96,druid,restoration,6,1,5
Nuruu,frostmourne,96,druid,restoration,6,1,5
Róce,stormrage,96,druid,restoration,6,1,5
Alajandro,malganis,96,druid,restoration,6,1,5
Zorp,bleeding-hollow,96,druid,restoration,6,1,5
Kirato,ragnaros,96,druid,restoration,6,1,5
Moonkingx,ragnaros,96,druid,restoration,6,1,5
Cowboyydan,malganis,96,druid,restoration,6,1,5
Nìck,the-scryers,96,druid,restoration,6,1,5
Boomtre,malganis,96,druid,restoration,6,1,5
Moonfart,zuljin,96,druid,restoration,6,1,5
Juves,frostmourne,96,druid,restoration,6,1,5
Barrahjr,frostmourne,96,druid,restoration,6,1,5
Spatulas,malganis,96,druid,restoration,6,1,5
Rastakant,malganis,96,druid,restoration,6,1,5
Uzheals,zuljin,96,druid,restoration,6,1,5
Nyanncat,frostmourne,96,druid,restoration,7,1,6
Lirilith,shadowsong,96,druid,restoration,16,2,14
Ikita,illidan,96,druid,restoration,8,1,7
Shebleeder,aegwynn,96,druid,restoration,11,1,10
Foracus,sargeras,96,druid,restoration,11,1,10
Taztoc,stormrage,96,druid,restoration,11,1,10
Bigjunk,boulderfist,96,druid,restoration,12,1,11
Morpheûs,bleeding-hollow,96,druid,restoration,12,1,11
Whiteglade,moon-guard,96,druid,restoration,12,1,11
Kopidruid,barthilas,96,druid,restoration,12,1,11
Morezby,frostmourne,96,druid,restoration,12,1,11
Rebornwhisp,moon-guard,96,druid,restoration,12,1,11
Kaeliah,stormrage,96,druid,restoration,12,1,11
Framling,sargeras,96,druid,restoration,12,1,11
Florella,misha,96,druid,restoration,12,1,11
Moonessence,fenris,96,druid,restoration,12,1,11
Flörence,drakkari,96,druid,restoration,12,1,11
Adaeloth,hyjal,96,druid,restoration,12,1,11
Bethorâ,suramar,96,druid,restoration,12,1,11
Durkanis,maelstrom,96,druid,restoration,12,1,11
Idontmoo,area-52,96,druid,restoration,12,1,11
Sinigang,duskwood,96,druid,restoration,12,1,11
Theserbian,mugthol,96,druid,restoration,12,1,11
Daxximus,area-52,96,druid,restoration,12,1,11
Carboz,jubeithos,96,druid,restoration,12,1,11
Mofoogoo,laughing-skull,96,druid,restoration,13,1,12
Thorsèn,sargeras,96,druid,restoration,15,1,14
Grakzul,blood-furnace,95,druid,restoration,9,2,7
Herbalife,stormrage,95,druid,restoration,6,1,5
Huriel,blackrock,95,druid,restoration,6,1,5
Bbabbi,tichondrius,89,druid,restoration,5,3,2
Miviaris,alleria,79,druid,restoration,5,1,4
Pawblems,sargeras,79,druid,restoration,5,1,4
Eliteshift,frostmourne,64,druid,restoration,4,1,3
Pownage,kelthuzad,64,druid,restoration,16,1,15
Bòmi,tichondrius,63,druid,restoration,2,2,0
Nightwinter,area-52,42,druid,restoration,10,2,8
Dankymoo,thunderlord,31,druid,restoration,2,1,1
Valrathsx,arthas,31,druid,restoration,2,1,1
Suwonhealer,tichondrius,31,druid,restoration,8,1,7
Landro,tichondrius,1373,druid,guardian,107,51,56
Kobebeef,malganis,1203,druid,guardian,30,13,17
Ashamang,emerald-dream,1135,druid,guardian,30,16,14
Haalls,gallywix,1110,druid,guardian,54,16,38
Yurius,kiljaeden,1107,druid,guardian,36,21,15
Ürsus,quelthalas,1106,druid,guardian,72,32,40
Theme,frostwolf,1089,druid,guardian,48,18,30
Ntseebxoxoxg,gurubashi,1085,druid,guardian,66,28,38
Crashägásm,proudmoore,1062,druid,guardian,30,15,15
Kesagake,feathermoon,921,druid,guardian,18,10,8
Nerfmesoon,sargeras,920,druid,guardian,22,10,12
Firash,frostmourne,888,druid,guardian,21,11,10
Aìón,emerald-dream,879,druid,guardian,24,12,12
Maraliss,shadowsong,863,druid,guardian,30,14,16
Muphasax,ragnaros,862,druid,guardian,74,25,49
Manasmi,frostmourne,854,druid,guardian,71,30,41
Mordu,rivendare,838,druid,guardian,25,9,16
Gums,lightbringer,800,druid,guardian,95,30,65
Inxert,tichondrius,792,druid,guardian,16,9,7
Gifteddream,zuljin,759,druid,guardian,24,9,15
Ishiftalot,bleeding-hollow,758,druid,guardian,21,9,12
Dalidielor,dalaran,671,druid,guardian,18,7,11
Koan,proudmoore,671,druid,guardian,24,7,17
Jacinty,saurfang,670,druid,guardian,18,7,11
Multivar,burning-legion,669,druid,guardian,12,7,5
Agmukar,wyrmrest-accord,659,druid,guardian,12,7,5
Strivinz,kelthuzad,632,druid,guardian,20,8,12
Lycanthus,thrall,575,druid,guardian,12,6,6
Moistism,khazgoroth,575,druid,guardian,24,6,18
Rektx,area-52,574,druid,guardian,12,6,6
Giddeonv,draenor,570,druid,guardian,12,6,6
Bjørnen,thrall,570,druid,guardian,12,6,6
Caliwagon,dalaran,490,druid,guardian,19,6,13
Agaxaido,azgalor,480,druid,guardian,12,5,7
Sloom,zuljin,480,druid,guardian,12,5,7
Ferio,moon-guard,480,druid,guardian,24,5,19
Chärmin,area-52,479,druid,guardian,12,5,7
Zhangfei,barthilas,479,druid,guardian,12,5,7
Balanah,quelthalas,472,druid,guardian,15,6,9
Tommygomy,illidan,384,druid,guardian,6,4,2
Maen,kelthuzad,384,druid,guardian,6,4,2
Krylax,sargeras,384,druid,guardian,12,4,8
Bleedhoof,frostmourne,384,druid,guardian,12,4,8
Druidd,moonrunner,384,druid,guardian,12,4,8
Bigxworm,gurubashi,384,druid,guardian,12,4,8
Wraithman,madoran,383,druid,guardian,6,4,2
Vennfox,illidan,383,druid,guardian,12,4,8
Tankbareass,aerie-peak,382,druid,guardian,18,4,14
Cléa,illidan,381,druid,guardian,12,4,8
Peteybears,stormrage,288,druid,guardian,6,3,3
Zultuot,azralon,288,druid,guardian,6,3,3
Jumånjï,tichondrius,288,druid,guardian,6,3,3
Manwool,illidan,288,druid,guardian,12,3,9
Jüggernäut,area-52,288,druid,guardian,12,3,9
Cayinna,altar-of-storms,288,druid,guardian,12,3,9
Woozydruid,anetheron,288,druid,guardian,12,3,9
Deutschland,whisperwind,288,druid,guardian,12,3,9
Read,boulderfist,288,druid,guardian,12,3,9
Israh,malygos,287,druid,guardian,12,3,9
Mavren,uldaman,286,druid,guardian,6,3,3
Classykitty,tichondrius,192,druid,guardian,4,3,1
Mommyh,duskwood,192,druid,guardian,6,2,4
Lilgushy,area-52,192,druid,guardian,6,2,4
Skrimshaw,burning-legion,192,druid,guardian,6,2,4
Drürsidae,malganis,192,druid,guardian,6,2,4
Avbox,proudmoore,192,druid,guardian,6,2,4
Athious,moon-guard,192,druid,guardian,6,2,4
Spacex,amanthul,192,druid,guardian,6,2,4
Denmotha,moon-guard,192,druid,guardian,6,2,4
Fluff,gurubashi,192,druid,guardian,6,2,4
Battlecát,stormscale,192,druid,guardian,6,2,4
Eithelsa,frostmourne,191,druid,guardian,6,2,4
Penjamiin,tichondrius,191,druid,guardian,6,2,4
Widedually,aegwynn,191,druid,guardian,6,2,4
Altabarda,quelthalas,191,druid,guardian,12,2,10
Meliódás,area-52,191,druid,guardian,18,2,16
Gornish,azralon,190,druid,guardian,12,2,10
Wintarz,sargeras,96,druid,guardian,6,1,5
Malvolo,eredar,96,druid,guardian,6,1,5
Funkbear,black-dragonflight,96,druid,guardian,6,1,5
Vindecca,kelthuzad,96,druid,guardian,6,1,5
Finntann,moon-guard,96,druid,guardian,6,1,5
Juicecarton,thrall,96,druid,guardian,6,1,5
Aurno,queldorei,96,druid,guardian,6,1,5
Gojen,stonemaul,96,druid,guardian,6,1,5
Sixfeetunder,shattered-halls,96,druid,guardian,6,1,5
Drur,zuljin,96,druid,guardian,6,1,5
Cawkaw,frostwolf,96,druid,guardian,6,1,5
Weezydende,area-52,96,druid,guardian,6,1,5
Moonshocka,tichondrius,96,druid,guardian,6,1,5
Kushtiger,ragnaros,96,druid,guardian,6,1,5
Flenser,frostmane,96,druid,guardian,6,1,5
Vineclaw,emerald-dream,96,druid,guardian,12,1,11
Kylysea,dalaran,96,druid,guardian,12,1,11
Woowis,stormrage,96,druid,guardian,12,1,11
Abuz,azralon,96,druid,guardian,12,1,11
Chathos,emerald-dream,96,druid,guardian,12,1,11
Fulmerethine,emerald-dream,96,druid,guardian,12,1,11
Varcoe,stormrage,96,druid,guardian,12,1,11
Divax,proudmoore,96,druid,guardian,12,1,11
Lakroz,zuljin,95,druid,guardian,6,1,5
Jussgrimm,kiljaeden,79,druid,guardian,5,1,4
Cheyvá,proudmoore,79,druid,guardian,5,1,4
Sitruk,uldum,63,druid,guardian,10,1,9
Ogdaugh,nagrand,48,druid,guardian,3,1,2
Bawbe,lightbringer,2250,druid,feral,119,66,53
Floppa,whisperwind,2243,druid,feral,102,56,46
Auntsusie,stormrage,2204,druid,feral,119,75,44
Evildooer,stormrage,2203,druid,feral,84,46,38
Marvin,stormreaver,2201,druid,feral,94,49,45
Loser,stormrage,2190,druid,feral,93,49,44
Jaguar,whisperwind,2188,druid,feral,93,50,43
Nyç,sargeras,2139,druid,feral,216,116,100
Kynvi,moon-guard,2133,druid,feral,78,41,37
Crunchyroll,sargeras,2126,druid,feral,168,91,77
Iinkinbio,alleria,2124,druid,feral,84,50,34
Duzis,tichondrius,2122,druid,feral,188,102,86
Bassy,whisperwind,2098,druid,feral,94,46,48
Angryalyu,tichondrius,2077,druid,feral,186,90,96
Porkonmyfork,frostmourne,2068,druid,feral,76,40,36
Formrage,jubeithos,2063,druid,feral,212,110,102
Boomboombom,tichondrius,2054,druid,feral,119,72,47
Yüxy,sargeras,2048,druid,feral,174,85,89
Henikbite,zuljin,2018,druid,feral,125,65,60
Calikonger,spirestone,2000,druid,feral,66,34,32
Trìckyz,tichondrius,1998,druid,feral,248,128,120
Beomjun,tichondrius,1970,druid,feral,128,69,59
Floorz,firetree,1969,druid,feral,54,27,27
Babekisser,stormrage,1961,druid,feral,130,69,61
Vinjo,ragnaros,1955,druid,feral,90,42,48
Amellies,quelthalas,1953,druid,feral,250,129,121
Pdfilewatch,stormrage,1943,druid,feral,42,30,12
Feeg,sargeras,1937,druid,feral,65,33,32
Notapn,tichondrius,1926,druid,feral,96,54,42
Floorz,bleeding-hollow,1923,druid,feral,117,55,62
Abstractf,sargeras,1916,druid,feral,92,51,41
Chowxx,tichondrius,1910,druid,feral,96,45,51
Skrambles,mugthol,1906,druid,feral,75,36,39
Cracked,vashj,1899,druid,feral,99,61,38
Samuel,ravencrest,1897,druid,feral,60,33,27
Nèffex,sargeras,1897,druid,feral,90,49,41
Ripbot,sargeras,1894,druid,feral,59,31,28
Duhfective,proudmoore,1887,druid,feral,65,33,32
Cliodhna,kelthuzad,1885,druid,feral,102,51,51
Suedle,kelthuzad,1883,druid,feral,53,27,26
Mocfernando,sargeras,1873,druid,feral,60,31,29
Hypérion,dalaran,1863,druid,feral,95,43,52
Astrozxy,sargeras,1860,druid,feral,42,23,19
Alleae,stormrage,1859,druid,feral,72,37,35
Boomboomboom,misha,1857,druid,feral,301,147,154
Kittendev,tichondrius,1852,druid,feral,78,35,43
Rwhatkr,tichondrius,1847,druid,feral,47,20,27
Meldzetzan,tichondrius,1845,druid,feral,49,30,19
Fappywapple,kiljaeden,1845,druid,feral,161,78,83
Sammy,scilla,1842,druid,feral,84,40,44
Lesliewj,proudmoore,1841,druid,feral,71,38,33
Tyxi,bleeding-hollow,1839,druid,feral,46,31,15
Hriiya,tichondrius,1838,druid,feral,101,46,55
Zuljor,sargeras,1836,druid,feral,54,34,20
Vebee,frostmourne,1833,druid,feral,89,49,40
Darmari,quelthalas,1833,druid,feral,71,30,41
Ërebüs,emerald-dream,1832,druid,feral,65,29,36
Yayue,tichondrius,1830,druid,feral,72,37,35
Kolbie,emerald-dream,1828,druid,feral,196,108,88
Bpdferal,stormrage,1828,druid,feral,180,99,81
Unfriendly,bleeding-hollow,1826,druid,feral,227,126,101
Russiaguy,area-52,1826,druid,feral,271,141,130
Linkinbiox,alleria,1824,druid,feral,54,29,25
Feignxd,emerald-dream,1823,druid,feral,60,43,17
Chrye,tichondrius,1820,druid,feral,69,35,34
Kakaroot,tichondrius,1813,druid,feral,153,78,75
Lemön,frostmourne,1812,druid,feral,66,34,32
Hugecat,tichondrius,1812,druid,feral,60,26,34
Stellar,steamwheedle-cartel,1811,druid,feral,138,66,72
Yukjr,stormrage,1810,druid,feral,149,71,78
Brewdock,boulderfist,1809,druid,feral,111,55,56
Ryecoke,stormrage,1801,druid,feral,48,25,23
Wowgamer,sargeras,1789,druid,feral,54,34,20
Killuf,quelthalas,1784,druid,feral,101,39,62
Soaring,moon-guard,1778,druid,feral,45,24,21
Kakagroot,tichondrius,1769,druid,feral,54,30,24
Save,aerie-peak,1769,druid,feral,54,27,27
Fangry,queldorei,1768,druid,feral,112,61,51
Sappora,illidan,1768,druid,feral,190,96,94
Fuqet,kelthuzad,1767,druid,feral,174,88,86
Tyx,bleeding-hollow,1767,druid,feral,80,35,45
Proudfurryxo,dragonmaw,1765,druid,feral,50,27,23
Icespicè,tichondrius,1765,druid,feral,114,53,61
Raincloud,mannoroth,1763,druid,feral,58,35,23
Wildfire,nesingwary,1760,druid,feral,134,73,61
Yoruìchí,tichondrius,1759,druid,feral,36,23,13
Idiotferal,tortheldrin,1754,druid,feral,59,37,22
Mhdd,tichondrius,1754,druid,feral,72,39,33
Kobez,bleeding-hollow,1748,druid,feral,84,46,38
Brawleyx,tichondrius,1742,druid,feral,88,42,46
Tabbsy,frostmourne,1741,druid,feral,90,37,53
Gaday,malganis,1732,druid,feral,90,43,47
Stêff,zuljin,1731,druid,feral,150,79,71
Tompunch,tichondrius,1730,druid,feral,109,55,54
Akamu,nemesis,1724,druid,feral,78,31,47
Ferar,frostmourne,1723,druid,feral,77,40,37
Jihadibleeds,stormrage,1722,druid,feral,55,41,14
Extic,sargeras,1721,druid,feral,84,47,37
Tenavï,stormrage,1719,druid,feral,48,23,25
Flayx,frostmourne,1718,druid,feral,54,23,31
Retzerbil,sargeras,1716,druid,feral,24,18,6
Plux,illidan,1714,druid,feral,186,102,84
Fliip,barthilas,1711,druid,feral,53,27,26
Addymeow,drenden,1709,druid,feral,54,30,24
Thycamore,cenarius,1708,druid,feral,60,23,37
Djdontlose,stormrage,1707,druid,feral,97,52,45
Nrp,stormrage,1702,druid,feral,114,48,66
Nicó,darkspear,1701,druid,feral,129,62,67
Europecat,stormrage,1698,druid,feral,36,20,16
Yavà,tichondrius,1697,druid,feral,90,51,39
Cjæ,bleeding-hollow,1693,druid,feral,40,26,14
Turow,firetree,1690,druid,feral,53,25,28
Ocêanus,sargeras,1689,druid,feral,31,27,4
Bobochan,tichondrius,1688,druid,feral,48,18,30
Loserceo,stormrage,1687,druid,feral,36,20,16
Flowkie,illidan,1684,druid,feral,140,70,70
Erykk,dalaran,1684,druid,feral,60,27,33
Nitetree,thrall,1679,druid,feral,78,40,38
Akanx,tichondrius,1677,druid,feral,36,21,15
Durwyn,sargeras,1677,druid,feral,243,119,124
Bearoids,daggerspine,1676,druid,feral,66,40,26
Ivangamaz,area-52,1675,druid,feral,41,22,19
Blrr,sargeras,1673,druid,feral,132,62,70
Lycanthrøpe,moon-guard,1672,druid,feral,80,35,45
Oroskii,bleeding-hollow,1671,druid,feral,71,35,36
Bearlylegalz,kelthuzad,1671,druid,feral,48,23,25
Ursarius,skullcrusher,1670,druid,feral,77,40,37
Dewfuss,tichondrius,1669,druid,feral,54,31,23
Redhotbean,tichondrius,1665,druid,feral,40,23,17
Féralis,sargeras,1663,druid,feral,30,18,12
Yavann,tichondrius,1663,druid,feral,124,68,56
Gabdruid,kiljaeden,1661,druid,feral,66,33,33
Feraly,malganis,1659,druid,feral,48,25,23
Yukjr,tichondrius,1656,druid,feral,42,18,24
Chasertv,tichondrius,1650,druid,feral,36,19,17
Milkmoneymeo,illidan,1650,druid,feral,42,20,22
Zlegacy,anvilmar,1650,druid,feral,54,21,33
Porkloafed,illidan,1649,druid,feral,163,82,81
Rokaizu,dalaran,1649,druid,feral,65,30,35
Faelonk,frostmourne,1646,druid,feral,132,71,61
Kyoski,moon-guard,1645,druid,feral,34,19,15
Kibbens,area-52,1643,druid,feral,196,98,98
Bhen,tichondrius,1643,druid,feral,42,19,23
Phøënîx,tichondrius,1643,druid,feral,42,18,24
Bigbite,tichondrius,1642,druid,feral,66,37,29
Grizzlepaw,tichondrius,1638,druid,feral,186,100,86
Nuadris,azralon,1638,druid,feral,173,87,86
Xyphor,bladefist,1637,druid,feral,40,22,18
Amishal,stormrage,1636,druid,feral,84,38,46
Atrumn,emerald-dream,1631,druid,feral,78,33,45
Darkosdruid,tichondrius,1630,druid,feral,36,24,12
Ging,azralon,1630,druid,feral,30,17,13
Dustin,moon-guard,1630,druid,feral,140,73,67
Nobruh,sargeras,1630,druid,feral,138,68,70
Zwaski,thrall,1630,druid,feral,150,73,77
Ohaa,sargeras,1628,druid,feral,18,17,1
Zenlonn,emerald-dream,1628,druid,feral,44,21,23
Foxmeowz,blackwater-raiders,1627,druid,feral,36,20,16
Jiffynuts,proudmoore,1627,druid,feral,36,18,18
Shiftage,frostmane,1627,druid,feral,57,22,35
Weedsmuggler,burning-legion,1626,druid,feral,284,149,135
Fendiy,barthilas,1625,druid,feral,84,49,35
Prille,tichondrius,1624,druid,feral,45,23,22
Feorb,azuremyst,1623,druid,feral,36,17,19
Dahmu,malygos,1622,druid,feral,203,107,96
Off,ravencrest,1622,druid,feral,172,86,86
Poppynoff,barthilas,1621,druid,feral,66,28,38
Csinii,bleeding-hollow,1621,druid,feral,54,22,32
Zyhsul,emerald-dream,1620,druid,feral,42,21,21
Lakunahof,ragnaros,1620,druid,feral,51,25,26
Susruth,area-52,1619,druid,feral,42,18,24
Enya,stormreaver,1618,druid,feral,66,31,35
Hiddenfur,ragnaros,1617,druid,feral,36,19,17
Poosnickety,kelthuzad,1617,druid,feral,49,21,28
Conker,frostmourne,1616,druid,feral,222,112,110
Jizzie,tichondrius,1615,druid,feral,114,67,47
Wøs,area-52,1615,druid,feral,98,50,48
Zirrie,stormrage,1614,druid,feral,68,36,32
Beastbaby,eldrethalas,1613,druid,feral,48,19,29
Anxietyburns,stormrage,1612,druid,feral,93,52,41
Clutchtime,sentinels,1610,druid,feral,46,21,25
Xanybarz,stormrage,1608,druid,feral,131,65,66
Ulcera,nemesis,1607,druid,feral,60,39,21
Chococrispis,quelthalas,1606,druid,feral,48,21,27
Batterydruid,silvermoon,1605,druid,feral,36,20,16
Lunacore,illidan,1605,druid,feral,97,50,47
Fyrkax,sargeras,1603,druid,feral,30,19,11
Hapgood,archimonde,1602,druid,feral,42,17,25
Kittycudi,hyjal,1601,druid,feral,28,18,10
Prêdator,ragnaros,1601,druid,feral,161,88,73
Oldtomcat,moon-guard,1601,druid,feral,96,45,51
Feralgo,tichondrius,1600,druid,feral,36,17,19
Tysandra,sargeras,1600,druid,feral,42,17,25
Irontree,dunemaul,1598,druid,feral,48,23,25
Jpegcollectr,tichondrius,1598,druid,feral,88,32,56
Unfunnyferal,kelthuzad,1596,druid,feral,42,19,23
Melez,kelthuzad,1588,druid,feral,229,119,110
Rank,nerzhul,1588,druid,feral,126,59,67
Mxdi,tichondrius,1586,druid,feral,42,23,19
Kyrô,sargeras,1585,druid,feral,47,21,26
Slanue,tichondrius,1585,druid,feral,76,33,43
Shreds,kirin-tor,1581,druid,feral,55,19,36
Meanbear,stormrage,1577,druid,feral,54,27,27
Jaspurr,illidan,1574,druid,feral,60,33,27
Elgatomarica,ragnaros,1573,druid,feral,66,33,33
Skyde,sargeras,1571,druid,feral,93,42,51
Nikola,dreadmaul,1566,druid,feral,63,30,33
Koochii,tichondrius,1565,druid,feral,45,23,22
Luvgames,area-52,1559,druid,feral,112,55,57
Kdrumania,tichondrius,1552,druid,feral,269,140,129
Swindlestan,zuljin,1548,druid,feral,97,49,48
Darkombra,frostmourne,1548,druid,feral,58,29,29
Goldferal,illidan,1545,druid,feral,48,31,17
Kaisuckslol,stormrage,1543,druid,feral,150,76,74
Yobibit,terenas,1542,druid,feral,66,29,37
Franksuba,windrunner,1541,druid,feral,126,61,65
Doblun,nemesis,1540,druid,feral,48,18,30
Rahxay,quelthalas,1539,druid,feral,71,32,39
Jonio,tichondrius,1539,druid,feral,71,30,41
Surmise,tichondrius,1535,druid,feral,107,66,41
Delorík,illidan,1534,druid,feral,66,32,34
Theømega,stormrage,1532,druid,feral,36,20,16
Waggs,illidan,1532,druid,feral,36,16,20
Lïberty,ragnaros,1528,druid,feral,30,20,10
Cawkaw,frostwolf,1528,druid,feral,122,62,60
Welshblack,tichondrius,1528,druid,feral,40,18,22
Dimsump,zuljin,1527,druid,feral,66,22,44
Féràlgøðx,sargeras,1526,druid,feral,24,16,8
Galind,rexxar,1524,druid,feral,40,26,14
Senex,stormrage,1518,druid,feral,100,60,40
Dobromar,quelthalas,1517,druid,feral,64,34,30
Malfurionsto,moon-guard,1517,druid,feral,79,34,45
Fugekî,zuljin,1514,druid,feral,89,52,37
Sugarbawls,area-52,1514,druid,feral,108,52,56
Sïmba,andorhal,1514,druid,feral,101,40,61
Pretzle,kelthuzad,1514,druid,feral,95,37,58
Kwilli,tichondrius,1513,druid,feral,108,54,54
Cätwälk,gnomeregan,1511,druid,feral,36,16,20
Swolareclips,eitrigg,1508,druid,feral,191,93,98
Sheeyts,tichondrius,1507,druid,feral,96,51,45
Getahfix,frostmourne,1507,druid,feral,48,20,28
Csagan,spirestone,1506,druid,feral,72,38,34
Gregondor,skullcrusher,1506,druid,feral,48,24,24
Shmayba,malganis,1504,druid,feral,30,16,14
Lucky,destromath,1504,druid,feral,204,94,110
Wildwhisper,moon-guard,1504,druid,feral,72,32,40
Koducck,tichondrius,1502,druid,feral,60,32,28
Kushtiger,ragnaros,1502,druid,feral,105,53,52
Barnedruid,stormreaver,1500,druid,feral,36,18,18
Hööper,illidan,1500,druid,feral,96,43,53
Fastcat,moon-guard,1499,druid,feral,100,53,47
Tree,lothar,1497,druid,feral,48,29,19
Snowfaerie,moon-guard,1497,druid,feral,446,236,210
Houseboat,hellscream,1496,druid,feral,66,23,43
Jurasico,ragnaros,1494,druid,feral,348,176,172
Shiftalk,nerzhul,1491,druid,feral,95,47,48
Gnairda,sargeras,1490,druid,feral,222,118,104
Ozex,crushridge,1490,druid,feral,88,39,49
Dababÿ,frostmourne,1489,druid,feral,41,23,18
Nightshift,dalvengyr,1486,druid,feral,42,22,20
Blêêd,stormscale,1484,druid,feral,31,22,9
Azakana,sargeras,1484,druid,feral,29,17,12
Luluid,tichondrius,1481,druid,feral,65,30,35
Nomnomnomn,chogall,1480,druid,feral,28,18,10
Flufball,whisperwind,1480,druid,feral,66,35,31
Revcow,malganis,1477,druid,feral,48,24,24
Dillywadz,tichondrius,1476,druid,feral,229,108,121
Duckystryker,tichondrius,1470,druid,feral,54,21,33
Amanardra,wyrmrest-accord,1468,druid,feral,36,21,15
Sharknado,haomarush,1465,druid,feral,41,18,23
Andaror,azralon,1464,druid,feral,42,20,22
Duuj,illidan,1462,druid,feral,30,22,8
Zivak,azshara,1460,druid,feral,66,32,34
Hoffhoff,area-52,1458,druid,feral,36,22,14
Chitára,ragnaros,1455,druid,feral,172,90,82
Badferal,blackhand,1455,druid,feral,78,38,40
Erwelz,quelthalas,1455,druid,feral,41,19,22
Bullcritzz,saurfang,1453,druid,feral,118,66,52
Freinnar,kiljaeden,1453,druid,feral,84,40,44
Hellodan,proudmoore,1451,druid,feral,78,33,45
Catahmine,thrall,1450,druid,feral,44,20,24
Prowli,tichondrius,1449,druid,feral,158,82,76
Lunarboy,tichondrius,1448,druid,feral,55,24,31
Bossdru,sargeras,1447,druid,feral,47,28,19
Kongquest,emerald-dream,1445,druid,feral,71,28,43
Chomperz,tichondrius,1442,druid,feral,85,45,40
Vaniedron,zuljin,1442,druid,feral,132,56,76
Wuby,tichondrius,1441,druid,feral,78,38,40
Aldr,tichondrius,1438,druid,feral,62,29,33
Toysruskyd,sargeras,1437,druid,feral,42,17,25
Jayp,thrall,1436,druid,feral,67,28,39
Shiftex,arthas,1434,druid,feral,144,72,72
Mysubrogue,veknilash,1432,druid,feral,24,15,9
Feond,illidan,1430,druid,feral,94,49,45
Bukybuky,tichondrius,1429,druid,feral,48,26,22
Azuredreams,bleeding-hollow,1429,druid,feral,56,28,28
Moonraker,caelestrasz,1427,druid,feral,83,44,39
Azrethyu,emerald-dream,1427,druid,feral,170,75,95
Ikkarus,nemesis,1426,druid,feral,133,67,66
Zulas,thrall,1426,druid,feral,53,21,32
Makonis,tichondrius,1424,druid,feral,36,20,16
Hoppus,icecrown,1423,druid,feral,99,42,57
Kaissara,nemesis,1420,druid,feral,32,17,15
Bobmarli,kiljaeden,1420,druid,feral,30,15,15
Niwßor,azralon,1419,druid,feral,107,55,52
Oobuck,kilrogg,1415,druid,feral,54,29,25
Treespec,stormrage,1414,druid,feral,29,18,11
Sloom,zuljin,1414,druid,feral,131,63,68
Gairen,the-venture-co,1413,druid,feral,48,25,23
Neetform,zuljin,1413,druid,feral,65,30,35
Chambz,tichondrius,1412,druid,feral,151,79,72
Silvshifter,frostmourne,1410,druid,feral,47,32,15
Muwudred,stormrage,1410,druid,feral,36,15,21
Clarice,shattered-halls,1409,druid,feral,24,15,9
Eletto,stormrage,1409,druid,feral,54,26,28
Oreganic,barthilas,1408,druid,feral,99,49,50
Vakimumu,anubarak,1407,druid,feral,68,33,35
Pibily,sargeras,1405,druid,feral,54,17,37
Classydruid,spinebreaker,1404,druid,feral,102,47,55
Shïfty,tichondrius,1403,druid,feral,30,16,14
Bênî,emerald-dream,1402,druid,feral,128,61,67
Frostyshakes,stormrage,1401,druid,feral,182,91,91
Flowke,illidan,1401,druid,feral,32,16,16
Boofings,sargeras,1400,druid,feral,34,19,15
Ðárk,ragnaros,1399,druid,feral,29,15,14
Raynark,azralon,1399,druid,feral,48,21,27
Scratchh,darkspear,1398,druid,feral,90,44,46
Aquahektik,malganis,1398,druid,feral,48,15,33
Gonjatusk,ravencrest,1397,druid,feral,54,30,24
Sweetxtooth,area-52,1397,druid,feral,92,48,44
Clawin,frostmourne,1395,druid,feral,24,15,9
Wabbehkus,barthilas,1394,druid,feral,66,23,43
Chin,ysera,1391,druid,feral,23,15,8
Ytgamezoned,darkspear,1390,druid,feral,30,16,14
Oneinchclaw,malganis,1389,druid,feral,84,41,43
Naturestouch,tichondrius,1388,druid,feral,36,15,21
Treeweed,tichondrius,1386,druid,feral,81,42,39
Hjerim,quelthalas,1386,druid,feral,50,24,26
Traxxo,tichondrius,1384,druid,feral,60,25,35
Darkasto,nemesis,1381,druid,feral,50,21,29
Hroney,area-52,1379,druid,feral,54,22,32
Craak,tichondrius,1376,druid,feral,41,19,22
Carboz,jubeithos,1375,druid,feral,54,26,28
Gotroadrash,azuremyst,1374,druid,feral,41,25,16
Tommyjimmy,andorhal,1374,druid,feral,60,30,30
Käïïjü,tichondrius,1370,druid,feral,94,35,59
Ceo,blackwater-raiders,1366,druid,feral,56,33,23
Herbx,sargeras,1366,druid,feral,60,30,30
Psychofeör,quelthalas,1365,druid,feral,112,54,58
Boll,akama,1361,druid,feral,34,15,19
Dätto,thrall,1357,druid,feral,71,37,34
Roots,anubarak,1357,druid,feral,116,59,57
Iamnature,dalaran,1355,druid,feral,67,30,37
Kotau,azralon,1353,druid,feral,84,55,29
Ðreadfang,tichondrius,1350,druid,feral,59,36,23
Fugg,frostmourne,1350,druid,feral,84,34,50
Fennel,korgath,1346,druid,feral,45,20,25
Darkdragoonz,barthilas,1344,druid,feral,43,20,23
Cntomy,tichondrius,1343,druid,feral,24,14,10
Taiga,moon-guard,1343,druid,feral,24,14,10
Azoth,hyjal,1342,druid,feral,24,14,10
Catzetzan,tichondrius,1342,druid,feral,30,14,16
Druidydruid,blackrock,1342,druid,feral,52,24,28
Threeo,burning-blade,1341,druid,feral,28,18,10
Malu,muradin,1341,druid,feral,58,33,25
Muidruid,thrall,1341,druid,feral,36,17,19
Canlexd,moon-guard,1340,druid,feral,115,53,62
Smeow,zuljin,1339,druid,feral,39,16,23
Samirgodx,tichondrius,1337,druid,feral,36,16,20
Riemannzeta,azgalor,1336,druid,feral,60,32,28
Swornenemy,mugthol,1336,druid,feral,87,45,42
Funkattack,tichondrius,1336,druid,feral,30,14,16
Ribushe,stormrage,1336,druid,feral,60,27,33
Datkittydoe,kiljaeden,1334,druid,feral,55,26,29
Nearkoo,tichondrius,1330,druid,feral,30,14,16
Khyzan,illidan,1329,druid,feral,82,43,39
Freddiemerk,moon-guard,1326,druid,feral,36,21,15
Blut,stormrage,1326,druid,feral,300,142,158
Zuga,the-venture-co,1324,druid,feral,60,31,29
Senorcholo,malganis,1323,druid,feral,60,29,31
Miviaris,alleria,1323,druid,feral,30,14,16
Bullboy,frostmourne,1320,druid,feral,30,17,13
Bleedz,mugthol,1319,druid,feral,36,18,18
Tardcakes,tichondrius,1318,druid,feral,92,44,48
Bloodynine,cairne,1316,druid,feral,30,14,16
Bigthirty,area-52,1315,druid,feral,36,20,16
Bearjoo,kelthuzad,1314,druid,feral,54,26,28
Zazieraiel,moon-guard,1314,druid,feral,159,73,86
Pachacamac,dragonmaw,1314,druid,feral,36,16,20
Ninefeet,argent-dawn,1311,druid,feral,84,43,41
Soupyhooves,dalaran,1311,druid,feral,30,14,16
Servax,illidan,1310,druid,feral,36,17,19
Jasminonmars,zuluhed,1305,druid,feral,65,36,29
Asteriel,stormrage,1305,druid,feral,52,25,27
Hoofin,blackwing-lair,1303,druid,feral,96,39,57
Nyanncat,frostmourne,1302,druid,feral,30,14,16
Nojiling,quelthalas,1301,druid,feral,55,24,31
Amdruid,bloodhoof,1297,druid,feral,26,15,11
Raebies,dalaran,1297,druid,feral,99,53,46
Sahksi,lothar,1297,druid,feral,60,30,30
Mbarakaja,malganis,1297,druid,feral,149,70,79
Furryboyxd,saurfang,1297,druid,feral,39,18,21
Hektuk,barthilas,1296,druid,feral,46,27,19
Anessan,silvermoon,1296,druid,feral,44,23,21
Percefhone,azralon,1296,druid,feral,122,56,66
Gapingloli,tichondrius,1295,druid,feral,51,25,26
Riseagainst,ragnaros,1294,druid,feral,52,30,22
Drbraino,sargeras,1294,druid,feral,36,16,20
Queiq,malganis,1292,druid,feral,30,15,15
Panyot,kiljaeden,1291,druid,feral,66,33,33
Awarz,drakkari,1291,druid,feral,36,14,22
Zelyvia,moon-guard,1283,druid,feral,48,23,25
Erahar,illidan,1281,druid,feral,46,24,22
Beygatti,sargeras,1281,druid,feral,79,36,43
Haneulso,tichondrius,1281,druid,feral,69,31,38
Dkkng,dalaran,1280,druid,feral,40,23,17
Barbary,tichondrius,1279,druid,feral,36,16,20
Bloodriot,wyrmrest-accord,1278,druid,feral,87,40,47
Vintera,sargeras,1277,druid,feral,138,74,64
Cheshiire,moon-guard,1277,druid,feral,167,78,89
Oldclive,frostmourne,1272,druid,feral,50,26,24
Bigmolii,quelthalas,1272,druid,feral,128,54,74
Nahtex,tichondrius,1270,druid,feral,42,19,23
Kilohanno,alexstrasza,1270,druid,feral,54,22,32
Súse,sargeras,1269,druid,feral,71,35,36
Mariko,area-52,1268,druid,feral,71,33,38
Mooseknuccle,tichondrius,1262,druid,feral,43,21,22
Feanah,tichondrius,1259,druid,feral,66,29,37
Rekrasaur,emerald-dream,1259,druid,feral,40,14,26
Midnightmeat,tichondrius,1255,druid,feral,64,31,33
Freeonlyfns,stormrage,1255,druid,feral,38,16,22
Hashmall,ragnaros,1251,druid,feral,42,14,28
Tenedoors,ragnaros,1249,druid,feral,115,45,70
Isalien,stormrage,1247,druid,feral,86,43,43
Malthen,quelthalas,1247,druid,feral,84,39,45
Sporadiclive,sargeras,1247,druid,feral,30,13,17
Fuujinn,korgath,1246,druid,feral,24,13,11
Aahx,thrall,1245,druid,feral,129,69,60
Gorim,area-52,1245,druid,feral,72,34,38
Selendis,tichondrius,1245,druid,feral,30,13,17
Enchiladacat,stormrage,1243,druid,feral,24,13,11
Zderhs,blackrock,1242,druid,feral,35,16,19
Kellydacat,azuremyst,1241,druid,feral,24,13,11
Buhooki,tichondrius,1241,druid,feral,200,105,95
Dorio,quelthalas,1240,druid,feral,36,17,19
Kals,burning-blade,1240,druid,feral,30,13,17
Pfheral,area-52,1240,druid,feral,30,13,17
Kleanxx,tichondrius,1238,druid,feral,226,113,113
Behrhart,stormrage,1234,druid,feral,24,16,8
Ourse,aegwynn,1234,druid,feral,89,52,37
Styli,tichondrius,1234,druid,feral,118,60,58
Stríðsmaður,area-52,1234,druid,feral,90,43,47
Glockitty,tichondrius,1234,druid,feral,114,53,61
Whitetigeris,tichondrius,1233,druid,feral,24,13,11
Pixyls,bleeding-hollow,1233,druid,feral,29,15,14
Critthisbruh,stormrage,1232,druid,feral,75,44,31
Hobbles,emerald-dream,1232,druid,feral,42,18,24
Munchausens,dalaran,1232,druid,feral,54,19,35
Aleksandér,ragnaros,1230,druid,feral,36,15,21
Duckieheit,sargeras,1229,druid,feral,34,15,19
Matpd,norgannon,1228,druid,feral,66,28,38
Orthognathic,emerald-dream,1227,druid,feral,57,35,22
Corv,drenden,1226,druid,feral,22,14,8
Bâgheera,sargeras,1225,druid,feral,61,25,36
Xanbàr,hyjal,1222,druid,feral,35,22,13
Twistach,quelthalas,1222,druid,feral,24,13,11
Zolíath,tichondrius,1221,druid,feral,36,13,23
Swappy,korgath,1220,druid,feral,69,31,38
Zelazia,area-52,1219,druid,feral,30,16,14
Udderchaos,dark-iron,1218,druid,feral,30,13,17
Berd,whisperwind,1216,druid,feral,52,26,26
Beargodx,stormrage,1215,druid,feral,84,43,41
Midnitex,illidan,1214,druid,feral,37,16,21
Maimsy,blackhand,1211,druid,feral,44,23,21
Hctibrehtom,illidan,1210,druid,feral,30,23,7
Aeonás,tichondrius,1210,druid,feral,37,18,19
Pusswhisperr,bleeding-hollow,1210,druid,feral,42,15,27
Hermbott,proudmoore,1206,druid,feral,60,29,31
Xdkittyrawr,tichondrius,1202,druid,feral,111,56,55
Hadox,azralon,1200,druid,feral,157,77,80
Spinach,moon-guard,1195,druid,feral,33,13,20
Ðrengr,quelthalas,1193,druid,feral,36,20,16
Sosd,kelthuzad,1189,druid,feral,32,17,15
Destrez,ragnaros,1188,druid,feral,27,13,14
Leight,whisperwind,1187,druid,feral,54,31,23
Hupod,proudmoore,1181,druid,feral,64,32,32
Sansao,sargeras,1179,druid,feral,42,21,21
Ursuur,drakkari,1178,druid,feral,86,38,48
Empathz,emerald-dream,1173,druid,feral,35,13,22
Khione,dreadmaul,1172,druid,feral,68,38,30
Dehltax,stormrage,1169,druid,feral,54,29,25
Cooln,bleeding-hollow,1168,druid,feral,30,19,11
Kittyboiz,illidan,1164,druid,feral,77,34,43
Scruffywolf,tichondrius,1157,druid,feral,161,70,91
Borybuilder,azralon,1153,druid,feral,52,22,30
Kistormx,tichondrius,1152,druid,feral,18,12,6
Sooey,wyrmrest-accord,1151,druid,feral,24,12,12
Kiwidru,frostmourne,1150,druid,feral,24,12,12
Manbeartree,malganis,1150,druid,feral,36,12,24
Yukcyducky,tichondrius,1148,druid,feral,114,48,66
Anaru,sisters-of-elune,1147,druid,feral,30,12,18
Concordya,tichondrius,1146,druid,feral,30,13,17
Werebruin,bleeding-hollow,1145,druid,feral,79,40,39
Vineclaw,emerald-dream,1144,druid,feral,42,17,25
Moonshady,zuljin,1142,druid,feral,25,12,13
Anastasyiar,illidan,1142,druid,feral,30,12,18
Ÿùp,tichondrius,1141,druid,feral,18,12,6
Infected,jubeithos,1141,druid,feral,28,13,15
Doubledówn,sargeras,1139,druid,feral,228,117,111
Saelyle,illidan,1138,druid,feral,100,42,58
Daniin,azralon,1137,druid,feral,78,36,42
Khaoticklaw,stormrage,1137,druid,feral,33,14,19
Skufty,illidan,1136,druid,feral,162,72,90
Aligantor,thrall,1134,druid,feral,18,12,6
Deadlykept,ragnaros,1134,druid,feral,66,33,33
Chëësëbürgër,illidan,1130,druid,feral,109,51,58
Kyrona,frostmourne,1129,druid,feral,60,33,27
Berall,bleeding-hollow,1128,druid,feral,18,12,6
Elunaya,illidan,1122,druid,feral,36,15,21
Tonoshapepai,azralon,1122,druid,feral,36,13,23
Shahahrazad,queldorei,1118,druid,feral,36,12,24
Strikinina,azralon,1117,druid,feral,79,36,43
Snugglin,kelthuzad,1116,druid,feral,48,22,26
Chernobiel,stormrage,1116,druid,feral,74,24,50
Eyzie,stormrage,1115,druid,feral,36,13,23
Nätural,bloodhoof,1113,druid,feral,23,12,11
Reallysauce,zuljin,1112,druid,feral,42,25,17
Cwonzocat,moon-guard,1110,druid,feral,22,13,9
Ðementia,stormrage,1109,druid,feral,126,68,58
Wwf,thrall,1104,druid,feral,107,42,65
Afrogx,dalaran,1103,druid,feral,30,14,16
Yobolsun,sargeras,1103,druid,feral,48,21,27
Ishiftalot,bleeding-hollow,1096,druid,feral,69,27,42
Tastelikecat,kelthuzad,1093,druid,feral,45,17,28
Druski,lightbringer,1089,druid,feral,23,14,9
Wildbeasts,proudmoore,1088,druid,feral,243,124,119
Twigz,illidan,1087,druid,feral,160,81,79
Kragma,zuluhed,1085,druid,feral,24,13,11
Daisyôreo,tichondrius,1080,druid,feral,76,38,38
Bernoboy,kelthuzad,1079,druid,feral,30,16,14
Momoxchan,quelthalas,1078,druid,feral,28,12,16
Skrillin,thrall,1076,druid,feral,35,19,16
Looquitaa,ragnaros,1074,druid,feral,138,63,75
Trevvor,thrall,1070,druid,feral,36,12,24
Kaya,hyjal,1069,druid,feral,72,22,50
Anarad,dalaran,1068,druid,feral,42,22,20
Pokémon,grizzly-hills,1064,druid,feral,33,15,18
Seraphim,lightnings-blade,1061,druid,feral,78,40,38
Mordrynn,veknilash,1059,druid,feral,62,32,30
Damnimal,caelestrasz,1058,druid,feral,22,13,9
Drdanknugs,laughing-skull,1057,druid,feral,54,16,38
Glenn,norgannon,1056,druid,feral,18,11,7
Birdy,proudmoore,1056,druid,feral,18,11,7
Switchform,kiljaeden,1056,druid,feral,18,11,7
Hatergodx,ravencrest,1056,druid,feral,24,11,13
Dangersweg,frostmourne,1056,druid,feral,30,11,19
Zoeishyper,sargeras,1055,druid,feral,24,11,13
Melonhole,darkspear,1055,druid,feral,24,11,13
Orekinya,area-52,1055,druid,feral,24,11,13
Dawsonxo,proudmoore,1055,druid,feral,24,11,13
Kellydabear,azuremyst,1054,druid,feral,24,11,13
Bearlyviable,stormrage,1054,druid,feral,33,12,21
Myeow,illidan,1052,druid,feral,24,11,13
Teddybear,medivh,1052,druid,feral,101,44,57
Pawsom,bleeding-hollow,1051,druid,feral,18,11,7
Klypz,tichondrius,1049,druid,feral,18,11,7
Nyla,nemesis,1048,druid,feral,12,11,1
Vykarux,suramar,1048,druid,feral,24,11,13
Yám,tichondrius,1048,druid,feral,30,11,19
Téddybéar,smolderthorn,1046,druid,feral,45,28,17
Fieryferal,kargath,1046,druid,feral,42,12,30
Moozdormu,stormrage,1042,druid,feral,32,13,19
Bananawaffle,proudmoore,1042,druid,feral,30,11,19
Dròódles,barthilas,1035,druid,feral,18,11,7
Jabiso,smolderthorn,1034,druid,feral,79,41,38
Oxvxo,senjin,1033,druid,feral,42,25,17
Dalinaìr,moon-guard,1033,druid,feral,24,13,11
Liktak,perenolde,1031,druid,feral,32,12,20
Hótlife,fizzcrank,1029,druid,feral,24,11,13
Meowzedon,sargeras,1029,druid,feral,24,11,13
Kayday,bloodscalp,1027,druid,feral,18,11,7
Greasemonkey,trollbane,1024,druid,feral,28,18,10
Zadayos,aerie-peak,1022,druid,feral,27,11,16
Screwdrivers,moon-guard,1022,druid,feral,29,11,18
Mojofoshobro,moonrunner,1017,druid,feral,72,29,43
Lyndonww,frostmourne,1016,druid,feral,32,13,19
Bifë,ragnaros,1010,druid,feral,48,14,34
Sisilo,bonechewer,1005,druid,feral,115,52,63
Gece,dalaran,1005,druid,feral,41,17,24
Superwrath,khaz-modan,1000,druid,feral,23,11,12
Ethernal,burning-blade,999,druid,feral,36,13,23
Brurion,dalaran,998,druid,feral,48,22,26
Ruzkit,illidan,996,druid,feral,30,14,16
Alagorn,zangarmarsh,990,druid,feral,72,27,45
Zurker,mannoroth,989,druid,feral,79,34,45
Tt,akama,989,druid,feral,26,11,15
Pearci,shattered-hand,988,druid,feral,30,13,17
Druidsling,mugthol,988,druid,feral,70,28,42
Lelobull,ragnaros,987,druid,feral,60,23,37
Ediiann,cenarius,986,druid,feral,24,11,13
Tolldruid,chogall,977,druid,feral,36,18,18
Treepiss,tichondrius,972,druid,feral,30,12,18
Mavren,uldaman,969,druid,feral,36,16,20
Semveta,alleria,960,druid,feral,12,10,2
Sweetpurple,elune,960,druid,feral,18,10,8
Buffjungle,tichondrius,960,druid,feral,26,10,16
Juiceonlips,sargeras,959,druid,feral,18,10,8
Rotclaws,stormrage,959,druid,feral,18,10,8
Yaboidakota,stormrage,959,druid,feral,24,10,14
Kekepop,emerald-dream,959,druid,feral,24,10,14
Whittlekitty,anetheron,959,druid,feral,24,10,14
Venomsecho,vashj,959,druid,feral,24,10,14
Rairven,stormrage,957,druid,feral,18,10,8
Noet,ragnaros,957,druid,feral,18,10,8
Pavel,aerie-peak,957,druid,feral,59,18,41
Predatõr,malorne,956,druid,feral,35,17,18
Shiftingdean,sargeras,956,druid,feral,30,10,20
Framko,quelthalas,956,druid,feral,84,25,59
Hoargar,senjin,955,druid,feral,18,12,6
Høruss,azralon,955,druid,feral,27,11,16
Pàntera,tichondrius,955,druid,feral,36,10,26
Moonbow,frostmourne,954,druid,feral,18,10,8
Yseraspawn,kelthuzad,954,druid,feral,30,10,20
Ramshackle,ursin,953,druid,feral,18,10,8
Stalfrus,area-52,952,druid,feral,12,10,2
Aladelryth,malfurion,951,druid,feral,24,10,14
Thegrefgx,ragnaros,949,druid,feral,18,10,8
Xform,jubeithos,946,druid,feral,18,10,8
Bullshiftin,area-52,945,druid,feral,18,10,8
Nokther,muradin,941,druid,feral,48,13,35
Darkemberrs,stormrage,939,druid,feral,48,11,37
Feraluwu,illidan,938,druid,feral,18,10,8
Ganodo,malganis,938,druid,feral,24,10,14
Lusk,blades-edge,937,druid,feral,70,32,38
Dinnerbone,echo-isles,926,druid,feral,24,10,14
Arntu,malganis,924,druid,feral,17,10,7
Soldadito,zuljin,924,druid,feral,27,12,15
Ekkoh,sargeras,921,druid,feral,29,10,19
Eglania,stormrage,920,druid,feral,42,22,20
Lacrarola,nemesis,916,druid,feral,17,10,7
Odesellena,moon-guard,910,druid,feral,60,29,31
Àspên,moon-guard,908,druid,feral,42,20,22
Pawprika,tichondrius,908,druid,feral,105,45,60
Muggsy,scilla,893,druid,feral,14,10,4
Sjana,bleeding-hollow,893,druid,feral,36,17,19
Chiknsketti,bleeding-hollow,892,druid,feral,26,10,16
Koag,dalaran,891,druid,feral,29,13,16
Disdeus,bleeding-hollow,887,druid,feral,37,11,26
Garuharken,skullcrusher,886,druid,feral,36,10,26
Rum,the-venture-co,885,druid,feral,42,18,24
Vácagada,ragnaros,885,druid,feral,30,10,20
Flenser,frostmane,882,druid,feral,40,18,22
Taurenaught,aegwynn,881,druid,feral,37,17,20
Syänn,thrall,880,druid,feral,48,20,28
Bigherbo,zuljin,872,druid,feral,26,11,15
Wuarlo,moon-guard,865,druid,feral,109,52,57
Jaegerbombx,sargeras,864,druid,feral,18,9,9
Uag,emerald-dream,864,druid,feral,18,9,9
Scuffedx,tichondrius,864,druid,feral,18,9,9
Thaddeusx,illidan,864,druid,feral,22,10,12
Snowlion,the-forgotten-coast,864,druid,feral,36,14,22
Faithxo,stormrage,864,druid,feral,24,9,15
Gz,icecrown,863,druid,feral,18,9,9
Zoehange,frostmourne,863,druid,feral,18,9,9
Féèd,stormrage,863,druid,feral,18,9,9
Tostaø,ragnaros,863,druid,feral,18,9,9
Parallax,shadowsong,863,druid,feral,18,9,9
Thaherb,korgath,863,druid,feral,24,9,15
Lunchßox,emerald-dream,862,druid,feral,12,9,3
Purplecat,frostmourne,862,druid,feral,12,9,3
Morphes,suramar,862,druid,feral,18,9,9
Torilisather,ragnaros,862,druid,feral,18,9,9
Hotsoncrak,tichondrius,862,druid,feral,24,9,15
Orizane,moon-guard,862,druid,feral,24,9,15
Fullmoon,greymane,862,druid,feral,28,10,18
Mogleyz,stormreaver,862,druid,feral,26,9,17
Fanaror,frostmourne,861,druid,feral,79,39,40
Izaràk,frostmourne,861,druid,feral,30,9,21
Catten,barthilas,860,druid,feral,12,9,3
Cadburycop,malganis,860,druid,feral,33,10,23
Manlymanman,shandris,859,druid,feral,24,9,15
Shiftyounot,shattered-hand,859,druid,feral,30,9,21
Ruhgen,deathwing,858,druid,feral,26,10,16
Jonoa,nagrand,858,druid,feral,24,9,15
Wokoom,windrunner,855,druid,feral,54,20,34
Bigravioli,ragnaros,854,druid,feral,24,9,15
Irontauren,drakkari,852,druid,feral,30,9,21
Cyder,thrall,851,druid,feral,16,10,6
Zauska,cenarion-circle,851,druid,feral,30,9,21
Drulicious,tichondrius,849,druid,feral,27,13,14
Kurodash,tichondrius,844,druid,feral,24,10,14
Dârkfang,moon-guard,844,druid,feral,47,19,28
Mooncatbear,malganis,831,druid,feral,22,9,13
Fogboom,area-52,830,druid,feral,20,10,10
Slymar,darkspear,828,druid,feral,18,9,9
Gorlammi,illidan,828,druid,feral,23,9,14
Dreamfyre,kiljaeden,828,druid,feral,29,9,20
Shartasm,anetheron,822,druid,feral,30,12,18
Tatiannaa,stormreaver,815,druid,feral,15,10,5
Khiefceef,sargeras,815,druid,feral,17,9,8
Importedalc,zuljin,813,druid,feral,35,11,24
Feorelm,proudmoore,810,druid,feral,17,9,8
Nephdruid,stormrage,804,druid,feral,30,9,21
Ðjangø,goldrinn,801,druid,feral,17,9,8
Kittyperry,kelthuzad,800,druid,feral,28,9,19
Kuzigothigh,thunderhorn,795,druid,feral,53,27,26
Capson,darkspear,786,druid,feral,54,20,34
Weezydende,area-52,779,druid,feral,65,21,44
Niocin,daggerspine,771,druid,feral,30,10,20
Griefs,emerald-dream,768,druid,feral,12,8,4
Cfab,tichondrius,768,druid,feral,12,8,4
Jason,vashj,768,druid,feral,12,8,4
Anìmorph,sargeras,768,druid,feral,12,8,4
Sweetnippies,elune,768,druid,feral,12,8,4
Kattles,frostmourne,768,druid,feral,12,8,4
Facegotrake,stormrage,768,druid,feral,12,8,4
Férállgødx,area-52,768,druid,feral,18,8,10
Sknrd,stormrage,768,druid,feral,18,8,10
Bitenscratch,tichondrius,768,druid,feral,18,8,10
Salemgomeow,sargeras,768,druid,feral,18,8,10
Owd,tichondrius,768,druid,feral,18,8,10
Gouzz,frostmourne,768,druid,feral,24,8,16
Sylvaster,stormrage,768,druid,feral,24,8,16
Germainee,shandris,768,druid,feral,24,8,16
Saltydru,illidan,768,druid,feral,24,8,16
Pokeyouryolk,sargeras,767,druid,feral,12,8,4
Ostley,moon-guard,767,druid,feral,12,8,4
Jentzull,tichondrius,767,druid,feral,12,8,4
Nahelae,tichondrius,767,druid,feral,12,8,4
Güar,area-52,767,druid,feral,12,8,4
Softshirtxo,ragnaros,767,druid,feral,18,8,10
Mythienair,stormrage,767,druid,feral,18,8,10
Kìttykat,stormrage,767,druid,feral,18,8,10
Zascat,malganis,767,druid,feral,18,8,10
Lazypaw,malganis,767,druid,feral,18,8,10
Pergutory,frostmourne,767,druid,feral,18,8,10
Bufusala,illidan,766,druid,feral,12,8,4
Jpnerazim,quelthalas,766,druid,feral,16,8,8
Angulus,darkspear,766,druid,feral,18,8,10
Meõw,tichondrius,766,druid,feral,18,8,10
Jumpjumpcat,tichondrius,766,druid,feral,21,9,12
Grumalzi,moon-guard,766,druid,feral,24,8,16
Notoriouzßig,sargeras,765,druid,feral,18,8,10
Zxtreme,tichondrius,765,druid,feral,24,8,16
Deaddpool,ragnaros,764,druid,feral,12,8,4
Ardelix,emerald-dream,764,druid,feral,15,9,6
Zimah,illidan,764,druid,feral,18,8,10
Davinchii,drakkari,764,druid,feral,18,8,10
Raknary,kelthuzad,764,druid,feral,30,8,22
Goorybud,tichondrius,762,druid,feral,12,8,4
Bebechat,area-52,762,druid,feral,12,8,4
Feralicious,hyjal,760,druid,feral,12,8,4
Isleyy,tichondrius,760,druid,feral,18,8,10
Gamble,the-underbog,760,druid,feral,24,8,16
Yokimo,amanthul,759,druid,feral,24,8,16
Zzkitty,stormreaver,759,druid,feral,24,8,16
Mychi,ragnaros,748,druid,feral,20,9,11
Nodraent,quelthalas,741,druid,feral,18,8,10
Ashmila,ragnaros,716,druid,feral,17,8,9
Notinsanity,proudmoore,714,druid,feral,20,9,11
Chucknöürish,dalaran,712,druid,feral,29,9,20
Mazoak,sargeras,703,druid,feral,28,8,20
Qtfurrylol,zuljin,703,druid,feral,35,9,26
Byson,bleeding-hollow,702,druid,feral,17,8,9
Amoru,moon-guard,699,druid,feral,16,8,8
Bigdeeza,frostmourne,698,druid,feral,25,10,15
Psynix,zuljin,688,druid,feral,19,8,11
Earlgrayl,kelthuzad,686,druid,feral,19,8,11
Shakedru,stormrage,684,druid,feral,19,8,11
Shalaz,magtheridon,672,druid,feral,12,7,5
Austínd,sargeras,672,druid,feral,12,7,5
Hypê,tichondrius,672,druid,feral,12,7,5
Tnvï,stormrage,672,druid,feral,12,7,5
Krobz,bleeding-hollow,672,druid,feral,12,7,5
Primalxd,area-52,672,druid,feral,12,7,5
Catculator,tichondrius,672,druid,feral,12,7,5
Dangerclaws,area-52,672,druid,feral,12,7,5
Elyveen,proudmoore,672,druid,feral,12,7,5
Extacy,ragnaros,672,druid,feral,12,7,5
Zðzð,zuljin,672,druid,feral,12,7,5
Isô,sargeras,672,druid,feral,12,7,5
Muffbfloppn,zuljin,672,druid,feral,18,7,11
Mommyshårk,tichondrius,672,druid,feral,18,7,11
Druidman,mugthol,672,druid,feral,18,7,11
Ronin,arthas,672,druid,feral,18,7,11
Dailydruid,illidan,672,druid,feral,18,7,11
Meowny,area-52,672,druid,feral,18,7,11
Islayne,moon-guard,672,druid,feral,18,7,11
Psyraxus,moon-guard,672,druid,feral,18,7,11
Caelüm,area-52,672,druid,feral,24,7,17
Pawblems,sargeras,671,druid,feral,12,7,5
Raeize,stormrage,671,druid,feral,12,7,5
Hallthrok,stormrage,671,druid,feral,12,7,5
Sneekykitty,malygos,671,druid,feral,12,7,5
Drywatter,tichondrius,671,druid,feral,12,7,5
Happyhotter,proudmoore,671,druid,feral,12,7,5
Fürïous,tichondrius,671,druid,feral,15,8,7
Zalmo,area-52,671,druid,feral,15,8,7
Zallo,korgath,671,druid,feral,18,7,11
Yuandi,tichondrius,671,druid,feral,18,7,11
Marathel,wyrmrest-accord,671,druid,feral,18,7,11
Ruckiz,stormrage,671,druid,feral,18,7,11
Corym,frostmourne,671,druid,feral,18,7,11
Ännä,moon-guard,671,druid,feral,18,7,11
Bearmuda,trollbane,671,druid,feral,18,7,11
Crendorides,bleeding-hollow,671,druid,feral,24,7,17
Wingus,smolderthorn,670,druid,feral,12,7,5
Chaace,proudmoore,670,druid,feral,12,7,5
Moçamba,azralon,670,druid,feral,24,7,17
Curainfeliz,nemesis,669,druid,feral,12,7,5
Bocát,stormrage,669,druid,feral,12,7,5
Nanassa,spinebreaker,669,druid,feral,18,7,11
Redness,daggerspine,669,druid,feral,18,7,11
Ewok,vashj,669,druid,feral,24,7,17
Mawnster,drenden,668,druid,feral,15,8,7
Zeldriss,arthas,668,druid,feral,19,7,12
Igneël,ragnaros,668,druid,feral,24,7,17
Jordiët,dalaran,667,druid,feral,12,7,5
Bàkari,stormrage,666,druid,feral,12,7,5
Healorhell,azralon,660,druid,feral,40,7,33
Vämps,area-52,658,druid,feral,12,7,5
Rhaines,moon-guard,656,druid,feral,24,7,17
Hyperlite,bonechewer,643,druid,feral,18,7,11
Injail,tichondrius,640,druid,feral,16,7,9
Chadwickx,illidan,639,druid,feral,11,7,4
Jeanz,bonechewer,632,druid,feral,19,9,10
Slapymilf,dentarg,623,druid,feral,11,7,4
Meowzetzan,tichondrius,623,druid,feral,11,7,4
Shyn,goldrinn,623,druid,feral,21,7,14
Puzzykat,uldum,621,druid,feral,27,7,20
Gutzzu,area-52,619,druid,feral,15,7,8
Weedleaf,wyrmrest-accord,610,druid,feral,20,8,12
Bigfloofy,frostmourne,606,druid,feral,11,7,4
Beaker,uldum,605,druid,feral,11,7,4
Honoriodruid,nemesis,576,druid,feral,12,6,6
Alyxsandr,dalaran,576,druid,feral,12,6,6
Wilddeity,tichondrius,576,druid,feral,12,6,6
Nelfwaifú,area-52,576,druid,feral,12,6,6
Parabear,area-52,576,druid,feral,12,6,6
Spaléxgu,azralon,576,druid,feral,12,6,6
Thontt,sargeras,576,druid,feral,12,6,6
Hybridxo,kelthuzad,576,druid,feral,12,6,6
Trottystwin,emerald-dream,576,druid,feral,12,6,6
Lilrichdps,sargeras,576,druid,feral,12,6,6
Ogversaucey,skullcrusher,576,druid,feral,12,6,6
Kurokyy,frostmourne,576,druid,feral,12,6,6
Bootayclappa,sargeras,576,druid,feral,12,6,6
Hotmomlover,malganis,576,druid,feral,12,6,6
Cíphenz,illidan,576,druid,feral,12,6,6
Bables,tichondrius,576,druid,feral,12,6,6
Rezin,barthilas,576,druid,feral,12,6,6
Daniverse,sargeras,576,druid,feral,12,6,6
Tailzy,tichondrius,576,druid,feral,12,6,6
Grimtreeper,illidan,576,druid,feral,12,6,6
Kittysnuggle,emerald-dream,576,druid,feral,15,7,8
Jinhova,stormrage,576,druid,feral,15,6,9
Rebrrth,antonidas,576,druid,feral,18,6,12
Mameseph,lightnings-blade,576,druid,feral,18,6,12
Emotionally,illidan,576,druid,feral,18,6,12
Haohomie,tichondrius,576,druid,feral,18,6,12
Kobebeef,malganis,576,druid,feral,24,6,18
Clamchaddy,tichondrius,576,druid,feral,24,6,18
Zazishi,zuljin,575,druid,feral,6,6,0
Tyriall,darkspear,575,druid,feral,12,6,6
Wulfjack,emerald-dream,575,druid,feral,12,6,6
Omnilul,zuljin,575,druid,feral,12,6,6
Chupaone,dalaran,575,druid,feral,12,6,6
Allenjunior,ragnaros,575,druid,feral,12,6,6
Austîn,moon-guard,575,druid,feral,12,6,6
Eliteshift,frostmourne,575,druid,feral,12,6,6
Yesqt,dalaran,575,druid,feral,12,6,6
Fireeloot,tichondrius,575,druid,feral,12,6,6
Druishcat,dark-iron,575,druid,feral,12,6,6
Bästakatten,tichondrius,575,druid,feral,15,7,8
Peppapig,mugthol,575,druid,feral,18,6,12
Strixferal,zuljin,575,druid,feral,18,6,12
Gush,echo-isles,575,druid,feral,18,6,12
Thorñ,cenarius,575,druid,feral,18,6,12
Ursoc,muradin,575,druid,feral,18,6,12
Volbourn,amanthul,575,druid,feral,24,6,18
Blackmoose,lethon,574,druid,feral,12,6,6
Beelzehog,whisperwind,574,druid,feral,12,6,6
Greemer,sargeras,574,druid,feral,18,6,12
Swánn,firetree,574,druid,feral,18,6,12
Droodkat,feathermoon,574,druid,feral,30,6,24
Imass,draka,573,druid,feral,18,6,12
Nikozho,sargeras,573,druid,feral,18,6,12
Udala,durotan,572,druid,feral,14,6,8
Meemow,frostmourne,572,druid,feral,18,6,12
Voju,wildhammer,572,druid,feral,36,6,30
Drewiid,stormrage,571,druid,feral,18,6,12
Eclipse,tichondrius,571,druid,feral,24,6,18
Expells,nemesis,569,druid,feral,18,6,12
Rawrii,nemesis,567,druid,feral,12,6,6
Ssimbaa,area-52,563,druid,feral,18,6,12
Oxentoes,sargeras,559,druid,feral,17,7,10
Dullbozer,thrall,543,druid,feral,11,6,5
Druidcyber,stormrage,543,druid,feral,16,6,10
Lémons,tichondrius,542,druid,feral,17,6,11
Wtfimacat,area-52,527,druid,feral,11,6,5
Fernés,proudmoore,526,druid,feral,11,6,5
Wierdosaur,azralon,524,druid,feral,15,6,9
Ripx,khadgar,522,druid,feral,16,7,9
Kajla,sargeras,521,druid,feral,22,7,15
Shadalor,frostmourne,512,druid,feral,16,6,10
Ashvir,wyrmrest-accord,511,druid,feral,11,6,5
Cokanebear,garrosh,511,druid,feral,14,6,8
Kilbys,nemesis,510,druid,feral,8,6,2
Iamatomic,illidan,509,druid,feral,20,6,14
Worgbearpig,destromath,496,druid,feral,13,6,7
Nbnbnb,proudmoore,480,druid,feral,6,5,1
Gloomcat,illidan,480,druid,feral,6,5,1
Chrøniç,illidan,480,druid,feral,6,5,1
Exxh,tichondrius,480,druid,feral,6,5,1
Bleèd,stormrage,480,druid,feral,6,5,1
Dës,sargeras,480,druid,feral,6,5,1
Idiotdruid,ragnaros,480,druid,feral,6,5,1
Flompstomper,skullcrusher,480,druid,feral,6,5,1
Wallabare,proudmoore,480,druid,feral,6,5,1
Hermes,moon-guard,480,druid,feral,6,5,1
Frenzyirl,darkspear,480,druid,feral,12,5,7
Lemonnz,illidan,480,druid,feral,12,5,7
Meowf,tichondrius,480,druid,feral,12,5,7
Sunmoons,hydraxis,480,druid,feral,12,5,7
Frizzle,onyxia,480,druid,feral,12,5,7
Shiftdeznutz,tichondrius,480,druid,feral,12,5,7
Ferallash,sargeras,480,druid,feral,12,5,7
Lilrichdmg,sargeras,480,druid,feral,12,5,7
Duckseasonn,sargeras,480,druid,feral,12,5,7
Ragingcloner,tichondrius,480,druid,feral,12,5,7
Samuraicat,frostmourne,480,druid,feral,12,5,7
Amadri,malganis,480,druid,feral,12,5,7
Cudlybear,bleeding-hollow,480,druid,feral,12,5,7
Ezconvoke,sargeras,480,druid,feral,12,5,7
Wurow,firetree,480,druid,feral,12,5,7
Feralhearted,kelthuzad,480,druid,feral,12,5,7
Karizikat,tichondrius,480,druid,feral,12,5,7
Cenarius,frostmourne,480,druid,feral,12,5,7
Bloodyugly,area-52,480,druid,feral,12,5,7
Vico,azralon,480,druid,feral,12,5,7
Loamie,proudmoore,480,druid,feral,12,5,7
Choolah,area-52,480,druid,feral,12,5,7
Topangâ,lightninghoof,480,druid,feral,12,5,7
Gunnymad,tichondrius,480,druid,feral,12,5,7
Zululu,dalaran,480,druid,feral,12,5,7
Honeybeam,moon-guard,480,druid,feral,12,5,7
Lurky,dalvengyr,480,druid,feral,12,5,7
Marshanlynch,korgath,480,druid,feral,12,5,7
Veryhighrn,area-52,480,druid,feral,12,5,7
Zeratull,cenarius,480,druid,feral,12,5,7
Scorn,spirestone,480,druid,feral,13,5,8
Fredolay,tichondrius,480,druid,feral,13,5,8
Kurimarlac,stormrage,480,druid,feral,18,5,13
Maplêleaf,moon-guard,480,druid,feral,18,5,13
Oneninesix,frostmourne,480,druid,feral,18,5,13
Purrcat,tichondrius,480,druid,feral,18,5,13
Bere,kul-tiras,480,druid,feral,18,5,13
Funfunfrank,aegwynn,480,druid,feral,18,5,13
Atreis,malganis,480,druid,feral,18,5,13
Lycanjungle,azralon,480,druid,feral,18,5,13
Jaydaprophet,azshara,480,druid,feral,18,5,13
Balthøs,moon-guard,479,druid,feral,12,5,7
Harrystun,hyjal,479,druid,feral,12,5,7
Elsancho,stormreaver,479,druid,feral,12,5,7
Hawthòrn,bloodscalp,479,druid,feral,12,5,7
Animalcade,area-52,479,druid,feral,12,5,7
Nisheon,wyrmrest-accord,479,druid,feral,12,5,7
Omnisyst,burning-blade,479,druid,feral,12,5,7
Tootiebootie,bleeding-hollow,479,druid,feral,12,5,7
Calani,lightnings-blade,479,druid,feral,12,5,7
Icecrackin,bloodscalp,479,druid,feral,12,5,7
Ysemia,drakkari,479,druid,feral,14,5,9
Ymirgore,zuljin,479,druid,feral,18,5,13
Donkeepunch,archimonde,479,druid,feral,18,5,13
Giatafix,whisperwind,479,druid,feral,18,5,13
Ráhilk,quelthalas,479,druid,feral,24,5,19
Bigoldbear,moon-guard,479,druid,feral,24,5,19
Madador,bleeding-hollow,478,druid,feral,12,5,7
Ramso,skullcrusher,478,druid,feral,12,5,7
Ccb,chogall,478,druid,feral,18,5,13
Fbombzz,kalecgos,477,druid,feral,12,5,7
Maaryjo,quelthalas,476,druid,feral,12,5,7
Feralhearted,tichondrius,463,druid,feral,17,5,12
Kogti,malganis,446,druid,feral,10,6,4
Moonrg,stormrage,431,druid,feral,11,5,6
Maplesyrup,moonrunner,431,druid,feral,11,5,6
Bjohns,bleeding-hollow,426,druid,feral,21,6,15
Ninelivez,gorgonnash,426,druid,feral,22,6,16
Veloon,laughing-skull,422,druid,feral,20,7,13
Yunekai,stormrage,415,druid,feral,11,5,6
Vaelthunis,sargeras,400,druid,feral,13,5,8
Ollyy,thrall,384,druid,feral,6,4,2
Xrw,kelthuzad,384,druid,feral,6,4,2
Softkity,area-52,384,druid,feral,6,4,2
Reversflash,emerald-dream,384,druid,feral,6,4,2
Zoomchicken,stormrage,384,druid,feral,6,4,2
Woshiyigede,frostmourne,384,druid,feral,6,4,2
Menapaws,muradin,384,druid,feral,6,4,2
Slackoth,dalaran,384,druid,feral,6,4,2
Pressuretd,frostmourne,384,druid,feral,6,4,2
Coolguyzack,stormscale,384,druid,feral,6,4,2
Acés,shattered-halls,384,druid,feral,6,4,2
Metrobloomin,bloodscalp,384,druid,feral,6,4,2
Rouxel,emerald-dream,384,druid,feral,6,4,2
Moondex,maelstrom,384,druid,feral,6,4,2
Srwow,elune,384,druid,feral,6,4,2
Kaldiel,ysera,384,druid,feral,6,4,2
Titiica,azralon,384,druid,feral,6,4,2
Steamerboi,stormrage,384,druid,feral,6,4,2
Beastkong,dalaran,384,druid,feral,6,4,2
Robomexi,tichondrius,384,druid,feral,6,4,2
Olhosdlua,azralon,384,druid,feral,6,4,2
Cloneyourmom,sargeras,384,druid,feral,6,4,2
Drinkmymoon,darkspear,384,druid,feral,6,4,2
Lharast,stormrage,384,druid,feral,6,4,2
Nâturê,dalaran,384,druid,feral,6,4,2
Bearcathawk,sargeras,384,druid,feral,6,4,2
Metamorfis,malorne,384,druid,feral,6,4,2
Vecuronium,tichondrius,384,druid,feral,6,4,2
Ñòpé,tichondrius,384,druid,feral,6,4,2
Torofarmeon,quelthalas,384,druid,feral,6,4,2
Feltcute,burning-legion,384,druid,feral,6,4,2
Curet,lightbringer,384,druid,feral,6,4,2
Toiiz,malganis,384,druid,feral,9,4,5
Genuine,guldan,384,druid,feral,11,4,7
Moohok,bleeding-hollow,384,druid,feral,12,4,8
Swippxx,tichondrius,384,druid,feral,12,4,8
Freshzk,azralon,384,druid,feral,12,4,8
Iamfynch,sargeras,384,druid,feral,12,4,8
Carlosd,tichondrius,384,druid,feral,12,4,8
Hellabanx,tichondrius,384,druid,feral,12,4,8
Bolthor,wyrmrest-accord,384,druid,feral,12,4,8
Nickarc,illidan,384,druid,feral,12,4,8
Imnotinhuman,tichondrius,384,druid,feral,12,4,8
Yakuho,proudmoore,384,druid,feral,12,4,8
Onewitnature,nordrassil,384,druid,feral,12,4,8
Gernichora,barthilas,384,druid,feral,12,4,8
Sample,dark-iron,384,druid,feral,12,4,8
Acdru,tichondrius,384,druid,feral,12,4,8
Bomani,ragnaros,384,druid,feral,12,4,8
Weeñor,tichondrius,384,druid,feral,12,4,8
Actioncat,emerald-dream,384,druid,feral,12,4,8
Feralgød,tichondrius,384,druid,feral,12,4,8
Carnumoose,zuljin,384,druid,feral,12,4,8
Toetoetoete,darrowmere,384,druid,feral,12,4,8
Elmachina,tichondrius,384,druid,feral,12,4,8
Riec,kiljaeden,384,druid,feral,12,4,8
Windded,area-52,384,druid,feral,12,4,8
Kokujin,proudmoore,384,druid,feral,12,4,8
Timthecatman,frostmourne,384,druid,feral,12,4,8
Auxl,tichondrius,384,druid,feral,12,4,8
Thalvannas,nazjatar,384,druid,feral,12,4,8
Heìrophant,trollbane,384,druid,feral,12,4,8
Alaillais,moon-guard,384,druid,feral,12,4,8
Rêàgøñ,tichondrius,384,druid,feral,12,4,8
Anzoô,illidan,384,druid,feral,12,4,8
Efflence,tichondrius,384,druid,feral,12,4,8
Binjuicex,frostmourne,384,druid,feral,12,4,8
Yakir,kiljaeden,384,druid,feral,12,4,8
Quiziato,burning-legion,384,druid,feral,12,4,8
Dragnformplz,magtheridon,384,druid,feral,12,4,8
Sellîas,senjin,384,druid,feral,12,4,8
Kollective,sargeras,384,druid,feral,12,4,8
Gatona,stormrage,384,druid,feral,12,4,8
Plantdaddy,bladefist,384,druid,feral,12,4,8
Anniehall,stormrage,384,druid,feral,12,4,8
Bënzy,frostmourne,384,druid,feral,12,4,8
Ferril,drenden,384,druid,feral,13,4,9
Naastir,medivh,384,druid,feral,14,4,10
Pereréka,azralon,384,druid,feral,14,4,10
Startalons,area-52,384,druid,feral,18,4,14
Riverthorne,moon-guard,384,druid,feral,18,4,14
Apothe,emerald-dream,384,druid,feral,18,4,14
Colinferal,thrall,384,druid,feral,18,4,14
Bronaarr,nordrassil,384,druid,feral,18,4,14
Nxndruid,tichondrius,384,druid,feral,18,4,14
Pollykush,sargeras,384,druid,feral,18,4,14
Tynyhands,tichondrius,383,druid,feral,6,4,2
Ruwkia,stormrage,383,druid,feral,12,4,8
Mfgs,kelthuzad,383,druid,feral,12,4,8
Gotbleedz,illidan,383,druid,feral,12,4,8
Porrosman,quelthalas,383,druid,feral,12,4,8
Bramth,quelthalas,383,druid,feral,12,4,8
Pröfëct,ragnaros,383,druid,feral,12,4,8
Jamesbailey,sargeras,383,druid,feral,12,4,8
Shoboski,quelthalas,383,druid,feral,12,4,8
Mogli,perenolde,383,druid,feral,30,4,26
Pochaso,cenarius,382,druid,feral,6,4,2
Kaidenn,spirestone,382,druid,feral,6,4,2
Quaektem,bloodhoof,379,druid,feral,12,4,8
Zyila,garithos,367,druid,feral,11,4,7
Eightyhd,ravencrest,351,druid,feral,11,4,7
Rainbowsix,sargeras,347,druid,feral,11,4,7
Moocka,ragnaros,336,druid,feral,9,4,5
Yizhiyuren,aegwynn,330,druid,feral,15,6,9
Defku,quelthalas,330,druid,feral,28,6,22
Bowbaggins,bleeding-hollow,318,druid,feral,10,4,6
Øvernight,azralon,288,druid,feral,6,3,3
Insatiablé,azralon,288,druid,feral,6,3,3
Heretoleaf,tichondrius,288,druid,feral,6,3,3
Itaiipava,azralon,288,druid,feral,6,3,3
Balnara,cenarius,288,druid,feral,6,3,3
Grrayfox,azralon,288,druid,feral,6,3,3
Datlogan,tichondrius,288,druid,feral,6,3,3
Katatafish,azralon,288,druid,feral,6,3,3
Riddickd,malfurion,288,druid,feral,6,3,3
Kíttypunch,bleeding-hollow,288,druid,feral,6,3,3
Robbas,stormrage,288,druid,feral,6,3,3
Kardien,quelthalas,288,druid,feral,6,3,3
Pansensual,archimonde,288,druid,feral,6,3,3
Tigriss,malganis,288,druid,feral,6,3,3
Dairycream,skullcrusher,288,druid,feral,6,3,3
Steakjr,senjin,288,druid,feral,6,3,3
Rootchan,azralon,288,druid,feral,6,3,3
Floridaman,moonrunner,288,druid,feral,6,3,3
Natureswang,bleeding-hollow,288,druid,feral,6,3,3
Hitchslaps,tichondrius,288,druid,feral,6,3,3
Pabag,chogall,288,druid,feral,6,3,3
Woodlly,stormrage,288,druid,feral,6,3,3
Arienne,kelthuzad,288,druid,feral,6,3,3
Mãsk,stormrage,288,druid,feral,6,3,3
Tasselhoof,hyjal,288,druid,feral,6,3,3
Espoir,azuremyst,288,druid,feral,6,3,3
Feraljake,tichondrius,288,druid,feral,6,3,3
Erbirus,proudmoore,288,druid,feral,6,3,3
Frrest,proudmoore,288,druid,feral,6,3,3
Askmeaboutmy,shattered-halls,288,druid,feral,6,3,3
Celetra,kiljaeden,288,druid,feral,6,3,3
Calph,kelthuzad,288,druid,feral,6,3,3
Nahualis,tichondrius,288,druid,feral,6,3,3
Ysero,area-52,288,druid,feral,6,3,3
Hyldru,stormrage,288,druid,feral,6,3,3
Frestydrul,stormrage,288,druid,feral,6,3,3
Posmard,ragnaros,288,druid,feral,6,3,3
Silit,tichondrius,288,druid,feral,6,3,3
Rígél,ragnaros,288,druid,feral,6,3,3
Krishcat,azshara,288,druid,feral,6,3,3
Bubbleshiftz,area-52,288,druid,feral,6,3,3
Taurenasarus,area-52,288,druid,feral,6,3,3
Jungledíff,ragnaros,288,druid,feral,6,3,3
Knauxk,black-dragonflight,288,druid,feral,6,3,3
Ahhpalu,tichondrius,288,druid,feral,6,3,3
Jeperty,tichondrius,288,druid,feral,6,3,3
Ñazary,thrall,288,druid,feral,6,3,3
Cwísp,dalaran,288,druid,feral,6,3,3
Svarun,jubeithos,288,druid,feral,6,3,3
Sarenko,jubeithos,288,druid,feral,6,3,3
Chopleaf,khadgar,288,druid,feral,6,3,3
Opconvoke,illidan,288,druid,feral,6,3,3
Lahgit,frostmourne,288,druid,feral,6,3,3
Sapplox,sargeras,288,druid,feral,6,3,3
Elythria,hellscream,288,druid,feral,6,3,3
Owlcapwn,stormreaver,288,druid,feral,6,3,3
Thecolortwoo,tichondrius,288,druid,feral,6,3,3
Gâlaxy,sargeras,288,druid,feral,6,3,3
Enti,sargeras,288,druid,feral,6,3,3
Mcnerd,sargeras,288,druid,feral,6,3,3
Shredupboo,illidan,288,druid,feral,6,3,3
Bigskeeve,sargeras,288,druid,feral,6,3,3
Purrfact,frostmourne,288,druid,feral,6,3,3
Injeckx,tichondrius,288,druid,feral,6,3,3
Donutdruid,illidan,288,druid,feral,6,3,3
Feronnia,sargeras,288,druid,feral,6,3,3
Octeviia,illidan,288,druid,feral,6,3,3
Bleedinzqt,illidan,288,druid,feral,6,3,3
Dramon,tichondrius,288,druid,feral,6,3,3
Nichodameus,firetree,288,druid,feral,6,3,3
Fancyprance,dalaran,288,druid,feral,6,3,3
Benaveth,moon-guard,288,druid,feral,9,4,5
Barnabie,black-dragonflight,288,druid,feral,10,4,6
Hídde,quelthalas,288,druid,feral,12,3,9
Lilnippy,stormscale,288,druid,feral,12,3,9
Zetlolc,tichondrius,288,druid,feral,12,3,9
Zyrhek,quelthalas,288,druid,feral,12,3,9
Treezymeezy,proudmoore,288,druid,feral,12,3,9
Tchallå,tichondrius,288,druid,feral,12,3,9
Flushi,nagrand,288,druid,feral,12,3,9
Treeguard,emerald-dream,288,druid,feral,12,3,9
Lovemakitty,sargeras,288,druid,feral,12,3,9
Solstice,frostmourne,288,druid,feral,12,3,9
Cattdog,tichondrius,288,druid,feral,12,3,9
Moobees,arthas,288,druid,feral,12,3,9
Pawpaw,terenas,288,druid,feral,12,3,9
Näna,dalaran,288,druid,feral,12,3,9
Neksir,ragnaros,288,druid,feral,12,3,9
Drailyo,ravenholdt,288,druid,feral,12,3,9
Madbuffs,nemesis,288,druid,feral,12,3,9
Vorare,tichondrius,288,druid,feral,12,3,9
Sosorry,blackhand,288,druid,feral,12,3,9
Xanjo,kiljaeden,288,druid,feral,12,3,9
Uniquex,zuljin,288,druid,feral,12,3,9
Rivetrix,azralon,288,druid,feral,12,3,9
Krawnk,zuljin,288,druid,feral,12,3,9
Oo,grizzly-hills,288,druid,feral,12,3,9
Snoww,moonrunner,288,druid,feral,12,3,9
Nighetager,uther,288,druid,feral,12,3,9
Catorcow,aegwynn,288,druid,feral,13,3,10
Denaye,tichondrius,288,druid,feral,18,3,15
Mákeitnasty,tichondrius,288,druid,feral,18,3,15
Èlunë,andorhal,288,druid,feral,18,3,15
Naebliss,arygos,288,druid,feral,18,3,15
Iamthewambo,bloodhoof,288,druid,feral,30,3,27
Extremeshift,dalaran,287,druid,feral,8,4,4
Twoworldz,tichondrius,287,druid,feral,6,3,3
Masilan,kelthuzad,287,druid,feral,6,3,3
Spartanlxl,zuljin,287,druid,feral,12,3,9
Nast,dreadmaul,287,druid,feral,12,3,9
Schwiftea,skullcrusher,287,druid,feral,12,3,9
Absoles,agamaggan,287,druid,feral,12,3,9
Zalledori,thrall,287,druid,feral,12,3,9
Pleomorpher,quelthalas,286,druid,feral,6,3,3
Psychosis,kul-tiras,285,druid,feral,12,3,9
Wardruidkvn,stormreaver,285,druid,feral,12,3,9
Mightymërlin,stormrage,255,druid,feral,11,3,8
Punderful,stormrage,254,druid,feral,10,4,6
Trippykitty,tichondrius,240,druid,feral,9,3,6
Taydollasign,blackrock,239,druid,feral,5,3,2
Yámï,stormrage,239,druid,feral,5,3,2
Orakuru,barthilas,239,druid,feral,11,3,8
Centimoose,area-52,234,druid,feral,7,4,3
Pél,tichondrius,223,druid,feral,14,3,11
Worldly,medivh,223,druid,feral,14,3,11
Feraldudu,illidan,192,druid,feral,4,3,1
Puiltraxs,ragnaros,192,druid,feral,4,3,1
Catmóm,tichondrius,192,druid,feral,6,2,4
Metaldruid,tichondrius,192,druid,feral,6,2,4
Katskratch,sargeras,192,druid,feral,6,2,4
Fulmerethine,emerald-dream,192,druid,feral,6,2,4
Estuvez,twisting-nether,192,druid,feral,6,2,4
Touchmyroot,frostmourne,192,druid,feral,6,2,4
Hännibal,hydraxis,192,druid,feral,6,2,4
Nabious,malganis,192,druid,feral,6,2,4
Centari,tichondrius,192,druid,feral,6,2,4
Lilstuped,tichondrius,192,druid,feral,6,2,4
Kanadae,thrall,192,druid,feral,6,2,4
Wreckked,sargeras,192,druid,feral,6,2,4
Hehaw,kelthuzad,192,druid,feral,6,2,4
Pecopeco,sargeras,192,druid,feral,6,2,4
Kai,spirestone,192,druid,feral,6,2,4
Nakte,area-52,192,druid,feral,6,2,4
Therooster,whisperwind,192,druid,feral,6,2,4
Apace,stonemaul,192,druid,feral,6,2,4
Anudi,whisperwind,192,druid,feral,6,2,4
Tigerbalm,tichondrius,192,druid,feral,6,2,4
Numbkin,stormrage,192,druid,feral,6,2,4
Majdomoterry,proudmoore,192,druid,feral,6,2,4
Dankbite,doomhammer,192,druid,feral,6,2,4
Meaningfully,kelthuzad,192,druid,feral,6,2,4
Àaron,thrall,192,druid,feral,6,2,4
Handolar,quelthalas,192,druid,feral,6,2,4
Driftwood,bonechewer,192,druid,feral,6,2,4
Tilly,malorne,192,druid,feral,6,2,4
Ikova,frostmourne,192,druid,feral,6,2,4
Bullbuddy,wyrmrest-accord,192,druid,feral,6,2,4
Theliono,lightnings-blade,192,druid,feral,6,2,4
Kikothecat,burning-blade,192,druid,feral,6,2,4
Geno,cenarius,192,druid,feral,6,2,4
Kurakai,runetotem,192,druid,feral,6,2,4
Vctrphs,nemesis,192,druid,feral,6,2,4
Tedrithal,moon-guard,192,druid,feral,6,2,4
Apocalyptoe,proudmoore,192,druid,feral,6,2,4
Night,jaedenar,192,druid,feral,6,2,4
Milezy,area-52,192,druid,feral,6,2,4
Theliverklng,sargeras,192,druid,feral,6,2,4
Vivinara,moon-guard,192,druid,feral,6,2,4
Ðjango,goldrinn,192,druid,feral,6,2,4
Selfplay,barthilas,192,druid,feral,6,2,4
Thalerosa,tichondrius,192,druid,feral,6,2,4
Fødaødruida,azralon,192,druid,feral,6,2,4
Evolute,sargeras,192,druid,feral,6,2,4
Barrah,barthilas,192,druid,feral,6,2,4
Buyadoge,area-52,192,druid,feral,6,2,4
Tauretari,tichondrius,192,druid,feral,6,2,4
Aurajin,spinebreaker,192,druid,feral,6,2,4
Lavanca,azralon,192,druid,feral,6,2,4
Slimh,stormrage,192,druid,feral,6,2,4
Yépp,sargeras,192,druid,feral,6,2,4
Lóríen,thrall,192,druid,feral,6,2,4
Eliaris,rivendare,192,druid,feral,6,2,4
Snupy,area-52,192,druid,feral,6,2,4
Athious,moon-guard,192,druid,feral,6,2,4
Augus,hyjal,192,druid,feral,6,2,4
Omgapuddycat,stormrage,192,druid,feral,6,2,4
Taztoc,stormrage,192,druid,feral,6,2,4
Keithmoonkin,area-52,192,druid,feral,6,2,4
Müfasä,azralon,192,druid,feral,6,2,4
Aethorax,hyjal,192,druid,feral,6,2,4
Klawzy,thrall,192,druid,feral,6,2,4
Basichoe,bleeding-hollow,192,druid,feral,6,2,4
Loadie,frostmourne,192,druid,feral,6,2,4
Shinoßi,area-52,192,druid,feral,6,2,4
Kumataku,emerald-dream,192,druid,feral,6,2,4
Pusscat,illidan,192,druid,feral,6,2,4
Robbieshift,emerald-dream,192,druid,feral,6,2,4
Rigotakz,illidan,192,druid,feral,6,2,4
Asmondruud,tichondrius,192,druid,feral,6,2,4
Perlek,bleeding-hollow,192,druid,feral,6,2,4
Laymonath,elune,192,druid,feral,6,2,4
Rizzit,wyrmrest-accord,192,druid,feral,6,2,4
Zevar,bleeding-hollow,192,druid,feral,6,2,4
Mahadevi,moonrunner,192,druid,feral,6,2,4
Samsaralol,tichondrius,192,druid,feral,6,2,4
Bdsurges,illidan,192,druid,feral,6,2,4
Stolenrims,tichondrius,192,druid,feral,6,2,4
Teancookies,tichondrius,192,druid,feral,6,2,4
ßleepßloop,tichondrius,192,druid,feral,6,2,4
Prosperz,dalaran,192,druid,feral,6,2,4
Nyanyahoshi,proudmoore,192,druid,feral,6,2,4
Timdillon,emerald-dream,192,druid,feral,6,2,4
Nurturing,wyrmrest-accord,192,druid,feral,6,2,4
Haegur,tichondrius,192,druid,feral,6,2,4
Manwool,illidan,192,druid,feral,6,2,4
Unclebolty,frostmourne,192,druid,feral,6,2,4
Uphine,area-52,192,druid,feral,6,2,4
Karpin,area-52,192,druid,feral,6,2,4
Varietypack,antonidas,192,druid,feral,6,2,4
Sweatyclaws,bleeding-hollow,192,druid,feral,6,2,4
Pwoons,tichondrius,192,druid,feral,6,2,4
Dreadonly,tichondrius,192,druid,feral,6,2,4
Illr,laughing-skull,192,druid,feral,6,2,4
Sadsex,illidan,192,druid,feral,6,2,4
Psycloned,magtheridon,192,druid,feral,6,2,4
Bigxworm,gurubashi,192,druid,feral,6,2,4
Evantheomni,tichondrius,192,druid,feral,6,2,4
Decapin,bonechewer,192,druid,feral,11,2,9
Shadedmika,zuljin,192,druid,feral,12,2,10
Pawz,windrunner,192,druid,feral,12,2,10
Faroo,azralon,192,druid,feral,12,2,10
Sylvanthorn,moon-guard,192,druid,feral,12,2,10
Moosesolini,chogall,192,druid,feral,12,2,10
Abene,tichondrius,192,druid,feral,12,2,10
Chaurli,hyjal,192,druid,feral,12,2,10
Codieneme,blades-edge,192,druid,feral,12,2,10
Kangyoku,aegwynn,192,druid,feral,12,2,10
Noktua,moon-guard,192,druid,feral,12,2,10
Ciggy,maiev,192,druid,feral,12,2,10
Meudayr,crushridge,192,druid,feral,12,2,10
Nerfdemo,kiljaeden,192,druid,feral,12,2,10
Àcid,stormreaver,192,druid,feral,12,2,10
Envasions,emerald-dream,192,druid,feral,12,2,10
Feathersnow,moon-guard,192,druid,feral,12,2,10
Acórn,frostmourne,192,druid,feral,12,2,10
Guy,drakthul,192,druid,feral,12,2,10
Samully,area-52,192,druid,feral,12,2,10
Seyala,moon-guard,192,druid,feral,12,2,10
Drabo,boulderfist,192,druid,feral,12,2,10
Happyc,bleeding-hollow,192,druid,feral,12,2,10
Merxxotass,area-52,192,druid,feral,13,2,11
Rorhenn,moon-guard,192,druid,feral,18,2,16
Boomanon,illidan,191,druid,feral,6,2,4
Liightbite,illidan,191,druid,feral,12,2,10
Blackcatvibe,sargeras,191,druid,feral,12,2,10
Baanell,kiljaeden,191,druid,feral,12,2,10
Maxsonmaximo,sargeras,191,druid,feral,12,2,10
Gefetnix,cenarion-circle,191,druid,feral,18,2,16
Scaryy,kelthuzad,160,druid,feral,10,2,8
Jdoozie,bleeding-hollow,159,druid,feral,5,2,3
Kipsmiffly,darkspear,128,druid,feral,4,2,2
Änimorph,emerald-dream,127,druid,feral,4,2,2
Dobrman,sargeras,127,druid,feral,8,2,6
Feles,darkspear,96,druid,feral,3,2,1
Dééz,illidan,96,druid,feral,6,1,5
Terminated,tichondrius,96,druid,feral,6,1,5
Naztekk,dalaran,96,druid,feral,6,1,5
Laynahri,moon-guard,96,druid,feral,6,1,5
Ballinthree,illidan,96,druid,feral,6,1,5
Scizor,lightninghoof,96,druid,feral,6,1,5
Jawsbee,emerald-dream,96,druid,feral,6,1,5
Shanê,proudmoore,96,druid,feral,6,1,5
Vernaar,laughing-skull,96,druid,feral,6,1,5
Ghostboy,zuljin,96,druid,feral,6,1,5
Ban,chogall,96,druid,feral,6,1,5
Healthy,auchindoun,96,druid,feral,6,1,5
Furricane,ysondre,96,druid,feral,6,1,5
Fortunecat,illidan,96,druid,feral,6,1,5
Ahnsuk,bleeding-hollow,96,druid,feral,6,1,5
Lakroz,zuljin,96,druid,feral,6,1,5
Eurth,lightbringer,96,druid,feral,6,1,5
Furrycon,ysera,96,druid,feral,6,1,5
Scarymon,tichondrius,96,druid,feral,6,1,5
Polyproof,emerald-dream,96,druid,feral,6,1,5
Symbiøsis,zuljin,96,druid,feral,6,1,5
Droody,earthen-ring,96,druid,feral,6,1,5
Daesperien,tichondrius,96,druid,feral,6,1,5
Ojira,moon-guard,96,druid,feral,6,1,5
Kaldelar,emerald-dream,96,druid,feral,6,1,5
Hasemilë,dalaran,96,druid,feral,6,1,5
Gúdru,zuljin,96,druid,feral,6,1,5
Dotsgallore,garrosh,96,druid,feral,6,1,5
Arôn,stormreaver,96,druid,feral,6,1,5
Nyatarii,hakkar,96,druid,feral,6,1,5
Wodbisxpac,sargeras,96,druid,feral,6,1,5
Gamerdaddydd,tichondrius,96,druid,feral,6,1,5
Satanstoe,illidan,96,druid,feral,6,1,5
Meowned,stormrage,96,druid,feral,6,1,5
Harlisu,stormrage,96,druid,feral,6,1,5
Mootality,area-52,96,druid,feral,6,1,5
Ticømia,stormrage,96,druid,feral,6,1,5
Battledruid,nagrand,96,druid,feral,6,1,5
Lithrian,stormrage,96,druid,feral,6,1,5
Ilikedôggy,saurfang,96,druid,feral,6,1,5
Purpyo,bleeding-hollow,96,druid,feral,6,1,5
Fuzzwuzzyqt,tichondrius,96,druid,feral,6,1,5
Ottoro,azralon,96,druid,feral,6,1,5
Spacex,amanthul,96,druid,feral,6,1,5
Samedo,sargeras,96,druid,feral,6,1,5
Thonarian,vashj,96,druid,feral,6,1,5
Édzar,area-52,96,druid,feral,6,1,5
Noemofu,barthilas,96,druid,feral,6,1,5
Ärianagrande,stormrage,96,druid,feral,6,1,5
Shortskate,area-52,96,druid,feral,6,1,5
Garcia,feathermoon,96,druid,feral,6,1,5
Hynz,barthilas,96,druid,feral,6,1,5
Wreckingcrew,emerald-dream,96,druid,feral,6,1,5
Yarmel,kaelthas,96,druid,feral,6,1,5
Crowaar,moon-guard,96,druid,feral,6,1,5
Valdr,stormrage,96,druid,feral,6,1,5
Azreklol,sargeras,96,druid,feral,6,1,5
Lulerz,cenarius,96,druid,feral,6,1,5
Avorah,tichondrius,96,druid,feral,6,1,5
Alope,blades-edge,96,druid,feral,6,1,5
Boundless,skullcrusher,96,druid,feral,6,1,5
Shréd,blades-edge,96,druid,feral,6,1,5
Shlümp,tichondrius,96,druid,feral,6,1,5
Nezrael,frostwolf,96,druid,feral,6,1,5
Ashmíla,ragnaros,96,druid,feral,6,1,5
Raigor,azralon,96,druid,feral,6,1,5
Droupy,proudmoore,96,druid,feral,6,1,5
Kî,thunderlord,96,druid,feral,6,1,5
Gretatunberg,skywall,96,druid,feral,6,1,5
Asaptom,frostmourne,96,druid,feral,6,1,5
Morizo,proudmoore,96,druid,feral,6,1,5
Shisha,mannoroth,96,druid,feral,6,1,5
Ausbie,garona,96,druid,feral,6,1,5
Shinova,darkspear,96,druid,feral,6,1,5
Kelylea,the-underbog,96,druid,feral,6,1,5
Remeta,tichondrius,96,druid,feral,6,1,5
Thebigcat,deathwing,96,druid,feral,6,1,5
Swippy,blackhand,96,druid,feral,6,1,5
Bootzs,kelthuzad,96,druid,feral,6,1,5
Whiplash,deathwing,96,druid,feral,6,1,5
Jijunss,tichondrius,96,druid,feral,6,1,5
Aigo,azralon,96,druid,feral,6,1,5
Crazypaddy,dark-iron,96,druid,feral,6,1,5
Doomkin,demon-soul,96,druid,feral,6,1,5
Kagran,haomarush,96,druid,feral,6,1,5
Sharialawl,stormreaver,96,druid,feral,6,1,5
Deelark,skywall,96,druid,feral,6,1,5
Díc,drakkari,96,druid,feral,6,1,5
Feralhefty,stormrage,96,druid,feral,6,1,5
Chumdrumrum,malganis,96,druid,feral,6,1,5
Sweetiefoxx,tichondrius,96,druid,feral,6,1,5
Slep,tichondrius,96,druid,feral,6,1,5
Glorp,blackwater-raiders,96,druid,feral,6,1,5
Yeyee,darkspear,96,druid,feral,6,1,5
Tuskdaddie,sargeras,96,druid,feral,6,1,5
Yungle,tichondrius,96,druid,feral,6,1,5
Frëýá,bleeding-hollow,96,druid,feral,6,1,5
Tartin,dragonmaw,96,druid,feral,6,1,5
Captclaws,tichondrius,96,druid,feral,6,1,5
Spunj,frostmourne,96,druid,feral,6,1,5
Hadzumi,quelthalas,96,druid,feral,6,1,5
Byefren,darkspear,96,druid,feral,7,1,6
Kâtniss,quelthalas,96,druid,feral,8,1,7
Versipex,emerald-dream,96,druid,feral,12,1,11
Backlazsh,illidan,96,druid,feral,12,1,11
Grovestalker,nemesis,96,druid,feral,12,1,11
Shawdoostorm,nemesis,96,druid,feral,12,1,11
Lonewolfdrd,illidan,96,druid,feral,12,1,11
Ballsnack,zuljin,96,druid,feral,12,1,11
Roldanspet,sargeras,96,druid,feral,12,1,11
Habras,alterac-mountains,96,druid,feral,12,1,11
Owlcapwn,tichondrius,96,druid,feral,12,1,11
Trisgold,azralon,96,druid,feral,18,1,17
Wonderclam,sargeras,96,druid,feral,18,1,17
Furiøsä,quelthalas,95,druid,feral,6,1,5
Kaightough,azgalor,95,druid,feral,6,1,5
Skwidrific,crushridge,95,druid,feral,12,1,11
Gordisimo,sargeras,79,druid,feral,5,1,4
Gitsnshigles,frostmourne,79,druid,feral,5,1,4
Ebrìthil,hyjal,58,druid,feral,10,3,7
Chubakea,kiljaeden,48,druid,feral,3,1,2
Relidra,dathremar,48,druid,feral,3,1,2
Qouro,area-52,42,druid,feral,6,2,4
Shiftwork,korgath,42,druid,feral,10,2,8
Enderhero,illidan,42,druid,feral,14,2,12
Ânhur,tichondrius,42,druid,feral,17,2,15
Wägÿü,tichondrius,31,druid,feral,2,1,1
Mooncow,dalaran,31,druid,feral,2,1,1
Supatease,tichondrius,2327,druid,balance,201,112,89
Laryfsherman,tichondrius,2324,druid,balance,83,54,29
Aqulaíssaela,sargeras,2296,druid,balance,119,67,52
Starfail,illidan,2286,druid,balance,102,56,46
Peterßigßeam,malganis,2285,druid,balance,135,75,60
Hessenmèow,tichondrius,2279,druid,balance,108,60,48
Xijînping,tichondrius,2275,druid,balance,104,62,42
Jbz,balnazzar,2269,druid,balance,201,128,73
Owl,shadowsong,2261,druid,balance,120,69,51
Soggykfc,illidan,2247,druid,balance,196,110,86
Solareclipse,tichondrius,2242,druid,balance,89,51,38
Legionsucks,tanaris,2240,druid,balance,186,102,84
Fredagn,illidan,2232,druid,balance,138,79,59
Catworm,sargeras,2211,druid,balance,130,80,50
Flapz,illidan,2210,druid,balance,119,61,58
Cti,tichondrius,2204,druid,balance,59,42,17
Gritzxv,stormrage,2195,druid,balance,125,72,53
Theforeigner,arathor,2194,druid,balance,59,46,13
Gugukuaipao,tichondrius,2186,druid,balance,155,83,72
Nbadizzyboy,illidan,2181,druid,balance,59,47,12
Flowerboï,azralon,2180,druid,balance,96,69,27
Jimmypop,malganis,2174,druid,balance,199,114,85
Babekisser,stormrage,2169,druid,balance,323,183,140
Sonicphantom,kelthuzad,2165,druid,balance,197,113,84
Gspx,dalaran,2159,druid,balance,90,44,46
Jaseyxxl,area-52,2151,druid,balance,75,55,20
Impëria,quelthalas,2137,druid,balance,89,58,31
Altoberano,azralon,2136,druid,balance,95,53,42
Mewfasa,duskwood,2135,druid,balance,147,94,53
Houli,tichondrius,2134,druid,balance,96,50,46
Ratspot,stormrage,2133,druid,balance,66,43,23
Napes,tichondrius,2133,druid,balance,84,45,39
Smëagol,zuljin,2133,druid,balance,114,59,55
Bkqtpie,tichondrius,2130,druid,balance,142,76,66
Tanerno,illidan,2126,druid,balance,223,120,103
Elythria,hellscream,2125,druid,balance,48,42,6
Firefirelol,proudmoore,2125,druid,balance,131,65,66
Pisces,emerald-dream,2123,druid,balance,128,75,53
Pushpop,frostmourne,2120,druid,balance,89,55,34
Riskies,tichondrius,2116,druid,balance,252,133,119
Brose,malganis,2115,druid,balance,66,43,23
Murkeÿ,frostmourne,2114,druid,balance,150,75,75
Fergh,tichondrius,2112,druid,balance,113,60,53
Spamclonewin,tichondrius,2107,druid,balance,177,106,71
Trusyrusty,stormrage,2106,druid,balance,163,89,74
Sqwippyd,tichondrius,2102,druid,balance,78,49,29
Omends,thrall,2101,druid,balance,158,87,71
Packinmeat,tichondrius,2100,druid,balance,102,59,43
Celtaberano,illidan,2099,druid,balance,108,67,41
Lavlol,frostmourne,2099,druid,balance,424,224,200
Wnxmomthicc,tichondrius,2094,druid,balance,54,35,19
Tygraz,alleria,2077,druid,balance,108,69,39
Xantastic,area-52,2072,druid,balance,138,68,70
Hayase,tichondrius,2071,druid,balance,150,86,64
Kidcudi,dentarg,2069,druid,balance,281,141,140
Ztraws,tichondrius,2068,druid,balance,130,81,49
Tranquilo,stormrage,2068,druid,balance,120,70,50
Mortqt,tichondrius,2068,druid,balance,78,44,34
Vertderferk,tichondrius,2065,druid,balance,86,50,36
Treirus,sargeras,2064,druid,balance,142,96,46
Notes,sargeras,2062,druid,balance,158,76,82
Instar,tichondrius,2061,druid,balance,54,33,21
Tòmathy,tichondrius,2061,druid,balance,89,51,38
Dízzen,bleeding-hollow,2058,druid,balance,120,70,50
Boomkek,wyrmrest-accord,2056,druid,balance,80,50,30
Boomçhicken,tichondrius,2056,druid,balance,112,58,54
Geezbutt,tichondrius,2055,druid,balance,271,144,127
Sebastian,tichondrius,2054,druid,balance,89,55,34
Feralgo,tichondrius,2045,druid,balance,81,52,29
Hxzard,dalaran,2045,druid,balance,199,112,87
Clonekunts,tichondrius,2043,druid,balance,124,70,54
John,azralon,2040,druid,balance,168,84,84
Vengexd,sargeras,2031,druid,balance,55,38,17
Suen,tichondrius,2030,druid,balance,92,56,36
Drwasabi,tichondrius,2030,druid,balance,138,74,64
Kaid,malganis,2029,druid,balance,72,43,29
Balancex,tichondrius,2027,druid,balance,150,72,78
Soulz,quelthalas,2026,druid,balance,96,53,43
Fhormations,area-52,2023,druid,balance,149,84,65
Bigdiablo,frostmourne,2023,druid,balance,249,131,118
Megadruidx,stormrage,2022,druid,balance,81,55,26
Lgpepperoni,tichondrius,2020,druid,balance,54,47,7
Ertuzi,tichondrius,2017,druid,balance,207,114,93
Fifty,ragnaros,2016,druid,balance,156,94,62
Compléx,tichondrius,2016,druid,balance,78,41,37
Flatass,cairne,2011,druid,balance,152,88,64
Nokomanida,zuljin,2011,druid,balance,97,55,42
Mittns,arthas,2006,druid,balance,72,45,27
Lazygaga,zuljin,2004,druid,balance,176,92,84
Snöwghost,aerie-peak,2000,druid,balance,227,118,109
Bobthehefty,area-52,1999,druid,balance,64,38,26
Bables,tichondrius,1998,druid,balance,96,61,35
Etherêal,stormrage,1997,druid,balance,138,80,58
Akuladonfana,tichondrius,1996,druid,balance,30,26,4
Thugrose,blackrock,1993,druid,balance,54,28,26
Catculator,tichondrius,1989,druid,balance,130,80,50
Komacine,emerald-dream,1989,druid,balance,535,289,246
Zneb,darkspear,1987,druid,balance,36,29,7
Giantpanther,tichondrius,1987,druid,balance,138,81,57
Boyoboy,thrall,1985,druid,balance,42,29,13
Pønchø,quelthalas,1984,druid,balance,134,73,61
Yepz,tichondrius,1984,druid,balance,144,78,66
Byk,tichondrius,1982,druid,balance,144,81,63
Panansy,stormrage,1982,druid,balance,330,174,156
Komaner,frostmourne,1982,druid,balance,84,43,41
Fracxx,area-52,1981,druid,balance,30,21,9
Cultnelf,illidan,1976,druid,balance,131,69,62
Beamed,thrall,1966,druid,balance,48,35,13
Biophilic,moon-guard,1966,druid,balance,207,103,104
Alpine,eldrethalas,1960,druid,balance,72,50,22
Jaydog,emerald-dream,1955,druid,balance,36,30,6
Lazersnewch,kelthuzad,1955,druid,balance,78,44,34
Lazershartz,cenarion-circle,1952,druid,balance,78,38,40
Ezgamed,tichondrius,1950,druid,balance,69,46,23
Ballinthree,illidan,1947,druid,balance,60,43,17
Vernaar,laughing-skull,1947,druid,balance,150,82,68
Houlix,stormrage,1947,druid,balance,401,195,206
Daspdruid,nagrand,1945,druid,balance,314,160,154
Basedcatx,tichondrius,1940,druid,balance,82,52,30
Murruk,darkspear,1936,druid,balance,159,86,73
Dilondru,area-52,1933,druid,balance,135,80,55
Asenna,moon-guard,1928,druid,balance,59,31,28
Pipiwiwi,stormrage,1925,druid,balance,213,119,94
Dorizio,illidan,1923,druid,balance,112,65,47
Ericzzdd,tichondrius,1922,druid,balance,77,55,22
Lovemakitty,sargeras,1922,druid,balance,78,46,32
Soar,destromath,1921,druid,balance,141,87,54
Davo,tichondrius,1920,druid,balance,148,91,57
Çoach,tichondrius,1918,druid,balance,128,70,58
Animlcracker,emerald-dream,1917,druid,balance,126,81,45
Mcv,tichondrius,1917,druid,balance,72,41,31
Uhnoheals,tichondrius,1917,druid,balance,98,54,44
Mõoõoõoõoõoõ,tichondrius,1917,druid,balance,93,47,46
Cousa,zuljin,1916,druid,balance,218,120,98
Locose,black-dragonflight,1915,druid,balance,72,44,28
Moanabluray,area-52,1915,druid,balance,78,37,41
Thundoon,tichondrius,1913,druid,balance,42,27,15
Treeheehee,frostmourne,1911,druid,balance,81,60,21
Oungan,illidan,1911,druid,balance,158,91,67
Acdru,tichondrius,1911,druid,balance,67,37,30
Girthybeam,sargeras,1910,druid,balance,68,36,32
Johnnybeach,tichondrius,1909,druid,balance,67,44,23
Toughshift,zuljin,1908,druid,balance,102,45,57
Beefnudlsoup,tichondrius,1906,druid,balance,66,39,27
Rizzit,wyrmrest-accord,1906,druid,balance,64,36,28
Starbränd,azralon,1904,druid,balance,90,57,33
Vengex,sargeras,1904,druid,balance,48,30,18
Doomty,tichondrius,1904,druid,balance,96,56,40
Pigdd,tichondrius,1900,druid,balance,40,27,13
Purkins,barthilas,1900,druid,balance,53,32,21
Knotgiver,moon-guard,1899,druid,balance,52,31,21
Lakermagik,moknathal,1899,druid,balance,61,36,25
Jakob,arygos,1895,druid,balance,168,94,74
Oakwalker,moon-guard,1895,druid,balance,120,64,56
Harukai,azralon,1894,druid,balance,138,82,56
Halrath,sargeras,1891,druid,balance,36,20,16
Sadboy,moon-guard,1888,druid,balance,191,103,88
Dreveron,bleeding-hollow,1888,druid,balance,78,40,38
Youngtree,tichondrius,1887,druid,balance,45,25,20
Binkin,tichondrius,1884,druid,balance,24,21,3
Hogd,illidan,1884,druid,balance,66,38,28
Druidstin,tichondrius,1883,druid,balance,66,33,33
Sharialawl,stormreaver,1881,druid,balance,54,37,17
Hefkerd,tichondrius,1881,druid,balance,30,20,10
Ethan,the-venture-co,1879,druid,balance,39,26,13
Jojo,ysera,1879,druid,balance,148,81,67
Jayelljaÿ,thrall,1874,druid,balance,141,83,58
Çørrúptíøñzx,tichondrius,1873,druid,balance,42,31,11
Astraldank,tichondrius,1873,druid,balance,169,92,77
Animatronixz,area-52,1871,druid,balance,72,39,33
Psychotycxd,tichondrius,1870,druid,balance,126,69,57
Toolboy,tichondrius,1870,druid,balance,84,45,39
Owlyfans,frostmourne,1869,druid,balance,60,39,21
Crusch,shattered-halls,1869,druid,balance,36,23,13
Fgsb,sargeras,1868,druid,balance,42,30,12
Thatboiscrew,tichondrius,1868,druid,balance,116,82,34
Wereocelot,firetree,1868,druid,balance,208,114,94
Ràjeesh,frostmourne,1867,druid,balance,46,31,15
Möshinòõb,proudmoore,1865,druid,balance,58,40,18
Sarvi,zuljin,1864,druid,balance,33,24,9
Mverstapp,moon-guard,1864,druid,balance,60,32,28
Vuru,azralon,1862,druid,balance,47,32,15
Ilovediego,stormrage,1862,druid,balance,48,30,18
Djayolo,illidan,1861,druid,balance,66,46,20
Nåpes,frostmourne,1861,druid,balance,62,31,31
Fidgy,tichondrius,1858,druid,balance,36,29,7
Yevenbother,tichondrius,1858,druid,balance,42,27,15
Poliage,moon-guard,1858,druid,balance,155,89,66
Elyveen,proudmoore,1856,druid,balance,122,83,39
Convokeopp,tichondrius,1856,druid,balance,149,78,71
Lilbeam,sargeras,1855,druid,balance,42,27,15
Blazeikin,tichondrius,1855,druid,balance,87,47,40
Daifuku,illidan,1854,druid,balance,54,32,22
Burninmoon,tichondrius,1851,druid,balance,117,61,56
Pizzaparties,tichondrius,1850,druid,balance,83,57,26
Johnieboy,azralon,1850,druid,balance,79,46,33
Starfallz,illidan,1850,druid,balance,42,23,19
Trollololkin,bleeding-hollow,1849,druid,balance,77,52,25
Kyura,sargeras,1848,druid,balance,160,82,78
Swaggu,kelthuzad,1847,druid,balance,72,44,28
Deenut,sargeras,1847,druid,balance,66,40,26
Irooftrellen,chogall,1847,druid,balance,107,59,48
Lothail,windrunner,1846,druid,balance,107,60,47
Idolizeme,skullcrusher,1845,druid,balance,59,30,29
Laser,bonechewer,1844,druid,balance,42,27,15
Judar,barthilas,1844,druid,balance,71,36,35
Sommerrays,kelthuzad,1843,druid,balance,108,57,51
Surfingbird,tichondrius,1839,druid,balance,248,150,98
Seyala,moon-guard,1839,druid,balance,181,103,78
Moonkay,tichondrius,1838,druid,balance,66,39,27
Boomfold,tichondrius,1837,druid,balance,48,27,21
Ottovonbird,tichondrius,1837,druid,balance,54,30,24
Lazerbeamz,tichondrius,1837,druid,balance,126,69,57
Proudmom,barthilas,1835,druid,balance,60,31,29
Hennydru,dalaran,1834,druid,balance,53,34,19
Chal,illidan,1834,druid,balance,65,39,26
Elunegoddess,tichondrius,1834,druid,balance,46,27,19
Bolthor,wyrmrest-accord,1834,druid,balance,138,77,61
Formhub,malganis,1834,druid,balance,84,42,42
Exxh,tichondrius,1833,druid,balance,58,41,17
Moonflora,stormrage,1833,druid,balance,129,73,56
Sawsaw,bleeding-hollow,1832,druid,balance,74,42,32
Lekick,tichondrius,1832,druid,balance,81,45,36
Nickyü,ragnaros,1832,druid,balance,102,53,49
Wecksox,area-52,1832,druid,balance,268,134,134
Ilovediegoxo,kelthuzad,1830,druid,balance,48,32,16
Itachi,dragonmaw,1830,druid,balance,83,48,35
Deloria,nemesis,1829,druid,balance,42,25,17
Dontnerfmore,queldorei,1829,druid,balance,66,31,35
Moozzash,azralon,1828,druid,balance,54,32,22
Chernovax,kelthuzad,1828,druid,balance,87,47,40
Equinøxx,malganis,1827,druid,balance,47,30,17
Evsn,tichondrius,1826,druid,balance,36,28,8
Goochies,aerie-peak,1826,druid,balance,59,35,24
Bcup,sargeras,1826,druid,balance,54,32,22
Ebrìthil,hyjal,1823,druid,balance,96,50,46
Angryjo,tichondrius,1822,druid,balance,76,43,33
Clonemunster,frostmourne,1821,druid,balance,66,38,28
Threk,spirestone,1821,druid,balance,161,90,71
Fleasy,wyrmrest-accord,1820,druid,balance,85,52,33
Lunalai,bloodhoof,1820,druid,balance,96,55,41
Metroboomy,magtheridon,1820,druid,balance,104,59,45
Kydro,sargeras,1820,druid,balance,80,44,36
Catpoop,frostmourne,1819,druid,balance,54,37,17
Sweatypapa,tichondrius,1819,druid,balance,126,82,44
Thrage,sargeras,1819,druid,balance,66,40,26
Ailari,moon-guard,1819,druid,balance,97,57,40
Dipii,proudmoore,1818,druid,balance,30,22,8
Resorange,malganis,1818,druid,balance,48,29,19
Sueycide,tichondrius,1818,druid,balance,89,43,46
Dorlingus,tichondrius,1817,druid,balance,48,29,19
Partylord,malganis,1817,druid,balance,156,87,69
Rìniroo,area-52,1816,druid,balance,48,30,18
Tratean,tichondrius,1816,druid,balance,90,53,37
Xenny,chogall,1815,druid,balance,48,34,14
Form,bleeding-hollow,1815,druid,balance,96,57,39
Stepbro,malorne,1815,druid,balance,252,144,108
Raïsin,moon-guard,1814,druid,balance,45,26,19
Jacusias,stormrage,1814,druid,balance,188,102,86
Bentøbøx,barthilas,1814,druid,balance,53,28,25
Haohomie,tichondrius,1813,druid,balance,78,52,26
Kogas,hyjal,1812,druid,balance,56,37,19
Omnigrind,frostmourne,1812,druid,balance,30,19,11
Staystrongox,tichondrius,1812,druid,balance,82,51,31
Donutdruid,illidan,1812,druid,balance,88,54,34
Jokerdks,tichondrius,1812,druid,balance,80,49,31
Thottiie,hyjal,1812,druid,balance,78,45,33
Keylae,sargeras,1812,druid,balance,86,46,40
Moongodx,stormrage,1811,druid,balance,36,26,10
Binjuicex,frostmourne,1811,druid,balance,57,38,19
Kamero,tichondrius,1811,druid,balance,63,39,24
Souress,shadowsong,1811,druid,balance,66,40,26
Oobuck,kilrogg,1810,druid,balance,81,50,31
Likorit,azralon,1809,druid,balance,36,25,11
Tôpdadwôrld,sargeras,1809,druid,balance,30,19,11
Sorh,stormrage,1809,druid,balance,60,37,23
Drcuy,ragnaros,1809,druid,balance,104,59,45
Kzinti,zuluhed,1809,druid,balance,113,60,53
Starlyxo,malganis,1808,druid,balance,86,57,29
Nasuu,bleeding-hollow,1808,druid,balance,131,80,51
Smeow,zuljin,1808,druid,balance,146,82,64
Dextructive,tichondrius,1808,druid,balance,142,72,70
Wiredxd,illidan,1807,druid,balance,44,28,16
Pào,tichondrius,1807,druid,balance,57,35,22
Seilah,lightbringer,1807,druid,balance,54,30,24
Cattdog,tichondrius,1806,druid,balance,82,55,27
Dustydrx,area-52,1806,druid,balance,56,34,22
Zeromoon,frostmourne,1806,druid,balance,59,29,30
Ðraoï,stormrage,1805,druid,balance,48,29,19
Bathrobe,bloodscalp,1805,druid,balance,54,28,26
Wòót,stormreaver,1804,druid,balance,108,73,35
Boomsquanch,emerald-dream,1804,druid,balance,54,32,22
Bloomqt,tichondrius,1804,druid,balance,182,105,77
Starsucceed,illidan,1804,druid,balance,48,25,23
Xannê,tichondrius,1804,druid,balance,62,32,30
Malfuria,tichondrius,1802,druid,balance,53,32,21
Mythleaf,ragnaros,1802,druid,balance,120,70,50
Enøsh,tichondrius,1802,druid,balance,102,52,50
Felny,malganis,1802,druid,balance,54,26,28
Buffjungle,tichondrius,1801,druid,balance,36,20,16
Gordzak,illidan,1801,druid,balance,212,113,99
Hateshinai,sargeras,1800,druid,balance,36,24,12
Treelah,tichondrius,1800,druid,balance,48,29,19
Starboy,garona,1800,druid,balance,54,32,22
Krahz,lightnings-blade,1800,druid,balance,415,219,196
Sahksi,lothar,1798,druid,balance,104,57,47
Rikishi,executus,1798,druid,balance,60,32,28
Gèb,dalaran,1797,druid,balance,158,91,67
Rank,nerzhul,1796,druid,balance,61,35,26
Sappyroots,area-52,1794,druid,balance,42,22,20
Fal,bloodscalp,1790,druid,balance,72,41,31
Hypefull,tichondrius,1790,druid,balance,54,26,28
Kellydacat,azuremyst,1789,druid,balance,24,19,5
Fungamezx,bleeding-hollow,1788,druid,balance,72,48,24
Striix,ragnaros,1788,druid,balance,48,23,25
Druidk,tichondrius,1786,druid,balance,102,51,51
Bunnykiss,tichondrius,1784,druid,balance,116,58,58
Boomybro,thrall,1783,druid,balance,146,88,58
Gsd,sargeras,1782,druid,balance,89,52,37
Drugdoer,tichondrius,1781,druid,balance,112,66,46
Destromz,zuljin,1780,druid,balance,36,24,12
Ataraxie,illidan,1780,druid,balance,78,47,31
Hydrahl,thrall,1780,druid,balance,90,50,40
Orollå,tichondrius,1771,druid,balance,50,29,21
Bearyhalls,frostmourne,1769,druid,balance,39,24,15
Davione,tichondrius,1767,druid,balance,64,37,27
Honeybeam,moon-guard,1767,druid,balance,92,49,43
Dooruid,tichondrius,1766,druid,balance,71,38,33
Olongjonsson,wyrmrest-accord,1766,druid,balance,36,19,17
Nxf,sargeras,1764,druid,balance,59,33,26
Lilkitty,tichondrius,1764,druid,balance,148,81,67
Tyapet,area-52,1763,druid,balance,190,107,83
Myex,illidan,1760,druid,balance,66,44,22
Bukkwild,stormrage,1759,druid,balance,72,50,22
Melloj,kelthuzad,1759,druid,balance,78,45,33
Coompie,frostmourne,1757,druid,balance,36,27,9
Líu,area-52,1757,druid,balance,102,63,39
Krispz,area-52,1757,druid,balance,95,49,46
Daddyshift,proudmoore,1756,druid,balance,74,42,32
Clarice,shattered-halls,1756,druid,balance,147,81,66
Awguseon,proudmoore,1755,druid,balance,66,43,23
Ternkote,tichondrius,1755,druid,balance,48,28,20
Cocainebeär,tichondrius,1755,druid,balance,77,39,38
Chanimal,tichondrius,1754,druid,balance,66,42,24
Cynhawts,emerald-dream,1754,druid,balance,46,27,19
Lewïs,stormrage,1753,druid,balance,121,69,52
Gorgoncity,illidan,1753,druid,balance,34,19,15
Cirranis,moon-guard,1750,druid,balance,153,88,65
Swayjizz,tichondrius,1750,druid,balance,114,64,50
Foekinghobo,sargeras,1750,druid,balance,167,91,76
Deviperdruid,frostmourne,1748,druid,balance,51,35,16
Bunnyes,tichondrius,1747,druid,balance,54,29,25
Sweatydruidx,tichondrius,1746,druid,balance,54,29,25
Bubalolz,quelthalas,1746,druid,balance,233,116,117
ßleepßloop,tichondrius,1745,druid,balance,45,29,16
Halenson,illidan,1745,druid,balance,82,45,37
Mûû,tichondrius,1743,druid,balance,116,69,47
Herpadruid,illidan,1743,druid,balance,150,66,84
Ayla,gorefiend,1741,druid,balance,47,30,17
Convoken,tichondrius,1740,druid,balance,58,35,23
Niroxic,frostmourne,1740,druid,balance,78,47,31
Handhandb,tichondrius,1740,druid,balance,84,47,37
Bearyhallsjr,sargeras,1739,druid,balance,30,22,8
Animaldoctor,illidan,1737,druid,balance,69,48,21
Whoopz,blackrock,1737,druid,balance,42,20,22
Taylorshift,misha,1735,druid,balance,39,33,6
Justsidious,sargeras,1735,druid,balance,36,27,9
Kydralola,ragnaros,1735,druid,balance,36,21,15
Druidwhat,stormrage,1734,druid,balance,153,81,72
Zoteqt,kelthuzad,1734,druid,balance,259,133,126
Starz,arthas,1733,druid,balance,50,33,17
Mädnhairy,zuljin,1731,druid,balance,51,32,19
Foxhoundlol,tichondrius,1731,druid,balance,78,48,30
Jemima,auchindoun,1730,druid,balance,142,83,59
Glickbear,illidan,1730,druid,balance,72,40,32
Nyloke,kelthuzad,1729,druid,balance,66,44,22
Choosegoose,area-52,1729,druid,balance,44,29,15
Meowkit,blackrock,1729,druid,balance,64,40,24
Wasabilol,tichondrius,1729,druid,balance,136,78,58
Scene,frostmourne,1729,druid,balance,71,40,31
Bumbleebee,azralon,1728,druid,balance,42,28,14
Zalothianx,thrall,1728,druid,balance,46,28,18
Tenhoteta,goldrinn,1727,druid,balance,81,46,35
Cobal,goldrinn,1727,druid,balance,419,216,203
Tinkeress,stormrage,1725,druid,balance,157,91,66
Chikinwing,illidan,1725,druid,balance,143,80,63
Stinkÿ,bleeding-hollow,1724,druid,balance,63,42,21
Xenöchrist,ragnaros,1724,druid,balance,154,95,59
Pannaxx,tichondrius,1723,druid,balance,36,24,12
Boattastic,terenas,1723,druid,balance,102,53,49
Brokenomega,area-52,1722,druid,balance,142,85,57
Naakx,tichondrius,1722,druid,balance,52,30,22
Jaxer,illidan,1720,druid,balance,147,85,62
Egomonster,tichondrius,1718,druid,balance,24,18,6
Brainlessqt,tichondrius,1717,druid,balance,34,24,10
Boosted,bloodscalp,1717,druid,balance,42,27,15
Jssy,tichondrius,1717,druid,balance,36,21,15
Sym,zuljin,1716,druid,balance,30,19,11
Chernlyssayo,stormrage,1714,druid,balance,56,35,21
Droodaphobé,sargeras,1714,druid,balance,59,34,25
Nophysique,zuljin,1714,druid,balance,136,74,62
Cjæ,bleeding-hollow,1713,druid,balance,24,18,6
Treeshift,tichondrius,1713,druid,balance,77,47,30
Dànkness,frostwolf,1713,druid,balance,53,29,24
Zils,bleeding-hollow,1713,druid,balance,55,29,26
Blamkin,tichondrius,1712,druid,balance,48,29,19
Weckxa,sargeras,1712,druid,balance,296,150,146
Frames,area-52,1712,druid,balance,89,45,44
Twinscroll,tichondrius,1711,druid,balance,178,108,70
Glazinator,sargeras,1709,druid,balance,257,126,131
Iambeefy,hyjal,1708,druid,balance,54,33,21
Faerie,kaelthas,1708,druid,balance,82,44,38
Slickitty,kelthuzad,1707,druid,balance,30,18,12
Ghaal,tichondrius,1707,druid,balance,132,78,54
Chaossdruid,bleeding-hollow,1706,druid,balance,183,104,79
Rayzer,bleeding-hollow,1706,druid,balance,135,76,59
Waiv,area-52,1706,druid,balance,48,25,23
Rikezz,black-dragonflight,1705,druid,balance,64,46,18
Chengxiaopao,tichondrius,1705,druid,balance,50,32,18
Padavore,wyrmrest-accord,1705,druid,balance,121,75,46
Boiledfrogs,zuljin,1705,druid,balance,36,22,14
Yggdrasil,ravencrest,1705,druid,balance,54,29,25
Suist,moonrunner,1703,druid,balance,45,24,21
Maligoz,nemesis,1703,druid,balance,95,49,46
Rerob,aerie-peak,1702,druid,balance,50,26,24
Delorík,illidan,1701,druid,balance,126,71,55
Doomdawn,sargeras,1701,druid,balance,123,65,58
Torrox,tichondrius,1700,druid,balance,274,149,125
Smeepy,bleeding-hollow,1700,druid,balance,48,26,22
Fätål,ysera,1699,druid,balance,72,45,27
Koratan,frostmourne,1699,druid,balance,53,28,25
Ðøomkinz,azjolnerub,1698,druid,balance,60,40,20
Knoxdog,illidan,1698,druid,balance,57,37,20
Themustafa,tichondrius,1698,druid,balance,48,31,17
Quelarre,velen,1698,druid,balance,100,58,42
Muunragery,illidan,1698,druid,balance,48,25,23
Aethisra,moon-guard,1697,druid,balance,167,95,72
Protagonist,zuluhed,1697,druid,balance,85,46,39
Fancynut,kiljaeden,1697,druid,balance,80,42,38
Tunaren,wyrmrest-accord,1696,druid,balance,42,21,21
Sigure,zuljin,1695,druid,balance,50,34,16
Raquelitá,ragnaros,1694,druid,balance,28,19,9
Haymade,sargeras,1694,druid,balance,150,87,63
Starsiee,drakkari,1694,druid,balance,71,35,36
Comidru,tichondrius,1694,druid,balance,84,41,43
Velyring,moon-guard,1693,druid,balance,96,57,39
Cyclone,darkspear,1693,druid,balance,48,21,27
Sibby,barthilas,1691,druid,balance,90,48,42
Flapperz,sargeras,1691,druid,balance,98,50,48
Meatbender,frostmourne,1691,druid,balance,110,55,55
Boomybalboa,stormrage,1690,druid,balance,29,19,10
Shibbith,nordrassil,1689,druid,balance,36,22,14
Moonrg,stormrage,1689,druid,balance,66,35,31
Ssantirap,quelthalas,1689,druid,balance,42,18,24
Reàsons,stormrage,1688,druid,balance,126,62,64
Aule,frostmourne,1687,druid,balance,36,18,18
Realmehji,wyrmrest-accord,1686,druid,balance,36,28,8
Whodoüvoodoo,tichondrius,1686,druid,balance,30,21,9
Spinach,moon-guard,1686,druid,balance,104,53,51
Ripkinztko,stormrage,1685,druid,balance,24,19,5
Aralix,zuljin,1684,druid,balance,184,101,83
Chickenwings,ragnaros,1683,druid,balance,42,27,15
Gwiffurry,tichondrius,1683,druid,balance,54,32,22
Taurenasarus,area-52,1683,druid,balance,51,30,21
Yazmawma,tichondrius,1683,druid,balance,72,40,32
Roofty,illidan,1681,druid,balance,34,22,12
Âzn,tichondrius,1681,druid,balance,126,80,46
Cheezaygx,arthas,1680,druid,balance,30,18,12
Dárách,malganis,1680,druid,balance,147,82,65
Nurtures,sargeras,1680,druid,balance,60,33,27
Beamrooster,silvermoon,1679,druid,balance,62,39,23
Realistik,kelthuzad,1678,druid,balance,60,39,21
Clawyou,illidan,1677,druid,balance,30,21,9
Cyclíze,sargeras,1677,druid,balance,48,30,18
Ruthlessbro,sargeras,1677,druid,balance,85,45,40
Rokk,baelgun,1676,druid,balance,128,77,51
Ironsightsdr,dalaran,1676,druid,balance,57,33,24
Johnnydrip,malganis,1676,druid,balance,42,22,20
Abomasnow,turalyon,1675,druid,balance,60,35,25
Cröòk,malganis,1675,druid,balance,48,24,24
Ànìmàl,stormrage,1674,druid,balance,36,27,9
Drmf,frostmourne,1674,druid,balance,48,28,20
Withwind,dalaran,1673,druid,balance,48,23,25
Islayne,moon-guard,1672,druid,balance,36,29,7
Pennytrate,barthilas,1672,druid,balance,110,60,50
Mooseknukel,zuljin,1671,druid,balance,42,25,17
Chococrispis,quelthalas,1671,druid,balance,36,21,15
Frostig,tichondrius,1670,druid,balance,36,22,14
Lostnsauce,tichondrius,1669,druid,balance,60,43,17
Softkiller,chogall,1669,druid,balance,72,44,28
Mastabtw,illidan,1669,druid,balance,42,20,22
Halensen,illidan,1668,druid,balance,47,23,24
Supafat,thrall,1667,druid,balance,37,23,14
Scurse,tichondrius,1667,druid,balance,114,60,54
Wallower,malganis,1667,druid,balance,54,24,30
Chøpstixs,bleeding-hollow,1666,druid,balance,60,35,25
Yipëë,moon-guard,1666,druid,balance,64,34,30
Kahpooya,tichondrius,1665,druid,balance,36,24,12
Sodapooping,azjolnerub,1665,druid,balance,186,106,80
Partybeast,malganis,1664,druid,balance,74,55,19
Zetii,emerald-dream,1663,druid,balance,108,64,44
Muwudred,stormrage,1663,druid,balance,72,41,31
Flappyjacks,elune,1663,druid,balance,60,32,28
Gumbawl,sargeras,1662,druid,balance,36,22,14
Gallianö,frostmourne,1662,druid,balance,46,27,19
Byte,ragnaros,1662,druid,balance,35,18,17
Marutot,tichondrius,1660,druid,balance,42,30,12
Gokki,zuljin,1660,druid,balance,77,53,24
Jalapenoz,wyrmrest-accord,1660,druid,balance,36,18,18
Spacedruidx,illidan,1659,druid,balance,91,49,42
Maxspeed,tichondrius,1657,druid,balance,30,20,10
Foafoa,illidan,1657,druid,balance,31,19,12
Verbz,arthas,1656,druid,balance,54,26,28
Sxc,frostmourne,1654,druid,balance,46,26,20
Entakkt,cenarius,1653,druid,balance,36,28,8
Saltydru,illidan,1653,druid,balance,56,34,22
Bearyhalls,sargeras,1653,druid,balance,30,18,12
Aull,kelthuzad,1653,druid,balance,36,19,17
Roar,moon-guard,1652,druid,balance,45,31,14
Vergota,emerald-dream,1652,druid,balance,73,50,23
Loudpax,zuljin,1652,druid,balance,53,36,17
Renithen,trollbane,1652,druid,balance,42,28,14
Înfamous,thrall,1652,druid,balance,36,24,12
Trapdoorboom,illidan,1652,druid,balance,138,69,69
Ashstarfall,barthilas,1651,druid,balance,36,26,10
Readt,malganis,1651,druid,balance,210,111,99
Druentia,tichondrius,1650,druid,balance,30,20,10
Loraxx,bleeding-hollow,1650,druid,balance,36,23,13
Coldkill,burning-legion,1650,druid,balance,36,20,16
Lyshani,thrall,1650,druid,balance,106,58,48
Khryllx,tichondrius,1649,druid,balance,42,27,15
Charmandxr,hyjal,1649,druid,balance,65,36,29
Phurr,area-52,1649,druid,balance,75,39,36
Harryhotter,blackrock,1649,druid,balance,115,58,57
Pils,nemesis,1648,druid,balance,177,104,73
Yoona,kiljaeden,1648,druid,balance,42,21,21
Nokitty,tichondrius,1647,druid,balance,48,37,11
Epicworld,stormrage,1647,druid,balance,156,92,64
Theboomkin,kelthuzad,1647,druid,balance,42,24,18
Dôcteurowl,zuljin,1647,druid,balance,155,75,80
Gwub,illidan,1646,druid,balance,29,23,6
Bbkingschair,tichondrius,1646,druid,balance,30,21,9
Korbö,zuljin,1645,druid,balance,48,27,21
Offthezaza,tichondrius,1644,druid,balance,94,53,41
Pankecito,ragnaros,1644,druid,balance,64,36,28
Josepha,tichondrius,1643,druid,balance,30,20,10
Wizdùm,frostmourne,1643,druid,balance,53,34,19
Buckbumble,frostmourne,1643,druid,balance,72,45,27
Convokeula,tichondrius,1643,druid,balance,132,76,56
Hagatta,stormrage,1643,druid,balance,186,99,87
Segamain,shuhalo,1643,druid,balance,87,45,42
Rezlur,tichondrius,1643,druid,balance,47,24,23
Masan,burning-blade,1642,druid,balance,36,23,13
Desiration,area-52,1642,druid,balance,33,20,13
Hootiepie,hyjal,1642,druid,balance,42,24,18
Boomchickens,area-52,1642,druid,balance,60,33,27
Irl,frostmane,1641,druid,balance,41,23,18
Dcountts,area-52,1640,druid,balance,44,28,16
Buckwhêât,illidan,1640,druid,balance,100,47,53
Rumorxo,illidan,1639,druid,balance,30,18,12
Snugglin,kelthuzad,1638,druid,balance,72,37,35
Killiamp,tichondrius,1636,druid,balance,41,27,14
Smokeytheelf,illidan,1636,druid,balance,77,50,27
Kïx,illidan,1636,druid,balance,38,23,15
Tummycummy,thrall,1635,druid,balance,36,24,12
Dudur,zuljin,1635,druid,balance,143,76,67
Thamoonsbak,aggramar,1635,druid,balance,35,18,17
Junaleska,lightbringer,1634,druid,balance,29,21,8
Ehleven,tichondrius,1634,druid,balance,48,29,19
Dharmatra,quelthalas,1634,druid,balance,101,56,45
Elliar,akama,1634,druid,balance,105,55,50
Ahrilee,area-52,1634,druid,balance,90,47,43
Deed,korialstrasz,1633,druid,balance,52,26,26
Raddosaurus,area-52,1632,druid,balance,95,52,43
Drognan,sargeras,1632,druid,balance,47,25,22
Mayanardz,bleeding-hollow,1631,druid,balance,24,17,7
Greenseed,nagrand,1631,druid,balance,54,38,16
Skeevz,darkspear,1630,druid,balance,74,38,36
Relaeh,andorhal,1629,druid,balance,36,19,17
Kekepop,emerald-dream,1628,druid,balance,36,25,11
Jimrobloxttv,emerald-dream,1627,druid,balance,36,24,12
Oppose,akama,1627,druid,balance,65,37,28
Swappy,korgath,1627,druid,balance,148,81,67
Boomchí,tichondrius,1627,druid,balance,54,29,25
Aethertide,stormrage,1627,druid,balance,53,26,27
Dreamwalker,bleeding-hollow,1626,druid,balance,24,17,7
ßigfoot,darkspear,1626,druid,balance,30,21,9
Ripdimebag,frostmourne,1626,druid,balance,58,37,21
Restorationz,tichondrius,1626,druid,balance,131,77,54
Scrubrat,moon-guard,1625,druid,balance,52,40,12
Ablackdruid,moon-guard,1624,druid,balance,35,21,14
Boome,blackrock,1624,druid,balance,186,99,87
Moonra,malganis,1623,druid,balance,66,38,28
Soonntkgo,ragnaros,1623,druid,balance,56,29,27
Bhboom,tichondrius,1623,druid,balance,54,23,31
Eseldra,area-52,1622,druid,balance,58,34,24
Wildbloom,draenor,1622,druid,balance,108,62,46
Galadon,tichondrius,1622,druid,balance,65,36,29
Kickconvoke,sargeras,1621,druid,balance,66,39,27
Nbnbnb,proudmoore,1621,druid,balance,39,21,18
Còyot,stormrage,1621,druid,balance,66,34,32
Finkledurp,dalaran,1621,druid,balance,47,24,23
Moonsliced,kiljaeden,1620,druid,balance,54,33,21
Lowkie,llane,1620,druid,balance,81,44,37
Kelagoat,kiljaeden,1620,druid,balance,60,29,31
Muffbfloppn,zuljin,1619,druid,balance,36,22,14
Taszy,blackrock,1619,druid,balance,58,34,24
Contrololol,hyjal,1619,druid,balance,66,35,31
Stinky,bleeding-hollow,1619,druid,balance,42,22,20
Gatø,area-52,1619,druid,balance,90,42,48
Dupaface,stormrage,1618,druid,balance,41,20,21
Beyondbeef,sargeras,1617,druid,balance,82,53,29
Tahunne,tichondrius,1617,druid,balance,130,80,50
Bambooty,veknilash,1617,druid,balance,84,43,41
Wildslash,proudmoore,1617,druid,balance,75,37,38
Drufasa,tichondrius,1617,druid,balance,70,34,36
Foxwit,jubeithos,1616,druid,balance,40,22,18
Lupintk,tichondrius,1615,druid,balance,120,69,51
Héisénbérg,sargeras,1615,druid,balance,60,33,27
Furryswipe,proudmoore,1614,druid,balance,56,33,23
Polánd,area-52,1614,druid,balance,75,43,32
Tereeke,moon-guard,1614,druid,balance,47,25,22
Caboom,frostmourne,1614,druid,balance,36,19,17
Yosuzume,thrall,1613,druid,balance,54,33,21
Seyedo,sargeras,1613,druid,balance,77,45,32
Treetard,altar-of-storms,1613,druid,balance,90,48,42
Kuaite,azralon,1613,druid,balance,88,44,44
Schneidèr,quelthalas,1613,druid,balance,42,20,22
Targareyen,sargeras,1613,druid,balance,59,28,31
Corki,vashj,1612,druid,balance,30,22,8
Ihavehothots,kiljaeden,1612,druid,balance,44,32,12
Duglas,illidan,1612,druid,balance,91,55,36
Auras,kelthuzad,1612,druid,balance,126,76,50
Grapeful,frostmourne,1612,druid,balance,72,39,33
Yorkville,sargeras,1612,druid,balance,84,43,41
Ellguin,malganis,1611,druid,balance,60,44,16
Cócorosie,tichondrius,1611,druid,balance,36,26,10
Gladdz,tichondrius,1611,druid,balance,53,30,23
Twcrazyk,tichondrius,1611,druid,balance,79,38,41
Bocephus,dark-iron,1610,druid,balance,66,41,25
Seyon,tichondrius,1610,druid,balance,39,20,19
Laradea,argent-dawn,1609,druid,balance,38,27,11
Pänzerkin,sargeras,1609,druid,balance,30,21,9
Fatsquid,tichondrius,1609,druid,balance,60,38,22
Alaillais,moon-guard,1609,druid,balance,48,28,20
Shafted,kelthuzad,1609,druid,balance,36,21,15
Eatmorchiken,boulderfist,1609,druid,balance,36,20,16
Brodda,sargeras,1609,druid,balance,220,115,105
Kittyboy,emerald-dream,1607,druid,balance,30,21,9
Kittiepurry,blackrock,1607,druid,balance,112,63,49
Swiftydel,frostmourne,1607,druid,balance,54,29,25
Boys,bleeding-hollow,1606,druid,balance,42,24,18
Galind,rexxar,1606,druid,balance,58,33,25
Rígél,ragnaros,1606,druid,balance,243,132,111
Signifies,tichondrius,1605,druid,balance,29,20,9
Shréd,blades-edge,1605,druid,balance,44,29,15
Xanybarz,stormrage,1605,druid,balance,42,27,15
Braviel,stormrage,1605,druid,balance,54,32,22
Huggerino,stormrage,1605,druid,balance,88,52,36
Bippygucci,tichondrius,1605,druid,balance,60,32,28
Baboongodx,frostmourne,1605,druid,balance,35,18,17
Lumipawz,frostmourne,1604,druid,balance,49,35,14
Ereshkïgal,stormrage,1604,druid,balance,95,57,38
Rongrong,kargath,1604,druid,balance,30,17,13
Columpio,area-52,1604,druid,balance,42,23,19
Nehrudruid,area-52,1603,druid,balance,24,17,7
Anchunlol,tichondrius,1603,druid,balance,36,19,17
Gaawdx,illidan,1603,druid,balance,160,81,79
Jentlegiant,tichondrius,1602,druid,balance,36,21,15
Nuubmurph,stormrage,1601,druid,balance,45,29,16
Dorobloom,sargeras,1600,druid,balance,72,45,27
Alastras,tichondrius,1600,druid,balance,42,19,23
Yoglosmas,tichondrius,1599,druid,balance,71,42,29
Mengniulol,tichondrius,1599,druid,balance,30,17,13
Mofan,tichondrius,1599,druid,balance,36,20,16
Kletys,azralon,1599,druid,balance,113,57,56
Almarasta,azralon,1598,druid,balance,106,63,43
Sadsex,illidan,1598,druid,balance,107,63,44
Woog,moon-guard,1598,druid,balance,102,59,43
Stellar,steamwheedle-cartel,1597,druid,balance,24,19,5
Dirtmaggot,barthilas,1597,druid,balance,31,21,10
Inuyasha,sargeras,1597,druid,balance,59,34,25
Doomkiñ,darkspear,1597,druid,balance,47,22,25
Rizzdja,frostmourne,1596,druid,balance,48,30,18
Gossìpgoat,frostmourne,1596,druid,balance,56,33,23
Wp,proudmoore,1595,druid,balance,76,48,28
Infam,sargeras,1595,druid,balance,36,21,15
Wattami,area-52,1595,druid,balance,36,20,16
Scoon,aegwynn,1595,druid,balance,59,30,29
Odirtytshirt,malganis,1595,druid,balance,55,27,28
Skurts,tichondrius,1594,druid,balance,39,25,14
Blackjésüs,kelthuzad,1594,druid,balance,153,86,67
Drakemaster,aggramar,1593,druid,balance,30,20,10
Faelonk,frostmourne,1592,druid,balance,30,23,7
Boomfire,thaurissan,1592,druid,balance,69,37,32
Kittycleave,tichondrius,1591,druid,balance,30,20,10
Jxrx,malganis,1590,druid,balance,36,22,14
Quefemme,kelthuzad,1590,druid,balance,41,23,18
Quaras,frostmourne,1590,druid,balance,261,138,123
Pissoutside,frostmourne,1589,druid,balance,30,19,11
Abn,sargeras,1588,druid,balance,36,22,14
Nodeathz,sargeras,1588,druid,balance,34,20,14
Skirts,area-52,1587,druid,balance,59,34,25
Zorn,lightnings-blade,1587,druid,balance,77,43,34
Flowérz,illidan,1586,druid,balance,42,24,18
Ligerbomb,bleeding-hollow,1586,druid,balance,30,17,13
Watchugonndo,tichondrius,1585,druid,balance,24,17,7
Druizzy,illidan,1585,druid,balance,54,21,33
Zesto,nazjatar,1584,druid,balance,36,24,12
Verslinker,stormrage,1583,druid,balance,30,17,13
Lunarbalance,veknilash,1583,druid,balance,147,73,74
Bigherbo,zuljin,1582,druid,balance,78,43,35
Cthulhuqt,kelthuzad,1581,druid,balance,24,17,7
Canek,ghostlands,1581,druid,balance,125,70,55
Harlisu,stormrage,1581,druid,balance,68,38,30
Chedisdru,mugthol,1580,druid,balance,48,28,20
Cottonpaw,sargeras,1580,druid,balance,311,171,140
Shîfty,ysondre,1580,druid,balance,65,35,30
Trippyshift,hyjal,1580,druid,balance,60,30,30
Jeanz,bonechewer,1579,druid,balance,36,22,14
Jillferal,proudmoore,1577,druid,balance,102,57,45
Astrals,runetotem,1577,druid,balance,39,21,18
Awazing,illidan,1576,druid,balance,65,30,35
Darach,boulderfist,1575,druid,balance,30,21,9
Druiddruid,daggerspine,1575,druid,balance,71,42,29
Cfp,tichondrius,1575,druid,balance,108,55,53
Yehaw,bloodhoof,1574,druid,balance,66,40,26
Zhinger,tichondrius,1574,druid,balance,97,52,45
Showmanship,tichondrius,1574,druid,balance,164,85,79
Djsummer,tichondrius,1573,druid,balance,131,67,64
Sombrien,stormrage,1573,druid,balance,90,46,44
Moolord,eonar,1572,druid,balance,57,33,24
Nodadpullout,tichondrius,1572,druid,balance,51,25,26
Midnitetoker,hyjal,1572,druid,balance,60,29,31
Beretta,rexxar,1571,druid,balance,90,51,39
Balanci,stormrage,1571,druid,balance,76,40,36
Trapkin,tichondrius,1570,druid,balance,173,102,71
Bugbugz,tichondrius,1570,druid,balance,36,18,18
Starsurgê,tichondrius,1569,druid,balance,66,42,24
Fondra,sargeras,1567,druid,balance,55,32,23
Boxtops,bleeding-hollow,1566,druid,balance,48,32,16
Jruids,stormrage,1566,druid,balance,96,57,39
Atagoo,tichondrius,1566,druid,balance,198,103,95
Draide,dragonblight,1566,druid,balance,55,27,28
Venkin,gnomeregan,1566,druid,balance,96,47,49
Dbanned,nemesis,1564,druid,balance,141,74,67
Groggs,frostwolf,1564,druid,balance,39,20,19
Swoopy,stormrage,1563,druid,balance,79,44,35
Poshspise,nathrezim,1563,druid,balance,42,21,21
Slumpxaddy,illidan,1562,druid,balance,35,21,14
Xiaoshuaigê,illidan,1562,druid,balance,30,18,12
Soupbeandru,zuljin,1561,druid,balance,60,33,27
Fatcowthank,tichondrius,1561,druid,balance,41,19,22
Stargrazing,tichondrius,1560,druid,balance,30,18,12
Cenariun,stormrage,1560,druid,balance,72,37,35
Daddyfresh,ursin,1559,druid,balance,78,47,31
Kitinglol,alexstrasza,1559,druid,balance,86,44,42
Fastlife,drakkari,1559,druid,balance,54,27,27
Ocâ,cenarius,1558,druid,balance,60,36,24
Indicamicah,tichondrius,1558,druid,balance,66,36,30
Ånðrømæðå,sargeras,1558,druid,balance,72,37,35
Moohok,bleeding-hollow,1558,druid,balance,41,21,20
Ghostowl,thrall,1557,druid,balance,83,52,31
Starsurgeon,thrall,1557,druid,balance,167,89,78
Blitzkreigtv,area-52,1555,druid,balance,63,34,29
Syclonez,stormrage,1555,druid,balance,54,27,27
Drunknoodles,stormrage,1554,druid,balance,41,25,16
Neytîrî,tichondrius,1554,druid,balance,113,61,52
Eyzie,stormrage,1554,druid,balance,95,50,45
Hasteley,khadgar,1554,druid,balance,71,34,37
Secodegatø,ragnaros,1553,druid,balance,30,19,11
Slowbleeds,blood-furnace,1553,druid,balance,30,18,12
Empriona,wildhammer,1553,druid,balance,31,18,13
Arnlu,malganis,1553,druid,balance,45,25,20
Thespían,tichondrius,1553,druid,balance,369,193,176
Midoo,proudmoore,1553,druid,balance,48,25,23
Drdrulittle,darkspear,1553,druid,balance,78,40,38
Rashmi,kiljaeden,1552,druid,balance,42,22,20
Meowmixx,frostmane,1551,druid,balance,95,50,45
Afpak,sargeras,1550,druid,balance,78,42,36
Druidlolwtf,area-52,1550,druid,balance,120,59,61
Swiftroots,tichondrius,1548,druid,balance,38,21,17
Starcastic,tichondrius,1548,druid,balance,126,66,60
Boõsty,bleeding-hollow,1548,druid,balance,58,29,29
Hefe,terenas,1547,druid,balance,42,23,19
Lharast,stormrage,1545,druid,balance,34,20,14
Hitchslaps,tichondrius,1545,druid,balance,48,28,20
Pirira,quelthalas,1545,druid,balance,51,29,22
Maplêleaf,moon-guard,1545,druid,balance,229,116,113
Faroo,azralon,1544,druid,balance,57,36,21
Dobrman,sargeras,1544,druid,balance,59,30,29
Hayop,illidan,1543,druid,balance,60,28,32
Sjchicken,tichondrius,1542,druid,balance,42,23,19
Hoagiecannon,moon-guard,1541,druid,balance,167,89,78
Montrá,stormrage,1541,druid,balance,131,62,69
Cringetbh,zuljin,1540,druid,balance,30,17,13
Espoir,azuremyst,1539,druid,balance,30,19,11
Zettka,tichondrius,1539,druid,balance,55,32,23
Cabek,malganis,1539,druid,balance,90,48,42
Donresantis,stormreaver,1539,druid,balance,90,46,44
Myeow,illidan,1539,druid,balance,98,48,50
Qs,rivendare,1539,druid,balance,89,39,50
November,wyrmrest-accord,1538,druid,balance,116,65,51
Hikoro,sargeras,1536,druid,balance,126,74,52
Ïny,emerald-dream,1536,druid,balance,40,21,19
Tanawak,tichondrius,1535,druid,balance,65,29,36
Bullquenepas,dalaran,1534,druid,balance,34,19,15
Jgb,dalaran,1534,druid,balance,30,16,14
Slowreverb,silver-hand,1534,druid,balance,30,16,14
Clense,tichondrius,1533,druid,balance,73,44,29
Metal,jaedenar,1533,druid,balance,67,35,32
Fironous,nerzhul,1532,druid,balance,36,20,16
Slipprypickl,archimonde,1531,druid,balance,42,21,21
Leeteracola,malganis,1530,druid,balance,38,19,19
Gatorskin,sargeras,1529,druid,balance,21,17,4
Basulto,tichondrius,1529,druid,balance,132,72,60
Kg,cenarion-circle,1528,druid,balance,162,93,69
Skrimshaw,burning-legion,1528,druid,balance,95,52,43
Enlil,the-underbog,1528,druid,balance,66,36,30
Brockolini,tichondrius,1528,druid,balance,82,44,38
Reenzy,azralon,1528,druid,balance,181,96,85
Petruccius,nordrassil,1528,druid,balance,249,123,126
Genghisz,area-52,1527,druid,balance,125,66,59
Theshy,tanaris,1525,druid,balance,18,16,2
Jesterdru,area-52,1525,druid,balance,23,17,6
Rabbithomas,malygos,1525,druid,balance,24,16,8
Catahoula,lothar,1525,druid,balance,36,22,14
Shebleeder,aegwynn,1525,druid,balance,60,34,26
Swooped,emerald-dream,1524,druid,balance,65,35,30
Rouse,tichondrius,1523,druid,balance,66,45,21
Wakeenfiendx,sargeras,1522,druid,balance,24,16,8
Slottpocket,malganis,1522,druid,balance,30,17,13
Paddywhacked,tichondrius,1521,druid,balance,42,28,14
Adaptivv,sargeras,1518,druid,balance,30,21,9
Rogsdruid,sargeras,1518,druid,balance,73,32,41
Xiaodlol,tichondrius,1517,druid,balance,24,16,8
Børing,sargeras,1517,druid,balance,81,44,37
Musha,tichondrius,1517,druid,balance,57,30,27
Skyde,sargeras,1517,druid,balance,36,17,19
Faruu,tichondrius,1516,druid,balance,24,16,8
Thorothir,ragnaros,1516,druid,balance,140,77,63
Groovyroom,tichondrius,1516,druid,balance,42,23,19
Yorch,stormrage,1516,druid,balance,77,36,41
Bruddahderpp,tichondrius,1515,druid,balance,54,36,18
Pëps,emerald-dream,1514,druid,balance,48,27,21
Lumala,drakkari,1514,druid,balance,48,27,21
Boompoizan,tichondrius,1514,druid,balance,135,69,66
Ganjácookies,stormrage,1513,druid,balance,40,26,14
Piping,thunderlord,1513,druid,balance,30,17,13
Xevão,nemesis,1512,druid,balance,92,48,44
Mk,caelestrasz,1511,druid,balance,30,17,13
Watchmecap,silvermoon,1510,druid,balance,36,25,11
Luke,ghostlands,1510,druid,balance,24,16,8
Darkombra,frostmourne,1510,druid,balance,66,30,36
Nicenature,gilneas,1508,druid,balance,40,21,19
Hudalu,wyrmrest-accord,1508,druid,balance,42,22,20
Skum,bloodscalp,1508,druid,balance,75,32,43
Polvinhoo,azralon,1507,druid,balance,86,45,41
Velaana,tichondrius,1506,druid,balance,133,65,68
Maimz,tichondrius,1505,druid,balance,145,82,63
Guitarsolos,nagrand,1505,druid,balance,42,22,20
Serega,skywall,1504,druid,balance,36,22,14
Vyrrath,stormrage,1504,druid,balance,32,19,13
Zèrkz,tichondrius,1503,druid,balance,194,107,87
Uckin,bleeding-hollow,1502,druid,balance,30,16,14
Rootchan,azralon,1501,druid,balance,58,38,20
Druuyid,jubeithos,1501,druid,balance,132,73,59
Stennz,tichondrius,1500,druid,balance,24,16,8
Swampduck,saurfang,1500,druid,balance,30,18,12
Kelrelyrare,kiljaeden,1500,druid,balance,36,18,18
Nephdruid,stormrage,1499,druid,balance,98,57,41
Völsüng,tichondrius,1499,druid,balance,90,49,41
Thatscute,moon-guard,1499,druid,balance,368,190,178
Mkong,tichondrius,1499,druid,balance,35,16,19
Kazamura,tichondrius,1499,druid,balance,88,38,50
Koluna,stormrage,1497,druid,balance,42,25,17
Tak,garrosh,1496,druid,balance,36,17,19
Høt,thunderhorn,1495,druid,balance,34,21,13
Nokash,tichondrius,1495,druid,balance,61,26,35
Yoloboomkin,tichondrius,1494,druid,balance,46,23,23
Clonexlt,wyrmrest-accord,1493,druid,balance,64,37,27
Sunmoonkong,area-52,1492,druid,balance,52,28,24
Dmtdruid,tichondrius,1492,druid,balance,53,27,26
Shumarina,mannoroth,1491,druid,balance,60,31,29
Wildsïde,tichondrius,1490,druid,balance,48,28,20
Oo,grizzly-hills,1487,druid,balance,37,24,13
Naurrog,tichondrius,1487,druid,balance,122,72,50
Deathkahn,lightninghoof,1487,druid,balance,90,49,41
Tone,illidan,1487,druid,balance,67,35,32
Cdroo,burning-blade,1486,druid,balance,24,16,8
Lightconvoke,norgannon,1485,druid,balance,50,27,23
Bäñgarang,tichondrius,1484,druid,balance,100,54,46
Umadornahh,malganis,1484,druid,balance,54,28,26
Milkman,mannoroth,1484,druid,balance,42,16,26
Pawpurrazzi,darkspear,1482,druid,balance,53,27,26
Owlgz,barthilas,1482,druid,balance,36,18,18
Dreamkin,tichondrius,1481,druid,balance,84,43,41
Boostgu,illidan,1478,druid,balance,41,24,17
Awkwarder,emerald-dream,1478,druid,balance,207,104,103
Fahnir,ragnaros,1477,druid,balance,72,40,32
Rakex,tichondrius,1477,druid,balance,104,50,54
Ryügähidëki,tichondrius,1476,druid,balance,61,32,29
Tickler,durotan,1476,druid,balance,36,17,19
Kittygoboom,kiljaeden,1476,druid,balance,105,47,58
Seneshy,azralon,1475,druid,balance,48,34,14
Árès,frostmourne,1475,druid,balance,89,48,41
Herbzlova,lightnings-blade,1475,druid,balance,132,67,65
Jawnfurry,tichondrius,1475,druid,balance,60,29,31
Kuwä,proudmoore,1474,druid,balance,72,36,36
Mommybod,stormrage,1472,druid,balance,30,23,7
Gummoo,tichondrius,1472,druid,balance,48,33,15
Milksquirts,thrall,1472,druid,balance,183,96,87
Liñk,sargeras,1471,druid,balance,41,20,21
Yaboydave,stonemaul,1471,druid,balance,72,34,38
Scarymon,tichondrius,1470,druid,balance,81,47,34
Surgingnews,sargeras,1470,druid,balance,54,24,30
Druiddreams,frostmourne,1469,druid,balance,42,30,12
Zukru,malganis,1469,druid,balance,54,32,22
Charnlok,thunderlord,1468,druid,balance,47,31,16
Swagdaddyjr,area-52,1468,druid,balance,48,26,22
Suncintus,aggramar,1468,druid,balance,60,27,33
Grandsoleil,tichondrius,1466,druid,balance,36,17,19
Brettdadad,shandris,1465,druid,balance,36,23,13
Feralownage,malorne,1465,druid,balance,42,25,17
Lavanis,stormrage,1465,druid,balance,235,121,114
Hyperdryve,bonechewer,1464,druid,balance,54,30,24
Famóus,stormrage,1463,druid,balance,28,17,11
Notsofat,deathwing,1463,druid,balance,33,17,16
Fìlø,bleeding-hollow,1461,druid,balance,252,139,113
Windstag,korgath,1461,druid,balance,52,24,28
Rajionu,kiljaeden,1460,druid,balance,30,20,10
Cyeq,blackrock,1460,druid,balance,307,157,150
Thetruetrue,sargeras,1460,druid,balance,84,40,44
Unclenya,barthilas,1460,druid,balance,96,43,53
Wïldmain,area-52,1459,druid,balance,32,20,12
Kyndel,kiljaeden,1459,druid,balance,54,26,28
Nightshàdowz,barthilas,1458,druid,balance,48,27,21
Shiftyn,proudmoore,1457,druid,balance,30,22,8
Lãzy,tichondrius,1456,druid,balance,96,53,43
Jubeam,area-52,1456,druid,balance,36,19,17
Muagor,tichondrius,1454,druid,balance,36,18,18
Thumpb,bronzebeard,1453,druid,balance,30,16,14
Aranuir,emerald-dream,1452,druid,balance,35,20,15
Atmospherè,tichondrius,1452,druid,balance,108,57,51
Queiq,kelthuzad,1452,druid,balance,42,22,20
Redhotbean,tichondrius,1452,druid,balance,101,49,52
Shiftybiznes,black-dragonflight,1451,druid,balance,28,17,11
Thunderhox,tichondrius,1451,druid,balance,67,36,31
Jaduss,thrall,1451,druid,balance,56,29,27
Stormmantlé,moon-guard,1451,druid,balance,35,18,17
Jeezelouise,kelthuzad,1450,druid,balance,38,26,12
Ayelune,stormrage,1450,druid,balance,54,30,24
Cerest,kaelthas,1448,druid,balance,34,21,13
Moonowl,crushridge,1448,druid,balance,66,39,27
Juicywap,proudmoore,1448,druid,balance,47,26,21
Druidlow,azralon,1448,druid,balance,79,41,38
Alucardxd,ragnaros,1448,druid,balance,65,31,34
Whiteseal,frostmourne,1447,druid,balance,49,31,18
Instanodle,proudmoore,1447,druid,balance,36,20,16
Fripp,stormrage,1446,druid,balance,54,28,26
Sileda,nemesis,1445,druid,balance,25,18,7
Isomer,kilrogg,1445,druid,balance,30,18,12
Rdruidchump,the-forgotten-coast,1445,druid,balance,32,19,13
Syntheris,kaelthas,1445,druid,balance,87,51,36
Bighomïe,emerald-dream,1445,druid,balance,48,27,21
Enrÿu,nemesis,1444,druid,balance,45,25,20
Beastsworn,alexstrasza,1443,druid,balance,54,21,33
Clawandørder,tichondrius,1442,druid,balance,26,16,10
Dabomb,malorne,1442,druid,balance,35,21,14
Lepolle,ragnaros,1441,druid,balance,31,21,10
Formmaster,malganis,1441,druid,balance,76,38,38
Gloomcat,illidan,1441,druid,balance,51,24,27
Mctree,cenarius,1440,druid,balance,120,72,48
Shorthorn,mannoroth,1439,druid,balance,97,62,35
Martians,laughing-skull,1439,druid,balance,24,15,9
Nicotinefien,sargeras,1439,druid,balance,24,15,9
Drubuzz,tichondrius,1439,druid,balance,102,56,46
Markers,gorefiend,1438,druid,balance,24,15,9
Armorkits,area-52,1438,druid,balance,24,15,9
Finntröll,area-52,1438,druid,balance,76,41,35
Mommyx,stormrage,1438,druid,balance,72,36,36
Ylanglang,sargeras,1437,druid,balance,18,15,3
Elvishrage,zuljin,1437,druid,balance,18,15,3
Taekdonuttv,tichondrius,1436,druid,balance,17,16,1
Wombatform,malganis,1436,druid,balance,24,15,9
Softdog,stormrage,1436,druid,balance,70,38,32
Timdillon,emerald-dream,1436,druid,balance,36,19,17
Roundtummy,area-52,1436,druid,balance,108,54,54
Reconus,frostmourne,1435,druid,balance,24,15,9
Zuice,thrall,1435,druid,balance,91,45,46
Chonkykitty,frostmourne,1434,druid,balance,36,23,13
Envoy,sargeras,1434,druid,balance,72,39,33
Falkond,tichondrius,1433,druid,balance,35,18,17
Squidwonk,sargeras,1433,druid,balance,48,23,25
Arealdruid,moon-guard,1433,druid,balance,42,18,24
Kallabaluwa,azralon,1433,druid,balance,59,25,34
Qelthalas,sargeras,1432,druid,balance,282,147,135
Shapedance,sargeras,1431,druid,balance,35,16,19
Zgg,ragnaros,1431,druid,balance,42,17,25
Øutcast,malganis,1430,druid,balance,77,41,36
Catatonik,emerald-dream,1430,druid,balance,36,15,21
Ðjx,stormrage,1429,druid,balance,37,28,9
Trollsmind,tichondrius,1429,druid,balance,58,34,24
Ularda,bleeding-hollow,1428,druid,balance,48,28,20
Bâzinga,bleeding-hollow,1428,druid,balance,59,33,26
Gønkh,quelthalas,1428,druid,balance,51,26,25
Sakurao,tichondrius,1428,druid,balance,42,17,25
Illilydan,tichondrius,1427,druid,balance,151,78,73
Raximus,moon-guard,1427,druid,balance,90,46,44
Bearserk,rexxar,1427,druid,balance,78,36,42
Alecxeon,tichondrius,1426,druid,balance,72,40,32
Buyadoge,area-52,1426,druid,balance,40,18,22
Livilla,sargeras,1425,druid,balance,53,29,24
Yaboidakota,stormrage,1425,druid,balance,177,92,85
Spawnolyonce,gorefiend,1425,druid,balance,59,30,29
Therooster,whisperwind,1425,druid,balance,53,22,31
Spicydurid,tichondrius,1424,druid,balance,38,18,20
Miviaris,alleria,1424,druid,balance,60,26,34
Ono,daggerspine,1423,druid,balance,24,15,9
Mèowcenaary,chogall,1423,druid,balance,60,35,25
Sammio,emerald-dream,1423,druid,balance,110,57,53
Kawshuhn,bleeding-hollow,1422,druid,balance,115,65,50
Meatcat,sargeras,1421,druid,balance,30,16,14
Tankzsz,malganis,1421,druid,balance,30,15,15
Ralphrawr,barthilas,1419,druid,balance,36,15,21
Hornny,shattered-hand,1418,druid,balance,24,15,9
Solarcannon,shuhalo,1418,druid,balance,195,105,90
Chakrabeam,kelthuzad,1417,druid,balance,48,22,26
Skêet,tichondrius,1417,druid,balance,66,29,37
Axiomisop,tichondrius,1416,druid,balance,59,35,24
Crocface,tichondrius,1415,druid,balance,66,38,28
Styless,azjolnerub,1415,druid,balance,78,43,35
Jâykeup,lightbringer,1415,druid,balance,114,62,52
Bâgheera,sargeras,1413,druid,balance,30,20,10
Atherra,sargeras,1413,druid,balance,145,84,61
Balverixqt,tichondrius,1413,druid,balance,42,20,22
Deathprofit,thrall,1413,druid,balance,36,16,20
Swapclone,sargeras,1413,druid,balance,60,20,40
Rootyou,frostmourne,1412,druid,balance,24,15,9
Highbye,area-52,1412,druid,balance,39,23,16
Bluechew,bleeding-hollow,1412,druid,balance,32,18,14
Monsin,illidan,1412,druid,balance,180,91,89
Gullmock,quelthalas,1412,druid,balance,78,35,43
Nothanxx,dalaran,1411,druid,balance,30,15,15
Repanda,proudmoore,1411,druid,balance,158,78,80
Jainzar,dreadmaul,1411,druid,balance,63,30,33
Seannybhoy,emerald-dream,1411,druid,balance,63,27,36
Wiiee,darkspear,1410,druid,balance,80,48,32
Dalsardirn,sargeras,1410,druid,balance,30,17,13
Siberian,lightnings-blade,1410,druid,balance,90,45,45
Sítkä,ragnaros,1410,druid,balance,45,22,23
Feroz,frostmourne,1409,druid,balance,24,15,9
Coorvinus,stormrage,1409,druid,balance,36,18,18
Diligent,dathremar,1408,druid,balance,30,15,15
Abzuri,kiljaeden,1408,druid,balance,36,17,19
Dontfloodit,tichondrius,1408,druid,balance,134,63,71
Notwhaaz,area-52,1408,druid,balance,72,28,44
Boombot,proudmoore,1407,druid,balance,32,17,15
Pavati,bleeding-hollow,1407,druid,balance,61,31,30
Schwenkyytv,sargeras,1407,druid,balance,30,15,15
Maviç,hyjal,1407,druid,balance,123,59,64
Dahts,destromath,1405,druid,balance,60,37,23
Shiftybuga,frostmourne,1404,druid,balance,21,16,5
Rocee,illidan,1404,druid,balance,79,47,32
Mythelian,icecrown,1403,druid,balance,72,42,30
Vicorin,illidan,1402,druid,balance,30,17,13
Alshari,proudmoore,1402,druid,balance,72,39,33
Ghoouul,tichondrius,1402,druid,balance,47,21,26
Moorgasmic,tichondrius,1400,druid,balance,51,23,28
Dtefy,ragnaros,1399,druid,balance,18,15,3
Cudbacrakhed,tichondrius,1399,druid,balance,48,27,21
Cien,thrall,1399,druid,balance,153,79,74
Brawndiboom,stormrage,1399,druid,balance,127,64,63
Dkat,malganis,1397,druid,balance,90,50,40
Nightstalkr,kelthuzad,1397,druid,balance,210,110,100
Arescarriess,shuhalo,1397,druid,balance,53,25,28
Hosehead,malganis,1396,druid,balance,110,63,47
Justinheras,area-52,1396,druid,balance,100,55,45
Ulcera,nemesis,1396,druid,balance,33,17,16
Aesthetical,frostmourne,1396,druid,balance,30,15,15
Squidrific,tichondrius,1395,druid,balance,77,49,28
Healthycow,illidan,1395,druid,balance,30,15,15
Knoxella,moon-guard,1394,druid,balance,157,83,74
Sallyshifts,area-52,1394,druid,balance,86,40,46
Haneulso,tichondrius,1393,druid,balance,267,138,129
Yseraspawn,kelthuzad,1392,druid,balance,42,21,21
Trickatreyy,kelthuzad,1392,druid,balance,43,21,22
Breynna,draenor,1391,druid,balance,53,28,25
Goldzin,stormrage,1388,druid,balance,33,18,15
Fluff,gurubashi,1388,druid,balance,30,15,15
Duakx,malganis,1388,druid,balance,36,17,19
Narthurs,ragnaros,1387,druid,balance,66,31,35
Clawriander,barthilas,1385,druid,balance,95,43,52
Grymdruid,wyrmrest-accord,1384,druid,balance,24,17,7
Amv,tichondrius,1384,druid,balance,42,21,21
Saltbae,velen,1384,druid,balance,37,16,21
Bigbeugs,frostmourne,1382,druid,balance,36,19,17
Driftwood,bonechewer,1381,druid,balance,53,30,23
Envasions,emerald-dream,1380,druid,balance,24,15,9
Campdoctor,azralon,1380,druid,balance,32,18,14
Capybara,nerzhul,1380,druid,balance,29,15,14
Atsiri,tichondrius,1380,druid,balance,41,20,21
Alliess,aerie-peak,1379,druid,balance,129,63,66
Jiya,zuljin,1379,druid,balance,48,18,30
Moonfart,zuljin,1378,druid,balance,161,81,80
Nanashi,tichondrius,1378,druid,balance,30,15,15
Roshaka,shadowmoon,1378,druid,balance,36,17,19
Slyfoxx,stonemaul,1375,druid,balance,104,58,46
Huskars,tichondrius,1375,druid,balance,48,26,22
Alwind,alleria,1375,druid,balance,129,62,67
Shemeus,malganis,1374,druid,balance,54,27,27
Mørphea,darkspear,1374,druid,balance,36,15,21
Barrahjr,frostmourne,1373,druid,balance,63,34,29
Furocious,shadowsong,1372,druid,balance,24,15,9
Starsaber,dalaran,1372,druid,balance,42,24,18
Daddymaple,tichondrius,1371,druid,balance,70,32,38
Volddy,tichondrius,1370,druid,balance,83,51,32
Petitjeremy,zuljin,1369,druid,balance,36,15,21
Indoee,mannoroth,1368,druid,balance,168,81,87
Pneumashift,tichondrius,1367,druid,balance,24,18,6
Asteriel,stormrage,1367,druid,balance,54,24,30
Airinsurgent,stormrage,1367,druid,balance,44,18,26
Binnchook,barthilas,1366,druid,balance,31,19,12
Prebark,sargeras,1366,druid,balance,27,16,11
Shadowformer,kelthuzad,1366,druid,balance,27,16,11
Graffsworth,emerald-dream,1366,druid,balance,140,71,69
Skagakr,moon-guard,1366,druid,balance,131,65,66
Stormaggedon,dalvengyr,1365,druid,balance,66,35,31
Apex,terenas,1365,druid,balance,54,24,30
Barekat,emerald-dream,1364,druid,balance,46,28,18
Throatjelly,blackrock,1363,druid,balance,48,26,22
Audacities,bloodhoof,1363,druid,balance,64,34,30
Leonardsby,tichondrius,1363,druid,balance,67,33,34
Eldenis,drakkari,1359,druid,balance,112,59,53
Jáguar,frostmourne,1358,druid,balance,71,40,31
Nuppxx,frostmourne,1356,druid,balance,30,20,10
Katobe,tichondrius,1355,druid,balance,36,19,17
Prismo,ravencrest,1354,druid,balance,54,28,26
Gepardéx,ragnaros,1354,druid,balance,240,118,122
Jynxy,sargeras,1353,druid,balance,47,23,24
Sofereir,frostmourne,1353,druid,balance,167,81,86
Snailbeam,shattered-hand,1353,druid,balance,54,21,33
Mercz,illidan,1352,druid,balance,58,37,21
Stärfäll,frostmourne,1351,druid,balance,24,17,7
Slimeyjoe,moon-guard,1351,druid,balance,90,51,39
Nebulose,moon-guard,1351,druid,balance,71,29,42
Tahnu,deathwing,1350,druid,balance,23,15,8
Itchyrat,moon-guard,1350,druid,balance,36,19,17
Ðementia,stormrage,1349,druid,balance,42,18,24
Lydariel,tichondrius,1348,druid,balance,94,60,34
Jonoa,nagrand,1348,druid,balance,120,67,53
Slingin,illidan,1348,druid,balance,66,32,34
Rezstars,tichondrius,1347,druid,balance,92,52,40
Regnier,burning-blade,1346,druid,balance,95,46,49
Rudar,sargeras,1344,druid,balance,24,14,10
Ironbark,azuremyst,1344,druid,balance,33,15,18
Dekmdrui,quelthalas,1343,druid,balance,21,16,5
Flapping,illidan,1343,druid,balance,24,14,10
Ehloheim,stormrage,1342,druid,balance,24,14,10
Gitsnshigles,frostmourne,1342,druid,balance,49,25,24
Ascension,emerald-dream,1341,druid,balance,48,27,21
Flôkey,tichondrius,1341,druid,balance,48,25,23
Starfallgg,sargeras,1340,druid,balance,18,14,4
Xoicowboy,tichondrius,1340,druid,balance,18,14,4
Hollyberry,hyjal,1340,druid,balance,58,31,27
Datdruidrod,illidan,1340,druid,balance,114,60,54
Deegawn,proudmoore,1340,druid,balance,30,15,15
Maulinyou,whisperwind,1339,druid,balance,36,20,16
Tanguanota,quelthalas,1339,druid,balance,114,55,59
Purv,tichondrius,1339,druid,balance,42,19,23
Töm,durotan,1338,druid,balance,90,35,55
Kïte,drakkari,1337,druid,balance,31,15,16
Babybite,frostmourne,1336,druid,balance,24,14,10
Verelyris,nordrassil,1335,druid,balance,18,14,4
Saturday,frostmourne,1335,druid,balance,35,24,11
Runhe,zuljin,1335,druid,balance,58,33,25
Wondercat,illidan,1334,druid,balance,24,14,10
Mntra,emerald-dream,1334,druid,balance,24,14,10
Panqwa,thrall,1334,druid,balance,63,31,32
Egotistic,tichondrius,1333,druid,balance,24,14,10
Imnotinhuman,tichondrius,1333,druid,balance,41,22,19
Droody,earthen-ring,1333,druid,balance,40,20,20
Yungterp,zuljin,1332,druid,balance,18,14,4
Calfurion,stormscale,1331,druid,balance,18,14,4
Deths,frostmourne,1331,druid,balance,36,22,14
Hautheurel,illidan,1330,druid,balance,18,14,4
Thiccyiff,frostmourne,1330,druid,balance,54,32,22
Medibull,tichondrius,1330,druid,balance,24,14,10
Boomkinks,moon-guard,1330,druid,balance,36,15,21
Koreanboom,tichondrius,1329,druid,balance,24,14,10
Birdmandaddy,bleeding-hollow,1329,druid,balance,24,14,10
Ghostxkillaz,antonidas,1329,druid,balance,37,16,21
Droodad,mannoroth,1329,druid,balance,36,14,22
Zùnma,tichondrius,1328,druid,balance,24,14,10
Salvattor,stormrage,1327,druid,balance,44,30,14
Pepperpawz,emerald-dream,1327,druid,balance,24,14,10
Teladrizzle,dalaran,1326,druid,balance,35,16,19
Redwallon,emerald-dream,1325,druid,balance,24,15,9
Pecopeco,sargeras,1325,druid,balance,30,14,16
Renamebdsm,cenarius,1324,druid,balance,30,14,16
Durdern,barthilas,1323,druid,balance,75,47,28
Vicvc,tichondrius,1323,druid,balance,95,53,42
Haxzr,sargeras,1321,druid,balance,60,35,25
Icancarryyou,darkspear,1321,druid,balance,24,14,10
Nerzert,sargeras,1321,druid,balance,30,14,16
Chupappi,tichondrius,1321,druid,balance,42,17,25
Bouffecul,zuljin,1318,druid,balance,54,28,26
Lucidkiaru,moon-guard,1317,druid,balance,37,19,18
Winekoolers,malganis,1317,druid,balance,54,27,27
Justwade,tichondrius,1316,druid,balance,36,19,17
Limikeen,bleeding-hollow,1316,druid,balance,42,18,24
Talinel,illidan,1315,druid,balance,36,14,22
Saeval,korgath,1314,druid,balance,93,47,46
Lavenderowl,arthas,1313,druid,balance,66,36,30
Rosalba,zuljin,1312,druid,balance,57,33,24
Thecovid,illidan,1312,druid,balance,161,82,79
Hypernovax,tichondrius,1312,druid,balance,46,17,29
Réko,sargeras,1311,druid,balance,46,26,20
Evilakali,tichondrius,1311,druid,balance,49,27,22
Ernest,goldrinn,1311,druid,balance,70,34,36
Druidmf,sargeras,1310,druid,balance,24,14,10
Theirs,tichondrius,1310,druid,balance,176,97,79
Snw,sargeras,1309,druid,balance,36,14,22
Orkinetvx,frostmourne,1308,druid,balance,67,42,25
Stepdru,sargeras,1308,druid,balance,26,14,12
Hamïlton,ragnaros,1308,druid,balance,109,52,57
Côheed,bleeding-hollow,1308,druid,balance,60,22,38
Firesun,quelthalas,1307,druid,balance,33,22,11
Amanara,echo-isles,1307,druid,balance,101,48,53
Msparker,illidan,1306,druid,balance,60,19,41
Fugginskoden,twisting-nether,1305,druid,balance,23,14,9
Drewpg,zuljin,1305,druid,balance,24,14,10
Vallk,area-52,1304,druid,balance,26,15,11
Deez,korgath,1304,druid,balance,56,23,33
Bdsurges,illidan,1303,druid,balance,21,15,6
Treemendous,nemesis,1303,druid,balance,30,14,16
Annef,tichondrius,1302,druid,balance,44,21,23
Nucleardruid,khadgar,1302,druid,balance,36,17,19
Treezús,thrall,1300,druid,balance,76,38,38
Iceingdeath,dalaran,1300,druid,balance,36,18,18
Meekgrylls,frostmourne,1300,druid,balance,58,27,31
Mofoogoo,laughing-skull,1299,druid,balance,48,18,30
Noteff,illidan,1298,druid,balance,42,24,18
Alagoano,azralon,1297,druid,balance,98,62,36
Shiffterzz,tichondrius,1295,druid,balance,36,21,15
Yoshinorii,tichondrius,1295,druid,balance,54,24,30
Smitenkiten,baelgun,1295,druid,balance,52,23,29
Draden,moknathal,1293,druid,balance,42,21,21
Lükê,tichondrius,1292,druid,balance,39,14,25
Shifterx,illidan,1290,druid,balance,34,18,16
Immortalwild,tichondrius,1289,druid,balance,181,93,88
Andrés,azralon,1288,druid,balance,30,18,12
Thickmoo,tichondrius,1288,druid,balance,93,43,50
Uuli,area-52,1287,druid,balance,24,16,8
Torhok,azralon,1287,druid,balance,30,17,13
Raknary,kelthuzad,1287,druid,balance,48,23,25
Stupidranga,barthilas,1286,druid,balance,54,29,25
Minusdruid,dalaran,1286,druid,balance,117,57,60
Fourthkind,illidan,1285,druid,balance,30,18,12
Crazystorm,ragnaros,1284,druid,balance,72,43,29
Lokdu,area-52,1284,druid,balance,30,15,15
Upps,kelthuzad,1283,druid,balance,24,16,8
Rahkaaga,kiljaeden,1283,druid,balance,57,36,21
Xodz,sargeras,1282,druid,balance,42,21,21
Shivlary,stormrage,1280,druid,balance,75,44,31
Beastmanqq,kiljaeden,1280,druid,balance,28,15,13
Barrah,barthilas,1280,druid,balance,70,34,36
Kasparhauser,illidan,1280,druid,balance,36,14,22
Nimfaa,nemesis,1279,druid,balance,36,21,15
Druidoy,tichondrius,1279,druid,balance,36,21,15
Bwokhanji,proudmoore,1279,druid,balance,54,30,24
Beal,azgalor,1279,druid,balance,93,41,52
Sergat,stormreaver,1276,druid,balance,66,33,33
Jinglebells,kiljaeden,1275,druid,balance,54,30,24
Édzar,area-52,1275,druid,balance,93,47,46
Torrwin,area-52,1275,druid,balance,88,42,46
Doomstar,malganis,1274,druid,balance,30,16,14
Floote,thrall,1274,druid,balance,85,40,45
Hanaak,illidan,1273,druid,balance,23,14,9
Exillïs,frostmourne,1273,druid,balance,51,26,25
Zeanasfaratu,spinebreaker,1273,druid,balance,45,19,26
Softshirtxo,ragnaros,1271,druid,balance,24,14,10
Quincunx,tichondrius,1270,druid,balance,136,74,62
Odweaven,thunderlord,1270,druid,balance,76,35,41
Jashyd,tichondrius,1269,druid,balance,33,22,11
Mukay,stormrage,1269,druid,balance,52,20,32
Pooöòôp,kiljaeden,1268,druid,balance,47,27,20
Solaress,moon-guard,1268,druid,balance,48,23,25
Sochin,nemesis,1267,druid,balance,90,49,41
Pandajerk,tichondrius,1266,druid,balance,94,53,41
Scoobyshiftz,frostmourne,1265,druid,balance,47,26,21
Lønewolf,sargeras,1265,druid,balance,77,38,39
Shuxz,sargeras,1264,druid,balance,66,36,30
Lavanca,azralon,1262,druid,balance,36,16,20
Druidma,aegwynn,1260,druid,balance,26,16,10
Muscelmilk,tichondrius,1258,druid,balance,51,25,26
Hugedumbcow,area-52,1257,druid,balance,65,37,28
Furu,bonechewer,1254,druid,balance,78,36,42
Kuroshizen,tichondrius,1252,druid,balance,110,48,62
Pãl,quelthalas,1251,druid,balance,42,24,18
Sunboy,tichondrius,1250,druid,balance,85,43,42
Rigotakz,illidan,1249,druid,balance,51,24,27
Råstafart,tichondrius,1248,druid,balance,53,26,27
Marcee,frostmourne,1248,druid,balance,32,15,17
Acidmoon,tichondrius,1248,druid,balance,58,26,32
Hugodruid,frostmourne,1247,druid,balance,24,13,11
Jaegerbombx,sargeras,1246,druid,balance,18,13,5
Galeshift,stormrage,1246,druid,balance,18,13,5
Lawlz,aegwynn,1246,druid,balance,51,28,23
Daspd,tichondrius,1246,druid,balance,24,13,11
Veganmom,zuluhed,1246,druid,balance,24,13,11
Dirtdog,uther,1246,druid,balance,24,13,11
Kûramä,dalaran,1246,druid,balance,24,13,11
Rslm,tichondrius,1246,druid,balance,43,21,22
Antiherø,sargeras,1245,druid,balance,18,13,5
Ungreed,tichondrius,1245,druid,balance,42,20,22
Hucklebeary,terokkar,1245,druid,balance,50,23,27
Drakeowl,area-52,1244,druid,balance,18,13,5
Purrfessorx,proudmoore,1243,druid,balance,18,13,5
Lunapuma,stonemaul,1243,druid,balance,24,15,9
Floridajoe,blackrock,1243,druid,balance,106,60,46
Spudpatikins,barthilas,1243,druid,balance,30,14,16
Asmodium,frostmourne,1243,druid,balance,57,23,34
Oldcreg,emerald-dream,1242,druid,balance,18,13,5
Hyzah,tichondrius,1242,druid,balance,24,13,11
Zebyn,tichondrius,1241,druid,balance,24,13,11
Avishominem,magtheridon,1241,druid,balance,24,13,11
Sneakichode,tichondrius,1241,druid,balance,26,14,12
Critthisbruh,stormrage,1240,druid,balance,85,46,39
Monicaduan,frostmourne,1239,druid,balance,38,19,19
Xornhxb,tichondrius,1238,druid,balance,18,13,5
Erealana,tichondrius,1238,druid,balance,24,13,11
Girthygramps,sargeras,1238,druid,balance,24,13,11
Guojue,tichondrius,1237,druid,balance,46,25,21
Gudkittykat,aggramar,1236,druid,balance,24,13,11
Hootie,arygos,1235,druid,balance,51,21,30
Iluvbae,bleeding-hollow,1234,druid,balance,37,17,20
Astrixx,frostmourne,1233,druid,balance,18,13,5
Goofyfoot,wyrmrest-accord,1232,druid,balance,100,51,49
Tryrah,shattered-hand,1229,druid,balance,30,13,17
Twanheal,kiljaeden,1228,druid,balance,36,21,15
Sugarflower,tichondrius,1228,druid,balance,24,13,11
Havôç,tichondrius,1228,druid,balance,78,28,50
Kudro,garithos,1227,druid,balance,102,48,54
Basilix,moon-guard,1226,druid,balance,63,30,33
Vorare,tichondrius,1225,druid,balance,26,14,12
Zentabra,proudmoore,1225,druid,balance,42,18,24
Ssïp,tichondrius,1223,druid,balance,31,14,17
Giantmoobies,zuluhed,1222,druid,balance,24,13,11
Morphkow,sargeras,1222,druid,balance,69,36,33
Bluethebull,lothar,1222,druid,balance,51,17,34
Luthienne,draktharon,1221,druid,balance,30,13,17
Nefnef,malganis,1221,druid,balance,30,13,17
Partydip,stormrage,1221,druid,balance,30,13,17
Apoc,bleeding-hollow,1220,druid,balance,18,13,5
Levincy,thrall,1220,druid,balance,75,42,33
Xoth,executus,1220,druid,balance,30,15,15
Imshiftastic,area-52,1220,druid,balance,124,60,64
Mooing,azralon,1219,druid,balance,28,19,9
Jackalman,tanaris,1218,druid,balance,72,41,31
Pokémon,grizzly-hills,1218,druid,balance,24,13,11
Strallà,illidan,1217,druid,balance,96,49,47
Flatnose,agamaggan,1216,druid,balance,30,13,17
Mutlèy,gundrak,1215,druid,balance,18,13,5
Vuginas,bleeding-hollow,1215,druid,balance,62,33,29
Worldbullguy,area-52,1215,druid,balance,36,16,20
Feralchild,emerald-dream,1214,druid,balance,54,28,26
Hawkk,azralon,1214,druid,balance,80,36,44
Judgedruid,scilla,1213,druid,balance,36,22,14
Cimanin,malganis,1213,druid,balance,24,13,11
Sodapoopins,stormrage,1213,druid,balance,72,28,44
Lindzy,moon-guard,1210,druid,balance,78,43,35
Elpako,ragnaros,1208,druid,balance,54,23,31
Kyabe,ragnaros,1208,druid,balance,103,43,60
Kattel,blackrock,1207,druid,balance,150,77,73
Bayaba,tichondrius,1206,druid,balance,24,14,10
Mufaasa,boulderfist,1204,druid,balance,96,50,46
Lazerchicken,boulderfist,1204,druid,balance,30,13,17
Bobedroods,bonechewer,1203,druid,balance,31,16,15
Tankbareass,aerie-peak,1203,druid,balance,42,16,26
Huoxiaoying,tichondrius,1202,druid,balance,36,21,15
Pleasepime,stormrage,1202,druid,balance,84,35,49
Dweralin,nemesis,1202,druid,balance,46,16,30
Bobtail,moon-guard,1201,druid,balance,19,15,4
Drßoom,stormrage,1201,druid,balance,89,38,51
Thehooligan,stormrage,1200,druid,balance,75,41,34
Eintier,tichondrius,1200,druid,balance,35,19,16
Vaalser,frostmourne,1196,druid,balance,71,31,40
Chillcat,illidan,1194,druid,balance,18,14,4
Rabbismang,area-52,1194,druid,balance,48,15,33
Shiftzy,thrall,1193,druid,balance,22,14,8
Tabbo,uther,1193,druid,balance,42,22,20
Nolifer,sargeras,1192,druid,balance,30,17,13
Tmoby,emerald-dream,1190,druid,balance,30,14,16
Crashägásm,proudmoore,1190,druid,balance,67,30,37
Chillygraves,stormrage,1188,druid,balance,48,16,32
Dampnr,tichondrius,1186,druid,balance,30,14,16
Overfunk,ragnaros,1186,druid,balance,48,22,26
Maxable,alleria,1184,druid,balance,27,14,13
Gazwazluz,lothar,1183,druid,balance,51,31,20
Lunarstone,tichondrius,1182,druid,balance,23,13,10
Bigboðm,tichondrius,1181,druid,balance,54,25,29
Zelyvia,moon-guard,1181,druid,balance,31,14,17
Volatus,emerald-dream,1180,druid,balance,23,13,10
Xvenusaur,bleeding-hollow,1179,druid,balance,24,16,8
Stringbeáns,tanaris,1179,druid,balance,42,21,21
Muhana,runetotem,1178,druid,balance,30,15,15
Thorsèn,sargeras,1175,druid,balance,48,25,23
Chodkiewicz,echo-isles,1174,druid,balance,30,14,16
Nobullshift,icecrown,1171,druid,balance,50,27,23
Aberdare,tichondrius,1169,druid,balance,29,13,16
Sÿd,sargeras,1169,druid,balance,30,13,17
Trythis,tichondrius,1167,druid,balance,61,28,33
Coggtron,uther,1166,druid,balance,30,20,10
Blackmoons,thunderlord,1166,druid,balance,42,15,27
Alphakatt,area-52,1165,druid,balance,84,38,46
Dirtydot,ragnaros,1164,druid,balance,24,14,10
Redbbull,tichondrius,1164,druid,balance,79,43,36
Ryxu,emerald-dream,1161,druid,balance,26,15,11
Simeron,silvermoon,1161,druid,balance,29,13,16
Psnárf,area-52,1159,druid,balance,24,14,10
Mihnt,sargeras,1158,druid,balance,40,14,26
Manglehornn,dalaran,1157,druid,balance,32,16,16
Naturlig,area-52,1156,druid,balance,36,19,17
Mambuz,tichondrius,1154,druid,balance,66,35,31
Dojacow,mannoroth,1154,druid,balance,34,16,18
Metik,frostmourne,1152,druid,balance,18,12,6
Kitem,tichondrius,1152,druid,balance,24,12,12
Hllw,tichondrius,1152,druid,balance,24,12,12
Ballnout,zuljin,1151,druid,balance,18,12,6
Katbriel,zuljin,1151,druid,balance,18,12,6
Manofhisword,malganis,1151,druid,balance,18,12,6
Rougaroux,andorhal,1151,druid,balance,18,12,6
Scraww,tichondrius,1151,druid,balance,29,14,15
Suurik,blackhand,1151,druid,balance,28,13,15
Prøspect,moon-guard,1150,druid,balance,18,12,6
Kniitvekitta,jubeithos,1150,druid,balance,72,39,33
Buckeye,tichondrius,1150,druid,balance,24,12,12
Borrdru,arthas,1150,druid,balance,24,12,12
Mcy,nerzhul,1150,druid,balance,24,12,12
Jaspen,bleeding-hollow,1149,druid,balance,18,12,6
Bigmilky,bloodhoof,1149,druid,balance,18,12,6
Bozart,stormrage,1149,druid,balance,26,13,13
Numbkin,stormrage,1149,druid,balance,30,12,18
Maserati,emerald-dream,1148,druid,balance,18,12,6
Ogdöstitz,area-52,1148,druid,balance,20,12,8
Slep,tichondrius,1148,druid,balance,25,13,12
Uggadruid,malganis,1148,druid,balance,24,12,12
Minxminx,moon-guard,1147,druid,balance,58,20,38
Exxosd,tichondrius,1146,druid,balance,18,12,6
Jocek,stormrage,1146,druid,balance,18,12,6
Coppersnout,moon-guard,1146,druid,balance,66,37,29
Pigmanbear,kelthuzad,1145,druid,balance,36,13,23
Goonrip,frostmourne,1144,druid,balance,18,12,6
Chillaxin,gundrak,1144,druid,balance,21,13,8
Roots,boulderfist,1144,druid,balance,30,13,17
Gravshift,zuljin,1143,druid,balance,18,12,6
Ganh,demon-soul,1142,druid,balance,24,14,10
Sìrfüzzy,proudmoore,1142,druid,balance,24,12,12
Druisole,zuljin,1141,druid,balance,97,42,55
ßullx,quelthalas,1141,druid,balance,66,28,38
Radagaste,stormrage,1139,druid,balance,24,12,12
Leetpete,eitrigg,1138,druid,balance,24,12,12
Jawsbar,tichondrius,1138,druid,balance,30,12,18
Aozeh,kiljaeden,1136,druid,balance,18,12,6
Kuthian,moon-guard,1135,druid,balance,42,19,23
Furrycringe,stormrage,1135,druid,balance,30,12,18
Hootyhoot,illidan,1133,druid,balance,18,12,6
Zoomchicken,stormrage,1132,druid,balance,18,12,6
Dumdumdugan,korgath,1130,druid,balance,137,66,71
Thebass,spinebreaker,1129,druid,balance,24,12,12
Meowfacebby,stormrage,1128,druid,balance,23,12,11
Aolus,kaelthas,1128,druid,balance,74,36,38
Treeteej,kelthuzad,1128,druid,balance,36,16,20
Elatheris,stormrage,1126,druid,balance,30,14,16
Abzyplasm,sargeras,1124,druid,balance,30,16,14
Lacroix,wildhammer,1123,druid,balance,30,20,10
Iamatomic,illidan,1123,druid,balance,149,73,76
Dennyyd,illidan,1118,druid,balance,24,16,8
Burninmôön,tichondrius,1118,druid,balance,35,12,23
Toofast,lightninghoof,1114,druid,balance,18,12,6
Smashthatbox,illidan,1113,druid,balance,44,17,27
Seytu,sargeras,1112,druid,balance,26,13,13
Ilgalsard,frostmourne,1109,druid,balance,36,16,20
Møønscar,tichondrius,1108,druid,balance,76,33,43
Dodid,laughing-skull,1105,druid,balance,66,32,34
Ûñø,frostmourne,1101,druid,balance,42,24,18
Schnitter,thrall,1099,druid,balance,29,12,17
Elsombrak,onyxia,1095,druid,balance,24,14,10
Krazykritz,illidan,1090,druid,balance,27,13,14
Bvó,stormrage,1090,druid,balance,29,12,17
Moistcream,tichondrius,1087,druid,balance,21,12,9
Zeromeme,frostmourne,1086,druid,balance,20,12,8
Luipu,elune,1086,druid,balance,24,12,12
Treelouco,tol-barad,1081,druid,balance,36,17,19
Wyldthangz,stormrage,1077,druid,balance,26,12,14
Nozgöth,quelthalas,1076,druid,balance,152,78,74
Pilaufakka,zuljin,1074,druid,balance,36,19,17
Bluechicken,sargeras,1065,druid,balance,30,17,13
Klyadedfogud,trollbane,1063,druid,balance,41,22,19
Macpoulet,aggramar,1062,druid,balance,22,12,10
Malamew,antonidas,1061,druid,balance,24,15,9
Plopperoo,caelestrasz,1058,druid,balance,44,15,29
Bulldog,runetotem,1057,druid,balance,18,12,6
Drdoomerkin,area-52,1056,druid,balance,12,11,1
Roccko,illidan,1056,druid,balance,18,11,7
Arwëna,tichondrius,1055,druid,balance,12,11,1
Docleave,tichondrius,1055,druid,balance,18,11,7
Slys,frostmourne,1055,druid,balance,18,11,7
Mastahskills,illidan,1055,druid,balance,18,11,7
Juìcedbro,illidan,1055,druid,balance,18,11,7
Piment,tichondrius,1055,druid,balance,18,11,7
Smwise,tichondrius,1055,druid,balance,18,11,7
Atreis,malganis,1054,druid,balance,18,11,7
Shînx,malganis,1054,druid,balance,18,11,7
Ryannshiftz,proudmoore,1054,druid,balance,18,11,7
Buffclyde,blackrock,1054,druid,balance,18,11,7
Cumvokinlol,sargeras,1054,druid,balance,18,11,7
Kimgurdian,tichondrius,1053,druid,balance,18,11,7
Johnnybigg,barthilas,1053,druid,balance,18,11,7
Lesbianitax,stormrage,1052,druid,balance,18,11,7
Jacinty,saurfang,1052,druid,balance,18,11,7
Ephwürd,malganis,1052,druid,balance,24,11,13
Milkshift,demon-soul,1051,druid,balance,24,11,13
Fjblol,sargeras,1051,druid,balance,24,11,13
Samsshifter,tichondrius,1050,druid,balance,24,11,13
Àbyss,moon-guard,1049,druid,balance,18,11,7
Fedidão,azralon,1049,druid,balance,24,11,13
Oakmont,darkspear,1049,druid,balance,24,11,13
Ramannoodlr,tichondrius,1049,druid,balance,24,11,13
Trashytrash,bleeding-hollow,1049,druid,balance,30,11,19
Merquiades,drakkari,1048,druid,balance,18,11,7
Zhuaraksha,kelthuzad,1048,druid,balance,24,11,13
Shavedtaco,azshara,1047,druid,balance,12,11,1
Cleppy,korgath,1047,druid,balance,18,11,7
Sekzor,darkspear,1047,druid,balance,18,11,7
Wídëwínkër,thrall,1047,druid,balance,18,11,7
Chikenflu,tichondrius,1047,druid,balance,22,11,11
Mäya,jubeithos,1047,druid,balance,24,11,13
Karpin,area-52,1046,druid,balance,18,11,7
Catrene,mannoroth,1045,druid,balance,45,28,17
Blckyoungsta,illidan,1045,druid,balance,42,23,19
Miggzii,draka,1045,druid,balance,57,24,33
Coochi,sargeras,1044,druid,balance,18,11,7
Druihd,stormrage,1042,druid,balance,36,20,16
Dèrpin,thrall,1042,druid,balance,39,12,27
Runestar,malganis,1039,druid,balance,25,11,14
Jherrak,area-52,1035,druid,balance,18,11,7
Bearhug,dragonmaw,1034,druid,balance,18,11,7
Aton,frostwolf,1031,druid,balance,18,11,7
Superhorsey,aggramar,1031,druid,balance,36,19,17
Schmeatbawls,illidan,1031,druid,balance,23,11,12
Balantina,tichondrius,1029,druid,balance,36,15,21
Reeiyna,gallywix,1026,druid,balance,60,35,25
Tuggmyudder,area-52,1026,druid,balance,43,21,22
Qfidy,sargeras,1026,druid,balance,25,11,14
Thèbearjèw,tichondrius,1024,druid,balance,55,23,32
Foxxyroxxy,malganis,1023,druid,balance,17,11,6
Tarukke,azralon,1016,druid,balance,26,12,14
Shalkam,stormrage,1013,druid,balance,30,12,18
Riprip,tichondrius,1012,druid,balance,27,12,15
Bloomsong,emerald-dream,1012,druid,balance,30,13,17
Circadion,illidan,1012,druid,balance,65,23,42
Araminka,drakkari,1011,druid,balance,12,11,1
Nîghtcráwlér,tichondrius,1010,druid,balance,53,30,23
Coqeh,frostwolf,1007,druid,balance,18,11,7
Yokimo,amanthul,1005,druid,balance,18,11,7
Vapeculture,lightbringer,1005,druid,balance,96,52,44
ßrian,stormscale,1002,druid,balance,24,11,13
Owlbearthing,sargeras,1002,druid,balance,108,42,66
Imhealer,drakkari,1000,druid,balance,23,13,10
Dustin,moon-guard,1000,druid,balance,22,12,10
Bethemarble,sargeras,998,druid,balance,75,28,47
Rakelan,tichondrius,993,druid,balance,152,80,72
Naturae,spirestone,990,druid,balance,14,11,3
Caminanube,quelthalas,989,druid,balance,30,13,17
Azevedoo,nemesis,988,druid,balance,49,17,32
Smallrichard,bleeding-hollow,986,druid,balance,27,11,16
Amigomel,emerald-dream,985,druid,balance,23,11,12
Gavalle,khaz-modan,981,druid,balance,128,70,58
Indy,rivendare,980,druid,balance,22,11,11
Spazz,firetree,975,druid,balance,17,11,6
Amandi,magtheridon,974,druid,balance,28,11,17
Athious,moon-guard,973,druid,balance,47,24,23
Cowel,tichondrius,969,druid,balance,25,11,14
Warberton,moon-guard,966,druid,balance,31,14,17
Bulldohz,tichondrius,965,druid,balance,36,16,20
Kunigami,malganis,960,druid,balance,12,10,2
Killy,nazjatar,960,druid,balance,12,10,2
Fäncy,sargeras,960,druid,balance,12,10,2
Jubi,bleeding-hollow,960,druid,balance,12,10,2
Soahclleh,sargeras,960,druid,balance,12,10,2
Sÿndru,illidan,960,druid,balance,18,10,8
Arenamasterx,stormscale,960,druid,balance,18,10,8
Beamerboy,bleeding-hollow,960,druid,balance,18,10,8
Roben,tichondrius,960,druid,balance,18,10,8
Bfaboomy,stormrage,960,druid,balance,24,10,14
Feaveldin,moon-guard,959,druid,balance,12,10,2
Rahwan,bleeding-hollow,959,druid,balance,12,10,2
Gënderdruid,tichondrius,959,druid,balance,12,10,2
Jshwills,sargeras,959,druid,balance,12,10,2
Azurehoof,earthen-ring,959,druid,balance,15,10,5
Sàbrè,darkspear,959,druid,balance,18,10,8
Jaz,jubeithos,959,druid,balance,18,10,8
Lindsanr,illidan,959,druid,balance,18,10,8
Qtkinzz,illidan,959,druid,balance,18,10,8
Kohru,moon-guard,959,druid,balance,18,10,8
Credd,zuljin,959,druid,balance,18,10,8
Fixxitfelix,sargeras,959,druid,balance,18,10,8
Skaie,ragnaros,959,druid,balance,18,10,8
Toro,gorefiend,959,druid,balance,18,10,8
Sill,illidan,959,druid,balance,18,10,8
Furor,eonar,959,druid,balance,24,10,14
Dotdmage,tichondrius,959,druid,balance,24,10,14
Harambetwo,quelthalas,959,druid,balance,24,10,14
Biggieclawz,tichondrius,958,druid,balance,12,10,2
Blàtté,zuljin,958,druid,balance,12,10,2
Zmk,barthilas,958,druid,balance,18,10,8
Psilo,kelthuzad,958,druid,balance,18,10,8
Immortalowl,illidan,958,druid,balance,18,10,8
Dasbeerboot,tichondrius,958,druid,balance,18,10,8
Swiftboom,stormrage,958,druid,balance,18,10,8
Argento,frostmourne,958,druid,balance,18,10,8
Tensuen,boulderfist,958,druid,balance,22,10,12
Tanakoi,zuljin,958,druid,balance,24,10,14
Kushidabs,tichondrius,958,druid,balance,34,11,23
Messyboom,illidan,957,druid,balance,12,10,2
Ulfaar,frostmourne,957,druid,balance,15,11,4
Fugg,frostmourne,957,druid,balance,18,10,8
Smokeheaters,dalaran,957,druid,balance,18,10,8
Nøzopium,kelthuzad,956,druid,balance,18,10,8
Mulgorer,tichondrius,956,druid,balance,24,10,14
Fixn,tichondrius,955,druid,balance,18,10,8
Vashida,stormrage,955,druid,balance,24,10,14
Antagonist,burning-blade,954,druid,balance,18,10,8
Ahruan,stormrage,954,druid,balance,24,10,14
Maldobear,stormrage,954,druid,balance,24,10,14
Ridicules,cenarius,953,druid,balance,18,10,8
Ardelorfin,kargath,953,druid,balance,18,10,8
Santogrial,blood-furnace,953,druid,balance,58,31,27
Dethkight,area-52,953,druid,balance,22,11,11
Snowfaerie,moon-guard,953,druid,balance,22,11,11
Jal,khazgoroth,953,druid,balance,20,10,10
Wìtchdoctor,barthilas,953,druid,balance,24,10,14
Crunkk,thunderlord,952,druid,balance,18,10,8
Hadoriss,kelthuzad,952,druid,balance,24,10,14
Barecowbear,bleeding-hollow,951,druid,balance,24,10,14
Ohzú,ragnaros,950,druid,balance,18,10,8
Sennur,kelthuzad,944,druid,balance,30,14,16
Flapjack,malganis,943,druid,balance,24,10,14
Skiouros,emerald-dream,943,druid,balance,36,10,26
Boomtre,malganis,942,druid,balance,17,10,7
Gidam,moon-guard,941,druid,balance,18,10,8
Soulhealer,quelthalas,940,druid,balance,18,10,8
Redrocket,eldrethalas,936,druid,balance,23,11,12
Haallanna,thunderlord,934,druid,balance,34,18,16
Boatox,jubeithos,931,druid,balance,30,10,20
Psychoboomi,bleeding-hollow,927,druid,balance,24,13,11
Chrisclones,stormrage,925,druid,balance,29,10,19
Bellä,nazjatar,923,druid,balance,42,12,30
Jokey,quelthalas,920,druid,balance,24,14,10
Sunneater,azuremyst,920,druid,balance,25,11,14
Beleraine,moon-guard,915,druid,balance,23,10,13
Sever,ysera,914,druid,balance,42,17,25
Rennar,stormrage,911,druid,balance,17,10,7
Maular,jubeithos,911,druid,balance,34,10,24
Ðarkscar,laughing-skull,910,druid,balance,56,20,36
Fancyprance,dalaran,910,druid,balance,29,10,19
Cast,moon-guard,908,druid,balance,17,10,7
Meliódás,area-52,907,druid,balance,247,109,138
Aroxus,tichondrius,903,druid,balance,23,10,13
Tinyypuppyy,sargeras,903,druid,balance,36,12,24
Stretchhxd,tichondrius,900,druid,balance,21,10,11
Wantto,moknathal,894,druid,balance,54,26,28
Juicedkin,tichondrius,891,druid,balance,20,10,10
Weezydende,area-52,889,druid,balance,87,31,56
Nalarin,kaelthas,878,druid,balance,72,35,37
Appitrap,emerald-dream,878,druid,balance,43,12,31
Meiling,spirestone,866,druid,balance,30,14,16
Rarelinedru,malganis,864,druid,balance,12,9,3
Simperella,dalaran,864,druid,balance,12,9,3
Hëllchaos,sargeras,864,druid,balance,12,9,3
Tinwhiskerz,bleeding-hollow,864,druid,balance,12,9,3
Gerrt,bleeding-hollow,864,druid,balance,12,9,3
Erutan,malganis,864,druid,balance,12,9,3
Hännibal,hydraxis,864,druid,balance,12,9,3
Carntko,sargeras,864,druid,balance,12,9,3
Wongelvis,zuljin,864,druid,balance,12,9,3
Toastsdruid,tichondrius,864,druid,balance,12,9,3
Maen,kelthuzad,864,druid,balance,12,9,3
Ory,illidan,864,druid,balance,12,9,3
Oatmeals,fizzcrank,864,druid,balance,18,9,9
Kittycatman,tichondrius,864,druid,balance,18,9,9
Zydea,stormrage,864,druid,balance,18,9,9
Mvpps,thrall,864,druid,balance,18,9,9
Bigbootyßutt,area-52,864,druid,balance,18,9,9
Lunartiç,kelthuzad,864,druid,balance,18,9,9
Gôdôfwow,tichondrius,864,druid,balance,18,9,9
Flamejacker,tichondrius,863,druid,balance,12,9,3
Cerberus,tanaris,863,druid,balance,12,9,3
Hàchi,malganis,863,druid,balance,12,9,3
Booteusmaxms,frostwolf,863,druid,balance,12,9,3
Flappyboí,proudmoore,863,druid,balance,15,10,5
Bearlylegál,sargeras,863,druid,balance,18,9,9
Doots,aegwynn,863,druid,balance,18,9,9
Starkraven,firetree,863,druid,balance,18,9,9
Skydín,stormrage,863,druid,balance,18,9,9
Supriix,moon-guard,863,druid,balance,18,9,9
Velaar,arthas,863,druid,balance,18,9,9
Môônkîn,chogall,863,druid,balance,18,9,9
Bullcritzz,saurfang,863,druid,balance,18,9,9
Céléstial,azralon,863,druid,balance,18,9,9
Cösmic,anetheron,863,druid,balance,18,9,9
Kdrumania,tichondrius,863,druid,balance,18,9,9
Furrysacks,sargeras,863,druid,balance,18,9,9
Wyldfire,azjolnerub,863,druid,balance,18,9,9
Amookelia,tichondrius,863,druid,balance,18,9,9
Galadriowl,dalaran,863,druid,balance,24,9,15
Bekbek,blackrock,863,druid,balance,24,9,15
Dolwizz,tichondrius,863,druid,balance,24,9,15
Rootslayer,tichondrius,862,druid,balance,12,9,3
Oreoshift,illidan,862,druid,balance,12,9,3
Zugdruid,tichondrius,862,druid,balance,13,9,4
Elydaria,destromath,862,druid,balance,24,12,12
Vèrsusapp,thrall,862,druid,balance,18,9,9
Tugboat,saurfang,862,druid,balance,18,9,9
Shack,alterac-mountains,862,druid,balance,18,9,9
Hallthrok,stormrage,862,druid,balance,18,9,9
Felløwship,nemesis,862,druid,balance,18,9,9
Furrmissile,area-52,862,druid,balance,18,9,9
Newclear,tichondrius,861,druid,balance,12,9,3
Tinkker,zuljin,861,druid,balance,12,9,3
Zyyh,proudmoore,861,druid,balance,16,10,6
Actiad,stormrage,861,druid,balance,16,10,6
Thullian,stormrage,861,druid,balance,19,10,9
Starslicer,vashj,861,druid,balance,18,9,9
Taurenosorus,illidan,861,druid,balance,82,39,43
Davymangravy,dalaran,861,druid,balance,24,9,15
Goldentaint,tichondrius,861,druid,balance,24,9,15
Blizdontcuur,area-52,860,druid,balance,12,9,3
Morphlöl,frostmourne,860,druid,balance,12,9,3
Runarok,ragnaros,860,druid,balance,18,9,9
Sanleba,tichondrius,860,druid,balance,18,9,9
Ðeepsixx,burning-legion,859,druid,balance,18,9,9
Soviclol,malganis,859,druid,balance,18,9,9
Einraedon,dalaran,859,druid,balance,24,9,15
Bestik,quelthalas,859,druid,balance,24,9,15
Kujo,bloodhoof,859,druid,balance,30,9,21
Moringo,azralon,858,druid,balance,12,9,3
Stormrrage,demon-soul,858,druid,balance,18,9,9
Palermo,aerie-peak,857,druid,balance,18,9,9
Kamionero,drakkari,856,druid,balance,12,9,3
Joshuah,stormrage,856,druid,balance,24,9,15
Damallis,anubarak,855,druid,balance,18,9,9
Dizzyshiftz,dalaran,852,druid,balance,30,9,21
Sleek,illidan,850,druid,balance,24,9,15
Bitechew,frostmourne,847,druid,balance,15,10,5
Everglim,azralon,847,druid,balance,24,9,15
Darkdragoonz,barthilas,847,druid,balance,30,9,21
Speedynut,area-52,843,druid,balance,15,10,5
Dèmønblâckev,malganis,842,druid,balance,24,11,13
Tyrana,bloodscalp,833,druid,balance,18,9,9
Starsfall,tichondrius,831,druid,balance,16,9,7
Nokther,muradin,830,druid,balance,28,9,19
Dankasauras,tichondrius,830,druid,balance,42,13,29
Batzul,tichondrius,826,druid,balance,17,9,8
Chicknfingaz,tichondrius,802,druid,balance,16,10,6
Stetile,azralon,800,druid,balance,16,9,7
Schlaankeyy,stormrage,800,druid,balance,22,9,13
Jieter,malganis,799,druid,balance,14,9,5
Grgcostanza,bleeding-hollow,793,druid,balance,14,9,5
Vyntrix,kelthuzad,792,druid,balance,20,9,11
Astroshift,emerald-dream,784,druid,balance,20,9,11
Ayyva,proudmoore,768,druid,balance,12,8,4
Catmoomoo,tichondrius,768,druid,balance,12,8,4
Notports,tichondrius,768,druid,balance,12,8,4
Juhji,dalaran,768,druid,balance,12,8,4
Jisoojwa,frostmourne,768,druid,balance,12,8,4
Evileyesqc,stormrage,768,druid,balance,12,8,4
Moonlitgrove,silvermoon,768,druid,balance,12,8,4
Meesterwolf,tichondrius,768,druid,balance,12,8,4
Duckdie,moon-guard,768,druid,balance,12,8,4
Givemethatcr,tichondrius,768,druid,balance,12,8,4
Elyiaida,emerald-dream,768,druid,balance,12,8,4
Aenari,anvilmar,768,druid,balance,12,8,4
Yøpìèrre,zuljin,768,druid,balance,12,8,4
Oopygoopy,bleeding-hollow,768,druid,balance,12,8,4
Shaney,zuljin,768,druid,balance,12,8,4
Azakai,sargeras,768,druid,balance,12,8,4
Ryanspeed,mugthol,768,druid,balance,12,8,4
Laserxo,tichondrius,768,druid,balance,12,8,4
Shiftytom,spirestone,768,druid,balance,12,8,4
Thallid,hydraxis,768,druid,balance,12,8,4
Mikelovin,nemesis,768,druid,balance,12,8,4
Treesrlegal,area-52,768,druid,balance,12,8,4
Domord,stormrage,768,druid,balance,12,8,4
Sñìp,zuljin,768,druid,balance,12,8,4
Wizkd,tichondrius,768,druid,balance,12,8,4
Guuh,tichondrius,768,druid,balance,12,8,4
Chayten,bleeding-hollow,768,druid,balance,12,8,4
Moistism,tichondrius,768,druid,balance,12,8,4
Aconcat,bleeding-hollow,768,druid,balance,12,8,4
Nyzear,bleeding-hollow,768,druid,balance,12,8,4
Zodovia,illidan,768,druid,balance,12,8,4
Nothecia,sargeras,768,druid,balance,12,8,4
Gameisass,illidan,768,druid,balance,12,8,4
Mådge,frostmourne,768,druid,balance,12,8,4
Cabrøn,illidan,768,druid,balance,12,8,4
Skylined,sargeras,768,druid,balance,12,8,4
Abelladañger,area-52,768,druid,balance,12,8,4
Hootforce,spirestone,768,druid,balance,12,8,4
Astralboom,stormrage,768,druid,balance,12,8,4
Løk,sargeras,768,druid,balance,12,8,4
Eskimocowboy,sargeras,768,druid,balance,12,8,4
Shardzz,illidan,768,druid,balance,15,9,6
Chickenbeam,tichondrius,768,druid,balance,17,8,9
Onsen,tichondrius,768,druid,balance,18,8,10
Lutze,frostmourne,768,druid,balance,18,8,10
Drop,shadow-council,767,druid,balance,10,9,1
Wizgarkin,area-52,767,druid,balance,12,8,4
Bearmäntle,ragnaros,767,druid,balance,12,8,4
Stärscrëäm,darkspear,767,druid,balance,12,8,4
Notadopted,sargeras,767,druid,balance,12,8,4
Starbender,arygos,767,druid,balance,12,8,4
Arellea,uther,767,druid,balance,12,8,4
Neurotoxins,tichondrius,767,druid,balance,12,8,4
Arntu,malganis,767,druid,balance,12,8,4
Asharä,mannoroth,767,druid,balance,12,8,4
Scudbomb,kelthuzad,767,druid,balance,12,8,4
Kimimàrø,illidan,767,druid,balance,12,8,4
Eøle,stormrage,767,druid,balance,12,8,4
Harddeenball,area-52,767,druid,balance,15,9,6
Ruckiz,stormrage,767,druid,balance,18,8,10
Whiteglade,moon-guard,767,druid,balance,18,8,10
Ebonclaw,malganis,767,druid,balance,18,8,10
Tomletrain,zuljin,767,druid,balance,18,8,10
Spicychicken,lightninghoof,767,druid,balance,19,8,11
Khristine,spinebreaker,767,druid,balance,24,8,16
Satanstoe,illidan,767,druid,balance,24,8,16
Museafour,tichondrius,766,druid,balance,12,8,4
Mornis,zuljin,766,druid,balance,12,8,4
Onidudu,frostmourne,766,druid,balance,12,8,4
Boogietease,frostmourne,766,druid,balance,12,8,4
Cuppnoodles,illidan,766,druid,balance,12,8,4
Volgoro,thrall,766,druid,balance,12,8,4
Melizaa,stormrage,766,druid,balance,12,8,4
Hootz,kelthuzad,766,druid,balance,16,9,7
Kastro,frostwolf,766,druid,balance,18,8,10
Nxghtfall,tichondrius,766,druid,balance,18,8,10
Cloyer,stormrage,766,druid,balance,18,8,10
Jashrus,korgath,765,druid,balance,12,8,4
Whitekongg,blackhand,765,druid,balance,15,9,6
Sefestria,senjin,765,druid,balance,18,8,10
Tegrizelle,cenarion-circle,765,druid,balance,18,8,10
Motörcharge,bleeding-hollow,764,druid,balance,12,8,4
Crépes,bleeding-hollow,764,druid,balance,18,8,10
Kelylea,the-underbog,764,druid,balance,18,8,10
Architech,bleeding-hollow,764,druid,balance,24,8,16
Wabbehkus,barthilas,764,druid,balance,26,8,18
Eiel,undermine,763,druid,balance,12,8,4
Chewychips,malganis,763,druid,balance,12,8,4
Kittydiddle,stormrage,763,druid,balance,18,8,10
Thonyg,sargeras,763,druid,balance,18,8,10
Anttfj,mannoroth,763,druid,balance,18,8,10
Herbirove,frostmourne,762,druid,balance,12,8,4
Astromyles,tichondrius,762,druid,balance,25,8,17
Krustyora,khazgoroth,761,druid,balance,18,11,7
Baaksau,illidan,761,druid,balance,18,8,10
Rejufang,sargeras,760,druid,balance,12,8,4
Freyaborn,sargeras,760,druid,balance,17,9,8
Jtogethendr,area-52,759,druid,balance,12,8,4
Boneheir,proudmoore,757,druid,balance,21,9,12
Aessinawisp,frostmourne,753,druid,balance,18,8,10
Seethert,quelthalas,751,druid,balance,12,8,4
Undeadshammy,tichondrius,736,druid,balance,16,9,7
Formgodx,malganis,735,druid,balance,28,8,20
Outclone,tichondrius,734,druid,balance,10,9,1
Outandy,quelthalas,727,druid,balance,17,8,9
Druz,spirestone,703,druid,balance,11,8,3
Iloveweed,tichondrius,703,druid,balance,11,8,3
Gulrahf,wyrmrest-accord,703,druid,balance,21,8,13
Jukebóx,stormrage,701,druid,balance,20,8,12
Mooncry,wyrmrest-accord,700,druid,balance,26,9,17
Alaskanimal,illidan,696,druid,balance,16,8,8
Shiftness,nordrassil,679,druid,balance,11,8,3
Floofi,kelthuzad,672,druid,balance,12,7,5
Donaldsr,area-52,672,druid,balance,12,7,5
Bronnasaurus,tichondrius,672,druid,balance,12,7,5
Suedou,moon-guard,672,druid,balance,12,7,5
Stacker,malganis,672,druid,balance,12,7,5
Riptin,kelthuzad,672,druid,balance,12,7,5
Dsavart,stormrage,672,druid,balance,12,7,5
Selvius,area-52,672,druid,balance,12,7,5
Køzi,tichondrius,672,druid,balance,12,7,5
Taysfriend,tichondrius,672,druid,balance,12,7,5
Tïgerpawz,stormrage,672,druid,balance,12,7,5
Omegablasted,tichondrius,672,druid,balance,12,7,5
Eizruk,tichondrius,672,druid,balance,12,7,5
Metal,kiljaeden,672,druid,balance,12,7,5
Straitbeast,tichondrius,672,druid,balance,12,7,5
Nutbutterpie,stormrage,672,druid,balance,12,7,5
Mar,misha,672,druid,balance,12,7,5
Jiywa,lightbringer,672,druid,balance,12,7,5
Xioqt,chogall,672,druid,balance,12,7,5
Jecci,tichondrius,672,druid,balance,12,7,5
Delayedxd,bleeding-hollow,672,druid,balance,12,7,5
Elithyra,area-52,672,druid,balance,12,7,5
Zoonkin,tichondrius,672,druid,balance,12,7,5
Saltkin,frostmourne,672,druid,balance,12,7,5
Rykudruid,azuremyst,672,druid,balance,12,7,5
Blassen,sargeras,672,druid,balance,12,7,5
Wildllama,moon-guard,672,druid,balance,12,7,5
Akiiragata,azralon,672,druid,balance,12,7,5
Rhyndris,dalaran,672,druid,balance,12,7,5
Boomypower,dalaran,672,druid,balance,12,7,5
Redscyclone,dalaran,672,druid,balance,12,7,5
Beörne,sargeras,672,druid,balance,12,7,5
Slickthick,sargeras,672,druid,balance,12,7,5
Covidcarrier,thrall,672,druid,balance,12,7,5
Alteraim,thrall,672,druid,balance,12,7,5
Pantec,eredar,672,druid,balance,12,7,5
Moonkiin,sargeras,672,druid,balance,12,7,5
Malafaïa,nemesis,672,druid,balance,12,7,5
Wascar,sargeras,672,druid,balance,12,7,5
Lalalu,frostmourne,672,druid,balance,15,8,7
Mythienair,stormrage,672,druid,balance,15,8,7
Forest,frostmourne,672,druid,balance,16,8,8
Sunspot,tichondrius,672,druid,balance,18,7,11
Ginunaga,tichondrius,672,druid,balance,18,7,11
Peteybears,stormrage,672,druid,balance,18,7,11
Purrfessor,proudmoore,672,druid,balance,18,7,11
Avbox,proudmoore,672,druid,balance,18,7,11
Slaÿr,malganis,672,druid,balance,18,7,11
Hream,echo-isles,672,druid,balance,18,7,11
Necromos,argent-dawn,672,druid,balance,18,7,11
Kassadega,sargeras,672,druid,balance,18,7,11
Shrubzilla,area-52,672,druid,balance,24,7,17
Ripx,khadgar,671,druid,balance,12,7,5
Dobidas,tichondrius,671,druid,balance,12,7,5
Douwantoplay,tichondrius,671,druid,balance,12,7,5
Stickyleavz,sargeras,671,druid,balance,12,7,5
Tubemagnet,tichondrius,671,druid,balance,12,7,5
Trìckyz,tichondrius,671,druid,balance,12,7,5
Sneeks,ragnaros,671,druid,balance,12,7,5
Jazzmaster,barthilas,671,druid,balance,12,7,5
Bambozled,sargeras,671,druid,balance,12,7,5
Bambam,frostwolf,671,druid,balance,12,7,5
Longstory,bonechewer,671,druid,balance,12,7,5
Feathergun,ragnaros,671,druid,balance,12,7,5
Pawpa,daggerspine,671,druid,balance,12,7,5
Ayari,sargeras,671,druid,balance,12,7,5
Dgas,tichondrius,671,druid,balance,12,7,5
Cashgame,malganis,671,druid,balance,12,7,5
Catalytic,frostmourne,671,druid,balance,15,8,7
Mirudru,stormrage,671,druid,balance,18,7,11
Dashio,lightnings-blade,671,druid,balance,18,7,11
Trenboloone,area-52,671,druid,balance,18,7,11
Ichangeabull,bleeding-hollow,671,druid,balance,18,7,11
Dirtytiger,sargeras,671,druid,balance,18,7,11
Ioncannon,darrowmere,671,druid,balance,18,7,11
Starsurged,moon-guard,671,druid,balance,18,7,11
Ankole,ravencrest,671,druid,balance,18,7,11
Barkcheeks,area-52,671,druid,balance,18,7,11
Devilkei,tichondrius,671,druid,balance,18,7,11
Ellysian,malganis,671,druid,balance,18,7,11
Chukksz,nerzhul,670,druid,balance,12,7,5
Oâk,farstriders,670,druid,balance,12,7,5
Traxxo,tichondrius,670,druid,balance,12,7,5
Budtender,moon-guard,670,druid,balance,12,7,5
Brodinmmx,bleeding-hollow,670,druid,balance,18,7,11
Siöux,kelthuzad,670,druid,balance,18,7,11
Teziq,sargeras,670,druid,balance,18,7,11
Kragma,zuluhed,670,druid,balance,18,7,11
Gilgorash,kiljaeden,670,druid,balance,24,7,17
Bruddanature,dawnbringer,670,druid,balance,24,7,17
Eurotrance,frostmourne,669,druid,balance,12,7,5
Aviendiana,thrall,669,druid,balance,12,7,5
Hpcorrection,bleeding-hollow,669,druid,balance,18,7,11
Onecalf,tichondrius,668,druid,balance,12,7,5
Rastafan,proudmoore,668,druid,balance,18,7,11
Wresty,frostmourne,667,druid,balance,12,7,5
Tïcks,illidan,666,druid,balance,18,7,11
Krunge,frostwolf,665,druid,balance,12,7,5
Beammz,stormrage,664,druid,balance,15,8,7
Pao,nordrassil,664,druid,balance,18,7,11
Kångåwalafox,sargeras,663,druid,balance,12,7,5
Nazrelar,ragnaros,663,druid,balance,26,10,16
Edrielin,quelthalas,657,druid,balance,12,7,5
Bigolehoe,tichondrius,654,druid,balance,17,7,10
Veraciouss,sargeras,652,druid,balance,18,10,8
Shyn,goldrinn,639,druid,balance,14,8,6
Dsoul,tichondrius,639,druid,balance,17,7,10
Spacéchicken,stormrage,638,druid,balance,10,8,2
Hancalimon,nemesis,634,druid,balance,26,8,18
Ilovebutter,illidan,624,druid,balance,9,8,1
Tumblr,terenas,624,druid,balance,9,7,2
Stive,nemesis,623,druid,balance,9,7,2
Neurologist,tichondrius,623,druid,balance,11,7,4
Corym,frostmourne,622,druid,balance,17,7,10
Marakar,nazjatar,622,druid,balance,17,7,10
Gutanamo,stormrage,620,druid,balance,14,8,6
Chankletta,quelthalas,618,druid,balance,18,8,10
Bignosecow,illidan,617,druid,balance,19,8,11
Tugond,tichondrius,617,druid,balance,28,8,20
Lawnkin,dalaran,608,druid,balance,16,7,9
Feldstarx,stormrage,607,druid,balance,14,7,7
Murkdruid,frostmourne,607,druid,balance,14,7,7
Instinctuals,sargeras,606,druid,balance,14,7,7
Bleedsxd,tichondrius,606,druid,balance,14,7,7
Hirtenweg,stormrage,605,druid,balance,20,7,13
Lunnæ,ragnaros,595,druid,balance,14,7,7
Razzldazzle,thrall,590,druid,balance,13,7,6
Fifthelement,tichondrius,587,druid,balance,11,8,3
Starswrath,moon-guard,576,druid,balance,6,6,0
Starsùrge,moon-guard,576,druid,balance,6,6,0
Yuhcy,malganis,576,druid,balance,6,6,0
Möòse,tichondrius,576,druid,balance,6,6,0
Dabshifter,tichondrius,576,druid,balance,6,6,0
Khayman,sargeras,576,druid,balance,6,6,0
Claws,elune,576,druid,balance,6,6,0
Trynayeet,area-52,576,druid,balance,6,6,0
Cattpiss,tichondrius,576,druid,balance,6,6,0
Canfinich,illidan,576,druid,balance,6,6,0
Starship,frostmourne,576,druid,balance,6,6,0
Brewtherbear,kelthuzad,576,druid,balance,6,6,0
Prev,arathor,576,druid,balance,6,6,0
Nardwaur,tichondrius,576,druid,balance,6,6,0
Animatronz,area-52,576,druid,balance,6,6,0
Zelø,zuljin,576,druid,balance,12,6,6
Tewdee,magtheridon,576,druid,balance,12,6,6
Beomjun,tichondrius,576,druid,balance,12,6,6
Gigathicc,malganis,576,druid,balance,12,6,6
Jonnygg,illidan,576,druid,balance,12,6,6
Jacknit,illidan,576,druid,balance,12,6,6
Slütcakes,tichondrius,576,druid,balance,12,6,6
Nýla,stormrage,576,druid,balance,12,6,6
Natureww,sargeras,576,druid,balance,12,6,6
Expatcow,tichondrius,576,druid,balance,12,6,6
Cowchicken,zuljin,576,druid,balance,12,6,6
Lolimatree,proudmoore,576,druid,balance,12,6,6
Còry,kiljaeden,576,druid,balance,12,6,6
Maidah,malganis,576,druid,balance,12,6,6
Grayfan,malganis,576,druid,balance,12,6,6
Dazedru,stormrage,576,druid,balance,12,6,6
Nerfdemo,kiljaeden,576,druid,balance,12,6,6
Juqzy,area-52,576,druid,balance,12,6,6
Treehard,malganis,576,druid,balance,12,6,6
Dalaverrunis,tichondrius,576,druid,balance,12,6,6
Nature,haomarush,576,druid,balance,12,6,6
Tylërðûrðên,sargeras,576,druid,balance,12,6,6
Jamuestus,illidan,576,druid,balance,12,6,6
Celetra,kiljaeden,576,druid,balance,12,6,6
Jonnytsunami,the-forgotten-coast,576,druid,balance,12,6,6
Alcorria,area-52,576,druid,balance,12,6,6
Bar,stormrage,576,druid,balance,12,6,6
Exiledruid,area-52,576,druid,balance,12,6,6
Sorrytofaded,tichondrius,576,druid,balance,12,6,6
Sandriuzs,nemesis,576,druid,balance,12,6,6
Pincho,hyjal,576,druid,balance,12,6,6
Cantheal,frostmourne,576,druid,balance,12,6,6
Chickenaeg,stormrage,576,druid,balance,12,6,6
Bamfferal,tichondrius,576,druid,balance,12,6,6
Cukld,tichondrius,576,druid,balance,12,6,6
Haffö,gundrak,576,druid,balance,12,6,6
Polyproof,emerald-dream,576,druid,balance,12,6,6
Cronosphere,stormrage,576,druid,balance,12,6,6
Formz,nagrand,576,druid,balance,12,6,6
Jmackd,frostmourne,576,druid,balance,12,6,6
Amundruid,area-52,576,druid,balance,12,6,6
Ggae,tichondrius,576,druid,balance,12,6,6
Runforest,tichondrius,576,druid,balance,12,6,6
Scykin,stormrage,576,druid,balance,12,6,6
Moonkid,barthilas,576,druid,balance,12,6,6
Drulicious,tichondrius,576,druid,balance,12,6,6
Hellabandzup,drakthul,576,druid,balance,12,6,6
Shwìftmend,area-52,576,druid,balance,12,6,6
Brocooli,tichondrius,576,druid,balance,12,6,6
Iefts,stormrage,576,druid,balance,12,6,6
Zaaduu,tichondrius,576,druid,balance,12,6,6
Loadstar,burning-blade,576,druid,balance,12,6,6
Gâlaxy,sargeras,576,druid,balance,12,6,6
Notpodruida,tichondrius,576,druid,balance,13,6,7
Faletra,eitrigg,576,druid,balance,18,6,12
Doomky,area-52,576,druid,balance,18,6,12
Longnus,stormrage,576,druid,balance,18,6,12
Sooey,wyrmrest-accord,576,druid,balance,18,6,12
Gåiâ,malganis,576,druid,balance,18,6,12
Fuzzybear,nemesis,576,druid,balance,18,6,12
Drphilsmith,moon-guard,576,druid,balance,18,6,12
Mesteno,proudmoore,576,druid,balance,18,6,12
Sample,dark-iron,576,druid,balance,18,6,12
Dibinha,azralon,575,druid,balance,12,6,6
Shroudyroudy,dalaran,575,druid,balance,12,6,6
Guybranch,illidan,575,druid,balance,12,6,6
Zieda,sisters-of-elune,575,druid,balance,12,6,6
Turnpike,exodar,575,druid,balance,12,6,6
Readox,sargeras,575,druid,balance,12,6,6
Ebichu,fenris,575,druid,balance,12,6,6
Emolia,amanthul,575,druid,balance,12,6,6
Beamin,thunderlord,575,druid,balance,12,6,6
Miçangak,azralon,575,druid,balance,12,6,6
Tariksha,sargeras,575,druid,balance,12,6,6
Akthos,stormrage,575,druid,balance,12,6,6
Hildisvini,sargeras,575,druid,balance,12,6,6
Déi,malganis,575,druid,balance,12,6,6
Tiju,wyrmrest-accord,575,druid,balance,18,6,12
Sokodruid,tichondrius,575,druid,balance,18,6,12
Guusx,bonechewer,575,druid,balance,18,6,12
Diarmaron,area-52,575,druid,balance,18,6,12
Samelthios,proudmoore,575,druid,balance,20,6,14
Painsbrook,thrall,574,druid,balance,12,6,6
Dradugun,hyjal,574,druid,balance,12,6,6
Idontknowbro,bonechewer,574,druid,balance,12,6,6
Mirialia,alexstrasza,574,druid,balance,12,6,6
Quagsire,moon-guard,574,druid,balance,18,6,12
Xinnii,illidan,573,druid,balance,18,7,11
Proñgs,tichondrius,566,druid,balance,12,6,6
Nyxlie,stormrage,560,druid,balance,13,7,6
Æpex,zuljin,544,druid,balance,10,6,4
Jokeclass,darkspear,544,druid,balance,10,6,4
Matock,malganis,543,druid,balance,11,6,5
Casaran,anetheron,543,druid,balance,11,6,5
Hchhi,ragnaros,543,druid,balance,14,7,7
Guarbird,tichondrius,528,druid,balance,9,6,3
Boufa,dentarg,527,druid,balance,9,7,2
Tzboo,stormrage,527,druid,balance,15,6,9
Pixelface,frostmourne,526,druid,balance,11,6,5
Guron,aegwynn,526,druid,balance,27,6,21
Mythianan,aggramar,520,druid,balance,16,9,7
Velais,exodar,512,druid,balance,22,6,16
Gemineye,stormrage,511,druid,balance,11,6,5
Istayfrawsty,darkspear,511,druid,balance,14,6,8
Thebruiser,baelgun,511,druid,balance,20,6,14
Tulkan,kelthuzad,508,druid,balance,15,7,8
Nephsis,kelthuzad,480,druid,balance,6,5,1
Sixxlul,malganis,480,druid,balance,6,5,1
Wassupfoo,area-52,480,druid,balance,6,5,1
Biggié,bleeding-hollow,480,druid,balance,6,5,1
Rowdie,area-52,480,druid,balance,6,5,1
Megåtron,kelthuzad,480,druid,balance,6,5,1
Beestwithin,illidan,480,druid,balance,6,5,1
Iconicxz,malganis,480,druid,balance,6,5,1
Hooffy,emerald-dream,480,druid,balance,6,5,1
Rastakant,malganis,480,druid,balance,6,5,1
Aoewynn,nerzhul,480,druid,balance,6,5,1
Emaris,malganis,480,druid,balance,6,5,1
Ragiix,tichondrius,480,druid,balance,6,5,1
Joink,sargeras,480,druid,balance,6,5,1
Alindrä,moon-guard,480,druid,balance,6,5,1
Chikojuan,tichondrius,480,druid,balance,6,5,1
Dojacat,tichondrius,480,druid,balance,6,5,1
Crazystarz,frostmourne,480,druid,balance,6,5,1
Coramoor,mannoroth,480,druid,balance,6,5,1
Canuatemyrat,tichondrius,480,druid,balance,6,5,1
Yurself,feathermoon,480,druid,balance,6,5,1
Yokux,thunderlord,480,druid,balance,6,5,1
Psychosocîal,kiljaeden,480,druid,balance,6,5,1
Guår,tichondrius,480,druid,balance,6,5,1
Daroot,spinebreaker,480,druid,balance,6,5,1
Smitebacklol,tichondrius,480,druid,balance,6,5,1
Horizøns,gorefiend,480,druid,balance,6,5,1
Mithroi,tichondrius,480,druid,balance,6,5,1
Steezydru,tichondrius,480,druid,balance,6,5,1
Solju,farstriders,480,druid,balance,6,5,1
ßælot,quelthalas,480,druid,balance,6,5,1
Fattdiabetic,tichondrius,480,druid,balance,6,5,1
Canola,tichondrius,480,druid,balance,6,5,1
Kìttenuwu,sargeras,480,druid,balance,6,5,1
Beamlord,frostmourne,480,druid,balance,6,5,1
Swergz,tichondrius,480,druid,balance,6,5,1
Atrocitÿ,tichondrius,480,druid,balance,11,5,6
Bêêfpattyx,darkspear,480,druid,balance,12,5,7
Amarexf,stormrage,480,druid,balance,12,5,7
Cloninglol,darkspear,480,druid,balance,12,5,7
Bearwithit,sargeras,480,druid,balance,12,5,7
Pcpolicebro,spirestone,480,druid,balance,12,5,7
Clubs,sargeras,480,druid,balance,12,5,7
Nöches,quelthalas,480,druid,balance,12,5,7
Kushkilla,malganis,480,druid,balance,12,5,7
Saucyy,malganis,480,druid,balance,12,5,7
Môistman,tichondrius,480,druid,balance,12,5,7
Zuga,the-venture-co,480,druid,balance,12,5,7
Intrinsiic,area-52,480,druid,balance,12,5,7
Mikoxarekt,area-52,480,druid,balance,12,5,7
Salanzô,bleeding-hollow,480,druid,balance,12,5,7
Shuba,ragnaros,480,druid,balance,12,5,7
Ripter,moon-guard,480,druid,balance,12,5,7
Redness,daggerspine,480,druid,balance,12,5,7
Fullyshiftz,frostmourne,480,druid,balance,12,5,7
Cynderellaa,proudmoore,480,druid,balance,12,5,7
Celestialife,frostmourne,480,druid,balance,12,5,7
Bigdaddyferg,illidan,480,druid,balance,12,5,7
Ragerag,trollbane,480,druid,balance,12,5,7
Cassatopia,zuljin,480,druid,balance,12,5,7
Falaan,frostmourne,480,druid,balance,12,5,7
Beastin,queldorei,480,druid,balance,12,5,7
Rokdx,barthilas,480,druid,balance,12,5,7
Milkmoneymeo,illidan,480,druid,balance,12,5,7
Harshphone,area-52,480,druid,balance,12,5,7
Cooln,bleeding-hollow,480,druid,balance,12,5,7
Kumataku,emerald-dream,480,druid,balance,12,5,7
Sodacream,illidan,480,druid,balance,12,5,7
Dedgame,malfurion,480,druid,balance,12,5,7
Voelcan,tichondrius,480,druid,balance,12,5,7
Öomkinn,sargeras,480,druid,balance,12,5,7
Jujubeartank,darkspear,480,druid,balance,12,5,7
Stratego,drenden,480,druid,balance,12,5,7
Ornaaga,blackrock,480,druid,balance,12,5,7
Drufasä,sargeras,480,druid,balance,12,5,7
Phatpat,illidan,480,druid,balance,12,5,7
Trippykitty,tichondrius,480,druid,balance,12,5,7
Bubblybear,winterhoof,480,druid,balance,12,5,7
Paintlicker,emerald-dream,480,druid,balance,12,5,7
Havócdh,tichondrius,480,druid,balance,12,5,7
Akay,bonechewer,480,druid,balance,12,5,7
Lickmypaws,sargeras,480,druid,balance,12,5,7
Deergut,illidan,480,druid,balance,12,5,7
Bashnerds,illidan,480,druid,balance,12,5,7
Zimah,illidan,480,druid,balance,12,5,7
Bigtammy,moon-guard,480,druid,balance,12,5,7
Hooloo,blades-edge,480,druid,balance,12,5,7
Toptrolls,illidan,480,druid,balance,12,5,7
Forsake,sargeras,480,druid,balance,12,5,7
Sharkfighter,sargeras,480,druid,balance,12,5,7
Stumphugger,tichondrius,480,druid,balance,12,5,7
Helpmeimbad,stormrage,480,druid,balance,12,5,7
Fakechower,stormreaver,480,druid,balance,12,5,7
Psycloned,undermine,480,druid,balance,12,5,7
Florella,misha,480,druid,balance,15,6,9
Coomlauncher,area-52,480,druid,balance,16,6,10
Verdagris,skullcrusher,480,druid,balance,18,5,13
Boomiè,tichondrius,480,druid,balance,18,5,13
Nexophobia,proudmoore,480,druid,balance,18,5,13
Fevo,dreadmaul,480,druid,balance,18,5,13
Laycan,azralon,480,druid,balance,18,5,13
Tuppyboom,barthilas,480,druid,balance,24,5,19
Wtfiisthis,tichondrius,479,druid,balance,6,5,1
Syllphrena,area-52,479,druid,balance,6,5,1
Kenblôck,tichondrius,479,druid,balance,12,5,7
Angelbigbutt,borean-tundra,479,druid,balance,12,5,7
Hoarseqock,area-52,479,druid,balance,12,5,7
Bóñés,malganis,479,druid,balance,12,5,7
Ohfudge,frostwolf,479,druid,balance,12,5,7
Smhyle,frostmourne,479,druid,balance,12,5,7
Cdrü,illidan,479,druid,balance,13,5,8
Edinhalfhorn,bonechewer,479,druid,balance,18,5,13
Loggoruk,illidan,479,druid,balance,18,5,13
Morphntime,blackrock,479,druid,balance,18,5,13
Killersilent,quelthalas,479,druid,balance,24,5,19
Mantis,the-underbog,478,druid,balance,12,5,7
Nahlem,greymane,478,druid,balance,12,5,7
Kirones,stormrage,478,druid,balance,12,5,7
Wardruidkvn,stormreaver,474,druid,balance,35,5,30
Twrixi,caelestrasz,463,druid,balance,17,5,12
Artimedian,kiljaeden,447,druid,balance,11,5,6
Bearcathawk,sargeras,447,druid,balance,11,5,6
Kyuub,barthilas,446,druid,balance,11,5,6
Thunderwolf,malganis,432,druid,balance,9,6,3
Féralis,sargeras,431,druid,balance,11,5,6
Azshunara,moon-guard,431,druid,balance,11,5,6
Cbreezyy,tichondrius,431,druid,balance,11,5,6
Thõrr,tichondrius,431,druid,balance,11,5,6
Krooksy,tichondrius,426,druid,balance,14,6,8
Shuja,wyrmrest-accord,426,druid,balance,15,6,9
Policë,skullcrusher,425,druid,balance,14,6,8
Theriomorph,barthilas,424,druid,balance,28,6,22
Feond,illidan,416,druid,balance,10,5,5
Biig,stormreaver,411,druid,balance,20,13,7
Gigajuiced,proudmoore,400,druid,balance,7,5,2
Äbÿss,tichondrius,400,druid,balance,7,5,2
Altha,proudmoore,400,druid,balance,13,5,8
Drmnheal,frostmourne,384,druid,balance,6,4,2
Filthyclaws,stormrage,384,druid,balance,6,4,2
Trogshift,blackrock,384,druid,balance,6,4,2
Silvshifter,frostmourne,384,druid,balance,6,4,2
Korlstone,zuljin,384,druid,balance,6,4,2
Kkamagwi,illidan,384,druid,balance,6,4,2
Stormbeef,tichondrius,384,druid,balance,6,4,2
Hellfireclaw,tichondrius,384,druid,balance,6,4,2
Orgnalf,area-52,384,druid,balance,6,4,2
Qyuka,area-52,384,druid,balance,6,4,2
Nevershiftx,kirin-tor,384,druid,balance,6,4,2
Dokasaurus,lightbringer,384,druid,balance,6,4,2
Nahelae,tichondrius,384,druid,balance,6,4,2
Shinazugawa,maiev,384,druid,balance,6,4,2
Spèèdy,illidan,384,druid,balance,6,4,2
Lukass,tichondrius,384,druid,balance,6,4,2
Anamoorphicc,kelthuzad,384,druid,balance,6,4,2
Splintered,kelthuzad,384,druid,balance,6,4,2
Bäyter,tichondrius,384,druid,balance,6,4,2
Fuzzytaco,stormrage,384,druid,balance,6,4,2
Beastboyy,tichondrius,384,druid,balance,6,4,2
Joiczar,maelstrom,384,druid,balance,6,4,2
Mcdizzil,bloodscalp,384,druid,balance,6,4,2
Kiwidru,frostmourne,384,druid,balance,6,4,2
Jherdugo,durotan,384,druid,balance,6,4,2
Drenten,stormrage,384,druid,balance,6,4,2
Germainee,shandris,384,druid,balance,6,4,2
Zigzäg,thrall,384,druid,balance,6,4,2
Goncko,ragnaros,384,druid,balance,6,4,2
Sschakall,tol-barad,384,druid,balance,6,4,2
Luvgames,area-52,384,druid,balance,6,4,2
Mythrestor,saurfang,384,druid,balance,6,4,2
Manbeartree,malganis,384,druid,balance,6,4,2
Meatbalmagus,stormrage,384,druid,balance,6,4,2
Oscillater,illidan,384,druid,balance,6,4,2
Bäldir,dalaran,384,druid,balance,6,4,2
Tankyguy,ragnaros,384,druid,balance,6,4,2
Duo,demon-soul,384,druid,balance,6,4,2
Hbf,tichondrius,384,druid,balance,6,4,2
Spaceland,emerald-dream,384,druid,balance,6,4,2
Seekamp,khazgoroth,384,druid,balance,6,4,2
Blams,stormrage,384,druid,balance,6,4,2
Kornobluss,azralon,384,druid,balance,6,4,2
Somarythe,moon-guard,384,druid,balance,6,4,2
Küb,sargeras,384,druid,balance,6,4,2
Vanillaricee,illidan,384,druid,balance,6,4,2
Nidalie,frostmourne,384,druid,balance,6,4,2
Belrin,garona,384,druid,balance,6,4,2
Medsurgdruid,emerald-dream,384,druid,balance,6,4,2
Yeyee,darkspear,384,druid,balance,6,4,2
Tchalla,detheroc,384,druid,balance,6,4,2
Tinishaker,ragnaros,384,druid,balance,6,4,2
Artanial,illidan,384,druid,balance,6,4,2
Matinee,tichondrius,384,druid,balance,6,4,2
Neophobia,stormrage,384,druid,balance,6,4,2
Kiddohhz,tichondrius,384,druid,balance,6,4,2
Elonmuskirl,illidan,384,druid,balance,6,4,2
Harute,aggramar,384,druid,balance,6,4,2
Ðrood,bleeding-hollow,384,druid,balance,6,4,2
Nightshift,dalvengyr,384,druid,balance,6,4,2
Critkatbear,detheroc,384,druid,balance,6,4,2
Peterdeleter,emerald-dream,384,druid,balance,6,4,2
Sabretoóth,malganis,384,druid,balance,6,4,2
Lunchßox,emerald-dream,384,druid,balance,6,4,2
Twostars,thrall,384,druid,balance,6,4,2
Whitehaze,proudmoore,384,druid,balance,6,4,2
Söökie,tichondrius,384,druid,balance,6,4,2
Bludehuestew,proudmoore,384,druid,balance,6,4,2
Brx,eredar,384,druid,balance,6,4,2
Leefman,tichondrius,384,druid,balance,6,4,2
Socknsandals,tichondrius,384,druid,balance,6,4,2
Deelark,skywall,384,druid,balance,6,4,2
Boomkinbob,malganis,384,druid,balance,6,4,2
Cujjoh,tichondrius,384,druid,balance,6,4,2
Böostedx,tichondrius,384,druid,balance,6,4,2
Soothe,barthilas,384,druid,balance,6,4,2
Vadant,sargeras,384,druid,balance,6,4,2
Zxve,stormrage,384,druid,balance,6,4,2
Selfplay,barthilas,384,druid,balance,6,4,2
Yoshí,emerald-dream,384,druid,balance,6,4,2
Sethfurian,magtheridon,384,druid,balance,6,4,2
Lyingcat,mannoroth,384,druid,balance,6,4,2
Magicgunner,tichondrius,384,druid,balance,6,4,2
Nicklul,llane,384,druid,balance,6,4,2
Mmbessa,tichondrius,384,druid,balance,6,4,2
Remorphose,tichondrius,384,druid,balance,6,4,2
Pacmaynè,illidan,384,druid,balance,9,5,4
Balancz,thrall,384,druid,balance,10,5,5
Erwelz,quelthalas,384,druid,balance,10,5,5
Sinistuhd,tichondrius,384,druid,balance,12,4,8
Simo,kaelthas,384,druid,balance,12,4,8
Altius,drakkari,384,druid,balance,12,4,8
Bowlpacka,malganis,384,druid,balance,12,4,8
Donti,laughing-skull,384,druid,balance,12,4,8
Skylightt,illidan,384,druid,balance,12,4,8
Wintarz,sargeras,384,druid,balance,12,4,8
Veyrønn,stormrage,384,druid,balance,12,4,8
Greemer,sargeras,384,druid,balance,12,4,8
Lifeforcer,barthilas,384,druid,balance,12,4,8
Astería,sentinels,384,druid,balance,12,4,8
Jakermans,area-52,384,druid,balance,12,4,8
Stormclaw,elune,384,druid,balance,12,4,8
Shinoßi,area-52,384,druid,balance,12,4,8
Omnipaw,kelthuzad,384,druid,balance,12,4,8
Soreze,kelthuzad,384,druid,balance,12,4,8
Blipshift,tichondrius,384,druid,balance,12,4,8
Bigsmurph,illidan,384,druid,balance,12,4,8
Darkangle,ysera,384,druid,balance,12,4,8
Winmax,tichondrius,384,druid,balance,12,4,8
Toxyflex,tichondrius,384,druid,balance,12,4,8
Tasselhoof,hyjal,384,druid,balance,12,4,8
Kerrzo,frostmourne,384,druid,balance,12,4,8
Zenowl,turalyon,384,druid,balance,12,4,8
Shanadris,stormrage,384,druid,balance,12,4,8
Menlove,area-52,384,druid,balance,12,4,8
Lilrichdps,sargeras,384,druid,balance,12,4,8
Drguillotine,azralon,384,druid,balance,12,4,8
Lutein,tichondrius,384,druid,balance,12,4,8
Aexs,kelthuzad,384,druid,balance,12,4,8
Amaryllis,the-underbog,384,druid,balance,12,4,8
Alexserina,dalaran,384,druid,balance,12,4,8
Cathelyana,tichondrius,384,druid,balance,16,5,11
Katdog,warsong,384,druid,balance,18,4,14
Spatulas,malganis,384,druid,balance,18,4,14
Samesaras,darkspear,383,druid,balance,6,4,2
Kukulkann,tichondrius,383,druid,balance,6,4,2
Astrowalkerx,tichondrius,383,druid,balance,6,4,2
Papitank,drakkari,383,druid,balance,6,4,2
Kornaz,guldan,383,druid,balance,6,4,2
Balthøs,moon-guard,383,druid,balance,6,4,2
Xisloko,azralon,383,druid,balance,6,4,2
Chatdôux,zuljin,383,druid,balance,6,4,2
Thiccybear,darkspear,383,druid,balance,6,4,2
Donokokiya,destromath,383,druid,balance,6,4,2
Skke,barthilas,383,druid,balance,12,4,8
Scienttific,malganis,383,druid,balance,12,4,8
Ranchdußois,illidan,383,druid,balance,12,4,8
Nukaboom,elune,382,druid,balance,6,4,2
Druaids,kargath,382,druid,balance,6,4,2
Boomanon,illidan,382,druid,balance,6,4,2
Korduroi,malygos,380,druid,balance,12,4,8
Crotchlicker,bloodscalp,352,druid,balance,10,4,6
Cortado,thrall,351,druid,balance,14,5,9
Rahdek,azgalor,330,druid,balance,7,5,2
Kimnim,tichondrius,330,druid,balance,9,6,3
Ihjx,sargeras,330,druid,balance,11,6,5
Yangrou,tichondrius,330,druid,balance,11,5,6
Telvannì,sargeras,330,druid,balance,12,5,7
Raquelíta,stormrage,319,druid,balance,5,4,1
Tehnklox,malorne,319,druid,balance,5,4,1
Relbedo,sargeras,304,druid,balance,7,4,3
Riddickd,malfurion,288,druid,balance,11,6,5
Luuxia,tichondrius,288,druid,balance,6,3,3
Spooser,proudmoore,288,druid,balance,6,3,3
Isleyy,tichondrius,288,druid,balance,6,3,3
Voodoopipe,tichondrius,288,druid,balance,6,3,3
Loren,gorefiend,288,druid,balance,6,3,3
Icefang,tichondrius,288,druid,balance,6,3,3
Revitalize,shadowsong,288,druid,balance,6,3,3
Jammi,skywall,288,druid,balance,6,3,3
Ohsnapz,silvermoon,288,druid,balance,6,3,3
Däll,tichondrius,288,druid,balance,6,3,3
Guidoanchovz,thrall,288,druid,balance,6,3,3
Xiaoguai,tichondrius,288,druid,balance,6,3,3
Wuckfød,tichondrius,288,druid,balance,6,3,3
Gorillavoke,tichondrius,288,druid,balance,6,3,3
Meruemoo,tichondrius,288,druid,balance,6,3,3
Cutely,tichondrius,288,druid,balance,6,3,3
Eightozpatty,tichondrius,288,druid,balance,6,3,3
Ménd,thrall,288,druid,balance,6,3,3
Cbark,ravencrest,288,druid,balance,6,3,3
Silkyroad,tichondrius,288,druid,balance,6,3,3
Shaftomatic,tichondrius,288,druid,balance,6,3,3
Jyuaiai,tichondrius,288,druid,balance,6,3,3
Levelboostx,tichondrius,288,druid,balance,6,3,3
Kurodash,tichondrius,288,druid,balance,6,3,3
Kavy,tichondrius,288,druid,balance,6,3,3
Leafthief,whisperwind,288,druid,balance,6,3,3
Druidnim,tichondrius,288,druid,balance,6,3,3
Jxred,illidan,288,druid,balance,6,3,3
Bridgerén,tichondrius,288,druid,balance,6,3,3
Sylvanna,tichondrius,288,druid,balance,6,3,3
Ÿùp,tichondrius,288,druid,balance,6,3,3
Fauck,illidan,288,druid,balance,6,3,3
Teddybëar,illidan,288,druid,balance,6,3,3
Rúdo,quelthalas,288,druid,balance,6,3,3
Venturi,blackwater-raiders,288,druid,balance,6,3,3
Akiza,sargeras,288,druid,balance,6,3,3
Noheárt,kelthuzad,288,druid,balance,6,3,3
Delrin,garona,288,druid,balance,6,3,3
Icastsmells,tichondrius,288,druid,balance,6,3,3
Bleedum,guldan,288,druid,balance,6,3,3
Treebag,frostmane,288,druid,balance,6,3,3
Targeted,sargeras,288,druid,balance,6,3,3
Superwrath,khaz-modan,288,druid,balance,6,3,3
Hallwanted,area-52,288,druid,balance,6,3,3
Tokyotimxoxx,area-52,288,druid,balance,6,3,3
Rektx,area-52,288,druid,balance,6,3,3
Endingitall,illidan,288,druid,balance,6,3,3
Bearys,area-52,288,druid,balance,6,3,3
Sowo,sargeras,288,druid,balance,6,3,3
Teribad,area-52,288,druid,balance,6,3,3
Sodah,tichondrius,288,druid,balance,6,3,3
Jabawockdeez,area-52,288,druid,balance,6,3,3
Brenden,area-52,288,druid,balance,6,3,3
Haaha,area-52,288,druid,balance,6,3,3
Laazz,area-52,288,druid,balance,6,3,3
Jpylm,ysera,288,druid,balance,6,3,3
Shalaz,magtheridon,288,druid,balance,6,3,3
Kaldelar,emerald-dream,288,druid,balance,6,3,3
Besto,moon-guard,288,druid,balance,6,3,3
Tsochickenn,bleeding-hollow,288,druid,balance,6,3,3
Iploopedyogf,bleeding-hollow,288,druid,balance,6,3,3
Ghostboy,zuljin,288,druid,balance,6,3,3
Nidalie,zuljin,288,druid,balance,6,3,3
Dauncy,sargeras,288,druid,balance,6,3,3
Woopsie,malfurion,288,druid,balance,6,3,3
Alleae,stormrage,288,druid,balance,6,3,3
Silynce,tichondrius,288,druid,balance,6,3,3
Taztoc,stormrage,288,druid,balance,6,3,3
Ularmdrd,stormrage,288,druid,balance,6,3,3
Zazacat,moon-guard,288,druid,balance,6,3,3
Lelantas,stormrage,288,druid,balance,6,3,3
Azoth,hyjal,288,druid,balance,6,3,3
Vykarux,suramar,288,druid,balance,6,3,3
Bhíkkhu,stormrage,288,druid,balance,6,3,3
Papacard,stormrage,288,druid,balance,6,3,3
Sypìí,stormrage,288,druid,balance,6,3,3
Druishcat,dark-iron,288,druid,balance,6,3,3
Meatmeester,tichondrius,288,druid,balance,6,3,3
Kî,thunderlord,288,druid,balance,6,3,3
Jerm,coilfang,288,druid,balance,6,3,3
Psycloned,magtheridon,288,druid,balance,6,3,3
Yëeëeëeëehaw,illidan,288,druid,balance,6,3,3
Kalalana,illidan,288,druid,balance,6,3,3
Mayet,area-52,288,druid,balance,6,3,3
Bresmeato,barthilas,288,druid,balance,6,3,3
Beefyhealz,emerald-dream,288,druid,balance,6,3,3
Pergutory,frostmourne,288,druid,balance,6,3,3
Phlexii,jubeithos,288,druid,balance,6,3,3
Deimos,jubeithos,288,druid,balance,6,3,3
Ferar,frostmourne,288,druid,balance,6,3,3
Fengfeidruid,illidan,288,druid,balance,6,3,3
Çãñçèr,frostmourne,288,druid,balance,6,3,3
Sáwá,frostmourne,288,druid,balance,6,3,3
Jayroneowo,frostmourne,288,druid,balance,6,3,3
Rhorr,frostmourne,288,druid,balance,6,3,3
Vawdka,proudmoore,288,druid,balance,9,4,5
Krittykitkat,chogall,288,druid,balance,9,4,5
Padfot,tichondrius,288,druid,balance,9,4,5
Bigswaag,malganis,288,druid,balance,7,3,4
Xail,hyjal,288,druid,balance,8,3,5
Retsarehard,illidan,288,druid,balance,8,3,5
Wreckingcrew,emerald-dream,288,druid,balance,8,3,5
Loathe,korialstrasz,288,druid,balance,12,3,9
Moonfirebeam,illidan,288,druid,balance,12,3,9
Plye,korgath,288,druid,balance,12,3,9
Hottiecake,bronzebeard,288,druid,balance,12,3,9
Koan,proudmoore,288,druid,balance,12,3,9
Scythé,stormrage,288,druid,balance,12,3,9
Evarene,vashj,288,druid,balance,12,3,9
Uezzon,tol-barad,288,druid,balance,12,3,9
Drchronic,boulderfist,288,druid,balance,12,3,9
Boomybum,bleeding-hollow,288,druid,balance,12,3,9
Apple,saurfang,288,druid,balance,12,3,9
Davelombardo,tichondrius,288,druid,balance,12,3,9
Alalletsa,destromath,288,druid,balance,12,3,9
Machinex,illidan,288,druid,balance,12,3,9
Livelucky,tichondrius,288,druid,balance,12,3,9
Nintrus,nazjatar,288,druid,balance,12,3,9
Tsaß,bleeding-hollow,288,druid,balance,12,3,9
Cêania,moon-guard,288,druid,balance,12,3,9
Nightnes,sargeras,288,druid,balance,12,3,9
Kittystarz,tichondrius,288,druid,balance,12,3,9
Teyollocuani,sargeras,288,druid,balance,12,3,9
Xalstarrot,sargeras,288,druid,balance,12,3,9
Kitsurumi,ragnaros,288,druid,balance,12,3,9
Feyrien,dalaran,288,druid,balance,12,3,9
Meowzedon,sargeras,288,druid,balance,12,3,9
Tretzyqt,tichondrius,288,druid,balance,18,3,15
Ravii,nemesis,287,druid,balance,6,3,3
Cyios,moon-guard,287,druid,balance,6,3,3
Johnee,barthilas,287,druid,balance,6,3,3
Guston,lightbringer,287,druid,balance,6,3,3
Wweegyy,tichondrius,287,druid,balance,6,3,3
Dainerysz,proudmoore,286,druid,balance,6,3,3
Teeball,tichondrius,271,druid,balance,17,3,14
Clownprince,barthilas,256,druid,balance,10,3,7
Daltius,illidan,256,druid,balance,10,3,7
Vollzar,sargeras,255,druid,balance,11,3,8
Cryptø,azralon,240,druid,balance,7,4,3
Trahfnahrumn,moon-guard,240,druid,balance,9,3,6
Oddclaw,stormrage,239,druid,balance,5,3,2
Verielda,skullcrusher,239,druid,balance,5,3,2
Wintrader,zuljin,239,druid,balance,5,3,2
Bigtoeess,tichondrius,239,druid,balance,5,3,2
Dipdodge,illidan,224,druid,balance,10,3,7
Mclarenz,frostmourne,223,druid,balance,8,3,5
Chikntenderz,illidan,223,druid,balance,8,3,5
Mkat,illidan,223,druid,balance,8,3,5
Variandruid,kelthuzad,223,druid,balance,8,3,5
Jazzman,jubeithos,223,druid,balance,14,3,11
Eden,thrall,223,druid,balance,14,3,11
Flummoz,frostmourne,192,druid,balance,4,3,1
Zzizi,tichondrius,192,druid,balance,4,3,1
Niwßor,azralon,192,druid,balance,10,4,6
Sloppysheila,sargeras,192,druid,balance,6,2,4
Isunami,emerald-dream,192,druid,balance,6,2,4
Aprendíz,azralon,192,druid,balance,6,2,4
Potus,illidan,192,druid,balance,6,2,4
Aquaarius,nemesis,192,druid,balance,6,2,4
Drule,illidan,192,druid,balance,6,2,4
Explicít,sargeras,192,druid,balance,6,2,4
Jackdru,illidan,192,druid,balance,6,2,4
Zigh,azralon,192,druid,balance,6,2,4
Bigboomy,sargeras,192,druid,balance,6,2,4
Zinaar,dalaran,192,druid,balance,6,2,4
Alagorn,zangarmarsh,192,druid,balance,6,2,4
Enyu,sargeras,192,druid,balance,6,2,4
Hagenws,azralon,192,druid,balance,6,2,4
Bemelerberg,sargeras,192,druid,balance,6,2,4
Slavenhausen,azralon,192,druid,balance,6,2,4
Feorb,azuremyst,192,druid,balance,6,2,4
Speaks,moon-guard,192,druid,balance,6,2,4
Wtfhommie,madoran,192,druid,balance,6,2,4
Spicyorange,dalaran,192,druid,balance,6,2,4
Wokker,mannoroth,192,druid,balance,6,2,4
Hasemilë,dalaran,192,druid,balance,6,2,4
Maélstrom,goldrinn,192,druid,balance,6,2,4
Skig,stormreaver,192,druid,balance,6,2,4
Treezyn,sargeras,192,druid,balance,6,2,4
Crycloné,stormrage,192,druid,balance,6,2,4
Lilherb,azralon,192,druid,balance,6,2,4
Meowed,sargeras,192,druid,balance,6,2,4
Saìyori,area-52,192,druid,balance,6,2,4
Totorostard,tichondrius,192,druid,balance,6,2,4
Markóla,stormrage,192,druid,balance,6,2,4
Mosdu,tichondrius,192,druid,balance,6,2,4
Mythicdruid,ragnaros,192,druid,balance,6,2,4
Empowers,garrosh,192,druid,balance,6,2,4
Absentteeth,stormrage,192,druid,balance,6,2,4
Hawtzi,stormrage,192,druid,balance,6,2,4
Criturpantz,garrosh,192,druid,balance,6,2,4
Thriaror,proudmoore,192,druid,balance,6,2,4
Octacer,malfurion,192,druid,balance,6,2,4
Hoptimus,zuljin,192,druid,balance,6,2,4
Tp,dragonblight,192,druid,balance,6,2,4
Moonhorn,kelthuzad,192,druid,balance,6,2,4
Centauri,shandris,192,druid,balance,6,2,4
Bullwïnkle,uther,192,druid,balance,6,2,4
Milkz,zuljin,192,druid,balance,6,2,4
Psspsspss,kelthuzad,192,druid,balance,6,2,4
Dartius,proudmoore,192,druid,balance,6,2,4
Roodbòy,zuljin,192,druid,balance,6,2,4
Guap,bleeding-hollow,192,druid,balance,6,2,4
Hawgs,bleeding-hollow,192,druid,balance,6,2,4
Sydneey,kelthuzad,192,druid,balance,6,2,4
Lùna,barthilas,192,druid,balance,6,2,4
Satyrø,frostmourne,192,druid,balance,6,2,4
Astroprof,bloodscalp,192,druid,balance,6,2,4
Arienne,kelthuzad,192,druid,balance,6,2,4
Joobastank,arthas,192,druid,balance,6,2,4
Mòónwhisper,moon-guard,192,druid,balance,6,2,4
Laymonath,elune,192,druid,balance,6,2,4
Neferpitou,fenris,192,druid,balance,6,2,4
Baankai,frostmourne,192,druid,balance,6,2,4
Boomtastik,frostmourne,192,druid,balance,6,2,4
Hellabanx,tichondrius,192,druid,balance,6,2,4
Malcavelli,tichondrius,192,druid,balance,6,2,4
Outofreach,tichondrius,192,druid,balance,6,2,4
Linful,tichondrius,192,druid,balance,6,2,4
Pepee,tichondrius,192,druid,balance,6,2,4
Katherine,moon-guard,192,druid,balance,6,2,4
Bubblebraìn,area-52,192,druid,balance,6,2,4
Adonalsium,area-52,192,druid,balance,6,2,4
Flarkage,area-52,192,druid,balance,6,2,4
Deadpoóll,area-52,192,druid,balance,6,2,4
Loodichriss,area-52,192,druid,balance,6,2,4
Blackchina,tichondrius,192,druid,balance,6,2,4
Glynistann,bladefist,192,druid,balance,6,2,4
Lilgushy,area-52,192,druid,balance,6,2,4
Stones,lightbringer,192,druid,balance,6,2,4
Glowstixz,tichondrius,192,druid,balance,6,2,4
Artaniss,tichondrius,192,druid,balance,6,2,4
Tansdruid,area-52,192,druid,balance,6,2,4
Shredstitute,tichondrius,192,druid,balance,6,2,4
Bosscjp,tichondrius,192,druid,balance,6,2,4
Chèétøhz,moon-guard,192,druid,balance,6,2,4
Xay,runetotem,192,druid,balance,6,2,4
Hzu,kelthuzad,192,druid,balance,6,2,4
Phatê,nerzhul,192,druid,balance,6,2,4
Lappz,malganis,192,druid,balance,6,2,4
Naturan,drakkari,192,druid,balance,6,2,4
Pawswap,tichondrius,192,druid,balance,6,2,4
Patiencé,moon-guard,192,druid,balance,6,2,4
Bobobear,proudmoore,192,druid,balance,6,2,4
Srbestias,quelthalas,192,druid,balance,6,2,4
Mäûled,fizzcrank,192,druid,balance,6,2,4
Injeckx,tichondrius,192,druid,balance,6,2,4
Sweetcat,malganis,192,druid,balance,6,2,4
Norzbek,silvermoon,192,druid,balance,6,2,4
Jitlit,malganis,192,druid,balance,6,2,4
Pleomorpher,quelthalas,192,druid,balance,6,2,4
Malffurryan,draktharon,192,druid,balance,6,2,4
Bomme,zuljin,192,druid,balance,7,2,5
Panchuwuanky,sargeras,192,druid,balance,8,2,6
Kångåwålafox,sargeras,192,druid,balance,8,2,6
Murrmerly,moon-guard,192,druid,balance,12,2,10
Visûcius,moon-guard,192,druid,balance,12,2,10
Papiçhoc,quelthalas,192,druid,balance,12,2,10
Shiftage,frostmane,192,druid,balance,12,2,10
Skaidi,quelthalas,192,druid,balance,12,2,10
Gholdris,moon-guard,192,druid,balance,12,2,10
Thundyrcat,tichondrius,192,druid,balance,12,2,10
Alluminax,sargeras,192,druid,balance,12,2,10
Trisinz,perenolde,192,druid,balance,12,2,10
Rakuath,zuljin,192,druid,balance,12,2,10
Papaland,tichondrius,192,druid,balance,12,2,10
Daydaygo,illidan,192,druid,balance,12,2,10
Unhappystill,tichondrius,192,druid,balance,12,2,10
Naebliss,arygos,192,druid,balance,12,2,10
Pusscat,illidan,192,druid,balance,18,2,16
Thicchicken,emerald-dream,191,druid,balance,12,2,10
Glockenstien,proudmoore,159,druid,balance,5,2,3
Moonkingx,ragnaros,159,druid,balance,5,2,3
Stealthhero,lightbringer,159,druid,balance,5,2,3
Formality,kalecgos,159,druid,balance,5,2,3
Irontree,dunemaul,159,druid,balance,5,2,3
Xylemcow,malganis,159,druid,balance,5,2,3
Sylthren,muradin,159,druid,balance,5,2,3
Sludgischonk,stormrage,159,druid,balance,5,2,3
Mayarí,sargeras,159,druid,balance,16,3,13
Ishalu,tichondrius,138,druid,balance,6,3,3
Meianoitchê,azralon,138,druid,balance,29,7,22
Wiseoldman,jubeithos,136,druid,balance,8,3,5
Nightruffles,moon-guard,128,druid,balance,4,2,2
Yukcyducky,tichondrius,128,druid,balance,4,2,2
Aeo,frostmourne,112,druid,balance,7,2,5
Bethorâ,suramar,112,druid,balance,7,2,5
Highs,sargeras,112,druid,balance,7,2,5
Yøpièrre,bleeding-hollow,96,druid,balance,3,2,1
Stradamus,sargeras,96,druid,balance,3,2,1
Moosesolini,chogall,96,druid,balance,3,2,1
Walkdown,turalyon,96,druid,balance,6,1,5
Bullkkake,tichondrius,96,druid,balance,6,1,5
Furryluvr,tichondrius,96,druid,balance,6,1,5
Kirrel,frostmourne,96,druid,balance,6,1,5
Ggumy,tichondrius,96,druid,balance,6,1,5
Selling,moon-guard,96,druid,balance,6,1,5
Florgsgorgan,sargeras,96,druid,balance,6,1,5
Goodhealer,akama,96,druid,balance,6,1,5
Faldrynn,sargeras,96,druid,balance,6,1,5
Omegabeast,frostmourne,96,druid,balance,6,1,5
Travys,sargeras,96,druid,balance,6,1,5
Twentypeice,tichondrius,96,druid,balance,6,1,5
Dendríta,ragnaros,96,druid,balance,6,1,5
Scatpanties,moon-guard,96,druid,balance,6,1,5
Torpina,malganis,96,druid,balance,6,1,5
Notdev,grizzly-hills,96,druid,balance,6,1,5
Anímorph,sargeras,96,druid,balance,6,1,5
Chulogringo,tichondrius,96,druid,balance,6,1,5
Oyweklefga,kelthuzad,96,druid,balance,6,1,5
Thissaene,sargeras,96,druid,balance,6,1,5
Øvernight,azralon,96,druid,balance,6,1,5
Sheeftah,illidan,96,druid,balance,6,1,5
Ultracatx,tichondrius,96,druid,balance,6,1,5
Keithmoonkin,area-52,96,druid,balance,6,1,5
Stalfrus,area-52,96,druid,balance,6,1,5
Abellia,moon-guard,96,druid,balance,6,1,5
Gaìjin,barthilas,96,druid,balance,6,1,5
Aeoc,barthilas,96,druid,balance,6,1,5
Sneakydikns,tichondrius,96,druid,balance,6,1,5
Caponetonejr,steamwheedle-cartel,96,druid,balance,6,1,5
Interfury,magtheridon,96,druid,balance,6,1,5
Stinkycrotch,malganis,96,druid,balance,6,1,5
Breedable,elune,96,druid,balance,6,1,5
Bernwolf,moon-guard,96,druid,balance,6,1,5
Shmooglite,emerald-dream,96,druid,balance,6,1,5
Invisakitty,demon-soul,96,druid,balance,6,1,5
Fioryxd,bleeding-hollow,96,druid,balance,6,1,5
Hurloon,demon-soul,96,druid,balance,6,1,5
Slackoth,dalaran,96,druid,balance,6,1,5
Aelena,whisperwind,96,druid,balance,6,1,5
Jorkalak,zuljin,96,druid,balance,6,1,5
Elivacheth,zuljin,96,druid,balance,6,1,5
Bpdferal,stormrage,96,druid,balance,6,1,5
Sundae,khazgoroth,96,druid,balance,6,1,5
Watchlady,thunderhorn,96,druid,balance,6,1,5
Brucey,khadgar,96,druid,balance,6,1,5
Dráz,stormrage,96,druid,balance,6,1,5
Sinapticc,proudmoore,96,druid,balance,6,1,5
Edorant,illidan,96,druid,balance,6,1,5
Chalupà,illidan,96,druid,balance,6,1,5
Youlived,aegwynn,96,druid,balance,6,1,5
Boomhówer,illidan,96,druid,balance,6,1,5
Oldcktwist,garrosh,96,druid,balance,6,1,5
Earthstalker,crushridge,96,druid,balance,6,1,5
Scarn,nathrezim,96,druid,balance,6,1,5
Zazinium,illidan,96,druid,balance,6,1,5
Treepaw,hyjal,96,druid,balance,6,1,5
Drilnos,hyjal,96,druid,balance,6,1,5
Melez,kelthuzad,96,druid,balance,6,1,5
Shifterjr,illidan,96,druid,balance,6,1,5
Feralmain,illidan,96,druid,balance,6,1,5
Zackfromwow,illidan,96,druid,balance,6,1,5
Kipsmiffly,darkspear,96,druid,balance,6,1,5
Rennan,cenarius,96,druid,balance,6,1,5
Jonculler,korgath,96,druid,balance,6,1,5
Klint,darkspear,96,druid,balance,6,1,5
Encosan,azralon,96,druid,balance,7,1,6
Simbaa,blades-edge,96,druid,balance,10,1,9
Ravendawnn,tichondrius,96,druid,balance,12,1,11
Kängawalafox,frostmourne,96,druid,balance,12,1,11
Kodrän,stormrage,96,druid,balance,12,1,11
Grimmb,emerald-dream,96,druid,balance,12,1,11
Ranokaliki,tichondrius,89,druid,balance,10,3,7
Gorfrog,tichondrius,84,druid,balance,13,6,7
Drewcarriesu,arthas,79,druid,balance,5,2,3
Manalune,firetree,79,druid,balance,5,1,4
Hydraulick,tichondrius,79,druid,balance,5,1,4
Raahmirtah,illidan,79,druid,balance,5,1,4
Lutzenberger,nemesis,79,druid,balance,5,1,4
Zephiee,kelthuzad,79,druid,balance,5,1,4
Foggie,spirestone,79,druid,balance,5,1,4
Doingo,destromath,79,druid,balance,11,1,10
Dso,tichondrius,64,druid,balance,4,1,3
Morpheûs,bleeding-hollow,64,druid,balance,4,1,3
Hughhefferr,illidan,63,druid,balance,2,2,0
Fyrleaf,lightnings-blade,48,druid,balance,3,1,2
Vleib,ragnaros,31,druid,balance,2,1,1
Tsubakihara,azralon,16,druid,balance,1,1,0
Garbagevoker,scilla,2242,evoker,preservation,192,99,93
Sleepiiheadx,stormrage,2197,evoker,preservation,132,76,56
Dracob,sargeras,2180,evoker,preservation,252,140,112
Sleepiihead,stormrage,2130,evoker,preservation,96,50,46
Meraxes,moonrunner,2124,evoker,preservation,131,64,67
Dragocula,tichondrius,2106,evoker,preservation,109,55,54
Sheepstealer,shuhalo,2104,evoker,preservation,133,69,64
Dracobys,area-52,2063,evoker,preservation,76,43,33
Jakedrake,stormrage,2062,evoker,preservation,235,117,118
Kallie,whisperwind,2059,evoker,preservation,596,302,294
Mkabaka,tichondrius,2027,evoker,preservation,147,81,66
Eyjes,stormrage,2016,evoker,preservation,252,133,119
Idk,proudmoore,2004,evoker,preservation,66,34,32
Goatkiller,lightbringer,2000,evoker,preservation,72,34,38
Eskrizzle,thrall,1991,evoker,preservation,78,38,40
Walf,stormrage,1983,evoker,preservation,409,211,198
Jdbthyr,malganis,1974,evoker,preservation,276,133,143
Didy,tichondrius,1973,evoker,preservation,388,195,193
Lucardeht,illidan,1970,evoker,preservation,92,46,46
Storeypagoda,tichondrius,1964,evoker,preservation,169,86,83
Draggin,barthilas,1953,evoker,preservation,60,31,29
Ellafortnite,emerald-dream,1942,evoker,preservation,61,33,28
Dreamfuego,tichondrius,1940,evoker,preservation,72,34,38
Idrinkurine,tichondrius,1918,evoker,preservation,88,45,43
Zarref,sargeras,1916,evoker,preservation,72,33,39
Advancedonly,tichondrius,1912,evoker,preservation,54,26,28
Healpumper,kelthuzad,1905,evoker,preservation,88,48,40
Kiry,emerald-dream,1902,evoker,preservation,126,59,67
Soô,tichondrius,1900,evoker,preservation,36,20,16
Sloane,dunemaul,1899,evoker,preservation,51,32,19
Dracthyrfang,elune,1895,evoker,preservation,250,122,128
Drupy,tichondrius,1890,evoker,preservation,66,34,32
Thnake,zuljin,1889,evoker,preservation,96,53,43
Ravebae,frostmourne,1889,evoker,preservation,73,37,36
Echowrath,tichondrius,1885,evoker,preservation,72,34,38
Philmcracken,proudmoore,1883,evoker,preservation,34,24,10
Kycaka,area-52,1874,evoker,preservation,76,33,43
Benym,tichondrius,1873,evoker,preservation,60,32,28
Lieferant,area-52,1867,evoker,preservation,48,25,23
Draconian,frostmourne,1866,evoker,preservation,76,36,40
Bimbus,illidan,1857,evoker,preservation,165,89,76
Dragongunz,illidan,1853,evoker,preservation,48,21,27
Selkisaurus,area-52,1852,evoker,preservation,114,53,61
Cenchii,proudmoore,1851,evoker,preservation,60,30,30
Dragonkok,stormrage,1848,evoker,preservation,48,28,20
Dweamfuego,sargeras,1846,evoker,preservation,36,24,12
Versezz,tichondrius,1846,evoker,preservation,48,29,19
Joc,khazgoroth,1841,evoker,preservation,113,63,50
Ancalagðn,quelthalas,1841,evoker,preservation,131,64,67
Patzdormu,area-52,1839,evoker,preservation,109,51,58
Dracadukez,illidan,1836,evoker,preservation,119,50,69
Ancalagøn,ragnaros,1833,evoker,preservation,70,35,35
Ojigi,sargeras,1833,evoker,preservation,69,28,41
Evokethisdik,tichondrius,1831,evoker,preservation,55,29,26
Iba,tichondrius,1828,evoker,preservation,96,54,42
Hamine,tichondrius,1825,evoker,preservation,113,52,61
Usedbandage,sargeras,1824,evoker,preservation,283,151,132
Voíd,sargeras,1814,evoker,preservation,45,29,16
Usedaspirin,sargeras,1813,evoker,preservation,42,24,18
Lodedragon,tichondrius,1813,evoker,preservation,179,88,91
Mikoriivoker,tichondrius,1813,evoker,preservation,60,25,35
Dragboy,stormrage,1812,evoker,preservation,187,107,80
Mngxaltx,ragnaros,1810,evoker,preservation,96,42,54
Hlaargh,illidan,1809,evoker,preservation,60,31,29
Dragonclause,stormrage,1809,evoker,preservation,72,32,40
Aymadragon,sargeras,1807,evoker,preservation,68,38,30
Furegos,zuljin,1807,evoker,preservation,48,23,25
Lodekiim,malganis,1806,evoker,preservation,66,30,36
Mcdonovan,stormrage,1805,evoker,preservation,81,36,45
Neskor,moon-guard,1804,evoker,preservation,119,66,53
Yoyke,tichondrius,1804,evoker,preservation,84,41,43
Velstrasza,stormrage,1802,evoker,preservation,54,29,25
Dragonchip,bleeding-hollow,1801,evoker,preservation,101,46,55
Obama,dragonmaw,1801,evoker,preservation,78,33,45
Ghîdøråh,moon-guard,1801,evoker,preservation,48,19,29
Novustrasza,lightbringer,1800,evoker,preservation,66,43,23
Petezra,ragnaros,1800,evoker,preservation,70,33,37
Allevesh,shadow-council,1798,evoker,preservation,52,28,24
Livesey,thunderhorn,1792,evoker,preservation,102,59,43
Driceses,area-52,1788,evoker,preservation,95,54,41
Flybro,malganis,1787,evoker,preservation,30,19,11
Basedfurry,dalaran,1786,evoker,preservation,48,25,23
Drerick,illidan,1772,evoker,preservation,104,53,51
Fatsu,executus,1768,evoker,preservation,54,24,30
Dragontrees,illidan,1765,evoker,preservation,54,28,26
Enderal,stormrage,1765,evoker,preservation,48,24,24
Vulkerr,stormrage,1756,evoker,preservation,224,123,101
Elimi,tichondrius,1748,evoker,preservation,36,22,14
Áäøxgød,ravencrest,1747,evoker,preservation,204,97,107
Berquone,tichondrius,1747,evoker,preservation,72,31,41
Starkiller,stormrage,1745,evoker,preservation,60,37,23
Schmitty,hellscream,1738,evoker,preservation,106,53,53
Phooby,sargeras,1736,evoker,preservation,72,37,35
Rosestrasza,silvermoon,1734,evoker,preservation,132,63,69
Twizzthyr,bleeding-hollow,1732,evoker,preservation,192,98,94
Stønemonkey,sargeras,1730,evoker,preservation,147,73,74
Basherm,moon-guard,1729,evoker,preservation,108,54,54
Pootylizard,daggerspine,1729,evoker,preservation,62,26,36
Thugzillah,tichondrius,1728,evoker,preservation,103,68,35
Miradrake,icecrown,1728,evoker,preservation,42,21,21
Fxii,tichondrius,1727,evoker,preservation,151,85,66
Révoked,magtheridon,1724,evoker,preservation,359,196,163
Dirtydragon,uther,1724,evoker,preservation,54,22,32
Kainalaz,moon-guard,1715,evoker,preservation,55,28,27
Moralies,area-52,1705,evoker,preservation,48,24,24
Venitsu,malganis,1705,evoker,preservation,36,18,18
Benbm,proudmoore,1703,evoker,preservation,36,18,18
Chronoloop,tichondrius,1699,evoker,preservation,32,21,11
Siire,tichondrius,1697,evoker,preservation,36,19,17
Dunkinonem,black-dragonflight,1697,evoker,preservation,987,492,495
Drepz,dalaran,1696,evoker,preservation,117,79,38
Deathdrake,jubeithos,1696,evoker,preservation,233,115,118
Chañïng,frostmourne,1695,evoker,preservation,36,18,18
Redeyesblm,sargeras,1693,evoker,preservation,37,21,16
Whelp,shadow-council,1689,evoker,preservation,30,18,12
Mikoribreath,moknathal,1685,evoker,preservation,30,18,12
Mirandaxo,tichondrius,1684,evoker,preservation,161,73,88
Ugg,stormrage,1684,evoker,preservation,189,82,107
Skyheal,ragnaros,1683,evoker,preservation,42,22,20
Whethersmell,tichondrius,1678,evoker,preservation,224,110,114
Yukiormi,sargeras,1677,evoker,preservation,36,18,18
Halcyonxz,tichondrius,1677,evoker,preservation,48,23,25
Flamedramon,bleeding-hollow,1673,evoker,preservation,366,175,191
Seviant,tichondrius,1671,evoker,preservation,48,20,28
Wimsx,malganis,1670,evoker,preservation,149,75,74
Dupastrasza,illidan,1664,evoker,preservation,60,25,35
Gharkul,frostmourne,1663,evoker,preservation,48,25,23
Got,burning-blade,1660,evoker,preservation,56,30,26
Tallcanman,kelthuzad,1660,evoker,preservation,42,20,22
Stinkler,stormscale,1659,evoker,preservation,126,63,63
Cannotjump,tichondrius,1653,evoker,preservation,60,27,33
Flyboy,malganis,1649,evoker,preservation,42,23,19
Redseal,tichondrius,1648,evoker,preservation,116,55,61
Sandragon,ragnaros,1646,evoker,preservation,57,25,32
Dragonman,twisting-nether,1645,evoker,preservation,59,33,26
Domavem,tichondrius,1642,evoker,preservation,66,28,38
Sanninv,barthilas,1638,evoker,preservation,57,26,31
Cycircle,proudmoore,1637,evoker,preservation,41,23,18
Cokobra,haomarush,1636,evoker,preservation,36,21,15
Modenzu,malganis,1635,evoker,preservation,90,45,45
Christína,tichondrius,1634,evoker,preservation,93,62,31
Trákanon,mugthol,1634,evoker,preservation,67,37,30
Ðrac,bleeding-hollow,1633,evoker,preservation,53,30,23
Dripdrop,stormscale,1629,evoker,preservation,100,52,48
Tinine,frostmourne,1626,evoker,preservation,150,77,73
Zullavoker,bleeding-hollow,1625,evoker,preservation,42,29,13
Baldpython,area-52,1625,evoker,preservation,32,19,13
Wingsoflyfe,frostmourne,1625,evoker,preservation,48,20,28
Yop,proudmoore,1624,evoker,preservation,108,45,63
Briggsybear,malganis,1622,evoker,preservation,82,48,34
Dragondikz,tichondrius,1622,evoker,preservation,48,25,23
Congodragon,frostmourne,1620,evoker,preservation,48,28,20
Buttcrease,emerald-dream,1620,evoker,preservation,60,33,27
Dgevoker,tichondrius,1620,evoker,preservation,47,19,28
Raptormoto,lothar,1619,evoker,preservation,44,19,25
Lucidreamx,tichondrius,1618,evoker,preservation,73,39,34
Jacm,fizzcrank,1616,evoker,preservation,141,73,68
Snuggleboo,malganis,1614,evoker,preservation,39,28,11
Grunkthyr,moon-guard,1614,evoker,preservation,53,28,25
Trembulos,malganis,1613,evoker,preservation,96,51,45
Egglayer,tichondrius,1611,evoker,preservation,196,91,105
Leonilxd,tichondrius,1610,evoker,preservation,97,51,46
Bigdwagon,stormrage,1608,evoker,preservation,36,17,19
Triarcs,sargeras,1606,evoker,preservation,40,21,19
Handeezol,malganis,1605,evoker,preservation,89,56,33
Yessirs,shadow-council,1604,evoker,preservation,28,19,9
Dragisha,gnomeregan,1604,evoker,preservation,190,106,84
Emperör,quelthalas,1604,evoker,preservation,109,58,51
Deadlybx,bleeding-hollow,1603,evoker,preservation,70,32,38
Fláppÿbírd,bleeding-hollow,1601,evoker,preservation,30,19,11
Layugos,azralon,1601,evoker,preservation,35,20,15
Provokker,drakkari,1600,evoker,preservation,30,21,9
Purrlynn,tichondrius,1600,evoker,preservation,72,42,30
Judra,barthilas,1599,evoker,preservation,104,51,53
Jnitoscaly,tichondrius,1598,evoker,preservation,30,20,10
Chessyk,ragnaros,1598,evoker,preservation,59,36,23
Daegonz,lightbringer,1597,evoker,preservation,134,63,71
Nyzara,emerald-dream,1595,evoker,preservation,192,97,95
Kwebab,tichondrius,1595,evoker,preservation,48,19,29
Imugee,sargeras,1592,evoker,preservation,36,20,16
Djvoker,zuljin,1589,evoker,preservation,36,22,14
Elcigala,ragnaros,1589,evoker,preservation,325,168,157
Raundur,ragnaros,1588,evoker,preservation,36,19,17
Junkstam,malganis,1587,evoker,preservation,96,43,53
Dwagndeez,tichondrius,1587,evoker,preservation,78,33,45
Adragon,garithos,1585,evoker,preservation,77,30,47
Thinprivlege,area-52,1583,evoker,preservation,60,26,34
Unidragon,malganis,1581,evoker,preservation,54,22,32
Evokesyn,stormrage,1580,evoker,preservation,105,55,50
Neocellx,frostwolf,1579,evoker,preservation,147,69,78
Whelpling,cenarion-circle,1577,evoker,preservation,30,23,7
Sineexe,illidan,1570,evoker,preservation,104,63,41
Drakjar,nemesis,1569,evoker,preservation,72,34,38
Hotblower,tichondrius,1565,evoker,preservation,61,22,39
Bynaero,area-52,1563,evoker,preservation,57,25,32
Linkinloatr,tichondrius,1563,evoker,preservation,54,23,31
Møritz,stormrage,1562,evoker,preservation,86,40,46
Dmt,ravencrest,1559,evoker,preservation,30,18,12
Xboy,tichondrius,1556,evoker,preservation,49,23,26
Bigbaojian,tichondrius,1555,evoker,preservation,71,34,37
Azarke,rivendare,1554,evoker,preservation,42,20,22
Vhaegart,area-52,1553,evoker,preservation,141,66,75
Dougreen,azralon,1552,evoker,preservation,38,18,20
Shruikan,lightnings-blade,1552,evoker,preservation,42,19,23
Seeyn,tichondrius,1551,evoker,preservation,89,35,54
Dracore,firetree,1549,evoker,preservation,215,112,103
Alitasbbq,malganis,1547,evoker,preservation,48,19,29
Ffaarrvv,illidan,1545,evoker,preservation,108,63,45
Nakyp,dalaran,1544,evoker,preservation,36,18,18
Tonysaur,lethon,1537,evoker,preservation,30,19,11
Prettycooll,dathremar,1537,evoker,preservation,36,17,19
Kwitty,illidan,1535,evoker,preservation,48,27,21
Suffler,warsong,1535,evoker,preservation,279,146,133
Stinkybussy,mannoroth,1533,evoker,preservation,65,37,28
Vormontis,azralon,1533,evoker,preservation,158,79,79
Corncrake,sargeras,1530,evoker,preservation,50,23,27
Jlucks,wyrmrest-accord,1529,evoker,preservation,172,94,78
Arnoeryan,ragnaros,1526,evoker,preservation,60,33,27
Velocîraptor,bleeding-hollow,1524,evoker,preservation,92,53,39
Qiblii,moon-guard,1524,evoker,preservation,72,38,34
Transmogplz,tichondrius,1522,evoker,preservation,66,27,39
Spyrotime,tichondrius,1521,evoker,preservation,39,16,23
Nulldd,tichondrius,1521,evoker,preservation,59,21,38
Gobananas,sargeras,1520,evoker,preservation,29,17,12
Nøzmosis,area-52,1519,evoker,preservation,158,90,68
Jimmydragon,blackhand,1518,evoker,preservation,108,47,61
Longaot,tichondrius,1517,evoker,preservation,114,66,48
Zenot,malganis,1516,evoker,preservation,59,38,21
Asschaps,area-52,1513,evoker,preservation,72,38,34
Dragocser,drakkari,1513,evoker,preservation,48,24,24
Dragonsteppz,aegwynn,1512,evoker,preservation,30,16,14
Mfka,dalaran,1512,evoker,preservation,83,39,44
Earthshatter,lightbringer,1510,evoker,preservation,166,91,75
Slizards,area-52,1510,evoker,preservation,66,25,41
Dragdezenutz,bleeding-hollow,1508,evoker,preservation,112,45,67
Veraxsys,wyrmrest-accord,1507,evoker,preservation,67,23,44
Ajiz,mannoroth,1505,evoker,preservation,54,27,27
Hakyou,tichondrius,1504,evoker,preservation,119,54,65
Dröhkar,ragnaros,1504,evoker,preservation,48,20,28
Spyrox,zuluhed,1503,evoker,preservation,60,33,27
Rõen,tichondrius,1501,evoker,preservation,36,16,20
Youngyongdie,tichondrius,1499,evoker,preservation,52,25,27
Grousegamer,barthilas,1498,evoker,preservation,88,38,50
Zakaraki,bloodscalp,1494,evoker,preservation,201,110,91
Kratheu,azralon,1494,evoker,preservation,53,26,27
Drustkin,illidan,1494,evoker,preservation,77,37,40
Slimez,malganis,1494,evoker,preservation,236,111,125
Beautylily,tichondrius,1492,evoker,preservation,311,172,139
Masondragon,darkspear,1492,evoker,preservation,36,16,20
Thevochr,area-52,1491,evoker,preservation,48,29,19
Kaidagos,tichondrius,1491,evoker,preservation,60,32,28
Unknowndrago,kul-tiras,1491,evoker,preservation,42,22,20
Emoker,magtheridon,1490,evoker,preservation,84,46,38
Splendadaddy,kiljaeden,1490,evoker,preservation,48,22,26
Runawayslave,frostmane,1489,evoker,preservation,239,114,125
Dragoncods,velen,1488,evoker,preservation,48,26,22
Buttfinger,bladefist,1488,evoker,preservation,86,39,47
Hepzibah,kelthuzad,1488,evoker,preservation,53,23,30
Vokr,area-52,1487,evoker,preservation,248,119,129
Virtualcrush,sisters-of-elune,1486,evoker,preservation,94,49,45
Nfts,darkspear,1486,evoker,preservation,40,18,22
Skrimbles,tichondrius,1486,evoker,preservation,54,24,30
Kozaraler,stormrage,1485,evoker,preservation,84,46,38
Waggon,moon-guard,1484,evoker,preservation,88,45,43
Nikholatrus,malganis,1483,evoker,preservation,106,52,54
Darchomp,illidan,1478,evoker,preservation,42,17,25
Ineptqt,frostmourne,1477,evoker,preservation,42,21,21
Pauly,suramar,1476,evoker,preservation,118,60,58
Ralzital,auchindoun,1476,evoker,preservation,68,29,39
Yotus,illidan,1474,evoker,preservation,60,35,25
Ninereeds,malganis,1473,evoker,preservation,185,89,96
Evoskunk,kelthuzad,1472,evoker,preservation,54,28,26
Cyndragosa,dalvengyr,1471,evoker,preservation,149,68,81
Diavai,area-52,1471,evoker,preservation,93,41,52
Bucket,wyrmrest-accord,1469,evoker,preservation,78,34,44
Venjolly,wyrmrest-accord,1468,evoker,preservation,90,47,43
Quickshootin,tichondrius,1468,evoker,preservation,367,177,190
Eyolker,kelthuzad,1467,evoker,preservation,94,47,47
Monavoker,bleeding-hollow,1466,evoker,preservation,36,20,16
Ponnukii,tichondrius,1466,evoker,preservation,184,93,91
Madegood,tichondrius,1465,evoker,preservation,72,32,40
Setalet,zuljin,1465,evoker,preservation,47,19,28
Weagle,zuljin,1465,evoker,preservation,45,18,27
Necrathma,tichondrius,1461,evoker,preservation,169,84,85
Puffdad,kiljaeden,1460,evoker,preservation,28,19,9
Macismighty,emerald-dream,1460,evoker,preservation,119,65,54
Enazen,kiljaeden,1460,evoker,preservation,83,45,38
Uneedawhip,zuljin,1457,evoker,preservation,36,19,17
Ycnpass,tichondrius,1456,evoker,preservation,158,89,69
Datinysmaug,stormrage,1456,evoker,preservation,65,28,37
Stableboy,bleeding-hollow,1455,evoker,preservation,54,27,27
Lalargata,azralon,1455,evoker,preservation,77,38,39
Cringilisk,kelthuzad,1454,evoker,preservation,126,82,44
Xerroh,area-52,1451,evoker,preservation,142,77,65
Miliolievo,azralon,1450,evoker,preservation,337,172,165
Suedeshoes,bleeding-hollow,1448,evoker,preservation,162,88,74
Nyxtari,ragnaros,1447,evoker,preservation,108,57,51
Nazzadormu,tichondrius,1445,evoker,preservation,70,30,40
Linguistic,tichondrius,1444,evoker,preservation,48,21,27
Squarter,kiljaeden,1443,evoker,preservation,60,34,26
Kjerne,stormrage,1443,evoker,preservation,81,43,38
Hageiz,tichondrius,1441,evoker,preservation,60,27,33
Norvoker,area-52,1440,evoker,preservation,75,39,36
Ttvfòxyllamà,tichondrius,1439,evoker,preservation,30,15,15
Caredormu,frostmourne,1437,evoker,preservation,63,30,33
Xaxas,boulderfist,1437,evoker,preservation,36,16,20
Jácorex,proudmoore,1436,evoker,preservation,104,47,57
Aetherz,illidan,1434,evoker,preservation,36,15,21
Dragonmyass,tichondrius,1434,evoker,preservation,43,17,26
Darthjarjar,bloodscalp,1433,evoker,preservation,333,169,164
Slither,terenas,1432,evoker,preservation,212,111,101
Biggestbroie,frostmourne,1431,evoker,preservation,30,15,15
Dragonkink,sargeras,1429,evoker,preservation,61,32,29
Macdrag,malganis,1428,evoker,preservation,30,17,13
Kymoxien,sargeras,1427,evoker,preservation,30,16,14
Eldenkingy,sargeras,1426,evoker,preservation,96,42,54
Gloamdream,cenarius,1425,evoker,preservation,381,202,179
Sovietønion,tichondrius,1425,evoker,preservation,83,38,45
Nandrolona,sargeras,1423,evoker,preservation,30,15,15
Spyrodadrago,malganis,1423,evoker,preservation,113,50,63
Annum,moon-guard,1423,evoker,preservation,60,22,38
Nandrolona,malganis,1422,evoker,preservation,30,15,15
Zka,nemesis,1421,evoker,preservation,55,28,27
Bendover,proudmoore,1420,evoker,preservation,42,22,20
Laggathaa,emerald-dream,1420,evoker,preservation,62,29,33
Dracndanuts,draenor,1420,evoker,preservation,61,28,33
Epsilon,laughing-skull,1419,evoker,preservation,24,15,9
Enalen,azjolnerub,1419,evoker,preservation,179,96,83
Evokeo,area-52,1417,evoker,preservation,30,15,15
Nazatra,wyrmrest-accord,1417,evoker,preservation,125,60,65
Zaedor,stormrage,1416,evoker,preservation,40,26,14
Meiron,azralon,1413,evoker,preservation,78,39,39
Gannsito,emerald-dream,1411,evoker,preservation,36,20,16
Fusrodude,shuhalo,1411,evoker,preservation,98,53,45
Kcwt,illidan,1411,evoker,preservation,113,55,58
Tørched,icecrown,1409,evoker,preservation,30,17,13
Uzuhl,zuljin,1409,evoker,preservation,71,32,39
Apollygos,malganis,1406,evoker,preservation,78,41,37
Kigglypuff,illidan,1406,evoker,preservation,36,15,21
Deshandrov,bleeding-hollow,1404,evoker,preservation,36,23,13
Cyntheticdr,malganis,1404,evoker,preservation,54,30,24
Roogye,illidan,1403,evoker,preservation,96,49,47
Fuzzievoker,tichondrius,1403,evoker,preservation,36,15,21
Sía,drakkari,1402,evoker,preservation,66,39,27
Masquemeto,illidan,1402,evoker,preservation,55,28,27
Courtvoke,turalyon,1402,evoker,preservation,233,117,116
Kaldobar,stormrage,1401,evoker,preservation,24,15,9
Naykir,khazgoroth,1400,evoker,preservation,42,27,15
Anthyrsia,zuljin,1400,evoker,preservation,47,24,23
Coldspawn,nerzhul,1400,evoker,preservation,30,15,15
Thicscales,tichondrius,1400,evoker,preservation,76,36,40
Erotheryx,gorgonnash,1399,evoker,preservation,95,51,44
Dylôn,tichondrius,1398,evoker,preservation,58,27,31
Garchamp,area-52,1396,evoker,preservation,54,22,32
Spyro,ravencrest,1395,evoker,preservation,42,22,20
Vyndormu,moon-guard,1394,evoker,preservation,67,32,35
Ráigon,ragnaros,1394,evoker,preservation,142,64,78
Derazar,malganis,1391,evoker,preservation,288,128,160
Jmir,tichondrius,1389,evoker,preservation,59,24,35
Vxfire,sargeras,1382,evoker,preservation,36,17,19
Dawitchvoker,illidan,1381,evoker,preservation,475,245,230
Gogmagog,korgath,1381,evoker,preservation,95,43,52
Jamörant,tichondrius,1378,evoker,preservation,24,15,9
Santokki,tichondrius,1378,evoker,preservation,158,76,82
Delivv,hyjal,1376,evoker,preservation,114,56,58
Tazarke,dawnbringer,1375,evoker,preservation,60,35,25
Flowsmoke,tichondrius,1375,evoker,preservation,78,40,38
Tigthyr,alleria,1375,evoker,preservation,30,15,15
Csodragon,sargeras,1374,evoker,preservation,48,25,23
Bigdrag,blackhand,1373,evoker,preservation,103,56,47
Kalikani,moon-guard,1373,evoker,preservation,123,59,64
Aspects,dreadmaul,1372,evoker,preservation,37,17,20
Zmaj,jubeithos,1371,evoker,preservation,55,36,19
Dragonpel,azralon,1371,evoker,preservation,124,62,62
Chambea,kelthuzad,1370,evoker,preservation,77,40,37
Errier,tichondrius,1370,evoker,preservation,33,17,16
Primshin,illidan,1370,evoker,preservation,123,62,61
Cjin,tichondrius,1370,evoker,preservation,36,18,18
Greenscales,frostmourne,1370,evoker,preservation,111,47,64
Healmeta,sargeras,1369,evoker,preservation,308,154,154
Vodkasauce,tichondrius,1369,evoker,preservation,30,15,15
Drakkar,elune,1367,evoker,preservation,66,20,46
Tzindelor,illidan,1364,evoker,preservation,60,27,33
Glizzurd,proudmoore,1363,evoker,preservation,309,154,155
Giratina,area-52,1363,evoker,preservation,132,61,71
Jinuva,tichondrius,1360,evoker,preservation,46,25,21
Otsira,frostmourne,1359,evoker,preservation,60,37,23
Friedwings,wyrmrest-accord,1359,evoker,preservation,27,16,11
Wtsgoldpst,tichondrius,1357,evoker,preservation,32,18,14
Kikokosta,tichondrius,1356,evoker,preservation,287,144,143
Misico,illidan,1355,evoker,preservation,78,46,32
Growthyy,malganis,1354,evoker,preservation,57,32,25
Thepplschamp,bloodhoof,1354,evoker,preservation,48,23,25
Kannakamui,malganis,1354,evoker,preservation,54,25,29
Cosmodrake,daggerspine,1352,evoker,preservation,54,24,30
Cynderrellaa,proudmoore,1351,evoker,preservation,164,81,83
Bomber,frostwolf,1351,evoker,preservation,34,16,18
Quesodillas,stormreaver,1349,evoker,preservation,66,27,39
Tigdragon,proudmoore,1348,evoker,preservation,36,16,20
Velzelya,zuljin,1348,evoker,preservation,82,36,46
Biagi,proudmoore,1347,evoker,preservation,28,17,11
Garboker,area-52,1346,evoker,preservation,158,75,83
Salusx,proudmoore,1345,evoker,preservation,42,18,24
Sabledraco,stormrage,1344,evoker,preservation,18,14,4
Kîñggïgàçhäð,stormrage,1343,evoker,preservation,24,14,10
Feijiwang,aegwynn,1342,evoker,preservation,69,41,28
Boseijwho,emerald-dream,1342,evoker,preservation,66,36,30
Mordrakhuul,chogall,1342,evoker,preservation,84,35,49
Kalsit,emerald-dream,1341,evoker,preservation,64,30,34
Originull,tichondrius,1340,evoker,preservation,24,14,10
Dracniel,illidan,1340,evoker,preservation,81,45,36
Frëëbîë,area-52,1339,evoker,preservation,93,48,45
Actïoncat,emerald-dream,1338,evoker,preservation,69,26,43
Whirlydirly,malganis,1337,evoker,preservation,24,14,10
Fionyan,proudmoore,1337,evoker,preservation,36,14,22
Gumbåll,bleeding-hollow,1335,evoker,preservation,192,93,99
Bryagh,executus,1334,evoker,preservation,54,28,26
Forsakentime,sargeras,1333,evoker,preservation,60,32,28
Unclelroh,kelthuzad,1333,evoker,preservation,30,14,16
Chunkè,moon-guard,1332,evoker,preservation,69,29,40
Panicnodisco,zuljin,1331,evoker,preservation,24,14,10
Sylf,kiljaeden,1331,evoker,preservation,225,121,104
Nitalzith,area-52,1331,evoker,preservation,54,27,27
Neffiie,dalaran,1331,evoker,preservation,106,50,56
Léthée,zuljin,1331,evoker,preservation,30,14,16
Ultis,tichondrius,1330,evoker,preservation,471,241,230
Kephii,eonar,1330,evoker,preservation,75,35,40
Meepslol,kiljaeden,1330,evoker,preservation,30,14,16
Paladinex,tichondrius,1329,evoker,preservation,53,32,21
Mäverick,kelthuzad,1327,evoker,preservation,35,23,12
Faffytwo,illidan,1327,evoker,preservation,30,14,16
Radragão,azralon,1326,evoker,preservation,48,28,20
Sighevoker,thrall,1325,evoker,preservation,30,14,16
Lifewing,bleeding-hollow,1324,evoker,preservation,73,27,46
Lilithlittle,daggerspine,1323,evoker,preservation,359,179,180
Gavstarz,frostmourne,1322,evoker,preservation,90,40,50
Dendywings,zuljin,1321,evoker,preservation,30,14,16
Elurb,illidan,1320,evoker,preservation,84,39,45
Caphe,nerzhul,1319,evoker,preservation,72,32,40
Cadwaladr,frostmourne,1317,evoker,preservation,24,14,10
Velaryonhero,arthas,1313,evoker,preservation,74,40,34
Mikorivoker,illidan,1310,evoker,preservation,23,14,9
Solong,sargeras,1310,evoker,preservation,67,38,29
Inkdsy,detheroc,1310,evoker,preservation,30,16,14
Jazzdragon,tichondrius,1310,evoker,preservation,51,24,27
Nuunos,tichondrius,1309,evoker,preservation,47,19,28
Verk,deathwing,1308,evoker,preservation,168,89,79
Benjaminamin,stormrage,1307,evoker,preservation,36,23,13
Whinks,zangarmarsh,1307,evoker,preservation,35,18,17
Saviorkai,barthilas,1306,evoker,preservation,22,15,7
Charbothyr,gorgonnash,1304,evoker,preservation,73,35,38
Aeonwish,stormrage,1303,evoker,preservation,30,14,16
Wangasaur,emerald-dream,1302,evoker,preservation,55,26,29
Matchamjölk,tichondrius,1302,evoker,preservation,53,23,30
Fuoco,kiljaeden,1299,evoker,preservation,62,31,31
Hamanv,tichondrius,1299,evoker,preservation,60,29,31
Icthelestron,black-dragonflight,1297,evoker,preservation,44,30,14
Kraiz,frostmourne,1295,evoker,preservation,60,26,34
Oogiewoogie,doomhammer,1294,evoker,preservation,23,14,9
Straxolotl,frostmourne,1293,evoker,preservation,81,33,48
Sadeyes,dalaran,1292,evoker,preservation,160,86,74
Crayonshinch,tichondrius,1291,evoker,preservation,30,15,15
Hydrrax,dalaran,1288,evoker,preservation,255,126,129
Moiraine,frostwolf,1288,evoker,preservation,48,17,31
Gotbreath,dalaran,1287,evoker,preservation,90,46,44
Rynntynn,blood-furnace,1286,evoker,preservation,30,15,15
Nitalash,moon-guard,1286,evoker,preservation,29,14,15
Thereptile,frostmourne,1284,evoker,preservation,90,41,49
Darkscalyboi,dalaran,1280,evoker,preservation,82,41,41
Vgt,nemesis,1280,evoker,preservation,181,85,96
Sensandors,tichondrius,1280,evoker,preservation,68,27,41
Dragûn,stormrage,1279,evoker,preservation,30,16,14
Shellessturt,kelthuzad,1278,evoker,preservation,27,14,13
Rayquazä,kelthuzad,1277,evoker,preservation,26,14,12
Enzi,vashj,1276,evoker,preservation,36,20,16
Drgndeeznüts,tichondrius,1272,evoker,preservation,64,30,34
Hotdawgin,korgath,1271,evoker,preservation,154,71,83
Shinryuu,warsong,1270,evoker,preservation,42,23,19
Altevoker,frostmourne,1268,evoker,preservation,101,55,46
Amnemís,tichondrius,1268,evoker,preservation,50,27,23
Dragonfruits,lightbringer,1268,evoker,preservation,90,46,44
Deepbreather,sargeras,1268,evoker,preservation,52,26,26
Selfhealzer,korgath,1268,evoker,preservation,92,43,49
Akavoker,sargeras,1267,evoker,preservation,62,21,41
Cronós,tichondrius,1266,evoker,preservation,90,38,52
Bassblasterr,dalaran,1265,evoker,preservation,24,14,10
Lickndragons,sargeras,1265,evoker,preservation,36,14,22
Endroz,tichondrius,1264,evoker,preservation,42,22,20
Shook,baelgun,1260,evoker,preservation,208,108,100
Shudo,moon-guard,1257,evoker,preservation,131,66,65
Ayavi,illidan,1255,evoker,preservation,40,23,17
Skailyx,zuljin,1254,evoker,preservation,30,14,16
Brantley,stormscale,1253,evoker,preservation,86,41,45
Zendrov,skywall,1253,evoker,preservation,96,45,51
Everglow,the-forgotten-coast,1251,evoker,preservation,66,36,30
Xhamon,quelthalas,1251,evoker,preservation,98,49,49
Nicegirl,stormrage,1251,evoker,preservation,42,21,21
Terpsy,area-52,1250,evoker,preservation,23,16,7
Xazxander,tichondrius,1249,evoker,preservation,78,37,41
Stadman,illidan,1248,evoker,preservation,24,13,11
Lilacstrasza,moon-guard,1248,evoker,preservation,164,78,86
Aoibae,frostmourne,1248,evoker,preservation,126,57,69
Dreamvisage,silvermoon,1247,evoker,preservation,44,20,24
Wethotgarbee,tichondrius,1245,evoker,preservation,44,23,21
Justbreathez,tichondrius,1245,evoker,preservation,35,13,22
Fibonac,frostmourne,1243,evoker,preservation,78,48,30
Valarakuu,illidan,1242,evoker,preservation,24,13,11
Raykwaza,tichondrius,1242,evoker,preservation,42,20,22
Rustty,bleeding-hollow,1242,evoker,preservation,89,37,52
Dansauce,sargeras,1241,evoker,preservation,56,30,26
Mãttyy,malganis,1241,evoker,preservation,48,25,23
Goonwing,frostmourne,1241,evoker,preservation,30,15,15
Wildcard,shattered-hand,1241,evoker,preservation,35,16,19
Allaston,tichondrius,1240,evoker,preservation,45,28,17
Zandragosa,dalaran,1240,evoker,preservation,24,13,11
Riz,blackhand,1239,evoker,preservation,114,56,58
Antirrhinum,zuljin,1237,evoker,preservation,72,43,29
Nerfmeplsaoa,area-52,1236,evoker,preservation,24,13,11
Zerath,frostmane,1236,evoker,preservation,30,13,17
Lavagurl,stormscale,1235,evoker,preservation,30,13,17
Voithyr,moon-guard,1232,evoker,preservation,245,111,134
Tinyvoker,area-52,1232,evoker,preservation,72,26,46
Irezfortips,tichondrius,1231,evoker,preservation,18,13,5
Astoragosa,moon-guard,1231,evoker,preservation,61,38,23
Verosria,area-52,1230,evoker,preservation,24,13,11
Mythsvoker,barthilas,1229,evoker,preservation,61,33,28
Zippityzoom,barthilas,1229,evoker,preservation,59,30,29
Onornun,magtheridon,1229,evoker,preservation,66,32,34
Brovoker,darkspear,1229,evoker,preservation,42,17,25
Draxyrawr,area-52,1228,evoker,preservation,29,18,11
Agony,emerald-dream,1228,evoker,preservation,255,123,132
Feelzz,illidan,1228,evoker,preservation,55,26,29
Mastadragndz,illidan,1228,evoker,preservation,42,13,29
Distortion,drakthul,1226,evoker,preservation,141,77,64
Lévocatrice,hakkar,1225,evoker,preservation,64,31,33
Abelldragon,tichondrius,1224,evoker,preservation,34,17,17
Lebronjmz,kiljaeden,1224,evoker,preservation,127,58,69
Mëleys,ragnaros,1224,evoker,preservation,53,24,29
Hlf,tichondrius,1222,evoker,preservation,50,29,21
Scalesona,black-dragonflight,1222,evoker,preservation,31,14,17
Barneydragon,stormrage,1220,evoker,preservation,24,14,10
Ghidorah,sentinels,1220,evoker,preservation,89,48,41
Milfwizard,tichondrius,1219,evoker,preservation,24,13,11
Prøøf,kelthuzad,1217,evoker,preservation,61,27,34
Dkvastate,tichondrius,1216,evoker,preservation,118,58,60
Dunkelzahn,gorgonnash,1214,evoker,preservation,30,15,15
Amniotic,hyjal,1212,evoker,preservation,54,31,23
Ysondrius,durotan,1212,evoker,preservation,48,26,22
Mittnz,arthas,1212,evoker,preservation,24,13,11
Naszeebo,frostmourne,1212,evoker,preservation,54,24,30
Istaybrutal,malganis,1210,evoker,preservation,24,13,11
Zindrozarath,area-52,1210,evoker,preservation,161,81,80
Deezdragon,stormrage,1209,evoker,preservation,47,24,23
Sanaz,stormreaver,1208,evoker,preservation,54,28,26
Lunelumi,sargeras,1208,evoker,preservation,30,15,15
Balèrion,illidan,1207,evoker,preservation,60,33,27
Gdragons,tichondrius,1207,evoker,preservation,31,17,14
Gadiel,draka,1207,evoker,preservation,50,25,25
Weirdclassx,tichondrius,1207,evoker,preservation,47,23,24
Buttstough,aerie-peak,1206,evoker,preservation,47,23,24
Frozanat,kelthuzad,1205,evoker,preservation,75,34,41
Döublepenn,tichondrius,1204,evoker,preservation,90,46,44
Thendroz,aerie-peak,1201,evoker,preservation,101,55,46
Dìnosaur,illidan,1201,evoker,preservation,42,21,21
Nêwt,darkspear,1201,evoker,preservation,238,115,123
Assassasin,bonechewer,1200,evoker,preservation,60,27,33
Partysnaxx,thrall,1199,evoker,preservation,72,35,37
Justbreathe,sargeras,1198,evoker,preservation,23,13,10
Çhara,illidan,1198,evoker,preservation,126,65,61
Rayvoker,elune,1198,evoker,preservation,54,27,27
Dragonsama,area-52,1198,evoker,preservation,42,16,26
Lazioo,frostmourne,1196,evoker,preservation,22,14,8
Maldormu,stormrage,1196,evoker,preservation,37,16,21
Karganos,darkspear,1195,evoker,preservation,48,27,21
Trrxx,tichondrius,1193,evoker,preservation,30,14,16
Shênlong,sargeras,1193,evoker,preservation,54,22,32
Crowqt,frostmourne,1190,evoker,preservation,95,34,61
Unscaleable,illidan,1188,evoker,preservation,99,57,42
Brôcôlînî,zuljin,1187,evoker,preservation,43,29,14
Zackxo,moon-guard,1185,evoker,preservation,52,32,20
Shandormu,kaelthas,1185,evoker,preservation,30,15,15
Shenlong,malganis,1185,evoker,preservation,165,81,84
Wyldefire,senjin,1185,evoker,preservation,60,28,32
Shockragosa,chogall,1184,evoker,preservation,42,13,29
Drektar,the-scryers,1180,evoker,preservation,30,15,15
Hakuroyime,ragnaros,1179,evoker,preservation,36,21,15
Puffthemagic,lightnings-blade,1179,evoker,preservation,33,14,19
Deralan,khaz-modan,1179,evoker,preservation,108,40,68
Nogard,dalaran,1177,evoker,preservation,24,14,10
Yozhz,ragnaros,1177,evoker,preservation,53,25,28
Doogiehowser,azshara,1175,evoker,preservation,192,89,103
Zinderal,thunderlord,1173,evoker,preservation,54,26,28
Mungwings,area-52,1172,evoker,preservation,55,26,29
Drokula,darkspear,1171,evoker,preservation,36,16,20
Scalyhoe,alterac-mountains,1171,evoker,preservation,36,13,23
Djdavi,azralon,1170,evoker,preservation,138,80,58
Bootymágic,tichondrius,1170,evoker,preservation,59,31,28
Proevoker,illidan,1170,evoker,preservation,51,22,29
Razerazenoth,tichondrius,1169,evoker,preservation,36,19,17
Treadcinder,tichondrius,1167,evoker,preservation,42,18,24
Kaguax,tichondrius,1167,evoker,preservation,84,32,52
Worldx,illidan,1166,evoker,preservation,24,13,11
Evokas,tichondrius,1166,evoker,preservation,270,134,136
Lyingdragon,tichondrius,1166,evoker,preservation,60,26,34
Ilithiphobia,ghostlands,1166,evoker,preservation,44,19,25
Mazalagon,trollbane,1165,evoker,preservation,29,15,14
Draginnuts,illidan,1162,evoker,preservation,53,25,28
Dandera,stormrage,1159,evoker,preservation,136,64,72
Repairraptor,area-52,1159,evoker,preservation,81,37,44
Vermitor,sargeras,1155,evoker,preservation,24,13,11
Firebreather,quelthalas,1155,evoker,preservation,30,13,17
Skithyrix,bleeding-hollow,1153,evoker,preservation,68,32,36
Spitdafire,tichondrius,1152,evoker,preservation,43,18,25
Dzdv,stormrage,1151,evoker,preservation,18,12,6
Aspecto,area-52,1151,evoker,preservation,117,51,66
Cruv,boulderfist,1151,evoker,preservation,30,12,18
Flyingmooie,frostmourne,1151,evoker,preservation,30,12,18
Crsevencr,tichondrius,1150,evoker,preservation,18,12,6
Kaddyragon,mannoroth,1150,evoker,preservation,18,12,6
Kilawatt,barthilas,1150,evoker,preservation,23,15,8
Mysticenergy,tichondrius,1150,evoker,preservation,60,28,32
Yaaty,tichondrius,1150,evoker,preservation,30,12,18
Riizo,malganis,1149,evoker,preservation,98,57,41
Smokeflare,frostmane,1149,evoker,preservation,24,12,12
Cycircle,tichondrius,1149,evoker,preservation,24,12,12
Lamentation,area-52,1148,evoker,preservation,143,71,72
Emozoomer,malganis,1148,evoker,preservation,66,25,41
Héllfire,ghostlands,1147,evoker,preservation,54,25,29
Derkscale,stormrage,1146,evoker,preservation,36,17,19
Nuubvoker,stormrage,1145,evoker,preservation,24,12,12
Lizzardload,stormreaver,1144,evoker,preservation,84,37,47
Xiwinnie,illidan,1144,evoker,preservation,36,14,22
Visserion,sargeras,1143,evoker,preservation,25,14,11
Readwise,tichondrius,1143,evoker,preservation,26,12,14
Xmystique,area-52,1143,evoker,preservation,44,19,25
Badbill,moon-guard,1142,evoker,preservation,18,12,6
Satratren,moon-guard,1142,evoker,preservation,30,12,18
Ashandshadow,area-52,1141,evoker,preservation,80,37,43
Dragonspire,burning-legion,1141,evoker,preservation,60,24,36
Careflight,barthilas,1140,evoker,preservation,72,40,32
Arcanasz,thrall,1137,evoker,preservation,24,12,12
Zitasanazen,tichondrius,1135,evoker,preservation,394,199,195
Eraticevo,illidan,1135,evoker,preservation,24,12,12
Tryhard,wyrmrest-accord,1134,evoker,preservation,96,43,53
Vermax,akama,1133,evoker,preservation,45,17,28
Zascar,stormrage,1132,evoker,preservation,24,13,11
Rorie,farstriders,1131,evoker,preservation,30,14,16
Blay,elune,1130,evoker,preservation,36,15,21
Deathgos,stormscale,1128,evoker,preservation,35,15,20
Mesamune,bonechewer,1126,evoker,preservation,169,83,86
Toothless,garithos,1123,evoker,preservation,42,27,15
Draczod,proudmoore,1123,evoker,preservation,59,23,36
Saphfire,burning-legion,1122,evoker,preservation,24,16,8
Droggerdrago,stormreaver,1122,evoker,preservation,52,29,23
Dzracona,gorefiend,1120,evoker,preservation,26,13,13
Cootietooter,icecrown,1120,evoker,preservation,36,16,20
Drathron,tichondrius,1118,evoker,preservation,28,13,15
Drozul,stormrage,1118,evoker,preservation,54,20,34
Smaaugg,area-52,1117,evoker,preservation,18,12,6
Kersava,frostmourne,1115,evoker,preservation,53,27,26
Darksmoke,spirestone,1112,evoker,preservation,24,12,12
Zindrozath,thrall,1112,evoker,preservation,24,12,12
Atpsuspect,nerzhul,1112,evoker,preservation,24,12,12
Tëssarion,quelthalas,1110,evoker,preservation,38,16,22
Idingosa,moon-guard,1109,evoker,preservation,28,12,16
Thegrinchh,malganis,1107,evoker,preservation,93,45,48
Potfase,tichondrius,1106,evoker,preservation,66,28,38
Evohrker,area-52,1103,evoker,preservation,60,30,30
Dragonwench,sargeras,1101,evoker,preservation,22,13,9
Dragndeez,garrosh,1101,evoker,preservation,55,15,40
Geico,spinebreaker,1100,evoker,preservation,15,13,2
Lendren,sargeras,1100,evoker,preservation,45,13,32
Garrgle,sargeras,1099,evoker,preservation,30,14,16
Daikis,proudmoore,1098,evoker,preservation,42,20,22
Saintpablox,illidan,1097,evoker,preservation,40,13,27
Krossbones,cenarion-circle,1096,evoker,preservation,80,47,33
Bahamut,magtheridon,1095,evoker,preservation,83,34,49
Linabeauty,ragnaros,1094,evoker,preservation,30,12,18
Djornmustman,sargeras,1094,evoker,preservation,42,12,30
Rah,gurubashi,1093,evoker,preservation,47,28,19
Balmoze,tichondrius,1093,evoker,preservation,66,35,31
Vyraethel,wyrmrest-accord,1093,evoker,preservation,51,27,24
Bayvoker,area-52,1093,evoker,preservation,56,29,27
Dmuzh,drakkari,1092,evoker,preservation,507,268,239
Abigaile,illidan,1088,evoker,preservation,24,17,7
Seiros,garrosh,1088,evoker,preservation,50,21,29
Lickyertits,tichondrius,1088,evoker,preservation,40,16,24
Mikkaelin,ragnaros,1086,evoker,preservation,67,31,36
Niraz,dalaran,1085,evoker,preservation,24,12,12
Emyhr,sargeras,1084,evoker,preservation,24,13,11
Drimare,quelthalas,1084,evoker,preservation,42,14,28
Draisin,zuljin,1083,evoker,preservation,24,13,11
Setash,hyjal,1081,evoker,preservation,24,12,12
Clubmetro,boulderfist,1081,evoker,preservation,39,18,21
Lahfly,tichondrius,1079,evoker,preservation,54,33,21
Dragoreo,illidan,1078,evoker,preservation,47,20,27
Shenrøn,altar-of-storms,1076,evoker,preservation,50,28,22
Qiuhan,tichondrius,1076,evoker,preservation,48,23,25
Bronzus,ragnaros,1076,evoker,preservation,73,29,44
Lilithà,kelthuzad,1075,evoker,preservation,30,20,10
Stankywing,thrall,1075,evoker,preservation,34,17,17
Deàthwing,proudmoore,1074,evoker,preservation,53,16,37
Dracoly,medivh,1073,evoker,preservation,30,16,14
Bobstrasz,tichondrius,1073,evoker,preservation,36,12,24
Rubellite,azralon,1072,evoker,preservation,75,37,38
Bumbledragn,moon-guard,1071,evoker,preservation,37,23,14
Dragown,sargeras,1071,evoker,preservation,46,22,24
Maxyz,khadgar,1071,evoker,preservation,42,13,29
Lunearia,stormrage,1067,evoker,preservation,24,12,12
Draganoche,zuljin,1066,evoker,preservation,30,14,16
Hollowscale,emerald-dream,1065,evoker,preservation,46,18,28
Kharizard,moon-guard,1065,evoker,preservation,33,12,21
Worldsdragon,area-52,1064,evoker,preservation,24,16,8
Acidbreath,tichondrius,1064,evoker,preservation,30,15,15
Shyyvana,malganis,1062,evoker,preservation,18,12,6
Sacrementus,tichondrius,1062,evoker,preservation,66,24,42
Lervish,durotan,1061,evoker,preservation,18,13,5
Fenalysten,cenarius,1060,evoker,preservation,113,49,64
Sorcerous,arthas,1060,evoker,preservation,36,12,24
Binidragon,tichondrius,1055,evoker,preservation,12,11,1
Wtfhappen,tichondrius,1055,evoker,preservation,24,11,13
Messyvok,illidan,1055,evoker,preservation,26,11,15
Eiselhuus,moon-guard,1055,evoker,preservation,65,26,39
Cindermint,mugthol,1055,evoker,preservation,49,19,30
Vulpyre,ragnaros,1055,evoker,preservation,30,11,19
Allaker,kargath,1054,evoker,preservation,40,17,23
Pnse,perenolde,1054,evoker,preservation,30,11,19
Fkndragon,proudmoore,1054,evoker,preservation,36,11,25
Fenroth,kelthuzad,1052,evoker,preservation,24,11,13
Dragonfroot,darkspear,1052,evoker,preservation,24,11,13
Slippee,mugthol,1051,evoker,preservation,12,11,1
Alzuresh,illidan,1051,evoker,preservation,30,11,19
Simmnyxia,area-52,1050,evoker,preservation,24,11,13
Swanzea,sargeras,1049,evoker,preservation,18,11,7
Kathendrov,sargeras,1049,evoker,preservation,119,58,61
Puraimaru,sargeras,1049,evoker,preservation,30,11,19
Sodtaoe,ursin,1047,evoker,preservation,23,11,12
Chewykek,area-52,1047,evoker,preservation,24,11,13
Scalethorne,illidan,1047,evoker,preservation,24,11,13
Flappytin,zuljin,1047,evoker,preservation,30,11,19
Draghyon,tichondrius,1044,evoker,preservation,42,11,31
Drittles,illidan,1043,evoker,preservation,62,28,34
Prevoker,kirin-tor,1042,evoker,preservation,54,28,26
Woozul,malganis,1042,evoker,preservation,36,11,25
Uniqqe,tichondrius,1041,evoker,preservation,18,11,7
Kakanjutan,azralon,1041,evoker,preservation,22,12,10
Bobbydracthy,illidan,1041,evoker,preservation,24,11,13
Bizzstrasza,shadowsong,1040,evoker,preservation,106,51,55
Detreshan,stormreaver,1039,evoker,preservation,188,97,91
Jorlozthyr,ragnaros,1039,evoker,preservation,36,12,24
Charadrius,zuljin,1038,evoker,preservation,41,23,18
Strawdormu,ragnaros,1037,evoker,preservation,18,11,7
Fránky,ragnaros,1037,evoker,preservation,77,34,43
Beerdragon,ragnaros,1036,evoker,preservation,69,39,30
Myxter,tichondrius,1035,evoker,preservation,49,25,24
Cripcuhz,tichondrius,1035,evoker,preservation,72,36,36
Carloxd,tichondrius,1035,evoker,preservation,34,12,22
Boomlvx,frostmourne,1034,evoker,preservation,24,11,13
Blankebr,gallywix,1032,evoker,preservation,36,24,12
Gemish,lethon,1032,evoker,preservation,44,17,27
Skkuld,stormrage,1029,evoker,preservation,24,11,13
Dracomedicus,frostmourne,1028,evoker,preservation,70,24,46
Cinderoz,moon-guard,1026,evoker,preservation,19,13,6
Degghurtni,area-52,1026,evoker,preservation,18,11,7
Mokkdala,blackrock,1026,evoker,preservation,40,12,28
Evoke,boulderfist,1025,evoker,preservation,28,12,16
Sophdrac,illidan,1024,evoker,preservation,43,25,18
Karmakulax,wildhammer,1024,evoker,preservation,31,12,19
Trillis,eldrethalas,1023,evoker,preservation,36,23,13
Draconys,shattered-hand,1020,evoker,preservation,42,23,19
Adessa,lothar,1020,evoker,preservation,36,14,22
Ownlyfans,silvermoon,1018,evoker,preservation,24,12,12
Cunk,illidan,1018,evoker,preservation,24,11,13
Prahvlord,shuhalo,1018,evoker,preservation,60,26,34
Turukmakto,illidan,1017,evoker,preservation,29,14,15
Tarnuss,skullcrusher,1017,evoker,preservation,42,14,28
Bitkoinz,tichondrius,1016,evoker,preservation,30,11,19
Mightywings,skywall,1011,evoker,preservation,138,70,68
Ohffs,malganis,1011,evoker,preservation,30,14,16
Richviewrd,illidan,1010,evoker,preservation,42,22,20
Esq,sargeras,1007,evoker,preservation,17,11,6
Kaeszandrus,azralon,1007,evoker,preservation,64,29,35
Dragonarchy,draenor,1003,evoker,preservation,78,37,41
Lightbeing,nazjatar,1001,evoker,preservation,48,29,19
Wheyvern,malganis,1000,evoker,preservation,93,41,52
Smögg,quelthalas,1000,evoker,preservation,54,23,31
Brahown,altar-of-storms,998,evoker,preservation,36,11,25
Sïgrìd,tichondrius,991,evoker,preservation,51,32,19
Gemis,anvilmar,991,evoker,preservation,55,25,30
Falsedaze,sargeras,990,evoker,preservation,45,21,24
Ozmayzin,proudmoore,990,evoker,preservation,69,30,39
Hover,vashj,989,evoker,preservation,27,13,14
Vandinus,stormrage,988,evoker,preservation,68,31,37
Items,frostmourne,987,evoker,preservation,22,11,11
Vyreth,sargeras,987,evoker,preservation,81,38,43
Kaikisen,malganis,986,evoker,preservation,55,18,37
Arazerazer,thrall,984,evoker,preservation,66,23,43
Arazarion,mugthol,979,evoker,preservation,30,17,13
Smaugett,zuljin,979,evoker,preservation,44,23,21
Kivoke,proudmoore,974,evoker,preservation,42,18,24
Curamil,azralon,973,evoker,preservation,26,11,15
Lawroadt,tichondrius,970,evoker,preservation,93,47,46
Solryp,terokkar,966,evoker,preservation,204,99,105
Straightman,stormrage,965,evoker,preservation,74,36,38
Dracalis,thrall,964,evoker,preservation,82,46,36
Caucasian,aegwynn,964,evoker,preservation,90,35,55
Boomon,blades-edge,963,evoker,preservation,48,22,26
Milkspurt,tichondrius,962,evoker,preservation,52,23,29
Syraxiez,sargeras,960,evoker,preservation,18,10,8
Rubyzz,illidan,960,evoker,preservation,18,10,8
Hwansu,tichondrius,960,evoker,preservation,18,10,8
Uncleìroh,tichondrius,960,evoker,preservation,24,10,14
Imwoker,illidan,960,evoker,preservation,24,10,14
Wamajam,area-52,960,evoker,preservation,24,10,14
Gaslightqt,tichondrius,960,evoker,preservation,25,10,15
Flyingkush,illidan,959,evoker,preservation,12,10,2
Sandrozeria,wyrmrest-accord,959,evoker,preservation,22,13,9
Dragoontekka,tichondrius,959,evoker,preservation,18,10,8
Abevv,bonechewer,959,evoker,preservation,18,10,8
Myspycanfly,malganis,958,evoker,preservation,12,10,2
Truffleßutta,tichondrius,958,evoker,preservation,18,10,8
Slrepeat,frostmourne,958,evoker,preservation,18,10,8
Dragonsand,area-52,958,evoker,preservation,62,30,32
Toastsevoker,tichondrius,958,evoker,preservation,24,10,14
Drakthussey,illidan,957,evoker,preservation,18,10,8
Wickedwings,tichondrius,957,evoker,preservation,24,10,14
Crumbflaps,kelthuzad,957,evoker,preservation,36,12,24
Dokthyr,lightbringer,956,evoker,preservation,12,10,2
Thiccprotein,tichondrius,956,evoker,preservation,18,10,8
Goonguy,gnomeregan,955,evoker,preservation,12,10,2
Holdherhorn,area-52,955,evoker,preservation,18,10,8
Dragy,bonechewer,954,evoker,preservation,24,10,14
Cvoker,illidan,954,evoker,preservation,24,10,14
Forlornomens,area-52,953,evoker,preservation,18,10,8
Hoverharder,stormrage,953,evoker,preservation,18,10,8
Soziin,skullcrusher,953,evoker,preservation,18,10,8
Grievaxion,ragnaros,953,evoker,preservation,24,10,14
Dragonblazer,illidan,952,evoker,preservation,18,10,8
Ayoitspav,malganis,952,evoker,preservation,25,11,14
Chue,quelthalas,952,evoker,preservation,24,10,14
Rubyskye,tichondrius,950,evoker,preservation,18,10,8
Surasi,frostmourne,948,evoker,preservation,18,10,8
Frozonic,tichondrius,948,evoker,preservation,36,17,19
Tagritash,kelthuzad,946,evoker,preservation,24,10,14
Sochen,kelthuzad,945,evoker,preservation,92,47,45
Galakraas,proudmoore,942,evoker,preservation,18,10,8
Dracthyrius,thunderlord,941,evoker,preservation,18,12,6
Venlormi,moon-guard,938,evoker,preservation,70,31,39
Echoker,destromath,934,evoker,preservation,61,28,33
Gidury,tichondrius,934,evoker,preservation,96,44,52
Faethana,thrall,929,evoker,preservation,23,11,12
Furygos,stormrage,927,evoker,preservation,23,10,13
Rilex,kelthuzad,927,evoker,preservation,30,11,19
Dragonbro,spirestone,923,evoker,preservation,18,10,8
Saintetoile,tichondrius,916,evoker,preservation,72,36,36
Tribunalis,stormrage,915,evoker,preservation,18,11,7
Lagartixa,kirin-tor,913,evoker,preservation,36,14,22
Rzdrag,nemesis,912,evoker,preservation,96,24,72
Kaelestian,ragnaros,910,evoker,preservation,36,18,18
Lisatallie,moon-guard,904,evoker,preservation,24,11,13
Azuril,wyrmrest-accord,904,evoker,preservation,96,31,65
Badvoker,area-52,902,evoker,preservation,71,26,45
Cransvoker,illidan,902,evoker,preservation,30,10,20
Leralera,moon-guard,898,evoker,preservation,30,13,17
Bandel,tichondrius,896,evoker,preservation,22,12,10
Kerlaan,illidan,895,evoker,preservation,18,10,8
Spliffdragon,sargeras,895,evoker,preservation,95,42,53
Proust,grizzly-hills,894,evoker,preservation,32,11,21
Zeldaryel,azralon,891,evoker,preservation,36,18,18
Medrathion,wyrmrest-accord,887,evoker,preservation,23,10,13
Dreezoo,tichondrius,881,evoker,preservation,62,33,29
Mugenyan,ragnaros,879,evoker,preservation,41,21,20
Pypokay,nemesis,877,evoker,preservation,48,17,31
Madzul,emerald-dream,871,evoker,preservation,19,10,9
Willowflight,illidan,867,evoker,preservation,50,23,27
Drewskie,malganis,867,evoker,preservation,94,37,57
Viserion,wildhammer,865,evoker,preservation,44,10,34
Mewoker,sargeras,864,evoker,preservation,12,9,3
Toonahzy,area-52,864,evoker,preservation,12,9,3
Newclassop,emerald-dream,864,evoker,preservation,18,9,9
Calvoker,moon-guard,864,evoker,preservation,18,9,9
Lizardfaith,tichondrius,863,evoker,preservation,12,9,3
Smnsevoker,emerald-dream,863,evoker,preservation,12,9,3
Wonderk,frostmourne,863,evoker,preservation,18,9,9
Tonymanitoba,whisperwind,863,evoker,preservation,18,9,9
Tadhg,mugthol,863,evoker,preservation,30,12,18
Soyum,sargeras,863,evoker,preservation,24,9,15
Azngodz,tichondrius,863,evoker,preservation,24,9,15
Flaemer,thaurissan,862,evoker,preservation,12,9,3
Velocivraull,malganis,862,evoker,preservation,12,9,3
Xerithious,bleeding-hollow,862,evoker,preservation,18,9,9
Whitesnow,korgath,862,evoker,preservation,18,9,9
Jesstrasza,quelthalas,862,evoker,preservation,96,42,54
Evvookkeerr,tichondrius,861,evoker,preservation,18,9,9
Gravityblast,tichondrius,861,evoker,preservation,24,9,15
Chewydragoon,kelthuzad,860,evoker,preservation,12,9,3
Binxyboy,garrosh,860,evoker,preservation,16,10,6
Lamdyn,wyrmrest-accord,860,evoker,preservation,18,9,9
Arûmat,tichondrius,859,evoker,preservation,30,9,21
Dracauzrys,gorefiend,857,evoker,preservation,12,9,3
Glamorousbra,tichondrius,857,evoker,preservation,18,9,9
Corun,zuljin,856,evoker,preservation,12,9,3
Aethrys,zuljin,856,evoker,preservation,12,9,3
Salakhar,drakkari,856,evoker,preservation,18,9,9
Wrathics,emerald-dream,856,evoker,preservation,18,9,9
Bjason,tichondrius,855,evoker,preservation,18,9,9
Tekath,altar-of-storms,855,evoker,preservation,18,9,9
Dragonballer,trollbane,853,evoker,preservation,24,9,15
Moxa,doomhammer,850,evoker,preservation,83,41,42
Moiraine,kargath,850,evoker,preservation,24,9,15
Hentaizilla,kiljaeden,850,evoker,preservation,55,19,36
Yoríchi,proudmoore,849,evoker,preservation,16,10,6
Tooby,velen,849,evoker,preservation,27,11,16
Lechonlechon,tichondrius,847,evoker,preservation,12,9,3
Dràgo,emerald-dream,846,evoker,preservation,12,9,3
Orïon,azralon,845,evoker,preservation,24,9,15
Razzell,barthilas,841,evoker,preservation,18,9,9
Drákô,ragnaros,841,evoker,preservation,30,9,21
Aurastella,frostwolf,837,evoker,preservation,24,9,15
Pinkponies,area-52,834,evoker,preservation,12,9,3
Dragonknght,tichondrius,830,evoker,preservation,46,21,25
Decyrion,bleeding-hollow,830,evoker,preservation,29,9,20
Kuratz,barthilas,829,evoker,preservation,32,10,22
Luxdraco,stormrage,827,evoker,preservation,22,9,13
Falastrasza,dalaran,821,evoker,preservation,23,9,14
Zaldraka,cairne,819,evoker,preservation,31,13,18
Yaaj,black-dragonflight,808,evoker,preservation,23,10,13
Drabbot,thunderlord,803,evoker,preservation,20,10,10
Risumon,uldum,802,evoker,preservation,191,78,113
Darkspyro,area-52,799,evoker,preservation,11,9,2
Icallthecops,tichondrius,798,evoker,preservation,16,9,7
Drackaras,stormrage,798,evoker,preservation,26,10,16
Rockzocain,area-52,798,evoker,preservation,24,9,15
Scourgewing,wyrmrest-accord,795,evoker,preservation,30,9,21
Azuragon,illidan,793,evoker,preservation,71,23,48
Itsac,daggerspine,792,evoker,preservation,30,13,17
Rathaloez,tichondrius,786,evoker,preservation,36,20,16
Slyfur,burning-legion,786,evoker,preservation,18,9,9
Namor,ragnaros,781,evoker,preservation,22,9,13
Sheepdoll,icecrown,777,evoker,preservation,25,10,15
Razen,silvermoon,773,evoker,preservation,33,13,20
Dracostayout,sargeras,768,evoker,preservation,12,8,4
Rvrbzv,stormrage,768,evoker,preservation,12,8,4
Æsshayád,area-52,768,evoker,preservation,12,8,4
Hasstle,tichondrius,768,evoker,preservation,12,8,4
Evokeondeez,stormrage,768,evoker,preservation,12,8,4
Ryóng,tichondrius,768,evoker,preservation,18,8,10
Airschlong,tichondrius,768,evoker,preservation,18,8,10
Babylons,area-52,768,evoker,preservation,18,8,10
Unclefarmer,illidan,768,evoker,preservation,18,8,10
Treysongz,area-52,768,evoker,preservation,18,8,10
Dendedewd,sargeras,767,evoker,preservation,12,8,4
Walloper,malganis,767,evoker,preservation,12,8,4
Baradad,frostmourne,767,evoker,preservation,12,8,4
Icecoldrink,suramar,767,evoker,preservation,12,8,4
Fluffelss,moon-guard,767,evoker,preservation,12,8,4
Liltj,tichondrius,767,evoker,preservation,18,8,10
Slèv,frostmourne,767,evoker,preservation,18,8,10
Dracthott,thrall,767,evoker,preservation,18,8,10
Xiaolongmei,frostmourne,767,evoker,preservation,18,8,10
Ève,area-52,767,evoker,preservation,18,8,10
Dracritzzx,ragnaros,767,evoker,preservation,18,8,10
Shrimpshumai,malganis,767,evoker,preservation,18,8,10
Smurgma,frostmane,767,evoker,preservation,18,8,10
Innervoker,tichondrius,767,evoker,preservation,18,8,10
Nowon,tichondrius,767,evoker,preservation,24,8,16
Aomend,stormrage,767,evoker,preservation,24,8,16
Iamthêt,sargeras,767,evoker,preservation,24,8,16
Devilmanguy,bonechewer,767,evoker,preservation,24,8,16
Galfiore,malganis,767,evoker,preservation,30,8,22
Dracarus,crushridge,767,evoker,preservation,30,8,22
Talzindera,sargeras,766,evoker,preservation,18,8,10
Rewind,draka,766,evoker,preservation,18,8,10
Heidibibe,tichondrius,766,evoker,preservation,18,8,10
Sunfyrion,sargeras,766,evoker,preservation,24,8,16
Paradïsso,tichondrius,765,evoker,preservation,12,8,4
Waveydavey,illidan,765,evoker,preservation,18,8,10
Shworm,bleeding-hollow,764,evoker,preservation,12,8,4
Selocky,bleeding-hollow,764,evoker,preservation,18,8,10
Snitx,stormrage,764,evoker,preservation,24,8,16
Neewhad,malganis,764,evoker,preservation,24,8,16
Nutsdragon,tichondrius,763,evoker,preservation,18,8,10
Pandavoke,kelthuzad,763,evoker,preservation,24,8,16
Wrathiøn,sargeras,763,evoker,preservation,24,8,16
Kyloflight,thrall,763,evoker,preservation,30,8,22
Matsutake,kelthuzad,762,evoker,preservation,18,8,10
Jubey,tichondrius,762,evoker,preservation,23,8,15
Dandroz,kelthuzad,761,evoker,preservation,18,8,10
Vermax,spirestone,759,evoker,preservation,18,8,10
Draehgor,hyjal,758,evoker,preservation,18,8,10
Cambodian,whisperwind,758,evoker,preservation,18,8,10
Gamesruined,area-52,753,evoker,preservation,19,8,11
Drevoker,lightbringer,748,evoker,preservation,18,8,10
Criteria,burning-legion,748,evoker,preservation,18,8,10
Madvillin,stormrage,747,evoker,preservation,12,8,4
Chaosrebørn,bleeding-hollow,746,evoker,preservation,36,8,28
Shintrax,ragnaros,744,evoker,preservation,73,35,38
Cindrozaraz,stormreaver,743,evoker,preservation,18,8,10
Durtyvoker,illidan,735,evoker,preservation,22,8,14
Butta,darkspear,734,evoker,preservation,17,8,9
Enuzan,dalaran,734,evoker,preservation,32,8,24
Polland,area-52,731,evoker,preservation,17,8,9
Enoch,chogall,727,evoker,preservation,27,10,17
Tamagotchî,quelthalas,719,evoker,preservation,22,8,14
Tailia,sargeras,718,evoker,preservation,23,8,15
Geicovoker,tichondrius,714,evoker,preservation,28,9,19
Scaleyboy,tichondrius,713,evoker,preservation,21,10,11
Shardsnorta,chogall,708,evoker,preservation,17,8,9
Kyrusic,tichondrius,705,evoker,preservation,27,11,16
Lunadragon,spinebreaker,704,evoker,preservation,16,8,8
Murozond,burning-blade,703,evoker,preservation,20,8,12
Kleptomancy,moon-guard,702,evoker,preservation,11,8,3
Kalswyrm,burning-blade,702,evoker,preservation,20,8,12
Letharrian,sargeras,698,evoker,preservation,12,10,2
Drakthuul,icecrown,696,evoker,preservation,103,44,59
Jsb,moon-guard,696,evoker,preservation,54,10,44
Orame,dalaran,685,evoker,preservation,25,8,17
Dragondubya,illidan,672,evoker,preservation,12,7,5
Trishulaice,illidan,672,evoker,preservation,12,7,5
Crivoker,quelthalas,672,evoker,preservation,12,7,5
Beatxqt,area-52,672,evoker,preservation,12,7,5
Azurgos,proudmoore,672,evoker,preservation,12,7,5
Vekke,illidan,672,evoker,preservation,12,7,5
Goursaud,malganis,672,evoker,preservation,12,7,5
Clm,staghelm,672,evoker,preservation,12,7,5
Suekeysaurus,frostmourne,672,evoker,preservation,12,7,5
Lilrandal,emerald-dream,672,evoker,preservation,12,7,5
Ayanokojí,stormrage,672,evoker,preservation,12,7,5
Vrondiss,trollbane,672,evoker,preservation,12,7,5
Alithrya,illidan,672,evoker,preservation,12,7,5
Hypetwo,bleeding-hollow,672,evoker,preservation,12,7,5
Vroomby,sargeras,672,evoker,preservation,12,7,5
Ruffee,frostmourne,672,evoker,preservation,12,7,5
Nythendrah,emerald-dream,672,evoker,preservation,12,7,5
Iantern,dalaran,672,evoker,preservation,12,7,5
Vroomby,area-52,672,evoker,preservation,12,7,5
Iamg,stormscale,672,evoker,preservation,18,7,11
Roastdrake,tichondrius,672,evoker,preservation,18,7,11
Draikia,zuljin,672,evoker,preservation,18,7,11
Evoketage,malganis,672,evoker,preservation,18,7,11
Orncen,emerald-dream,672,evoker,preservation,18,7,11
Draislyn,cenarion-circle,672,evoker,preservation,18,7,11
Mjlf,sargeras,672,evoker,preservation,18,7,11
Golden,area-52,672,evoker,preservation,18,7,11
Kontaz,icecrown,672,evoker,preservation,24,7,17
Hdyl,tichondrius,672,evoker,preservation,24,7,17
Zalpx,sargeras,672,evoker,preservation,24,7,17
Hammylee,firetree,672,evoker,preservation,30,7,23
Ketasdragon,frostmourne,671,evoker,preservation,10,8,2
Squablebox,kul-tiras,671,evoker,preservation,12,7,5
Vertorgon,proudmoore,671,evoker,preservation,12,7,5
Doramifa,tichondrius,671,evoker,preservation,12,7,5
Emopidgey,dalaran,671,evoker,preservation,12,7,5
Tyrøs,illidan,671,evoker,preservation,12,7,5
Spicypnuts,zuljin,671,evoker,preservation,12,7,5
Flapthewap,illidan,671,evoker,preservation,12,7,5
Vaxilia,sargeras,671,evoker,preservation,12,7,5
Kaidough,tichondrius,671,evoker,preservation,12,7,5
Ndr,proudmoore,671,evoker,preservation,12,7,5
Reskue,burning-legion,671,evoker,preservation,12,7,5
Toppedyouoff,thrall,671,evoker,preservation,15,7,8
Longxx,dalaran,671,evoker,preservation,18,7,11
Trogdør,illidan,671,evoker,preservation,18,7,11
Likelybaked,kiljaeden,671,evoker,preservation,18,7,11
Tailup,sargeras,671,evoker,preservation,18,7,11
Jigsz,illidan,671,evoker,preservation,18,7,11
Nunez,frostmourne,671,evoker,preservation,18,7,11
Drøgon,sargeras,671,evoker,preservation,24,7,17
Lampizard,bonechewer,671,evoker,preservation,24,7,17
Bookkoo,burning-legion,671,evoker,preservation,24,7,17
Nienze,wyrmrest-accord,670,evoker,preservation,12,7,5
Prozach,shadowmoon,670,evoker,preservation,12,7,5
Mad,aerie-peak,670,evoker,preservation,19,9,10
Zumanitÿ,zangarmarsh,670,evoker,preservation,18,7,11
Koopa,malygos,670,evoker,preservation,24,7,17
Dshiznit,sargeras,670,evoker,preservation,24,7,17
Deezyroller,sargeras,669,evoker,preservation,12,7,5
Auradraca,queldorei,669,evoker,preservation,13,7,6
Azaralzind,bleeding-hollow,669,evoker,preservation,15,8,7
Rhaènyra,sargeras,669,evoker,preservation,18,7,11
Retcondragon,sargeras,669,evoker,preservation,18,7,11
Chickchauker,tichondrius,669,evoker,preservation,18,7,11
Tazalth,uther,668,evoker,preservation,18,7,11
Selden,boulderfist,668,evoker,preservation,18,7,11
Shartzypoo,thrall,668,evoker,preservation,24,7,17
Alexstrazaa,hyjal,667,evoker,preservation,12,7,5
Xdragon,lightbringer,667,evoker,preservation,18,7,11
Drizzydrag,jubeithos,667,evoker,preservation,18,7,11
Rainwalkers,illidan,666,evoker,preservation,12,7,5
Aceu,bloodhoof,665,evoker,preservation,12,7,5
Azulnova,tichondrius,665,evoker,preservation,18,7,11
Erso,hellscream,664,evoker,preservation,12,7,5
Dragginhealz,stormrage,662,evoker,preservation,129,59,70
Biggslegion,ysera,659,evoker,preservation,12,7,5
Heleucadio,tichondrius,659,evoker,preservation,12,7,5
Mulutlaser,frostmourne,659,evoker,preservation,18,7,11
Astaro,area-52,656,evoker,preservation,30,7,23
Densgone,aggramar,654,evoker,preservation,18,7,11
Yiptondabs,emerald-dream,650,evoker,preservation,29,7,22
Thenasath,sargeras,640,evoker,preservation,17,7,10
Wizkmushu,tichondrius,639,evoker,preservation,14,8,6
Ramas,burning-blade,638,evoker,preservation,32,8,24
Elderdragon,nerzhul,629,evoker,preservation,16,8,8
Kixxely,sargeras,623,evoker,preservation,12,8,4
Kirasa,moon-guard,623,evoker,preservation,17,7,10
Rápturé,tichondrius,618,evoker,preservation,22,10,12
Tsuruda,illidan,618,evoker,preservation,21,8,13
Soukizilla,sargeras,608,evoker,preservation,16,7,9
Drakesennin,frostmane,607,evoker,preservation,17,7,10
Hutáo,tichondrius,607,evoker,preservation,26,7,19
Saxthyr,stormreaver,592,evoker,preservation,13,7,6
Ambadragon,frostmourne,591,evoker,preservation,11,7,4
Mouthgorawr,tichondrius,590,evoker,preservation,20,7,13
Cheesedragon,tichondrius,576,evoker,preservation,6,6,0
Tatsurai,tichondrius,576,evoker,preservation,10,7,3
Melvoker,tichondrius,576,evoker,preservation,12,6,6
Dragondznuts,archimonde,576,evoker,preservation,12,6,6
Localfemboy,area-52,576,evoker,preservation,12,6,6
Daylenx,thrall,576,evoker,preservation,12,6,6
Bookwyrm,khadgar,576,evoker,preservation,12,6,6
Diregon,kelthuzad,576,evoker,preservation,12,6,6
Deecarys,illidan,576,evoker,preservation,12,6,6
Exrtj,stormrage,576,evoker,preservation,12,6,6
Thegoone,bleeding-hollow,576,evoker,preservation,12,6,6
Theyevokbuda,kelthuzad,576,evoker,preservation,12,6,6
Bad,nerzhul,576,evoker,preservation,12,6,6
Ozvoker,area-52,576,evoker,preservation,12,6,6
Dchappelle,sargeras,576,evoker,preservation,12,6,6
Kwaz,kelthuzad,576,evoker,preservation,12,6,6
Mushuffle,malygos,576,evoker,preservation,12,6,6
Jugemjugempe,icecrown,576,evoker,preservation,12,6,6
Oldgeorge,tichondrius,576,evoker,preservation,12,6,6
Psykx,frostmourne,576,evoker,preservation,12,6,6
Teëst,malganis,576,evoker,preservation,12,6,6
Ccguzzlerx,tichondrius,576,evoker,preservation,12,6,6
Dragqueenx,hyjal,576,evoker,preservation,12,6,6
Thalzudormu,bleeding-hollow,576,evoker,preservation,12,6,6
Yrenlef,laughing-skull,576,evoker,preservation,12,6,6
Thefish,tichondrius,576,evoker,preservation,12,6,6
Teddydarg,tichondrius,576,evoker,preservation,14,6,8
Sekidrac,ragnaros,576,evoker,preservation,18,6,12
Murphymonsta,stormscale,576,evoker,preservation,18,6,12
Westyvoker,arthas,576,evoker,preservation,18,6,12
Holyshiip,tichondrius,576,evoker,preservation,18,6,12
Ablunxs,drakkari,576,evoker,preservation,18,6,12
Phanthyr,tichondrius,576,evoker,preservation,18,6,12
Dragonk,dragonblight,576,evoker,preservation,18,6,12
Spyroguts,thrall,576,evoker,preservation,18,6,12
Hicane,tichondrius,576,evoker,preservation,18,6,12
Alerale,thunderlord,576,evoker,preservation,18,6,12
Deyuu,barthilas,576,evoker,preservation,28,7,21
Drageyman,tichondrius,576,evoker,preservation,28,7,21
Jumpmaster,black-dragonflight,576,evoker,preservation,24,6,18
Ryloun,sargeras,576,evoker,preservation,24,6,18
Exurion,quelthalas,575,evoker,preservation,6,6,0
Toodllesz,stormrage,575,evoker,preservation,6,6,0
Picklevoke,frostmourne,575,evoker,preservation,12,6,6
Ygnizem,ysera,575,evoker,preservation,12,6,6
Balerion,chromaggus,575,evoker,preservation,12,6,6
Dragonpaws,illidan,575,evoker,preservation,12,6,6
Nâpâlm,aggramar,575,evoker,preservation,12,6,6
Pramhedax,tichondrius,575,evoker,preservation,12,6,6
Magnito,thorium-brotherhood,575,evoker,preservation,12,6,6
Valadrakth,tichondrius,575,evoker,preservation,12,6,6
Valeshkanyel,ragnaros,575,evoker,preservation,12,6,6
Enkvoker,tichondrius,575,evoker,preservation,12,6,6
Tokeandvoke,haomarush,575,evoker,preservation,12,6,6
Flameschosen,malganis,575,evoker,preservation,12,6,6
Karuikei,proudmoore,575,evoker,preservation,12,6,6
Bhfflove,area-52,575,evoker,preservation,12,6,6
Quetzaluma,tichondrius,575,evoker,preservation,14,6,8
Naùghtygames,area-52,575,evoker,preservation,18,6,12
Drakistraz,draenor,575,evoker,preservation,18,6,12
Tanninim,sargeras,575,evoker,preservation,18,6,12
Sgtskip,blackrock,575,evoker,preservation,24,6,18
Ðrízzy,area-52,575,evoker,preservation,24,6,18
Amun,frostwolf,574,evoker,preservation,12,6,6
Evalker,tichondrius,574,evoker,preservation,12,6,6
Cinderazerat,moon-guard,574,evoker,preservation,18,6,12
Karrykx,tichondrius,574,evoker,preservation,18,6,12
Azalana,thrall,574,evoker,preservation,24,6,18
Moraise,bonechewer,573,evoker,preservation,12,6,6
Ozsandlbs,tichondrius,573,evoker,preservation,12,6,6
Siquitraki,illidan,573,evoker,preservation,18,6,12
Aethyrious,moon-guard,573,evoker,preservation,18,6,12
Zulidar,silvermoon,572,evoker,preservation,12,6,6
Banevoker,tichondrius,570,evoker,preservation,17,7,10
Rhaeynes,moon-guard,568,evoker,preservation,12,6,6
Ankhalagor,ragnaros,567,evoker,preservation,12,6,6
Preservant,stormrage,567,evoker,preservation,12,6,6
Wilbog,moon-guard,550,evoker,preservation,49,10,39
Dragussy,illidan,548,evoker,preservation,28,10,18
Hecklinheals,hyjal,544,evoker,preservation,13,7,6
Fckheals,bonechewer,543,evoker,preservation,10,6,4
Hexavalent,tichondrius,542,evoker,preservation,11,6,5
Galrend,firetree,542,evoker,preservation,17,6,11
Lishalthen,frostmourne,541,evoker,preservation,20,10,10
Freeblaze,blackhand,540,evoker,preservation,17,6,11
Dabdrake,illidan,539,evoker,preservation,14,7,7
Arazen,frostmourne,539,evoker,preservation,23,6,17
Fieros,area-52,527,evoker,preservation,13,6,7
Imperialist,proudmoore,522,evoker,preservation,29,7,22
Shenlòng,drakkari,521,evoker,preservation,15,7,8
Supernovax,illidan,512,evoker,preservation,16,6,10
Imaginedrgn,tichondrius,511,evoker,preservation,11,6,5
Nwo,shattered-hand,494,evoker,preservation,11,6,5
Brindletail,proudmoore,494,evoker,preservation,19,6,13
Finnahorns,sargeras,480,evoker,preservation,6,5,1
Imcaprise,tichondrius,480,evoker,preservation,6,5,1
Fatalion,thrall,480,evoker,preservation,6,5,1
Arzaria,stormrage,480,evoker,preservation,6,5,1
Deathwingjr,illidan,480,evoker,preservation,6,5,1
Timaeuz,malganis,480,evoker,preservation,6,5,1
Chinadragon,balnazzar,480,evoker,preservation,6,5,1
Jejep,sargeras,480,evoker,preservation,12,5,7
Fazedd,tichondrius,480,evoker,preservation,12,5,7
Spaceox,tichondrius,480,evoker,preservation,12,5,7
Supernamv,sargeras,480,evoker,preservation,12,5,7
Pinkoi,antonidas,480,evoker,preservation,12,5,7
Hornychunga,burning-legion,480,evoker,preservation,12,5,7
Cutewing,tichondrius,480,evoker,preservation,12,5,7
Berylhwit,emerald-dream,480,evoker,preservation,12,5,7
Ezarra,tichondrius,480,evoker,preservation,12,5,7
Thedajjal,tichondrius,480,evoker,preservation,12,5,7
Chronocolter,thunderhorn,480,evoker,preservation,12,5,7
Pyraxes,thunderhorn,480,evoker,preservation,12,5,7
Kayvoke,stormrage,480,evoker,preservation,12,5,7
Wydbro,kiljaeden,480,evoker,preservation,12,5,7
Killaseabee,lightnings-blade,480,evoker,preservation,12,5,7
Jambiisauce,fenris,480,evoker,preservation,12,5,7
Oldmandrake,mannoroth,480,evoker,preservation,12,5,7
Cirroaltos,aerie-peak,480,evoker,preservation,12,5,7
Shazdrag,stormrage,480,evoker,preservation,12,5,7
Transitory,bleeding-hollow,480,evoker,preservation,12,5,7
Zealantis,area-52,480,evoker,preservation,12,5,7
Draktharl,tichondrius,480,evoker,preservation,12,5,7
Evizzar,zuljin,480,evoker,preservation,12,5,7
Dragndznuhts,tichondrius,480,evoker,preservation,15,6,9
Minzur,illidan,480,evoker,preservation,21,6,15
Gdragon,sargeras,480,evoker,preservation,18,5,13
Backuphealer,bleeding-hollow,480,evoker,preservation,18,5,13
Olindoe,tichondrius,480,evoker,preservation,18,5,13
Ytsan,wyrmrest-accord,480,evoker,preservation,18,5,13
Dragonthese,cenarius,480,evoker,preservation,19,5,14
Selenian,area-52,480,evoker,preservation,24,5,19
Bronyflexy,sargeras,480,evoker,preservation,24,5,19
Bvo,stormrage,479,evoker,preservation,6,5,1
Yadirstraza,quelthalas,479,evoker,preservation,12,5,7
Lazzarross,area-52,479,evoker,preservation,12,5,7
Dandroz,hyjal,479,evoker,preservation,12,5,7
Dragonsoup,frostmourne,479,evoker,preservation,12,5,7
Dracdeez,dreadmaul,479,evoker,preservation,12,5,7
Álln,sargeras,479,evoker,preservation,12,5,7
Wrathykos,thrall,479,evoker,preservation,12,5,7
Flappeebird,area-52,479,evoker,preservation,12,5,7
Vaeghar,anvilmar,479,evoker,preservation,12,5,7
Rezpmpdragon,tichondrius,479,evoker,preservation,12,5,7
Flaplordx,frostmourne,479,evoker,preservation,12,5,7
Kratostrasz,moon-guard,479,evoker,preservation,12,5,7
Psyydragon,azralon,479,evoker,preservation,18,5,13
Scardrakk,doomhammer,479,evoker,preservation,18,5,13
Lizardtrash,ragnaros,478,evoker,preservation,12,5,7
Melbu,thunderlord,478,evoker,preservation,12,5,7
Flymuch,illidan,478,evoker,preservation,18,5,13
Oasisrose,andorhal,478,evoker,preservation,24,5,19
Scaryðragon,akama,477,evoker,preservation,12,5,7
Korvold,zuluhed,477,evoker,preservation,12,5,7
Livemaximii,moon-guard,477,evoker,preservation,12,5,7
Wetsponge,kelthuzad,477,evoker,preservation,12,5,7
Dracorblaq,bleeding-hollow,476,evoker,preservation,12,5,7
Tazeneth,sargeras,476,evoker,preservation,12,5,7
Interracial,stormscale,475,evoker,preservation,10,6,4
Ruination,lightnings-blade,463,evoker,preservation,17,5,12
Amoraz,tichondrius,460,evoker,preservation,23,5,18
Digna,thrall,448,evoker,preservation,16,5,11
Easyevoker,tichondrius,447,evoker,preservation,11,5,6
Jcii,tichondrius,447,evoker,preservation,11,5,6
Drakonyx,mugthol,439,evoker,preservation,17,5,12
Meilokkttv,sargeras,432,evoker,preservation,13,5,8
Temporal,mannoroth,431,evoker,preservation,9,6,3
Gaserick,quelthalas,426,evoker,preservation,17,6,11
Drippydragon,stormrage,424,evoker,preservation,16,6,10
Tealik,frostmourne,416,evoker,preservation,16,5,11
Swagondragon,illidan,412,evoker,preservation,10,5,5
Monzydrake,emerald-dream,408,evoker,preservation,20,5,15
Dragondewd,area-52,384,evoker,preservation,6,4,2
Râïn,tichondrius,384,evoker,preservation,6,4,2
Atraxian,tichondrius,384,evoker,preservation,6,4,2
Chainchomp,suramar,384,evoker,preservation,6,4,2
Taegon,area-52,384,evoker,preservation,6,4,2
Dyvyne,demon-soul,384,evoker,preservation,6,4,2
Murloc,shadowsong,384,evoker,preservation,6,4,2
Docevoker,tichondrius,384,evoker,preservation,6,4,2
Suzusaza,malganis,384,evoker,preservation,6,4,2
Blackdragôn,stormrage,384,evoker,preservation,6,4,2
Jëthrø,illidan,384,evoker,preservation,6,4,2
Tygor,arthas,384,evoker,preservation,6,4,2
Mtndewboy,illidan,384,evoker,preservation,6,4,2
Odmehbb,tichondrius,384,evoker,preservation,6,4,2
Blazedvoke,tichondrius,384,evoker,preservation,6,4,2
Babydragon,ragnaros,384,evoker,preservation,6,4,2
Ctlajumma,frostmourne,384,evoker,preservation,6,4,2
Soupywings,illidan,384,evoker,preservation,6,4,2
Dracmorz,nemesis,384,evoker,preservation,6,4,2
Syneestra,nemesis,384,evoker,preservation,6,4,2
Velahesa,sargeras,384,evoker,preservation,6,4,2
Mvpjs,medivh,384,evoker,preservation,8,4,4
Dragginnutsz,tichondrius,384,evoker,preservation,12,4,8
Dragwyn,senjin,384,evoker,preservation,12,4,8
Slaymedaddy,proudmoore,384,evoker,preservation,12,4,8
Drawong,zuljin,384,evoker,preservation,12,4,8
Kalessin,whisperwind,384,evoker,preservation,12,4,8
Blazedvoker,tichondrius,384,evoker,preservation,12,4,8
Larryboy,kelthuzad,384,evoker,preservation,12,4,8
Donresantis,tichondrius,384,evoker,preservation,12,4,8
Williamjong,tichondrius,384,evoker,preservation,12,4,8
Crumbsock,thrall,384,evoker,preservation,12,4,8
Dragonslut,kiljaeden,384,evoker,preservation,12,4,8
Shoestrings,tichondrius,384,evoker,preservation,12,4,8
Jep,emerald-dream,384,evoker,preservation,12,4,8
Rawrexp,emerald-dream,384,evoker,preservation,12,4,8
Khalio,hyjal,384,evoker,preservation,12,4,8
Pensini,illidan,384,evoker,preservation,12,4,8
Flipturn,illidan,384,evoker,preservation,12,4,8
Mignificent,sargeras,384,evoker,preservation,12,4,8
Livebate,tichondrius,384,evoker,preservation,12,4,8
Dracynmana,perenolde,384,evoker,preservation,12,4,8
Zymx,moon-guard,384,evoker,preservation,12,4,8
Samostrasza,illidan,384,evoker,preservation,12,4,8
Boppled,tichondrius,384,evoker,preservation,12,4,8
Bryágh,wyrmrest-accord,384,evoker,preservation,12,4,8
Dragonberry,tichondrius,384,evoker,preservation,12,4,8
Dragrenghost,illidan,384,evoker,preservation,12,4,8
Razenset,draktharon,384,evoker,preservation,12,4,8
Dragondoh,frostmourne,384,evoker,preservation,12,4,8
Imadargin,malganis,384,evoker,preservation,12,4,8
Zandet,thunderlord,384,evoker,preservation,12,4,8
Vanyalus,uldum,384,evoker,preservation,12,4,8
Raphdragon,stormrage,384,evoker,preservation,12,4,8
Gójira,jubeithos,384,evoker,preservation,12,4,8
Oatmealneil,bleeding-hollow,384,evoker,preservation,16,4,12
Trensetra,sargeras,384,evoker,preservation,18,4,14
Epicdragon,sargeras,384,evoker,preservation,18,4,14
Pbaxo,tichondrius,384,evoker,preservation,18,4,14
Upsdriver,dentarg,384,evoker,preservation,18,4,14
Oldui,frostmourne,384,evoker,preservation,18,4,14
Tidehunter,chogall,384,evoker,preservation,18,4,14
Clawbear,kiljaeden,384,evoker,preservation,18,4,14
Alysraa,moon-guard,384,evoker,preservation,24,4,20
Cerémony,zuljin,383,evoker,preservation,6,4,2
Kildormu,tichondrius,383,evoker,preservation,12,4,8
Tihkal,spinebreaker,383,evoker,preservation,12,4,8
Dombi,moon-guard,383,evoker,preservation,12,4,8
Quesovoke,eldrethalas,383,evoker,preservation,12,4,8
Sheshumaru,ragnaros,383,evoker,preservation,12,4,8
Razhion,arathor,383,evoker,preservation,12,4,8
Sylvee,bleeding-hollow,383,evoker,preservation,13,4,9
Kyldarr,garithos,382,evoker,preservation,6,4,2
Uwuspit,tichondrius,382,evoker,preservation,12,4,8
Enlighteni,area-52,382,evoker,preservation,12,4,8
Bigtoots,illidan,382,evoker,preservation,12,4,8
Stroker,boulderfist,381,evoker,preservation,12,4,8
Danatreseth,moon-guard,380,evoker,preservation,12,4,8
Extremess,quelthalas,380,evoker,preservation,12,4,8
Galaxiz,bonechewer,377,evoker,preservation,18,4,14
Ragendragon,hellscream,377,evoker,preservation,18,4,14
Daddyrp,tichondrius,372,evoker,preservation,26,9,17
Nyxstrasza,moknathal,366,evoker,preservation,11,4,7
Snailor,eldrethalas,351,evoker,preservation,10,4,6
Draxitar,blackrock,346,evoker,preservation,16,4,12
Annazara,stormrage,336,evoker,preservation,9,4,5
Zathasar,tichondrius,333,evoker,preservation,28,4,24
Corlys,thunderhorn,330,evoker,preservation,17,5,12
Zaraller,tichondrius,329,evoker,preservation,9,5,4
Homiedraconi,nordrassil,329,evoker,preservation,12,5,7
Jolynne,illidan,320,evoker,preservation,14,4,10
Vlysage,dark-iron,319,evoker,preservation,5,4,1
Theory,icecrown,319,evoker,preservation,5,4,1
Ccms,area-52,319,evoker,preservation,5,4,1
Lantur,perenolde,319,evoker,preservation,16,4,12
Mordrake,tichondrius,318,evoker,preservation,25,4,21
Polyrhythmic,ysera,304,evoker,preservation,7,4,3
Hopefire,zuljin,288,evoker,preservation,6,3,3
Dimpulse,zuljin,288,evoker,preservation,6,3,3
Simplerules,zuljin,288,evoker,preservation,6,3,3
Crackcook,frostmourne,288,evoker,preservation,6,3,3
Zenazen,sargeras,288,evoker,preservation,6,3,3
Chawp,tichondrius,288,evoker,preservation,6,3,3
Ðçßñÿåæéîùøð,tichondrius,288,evoker,preservation,6,3,3
Kreutzhauser,tichondrius,288,evoker,preservation,6,3,3
Sigmanuz,tichondrius,288,evoker,preservation,6,3,3
Gvoker,nemesis,288,evoker,preservation,6,3,3
Kheeleesi,illidan,288,evoker,preservation,6,3,3
Johnevoker,malganis,288,evoker,preservation,6,3,3
Dirtydraco,nerzhul,288,evoker,preservation,6,3,3
Dragonwagon,kelthuzad,288,evoker,preservation,6,3,3
Flexlong,tichondrius,288,evoker,preservation,6,3,3
Tournament,hakkar,288,evoker,preservation,6,3,3
Lìthium,frostmourne,288,evoker,preservation,6,3,3
Dragonboots,area-52,288,evoker,preservation,6,3,3
Shalestrasz,proudmoore,288,evoker,preservation,6,3,3
Shalanoth,proudmoore,288,evoker,preservation,6,3,3
Rangä,caelestrasz,288,evoker,preservation,6,3,3
Beelzeyob,illidan,288,evoker,preservation,6,3,3
Drakush,tichondrius,288,evoker,preservation,6,3,3
Predacious,draktharon,288,evoker,preservation,6,3,3
Dalechance,tichondrius,288,evoker,preservation,6,3,3
Kñuj,illidan,288,evoker,preservation,6,3,3
Cônflicted,emerald-dream,288,evoker,preservation,6,3,3
Raxdragon,sargeras,288,evoker,preservation,6,3,3
Thendetra,mannoroth,288,evoker,preservation,6,3,3
Bigtitsdrag,illidan,288,evoker,preservation,6,3,3
Knowragretz,tichondrius,288,evoker,preservation,6,3,3
Flapandclap,nerzhul,288,evoker,preservation,6,3,3
Spyrä,moon-guard,288,evoker,preservation,6,3,3
Lirøu,azralon,288,evoker,preservation,6,3,3
Skarsx,frostmourne,288,evoker,preservation,6,3,3
Dragonleaves,sargeras,288,evoker,preservation,6,3,3
Powerfulman,drakthul,288,evoker,preservation,6,3,3
Drogôn,cairne,288,evoker,preservation,6,3,3
Draseew,drakkari,288,evoker,preservation,6,3,3
Vokefuu,illidan,288,evoker,preservation,6,3,3
Iggyytv,area-52,288,evoker,preservation,6,3,3
Razdargon,kiljaeden,288,evoker,preservation,6,3,3
Setren,antonidas,288,evoker,preservation,6,3,3
Jakburnon,stormrage,288,evoker,preservation,6,3,3
Javoc,drakkari,288,evoker,preservation,6,3,3
Æg,zuljin,288,evoker,preservation,6,3,3
Dracoon,madoran,288,evoker,preservation,6,3,3
Swagdriver,moon-guard,288,evoker,preservation,6,3,3
Jokko,moon-guard,288,evoker,preservation,6,3,3
Thayvoker,bleeding-hollow,288,evoker,preservation,6,3,3
Redhorn,frostmourne,288,evoker,preservation,6,3,3
Vygrax,nerzhul,288,evoker,preservation,6,3,3
Shenròn,kelthuzad,288,evoker,preservation,9,4,5
Tessaryonn,ragnaros,288,evoker,preservation,7,3,4
Fugginuhh,proudmoore,288,evoker,preservation,12,3,9
Discussion,area-52,288,evoker,preservation,12,3,9
Specscaly,hyjal,288,evoker,preservation,12,3,9
Tefari,dalaran,288,evoker,preservation,12,3,9
Raegon,wyrmrest-accord,288,evoker,preservation,12,3,9
Zeldormu,malganis,288,evoker,preservation,12,3,9
Hel,stormrage,288,evoker,preservation,12,3,9
Teldormu,drenden,288,evoker,preservation,12,3,9
Vandornomu,illidan,288,evoker,preservation,12,3,9
Jammstraza,skywall,288,evoker,preservation,12,3,9
Drazongas,cenarius,288,evoker,preservation,12,3,9
Alevoker,ragnaros,288,evoker,preservation,12,3,9
Dwacawys,zuljin,288,evoker,preservation,12,3,9
Dragonbabu,area-52,288,evoker,preservation,12,3,9
Cøømbuya,sargeras,288,evoker,preservation,12,3,9
Tyrannicull,sargeras,288,evoker,preservation,12,3,9
Ryuzaki,zuluhed,288,evoker,preservation,12,3,9
Snáckbóx,alexstrasza,288,evoker,preservation,12,3,9
Stormdagger,proudmoore,288,evoker,preservation,12,3,9
Scyyterr,azralon,288,evoker,preservation,12,3,9
Phosphothel,moon-guard,288,evoker,preservation,12,3,9
Ahahaa,frostmourne,288,evoker,preservation,12,3,9
Reflexd,malganis,288,evoker,preservation,12,3,9
Explosives,blades-edge,288,evoker,preservation,12,3,9
Windchaser,kelthuzad,288,evoker,preservation,18,3,15
Rogir,zuljin,288,evoker,preservation,18,3,15
Wapowthion,blades-edge,288,evoker,preservation,18,3,15
Azhdaha,kelthuzad,288,evoker,preservation,18,3,15
Arkaan,malganis,288,evoker,preservation,18,3,15
Rizzanomics,zuljin,287,evoker,preservation,8,4,4
Retroo,dark-iron,287,evoker,preservation,6,3,3
Notvez,bleeding-hollow,287,evoker,preservation,6,3,3
Killerdragon,darkspear,287,evoker,preservation,6,3,3
Drakier,kelthuzad,287,evoker,preservation,6,3,3
Arcaenae,moon-guard,287,evoker,preservation,6,3,3
Supereragon,area-52,287,evoker,preservation,6,3,3
Deralizrd,tichondrius,287,evoker,preservation,6,3,3
Chenrong,sargeras,287,evoker,preservation,12,3,9
Bilbodragons,stormreaver,287,evoker,preservation,12,3,9
Meekness,misha,287,evoker,preservation,12,3,9
Draktarion,ragnaros,287,evoker,preservation,12,3,9
Tazen,bleeding-hollow,287,evoker,preservation,12,3,9
Kalestrasza,nathrezim,287,evoker,preservation,13,3,10
Toothlesz,draka,287,evoker,preservation,18,3,15
Cyndera,windrunner,286,evoker,preservation,6,3,3
Kalistro,quelthalas,286,evoker,preservation,6,3,3
Naxarick,ragnaros,286,evoker,preservation,6,3,3
Dractherion,kiljaeden,285,evoker,preservation,18,3,15
Sodre,illidan,285,evoker,preservation,24,3,21
Gibvoke,icecrown,271,evoker,preservation,11,3,8
Blargan,area-52,271,evoker,preservation,17,3,14
Uskrait,tichondrius,255,evoker,preservation,14,4,10
Stíckyj,tichondrius,255,evoker,preservation,11,3,8
Slashprovoke,frostmourne,239,evoker,preservation,5,3,2
Setrazen,illidan,234,evoker,preservation,9,4,5
Yujirohanma,frostmourne,234,evoker,preservation,12,4,8
Saenys,ragnaros,234,evoker,preservation,16,4,12
Avastra,blackrock,233,evoker,preservation,9,5,4
Winghoof,kiljaeden,224,evoker,preservation,16,3,13
Chicknwingz,stormreaver,223,evoker,preservation,8,3,5
Baexstrasza,tichondrius,223,evoker,preservation,10,3,7
Zenetar,area-52,223,evoker,preservation,26,3,23
Tugmapvpean,kelthuzad,208,evoker,preservation,7,3,4
Salamandra,malganis,192,evoker,preservation,6,2,4
Drugdoer,illidan,192,evoker,preservation,6,2,4
Conorvokes,tichondrius,192,evoker,preservation,6,2,4
Ashgaar,sargeras,192,evoker,preservation,6,2,4
Wse,illidan,192,evoker,preservation,6,2,4
Blazor,sisters-of-elune,192,evoker,preservation,6,2,4
Preserveluke,moon-guard,192,evoker,preservation,6,2,4
Helixor,anvilmar,192,evoker,preservation,6,2,4
Zindrath,emerald-dream,192,evoker,preservation,6,2,4
Aldruín,illidan,192,evoker,preservation,6,2,4
Carrnedge,area-52,192,evoker,preservation,6,2,4
Daemon,terokkar,192,evoker,preservation,6,2,4
Nil,malganis,192,evoker,preservation,6,2,4
Dscim,zuljin,192,evoker,preservation,6,2,4
Evokeyabtch,malganis,192,evoker,preservation,6,2,4
Johka,tichondrius,192,evoker,preservation,6,2,4
Baðìka,area-52,192,evoker,preservation,6,2,4
Jessefurr,undermine,192,evoker,preservation,6,2,4
Memnochd,emerald-dream,192,evoker,preservation,6,2,4
Sanashalan,moon-guard,192,evoker,preservation,6,2,4
Sketchybum,tichondrius,192,evoker,preservation,6,2,4
Ignicion,quelthalas,192,evoker,preservation,6,2,4
Dwagonwage,zuljin,192,evoker,preservation,6,2,4
Raelennis,ragnaros,192,evoker,preservation,6,2,4
Kaaer,emerald-dream,192,evoker,preservation,6,2,4
Ewoked,tichondrius,192,evoker,preservation,6,2,4
Stickvoker,sargeras,192,evoker,preservation,6,2,4
Exiztx,tichondrius,192,evoker,preservation,6,2,4
Froky,stormrage,192,evoker,preservation,6,2,4
Ardu,frostmourne,192,evoker,preservation,6,2,4
Racovoker,zuljin,192,evoker,preservation,6,2,4
Mako,uther,192,evoker,preservation,6,2,4
Todorokî,frostmourne,192,evoker,preservation,6,2,4
Topg,boulderfist,192,evoker,preservation,6,2,4
Syfen,burning-blade,192,evoker,preservation,6,2,4
Devokèr,tichondrius,192,evoker,preservation,6,2,4
Custipiu,azralon,192,evoker,preservation,6,2,4
Evokesaint,wyrmrest-accord,192,evoker,preservation,6,2,4
Lexazule,bleeding-hollow,192,evoker,preservation,6,2,4
Nonjer,tichondrius,192,evoker,preservation,6,2,4
Tóòthless,senjin,192,evoker,preservation,6,2,4
Mestrewëll,stormrage,192,evoker,preservation,6,2,4
Nite,lothar,192,evoker,preservation,6,2,4
Dragonsand,stormrage,192,evoker,preservation,6,2,4
Kalrid,sargeras,192,evoker,preservation,6,2,4
Åñçhör,stormrage,192,evoker,preservation,6,2,4
Burninator,black-dragonflight,192,evoker,preservation,6,2,4
Bloodydragon,firetree,192,evoker,preservation,6,2,4
Wonyoungx,frostmourne,192,evoker,preservation,6,2,4
Hochelaga,arthas,192,evoker,preservation,6,2,4
Alexevoker,tichondrius,192,evoker,preservation,6,2,4
Invdkill,azralon,192,evoker,preservation,6,2,4
Lëåf,area-52,192,evoker,preservation,6,2,4
Flappyboy,bleeding-hollow,192,evoker,preservation,6,2,4
Drakhaz,azralon,192,evoker,preservation,6,2,4
Echosapián,stormrage,192,evoker,preservation,6,2,4
Drapary,dathremar,192,evoker,preservation,6,2,4
Melchior,suramar,192,evoker,preservation,6,2,4
Huanglong,sargeras,192,evoker,preservation,12,2,10
Drakthyrmonk,hyjal,192,evoker,preservation,12,2,10
Ceraxxes,tichondrius,192,evoker,preservation,12,2,10
Poatis,illidan,192,evoker,preservation,12,2,10
Kakäshï,tichondrius,192,evoker,preservation,12,2,10
Contractor,emerald-dream,192,evoker,preservation,12,2,10
Nøøvè,area-52,192,evoker,preservation,12,2,10
Toyatoki,stormrage,192,evoker,preservation,12,2,10
Timecøp,zuljin,192,evoker,preservation,12,2,10
Raphd,sargeras,192,evoker,preservation,12,2,10
Archoni,kelthuzad,192,evoker,preservation,12,2,10
Luxxa,bloodhoof,192,evoker,preservation,12,2,10
Shellybelly,shadowmoon,192,evoker,preservation,12,2,10
Takasaki,dalaran,192,evoker,preservation,12,2,10
Moop,spinebreaker,192,evoker,preservation,12,2,10
Olesmokey,tichondrius,192,evoker,preservation,12,2,10
Tightp,malganis,192,evoker,preservation,12,2,10
Olawd,azshara,192,evoker,preservation,12,2,10
Drachenatem,skywall,192,evoker,preservation,15,2,13
Dadydafather,sargeras,192,evoker,preservation,24,2,22
Valethal,ragnaros,191,evoker,preservation,6,2,4
Spyrð,emerald-dream,191,evoker,preservation,6,2,4
Lacost,area-52,191,evoker,preservation,6,2,4
Shadowyasuke,area-52,191,evoker,preservation,12,2,10
Shtableboy,illidan,191,evoker,preservation,12,2,10
Evooern,frostmourne,175,evoker,preservation,11,2,9
Solekstraza,stormrage,160,evoker,preservation,10,3,7
Caldragon,aerie-peak,159,evoker,preservation,5,2,3
Pandasmoketv,proudmoore,159,evoker,preservation,5,2,3
Pyrodextrin,wyrmrest-accord,159,evoker,preservation,5,2,3
Devokerkofwa,tichondrius,159,evoker,preservation,5,2,3
Gigaiguana,quelthalas,159,evoker,preservation,8,3,5
Jetthryx,emerald-dream,159,evoker,preservation,11,2,9
Dragonbush,sargeras,138,evoker,preservation,10,3,7
Shíkyo,stormrage,138,evoker,preservation,20,3,17
Clapzyrbgs,stormrage,105,evoker,preservation,13,3,10
Hutterbut,malganis,96,evoker,preservation,3,2,1
Dragoondeez,bleeding-hollow,96,evoker,preservation,3,2,1
Tyson,frostmane,96,evoker,preservation,6,1,5
Mookthyr,area-52,96,evoker,preservation,6,1,5
Varandir,frostmane,96,evoker,preservation,6,1,5
Daraz,tichondrius,96,evoker,preservation,6,1,5
Caelïn,malganis,96,evoker,preservation,6,1,5
Deviantart,emerald-dream,96,evoker,preservation,6,1,5
Neroker,malganis,96,evoker,preservation,6,1,5
Hausebat,moon-guard,96,evoker,preservation,6,1,5
Rdrako,emerald-dream,96,evoker,preservation,6,1,5
Spyroh,crushridge,96,evoker,preservation,6,1,5
Minikoaall,illidan,96,evoker,preservation,6,1,5
Dragnips,bleeding-hollow,96,evoker,preservation,6,1,5
Pyrepeanut,tichondrius,96,evoker,preservation,6,1,5
Dragostephen,nazjatar,96,evoker,preservation,6,1,5
Kazerica,illidan,96,evoker,preservation,6,1,5
Ashafi,area-52,96,evoker,preservation,6,1,5
Acvoker,tichondrius,96,evoker,preservation,6,1,5
Simarity,thrall,96,evoker,preservation,6,1,5
Keedrori,thrall,96,evoker,preservation,6,1,5
Henryvoker,moknathal,96,evoker,preservation,6,1,5
Gamerwords,barthilas,96,evoker,preservation,6,1,5
Saînt,thrall,96,evoker,preservation,6,1,5
Undeniable,zuljin,96,evoker,preservation,6,1,5
Khaosdragona,proudmoore,96,evoker,preservation,6,1,5
Hardstuckirl,tichondrius,96,evoker,preservation,6,1,5
Rojothyr,tichondrius,96,evoker,preservation,6,1,5
Daddymike,thrall,96,evoker,preservation,6,1,5
Nivekk,zuljin,96,evoker,preservation,6,1,5
Xampusaurio,ragnaros,96,evoker,preservation,6,1,5
Sobuker,wyrmrest-accord,96,evoker,preservation,6,1,5
Patrdorasz,zuljin,96,evoker,preservation,6,1,5
Myjewelshurt,stormrage,96,evoker,preservation,6,1,5
Atreign,blackwing-lair,96,evoker,preservation,6,1,5
Banjee,hellscream,96,evoker,preservation,6,1,5
Ripdumpster,bonechewer,96,evoker,preservation,6,1,5
Azgrodragon,stonemaul,96,evoker,preservation,6,1,5
Daymanx,zuljin,96,evoker,preservation,6,1,5
Beanflickher,tichondrius,96,evoker,preservation,6,1,5
Ambium,dunemaul,96,evoker,preservation,6,1,5
Rekkcah,bloodscalp,96,evoker,preservation,6,1,5
Ðrogõ,ragnaros,96,evoker,preservation,6,1,5
Talleraz,zuljin,96,evoker,preservation,6,1,5
Vvhip,tichondrius,96,evoker,preservation,6,1,5
Omars,sargeras,96,evoker,preservation,6,1,5
Etereosthel,ragnaros,96,evoker,preservation,6,1,5
Nändy,tichondrius,96,evoker,preservation,6,1,5
Azurflame,tichondrius,96,evoker,preservation,6,1,5
Chrisbenoitx,illidan,96,evoker,preservation,6,1,5
Catvoker,area-52,96,evoker,preservation,6,1,5
Tasdarallar,frostmourne,96,evoker,preservation,6,1,5
Tobee,stormrage,96,evoker,preservation,6,1,5
Ðräco,quelthalas,96,evoker,preservation,6,1,5
Ohmylanta,stormrage,96,evoker,preservation,6,1,5
Fronkeyxl,stormrage,96,evoker,preservation,6,1,5
Derath,maelstrom,96,evoker,preservation,12,1,11
Eragon,feathermoon,96,evoker,preservation,12,1,11
Alkden,azralon,96,evoker,preservation,12,1,11
Shimshine,destromath,96,evoker,preservation,12,1,11
Nelphemuer,wyrmrest-accord,96,evoker,preservation,12,1,11
Morkite,moon-guard,96,evoker,preservation,12,1,11
Draghone,illidan,96,evoker,preservation,12,1,11
Sashvoker,illidan,96,evoker,preservation,12,1,11
Dakotakek,illidan,96,evoker,preservation,12,1,11
Seamanstorm,area-52,96,evoker,preservation,12,1,11
Jeeyell,malganis,96,evoker,preservation,12,1,11
Khorvin,proudmoore,96,evoker,preservation,12,1,11
Rhale,whisperwind,96,evoker,preservation,12,1,11
Exilence,alleria,96,evoker,preservation,17,1,16
Kâïn,tichondrius,95,evoker,preservation,24,1,23
Dragontamz,the-forgotten-coast,89,evoker,preservation,8,3,5
Blowmiê,area-52,79,evoker,preservation,5,1,4
Dragcules,thrall,42,evoker,preservation,11,2,9
Zagze,stormrage,42,evoker,preservation,15,2,13
Tenyeen,moonrunner,31,evoker,preservation,2,1,1
Luøzheng,drakkari,16,evoker,preservation,1,1,0
Sëverus,moon-guard,9,evoker,preservation,8,5,3
Thiqc,zuluhed,9,evoker,preservation,9,3,6
Nikthevoker,tichondrius,2207,evoker,devastation,176,96,80
Caedalade,spirestone,2180,evoker,devastation,123,70,53
Ocdgamer,malganis,2171,evoker,devastation,143,73,70
Nikthevoker,area-52,2160,evoker,devastation,225,115,110
Crappysmellz,tichondrius,2157,evoker,devastation,85,48,37
Chun,malganis,2148,evoker,devastation,60,35,25
Whilefalse,stormrage,2125,evoker,devastation,95,48,47
Lizzimcguire,zuljin,2118,evoker,devastation,90,60,30
Artemad,moon-guard,2109,evoker,devastation,144,84,60
Shamblewing,arthas,2094,evoker,devastation,95,47,48
Breathalizer,sargeras,2068,evoker,devastation,132,74,58
Dametra,proudmoore,2066,evoker,devastation,126,70,56
Evokemedaddy,bleeding-hollow,2064,evoker,devastation,179,95,84
Kinndyvoker,sargeras,2048,evoker,devastation,77,38,39
Jwoker,malganis,2044,evoker,devastation,77,42,35
Rothvoker,tichondrius,2040,evoker,devastation,127,73,54
Frequevoker,tichondrius,2020,evoker,devastation,65,30,35
Drogu,kelthuzad,2013,evoker,devastation,84,47,37
Somyr,area-52,2010,evoker,devastation,198,103,95
Caedalade,proudmoore,2001,evoker,devastation,402,198,204
Eastwubz,norgannon,1977,evoker,devastation,238,122,116
Katadrak,area-52,1974,evoker,devastation,54,32,22
Juicyjom,staghelm,1972,evoker,devastation,66,36,30
Azradormu,zuljin,1968,evoker,devastation,288,143,145
Saryuja,thunderhorn,1958,evoker,devastation,82,52,30
Pykan,skullcrusher,1950,evoker,devastation,65,34,31
Meltharian,frostmourne,1938,evoker,devastation,146,80,66
Hutaothighs,illidan,1937,evoker,devastation,130,67,63
Bigdrag,blackhand,1927,evoker,devastation,245,129,116
Dzrn,moon-guard,1922,evoker,devastation,144,72,72
Wazgon,emerald-dream,1915,evoker,devastation,272,132,140
Draxarys,area-52,1914,evoker,devastation,284,147,137
Arzaria,stormrage,1908,evoker,devastation,170,94,76
Venarys,dalaran,1903,evoker,devastation,54,36,18
Rõÿ,area-52,1903,evoker,devastation,42,25,17
Ayavi,illidan,1890,evoker,devastation,96,61,35
Trogdør,illidan,1887,evoker,devastation,171,85,86
Quadude,illidan,1886,evoker,devastation,221,109,112
Gôdzevoker,area-52,1879,evoker,devastation,129,73,56
Seldantria,dalaran,1875,evoker,devastation,71,36,35
Azazél,borean-tundra,1868,evoker,devastation,257,136,121
Draxarys,tichondrius,1867,evoker,devastation,369,183,186
Gwaelii,tichondrius,1865,evoker,devastation,117,70,47
Laneva,moon-guard,1863,evoker,devastation,134,90,44
Krashbandico,zangarmarsh,1863,evoker,devastation,61,30,31
Mtndewboy,illidan,1856,evoker,devastation,126,67,59
Thrawn,arygos,1855,evoker,devastation,59,37,22
Strepo,proudmoore,1851,evoker,devastation,66,34,32
Royquaza,illidan,1850,evoker,devastation,60,33,27
Wheezee,emerald-dream,1850,evoker,devastation,46,25,21
Coltist,elune,1848,evoker,devastation,42,29,13
Rescued,wyrmrest-accord,1848,evoker,devastation,54,31,23
Tatsurai,tichondrius,1845,evoker,devastation,43,24,19
Puf,magtheridon,1845,evoker,devastation,420,223,197
Fores,tichondrius,1845,evoker,devastation,127,65,62
Eshen,ragnaros,1843,evoker,devastation,298,158,140
Yrue,moon-guard,1843,evoker,devastation,72,37,35
Koalaman,area-52,1840,evoker,devastation,348,176,172
Plep,wyrmrest-accord,1836,evoker,devastation,51,30,21
Anachronormu,mannoroth,1836,evoker,devastation,119,64,55
Raxdragon,sargeras,1826,evoker,devastation,36,22,14
Dracthael,stormrage,1825,evoker,devastation,134,76,58
Srb,chogall,1824,evoker,devastation,113,63,50
Krúnsh,ragnaros,1823,evoker,devastation,191,104,87
Izzythelizzy,tichondrius,1820,evoker,devastation,206,114,92
Beatdownbill,sargeras,1820,evoker,devastation,200,104,96
Mushugon,wyrmrest-accord,1819,evoker,devastation,71,44,27
Zoomi,whisperwind,1819,evoker,devastation,35,20,15
Komodolong,tichondrius,1819,evoker,devastation,53,26,27
Azvanced,sargeras,1818,evoker,devastation,48,31,17
Kyloflight,thrall,1817,evoker,devastation,50,33,17
Æthyr,anubarak,1816,evoker,devastation,54,33,21
Dracaryz,blackhand,1814,evoker,devastation,60,35,25
Fizzlevoker,malganis,1814,evoker,devastation,65,32,33
Gridskully,quelthalas,1814,evoker,devastation,81,38,43
Courtvoke,turalyon,1813,evoker,devastation,94,57,37
Teriarch,stormrage,1813,evoker,devastation,39,23,16
Caelïn,malganis,1812,evoker,devastation,244,133,111
Milkymike,uldum,1811,evoker,devastation,72,44,28
Gojirastraza,stormrage,1810,evoker,devastation,53,32,21
Taylordra,tichondrius,1810,evoker,devastation,63,33,30
Nørbert,frostmourne,1808,evoker,devastation,66,36,30
Ragedizzle,twisting-nether,1808,evoker,devastation,91,49,42
Mil,lightnings-blade,1808,evoker,devastation,69,37,32
Geicovoker,tichondrius,1806,evoker,devastation,52,30,22
Blackdragôn,stormrage,1806,evoker,devastation,67,36,31
Tazriak,tichondrius,1803,evoker,devastation,83,52,31
Ycnpass,tichondrius,1802,evoker,devastation,119,66,53
Hlnv,aegwynn,1801,evoker,devastation,64,43,21
Thordak,drakkari,1801,evoker,devastation,72,40,32
Fractalz,alterac-mountains,1800,evoker,devastation,169,92,77
Drakori,azralon,1797,evoker,devastation,109,63,46
Dobbieslide,barthilas,1791,evoker,devastation,24,19,5
Evokes,moon-guard,1790,evoker,devastation,92,46,46
Obsidianimp,sargeras,1785,evoker,devastation,54,24,30
Bugberry,illidan,1784,evoker,devastation,102,51,51
Derite,bonechewer,1781,evoker,devastation,46,34,12
Airgordan,area-52,1781,evoker,devastation,107,50,57
Mfquietus,illidan,1773,evoker,devastation,84,49,35
Mcglizzy,stormrage,1766,evoker,devastation,179,96,83
Zenithria,thrall,1760,evoker,devastation,190,102,88
Dragnmÿballs,blackrock,1756,evoker,devastation,66,44,22
Swolegarian,emerald-dream,1756,evoker,devastation,107,57,50
Dilon,area-52,1750,evoker,devastation,72,41,31
Flapples,stormrage,1746,evoker,devastation,120,65,55
Vhagarius,tichondrius,1746,evoker,devastation,118,61,57
Emiriss,thrall,1744,evoker,devastation,88,45,43
Ilovepolpot,tichondrius,1738,evoker,devastation,30,21,9
Blowmiê,area-52,1736,evoker,devastation,164,88,76
Theredmenace,barthilas,1734,evoker,devastation,41,26,15
Cowboyydann,malganis,1733,evoker,devastation,29,19,10
Stickvoker,sargeras,1733,evoker,devastation,66,40,26
Golden,area-52,1733,evoker,devastation,46,24,22
Galakrønd,illidan,1732,evoker,devastation,146,82,64
Flippyflappy,zuljin,1731,evoker,devastation,51,31,20
Juicylizard,stormrage,1730,evoker,devastation,266,135,131
Zenasatral,sargeras,1726,evoker,devastation,37,27,10
Draislyn,cenarion-circle,1725,evoker,devastation,66,40,26
Axiomoixa,tichondrius,1722,evoker,devastation,42,23,19
Drgua,tichondrius,1722,evoker,devastation,69,33,36
Peef,tichondrius,1720,evoker,devastation,30,18,12
Nazaral,mannoroth,1718,evoker,devastation,126,67,59
Nunez,frostmourne,1713,evoker,devastation,41,22,19
Arkeryte,moon-guard,1713,evoker,devastation,184,95,89
Betasoldier,kelthuzad,1710,evoker,devastation,107,62,45
Eszel,thunderlord,1708,evoker,devastation,190,102,88
Djvokey,area-52,1706,evoker,devastation,47,26,21
Ðeepßreath,sargeras,1703,evoker,devastation,72,38,34
Iamluck,kiljaeden,1701,evoker,devastation,58,30,28
Millagosa,stormrage,1700,evoker,devastation,120,62,58
Xxkimura,tichondrius,1698,evoker,devastation,376,190,186
Zlyrax,moon-guard,1695,evoker,devastation,30,18,12
Tagzy,tichondrius,1693,evoker,devastation,105,64,41
Jase,gilneas,1691,evoker,devastation,74,45,29
Ethalem,thrall,1690,evoker,devastation,330,173,157
Nändy,tichondrius,1689,evoker,devastation,48,28,20
Spyrodadrago,malganis,1689,evoker,devastation,93,51,42
Oldxdrake,sargeras,1689,evoker,devastation,156,77,79
Puffthemagic,lightnings-blade,1687,evoker,devastation,53,27,26
Qbgosa,malganis,1686,evoker,devastation,48,27,21
Whinks,zangarmarsh,1685,evoker,devastation,48,26,22
Cløud,hellscream,1684,evoker,devastation,24,18,6
Schmitty,hellscream,1684,evoker,devastation,30,20,10
Dragonborn,malganis,1684,evoker,devastation,33,20,13
Evokez,barthilas,1682,evoker,devastation,64,41,23
Djvoker,zuljin,1681,evoker,devastation,62,32,30
Darkwingz,icecrown,1680,evoker,devastation,44,25,19
Catvoker,area-52,1678,evoker,devastation,114,58,56
Alekoslol,area-52,1677,evoker,devastation,46,27,19
Vizora,moon-guard,1674,evoker,devastation,184,97,87
Lukamagik,boulderfist,1673,evoker,devastation,42,22,20
Balrôg,malganis,1672,evoker,devastation,104,50,54
Garlicbreth,stormrage,1671,evoker,devastation,76,40,36
Kaldesun,ragnaros,1670,evoker,devastation,36,22,14
Bucket,wyrmrest-accord,1665,evoker,devastation,48,24,24
Shalander,proudmoore,1664,evoker,devastation,159,87,72
Scaleychad,zuljin,1656,evoker,devastation,65,31,34
Dovàhkin,moon-guard,1655,evoker,devastation,66,35,31
Rá,drenden,1655,evoker,devastation,102,43,59
Bumbaclot,illidan,1653,evoker,devastation,43,24,19
Mindme,tichondrius,1652,evoker,devastation,53,30,23
Haramcad,tichondrius,1652,evoker,devastation,165,89,76
Wingdeadly,tichondrius,1650,evoker,devastation,66,35,31
Raller,malganis,1649,evoker,devastation,30,18,12
Mlboa,frostmourne,1649,evoker,devastation,64,31,33
Madjeckyl,dalaran,1649,evoker,devastation,54,25,29
Whethersmell,tichondrius,1648,evoker,devastation,75,46,29
Nykhel,tichondrius,1648,evoker,devastation,42,21,21
Kazooie,zuljin,1648,evoker,devastation,42,20,22
Rhÿu,quelthalas,1647,evoker,devastation,137,76,61
Koralia,moon-guard,1647,evoker,devastation,42,18,24
Deralan,khaz-modan,1645,evoker,devastation,36,20,16
Zindraco,thrall,1645,evoker,devastation,48,23,25
Psynister,illidan,1644,evoker,devastation,168,76,92
Hmong,proudmoore,1643,evoker,devastation,48,20,28
Erizcdraa,tichondrius,1642,evoker,devastation,46,26,20
Epollyon,sargeras,1639,evoker,devastation,42,25,17
Soory,coilfang,1639,evoker,devastation,82,46,36
Xhamon,quelthalas,1636,evoker,devastation,231,113,118
Yakkin,kelthuzad,1634,evoker,devastation,92,51,41
Dractheseus,tichondrius,1633,evoker,devastation,42,23,19
Zeranthal,moon-guard,1632,evoker,devastation,32,21,11
Breathkillsu,emerald-dream,1631,evoker,devastation,42,20,22
Averithel,moon-guard,1630,evoker,devastation,35,23,12
Baigels,thrall,1628,evoker,devastation,72,39,33
Burnyxia,zuljin,1628,evoker,devastation,48,23,25
Drayongari,tichondrius,1627,evoker,devastation,82,45,37
Rizzanomics,zuljin,1626,evoker,devastation,76,32,44
Shoestrings,tichondrius,1625,evoker,devastation,138,64,74
Bhanethyr,illidan,1624,evoker,devastation,36,17,19
Hochenblume,proudmoore,1621,evoker,devastation,77,40,37
Sofyon,dalaran,1621,evoker,devastation,64,31,33
Naverdr,tichondrius,1619,evoker,devastation,54,30,24
Quadarius,tichondrius,1617,evoker,devastation,147,82,65
Bombs,shattered-hand,1617,evoker,devastation,162,85,77
Lorb,icecrown,1616,evoker,devastation,170,94,76
Kozukimomo,area-52,1616,evoker,devastation,125,63,62
Jòrmungandr,moon-guard,1616,evoker,devastation,62,27,35
Lïzzy,tichondrius,1614,evoker,devastation,34,23,11
Lizardik,lightnings-blade,1614,evoker,devastation,44,26,18
Eternabeam,gilneas,1614,evoker,devastation,89,45,44
Smoochies,emerald-dream,1614,evoker,devastation,72,36,36
Zyzzy,icecrown,1613,evoker,devastation,80,48,32
Embarasi,moon-guard,1613,evoker,devastation,60,36,24
Ruination,lightnings-blade,1613,evoker,devastation,42,24,18
Shortdargon,zuljin,1613,evoker,devastation,48,25,23
Endoveire,tichondrius,1613,evoker,devastation,54,23,31
Superscales,zuljin,1612,evoker,devastation,37,22,15
Rotscale,proudmoore,1612,evoker,devastation,42,23,19
Âvalon,zuljin,1611,evoker,devastation,24,17,7
Pewpowdragon,malganis,1609,evoker,devastation,40,24,16
Bréáth,tichondrius,1608,evoker,devastation,48,33,15
Youdig,nazjatar,1608,evoker,devastation,42,24,18
Onysable,stormrage,1608,evoker,devastation,42,21,21
Wonyoungx,frostmourne,1608,evoker,devastation,97,45,52
Akajills,tichondrius,1607,evoker,devastation,124,70,54
Eshaybruh,barthilas,1605,evoker,devastation,34,20,14
Dracomalfoyy,caelestrasz,1605,evoker,devastation,33,18,15
Xplode,area-52,1605,evoker,devastation,206,108,98
Kinto,stormrage,1605,evoker,devastation,48,21,27
Likelydevo,tichondrius,1604,evoker,devastation,30,22,8
Devokerx,emerald-dream,1603,evoker,devastation,36,20,16
Dubskis,area-52,1603,evoker,devastation,122,63,59
Jereico,stonemaul,1603,evoker,devastation,78,39,39
Bently,bloodhoof,1603,evoker,devastation,48,21,27
Mcflý,sargeras,1602,evoker,devastation,66,43,23
Marccuss,bleeding-hollow,1601,evoker,devastation,24,17,7
Børedom,burning-legion,1601,evoker,devastation,54,36,18
Ryuback,sargeras,1601,evoker,devastation,42,26,16
Spicyrooster,area-52,1601,evoker,devastation,44,24,20
Xhaal,tichondrius,1601,evoker,devastation,168,83,85
Rengöku,skullcrusher,1600,evoker,devastation,54,27,27
Tealetaz,area-52,1597,evoker,devastation,76,49,27
Talent,deathwing,1597,evoker,devastation,30,17,13
Juooun,tichondrius,1597,evoker,devastation,77,35,42
Potfase,tichondrius,1596,evoker,devastation,50,23,27
Kozara,trollbane,1595,evoker,devastation,41,21,20
Imugee,sargeras,1594,evoker,devastation,66,33,33
Ackreshanaz,nagrand,1594,evoker,devastation,36,17,19
Batwig,tichondrius,1590,evoker,devastation,71,39,32
Aentharion,argent-dawn,1589,evoker,devastation,53,25,28
Quickshootin,tichondrius,1589,evoker,devastation,71,30,41
Linguistic,tichondrius,1585,evoker,devastation,54,29,25
Devilmanguy,bonechewer,1585,evoker,devastation,102,51,51
Cottoncandy,stormrage,1585,evoker,devastation,147,70,77
Terraxkhan,quelthalas,1585,evoker,devastation,66,29,37
Mayhemvoker,rexxar,1584,evoker,devastation,60,35,25
Sethelys,tichondrius,1584,evoker,devastation,38,21,17
Flysokan,tichondrius,1582,evoker,devastation,63,32,31
Algonir,wyrmrest-accord,1581,evoker,devastation,30,17,13
Mmrglmrglmr,stormrage,1580,evoker,devastation,71,39,32
Nethenezoth,auchindoun,1580,evoker,devastation,48,23,25
Zona,moon-guard,1580,evoker,devastation,65,31,34
Dooklord,shuhalo,1579,evoker,devastation,144,63,81
Wangfly,area-52,1576,evoker,devastation,42,20,22
Kylidon,garrosh,1572,evoker,devastation,77,43,34
Voithyr,moon-guard,1572,evoker,devastation,152,81,71
Envisioned,kelthuzad,1572,evoker,devastation,36,19,17
Aarax,tichondrius,1570,evoker,devastation,89,45,44
Dracky,deathwing,1569,evoker,devastation,23,18,5
Ævoker,tichondrius,1569,evoker,devastation,111,54,57
Devdjinn,tichondrius,1564,evoker,devastation,282,149,133
Hoodwings,stormrage,1561,evoker,devastation,91,53,38
Rðsè,tichondrius,1558,evoker,devastation,204,97,107
Trákanon,mugthol,1557,evoker,devastation,93,49,44
Gangbânk,tichondrius,1555,evoker,devastation,71,34,37
Rinstraza,thrall,1552,evoker,devastation,173,86,87
Slyinx,area-52,1551,evoker,devastation,48,23,25
Jarzilla,illidan,1548,evoker,devastation,30,19,11
Pewnee,eonar,1548,evoker,devastation,101,47,54
Dwagonwage,zuljin,1548,evoker,devastation,102,45,57
Curtis,shadowmoon,1545,evoker,devastation,130,73,57
Sintholo,sargeras,1544,evoker,devastation,104,52,52
Karox,moon-guard,1544,evoker,devastation,187,93,94
Agheel,firetree,1543,evoker,devastation,44,23,21
Hotdragon,zuljin,1540,evoker,devastation,95,52,43
Breezemordus,zuljin,1540,evoker,devastation,45,24,21
Growthyy,malganis,1539,evoker,devastation,30,18,12
Evòker,tichondrius,1539,evoker,devastation,84,40,44
Jurokiel,sargeras,1536,evoker,devastation,221,120,101
Emoker,magtheridon,1535,evoker,devastation,54,31,23
Deathwingtwo,sargeras,1533,evoker,devastation,61,34,27
Drachenatem,skywall,1530,evoker,devastation,48,27,21
Hydrogenbomb,sargeras,1530,evoker,devastation,86,47,39
Nxnevo,tichondrius,1529,evoker,devastation,36,19,17
You,deathwing,1528,evoker,devastation,42,24,18
Hemipenes,tichondrius,1528,evoker,devastation,30,17,13
Chànge,lothar,1527,evoker,devastation,71,36,35
Zandrov,greymane,1526,evoker,devastation,51,29,22
Ragnagos,area-52,1525,evoker,devastation,60,29,31
Bellerion,proudmoore,1524,evoker,devastation,60,31,29
Dracfire,saurfang,1520,evoker,devastation,72,36,36
Drussyboy,illidan,1517,evoker,devastation,100,52,48
Fairstrider,tichondrius,1517,evoker,devastation,72,32,40
Dragontales,stormrage,1515,evoker,devastation,119,63,56
Deewey,sargeras,1514,evoker,devastation,74,43,31
Daydrac,thrall,1514,evoker,devastation,66,33,33
Olesmokey,tichondrius,1513,evoker,devastation,86,45,41
Mustardtiger,malorne,1512,evoker,devastation,103,56,47
Cmiygl,proudmoore,1511,evoker,devastation,24,16,8
Galrend,firetree,1511,evoker,devastation,84,44,40
Meleyx,saurfang,1510,evoker,devastation,96,48,48
Zartolas,moon-guard,1510,evoker,devastation,124,60,64
Polyrhythmic,ysera,1510,evoker,devastation,79,38,41
Kalisee,skullcrusher,1508,evoker,devastation,97,50,47
Zlandicaar,area-52,1507,evoker,devastation,122,66,56
Meepslol,kiljaeden,1506,evoker,devastation,27,17,10
Drflame,quelthalas,1505,evoker,devastation,53,32,21
Topg,boulderfist,1505,evoker,devastation,39,23,16
Tinine,frostmourne,1503,evoker,devastation,60,33,27
Mythsvoker,barthilas,1503,evoker,devastation,37,18,19
Êsh,lightbringer,1502,evoker,devastation,40,21,19
Atreign,blackwing-lair,1499,evoker,devastation,55,22,33
Valentis,bleeding-hollow,1498,evoker,devastation,108,60,48
Tezzyl,kiljaeden,1498,evoker,devastation,30,16,14
Vikings,madoran,1497,evoker,devastation,41,19,22
Famousdr,stormrage,1495,evoker,devastation,50,26,24
Dunkinonem,black-dragonflight,1494,evoker,devastation,42,25,17
Koopa,malygos,1493,evoker,devastation,60,27,33
Ùwüdragon,tichondrius,1490,evoker,devastation,118,71,47
Erling,duskwood,1490,evoker,devastation,84,46,38
Bloodwings,tichondrius,1490,evoker,devastation,66,34,32
Dragonkings,tichondrius,1490,evoker,devastation,147,65,82
Jgdragon,sargeras,1489,evoker,devastation,36,18,18
Abaddragon,dalaran,1489,evoker,devastation,65,28,37
Taeloc,frostmourne,1488,evoker,devastation,36,16,20
Dimatis,ragnaros,1488,evoker,devastation,42,17,25
Nishalethen,moon-guard,1487,evoker,devastation,92,43,49
Serthius,darkspear,1486,evoker,devastation,36,23,13
Kjerne,stormrage,1486,evoker,devastation,59,37,22
Xaeradroz,area-52,1486,evoker,devastation,78,41,37
Grapthar,korgath,1485,evoker,devastation,120,64,56
Ilovequiet,proudmoore,1483,evoker,devastation,30,16,14
Jiminsgf,tichondrius,1482,evoker,devastation,62,38,24
Qfyre,frostmourne,1480,evoker,devastation,57,34,23
Cmdragonbalz,sargeras,1480,evoker,devastation,90,47,43
Daesired,moon-guard,1480,evoker,devastation,60,28,32
Puffthemagiq,mugthol,1479,evoker,devastation,72,40,32
Toxicspyro,frostmourne,1479,evoker,devastation,94,48,46
Phlegython,eredar,1478,evoker,devastation,42,21,21
Encouraçado,stormrage,1477,evoker,devastation,71,37,34
Jowtzprev,ragnaros,1476,evoker,devastation,72,38,34
Dragonvore,moon-guard,1475,evoker,devastation,23,17,6
Elurb,illidan,1475,evoker,devastation,50,30,20
Narissian,wyrmrest-accord,1473,evoker,devastation,114,58,56
Lexgrossman,kelthuzad,1472,evoker,devastation,122,66,56
Drakoris,malganis,1472,evoker,devastation,217,116,101
Zervis,arthas,1472,evoker,devastation,65,27,38
Friedsalmon,azshara,1467,evoker,devastation,76,39,37
Dreamtalons,area-52,1465,evoker,devastation,54,31,23
Evoqz,stormrage,1460,evoker,devastation,42,25,17
Aoxila,proudmoore,1459,evoker,devastation,273,134,139
Dekux,elune,1459,evoker,devastation,36,16,20
Netreset,illidan,1459,evoker,devastation,55,24,31
Bryiona,proudmoore,1458,evoker,devastation,121,57,64
Unseenzblack,tichondrius,1453,evoker,devastation,30,19,11
Dillss,tichondrius,1453,evoker,devastation,78,39,39
Dragontrees,illidan,1450,evoker,devastation,36,19,17
Amlug,illidan,1450,evoker,devastation,88,38,50
Ýüp,tichondrius,1448,evoker,devastation,34,21,13
Midi,boulderfist,1446,evoker,devastation,42,21,21
Lilfootmommy,emerald-dream,1446,evoker,devastation,36,16,20
Bryágh,wyrmrest-accord,1445,evoker,devastation,183,92,91
Koralia,wyrmrest-accord,1440,evoker,devastation,35,16,19
Veserion,azralon,1439,evoker,devastation,96,54,42
Salakhar,drakkari,1438,evoker,devastation,38,24,14
Tyrvin,kiljaeden,1438,evoker,devastation,177,90,87
Kheeleesi,illidan,1438,evoker,devastation,113,55,58
Monkeydrake,tichondrius,1438,evoker,devastation,78,34,44
Smacktoch,sargeras,1436,evoker,devastation,42,22,20
Chinesedragn,tichondrius,1436,evoker,devastation,100,51,49
Desiinger,tichondrius,1435,evoker,devastation,54,29,25
Zalzin,agamaggan,1435,evoker,devastation,92,48,44
Vexosza,moon-guard,1434,evoker,devastation,30,16,14
Tabebuya,illidan,1432,evoker,devastation,63,25,38
Favoredson,area-52,1431,evoker,devastation,54,29,25
Joopydrake,tichondrius,1431,evoker,devastation,30,15,15
Drêki,bleeding-hollow,1431,evoker,devastation,156,75,81
Dracthyrius,thunderlord,1430,evoker,devastation,30,16,14
Razistzegrlz,illidan,1430,evoker,devastation,36,15,21
Valthenax,frostmourne,1430,evoker,devastation,94,39,55
Brounno,area-52,1429,evoker,devastation,76,49,27
Erokx,kelthuzad,1428,evoker,devastation,30,15,15
Brendormu,moon-guard,1428,evoker,devastation,39,15,24
Neith,aerie-peak,1425,evoker,devastation,47,18,29
Dylawn,illidan,1424,evoker,devastation,54,31,23
Dragonbic,illidan,1423,evoker,devastation,36,16,20
Nessumsar,azralon,1422,evoker,devastation,38,18,20
Trenash,illidan,1418,evoker,devastation,82,36,46
Ezarke,madoran,1417,evoker,devastation,65,33,32
Trazana,wyrmrest-accord,1414,evoker,devastation,40,23,17
Dragondis,thrall,1412,evoker,devastation,64,30,34
Ashenoth,antonidas,1410,evoker,devastation,54,31,23
Rangel,tol-barad,1410,evoker,devastation,76,34,42
Altri,lightnings-blade,1409,evoker,devastation,24,15,9
Dovå,moon-guard,1409,evoker,devastation,38,21,17
Zayllaerth,illidan,1409,evoker,devastation,104,55,49
Talanoth,skullcrusher,1408,evoker,devastation,57,34,23
Setash,kiljaeden,1407,evoker,devastation,72,39,33
Toastragosa,cenarius,1406,evoker,devastation,149,66,83
Thechadwasgr,bleeding-hollow,1403,evoker,devastation,62,31,31
Dragoom,saurfang,1402,evoker,devastation,36,20,16
Firkrag,bleeding-hollow,1402,evoker,devastation,60,28,32
Zeetash,illidan,1402,evoker,devastation,84,34,50
Spicy,mannoroth,1400,evoker,devastation,40,22,18
Valkalas,moon-guard,1400,evoker,devastation,63,30,33
Tasoly,stormrage,1400,evoker,devastation,65,26,39
Rodgoesinya,blackrock,1392,evoker,devastation,54,30,24
Blittlle,bleeding-hollow,1391,evoker,devastation,66,39,27
Riz,blackhand,1391,evoker,devastation,51,28,23
Prevocker,sargeras,1387,evoker,devastation,85,37,48
Zendrov,skywall,1386,evoker,devastation,79,41,38
Bumbledragn,moon-guard,1385,evoker,devastation,126,63,63
Dailon,stormreaver,1385,evoker,devastation,63,29,34
Tinà,tichondrius,1377,evoker,devastation,48,27,21
Howtew,jubeithos,1377,evoker,devastation,72,37,35
Madashy,durotan,1377,evoker,devastation,71,34,37
Devonstation,zuljin,1372,evoker,devastation,48,25,23
Sylnathaire,wyrmrest-accord,1372,evoker,devastation,154,77,77
Yujirohanma,frostmourne,1371,evoker,devastation,42,20,22
Malygoz,frostmourne,1370,evoker,devastation,60,24,36
Monyz,emerald-dream,1369,evoker,devastation,80,50,30
Draginnutz,dunemaul,1369,evoker,devastation,54,28,26
Dragoness,azralon,1369,evoker,devastation,77,33,44
Kosstro,thunderlord,1366,evoker,devastation,58,35,23
Bvo,stormrage,1364,evoker,devastation,77,41,36
Narthraxion,destromath,1364,evoker,devastation,135,71,64
Gutterskank,illidan,1362,evoker,devastation,35,22,13
Leapofagony,zuljin,1362,evoker,devastation,33,15,18
Evokedx,area-52,1361,evoker,devastation,42,21,21
Sidrasza,norgannon,1360,evoker,devastation,73,40,33
Cròk,quelthalas,1360,evoker,devastation,33,15,18
Thendroz,moon-guard,1357,evoker,devastation,30,18,12
Valyrik,illidan,1356,evoker,devastation,110,54,56
Kêristrasza,wyrmrest-accord,1352,evoker,devastation,54,27,27
Hugehorns,jubeithos,1349,evoker,devastation,24,15,9
Dragginballz,twisting-nether,1345,evoker,devastation,42,23,19
Ironscale,dalaran,1344,evoker,devastation,36,19,17
Tïtäm,area-52,1344,evoker,devastation,32,16,16
Aydetal,eonar,1343,evoker,devastation,42,20,22
Grendalevo,tichondrius,1341,evoker,devastation,69,34,35
Puffthemagik,doomhammer,1341,evoker,devastation,202,95,107
Skooby,drenden,1340,evoker,devastation,36,20,16
Kazrekan,moon-guard,1339,evoker,devastation,30,14,16
Evokinator,zuljin,1338,evoker,devastation,48,26,22
Yuukee,thrall,1338,evoker,devastation,43,23,20
Wackthyr,frostmourne,1338,evoker,devastation,40,21,19
Brunswichk,azralon,1336,evoker,devastation,66,36,30
Satanasx,illidan,1336,evoker,devastation,78,36,42
Sizzlebird,darkspear,1336,evoker,devastation,72,33,39
Basiliskgodx,tichondrius,1334,evoker,devastation,24,14,10
Zippityzoom,barthilas,1331,evoker,devastation,109,57,52
Pisslizard,stormrage,1331,evoker,devastation,40,19,21
Rial,frostmourne,1331,evoker,devastation,30,14,16
Gypgo,ragnaros,1330,evoker,devastation,24,14,10
Acoldwall,illidan,1328,evoker,devastation,24,15,9
Dragocser,drakkari,1327,evoker,devastation,24,14,10
Dragonair,spinebreaker,1327,evoker,devastation,39,22,17
Evokjoe,tortheldrin,1327,evoker,devastation,64,33,31
Vaelikai,korgath,1326,evoker,devastation,18,14,4
Puffsmoke,korgath,1326,evoker,devastation,30,16,14
Zlolykcir,malganis,1324,evoker,devastation,95,52,43
Derazar,malganis,1323,evoker,devastation,42,25,17
Taamyr,wyrmrest-accord,1323,evoker,devastation,206,111,95
Doomn,moon-guard,1323,evoker,devastation,30,15,15
Dvrk,frostmourne,1323,evoker,devastation,59,29,30
Dîego,azralon,1321,evoker,devastation,58,33,25
Grievaxion,ragnaros,1319,evoker,devastation,24,15,9
Emikothyr,thrall,1319,evoker,devastation,74,41,33
Tekath,altar-of-storms,1317,evoker,devastation,56,26,30
Ggcthulhu,area-52,1316,evoker,devastation,24,14,10
Dragneel,wyrmrest-accord,1316,evoker,devastation,62,25,37
Drahconne,illidan,1312,evoker,devastation,76,40,36
Benares,zuljin,1311,evoker,devastation,96,47,49
Vokeero,ysera,1310,evoker,devastation,78,40,38
Galakraas,proudmoore,1306,evoker,devastation,93,46,47
Notvez,bleeding-hollow,1305,evoker,devastation,43,18,25
Senven,blackhand,1303,evoker,devastation,48,21,27
Skykeeper,quelthalas,1300,evoker,devastation,130,67,63
Alligatorz,sargeras,1300,evoker,devastation,54,27,27
Drogan,demon-soul,1299,evoker,devastation,104,59,45
Midnights,scarlet-crusade,1296,evoker,devastation,89,52,37
Vahaerys,stormrage,1296,evoker,devastation,48,21,27
Slitherin,dalaran,1294,evoker,devastation,60,28,32
Panicnodisco,zuljin,1292,evoker,devastation,23,14,9
Klownfiesta,thrall,1292,evoker,devastation,145,78,67
Darazen,scarlet-crusade,1292,evoker,devastation,37,18,19
Wrecketz,tichondrius,1284,evoker,devastation,100,53,47
Aelvina,moon-guard,1282,evoker,devastation,68,33,35
Layothyr,stormrage,1281,evoker,devastation,30,18,12
Aktas,illidan,1280,evoker,devastation,40,19,21
Vlåd,tichondrius,1279,evoker,devastation,42,19,23
Sylverion,thrall,1277,evoker,devastation,70,35,35
Chimo,laughing-skull,1277,evoker,devastation,57,28,29
Dinnkyion,dalaran,1277,evoker,devastation,30,14,16
Zorashal,kiljaeden,1276,evoker,devastation,52,31,21
Tealandrov,zuljin,1275,evoker,devastation,62,25,37
Cheaterz,area-52,1274,evoker,devastation,54,33,21
Nið,moon-guard,1274,evoker,devastation,28,14,14
Emsli,moon-guard,1273,evoker,devastation,34,20,14
Tralanoth,destromath,1270,evoker,devastation,30,16,14
Raygos,nemesis,1269,evoker,devastation,74,31,43
Loganvkr,illidan,1268,evoker,devastation,48,25,23
Targaryenz,malganis,1263,evoker,devastation,66,32,34
Raghnard,illidan,1261,evoker,devastation,115,58,57
Døvahkiin,sargeras,1260,evoker,devastation,29,14,15
Skizle,destromath,1259,evoker,devastation,35,16,19
Obeahfire,tichondrius,1259,evoker,devastation,70,26,44
Skykeeper,dalaran,1257,evoker,devastation,36,19,17
Ripdumpster,bonechewer,1257,evoker,devastation,38,16,22
Nathenezital,frostmourne,1255,evoker,devastation,39,21,18
Craterearth,moon-guard,1255,evoker,devastation,115,50,65
Itwasntthis,tichondrius,1254,evoker,devastation,123,61,62
Grem,muradin,1253,evoker,devastation,32,20,12
Nephrites,area-52,1252,evoker,devastation,34,15,19
Nathx,drakkari,1251,evoker,devastation,48,31,17
Crogosa,quelthalas,1251,evoker,devastation,36,14,22
Atpsuspect,nerzhul,1250,evoker,devastation,48,23,25
Ezgamedeez,tichondrius,1247,evoker,devastation,24,13,11
Yiserion,sargeras,1247,evoker,devastation,215,112,103
Marknormand,area-52,1246,evoker,devastation,24,13,11
Tjofscales,stormrage,1245,evoker,devastation,30,13,17
Shanegillis,emerald-dream,1244,evoker,devastation,18,13,5
Dracopium,tichondrius,1244,evoker,devastation,78,48,30
Sindraxx,stormrage,1242,evoker,devastation,57,30,27
Seranis,sargeras,1242,evoker,devastation,36,13,23
Azorian,vashj,1236,evoker,devastation,36,21,15
Longxx,dalaran,1235,evoker,devastation,24,13,11
Xm,emerald-dream,1235,evoker,devastation,31,14,17
Billynobob,tichondrius,1235,evoker,devastation,30,13,17
Bigbadfred,tichondrius,1234,evoker,devastation,24,13,11
Nuttutted,emerald-dream,1232,evoker,devastation,24,13,11
Loginplease,frostmourne,1230,evoker,devastation,98,47,51
Dkvastate,tichondrius,1229,evoker,devastation,36,26,10
Tylexstranza,malganis,1229,evoker,devastation,24,13,11
Riyad,emerald-dream,1229,evoker,devastation,58,28,30
Riizo,malganis,1228,evoker,devastation,24,13,11
Subject,kelthuzad,1228,evoker,devastation,30,13,17
Snowdragon,azralon,1226,evoker,devastation,53,28,25
Dingermun,bleeding-hollow,1225,evoker,devastation,20,15,5
Momonosuke,fizzcrank,1225,evoker,devastation,36,20,16
Fáffy,kelthuzad,1218,evoker,devastation,42,15,27
Ezath,zuljin,1215,evoker,devastation,68,40,28
Dracthul,tichondrius,1213,evoker,devastation,90,46,44
Kèrby,frostmourne,1213,evoker,devastation,30,15,15
Gôdswrath,tichondrius,1213,evoker,devastation,30,13,17
Jugzxs,frostmourne,1213,evoker,devastation,36,14,22
Atrocion,wyrmrest-accord,1209,evoker,devastation,94,50,44
Midyr,nemesis,1207,evoker,devastation,57,34,23
Draconicus,bonechewer,1205,evoker,devastation,190,93,97
Drahkoo,azralon,1204,evoker,devastation,27,14,13
Dragoceleste,ragnaros,1201,evoker,devastation,63,33,30
Tattleslug,illidan,1199,evoker,devastation,30,15,15
Vahvan,sargeras,1197,evoker,devastation,54,21,33
Acnølogia,stormrage,1196,evoker,devastation,24,13,11
Clarkeboi,barthilas,1196,evoker,devastation,52,27,25
Ejokerxx,tichondrius,1193,evoker,devastation,36,19,17
Valakaztower,area-52,1193,evoker,devastation,41,20,21
Dragkon,azuremyst,1193,evoker,devastation,66,28,38
Culture,khazgoroth,1191,evoker,devastation,21,13,8
Paean,moon-guard,1183,evoker,devastation,32,18,14
Jabbawockeëz,drakkari,1182,evoker,devastation,107,57,50
Nazanazar,wyrmrest-accord,1181,evoker,devastation,128,60,68
Evooern,frostmourne,1181,evoker,devastation,84,39,45
Huanglong,sargeras,1180,evoker,devastation,30,16,14
Navaji,tichondrius,1180,evoker,devastation,59,30,29
Acnøløgia,azralon,1179,evoker,devastation,48,23,25
Xampusaurio,ragnaros,1178,evoker,devastation,24,13,11
Aratre,daggerspine,1178,evoker,devastation,168,89,79
Kaikisen,malganis,1178,evoker,devastation,41,19,22
Climax,stormrage,1177,evoker,devastation,28,13,15
Vaayu,moon-guard,1176,evoker,devastation,24,13,11
Trenot,draenor,1176,evoker,devastation,60,29,31
Tessedract,bleeding-hollow,1167,evoker,devastation,18,13,5
Teritwo,stormrage,1166,evoker,devastation,28,13,15
Thalyxia,azralon,1166,evoker,devastation,36,16,20
Stretonaught,dalaran,1165,evoker,devastation,51,25,26
Dragonpete,whisperwind,1161,evoker,devastation,48,23,25
Skeedaddle,zuljin,1159,evoker,devastation,51,26,25
Drakhaz,azralon,1156,evoker,devastation,22,13,9
Visron,stormrage,1153,evoker,devastation,65,41,24
Asham,azralon,1152,evoker,devastation,63,36,27
Tërminus,quelthalas,1151,evoker,devastation,18,12,6
Shwaydbz,zuljin,1151,evoker,devastation,24,12,12
Fortwonty,thrall,1150,evoker,devastation,30,18,12
Drsgme,dentarg,1150,evoker,devastation,24,12,12
Konne,tichondrius,1149,evoker,devastation,24,12,12
Ammar,drakkari,1148,evoker,devastation,32,14,18
Skylizard,illidan,1147,evoker,devastation,24,12,12
Drozul,stormrage,1145,evoker,devastation,30,12,18
Valkhar,illidan,1135,evoker,devastation,30,12,18
Dethendrov,moon-guard,1133,evoker,devastation,36,19,17
Dragonbranch,area-52,1133,evoker,devastation,24,12,12
Thenderazen,sargeras,1132,evoker,devastation,135,77,58
Trrxx,tichondrius,1132,evoker,devastation,74,30,44
Lorathyr,lothar,1128,evoker,devastation,24,12,12
Enuzan,dalaran,1128,evoker,devastation,89,41,48
Deàthwing,proudmoore,1128,evoker,devastation,213,97,116
Duamutef,wyrmrest-accord,1127,evoker,devastation,28,16,12
Archion,azgalor,1127,evoker,devastation,35,13,22
Bhalaria,ragnaros,1120,evoker,devastation,81,31,50
Daikon,kaelthas,1117,evoker,devastation,29,13,16
Historius,proudmoore,1117,evoker,devastation,30,13,17
Byäkuyá,azralon,1115,evoker,devastation,144,75,69
Pyrepapi,thrall,1115,evoker,devastation,32,13,19
Paycussy,sargeras,1110,evoker,devastation,18,12,6
Scotcheroo,turalyon,1108,evoker,devastation,22,14,8
Drakonyx,mugthol,1107,evoker,devastation,56,22,34
Zitasanazen,tichondrius,1107,evoker,devastation,64,25,39
Redeyés,area-52,1104,evoker,devastation,18,12,6
Drögón,stormrage,1100,evoker,devastation,42,27,15
Crymor,lethon,1099,evoker,devastation,30,16,14
Danzick,sargeras,1098,evoker,devastation,36,19,17
Madelines,tichondrius,1097,evoker,devastation,24,13,11
Zhannecgos,moon-guard,1087,evoker,devastation,28,12,16
Cunk,illidan,1085,evoker,devastation,41,28,13
Razorwing,azgalor,1084,evoker,devastation,36,20,16
Deepdweller,wyrmrest-accord,1082,evoker,devastation,33,16,17
Rayomcquen,garrosh,1080,evoker,devastation,29,16,13
Blazor,sisters-of-elune,1076,evoker,devastation,35,14,21
Tiamaat,black-dragonflight,1073,evoker,devastation,28,12,16
Gamerwords,barthilas,1071,evoker,devastation,36,15,21
Flygor,quelthalas,1069,evoker,devastation,84,34,50
Durijus,tichondrius,1069,evoker,devastation,35,14,21
Ðarkwyrm,laughing-skull,1062,evoker,devastation,42,22,20
Slimyreptile,sargeras,1062,evoker,devastation,75,31,44
Dhcb,tichondrius,1056,evoker,devastation,24,11,13
Devokèr,tichondrius,1056,evoker,devastation,24,11,13
Bähamut,proudmoore,1056,evoker,devastation,47,18,29
Talzindera,sargeras,1055,evoker,devastation,21,12,9
Jwas,tichondrius,1055,evoker,devastation,24,11,13
Hydroponicsz,bloodscalp,1055,evoker,devastation,24,11,13
Kiry,emerald-dream,1055,evoker,devastation,24,11,13
Kubus,emerald-dream,1054,evoker,devastation,18,11,7
Tepaku,thrall,1054,evoker,devastation,18,11,7
Yousurper,thunderlord,1054,evoker,devastation,27,14,13
Anthyrsia,zuljin,1053,evoker,devastation,30,11,19
Dafiya,thrall,1051,evoker,devastation,18,11,7
Dragonfarts,frostmourne,1050,evoker,devastation,27,12,15
Alnuin,stormrage,1050,evoker,devastation,113,49,64
Eìdolon,sargeras,1049,evoker,devastation,18,11,7
Dragostephen,nazjatar,1049,evoker,devastation,24,11,13
Janacovstra,moon-guard,1047,evoker,devastation,18,11,7
Dracnovae,emerald-dream,1047,evoker,devastation,59,26,33
Makiabelico,terenas,1046,evoker,devastation,50,14,36
Setasdan,illidan,1045,evoker,devastation,22,12,10
Zirath,emerald-dream,1045,evoker,devastation,24,11,13
Sübjugador,azralon,1042,evoker,devastation,30,20,10
Fpbafome,azralon,1038,evoker,devastation,42,13,29
Bhristopher,wildhammer,1035,evoker,devastation,12,11,1
Koderalth,azralon,1033,evoker,devastation,24,11,13
Byssrak,borean-tundra,1029,evoker,devastation,18,11,7
Granolajin,ragnaros,1028,evoker,devastation,30,11,19
Warhammerxx,tichondrius,1027,evoker,devastation,84,33,51
Azuria,lothar,1021,evoker,devastation,18,11,7
Murtharion,stormrage,1017,evoker,devastation,36,11,25
Lostplanet,drakkari,1016,evoker,devastation,47,15,32
Kaidô,illidan,1008,evoker,devastation,16,12,4
Dracothyst,tichondrius,1007,evoker,devastation,29,15,14
Jgxv,dalaran,1007,evoker,devastation,23,11,12
Mewclaw,tol-barad,1006,evoker,devastation,18,13,5
Dragonbreaf,emerald-dream,1004,evoker,devastation,17,11,6
Toyatoki,stormrage,1000,evoker,devastation,47,20,27
Stolesom,emerald-dream,994,evoker,devastation,65,32,33
Azulagos,sargeras,992,evoker,devastation,28,17,11
Sixjobs,area-52,990,evoker,devastation,29,11,18
Neofarian,lightbringer,986,evoker,devastation,20,11,9
Dragongrim,silvermoon,986,evoker,devastation,30,14,16
Maximiliam,ragnaros,985,evoker,devastation,60,33,27
Popgoesurmom,tichondrius,981,evoker,devastation,24,13,11
Drapybaras,bleeding-hollow,963,evoker,devastation,54,26,28
Miradrake,icecrown,960,evoker,devastation,12,10,2
Iantern,dalaran,960,evoker,devastation,18,10,8
Rizzlordx,bleeding-hollow,960,evoker,devastation,24,10,14
Drakedrift,malganis,959,evoker,devastation,12,10,2
Hausebat,moon-guard,959,evoker,devastation,18,10,8
Nasdanot,zuljin,959,evoker,devastation,18,10,8
Chime,dalaran,959,evoker,devastation,18,10,8
Solidusz,thrall,959,evoker,devastation,18,10,8
Moreleth,stormrage,959,evoker,devastation,18,10,8
Xeerus,stormreaver,959,evoker,devastation,18,10,8
Runescape,altar-of-storms,959,evoker,devastation,24,10,14
Grafixx,sargeras,958,evoker,devastation,15,11,4
Ryhu,sargeras,958,evoker,devastation,18,10,8
Vokezuì,sargeras,958,evoker,devastation,30,10,20
Jormungandre,wyrmrest-accord,957,evoker,devastation,18,10,8
Galaxiz,bonechewer,957,evoker,devastation,24,12,12
Oatmealneil,bleeding-hollow,955,evoker,devastation,24,10,14
Sinepbreath,bleeding-hollow,954,evoker,devastation,18,10,8
Finvoker,kalecgos,953,evoker,devastation,18,10,8
Pågemaster,moon-guard,953,evoker,devastation,18,10,8
Brothererik,hydraxis,953,evoker,devastation,24,10,14
Liekki,illidan,953,evoker,devastation,24,10,14
Ecksdoom,sargeras,952,evoker,devastation,18,10,8
Wizadsa,amanthul,951,evoker,devastation,12,10,2
Takhysis,frostmourne,949,evoker,devastation,24,10,14
Fìg,wyrmrest-accord,948,evoker,devastation,18,10,8
Jorlozthyr,ragnaros,948,evoker,devastation,24,10,14
Aegontargary,azralon,945,evoker,devastation,27,11,16
Prolyfe,blood-furnace,942,evoker,devastation,15,11,4
Toephotos,tichondrius,937,evoker,devastation,23,10,13
Escanorr,ghostlands,936,evoker,devastation,20,11,9
Ciana,black-dragonflight,936,evoker,devastation,50,26,24
Báalboski,tichondrius,935,evoker,devastation,18,10,8
Littleripper,tichondrius,935,evoker,devastation,30,16,14
Hicane,tichondrius,935,evoker,devastation,29,10,19
Ryùtt,illidan,933,evoker,devastation,18,10,8
Talegos,ragnaros,932,evoker,devastation,36,11,25
Evokatoke,proudmoore,929,evoker,devastation,43,17,26
Battledragon,illidan,918,evoker,devastation,18,10,8
Darlión,ragnaros,917,evoker,devastation,24,13,11
Fukhur,ragnaros,917,evoker,devastation,24,11,13
Galgaldr,tichondrius,914,evoker,devastation,30,12,18
Phatë,nerzhul,905,evoker,devastation,23,10,13
Ezdrake,drakkari,900,evoker,devastation,36,11,25
Stormstryke,queldorei,900,evoker,devastation,59,18,41
Arath,zangarmarsh,898,evoker,devastation,42,22,20
Embeka,illidan,895,evoker,devastation,42,20,22
Herikas,tichondrius,895,evoker,devastation,92,43,49
Tikkaratika,nemesis,892,evoker,devastation,30,11,19
Alextroxo,stormrage,888,evoker,devastation,17,10,7
Dreampunk,tichondrius,879,evoker,devastation,19,10,9
Tireoz,frostmourne,866,evoker,devastation,48,12,36
Oracle,duskwood,864,evoker,devastation,12,9,3
Kiserys,suramar,864,evoker,devastation,12,9,3
Gobananas,sargeras,864,evoker,devastation,12,9,3
Áspect,aegwynn,864,evoker,devastation,12,9,3
Orncen,emerald-dream,864,evoker,devastation,16,10,6
Frequentlee,illidan,864,evoker,devastation,18,9,9
Thnake,zuljin,864,evoker,devastation,18,9,9
Todorøki,hyjal,864,evoker,devastation,18,9,9
Brakkarion,wyrmrest-accord,864,evoker,devastation,18,9,9
Creachy,kiljaeden,864,evoker,devastation,18,9,9
Velstrana,moon-guard,863,evoker,devastation,12,9,3
Weedi,tichondrius,863,evoker,devastation,12,9,3
Novi,kaelthas,863,evoker,devastation,12,9,3
Raikori,ragnaros,863,evoker,devastation,12,9,3
Siatrend,moon-guard,863,evoker,devastation,18,9,9
Nelthendros,moon-guard,863,evoker,devastation,18,9,9
Wse,illidan,863,evoker,devastation,18,9,9
Dragonsteppz,aegwynn,863,evoker,devastation,18,9,9
Missjenny,korgath,863,evoker,devastation,18,9,9
Drazgarth,azshara,863,evoker,devastation,18,9,9
Misik,frostwolf,863,evoker,devastation,18,9,9
Naraxus,thrall,863,evoker,devastation,18,9,9
Thyatera,ragnaros,863,evoker,devastation,18,9,9
Dâpper,queldorei,863,evoker,devastation,18,9,9
Dragbod,korgath,863,evoker,devastation,18,9,9
Lardicønn,thrall,863,evoker,devastation,18,9,9
Gharscales,tichondrius,863,evoker,devastation,24,9,15
Demidas,emerald-dream,862,evoker,devastation,13,9,4
Serathrine,smolderthorn,862,evoker,devastation,18,9,9
Alsilitroisa,tichondrius,862,evoker,devastation,18,9,9
Ezindrozar,tichondrius,862,evoker,devastation,18,9,9
Müshü,icecrown,862,evoker,devastation,24,9,15
Disugaiza,tichondrius,861,evoker,devastation,12,9,3
Sía,drakkari,861,evoker,devastation,12,9,3
Nasath,arthas,861,evoker,devastation,18,9,9
Teanie,tichondrius,861,evoker,devastation,18,9,9
Karaxes,gorefiend,861,evoker,devastation,24,9,15
Krokuzan,ragnaros,860,evoker,devastation,18,9,9
Doombreath,ragnaros,859,evoker,devastation,18,9,9
Keedrori,thrall,859,evoker,devastation,19,9,10
Aoibae,frostmourne,859,evoker,devastation,24,9,15
Himän,tichondrius,858,evoker,devastation,20,9,11
Dedderion,zuljin,857,evoker,devastation,18,9,9
Muppetgronk,frostmourne,857,evoker,devastation,30,9,21
Furyíon,stormrage,855,evoker,devastation,12,9,3
Dimpulse,zuljin,855,evoker,devastation,18,9,9
Edivian,ragnaros,849,evoker,devastation,19,10,9
Dragopnik,tichondrius,848,evoker,devastation,24,12,12
Azafs,azralon,847,evoker,devastation,26,10,16
Saraphrodite,hakkar,844,evoker,devastation,18,9,9
Stylez,anetheron,844,evoker,devastation,48,22,26
Rasec,moon-guard,843,evoker,devastation,20,9,11
Rikfreedom,ragnaros,836,evoker,devastation,42,19,23
Nyranblood,zuljin,825,evoker,devastation,62,27,35
Jenovi,tichondrius,768,evoker,devastation,12,8,4
Latria,malganis,768,evoker,devastation,12,8,4
Rawrrxd,blackrock,768,evoker,devastation,12,8,4
Saînt,thrall,768,evoker,devastation,12,8,4
Cheeriosvokr,tichondrius,768,evoker,devastation,12,8,4
Inumizu,dentarg,768,evoker,devastation,12,8,4
Toastsevoker,tichondrius,768,evoker,devastation,15,9,6
Saintpablox,illidan,768,evoker,devastation,18,8,10
Crosis,azralon,768,evoker,devastation,18,8,10
Evokemon,hyjal,767,evoker,devastation,12,8,4
Gooliath,madoran,767,evoker,devastation,12,8,4
Aurinax,proudmoore,767,evoker,devastation,12,8,4
Copevoker,black-dragonflight,767,evoker,devastation,12,8,4
Vermax,akama,767,evoker,devastation,18,8,10
Scalendar,frostmourne,767,evoker,devastation,18,8,10
Rïvé,tichondrius,767,evoker,devastation,24,8,16
Arokh,frostmourne,767,evoker,devastation,30,8,22
Cindiql,stormrage,766,evoker,devastation,12,8,4
Naykir,khazgoroth,766,evoker,devastation,12,8,4
Dawitchvoker,illidan,766,evoker,devastation,18,8,10
Ghostfable,emerald-dream,766,evoker,devastation,18,8,10
Dragonballer,trollbane,766,evoker,devastation,18,8,10
Glideoure,stonemaul,766,evoker,devastation,24,8,16
Dracthylian,ragnaros,765,evoker,devastation,12,8,4
Dragxs,ragnaros,765,evoker,devastation,12,8,4
Aaztra,whisperwind,765,evoker,devastation,12,8,4
Skrillerv,frostmourne,765,evoker,devastation,18,8,10
Quêtzal,akama,764,evoker,devastation,12,8,4
Gyirzkaag,illidan,764,evoker,devastation,18,8,10
Scalesun,azralon,763,evoker,devastation,18,8,10
Davidfesago,quelthalas,762,evoker,devastation,18,8,10
Zenithgar,aerie-peak,761,evoker,devastation,12,8,4
Roksanda,azralon,761,evoker,devastation,24,8,16
Seletgos,quelthalas,761,evoker,devastation,24,8,16
Detraa,illidan,754,evoker,devastation,12,8,4
Pouncer,proudmoore,754,evoker,devastation,48,18,30
Konarth,moon-guard,753,evoker,devastation,12,8,4
Fafnirr,draenor,753,evoker,devastation,32,8,24
Daigrefn,echo-isles,751,evoker,devastation,18,8,10
Bàkèd,illidan,750,evoker,devastation,23,8,15
Reptyle,emerald-dream,743,evoker,devastation,24,8,16
Liefarion,barthilas,734,evoker,devastation,22,8,14
Draehgor,hyjal,718,evoker,devastation,17,8,9
Onornun,magtheridon,718,evoker,devastation,17,8,9
Freyess,malganis,717,evoker,devastation,15,8,7
Dracthyrwa,azralon,712,evoker,devastation,16,9,7
Ryü,silver-hand,704,evoker,devastation,16,8,8
Drøgon,sargeras,703,evoker,devastation,20,8,12
Zhyrouvion,stormrage,699,evoker,devastation,17,8,9
Torakk,ravencrest,687,evoker,devastation,13,8,5
Shambly,kelthuzad,672,evoker,devastation,12,7,5
Dinohgos,area-52,672,evoker,devastation,12,7,5
Lizardgodtko,tichondrius,672,evoker,devastation,12,7,5
Rearcalzone,illidan,672,evoker,devastation,12,7,5
Emberlyn,sargeras,672,evoker,devastation,12,7,5
Dragzun,tichondrius,672,evoker,devastation,12,7,5
Chewbigred,vashj,672,evoker,devastation,12,7,5
Lacadabeef,tichondrius,672,evoker,devastation,12,7,5
Dragonherb,zuljin,672,evoker,devastation,12,7,5
Spikeyboi,eonar,672,evoker,devastation,12,7,5
Maillard,dragonmaw,672,evoker,devastation,12,7,5
Spryo,illidan,672,evoker,devastation,12,7,5
Vokr,area-52,672,evoker,devastation,12,7,5
Dudeofdragon,illidan,672,evoker,devastation,12,7,5
Nysian,wyrmrest-accord,672,evoker,devastation,12,7,5
Evook,tichondrius,672,evoker,devastation,12,7,5
Écaille,dalaran,672,evoker,devastation,15,8,7
Deathstaind,tichondrius,672,evoker,devastation,16,8,8
Emopidgey,dalaran,672,evoker,devastation,18,7,11
Sådge,frostmourne,672,evoker,devastation,18,7,11
Dragonshani,thrall,672,evoker,devastation,18,7,11
Dragonstonks,moon-guard,672,evoker,devastation,18,7,11
Dragonballzx,kelthuzad,672,evoker,devastation,24,7,17
Wekinball,tichondrius,671,evoker,devastation,12,7,5
Boseijwho,emerald-dream,671,evoker,devastation,12,7,5
Vyrathysra,moon-guard,671,evoker,devastation,12,7,5
Whiegrath,azralon,671,evoker,devastation,12,7,5
Glaurungr,ragnaros,671,evoker,devastation,12,7,5
Xeretas,bleeding-hollow,671,evoker,devastation,12,7,5
Archalygos,moon-guard,671,evoker,devastation,12,7,5
Garchamp,area-52,671,evoker,devastation,15,8,7
Saristrasza,moon-guard,671,evoker,devastation,18,7,11
Kluath,daggerspine,671,evoker,devastation,18,7,11
Ackrenoth,emerald-dream,671,evoker,devastation,18,7,11
Shenroda,tichondrius,671,evoker,devastation,18,7,11
Zogdagron,demon-soul,671,evoker,devastation,18,7,11
Drageyman,tichondrius,671,evoker,devastation,24,7,17
Gulvoke,shattered-hand,670,evoker,devastation,12,7,5
Chryphord,emerald-dream,670,evoker,devastation,12,7,5
Setchagos,emerald-dream,670,evoker,devastation,12,7,5
Beastlysoul,tichondrius,670,evoker,devastation,12,7,5
Nikeze,kiljaeden,670,evoker,devastation,18,7,11
Draecion,tichondrius,670,evoker,devastation,18,7,11
Pläid,azuremyst,668,evoker,devastation,12,7,5
Sleepeasy,blackrock,667,evoker,devastation,18,7,11
Mmanigoldo,quelthalas,667,evoker,devastation,18,7,11
Lamperr,illidan,667,evoker,devastation,60,11,49
Evilsquirel,area-52,666,evoker,devastation,12,7,5
Kodeserath,hakkar,666,evoker,devastation,24,7,17
Movoker,tichondrius,655,evoker,devastation,15,8,7
Henscale,malganis,639,evoker,devastation,11,7,4
Krefugee,tichondrius,637,evoker,devastation,17,7,10
Cerisoromis,stormrage,607,evoker,devastation,16,7,9
Fuecoco,proudmoore,576,evoker,devastation,6,6,0
Yellowker,thrall,576,evoker,devastation,6,6,0
Zérai,quelthalas,576,evoker,devastation,6,6,0
Jácorex,proudmoore,576,evoker,devastation,12,6,6
Dragonage,stormrage,576,evoker,devastation,12,6,6
Borpia,malganis,576,evoker,devastation,12,6,6
Bruceleezard,sargeras,576,evoker,devastation,12,6,6
Iamtrash,daggerspine,576,evoker,devastation,12,6,6
Dragønbørne,blackrock,576,evoker,devastation,12,6,6
Nemenyah,emerald-dream,576,evoker,devastation,12,6,6
Pÿthön,sargeras,576,evoker,devastation,12,6,6
Comepancito,quelthalas,576,evoker,devastation,12,6,6
Dragordito,drakkari,576,evoker,devastation,12,6,6
Shrikethyr,chogall,576,evoker,devastation,12,6,6
Shanaynayae,area-52,576,evoker,devastation,12,6,6
Wingjob,tichondrius,576,evoker,devastation,12,6,6
Lazarust,tichondrius,576,evoker,devastation,12,6,6
Alucardragon,turalyon,576,evoker,devastation,12,6,6
Volksdragen,sargeras,576,evoker,devastation,12,6,6
Joyburn,tichondrius,576,evoker,devastation,12,6,6
Sathregos,emerald-dream,576,evoker,devastation,12,6,6
Actïoncat,emerald-dream,576,evoker,devastation,12,6,6
Uncleìroh,tichondrius,576,evoker,devastation,12,6,6
Papadigi,tichondrius,576,evoker,devastation,12,6,6
Chadizard,tichondrius,576,evoker,devastation,12,6,6
Medusaan,tichondrius,576,evoker,devastation,12,6,6
Vysenía,moon-guard,576,evoker,devastation,12,6,6
Bigdvoker,jubeithos,576,evoker,devastation,12,6,6
Glizard,firetree,576,evoker,devastation,12,6,6
Jarregos,dalaran,576,evoker,devastation,12,6,6
Daethwang,moon-guard,576,evoker,devastation,12,6,6
Dukä,dalaran,576,evoker,devastation,15,7,8
Syvernius,khazgoroth,576,evoker,devastation,18,6,12
Rezoth,malganis,576,evoker,devastation,18,6,12
Chaosrebørn,bleeding-hollow,576,evoker,devastation,18,6,12
Deneryus,illidan,576,evoker,devastation,18,6,12
Amplicon,stormrage,576,evoker,devastation,18,6,12
Saxthyr,stormreaver,576,evoker,devastation,24,6,18
Zeldir,ragnaros,575,evoker,devastation,6,6,0
Avithori,borean-tundra,575,evoker,devastation,12,6,6
Drãco,area-52,575,evoker,devastation,12,6,6
Rykuvokr,azuremyst,575,evoker,devastation,12,6,6
Dumbodragon,bleeding-hollow,575,evoker,devastation,12,6,6
Cøømbuya,sargeras,575,evoker,devastation,12,6,6
Kazecgos,zuljin,575,evoker,devastation,12,6,6
Sevariel,frostmane,575,evoker,devastation,12,6,6
Swagondragon,illidan,575,evoker,devastation,12,6,6
Avastri,moon-guard,575,evoker,devastation,12,6,6
Lòrdope,illidan,575,evoker,devastation,12,6,6
Koriaz,ragnaros,575,evoker,devastation,12,6,6
Amaryliss,kelthuzad,575,evoker,devastation,12,6,6
Vrtra,lightbringer,575,evoker,devastation,12,6,6
Evokÿ,stormrage,575,evoker,devastation,12,6,6
Taxfraudchad,sargeras,575,evoker,devastation,13,6,7
Hopefire,zuljin,575,evoker,devastation,18,6,12
Lindrak,azralon,575,evoker,devastation,18,6,12
Alragos,ragnaros,575,evoker,devastation,18,6,12
Cinderelluh,area-52,575,evoker,devastation,18,6,12
Bazelgos,moon-guard,575,evoker,devastation,24,6,18
Saphirå,kelthuzad,575,evoker,devastation,24,6,18
Vermáx,caelestrasz,574,evoker,devastation,12,6,6
Baeltas,blackrock,574,evoker,devastation,12,6,6
Spyrofnir,stormrage,574,evoker,devastation,18,6,12
Carloxd,tichondrius,574,evoker,devastation,24,6,18
Deathb,chromaggus,573,evoker,devastation,12,6,6
Noodleslut,stormrage,573,evoker,devastation,12,6,6
Silvèrr,tichondrius,573,evoker,devastation,12,6,6
Syndue,malganis,573,evoker,devastation,12,6,6
Azuril,wyrmrest-accord,572,evoker,devastation,12,6,6
Abodie,dalaran,572,evoker,devastation,18,6,12
Ambrosîa,area-52,572,evoker,devastation,20,6,14
Lightaurae,thunderlord,556,evoker,devastation,30,6,24
Pzyko,ragnaros,551,evoker,devastation,17,6,11
Zindrozarath,area-52,544,evoker,devastation,10,6,4
Vyserion,turalyon,543,evoker,devastation,8,7,1
Boadie,kilrogg,542,evoker,devastation,24,7,17
Adorablexo,stormrage,527,evoker,devastation,11,6,5
Zovaan,emerald-dream,526,evoker,devastation,11,6,5
Kodeser,alleria,522,evoker,devastation,15,6,9
Arnoeryan,ragnaros,512,evoker,devastation,16,6,10
Carrnedge,area-52,511,evoker,devastation,11,6,5
Eleechee,magtheridon,510,evoker,devastation,10,6,4
Nathrach,wyrmrest-accord,506,evoker,devastation,8,6,2
Khalt,quelthalas,480,evoker,devastation,6,5,1
Kensar,drakkari,480,evoker,devastation,6,5,1
Elf,malganis,480,evoker,devastation,6,5,1
Wrathics,emerald-dream,480,evoker,devastation,6,5,1
Vellony,kelthuzad,480,evoker,devastation,6,5,1
Kharibdis,kul-tiras,480,evoker,devastation,6,5,1
Nuppsy,frostmourne,480,evoker,devastation,12,5,7
Dragonhyde,stormrage,480,evoker,devastation,12,5,7
Daraz,tichondrius,480,evoker,devastation,12,5,7
Galakrond,black-dragonflight,480,evoker,devastation,12,5,7
Ventiev,tichondrius,480,evoker,devastation,12,5,7
Demikass,azralon,480,evoker,devastation,12,5,7
Jevoker,area-52,480,evoker,devastation,12,5,7
Stælthßømbèr,baelgun,480,evoker,devastation,12,5,7
Asatrat,greymane,480,evoker,devastation,12,5,7
Vallath,zuljin,480,evoker,devastation,12,5,7
Saìntgeorge,sargeras,480,evoker,devastation,12,5,7
Nardleberry,wyrmrest-accord,480,evoker,devastation,12,5,7
Eyedxl,magtheridon,480,evoker,devastation,12,5,7
Darkscale,haomarush,480,evoker,devastation,12,5,7
Trillvoker,illidan,480,evoker,devastation,12,5,7
Rebuk,area-52,480,evoker,devastation,12,5,7
Lillbigd,bleeding-hollow,480,evoker,devastation,12,5,7
Dratonos,stormrage,480,evoker,devastation,12,5,7
Toenailstew,zuljin,480,evoker,devastation,12,5,7
Purplerocket,illidan,480,evoker,devastation,12,5,7
Ackresh,executus,480,evoker,devastation,12,5,7
Deezdragon,stormrage,480,evoker,devastation,12,5,7
Moltqt,tichondrius,480,evoker,devastation,12,5,7
Faahrad,azralon,480,evoker,devastation,12,5,7
Nyldra,area-52,480,evoker,devastation,14,5,9
Abath,quelthalas,480,evoker,devastation,14,5,9
Naji,azralon,480,evoker,devastation,18,5,13
Uhlive,area-52,480,evoker,devastation,18,5,13
Velahesa,sargeras,480,evoker,devastation,24,5,19
Cursak,ragnaros,479,evoker,devastation,10,6,4
Müshu,duskwood,479,evoker,devastation,12,5,7
Brokenscales,nerzhul,479,evoker,devastation,12,5,7
Lightbeing,nazjatar,479,evoker,devastation,12,5,7
Dracoi,illidan,479,evoker,devastation,12,5,7
Dracmalefic,area-52,479,evoker,devastation,12,5,7
Mattykanish,illidan,479,evoker,devastation,12,5,7
Zerodorez,zuljin,479,evoker,devastation,12,5,7
Windylyrics,drakkari,479,evoker,devastation,18,5,13
Adraell,illidan,478,evoker,devastation,13,6,7
Niratrenn,area-52,478,evoker,devastation,12,5,7
Dracosofi,quelthalas,478,evoker,devastation,18,5,13
Nazervis,silver-hand,478,evoker,devastation,18,5,13
Mitzvah,barthilas,478,evoker,devastation,18,5,13
Althenot,emerald-dream,477,evoker,devastation,12,5,7
Sandrov,kaelthas,477,evoker,devastation,12,5,7
Broconian,zuljin,477,evoker,devastation,18,5,13
Surezilla,malganis,477,evoker,devastation,24,5,19
Odorf,duskwood,474,evoker,devastation,12,5,7
Sammalone,burning-blade,474,evoker,devastation,12,5,7
Shennron,darkspear,447,evoker,devastation,11,5,6
Zzae,tichondrius,432,evoker,devastation,15,5,10
Tiyeal,thrall,431,evoker,devastation,11,5,6
Bowsette,area-52,431,evoker,devastation,11,5,6
Dazei,quelthalas,431,evoker,devastation,15,5,10
Xfemboyqt,area-52,426,evoker,devastation,19,7,12
Lifcleal,moon-guard,415,evoker,devastation,14,5,9
Shënrøn,tichondrius,384,evoker,devastation,6,4,2
Docevoker,tichondrius,384,evoker,devastation,6,4,2
Machaflux,winterhoof,384,evoker,devastation,6,4,2
Bmbo,illidan,384,evoker,devastation,6,4,2
Dragonsbgay,stormrage,384,evoker,devastation,6,4,2
Biscotti,illidan,384,evoker,devastation,6,4,2
Bodytypetwo,area-52,384,evoker,devastation,6,4,2
Walmartshoes,tichondrius,384,evoker,devastation,6,4,2
Solazari,tichondrius,384,evoker,devastation,6,4,2
Vuldon,area-52,384,evoker,devastation,6,4,2
Jammstraza,skywall,384,evoker,devastation,6,4,2
Dragonaria,illidan,384,evoker,devastation,6,4,2
Niratreno,tichondrius,384,evoker,devastation,6,4,2
Korvold,zuluhed,384,evoker,devastation,6,4,2
Deathraux,tichondrius,384,evoker,devastation,6,4,2
Foxstrazagos,hellscream,384,evoker,devastation,6,4,2
Atraxian,tichondrius,384,evoker,devastation,6,4,2
Spyro,ravencrest,384,evoker,devastation,6,4,2
Seaserpent,kelthuzad,384,evoker,devastation,6,4,2
Kusarí,moon-guard,384,evoker,devastation,6,4,2
Draisin,zuljin,384,evoker,devastation,6,4,2
Skazz,emerald-dream,384,evoker,devastation,6,4,2
Dragonchip,bleeding-hollow,384,evoker,devastation,6,4,2
Daemon,detheroc,384,evoker,devastation,6,4,2
Awexstwaza,bleeding-hollow,384,evoker,devastation,6,4,2
Shenròn,kelthuzad,384,evoker,devastation,6,4,2
Kaidoxuchihv,ragnaros,384,evoker,devastation,6,4,2
Testzvoker,dalaran,384,evoker,devastation,6,4,2
Zorlstisza,moon-guard,384,evoker,devastation,6,4,2
Opsmybad,ragnaros,384,evoker,devastation,6,4,2
Mushú,archimonde,384,evoker,devastation,6,4,2
Silumgarr,thrall,384,evoker,devastation,9,5,4
Shenrõn,malganis,384,evoker,devastation,15,5,10
Usulamili,stormrage,384,evoker,devastation,12,4,8
Idiotlizard,stormrage,384,evoker,devastation,12,4,8
Kurulol,ragnaros,384,evoker,devastation,12,4,8
Nitalzith,area-52,384,evoker,devastation,12,4,8
Arkevo,tichondrius,384,evoker,devastation,12,4,8
Trazer,malfurion,384,evoker,devastation,12,4,8
Bigsquirt,proudmoore,384,evoker,devastation,12,4,8
Bootybee,area-52,384,evoker,devastation,12,4,8
Devåståtion,tichondrius,384,evoker,devastation,12,4,8
Magnito,thorium-brotherhood,384,evoker,devastation,12,4,8
Baddrakthyr,moon-guard,384,evoker,devastation,12,4,8
Kaaer,emerald-dream,384,evoker,devastation,12,4,8
Nosrej,hyjal,384,evoker,devastation,12,4,8
Royagon,draktharon,384,evoker,devastation,12,4,8
Dracconic,sargeras,384,evoker,devastation,12,4,8
Cuarta,drakkari,384,evoker,devastation,12,4,8
Kcwt,illidan,384,evoker,devastation,12,4,8
Smackthyr,thrall,384,evoker,devastation,12,4,8
Blay,elune,384,evoker,devastation,12,4,8
Lamdyn,wyrmrest-accord,384,evoker,devastation,12,4,8
Kendrac,wyrmrest-accord,384,evoker,devastation,12,4,8
Butta,darkspear,384,evoker,devastation,12,4,8
Munichho,spirestone,384,evoker,devastation,18,4,14
Dadydafather,sargeras,384,evoker,devastation,30,4,26
Dragonboi,dathremar,383,evoker,devastation,6,4,2
Deralizrd,tichondrius,383,evoker,devastation,6,4,2
Porchoy,area-52,383,evoker,devastation,6,4,2
Rysonda,tichondrius,383,evoker,devastation,6,4,2
Dinossauro,stormrage,383,evoker,devastation,6,4,2
Shenrøn,altar-of-storms,383,evoker,devastation,12,4,8
Wheyvern,malganis,383,evoker,devastation,12,4,8
Zaland,whisperwind,383,evoker,devastation,12,4,8
Jabberwockie,zuljin,383,evoker,devastation,12,4,8
Gorby,tichondrius,383,evoker,devastation,12,4,8
Gunship,moon-guard,383,evoker,devastation,12,4,8
Odaa,moon-guard,383,evoker,devastation,12,4,8
Bagelsaurus,tichondrius,383,evoker,devastation,12,4,8
Axlo,azgalor,383,evoker,devastation,12,4,8
Mynameisjohn,hakkar,382,evoker,devastation,6,4,2
Äpollo,frostmourne,382,evoker,devastation,12,4,8
Dracalis,thrall,381,evoker,devastation,12,4,8
Forte,terokkar,381,evoker,devastation,18,4,14
Fearmybreath,stormrage,370,evoker,devastation,22,7,15
Vermicri,zuljin,351,evoker,devastation,11,4,7
Goongdi,tichondrius,351,evoker,devastation,11,4,7
Serazenoth,area-52,336,evoker,devastation,9,4,5
Acindor,stormrage,335,evoker,devastation,11,4,7
Ackrs,tichondrius,335,evoker,devastation,11,4,7
Heizdrag,area-52,335,evoker,devastation,11,4,7
Totýs,quelthalas,330,evoker,devastation,17,7,10
Draygaar,stormrage,330,evoker,devastation,15,5,10
Unclelroh,kelthuzad,319,evoker,devastation,5,4,1
Kulrainor,drakkari,288,evoker,devastation,6,3,3
Ráigon,ragnaros,288,evoker,devastation,6,3,3
Larythelzrd,tichondrius,288,evoker,devastation,6,3,3
Burningwoe,tichondrius,288,evoker,devastation,6,3,3
Sovant,sargeras,288,evoker,devastation,6,3,3
Holdherhorn,area-52,288,evoker,devastation,6,3,3
Jakarn,moon-guard,288,evoker,devastation,6,3,3
Sardonyx,dragonmaw,288,evoker,devastation,6,3,3
Avasd,area-52,288,evoker,devastation,6,3,3
Raelstra,sargeras,288,evoker,devastation,6,3,3
Dragonpel,azralon,288,evoker,devastation,6,3,3
Yousmokemids,frostwolf,288,evoker,devastation,6,3,3
Crankxz,malganis,288,evoker,devastation,6,3,3
Kaeszandrus,azralon,288,evoker,devastation,6,3,3
Dreamfyrexi,thrall,288,evoker,devastation,6,3,3
Drackthyria,quelthalas,288,evoker,devastation,6,3,3
Lëåf,area-52,288,evoker,devastation,6,3,3
Magicev,tichondrius,288,evoker,devastation,6,3,3
Steveaoker,frostmourne,288,evoker,devastation,6,3,3
Devastateme,frostmourne,288,evoker,devastation,6,3,3
Draggoh,bleeding-hollow,288,evoker,devastation,6,3,3
Wickedwings,tichondrius,288,evoker,devastation,6,3,3
Aomend,stormrage,288,evoker,devastation,6,3,3
Wizzkii,wyrmrest-accord,288,evoker,devastation,6,3,3
Âréz,frostmourne,288,evoker,devastation,6,3,3
Zindrath,emerald-dream,288,evoker,devastation,6,3,3
Sensandors,tichondrius,288,evoker,devastation,6,3,3
Ceraxes,stormscale,288,evoker,devastation,6,3,3
Judra,barthilas,288,evoker,devastation,6,3,3
Zarazerath,tichondrius,288,evoker,devastation,6,3,3
Shenronda,moon-guard,288,evoker,devastation,6,3,3
Damo,skullcrusher,288,evoker,devastation,6,3,3
Skeye,malganis,288,evoker,devastation,6,3,3
Ecoera,tichondrius,288,evoker,devastation,6,3,3
Unisex,ragnaros,288,evoker,devastation,6,3,3
Koyra,illidan,288,evoker,devastation,6,3,3
Stewvoker,wyrmrest-accord,288,evoker,devastation,6,3,3
Baddrake,moon-guard,288,evoker,devastation,6,3,3
Kettor,kelthuzad,288,evoker,devastation,6,3,3
Scyyterr,azralon,288,evoker,devastation,6,3,3
Ancalgon,bloodscalp,288,evoker,devastation,6,3,3
Brôcôlînî,zuljin,288,evoker,devastation,6,3,3
Soupywings,illidan,288,evoker,devastation,6,3,3
Yeda,barthilas,288,evoker,devastation,6,3,3
Derkscale,stormrage,288,evoker,devastation,6,3,3
Baarss,tichondrius,288,evoker,devastation,6,3,3
Nonjer,tichondrius,288,evoker,devastation,6,3,3
Straykitty,moon-guard,288,evoker,devastation,6,3,3
Blackrend,illidan,288,evoker,devastation,6,3,3
Spyro,nazgrel,288,evoker,devastation,6,3,3
Theomarz,nagrand,288,evoker,devastation,6,3,3
Hausebat,aegwynn,288,evoker,devastation,6,3,3
Varandir,frostmane,288,evoker,devastation,6,3,3
Drakistraz,draenor,288,evoker,devastation,6,3,3
Gavstarz,frostmourne,288,evoker,devastation,9,4,5
Skydragonlol,tichondrius,288,evoker,devastation,7,3,4
Drakthaer,tichondrius,288,evoker,devastation,7,3,4
Taegon,area-52,288,evoker,devastation,10,4,6
Viverion,dalaran,288,evoker,devastation,10,4,6
Vandinus,stormrage,288,evoker,devastation,8,3,5
Berylhwit,emerald-dream,288,evoker,devastation,11,3,8
Enserio,stormrage,288,evoker,devastation,12,3,9
Zafirina,proudmoore,288,evoker,devastation,12,3,9
Healmeta,sargeras,288,evoker,devastation,12,3,9
Chriszilla,tichondrius,288,evoker,devastation,12,3,9
Draconis,onyxia,288,evoker,devastation,12,3,9
Bjarne,hyjal,288,evoker,devastation,12,3,9
Lizardlee,stormrage,288,evoker,devastation,12,3,9
Akatosh,bloodhoof,288,evoker,devastation,12,3,9
Spyspyro,emerald-dream,288,evoker,devastation,12,3,9
Mâne,ragnaros,288,evoker,devastation,12,3,9
Karmísh,quelthalas,288,evoker,devastation,12,3,9
Inferna,ysera,288,evoker,devastation,12,3,9
Freddragon,illidan,288,evoker,devastation,12,3,9
Marâjade,proudmoore,288,evoker,devastation,12,3,9
Praac,illidan,288,evoker,devastation,12,3,9
Talonsong,wyrmrest-accord,288,evoker,devastation,12,3,9
Dragndesnuts,scilla,288,evoker,devastation,18,3,15
Zeralzin,aerie-peak,287,evoker,devastation,6,3,3
Slev,blades-edge,287,evoker,devastation,6,3,3
Zatrazenot,area-52,287,evoker,devastation,6,3,3
Vaegahr,tichondrius,287,evoker,devastation,6,3,3
Doubledeuce,gorefiend,287,evoker,devastation,12,3,9
Shaletresh,thrall,287,evoker,devastation,12,3,9
Myvrth,windrunner,287,evoker,devastation,12,3,9
Kilnarx,uldaman,286,evoker,devastation,6,3,3
Brontez,malganis,286,evoker,devastation,6,3,3
Ghorin,akama,240,evoker,devastation,9,3,6
Draconiss,bonechewer,239,evoker,devastation,5,3,2
Evoque,sargeras,239,evoker,devastation,15,3,12
Reombarth,nemesis,234,evoker,devastation,12,6,6
Spectaclaw,crushridge,223,evoker,devastation,8,3,5
Ormagöden,ravencrest,208,evoker,devastation,7,3,4
Frozanat,kelthuzad,192,evoker,devastation,6,2,4
Draketyr,area-52,192,evoker,devastation,6,2,4
Mikaeza,tichondrius,192,evoker,devastation,6,2,4
Siatren,shadowmoon,192,evoker,devastation,6,2,4
Umbrathel,tichondrius,192,evoker,devastation,6,2,4
Aralzit,tichondrius,192,evoker,devastation,6,2,4
Dracorblaq,bleeding-hollow,192,evoker,devastation,6,2,4
Parachutes,kelthuzad,192,evoker,devastation,6,2,4
Dragonsand,area-52,192,evoker,devastation,6,2,4
Eggvoker,area-52,192,evoker,devastation,6,2,4
Xazxander,tichondrius,192,evoker,devastation,6,2,4
Ryüh,azralon,192,evoker,devastation,6,2,4
Genderboy,tichondrius,192,evoker,devastation,6,2,4
Vermithõr,ragnaros,192,evoker,devastation,6,2,4
Racovoker,zuljin,192,evoker,devastation,6,2,4
Hoodoo,dark-iron,192,evoker,devastation,6,2,4
Chapdragless,illidan,192,evoker,devastation,6,2,4
Selocky,bleeding-hollow,192,evoker,devastation,6,2,4
Kímbah,emerald-dream,192,evoker,devastation,6,2,4
Daebruk,ragnaros,192,evoker,devastation,6,2,4
Swamper,emerald-dream,192,evoker,devastation,6,2,4
Moorozond,zuljin,192,evoker,devastation,6,2,4
Analogies,stormrage,192,evoker,devastation,6,2,4
Álln,sargeras,192,evoker,devastation,6,2,4
Visheira,bleeding-hollow,192,evoker,devastation,6,2,4
Hellasketchy,sargeras,192,evoker,devastation,6,2,4
Dragboy,stormrage,192,evoker,devastation,6,2,4
Weirdclassx,tichondrius,192,evoker,devastation,6,2,4
Dragondubya,illidan,192,evoker,devastation,6,2,4
Acade,tichondrius,192,evoker,devastation,6,2,4
Theyevokbuda,kelthuzad,192,evoker,devastation,6,2,4
Ilithiphobia,ghostlands,192,evoker,devastation,6,2,4
Zattanik,ragnaros,192,evoker,devastation,6,2,4
Pyrepeanut,tichondrius,192,evoker,devastation,6,2,4
Dixb,illidan,192,evoker,devastation,6,2,4
Desdinova,tortheldrin,192,evoker,devastation,6,2,4
Puffed,frostmourne,192,evoker,devastation,6,2,4
Zuberion,wyrmrest-accord,192,evoker,devastation,6,2,4
Ralzital,auchindoun,192,evoker,devastation,6,2,4
Noxidian,moon-guard,192,evoker,devastation,6,2,4
Magikarpchan,ragnaros,192,evoker,devastation,6,2,4
Joesount,frostmourne,192,evoker,devastation,6,2,4
Guavomango,moon-guard,192,evoker,devastation,6,2,4
Nitalash,moon-guard,192,evoker,devastation,6,2,4
Draguhne,stormrage,192,evoker,devastation,6,2,4
Hiroshim,stormrage,192,evoker,devastation,6,2,4
Tasdaral,tichondrius,192,evoker,devastation,6,2,4
Doldorrii,terenas,192,evoker,devastation,6,2,4
Pocketgiga,stormrage,192,evoker,devastation,6,2,4
Goreriders,area-52,192,evoker,devastation,6,2,4
Yalena,illidan,192,evoker,devastation,6,2,4
Dokthyr,lightbringer,192,evoker,devastation,6,2,4
Vapegodx,proudmoore,192,evoker,devastation,6,2,4
Setaler,bonechewer,192,evoker,devastation,6,2,4
Iragorn,nemesis,192,evoker,devastation,6,2,4
Daemon,terokkar,192,evoker,devastation,6,2,4
Paindragon,tol-barad,192,evoker,devastation,6,2,4
Kazervish,wyrmrest-accord,192,evoker,devastation,6,2,4
Wydbro,kiljaeden,192,evoker,devastation,6,2,4
Grawlix,stormreaver,192,evoker,devastation,6,2,4
Critqueenx,destromath,192,evoker,devastation,6,2,4
Olawd,azshara,192,evoker,devastation,6,2,4
Lanati,veknilash,192,evoker,devastation,6,2,4
Slydawg,amanthul,192,evoker,devastation,6,2,4
Shädòwçäsper,kilrogg,192,evoker,devastation,6,2,4
Nyaraoorun,uther,192,evoker,devastation,6,2,4
Horusnight,drakkari,192,evoker,devastation,6,2,4
Cyromancerr,illidan,192,evoker,devastation,8,2,6
Blueblack,proudmoore,192,evoker,devastation,12,2,10
Villaindraq,stormrage,192,evoker,devastation,12,2,10
Dragonbornhd,tichondrius,192,evoker,devastation,12,2,10
Detralan,draka,192,evoker,devastation,12,2,10
Kuthar,barthilas,192,evoker,devastation,12,2,10
Bitormu,scilla,192,evoker,devastation,12,2,10
Valkarie,arygos,192,evoker,devastation,12,2,10
Chillistraza,tichondrius,192,evoker,devastation,12,2,10
Erathiss,wyrmrest-accord,192,evoker,devastation,12,2,10
Niraller,tichondrius,192,evoker,devastation,12,2,10
Ragtharion,tichondrius,192,evoker,devastation,12,2,10
Sørrøw,blades-edge,192,evoker,devastation,18,2,16
Shenlongg,sargeras,191,evoker,devastation,6,2,4
Grigori,vashj,191,evoker,devastation,12,2,10
Exiztx,tichondrius,160,evoker,devastation,10,2,8
Tevvez,moon-guard,159,evoker,devastation,5,2,3
Alkden,azralon,159,evoker,devastation,8,3,5
Skaylee,illidan,144,evoker,devastation,9,2,7
Deshalth,dalaran,138,evoker,devastation,11,5,6
Platypus,tichondrius,138,evoker,devastation,11,4,7
Deathflamee,emerald-dream,138,evoker,devastation,12,3,9
Booniejimbob,illidan,128,evoker,devastation,4,2,2
Shunkagosa,frostmourne,128,evoker,devastation,4,2,2
Vïtmercon,frostmourne,128,evoker,devastation,4,2,2
Vormontis,azralon,112,evoker,devastation,7,2,5
Tugmapvpean,kelthuzad,96,evoker,devastation,3,2,1
Ryuukishi,amanthul,96,evoker,devastation,6,1,5
Leralan,illidan,96,evoker,devastation,6,1,5
Dripps,bleeding-hollow,96,evoker,devastation,6,1,5
Drakkar,elune,96,evoker,devastation,6,1,5
Chocamocos,area-52,96,evoker,devastation,6,1,5
Zinderaz,runetotem,96,evoker,devastation,6,1,5
Luceryz,drakkari,96,evoker,devastation,6,1,5
Selfhealzer,korgath,96,evoker,devastation,6,1,5
Demonmommy,caelestrasz,96,evoker,devastation,6,1,5
Handb,tichondrius,96,evoker,devastation,6,1,5
Natsirt,malorne,96,evoker,devastation,6,1,5
Ghidorah,sentinels,96,evoker,devastation,6,1,5
Asui,senjin,96,evoker,devastation,6,1,5
Ackonstraza,frostmourne,96,evoker,devastation,6,1,5
Ocd,stormrage,96,evoker,devastation,6,1,5
Skithyrix,bleeding-hollow,96,evoker,devastation,6,1,5
Kazadon,icecrown,96,evoker,devastation,6,1,5
Happyevoker,tichondrius,96,evoker,devastation,6,1,5
Shintrax,ragnaros,96,evoker,devastation,6,1,5
Repd,sargeras,96,evoker,devastation,6,1,5
Charrio,illidan,96,evoker,devastation,6,1,5
Stankybreff,area-52,96,evoker,devastation,6,1,5
Proust,grizzly-hills,96,evoker,devastation,6,1,5
Fígment,tichondrius,96,evoker,devastation,6,1,5
Zealagon,ragnaros,96,evoker,devastation,6,1,5
Cindrozaraz,stormreaver,96,evoker,devastation,6,1,5
Bløssom,malganis,96,evoker,devastation,6,1,5
Demobreath,sargeras,96,evoker,devastation,6,1,5
Rojothyr,tichondrius,96,evoker,devastation,6,1,5
Ðrac,bleeding-hollow,96,evoker,devastation,6,1,5
Sneekysnekz,tichondrius,96,evoker,devastation,6,1,5
Sigroux,area-52,96,evoker,devastation,6,1,5
Ipunchdarts,frostmourne,96,evoker,devastation,6,1,5
Batterypowa,frostmourne,96,evoker,devastation,6,1,5
Warchad,stormrage,96,evoker,devastation,6,1,5
Modenzu,malganis,96,evoker,devastation,6,1,5
Myjewelshurt,stormrage,96,evoker,devastation,6,1,5
Trogs,emerald-dream,96,evoker,devastation,6,1,5
Ojigi,sargeras,96,evoker,devastation,6,1,5
Jsb,moon-guard,96,evoker,devastation,6,1,5
Lucià,thrall,96,evoker,devastation,6,1,5
Carnosaur,lightbringer,96,evoker,devastation,12,1,11
Donormi,moon-guard,96,evoker,devastation,12,1,11
Ysondrius,durotan,96,evoker,devastation,12,1,11
Rathend,lothar,96,evoker,devastation,12,1,11
Colloc,tichondrius,96,evoker,devastation,12,1,11
Icedmochaa,thrall,96,evoker,devastation,12,1,11
Bigwurrm,illidan,96,evoker,devastation,18,1,17
Líghtníng,tichondrius,95,evoker,devastation,7,1,6
Coped,stormrage,79,evoker,devastation,5,1,4
Starkiller,stormrage,64,evoker,devastation,4,1,3
Nwo,shattered-hand,64,evoker,devastation,4,1,3
Skymagician,frostmourne,64,evoker,devastation,4,1,3
Nyxtari,ragnaros,48,evoker,devastation,3,1,2
Charlestrasz,hyjal,42,evoker,devastation,11,3,8
Ytq,tichondrius,42,evoker,devastation,10,2,8
Dobarantu,tichondrius,2232,hunter,marksmanship,205,112,93
Remisha,emerald-dream,2210,hunter,marksmanship,127,69,58
Darkshady,tichondrius,2108,hunter,marksmanship,84,44,40
Chadsmanship,kelthuzad,2103,hunter,marksmanship,98,47,51
Imvalence,area-52,1983,hunter,marksmanship,157,75,82
Abolick,area-52,1953,hunter,marksmanship,141,71,70
Fuknhunter,kiljaeden,1905,hunter,marksmanship,110,56,54
Banshee,frostmourne,1886,hunter,marksmanship,40,24,16
Rakan,spinebreaker,1884,hunter,marksmanship,54,33,21
Bøl,ragnaros,1882,hunter,marksmanship,30,20,10
Milahwa,frostmourne,1880,hunter,marksmanship,66,31,35
Hokutox,tichondrius,1870,hunter,marksmanship,68,31,37
Drupert,tichondrius,1869,hunter,marksmanship,36,20,16
Rendel,drakkari,1863,hunter,marksmanship,237,114,123
Mhd,stormrage,1863,hunter,marksmanship,77,36,41
Hrafn,illidan,1859,hunter,marksmanship,60,31,29
Babyhydra,frostmourne,1858,hunter,marksmanship,65,32,33
Preze,moon-guard,1852,hunter,marksmanship,63,37,26
Photos,moon-guard,1851,hunter,marksmanship,71,48,23
Squawkers,sargeras,1848,hunter,marksmanship,78,43,35
Astolenis,quelthalas,1847,hunter,marksmanship,60,29,31
Blackjesu,blackrock,1841,hunter,marksmanship,78,35,43
Bosshunter,tichondrius,1838,hunter,marksmanship,116,59,57
Moonwind,tichondrius,1836,hunter,marksmanship,65,31,34
Takeiya,zuljin,1830,hunter,marksmanship,59,30,29
Hâwkêyê,thrall,1827,hunter,marksmanship,48,22,26
Dynith,sargeras,1825,hunter,marksmanship,75,39,36
Ingrutamig,tichondrius,1817,hunter,marksmanship,72,34,38
Iconvoked,sargeras,1816,hunter,marksmanship,214,110,104
Dolcece,tichondrius,1816,hunter,marksmanship,60,29,31
Colada,malganis,1813,hunter,marksmanship,72,34,38
Zumago,tichondrius,1808,hunter,marksmanship,117,60,57
Nishinos,tichondrius,1808,hunter,marksmanship,183,88,95
Kristemis,thrall,1806,hunter,marksmanship,57,30,27
Renaître,tichondrius,1806,hunter,marksmanship,126,58,68
Tánsøxøxø,tichondrius,1805,hunter,marksmanship,60,30,30
Czeroenjoyer,malganis,1803,hunter,marksmanship,66,33,33
Lely,tichondrius,1800,hunter,marksmanship,72,38,34
Trapordíe,tichondrius,1800,hunter,marksmanship,42,21,21
Supersaiyan,antonidas,1797,hunter,marksmanship,60,28,32
Wmsgs,tichondrius,1796,hunter,marksmanship,151,75,76
Valdra,aegwynn,1784,hunter,marksmanship,72,43,29
Milae,frostmourne,1779,hunter,marksmanship,66,32,34
Drasen,deathwing,1778,hunter,marksmanship,48,27,21
Kensho,illidan,1777,hunter,marksmanship,101,54,47
Undeadroach,tichondrius,1776,hunter,marksmanship,131,62,69
Brewster,burning-legion,1769,hunter,marksmanship,72,39,33
Khasu,ragnaros,1767,hunter,marksmanship,42,21,21
Ladderpolice,tichondrius,1766,hunter,marksmanship,125,68,57
Alyywn,tichondrius,1766,hunter,marksmanship,191,95,96
Hagadinn,frostmourne,1765,hunter,marksmanship,48,21,27
Landon,lightnings-blade,1760,hunter,marksmanship,48,27,21
Notnick,tichondrius,1747,hunter,marksmanship,84,37,47
Shatterwax,area-52,1744,hunter,marksmanship,48,24,24
Overgnome,ragnaros,1736,hunter,marksmanship,66,32,34
Trapstar,aggramar,1729,hunter,marksmanship,74,43,31
Bootywhop,dalaran,1724,hunter,marksmanship,54,25,29
Jamesmcgill,tichondrius,1723,hunter,marksmanship,47,19,28
Maximos,lightnings-blade,1720,hunter,marksmanship,150,75,75
Dudemanyeah,skullcrusher,1720,hunter,marksmanship,66,26,40
Mapp,tichondrius,1717,hunter,marksmanship,36,21,15
Primalus,tichondrius,1717,hunter,marksmanship,36,18,18
Kkoduckk,tichondrius,1715,hunter,marksmanship,30,19,11
Comebacks,ragnaros,1714,hunter,marksmanship,95,46,49
Slantedshot,coilfang,1714,hunter,marksmanship,132,61,71
Gohan,jubeithos,1713,hunter,marksmanship,39,22,17
Nãmki,tichondrius,1710,hunter,marksmanship,48,32,16
Globalcake,illidan,1710,hunter,marksmanship,204,99,105
Quickitty,proudmoore,1703,hunter,marksmanship,148,73,75
Sharpknife,dreadmaul,1700,hunter,marksmanship,66,31,35
Heädshöt,malorne,1699,hunter,marksmanship,78,38,40
Khasü,quelthalas,1691,hunter,marksmanship,53,33,20
Doves,wyrmrest-accord,1685,hunter,marksmanship,66,38,28
Undien,area-52,1678,hunter,marksmanship,64,33,31
Killatrap,malganis,1677,hunter,marksmanship,42,23,19
Deutêr,quelthalas,1677,hunter,marksmanship,84,40,44
Markymarc,tichondrius,1677,hunter,marksmanship,53,22,31
Dracõ,proudmoore,1674,hunter,marksmanship,128,67,61
Boquiinha,stormrage,1674,hunter,marksmanship,177,86,91
Ekzoo,tichondrius,1672,hunter,marksmanship,34,21,13
Spunky,zuluhed,1670,hunter,marksmanship,60,32,28
Petattack,barthilas,1668,hunter,marksmanship,42,20,22
Ðurostar,area-52,1666,hunter,marksmanship,36,18,18
Beldhur,archimonde,1666,hunter,marksmanship,59,26,33
Tassili,illidan,1666,hunter,marksmanship,60,23,37
Vitekz,illidan,1665,hunter,marksmanship,36,25,11
Aueria,kiljaeden,1664,hunter,marksmanship,66,29,37
Onemøreshot,bleeding-hollow,1658,hunter,marksmanship,161,84,77
Tren,blackrock,1657,hunter,marksmanship,41,21,20
Neverhunter,azralon,1656,hunter,marksmanship,47,26,21
Huntkiller,tichondrius,1651,hunter,marksmanship,40,29,11
Gotchã,area-52,1650,hunter,marksmanship,42,27,15
Bwaa,illidan,1650,hunter,marksmanship,125,66,59
Onemoreshot,bleeding-hollow,1650,hunter,marksmanship,224,110,114
Stormjin,arthas,1647,hunter,marksmanship,66,33,33
Aymas,sargeras,1646,hunter,marksmanship,125,65,60
Hunterlist,frostmourne,1642,hunter,marksmanship,54,21,33
Freshko,kiljaeden,1641,hunter,marksmanship,48,31,17
Misakilr,sargeras,1640,hunter,marksmanship,48,27,21
Headshoot,tichondrius,1640,hunter,marksmanship,77,42,35
Barelyknower,area-52,1639,hunter,marksmanship,90,44,46
Wildder,area-52,1637,hunter,marksmanship,62,35,27
Tommychong,shandris,1636,hunter,marksmanship,70,35,35
Learn,sargeras,1635,hunter,marksmanship,54,31,23
Surprisemfkr,emerald-dream,1635,hunter,marksmanship,78,39,39
Venerer,tichondrius,1634,hunter,marksmanship,66,33,33
Candytoxic,quelthalas,1634,hunter,marksmanship,42,21,21
Nes,azuremyst,1633,hunter,marksmanship,36,19,17
Freezetrap,proudmoore,1632,hunter,marksmanship,39,24,15
Wìkkihx,emerald-dream,1632,hunter,marksmanship,89,49,40
Blaðe,kelthuzad,1629,hunter,marksmanship,206,95,111
Bigpie,daggerspine,1628,hunter,marksmanship,59,37,22
Orber,stormrage,1628,hunter,marksmanship,43,23,20
Taylormadae,frostmourne,1627,hunter,marksmanship,66,37,29
Elfymcelf,arthas,1626,hunter,marksmanship,108,55,53
Shawtytraps,tichondrius,1623,hunter,marksmanship,188,80,108
Arjunå,sargeras,1621,hunter,marksmanship,101,56,45
Xcw,stormrage,1619,hunter,marksmanship,60,28,32
Zakiro,illidan,1618,hunter,marksmanship,30,20,10
Ssdslol,bleeding-hollow,1618,hunter,marksmanship,163,97,66
Alansho,tichondrius,1618,hunter,marksmanship,53,20,33
Tânsøxøxø,tichondrius,1617,hunter,marksmanship,30,17,13
Timmee,bleeding-hollow,1617,hunter,marksmanship,46,26,20
Latesummer,tichondrius,1616,hunter,marksmanship,48,25,23
Johaylon,sargeras,1616,hunter,marksmanship,42,19,23
Dezertpower,sargeras,1613,hunter,marksmanship,36,20,16
Junglejam,elune,1613,hunter,marksmanship,76,37,39
Darance,sargeras,1612,hunter,marksmanship,40,22,18
Snìpershot,sargeras,1612,hunter,marksmanship,61,33,28
Shotashot,area-52,1612,hunter,marksmanship,36,17,19
Hhappy,tichondrius,1612,hunter,marksmanship,66,27,39
Toxarch,aggramar,1610,hunter,marksmanship,72,31,41
Arrowslol,stormrage,1608,hunter,marksmanship,60,32,28
Biubiubiubiu,proudmoore,1606,hunter,marksmanship,72,43,29
Aqurandris,moon-guard,1605,hunter,marksmanship,78,49,29
Simbagrove,dalaran,1605,hunter,marksmanship,42,19,23
Evaelfi,illidan,1605,hunter,marksmanship,40,17,23
Hyyz,proudmoore,1604,hunter,marksmanship,36,22,14
Lilbang,thrall,1604,hunter,marksmanship,123,61,62
Drivebymac,tichondrius,1599,hunter,marksmanship,102,51,51
Blungo,azralon,1599,hunter,marksmanship,118,56,62
Deadshöt,bleeding-hollow,1597,hunter,marksmanship,59,26,33
Gor,hyjal,1594,hunter,marksmanship,53,25,28
Shootipie,hyjal,1593,hunter,marksmanship,28,20,8
Topshotx,tichondrius,1592,hunter,marksmanship,42,26,16
Bowreckage,malganis,1591,hunter,marksmanship,139,77,62
Yønkøu,azralon,1591,hunter,marksmanship,80,35,45
Bertimus,sargeras,1583,hunter,marksmanship,57,26,31
Tyrmaakk,emerald-dream,1581,hunter,marksmanship,46,25,21
Lilbebe,illidan,1580,hunter,marksmanship,54,31,23
Lîvy,aerie-peak,1579,hunter,marksmanship,82,45,37
Mambothehunt,stormrage,1579,hunter,marksmanship,66,36,30
Hideonpet,barthilas,1578,hunter,marksmanship,77,38,39
Thebweh,ragnaros,1578,hunter,marksmanship,53,24,29
Dienasty,zuljin,1577,hunter,marksmanship,36,23,13
Itsgma,shandris,1575,hunter,marksmanship,42,23,19
Flämma,azralon,1573,hunter,marksmanship,90,40,50
Huntonthic,korgath,1571,hunter,marksmanship,68,34,34
Hmh,burning-legion,1570,hunter,marksmanship,275,138,137
Odin,goldrinn,1567,hunter,marksmanship,205,99,106
Zasnar,malganis,1565,hunter,marksmanship,48,26,22
Stimpblimp,jubeithos,1563,hunter,marksmanship,48,19,29
Crounzz,sargeras,1558,hunter,marksmanship,51,23,28
Mù,frostmourne,1556,hunter,marksmanship,66,36,30
Rampagez,tichondrius,1555,hunter,marksmanship,36,19,17
Tråppin,sargeras,1552,hunter,marksmanship,87,47,40
Ryukuzen,tichondrius,1551,hunter,marksmanship,48,20,28
Bacchantress,tichondrius,1550,hunter,marksmanship,48,24,24
Wockqt,kiljaeden,1550,hunter,marksmanship,61,28,33
Easynightjr,bleeding-hollow,1549,hunter,marksmanship,237,121,116
Unravel,tichondrius,1548,hunter,marksmanship,111,62,49
Mukbangbj,terenas,1546,hunter,marksmanship,76,40,36
Sagadegêmeos,stormrage,1545,hunter,marksmanship,118,50,68
Luchadoris,malganis,1544,hunter,marksmanship,72,36,36
Kimghak,tichondrius,1544,hunter,marksmanship,67,30,37
Rubinaldo,azralon,1543,hunter,marksmanship,36,18,18
Saltard,frostmourne,1542,hunter,marksmanship,30,17,13
Baixiaochu,area-52,1539,hunter,marksmanship,141,69,72
Artemyzz,tichondrius,1537,hunter,marksmanship,48,22,26
Ggtooeasy,thrall,1536,hunter,marksmanship,42,21,21
Jubiscleudo,azralon,1535,hunter,marksmanship,133,60,73
Huntncheekz,kelthuzad,1534,hunter,marksmanship,76,38,38
Hogshanks,moon-guard,1534,hunter,marksmanship,36,18,18
Metalgear,icecrown,1533,hunter,marksmanship,66,34,32
Hitts,barthilas,1532,hunter,marksmanship,59,30,29
Smokabombom,eredar,1530,hunter,marksmanship,34,18,16
Zugbrained,illidan,1529,hunter,marksmanship,48,26,22
Hämhunter,stormrage,1528,hunter,marksmanship,75,44,31
Amyrkvothe,ragnaros,1528,hunter,marksmanship,72,32,40
Papiskrill,staghelm,1526,hunter,marksmanship,103,47,56
Swayshunt,area-52,1525,hunter,marksmanship,52,26,26
Dummorogh,stormrage,1522,hunter,marksmanship,126,58,68
Guacmec,tichondrius,1521,hunter,marksmanship,48,28,20
Richmond,lightnings-blade,1521,hunter,marksmanship,72,33,39
Gretress,azralon,1520,hunter,marksmanship,66,28,38
Grands,tortheldrin,1519,hunter,marksmanship,54,26,28
Lsily,tichondrius,1519,hunter,marksmanship,36,16,20
Maia,frostwolf,1518,hunter,marksmanship,66,30,36
Bowflexen,illidan,1518,hunter,marksmanship,42,19,23
Tropic,proudmoore,1518,hunter,marksmanship,101,38,63
Dykbuht,area-52,1517,hunter,marksmanship,60,31,29
Roidbum,barthilas,1517,hunter,marksmanship,40,16,24
Ocromiun,illidan,1517,hunter,marksmanship,63,22,41
Balaria,tichondrius,1515,hunter,marksmanship,35,19,16
Insanedabz,tichondrius,1515,hunter,marksmanship,72,35,37
Gnomorecum,kiljaeden,1514,hunter,marksmanship,99,58,41
Legeye,malganis,1514,hunter,marksmanship,54,26,28
Stfd,illidan,1513,hunter,marksmanship,39,23,16
Trippyhunter,akama,1509,hunter,marksmanship,30,18,12
Swagprince,skullcrusher,1509,hunter,marksmanship,64,36,28
Mehontar,area-52,1509,hunter,marksmanship,42,20,22
Plopslopper,frostmourne,1508,hunter,marksmanship,60,31,29
Shotsphodays,sargeras,1506,hunter,marksmanship,90,45,45
Cyrsmen,ragnaros,1505,hunter,marksmanship,105,51,54
Fatehunter,bleeding-hollow,1505,hunter,marksmanship,80,34,46
Lostfaith,tichondrius,1504,hunter,marksmanship,66,36,30
Rïve,tichondrius,1504,hunter,marksmanship,36,17,19
Marshen,zuljin,1503,hunter,marksmanship,36,17,19
Saloran,akama,1502,hunter,marksmanship,102,55,47
Dsnowy,emerald-dream,1500,hunter,marksmanship,30,16,14
Kekkww,hyjal,1499,hunter,marksmanship,60,30,30
Rednivrap,kelthuzad,1498,hunter,marksmanship,29,16,13
Lixniqua,tichondrius,1498,hunter,marksmanship,75,38,37
Papacohen,stormrage,1495,hunter,marksmanship,45,22,23
Lildex,demon-soul,1494,hunter,marksmanship,30,18,12
Föcker,emerald-dream,1492,hunter,marksmanship,25,19,6
ßoo,darkspear,1492,hunter,marksmanship,36,20,16
Esler,quelthalas,1490,hunter,marksmanship,54,28,26
Larree,kelthuzad,1489,hunter,marksmanship,30,21,9
Ðaybreâker,tichondrius,1489,hunter,marksmanship,49,29,20
Yozsh,azralon,1485,hunter,marksmanship,47,32,15
Rudekeef,illidan,1478,hunter,marksmanship,36,17,19
Boomphaque,ravencrest,1476,hunter,marksmanship,132,63,69
Metalstorm,draenor,1476,hunter,marksmanship,41,19,22
Booyakah,hyjal,1475,hunter,marksmanship,36,19,17
Windrein,ysondre,1475,hunter,marksmanship,48,20,28
Hoboh,illidan,1474,hunter,marksmanship,123,63,60
Barrohunt,tichondrius,1473,hunter,marksmanship,49,31,18
Bodaki,proudmoore,1473,hunter,marksmanship,42,20,22
Somethinggo,tichondrius,1472,hunter,marksmanship,161,77,84
Adive,drakkari,1471,hunter,marksmanship,100,46,54
Artois,tichondrius,1471,hunter,marksmanship,40,18,22
Tup,guldan,1470,hunter,marksmanship,69,36,33
Scourgesurge,kiljaeden,1470,hunter,marksmanship,42,21,21
Cloudzbow,moon-guard,1470,hunter,marksmanship,40,18,22
Finaqua,sargeras,1469,hunter,marksmanship,56,24,32
Shadowhokage,zuljin,1468,hunter,marksmanship,67,36,31
Dharo,illidan,1466,hunter,marksmanship,27,17,10
Killshøtß,tichondrius,1466,hunter,marksmanship,54,25,29
Lowlore,moon-guard,1463,hunter,marksmanship,96,52,44
Automatic,illidan,1463,hunter,marksmanship,69,34,35
Pwnagraphic,barthilas,1463,hunter,marksmanship,82,36,46
Skybourne,nemesis,1462,hunter,marksmanship,150,82,68
Deliond,moon-guard,1462,hunter,marksmanship,222,112,110
Zeenuts,sargeras,1461,hunter,marksmanship,47,24,23
Renzô,sargeras,1459,hunter,marksmanship,88,51,37
Angelickon,tichondrius,1459,hunter,marksmanship,62,29,33
Shootybooty,arygos,1459,hunter,marksmanship,66,25,41
Bomomatic,zuljin,1457,hunter,marksmanship,42,24,18
Tòxophilite,tichondrius,1456,hunter,marksmanship,74,28,46
Nelosi,shadowmoon,1455,hunter,marksmanship,54,25,29
Rockenrique,nemesis,1453,hunter,marksmanship,72,34,38
Pkn,chogall,1450,hunter,marksmanship,60,27,33
Tóri,emerald-dream,1445,hunter,marksmanship,47,25,22
Zombified,moon-guard,1442,hunter,marksmanship,59,31,28
Hemathios,drakkari,1442,hunter,marksmanship,50,21,29
Rumzi,thrall,1441,hunter,marksmanship,102,57,45
Stupidgodx,tichondrius,1441,hunter,marksmanship,68,35,33
Backpedalftw,darrowmere,1440,hunter,marksmanship,42,16,26
Katebishop,nemesis,1438,hunter,marksmanship,28,18,10
Jotosalsa,blackrock,1438,hunter,marksmanship,60,30,30
Klitz,lightninghoof,1436,hunter,marksmanship,36,21,15
Blickys,area-52,1435,hunter,marksmanship,36,15,21
Boradin,lightbringer,1434,hunter,marksmanship,77,48,29
Acelol,proudmoore,1434,hunter,marksmanship,245,130,115
Pokcmvmxckm,senjin,1433,hunter,marksmanship,66,35,31
Allondra,proudmoore,1432,hunter,marksmanship,30,17,13
Crazyeasy,azshara,1431,hunter,marksmanship,30,15,15
Lewanker,zuljin,1429,hunter,marksmanship,42,23,19
Mèseeks,bleeding-hollow,1427,hunter,marksmanship,60,34,26
Joshmckin,area-52,1427,hunter,marksmanship,134,63,71
Valimhir,tichondrius,1426,hunter,marksmanship,75,33,42
Inktray,durotan,1426,hunter,marksmanship,36,15,21
Hötdôg,kiljaeden,1425,hunter,marksmanship,66,31,35
Cholohippie,blackrock,1424,hunter,marksmanship,55,30,25
Vonkrieg,tichondrius,1424,hunter,marksmanship,42,15,27
Chï,zuljin,1422,hunter,marksmanship,168,84,84
Sleepyjoee,dalaran,1421,hunter,marksmanship,54,31,23
Infinitý,zuljin,1421,hunter,marksmanship,77,34,43
Rorijii,tichondrius,1421,hunter,marksmanship,54,23,31
Leucis,cenarius,1420,hunter,marksmanship,18,15,3
Lokuhzmarcus,goldrinn,1419,hunter,marksmanship,84,45,39
Longshánks,stormrage,1416,hunter,marksmanship,30,15,15
Kronicbeast,bleeding-hollow,1416,hunter,marksmanship,128,59,69
Cheetah,tichondrius,1415,hunter,marksmanship,30,15,15
Boombob,sargeras,1415,hunter,marksmanship,59,27,32
Shøtii,tichondrius,1414,hunter,marksmanship,40,21,19
Dathunterr,azralon,1414,hunter,marksmanship,113,56,57
Vivaswan,tichondrius,1413,hunter,marksmanship,42,15,27
Tømalúca,azralon,1412,hunter,marksmanship,36,22,14
Brapdaddy,lightbringer,1412,hunter,marksmanship,48,21,27
Elendïr,tichondrius,1411,hunter,marksmanship,60,33,27
Feov,tichondrius,1410,hunter,marksmanship,24,15,9
Berkhof,tichondrius,1410,hunter,marksmanship,74,34,40
Toowizeë,barthilas,1409,hunter,marksmanship,59,27,32
Klannis,quelthalas,1409,hunter,marksmanship,42,19,23
Microshotz,windrunner,1408,hunter,marksmanship,36,24,12
Jeezyxxii,shadowmoon,1408,hunter,marksmanship,103,49,54
Grimcask,ragnaros,1408,hunter,marksmanship,39,18,21
Rapidfire,perenolde,1407,hunter,marksmanship,69,35,34
Javoj,drakkari,1405,hunter,marksmanship,30,15,15
Voidmarksman,whisperwind,1404,hunter,marksmanship,49,30,19
Lederniertra,gorefiend,1404,hunter,marksmanship,296,149,147
Péppérmínt,korgath,1403,hunter,marksmanship,62,32,30
Madsniper,thunderlord,1403,hunter,marksmanship,90,46,44
Grànd,tortheldrin,1402,hunter,marksmanship,35,17,18
Déadshot,thaurissan,1402,hunter,marksmanship,42,17,25
Xcisiion,nagrand,1401,hunter,marksmanship,185,92,93
Ravenblood,lothar,1400,hunter,marksmanship,30,16,14
Vibøra,stormrage,1400,hunter,marksmanship,150,68,82
Dsizzle,tichondrius,1400,hunter,marksmanship,44,18,26
Pâl,quelthalas,1399,hunter,marksmanship,78,36,42
Hawkeyë,ragnaros,1397,hunter,marksmanship,24,15,9
Mizhu,ragnaros,1397,hunter,marksmanship,130,70,60
Hunsak,ragnaros,1396,hunter,marksmanship,36,24,12
Ashx,khazgoroth,1392,hunter,marksmanship,30,15,15
Chîll,frostmourne,1392,hunter,marksmanship,68,32,36
Soljer,kiljaeden,1392,hunter,marksmanship,78,33,45
Häydn,emerald-dream,1390,hunter,marksmanship,40,22,18
Insulin,moonrunner,1390,hunter,marksmanship,36,17,19
Littledougie,boulderfist,1388,hunter,marksmanship,90,47,43
ßeãst,bladefist,1387,hunter,marksmanship,24,16,8
Staticarrow,norgannon,1387,hunter,marksmanship,132,64,68
Zgabriel,azralon,1387,hunter,marksmanship,42,19,23
Bigolhippy,frostmourne,1386,hunter,marksmanship,42,23,19
Slayou,uldum,1383,hunter,marksmanship,69,37,32
Fuzzypjs,stormrage,1382,hunter,marksmanship,39,17,22
Siebee,tichondrius,1382,hunter,marksmanship,42,17,25
Dnicee,stormrage,1380,hunter,marksmanship,42,30,12
Grayføxx,twisting-nether,1379,hunter,marksmanship,95,49,46
Mariaassjx,ragnaros,1379,hunter,marksmanship,114,51,63
Dreygar,dawnbringer,1379,hunter,marksmanship,36,15,21
Gothew,turalyon,1378,hunter,marksmanship,137,73,64
Spacelandz,emerald-dream,1374,hunter,marksmanship,30,19,11
Dominate,frostmourne,1374,hunter,marksmanship,54,26,28
Precísion,malganis,1372,hunter,marksmanship,35,18,17
Kusz,bleeding-hollow,1372,hunter,marksmanship,107,47,60
Rawrzy,sargeras,1372,hunter,marksmanship,35,15,20
Itryharder,stormrage,1371,hunter,marksmanship,48,30,18
Leshwi,ragnaros,1370,hunter,marksmanship,47,23,24
Desolater,bleeding-hollow,1369,hunter,marksmanship,60,19,41
Malebolick,ragnaros,1367,hunter,marksmanship,65,27,38
Lukhas,moon-guard,1367,hunter,marksmanship,66,27,39
Toniic,moon-guard,1366,hunter,marksmanship,66,40,26
Cashhapp,zuljin,1366,hunter,marksmanship,213,107,106
Murderville,illidan,1366,hunter,marksmanship,54,27,27
Chokemescara,stormrage,1364,hunter,marksmanship,36,16,20
Worewolf,lightninghoof,1363,hunter,marksmanship,50,22,28
Amonerhunter,bleeding-hollow,1362,hunter,marksmanship,54,23,31
Jenniekim,mugthol,1361,hunter,marksmanship,31,21,10
Skelyeelegno,perenolde,1361,hunter,marksmanship,30,17,13
Ladright,altar-of-storms,1361,hunter,marksmanship,54,26,28
Gorîlla,sargeras,1361,hunter,marksmanship,102,49,53
Lotatinyfish,malganis,1360,hunter,marksmanship,54,32,22
Glittergun,sargeras,1360,hunter,marksmanship,41,19,22
Trapshawty,darkspear,1359,hunter,marksmanship,54,19,35
Bowinc,greymane,1357,hunter,marksmanship,24,15,9
Vergillx,ragnaros,1357,hunter,marksmanship,95,54,41
Boggartt,ragnaros,1357,hunter,marksmanship,60,27,33
Pleyadez,drakkari,1356,hunter,marksmanship,42,24,18
Doug,illidan,1356,hunter,marksmanship,36,20,16
Condorexe,illidan,1356,hunter,marksmanship,90,39,51
Gq,garona,1355,hunter,marksmanship,101,43,58
Sï,anubarak,1354,hunter,marksmanship,48,19,29
Húntingarrow,area-52,1353,hunter,marksmanship,95,47,48
Moktarg,archimonde,1353,hunter,marksmanship,71,33,38
Aimz,zuluhed,1353,hunter,marksmanship,79,30,49
Huuntard,proudmoore,1351,hunter,marksmanship,47,19,28
Watchmanjoe,grizzly-hills,1350,hunter,marksmanship,54,30,24
Kolosaltraps,tichondrius,1349,hunter,marksmanship,33,16,17
Drjingajanga,zuluhed,1346,hunter,marksmanship,45,20,25
Kyukon,illidan,1345,hunter,marksmanship,36,18,18
Snipeudead,sargeras,1345,hunter,marksmanship,36,15,21
Diisdik,tichondrius,1344,hunter,marksmanship,51,23,28
Ÿöskë,tichondrius,1343,hunter,marksmanship,24,14,10
Hurstt,kelthuzad,1341,hunter,marksmanship,56,27,29
Nirika,moon-guard,1340,hunter,marksmanship,105,47,58
Fartingshot,proudmoore,1339,hunter,marksmanship,89,41,48
Llachiip,zuljin,1338,hunter,marksmanship,52,27,25
Ghudi,moon-guard,1337,hunter,marksmanship,51,27,24
Dexteros,ragnaros,1337,hunter,marksmanship,66,33,33
Braxigarr,area-52,1337,hunter,marksmanship,235,113,122
Wìllòw,khazgoroth,1337,hunter,marksmanship,48,18,30
Unclepez,barthilas,1336,hunter,marksmanship,18,14,4
Orgpopeyes,illidan,1336,hunter,marksmanship,24,14,10
Dvei,silvermoon,1336,hunter,marksmanship,57,25,32
Targetreaper,proudmoore,1335,hunter,marksmanship,108,55,53
Cablok,moon-guard,1335,hunter,marksmanship,30,14,16
Døubletap,gundrak,1334,hunter,marksmanship,52,22,30
Booffmeister,area-52,1329,hunter,marksmanship,30,14,16
Sindain,bloodscalp,1327,hunter,marksmanship,36,20,16
Picaubica,kiljaeden,1327,hunter,marksmanship,69,31,38
Tonnyfab,ragnaros,1326,hunter,marksmanship,34,19,15
Leeshaarrow,moon-guard,1325,hunter,marksmanship,66,33,33
Uwuessy,illidan,1325,hunter,marksmanship,72,32,40
Bojob,azgalor,1324,hunter,marksmanship,69,37,32
Gniw,tichondrius,1324,hunter,marksmanship,39,16,23
Softhunter,tichondrius,1324,hunter,marksmanship,36,14,22
Murza,korgath,1323,hunter,marksmanship,24,15,9
Xhartanis,magtheridon,1323,hunter,marksmanship,63,31,32
Brienz,tichondrius,1322,hunter,marksmanship,24,14,10
Purpurkle,area-52,1322,hunter,marksmanship,60,31,29
Benme,illidan,1322,hunter,marksmanship,323,152,171
Dougv,stormrage,1322,hunter,marksmanship,30,14,16
Slanderous,korgath,1322,hunter,marksmanship,36,15,21
Kä,blackhand,1321,hunter,marksmanship,66,28,38
Ärtémisa,quelthalas,1320,hunter,marksmanship,41,22,19
Gstring,kelthuzad,1320,hunter,marksmanship,204,96,108
Tristiae,stormrage,1319,hunter,marksmanship,67,36,31
Swolfp,tichondrius,1319,hunter,marksmanship,58,23,35
Smoothbrain,khadgar,1318,hunter,marksmanship,70,28,42
Ilina,malorne,1317,hunter,marksmanship,24,14,10
Nemmises,proudmoore,1317,hunter,marksmanship,42,19,23
Dogezandalar,illidan,1317,hunter,marksmanship,40,18,22
Imineore,stormrage,1316,hunter,marksmanship,117,57,60
Explosief,area-52,1315,hunter,marksmanship,60,30,30
Chuvug,quelthalas,1315,hunter,marksmanship,30,14,16
Shooterzz,illidan,1314,hunter,marksmanship,33,21,12
Juicyjams,moon-guard,1313,hunter,marksmanship,42,22,20
Lookøut,moon-guard,1313,hunter,marksmanship,98,42,56
Zaheerz,sargeras,1312,hunter,marksmanship,36,16,20
Skullcracker,azralon,1309,hunter,marksmanship,42,16,26
Thirià,garona,1306,hunter,marksmanship,18,14,4
Phojuansixx,ghostlands,1305,hunter,marksmanship,62,32,30
Wolverhino,thrall,1304,hunter,marksmanship,48,21,27
Akomata,emerald-dream,1303,hunter,marksmanship,42,21,21
Cocobread,stormreaver,1303,hunter,marksmanship,48,21,27
Balun,sargeras,1303,hunter,marksmanship,66,28,38
Oattes,daggerspine,1303,hunter,marksmanship,34,14,20
Thaden,akama,1301,hunter,marksmanship,71,36,35
Revo,darkspear,1301,hunter,marksmanship,36,14,22
Caylix,sargeras,1300,hunter,marksmanship,48,21,27
Snewboy,malganis,1299,hunter,marksmanship,24,14,10
Celph,moon-guard,1299,hunter,marksmanship,48,20,28
Cullowhee,proudmoore,1299,hunter,marksmanship,35,14,21
Gunther,korgath,1296,hunter,marksmanship,30,14,16
Ahegoface,frostmourne,1295,hunter,marksmanship,60,21,39
Mensrea,illidan,1294,hunter,marksmanship,53,33,20
Hukkx,kalecgos,1294,hunter,marksmanship,56,24,32
Audioannie,thrall,1294,hunter,marksmanship,48,20,28
Urtthel,stormrage,1293,hunter,marksmanship,28,17,11
Picapaul,stormrage,1293,hunter,marksmanship,59,32,27
Arrowhoe,spinebreaker,1293,hunter,marksmanship,33,17,16
Huntnmaster,thrall,1293,hunter,marksmanship,30,14,16
Cobrag,tichondrius,1291,hunter,marksmanship,30,16,14
Mwprimus,darkspear,1290,hunter,marksmanship,56,26,30
Krattøs,bleeding-hollow,1290,hunter,marksmanship,38,17,21
Kazug,destromath,1290,hunter,marksmanship,36,16,20
Tinsho,drakkari,1289,hunter,marksmanship,39,18,21
Glediator,tichondrius,1288,hunter,marksmanship,112,51,61
Tenlbbow,illidan,1287,hunter,marksmanship,48,22,26
Eilleath,zuljin,1286,hunter,marksmanship,30,18,12
Duruainn,zuljin,1286,hunter,marksmanship,88,42,46
Ticey,frostmourne,1286,hunter,marksmanship,51,20,31
Vipermaster,azralon,1285,hunter,marksmanship,54,30,24
Aquastasia,aegwynn,1285,hunter,marksmanship,36,19,17
Ricas,malganis,1285,hunter,marksmanship,104,46,58
Kalibah,azralon,1285,hunter,marksmanship,81,30,51
Thickychan,illidan,1284,hunter,marksmanship,24,14,10
Spiketurtle,queldorei,1284,hunter,marksmanship,58,30,28
Juhyeon,tichondrius,1284,hunter,marksmanship,46,17,29
Goldenblade,shadowmoon,1283,hunter,marksmanship,33,14,19
Keedub,stormrage,1282,hunter,marksmanship,29,14,15
Kìkìjiki,emerald-dream,1281,hunter,marksmanship,30,16,14
Gromtheponch,area-52,1280,hunter,marksmanship,43,22,21
Loth,illidan,1279,hunter,marksmanship,34,19,15
Tracershot,malganis,1277,hunter,marksmanship,26,14,12
Jumaanji,gurubashi,1277,hunter,marksmanship,82,39,43
Lightweight,kelthuzad,1276,hunter,marksmanship,71,35,36
Albe,azralon,1276,hunter,marksmanship,93,45,48
Hokutoxx,tichondrius,1276,hunter,marksmanship,38,14,24
Tîpz,stormrage,1275,hunter,marksmanship,29,17,12
Clutchxx,tichondrius,1275,hunter,marksmanship,24,14,10
Uc,khadgar,1275,hunter,marksmanship,30,14,16
Sniperarmy,dalaran,1274,hunter,marksmanship,103,52,51
Darylovejr,destromath,1274,hunter,marksmanship,38,16,22
Blackhuntr,garona,1272,hunter,marksmanship,282,142,140
Nights,nemesis,1271,hunter,marksmanship,24,15,9
Milktoker,tichondrius,1270,hunter,marksmanship,42,20,22
Hunimi,elune,1270,hunter,marksmanship,38,16,22
Igopew,firetree,1268,hunter,marksmanship,48,23,25
Azaz,khaz-modan,1266,hunter,marksmanship,65,28,37
Xephert,ragnaros,1265,hunter,marksmanship,48,22,26
Birgite,stormrage,1265,hunter,marksmanship,54,21,33
Drillklinton,tichondrius,1262,hunter,marksmanship,53,24,29
Cloudbuck,aegwynn,1262,hunter,marksmanship,58,22,36
Snaafu,duskwood,1261,hunter,marksmanship,58,25,33
Trikshot,magtheridon,1259,hunter,marksmanship,66,35,31
Sóny,area-52,1258,hunter,marksmanship,32,18,14
Stoopkid,dunemaul,1255,hunter,marksmanship,32,15,17
Onehunnid,frostmourne,1254,hunter,marksmanship,30,16,14
Netorip,azralon,1254,hunter,marksmanship,44,21,23
Jerybery,gundrak,1253,hunter,marksmanship,29,18,11
Infamousorc,chogall,1251,hunter,marksmanship,82,36,46
Solomine,jubeithos,1251,hunter,marksmanship,36,15,21
Rattrap,proudmoore,1250,hunter,marksmanship,41,18,23
Brokenstars,illidan,1249,hunter,marksmanship,107,53,54
Ecbomb,tichondrius,1247,hunter,marksmanship,18,13,5
Mochigelato,kelthuzad,1247,hunter,marksmanship,30,13,17
Dest,azralon,1247,hunter,marksmanship,42,17,25
Ëzy,frostmourne,1246,hunter,marksmanship,66,36,30
Zota,frostmourne,1245,hunter,marksmanship,24,13,11
Tiofil,goldrinn,1244,hunter,marksmanship,72,41,31
Hoeswannafuk,stormrage,1243,hunter,marksmanship,24,13,11
Shooked,area-52,1242,hunter,marksmanship,24,13,11
Zock,lothar,1240,hunter,marksmanship,170,84,86
Shotpig,proudmoore,1240,hunter,marksmanship,30,13,17
Lavaun,eredar,1239,hunter,marksmanship,42,22,20
Lafleche,kiljaeden,1239,hunter,marksmanship,29,15,14
Critaclyzm,moon-guard,1238,hunter,marksmanship,49,22,27
Islachan,ragnaros,1238,hunter,marksmanship,30,13,17
Highershot,azralon,1237,hunter,marksmanship,18,13,5
Botoshooter,dragonmaw,1236,hunter,marksmanship,18,13,5
Kritsu,tichondrius,1236,hunter,marksmanship,59,30,29
Sootgarbage,sargeras,1235,hunter,marksmanship,18,13,5
Pokeyourbutt,hydraxis,1235,hunter,marksmanship,24,13,11
Wincolt,stormrage,1235,hunter,marksmanship,30,13,17
Tonichype,tichondrius,1235,hunter,marksmanship,30,13,17
Killz,skullcrusher,1234,hunter,marksmanship,50,24,26
Loathin,stormrage,1233,hunter,marksmanship,30,22,8
Lolknocked,alexstrasza,1233,hunter,marksmanship,27,14,13
Seenobody,stormrage,1233,hunter,marksmanship,118,60,58
Falconex,azralon,1233,hunter,marksmanship,30,13,17
Deathhshott,area-52,1232,hunter,marksmanship,41,22,19
Spyhunter,malganis,1232,hunter,marksmanship,103,45,58
Rocroc,gurubashi,1231,hunter,marksmanship,84,40,44
Oopsurtrappd,darkspear,1229,hunter,marksmanship,35,19,16
Malcab,tichondrius,1228,hunter,marksmanship,18,13,5
Ongorn,lightninghoof,1228,hunter,marksmanship,54,25,29
Snipezone,kelthuzad,1228,hunter,marksmanship,30,13,17
Chikkynuggy,destromath,1228,hunter,marksmanship,33,14,19
Mlzj,tichondrius,1225,hunter,marksmanship,24,13,11
Blimpbooty,stormrage,1225,hunter,marksmanship,30,13,17
Dandogg,tichondrius,1225,hunter,marksmanship,36,14,22
Searobot,kelthuzad,1224,hunter,marksmanship,24,13,11
Huntmeplz,proudmoore,1221,hunter,marksmanship,30,14,16
Wwing,frostwolf,1219,hunter,marksmanship,366,186,180
Seyd,barthilas,1216,hunter,marksmanship,51,21,30
Sukr,korgath,1215,hunter,marksmanship,98,37,61
Bärney,frostmourne,1214,hunter,marksmanship,24,13,11
Give,draktharon,1214,hunter,marksmanship,33,14,19
Tandope,sargeras,1213,hunter,marksmanship,35,13,22
Malkuri,medivh,1213,hunter,marksmanship,35,13,22
Puresport,hyjal,1212,hunter,marksmanship,24,13,11
Hyü,hyjal,1211,hunter,marksmanship,30,13,17
Escolhido,azralon,1209,hunter,marksmanship,89,43,46
Calî,stormscale,1209,hunter,marksmanship,36,17,19
Äce,khazgoroth,1208,hunter,marksmanship,30,13,17
Idiiot,sargeras,1206,hunter,marksmanship,89,42,47
Lunastrasza,moon-guard,1202,hunter,marksmanship,24,18,6
Augus,eredar,1202,hunter,marksmanship,41,15,26
Bowdown,moon-guard,1200,hunter,marksmanship,84,43,41
Kalgorn,emerald-dream,1200,hunter,marksmanship,30,13,17
Squarë,ragnaros,1200,hunter,marksmanship,35,13,22
Ashaelyn,wyrmrest-accord,1199,hunter,marksmanship,50,23,27
Bowtech,kelthuzad,1198,hunter,marksmanship,37,17,20
Vinranya,sargeras,1194,hunter,marksmanship,75,34,41
Moonet,amanthul,1192,hunter,marksmanship,29,16,13
Chaðs,amanthul,1190,hunter,marksmanship,39,21,18
Moüserat,moon-guard,1190,hunter,marksmanship,138,68,70
Rekshot,amanthul,1190,hunter,marksmanship,168,78,90
Kayzia,lightninghoof,1190,hunter,marksmanship,29,13,16
Valieev,black-dragonflight,1188,hunter,marksmanship,42,25,17
Ilovehippos,laughing-skull,1188,hunter,marksmanship,145,67,78
Forthethrill,area-52,1187,hunter,marksmanship,45,24,21
Yaboismokey,aerie-peak,1181,hunter,marksmanship,53,24,29
Ramdy,quelthalas,1180,hunter,marksmanship,30,14,16
Fova,wyrmrest-accord,1179,hunter,marksmanship,19,14,5
Greyk,moon-guard,1179,hunter,marksmanship,23,13,10
Doubletappz,stormreaver,1178,hunter,marksmanship,36,15,21
Chïnchïlla,zuljin,1176,hunter,marksmanship,27,14,13
Guarambare,ragnaros,1176,hunter,marksmanship,63,26,37
Silverweaver,illidan,1174,hunter,marksmanship,30,15,15
Ellishunter,frostmourne,1174,hunter,marksmanship,64,23,41
Taynen,azralon,1173,hunter,marksmanship,29,13,16
Tweak,ysera,1172,hunter,marksmanship,24,13,11
Shuweet,moon-guard,1172,hunter,marksmanship,60,22,38
Aftërlyfe,tichondrius,1170,hunter,marksmanship,29,14,15
Coolwhip,demon-soul,1170,hunter,marksmanship,55,25,30
Foxhe,hyjal,1167,hunter,marksmanship,54,29,25
Ragnarlobkk,ragnaros,1167,hunter,marksmanship,125,60,65
Patmypet,terenas,1167,hunter,marksmanship,30,14,16
Mezmore,thrall,1167,hunter,marksmanship,54,24,30
Jordanhunter,frostmourne,1167,hunter,marksmanship,35,14,21
Thyraza,proudmoore,1166,hunter,marksmanship,36,20,16
Ripmytoast,chogall,1166,hunter,marksmanship,213,111,102
Papiquezo,nagrand,1165,hunter,marksmanship,27,14,13
Wøllver,azralon,1164,hunter,marksmanship,26,14,12
Niteynite,duskwood,1163,hunter,marksmanship,24,13,11
Myrfes,ragnaros,1163,hunter,marksmanship,83,33,50
Redskul,azralon,1162,hunter,marksmanship,42,24,18
Richihunt,ragnaros,1161,hunter,marksmanship,44,16,28
Mídnîght,azralon,1161,hunter,marksmanship,39,14,25
Miscreant,kelthuzad,1160,hunter,marksmanship,32,13,19
Cu,frostmourne,1159,hunter,marksmanship,19,13,6
Flacidhunter,kelthuzad,1159,hunter,marksmanship,42,21,21
Ues,shuhalo,1158,hunter,marksmanship,25,14,11
Dyson,nordrassil,1158,hunter,marksmanship,30,16,14
Ackzar,ragnaros,1158,hunter,marksmanship,154,79,75
Whatsleft,area-52,1155,hunter,marksmanship,34,17,17
Enuk,nagrand,1155,hunter,marksmanship,109,51,58
Rhaygon,arthas,1154,hunter,marksmanship,57,20,37
Chetta,ragnaros,1153,hunter,marksmanship,71,29,42
Huntdawgg,illidan,1153,hunter,marksmanship,57,16,41
Buckethole,doomhammer,1152,hunter,marksmanship,60,28,32
Huataran,stormrage,1151,hunter,marksmanship,18,12,6
Negãn,tichondrius,1151,hunter,marksmanship,24,12,12
Taumelz,sargeras,1151,hunter,marksmanship,30,12,18
Cannondale,tichondrius,1150,hunter,marksmanship,18,12,6
Sunnimuffens,deathwing,1150,hunter,marksmanship,53,25,28
Summerrain,illidan,1149,hunter,marksmanship,18,12,6
Volga,haomarush,1149,hunter,marksmanship,64,30,34
Zuuvuya,nemesis,1149,hunter,marksmanship,56,20,36
Gnometoprace,illidan,1148,hunter,marksmanship,36,12,24
Amsalja,tichondrius,1147,hunter,marksmanship,62,28,34
Bullseated,nemesis,1145,hunter,marksmanship,24,12,12
Sugarboyy,darkspear,1145,hunter,marksmanship,39,19,20
Zensuox,barthilas,1143,hunter,marksmanship,24,12,12
Lilnatty,area-52,1143,hunter,marksmanship,33,13,20
Inability,emerald-dream,1142,hunter,marksmanship,30,12,18
Kimbaa,tichondrius,1142,hunter,marksmanship,30,12,18
Zachhunter,frostmourne,1141,hunter,marksmanship,54,20,34
Òriòn,tichondrius,1141,hunter,marksmanship,36,12,24
Waqz,tichondrius,1140,hunter,marksmanship,30,12,18
Diacachimbaa,ragnaros,1138,hunter,marksmanship,27,13,14
Trìggered,dark-iron,1136,hunter,marksmanship,60,31,29
Thundershots,tichondrius,1136,hunter,marksmanship,86,38,48
Drewshot,sargeras,1134,hunter,marksmanship,18,12,6
Aoolfs,stormrage,1133,hunter,marksmanship,96,45,51
Vhan,azralon,1133,hunter,marksmanship,44,19,25
Oqqo,tichondrius,1132,hunter,marksmanship,57,24,33
Gunshow,wyrmrest-accord,1131,hunter,marksmanship,30,12,18
Jarloo,madoran,1129,hunter,marksmanship,35,19,16
Bumpf,malganis,1129,hunter,marksmanship,30,14,16
Táká,quelthalas,1129,hunter,marksmanship,30,13,17
Peña,trollbane,1129,hunter,marksmanship,37,13,24
Abloodelf,zuljin,1128,hunter,marksmanship,30,12,18
Systane,mugthol,1127,hunter,marksmanship,18,12,6
Mayhunter,ragnaros,1127,hunter,marksmanship,31,14,17
Minzuki,drakkari,1127,hunter,marksmanship,30,13,17
Clockwörk,sargeras,1125,hunter,marksmanship,21,13,8
Martlz,tichondrius,1125,hunter,marksmanship,24,12,12
Queldana,drakkari,1124,hunter,marksmanship,30,12,18
Amanazàra,tichondrius,1123,hunter,marksmanship,84,41,43
Kanaká,moon-guard,1122,hunter,marksmanship,43,24,19
Pikochon,illidan,1121,hunter,marksmanship,77,30,47
Gramaverde,kelthuzad,1120,hunter,marksmanship,36,13,23
Emeri,winterhoof,1119,hunter,marksmanship,60,31,29
Mathund,gurubashi,1118,hunter,marksmanship,203,96,107
Starkmeister,stormrage,1118,hunter,marksmanship,30,12,18
Torvauk,bleeding-hollow,1116,hunter,marksmanship,30,12,18
Onekz,ragnaros,1115,hunter,marksmanship,65,24,41
Minihunter,onyxia,1114,hunter,marksmanship,59,30,29
Wixyy,aegwynn,1114,hunter,marksmanship,58,23,35
Grimbleneep,emerald-dream,1111,hunter,marksmanship,40,16,24
Deadlyattack,barthilas,1108,hunter,marksmanship,24,12,12
Tanephar,proudmoore,1107,hunter,marksmanship,42,18,24
Raneldar,proudmoore,1107,hunter,marksmanship,167,70,97
Halibut,quelthalas,1106,hunter,marksmanship,47,25,22
Rykár,kiljaeden,1106,hunter,marksmanship,24,12,12
Chainmaster,misha,1106,hunter,marksmanship,147,69,78
Clemenlemon,illidan,1105,hunter,marksmanship,42,20,22
Týrak,illidan,1100,hunter,marksmanship,24,12,12
Apaweclover,stormrage,1100,hunter,marksmanship,277,136,141
Vngadr,stormrage,1100,hunter,marksmanship,45,18,27
Bentrick,altar-of-storms,1097,hunter,marksmanship,33,18,15
Udietofast,illidan,1095,hunter,marksmanship,142,63,79
Killincrew,scilla,1093,hunter,marksmanship,56,26,30
Veranir,nemesis,1091,hunter,marksmanship,98,49,49
Mikeangel,hydraxis,1091,hunter,marksmanship,27,12,15
Malo,dragonmaw,1090,hunter,marksmanship,30,16,14
Bluecoral,frostmourne,1088,hunter,marksmanship,129,56,73
Angelacross,azralon,1087,hunter,marksmanship,54,26,28
Deathwynd,malfurion,1085,hunter,marksmanship,24,13,11
Porkerr,black-dragonflight,1084,hunter,marksmanship,59,32,27
Maxwel,sargeras,1082,hunter,marksmanship,175,86,89
Lezzbow,tichondrius,1081,hunter,marksmanship,61,32,29
Zarely,frostmourne,1081,hunter,marksmanship,41,20,21
Roseandra,stormrage,1081,hunter,marksmanship,47,19,28
Bemaa,frostmourne,1079,hunter,marksmanship,48,23,25
Ligmubhole,queldorei,1077,hunter,marksmanship,50,24,26
Yoimiya,thunderlord,1077,hunter,marksmanship,53,25,28
Remak,barthilas,1075,hunter,marksmanship,39,17,22
Gundolf,kargath,1075,hunter,marksmanship,30,12,18
Aïmïng,tichondrius,1074,hunter,marksmanship,42,14,28
Cßo,tichondrius,1073,hunter,marksmanship,96,43,53
Linedalina,wyrmrest-accord,1073,hunter,marksmanship,42,18,24
Pewpow,barthilas,1072,hunter,marksmanship,60,28,32
Mynnokyr,gallywix,1070,hunter,marksmanship,59,28,31
Towness,kelthuzad,1067,hunter,marksmanship,48,23,25
Returners,emerald-dream,1066,hunter,marksmanship,66,35,31
Floozyfairy,daggerspine,1066,hunter,marksmanship,92,42,50
Daytrade,stormrage,1065,hunter,marksmanship,52,26,26
Ryhew,emerald-dream,1063,hunter,marksmanship,42,16,26
Thoopered,korgath,1062,hunter,marksmanship,65,33,32
Baldor,stormrage,1062,hunter,marksmanship,72,31,41
Obsol,hyjal,1062,hunter,marksmanship,37,12,25
Piloks,gallywix,1058,hunter,marksmanship,50,24,26
Imperatrix,emerald-dream,1058,hunter,marksmanship,72,25,47
Repotro,drakkari,1057,hunter,marksmanship,57,20,37
Gvjellybeans,tichondrius,1056,hunter,marksmanship,18,11,7
Lexodream,bleeding-hollow,1056,hunter,marksmanship,18,11,7
Runsfromcops,sargeras,1056,hunter,marksmanship,18,11,7
Ryutiz,fizzcrank,1056,hunter,marksmanship,30,11,19
Galfhord,ragnaros,1056,hunter,marksmanship,54,17,37
Shayelin,frostmourne,1055,hunter,marksmanship,18,11,7
Thornshadow,steamwheedle-cartel,1055,hunter,marksmanship,24,12,12
Seyu,tichondrius,1055,hunter,marksmanship,24,11,13
Eratichunt,illidan,1055,hunter,marksmanship,30,11,19
Redzic,tichondrius,1054,hunter,marksmanship,18,11,7
Bringthewar,undermine,1054,hunter,marksmanship,30,15,15
Tharlor,aegwynn,1054,hunter,marksmanship,30,11,19
Enty,khazgoroth,1053,hunter,marksmanship,18,11,7
Ezx,moon-guard,1053,hunter,marksmanship,18,11,7
Zøkøtrøkø,ragnaros,1053,hunter,marksmanship,69,29,40
Alindra,zuluhed,1053,hunter,marksmanship,90,37,53
Samloomis,ursin,1053,hunter,marksmanship,30,11,19
Kazzanval,sargeras,1052,hunter,marksmanship,30,15,15
Benryats,area-52,1052,hunter,marksmanship,54,20,34
Guntrïx,stormrage,1052,hunter,marksmanship,36,11,25
Callenna,zuljin,1051,hunter,marksmanship,18,11,7
Westbrooke,illidan,1050,hunter,marksmanship,30,12,18
Mensita,quelthalas,1049,hunter,marksmanship,30,11,19
Murderone,undermine,1048,hunter,marksmanship,24,11,13
Exotichunter,the-underbog,1047,hunter,marksmanship,24,11,13
Vansatih,azralon,1047,hunter,marksmanship,66,27,39
Jakal,blackwater-raiders,1046,hunter,marksmanship,24,11,13
Lowk,stonemaul,1045,hunter,marksmanship,36,21,15
Secure,doomhammer,1045,hunter,marksmanship,72,34,38
Kánnah,ragnaros,1044,hunter,marksmanship,180,90,90
Fëanora,quelthalas,1044,hunter,marksmanship,24,11,13
Lyssavirhus,azralon,1040,hunter,marksmanship,24,12,12
Corruptid,moon-guard,1039,hunter,marksmanship,18,11,7
Ansone,nazjatar,1039,hunter,marksmanship,24,11,13
Tazent,moon-guard,1039,hunter,marksmanship,24,11,13
Deadalot,dalaran,1038,hunter,marksmanship,18,11,7
Jahir,tichondrius,1038,hunter,marksmanship,36,11,25
Iililillilii,tichondrius,1035,hunter,marksmanship,34,14,20
Sartros,drakkari,1034,hunter,marksmanship,19,13,6
Rottinghood,hyjal,1032,hunter,marksmanship,23,12,11
Ramblin,ragnaros,1032,hunter,marksmanship,36,16,20
Delukzin,azralon,1032,hunter,marksmanship,44,15,29
Huntnfizzle,dethecus,1031,hunter,marksmanship,18,11,7
Vendortrash,aggramar,1029,hunter,marksmanship,24,12,12
Talonwind,tanaris,1027,hunter,marksmanship,36,19,17
Silenciozzo,azralon,1026,hunter,marksmanship,42,17,25
Àlëxx,aegwynn,1024,hunter,marksmanship,60,23,37
Soulbutter,malganis,1023,hunter,marksmanship,18,11,7
Blaptz,wyrmrest-accord,1021,hunter,marksmanship,36,17,19
Madogite,azralon,1016,hunter,marksmanship,90,49,41
Shukucingjr,illidan,1015,hunter,marksmanship,39,23,16
Ritler,frostmourne,1014,hunter,marksmanship,28,14,14
Kødran,stormrage,1013,hunter,marksmanship,54,26,28
Zenwrath,illidan,1012,hunter,marksmanship,28,12,16
Jzander,ragnaros,1010,hunter,marksmanship,20,13,7
Derenit,ragnaros,1008,hunter,marksmanship,72,29,43
Killerxzxz,stormrage,1007,hunter,marksmanship,24,13,11
Desolateone,nazgrel,1006,hunter,marksmanship,62,34,28
Jvmr,azralon,1005,hunter,marksmanship,75,40,35
Salsa,hakkar,1005,hunter,marksmanship,107,39,68
Sumom,darrowmere,1004,hunter,marksmanship,218,103,115
Brenri,boulderfist,1003,hunter,marksmanship,30,15,15
Zengrin,quelthalas,1003,hunter,marksmanship,23,11,12
Thunter,kiljaeden,1002,hunter,marksmanship,30,15,15
Shotdown,suramar,1000,hunter,marksmanship,27,11,16
Koonorc,dalaran,998,hunter,marksmanship,46,22,24
Øparin,azralon,996,hunter,marksmanship,34,21,13
Triggaplease,jubeithos,994,hunter,marksmanship,78,42,36
Sitaelh,quelthalas,994,hunter,marksmanship,48,23,25
Broking,azralon,992,hunter,marksmanship,62,26,36
Balgair,hakkar,991,hunter,marksmanship,52,27,25
Scottcrume,area-52,990,hunter,marksmanship,72,33,39
Nelay,ragnaros,988,hunter,marksmanship,23,11,12
Kalinor,cenarius,988,hunter,marksmanship,66,30,36
Scubby,anetheron,988,hunter,marksmanship,28,12,16
Cruelhuntres,tichondrius,986,hunter,marksmanship,71,25,46
Huntercry,ragnaros,982,hunter,marksmanship,24,15,9
Xaveco,gallywix,982,hunter,marksmanship,64,26,38
Àbyss,shandris,982,hunter,marksmanship,48,18,30
Kuramax,senjin,979,hunter,marksmanship,115,52,63
Yadír,quelthalas,979,hunter,marksmanship,138,62,76
Adbéélitø,ragnaros,977,hunter,marksmanship,96,49,47
Tungles,tichondrius,977,hunter,marksmanship,41,15,26
Galaxxis,bonechewer,974,hunter,marksmanship,51,26,25
Iiwii,burning-legion,969,hunter,marksmanship,19,11,8
Tiidkloul,illidan,968,hunter,marksmanship,18,12,6
Reanivan,kiljaeden,968,hunter,marksmanship,66,24,42
Silhouettes,barthilas,967,hunter,marksmanship,57,27,30
Djpwnz,bladefist,967,hunter,marksmanship,54,18,36
Dmasterbiter,zuljin,966,hunter,marksmanship,31,11,20
Scoundrella,sargeras,963,hunter,marksmanship,78,37,41
Recebaa,barthilas,963,hunter,marksmanship,30,12,18
Hanabanana,wyrmrest-accord,960,hunter,marksmanship,12,10,2
Adjusted,frostmourne,960,hunter,marksmanship,12,10,2
Nainit,sargeras,960,hunter,marksmanship,18,10,8
Goonsh,tichondrius,960,hunter,marksmanship,18,10,8
Kagaramar,hellscream,960,hunter,marksmanship,21,11,10
Sylvaa,tichondrius,960,hunter,marksmanship,30,10,20
Throre,bleeding-hollow,959,hunter,marksmanship,18,10,8
Nelandris,tichondrius,959,hunter,marksmanship,72,28,44
Hunghang,frostmourne,959,hunter,marksmanship,30,10,20
Ñðñdêsçrípt,frostmourne,959,hunter,marksmanship,30,10,20
Cyboreg,stormrage,958,hunter,marksmanship,18,10,8
Austelos,moon-guard,958,hunter,marksmanship,18,10,8
Humiliation,mugthol,958,hunter,marksmanship,18,10,8
Shotfromhell,sargeras,958,hunter,marksmanship,27,10,17
Chasseür,quelthalas,957,hunter,marksmanship,18,10,8
Lanarhoades,firetree,957,hunter,marksmanship,18,10,8
Graid,azralon,957,hunter,marksmanship,24,10,14
Thunderox,tichondrius,957,hunter,marksmanship,36,11,25
Starsworn,moon-guard,956,hunter,marksmanship,18,10,8
Zhions,ragnaros,956,hunter,marksmanship,18,10,8
Blamethenaga,sargeras,956,hunter,marksmanship,18,10,8
Zulorion,the-forgotten-coast,956,hunter,marksmanship,24,10,14
Aewyn,malganis,956,hunter,marksmanship,24,10,14
Arcticwôlf,ragnaros,956,hunter,marksmanship,30,10,20
Sparemeok,illidan,955,hunter,marksmanship,18,10,8
Goatshots,lightninghoof,955,hunter,marksmanship,24,10,14
Jxoxex,wildhammer,955,hunter,marksmanship,30,12,18
Daymanaahh,malfurion,954,hunter,marksmanship,24,10,14
Twist,burning-legion,953,hunter,marksmanship,12,10,2
Damadar,tichondrius,953,hunter,marksmanship,24,10,14
Valane,ragnaros,953,hunter,marksmanship,30,10,20
Mailmann,skywall,952,hunter,marksmanship,30,17,13
Getnukedbud,emerald-dream,952,hunter,marksmanship,18,10,8
Ragar,korialstrasz,952,hunter,marksmanship,24,10,14
Verdao,stormrage,952,hunter,marksmanship,30,10,20
Hishamo,aggramar,951,hunter,marksmanship,12,10,2
Lathrop,runetotem,950,hunter,marksmanship,18,10,8
Vanhe,quelthalas,947,hunter,marksmanship,18,10,8
Kidofdeath,borean-tundra,947,hunter,marksmanship,18,10,8
Momomomo,draka,947,hunter,marksmanship,24,10,14
Globlauncher,tichondrius,946,hunter,marksmanship,18,10,8
Prozerpine,tichondrius,946,hunter,marksmanship,30,10,20
Skarioth,azralon,945,hunter,marksmanship,18,10,8
Ontarget,cairne,944,hunter,marksmanship,90,42,48
Alorick,ragnaros,944,hunter,marksmanship,30,10,20
Mirãbel,drakkari,944,hunter,marksmanship,48,14,34
Tazmaniak,gorefiend,942,hunter,marksmanship,24,10,14
Herroo,thrall,938,hunter,marksmanship,36,10,26
Arïya,azralon,936,hunter,marksmanship,18,10,8
Lazygnome,azshara,934,hunter,marksmanship,23,11,12
Konar,nemesis,934,hunter,marksmanship,123,53,70
Ud,eldrethalas,931,hunter,marksmanship,18,12,6
Nachtcloverr,stormrage,931,hunter,marksmanship,63,27,36
Jamzlol,frostmourne,930,hunter,marksmanship,23,14,9
Caraméla,stormrage,927,hunter,marksmanship,22,10,12
Sungold,dathremar,926,hunter,marksmanship,14,11,3
Brenogam,azralon,922,hunter,marksmanship,64,32,32
Torturekilla,bleeding-hollow,922,hunter,marksmanship,75,34,41
Wael,perenolde,920,hunter,marksmanship,29,10,19
Katnie,azralon,919,hunter,marksmanship,70,32,38
Vaerromar,thunderlord,918,hunter,marksmanship,24,13,11
Yamanashi,black-dragonflight,914,hunter,marksmanship,120,59,61
Lauannÿ,gallywix,914,hunter,marksmanship,147,68,79
Styles,thaurissan,907,hunter,marksmanship,54,22,32
Blaws,tichondrius,906,hunter,marksmanship,27,10,17
Onehitrip,illidan,904,hunter,marksmanship,90,38,52
Dartháne,moon-guard,904,hunter,marksmanship,45,17,28
Fourtwents,stormrage,901,hunter,marksmanship,25,10,15
Flechá,illidan,900,hunter,marksmanship,17,10,7
Franzkafka,azralon,899,hunter,marksmanship,78,36,42
Huntercotoco,azralon,896,hunter,marksmanship,48,25,23
Onlyphanz,darkspear,894,hunter,marksmanship,20,10,10
Bont,jubeithos,893,hunter,marksmanship,17,10,7
Braddocky,azralon,889,hunter,marksmanship,21,11,10
Fourkayiv,azgalor,889,hunter,marksmanship,41,18,23
Typh,saurfang,888,hunter,marksmanship,23,10,13
Motommotto,deathwing,887,hunter,marksmanship,30,14,16
Fleshfair,kiljaeden,886,hunter,marksmanship,75,32,43
Murozz,malganis,884,hunter,marksmanship,37,18,19
Alleessa,goldrinn,883,hunter,marksmanship,54,21,33
Viciosa,bleeding-hollow,882,hunter,marksmanship,78,40,38
Jetlinx,thrall,881,hunter,marksmanship,21,12,9
Nightwatch,kelthuzad,877,hunter,marksmanship,18,10,8
Zettl,eredar,877,hunter,marksmanship,166,75,91
Thaendra,moon-guard,865,hunter,marksmanship,23,11,12
Qthunterr,dalaran,864,hunter,marksmanship,12,9,3
Zulla,bleeding-hollow,864,hunter,marksmanship,12,9,3
Decohunter,tichondrius,864,hunter,marksmanship,18,9,9
Rangêr,frostmourne,864,hunter,marksmanship,18,9,9
Deletedyou,tichondrius,864,hunter,marksmanship,18,9,9
Ashx,nemesis,864,hunter,marksmanship,18,9,9
Drãgenox,quelthalas,864,hunter,marksmanship,24,9,15
Keenz,frostmourne,864,hunter,marksmanship,24,9,15
Scareder,malganis,864,hunter,marksmanship,24,9,15
Xonios,frostwolf,864,hunter,marksmanship,24,9,15
Singletap,barthilas,864,hunter,marksmanship,24,9,15
Trapkeithx,frostmourne,864,hunter,marksmanship,24,9,15
Tetz,kelthuzad,864,hunter,marksmanship,30,9,21
Demolitions,kelthuzad,864,hunter,marksmanship,30,9,21
Najmoira,area-52,864,hunter,marksmanship,30,9,21
Rambot,bleeding-hollow,863,hunter,marksmanship,12,9,3
Ultrasj,malfurion,863,hunter,marksmanship,18,9,9
Torrthack,area-52,863,hunter,marksmanship,18,9,9
Ohifren,proudmoore,863,hunter,marksmanship,18,9,9
Telånnas,illidan,863,hunter,marksmanship,18,9,9
Dayanier,ragnaros,863,hunter,marksmanship,18,9,9
Dôntlosmebro,stormrage,863,hunter,marksmanship,18,9,9
Ojmo,arthas,863,hunter,marksmanship,24,9,15
Nosmoke,kargath,863,hunter,marksmanship,24,9,15
Fangs,arthas,862,hunter,marksmanship,12,9,3
Airpodpro,emerald-dream,862,hunter,marksmanship,12,9,3
Syrach,area-52,862,hunter,marksmanship,18,9,9
Bigvudu,illidan,862,hunter,marksmanship,18,9,9
Insgesicht,proudmoore,862,hunter,marksmanship,24,9,15
Varrinda,wyrmrest-accord,862,hunter,marksmanship,24,9,15
Diertz,area-52,862,hunter,marksmanship,24,9,15
Feltz,moon-guard,861,hunter,marksmanship,18,9,9
Jagwaar,malganis,861,hunter,marksmanship,24,9,15
Zarkul,tichondrius,861,hunter,marksmanship,24,9,15
Snipastyle,twisting-nether,861,hunter,marksmanship,30,9,21
Illt,blackrock,860,hunter,marksmanship,18,9,9
Skedd,wyrmrest-accord,860,hunter,marksmanship,18,9,9
Twistedtawl,area-52,860,hunter,marksmanship,18,9,9
Junka,bleeding-hollow,860,hunter,marksmanship,18,9,9
Tekkerz,tichondrius,860,hunter,marksmanship,19,9,10
Jackrandall,frostmourne,860,hunter,marksmanship,24,9,15
Kaeuljua,tichondrius,860,hunter,marksmanship,24,9,15
Lánárhóádés,tichondrius,860,hunter,marksmanship,24,9,15
Kluetus,sargeras,859,hunter,marksmanship,12,9,3
Loyalrely,tichondrius,859,hunter,marksmanship,18,9,9
Smokezy,barthilas,859,hunter,marksmanship,18,9,9
Arzant,quelthalas,858,hunter,marksmanship,12,9,3
Wolftracer,sargeras,858,hunter,marksmanship,18,9,9
Coldhunger,uldum,857,hunter,marksmanship,12,9,3
Raxa,shuhalo,857,hunter,marksmanship,18,9,9
Banhunter,tichondrius,857,hunter,marksmanship,18,9,9
Ëz,ragnaros,857,hunter,marksmanship,18,9,9
Lahyanhou,azjolnerub,857,hunter,marksmanship,24,9,15
Lws,ragnaros,856,hunter,marksmanship,12,9,3
Hobbës,kelthuzad,856,hunter,marksmanship,18,9,9
Lameshot,dalaran,856,hunter,marksmanship,24,9,15
Skillkiting,area-52,856,hunter,marksmanship,30,9,21
Panborikat,thaurissan,855,hunter,marksmanship,36,16,20
Azx,tichondrius,851,hunter,marksmanship,18,9,9
Avindal,greymane,850,hunter,marksmanship,18,9,9
Dragonlandy,stormrage,848,hunter,marksmanship,24,9,15
Heapstack,stormrage,845,hunter,marksmanship,42,15,27
Cazadorelite,tichondrius,845,hunter,marksmanship,79,24,55
Arshuntica,blackrock,840,hunter,marksmanship,60,28,32
Zievieda,hellscream,840,hunter,marksmanship,35,15,20
Ramblinon,bloodhoof,840,hunter,marksmanship,30,11,19
Apochuntz,greymane,839,hunter,marksmanship,24,11,13
Zelanst,illidan,838,hunter,marksmanship,18,9,9
Oorudun,hellscream,838,hunter,marksmanship,59,26,33
Euphylesz,garrosh,836,hunter,marksmanship,22,9,13
Tkrenshaw,proudmoore,831,hunter,marksmanship,17,9,8
Vaelanor,destromath,831,hunter,marksmanship,24,11,13
Cio,fizzcrank,831,hunter,marksmanship,24,9,15
Mawlotov,barthilas,829,hunter,marksmanship,29,9,20
Baruz,tichondrius,827,hunter,marksmanship,28,9,19
Póra,stormrage,826,hunter,marksmanship,29,11,18
Dairoxd,drakkari,825,hunter,marksmanship,59,25,34
Muggzzy,malygos,824,hunter,marksmanship,18,9,9
Deejwithabow,frostmourne,815,hunter,marksmanship,18,9,9
Déadlyshot,tichondrius,814,hunter,marksmanship,89,39,50
Mohz,kiljaeden,814,hunter,marksmanship,29,9,20
ßonßon,stormrage,811,hunter,marksmanship,22,9,13
Skyloss,illidan,811,hunter,marksmanship,66,23,43
Iamtotoro,area-52,809,hunter,marksmanship,28,9,19
Snäpträp,stormrage,807,hunter,marksmanship,15,9,6
Axtlas,moonrunner,805,hunter,marksmanship,18,9,9
Hoarf,nemesis,799,hunter,marksmanship,14,9,5
Ifeignalot,stormscale,799,hunter,marksmanship,16,9,7
Ciils,sargeras,798,hunter,marksmanship,22,9,13
Fian,lightnings-blade,797,hunter,marksmanship,22,9,13
Qúin,frostmourne,797,hunter,marksmanship,29,10,19
Brody,eitrigg,785,hunter,marksmanship,22,9,13
Krossx,thrall,781,hunter,marksmanship,18,9,9
Karazuba,ragnaros,777,hunter,marksmanship,104,37,67
Getkited,tichondrius,773,hunter,marksmanship,22,10,12
Wij,turalyon,770,hunter,marksmanship,36,12,24
Ganeva,sargeras,769,hunter,marksmanship,75,28,47
Tamsynn,stormreaver,769,hunter,marksmanship,54,15,39
Entrapment,stormrage,768,hunter,marksmanship,12,8,4
Ragshunt,stormrage,768,hunter,marksmanship,12,8,4
Songhammer,tichondrius,768,hunter,marksmanship,18,8,10
Achillez,bleeding-hollow,768,hunter,marksmanship,18,8,10
Bonquiesha,area-52,768,hunter,marksmanship,24,8,16
Woeisyou,stormrage,768,hunter,marksmanship,24,8,16
Soul,sargeras,768,hunter,marksmanship,24,8,16
Civvo,dalaran,768,hunter,marksmanship,24,8,16
Wolfmilkers,illidan,767,hunter,marksmanship,12,8,4
Thrandrial,smolderthorn,767,hunter,marksmanship,12,8,4
Connovar,nemesis,767,hunter,marksmanship,12,8,4
Côckblocked,tichondrius,767,hunter,marksmanship,12,8,4
Arttemiss,zangarmarsh,767,hunter,marksmanship,12,8,4
Spiderham,tichondrius,767,hunter,marksmanship,12,8,4
Melkmane,emerald-dream,767,hunter,marksmanship,12,8,4
Fhodhaz,nemesis,767,hunter,marksmanship,12,8,4
Harlory,moon-guard,767,hunter,marksmanship,12,8,4
Suyesh,tichondrius,767,hunter,marksmanship,12,8,4
Cimotsw,stormrage,767,hunter,marksmanship,12,8,4
Hunterll,tichondrius,767,hunter,marksmanship,12,8,4
Handlez,gundrak,767,hunter,marksmanship,12,8,4
Wike,hyjal,767,hunter,marksmanship,15,9,6
Vileplumè,stormrage,767,hunter,marksmanship,18,8,10
Ravanskull,burning-blade,767,hunter,marksmanship,18,8,10
Xtina,drakkari,767,hunter,marksmanship,18,8,10
Cufless,proudmoore,767,hunter,marksmanship,18,8,10
Runethkape,kelthuzad,767,hunter,marksmanship,18,8,10
Thejessiah,tichondrius,767,hunter,marksmanship,18,8,10
Yory,tol-barad,767,hunter,marksmanship,18,8,10
Kyler,draka,767,hunter,marksmanship,18,8,10
Kynigi,bleeding-hollow,767,hunter,marksmanship,18,8,10
Rumnaheim,nemesis,767,hunter,marksmanship,18,8,10
Fjdominador,azralon,767,hunter,marksmanship,18,8,10
Clo,illidan,767,hunter,marksmanship,18,8,10
Rickshaw,frostmourne,767,hunter,marksmanship,18,8,10
Mhortaì,stormrage,767,hunter,marksmanship,21,9,12
Rizzbow,dalvengyr,767,hunter,marksmanship,24,8,16
Tarah,lightbringer,767,hunter,marksmanship,24,8,16
Saltz,tichondrius,766,hunter,marksmanship,12,8,4
Mööky,frostmourne,766,hunter,marksmanship,12,8,4
Noeffort,frostmourne,766,hunter,marksmanship,18,8,10
Grimdrakk,zuljin,766,hunter,marksmanship,18,8,10
Årcter,alexstrasza,766,hunter,marksmanship,18,8,10
Blackbrute,nathrezim,766,hunter,marksmanship,18,8,10
Trochillidae,dragonmaw,766,hunter,marksmanship,18,8,10
Raiku,aggramar,766,hunter,marksmanship,18,8,10
Zèd,azralon,766,hunter,marksmanship,18,8,10
Deathspot,thrall,766,hunter,marksmanship,18,8,10
Zindula,malganis,766,hunter,marksmanship,19,8,11
Kaelhim,warsong,766,hunter,marksmanship,24,8,16
Tonyhunter,nemesis,766,hunter,marksmanship,24,8,16
Basticus,blackwater-raiders,765,hunter,marksmanship,12,8,4
Brosk,drakthul,765,hunter,marksmanship,18,8,10
Lìlleth,thrall,765,hunter,marksmanship,18,8,10
Mfjl,tichondrius,765,hunter,marksmanship,18,8,10
Löbo,quelthalas,765,hunter,marksmanship,21,9,12
Dhar,eldrethalas,765,hunter,marksmanship,21,9,12
Evilslaug,tichondrius,765,hunter,marksmanship,20,8,12
Youngpo,thunderlord,765,hunter,marksmanship,24,8,16
Kòng,quelthalas,765,hunter,marksmanship,24,8,16
Ididntdoit,blackhand,765,hunter,marksmanship,24,8,16
Daahm,malganis,765,hunter,marksmanship,25,8,17
Myciri,proudmoore,764,hunter,marksmanship,18,8,10
Bionix,sargeras,764,hunter,marksmanship,18,8,10
Sinsix,akama,763,hunter,marksmanship,18,8,10
Kluako,stormreaver,762,hunter,marksmanship,12,8,4
Thisguÿ,arthas,762,hunter,marksmanship,18,8,10
Sorid,medivh,761,hunter,marksmanship,12,8,4
Emptypokcets,shattered-hand,761,hunter,marksmanship,24,8,16
Enonoa,thunderlord,760,hunter,marksmanship,12,8,4
Krane,alleria,760,hunter,marksmanship,18,8,10
Arbeis,area-52,758,hunter,marksmanship,78,24,54
Porta,zuljin,757,hunter,marksmanship,16,9,7
Staudt,emerald-dream,757,hunter,marksmanship,18,8,10
Aeclpysis,dark-iron,754,hunter,marksmanship,18,10,8
Niceshotboi,azgalor,751,hunter,marksmanship,24,8,16
Lynnì,khadgar,750,hunter,marksmanship,18,8,10
Darkmaximus,echo-isles,750,hunter,marksmanship,24,8,16
Xshadowdemon,korgath,749,hunter,marksmanship,12,8,4
Aksalaz,area-52,749,hunter,marksmanship,17,8,9
Skatenos,tortheldrin,746,hunter,marksmanship,18,8,10
Damnnicebutt,borean-tundra,746,hunter,marksmanship,26,10,16
Belieli,ragnaros,740,hunter,marksmanship,22,8,14
Mackin,maelstrom,740,hunter,marksmanship,24,8,16
Lennfear,frostmourne,739,hunter,marksmanship,24,8,16
Jux,shadowmoon,734,hunter,marksmanship,23,8,15
Elchavo,malganis,733,hunter,marksmanship,17,8,9
Archemp,stormrage,729,hunter,marksmanship,27,8,19
Rödrigö,azralon,726,hunter,marksmanship,34,16,18
Chicatatuada,ragnaros,720,hunter,marksmanship,15,9,6
Äzrael,elune,719,hunter,marksmanship,35,10,25
Setepalms,azralon,718,hunter,marksmanship,17,8,9
Mayohater,sargeras,714,hunter,marksmanship,33,9,24
Huntersuck,burning-blade,703,hunter,marksmanship,11,8,3
Andalora,malganis,703,hunter,marksmanship,11,8,3
Dainsleif,perenolde,703,hunter,marksmanship,16,8,8
Dasvydanya,illidan,702,hunter,marksmanship,19,9,10
Glokrag,ysera,702,hunter,marksmanship,20,8,12
Sylanthia,sargeras,701,hunter,marksmanship,14,8,6
Fizzleshot,malganis,699,hunter,marksmanship,18,8,10
Felkrozzul,kalecgos,672,hunter,marksmanship,9,8,1
Boxpatrol,ravencrest,672,hunter,marksmanship,12,7,5
Kookh,area-52,672,hunter,marksmanship,12,7,5
Bárd,tichondrius,672,hunter,marksmanship,12,7,5
Kaznik,ragnaros,672,hunter,marksmanship,12,7,5
Titzyø,area-52,672,hunter,marksmanship,12,7,5
Mms,frostmourne,672,hunter,marksmanship,12,7,5
Goosejuicer,emerald-dream,672,hunter,marksmanship,12,7,5
Keboks,alleria,672,hunter,marksmanship,12,7,5
Mörgoth,quelthalas,672,hunter,marksmanship,12,7,5
Shotmaster,tichondrius,672,hunter,marksmanship,12,7,5
Kaptincrunch,skywall,672,hunter,marksmanship,12,7,5
Winotah,barthilas,672,hunter,marksmanship,12,7,5
Relapse,dreadmaul,672,hunter,marksmanship,12,7,5
Topgronk,tichondrius,672,hunter,marksmanship,12,7,5
Raktama,proudmoore,672,hunter,marksmanship,12,7,5
Ehnub,stormrage,672,hunter,marksmanship,12,7,5
Hyrus,shadowmoon,672,hunter,marksmanship,12,7,5
Vixaria,illidan,672,hunter,marksmanship,12,7,5
Luoshi,proudmoore,672,hunter,marksmanship,12,7,5
Mochaxd,stormrage,672,hunter,marksmanship,14,7,7
Segfault,korgath,672,hunter,marksmanship,16,7,9
Womdalekk,azralon,672,hunter,marksmanship,18,7,11
Lexandra,quelthalas,672,hunter,marksmanship,18,7,11
Trapshootjk,area-52,672,hunter,marksmanship,18,7,11
Mondlicht,tichondrius,672,hunter,marksmanship,18,7,11
Lökeii,area-52,672,hunter,marksmanship,18,7,11
Bombanodos,kelthuzad,672,hunter,marksmanship,18,7,11
Focusfire,khazgoroth,672,hunter,marksmanship,18,7,11
Ping,tol-barad,672,hunter,marksmanship,18,7,11
Phatshiet,anvilmar,672,hunter,marksmanship,18,7,11
Trappah,stormrage,672,hunter,marksmanship,18,7,11
Darkasacin,wyrmrest-accord,672,hunter,marksmanship,18,7,11
Jimryl,illidan,672,hunter,marksmanship,18,7,11
Tirrill,malganis,672,hunter,marksmanship,18,7,11
Clawdio,ragnaros,672,hunter,marksmanship,18,7,11
Bigkolache,zuljin,672,hunter,marksmanship,24,7,17
Bigzane,darkspear,672,hunter,marksmanship,24,7,17
Datbigbowdoe,illidan,672,hunter,marksmanship,24,7,17
Gotskill,lethon,672,hunter,marksmanship,24,7,17
Wasteyou,tichondrius,671,hunter,marksmanship,12,7,5
Foxyevermew,tichondrius,671,hunter,marksmanship,12,7,5
Xhare,stormrage,671,hunter,marksmanship,12,7,5
Halford,tol-barad,671,hunter,marksmanship,12,7,5
Zelonas,emerald-dream,671,hunter,marksmanship,12,7,5
Ethne,garithos,671,hunter,marksmanship,12,7,5
Ocui,ragnaros,671,hunter,marksmanship,12,7,5
Kneecrippler,proudmoore,671,hunter,marksmanship,12,7,5
Jaganshot,tol-barad,671,hunter,marksmanship,12,7,5
Bungee,dentarg,671,hunter,marksmanship,12,7,5
Neoxbow,wyrmrest-accord,671,hunter,marksmanship,12,7,5
Vatits,dalaran,671,hunter,marksmanship,12,7,5
Hannover,ragnaros,671,hunter,marksmanship,12,7,5
Thekilla,ragnaros,671,hunter,marksmanship,12,7,5
Sunyourmom,proudmoore,671,hunter,marksmanship,12,7,5
Geraldson,proudmoore,671,hunter,marksmanship,12,7,5
Raposo,nemesis,671,hunter,marksmanship,12,7,5
Shootbert,malganis,671,hunter,marksmanship,12,7,5
Texploto,area-52,671,hunter,marksmanship,12,7,5
Toesgoes,thrall,671,hunter,marksmanship,18,7,11
Navagee,tichondrius,671,hunter,marksmanship,18,7,11
Lyricly,lightbringer,671,hunter,marksmanship,18,7,11
Atallstalker,sargeras,671,hunter,marksmanship,18,7,11
Sáns,sargeras,671,hunter,marksmanship,18,7,11
Schbaltz,tichondrius,671,hunter,marksmanship,18,7,11
Bstic,quelthalas,671,hunter,marksmanship,18,7,11
Feignmilf,tichondrius,671,hunter,marksmanship,18,7,11
Furrhunter,tichondrius,671,hunter,marksmanship,18,7,11
Stingyshot,thrall,671,hunter,marksmanship,18,7,11
Bowsbéforhos,stormrage,671,hunter,marksmanship,18,7,11
Såvagehunter,malganis,671,hunter,marksmanship,18,7,11
Zhetsu,cenarius,671,hunter,marksmanship,18,7,11
Kalizra,quelthalas,671,hunter,marksmanship,18,7,11
Prpl,sargeras,671,hunter,marksmanship,27,8,19
Temara,icecrown,671,hunter,marksmanship,24,7,17
Ohimissyou,emerald-dream,671,hunter,marksmanship,24,7,17
Kìngjaybroni,sargeras,670,hunter,marksmanship,12,7,5
Untermench,tichondrius,670,hunter,marksmanship,12,7,5
Joogeenda,kaelthas,670,hunter,marksmanship,12,7,5
Cócaine,tichondrius,670,hunter,marksmanship,19,8,11
Gagau,stormrage,670,hunter,marksmanship,18,7,11
Wolfyyxx,stormrage,670,hunter,marksmanship,18,7,11
Ownshot,kiljaeden,670,hunter,marksmanship,18,7,11
Nellond,malganis,670,hunter,marksmanship,18,7,11
Gemky,ragnaros,670,hunter,marksmanship,25,8,17
Bartolomeu,kirin-tor,669,hunter,marksmanship,12,7,5
Johnwayne,alterac-mountains,669,hunter,marksmanship,22,8,14
Pucky,quelthalas,669,hunter,marksmanship,24,7,17
Lostkníght,ragnaros,669,hunter,marksmanship,30,7,23
Lilzoomer,barthilas,668,hunter,marksmanship,12,7,5
Lionnheart,wyrmrest-accord,668,hunter,marksmanship,12,7,5
Roboputa,quelthalas,667,hunter,marksmanship,18,7,11
Mulnaaj,zuljin,666,hunter,marksmanship,24,7,17
Mahty,stormrage,665,hunter,marksmanship,12,7,5
Blåckhat,frostmourne,665,hunter,marksmanship,36,7,29
Bowzo,emerald-dream,663,hunter,marksmanship,18,7,11
Steelfeather,hellscream,662,hunter,marksmanship,12,7,5
Lulaladraun,azralon,662,hunter,marksmanship,24,7,17
Twofeathers,wyrmrest-accord,659,hunter,marksmanship,18,7,11
Fearsabyss,stormrage,655,hunter,marksmanship,18,7,11
Cassîdy,quelthalas,651,hunter,marksmanship,24,7,17
Righthole,area-52,640,hunter,marksmanship,22,7,15
Atraksis,thrall,623,hunter,marksmanship,11,7,4
Grukar,tichondrius,623,hunter,marksmanship,17,7,10
Muerteaterry,ragnaros,618,hunter,marksmanship,18,8,10
Mesiauzx,stormrage,618,hunter,marksmanship,22,9,13
Tinylegzz,illidan,617,hunter,marksmanship,26,8,18
Maveraxx,executus,616,hunter,marksmanship,21,7,14
Kushminion,zuljin,607,hunter,marksmanship,14,9,5
Ròllinafatty,dark-iron,607,hunter,marksmanship,14,7,7
Almighty,trollbane,597,hunter,marksmanship,47,11,36
Jonsnow,lightnings-blade,594,hunter,marksmanship,27,9,18
Jpynovisa,moon-guard,576,hunter,marksmanship,12,6,6
Dranel,nordrassil,576,hunter,marksmanship,12,6,6
Ysoseriusg,area-52,576,hunter,marksmanship,12,6,6
Aurzwraek,proudmoore,576,hunter,marksmanship,12,6,6
Kangar,senjin,576,hunter,marksmanship,12,6,6
Therana,duskwood,576,hunter,marksmanship,12,6,6
Donotrunaway,ragnaros,576,hunter,marksmanship,12,6,6
Zaamsa,ragnaros,576,hunter,marksmanship,12,6,6
Spanerd,moon-guard,576,hunter,marksmanship,12,6,6
Küngen,zuljin,576,hunter,marksmanship,12,6,6
Viralshot,tichondrius,576,hunter,marksmanship,12,6,6
Trapwiz,firetree,576,hunter,marksmanship,12,6,6
Vigero,proudmoore,576,hunter,marksmanship,12,6,6
Nightgecko,elune,576,hunter,marksmanship,12,6,6
Skum,tichondrius,576,hunter,marksmanship,12,6,6
Soxstayon,tichondrius,576,hunter,marksmanship,12,6,6
Êlautismo,wyrmrest-accord,576,hunter,marksmanship,12,6,6
Kyudo,moon-guard,576,hunter,marksmanship,12,6,6
Aoti,nerzhul,576,hunter,marksmanship,12,6,6
Talanar,ragnaros,576,hunter,marksmanship,12,6,6
Groomme,area-52,576,hunter,marksmanship,12,6,6
Birbwatcher,moon-guard,576,hunter,marksmanship,12,6,6
Cubecrawler,skullcrusher,576,hunter,marksmanship,12,6,6
Pandaslayr,garrosh,576,hunter,marksmanship,12,6,6
Mdizzly,zuljin,576,hunter,marksmanship,12,6,6
Xohzabu,wyrmrest-accord,576,hunter,marksmanship,12,6,6
Gugubird,proudmoore,576,hunter,marksmanship,12,6,6
Nerfmeplezz,area-52,576,hunter,marksmanship,12,6,6
Laurenx,illidan,576,hunter,marksmanship,12,6,6
Ishootpeople,illidan,576,hunter,marksmanship,12,6,6
Cù,frostmourne,576,hunter,marksmanship,12,6,6
Pulso,illidan,576,hunter,marksmanship,12,6,6
Klepa,illidan,576,hunter,marksmanship,12,6,6
Warblez,spinebreaker,576,hunter,marksmanship,12,6,6
Elmozz,thrall,576,hunter,marksmanship,12,6,6
Koridelse,nemesis,576,hunter,marksmanship,12,6,6
Rhunakk,emerald-dream,576,hunter,marksmanship,12,6,6
Gritzix,frostmourne,576,hunter,marksmanship,12,6,6
Vicecheney,illidan,576,hunter,marksmanship,12,6,6
Vårelse,sargeras,576,hunter,marksmanship,12,6,6
Hyjix,stormrage,576,hunter,marksmanship,12,6,6
Huntkillerx,illidan,576,hunter,marksmanship,12,6,6
Juwannaaim,lethon,576,hunter,marksmanship,12,6,6
Illine,azralon,576,hunter,marksmanship,12,6,6
Xernen,thrall,576,hunter,marksmanship,12,6,6
Rockehm,frostmourne,576,hunter,marksmanship,12,6,6
Ssds,sargeras,576,hunter,marksmanship,12,6,6
Arenthius,lothar,576,hunter,marksmanship,12,6,6
Tokez,moon-guard,576,hunter,marksmanship,14,6,8
Mojopojo,tichondrius,576,hunter,marksmanship,18,7,11
Lightbullet,kelthuzad,576,hunter,marksmanship,18,6,12
Shcrimps,proudmoore,576,hunter,marksmanship,18,6,12
Valro,hyjal,576,hunter,marksmanship,18,6,12
Aaggros,sargeras,576,hunter,marksmanship,18,6,12
Vanir,stormscale,576,hunter,marksmanship,24,6,18
Jônathan,tichondrius,576,hunter,marksmanship,24,6,18
Muckenfoose,frostmourne,575,hunter,marksmanship,12,6,6
Lagginwaggin,azgalor,575,hunter,marksmanship,12,6,6
Pumpum,malganis,575,hunter,marksmanship,12,6,6
Taphh,moon-guard,575,hunter,marksmanship,12,6,6
Thehunturd,dalaran,575,hunter,marksmanship,12,6,6
Projectilez,sargeras,575,hunter,marksmanship,12,6,6
Kazes,stormrage,575,hunter,marksmanship,12,6,6
Cerrundan,icecrown,575,hunter,marksmanship,12,6,6
Sylvaethas,lightninghoof,575,hunter,marksmanship,12,6,6
Alinûs,stormrage,575,hunter,marksmanship,12,6,6
Gresga,dalaran,575,hunter,marksmanship,12,6,6
Chipsncheese,korgath,575,hunter,marksmanship,12,6,6
Tajo,sargeras,575,hunter,marksmanship,12,6,6
Silentzkill,tichondrius,575,hunter,marksmanship,12,6,6
Daggétt,zuljin,575,hunter,marksmanship,12,6,6
Onlyfeìgns,frostmourne,575,hunter,marksmanship,12,6,6
Wârhunt,frostmourne,575,hunter,marksmanship,12,6,6
Badharexx,perenolde,575,hunter,marksmanship,12,6,6
Aragörnn,azralon,575,hunter,marksmanship,12,6,6
Chapushoot,ragnaros,575,hunter,marksmanship,12,6,6
Blowedazchit,bonechewer,575,hunter,marksmanship,12,6,6
Littlespike,queldorei,575,hunter,marksmanship,12,6,6
Starsabov,emerald-dream,575,hunter,marksmanship,12,6,6
Dirtbagchaz,illidan,575,hunter,marksmanship,12,6,6
Smashfacehnt,tichondrius,575,hunter,marksmanship,18,6,12
Arbclimbs,frostmane,575,hunter,marksmanship,18,6,12
Zugineer,tichondrius,575,hunter,marksmanship,18,6,12
Duaalipaa,malganis,575,hunter,marksmanship,24,6,18
Hildihunt,stormrage,574,hunter,marksmanship,12,6,6
Zeddunn,stormrage,574,hunter,marksmanship,12,6,6
Marcusrarnis,zuljin,574,hunter,marksmanship,12,6,6
Folgadoo,azralon,574,hunter,marksmanship,18,6,12
Brotag,aggramar,574,hunter,marksmanship,18,6,12
Bunb,area-52,574,hunter,marksmanship,24,6,18
Bigmommah,durotan,574,hunter,marksmanship,24,6,18
Pilk,daggerspine,573,hunter,marksmanship,18,6,12
Zérõ,area-52,572,hunter,marksmanship,18,6,12
Jogoran,thunderlord,571,hunter,marksmanship,12,6,6
Kahunå,area-52,571,hunter,marksmanship,12,6,6
Strelyatil,trollbane,571,hunter,marksmanship,18,6,12
Zandrá,drakkari,570,hunter,marksmanship,12,6,6
Drâgônâr,stormrage,570,hunter,marksmanship,18,6,12
Slayemz,barthilas,570,hunter,marksmanship,18,6,12
Beastmodeqt,blood-furnace,566,hunter,marksmanship,18,6,12
Ikkare,dalaran,565,hunter,marksmanship,12,6,6
Nickhell,azralon,565,hunter,marksmanship,12,6,6
Weirdjeff,alexstrasza,565,hunter,marksmanship,12,6,6
Purplebeaver,gorgonnash,565,hunter,marksmanship,18,6,12
Neef,mannoroth,564,hunter,marksmanship,24,6,18
Ratspit,chogall,557,hunter,marksmanship,17,6,11
Erudraugdin,quelthalas,545,hunter,marksmanship,24,6,18
Iapsux,bleeding-hollow,543,hunter,marksmanship,10,7,3
Shímmér,barthilas,543,hunter,marksmanship,11,6,5
Cloveth,wyrmrest-accord,543,hunter,marksmanship,11,6,5
Gymli,destromath,543,hunter,marksmanship,11,6,5
Stephkurryz,tichondrius,543,hunter,marksmanship,14,7,7
Päinal,area-52,528,hunter,marksmanship,9,6,3
Déadshøt,blackhand,527,hunter,marksmanship,17,6,11
Jaydemo,thunderhorn,527,hunter,marksmanship,17,6,11
Xtremesnipez,frostmourne,522,hunter,marksmanship,15,9,6
Ayrelial,tichondrius,522,hunter,marksmanship,13,7,6
Remixjy,burning-blade,522,hunter,marksmanship,16,7,9
Kenichyi,drakkari,522,hunter,marksmanship,22,7,15
Pogcheddar,tichondrius,511,hunter,marksmanship,14,6,8
Cplski,kelthuzad,511,hunter,marksmanship,16,6,10
Stupid,arthas,511,hunter,marksmanship,20,6,14
Stepbroski,moon-guard,510,hunter,marksmanship,14,6,8
Brainzz,emerald-dream,509,hunter,marksmanship,16,7,9
Äpos,tichondrius,480,hunter,marksmanship,6,5,1
Taije,arthas,480,hunter,marksmanship,6,5,1
Kimchishotxo,tichondrius,480,hunter,marksmanship,6,5,1
Knerf,silvermoon,480,hunter,marksmanship,6,5,1
Shootandloot,zuljin,480,hunter,marksmanship,6,5,1
Zmghost,nathrezim,480,hunter,marksmanship,6,5,1
Drup,dalaran,480,hunter,marksmanship,6,5,1
Bendotexe,stormrage,480,hunter,marksmanship,6,5,1
Johhnweed,ragnaros,480,hunter,marksmanship,6,5,1
Chickenzzack,tichondrius,480,hunter,marksmanship,6,5,1
Martminas,stormrage,480,hunter,marksmanship,6,5,1
Arimkal,area-52,480,hunter,marksmanship,6,5,1
Raevon,kelthuzad,480,hunter,marksmanship,9,6,3
Idtrapthat,nordrassil,480,hunter,marksmanship,9,5,4
Orì,stormrage,480,hunter,marksmanship,12,5,7
Omniquiver,sargeras,480,hunter,marksmanship,12,5,7
Partÿ,tichondrius,480,hunter,marksmanship,12,5,7
Kreaytion,sargeras,480,hunter,marksmanship,12,5,7
Yukily,sargeras,480,hunter,marksmanship,12,5,7
Splosiv,stormrage,480,hunter,marksmanship,12,5,7
Cotoyo,sargeras,480,hunter,marksmanship,12,5,7
Connora,stormrage,480,hunter,marksmanship,12,5,7
Trænquility,tichondrius,480,hunter,marksmanship,12,5,7
Raeyy,area-52,480,hunter,marksmanship,12,5,7
Hitstickk,tichondrius,480,hunter,marksmanship,12,5,7
Davidbowey,bonechewer,480,hunter,marksmanship,12,5,7
Slobon,tichondrius,480,hunter,marksmanship,12,5,7
Bluejay,agamaggan,480,hunter,marksmanship,12,5,7
Hunt,the-underbog,480,hunter,marksmanship,12,5,7
Thewïld,tichondrius,480,hunter,marksmanship,12,5,7
Eldotbrod,quelthalas,480,hunter,marksmanship,12,5,7
Arraza,ragnaros,480,hunter,marksmanship,12,5,7
Zünma,tichondrius,480,hunter,marksmanship,12,5,7
Mickyluvin,emerald-dream,480,hunter,marksmanship,12,5,7
Smokabonbon,eredar,480,hunter,marksmanship,12,5,7
Qqshot,emerald-dream,480,hunter,marksmanship,12,5,7
Yonzo,area-52,480,hunter,marksmanship,12,5,7
Ellissniper,frostmourne,480,hunter,marksmanship,12,5,7
Xísa,proudmoore,480,hunter,marksmanship,12,5,7
Lianm,stormrage,480,hunter,marksmanship,12,5,7
Teaks,aggramar,480,hunter,marksmanship,12,5,7
Boomheadshot,blood-furnace,480,hunter,marksmanship,12,5,7
Íkíte,zuljin,480,hunter,marksmanship,12,5,7
Lilbowbigdam,emerald-dream,480,hunter,marksmanship,12,5,7
Lorgor,eonar,480,hunter,marksmanship,12,5,7
Kankuro,proudmoore,480,hunter,marksmanship,12,5,7
Baehydra,frostmourne,480,hunter,marksmanship,12,5,7
Josyv,quelthalas,480,hunter,marksmanship,12,5,7
Duckpow,frostmourne,480,hunter,marksmanship,12,5,7
Scruffiebear,deathwing,480,hunter,marksmanship,12,5,7
Lagshots,kelthuzad,480,hunter,marksmanship,12,5,7
Jaywuz,tichondrius,480,hunter,marksmanship,12,5,7
Soloshuffle,kelthuzad,480,hunter,marksmanship,12,5,7
Snipedown,bonechewer,480,hunter,marksmanship,12,5,7
Aloa,nagrand,480,hunter,marksmanship,12,5,7
Volarsomar,shattered-hand,480,hunter,marksmanship,12,5,7
Ophois,lightbringer,480,hunter,marksmanship,12,5,7
Hawkeyees,ragnaros,480,hunter,marksmanship,12,5,7
Bowjoby,kelthuzad,480,hunter,marksmanship,12,5,7
Bullzeyê,kelthuzad,480,hunter,marksmanship,12,5,7
Snoplow,illidan,480,hunter,marksmanship,12,5,7
Cortavento,azralon,480,hunter,marksmanship,12,5,7
Reys,bonechewer,480,hunter,marksmanship,15,6,9
Regretful,kelthuzad,480,hunter,marksmanship,13,5,8
Velinieron,norgannon,480,hunter,marksmanship,14,5,9
Absinther,emerald-dream,480,hunter,marksmanship,18,5,13
Keelif,arthas,480,hunter,marksmanship,18,5,13
Msghunter,sargeras,480,hunter,marksmanship,18,5,13
Ikiteforfood,zuljin,480,hunter,marksmanship,18,5,13
Kattarry,moon-guard,480,hunter,marksmanship,18,5,13
Gorthmog,daggerspine,480,hunter,marksmanship,18,5,13
Eurekasl,ragnaros,480,hunter,marksmanship,18,5,13
Shootybootìe,tichondrius,480,hunter,marksmanship,18,5,13
Ownyoufast,darkspear,480,hunter,marksmanship,24,5,19
Runimurder,zuljin,479,hunter,marksmanship,6,5,1
Hoechunk,bonechewer,479,hunter,marksmanship,6,5,1
Ritrune,anvilmar,479,hunter,marksmanship,6,5,1
Logonman,rexxar,479,hunter,marksmanship,12,5,7
Blurrí,area-52,479,hunter,marksmanship,12,5,7
Zaghoward,fenris,479,hunter,marksmanship,12,5,7
Alluminant,gilneas,479,hunter,marksmanship,12,5,7
Hyora,tichondrius,479,hunter,marksmanship,12,5,7
Rykbad,area-52,479,hunter,marksmanship,12,5,7
Jazeath,tichondrius,479,hunter,marksmanship,12,5,7
Huntingyou,destromath,479,hunter,marksmanship,12,5,7
Pathius,uldaman,479,hunter,marksmanship,12,5,7
Keyva,moon-guard,479,hunter,marksmanship,12,5,7
Peitowyn,illidan,479,hunter,marksmanship,12,5,7
Voujin,ragnaros,479,hunter,marksmanship,12,5,7
Globalhunter,emerald-dream,479,hunter,marksmanship,12,5,7
Hunchback,emerald-dream,479,hunter,marksmanship,12,5,7
Ohhsnaapp,blood-furnace,479,hunter,marksmanship,12,5,7
Karimysac,aggramar,479,hunter,marksmanship,12,5,7
Diur,ragnaros,479,hunter,marksmanship,15,5,10
Kiteftw,tichondrius,479,hunter,marksmanship,21,6,15
Johar,nerzhul,479,hunter,marksmanship,18,5,13
Enzym,archimonde,479,hunter,marksmanship,18,5,13
Skillvanas,stormrage,479,hunter,marksmanship,18,5,13
Dirtman,laughing-skull,479,hunter,marksmanship,24,5,19
Ensnare,wyrmrest-accord,478,hunter,marksmanship,12,5,7
Ozzoty,tol-barad,478,hunter,marksmanship,12,5,7
Drakkoniss,spinebreaker,478,hunter,marksmanship,12,5,7
Cocobage,destromath,478,hunter,marksmanship,12,5,7
Nobelscarlet,wildhammer,477,hunter,marksmanship,12,5,7
Survivor,dentarg,477,hunter,marksmanship,12,5,7
Tularac,sentinels,477,hunter,marksmanship,12,5,7
Akbu,azralon,476,hunter,marksmanship,12,5,7
Puttry,stormrage,476,hunter,marksmanship,12,5,7
Àrsha,gallywix,475,hunter,marksmanship,12,5,7
Zmugetsu,bleeding-hollow,474,hunter,marksmanship,12,5,7
Nubberton,sargeras,473,hunter,marksmanship,16,8,8
Lanney,firetree,473,hunter,marksmanship,12,5,7
Hartman,frostwolf,473,hunter,marksmanship,18,5,13
Mazkeen,bonechewer,472,hunter,marksmanship,12,5,7
Butimbutters,bleeding-hollow,467,hunter,marksmanship,23,8,15
Nixous,azralon,460,hunter,marksmanship,17,5,12
Raun,anvilmar,453,hunter,marksmanship,17,5,12
Againzt,tichondrius,447,hunter,marksmanship,12,6,6
Diavál,area-52,447,hunter,marksmanship,11,5,6
Racooning,proudmoore,447,hunter,marksmanship,11,5,6
Ryonel,moon-guard,447,hunter,marksmanship,17,5,12
Mukeru,stormrage,432,hunter,marksmanship,9,5,4
Jud,thunderlord,432,hunter,marksmanship,21,5,16
Irontoast,kelthuzad,431,hunter,marksmanship,11,5,6
Wook,hyjal,431,hunter,marksmanship,11,5,6
Yukiqtpie,barthilas,431,hunter,marksmanship,11,5,6
Noriee,destromath,431,hunter,marksmanship,15,5,10
Ozarks,kiljaeden,426,hunter,marksmanship,17,6,11
Yarthax,illidan,416,hunter,marksmanship,10,5,5
Swm,nazjatar,415,hunter,marksmanship,10,5,5
Aboy,frostmourne,408,hunter,marksmanship,19,6,13
Deathbyebow,maiev,384,hunter,marksmanship,6,4,2
Hèro,barthilas,384,hunter,marksmanship,6,4,2
Cornstalk,area-52,384,hunter,marksmanship,6,4,2
Huumpoutine,burning-blade,384,hunter,marksmanship,6,4,2
Gogey,area-52,384,hunter,marksmanship,6,4,2
Croift,stormrage,384,hunter,marksmanship,6,4,2
Goonlmao,hyjal,384,hunter,marksmanship,6,4,2
Subdue,tichondrius,384,hunter,marksmanship,6,4,2
Maidán,azralon,384,hunter,marksmanship,6,4,2
Valtolimor,moon-guard,384,hunter,marksmanship,6,4,2
Swoljashotxp,area-52,384,hunter,marksmanship,6,4,2
Swish,burning-legion,384,hunter,marksmanship,6,4,2
Silvertokay,ragnaros,384,hunter,marksmanship,6,4,2
Anecko,zuljin,384,hunter,marksmanship,6,4,2
Llhopital,ragnaros,384,hunter,marksmanship,6,4,2
Infatuatedx,moon-guard,384,hunter,marksmanship,6,4,2
Hannispian,tichondrius,384,hunter,marksmanship,6,4,2
Demölishar,proudmoore,384,hunter,marksmanship,6,4,2
Tdarknet,quelthalas,384,hunter,marksmanship,6,4,2
Cashisabeast,zuljin,384,hunter,marksmanship,6,4,2
Yamamasofat,proudmoore,384,hunter,marksmanship,6,4,2
Zendarae,tichondrius,384,hunter,marksmanship,6,4,2
Rektarrow,area-52,384,hunter,marksmanship,6,4,2
Venj,proudmoore,384,hunter,marksmanship,6,4,2
Aimbôt,frostmourne,384,hunter,marksmanship,6,4,2
Jojojobo,tichondrius,384,hunter,marksmanship,6,4,2
Sylos,moon-guard,384,hunter,marksmanship,6,4,2
Cainus,zuljin,384,hunter,marksmanship,6,4,2
Lenacraft,frostmourne,384,hunter,marksmanship,6,4,2
Junmuxiao,ragnaros,384,hunter,marksmanship,6,4,2
Shootyzenth,kiljaeden,384,hunter,marksmanship,6,4,2
Hitemup,bleeding-hollow,384,hunter,marksmanship,6,4,2
Arteene,illidan,384,hunter,marksmanship,6,4,2
Beefcow,barthilas,384,hunter,marksmanship,6,4,2
Zenkhi,quelthalas,384,hunter,marksmanship,6,4,2
Emilysamuels,tichondrius,384,hunter,marksmanship,6,4,2
Beatnass,cairne,384,hunter,marksmanship,6,4,2
Oromís,dalaran,384,hunter,marksmanship,6,4,2
Nyxus,tichondrius,384,hunter,marksmanship,6,4,2
Nenenhunt,ragnaros,384,hunter,marksmanship,6,4,2
Xurul,bleeding-hollow,384,hunter,marksmanship,6,4,2
Moyria,quelthalas,384,hunter,marksmanship,6,4,2
Folf,turalyon,384,hunter,marksmanship,6,4,2
Gunstorms,dalaran,384,hunter,marksmanship,6,4,2
Bayum,emerald-dream,384,hunter,marksmanship,6,4,2
Krissiz,drakkari,384,hunter,marksmanship,6,4,2
Déwi,tichondrius,384,hunter,marksmanship,6,4,2
Frîck,bleeding-hollow,384,hunter,marksmanship,6,4,2
Cucumber,shuhalo,384,hunter,marksmanship,6,4,2
Àshborn,stormrage,384,hunter,marksmanship,6,4,2
Goldensour,malganis,384,hunter,marksmanship,6,4,2
Elmerfuddx,terokkar,384,hunter,marksmanship,6,4,2
Archetype,bladefist,384,hunter,marksmanship,6,4,2
Wellerman,firetree,384,hunter,marksmanship,6,4,2
Malthiz,antonidas,384,hunter,marksmanship,8,4,4
Baydog,moon-guard,384,hunter,marksmanship,11,4,7
Ganzilla,aerie-peak,384,hunter,marksmanship,12,4,8
Resonatorrob,illidan,384,hunter,marksmanship,12,4,8
Whatalexa,tichondrius,384,hunter,marksmanship,12,4,8
Emérr,drakkari,384,hunter,marksmanship,12,4,8
Specops,illidan,384,hunter,marksmanship,12,4,8
Junglar,eitrigg,384,hunter,marksmanship,12,4,8
Dropflag,stormrage,384,hunter,marksmanship,12,4,8
Crackshotzz,illidan,384,hunter,marksmanship,12,4,8
Kumari,lothar,384,hunter,marksmanship,12,4,8
Percision,bonechewer,384,hunter,marksmanship,12,4,8
Mckillahoe,malganis,384,hunter,marksmanship,12,4,8
Sabo,nemesis,384,hunter,marksmanship,12,4,8
Sylvanâs,bleeding-hollow,384,hunter,marksmanship,12,4,8
Hywhan,stormrage,384,hunter,marksmanship,12,4,8
Limpnoodle,nerzhul,384,hunter,marksmanship,12,4,8
Xeriife,stormrage,384,hunter,marksmanship,12,4,8
Gotrap,saurfang,384,hunter,marksmanship,12,4,8
Braindeadorc,illidan,384,hunter,marksmanship,12,4,8
Sogeki,kelthuzad,384,hunter,marksmanship,12,4,8
Bunryl,thorium-brotherhood,384,hunter,marksmanship,12,4,8
Ningiiwose,garona,384,hunter,marksmanship,12,4,8
Ezpzx,sargeras,384,hunter,marksmanship,12,4,8
Lithality,tichondrius,384,hunter,marksmanship,12,4,8
Vion,mannoroth,384,hunter,marksmanship,12,4,8
Hordworld,tichondrius,384,hunter,marksmanship,12,4,8
Altte,proudmoore,384,hunter,marksmanship,12,4,8
Vélos,illidan,384,hunter,marksmanship,12,4,8
Taurenseason,sargeras,384,hunter,marksmanship,12,4,8
Robobop,stormrage,384,hunter,marksmanship,12,4,8
Htcrazykofwa,tichondrius,384,hunter,marksmanship,12,4,8
Sucontheze,kelthuzad,384,hunter,marksmanship,12,4,8
Enchantras,jaedenar,384,hunter,marksmanship,12,4,8
Frankyy,frostmourne,384,hunter,marksmanship,12,4,8
Bigclamz,dragonmaw,384,hunter,marksmanship,12,4,8
Samsin,sargeras,384,hunter,marksmanship,12,4,8
Mabaku,tichondrius,384,hunter,marksmanship,12,4,8
Saralli,thrall,384,hunter,marksmanship,12,4,8
ßiognosis,ragnaros,384,hunter,marksmanship,12,4,8
Hunterjahvek,area-52,384,hunter,marksmanship,12,4,8
Kanati,dunemaul,384,hunter,marksmanship,12,4,8
Aaron,jubeithos,384,hunter,marksmanship,12,4,8
Karev,area-52,384,hunter,marksmanship,12,4,8
Gstygodx,frostmourne,384,hunter,marksmanship,12,4,8
Zipzyup,tichondrius,384,hunter,marksmanship,12,4,8
Crimsonmm,ragnaros,384,hunter,marksmanship,12,4,8
Lilbic,bleeding-hollow,384,hunter,marksmanship,12,4,8
Shottz,blackhand,384,hunter,marksmanship,12,4,8
Protrapz,sargeras,384,hunter,marksmanship,12,4,8
Patroclo,azralon,384,hunter,marksmanship,12,4,8
Joton,tichondrius,384,hunter,marksmanship,12,4,8
Missnevamiss,skullcrusher,384,hunter,marksmanship,12,4,8
Tsubakï,ragnaros,384,hunter,marksmanship,12,4,8
Revö,area-52,384,hunter,marksmanship,12,4,8
Artemisagro,greymane,384,hunter,marksmanship,12,4,8
Ðao,nazjatar,384,hunter,marksmanship,12,4,8
Bleedwolf,tichondrius,384,hunter,marksmanship,12,4,8
Bacigalupo,medivh,384,hunter,marksmanship,12,4,8
Adepia,hellscream,384,hunter,marksmanship,12,4,8
Ðïanä,azralon,384,hunter,marksmanship,12,4,8
Peashooter,sargeras,384,hunter,marksmanship,19,4,15
Meriah,bleeding-hollow,383,hunter,marksmanship,6,4,2
Balanguxa,azralon,383,hunter,marksmanship,6,4,2
Dathronin,chogall,383,hunter,marksmanship,6,4,2
Comtambisuon,frostmourne,383,hunter,marksmanship,6,4,2
Essya,frostmourne,383,hunter,marksmanship,6,4,2
Rplover,malganis,383,hunter,marksmanship,9,5,4
Fermra,dunemaul,383,hunter,marksmanship,12,4,8
Juanita,laughing-skull,383,hunter,marksmanship,12,4,8
Minibrö,tichondrius,383,hunter,marksmanship,12,4,8
Lanamatt,azralon,383,hunter,marksmanship,12,4,8
Ytsejammer,eonar,383,hunter,marksmanship,12,4,8
Cornbreadfed,gorgonnash,383,hunter,marksmanship,12,4,8
Shootymcshot,vashj,383,hunter,marksmanship,12,4,8
Aridan,area-52,383,hunter,marksmanship,12,4,8
Shootingjaem,tichondrius,383,hunter,marksmanship,12,4,8
Hunternao,nemesis,383,hunter,marksmanship,18,4,14
Nevon,azralon,383,hunter,marksmanship,18,4,14
Rzan,fenris,382,hunter,marksmanship,6,4,2
Oohuntsoo,emerald-dream,382,hunter,marksmanship,6,4,2
Lovek,ragnaros,382,hunter,marksmanship,12,4,8
Eaudelune,vashj,382,hunter,marksmanship,12,4,8
Blindshotz,moon-guard,381,hunter,marksmanship,12,4,8
Goofyfingers,illidan,380,hunter,marksmanship,18,4,14
Venessie,moon-guard,379,hunter,marksmanship,12,4,8
Cns,tichondrius,371,hunter,marksmanship,23,7,16
Arighthunt,frostmourne,367,hunter,marksmanship,17,4,13
Hyesik,tichondrius,362,hunter,marksmanship,21,7,14
Outranged,moon-guard,351,hunter,marksmanship,8,5,3
Pérséús,ragnaros,351,hunter,marksmanship,12,5,7
Bloodarrow,tichondrius,351,hunter,marksmanship,11,4,7
Tarkovs,area-52,351,hunter,marksmanship,11,4,7
Rnger,aerie-peak,350,hunter,marksmanship,12,5,7
Tafer,quelthalas,336,hunter,marksmanship,9,4,5
Trappxy,sargeras,336,hunter,marksmanship,9,4,5
Smokiiganja,proudmoore,335,hunter,marksmanship,11,4,7
Brorc,kul-tiras,335,hunter,marksmanship,11,4,7
Zucarita,tichondrius,330,hunter,marksmanship,9,5,4
Iol,blades-edge,330,hunter,marksmanship,14,5,9
Huntersaul,dalvengyr,330,hunter,marksmanship,17,5,12
Nubcaks,nerzhul,330,hunter,marksmanship,21,5,16
Lovedietdew,borean-tundra,329,hunter,marksmanship,21,5,16
Stupïd,tichondrius,319,hunter,marksmanship,5,4,1
Misogynistaf,tichondrius,319,hunter,marksmanship,5,4,1
Aimian,frostmourne,319,hunter,marksmanship,8,4,4
Ðeathßyarrøw,bloodscalp,319,hunter,marksmanship,10,4,6
Streetcrime,stormrage,304,hunter,marksmanship,7,4,3
Dahunterguy,illidan,304,hunter,marksmanship,7,4,3
Dagre,the-forgotten-coast,304,hunter,marksmanship,13,4,9
Guncontrol,malganis,288,hunter,marksmanship,6,3,3
Rivs,detheroc,288,hunter,marksmanship,6,3,3
Kargathx,ragnaros,288,hunter,marksmanship,6,3,3
Limpingspoon,kelthuzad,288,hunter,marksmanship,6,3,3
Huerfyta,quelthalas,288,hunter,marksmanship,6,3,3
Jackohun,quelthalas,288,hunter,marksmanship,6,3,3
Niche,jaedenar,288,hunter,marksmanship,6,3,3
Alliestrasza,azralon,288,hunter,marksmanship,6,3,3
Saphling,emerald-dream,288,hunter,marksmanship,6,3,3
Arithrawn,area-52,288,hunter,marksmanship,6,3,3
Casadora,dark-iron,288,hunter,marksmanship,6,3,3
Physical,destromath,288,hunter,marksmanship,6,3,3
Bernelli,kelthuzad,288,hunter,marksmanship,6,3,3
Arröws,area-52,288,hunter,marksmanship,6,3,3
Laer,archimonde,288,hunter,marksmanship,6,3,3
Antily,kelthuzad,288,hunter,marksmanship,6,3,3
Yeaheh,area-52,288,hunter,marksmanship,6,3,3
Canadïan,stormrage,288,hunter,marksmanship,6,3,3
Garden,kelthuzad,288,hunter,marksmanship,6,3,3
Eforas,ragnaros,288,hunter,marksmanship,6,3,3
Rhovanni,ragnaros,288,hunter,marksmanship,6,3,3
Silvershot,emerald-dream,288,hunter,marksmanship,6,3,3
Eatmybow,nemesis,288,hunter,marksmanship,6,3,3
Fruitenveg,frostmourne,288,hunter,marksmanship,6,3,3
Azairxd,tichondrius,288,hunter,marksmanship,6,3,3
Thugbeast,tichondrius,288,hunter,marksmanship,6,3,3
Innerhunt,aegwynn,288,hunter,marksmanship,6,3,3
Auset,aegwynn,288,hunter,marksmanship,6,3,3
Mtuanwm,tichondrius,288,hunter,marksmanship,6,3,3
Petmychode,illidan,288,hunter,marksmanship,6,3,3
Stupedhunter,tichondrius,288,hunter,marksmanship,6,3,3
Exabyssus,bleeding-hollow,288,hunter,marksmanship,6,3,3
Ropivacaine,illidan,288,hunter,marksmanship,6,3,3
Adowsol,kiljaeden,288,hunter,marksmanship,6,3,3
Halosucks,sargeras,288,hunter,marksmanship,6,3,3
Iresa,bleeding-hollow,288,hunter,marksmanship,6,3,3
Mangosteen,illidan,288,hunter,marksmanship,6,3,3
Chootembro,thunderlord,288,hunter,marksmanship,6,3,3
Boonë,tichondrius,288,hunter,marksmanship,6,3,3
Kormas,illidan,288,hunter,marksmanship,6,3,3
Sabanna,proudmoore,288,hunter,marksmanship,6,3,3
Inked,frostmourne,288,hunter,marksmanship,6,3,3
Waldrom,arathor,288,hunter,marksmanship,6,3,3
Zym,the-forgotten-coast,288,hunter,marksmanship,6,3,3
Krelas,eldrethalas,288,hunter,marksmanship,6,3,3
Maximuhm,vashj,288,hunter,marksmanship,6,3,3
Strudelshot,tichondrius,288,hunter,marksmanship,6,3,3
Mikey,exodar,288,hunter,marksmanship,6,3,3
Vashra,stormrage,288,hunter,marksmanship,6,3,3
Sufferiñg,doomhammer,288,hunter,marksmanship,6,3,3
Madjango,illidan,288,hunter,marksmanship,6,3,3
Cloakedninja,illidan,288,hunter,marksmanship,6,3,3
Tugh,maiev,288,hunter,marksmanship,6,3,3
Maxifier,tichondrius,288,hunter,marksmanship,6,3,3
Deepbowjob,sargeras,288,hunter,marksmanship,6,3,3
Baoßun,thrall,288,hunter,marksmanship,6,3,3
Quondo,boulderfist,288,hunter,marksmanship,6,3,3
Buzzkiller,sargeras,288,hunter,marksmanship,6,3,3
Hanccok,tichondrius,288,hunter,marksmanship,6,3,3
Murrunu,windrunner,288,hunter,marksmanship,6,3,3
Iannieht,illidan,288,hunter,marksmanship,6,3,3
Keliara,dunemaul,288,hunter,marksmanship,6,3,3
Candîce,moon-guard,288,hunter,marksmanship,6,3,3
Carot,dalaran,288,hunter,marksmanship,6,3,3
Dasdasdds,zuljin,288,hunter,marksmanship,6,3,3
Tichong,tichondrius,288,hunter,marksmanship,6,3,3
Kaitoo,tichondrius,288,hunter,marksmanship,6,3,3
Chimpx,moon-guard,288,hunter,marksmanship,6,3,3
Bloodyman,korgath,288,hunter,marksmanship,6,3,3
Sosaho,sargeras,288,hunter,marksmanship,6,3,3
Vinksy,sargeras,288,hunter,marksmanship,6,3,3
Blakespace,area-52,288,hunter,marksmanship,6,3,3
Pupus,moon-guard,288,hunter,marksmanship,6,3,3
Twoshotts,tichondrius,288,hunter,marksmanship,6,3,3
Bacin,tichondrius,288,hunter,marksmanship,6,3,3
Perfectcrit,area-52,288,hunter,marksmanship,6,3,3
Triggamikê,tichondrius,288,hunter,marksmanship,6,3,3
Barrit,windrunner,288,hunter,marksmanship,6,3,3
Glazing,zuljin,288,hunter,marksmanship,6,3,3
Racoon,spinebreaker,288,hunter,marksmanship,6,3,3
Battleon,dalaran,288,hunter,marksmanship,6,3,3
Kogger,frostmourne,288,hunter,marksmanship,6,3,3
Tìnker,stormrage,288,hunter,marksmanship,6,3,3
Mmx,whisperwind,288,hunter,marksmanship,6,3,3
Playnogames,moon-guard,288,hunter,marksmanship,6,3,3
Tmtrap,tichondrius,288,hunter,marksmanship,6,3,3
Wannakill,stormrage,288,hunter,marksmanship,6,3,3
Somethinglit,sargeras,288,hunter,marksmanship,6,3,3
Plastera,zuljin,288,hunter,marksmanship,6,3,3
Kong,tichondrius,288,hunter,marksmanship,6,3,3
Gaazul,destromath,288,hunter,marksmanship,6,3,3
Clait,frostmourne,288,hunter,marksmanship,6,3,3
Sylvãnâs,tichondrius,288,hunter,marksmanship,6,3,3
Internade,frostmourne,288,hunter,marksmanship,6,3,3
Zzackchicken,tichondrius,288,hunter,marksmanship,6,3,3
Muffhuntér,blackrock,288,hunter,marksmanship,6,3,3
Munger,dathremar,288,hunter,marksmanship,6,3,3
Deathshoôt,suramar,288,hunter,marksmanship,6,3,3
Kansolly,tichondrius,288,hunter,marksmanship,6,3,3
Gorhound,tichondrius,288,hunter,marksmanship,6,3,3
Rockendude,sargeras,288,hunter,marksmanship,6,3,3
Traphouse,blackrock,288,hunter,marksmanship,6,3,3
Weegnomie,wyrmrest-accord,288,hunter,marksmanship,6,3,3
Sereom,frostmourne,288,hunter,marksmanship,6,3,3
Luckynoodlle,frostmourne,288,hunter,marksmanship,6,3,3
Dansfarm,tichondrius,288,hunter,marksmanship,6,3,3
Tzoop,tichondrius,288,hunter,marksmanship,6,3,3
Bowtech,malygos,288,hunter,marksmanship,6,3,3
Rukojop,undermine,288,hunter,marksmanship,6,3,3
Zestia,tichondrius,288,hunter,marksmanship,6,3,3
Kallindo,sargeras,288,hunter,marksmanship,6,3,3
Brumbuh,tichondrius,288,hunter,marksmanship,6,3,3
Baalboski,tichondrius,288,hunter,marksmanship,6,3,3
Airchick,frostmourne,288,hunter,marksmanship,6,3,3
Getgaped,bronzebeard,288,hunter,marksmanship,6,3,3
Wonshawt,tichondrius,288,hunter,marksmanship,6,3,3
Zeonas,tichondrius,288,hunter,marksmanship,6,3,3
Weerou,arthas,288,hunter,marksmanship,6,3,3
Amazoness,tichondrius,288,hunter,marksmanship,6,3,3
Darforner,shandris,288,hunter,marksmanship,6,3,3
Odratnuh,bleeding-hollow,288,hunter,marksmanship,6,3,3
Razer,anvilmar,288,hunter,marksmanship,9,4,5
Royshot,stormrage,288,hunter,marksmanship,7,3,4
Konungr,zuljin,288,hunter,marksmanship,11,3,8
Snigskytte,dreadmaul,288,hunter,marksmanship,11,3,8
Bensonlmn,tichondrius,288,hunter,marksmanship,15,4,11
Sliperysaly,tichondrius,288,hunter,marksmanship,12,3,9
Surfbum,lightbringer,288,hunter,marksmanship,12,3,9
Strixx,emerald-dream,288,hunter,marksmanship,12,3,9
Salvatiel,stormrage,288,hunter,marksmanship,12,3,9
Quackattack,arthas,288,hunter,marksmanship,12,3,9
Sukiru,ragnaros,288,hunter,marksmanship,12,3,9
Princssdaizy,zuljin,288,hunter,marksmanship,12,3,9
Durbìn,sargeras,288,hunter,marksmanship,12,3,9
Sparkco,area-52,288,hunter,marksmanship,12,3,9
Exiun,sargeras,288,hunter,marksmanship,12,3,9
Xsparkys,kargath,288,hunter,marksmanship,12,3,9
Sásori,area-52,288,hunter,marksmanship,12,3,9
Alyzza,sargeras,288,hunter,marksmanship,12,3,9
Blaisian,frostmourne,288,hunter,marksmanship,12,3,9
Hefty,azuremyst,288,hunter,marksmanship,12,3,9
Aerefix,frostmourne,288,hunter,marksmanship,12,3,9
Stinkyfob,barthilas,288,hunter,marksmanship,12,3,9
Davidböwie,stormreaver,288,hunter,marksmanship,12,3,9
Angelicarrow,area-52,288,hunter,marksmanship,12,3,9
Lesley,illidan,288,hunter,marksmanship,12,3,9
Drysst,tichondrius,288,hunter,marksmanship,12,3,9
Gustavitch,executus,288,hunter,marksmanship,12,3,9
Uro,illidan,288,hunter,marksmanship,12,3,9
Hatara,quelthalas,288,hunter,marksmanship,12,3,9
Shifted,quelthalas,288,hunter,marksmanship,12,3,9
Boltflux,nemesis,288,hunter,marksmanship,12,3,9
Kårdashian,illidan,288,hunter,marksmanship,12,3,9
Tastysauce,wyrmrest-accord,288,hunter,marksmanship,12,3,9
Wadadly,malganis,288,hunter,marksmanship,12,3,9
Blarck,shattered-halls,288,hunter,marksmanship,12,3,9
Skywrecker,bleeding-hollow,288,hunter,marksmanship,12,3,9
Ouchiies,barthilas,288,hunter,marksmanship,12,3,9
Shablagoosh,zuljin,288,hunter,marksmanship,12,3,9
Zeedii,dalaran,288,hunter,marksmanship,12,3,9
Tmd,thrall,288,hunter,marksmanship,12,3,9
Beastcraft,emerald-dream,288,hunter,marksmanship,12,3,9
Oua,queldorei,288,hunter,marksmanship,12,3,9
Heloran,maelstrom,288,hunter,marksmanship,12,3,9
Lumbygoblin,illidan,288,hunter,marksmanship,13,3,10
Jgodsslayer,tichondrius,288,hunter,marksmanship,18,3,15
Zarknoth,cenarius,288,hunter,marksmanship,18,3,15
Cerébro,illidan,288,hunter,marksmanship,24,3,21
Ghazzghkuull,ragnaros,287,hunter,marksmanship,6,3,3
Lapelada,ragnaros,287,hunter,marksmanship,6,3,3
Braindeadly,malganis,287,hunter,marksmanship,6,3,3
Jitazz,azgalor,287,hunter,marksmanship,6,3,3
Downtimes,illidan,287,hunter,marksmanship,6,3,3
Multicereal,quelthalas,287,hunter,marksmanship,6,3,3
Allready,stormrage,287,hunter,marksmanship,12,3,9
Arawnz,emerald-dream,287,hunter,marksmanship,12,3,9
Tarbabies,mannoroth,287,hunter,marksmanship,12,3,9
Bumbow,tichondrius,287,hunter,marksmanship,12,3,9
Darthwillie,cenarius,287,hunter,marksmanship,12,3,9
Divinee,undermine,287,hunter,marksmanship,12,3,9
Josthar,thrall,287,hunter,marksmanship,24,3,21
Lorelåii,tichondrius,286,hunter,marksmanship,6,3,3
Irishnia,bleeding-hollow,286,hunter,marksmanship,6,3,3
Bloodofcaos,area-52,285,hunter,marksmanship,18,3,15
Dashing,magtheridon,271,hunter,marksmanship,11,3,8
Mythman,area-52,255,hunter,marksmanship,14,4,10
Amorial,barthilas,255,hunter,marksmanship,11,3,8
Tanneritez,bleeding-hollow,240,hunter,marksmanship,17,3,14
Evilmoe,zuluhed,239,hunter,marksmanship,5,3,2
Glôck,dalaran,239,hunter,marksmanship,11,3,8
Wildspirits,frostmourne,239,hunter,marksmanship,11,3,8
Knowtraps,area-52,234,hunter,marksmanship,7,4,3
Druskritag,moon-guard,234,hunter,marksmanship,10,4,6
Demongirl,arathor,231,hunter,marksmanship,25,4,21
Noscoped,wildhammer,224,hunter,marksmanship,16,3,13
Downworlder,darkspear,223,hunter,marksmanship,8,3,5
Andrømeda,frostmourne,208,hunter,marksmanship,7,3,4
Doop,azuremyst,207,hunter,marksmanship,7,3,4
Lamb,undermine,202,hunter,marksmanship,11,4,7
Farverr,area-52,192,hunter,marksmanship,4,3,1
Traitorously,daggerspine,192,hunter,marksmanship,9,3,6
Arbos,ragnaros,192,hunter,marksmanship,6,2,4
Isitrng,aggramar,192,hunter,marksmanship,6,2,4
Nughunter,area-52,192,hunter,marksmanship,6,2,4
Haemøphilus,area-52,192,hunter,marksmanship,6,2,4
Alssong,tichondrius,192,hunter,marksmanship,6,2,4
Symz,ragnaros,192,hunter,marksmanship,6,2,4
Bowzørx,tichondrius,192,hunter,marksmanship,6,2,4
Xxunderoath,frostwolf,192,hunter,marksmanship,6,2,4
Tus,tichondrius,192,hunter,marksmanship,6,2,4
Hfn,stormrage,192,hunter,marksmanship,6,2,4
Geldyn,stormreaver,192,hunter,marksmanship,6,2,4
Bendoon,sargeras,192,hunter,marksmanship,6,2,4
Blury,tichondrius,192,hunter,marksmanship,6,2,4
Yortrox,ragnaros,192,hunter,marksmanship,6,2,4
Bvø,stormrage,192,hunter,marksmanship,6,2,4
Voodoohunter,blood-furnace,192,hunter,marksmanship,6,2,4
Yembohi,queldorei,192,hunter,marksmanship,6,2,4
Áppóló,spinebreaker,192,hunter,marksmanship,6,2,4
Haki,gallywix,192,hunter,marksmanship,6,2,4
Stormwardenx,turalyon,192,hunter,marksmanship,6,2,4
Saveawp,stormrage,192,hunter,marksmanship,6,2,4
Angelfern,sargeras,192,hunter,marksmanship,6,2,4
Dikbender,tichondrius,192,hunter,marksmanship,6,2,4
Knator,area-52,192,hunter,marksmanship,6,2,4
Zackmorris,kelthuzad,192,hunter,marksmanship,6,2,4
Ðecarlis,azralon,192,hunter,marksmanship,6,2,4
Xuxoo,nemesis,192,hunter,marksmanship,6,2,4
Rolandschitt,area-52,192,hunter,marksmanship,6,2,4
Jaigo,stormrage,192,hunter,marksmanship,6,2,4
Fizzleegear,area-52,192,hunter,marksmanship,6,2,4
Fleshfeast,tichondrius,192,hunter,marksmanship,6,2,4
Gangstashot,burning-legion,192,hunter,marksmanship,6,2,4
Happyhunting,sargeras,192,hunter,marksmanship,6,2,4
Namøscä,nemesis,192,hunter,marksmanship,6,2,4
Lemmiewînkzz,sargeras,192,hunter,marksmanship,6,2,4
Zeaks,emerald-dream,192,hunter,marksmanship,6,2,4
Actimetohunt,gundrak,192,hunter,marksmanship,6,2,4
Okcupid,proudmoore,192,hunter,marksmanship,6,2,4
Vzeroo,emerald-dream,192,hunter,marksmanship,6,2,4
Sergunter,area-52,192,hunter,marksmanship,6,2,4
Amptx,tichondrius,192,hunter,marksmanship,6,2,4
Ramchi,burning-blade,192,hunter,marksmanship,6,2,4
Thugio,sargeras,192,hunter,marksmanship,6,2,4
Nixuis,stormrage,192,hunter,marksmanship,6,2,4
Huntbodom,drakkari,192,hunter,marksmanship,6,2,4
Defacegg,illidan,192,hunter,marksmanship,6,2,4
Tuanorz,proudmoore,192,hunter,marksmanship,6,2,4
Ðevil,ragnaros,192,hunter,marksmanship,6,2,4
Córnell,tichondrius,192,hunter,marksmanship,6,2,4
Lulafourdedo,stormrage,192,hunter,marksmanship,6,2,4
Mtq,thrall,192,hunter,marksmanship,6,2,4
Shoccka,thrall,192,hunter,marksmanship,6,2,4
Bloodrainia,ravencrest,192,hunter,marksmanship,6,2,4
Faldran,earthen-ring,192,hunter,marksmanship,6,2,4
Ezari,zuljin,192,hunter,marksmanship,6,2,4
Erelenn,tichondrius,192,hunter,marksmanship,6,2,4
Illweedx,kiljaeden,192,hunter,marksmanship,6,2,4
Arantir,drakkari,192,hunter,marksmanship,6,2,4
Terapista,area-52,192,hunter,marksmanship,6,2,4
Doopers,kiljaeden,192,hunter,marksmanship,6,2,4
Cefla,illidan,192,hunter,marksmanship,6,2,4
Magvez,tichondrius,192,hunter,marksmanship,6,2,4
Ctrlaltdel,gundrak,192,hunter,marksmanship,6,2,4
Vitae,shattered-halls,192,hunter,marksmanship,6,2,4
Camorcaist,stormrage,192,hunter,marksmanship,6,2,4
Regerts,sargeras,192,hunter,marksmanship,6,2,4
Ayrana,tichondrius,192,hunter,marksmanship,6,2,4
Gytaepung,tichondrius,192,hunter,marksmanship,6,2,4
Théw,tichondrius,192,hunter,marksmanship,6,2,4
Thiccita,tichondrius,192,hunter,marksmanship,6,2,4
Bôdon,illidan,192,hunter,marksmanship,6,2,4
Cazaaires,quelthalas,192,hunter,marksmanship,6,2,4
Kïwwï,tichondrius,192,hunter,marksmanship,6,2,4
Huntgar,earthen-ring,192,hunter,marksmanship,6,2,4
Orkemon,emerald-dream,192,hunter,marksmanship,6,2,4
Kahtniss,quelthalas,192,hunter,marksmanship,6,2,4
Desdee,icecrown,192,hunter,marksmanship,6,2,4
Genom,tichondrius,192,hunter,marksmanship,6,2,4
Cuchulláin,area-52,192,hunter,marksmanship,6,2,4
Valcyoneus,dragonmaw,192,hunter,marksmanship,6,2,4
Deepcarver,tichondrius,192,hunter,marksmanship,6,2,4
Leaf,chromaggus,192,hunter,marksmanship,6,2,4
Thiccshawts,moon-guard,192,hunter,marksmanship,6,2,4
Zhona,moon-guard,192,hunter,marksmanship,6,2,4
Percival,firetree,192,hunter,marksmanship,6,2,4
Sleazyrider,azuremyst,192,hunter,marksmanship,6,2,4
Ire,kelthuzad,192,hunter,marksmanship,6,2,4
Petmydog,aegwynn,192,hunter,marksmanship,6,2,4
Wartoz,dragonblight,192,hunter,marksmanship,6,2,4
Muscletooth,moon-guard,192,hunter,marksmanship,6,2,4
Ilîiìîìiilil,bleeding-hollow,192,hunter,marksmanship,6,2,4
Angrypepe,bleeding-hollow,192,hunter,marksmanship,6,2,4
Shellby,malganis,192,hunter,marksmanship,6,2,4
Valdevenator,illidan,192,hunter,marksmanship,6,2,4
Jebote,frostmourne,192,hunter,marksmanship,6,2,4
Basicskills,illidan,192,hunter,marksmanship,6,2,4
Erebor,malganis,192,hunter,marksmanship,6,2,4
Gadorim,kelthuzad,192,hunter,marksmanship,6,2,4
Glockin,zuljin,192,hunter,marksmanship,6,2,4
Inurah,malganis,192,hunter,marksmanship,6,2,4
Aridias,mannoroth,192,hunter,marksmanship,6,2,4
Crownchild,illidan,192,hunter,marksmanship,6,2,4
Geeshot,area-52,192,hunter,marksmanship,6,2,4
Hárd,illidan,192,hunter,marksmanship,6,2,4
Jathriel,zuljin,192,hunter,marksmanship,6,2,4
Huntugz,frostmourne,192,hunter,marksmanship,6,2,4
Ïkite,zuljin,192,hunter,marksmanship,6,2,4
Rëxx,moon-guard,192,hunter,marksmanship,6,2,4
Booshwookie,frostmourne,192,hunter,marksmanship,6,2,4
Commonbuck,area-52,192,hunter,marksmanship,6,2,4
Justhunter,moknathal,192,hunter,marksmanship,6,2,4
Gokissmywolf,moknathal,192,hunter,marksmanship,6,2,4
Pichsolika,frostmourne,192,hunter,marksmanship,6,2,4
Firskin,frostmourne,192,hunter,marksmanship,6,2,4
Warsh,anubarak,192,hunter,marksmanship,6,2,4
Aimi,twisting-nether,192,hunter,marksmanship,6,2,4
Fkurrules,frostmourne,192,hunter,marksmanship,6,2,4
Latherel,bleeding-hollow,192,hunter,marksmanship,6,2,4
Anilora,wyrmrest-accord,192,hunter,marksmanship,6,2,4
Hideontrap,malganis,192,hunter,marksmanship,6,2,4
Noisetrader,illidan,192,hunter,marksmanship,6,2,4
Skolzero,azralon,192,hunter,marksmanship,6,2,4
Dreezzy,bleeding-hollow,192,hunter,marksmanship,6,2,4
Nord,draka,192,hunter,marksmanship,6,2,4
Lukara,darkspear,192,hunter,marksmanship,6,2,4
Peppancini,wyrmrest-accord,192,hunter,marksmanship,6,2,4
Whitemàne,dalaran,192,hunter,marksmanship,6,2,4
Lycanthropei,illidan,192,hunter,marksmanship,6,2,4
Kanta,bleeding-hollow,192,hunter,marksmanship,6,2,4
Pumpydumpy,malganis,192,hunter,marksmanship,6,2,4
Sobala,azralon,192,hunter,marksmanship,6,2,4
Penelòpe,wyrmrest-accord,192,hunter,marksmanship,6,2,4
Àngèl,malganis,192,hunter,marksmanship,6,2,4
Tyraelias,kaelthas,192,hunter,marksmanship,6,2,4
Holytrap,destromath,192,hunter,marksmanship,6,2,4
Molty,wyrmrest-accord,192,hunter,marksmanship,6,2,4
Léfty,nagrand,192,hunter,marksmanship,6,2,4
Valeriian,frostmourne,192,hunter,marksmanship,6,2,4
Mordriva,azjolnerub,192,hunter,marksmanship,6,2,4
Arroz,blackwing-lair,192,hunter,marksmanship,6,2,4
Redrangerzz,daggerspine,192,hunter,marksmanship,10,3,7
Brindlë,kelthuzad,192,hunter,marksmanship,11,3,8
Kîra,stormrage,192,hunter,marksmanship,16,3,13
Gunnpowder,malganis,192,hunter,marksmanship,12,2,10
Rondlor,azralon,192,hunter,marksmanship,12,2,10
Stïinck,azralon,192,hunter,marksmanship,12,2,10
Luvtits,bonechewer,192,hunter,marksmanship,12,2,10
Jmonger,runetotem,192,hunter,marksmanship,12,2,10
Killdred,bonechewer,192,hunter,marksmanship,12,2,10
Zumythriel,stormrage,192,hunter,marksmanship,12,2,10
Littleagu,proudmoore,192,hunter,marksmanship,12,2,10
Warrioress,illidan,192,hunter,marksmanship,12,2,10
Warpedshots,malganis,192,hunter,marksmanship,12,2,10
Xulag,tichondrius,192,hunter,marksmanship,12,2,10
Larts,fenris,192,hunter,marksmanship,12,2,10
Shafttrapper,queldorei,192,hunter,marksmanship,12,2,10
Sevitham,dalaran,192,hunter,marksmanship,12,2,10
Hatros,stormrage,192,hunter,marksmanship,12,2,10
Dojaqat,frostmourne,192,hunter,marksmanship,12,2,10
Eaglesx,skullcrusher,192,hunter,marksmanship,12,2,10
Sharpzy,jubeithos,192,hunter,marksmanship,12,2,10
Hunterish,area-52,192,hunter,marksmanship,12,2,10
Otirrub,deathwing,192,hunter,marksmanship,12,2,10
Jahvekhunter,area-52,192,hunter,marksmanship,12,2,10
Findbind,altar-of-storms,192,hunter,marksmanship,12,2,10
Sukmedik,barthilas,192,hunter,marksmanship,12,2,10
Seekem,destromath,192,hunter,marksmanship,12,2,10
Luffzy,barthilas,192,hunter,marksmanship,12,2,10
Drathuss,lightbringer,192,hunter,marksmanship,12,2,10
Chinchompas,bleeding-hollow,192,hunter,marksmanship,18,2,16
Griffox,frostwolf,191,hunter,marksmanship,4,3,1
Luzdivina,agamaggan,191,hunter,marksmanship,6,2,4
Wörg,elune,191,hunter,marksmanship,6,2,4
Cøpycat,dreadmaul,191,hunter,marksmanship,6,2,4
Airshots,bleeding-hollow,191,hunter,marksmanship,6,2,4
Donchy,proudmoore,191,hunter,marksmanship,6,2,4
Rorrnus,blackwing-lair,191,hunter,marksmanship,6,2,4
Sylviannas,frostmourne,191,hunter,marksmanship,6,2,4
Dorg,azjolnerub,191,hunter,marksmanship,6,2,4
Hellcry,khadgar,191,hunter,marksmanship,12,2,10
Actaeom,area-52,191,hunter,marksmanship,12,2,10
Ragehunter,scilla,191,hunter,marksmanship,12,2,10
Thesloott,azshara,159,hunter,marksmanship,5,2,3
Coçador,stormrage,159,hunter,marksmanship,5,2,3
Dropitëns,nemesis,159,hunter,marksmanship,5,2,3
Mhyalî,moon-guard,159,hunter,marksmanship,5,2,3
Gonnujo,ragnaros,159,hunter,marksmanship,5,2,3
Clintbartun,shadowsong,159,hunter,marksmanship,5,2,3
Hunntard,veknilash,159,hunter,marksmanship,5,2,3
Fadek,mannoroth,159,hunter,marksmanship,11,2,9
Dusle,azralon,138,hunter,marksmanship,8,3,5
Darthski,drenden,138,hunter,marksmanship,12,4,8
Pvrisxoxo,frostmourne,138,hunter,marksmanship,9,3,6
Xpyroshot,area-52,138,hunter,marksmanship,13,4,9
Zarrockk,emerald-dream,138,hunter,marksmanship,10,3,7
Gilton,blackrock,138,hunter,marksmanship,11,3,8
Thindraa,dalaran,138,hunter,marksmanship,15,4,11
Winstônwolf,spinebreaker,138,hunter,marksmanship,19,4,15
Plsnobanmee,frostmourne,137,hunter,marksmanship,9,5,4
Jjackchicken,tichondrius,128,hunter,marksmanship,4,2,2
Mookvader,illidan,128,hunter,marksmanship,4,2,2
Lúthiel,azralon,127,hunter,marksmanship,8,2,6
Shootr,darkspear,96,hunter,marksmanship,3,2,1
Ïmprîsôñ,dalaran,96,hunter,marksmanship,3,2,1
Cesz,ragnaros,96,hunter,marksmanship,3,2,1
Coppersnout,wyrmrest-accord,96,hunter,marksmanship,6,1,5
Cowboytroy,exodar,96,hunter,marksmanship,6,1,5
Levette,wyrmrest-accord,96,hunter,marksmanship,6,1,5
Architect,bleeding-hollow,96,hunter,marksmanship,6,1,5
Huntbooty,mannoroth,96,hunter,marksmanship,6,1,5
Exitwoundz,hyjal,96,hunter,marksmanship,6,1,5
Sarutovy,kelthuzad,96,hunter,marksmanship,6,1,5
Pinheira,nemesis,96,hunter,marksmanship,6,1,5
Vilguz,illidan,96,hunter,marksmanship,6,1,5
Jaidev,nemesis,96,hunter,marksmanship,6,1,5
Dalzar,darkspear,96,hunter,marksmanship,6,1,5
Staytrill,tichondrius,96,hunter,marksmanship,6,1,5
Samanta,blood-furnace,96,hunter,marksmanship,6,1,5
Minnervva,malganis,96,hunter,marksmanship,6,1,5
Fritzy,nazjatar,96,hunter,marksmanship,6,1,5
Clacktar,wyrmrest-accord,96,hunter,marksmanship,6,1,5
Arin,suramar,96,hunter,marksmanship,6,1,5
Terezhunt,tichondrius,96,hunter,marksmanship,6,1,5
Autaila,thunderlord,96,hunter,marksmanship,6,1,5
Zirstorm,altar-of-storms,96,hunter,marksmanship,6,1,5
Lemmetrap,illidan,96,hunter,marksmanship,6,1,5
Nodar,quelthalas,96,hunter,marksmanship,6,1,5
Garkia,hyjal,96,hunter,marksmanship,6,1,5
Feignqt,illidan,96,hunter,marksmanship,6,1,5
Dogtagluke,stormrage,96,hunter,marksmanship,6,1,5
Vortex,arthas,96,hunter,marksmanship,6,1,5
Allerios,alleria,96,hunter,marksmanship,6,1,5
Consanguin,sargeras,96,hunter,marksmanship,6,1,5
Gabitoqt,gallywix,96,hunter,marksmanship,6,1,5
Longshott,azralon,96,hunter,marksmanship,6,1,5
Hopsmatei,azralon,96,hunter,marksmanship,6,1,5
Ethùg,area-52,96,hunter,marksmanship,6,1,5
Ruhak,windrunner,96,hunter,marksmanship,6,1,5
Hyena,kelthuzad,96,hunter,marksmanship,6,1,5
Ruvathir,wyrmrest-accord,96,hunter,marksmanship,6,1,5
Luthairian,sargeras,96,hunter,marksmanship,6,1,5
Savageshot,daggerspine,96,hunter,marksmanship,6,1,5
Clydebarro,sargeras,96,hunter,marksmanship,6,1,5
Traxêx,nemesis,96,hunter,marksmanship,6,1,5
Legoretzlas,durotan,96,hunter,marksmanship,6,1,5
Poizon,gorefiend,96,hunter,marksmanship,6,1,5
Vladik,stormrage,96,hunter,marksmanship,6,1,5
Konflako,quelthalas,96,hunter,marksmanship,6,1,5
Maquire,tichondrius,96,hunter,marksmanship,6,1,5
Ragerab,trollbane,96,hunter,marksmanship,6,1,5
Puppyghoul,malganis,96,hunter,marksmanship,6,1,5
Shootdogg,mannoroth,96,hunter,marksmanship,6,1,5
Gunwalk,azjolnerub,96,hunter,marksmanship,6,1,5
Brändöncody,stormrage,96,hunter,marksmanship,6,1,5
Nikolov,proudmoore,96,hunter,marksmanship,6,1,5
Arrowenn,zuljin,96,hunter,marksmanship,6,1,5
Shortbow,nordrassil,96,hunter,marksmanship,6,1,5
Rämbow,frostmourne,96,hunter,marksmanship,6,1,5
Crazyshot,drakkari,96,hunter,marksmanship,6,1,5
Fingamyquill,tichondrius,96,hunter,marksmanship,6,1,5
Darkarcher,hyjal,96,hunter,marksmanship,6,1,5
Wolfmastera,zuljin,96,hunter,marksmanship,6,1,5
Dragov,frostmourne,96,hunter,marksmanship,6,1,5
Qua,perenolde,96,hunter,marksmanship,6,1,5
Elaestel,moon-guard,96,hunter,marksmanship,6,1,5
Necroshotz,kul-tiras,96,hunter,marksmanship,6,1,5
Quepop,demon-soul,96,hunter,marksmanship,6,1,5
Brutalhit,bonechewer,96,hunter,marksmanship,6,1,5
Anndaria,tichondrius,96,hunter,marksmanship,6,1,5
Siimmplicitz,area-52,96,hunter,marksmanship,6,1,5
Fawn,moon-guard,96,hunter,marksmanship,6,1,5
Narukín,tichondrius,96,hunter,marksmanship,6,1,5
Ellesia,saurfang,96,hunter,marksmanship,6,1,5
Panchovill,ragnaros,96,hunter,marksmanship,6,1,5
Seizedhunt,frostmourne,96,hunter,marksmanship,6,1,5
Wellfaír,area-52,96,hunter,marksmanship,6,1,5
Elknut,sargeras,96,hunter,marksmanship,6,1,5
Artilleria,quelthalas,96,hunter,marksmanship,6,1,5
Shootermgavn,frostmourne,96,hunter,marksmanship,6,1,5
Yandralen,kiljaeden,96,hunter,marksmanship,6,1,5
Boongtokes,illidan,96,hunter,marksmanship,6,1,5
Smackadoodlé,illidan,96,hunter,marksmanship,6,1,5
Ashner,illidan,96,hunter,marksmanship,6,1,5
Bowbaggins,stormrage,96,hunter,marksmanship,6,1,5
Genug,tichondrius,96,hunter,marksmanship,6,1,5
Chocoshots,burning-blade,96,hunter,marksmanship,6,1,5
Laudion,quelthalas,96,hunter,marksmanship,6,1,5
Insönnia,azralon,96,hunter,marksmanship,6,1,5
Barginmeal,undermine,96,hunter,marksmanship,6,1,5
Slimshadie,kiljaeden,96,hunter,marksmanship,6,1,5
Romro,norgannon,96,hunter,marksmanship,6,1,5
Wínchester,stormrage,96,hunter,marksmanship,6,1,5
Desarus,archimonde,96,hunter,marksmanship,6,1,5
Saeculorum,azralon,96,hunter,marksmanship,6,1,5
Nightfall,azshara,96,hunter,marksmanship,6,1,5
Hovahdo,proudmoore,96,hunter,marksmanship,6,1,5
Kiatus,nesingwary,96,hunter,marksmanship,6,1,5
Kkurama,area-52,96,hunter,marksmanship,6,1,5
Darksidios,quelthalas,96,hunter,marksmanship,6,1,5
Lailyann,sargeras,96,hunter,marksmanship,6,1,5
Evemae,sargeras,96,hunter,marksmanship,6,1,5
Faceshots,tichondrius,96,hunter,marksmanship,6,1,5
Slaughterr,kelthuzad,96,hunter,marksmanship,6,1,5
Pilhul,illidan,96,hunter,marksmanship,6,1,5
Solderboi,tichondrius,96,hunter,marksmanship,6,1,5
Jumeog,stormscale,96,hunter,marksmanship,6,1,5
Biehuixin,tichondrius,96,hunter,marksmanship,6,1,5
Eternalhunt,ragnaros,96,hunter,marksmanship,6,1,5
Rensv,frostmourne,96,hunter,marksmanship,6,1,5
Ikiteforgold,zuljin,96,hunter,marksmanship,6,1,5
Zral,dragonmaw,96,hunter,marksmanship,6,1,5
Citizen,dragonmaw,96,hunter,marksmanship,6,1,5
Nickaz,frostmourne,96,hunter,marksmanship,8,1,7
Anysia,amanthul,96,hunter,marksmanship,12,1,11
Xalmoinmybow,illidan,96,hunter,marksmanship,12,1,11
Missedshot,frostmourne,96,hunter,marksmanship,12,1,11
Kofan,darkspear,96,hunter,marksmanship,12,1,11
Bophadeaz,sargeras,96,hunter,marksmanship,12,1,11
Tarapandas,kilrogg,96,hunter,marksmanship,12,1,11
Jacobsladder,illidan,96,hunter,marksmanship,12,1,11
Lawyernickk,thrall,96,hunter,marksmanship,12,1,11
Hawneyduo,skullcrusher,96,hunter,marksmanship,12,1,11
Elanor,feathermoon,96,hunter,marksmanship,18,1,17
Strixis,blood-furnace,95,hunter,marksmanship,6,1,5
Astorf,drakkari,95,hunter,marksmanship,6,1,5
Chaarlee,senjin,95,hunter,marksmanship,6,1,5
Setbackhunt,illidan,79,hunter,marksmanship,5,1,4
Trionias,malfurion,79,hunter,marksmanship,5,1,4
Bownappetite,bleeding-hollow,79,hunter,marksmanship,5,1,4
Coffetaum,illidan,64,hunter,marksmanship,4,1,3
Creatuuree,zuljin,64,hunter,marksmanship,4,1,3
Raymose,tichondrius,64,hunter,marksmanship,4,1,3
Huntsmate,tichondrius,64,hunter,marksmanship,4,1,3
Nyloc,dalvengyr,64,hunter,marksmanship,4,1,3
Killarth,quelthalas,48,hunter,marksmanship,3,1,2
Boyarsky,area-52,48,hunter,marksmanship,3,1,2
Døctørmälitø,tichondrius,42,hunter,marksmanship,9,2,7
Ahncheolsoo,tichondrius,42,hunter,marksmanship,11,2,9
Dapoosyx,tichondrius,31,hunter,marksmanship,2,1,1
Phíl,queldorei,31,hunter,marksmanship,2,1,1
Haamsuplo,tichondrius,31,hunter,marksmanship,2,1,1
Suntail,dalaran,2208,hunter,survival,111,58,53
Cndavyjones,akama,2191,hunter,survival,168,86,82
Bonquiesha,area-52,2176,hunter,survival,79,52,27
Saiiph,bleeding-hollow,2169,hunter,survival,144,74,70
Cëb,stormrage,2157,hunter,survival,168,84,84
Disciple,darkspear,2152,hunter,survival,74,43,31
Malukaca,azralon,2131,hunter,survival,149,75,74
Buffmm,kelthuzad,2130,hunter,survival,90,46,44
Hotmuscleman,tichondrius,2127,hunter,survival,74,45,29
Capncams,emerald-dream,2120,hunter,survival,130,68,62
Missedmytrap,draenor,2119,hunter,survival,83,49,34
Covlol,illidan,2119,hunter,survival,70,38,32
Dyucol,tichondrius,2117,hunter,survival,268,152,116
Cadencex,stormrage,2101,hunter,survival,141,71,70
Kansolly,tichondrius,2091,hunter,survival,111,59,52
Ferex,tichondrius,2090,hunter,survival,75,45,30
Briggsx,sargeras,2083,hunter,survival,78,40,38
Aimbotmir,zuljin,2083,hunter,survival,86,40,46
Ikiteforfood,zuljin,2069,hunter,survival,56,32,24
Legoelass,emerald-dream,2068,hunter,survival,197,109,88
Hwslol,tichondrius,2065,hunter,survival,172,96,76
Pathofsexile,tichondrius,2062,hunter,survival,264,142,122
Pridefulz,stormrage,2062,hunter,survival,170,85,85
Gloomy,dark-iron,2054,hunter,survival,54,41,13
Töxic,dalaran,2015,hunter,survival,85,49,36
Dirtysoap,sargeras,2013,hunter,survival,84,43,41
Djtraphouse,stormrage,2012,hunter,survival,144,73,71
Ungrella,malganis,2001,hunter,survival,81,44,37
Wmsgs,tichondrius,1998,hunter,survival,201,99,102
Endsnear,stormrage,1997,hunter,survival,178,89,89
Dijhoni,moon-guard,1996,hunter,survival,137,72,65
Survchris,bleeding-hollow,1994,hunter,survival,79,44,35
Noimnotokay,tichondrius,1992,hunter,survival,113,57,56
Maxiam,frostmourne,1989,hunter,survival,71,37,34
Nearly,wyrmrest-accord,1987,hunter,survival,79,40,39
Cadenxr,bleeding-hollow,1983,hunter,survival,59,40,19
Queríde,emerald-dream,1982,hunter,survival,71,50,21
Veyronnx,stormrage,1981,hunter,survival,126,71,55
Ynoit,sargeras,1974,hunter,survival,100,53,47
Budika,ragnaros,1973,hunter,survival,42,30,12
Bicmex,sargeras,1970,hunter,survival,42,29,13
Xyzv,tichondrius,1965,hunter,survival,81,41,40
Pokìmane,tichondrius,1961,hunter,survival,98,62,36
Galavant,frostmourne,1960,hunter,survival,98,52,46
Koupon,tichondrius,1959,hunter,survival,148,74,74
Lèkïnhø,azralon,1953,hunter,survival,84,42,42
Aurelx,tichondrius,1950,hunter,survival,48,32,16
Hamslapper,shattered-hand,1946,hunter,survival,141,68,73
Kubu,emerald-dream,1940,hunter,survival,139,83,56
Sikhunt,frostmourne,1939,hunter,survival,60,35,25
Robotwo,illidan,1937,hunter,survival,54,36,18
Gabiña,tichondrius,1934,hunter,survival,369,188,181
Neverturtlex,tichondrius,1929,hunter,survival,42,24,18
Foxyhood,ragnaros,1927,hunter,survival,143,76,67
Garfieldbb,tichondrius,1927,hunter,survival,66,35,31
Dwx,bleeding-hollow,1915,hunter,survival,84,44,40
Fictìon,kelthuzad,1909,hunter,survival,64,34,30
Queride,area-52,1909,hunter,survival,90,40,50
Effyh,emerald-dream,1907,hunter,survival,200,104,96
Leonilc,tichondrius,1907,hunter,survival,78,36,42
Ingridaniela,aegwynn,1900,hunter,survival,48,35,13
Moroally,sargeras,1900,hunter,survival,48,30,18
Kzmo,gnomeregan,1896,hunter,survival,35,25,10
Coggenda,sargeras,1895,hunter,survival,341,180,161
Drasen,deathwing,1890,hunter,survival,60,31,29
Møéÿsgïrîxø,tichondrius,1888,hunter,survival,31,20,11
Truckrsaurus,tichondrius,1882,hunter,survival,111,59,52
Anisphia,tichondrius,1882,hunter,survival,305,160,145
Otii,tichondrius,1880,hunter,survival,172,82,90
Bergy,thrall,1873,hunter,survival,54,30,24
Nishinos,tichondrius,1868,hunter,survival,297,152,145
Notnunca,tichondrius,1865,hunter,survival,66,34,32
Jalinhabbei,azralon,1862,hunter,survival,53,28,25
Dirtysoap,tichondrius,1861,hunter,survival,63,31,32
Gvoo,tichondrius,1858,hunter,survival,36,28,8
Runecrossbow,barthilas,1855,hunter,survival,162,79,83
Destrumz,zuljin,1855,hunter,survival,66,31,35
Tyjes,stormrage,1851,hunter,survival,75,41,34
Lawyerpbj,tichondrius,1851,hunter,survival,48,24,24
Hibyexo,illidan,1849,hunter,survival,48,32,16
Chiline,frostmourne,1849,hunter,survival,54,29,25
Buffnac,tichondrius,1848,hunter,survival,60,29,31
Kelarcia,moon-guard,1846,hunter,survival,65,29,36
Boogiemas,akama,1845,hunter,survival,48,29,19
Neonjz,ragnaros,1843,hunter,survival,126,61,65
Pylorih,area-52,1842,hunter,survival,51,35,16
Stinkyfob,barthilas,1841,hunter,survival,102,54,48
Artêêzy,illidan,1840,hunter,survival,23,20,3
Feignqt,illidan,1840,hunter,survival,48,25,23
Chimeralol,area-52,1839,hunter,survival,132,81,51
Raef,azralon,1838,hunter,survival,72,38,34
Ordius,azralon,1837,hunter,survival,60,33,27
Ssds,sargeras,1834,hunter,survival,42,26,16
Foxwalk,nemesis,1834,hunter,survival,70,33,37
Mørødox,sargeras,1832,hunter,survival,30,23,7
Fizzleegear,area-52,1831,hunter,survival,225,110,115
Focús,laughing-skull,1828,hunter,survival,108,55,53
Goonsh,tichondrius,1826,hunter,survival,48,32,16
Mlemily,stormrage,1826,hunter,survival,47,31,16
Unicom,malganis,1826,hunter,survival,36,22,14
Éshen,illidan,1826,hunter,survival,101,53,48
Aaggros,sargeras,1825,hunter,survival,42,20,22
Bjornwald,thrall,1824,hunter,survival,410,214,196
Angrybow,ragnaros,1821,hunter,survival,36,25,11
Misogynistaf,tichondrius,1821,hunter,survival,40,22,18
Arcobaleno,tichondrius,1821,hunter,survival,60,32,28
Thoromel,wyrmrest-accord,1820,hunter,survival,66,33,33
Toozz,frostmourne,1819,hunter,survival,42,26,16
Finito,bladefist,1818,hunter,survival,305,151,154
Shootin,frostmourne,1817,hunter,survival,60,34,26
Alphaqt,dethecus,1816,hunter,survival,48,27,21
Savagerko,illidan,1816,hunter,survival,75,42,33
Concur,frostmourne,1816,hunter,survival,132,69,63
Kisuke,khaz-modan,1815,hunter,survival,54,34,20
Hawkem,illidan,1815,hunter,survival,48,28,20
Trapula,tichondrius,1814,hunter,survival,84,46,38
Terapista,area-52,1813,hunter,survival,90,45,45
Leaku,illidan,1810,hunter,survival,64,41,23
Axezul,tichondrius,1810,hunter,survival,84,48,36
Emart,bloodhoof,1810,hunter,survival,69,32,37
Joón,moon-guard,1808,hunter,survival,43,26,17
Jagaerz,emerald-dream,1808,hunter,survival,42,23,19
Krømatik,tichondrius,1807,hunter,survival,42,23,19
Plainrain,tichondrius,1803,hunter,survival,77,48,29
Adjusted,frostmourne,1802,hunter,survival,36,21,15
Vigon,stormrage,1802,hunter,survival,147,83,64
Ratonh,ragnaros,1801,hunter,survival,156,88,68
Saltstream,tichondrius,1801,hunter,survival,132,60,72
Huntmon,nemesis,1800,hunter,survival,48,31,17
Yiyixx,tichondrius,1798,hunter,survival,36,19,17
Sartel,tichondrius,1794,hunter,survival,244,123,121
Caiodluffy,malganis,1791,hunter,survival,78,41,37
Redhøød,moon-guard,1788,hunter,survival,36,19,17
Kensho,illidan,1784,hunter,survival,85,39,46
Pivott,wyrmrest-accord,1782,hunter,survival,328,176,152
Percival,firetree,1782,hunter,survival,54,27,27
Skàdii,tichondrius,1778,hunter,survival,115,63,52
Lenacraft,frostmourne,1776,hunter,survival,54,31,23
Sniffler,barthilas,1772,hunter,survival,42,19,23
Svhunt,frostmourne,1768,hunter,survival,43,24,19
Frêäkk,ragnaros,1767,hunter,survival,51,29,22
Carnidon,area-52,1765,hunter,survival,217,108,109
Acres,emerald-dream,1765,hunter,survival,66,32,34
Mambothehunt,stormrage,1764,hunter,survival,84,39,45
Sylvanne,sargeras,1762,hunter,survival,57,28,29
Douggigadome,illidan,1761,hunter,survival,36,21,15
Pathed,azralon,1761,hunter,survival,54,31,23
Trevyx,aegwynn,1761,hunter,survival,120,68,52
Woriath,quelthalas,1761,hunter,survival,96,50,46
Yná,nemesis,1760,hunter,survival,42,24,18
Poston,ragnaros,1758,hunter,survival,153,78,75
Tøkÿöghøül,agamaggan,1757,hunter,survival,42,26,16
Kimchishotxo,tichondrius,1756,hunter,survival,41,22,19
Sensator,barthilas,1753,hunter,survival,58,33,25
Vlf,tichondrius,1753,hunter,survival,60,30,30
Exhausted,blackrock,1747,hunter,survival,98,43,55
Jîñßæçhïñæ,sargeras,1745,hunter,survival,72,30,42
Saelym,arthas,1739,hunter,survival,48,22,26
Henroyer,quelthalas,1733,hunter,survival,48,30,18
Envoltorio,ragnaros,1732,hunter,survival,60,33,27
Inktray,durotan,1730,hunter,survival,36,23,13
Crypy,illidan,1730,hunter,survival,54,28,26
Petrà,tichondrius,1729,hunter,survival,39,20,19
Sobit,tichondrius,1728,hunter,survival,48,25,23
Peppancini,wyrmrest-accord,1725,hunter,survival,53,34,19
Wvwvwvwvwvww,stormrage,1721,hunter,survival,42,24,18
Darkshady,tichondrius,1718,hunter,survival,30,18,12
Krouno,ragnaros,1716,hunter,survival,78,42,36
Buttercocoa,kelthuzad,1712,hunter,survival,36,18,18
Stevemonday,stormrage,1711,hunter,survival,96,53,43
Henhøuse,illidan,1710,hunter,survival,54,25,29
Yeahimsad,tichondrius,1709,hunter,survival,24,18,6
Limpingspoon,kelthuzad,1708,hunter,survival,166,94,72
Viólenc,tichondrius,1708,hunter,survival,54,29,25
Róckzero,quelthalas,1708,hunter,survival,211,105,106
Názzul,area-52,1705,hunter,survival,30,18,12
Knewbee,emerald-dream,1704,hunter,survival,81,44,37
Violenc,tichondrius,1704,hunter,survival,42,22,20
Partz,darkspear,1702,hunter,survival,56,35,21
Eref,sargeras,1702,hunter,survival,42,18,24
Javlinz,thrall,1701,hunter,survival,44,20,24
Scytsbow,illidan,1700,hunter,survival,48,26,22
Samcro,rivendare,1700,hunter,survival,65,33,32
Toxarch,aggramar,1698,hunter,survival,48,26,22
Yip,moon-guard,1698,hunter,survival,39,20,19
Spinze,stormrage,1697,hunter,survival,35,23,12
Xtralitê,tichondrius,1696,hunter,survival,50,38,12
Bbaronsamedi,darkspear,1693,hunter,survival,51,27,24
Gnarwallz,stormrage,1691,hunter,survival,60,32,28
Táká,quelthalas,1689,hunter,survival,60,38,22
Noxtis,kiljaeden,1689,hunter,survival,36,18,18
Arrów,duskwood,1688,hunter,survival,36,18,18
Soyos,sargeras,1687,hunter,survival,150,81,69
Irishredd,undermine,1682,hunter,survival,32,19,13
Budgetben,stormrage,1682,hunter,survival,33,19,14
Blåker,bleeding-hollow,1682,hunter,survival,96,49,47
Nussyo,tichondrius,1679,hunter,survival,54,26,28
Grandpopjim,illidan,1678,hunter,survival,36,20,16
Shablagoosh,zuljin,1672,hunter,survival,45,23,22
Ryukotsu,tichondrius,1671,hunter,survival,55,26,29
Arsk,ragnaros,1670,hunter,survival,45,19,26
Yolloswag,tichondrius,1666,hunter,survival,182,98,84
Dju,stormrage,1665,hunter,survival,60,27,33
Interleukin,frostwolf,1664,hunter,survival,244,132,112
Huntardzz,area-52,1663,hunter,survival,56,43,13
Fälke,stormrage,1662,hunter,survival,54,30,24
Trapgodxo,moon-guard,1658,hunter,survival,27,19,8
Fleche,aggramar,1658,hunter,survival,30,20,10
Sharkzooka,illidan,1658,hunter,survival,47,20,27
Wingclippin,stormrage,1656,hunter,survival,36,22,14
Reeiko,ragnaros,1654,hunter,survival,54,31,23
Ganemdar,sargeras,1653,hunter,survival,57,22,35
Drezzial,illidan,1651,hunter,survival,39,23,16
Ajacs,zuljin,1647,hunter,survival,35,24,11
Undien,area-52,1647,hunter,survival,60,35,25
Survïvalïst,bleeding-hollow,1643,hunter,survival,35,21,14
Krøww,azralon,1642,hunter,survival,39,22,17
Rvn,kelthuzad,1641,hunter,survival,36,20,16
Clawdio,ragnaros,1641,hunter,survival,114,60,54
Asarden,jubeithos,1639,hunter,survival,96,53,43
Bendotexe,stormrage,1638,hunter,survival,36,21,15
Iyne,stormrage,1635,hunter,survival,36,23,13
Zêrø,moon-guard,1635,hunter,survival,52,29,23
Huntardadoo,nemesis,1634,hunter,survival,45,23,22
Covloltrap,illidan,1633,hunter,survival,24,21,3
Vinnieone,kiljaeden,1633,hunter,survival,36,26,10
Vhelkan,senjin,1632,hunter,survival,42,26,16
Nimeer,tichondrius,1632,hunter,survival,82,45,37
Moartraps,zuljin,1631,hunter,survival,42,24,18
Rezkiin,tichondrius,1629,hunter,survival,42,23,19
Nandorius,proudmoore,1628,hunter,survival,90,45,45
Nightarrows,area-52,1626,hunter,survival,41,24,17
Hazzeth,thrall,1625,hunter,survival,30,19,11
Glockin,zuljin,1625,hunter,survival,30,17,13
Køjo,emerald-dream,1624,hunter,survival,55,34,21
Bigbillx,tichondrius,1623,hunter,survival,30,17,13
Shakeasaurus,sargeras,1622,hunter,survival,42,20,22
Piñg,tichondrius,1621,hunter,survival,30,18,12
Viòlenc,tichondrius,1621,hunter,survival,41,24,17
Skyland,tichondrius,1621,hunter,survival,60,32,28
Dazarrow,burning-blade,1621,hunter,survival,47,20,27
Mxabyycc,tichondrius,1619,hunter,survival,60,33,27
Wingclipt,stormrage,1619,hunter,survival,41,17,24
Shinhyez,tichondrius,1618,hunter,survival,42,21,21
Titanaxis,tichondrius,1617,hunter,survival,301,155,146
Awârz,drakkari,1615,hunter,survival,44,27,17
Zanira,stormrage,1614,hunter,survival,60,35,25
Cuddlestomp,magtheridon,1614,hunter,survival,46,24,22
Xenonviper,bleeding-hollow,1612,hunter,survival,114,59,55
Blackdevil,magtheridon,1612,hunter,survival,54,25,29
Huntingjutsu,kelthuzad,1609,hunter,survival,95,55,40
Fkurrules,frostmourne,1608,hunter,survival,109,59,50
Killshøtß,tichondrius,1604,hunter,survival,102,51,51
Nicochan,senjin,1603,hunter,survival,76,34,42
Schurk,illidan,1602,hunter,survival,126,67,59
Cybella,darkspear,1602,hunter,survival,77,39,38
Adobo,garona,1600,hunter,survival,30,21,9
Zakorai,thrall,1600,hunter,survival,146,85,61
Imapacifist,barthilas,1600,hunter,survival,69,37,32
Huntranger,malganis,1599,hunter,survival,77,42,35
Downer,antonidas,1599,hunter,survival,89,46,43
Snowynightt,proudmoore,1598,hunter,survival,192,92,100
Rojpube,frostmourne,1596,hunter,survival,35,17,18
Apokryph,stormrage,1595,hunter,survival,94,65,29
Mckim,tichondrius,1595,hunter,survival,47,23,24
Kukulkan,haomarush,1594,hunter,survival,138,74,64
Ophois,lightbringer,1593,hunter,survival,84,42,42
Lovethabeans,zangarmarsh,1590,hunter,survival,77,45,32
Giraffetrap,zuljin,1588,hunter,survival,24,17,7
Keelif,arthas,1588,hunter,survival,29,17,12
Stylebende,tichondrius,1588,hunter,survival,42,22,20
Noxickk,sargeras,1587,hunter,survival,30,19,11
Squeakerx,sargeras,1585,hunter,survival,29,19,10
Liekis,darkspear,1585,hunter,survival,66,27,39
Helïos,drakkari,1584,hunter,survival,66,36,30
Wildoldman,stormrage,1583,hunter,survival,24,17,7
Mmx,whisperwind,1583,hunter,survival,79,45,34
Prêd,malganis,1582,hunter,survival,34,19,15
Uhm,laughing-skull,1582,hunter,survival,112,61,51
Jésús,dalaran,1581,hunter,survival,33,17,16
Xtina,drakkari,1577,hunter,survival,71,40,31
Fabfilter,tichondrius,1577,hunter,survival,46,24,22
Randël,nemesis,1576,hunter,survival,77,43,34
Darkvicious,area-52,1574,hunter,survival,65,35,30
Xebbec,sargeras,1571,hunter,survival,80,43,37
Freebeë,area-52,1568,hunter,survival,48,26,22
Warhog,wyrmrest-accord,1568,hunter,survival,67,35,32
Pedropete,barthilas,1564,hunter,survival,42,17,25
Bambii,fizzcrank,1561,hunter,survival,73,40,33
Stepzback,malganis,1560,hunter,survival,36,19,17
Kaitoo,tichondrius,1560,hunter,survival,65,33,32
Mckennagrace,tichondrius,1558,hunter,survival,54,29,25
Drifting,bleeding-hollow,1555,hunter,survival,71,39,32
Réxon,quelthalas,1555,hunter,survival,117,53,64
Ryohlin,sargeras,1554,hunter,survival,63,37,26
Lfg,bleeding-hollow,1553,hunter,survival,53,31,22
Shtealo,ragnaros,1553,hunter,survival,80,45,35
Kimbaa,tichondrius,1553,hunter,survival,83,41,42
Huntasaurus,saurfang,1553,hunter,survival,66,32,34
Arazian,stormrage,1550,hunter,survival,58,31,27
Hildebald,moon-guard,1549,hunter,survival,64,37,27
Dooper,malfurion,1548,hunter,survival,105,51,54
Demtings,dark-iron,1545,hunter,survival,50,21,29
Equilibrium,tol-barad,1544,hunter,survival,153,79,74
Aheefeog,proudmoore,1543,hunter,survival,42,24,18
Prv,stormrage,1542,hunter,survival,36,23,13
Dephobius,azralon,1540,hunter,survival,71,37,34
Legalt,tichondrius,1539,hunter,survival,80,42,38
Violénc,tichondrius,1538,hunter,survival,46,18,28
Yandralen,kiljaeden,1536,hunter,survival,65,41,24
Trapdaddyx,thrall,1534,hunter,survival,24,16,8
Kuzar,thrall,1530,hunter,survival,30,16,14
Viiu,sargeras,1528,hunter,survival,24,16,8
Arrowmatic,frostmourne,1527,hunter,survival,24,16,8
Seanpennis,barthilas,1527,hunter,survival,30,16,14
Altarare,ragnaros,1527,hunter,survival,297,146,151
Exh,tichondrius,1527,hunter,survival,107,52,55
Ripsurvival,area-52,1526,hunter,survival,52,29,23
Trappah,stormrage,1525,hunter,survival,24,16,8
Tharoks,tichondrius,1525,hunter,survival,66,34,32
Berenal,moon-guard,1525,hunter,survival,162,77,85
Sativ,moknathal,1524,hunter,survival,54,27,27
Offensive,dragonmaw,1522,hunter,survival,49,28,21
Opsi,ragnaros,1522,hunter,survival,76,36,40
Dorkins,azralon,1521,hunter,survival,75,35,40
Spitballa,emerald-dream,1520,hunter,survival,52,25,27
Meowtard,kaelthas,1520,hunter,survival,66,31,35
Rhyzen,drenden,1519,hunter,survival,30,18,12
Vindication,ysera,1517,hunter,survival,30,17,13
Brewster,burning-legion,1517,hunter,survival,30,16,14
Ifoxs,bleeding-hollow,1517,hunter,survival,30,16,14
Ronnïn,proudmoore,1517,hunter,survival,42,21,21
Trap,vashj,1512,hunter,survival,36,21,15
Ceejaee,tichondrius,1511,hunter,survival,66,31,35
Mateko,amanthul,1510,hunter,survival,74,35,39
Bigiesmalls,moon-guard,1509,hunter,survival,84,41,43
Nigthunt,quelthalas,1504,hunter,survival,77,43,34
Ajira,stormrage,1504,hunter,survival,63,34,29
Jubulba,frostwolf,1502,hunter,survival,24,16,8
Kurnos,hyjal,1500,hunter,survival,46,27,19
Civvo,dalaran,1500,hunter,survival,98,52,46
Holbrook,greymane,1499,hunter,survival,77,41,36
Kenjipoo,tichondrius,1499,hunter,survival,48,23,25
Swordshot,moon-guard,1499,hunter,survival,127,60,67
Dirtypolee,bleeding-hollow,1497,hunter,survival,117,58,59
Pfizershot,tichondrius,1496,hunter,survival,54,28,26
Fâmôûs,tichondrius,1495,hunter,survival,36,19,17
Darkèlfo,azralon,1493,hunter,survival,68,42,26
Gilæd,kelthuzad,1493,hunter,survival,41,21,20
Spromix,ragnaros,1490,hunter,survival,45,24,21
Dogwoöd,emerald-dream,1488,hunter,survival,30,16,14
Met,dentarg,1488,hunter,survival,56,26,30
Fuzzypjs,stormrage,1486,hunter,survival,53,34,19
Kekkww,hyjal,1486,hunter,survival,40,17,23
Trumpmerica,illidan,1486,hunter,survival,58,20,38
Carnosynn,sargeras,1484,hunter,survival,30,19,11
Kyoü,drakkari,1483,hunter,survival,82,51,31
Woeisyou,stormrage,1481,hunter,survival,72,35,37
Crongar,magtheridon,1480,hunter,survival,36,18,18
Ropivacaine,illidan,1479,hunter,survival,36,17,19
Fangtreason,sargeras,1478,hunter,survival,42,22,20
Shooting,sargeras,1478,hunter,survival,129,65,64
Orgpopeyes,illidan,1478,hunter,survival,55,23,32
Rooman,ragnaros,1477,hunter,survival,48,24,24
Triplethreat,bleeding-hollow,1475,hunter,survival,98,52,46
Lyler,tichondrius,1474,hunter,survival,63,33,30
Elmoon,zuljin,1474,hunter,survival,36,18,18
Kaiholeo,tichondrius,1473,hunter,survival,36,21,15
Rúdrá,area-52,1468,hunter,survival,145,76,69
Eliandriss,quelthalas,1468,hunter,survival,70,33,37
Liñcoln,sargeras,1467,hunter,survival,34,18,16
Wharble,illidan,1464,hunter,survival,72,37,35
Huntardxo,moon-guard,1464,hunter,survival,45,23,22
Volkr,bleeding-hollow,1460,hunter,survival,108,55,53
Alby,deathwing,1459,hunter,survival,67,33,34
Søapbubble,tichondrius,1458,hunter,survival,42,24,18
Kaawhii,stormrage,1457,hunter,survival,24,18,6
Lilgayjared,kelthuzad,1456,hunter,survival,88,49,39
Hrywnn,azralon,1455,hunter,survival,252,130,122
Kelx,azralon,1454,hunter,survival,66,35,31
Dversive,nagrand,1452,hunter,survival,33,18,15
Jarhar,nesingwary,1451,hunter,survival,114,54,60
Shadeckz,stormrage,1451,hunter,survival,80,36,44
Darkarrow,hyjal,1443,hunter,survival,67,38,29
Core,gorefiend,1442,hunter,survival,45,21,24
Fallacies,moon-guard,1440,hunter,survival,229,118,111
Pinêapplê,bleeding-hollow,1439,hunter,survival,18,15,3
Mayamia,ragnaros,1439,hunter,survival,84,40,44
Tejodite,thrall,1438,hunter,survival,48,24,24
Gadorim,kelthuzad,1436,hunter,survival,169,80,89
Shytshot,dalaran,1435,hunter,survival,91,46,45
Iol,blades-edge,1434,hunter,survival,87,37,50
Rimjobranger,bleeding-hollow,1433,hunter,survival,48,23,25
That,tichondrius,1428,hunter,survival,46,20,26
Daxar,ragnaros,1428,hunter,survival,42,18,24
Dotaace,emerald-dream,1427,hunter,survival,55,26,29
Vhan,azralon,1426,hunter,survival,172,93,79
Ivansotes,quelthalas,1426,hunter,survival,45,22,23
Kula,haomarush,1424,hunter,survival,52,24,28
Grizzlydeath,stormrage,1421,hunter,survival,60,36,24
Henesis,sargeras,1421,hunter,survival,54,28,26
Anaebody,stormrage,1420,hunter,survival,24,16,8
Rirand,dalaran,1419,hunter,survival,71,36,35
Junglepaw,moon-guard,1419,hunter,survival,60,30,30
Rayuwa,azralon,1419,hunter,survival,151,75,76
Platonium,stormrage,1418,hunter,survival,50,29,21
Dudemanyeah,black-dragonflight,1418,hunter,survival,118,56,62
Soulwarden,haomarush,1417,hunter,survival,36,17,19
Petmychode,illidan,1414,hunter,survival,24,15,9
Sarvaxagar,tichondrius,1414,hunter,survival,30,15,15
Krimzus,hyjal,1414,hunter,survival,71,35,36
Moistbooger,emerald-dream,1407,hunter,survival,36,22,14
Hankjr,thunderlord,1406,hunter,survival,185,103,82
Weedhoof,barthilas,1406,hunter,survival,66,36,30
Soukken,ragnaros,1406,hunter,survival,42,20,22
Jawbreakër,tichondrius,1405,hunter,survival,56,27,29
Ogamì,aegwynn,1404,hunter,survival,46,28,18
Aniraza,ragnaros,1404,hunter,survival,33,18,15
Htniss,tichondrius,1401,hunter,survival,60,28,32
Sukr,korgath,1400,hunter,survival,148,72,76
Raiku,aggramar,1399,hunter,survival,48,22,26
Animityx,illidan,1398,hunter,survival,57,29,28
Aeht,illidan,1397,hunter,survival,36,15,21
Pdg,ragnaros,1394,hunter,survival,78,42,36
Gildthorn,frostmourne,1394,hunter,survival,60,31,29
Dakti,tichondrius,1393,hunter,survival,54,23,31
Vanthel,ragnaros,1390,hunter,survival,91,47,44
Azx,tichondrius,1389,hunter,survival,60,25,35
Zänich,tichondrius,1387,hunter,survival,36,18,18
Casadega,sargeras,1386,hunter,survival,28,18,10
Mookvader,illidan,1383,hunter,survival,42,21,21
Haemøphilus,area-52,1380,hunter,survival,45,22,23
Toross,stormscale,1379,hunter,survival,73,29,44
Bolognã,tichondrius,1378,hunter,survival,29,15,14
Vilguz,illidan,1378,hunter,survival,83,39,44
Arcos,emerald-dream,1376,hunter,survival,24,16,8
Viró,sargeras,1375,hunter,survival,33,17,16
Ryonel,moon-guard,1375,hunter,survival,197,98,99
Thalrae,quelthalas,1374,hunter,survival,96,48,48
Figurinet,sargeras,1369,hunter,survival,30,19,11
Killconfirm,sargeras,1369,hunter,survival,59,24,35
Xuxoo,nemesis,1368,hunter,survival,30,16,14
Fìebs,queldorei,1368,hunter,survival,53,25,28
Pokeahuntasz,frostmourne,1367,hunter,survival,42,24,18
Hunterdemond,ragnaros,1367,hunter,survival,107,51,56
Riivali,quelthalas,1366,hunter,survival,72,36,36
Dreebizz,gorefiend,1365,hunter,survival,128,63,65
Navagee,tichondrius,1364,hunter,survival,47,25,22
Evilfury,tichondrius,1363,hunter,survival,220,106,114
Hawkethorn,moon-guard,1361,hunter,survival,98,44,54
Gichiwalrus,emerald-dream,1358,hunter,survival,96,52,44
Wetpeach,frostmourne,1357,hunter,survival,58,29,29
Audiofly,tichondrius,1356,hunter,survival,135,71,64
Tuohnosaj,sargeras,1353,hunter,survival,138,63,75
Gunka,illidan,1349,hunter,survival,35,17,18
Xfo,bleeding-hollow,1346,hunter,survival,42,25,17
Joeexotíc,moknathal,1344,hunter,survival,30,16,14
Sarqis,lightbringer,1344,hunter,survival,36,17,19
Lavo,borean-tundra,1344,hunter,survival,43,17,26
Lamerpvp,tichondrius,1343,hunter,survival,18,14,4
Zizzo,eonar,1343,hunter,survival,60,29,31
Vogtfog,tichondrius,1343,hunter,survival,36,17,19
Ickstab,illidan,1342,hunter,survival,18,14,4
Tumerok,barthilas,1342,hunter,survival,24,14,10
Adroi,tichondrius,1341,hunter,survival,36,14,22
Champjones,senjin,1339,hunter,survival,24,14,10
Jollycraze,spirestone,1337,hunter,survival,18,14,4
Anêmos,ragnaros,1337,hunter,survival,24,14,10
Crissy,crushridge,1335,hunter,survival,58,31,27
Jyñ,malganis,1335,hunter,survival,36,15,21
Sniperælite,korgath,1335,hunter,survival,36,14,22
Åpe,illidan,1334,hunter,survival,24,14,10
Quepop,demon-soul,1334,hunter,survival,72,37,35
Clinteastwoo,ragnaros,1334,hunter,survival,30,14,16
Exxonerous,sargeras,1333,hunter,survival,108,52,56
Noguns,tichondrius,1333,hunter,survival,30,14,16
Bowzørx,tichondrius,1331,hunter,survival,30,14,16
Bigsexi,kiljaeden,1329,hunter,survival,62,27,35
Sufutih,proudmoore,1329,hunter,survival,59,25,34
Inheart,khazgoroth,1328,hunter,survival,84,37,47
Madhuntter,azralon,1323,hunter,survival,30,14,16
Pablita,drakkari,1322,hunter,survival,24,15,9
Ariran,illidan,1322,hunter,survival,36,17,19
Myrfes,ragnaros,1320,hunter,survival,60,25,35
Taiberianrex,khazgoroth,1317,hunter,survival,48,28,20
Cuervostreet,ragnaros,1317,hunter,survival,90,43,47
Buggyhuntz,stormrage,1317,hunter,survival,42,16,26
Bangerzx,stormrage,1315,hunter,survival,30,18,12
Cocobread,stormreaver,1315,hunter,survival,102,43,59
Nippoc,aerie-peak,1314,hunter,survival,18,14,4
Chiad,kargath,1313,hunter,survival,42,25,17
Éygon,sargeras,1311,hunter,survival,39,17,22
Mypeach,frostmourne,1310,hunter,survival,66,33,33
Wìllòw,khazgoroth,1310,hunter,survival,74,35,39
Rogaldornn,thrall,1307,hunter,survival,53,26,27
Draban,stormrage,1305,hunter,survival,30,14,16
Lorethor,kaelthas,1305,hunter,survival,42,17,25
Snoopinator,malganis,1305,hunter,survival,42,15,27
Wrathofexwif,proudmoore,1304,hunter,survival,36,20,16
Zorht,ragnaros,1301,hunter,survival,206,103,103
Yesthyra,sargeras,1301,hunter,survival,30,14,16
Bredys,quelthalas,1295,hunter,survival,42,15,27
Cvelian,tichondrius,1293,hunter,survival,60,23,37
Rykbad,area-52,1292,hunter,survival,49,28,21
Xochiquetzal,jubeithos,1288,hunter,survival,24,18,6
Bleedwish,tichondrius,1288,hunter,survival,23,14,9
Hovahdo,proudmoore,1287,hunter,survival,35,14,21
Lashga,wyrmrest-accord,1279,hunter,survival,45,17,28
Extremis,emerald-dream,1277,hunter,survival,124,59,65
Vongard,wyrmrest-accord,1277,hunter,survival,52,24,28
Austelos,moon-guard,1275,hunter,survival,23,14,9
Nanotorque,moon-guard,1273,hunter,survival,84,44,40
Luangg,tichondrius,1269,hunter,survival,26,14,12
Jerusa,illidan,1268,hunter,survival,23,14,9
Gxswow,tichondrius,1268,hunter,survival,66,30,36
Seratoninx,malganis,1267,hunter,survival,29,14,15
Ghuntcassh,quelthalas,1262,hunter,survival,30,18,12
Laurett,ragnaros,1253,hunter,survival,39,19,20
Fancyox,frostmourne,1247,hunter,survival,18,13,5
Honorola,twisting-nether,1247,hunter,survival,18,13,5
Duckpow,frostmourne,1247,hunter,survival,60,24,36
Akigga,arthas,1246,hunter,survival,42,24,18
Maran,chogall,1245,hunter,survival,18,13,5
Twodoobies,ghostlands,1243,hunter,survival,24,13,11
Bicflop,azralon,1241,hunter,survival,18,13,5
Ganderion,sargeras,1240,hunter,survival,27,14,13
Nowê,azralon,1239,hunter,survival,36,15,21
Ariädne,sargeras,1239,hunter,survival,72,27,45
Bubblesh,whisperwind,1234,hunter,survival,36,18,18
Obsididan,aerie-peak,1234,hunter,survival,30,14,16
Mameikilled,saurfang,1233,hunter,survival,18,13,5
Sealteamrick,frostmourne,1231,hunter,survival,30,15,15
Grayrat,trollbane,1221,hunter,survival,24,14,10
Pastelitoz,tichondrius,1221,hunter,survival,55,21,34
Nucleosome,stormrage,1219,hunter,survival,24,13,11
Yory,tol-barad,1217,hunter,survival,30,15,15
Diebleeding,ragnaros,1210,hunter,survival,29,13,16
Cufless,proudmoore,1204,hunter,survival,36,13,23
Arkeryn,azralon,1203,hunter,survival,18,13,5
Firesail,kelthuzad,1199,hunter,survival,79,36,43
Natsai,illidan,1199,hunter,survival,72,32,40
Rensv,frostmourne,1190,hunter,survival,56,30,26
Rairin,tichondrius,1190,hunter,survival,47,20,27
Tinsho,drakkari,1187,hunter,survival,72,35,37
Wartoz,dragonblight,1172,hunter,survival,104,62,42
Vansatih,azralon,1172,hunter,survival,172,93,79
Villainshunt,stormrage,1170,hunter,survival,41,17,24
Allahakbar,ragnaros,1169,hunter,survival,36,15,21
Gruì,malganis,1168,hunter,survival,26,13,13
Félíx,ragnaros,1168,hunter,survival,56,25,31
Kukulkán,muradin,1164,hunter,survival,28,13,15
Travail,illidan,1163,hunter,survival,24,17,7
Banai,the-underbog,1163,hunter,survival,79,32,47
Trapordie,stormrage,1162,hunter,survival,30,13,17
Skriill,tichondrius,1161,hunter,survival,72,30,42
Daymanaahh,malfurion,1159,hunter,survival,56,24,32
Mokuraak,emerald-dream,1154,hunter,survival,42,20,22
Gigabigly,wyrmrest-accord,1152,hunter,survival,18,12,6
Yøske,tichondrius,1152,hunter,survival,18,12,6
Gunicks,illidan,1152,hunter,survival,24,12,12
Musculate,firetree,1151,hunter,survival,24,12,12
Drunknachos,bleeding-hollow,1150,hunter,survival,24,12,12
Broskina,stormrage,1150,hunter,survival,24,12,12
Crimsoncoast,tichondrius,1149,hunter,survival,18,12,6
Ðfac,moon-guard,1149,hunter,survival,24,12,12
Barnbougle,sargeras,1149,hunter,survival,24,12,12
Imbrokenlol,kiljaeden,1148,hunter,survival,30,12,18
Expskippy,darkspear,1146,hunter,survival,55,34,21
Arigon,frostmane,1144,hunter,survival,24,12,12
Emiri,dalaran,1141,hunter,survival,42,14,28
Leftty,illidan,1140,hunter,survival,30,12,18
Otternaught,tichondrius,1139,hunter,survival,18,12,6
Xitara,stormrage,1137,hunter,survival,24,12,12
Chopsley,feathermoon,1136,hunter,survival,71,30,41
Stoleurgurl,sargeras,1136,hunter,survival,30,12,18
Rokimi,muradin,1129,hunter,survival,24,12,12
Ashtron,trollbane,1129,hunter,survival,30,12,18
Ligerjin,ragnaros,1122,hunter,survival,30,12,18
Laralodge,stormrage,1121,hunter,survival,90,37,53
Eastera,tichondrius,1119,hunter,survival,68,30,38
Rayhuntard,tichondrius,1115,hunter,survival,23,12,11
Superiorkill,arathor,1113,hunter,survival,31,13,18
Abdias,ragnaros,1104,hunter,survival,84,35,49
Kaïmsael,kelthuzad,1101,hunter,survival,155,85,70
Chicall,kalecgos,1096,hunter,survival,31,13,18
Lesseneth,aegwynn,1072,hunter,survival,48,20,28
Zhafiro,drakkari,1069,hunter,survival,48,27,21
Arucedd,frostmourne,1068,hunter,survival,87,49,38
Eskii,moon-guard,1059,hunter,survival,48,25,23
Kalgorn,emerald-dream,1059,hunter,survival,34,16,18
Scythedom,tichondrius,1056,hunter,survival,18,11,7
Summerdope,aggramar,1056,hunter,survival,18,11,7
Cptx,kelthuzad,1056,hunter,survival,18,11,7
Anooß,tichondrius,1056,hunter,survival,21,12,9
Ïkite,zuljin,1055,hunter,survival,18,11,7
Lovevv,frostmourne,1055,hunter,survival,18,11,7
Nevertraps,frostmourne,1055,hunter,survival,18,11,7
Maxlol,stormrage,1055,hunter,survival,24,11,13
Plsbepatient,wyrmrest-accord,1054,hunter,survival,18,11,7
Malikyr,moon-guard,1054,hunter,survival,28,12,16
Reignwolf,nemesis,1053,hunter,survival,18,11,7
Jaw,hakkar,1053,hunter,survival,18,11,7
Sagadegêmeos,stormrage,1053,hunter,survival,18,11,7
Nautílus,ragnaros,1053,hunter,survival,24,11,13
Ælij,tichondrius,1051,hunter,survival,24,11,13
Thoriden,amanthul,1051,hunter,survival,54,14,40
Eithelleta,frostmourne,1039,hunter,survival,116,49,67
Pêtophile,kiljaeden,1037,hunter,survival,54,24,30
Panm,runetotem,1034,hunter,survival,27,12,15
Vizkha,azralon,1033,hunter,survival,24,12,12
Triggers,ghostlands,1033,hunter,survival,30,11,19
Phasm,ravencrest,1030,hunter,survival,18,11,7
Fisthammer,frostmane,1018,hunter,survival,30,16,14
Wkx,tichondrius,1017,hunter,survival,26,12,14
Jaykwan,boulderfist,1016,hunter,survival,23,11,12
Loochlin,sargeras,1014,hunter,survival,33,11,22
Luckboy,tichondrius,1009,hunter,survival,189,92,97
Rukkora,deathwing,1009,hunter,survival,66,30,36
Sliturthroat,barthilas,1005,hunter,survival,21,11,10
Lucarcher,stormrage,988,hunter,survival,17,11,6
Thrandrial,smolderthorn,985,hunter,survival,20,11,9
Hellrayserr,azralon,970,hunter,survival,24,11,13
Virindi,barthilas,960,hunter,survival,12,10,2
Sbgrv,dalaran,960,hunter,survival,18,10,8
Fancyxo,frostmourne,960,hunter,survival,18,10,8
Covlolzz,illidan,960,hunter,survival,24,10,14
Zipzyo,tichondrius,960,hunter,survival,24,10,14
Corpo,area-52,960,hunter,survival,24,10,14
Snipin,ragnaros,960,hunter,survival,30,10,20
Kêdokî,sargeras,959,hunter,survival,12,10,2
Reeload,tichondrius,959,hunter,survival,18,10,8
Clampula,sargeras,959,hunter,survival,18,10,8
Rickybobby,warsong,959,hunter,survival,18,10,8
Tyleraq,area-52,959,hunter,survival,18,10,8
Zizilio,kelthuzad,959,hunter,survival,18,10,8
Egurl,firetree,959,hunter,survival,18,10,8
Narakara,stormreaver,959,hunter,survival,21,11,10
Slomp,bleeding-hollow,959,hunter,survival,24,10,14
Venoc,bleeding-hollow,959,hunter,survival,24,10,14
Araqíel,aegwynn,959,hunter,survival,24,10,14
Kaldrool,frostmourne,959,hunter,survival,27,11,16
Oattes,daggerspine,958,hunter,survival,24,10,14
Firskin,frostmourne,958,hunter,survival,28,11,17
Kimchimaster,tichondrius,958,hunter,survival,26,10,16
Fanikita,azralon,957,hunter,survival,15,11,4
Wouow,tichondrius,957,hunter,survival,18,10,8
Deejwithabow,frostmourne,957,hunter,survival,18,10,8
Rockehm,frostmourne,957,hunter,survival,18,10,8
Genesiz,sargeras,957,hunter,survival,24,10,14
Daréz,blackrock,956,hunter,survival,16,11,5
Vietnrg,doomhammer,954,hunter,survival,24,10,14
Jerza,emerald-dream,953,hunter,survival,18,10,8
Najmoira,area-52,950,hunter,survival,18,10,8
Calÿpsø,quelthalas,943,hunter,survival,14,12,2
Syvarris,medivh,943,hunter,survival,17,10,7
Puffcopeak,illidan,943,hunter,survival,17,10,7
Imraghorn,sargeras,943,hunter,survival,23,10,13
Amarox,zuljin,938,hunter,survival,23,11,12
Gairkill,area-52,927,hunter,survival,104,53,51
Khaoskills,thunderlord,926,hunter,survival,49,26,23
Gelter,stormrage,924,hunter,survival,23,10,13
Tempistworg,greymane,912,hunter,survival,110,53,57
Crapshot,daggerspine,885,hunter,survival,33,10,23
Turkshot,area-52,875,hunter,survival,25,10,15
Jaywaz,tichondrius,864,hunter,survival,12,9,3
Ÿöskë,tichondrius,864,hunter,survival,12,9,3
Hunterguyy,tichondrius,864,hunter,survival,12,9,3
Tigglyjits,tichondrius,864,hunter,survival,12,9,3
Jäger,zuljin,864,hunter,survival,12,9,3
Weedzy,tichondrius,864,hunter,survival,12,9,3
Magvez,tichondrius,864,hunter,survival,18,9,9
Eain,wyrmrest-accord,864,hunter,survival,18,9,9
Alansho,tichondrius,864,hunter,survival,18,9,9
Megaspeed,arthas,864,hunter,survival,18,9,9
Desari,thunderhorn,864,hunter,survival,18,9,9
Scottmeyers,proudmoore,864,hunter,survival,24,9,15
Zumythriel,stormrage,863,hunter,survival,12,9,3
Serpantsting,moon-guard,863,hunter,survival,18,9,9
Negligent,sargeras,863,hunter,survival,18,9,9
Riram,stormrage,863,hunter,survival,18,9,9
Daspx,nagrand,863,hunter,survival,18,9,9
Landscape,kiljaeden,863,hunter,survival,24,9,15
Keenai,moon-guard,862,hunter,survival,12,9,3
Lovoo,sargeras,862,hunter,survival,12,9,3
Contrack,zuljin,862,hunter,survival,19,10,9
Vulkru,azralon,862,hunter,survival,18,9,9
Deerhunt,black-dragonflight,862,hunter,survival,18,9,9
Chootyboi,bronzebeard,862,hunter,survival,18,9,9
Lasagnadaddy,maiev,862,hunter,survival,18,9,9
Shamewizard,barthilas,862,hunter,survival,18,9,9
Packlead,sargeras,861,hunter,survival,18,9,9
Nøzhaha,area-52,861,hunter,survival,18,9,9
Sitalces,ragnaros,859,hunter,survival,60,29,31
Kerion,emerald-dream,859,hunter,survival,24,9,15
Zotahunterx,ragnaros,859,hunter,survival,24,9,15
Blizhunt,thunderlord,859,hunter,survival,24,9,15
Mabaku,tichondrius,858,hunter,survival,12,9,3
Turquesaa,wyrmrest-accord,856,hunter,survival,18,9,9
Drunkbunny,tichondrius,855,hunter,survival,30,14,16
Wolfsorgorr,area-52,854,hunter,survival,24,9,15
Eforas,ragnaros,853,hunter,survival,24,9,15
Prettysure,nesingwary,851,hunter,survival,25,12,13
Lisbboax,stormrage,844,hunter,survival,27,11,16
Shukucingjr,illidan,842,hunter,survival,18,9,9
Blaymorrd,senjin,839,hunter,survival,18,9,9
Mcilreavey,kelthuzad,836,hunter,survival,23,9,14
Defiance,rexxar,831,hunter,survival,16,9,7
Hillside,frostmourne,830,hunter,survival,14,10,4
Bowjoby,kelthuzad,830,hunter,survival,22,9,13
Somethinglit,sargeras,798,hunter,survival,20,9,11
Ærês,ysondre,796,hunter,survival,20,9,11
Gondolin,andorhal,768,hunter,survival,12,8,4
Árröw,arygos,768,hunter,survival,12,8,4
Volbz,barthilas,768,hunter,survival,12,8,4
Iizerd,illidan,768,hunter,survival,12,8,4
Ehz,tichondrius,768,hunter,survival,12,8,4
Kanta,bleeding-hollow,768,hunter,survival,12,8,4
Shootypie,hyjal,768,hunter,survival,12,8,4
Banshers,stormrage,768,hunter,survival,12,8,4
Elccid,tichondrius,768,hunter,survival,12,8,4
Buffmarks,moon-guard,768,hunter,survival,12,8,4
Fiftyyddash,tichondrius,768,hunter,survival,12,8,4
Fineye,illidan,768,hunter,survival,14,8,6
Goromi,tichondrius,768,hunter,survival,18,8,10
Kimssis,tichondrius,768,hunter,survival,18,8,10
Embaçado,bleeding-hollow,768,hunter,survival,18,8,10
Drupert,tichondrius,768,hunter,survival,18,8,10
Igotloud,illidan,768,hunter,survival,18,8,10
Michaeljfox,area-52,768,hunter,survival,18,8,10
Mythfive,stormrage,768,hunter,survival,18,8,10
Diddycombe,stormrage,768,hunter,survival,18,8,10
Madival,ragnaros,768,hunter,survival,18,8,10
Littlechooch,illidan,767,hunter,survival,12,8,4
Hanabî,jubeithos,767,hunter,survival,12,8,4
Nervousness,draka,767,hunter,survival,12,8,4
Brissy,sargeras,767,hunter,survival,18,8,10
Rummaker,mugthol,767,hunter,survival,18,8,10
Korasaya,area-52,767,hunter,survival,18,8,10
Zouzu,area-52,767,hunter,survival,18,8,10
Bruzit,tol-barad,767,hunter,survival,18,8,10
Slimshadie,kiljaeden,767,hunter,survival,18,8,10
Deifyz,stormrage,767,hunter,survival,18,8,10
Booshwookie,frostmourne,767,hunter,survival,18,8,10
Trixster,lethon,767,hunter,survival,18,8,10
Wakkå,mugthol,767,hunter,survival,21,9,12
Mmchode,zuljin,767,hunter,survival,24,8,16
Soberish,bleeding-hollow,767,hunter,survival,24,8,16
Zyzzmirin,illidan,767,hunter,survival,24,8,16
Chokemescara,stormrage,767,hunter,survival,30,8,22
Bowowner,aggramar,767,hunter,survival,30,8,22
Greyh,madoran,766,hunter,survival,12,8,4
Kraslin,bleeding-hollow,766,hunter,survival,12,8,4
Segulah,dalaran,766,hunter,survival,18,8,10
Cynya,wyrmrest-accord,766,hunter,survival,18,8,10
Hunfor,anubarak,766,hunter,survival,18,8,10
Jathriel,zuljin,765,hunter,survival,18,8,10
Lohse,emerald-dream,765,hunter,survival,18,8,10
Sterge,maiev,764,hunter,survival,18,8,10
Ghannha,wyrmrest-accord,764,hunter,survival,18,8,10
Runecbow,eonar,764,hunter,survival,24,8,16
Haumer,wyrmrest-accord,763,hunter,survival,12,8,4
Dgs,nemesis,763,hunter,survival,18,8,10
Alfaan,moon-guard,763,hunter,survival,18,8,10
Querosushi,ragnaros,760,hunter,survival,18,8,10
Kaelgrog,kiljaeden,754,hunter,survival,24,8,16
Iraxium,illidan,735,hunter,survival,14,9,5
Gaahl,aggramar,735,hunter,survival,14,9,5
Thesniperx,sargeras,719,hunter,survival,21,8,13
Thrakgor,wyrmrest-accord,713,hunter,survival,23,10,13
Acidhunt,tichondrius,703,hunter,survival,28,8,20
Dangerrangér,area-52,688,hunter,survival,13,8,5
Kanekki,ragnaros,688,hunter,survival,13,8,5
Yoppa,zuljin,672,hunter,survival,12,7,5
Glediator,tichondrius,672,hunter,survival,12,7,5
Ozzsimp,stormrage,672,hunter,survival,12,7,5
Dumshot,zuljin,672,hunter,survival,12,7,5
Vânillaice,stormrage,672,hunter,survival,12,7,5
Endxworld,tichondrius,672,hunter,survival,12,7,5
Pfheign,area-52,672,hunter,survival,12,7,5
Trapirl,tichondrius,672,hunter,survival,12,7,5
Arraza,ragnaros,672,hunter,survival,12,7,5
Jamesön,sargeras,672,hunter,survival,12,7,5
Mattyhuntz,tichondrius,672,hunter,survival,12,7,5
Antø,tichondrius,672,hunter,survival,12,7,5
Trenbolone,frostmourne,672,hunter,survival,12,7,5
Aquafino,chogall,672,hunter,survival,12,7,5
Fannypacks,dragonmaw,672,hunter,survival,12,7,5
Huntbay,destromath,672,hunter,survival,12,7,5
Vegâ,ursin,672,hunter,survival,12,7,5
Tsuka,eldrethalas,672,hunter,survival,12,7,5
Equalizér,sargeras,672,hunter,survival,12,7,5
Joree,medivh,672,hunter,survival,12,7,5
Oronir,frostmourne,672,hunter,survival,12,7,5
Ayjay,zuljin,672,hunter,survival,12,7,5
Onécare,bleeding-hollow,672,hunter,survival,12,7,5
Freshko,kiljaeden,672,hunter,survival,18,7,11
Porrainga,auchindoun,672,hunter,survival,18,7,11
Bombbot,zuljin,672,hunter,survival,18,7,11
Meowimadog,spinebreaker,672,hunter,survival,18,7,11
Gorgrokk,area-52,672,hunter,survival,18,7,11
Mav,dragonmaw,671,hunter,survival,12,7,5
Pulso,illidan,671,hunter,survival,12,7,5
Genocell,thunderlord,671,hunter,survival,12,7,5
Ziaxel,bleeding-hollow,671,hunter,survival,12,7,5
Suyesh,tichondrius,671,hunter,survival,12,7,5
Jigua,stormrage,671,hunter,survival,12,7,5
Zackèse,area-52,671,hunter,survival,18,7,11
Gaezangsu,tichondrius,671,hunter,survival,24,7,17
Killswitches,dragonmaw,670,hunter,survival,12,7,5
Joskyia,drenden,669,hunter,survival,12,7,5
Hatespark,bonechewer,667,hunter,survival,12,7,5
Illustrus,bleeding-hollow,639,hunter,survival,11,7,4
Catboikilla,altar-of-storms,639,hunter,survival,17,7,10
Mfjl,tichondrius,639,hunter,survival,22,7,15
Cagooggo,moon-guard,638,hunter,survival,16,7,9
Rotthem,ragnaros,638,hunter,survival,20,8,12
Trappin,malganis,623,hunter,survival,11,7,4
Lartrius,bleeding-hollow,621,hunter,survival,15,8,7
Tagsy,quelthalas,613,hunter,survival,31,10,21
Arrebol,tichondrius,608,hunter,survival,16,7,9
Primez,sargeras,607,hunter,survival,11,7,4
Odynsraven,stormrage,605,hunter,survival,11,7,4
Mimimoumou,tichondrius,576,hunter,survival,6,6,0
Ðevil,ragnaros,576,hunter,survival,6,6,0
Drees,nerzhul,576,hunter,survival,6,6,0
Jåden,kelthuzad,576,hunter,survival,6,6,0
Garkia,hyjal,576,hunter,survival,6,6,0
Swinky,tichondrius,576,hunter,survival,10,7,3
Ivanjackenov,illidan,576,hunter,survival,10,7,3
Nedad,tichondrius,576,hunter,survival,12,6,6
Tenzën,drakkari,576,hunter,survival,12,6,6
Yoske,tichondrius,576,hunter,survival,12,6,6
Amhavgun,tichondrius,576,hunter,survival,12,6,6
Mctrapturds,tichondrius,576,hunter,survival,12,6,6
Nijicon,frostmourne,576,hunter,survival,12,6,6
Wezkerh,ragnaros,576,hunter,survival,12,6,6
Lefuza,malganis,576,hunter,survival,12,6,6
Cosmodome,daggerspine,576,hunter,survival,12,6,6
Traponomics,stormrage,576,hunter,survival,12,6,6
Tazsic,mannoroth,576,hunter,survival,12,6,6
Walterwhite,trollbane,576,hunter,survival,12,6,6
Sinrax,stormrage,576,hunter,survival,12,6,6
Zugfeito,nemesis,576,hunter,survival,12,6,6
Fíction,kelthuzad,576,hunter,survival,12,6,6
Zerark,kelthuzad,576,hunter,survival,13,6,7
Jaggeroi,thrall,576,hunter,survival,16,7,9
Dikqt,quelthalas,576,hunter,survival,17,6,11
Lahinch,darkspear,576,hunter,survival,21,7,14
Kowabungy,tichondrius,576,hunter,survival,18,6,12
Chetvi,uldum,576,hunter,survival,18,6,12
Pilesofpoop,sargeras,576,hunter,survival,18,6,12
Raaph,zuljin,576,hunter,survival,18,6,12
Dfnhdft,stormrage,575,hunter,survival,12,6,6
Xeiana,proudmoore,575,hunter,survival,12,6,6
Týrak,illidan,575,hunter,survival,12,6,6
Bherskrograx,burning-legion,575,hunter,survival,12,6,6
Zepplin,medivh,575,hunter,survival,12,6,6
Bôwbafett,sargeras,575,hunter,survival,12,6,6
Vortann,proudmoore,575,hunter,survival,18,6,12
Bearbarryls,azralon,575,hunter,survival,18,6,12
Dartoo,ragnaros,575,hunter,survival,24,6,18
Berzxd,stormrage,573,hunter,survival,12,6,6
Bushytails,illidan,573,hunter,survival,18,6,12
Aiyanafox,moon-guard,572,hunter,survival,24,6,18
Alpacxpress,stormrage,544,hunter,survival,16,6,10
Tyrokk,barthilas,543,hunter,survival,18,6,12
Böuntyhuntêr,area-52,527,hunter,survival,11,6,5
Dräkö,tichondrius,527,hunter,survival,15,7,8
Ceezrh,sargeras,527,hunter,survival,15,7,8
Zerkie,area-52,527,hunter,survival,15,7,8
Kovoth,darkspear,526,hunter,survival,15,6,9
Greyhollow,sargeras,522,hunter,survival,17,8,9
Showtheio,azralon,522,hunter,survival,16,7,9
Lawafla,area-52,521,hunter,survival,14,7,7
Raeshots,area-52,518,hunter,survival,21,8,13
Gunudown,haomarush,511,hunter,survival,11,6,5
Pxry,drenden,511,hunter,survival,11,6,5
Therealpafo,tichondrius,507,hunter,survival,20,6,14
Notzindalari,frostmourne,494,hunter,survival,22,6,16
Hollymarie,nazjatar,480,hunter,survival,6,5,1
Selenis,khadgar,480,hunter,survival,6,5,1
Heretotrap,tichondrius,480,hunter,survival,6,5,1
Gufanyaun,tichondrius,480,hunter,survival,6,5,1
Tmzsteezy,tichondrius,480,hunter,survival,6,5,1
Poorapple,tichondrius,480,hunter,survival,6,5,1
Wwangman,tichondrius,480,hunter,survival,6,5,1
Antoriel,ragnaros,480,hunter,survival,6,5,1
Lilqueezy,area-52,480,hunter,survival,6,5,1
Nearsight,proudmoore,480,hunter,survival,6,5,1
Jonah,sargeras,480,hunter,survival,6,5,1
Booffmeister,area-52,480,hunter,survival,6,5,1
Ewife,illidan,480,hunter,survival,6,5,1
Grimbrew,garona,480,hunter,survival,6,5,1
Taumelz,sargeras,480,hunter,survival,6,5,1
Klancy,bleeding-hollow,480,hunter,survival,6,5,1
Itryharder,stormrage,480,hunter,survival,6,5,1
Narukín,tichondrius,480,hunter,survival,6,5,1
Minnsc,tichondrius,480,hunter,survival,6,5,1
Toyshoota,stormrage,480,hunter,survival,9,6,3
Flanzo,illidan,480,hunter,survival,12,5,7
Draevinz,stormrage,480,hunter,survival,12,5,7
Downrange,stonemaul,480,hunter,survival,12,5,7
Tezlekhan,haomarush,480,hunter,survival,12,5,7
Luckione,destromath,480,hunter,survival,12,5,7
Giorvannar,ragnaros,480,hunter,survival,12,5,7
Cefirhok,ragnaros,480,hunter,survival,12,5,7
Veluci,tichondrius,480,hunter,survival,12,5,7
Minxed,sargeras,480,hunter,survival,12,5,7
Úllr,wyrmrest-accord,480,hunter,survival,12,5,7
Jumpkick,azralon,480,hunter,survival,12,5,7
Bastÿ,area-52,480,hunter,survival,12,5,7
Bundablasta,frostmourne,480,hunter,survival,12,5,7
Drysst,tichondrius,480,hunter,survival,12,5,7
Droj,stormrage,480,hunter,survival,12,5,7
Calidian,moon-guard,480,hunter,survival,12,5,7
Moomo,frostmourne,480,hunter,survival,12,5,7
Mìtáng,moon-guard,480,hunter,survival,12,5,7
Iambobby,area-52,480,hunter,survival,12,5,7
Thiccita,tichondrius,480,hunter,survival,12,5,7
Alaurys,moon-guard,480,hunter,survival,12,5,7
Shootnoscore,vashj,480,hunter,survival,15,6,9
Ärtémisa,quelthalas,480,hunter,survival,18,5,13
Lxke,tichondrius,480,hunter,survival,18,5,13
Mirdous,moon-guard,479,hunter,survival,12,5,7
Belvhar,skullcrusher,479,hunter,survival,12,5,7
Mcgoob,tichondrius,479,hunter,survival,12,5,7
Calvarîam,korgath,479,hunter,survival,18,5,13
Légölás,tichondrius,463,hunter,survival,17,5,12
Faniquitinha,stormrage,431,hunter,survival,13,6,7
Crumpit,moon-guard,426,hunter,survival,22,6,16
Flowolf,tichondrius,416,hunter,survival,10,5,5
Hakaisurv,azralon,416,hunter,survival,10,5,5
Cinnybunz,malganis,415,hunter,survival,16,6,10
Rinehart,dalaran,415,hunter,survival,14,5,9
Scrubmastery,emerald-dream,384,hunter,survival,6,4,2
Ethxx,emerald-dream,384,hunter,survival,6,4,2
Junglefever,skywall,384,hunter,survival,6,4,2
Bigpets,azralon,384,hunter,survival,6,4,2
Gaymonbarnet,sargeras,384,hunter,survival,6,4,2
Hunterlolxd,altar-of-storms,384,hunter,survival,6,4,2
Surprisemfkr,emerald-dream,384,hunter,survival,6,4,2
Bendoon,sargeras,384,hunter,survival,6,4,2
Petstun,moon-guard,384,hunter,survival,6,4,2
Wilmaßallfit,malganis,384,hunter,survival,6,4,2
Æßç,ragnaros,384,hunter,survival,6,4,2
Litchi,illidan,384,hunter,survival,6,4,2
Malkuri,medivh,384,hunter,survival,6,4,2
Boomseed,nagrand,384,hunter,survival,6,4,2
Pouncedgg,sargeras,384,hunter,survival,6,4,2
Ratherbully,tichondrius,384,hunter,survival,6,4,2
Rankonee,area-52,384,hunter,survival,6,4,2
Pwn,korgath,384,hunter,survival,6,4,2
Ssobit,tichondrius,384,hunter,survival,6,4,2
Trapful,illidan,384,hunter,survival,6,4,2
Ofthedeath,ragnaros,384,hunter,survival,6,4,2
Ehhee,twisting-nether,384,hunter,survival,6,4,2
Chasseür,quelthalas,384,hunter,survival,6,4,2
Siëgward,quelthalas,384,hunter,survival,6,4,2
Thalyxion,moon-guard,384,hunter,survival,6,4,2
Pumpkinovo,tichondrius,384,hunter,survival,6,4,2
Failtrap,ragnaros,384,hunter,survival,6,4,2
Elcap,tichondrius,384,hunter,survival,6,4,2
ßløømtøðèáth,shadow-council,384,hunter,survival,6,4,2
Aurelqt,tichondrius,384,hunter,survival,6,4,2
Kapukapu,illidan,384,hunter,survival,6,4,2
Swagprince,skullcrusher,384,hunter,survival,6,4,2
Ikitefordmt,zuljin,384,hunter,survival,6,4,2
Wapnonymous,mugthol,384,hunter,survival,6,4,2
Thefanbus,tichondrius,384,hunter,survival,6,4,2
Architect,bleeding-hollow,384,hunter,survival,6,4,2
Mihall,tichondrius,384,hunter,survival,6,4,2
Nastoid,area-52,384,hunter,survival,6,4,2
Biscuitbread,azuremyst,384,hunter,survival,6,4,2
Virgim,kelthuzad,384,hunter,survival,6,4,2
Bacchantress,tichondrius,384,hunter,survival,6,4,2
Hyena,kelthuzad,384,hunter,survival,9,5,4
Newcomb,tichondrius,384,hunter,survival,12,4,8
Zurzas,tichondrius,384,hunter,survival,12,4,8
Àngèl,malganis,384,hunter,survival,12,4,8
Oatmeallover,stormrage,384,hunter,survival,12,4,8
Kissmylin,tichondrius,384,hunter,survival,12,4,8
Goonlmao,hyjal,384,hunter,survival,12,4,8
Ganash,gallywix,384,hunter,survival,12,4,8
Axxax,azralon,384,hunter,survival,12,4,8
Stupidgodx,tichondrius,384,hunter,survival,12,4,8
Gluegobbler,spinebreaker,384,hunter,survival,12,4,8
Braindeadorc,illidan,384,hunter,survival,12,4,8
Camfeed,illidan,384,hunter,survival,12,4,8
Troglav,drakkari,384,hunter,survival,12,4,8
Harosh,azralon,384,hunter,survival,12,4,8
Fâpple,stormrage,384,hunter,survival,12,4,8
Blackjesu,blackrock,384,hunter,survival,12,4,8
Golorn,malganis,384,hunter,survival,12,4,8
Sybernetik,tichondrius,384,hunter,survival,12,4,8
Wolfsok,norgannon,384,hunter,survival,12,4,8
Keenz,frostmourne,384,hunter,survival,12,4,8
Cakeislife,kelthuzad,384,hunter,survival,18,4,14
Tydee,nagrand,383,hunter,survival,18,4,14
Dabaosplash,tichondrius,351,hunter,survival,8,5,3
Bâïr,frostmourne,351,hunter,survival,8,5,3
Adamariss,stormrage,319,hunter,survival,16,4,12
Skolfongoun,malfurion,318,hunter,survival,14,4,10
Illshot,tichondrius,304,hunter,survival,13,4,9
Pvx,darkspear,288,hunter,survival,6,3,3
Trapmasterx,tichondrius,288,hunter,survival,6,3,3
Zà,sargeras,288,hunter,survival,6,3,3
Makeastinky,malfurion,288,hunter,survival,6,3,3
Loogan,sargeras,288,hunter,survival,6,3,3
Soul,sargeras,288,hunter,survival,6,3,3
Hazzersk,ragnaros,288,hunter,survival,6,3,3
Mistrj,frostmourne,288,hunter,survival,6,3,3
Trellium,area-52,288,hunter,survival,6,3,3
Petkd,frostmourne,288,hunter,survival,6,3,3
Spårrow,alleria,288,hunter,survival,6,3,3
Cantantie,tichondrius,288,hunter,survival,6,3,3
Epochal,illidan,288,hunter,survival,6,3,3
Duune,wyrmrest-accord,288,hunter,survival,6,3,3
Goodtimez,sargeras,288,hunter,survival,6,3,3
Lemmetrap,illidan,288,hunter,survival,6,3,3
Furipoon,stormrage,288,hunter,survival,6,3,3
Dirtymongrel,barthilas,288,hunter,survival,6,3,3
Slowdamage,ragnaros,288,hunter,survival,6,3,3
Shootdogg,mannoroth,288,hunter,survival,6,3,3
Fearna,destromath,288,hunter,survival,6,3,3
Trailed,dalaran,288,hunter,survival,6,3,3
Seiber,quelthalas,288,hunter,survival,6,3,3
Pridefulzjr,stormrage,288,hunter,survival,6,3,3
Tawok,moon-guard,288,hunter,survival,6,3,3
Happyvelic,tichondrius,288,hunter,survival,6,3,3
Wooftoof,frostmourne,288,hunter,survival,6,3,3
Guncontrol,malganis,288,hunter,survival,6,3,3
Pewpewboi,malganis,288,hunter,survival,6,3,3
Whitemàne,dalaran,288,hunter,survival,6,3,3
Nitroguy,moknathal,288,hunter,survival,6,3,3
Badseedz,kargath,288,hunter,survival,6,3,3
Slaughterr,kelthuzad,288,hunter,survival,6,3,3
Slowhunterr,tichondrius,288,hunter,survival,6,3,3
Drivebymac,tichondrius,288,hunter,survival,6,3,3
Fjdominador,azralon,288,hunter,survival,6,3,3
Samsin,sargeras,288,hunter,survival,6,3,3
Rustyspork,muradin,288,hunter,survival,6,3,3
Vaz,haomarush,288,hunter,survival,6,3,3
Pistolon,quelthalas,288,hunter,survival,6,3,3
Lowlore,moon-guard,288,hunter,survival,6,3,3
Adonai,stormrage,288,hunter,survival,6,3,3
Hackerman,tichondrius,288,hunter,survival,6,3,3
Griefs,malganis,288,hunter,survival,6,3,3
Mooguapo,kiljaeden,288,hunter,survival,6,3,3
Rûff,azralon,288,hunter,survival,6,3,3
Ünitedi,nemesis,288,hunter,survival,6,3,3
Hendlie,frostmourne,288,hunter,survival,6,3,3
Bakalan,dalaran,288,hunter,survival,16,4,12
Krispyflayz,sargeras,288,hunter,survival,12,3,9
Pooshot,kelthuzad,288,hunter,survival,12,3,9
Hironna,proudmoore,288,hunter,survival,12,3,9
Gutshott,tichondrius,288,hunter,survival,12,3,9
Lixniqua,tichondrius,288,hunter,survival,12,3,9
Hawkéns,moon-guard,288,hunter,survival,12,3,9
Kharñe,tichondrius,288,hunter,survival,12,3,9
Wildhùnt,tichondrius,288,hunter,survival,12,3,9
Kalibah,azralon,288,hunter,survival,12,3,9
Wakõz,arthas,288,hunter,survival,12,3,9
Chaps,malygos,288,hunter,survival,12,3,9
Sratenuz,stormrage,287,hunter,survival,6,3,3
Waylòn,moon-guard,287,hunter,survival,12,3,9
Ynoit,illidan,271,hunter,survival,11,3,8
Mokaonly,wildhammer,256,hunter,survival,8,4,4
Crèpes,bleeding-hollow,239,hunter,survival,5,3,2
Frostwulff,tichondrius,239,hunter,survival,5,3,2
Yogurtti,zuljin,239,hunter,survival,5,3,2
Onehitrip,illidan,233,hunter,survival,8,4,4
Moscato,cenarion-circle,232,hunter,survival,14,4,10
Inume,ragnaros,224,hunter,survival,10,3,7
Cumman,sargeras,208,hunter,survival,7,3,4
Rifomen,illidan,192,hunter,survival,9,3,6
Pint,madoran,192,hunter,survival,6,2,4
Thazen,sargeras,192,hunter,survival,6,2,4
Tréèstump,tichondrius,192,hunter,survival,6,2,4
Mukbangbj,terenas,192,hunter,survival,6,2,4
Cernos,malganis,192,hunter,survival,6,2,4
Rimbar,ysera,192,hunter,survival,6,2,4
Urtitaz,shadowmoon,192,hunter,survival,6,2,4
Machunt,lightbringer,192,hunter,survival,6,2,4
Sebastian,blackhand,192,hunter,survival,6,2,4
Araghrn,draktharon,192,hunter,survival,6,2,4
Nahzah,stormrage,192,hunter,survival,6,2,4
Gswag,malganis,192,hunter,survival,6,2,4
Gaea,korgath,192,hunter,survival,6,2,4
Quiveringboy,chogall,192,hunter,survival,6,2,4
Finol,azralon,192,hunter,survival,6,2,4
Zellor,wyrmrest-accord,192,hunter,survival,6,2,4
Ishotmydog,malganis,192,hunter,survival,6,2,4
Spizsnipes,malganis,192,hunter,survival,6,2,4
Kharvaash,onyxia,192,hunter,survival,6,2,4
Qua,perenolde,192,hunter,survival,6,2,4
Giovasper,sargeras,192,hunter,survival,6,2,4
Rainzs,stormrage,192,hunter,survival,6,2,4
Achilles,twisting-nether,192,hunter,survival,6,2,4
Comebacks,ragnaros,192,hunter,survival,6,2,4
Slipox,sargeras,192,hunter,survival,6,2,4
Gobygobbs,magtheridon,192,hunter,survival,6,2,4
Shaftgravy,area-52,192,hunter,survival,6,2,4
Gugucachorro,azralon,192,hunter,survival,6,2,4
Femboyfatale,stormrage,192,hunter,survival,6,2,4
Trígger,azshara,192,hunter,survival,6,2,4
Viio,sargeras,192,hunter,survival,6,2,4
Zèd,azralon,192,hunter,survival,6,2,4
Gomrog,gurubashi,192,hunter,survival,6,2,4
Sharpster,zuljin,192,hunter,survival,6,2,4
Heãdhunter,area-52,192,hunter,survival,6,2,4
Zirstorm,altar-of-storms,192,hunter,survival,6,2,4
Shïndow,ragnaros,192,hunter,survival,6,2,4
Nelandris,tichondrius,192,hunter,survival,6,2,4
Cuckw,nemesis,192,hunter,survival,6,2,4
ßn,zuljin,192,hunter,survival,6,2,4
Traptations,sargeras,192,hunter,survival,6,2,4
Splewsh,area-52,192,hunter,survival,6,2,4
Bboo,bonechewer,192,hunter,survival,6,2,4
Harposmash,trollbane,192,hunter,survival,6,2,4
Gaim,dalaran,192,hunter,survival,6,2,4
Kravern,ragnaros,192,hunter,survival,6,2,4
Théw,tichondrius,192,hunter,survival,6,2,4
Dobuu,tichondrius,192,hunter,survival,6,2,4
Cio,fizzcrank,192,hunter,survival,6,2,4
Pedropete,frostmourne,192,hunter,survival,6,2,4
Xoxono,frostmourne,192,hunter,survival,6,2,4
Toruhagakure,tichondrius,192,hunter,survival,6,2,4
Cameløt,ragnaros,192,hunter,survival,6,2,4
Lenyuecf,proudmoore,192,hunter,survival,6,2,4
Durko,frostmourne,192,hunter,survival,6,2,4
Sunchea,arygos,192,hunter,survival,6,2,4
Eclipsie,aerie-peak,192,hunter,survival,6,2,4
Eekbarbadrkl,frostmourne,192,hunter,survival,6,2,4
Razzldazzlbb,thrall,192,hunter,survival,6,2,4
Dikkins,windrunner,192,hunter,survival,6,2,4
Woobinman,tichondrius,192,hunter,survival,6,2,4
Côckblocked,tichondrius,192,hunter,survival,6,2,4
Skrìms,tichondrius,192,hunter,survival,12,2,10
Yukisong,bleeding-hollow,192,hunter,survival,12,2,10
Zhona,moon-guard,192,hunter,survival,12,2,10
Raythør,area-52,192,hunter,survival,12,2,10
Zbg,jubeithos,192,hunter,survival,12,2,10
Linova,stormrage,192,hunter,survival,12,2,10
Nwah,stormrage,159,hunter,survival,5,2,3
Twom,area-52,138,hunter,survival,8,3,5
Ohnahra,kiljaeden,138,hunter,survival,9,3,6
Xradû,dawnbringer,138,hunter,survival,9,3,6
Morganson,moon-guard,138,hunter,survival,22,4,18
Bránn,quelthalas,128,hunter,survival,4,2,2
Coçador,stormrage,128,hunter,survival,4,2,2
Drtapdatass,mannoroth,127,hunter,survival,8,2,6
Whitecake,area-52,96,hunter,survival,3,2,1
Fenrock,cenarius,96,hunter,survival,3,2,1
Legosshi,darrowmere,96,hunter,survival,6,1,5
Survbot,malganis,96,hunter,survival,6,1,5
Terrabytés,kelthuzad,96,hunter,survival,6,1,5
Skybourne,nemesis,96,hunter,survival,6,1,5
Ergen,zuluhed,96,hunter,survival,6,1,5
Lance,darrowmere,96,hunter,survival,6,1,5
Symz,ragnaros,96,hunter,survival,6,1,5
Alsol,drakkari,96,hunter,survival,6,1,5
Esser,mannoroth,96,hunter,survival,6,1,5
Ezpzx,sargeras,96,hunter,survival,6,1,5
Nevertraps,tichondrius,96,hunter,survival,6,1,5
Shottz,aerie-peak,96,hunter,survival,6,1,5
Killerxzxz,stormrage,96,hunter,survival,6,1,5
Jîlt,aerie-peak,96,hunter,survival,6,1,5
Pinktrexx,darkspear,96,hunter,survival,6,1,5
Shuweet,moon-guard,96,hunter,survival,6,1,5
Agrahunter,barthilas,96,hunter,survival,6,1,5
Berkhof,tichondrius,96,hunter,survival,6,1,5
Fearlesarrow,suramar,96,hunter,survival,6,1,5
Alorick,ragnaros,96,hunter,survival,6,1,5
Critz,undermine,96,hunter,survival,6,1,5
Sobala,azralon,96,hunter,survival,6,1,5
Dusle,azralon,96,hunter,survival,6,1,5
Lammy,bleeding-hollow,96,hunter,survival,6,1,5
Bloodarrow,tichondrius,96,hunter,survival,6,1,5
Elpidere,tichondrius,96,hunter,survival,6,1,5
Caliente,tichondrius,96,hunter,survival,6,1,5
Kölhberg,azralon,96,hunter,survival,6,1,5
Weegnomie,wyrmrest-accord,96,hunter,survival,6,1,5
Kdik,azralon,96,hunter,survival,6,1,5
Elroyjetson,arthas,96,hunter,survival,6,1,5
Floorislava,durotan,96,hunter,survival,6,1,5
Taofang,emerald-dream,96,hunter,survival,6,1,5
Elaiaa,quelthalas,96,hunter,survival,6,1,5
Feorbxl,proudmoore,96,hunter,survival,6,1,5
Mybest,stormrage,96,hunter,survival,6,1,5
Purpmang,bleeding-hollow,96,hunter,survival,12,1,11
Montakka,illidan,79,hunter,survival,5,1,4
Vortex,arthas,63,hunter,survival,2,2,0
Äzrael,elune,41,hunter,survival,6,2,4
Tayeal,thrall,31,hunter,survival,2,1,1
Destinations,bleeding-hollow,31,hunter,survival,8,1,7
Hurrican,kaelthas,16,hunter,survival,1,1,0
Longshánks,stormrage,16,hunter,survival,1,1,0
Saiiph,bleeding-hollow,2274,hunter,beastmastery,136,76,60
Sphericsnow,shuhalo,2210,hunter,beastmastery,95,51,44
Studiosx,tichondrius,2186,hunter,beastmastery,106,56,50
Missedmytrap,agamaggan,2149,hunter,beastmastery,80,46,34
Zujo,emerald-dream,2134,hunter,beastmastery,173,89,84
Pikabow,tichondrius,2123,hunter,beastmastery,81,42,39
Wmsgs,tichondrius,2116,hunter,beastmastery,129,64,65
Traptations,sargeras,2114,hunter,beastmastery,90,43,47
Warpath,ursin,2113,hunter,beastmastery,144,79,65
Pãrzival,tichondrius,2100,hunter,beastmastery,66,35,31
Ucl,tichondrius,2097,hunter,beastmastery,102,50,52
Eref,sargeras,2080,hunter,beastmastery,84,44,40
Maiyev,quelthalas,2074,hunter,beastmastery,95,52,43
Fish,darkspear,2070,hunter,beastmastery,90,45,45
Outz,anvilmar,2069,hunter,beastmastery,436,222,214
Hfn,stormrage,2058,hunter,beastmastery,70,37,33
Orber,stormrage,2057,hunter,beastmastery,296,157,139
Øverdose,ragnaros,2055,hunter,beastmastery,66,35,31
Axlee,tichondrius,2049,hunter,beastmastery,368,186,182
Sarutobi,black-dragonflight,2036,hunter,beastmastery,90,44,46
Manyu,tichondrius,2035,hunter,beastmastery,69,34,35
Sphericsnow,sargeras,2027,hunter,beastmastery,92,43,49
Hazzersk,ragnaros,2023,hunter,beastmastery,161,78,83
Perawantua,frostmourne,2021,hunter,beastmastery,85,47,38
Pokìmane,tichondrius,2014,hunter,beastmastery,254,136,118
Genom,tichondrius,1996,hunter,beastmastery,348,178,170
Cannondale,tichondrius,1993,hunter,beastmastery,42,21,21
Beastmunster,frostmourne,1984,hunter,beastmastery,72,34,38
Nflmaster,malganis,1967,hunter,beastmastery,78,44,34
Trappxy,sargeras,1961,hunter,beastmastery,120,63,57
Zeddead,magtheridon,1961,hunter,beastmastery,208,108,100
Trapful,illidan,1959,hunter,beastmastery,101,50,51
Arcobaleno,tichondrius,1952,hunter,beastmastery,89,44,45
Trapandclap,tichondrius,1950,hunter,beastmastery,119,57,62
Nerfthepet,blackrock,1937,hunter,beastmastery,93,59,34
Diegoshotz,zuljin,1934,hunter,beastmastery,70,36,34
Blackathena,tichondrius,1933,hunter,beastmastery,162,83,79
Vëëv,proudmoore,1926,hunter,beastmastery,107,55,52
Headshotzplz,tichondrius,1924,hunter,beastmastery,71,39,32
Audeline,tichondrius,1921,hunter,beastmastery,93,48,45
Ashenga,cairne,1918,hunter,beastmastery,240,127,113
Kytan,shadowmoon,1918,hunter,beastmastery,198,101,97
Lenacraft,frostmourne,1917,hunter,beastmastery,66,41,25
Wodhunterxdd,sargeras,1915,hunter,beastmastery,70,34,36
Kyló,sargeras,1914,hunter,beastmastery,75,38,37
Graar,tichondrius,1911,hunter,beastmastery,54,27,27
Zugbrained,illidan,1910,hunter,beastmastery,268,140,128
Benay,emerald-dream,1904,hunter,beastmastery,84,49,35
Taterballs,illidan,1898,hunter,beastmastery,96,50,46
Junglefever,skywall,1893,hunter,beastmastery,64,34,30
Veevx,proudmoore,1890,hunter,beastmastery,77,50,27
Hogx,sargeras,1890,hunter,beastmastery,78,34,44
Antø,tichondrius,1889,hunter,beastmastery,159,74,85
Auwstin,tichondrius,1888,hunter,beastmastery,61,34,27
Nyxus,tichondrius,1887,hunter,beastmastery,125,63,62
Lamerpvp,tichondrius,1885,hunter,beastmastery,50,31,19
Sobewan,staghelm,1881,hunter,beastmastery,109,53,56
Carlitocool,tichondrius,1877,hunter,beastmastery,36,28,8
Mugiwara,frostwolf,1877,hunter,beastmastery,42,25,17
Argryta,azralon,1872,hunter,beastmastery,47,22,25
Nishinos,tichondrius,1870,hunter,beastmastery,138,70,68
Notvn,illidan,1869,hunter,beastmastery,53,29,24
Ciany,elune,1869,hunter,beastmastery,119,64,55
Illweedx,kiljaeden,1869,hunter,beastmastery,170,85,85
Twopumphunt,tichondrius,1868,hunter,beastmastery,36,23,13
Lilstinstin,tichondrius,1867,hunter,beastmastery,42,23,19
Playnogames,moon-guard,1867,hunter,beastmastery,54,26,28
Dekestei,bleeding-hollow,1867,hunter,beastmastery,65,27,38
Easonl,tichondrius,1864,hunter,beastmastery,186,87,99
Kenshaunter,azralon,1864,hunter,beastmastery,71,31,40
Taxest,illidan,1860,hunter,beastmastery,53,26,27
Nelay,ragnaros,1857,hunter,beastmastery,124,68,56
Quietqt,ragnaros,1857,hunter,beastmastery,117,63,54
Flitt,zuljin,1857,hunter,beastmastery,42,21,21
Petmanx,tichondrius,1855,hunter,beastmastery,150,85,65
Faniquitinha,stormrage,1854,hunter,beastmastery,54,25,29
Urukah,gallywix,1853,hunter,beastmastery,58,29,29
Ñotorious,frostmane,1852,hunter,beastmastery,53,27,26
Cashisabeast,zuljin,1851,hunter,beastmastery,46,25,21
Yucca,drenden,1851,hunter,beastmastery,48,25,23
Saintpablo,mannoroth,1850,hunter,beastmastery,111,63,48
Koridelse,nemesis,1850,hunter,beastmastery,138,68,70
Infinit,onyxia,1848,hunter,beastmastery,112,54,58
Nollzey,frostmourne,1847,hunter,beastmastery,45,22,23
Tânsøxøxø,tichondrius,1847,hunter,beastmastery,54,22,32
Wickyz,malganis,1846,hunter,beastmastery,42,24,18
Bolanite,illidan,1846,hunter,beastmastery,48,27,21
Arsk,ragnaros,1846,hunter,beastmastery,154,76,78
Jokerlord,illidan,1845,hunter,beastmastery,30,20,10
Nalasdottirh,moon-guard,1845,hunter,beastmastery,84,51,33
Skysmile,tichondrius,1845,hunter,beastmastery,60,34,26
Karumä,thrall,1845,hunter,beastmastery,66,31,35
Inktray,durotan,1844,hunter,beastmastery,37,22,15
Wilmaßallfit,malganis,1844,hunter,beastmastery,71,31,40
Bogen,nemesis,1843,hunter,beastmastery,94,50,44
Ðeatheater,tichondrius,1843,hunter,beastmastery,41,21,20
Sinvat,tichondrius,1842,hunter,beastmastery,42,25,17
Aqq,moon-guard,1842,hunter,beastmastery,98,58,40
Starkhaven,firetree,1842,hunter,beastmastery,110,63,47
Monffbe,tichondrius,1842,hunter,beastmastery,60,28,32
Squawkers,sargeras,1838,hunter,beastmastery,48,28,20
Lenalena,tichondrius,1836,hunter,beastmastery,107,58,49
Massacration,area-52,1836,hunter,beastmastery,69,34,35
Ârtæmïs,stormrage,1835,hunter,beastmastery,48,24,24
Mørodox,sargeras,1834,hunter,beastmastery,54,24,30
Rëxx,moon-guard,1833,hunter,beastmastery,103,62,41
Smokabombom,eredar,1830,hunter,beastmastery,72,55,17
Absinther,emerald-dream,1829,hunter,beastmastery,66,41,25
Lkw,tichondrius,1829,hunter,beastmastery,80,37,43
Dju,stormrage,1828,hunter,beastmastery,95,51,44
Oromia,proudmoore,1828,hunter,beastmastery,60,29,31
Vox,tichondrius,1827,hunter,beastmastery,46,30,16
Tyleraq,area-52,1827,hunter,beastmastery,41,24,17
Sxra,area-52,1826,hunter,beastmastery,70,37,33
Negãn,tichondrius,1826,hunter,beastmastery,80,41,39
Flanzo,illidan,1825,hunter,beastmastery,59,32,27
Sosaho,sargeras,1825,hunter,beastmastery,41,21,20
Sensator,barthilas,1824,hunter,beastmastery,60,36,24
Sniperælite,korgath,1824,hunter,beastmastery,55,32,23
Songhammer,tichondrius,1824,hunter,beastmastery,112,62,50
Madbéê,tichondrius,1824,hunter,beastmastery,47,24,23
Phatshiet,anvilmar,1823,hunter,beastmastery,50,31,19
Lrnb,tichondrius,1823,hunter,beastmastery,68,38,30
Asynic,blades-edge,1823,hunter,beastmastery,131,70,61
Jeffersan,illidan,1823,hunter,beastmastery,149,72,77
Zumago,tichondrius,1823,hunter,beastmastery,118,54,64
Tangoda,tichondrius,1822,hunter,beastmastery,42,23,19
Trap,demon-soul,1822,hunter,beastmastery,54,28,26
Zefbaby,quelthalas,1822,hunter,beastmastery,66,31,35
Tyreu,tichondrius,1820,hunter,beastmastery,59,30,29
Mikey,exodar,1819,hunter,beastmastery,216,123,93
Grimrokk,malganis,1819,hunter,beastmastery,78,40,38
Phayzd,sargeras,1818,hunter,beastmastery,66,34,32
Scuffedshots,tichondrius,1817,hunter,beastmastery,74,43,31
Hollymarie,nazjatar,1816,hunter,beastmastery,60,36,24
Jawnhunter,tichondrius,1816,hunter,beastmastery,48,23,25
Çute,moon-guard,1815,hunter,beastmastery,60,39,21
Gumbro,malganis,1814,hunter,beastmastery,138,82,56
Comebacks,ragnaros,1814,hunter,beastmastery,72,41,31
Goonsh,tichondrius,1813,hunter,beastmastery,40,25,15
Jalinhabbei,azralon,1813,hunter,beastmastery,33,20,13
Asukaw,barthilas,1813,hunter,beastmastery,57,28,29
Dayquillx,illidan,1813,hunter,beastmastery,48,23,25
Drektorath,bleeding-hollow,1812,hunter,beastmastery,66,34,32
Wodhunterxdd,tichondrius,1811,hunter,beastmastery,32,23,9
Logjohn,frostmourne,1811,hunter,beastmastery,40,20,20
Hogd,sargeras,1810,hunter,beastmastery,54,26,28
Bertimus,sargeras,1809,hunter,beastmastery,158,81,77
Robinhooz,illidan,1807,hunter,beastmastery,187,102,85
Facerolled,area-52,1805,hunter,beastmastery,123,74,49
Bowrockobama,illidan,1805,hunter,beastmastery,81,42,39
Lilprimary,tichondrius,1804,hunter,beastmastery,66,30,36
Shot,shuhalo,1802,hunter,beastmastery,30,24,6
Kabalaku,moon-guard,1802,hunter,beastmastery,130,72,58
Warcher,azralon,1802,hunter,beastmastery,60,32,28
Huntmon,nemesis,1802,hunter,beastmastery,42,19,23
Mhter,tichondrius,1801,hunter,beastmastery,95,44,51
Hg,illidan,1800,hunter,beastmastery,38,25,13
Kangarookyle,illidan,1800,hunter,beastmastery,96,58,38
Shafttrapper,queldorei,1800,hunter,beastmastery,119,64,55
Funkyjunk,arthas,1800,hunter,beastmastery,72,35,37
Zå,dalaran,1798,hunter,beastmastery,99,52,47
Somethinggo,tichondrius,1797,hunter,beastmastery,223,108,115
Turtlegirl,tichondrius,1797,hunter,beastmastery,76,35,41
Bustyredhead,kelthuzad,1794,hunter,beastmastery,113,51,62
Austelos,moon-guard,1793,hunter,beastmastery,95,52,43
Bowzørx,tichondrius,1791,hunter,beastmastery,36,23,13
Cuchulláin,area-52,1787,hunter,beastmastery,138,73,65
Sñïpêr,tichondrius,1784,hunter,beastmastery,53,29,24
Survchris,bleeding-hollow,1784,hunter,beastmastery,100,45,55
Pathofsexile,tichondrius,1783,hunter,beastmastery,93,43,50
Xgoh,sargeras,1782,hunter,beastmastery,42,22,20
Hunterphil,hyjal,1777,hunter,beastmastery,66,39,27
Alaurys,moon-guard,1776,hunter,beastmastery,47,24,23
Mckim,tichondrius,1775,hunter,beastmastery,48,28,20
Tyrokk,barthilas,1774,hunter,beastmastery,84,42,42
Livelovelaff,tichondrius,1773,hunter,beastmastery,54,28,26
Kybelís,dalaran,1772,hunter,beastmastery,152,82,70
Savagerko,illidan,1770,hunter,beastmastery,63,29,34
Trapordíe,tichondrius,1768,hunter,beastmastery,54,31,23
Mukbangbj,terenas,1766,hunter,beastmastery,144,79,65
Tytonic,bleeding-hollow,1765,hunter,beastmastery,60,31,29
Vonkrieg,tichondrius,1764,hunter,beastmastery,41,25,16
Nutellacrepe,kelthuzad,1764,hunter,beastmastery,224,110,114
Perffect,sargeras,1763,hunter,beastmastery,57,24,33
Hyjax,darkspear,1761,hunter,beastmastery,49,30,19
Tracershot,malganis,1759,hunter,beastmastery,113,64,49
Skywvlker,illidan,1759,hunter,beastmastery,100,46,54
Xonios,frostwolf,1757,hunter,beastmastery,120,62,58
Chrisp,bloodhoof,1757,hunter,beastmastery,60,27,33
Goongarg,frostmourne,1753,hunter,beastmastery,60,30,30
Survivalists,kelthuzad,1752,hunter,beastmastery,36,24,12
Datbigbowdoe,illidan,1752,hunter,beastmastery,36,23,13
Mhters,tichondrius,1752,hunter,beastmastery,48,26,22
Cresselia,drakkari,1751,hunter,beastmastery,73,41,32
Tembaktytyd,barthilas,1751,hunter,beastmastery,49,24,25
Airpodpro,emerald-dream,1747,hunter,beastmastery,36,21,15
Esstark,bleeding-hollow,1743,hunter,beastmastery,48,20,28
Dirtymongrel,barthilas,1739,hunter,beastmastery,102,54,48
Deathtomyfoe,sargeras,1735,hunter,beastmastery,54,21,33
Swang,kiljaeden,1734,hunter,beastmastery,79,36,43
Åspect,aegwynn,1732,hunter,beastmastery,53,28,25
Dahmer,greymane,1732,hunter,beastmastery,62,29,33
Shootnskoot,icecrown,1731,hunter,beastmastery,36,23,13
Clowntown,illidan,1731,hunter,beastmastery,42,21,21
Reachme,moon-guard,1731,hunter,beastmastery,48,22,26
Kidao,emerald-dream,1729,hunter,beastmastery,54,30,24
Mvpwonder,frostmourne,1728,hunter,beastmastery,66,31,35
Ecl,azralon,1727,hunter,beastmastery,98,56,42
Bazanguita,tichondrius,1727,hunter,beastmastery,53,29,24
Smullik,wyrmrest-accord,1726,hunter,beastmastery,120,57,63
Buliss,wyrmrest-accord,1725,hunter,beastmastery,45,22,23
Mythxplosive,ragnaros,1725,hunter,beastmastery,85,35,50
Dragonspider,zuljin,1724,hunter,beastmastery,30,21,9
Krunkz,frostmourne,1724,hunter,beastmastery,53,33,20
Ðfac,moon-guard,1724,hunter,beastmastery,84,42,42
Reparcero,quelthalas,1723,hunter,beastmastery,42,20,22
Bootydoo,illidan,1721,hunter,beastmastery,130,67,63
Kushaddict,lightnings-blade,1721,hunter,beastmastery,232,112,120
Edarkness,gurubashi,1718,hunter,beastmastery,194,91,103
Kensho,illidan,1718,hunter,beastmastery,219,102,117
Whoshotu,tichondrius,1717,hunter,beastmastery,59,32,27
Kenpachie,jubeithos,1716,hunter,beastmastery,35,23,12
Kenji,sargeras,1716,hunter,beastmastery,80,40,40
Twixzorz,boulderfist,1716,hunter,beastmastery,60,28,32
Lucki,blades-edge,1715,hunter,beastmastery,66,37,29
Acres,emerald-dream,1714,hunter,beastmastery,27,19,8
Cachín,ragnaros,1714,hunter,beastmastery,65,34,31
Warrccjr,steamwheedle-cartel,1714,hunter,beastmastery,47,21,26
Ryûkø,quelthalas,1712,hunter,beastmastery,90,44,46
Fanikita,azralon,1712,hunter,beastmastery,75,31,44
Laoai,tichondrius,1711,hunter,beastmastery,37,23,14
Trickshotss,illidan,1711,hunter,beastmastery,124,75,49
Revalay,emerald-dream,1711,hunter,beastmastery,54,32,22
Ipickmynose,tichondrius,1711,hunter,beastmastery,89,51,38
Squeekin,sargeras,1709,hunter,beastmastery,33,26,7
Wordd,area-52,1709,hunter,beastmastery,36,20,16
Fxsb,tichondrius,1708,hunter,beastmastery,170,79,91
Shablagoosh,zuljin,1706,hunter,beastmastery,37,25,12
Torolol,tichondrius,1706,hunter,beastmastery,138,75,63
Genug,tichondrius,1706,hunter,beastmastery,36,18,18
Sbplayshunt,akama,1706,hunter,beastmastery,48,19,29
Xorian,frostmourne,1705,hunter,beastmastery,36,18,18
Pkkfantasy,archimonde,1704,hunter,beastmastery,82,44,38
Sniper,area-52,1702,hunter,beastmastery,206,101,105
Snowmnz,tichondrius,1701,hunter,beastmastery,53,30,23
Raymose,tichondrius,1701,hunter,beastmastery,64,30,34
Killshøtß,tichondrius,1701,hunter,beastmastery,65,30,35
Melov,frostmourne,1700,hunter,beastmastery,76,35,41
Fatalshots,bonechewer,1699,hunter,beastmastery,42,24,18
Pepepls,proudmoore,1699,hunter,beastmastery,72,38,34
Wodunaz,stormrage,1698,hunter,beastmastery,71,45,26
Geeshot,area-52,1698,hunter,beastmastery,66,27,39
Liennä,stormrage,1697,hunter,beastmastery,48,24,24
Dj,arygos,1696,hunter,beastmastery,72,38,34
Bowreckage,malganis,1695,hunter,beastmastery,251,121,130
Mojopojo,tichondrius,1694,hunter,beastmastery,61,35,26
Cocoapuffs,cenarius,1694,hunter,beastmastery,42,20,22
Jfkd,sargeras,1694,hunter,beastmastery,52,21,31
Tuân,azgalor,1693,hunter,beastmastery,42,24,18
Nobito,quelthalas,1691,hunter,beastmastery,153,82,71
Soccratees,shattered-hand,1690,hunter,beastmastery,41,25,16
Urzoth,tichondrius,1689,hunter,beastmastery,66,43,23
Bicas,emerald-dream,1689,hunter,beastmastery,72,37,35
Shadowfangs,tichondrius,1689,hunter,beastmastery,66,31,35
Casperonni,illidan,1688,hunter,beastmastery,132,72,60
Hxnry,barthilas,1686,hunter,beastmastery,30,18,12
Jellyleg,bleeding-hollow,1686,hunter,beastmastery,42,23,19
Fabbs,frostmourne,1686,hunter,beastmastery,52,26,26
Edelyysa,arthas,1682,hunter,beastmastery,192,94,98
Lilskill,lightnings-blade,1681,hunter,beastmastery,42,22,20
Kapukapu,illidan,1679,hunter,beastmastery,30,18,12
Puffcopeak,illidan,1679,hunter,beastmastery,84,46,38
Darylovejr,destromath,1679,hunter,beastmastery,36,19,17
Flor,boulderfist,1679,hunter,beastmastery,38,20,18
Showtheio,azralon,1679,hunter,beastmastery,81,42,39
Silverbite,garona,1678,hunter,beastmastery,92,51,41
Shootiepie,hyjal,1677,hunter,beastmastery,30,19,11
Urukkz,goldrinn,1677,hunter,beastmastery,54,24,30
Lark,emerald-dream,1676,hunter,beastmastery,45,22,23
Saiiphz,bleeding-hollow,1675,hunter,beastmastery,40,22,18
Xionos,wyrmrest-accord,1673,hunter,beastmastery,157,82,75
Scythedom,tichondrius,1673,hunter,beastmastery,48,23,25
Sambucca,daggerspine,1673,hunter,beastmastery,66,31,35
Spizsnipes,malganis,1672,hunter,beastmastery,66,30,36
Gabulmenina,nemesis,1671,hunter,beastmastery,48,23,25
Sissleto,tichondrius,1667,hunter,beastmastery,347,172,175
Huntard,stormrage,1667,hunter,beastmastery,60,26,34
Koalahunter,area-52,1667,hunter,beastmastery,76,31,45
Sonichunterr,illidan,1666,hunter,beastmastery,118,69,49
Montakka,illidan,1666,hunter,beastmastery,66,36,30
Huntinpuss,tichondrius,1666,hunter,beastmastery,44,21,23
Fockewulf,dragonmaw,1664,hunter,beastmastery,114,49,65
Hokutoxx,tichondrius,1663,hunter,beastmastery,61,25,36
Yughii,stormrage,1662,hunter,beastmastery,42,20,22
Pinêapplê,bleeding-hollow,1661,hunter,beastmastery,36,23,13
Sasorï,nemesis,1659,hunter,beastmastery,30,19,11
Dpdóugh,illidan,1658,hunter,beastmastery,112,59,53
Thebush,dragonmaw,1657,hunter,beastmastery,90,52,38
Illsugoi,frostwolf,1657,hunter,beastmastery,141,70,71
Showmakerc,proudmoore,1656,hunter,beastmastery,77,35,42
Liarael,illidan,1655,hunter,beastmastery,154,71,83
Gufanyaun,tichondrius,1654,hunter,beastmastery,34,18,16
Crounzz,sargeras,1654,hunter,beastmastery,72,28,44
Kopula,illidan,1653,hunter,beastmastery,67,35,32
Rndx,sargeras,1653,hunter,beastmastery,46,20,26
Sylviai,hyjal,1652,hunter,beastmastery,77,40,37
Sindragostra,tichondrius,1652,hunter,beastmastery,135,70,65
Kwinoah,zuljin,1651,hunter,beastmastery,198,96,102
Teddybowschi,sargeras,1650,hunter,beastmastery,35,18,17
Odb,kelthuzad,1650,hunter,beastmastery,48,20,28
Mojopotato,stormrage,1649,hunter,beastmastery,77,37,40
Greyhunts,tichondrius,1649,hunter,beastmastery,48,23,25
Grimbrew,garona,1648,hunter,beastmastery,47,26,21
Ñðñdêsçrípt,frostmourne,1648,hunter,beastmastery,109,59,50
Mortalz,barthilas,1648,hunter,beastmastery,232,119,113
Eastwood,tichondrius,1648,hunter,beastmastery,92,41,51
Rcman,tichondrius,1647,hunter,beastmastery,54,41,13
Cw,gorefiend,1647,hunter,beastmastery,48,25,23
Kite,dathremar,1646,hunter,beastmastery,36,21,15
Zemphoths,eredar,1645,hunter,beastmastery,93,41,52
Camhaanes,area-52,1644,hunter,beastmastery,155,85,70
Mauklindaufe,fenris,1644,hunter,beastmastery,85,43,42
Tus,tichondrius,1644,hunter,beastmastery,60,23,37
Mlemily,stormrage,1643,hunter,beastmastery,63,36,27
Unloaded,illidan,1642,hunter,beastmastery,63,39,24
Icecaffemoca,tichondrius,1641,hunter,beastmastery,56,25,31
Jímmycorn,sargeras,1640,hunter,beastmastery,54,32,22
Onemoreshot,bleeding-hollow,1639,hunter,beastmastery,113,59,54
Kaelhim,warsong,1638,hunter,beastmastery,28,20,8
Andalora,malganis,1638,hunter,beastmastery,67,30,37
Publicpooper,tichondrius,1637,hunter,beastmastery,36,21,15
Energiser,stormrage,1637,hunter,beastmastery,58,29,29
Spídër,maiev,1637,hunter,beastmastery,74,35,39
Mmeep,illidan,1636,hunter,beastmastery,64,33,31
Teneightt,tichondrius,1636,hunter,beastmastery,74,38,36
Mcclintock,executus,1636,hunter,beastmastery,41,21,20
Razor,destromath,1636,hunter,beastmastery,88,42,46
Angrypepe,bleeding-hollow,1635,hunter,beastmastery,42,21,21
Drakarth,khazgoroth,1635,hunter,beastmastery,47,22,25
Kahll,azralon,1634,hunter,beastmastery,54,24,30
Plastera,zuljin,1634,hunter,beastmastery,52,23,29
Shootsb,tichondrius,1634,hunter,beastmastery,82,36,46
Montano,area-52,1633,hunter,beastmastery,32,22,10
Beastkets,area-52,1632,hunter,beastmastery,60,31,29
Damadar,tichondrius,1632,hunter,beastmastery,42,19,23
Airhunt,thrall,1632,hunter,beastmastery,42,19,23
Liadrelle,proudmoore,1632,hunter,beastmastery,63,27,36
Thtswap,moon-guard,1630,hunter,beastmastery,66,38,28
Axxll,tichondrius,1629,hunter,beastmastery,55,25,30
Vurlo,tichondrius,1628,hunter,beastmastery,54,30,24
Dreygar,dawnbringer,1627,hunter,beastmastery,182,93,89
Layloww,thrall,1626,hunter,beastmastery,36,18,18
Beastkets,proudmoore,1626,hunter,beastmastery,55,22,33
Stonehard,mugthol,1623,hunter,beastmastery,48,20,28
Zakalla,malganis,1622,hunter,beastmastery,62,33,29
Assbow,kiljaeden,1622,hunter,beastmastery,155,73,82
Wøden,draka,1619,hunter,beastmastery,96,50,46
Brokiînn,aegwynn,1619,hunter,beastmastery,129,67,62
Missedtrap,tichondrius,1618,hunter,beastmastery,42,23,19
Rürü,illidan,1618,hunter,beastmastery,40,21,19
Lasix,burning-blade,1618,hunter,beastmastery,143,72,71
Darkoshuntar,tichondrius,1617,hunter,beastmastery,30,17,13
Oblivîon,illidan,1616,hunter,beastmastery,59,38,21
Phiyuh,stormrage,1616,hunter,beastmastery,72,42,30
Telånnas,illidan,1616,hunter,beastmastery,42,21,21
Skytrooper,boulderfist,1616,hunter,beastmastery,59,26,33
Nooche,bleeding-hollow,1615,hunter,beastmastery,36,22,14
Thejw,firetree,1614,hunter,beastmastery,30,17,13
Legoflaiz,drakkari,1614,hunter,beastmastery,48,23,25
Apøllö,kilrogg,1614,hunter,beastmastery,262,123,139
Pillarington,tichondrius,1613,hunter,beastmastery,52,32,20
Kript,dragonmaw,1613,hunter,beastmastery,431,213,218
Thamie,tichondrius,1610,hunter,beastmastery,24,17,7
Grannygatya,tichondrius,1610,hunter,beastmastery,42,24,18
Despise,frostmourne,1610,hunter,beastmastery,42,23,19
Vanasir,moon-guard,1610,hunter,beastmastery,47,24,23
Horcnbeans,bleeding-hollow,1610,hunter,beastmastery,250,125,125
Mambothehunt,stormrage,1610,hunter,beastmastery,89,42,47
Syldris,proudmoore,1609,hunter,beastmastery,30,19,11
Kaizong,hyjal,1609,hunter,beastmastery,41,22,19
Mournebow,tichondrius,1608,hunter,beastmastery,279,151,128
Statistic,black-dragonflight,1608,hunter,beastmastery,59,30,29
Njörðr,eldrethalas,1608,hunter,beastmastery,65,32,33
Recklaw,frostmourne,1607,hunter,beastmastery,36,21,15
Reeload,tichondrius,1607,hunter,beastmastery,30,17,13
Parnicyon,frostmourne,1607,hunter,beastmastery,209,109,100
Focusfire,khazgoroth,1607,hunter,beastmastery,66,32,34
Mordriva,azjolnerub,1607,hunter,beastmastery,53,25,28
Thezeus,barthilas,1607,hunter,beastmastery,77,33,44
Feignmilf,tichondrius,1606,hunter,beastmastery,84,51,33
Shootnoscore,vashj,1606,hunter,beastmastery,83,46,37
Elad,tichondrius,1606,hunter,beastmastery,102,55,47
Foxqt,emerald-dream,1606,hunter,beastmastery,38,20,18
Unrealpewpew,lightbringer,1606,hunter,beastmastery,148,76,72
Nodougaelark,dalaran,1606,hunter,beastmastery,48,20,28
Legacyhunter,nazgrel,1605,hunter,beastmastery,30,17,13
Asurvivor,suramar,1605,hunter,beastmastery,232,119,113
Terpa,nemesis,1604,hunter,beastmastery,196,100,96
Légölás,tichondrius,1603,hunter,beastmastery,84,47,37
Coopshot,darkspear,1603,hunter,beastmastery,75,40,35
Jillypoo,azralon,1602,hunter,beastmastery,30,21,9
Getrekt,azralon,1602,hunter,beastmastery,79,39,40
Scattertrap,ragnaros,1601,hunter,beastmastery,30,20,10
Bettallana,tichondrius,1601,hunter,beastmastery,30,17,13
Axis,mugthol,1601,hunter,beastmastery,85,45,40
Aazua,frostmourne,1601,hunter,beastmastery,45,22,23
Snewfly,tichondrius,1600,hunter,beastmastery,54,36,18
Putos,zuljin,1600,hunter,beastmastery,48,27,21
Hillside,frostmourne,1600,hunter,beastmastery,98,50,48
Gonnujo,ragnaros,1600,hunter,beastmastery,72,29,43
Bloodymalik,tichondrius,1600,hunter,beastmastery,48,19,29
Pineapplees,tichondrius,1599,hunter,beastmastery,66,30,36
Whitecake,area-52,1598,hunter,beastmastery,46,27,19
Harag,bleeding-hollow,1598,hunter,beastmastery,51,21,30
Lexandr,tichondrius,1597,hunter,beastmastery,120,65,55
Beasting,moon-guard,1596,hunter,beastmastery,54,29,25
Stfd,illidan,1596,hunter,beastmastery,48,21,27
Kaboomza,tichondrius,1595,hunter,beastmastery,78,43,35
Brorc,kul-tiras,1593,hunter,beastmastery,42,24,18
Morbow,proudmoore,1593,hunter,beastmastery,82,46,36
Metrallon,black-dragonflight,1593,hunter,beastmastery,59,31,28
Monatre,fizzcrank,1593,hunter,beastmastery,63,27,36
Shyck,ragnaros,1591,hunter,beastmastery,71,35,36
Consanguin,sargeras,1590,hunter,beastmastery,42,24,18
Grindal,drakkari,1590,hunter,beastmastery,54,25,29
Merkidy,illidan,1588,hunter,beastmastery,35,20,15
Svsnipe,tichondrius,1587,hunter,beastmastery,67,36,31
Killwill,illidan,1587,hunter,beastmastery,54,28,26
Hofftimus,tichondrius,1585,hunter,beastmastery,82,53,29
Sashagreen,frostmourne,1585,hunter,beastmastery,83,43,40
Toxarch,aggramar,1585,hunter,beastmastery,78,39,39
Mavrik,sargeras,1582,hunter,beastmastery,41,21,20
Lissavi,tichondrius,1581,hunter,beastmastery,42,21,21
Kniightjayyx,kelthuzad,1581,hunter,beastmastery,114,51,63
Despairius,moon-guard,1580,hunter,beastmastery,50,29,21
Reloadz,shattered-hand,1577,hunter,beastmastery,58,32,26
Zyzzmirin,illidan,1577,hunter,beastmastery,78,35,43
Overshot,tichondrius,1577,hunter,beastmastery,72,31,41
Häm,dalaran,1576,hunter,beastmastery,163,86,77
Stimpblimp,jubeithos,1576,hunter,beastmastery,40,19,21
Squishasf,tichondrius,1575,hunter,beastmastery,30,18,12
Squeeb,frostmourne,1572,hunter,beastmastery,62,30,32
Pàstor,azralon,1571,hunter,beastmastery,42,21,21
Zennifi,bleeding-hollow,1570,hunter,beastmastery,97,49,48
Snipin,ragnaros,1570,hunter,beastmastery,48,18,30
Phindo,agamaggan,1569,hunter,beastmastery,36,20,16
Robnhunt,tichondrius,1568,hunter,beastmastery,36,18,18
Rektarrow,area-52,1568,hunter,beastmastery,47,23,24
Skeetslinger,illidan,1568,hunter,beastmastery,45,18,27
Barbed,blackrock,1567,hunter,beastmastery,49,19,30
Petkd,frostmourne,1566,hunter,beastmastery,48,27,21
Bubbzar,frostmourne,1564,hunter,beastmastery,54,29,25
Grumnz,thrall,1564,hunter,beastmastery,54,28,26
Biehuixin,tichondrius,1562,hunter,beastmastery,80,38,42
Uzpak,tichondrius,1561,hunter,beastmastery,77,44,33
Elieliloa,quelthalas,1560,hunter,beastmastery,81,39,42
Ahuamax,tichondrius,1559,hunter,beastmastery,82,47,35
Lemmetrap,illidan,1554,hunter,beastmastery,41,22,19
Hovahdo,proudmoore,1553,hunter,beastmastery,35,19,16
Keboks,alleria,1551,hunter,beastmastery,33,18,15
Kolyanis,stormrage,1551,hunter,beastmastery,143,76,67
Reay,frostmourne,1551,hunter,beastmastery,36,19,17
Khaydarin,sargeras,1551,hunter,beastmastery,48,21,27
Partz,darkspear,1549,hunter,beastmastery,36,20,16
Nitroxl,illidan,1548,hunter,beastmastery,90,47,43
Hazzeth,thrall,1547,hunter,beastmastery,36,25,11
Raven,sargeras,1547,hunter,beastmastery,46,19,27
Readtitle,malganis,1546,hunter,beastmastery,60,35,25
Gernon,frostmourne,1546,hunter,beastmastery,63,32,31
Dorkins,azralon,1545,hunter,beastmastery,56,32,24
Reallybroke,stormrage,1543,hunter,beastmastery,44,24,20
Fernn,illidan,1543,hunter,beastmastery,182,83,99
Jugi,wyrmrest-accord,1542,hunter,beastmastery,76,41,35
Outfazed,tichondrius,1541,hunter,beastmastery,105,57,48
Dôntlosmebro,stormrage,1540,hunter,beastmastery,66,37,29
Mfjl,tichondrius,1540,hunter,beastmastery,105,52,53
Varka,area-52,1539,hunter,beastmastery,48,26,22
Laurenx,illidan,1537,hunter,beastmastery,33,20,13
Somethinglit,sargeras,1537,hunter,beastmastery,75,38,37
Szone,tichondrius,1537,hunter,beastmastery,166,84,82
Runforthehil,barthilas,1537,hunter,beastmastery,60,30,30
Zakrogg,tichondrius,1535,hunter,beastmastery,77,36,41
Velhokoira,illidan,1534,hunter,beastmastery,60,35,25
Sanchode,tichondrius,1534,hunter,beastmastery,78,36,42
Limpnoodle,nerzhul,1530,hunter,beastmastery,194,98,96
Cyrsmen,ragnaros,1529,hunter,beastmastery,234,116,118
Teaks,aggramar,1527,hunter,beastmastery,30,16,14
Breezekeeper,area-52,1527,hunter,beastmastery,78,40,38
Shadowtensai,stormrage,1527,hunter,beastmastery,78,34,44
Exitwoundz,hyjal,1526,hunter,beastmastery,71,35,36
Robitur,sargeras,1526,hunter,beastmastery,36,17,19
Ddänz,kiljaeden,1524,hunter,beastmastery,101,41,60
Broydiesnipe,illidan,1523,hunter,beastmastery,24,16,8
Dooper,malfurion,1523,hunter,beastmastery,42,20,22
Happyvelic,tichondrius,1522,hunter,beastmastery,36,16,20
Ullr,gurubashi,1522,hunter,beastmastery,76,28,48
Cigâro,thrall,1520,hunter,beastmastery,183,96,87
Lindsang,illidan,1520,hunter,beastmastery,60,31,29
Bonnèy,zuljin,1518,hunter,beastmastery,49,32,17
Clinteastwoo,ragnaros,1517,hunter,beastmastery,48,16,32
Balldik,bleeding-hollow,1516,hunter,beastmastery,42,20,22
Hynathios,azralon,1514,hunter,beastmastery,53,25,28
Yugno,wildhammer,1513,hunter,beastmastery,42,22,20
Whatfoxsay,tichondrius,1513,hunter,beastmastery,54,26,28
Deirrë,saurfang,1512,hunter,beastmastery,197,105,92
Yager,kalecgos,1512,hunter,beastmastery,52,26,26
Ungoliánt,cairne,1511,hunter,beastmastery,66,33,33
Askelon,firetree,1511,hunter,beastmastery,45,22,23
Gamestopceo,tichondrius,1511,hunter,beastmastery,84,41,43
Hobbingtons,thunderlord,1510,hunter,beastmastery,36,19,17
Morganson,moon-guard,1509,hunter,beastmastery,234,117,117
Internade,frostmourne,1509,hunter,beastmastery,54,25,29
Myladyy,zuljin,1509,hunter,beastmastery,71,30,41
Qlbl,tichondrius,1508,hunter,beastmastery,57,27,30
Datadyne,stormrage,1507,hunter,beastmastery,18,16,2
Diavál,area-52,1507,hunter,beastmastery,46,26,20
Tinyted,nathrezim,1507,hunter,beastmastery,96,47,49
Dinaoce,frostmourne,1505,hunter,beastmastery,167,89,78
Volbz,barthilas,1505,hunter,beastmastery,36,16,20
Yeaheh,area-52,1504,hunter,beastmastery,30,18,12
Buggyhuntz,stormrage,1504,hunter,beastmastery,67,38,29
Pankyrangs,kelthuzad,1504,hunter,beastmastery,54,27,27
Emilysamuels,tichondrius,1503,hunter,beastmastery,24,16,8
Chowyunfatss,proudmoore,1503,hunter,beastmastery,136,66,70
Fkkroglash,barthilas,1501,hunter,beastmastery,42,23,19
Chrest,sargeras,1500,hunter,beastmastery,76,39,37
Tsuro,area-52,1499,hunter,beastmastery,83,41,42
Irøneye,sargeras,1499,hunter,beastmastery,55,20,35
Entrapment,emerald-dream,1498,hunter,beastmastery,41,22,19
Folf,turalyon,1497,hunter,beastmastery,78,34,44
Sartel,tichondrius,1495,hunter,beastmastery,30,17,13
Ramchi,burning-blade,1494,hunter,beastmastery,61,33,28
Xuorias,area-52,1494,hunter,beastmastery,47,24,23
Zaetor,ragnaros,1493,hunter,beastmastery,119,65,54
Punjisticks,tichondrius,1492,hunter,beastmastery,110,53,57
Souperman,malganis,1492,hunter,beastmastery,36,16,20
Finalshot,barthilas,1491,hunter,beastmastery,39,18,21
Pavlovik,ragnaros,1491,hunter,beastmastery,60,25,35
Anastasia,gorgonnash,1490,hunter,beastmastery,66,36,30
Drunkhunter,malygos,1489,hunter,beastmastery,30,17,13
Accuzationzx,tichondrius,1489,hunter,beastmastery,36,20,16
Oceandoom,tichondrius,1489,hunter,beastmastery,158,84,74
Limcross,drakkari,1489,hunter,beastmastery,56,28,28
Gaktog,area-52,1489,hunter,beastmastery,45,22,23
Setepalms,azralon,1489,hunter,beastmastery,38,18,20
Wredd,nemesis,1488,hunter,beastmastery,35,20,15
Zünma,tichondrius,1488,hunter,beastmastery,60,30,30
Borudin,stormrage,1488,hunter,beastmastery,215,104,111
Chaw,nathrezim,1487,hunter,beastmastery,236,120,116
Scirfreez,ragnaros,1487,hunter,beastmastery,66,30,36
Shedowhunter,azralon,1486,hunter,beastmastery,42,26,16
Bigolekack,tichondrius,1486,hunter,beastmastery,60,29,31
Droneshot,tichondrius,1485,hunter,beastmastery,54,35,19
Regivaness,nemesis,1485,hunter,beastmastery,30,16,14
Yandralen,kiljaeden,1485,hunter,beastmastery,129,66,63
Laras,blades-edge,1484,hunter,beastmastery,36,22,14
Chizhi,tichondrius,1484,hunter,beastmastery,90,45,45
Cerébro,illidan,1483,hunter,beastmastery,90,35,55
Midgetsniper,thrall,1481,hunter,beastmastery,32,17,15
Selhort,quelthalas,1481,hunter,beastmastery,84,36,48
Rengarok,emerald-dream,1480,hunter,beastmastery,44,23,21
Grànd,tortheldrin,1480,hunter,beastmastery,66,33,33
Angdre,tichondrius,1480,hunter,beastmastery,36,18,18
Kaliaraan,bleeding-hollow,1479,hunter,beastmastery,100,51,49
Shockwave,velen,1479,hunter,beastmastery,275,140,135
Hughneutron,kirin-tor,1478,hunter,beastmastery,279,152,127
Junmuxiao,ragnaros,1478,hunter,beastmastery,124,61,63
Scourgesurge,kiljaeden,1478,hunter,beastmastery,145,71,74
Josyv,quelthalas,1477,hunter,beastmastery,36,21,15
Tageh,malganis,1477,hunter,beastmastery,74,35,39
Pingaamarela,nemesis,1476,hunter,beastmastery,232,122,110
Garzb,area-52,1476,hunter,beastmastery,42,22,20
Aguntur,ragnaros,1474,hunter,beastmastery,99,59,40
Loktarnum,illidan,1474,hunter,beastmastery,52,23,29
Hyena,kelthuzad,1470,hunter,beastmastery,36,18,18
Virolac,tichondrius,1469,hunter,beastmastery,32,16,16
Fistbirtdor,illidan,1468,hunter,beastmastery,64,30,34
Caetomon,kiljaeden,1467,hunter,beastmastery,29,18,11
Lunarlunar,khadgar,1466,hunter,beastmastery,56,24,32
Tacos,kelthuzad,1465,hunter,beastmastery,36,22,14
Léfty,burning-blade,1465,hunter,beastmastery,90,42,48
Sootgarbage,sargeras,1464,hunter,beastmastery,72,42,30
Thoridhal,quelthalas,1464,hunter,beastmastery,66,33,33
Kerandas,stormrage,1463,hunter,beastmastery,35,19,16
Shangowar,darrowmere,1462,hunter,beastmastery,30,17,13
Xpyro,azralon,1462,hunter,beastmastery,72,36,36
Fifie,azgalor,1460,hunter,beastmastery,77,39,38
ßoness,area-52,1460,hunter,beastmastery,92,38,54
Jaysuper,zuljin,1460,hunter,beastmastery,84,34,50
Danncer,alexstrasza,1459,hunter,beastmastery,102,56,46
Bootylickin,tichondrius,1459,hunter,beastmastery,36,17,19
Pheijaumn,azralon,1458,hunter,beastmastery,55,32,23
Mms,frostmourne,1458,hunter,beastmastery,84,43,41
Ehnó,illidan,1458,hunter,beastmastery,39,19,20
Mikly,ragnaros,1457,hunter,beastmastery,44,18,26
Wolfarms,area-52,1455,hunter,beastmastery,93,45,48
Puppe,sargeras,1452,hunter,beastmastery,61,31,30
Computer,darkspear,1452,hunter,beastmastery,36,18,18
Hongnael,tichondrius,1452,hunter,beastmastery,36,17,19
Sax,stormreaver,1452,hunter,beastmastery,36,16,20
Freebeë,area-52,1451,hunter,beastmastery,109,58,51
Fusbowdah,bleeding-hollow,1451,hunter,beastmastery,64,29,35
Drig,korgath,1450,hunter,beastmastery,59,27,32
Daskreg,uther,1450,hunter,beastmastery,35,16,19
Spitballa,emerald-dream,1448,hunter,beastmastery,66,30,36
Sereom,frostmourne,1447,hunter,beastmastery,154,83,71
Stalkstride,destromath,1447,hunter,beastmastery,78,36,42
Vanero,eonar,1447,hunter,beastmastery,77,31,46
Jacss,azralon,1446,hunter,beastmastery,30,17,13
Bronke,azralon,1446,hunter,beastmastery,67,30,37
Narus,whisperwind,1444,hunter,beastmastery,132,74,58
Gorgoon,sargeras,1444,hunter,beastmastery,42,21,21
Kouandjio,area-52,1444,hunter,beastmastery,36,18,18
Stonëdpimp,moon-guard,1443,hunter,beastmastery,30,18,12
Sabanna,proudmoore,1442,hunter,beastmastery,36,20,16
Zanahoria,stormscale,1442,hunter,beastmastery,43,19,24
Earlzmoade,bleeding-hollow,1441,hunter,beastmastery,54,26,28
Daarrk,thrall,1441,hunter,beastmastery,82,39,43
Dontmissz,tichondrius,1439,hunter,beastmastery,59,32,27
Gennaro,ragnaros,1439,hunter,beastmastery,30,15,15
Lashga,wyrmrest-accord,1439,hunter,beastmastery,47,22,25
Yná,azralon,1438,hunter,beastmastery,24,15,9
Revbubs,darkspear,1438,hunter,beastmastery,66,35,31
Bigclamz,dragonmaw,1437,hunter,beastmastery,45,25,20
Bliv,tichondrius,1436,hunter,beastmastery,18,15,3
Aristæos,kelthuzad,1436,hunter,beastmastery,77,40,37
Sungoro,tichondrius,1436,hunter,beastmastery,84,38,46
Squírtle,ragnaros,1436,hunter,beastmastery,36,15,21
Sarahbeara,moonrunner,1435,hunter,beastmastery,24,15,9
Artames,tichondrius,1435,hunter,beastmastery,30,15,15
Alexxspewpew,ragnaros,1434,hunter,beastmastery,29,15,14
Dlabio,emerald-dream,1434,hunter,beastmastery,114,57,57
Jangle,mannoroth,1433,hunter,beastmastery,52,30,22
Seatback,arathor,1432,hunter,beastmastery,76,33,43
Kkoner,illidan,1431,hunter,beastmastery,24,15,9
Munyshotz,tichondrius,1431,hunter,beastmastery,128,72,56
Seljzs,zuljin,1430,hunter,beastmastery,24,15,9
Bagodonuts,malganis,1429,hunter,beastmastery,47,26,21
Prierhunt,frostmourne,1429,hunter,beastmastery,36,15,21
Zarova,moon-guard,1428,hunter,beastmastery,24,15,9
Snypêr,tichondrius,1428,hunter,beastmastery,48,21,27
Lilbic,bleeding-hollow,1427,hunter,beastmastery,33,22,11
Iyne,stormrage,1427,hunter,beastmastery,36,15,21
Meowimadog,spinebreaker,1426,hunter,beastmastery,54,34,20
Yaisk,tichondrius,1426,hunter,beastmastery,74,38,36
Kleankilla,malganis,1425,hunter,beastmastery,50,27,23
Gandson,fizzcrank,1425,hunter,beastmastery,59,28,31
Elyssandrá,thrall,1424,hunter,beastmastery,125,62,63
Handicrap,tichondrius,1423,hunter,beastmastery,44,26,18
Jboogie,malganis,1423,hunter,beastmastery,40,18,22
Xuv,illidan,1423,hunter,beastmastery,42,18,24
Kellsier,nordrassil,1422,hunter,beastmastery,30,15,15
Jesselos,stormrage,1422,hunter,beastmastery,60,29,31
Keknine,gnomeregan,1421,hunter,beastmastery,92,44,48
Boomseed,nagrand,1420,hunter,beastmastery,34,16,18
Nephewblasty,nagrand,1419,hunter,beastmastery,42,23,19
Tentoontrey,emerald-dream,1419,hunter,beastmastery,48,24,24
Mukeru,stormrage,1418,hunter,beastmastery,24,15,9
Strikerfirst,area-52,1417,hunter,beastmastery,45,27,18
Araghrn,draktharon,1417,hunter,beastmastery,111,54,57
Rawspits,kiljaeden,1417,hunter,beastmastery,47,17,30
Celarla,tichondrius,1416,hunter,beastmastery,27,16,11
Gannidema,illidan,1416,hunter,beastmastery,30,17,13
Gravshot,zuljin,1416,hunter,beastmastery,36,18,18
Belime,korgath,1415,hunter,beastmastery,96,53,43
Javoz,drakkari,1415,hunter,beastmastery,42,18,24
Terminatôr,malganis,1415,hunter,beastmastery,36,15,21
Legolasbow,tichondrius,1414,hunter,beastmastery,58,30,28
Akoshi,illidan,1414,hunter,beastmastery,42,18,24
Clütch,darkspear,1413,hunter,beastmastery,36,15,21
Existential,moon-guard,1412,hunter,beastmastery,59,27,32
Turbows,proudmoore,1412,hunter,beastmastery,48,20,28
Mopgodxqt,nemesis,1410,hunter,beastmastery,48,19,29
Zombified,moon-guard,1409,hunter,beastmastery,50,23,27
Hobbléfoot,proudmoore,1409,hunter,beastmastery,36,15,21
Smoothbrainz,blackrock,1407,hunter,beastmastery,30,15,15
Sioul,bleeding-hollow,1403,hunter,beastmastery,30,15,15
Ruffini,tichondrius,1402,hunter,beastmastery,60,26,34
Sliturthroat,barthilas,1402,hunter,beastmastery,50,20,30
Rocchettâ,kirin-tor,1399,hunter,beastmastery,58,31,27
Floopze,burning-legion,1399,hunter,beastmastery,30,16,14
Luckshot,destromath,1398,hunter,beastmastery,60,27,33
Overshot,barthilas,1397,hunter,beastmastery,24,16,8
Therooth,bleeding-hollow,1397,hunter,beastmastery,59,35,24
Eggbertx,frostmourne,1396,hunter,beastmastery,36,19,17
Jyttrg,tichondrius,1396,hunter,beastmastery,65,34,31
Boomsprocket,khazgoroth,1395,hunter,beastmastery,51,31,20
Aggargh,baelgun,1395,hunter,beastmastery,66,36,30
Spèedbump,stormrage,1394,hunter,beastmastery,81,40,41
Petmayo,tichondrius,1393,hunter,beastmastery,30,19,11
Fruitenveg,frostmourne,1393,hunter,beastmastery,48,24,24
Huntncheekz,kelthuzad,1393,hunter,beastmastery,30,15,15
Timmee,bleeding-hollow,1392,hunter,beastmastery,36,15,21
Liillilliil,tichondrius,1391,hunter,beastmastery,31,16,15
Paganfinn,tichondrius,1391,hunter,beastmastery,66,29,37
Fuzzypjs,stormrage,1390,hunter,beastmastery,42,24,18
Sleepywrld,area-52,1390,hunter,beastmastery,41,20,21
Køk,agamaggan,1389,hunter,beastmastery,41,15,26
Redwolf,moon-guard,1388,hunter,beastmastery,56,30,26
Sülivan,zuljin,1388,hunter,beastmastery,61,32,29
Recha,emerald-dream,1388,hunter,beastmastery,42,21,21
Genx,frostmane,1387,hunter,beastmastery,89,44,45
Laudion,quelthalas,1386,hunter,beastmastery,24,17,7
Scruffiebear,deathwing,1385,hunter,beastmastery,24,15,9
Fleetfox,tichondrius,1385,hunter,beastmastery,115,57,58
Alwaysblazed,hyjal,1383,hunter,beastmastery,36,17,19
Critterz,gorgonnash,1383,hunter,beastmastery,77,33,44
Tearsofnoobs,tichondrius,1381,hunter,beastmastery,33,16,17
Viperstng,area-52,1380,hunter,beastmastery,70,40,30
Velkhan,sargeras,1379,hunter,beastmastery,36,16,20
Lastanar,amanthul,1376,hunter,beastmastery,122,65,57
Kronas,laughing-skull,1376,hunter,beastmastery,87,45,42
Taelen,aegwynn,1376,hunter,beastmastery,98,49,49
Sharpster,zuljin,1376,hunter,beastmastery,91,43,48
Killshotqq,tichondrius,1375,hunter,beastmastery,40,18,22
Gejagt,sargeras,1373,hunter,beastmastery,43,23,20
Tearsofrogue,tichondrius,1373,hunter,beastmastery,30,16,14
Lilpoots,warsong,1373,hunter,beastmastery,71,33,38
Chrise,darkspear,1371,hunter,beastmastery,24,18,6
Kleivar,alleria,1370,hunter,beastmastery,30,15,15
Jijiyoyo,tichondrius,1370,hunter,beastmastery,47,18,29
Thralzun,dunemaul,1369,hunter,beastmastery,49,24,25
Phaction,tichondrius,1369,hunter,beastmastery,60,26,34
Voodoohunter,blood-furnace,1366,hunter,beastmastery,47,25,22
Bubbz,bloodscalp,1365,hunter,beastmastery,132,70,62
Femonemos,nemesis,1364,hunter,beastmastery,61,32,29
Terrygross,sargeras,1364,hunter,beastmastery,36,15,21
Yembohi,queldorei,1363,hunter,beastmastery,24,15,9
Jahir,tichondrius,1363,hunter,beastmastery,30,16,14
Salvatiel,stormrage,1363,hunter,beastmastery,60,30,30
Boward,illidan,1362,hunter,beastmastery,67,36,31
Blackspit,ragnaros,1362,hunter,beastmastery,65,34,31
Ogkhalifa,tichondrius,1362,hunter,beastmastery,59,26,33
Calypso,chromaggus,1360,hunter,beastmastery,36,19,17
Moistlegs,proudmoore,1360,hunter,beastmastery,36,16,20
Wook,hyjal,1359,hunter,beastmastery,35,17,18
Ryukuzen,tichondrius,1359,hunter,beastmastery,35,15,20
Dabondweebs,dalaran,1357,hunter,beastmastery,65,32,33
Shlandy,frostmourne,1356,hunter,beastmastery,32,18,14
Wrècked,kiljaeden,1356,hunter,beastmastery,65,28,37
Kronc,dethecus,1355,hunter,beastmastery,40,16,24
Deadlyarrows,ragnaros,1354,hunter,beastmastery,78,35,43
Saintshaka,drakkari,1353,hunter,beastmastery,23,15,8
Tokendaily,sargeras,1353,hunter,beastmastery,72,40,32
Conizle,sargeras,1353,hunter,beastmastery,36,17,19
Xcisiion,nagrand,1353,hunter,beastmastery,70,31,39
Tmac,winterhoof,1349,hunter,beastmastery,116,65,51
Cinamong,blackrock,1347,hunter,beastmastery,30,15,15
Pokérap,dalaran,1347,hunter,beastmastery,42,17,25
Jackcoügh,frostmourne,1346,hunter,beastmastery,37,15,22
Eldlichi,proudmoore,1344,hunter,beastmastery,66,26,40
Djfortnité,tichondrius,1343,hunter,beastmastery,24,14,10
Wildlifezoo,tichondrius,1343,hunter,beastmastery,30,14,16
Willdey,frostmourne,1343,hunter,beastmastery,36,14,22
Iar,tichondrius,1342,hunter,beastmastery,42,27,15
Killaseason,akama,1342,hunter,beastmastery,24,14,10
Pressbro,tichondrius,1342,hunter,beastmastery,30,14,16
Lilien,khazgoroth,1341,hunter,beastmastery,36,21,15
Bingdat,area-52,1341,hunter,beastmastery,88,45,43
Runecrossbow,barthilas,1341,hunter,beastmastery,30,14,16
Choclit,scilla,1341,hunter,beastmastery,42,14,28
Devised,proudmoore,1340,hunter,beastmastery,29,16,13
Burtone,aegwynn,1340,hunter,beastmastery,40,19,21
ßutter,thunderlord,1340,hunter,beastmastery,195,91,104
Clydebarro,sargeras,1339,hunter,beastmastery,30,14,16
Cantcatchtin,tichondrius,1339,hunter,beastmastery,30,14,16
Barosan,illidan,1339,hunter,beastmastery,30,14,16
Oatmeallover,stormrage,1339,hunter,beastmastery,30,14,16
Peterming,tichondrius,1339,hunter,beastmastery,108,49,59
Toozz,frostmourne,1339,hunter,beastmastery,36,14,22
Lele,stormrage,1338,hunter,beastmastery,76,40,36
Euclase,bleeding-hollow,1338,hunter,beastmastery,46,23,23
Aiollus,stormreaver,1338,hunter,beastmastery,30,14,16
Pvrisxoxo,frostmourne,1337,hunter,beastmastery,31,15,16
Bro,malorne,1337,hunter,beastmastery,96,45,51
Misakilr,illidan,1337,hunter,beastmastery,31,14,17
Ordius,azralon,1337,hunter,beastmastery,36,14,22
Crownchild,illidan,1336,hunter,beastmastery,24,14,10
Muffkick,illidan,1336,hunter,beastmastery,27,15,12
Soulreaperts,ragnaros,1336,hunter,beastmastery,40,21,19
Skulgor,zuljin,1336,hunter,beastmastery,66,34,32
Azx,tichondrius,1336,hunter,beastmastery,42,19,23
Stel,tichondrius,1335,hunter,beastmastery,33,17,16
Roostersauce,durotan,1335,hunter,beastmastery,36,18,18
Selljzs,zuljin,1333,hunter,beastmastery,24,14,10
Hendó,korgath,1332,hunter,beastmastery,24,14,10
Jîa,tichondrius,1332,hunter,beastmastery,34,16,18
Cryfu,kelthuzad,1331,hunter,beastmastery,24,14,10
Óriion,zuljin,1331,hunter,beastmastery,30,15,15
Daken,ysera,1330,hunter,beastmastery,24,14,10
Argent,altar-of-storms,1330,hunter,beastmastery,42,23,19
Khels,stormreaver,1330,hunter,beastmastery,28,15,13
Oblíviion,stormrage,1330,hunter,beastmastery,86,44,42
Jjack,muradin,1330,hunter,beastmastery,96,45,51
Phatniss,tichondrius,1330,hunter,beastmastery,36,14,22
Luprikus,maelstrom,1328,hunter,beastmastery,29,14,15
Rycksanches,quelthalas,1328,hunter,beastmastery,97,44,53
Babyshawrk,tichondrius,1327,hunter,beastmastery,24,14,10
Kârân,tichondrius,1327,hunter,beastmastery,91,42,49
Hugehuntard,frostmane,1327,hunter,beastmastery,93,38,55
Frostyarrow,moon-guard,1325,hunter,beastmastery,55,28,27
Jetzy,illidan,1324,hunter,beastmastery,95,46,49
Skippyh,zuluhed,1323,hunter,beastmastery,24,14,10
Hitts,kelthuzad,1323,hunter,beastmastery,31,17,14
Darthski,drenden,1323,hunter,beastmastery,68,30,38
Bowna,stormscale,1323,hunter,beastmastery,54,20,34
Fusionrpg,quelthalas,1320,hunter,beastmastery,30,17,13
Jesticles,zuljin,1320,hunter,beastmastery,60,30,30
Sáns,sargeras,1320,hunter,beastmastery,30,14,16
Nimbioth,proudmoore,1319,hunter,beastmastery,30,14,16
Cottonshots,dalaran,1318,hunter,beastmastery,107,49,58
Doug,illidan,1317,hunter,beastmastery,30,14,16
Nøtsurê,llane,1317,hunter,beastmastery,66,25,41
Shaximus,illidan,1314,hunter,beastmastery,62,35,27
Xeminis,area-52,1314,hunter,beastmastery,30,14,16
Peiching,proudmoore,1314,hunter,beastmastery,36,15,21
Hoboh,illidan,1310,hunter,beastmastery,66,32,34
Huntmeplz,proudmoore,1309,hunter,beastmastery,35,17,18
Ellarise,stormrage,1308,hunter,beastmastery,36,22,14
Varthurg,ragnaros,1308,hunter,beastmastery,30,15,15
Fames,shuhalo,1308,hunter,beastmastery,73,30,43
Pooterdrip,shadowmoon,1307,hunter,beastmastery,30,14,16
Hunterjim,tichondrius,1306,hunter,beastmastery,38,19,19
Vruul,sargeras,1306,hunter,beastmastery,82,38,44
Vayesa,stormscale,1306,hunter,beastmastery,45,20,25
Kamikazey,tichondrius,1304,hunter,beastmastery,36,18,18
Bacatran,darkspear,1301,hunter,beastmastery,58,32,26
Bepee,auchindoun,1300,hunter,beastmastery,122,65,57
Sunchea,arygos,1300,hunter,beastmastery,30,14,16
Snoozee,emerald-dream,1300,hunter,beastmastery,57,22,35
Finol,azralon,1299,hunter,beastmastery,20,15,5
Eglon,bleeding-hollow,1299,hunter,beastmastery,24,16,8
Vaettai,barthilas,1297,hunter,beastmastery,112,52,60
Mvpbunny,tichondrius,1296,hunter,beastmastery,74,41,33
Zzsocrateszz,dragonmaw,1295,hunter,beastmastery,128,64,64
Dabznblunts,twisting-nether,1295,hunter,beastmastery,42,18,24
Jacobsladder,illidan,1293,hunter,beastmastery,113,51,62
Youngteflon,bonechewer,1293,hunter,beastmastery,36,16,20
Xxty,stormrage,1292,hunter,beastmastery,30,15,15
Artemisa,warsong,1291,hunter,beastmastery,84,34,50
Darksector,nemesis,1290,hunter,beastmastery,41,14,27
Wogolas,barthilas,1288,hunter,beastmastery,30,16,14
Gïzmo,malganis,1287,hunter,beastmastery,60,30,30
Wulfgeng,azgalor,1287,hunter,beastmastery,152,74,78
Huukend,azjolnerub,1286,hunter,beastmastery,54,27,27
Shorÿuken,tichondrius,1285,hunter,beastmastery,45,15,30
Tiraa,kelthuzad,1283,hunter,beastmastery,54,24,30
Cyboreg,stormrage,1281,hunter,beastmastery,58,33,25
Lizymcguire,malganis,1281,hunter,beastmastery,54,28,26
Firesail,kelthuzad,1281,hunter,beastmastery,32,16,16
Orcbeast,illidan,1280,hunter,beastmastery,68,27,41
Peppiee,tichondrius,1279,hunter,beastmastery,23,14,9
Villain,arthas,1279,hunter,beastmastery,36,15,21
Bowflëx,zuljin,1278,hunter,beastmastery,54,26,28
Thiccphat,sargeras,1277,hunter,beastmastery,23,14,9
Bluebow,tichondrius,1276,hunter,beastmastery,126,60,66
Tupirani,azralon,1275,hunter,beastmastery,22,14,8
Eightbeers,bleeding-hollow,1275,hunter,beastmastery,92,46,46
Tergls,illidan,1274,hunter,beastmastery,103,46,57
Trionias,malfurion,1274,hunter,beastmastery,48,17,31
Haiume,nemesis,1273,hunter,beastmastery,42,17,25
Radat,stormscale,1272,hunter,beastmastery,37,22,15
Shootaids,illidan,1272,hunter,beastmastery,56,31,25
Highdroe,tichondrius,1272,hunter,beastmastery,102,54,48
Scaredcrow,azshara,1272,hunter,beastmastery,40,14,26
Snipershot,blackrock,1271,hunter,beastmastery,42,19,23
Itsdoom,sargeras,1270,hunter,beastmastery,66,40,26
Ascer,gurubashi,1270,hunter,beastmastery,110,55,55
Timogen,illidan,1269,hunter,beastmastery,42,20,22
Glediator,tichondrius,1269,hunter,beastmastery,45,21,24
Henski,wyrmrest-accord,1268,hunter,beastmastery,48,23,25
Rnger,aerie-peak,1267,hunter,beastmastery,61,28,33
Piu,illidan,1267,hunter,beastmastery,66,30,36
Starsworn,moon-guard,1266,hunter,beastmastery,78,38,40
Gigawrench,darkspear,1265,hunter,beastmastery,24,16,8
Airtight,area-52,1265,hunter,beastmastery,59,26,33
Frenzyfire,whisperwind,1263,hunter,beastmastery,75,37,38
Böuntyhuntêr,area-52,1263,hunter,beastmastery,72,35,37
Mitulla,wyrmrest-accord,1261,hunter,beastmastery,68,32,36
Shekiro,illidan,1261,hunter,beastmastery,61,27,34
Sagittarion,malfurion,1260,hunter,beastmastery,31,18,13
Saltz,tichondrius,1259,hunter,beastmastery,27,15,12
Bobbysmurica,cenarion-circle,1257,hunter,beastmastery,66,30,36
Trianthel,azralon,1255,hunter,beastmastery,24,15,9
Bulleitrye,illidan,1253,hunter,beastmastery,64,28,36
Socrato,tichondrius,1252,hunter,beastmastery,43,21,22
Dunkam,quelthalas,1252,hunter,beastmastery,90,43,47
Drimhuzzah,velen,1251,hunter,beastmastery,32,18,14
Chrønic,khadgar,1251,hunter,beastmastery,36,19,17
Exotichunter,the-underbog,1250,hunter,beastmastery,64,26,38
Onihanzo,thrall,1250,hunter,beastmastery,37,15,22
Danion,aerie-peak,1249,hunter,beastmastery,64,27,37
Vesity,tichondrius,1248,hunter,beastmastery,63,29,34
Karev,area-52,1248,hunter,beastmastery,36,16,20
Ztyer,stormrage,1247,hunter,beastmastery,24,13,11
Lfghunter,frostmourne,1247,hunter,beastmastery,24,13,11
Jawnhunterii,tichondrius,1247,hunter,beastmastery,24,13,11
Wastdpenguin,area-52,1247,hunter,beastmastery,30,13,17
Frankabingle,area-52,1247,hunter,beastmastery,30,13,17
Slowhunterr,tichondrius,1247,hunter,beastmastery,36,13,23
Refinedx,sargeras,1246,hunter,beastmastery,18,13,5
Sotsöl,ragnaros,1246,hunter,beastmastery,24,13,11
Thiccit,illidan,1246,hunter,beastmastery,54,26,28
Òrìòn,tichondrius,1245,hunter,beastmastery,51,20,31
Blury,tichondrius,1244,hunter,beastmastery,85,44,41
Shotmieye,thunderhorn,1244,hunter,beastmastery,60,30,30
Maquire,tichondrius,1244,hunter,beastmastery,36,17,19
Digitizoid,tichondrius,1244,hunter,beastmastery,30,13,17
Craftarrow,tichondrius,1243,hunter,beastmastery,41,21,20
Alitharia,nerzhul,1243,hunter,beastmastery,193,86,107
Guapshot,stormreaver,1242,hunter,beastmastery,41,16,25
Heparinqt,area-52,1242,hunter,beastmastery,36,13,23
Bighuntz,bleeding-hollow,1241,hunter,beastmastery,36,13,23
Entillyrian,caelestrasz,1240,hunter,beastmastery,29,16,13
Gunbladez,burning-blade,1240,hunter,beastmastery,27,13,14
Mistachów,malganis,1240,hunter,beastmastery,30,13,17
Deepcarver,tichondrius,1240,hunter,beastmastery,41,16,25
Wadadly,malganis,1239,hunter,beastmastery,144,69,75
Winchestyr,lightbringer,1239,hunter,beastmastery,36,17,19
Norcklow,ragnaros,1239,hunter,beastmastery,76,34,42
Balsagoth,azralon,1239,hunter,beastmastery,54,24,30
Ioioi,tichondrius,1238,hunter,beastmastery,34,16,18
Neymoxi,icecrown,1237,hunter,beastmastery,54,30,24
Nebulahaze,stormrage,1236,hunter,beastmastery,56,27,29
Nogaro,nemesis,1235,hunter,beastmastery,42,20,22
Yesterday,draka,1234,hunter,beastmastery,30,13,17
Honeygold,tichondrius,1233,hunter,beastmastery,51,19,32
Wârhunt,frostmourne,1232,hunter,beastmastery,78,41,37
Rbtz,illidan,1231,hunter,beastmastery,17,13,4
Xtop,draktharon,1231,hunter,beastmastery,23,15,8
Iffy,dentarg,1230,hunter,beastmastery,36,21,15
Tanarin,bleeding-hollow,1230,hunter,beastmastery,30,13,17
Blanar,quelthalas,1230,hunter,beastmastery,42,13,29
Chickenadobo,maelstrom,1227,hunter,beastmastery,48,30,18
Luoca,shuhalo,1227,hunter,beastmastery,24,13,11
Skywrecker,bleeding-hollow,1226,hunter,beastmastery,24,13,11
Warwonka,magtheridon,1226,hunter,beastmastery,50,23,27
Smallsouljah,demon-soul,1226,hunter,beastmastery,39,17,22
Blockeyhunt,tichondrius,1225,hunter,beastmastery,24,13,11
Brandough,detheroc,1223,hunter,beastmastery,33,19,14
Urimiel,daggerspine,1223,hunter,beastmastery,36,16,20
Foffy,darkspear,1222,hunter,beastmastery,54,30,24
Mithrandiel,blood-furnace,1221,hunter,beastmastery,97,49,48
Bromance,kaelthas,1221,hunter,beastmastery,36,18,18
Crumpit,moon-guard,1220,hunter,beastmastery,51,17,34
Grands,tortheldrin,1219,hunter,beastmastery,29,14,15
Havymetal,andorhal,1219,hunter,beastmastery,48,20,28
Machiko,gorefiend,1218,hunter,beastmastery,30,13,17
Anaiset,hyjal,1217,hunter,beastmastery,24,13,11
Mazziy,zangarmarsh,1217,hunter,beastmastery,36,15,21
Xxo,frostmourne,1215,hunter,beastmastery,34,13,21
Loathin,stormrage,1213,hunter,beastmastery,33,21,12
Wingclipped,kelthuzad,1213,hunter,beastmastery,22,14,8
Slipperyqt,frostmourne,1213,hunter,beastmastery,40,14,26
Brendie,thrall,1212,hunter,beastmastery,304,153,151
Capnjack,hyjal,1212,hunter,beastmastery,69,25,44
Frxyza,stormrage,1211,hunter,beastmastery,24,13,11
Cotó,stormrage,1211,hunter,beastmastery,30,13,17
Soulshots,malganis,1211,hunter,beastmastery,36,13,23
Desydn,draenor,1210,hunter,beastmastery,161,81,80
Trapz,hellscream,1210,hunter,beastmastery,132,63,69
Élmérfudd,tichondrius,1210,hunter,beastmastery,36,16,20
Traxêx,nemesis,1209,hunter,beastmastery,36,16,20
Cullowhee,proudmoore,1208,hunter,beastmastery,26,14,12
Slutnamedjim,zuljin,1208,hunter,beastmastery,65,33,32
Zullypewpew,stormrage,1207,hunter,beastmastery,28,19,9
Alexbm,amanthul,1207,hunter,beastmastery,51,28,23
Hairyhype,malganis,1207,hunter,beastmastery,48,22,26
Rogshunt,sargeras,1207,hunter,beastmastery,29,13,16
Dayneryz,quelthalas,1206,hunter,beastmastery,99,46,53
Omegalulzxd,kelthuzad,1206,hunter,beastmastery,111,49,62
Ydaine,alexstrasza,1206,hunter,beastmastery,75,33,42
Trono,korgath,1205,hunter,beastmastery,36,15,21
Yousokook,frostmourne,1204,hunter,beastmastery,42,17,25
Ryøkø,nemesis,1202,hunter,beastmastery,23,14,9
Momodasi,illidan,1201,hunter,beastmastery,27,14,13
Owoonisan,illidan,1201,hunter,beastmastery,34,16,18
Leannon,stormrage,1200,hunter,beastmastery,35,19,16
Xarmozao,nemesis,1197,hunter,beastmastery,57,21,36
Nalsa,tichondrius,1195,hunter,beastmastery,28,13,15
Rosebullets,bleeding-hollow,1193,hunter,beastmastery,23,13,10
Londen,tichondrius,1193,hunter,beastmastery,48,23,25
Fallenfates,stormrage,1190,hunter,beastmastery,96,42,54
Alaranel,kiljaeden,1190,hunter,beastmastery,68,29,39
Sylriynn,moon-guard,1189,hunter,beastmastery,65,30,35
Vord,frostmourne,1189,hunter,beastmastery,30,13,17
Jônathan,tichondrius,1188,hunter,beastmastery,39,22,17
Chetta,ragnaros,1187,hunter,beastmastery,66,28,38
Hartman,frostwolf,1185,hunter,beastmastery,30,13,17
Rypunzul,proudmoore,1183,hunter,beastmastery,42,19,23
Kaxer,illidan,1182,hunter,beastmastery,65,33,32
Twatshót,burning-legion,1182,hunter,beastmastery,34,16,18
Shneedle,illidan,1180,hunter,beastmastery,54,22,32
Thetrickyone,area-52,1180,hunter,beastmastery,52,20,32
Ownyoufast,darkspear,1179,hunter,beastmastery,60,23,37
Poonbaddy,kiljaeden,1179,hunter,beastmastery,35,13,22
Aztrappin,illidan,1177,hunter,beastmastery,63,24,39
Fixnoone,moon-guard,1176,hunter,beastmastery,38,18,20
Vegamax,illidan,1173,hunter,beastmastery,36,22,14
Warsh,anubarak,1173,hunter,beastmastery,34,19,15
Therealgam,the-underbog,1173,hunter,beastmastery,36,18,18
Trailbreaker,trollbane,1169,hunter,beastmastery,93,50,43
Riivali,quelthalas,1169,hunter,beastmastery,87,40,47
Pigmaster,tichondrius,1166,hunter,beastmastery,26,13,13
Kathoey,wyrmrest-accord,1166,hunter,beastmastery,65,26,39
Elfinballz,khadgar,1164,hunter,beastmastery,36,18,18
Pikochon,illidan,1164,hunter,beastmastery,51,22,29
Thiccshawts,moon-guard,1162,hunter,beastmastery,24,13,11
Dracð,malganis,1162,hunter,beastmastery,64,34,30
Minkô,tichondrius,1159,hunter,beastmastery,30,13,17
Jezoo,frostmourne,1158,hunter,beastmastery,44,18,26
Totorostarh,tichondrius,1158,hunter,beastmastery,33,13,20
Macabre,scilla,1156,hunter,beastmastery,30,13,17
Arucedd,frostmourne,1154,hunter,beastmastery,80,35,45
Lustblitz,illidan,1152,hunter,beastmastery,24,12,12
Shinhyez,tichondrius,1152,hunter,beastmastery,24,12,12
Malvnfresh,tichondrius,1152,hunter,beastmastery,24,12,12
Tyrec,proudmoore,1152,hunter,beastmastery,30,12,18
Lhax,stormrage,1152,hunter,beastmastery,42,16,26
Rthr,kiljaeden,1151,hunter,beastmastery,18,12,6
Survenant,zuljin,1151,hunter,beastmastery,24,12,12
Awps,sargeras,1150,hunter,beastmastery,18,12,6
Chouklak,zuljin,1150,hunter,beastmastery,24,12,12
Shrian,illidan,1150,hunter,beastmastery,25,12,13
Kroozeh,illidan,1149,hunter,beastmastery,24,12,12
Ddukgue,tichondrius,1149,hunter,beastmastery,30,12,18
Tosila,tichondrius,1149,hunter,beastmastery,30,12,18
Moapax,azralon,1148,hunter,beastmastery,71,40,31
Funnk,tichondrius,1148,hunter,beastmastery,24,12,12
Berreydingle,norgannon,1148,hunter,beastmastery,24,12,12
Elfo,kelthuzad,1147,hunter,beastmastery,18,12,6
Suetyic,tichondrius,1147,hunter,beastmastery,24,12,12
Brickgrimes,illidan,1147,hunter,beastmastery,25,12,13
Mangosteen,illidan,1147,hunter,beastmastery,33,13,20
Geregaux,sargeras,1146,hunter,beastmastery,24,12,12
Slap,shattered-hand,1145,hunter,beastmastery,24,12,12
Ragnarlobkk,ragnaros,1144,hunter,beastmastery,148,71,77
Kharthorin,moon-guard,1142,hunter,beastmastery,48,19,29
Gratmuk,ragnaros,1139,hunter,beastmastery,30,12,18
Hatteras,drakthul,1139,hunter,beastmastery,50,16,34
Dyz,ragnaros,1137,hunter,beastmastery,28,13,15
Daréz,blackrock,1136,hunter,beastmastery,31,14,17
Strongene,aegwynn,1135,hunter,beastmastery,24,12,12
Jaboe,thrall,1135,hunter,beastmastery,24,12,12
Håwkeye,hyjal,1132,hunter,beastmastery,163,85,78
Blimpbooty,stormrage,1130,hunter,beastmastery,41,20,21
Revö,area-52,1129,hunter,beastmastery,30,12,18
Juicedhunter,tichondrius,1128,hunter,beastmastery,24,12,12
Hukkx,kalecgos,1127,hunter,beastmastery,18,12,6
Baconzola,dalaran,1127,hunter,beastmastery,18,12,6
Camperbill,borean-tundra,1127,hunter,beastmastery,25,14,11
Huñté,stormrage,1127,hunter,beastmastery,24,12,12
Kälec,quelthalas,1127,hunter,beastmastery,66,32,34
Artilleria,quelthalas,1127,hunter,beastmastery,83,36,47
Neverhunter,azralon,1127,hunter,beastmastery,30,13,17
Lieolaste,area-52,1126,hunter,beastmastery,35,17,18
Drexzo,tichondrius,1125,hunter,beastmastery,24,12,12
Traps,deathwing,1123,hunter,beastmastery,30,12,18
Toontot,sargeras,1123,hunter,beastmastery,42,16,26
Qpoc,tichondrius,1120,hunter,beastmastery,44,20,24
Bagofsnit,frostmourne,1119,hunter,beastmastery,36,12,24
Skpro,tichondrius,1118,hunter,beastmastery,42,13,29
Soulr,tichondrius,1117,hunter,beastmastery,28,14,14
Rhonishot,tichondrius,1115,hunter,beastmastery,61,24,37
Eyeofkiller,azralon,1113,hunter,beastmastery,30,17,13
Brokenstars,illidan,1108,hunter,beastmastery,146,70,76
Ukamau,ragnaros,1105,hunter,beastmastery,30,17,13
Berelai,area-52,1102,hunter,beastmastery,30,12,18
Topshunter,sargeras,1100,hunter,beastmastery,93,49,44
Falsifier,ragnaros,1100,hunter,beastmastery,27,12,15
Skillvanas,stormrage,1099,hunter,beastmastery,30,13,17
Nakyash,ragnaros,1097,hunter,beastmastery,24,13,11
Massivattack,skullcrusher,1096,hunter,beastmastery,30,12,18
Myrfes,ragnaros,1096,hunter,beastmastery,68,27,41
Shmurda,duskwood,1095,hunter,beastmastery,100,40,60
Zhanzu,quelthalas,1094,hunter,beastmastery,30,12,18
Strelyatil,trollbane,1092,hunter,beastmastery,36,20,16
Nightfal,emerald-dream,1091,hunter,beastmastery,81,32,49
Valintine,the-scryers,1090,hunter,beastmastery,23,12,11
Funwell,dalaran,1090,hunter,beastmastery,29,14,15
Fhodhaz,nemesis,1087,hunter,beastmastery,23,12,11
Zalyssavara,aerie-peak,1085,hunter,beastmastery,27,12,15
Autismo,garithos,1077,hunter,beastmastery,48,13,35
Backa,jubeithos,1074,hunter,beastmastery,26,12,14
Buyaga,stormreaver,1073,hunter,beastmastery,72,37,35
Kinete,proudmoore,1072,hunter,beastmastery,25,13,12
Brendenhunt,area-52,1071,hunter,beastmastery,17,12,5
Jayken,gnomeregan,1067,hunter,beastmastery,28,12,16
Dadhatesme,stormrage,1066,hunter,beastmastery,27,12,15
Mouthymerc,zuljin,1063,hunter,beastmastery,35,12,23
Ijii,tichondrius,1059,hunter,beastmastery,26,12,14
Splosiv,stormrage,1056,hunter,beastmastery,18,11,7
Trapinc,sargeras,1056,hunter,beastmastery,18,11,7
Hog,darkspear,1056,hunter,beastmastery,18,11,7
Prêd,malganis,1056,hunter,beastmastery,27,12,15
Sniffler,barthilas,1056,hunter,beastmastery,30,11,19
Unicom,malganis,1056,hunter,beastmastery,30,11,19
Latrampoza,quelthalas,1055,hunter,beastmastery,18,11,7
Ryutiz,fizzcrank,1055,hunter,beastmastery,18,11,7
Undeadroach,tichondrius,1055,hunter,beastmastery,24,11,13
Tashio,aerie-peak,1055,hunter,beastmastery,24,11,13
Emmihunt,tichondrius,1055,hunter,beastmastery,24,11,13
Zertkal,undermine,1055,hunter,beastmastery,24,11,13
Ispamtraps,emerald-dream,1054,hunter,beastmastery,18,11,7
Puns,stormreaver,1054,hunter,beastmastery,18,11,7
Buzzkilla,mannoroth,1054,hunter,beastmastery,18,11,7
Vexxør,bleeding-hollow,1054,hunter,beastmastery,42,21,21
Houdan,frostmourne,1054,hunter,beastmastery,22,11,11
Kelgar,the-scryers,1054,hunter,beastmastery,30,14,16
Shøz,wyrmrest-accord,1053,hunter,beastmastery,18,11,7
Alligatorz,firetree,1053,hunter,beastmastery,18,11,7
Hitx,tichondrius,1052,hunter,beastmastery,18,11,7
Zephanno,sargeras,1052,hunter,beastmastery,24,11,13
Sagadegêmeos,stormrage,1052,hunter,beastmastery,30,11,19
Sylpheous,bleeding-hollow,1052,hunter,beastmastery,36,11,25
Cummis,skullcrusher,1051,hunter,beastmastery,18,11,7
Ezari,zuljin,1051,hunter,beastmastery,27,12,15
Mav,dragonmaw,1051,hunter,beastmastery,26,11,15
Hohohohahah,gallywix,1051,hunter,beastmastery,30,11,19
Booffmeister,area-52,1050,hunter,beastmastery,24,11,13
Gølin,aerie-peak,1049,hunter,beastmastery,30,11,19
Memënto,barthilas,1049,hunter,beastmastery,30,11,19
Freeside,emerald-dream,1048,hunter,beastmastery,18,11,7
Thoraky,stormrage,1048,hunter,beastmastery,24,11,13
Eithelleta,frostmourne,1048,hunter,beastmastery,54,20,34
Mackabeagden,illidan,1048,hunter,beastmastery,30,11,19
ßaelon,malganis,1047,hunter,beastmastery,12,11,1
Flacidpasta,sargeras,1047,hunter,beastmastery,18,11,7
Kynagidas,korgath,1047,hunter,beastmastery,24,11,13
Grimhuntz,frostmourne,1047,hunter,beastmastery,24,11,13
Quigfoot,area-52,1047,hunter,beastmastery,87,36,51
Pewpew,gallywix,1047,hunter,beastmastery,47,19,28
Frenchhtoast,sargeras,1045,hunter,beastmastery,24,12,12
Nj,kiljaeden,1045,hunter,beastmastery,24,11,13
Cilnolm,moon-guard,1045,hunter,beastmastery,24,11,13
Riukyv,ragnaros,1045,hunter,beastmastery,30,11,19
Braii,blood-furnace,1042,hunter,beastmastery,42,18,24
Morenarösa,nemesis,1040,hunter,beastmastery,66,28,38
Cocstrong,darrowmere,1039,hunter,beastmastery,90,47,43
Zooker,tichondrius,1039,hunter,beastmastery,29,11,18
Frenzygirl,azralon,1036,hunter,beastmastery,18,11,7
Harÿn,nemesis,1036,hunter,beastmastery,24,11,13
Cuddle,arathor,1036,hunter,beastmastery,29,12,17
Euamomilfs,azralon,1035,hunter,beastmastery,24,12,12
More,khadgar,1035,hunter,beastmastery,30,11,19
Vicluvv,stormrage,1034,hunter,beastmastery,23,11,12
Abundalacaca,sargeras,1032,hunter,beastmastery,30,11,19
Skarioth,azralon,1029,hunter,beastmastery,24,11,13
Huntercry,ragnaros,1026,hunter,beastmastery,18,11,7
Jagër,dalaran,1024,hunter,beastmastery,21,13,8
Wrekkthal,illidan,1023,hunter,beastmastery,41,16,25
Blankshot,doomhammer,1021,hunter,beastmastery,131,63,68
Elisen,frostmourne,1021,hunter,beastmastery,42,13,29
Bolbathefett,shadowsong,1020,hunter,beastmastery,30,11,19
Taedulos,azralon,1019,hunter,beastmastery,36,19,17
Hetaya,haomarush,1019,hunter,beastmastery,137,60,77
Wildfirefly,whisperwind,1014,hunter,beastmastery,94,41,53
Dakirell,drakkari,1014,hunter,beastmastery,30,12,18
Caytano,quelthalas,1010,hunter,beastmastery,30,17,13
Dragonman,grizzly-hills,1009,hunter,beastmastery,72,26,46
Fwun,nerzhul,1008,hunter,beastmastery,18,12,6
Robingear,baelgun,1008,hunter,beastmastery,241,118,123
Killerronald,ragnaros,1008,hunter,beastmastery,42,15,27
Fiury,hyjal,1006,hunter,beastmastery,35,19,16
Namikawa,stormrage,1005,hunter,beastmastery,24,11,13
Rairin,tichondrius,1004,hunter,beastmastery,65,33,32
Snapyaf,area-52,1002,hunter,beastmastery,28,12,16
Antihero,norgannon,1001,hunter,beastmastery,20,12,8
Eddyholiday,tichondrius,1001,hunter,beastmastery,26,13,13
Leandrox,quelthalas,1001,hunter,beastmastery,23,11,12
Catharsis,quelthalas,1001,hunter,beastmastery,24,11,13
Shikago,wyrmrest-accord,1001,hunter,beastmastery,37,12,25
Oldmatador,azralon,1000,hunter,beastmastery,71,32,39
Thuperduper,tichondrius,999,hunter,beastmastery,18,12,6
Falesta,sargeras,999,hunter,beastmastery,28,12,16
Oldmanmacd,tichondrius,998,hunter,beastmastery,37,16,21
Raikuu,skullcrusher,995,hunter,beastmastery,90,47,43
Flexxbow,thrall,994,hunter,beastmastery,23,13,10
Arrowae,sargeras,994,hunter,beastmastery,122,58,64
Robobrain,area-52,993,hunter,beastmastery,23,11,12
Lunachyara,quelthalas,991,hunter,beastmastery,26,11,15
Trassic,emerald-dream,990,hunter,beastmastery,23,11,12
Speirs,tichondrius,983,hunter,beastmastery,71,32,39
Ruthgarth,akama,983,hunter,beastmastery,30,13,17
Puhpsy,azralon,981,hunter,beastmastery,72,37,35
Barabulk,wyrmrest-accord,981,hunter,beastmastery,24,12,12
Johnwïck,moon-guard,980,hunter,beastmastery,42,12,30
Faldran,earthen-ring,977,hunter,beastmastery,112,46,66
Dd,frostmourne,973,hunter,beastmastery,19,11,8
Gammaraven,dalaran,968,hunter,beastmastery,19,11,8
Erik,nemesis,968,hunter,beastmastery,182,86,96
Ahhpash,tichondrius,960,hunter,beastmastery,16,11,5
Pumplum,kiljaeden,960,hunter,beastmastery,18,10,8
Zarnick,frostwolf,960,hunter,beastmastery,18,10,8
Worsthunt,tichondrius,960,hunter,beastmastery,18,10,8
Sniperfx,lightbringer,960,hunter,beastmastery,18,10,8
Oidhunter,barthilas,960,hunter,beastmastery,18,10,8
Spekgäwd,emerald-dream,960,hunter,beastmastery,18,10,8
Wovow,tichondrius,960,hunter,beastmastery,18,10,8
Xbee,shattered-halls,960,hunter,beastmastery,18,10,8
Gööber,hyjal,960,hunter,beastmastery,18,10,8
Csantana,sargeras,960,hunter,beastmastery,18,10,8
Dualp,tichondrius,960,hunter,beastmastery,18,10,8
Shelbyy,tichondrius,960,hunter,beastmastery,58,28,30
Fishxxo,frostmourne,960,hunter,beastmastery,24,10,14
Focús,laughing-skull,960,hunter,beastmastery,24,10,14
Justforfunxx,tichondrius,960,hunter,beastmastery,30,10,20
Kalhistra,stormrage,959,hunter,beastmastery,18,10,8
Tmnarcanttv,tichondrius,959,hunter,beastmastery,18,10,8
Arrowsgobrr,norgannon,959,hunter,beastmastery,18,10,8
Bigkolache,zuljin,959,hunter,beastmastery,18,10,8
Evolushun,kiljaeden,959,hunter,beastmastery,21,11,10
Orgpopeyes,illidan,959,hunter,beastmastery,24,10,14
Huntfaceguy,agamaggan,959,hunter,beastmastery,24,10,14
Vigon,stormrage,959,hunter,beastmastery,24,10,14
Yangthekhunt,tichondrius,959,hunter,beastmastery,24,10,14
Leyliann,quelthalas,959,hunter,beastmastery,27,11,16
Kimbaa,tichondrius,959,hunter,beastmastery,30,10,20
Yolloswag,tichondrius,959,hunter,beastmastery,36,10,26
Motegi,illidan,959,hunter,beastmastery,36,10,26
Quickfyre,stormrage,958,hunter,beastmastery,18,10,8
Aquabat,wildhammer,958,hunter,beastmastery,18,10,8
Bunsglazing,illidan,958,hunter,beastmastery,18,10,8
Khattab,tichondrius,958,hunter,beastmastery,24,10,14
Tazer,area-52,958,hunter,beastmastery,24,10,14
Marexx,tichondrius,958,hunter,beastmastery,24,10,14
Chunco,ragnaros,958,hunter,beastmastery,24,10,14
Pafäcïle,tichondrius,958,hunter,beastmastery,24,10,14
Shrapnelx,ragnaros,958,hunter,beastmastery,30,10,20
Behavior,nemesis,957,hunter,beastmastery,18,10,8
Xua,frostmourne,957,hunter,beastmastery,18,10,8
Wabí,tichondrius,957,hunter,beastmastery,18,10,8
Imthaböss,nazjatar,957,hunter,beastmastery,23,10,13
Sumom,darrowmere,957,hunter,beastmastery,44,18,26
Littledougie,boulderfist,957,hunter,beastmastery,30,10,20
Kaiholeo,tichondrius,957,hunter,beastmastery,30,10,20
Acturius,jubeithos,956,hunter,beastmastery,33,11,22
Chimpx,moon-guard,955,hunter,beastmastery,24,10,14
Bowjobe,tichondrius,955,hunter,beastmastery,24,10,14
Trim,tichondrius,954,hunter,beastmastery,18,10,8
Murdaugh,icecrown,954,hunter,beastmastery,18,10,8
Coppersnout,wyrmrest-accord,954,hunter,beastmastery,24,10,14
Rezkiin,tichondrius,953,hunter,beastmastery,18,10,8
Phife,emerald-dream,953,hunter,beastmastery,24,10,14
Jendell,area-52,952,hunter,beastmastery,18,10,8
Huntertimes,ragnaros,951,hunter,beastmastery,12,10,2
Steelaeon,moon-guard,951,hunter,beastmastery,24,10,14
Malcab,tichondrius,950,hunter,beastmastery,18,10,8
Atheranni,azralon,950,hunter,beastmastery,24,10,14
Easypoacher,tichondrius,948,hunter,beastmastery,18,10,8
Flacidhunter,kelthuzad,948,hunter,beastmastery,24,10,14
ßaeløn,malganis,947,hunter,beastmastery,15,11,4
Bittitan,frostmourne,947,hunter,beastmastery,18,10,8
Leaii,thrall,944,hunter,beastmastery,43,24,19
Oddangel,azuremyst,944,hunter,beastmastery,24,10,14
Rotokrim,emerald-dream,942,hunter,beastmastery,196,95,101
Nioloari,tichondrius,939,hunter,beastmastery,25,11,14
Noitrag,azralon,937,hunter,beastmastery,17,10,7
Arthex,exodar,934,hunter,beastmastery,48,22,26
Malthiz,antonidas,934,hunter,beastmastery,38,17,21
Linszsz,nemesis,930,hunter,beastmastery,29,12,17
Salurian,destromath,930,hunter,beastmastery,40,15,25
Shootyurshot,stormrage,927,hunter,beastmastery,20,11,9
Triggamikê,tichondrius,926,hunter,beastmastery,14,11,3
Mauiies,sargeras,926,hunter,beastmastery,23,10,13
Ashantii,hakkar,919,hunter,beastmastery,24,10,14
Kenhay,wyrmrest-accord,916,hunter,beastmastery,24,10,14
Maveraxx,executus,916,hunter,beastmastery,42,15,27
Çhexmix,kiljaeden,910,hunter,beastmastery,15,10,5
Rachetbutt,tichondrius,910,hunter,beastmastery,17,10,7
Actehón,ragnaros,909,hunter,beastmastery,36,18,18
Hercules,draktharon,908,hunter,beastmastery,29,10,19
Beolwolf,darkspear,907,hunter,beastmastery,17,10,7
Coyner,tichondrius,907,hunter,beastmastery,21,10,11
Wael,perenolde,905,hunter,beastmastery,17,10,7
Glizzys,cairne,904,hunter,beastmastery,29,12,17
Cernos,malganis,902,hunter,beastmastery,23,10,13
Gnomisaurus,scarlet-crusade,900,hunter,beastmastery,32,11,21
Vastiks,dalaran,891,hunter,beastmastery,38,12,26
Ketulirantle,azralon,891,hunter,beastmastery,52,13,39
Rachael,veknilash,890,hunter,beastmastery,20,10,10
Boww,sargeras,890,hunter,beastmastery,20,10,10
Ovî,area-52,889,hunter,beastmastery,17,10,7
Foh,kelthuzad,888,hunter,beastmastery,17,10,7
Killmachine,sargeras,886,hunter,beastmastery,22,10,12
Erovianoria,silver-hand,885,hunter,beastmastery,69,32,37
Hunbatz,dalaran,866,hunter,beastmastery,49,23,26
Lilperc,zuljin,864,hunter,beastmastery,12,9,3
Citygirl,emerald-dream,864,hunter,beastmastery,12,9,3
Naestrá,bleeding-hollow,864,hunter,beastmastery,12,9,3
Lubze,bleeding-hollow,864,hunter,beastmastery,12,9,3
Petattack,barthilas,864,hunter,beastmastery,12,9,3
Bmhuntlol,illidan,864,hunter,beastmastery,12,9,3
Bmobepip,malganis,864,hunter,beastmastery,12,9,3
Elaisse,uther,864,hunter,beastmastery,12,9,3
Huntations,sargeras,864,hunter,beastmastery,12,9,3
Slipox,sargeras,864,hunter,beastmastery,12,9,3
Reilerhunt,stormrage,864,hunter,beastmastery,12,9,3
Phetch,bleeding-hollow,864,hunter,beastmastery,12,9,3
Fereni,emerald-dream,864,hunter,beastmastery,16,10,6
Lilsynchfyb,sargeras,864,hunter,beastmastery,18,9,9
Zinelun,quelthalas,864,hunter,beastmastery,18,9,9
Hagadinn,frostmourne,864,hunter,beastmastery,18,9,9
Alenkras,stormrage,864,hunter,beastmastery,18,9,9
Actioh,stormrage,864,hunter,beastmastery,18,9,9
Zizilio,kelthuzad,864,hunter,beastmastery,18,9,9
Deutêr,quelthalas,864,hunter,beastmastery,18,9,9
Yatyegatchun,illidan,864,hunter,beastmastery,18,9,9
Airlol,tichondrius,864,hunter,beastmastery,18,9,9
Xbloody,tichondrius,864,hunter,beastmastery,18,9,9
Elenin,tichondrius,864,hunter,beastmastery,18,9,9
Déwi,tichondrius,864,hunter,beastmastery,18,9,9
Scurvypete,perenolde,864,hunter,beastmastery,24,9,15
Dirtyytroll,area-52,864,hunter,beastmastery,24,9,15
Kaitoo,tichondrius,864,hunter,beastmastery,24,9,15
Balrröt,malganis,864,hunter,beastmastery,24,9,15
Arteene,illidan,864,hunter,beastmastery,24,9,15
Katiepie,frostmourne,864,hunter,beastmastery,30,9,21
Saynice,warsong,863,hunter,beastmastery,12,9,3
Noisetrader,illidan,863,hunter,beastmastery,12,9,3
Reic,kiljaeden,863,hunter,beastmastery,15,10,5
Twoshotzz,darkspear,863,hunter,beastmastery,15,10,5
Beabalm,dalaran,863,hunter,beastmastery,18,9,9
Drezzial,illidan,863,hunter,beastmastery,18,9,9
Wellerman,firetree,863,hunter,beastmastery,18,9,9
Jockitch,wildhammer,863,hunter,beastmastery,18,9,9
Tethro,zuljin,863,hunter,beastmastery,18,9,9
Snowjin,stormrage,863,hunter,beastmastery,18,9,9
Aredbull,jubeithos,863,hunter,beastmastery,18,9,9
Xernen,thrall,863,hunter,beastmastery,18,9,9
Oztroza,grizzly-hills,863,hunter,beastmastery,18,9,9
Nikronos,quelthalas,863,hunter,beastmastery,18,9,9
Luçkyan,tichondrius,863,hunter,beastmastery,18,9,9
Viral,grizzly-hills,863,hunter,beastmastery,18,9,9
Ellzuk,tichondrius,863,hunter,beastmastery,18,9,9
Drivebyjuju,dentarg,863,hunter,beastmastery,18,9,9
Jamzlol,frostmourne,863,hunter,beastmastery,18,9,9
Petizoql,ragnaros,863,hunter,beastmastery,18,9,9
Burguir,ragnaros,863,hunter,beastmastery,18,9,9
Dbrickashaw,proudmoore,863,hunter,beastmastery,18,9,9
Berkhof,tichondrius,863,hunter,beastmastery,18,9,9
Nubberton,sargeras,863,hunter,beastmastery,24,9,15
Tarah,lightbringer,863,hunter,beastmastery,24,9,15
Junglepaw,moon-guard,863,hunter,beastmastery,24,9,15
Bleedwish,tichondrius,863,hunter,beastmastery,31,9,22
Zansnipes,dalaran,862,hunter,beastmastery,12,9,3
Seáhawk,kiljaeden,862,hunter,beastmastery,12,9,3
Loriandel,proudmoore,862,hunter,beastmastery,14,9,5
Kyoü,drakkari,862,hunter,beastmastery,18,9,9
Qúin,frostmourne,862,hunter,beastmastery,18,9,9
Bloodstark,dreadmaul,862,hunter,beastmastery,18,9,9
Toross,stormscale,862,hunter,beastmastery,18,9,9
Eatmybow,nemesis,862,hunter,beastmastery,22,10,12
Hawkeye,boulderfist,862,hunter,beastmastery,24,9,15
Thunderbúll,tichondrius,862,hunter,beastmastery,24,9,15
Korasaurus,tichondrius,861,hunter,beastmastery,12,9,3
Arrowbadoors,azralon,861,hunter,beastmastery,18,9,9
Hrodvitnir,quelthalas,861,hunter,beastmastery,24,9,15
Trápngap,barthilas,861,hunter,beastmastery,24,9,15
Alikay,ragnaros,861,hunter,beastmastery,24,9,15
Ogbrooks,tichondrius,861,hunter,beastmastery,24,9,15
Zpax,area-52,860,hunter,beastmastery,19,11,8
Vladik,stormrage,860,hunter,beastmastery,24,9,15
Shdwhntrclub,wyrmrest-accord,860,hunter,beastmastery,24,9,15
Byrdh,zuljin,860,hunter,beastmastery,27,10,17
Recoyl,proudmoore,859,hunter,beastmastery,18,9,9
Goinghuntin,frostmourne,859,hunter,beastmastery,18,9,9
Purpmang,bleeding-hollow,859,hunter,beastmastery,30,9,21
Rayman,thunderhorn,858,hunter,beastmastery,12,9,3
Xeriife,stormrage,858,hunter,beastmastery,19,9,10
Chuphunts,tichondrius,857,hunter,beastmastery,12,9,3
Ventura,emerald-dream,857,hunter,beastmastery,18,9,9
Nikå,ragnaros,857,hunter,beastmastery,24,9,15
Kalekros,tichondrius,856,hunter,beastmastery,30,9,21
Galerius,illidan,855,hunter,beastmastery,36,9,27
Shiztec,malganis,854,hunter,beastmastery,24,9,15
Lanadari,trollbane,853,hunter,beastmastery,12,9,3
Bluehead,emerald-dream,852,hunter,beastmastery,38,18,20
ßloodmain,tichondrius,852,hunter,beastmastery,24,9,15
Hunterdps,gurubashi,851,hunter,beastmastery,18,9,9
Rinasonline,sargeras,851,hunter,beastmastery,24,9,15
Survivor,dentarg,851,hunter,beastmastery,24,9,15
Doombug,lethon,846,hunter,beastmastery,18,9,9
Eggsquatch,emerald-dream,844,hunter,beastmastery,12,9,3
Vannaria,destromath,844,hunter,beastmastery,12,9,3
Dikkins,windrunner,844,hunter,beastmastery,17,9,8
Skullgrain,eitrigg,844,hunter,beastmastery,23,9,14
Alby,daggerspine,843,hunter,beastmastery,23,9,14
Anya,proudmoore,839,hunter,beastmastery,47,20,27
Zoëx,amanthul,836,hunter,beastmastery,36,9,27
Larthas,greymane,835,hunter,beastmastery,18,9,9
Seenobody,stormrage,834,hunter,beastmastery,41,9,32
Noahxkhalel,azralon,832,hunter,beastmastery,29,9,20
Hikkupz,tichondrius,831,hunter,beastmastery,23,9,14
Flamenco,arthas,830,hunter,beastmastery,17,9,8
Moash,spinebreaker,830,hunter,beastmastery,17,9,8
Spunky,zuluhed,830,hunter,beastmastery,17,9,8
Acotas,blades-edge,828,hunter,beastmastery,36,16,20
Coletrickle,chogall,822,hunter,beastmastery,32,10,22
Vyalaris,emerald-dream,813,hunter,beastmastery,21,9,12
Árescarries,shuhalo,809,hunter,beastmastery,27,9,18
Gilonate,tichondrius,805,hunter,beastmastery,48,10,38
Bagurgur,tichondrius,799,hunter,beastmastery,16,9,7
Jonyvi,stormrage,798,hunter,beastmastery,19,10,9
Malgar,zuljin,778,hunter,beastmastery,28,9,19
Feralhuntard,muradin,774,hunter,beastmastery,30,9,21
Flub,shadow-council,768,hunter,beastmastery,12,8,4
Zute,sargeras,768,hunter,beastmastery,12,8,4
Valtierd,illidan,768,hunter,beastmastery,12,8,4
Kolotak,kelthuzad,768,hunter,beastmastery,12,8,4
Newcomb,sargeras,768,hunter,beastmastery,12,8,4
Jsrhuntz,sargeras,768,hunter,beastmastery,12,8,4
Disper,hyjal,768,hunter,beastmastery,12,8,4
Chippendales,illidan,768,hunter,beastmastery,12,8,4
Huntsey,frostmourne,768,hunter,beastmastery,12,8,4
Bluez,tichondrius,768,hunter,beastmastery,12,8,4
Follard,stormrage,768,hunter,beastmastery,12,8,4
Priapismxh,stormrage,768,hunter,beastmastery,12,8,4
Bowbaggins,stormrage,768,hunter,beastmastery,12,8,4
Deinaito,bleeding-hollow,768,hunter,beastmastery,12,8,4
Ogstrutt,zuljin,768,hunter,beastmastery,12,8,4
Torghast,demon-soul,768,hunter,beastmastery,12,8,4
Paraxh,tichondrius,768,hunter,beastmastery,12,8,4
Meshunt,tichondrius,768,hunter,beastmastery,12,8,4
Seeq,illidan,768,hunter,beastmastery,18,8,10
Heädshöt,malorne,768,hunter,beastmastery,18,8,10
Seongnam,tichondrius,768,hunter,beastmastery,18,8,10
Oblio,silvermoon,768,hunter,beastmastery,18,8,10
Oblitus,zuljin,768,hunter,beastmastery,18,8,10
Golgy,thrall,768,hunter,beastmastery,18,8,10
Mastasnipa,illidan,768,hunter,beastmastery,18,8,10
Homilbab,tichondrius,768,hunter,beastmastery,18,8,10
Yonzo,area-52,768,hunter,beastmastery,18,8,10
Rethum,tichondrius,768,hunter,beastmastery,18,8,10
Séptimo,illidan,768,hunter,beastmastery,18,8,10
Wolfzburg,moon-guard,768,hunter,beastmastery,18,8,10
Gotrap,saurfang,768,hunter,beastmastery,18,8,10
Tigglyjits,tichondrius,768,hunter,beastmastery,18,8,10
Teammatescba,tichondrius,768,hunter,beastmastery,18,8,10
Katherìnelol,tichondrius,768,hunter,beastmastery,21,9,12
Aamoody,bloodhoof,768,hunter,beastmastery,24,8,16
Peregrin,burning-legion,768,hunter,beastmastery,24,8,16
Kolosaltraps,tichondrius,768,hunter,beastmastery,24,8,16
Hackerman,tichondrius,767,hunter,beastmastery,12,8,4
Probo,aegwynn,767,hunter,beastmastery,12,8,4
Keldrek,wyrmrest-accord,767,hunter,beastmastery,12,8,4
Torva,firetree,767,hunter,beastmastery,12,8,4
Remièl,frostmourne,767,hunter,beastmastery,12,8,4
Cxnt,saurfang,767,hunter,beastmastery,15,9,6
Bowjingles,blackrock,767,hunter,beastmastery,18,8,10
Quepop,demon-soul,767,hunter,beastmastery,18,8,10
Picapaul,stormrage,767,hunter,beastmastery,18,8,10
Raphgun,stormrage,767,hunter,beastmastery,18,8,10
Trapgodtina,bleeding-hollow,767,hunter,beastmastery,18,8,10
Covfefeqt,illidan,767,hunter,beastmastery,18,8,10
Thehunturd,dalaran,767,hunter,beastmastery,18,8,10
Hygogg,area-52,767,hunter,beastmastery,18,8,10
Flîp,daggerspine,767,hunter,beastmastery,18,8,10
Vindication,ysera,767,hunter,beastmastery,18,8,10
Iamreek,sargeras,767,hunter,beastmastery,18,8,10
Gerathorn,sargeras,767,hunter,beastmastery,18,8,10
Lûrtz,aegwynn,767,hunter,beastmastery,21,8,13
Snipingmilfs,zuluhed,766,hunter,beastmastery,12,8,4
Ropz,eonar,766,hunter,beastmastery,20,9,11
Satours,quelthalas,766,hunter,beastmastery,18,8,10
Hideontrap,malganis,766,hunter,beastmastery,18,8,10
Thirtyeight,blades-edge,766,hunter,beastmastery,18,8,10
Föcker,emerald-dream,766,hunter,beastmastery,18,8,10
Ghostone,sargeras,766,hunter,beastmastery,18,8,10
Tirocertobr,azralon,766,hunter,beastmastery,18,8,10
Katsumito,sargeras,766,hunter,beastmastery,18,8,10
Thugio,sargeras,766,hunter,beastmastery,24,8,16
Ivix,sargeras,765,hunter,beastmastery,12,8,4
Calbone,stormrage,765,hunter,beastmastery,12,8,4
Queldana,drakkari,765,hunter,beastmastery,18,8,10
Brenoob,azralon,765,hunter,beastmastery,18,8,10
Cae,hellscream,765,hunter,beastmastery,24,8,16
Hunt,akama,765,hunter,beastmastery,24,8,16
Franzosisch,stormrage,764,hunter,beastmastery,12,8,4
Speshylponi,smolderthorn,763,hunter,beastmastery,18,8,10
Grøøves,dalaran,763,hunter,beastmastery,18,8,10
Dodirty,laughing-skull,763,hunter,beastmastery,24,8,16
Jayker,illidan,762,hunter,beastmastery,12,8,4
Shamtus,bladefist,762,hunter,beastmastery,12,8,4
Liightnight,illidan,762,hunter,beastmastery,12,8,4
Tookoid,sargeras,762,hunter,beastmastery,12,8,4
Halberick,quelthalas,762,hunter,beastmastery,12,8,4
Kluetus,sargeras,762,hunter,beastmastery,18,8,10
Stillkrow,sargeras,762,hunter,beastmastery,18,8,10
Riverjumper,ghostlands,761,hunter,beastmastery,12,8,4
Riccolonamek,veknilash,761,hunter,beastmastery,12,8,4
Galadrieel,magtheridon,761,hunter,beastmastery,28,9,19
Derringer,the-scryers,760,hunter,beastmastery,18,8,10
Bakharnabi,azralon,760,hunter,beastmastery,18,8,10
Wolftracer,sargeras,759,hunter,beastmastery,12,8,4
Fiddich,shattered-hand,759,hunter,beastmastery,18,8,10
Ophiela,shuhalo,759,hunter,beastmastery,36,8,28
Eeremm,drakkari,758,hunter,beastmastery,12,8,4
Barberreggie,barthilas,757,hunter,beastmastery,36,8,28
Drpenatrator,barthilas,755,hunter,beastmastery,18,8,10
Bblsallday,illidan,754,hunter,beastmastery,12,8,4
Nyer,nemesis,754,hunter,beastmastery,24,8,16
Androki,stormrage,752,hunter,beastmastery,12,8,4
Krispyflayz,sargeras,751,hunter,beastmastery,17,8,9
Thor,barthilas,751,hunter,beastmastery,18,8,10
Raevenah,dalaran,747,hunter,beastmastery,12,8,4
Luxyminx,moon-guard,747,hunter,beastmastery,23,8,15
Relaxnerd,antonidas,735,hunter,beastmastery,17,8,9
Cabel,ragnaros,735,hunter,beastmastery,23,8,15
Tekkys,barthilas,734,hunter,beastmastery,17,8,9
Hawkkeye,thunderlord,734,hunter,beastmastery,23,8,15
Vendortrash,aggramar,733,hunter,beastmastery,17,8,9
Wkg,azgalor,728,hunter,beastmastery,41,19,22
Kathelvia,area-52,727,hunter,beastmastery,26,9,17
Eksd,sargeras,719,hunter,beastmastery,11,8,3
Timberex,drenden,715,hunter,beastmastery,15,8,7
Kysii,burning-blade,714,hunter,beastmastery,21,8,13
Cloxygen,moon-guard,713,hunter,beastmastery,22,9,13
Oromme,ragnaros,710,hunter,beastmastery,26,9,17
Popster,cenarius,704,hunter,beastmastery,22,8,14
Petpenguin,kelthuzad,703,hunter,beastmastery,11,8,3
Yozomoto,nordrassil,703,hunter,beastmastery,14,8,6
Oppshot,kul-tiras,703,hunter,beastmastery,19,8,11
Jinchuriki,shadow-council,703,hunter,beastmastery,28,8,20
Qua,perenolde,702,hunter,beastmastery,17,8,9
Tozier,destromath,700,hunter,beastmastery,22,8,14
Mexishots,tichondrius,688,hunter,beastmastery,13,8,5
Hunatar,stormrage,672,hunter,beastmastery,12,7,5
Ojsimp,illidan,672,hunter,beastmastery,12,7,5
Mylaqt,malganis,672,hunter,beastmastery,12,7,5
Jxbupx,tichondrius,672,hunter,beastmastery,12,7,5
Mehontar,area-52,672,hunter,beastmastery,12,7,5
Suliaodai,tichondrius,672,hunter,beastmastery,12,7,5
Kuzar,thrall,672,hunter,beastmastery,12,7,5
Calsu,kiljaeden,672,hunter,beastmastery,12,7,5
Akirarika,wyrmrest-accord,672,hunter,beastmastery,12,7,5
Downor,malganis,672,hunter,beastmastery,12,7,5
Tusxx,tichondrius,672,hunter,beastmastery,12,7,5
Pmø,sargeras,672,hunter,beastmastery,12,7,5
Hollowhunt,sentinels,672,hunter,beastmastery,12,7,5
Dadedehuyeah,illidan,672,hunter,beastmastery,12,7,5
Cumman,sargeras,672,hunter,beastmastery,12,7,5
Gun,shadowsong,672,hunter,beastmastery,12,7,5
Cinnybunz,malganis,672,hunter,beastmastery,12,7,5
Kaikunoshiri,tichondrius,672,hunter,beastmastery,12,7,5
Yolotraps,thrall,672,hunter,beastmastery,12,7,5
Ajukeo,tichondrius,672,hunter,beastmastery,12,7,5
Xerosa,emerald-dream,672,hunter,beastmastery,12,7,5
Küky,ragnaros,672,hunter,beastmastery,12,7,5
Sakedji,area-52,672,hunter,beastmastery,12,7,5
Crimsoncoast,tichondrius,672,hunter,beastmastery,12,7,5
Barainto,tichondrius,672,hunter,beastmastery,12,7,5
Alfentanil,thrall,672,hunter,beastmastery,12,7,5
Handmemygun,aggramar,672,hunter,beastmastery,12,7,5
Jsr,tichondrius,672,hunter,beastmastery,12,7,5
Litchi,illidan,672,hunter,beastmastery,12,7,5
Wrâge,senjin,672,hunter,beastmastery,12,7,5
Buffhunt,tichondrius,672,hunter,beastmastery,12,7,5
Handla,zuljin,672,hunter,beastmastery,12,7,5
Varya,barthilas,672,hunter,beastmastery,12,7,5
Gentledream,dalaran,672,hunter,beastmastery,12,7,5
Drwíggles,smolderthorn,672,hunter,beastmastery,12,7,5
Rexzoolza,tichondrius,672,hunter,beastmastery,12,7,5
Interer,proudmoore,672,hunter,beastmastery,12,7,5
Shaytime,proudmoore,672,hunter,beastmastery,16,8,8
Szeh,tichondrius,672,hunter,beastmastery,14,7,7
Greenmamba,thrall,672,hunter,beastmastery,18,7,11
Moralidawn,illidan,672,hunter,beastmastery,18,7,11
Hoodster,illidan,672,hunter,beastmastery,18,7,11
Antares,dalaran,672,hunter,beastmastery,18,7,11
Dreagneal,ragnaros,672,hunter,beastmastery,18,7,11
Nashi,burning-blade,672,hunter,beastmastery,18,7,11
Msghunter,sargeras,672,hunter,beastmastery,18,7,11
Deuzebuk,azralon,672,hunter,beastmastery,18,7,11
Ðevil,ragnaros,672,hunter,beastmastery,18,7,11
Aethernovae,area-52,672,hunter,beastmastery,18,7,11
Sensitivthug,sargeras,672,hunter,beastmastery,18,7,11
Berrydanish,tichondrius,672,hunter,beastmastery,18,7,11
Mostmanly,tichondrius,672,hunter,beastmastery,18,7,11
Hyperíon,draenor,672,hunter,beastmastery,18,7,11
Chernovax,altar-of-storms,672,hunter,beastmastery,18,7,11
Joerogan,hydraxis,672,hunter,beastmastery,18,7,11
Velaknahtou,illidan,672,hunter,beastmastery,18,7,11
Sèasons,tichondrius,672,hunter,beastmastery,21,7,14
Desoh,kelthuzad,672,hunter,beastmastery,24,7,17
Titanaxis,tichondrius,672,hunter,beastmastery,24,7,17
Trycaza,ragnaros,672,hunter,beastmastery,24,7,17
Sunsinfour,proudmoore,672,hunter,beastmastery,24,7,17
Kango,azgalor,672,hunter,beastmastery,30,7,23
Melinda,kilrogg,671,hunter,beastmastery,12,7,5
Gytaepung,tichondrius,671,hunter,beastmastery,12,7,5
Spunkked,tichondrius,671,hunter,beastmastery,12,7,5
Ziêg,eonar,671,hunter,beastmastery,12,7,5
Terezhunt,tichondrius,671,hunter,beastmastery,12,7,5
Scrubmastery,emerald-dream,671,hunter,beastmastery,12,7,5
Vanquisher,trollbane,671,hunter,beastmastery,12,7,5
Winzip,whisperwind,671,hunter,beastmastery,12,7,5
Kupupor,area-52,671,hunter,beastmastery,12,7,5
Lavo,borean-tundra,671,hunter,beastmastery,12,7,5
Exploits,stormrage,671,hunter,beastmastery,12,7,5
Anniefuchsia,stormrage,671,hunter,beastmastery,12,7,5
Tremobbin,kelthuzad,671,hunter,beastmastery,12,7,5
Thanthion,spirestone,671,hunter,beastmastery,12,7,5
Redzic,tichondrius,671,hunter,beastmastery,12,7,5
Mannypew,kelthuzad,671,hunter,beastmastery,12,7,5
Ragerab,trollbane,671,hunter,beastmastery,12,7,5
Beardedeagle,tichondrius,671,hunter,beastmastery,15,8,7
Dontkillpet,shandris,671,hunter,beastmastery,18,7,11
Mooséhunt,wyrmrest-accord,671,hunter,beastmastery,18,7,11
Threethirty,thrall,671,hunter,beastmastery,18,7,11
Jagare,tichondrius,671,hunter,beastmastery,18,7,11
Loranoh,illidan,671,hunter,beastmastery,18,7,11
Amortiz,illidan,671,hunter,beastmastery,18,7,11
Heylenny,area-52,671,hunter,beastmastery,18,7,11
Genowin,sargeras,671,hunter,beastmastery,18,7,11
Ratfood,tichondrius,671,hunter,beastmastery,23,7,16
Slêv,frostmourne,670,hunter,beastmastery,12,7,5
Enigmer,area-52,670,hunter,beastmastery,12,7,5
Topgun,laughing-skull,670,hunter,beastmastery,12,7,5
Trikshot,magtheridon,670,hunter,beastmastery,12,7,5
Madness,zuljin,670,hunter,beastmastery,12,7,5
Yanzz,spinebreaker,670,hunter,beastmastery,12,7,5
Fawn,moon-guard,670,hunter,beastmastery,18,7,11
Spaeth,borean-tundra,670,hunter,beastmastery,24,7,17
Vicarnam,uldum,669,hunter,beastmastery,12,7,5
Neurosurgery,azralon,669,hunter,beastmastery,18,7,11
Tigerswood,sargeras,669,hunter,beastmastery,18,7,11
Fynnigan,shandris,669,hunter,beastmastery,18,7,11
Oneshotman,hydraxis,668,hunter,beastmastery,12,7,5
Bosslord,wyrmrest-accord,667,hunter,beastmastery,12,7,5
Terusa,ragnaros,667,hunter,beastmastery,24,7,17
Arielma,illidan,667,hunter,beastmastery,30,7,23
Strafenshoot,darkspear,666,hunter,beastmastery,12,7,5
Olelf,chogall,666,hunter,beastmastery,12,7,5
Badboyzcry,deathwing,666,hunter,beastmastery,12,7,5
Beatnyou,tichondrius,664,hunter,beastmastery,18,7,11
Rikitiki,bleeding-hollow,663,hunter,beastmastery,18,7,11
Eastera,tichondrius,663,hunter,beastmastery,27,8,19
Isagypsy,ragnaros,662,hunter,beastmastery,18,7,11
Cbramatacera,drakkari,661,hunter,beastmastery,12,7,5
Theprovider,burning-blade,659,hunter,beastmastery,12,7,5
Benryats,area-52,657,hunter,beastmastery,21,8,13
Legendhunter,quelthalas,655,hunter,beastmastery,12,8,4
Lyduc,barthilas,655,hunter,beastmastery,17,7,10
Wuzi,echo-isles,653,hunter,beastmastery,18,7,11
Pureguava,gorefiend,652,hunter,beastmastery,24,7,17
Jashak,windrunner,625,hunter,beastmastery,22,10,12
Sclum,tichondrius,623,hunter,beastmastery,11,7,4
Xhítt,sargeras,623,hunter,beastmastery,17,7,10
Ashx,nemesis,623,hunter,beastmastery,17,7,10
Lelreisw,goldrinn,622,hunter,beastmastery,21,7,14
Ôhunter,sentinels,618,hunter,beastmastery,17,8,9
Àléç,mannoroth,610,hunter,beastmastery,18,8,10
Fintlok,saurfang,608,hunter,beastmastery,16,7,9
Tribë,emerald-dream,607,hunter,beastmastery,11,7,4
Chopt,runetotem,607,hunter,beastmastery,11,7,4
Booticheekz,tichondrius,607,hunter,beastmastery,11,7,4
Supdawg,aggramar,607,hunter,beastmastery,17,7,10
Shootdogg,mannoroth,607,hunter,beastmastery,20,7,13
Missionfiggs,malganis,607,hunter,beastmastery,20,7,13
Lulafourdedo,stormrage,606,hunter,beastmastery,9,7,2
Drisilla,stormrage,606,hunter,beastmastery,11,7,4
Shanghunt,cenarius,604,hunter,beastmastery,14,7,7
Oshosiwar,ragnaros,588,hunter,beastmastery,21,7,14
Gassmask,area-52,576,hunter,beastmastery,6,6,0
Igotapvpness,tichondrius,576,hunter,beastmastery,6,6,0
Píps,maelstrom,576,hunter,beastmastery,6,6,0
Jjaro,area-52,576,hunter,beastmastery,6,6,0
Rekkis,area-52,576,hunter,beastmastery,6,6,0
Mavmavmavmav,illidan,576,hunter,beastmastery,6,6,0
Markieemark,tichondrius,576,hunter,beastmastery,12,6,6
Meluremster,tichondrius,576,hunter,beastmastery,12,6,6
Kånade,ragnaros,576,hunter,beastmastery,12,6,6
Zookeepah,tichondrius,576,hunter,beastmastery,12,6,6
Nytefell,skullcrusher,576,hunter,beastmastery,12,6,6
Boybawang,area-52,576,hunter,beastmastery,12,6,6
Gilv,frostmourne,576,hunter,beastmastery,12,6,6
Ziraiel,tichondrius,576,hunter,beastmastery,12,6,6
Cubixer,zuljin,576,hunter,beastmastery,12,6,6
Clawdio,ragnaros,576,hunter,beastmastery,12,6,6
Toniic,moon-guard,576,hunter,beastmastery,12,6,6
Yoske,tichondrius,576,hunter,beastmastery,12,6,6
Sumpunter,barthilas,576,hunter,beastmastery,12,6,6
Wapnonymous,mugthol,576,hunter,beastmastery,12,6,6
Aduurant,quelthalas,576,hunter,beastmastery,12,6,6
Mcfibers,malganis,576,hunter,beastmastery,12,6,6
Deidada,ragnaros,576,hunter,beastmastery,12,6,6
Alochol,vashj,576,hunter,beastmastery,12,6,6
Chriscal,zuljin,576,hunter,beastmastery,12,6,6
Itch,moon-guard,576,hunter,beastmastery,12,6,6
Khanittus,area-52,576,hunter,beastmastery,12,6,6
Wopper,moon-guard,576,hunter,beastmastery,12,6,6
Santiiadonai,quelthalas,576,hunter,beastmastery,12,6,6
Orqism,tichondrius,576,hunter,beastmastery,12,6,6
Thugbus,frostmourne,576,hunter,beastmastery,12,6,6
Skyfel,aggramar,576,hunter,beastmastery,12,6,6
Spookytrap,tichondrius,576,hunter,beastmastery,12,6,6
Taurask,tichondrius,576,hunter,beastmastery,12,6,6
Spottedoger,burning-legion,576,hunter,beastmastery,12,6,6
Zeedii,dalaran,576,hunter,beastmastery,12,6,6
Balboa,tortheldrin,576,hunter,beastmastery,12,6,6
Zigum,dalaran,576,hunter,beastmastery,12,6,6
Noblesaïnt,tichondrius,576,hunter,beastmastery,12,6,6
Raerdun,bonechewer,576,hunter,beastmastery,12,6,6
Fma,stormrage,576,hunter,beastmastery,12,6,6
Jonah,sargeras,576,hunter,beastmastery,12,6,6
Hunterpk,lightbringer,576,hunter,beastmastery,12,6,6
Jwzz,tichondrius,576,hunter,beastmastery,12,6,6
Raadun,terokkar,576,hunter,beastmastery,12,6,6
Wongy,tichondrius,576,hunter,beastmastery,12,6,6
Rockoutt,emerald-dream,576,hunter,beastmastery,12,6,6
Daylilycoast,emerald-dream,576,hunter,beastmastery,12,6,6
Himmihyme,illidan,576,hunter,beastmastery,12,6,6
Invisabootz,hyjal,576,hunter,beastmastery,12,6,6
Drdill,gorefiend,576,hunter,beastmastery,12,6,6
Retaâáàäãart,tichondrius,576,hunter,beastmastery,12,6,6
Leadblaster,gorefiend,576,hunter,beastmastery,12,6,6
Arrebol,tichondrius,576,hunter,beastmastery,12,6,6
Evilblammo,thorium-brotherhood,576,hunter,beastmastery,12,6,6
Hurato,stormrage,576,hunter,beastmastery,12,6,6
Nampa,stormrage,576,hunter,beastmastery,12,6,6
Harmfulwang,emerald-dream,576,hunter,beastmastery,12,6,6
Drivebytko,illidan,576,hunter,beastmastery,12,6,6
Supernamh,sargeras,576,hunter,beastmastery,12,6,6
Peacemaker,dunemaul,576,hunter,beastmastery,12,6,6
Ahncheolsoo,tichondrius,576,hunter,beastmastery,12,6,6
Schvitz,darkspear,576,hunter,beastmastery,12,6,6
Darksniper,proudmoore,576,hunter,beastmastery,12,6,6
Teaa,dalaran,576,hunter,beastmastery,12,6,6
Makag,illidan,576,hunter,beastmastery,12,6,6
Rhovanni,ragnaros,576,hunter,beastmastery,15,7,8
Percival,firetree,576,hunter,beastmastery,15,7,8
Pieman,azuremyst,576,hunter,beastmastery,18,6,12
Mørødox,sargeras,576,hunter,beastmastery,18,6,12
Kanta,bleeding-hollow,576,hunter,beastmastery,18,6,12
Kurmojo,hyjal,576,hunter,beastmastery,18,6,12
Ljai,gilneas,576,hunter,beastmastery,18,6,12
Larrydog,fizzcrank,576,hunter,beastmastery,18,6,12
Møoo,ragnaros,576,hunter,beastmastery,18,6,12
Thorssman,illidan,576,hunter,beastmastery,18,6,12
Virgim,kelthuzad,576,hunter,beastmastery,18,6,12
Rostter,azralon,576,hunter,beastmastery,18,6,12
Arraza,ragnaros,576,hunter,beastmastery,22,7,15
Ærês,ysondre,576,hunter,beastmastery,20,6,14
Beastbaal,sargeras,576,hunter,beastmastery,24,6,18
Asuryakha,darkspear,575,hunter,beastmastery,12,6,6
Rankhor,darkspear,575,hunter,beastmastery,12,6,6
Gwarnar,stormrage,575,hunter,beastmastery,12,6,6
Fulca,area-52,575,hunter,beastmastery,12,6,6
Yobby,area-52,575,hunter,beastmastery,12,6,6
Mindbreaker,illidan,575,hunter,beastmastery,12,6,6
Hollee,turalyon,575,hunter,beastmastery,12,6,6
Tibineids,stormrage,575,hunter,beastmastery,12,6,6
Míbu,lightbringer,575,hunter,beastmastery,12,6,6
Britannian,moon-guard,575,hunter,beastmastery,12,6,6
Ontop,draka,575,hunter,beastmastery,12,6,6
Fireshots,tichondrius,575,hunter,beastmastery,12,6,6
Wdb,tichondrius,575,hunter,beastmastery,12,6,6
Aoife,zuljin,575,hunter,beastmastery,12,6,6
Forsaken,bleeding-hollow,575,hunter,beastmastery,12,6,6
Vipermaster,azralon,575,hunter,beastmastery,12,6,6
Chinoiti,bleeding-hollow,575,hunter,beastmastery,12,6,6
Longshott,azralon,575,hunter,beastmastery,12,6,6
Horsegirl,chogall,575,hunter,beastmastery,12,6,6
Eastwake,stormrage,575,hunter,beastmastery,12,6,6
Orangegummy,frostmourne,575,hunter,beastmastery,15,7,8
Camorcaist,stormrage,575,hunter,beastmastery,18,6,12
Aliciaomg,andorhal,575,hunter,beastmastery,18,6,12
Logandawgfan,thunderlord,575,hunter,beastmastery,18,6,12
Boradin,lightbringer,575,hunter,beastmastery,18,6,12
Mingsomnia,kiljaeden,575,hunter,beastmastery,24,6,18
Nekrongar,agamaggan,574,hunter,beastmastery,12,6,6
Arcticuz,aegwynn,574,hunter,beastmastery,18,6,12
Kalibah,azralon,574,hunter,beastmastery,18,6,12
Sapphie,frostmourne,574,hunter,beastmastery,24,6,18
Kresnik,azralon,574,hunter,beastmastery,24,6,18
Roseandra,stormrage,574,hunter,beastmastery,24,6,18
Flooring,illidan,573,hunter,beastmastery,12,6,6
Dethh,dunemaul,572,hunter,beastmastery,12,6,6
Pewpewd,tichondrius,572,hunter,beastmastery,12,6,6
Cousinlarry,kaelthas,571,hunter,beastmastery,12,6,6
Høød,aggramar,571,hunter,beastmastery,12,6,6
Katmang,frostmourne,571,hunter,beastmastery,18,6,12
Lanamatt,azralon,569,hunter,beastmastery,12,6,6
Kargathx,ragnaros,569,hunter,beastmastery,20,8,12
Mondlicht,tichondrius,559,hunter,beastmastery,17,6,11
Parâsite,kelthuzad,559,hunter,beastmastery,23,6,17
Gerpshot,darrowmere,557,hunter,beastmastery,18,7,11
Ullria,frostmourne,544,hunter,beastmastery,16,6,10
Onearmsteve,tichondrius,543,hunter,beastmastery,11,6,5
Habanero,anetheron,543,hunter,beastmastery,14,7,7
Boopuh,illidan,543,hunter,beastmastery,14,7,7
Tezlekhan,haomarush,543,hunter,beastmastery,17,6,11
Viserysll,azralon,542,hunter,beastmastery,11,6,5
Trycen,bleeding-hollow,527,hunter,beastmastery,11,6,5
Memorypet,proudmoore,527,hunter,beastmastery,15,6,9
Pikepounder,tichondrius,527,hunter,beastmastery,15,6,9
Yatolo,barthilas,526,hunter,beastmastery,15,6,9
Porkrager,doomhammer,522,hunter,beastmastery,14,7,7
Iililillilii,tichondrius,522,hunter,beastmastery,20,7,13
Mïsërý,tichondrius,522,hunter,beastmastery,21,7,14
Beastcraft,emerald-dream,521,hunter,beastmastery,21,7,14
Bugsßunny,sargeras,521,hunter,beastmastery,22,7,15
Ataxyus,area-52,512,hunter,beastmastery,10,6,4
Bowjobs,stormscale,511,hunter,beastmastery,14,6,8
Aluminumfoil,kelthuzad,510,hunter,beastmastery,11,6,5
Genjiutsu,zuljin,495,hunter,beastmastery,11,8,3
Zock,lothar,494,hunter,beastmastery,19,6,13
Glacierr,emerald-dream,480,hunter,beastmastery,6,5,1
Cojáx,dalaran,480,hunter,beastmastery,6,5,1
Yajr,black-dragonflight,480,hunter,beastmastery,6,5,1
Brokensnipez,area-52,480,hunter,beastmastery,6,5,1
Moistbooger,emerald-dream,480,hunter,beastmastery,6,5,1
Kkoduckk,tichondrius,480,hunter,beastmastery,6,5,1
Luys,illidan,480,hunter,beastmastery,6,5,1
Tukki,quelthalas,480,hunter,beastmastery,6,5,1
Cyrads,darkspear,480,hunter,beastmastery,6,5,1
Pwn,korgath,480,hunter,beastmastery,6,5,1
Oeoeoeoeoeoe,alterac-mountains,480,hunter,beastmastery,6,5,1
Chimeralol,area-52,480,hunter,beastmastery,6,5,1
Vynloresh,thrall,480,hunter,beastmastery,6,5,1
Acidhunt,tichondrius,480,hunter,beastmastery,6,5,1
Traptrinket,sargeras,480,hunter,beastmastery,6,5,1
Linkolnn,sargeras,480,hunter,beastmastery,6,5,1
Nokda,tichondrius,480,hunter,beastmastery,6,5,1
Sinon,stormrage,480,hunter,beastmastery,6,5,1
Arthäsxd,azralon,480,hunter,beastmastery,6,5,1
Jjackchicken,tichondrius,480,hunter,beastmastery,6,5,1
Nsjp,darkspear,480,hunter,beastmastery,6,5,1
Jareeth,bleeding-hollow,480,hunter,beastmastery,6,5,1
Plsnobanmee,frostmourne,480,hunter,beastmastery,6,5,1
Tèrrabite,sargeras,480,hunter,beastmastery,6,5,1
Arleesta,thrall,480,hunter,beastmastery,6,5,1
Dankshunt,arthas,480,hunter,beastmastery,6,5,1
Phoktard,dark-iron,480,hunter,beastmastery,6,5,1
Silentbeast,bleeding-hollow,480,hunter,beastmastery,6,5,1
Megahuntard,bleeding-hollow,480,hunter,beastmastery,6,5,1
Devilborne,tichondrius,480,hunter,beastmastery,6,5,1
Victorcrumb,tichondrius,480,hunter,beastmastery,6,5,1
Añtø,tichondrius,480,hunter,beastmastery,6,5,1
Goodwillhunt,tichondrius,480,hunter,beastmastery,6,5,1
Airoh,gorefiend,480,hunter,beastmastery,10,6,4
Fallacies,moon-guard,480,hunter,beastmastery,12,5,7
Taphh,moon-guard,480,hunter,beastmastery,12,5,7
Spicycheezit,malganis,480,hunter,beastmastery,12,5,7
Wønky,stormrage,480,hunter,beastmastery,12,5,7
Hitcompleted,moon-guard,480,hunter,beastmastery,12,5,7
Tureckk,illidan,480,hunter,beastmastery,12,5,7
Tneex,zuljin,480,hunter,beastmastery,12,5,7
Silveraero,ghostlands,480,hunter,beastmastery,12,5,7
Alssong,tichondrius,480,hunter,beastmastery,12,5,7
Twoshotz,stormrage,480,hunter,beastmastery,12,5,7
Ghostdâwg,stormrage,480,hunter,beastmastery,12,5,7
Xavííer,tichondrius,480,hunter,beastmastery,12,5,7
Åî,tichondrius,480,hunter,beastmastery,12,5,7
Atlacatl,tichondrius,480,hunter,beastmastery,12,5,7
Yørch,stormrage,480,hunter,beastmastery,12,5,7
Ferex,tichondrius,480,hunter,beastmastery,12,5,7
Cowahunt,illidan,480,hunter,beastmastery,12,5,7
Hendlie,frostmourne,480,hunter,beastmastery,12,5,7
Àthenaa,malygos,480,hunter,beastmastery,12,5,7
Drakku,zuljin,480,hunter,beastmastery,12,5,7
Kaloh,daggerspine,480,hunter,beastmastery,12,5,7
Affections,darkspear,480,hunter,beastmastery,12,5,7
Hellbow,ragnaros,480,hunter,beastmastery,12,5,7
Powdersoak,area-52,480,hunter,beastmastery,12,5,7
Skitso,illidan,480,hunter,beastmastery,12,5,7
Yosra,frostmourne,480,hunter,beastmastery,12,5,7
Zernagul,proudmoore,480,hunter,beastmastery,12,5,7
Stayinsight,area-52,480,hunter,beastmastery,12,5,7
Feladorn,silver-hand,480,hunter,beastmastery,12,5,7
ßoo,darkspear,480,hunter,beastmastery,12,5,7
Pannds,proudmoore,480,hunter,beastmastery,12,5,7
Squiik,wildhammer,480,hunter,beastmastery,12,5,7
Grizmin,sargeras,480,hunter,beastmastery,12,5,7
Tarkovs,area-52,480,hunter,beastmastery,12,5,7
Abloodelf,zuljin,480,hunter,beastmastery,12,5,7
Powerstrokes,sargeras,480,hunter,beastmastery,12,5,7
Chenghiskhan,tichondrius,480,hunter,beastmastery,12,5,7
Taskete,ragnaros,480,hunter,beastmastery,12,5,7
Valeous,azjolnerub,480,hunter,beastmastery,12,5,7
Pichsolika,frostmourne,480,hunter,beastmastery,12,5,7
Nerfmytraps,frostmourne,480,hunter,beastmastery,12,5,7
Ariais,zangarmarsh,480,hunter,beastmastery,12,5,7
Bowzza,area-52,480,hunter,beastmastery,12,5,7
Chipsncheese,korgath,480,hunter,beastmastery,12,5,7
Çhïlly,frostmourne,480,hunter,beastmastery,12,5,7
Michaeljfox,area-52,480,hunter,beastmastery,12,5,7
Tetzuo,illidan,480,hunter,beastmastery,12,5,7
Gorillafart,spirestone,480,hunter,beastmastery,12,5,7
Imperatrix,emerald-dream,480,hunter,beastmastery,12,5,7
Satàn,thrall,480,hunter,beastmastery,12,5,7
Tonysting,sargeras,480,hunter,beastmastery,12,5,7
Sunflwerdawn,emerald-dream,480,hunter,beastmastery,12,5,7
Kansolly,tichondrius,480,hunter,beastmastery,12,5,7
Skillhunter,tichondrius,480,hunter,beastmastery,12,5,7
Atirofofo,azralon,480,hunter,beastmastery,12,5,7
Mcbacon,illidan,480,hunter,beastmastery,12,5,7
Exabyssus,bleeding-hollow,480,hunter,beastmastery,12,5,7
Deklin,malganis,480,hunter,beastmastery,12,5,7
Banai,the-underbog,480,hunter,beastmastery,12,5,7
Smexyhunter,moon-guard,480,hunter,beastmastery,12,5,7
Mylfhunter,azralon,480,hunter,beastmastery,12,5,7
Chutput,dalaran,480,hunter,beastmastery,15,6,9
Llachiip,zuljin,480,hunter,beastmastery,16,6,10
Bøl,ragnaros,480,hunter,beastmastery,16,5,11
Blockbusters,sargeras,480,hunter,beastmastery,18,5,13
Amoreiene,stormrage,480,hunter,beastmastery,18,5,13
Murk,spirestone,480,hunter,beastmastery,18,5,13
Cophunter,tichondrius,480,hunter,beastmastery,18,5,13
Panzerfäust,zuljin,480,hunter,beastmastery,18,5,13
Chetxs,bleeding-hollow,480,hunter,beastmastery,18,5,13
Semiautmatic,thrall,480,hunter,beastmastery,18,5,13
Snoogen,illidan,480,hunter,beastmastery,18,5,13
Sizzimus,area-52,479,hunter,beastmastery,6,5,1
Segulah,dalaran,479,hunter,beastmastery,6,5,1
Mafghine,malganis,479,hunter,beastmastery,6,5,1
Livershot,zuljin,479,hunter,beastmastery,12,5,7
Capyou,lightninghoof,479,hunter,beastmastery,12,5,7
Pickshot,boulderfist,479,hunter,beastmastery,12,5,7
Ashevan,stormrage,479,hunter,beastmastery,12,5,7
Apolex,velen,479,hunter,beastmastery,12,5,7
Mecatrón,quelthalas,479,hunter,beastmastery,12,5,7
Chosan,sargeras,479,hunter,beastmastery,12,5,7
Shoya,nerzhul,479,hunter,beastmastery,12,5,7
Equipmunk,arthas,479,hunter,beastmastery,12,5,7
Dwarfpecker,hydraxis,479,hunter,beastmastery,12,5,7
Holyhunnter,proudmoore,479,hunter,beastmastery,12,5,7
Kairoke,azralon,479,hunter,beastmastery,12,5,7
Deadlyattack,barthilas,479,hunter,beastmastery,12,5,7
Celdiirn,dragonmaw,479,hunter,beastmastery,12,5,7
Simoro,malganis,479,hunter,beastmastery,14,5,9
Trushôtz,tichondrius,479,hunter,beastmastery,17,5,12
Boomup,tichondrius,479,hunter,beastmastery,21,6,15
Starkmeister,stormrage,479,hunter,beastmastery,18,5,13
Morngrimm,area-52,479,hunter,beastmastery,18,5,13
Auset,aegwynn,479,hunter,beastmastery,18,5,13
Smider,magtheridon,479,hunter,beastmastery,18,5,13
Zarrockk,emerald-dream,478,hunter,beastmastery,12,5,7
Waagg,ragnaros,478,hunter,beastmastery,12,5,7
Bernice,darrowmere,478,hunter,beastmastery,12,5,7
Wishon,proudmoore,478,hunter,beastmastery,16,6,10
Titchi,azralon,478,hunter,beastmastery,18,5,13
Fiznits,nerzhul,478,hunter,beastmastery,18,5,13
Slowbear,kiljaeden,477,hunter,beastmastery,12,5,7
Haltheron,azshara,477,hunter,beastmastery,12,5,7
Baelien,tichondrius,476,hunter,beastmastery,10,6,4
Braindeadly,malganis,476,hunter,beastmastery,12,5,7
Syphiel,moon-guard,476,hunter,beastmastery,12,5,7
Ogma,mugthol,475,hunter,beastmastery,12,5,7
Mehtcurious,ragnaros,470,hunter,beastmastery,18,5,13
Ledrip,sargeras,463,hunter,beastmastery,11,5,6
Redrum,turalyon,448,hunter,beastmastery,10,5,5
Degenape,bleeding-hollow,447,hunter,beastmastery,11,5,6
Verzatyle,frostwolf,447,hunter,beastmastery,11,5,6
Travisshot,tichondrius,447,hunter,beastmastery,11,5,6
Revenantz,stormrage,447,hunter,beastmastery,11,5,6
Gunther,korgath,447,hunter,beastmastery,11,5,6
Vuur,korialstrasz,447,hunter,beastmastery,19,6,13
Rástakhan,ragnaros,431,hunter,beastmastery,11,5,6
Ryanshootsu,tichondrius,431,hunter,beastmastery,11,5,6
Hum,tichondrius,426,hunter,beastmastery,15,7,8
Hazzlôk,cairne,426,hunter,beastmastery,20,7,13
Soljer,kiljaeden,426,hunter,beastmastery,23,6,17
Ripmytoast,chogall,424,hunter,beastmastery,16,7,9
Verse,aggramar,415,hunter,beastmastery,12,6,6
Kaiso,chogall,415,hunter,beastmastery,14,5,9
Resonators,tichondrius,400,hunter,beastmastery,13,5,8
Chichi,korgath,384,hunter,beastmastery,6,4,2
Mälädÿ,nemesis,384,hunter,beastmastery,6,4,2
Stallwart,bronzebeard,384,hunter,beastmastery,6,4,2
Zzackchicken,tichondrius,384,hunter,beastmastery,6,4,2
Krazykilla,spirestone,384,hunter,beastmastery,6,4,2
Chokemescara,stormrage,384,hunter,beastmastery,6,4,2
Fizzpow,blackrock,384,hunter,beastmastery,6,4,2
Jerso,zuljin,384,hunter,beastmastery,6,4,2
Hunterquim,stormrage,384,hunter,beastmastery,6,4,2
Skankhuntx,kelthuzad,384,hunter,beastmastery,6,4,2
Zubo,tichondrius,384,hunter,beastmastery,6,4,2
Coçador,stormrage,384,hunter,beastmastery,6,4,2
Infatuatedx,moon-guard,384,hunter,beastmastery,6,4,2
Bodangel,galakrond,384,hunter,beastmastery,6,4,2
Moktarg,archimonde,384,hunter,beastmastery,6,4,2
Markymarc,tichondrius,384,hunter,beastmastery,6,4,2
Silvershot,emerald-dream,384,hunter,beastmastery,6,4,2
Hyyz,proudmoore,384,hunter,beastmastery,6,4,2
Eazyaimz,thrall,384,hunter,beastmastery,6,4,2
Thickgirl,kiljaeden,384,hunter,beastmastery,6,4,2
Bowfox,area-52,384,hunter,beastmastery,6,4,2
Statîcx,thrall,384,hunter,beastmastery,6,4,2
Chikkynuggy,destromath,384,hunter,beastmastery,6,4,2
Kong,tichondrius,384,hunter,beastmastery,6,4,2
Drãgenox,quelthalas,384,hunter,beastmastery,6,4,2
Deddita,zuljin,384,hunter,beastmastery,6,4,2
Damatic,area-52,384,hunter,beastmastery,6,4,2
Skað,lightbringer,384,hunter,beastmastery,6,4,2
Sôuleater,moon-guard,384,hunter,beastmastery,6,4,2
Chaucyy,magtheridon,384,hunter,beastmastery,6,4,2
Dcousins,tichondrius,384,hunter,beastmastery,6,4,2
Ithanna,quelthalas,384,hunter,beastmastery,6,4,2
Anisphia,tichondrius,384,hunter,beastmastery,6,4,2
Natiry,nemesis,384,hunter,beastmastery,6,4,2
Jerusa,illidan,384,hunter,beastmastery,6,4,2
Naxhunter,stormrage,384,hunter,beastmastery,6,4,2
Dexh,frostmourne,384,hunter,beastmastery,6,4,2
Lowlore,moon-guard,384,hunter,beastmastery,6,4,2
Deshiie,proudmoore,384,hunter,beastmastery,6,4,2
Sindshai,onyxia,384,hunter,beastmastery,6,4,2
Drinktodrown,moon-guard,384,hunter,beastmastery,6,4,2
Scytsbow,illidan,384,hunter,beastmastery,6,4,2
Bufluu,bleeding-hollow,384,hunter,beastmastery,6,4,2
Redpvp,illidan,384,hunter,beastmastery,6,4,2
Shotgunpain,nazjatar,384,hunter,beastmastery,6,4,2
Cowboyhood,tanaris,384,hunter,beastmastery,6,4,2
Shiki,icecrown,384,hunter,beastmastery,6,4,2
Bênton,tichondrius,384,hunter,beastmastery,6,4,2
Tezcâtlipocâ,sargeras,384,hunter,beastmastery,6,4,2
Valeine,barthilas,384,hunter,beastmastery,6,4,2
Tìrra,stormrage,384,hunter,beastmastery,6,4,2
Skytah,darkspear,384,hunter,beastmastery,6,4,2
Jeonghun,tichondrius,384,hunter,beastmastery,9,5,4
Anteróz,tichondrius,384,hunter,beastmastery,9,4,5
Elywen,alexstrasza,384,hunter,beastmastery,12,4,8
Doves,wyrmrest-accord,384,hunter,beastmastery,12,4,8
Whaling,tichondrius,384,hunter,beastmastery,12,4,8
Calev,frostmourne,384,hunter,beastmastery,12,4,8
Twopawshunta,tichondrius,384,hunter,beastmastery,12,4,8
Saharä,illidan,384,hunter,beastmastery,12,4,8
Gandury,tichondrius,384,hunter,beastmastery,12,4,8
Grimshot,boulderfist,384,hunter,beastmastery,12,4,8
Dopeykingdom,illidan,384,hunter,beastmastery,12,4,8
Coggter,uther,384,hunter,beastmastery,12,4,8
Czeroenjoyer,malganis,384,hunter,beastmastery,12,4,8
Deahtgab,ragnaros,384,hunter,beastmastery,12,4,8
Mídnîght,azralon,384,hunter,beastmastery,12,4,8
Øutpläyed,quelthalas,384,hunter,beastmastery,12,4,8
Moùrningwood,stormrage,384,hunter,beastmastery,12,4,8
Vandescar,illidan,384,hunter,beastmastery,12,4,8
Dubbledee,malganis,384,hunter,beastmastery,12,4,8
Largetender,illidan,384,hunter,beastmastery,12,4,8
Kok,andorhal,384,hunter,beastmastery,12,4,8
Gaydin,zuljin,384,hunter,beastmastery,12,4,8
Softhunter,tichondrius,384,hunter,beastmastery,12,4,8
Bówjòb,nordrassil,384,hunter,beastmastery,12,4,8
Pirateninja,illidan,384,hunter,beastmastery,12,4,8
Zothus,azralon,384,hunter,beastmastery,12,4,8
Noxura,illidan,384,hunter,beastmastery,12,4,8
Zeront,garona,384,hunter,beastmastery,12,4,8
Vencc,tichondrius,384,hunter,beastmastery,12,4,8
Zøro,malganis,384,hunter,beastmastery,12,4,8
Zylen,tichondrius,384,hunter,beastmastery,12,4,8
Bvø,stormrage,384,hunter,beastmastery,12,4,8
Quintonius,stormrage,384,hunter,beastmastery,12,4,8
Skycaptaín,lightbringer,384,hunter,beastmastery,12,4,8
Bowsauce,khadgar,384,hunter,beastmastery,12,4,8
Arcuz,quelthalas,384,hunter,beastmastery,12,4,8
Cluhaywood,zuljin,384,hunter,beastmastery,12,4,8
Withoutraps,quelthalas,384,hunter,beastmastery,12,4,8
Rhyzen,drenden,384,hunter,beastmastery,12,4,8
Calvarîam,korgath,384,hunter,beastmastery,12,4,8
Ælij,tichondrius,384,hunter,beastmastery,12,4,8
Accessdraven,tichondrius,384,hunter,beastmastery,12,4,8
Kharvaash,onyxia,384,hunter,beastmastery,12,4,8
Rektage,jubeithos,384,hunter,beastmastery,12,4,8
Wannakill,stormrage,384,hunter,beastmastery,12,4,8
Shaevie,lothar,384,hunter,beastmastery,12,4,8
Killatrap,malganis,384,hunter,beastmastery,12,4,8
Knarlin,uldum,384,hunter,beastmastery,12,4,8
Coolbeanz,boulderfist,384,hunter,beastmastery,12,4,8
Lookoutt,tichondrius,384,hunter,beastmastery,12,4,8
Inetpub,stormrage,384,hunter,beastmastery,12,4,8
Alkynabm,kelthuzad,384,hunter,beastmastery,12,4,8
Deatharrow,azuremyst,384,hunter,beastmastery,12,4,8
Sydina,malganis,384,hunter,beastmastery,12,4,8
Miansi,tichondrius,384,hunter,beastmastery,12,4,8
Bangerzx,stormrage,384,hunter,beastmastery,12,4,8
Fáelin,proudmoore,384,hunter,beastmastery,12,4,8
Cndavyjones,akama,384,hunter,beastmastery,12,4,8
Dampteeth,sargeras,384,hunter,beastmastery,12,4,8
Dangerclam,barthilas,384,hunter,beastmastery,12,4,8
Devastavi,proudmoore,384,hunter,beastmastery,12,4,8
Grumaku,area-52,384,hunter,beastmastery,12,4,8
Graatata,shandris,384,hunter,beastmastery,12,4,8
Throwadox,malganis,384,hunter,beastmastery,12,4,8
Päinal,area-52,384,hunter,beastmastery,12,4,8
Seanpaì,tichondrius,384,hunter,beastmastery,12,4,8
Valrosan,stormrage,384,hunter,beastmastery,12,4,8
Shatterwax,area-52,384,hunter,beastmastery,12,4,8
Fydehunt,stormrage,384,hunter,beastmastery,14,4,10
Atheos,gallywix,384,hunter,beastmastery,18,4,14
Gugubird,proudmoore,384,hunter,beastmastery,18,4,14
Petkink,stormrage,384,hunter,beastmastery,18,4,14
Löö,arthas,384,hunter,beastmastery,23,4,19
Ganaja,laughing-skull,383,hunter,beastmastery,6,4,2
Bboo,bonechewer,383,hunter,beastmastery,6,4,2
Gichiwalrus,emerald-dream,383,hunter,beastmastery,6,4,2
Volga,haomarush,383,hunter,beastmastery,6,4,2
Paulayork,drakthul,383,hunter,beastmastery,12,4,8
Tarakii,moon-guard,383,hunter,beastmastery,12,4,8
Böwjøb,illidan,383,hunter,beastmastery,12,4,8
Gals,saurfang,383,hunter,beastmastery,12,4,8
Purna,moon-guard,383,hunter,beastmastery,12,4,8
Patcherson,kargath,383,hunter,beastmastery,12,4,8
Mortia,thunderlord,383,hunter,beastmastery,12,4,8
Defacecilth,dalaran,383,hunter,beastmastery,12,4,8
Lamper,emerald-dream,383,hunter,beastmastery,12,4,8
Lazygnome,azshara,383,hunter,beastmastery,12,4,8
Foakus,zuljin,383,hunter,beastmastery,13,4,9
Etb,bleeding-hollow,382,hunter,beastmastery,12,4,8
Ire,kelthuzad,367,hunter,beastmastery,11,4,7
Ssobit,tichondrius,367,hunter,beastmastery,11,4,7
Sylaris,arathor,366,hunter,beastmastery,11,4,7
Clinkz,chogall,351,hunter,beastmastery,11,4,7
Kemper,dragonmaw,351,hunter,beastmastery,11,4,7
Vínçent,blood-furnace,351,hunter,beastmastery,17,4,13
Hunturr,thrall,350,hunter,beastmastery,11,4,7
Elftigy,dentarg,337,hunter,beastmastery,16,7,9
Swagprince,skullcrusher,335,hunter,beastmastery,11,4,7
Theblurd,kiljaeden,335,hunter,beastmastery,11,4,7
Sadarrow,frostmourne,334,hunter,beastmastery,11,4,7
Drakarÿs,drakkari,326,hunter,beastmastery,18,5,13
Khillin,destromath,319,hunter,beastmastery,8,4,4
Punkrockguy,illidan,319,hunter,beastmastery,14,4,10
Huntli,elune,304,hunter,beastmastery,7,4,3
Tuanorz,proudmoore,288,hunter,beastmastery,6,3,3
Shallwe,frostmourne,288,hunter,beastmastery,6,3,3
Hordworld,tichondrius,288,hunter,beastmastery,6,3,3
Perfectcrit,area-52,288,hunter,beastmastery,6,3,3
Archicur,darkspear,288,hunter,beastmastery,6,3,3
Shootin,frostmourne,288,hunter,beastmastery,6,3,3
Gudlukk,stormrage,288,hunter,beastmastery,6,3,3
Cablok,moon-guard,288,hunter,beastmastery,6,3,3
Shikay,frostmourne,288,hunter,beastmastery,6,3,3
Vinksy,sargeras,288,hunter,beastmastery,6,3,3
Verdao,stormrage,288,hunter,beastmastery,6,3,3
Gnurfgun,proudmoore,288,hunter,beastmastery,6,3,3
Saucypapi,kiljaeden,288,hunter,beastmastery,6,3,3
Braxigarr,area-52,288,hunter,beastmastery,6,3,3
Lyler,tichondrius,288,hunter,beastmastery,6,3,3
Çrimson,frostmourne,288,hunter,beastmastery,6,3,3
Norgalys,proudmoore,288,hunter,beastmastery,6,3,3
Arrowenn,zuljin,288,hunter,beastmastery,6,3,3
Venj,proudmoore,288,hunter,beastmastery,6,3,3
Hahahahahaha,frostmourne,288,hunter,beastmastery,6,3,3
Heãdhunter,area-52,288,hunter,beastmastery,6,3,3
Skulltøn,area-52,288,hunter,beastmastery,6,3,3
Rolandschitt,area-52,288,hunter,beastmastery,6,3,3
Wrectitralph,sargeras,288,hunter,beastmastery,6,3,3
Grimpossible,sargeras,288,hunter,beastmastery,6,3,3
Billcsbyswtr,sargeras,288,hunter,beastmastery,6,3,3
Toxicbowjobs,tichondrius,288,hunter,beastmastery,6,3,3
Adapted,proudmoore,288,hunter,beastmastery,6,3,3
Vikshen,illidan,288,hunter,beastmastery,6,3,3
Gupples,frostwolf,288,hunter,beastmastery,6,3,3
Nothìng,tichondrius,288,hunter,beastmastery,6,3,3
Raainha,stormrage,288,hunter,beastmastery,6,3,3
Coachs,tichondrius,288,hunter,beastmastery,6,3,3
Chadbowsman,tichondrius,288,hunter,beastmastery,6,3,3
Shoottokill,frostmourne,288,hunter,beastmastery,6,3,3
Skarsnick,draenor,288,hunter,beastmastery,6,3,3
Anatric,illidan,288,hunter,beastmastery,6,3,3
Ballistik,area-52,288,hunter,beastmastery,6,3,3
Díllý,area-52,288,hunter,beastmastery,6,3,3
Ogkataro,tichondrius,288,hunter,beastmastery,6,3,3
Mogradme,shadowsong,288,hunter,beastmastery,6,3,3
Añto,tichondrius,288,hunter,beastmastery,6,3,3
Guacmec,tichondrius,288,hunter,beastmastery,6,3,3
Mynds,stormrage,288,hunter,beastmastery,6,3,3
Longbeau,gnomeregan,288,hunter,beastmastery,6,3,3
Viavii,barthilas,288,hunter,beastmastery,6,3,3
Yunggrávy,sargeras,288,hunter,beastmastery,6,3,3
Grayføxx,twisting-nether,288,hunter,beastmastery,6,3,3
Emart,bloodhoof,288,hunter,beastmastery,6,3,3
Lelantos,stonemaul,288,hunter,beastmastery,6,3,3
Nopez,tichondrius,288,hunter,beastmastery,6,3,3
Iosaon,tichondrius,288,hunter,beastmastery,6,3,3
Legendshot,area-52,288,hunter,beastmastery,6,3,3
Naksha,area-52,288,hunter,beastmastery,6,3,3
Nyloc,dalvengyr,288,hunter,beastmastery,6,3,3
Ryko,firetree,288,hunter,beastmastery,6,3,3
Aldurion,wyrmrest-accord,288,hunter,beastmastery,6,3,3
Trixex,darkspear,288,hunter,beastmastery,6,3,3
Elroyjetson,arthas,288,hunter,beastmastery,6,3,3
Shallaiya,stormrage,288,hunter,beastmastery,6,3,3
Hannes,boulderfist,288,hunter,beastmastery,6,3,3
Onahai,tichondrius,288,hunter,beastmastery,6,3,3
Sibbleiv,boulderfist,288,hunter,beastmastery,6,3,3
Georgigeo,turalyon,288,hunter,beastmastery,6,3,3
Harosh,azralon,288,hunter,beastmastery,6,3,3
Makeastinky,malfurion,288,hunter,beastmastery,6,3,3
Refused,magtheridon,288,hunter,beastmastery,6,3,3
Doubletappz,stormreaver,288,hunter,beastmastery,6,3,3
Moroallytwo,sargeras,288,hunter,beastmastery,6,3,3
Cefla,illidan,288,hunter,beastmastery,6,3,3
Zeroday,emerald-dream,288,hunter,beastmastery,6,3,3
Bmsurvmm,tichondrius,288,hunter,beastmastery,6,3,3
Nastynadia,frostmourne,288,hunter,beastmastery,6,3,3
Goraku,dalaran,288,hunter,beastmastery,6,3,3
Fakerz,stormrage,288,hunter,beastmastery,6,3,3
Ow,shadow-council,288,hunter,beastmastery,6,3,3
Tulipbee,moon-guard,288,hunter,beastmastery,6,3,3
Trickshot,hakkar,288,hunter,beastmastery,6,3,3
Soberish,bleeding-hollow,288,hunter,beastmastery,6,3,3
Schumann,ursin,288,hunter,beastmastery,6,3,3
Siimmplicitz,area-52,288,hunter,beastmastery,6,3,3
Popshotz,khazgoroth,288,hunter,beastmastery,6,3,3
Hunterspirit,azralon,288,hunter,beastmastery,6,3,3
Blastinnagas,tichondrius,288,hunter,beastmastery,6,3,3
Redthedeer,warsong,288,hunter,beastmastery,6,3,3
Enonoa,thunderlord,288,hunter,beastmastery,6,3,3
Firskin,frostmourne,288,hunter,beastmastery,6,3,3
Wanshöt,tichondrius,288,hunter,beastmastery,6,3,3
Rexczar,shattered-hand,288,hunter,beastmastery,6,3,3
Barrohunt,tichondrius,288,hunter,beastmastery,6,3,3
Mulnaaj,zuljin,288,hunter,beastmastery,6,3,3
Hèro,barthilas,288,hunter,beastmastery,6,3,3
Illine,azralon,288,hunter,beastmastery,6,3,3
Nightstålkër,moon-guard,288,hunter,beastmastery,6,3,3
Comtambisuon,frostmourne,288,hunter,beastmastery,6,3,3
Trailed,dalaran,288,hunter,beastmastery,6,3,3
Scolhunter,scarlet-crusade,288,hunter,beastmastery,6,3,3
Slowtogo,moon-guard,288,hunter,beastmastery,6,3,3
Beastmodex,quelthalas,288,hunter,beastmastery,6,3,3
Wiittig,hyjal,288,hunter,beastmastery,6,3,3
Vivaswan,tichondrius,288,hunter,beastmastery,6,3,3
Kahoykeso,frostmourne,288,hunter,beastmastery,6,3,3
Crinkx,arthas,288,hunter,beastmastery,6,3,3
Moyria,quelthalas,288,hunter,beastmastery,6,3,3
Haamsuplo,tichondrius,288,hunter,beastmastery,6,3,3
Ocxhunter,nemesis,288,hunter,beastmastery,6,3,3
Arrazyne,jubeithos,288,hunter,beastmastery,6,3,3
Miraclez,nerzhul,288,hunter,beastmastery,6,3,3
Nandaax,nemesis,288,hunter,beastmastery,6,3,3
Nexxa,muradin,288,hunter,beastmastery,6,3,3
Herroo,thrall,288,hunter,beastmastery,6,3,3
Rakhesh,quelthalas,288,hunter,beastmastery,6,3,3
Ironova,illidan,288,hunter,beastmastery,6,3,3
Pewpewbang,muradin,288,hunter,beastmastery,6,3,3
Jungling,kelthuzad,288,hunter,beastmastery,6,3,3
Komayam,malganis,288,hunter,beastmastery,6,3,3
Archetype,bladefist,288,hunter,beastmastery,6,3,3
Prasanna,kelthuzad,288,hunter,beastmastery,6,3,3
Talksic,bladefist,288,hunter,beastmastery,6,3,3
Djpopshot,thrall,288,hunter,beastmastery,6,3,3
Dranel,nordrassil,288,hunter,beastmastery,6,3,3
Realzanderr,antonidas,288,hunter,beastmastery,6,3,3
Yoyoletsgo,malganis,288,hunter,beastmastery,6,3,3
Terrabytés,kelthuzad,288,hunter,beastmastery,6,3,3
Limpingspoon,kelthuzad,288,hunter,beastmastery,6,3,3
Pumpydumpy,malganis,288,hunter,beastmastery,6,3,3
Cloudbuck,aegwynn,288,hunter,beastmastery,7,3,4
Omenevil,stormrage,288,hunter,beastmastery,8,3,5
Reecerkoz,nagrand,288,hunter,beastmastery,12,3,9
Bithiáh,quelthalas,288,hunter,beastmastery,12,3,9
Rice,veknilash,288,hunter,beastmastery,12,3,9
Ruckq,stormrage,288,hunter,beastmastery,12,3,9
Inume,ragnaros,288,hunter,beastmastery,12,3,9
Natnat,sargeras,288,hunter,beastmastery,12,3,9
Fosberry,sargeras,288,hunter,beastmastery,12,3,9
Boyarsky,area-52,288,hunter,beastmastery,12,3,9
Cufless,proudmoore,288,hunter,beastmastery,12,3,9
Iboofprofen,illidan,288,hunter,beastmastery,12,3,9
Dragon,stormscale,288,hunter,beastmastery,12,3,9
Xhitara,stormrage,288,hunter,beastmastery,12,3,9
Wargodthor,blades-edge,288,hunter,beastmastery,12,3,9
Grlzzlyadams,norgannon,288,hunter,beastmastery,12,3,9
Delanooch,rexxar,288,hunter,beastmastery,12,3,9
Wave,kelthuzad,288,hunter,beastmastery,12,3,9
Rsttlegore,stormscale,288,hunter,beastmastery,12,3,9
Warhog,wyrmrest-accord,288,hunter,beastmastery,12,3,9
Gunwalk,azjolnerub,288,hunter,beastmastery,12,3,9
Rooman,ragnaros,288,hunter,beastmastery,12,3,9
Ryanderanged,wyrmrest-accord,288,hunter,beastmastery,12,3,9
Neríne,drakkari,288,hunter,beastmastery,12,3,9
Nephyxo,kiljaeden,288,hunter,beastmastery,12,3,9
Zaydenm,sargeras,288,hunter,beastmastery,12,3,9
Brewster,burning-legion,288,hunter,beastmastery,12,3,9
Leggodex,caelestrasz,288,hunter,beastmastery,12,3,9
Ratbasterrd,darkspear,288,hunter,beastmastery,12,3,9
Icculus,norgannon,288,hunter,beastmastery,12,3,9
Dieplox,thunderhorn,288,hunter,beastmastery,12,3,9
Mahdy,ragnaros,288,hunter,beastmastery,12,3,9
Simyra,moon-guard,288,hunter,beastmastery,12,3,9
Worewolf,lightninghoof,288,hunter,beastmastery,12,3,9
Jgalth,chogall,288,hunter,beastmastery,12,3,9
Tanrith,dark-iron,288,hunter,beastmastery,12,3,9
Digsites,emerald-dream,288,hunter,beastmastery,12,3,9
Tatab,tichondrius,288,hunter,beastmastery,12,3,9
Thiande,zuljin,288,hunter,beastmastery,12,3,9
Spurtzki,emerald-dream,288,hunter,beastmastery,12,3,9
Prowd,staghelm,288,hunter,beastmastery,12,3,9
Inurah,malganis,288,hunter,beastmastery,12,3,9
Zhona,moon-guard,288,hunter,beastmastery,12,3,9
Legacee,shattered-hand,288,hunter,beastmastery,12,3,9
Dsizzle,tichondrius,288,hunter,beastmastery,12,3,9
Rhaygon,arthas,288,hunter,beastmastery,18,3,15
Yiyixx,tichondrius,288,hunter,beastmastery,18,3,15
Bëcäüsë,proudmoore,288,hunter,beastmastery,18,3,15
Yazonics,stormrage,288,hunter,beastmastery,18,3,15
Fiercetamer,azuremyst,288,hunter,beastmastery,18,3,15
Mphunter,azralon,288,hunter,beastmastery,24,3,21
Ledan,lightnings-blade,287,hunter,beastmastery,6,3,3
Euroniimus,ragnaros,287,hunter,beastmastery,6,3,3
Luzyfer,quelthalas,287,hunter,beastmastery,6,3,3
Qwazy,zuljin,287,hunter,beastmastery,6,3,3
Funpickle,area-52,287,hunter,beastmastery,6,3,3
Xeneize,anubarak,287,hunter,beastmastery,6,3,3
Dagganet,thrall,287,hunter,beastmastery,6,3,3
Broseth,saurfang,287,hunter,beastmastery,12,3,9
Snaken,the-forgotten-coast,287,hunter,beastmastery,12,3,9
Drwu,stormrage,287,hunter,beastmastery,12,3,9
Xereck,emerald-dream,287,hunter,beastmastery,12,3,9
Arin,suramar,287,hunter,beastmastery,12,3,9
Elravagerr,medivh,287,hunter,beastmastery,12,3,9
Khaldru,drakkari,286,hunter,beastmastery,6,3,3
Morasongg,area-52,286,hunter,beastmastery,12,3,9
Darkally,blades-edge,285,hunter,beastmastery,18,3,15
Starkills,galakrond,256,hunter,beastmastery,10,3,7
Smokiiganja,proudmoore,256,hunter,beastmastery,10,3,7
Bulszeye,azgalor,255,hunter,beastmastery,8,4,4
Pokeyourbutt,hydraxis,240,hunter,beastmastery,15,3,12
Reyxhunter,area-52,239,hunter,beastmastery,5,3,2
Diisdik,tichondrius,239,hunter,beastmastery,5,3,2
Vicecheney,illidan,239,hunter,beastmastery,5,3,2
Barrit,windrunner,239,hunter,beastmastery,5,3,2
Léfty,nagrand,239,hunter,beastmastery,11,3,8
Kîsmet,area-52,234,hunter,beastmastery,8,4,4
Djcummyfeet,stormrage,234,hunter,beastmastery,17,6,11
Feralcat,nazjatar,208,hunter,beastmastery,13,3,10
Fistbèk,bleeding-hollow,201,hunter,beastmastery,17,5,12
Zarknoth,cenarius,192,hunter,beastmastery,6,2,4
Kzxh,illidan,192,hunter,beastmastery,6,2,4
Castíèl,thrall,192,hunter,beastmastery,6,2,4
Camfeed,illidan,192,hunter,beastmastery,6,2,4
Sukr,korgath,192,hunter,beastmastery,6,2,4
Resonatorrob,illidan,192,hunter,beastmastery,6,2,4
Honeyhunt,thrall,192,hunter,beastmastery,6,2,4
Slanderous,korgath,192,hunter,beastmastery,6,2,4
Elmozz,thrall,192,hunter,beastmastery,6,2,4
Luminai,thrall,192,hunter,beastmastery,6,2,4
Etarie,malganis,192,hunter,beastmastery,6,2,4
Vvs,arthas,192,hunter,beastmastery,6,2,4
Islapuwitaro,azjolnerub,192,hunter,beastmastery,6,2,4
Nubcaks,nerzhul,192,hunter,beastmastery,6,2,4
Madsniper,thunderlord,192,hunter,beastmastery,6,2,4
Huntwhor,bladefist,192,hunter,beastmastery,6,2,4
Flawwless,eredar,192,hunter,beastmastery,6,2,4
Xeneye,tichondrius,192,hunter,beastmastery,6,2,4
Verzoz,illidan,192,hunter,beastmastery,6,2,4
Lilaeth,khadgar,192,hunter,beastmastery,6,2,4
Chaseurnoir,exodar,192,hunter,beastmastery,6,2,4
Diacachimbaa,ragnaros,192,hunter,beastmastery,6,2,4
Obsol,hyjal,192,hunter,beastmastery,6,2,4
Precizionlol,area-52,192,hunter,beastmastery,6,2,4
Monstroow,nemesis,192,hunter,beastmastery,6,2,4
Öops,hyjal,192,hunter,beastmastery,6,2,4
Munrrack,ragnaros,192,hunter,beastmastery,6,2,4
Jbahh,hyjal,192,hunter,beastmastery,6,2,4
Nenenhunt,ragnaros,192,hunter,beastmastery,6,2,4
Hunata,crushridge,192,hunter,beastmastery,6,2,4
Hunterdemond,ragnaros,192,hunter,beastmastery,6,2,4
Rúdrá,area-52,192,hunter,beastmastery,6,2,4
Halaruka,area-52,192,hunter,beastmastery,6,2,4
Csadark,nemesis,192,hunter,beastmastery,6,2,4
Strepmutan,hakkar,192,hunter,beastmastery,6,2,4
Aesennia,wyrmrest-accord,192,hunter,beastmastery,6,2,4
Skillkitingu,area-52,192,hunter,beastmastery,6,2,4
Cuervostreet,ragnaros,192,hunter,beastmastery,6,2,4
Kudzue,illidan,192,hunter,beastmastery,6,2,4
Shootermgavn,frostmourne,192,hunter,beastmastery,6,2,4
Fova,wyrmrest-accord,192,hunter,beastmastery,6,2,4
Cazadak,ragnaros,192,hunter,beastmastery,6,2,4
Bluntcrushed,area-52,192,hunter,beastmastery,6,2,4
Hüh,area-52,192,hunter,beastmastery,6,2,4
Harrowin,area-52,192,hunter,beastmastery,6,2,4
Zellor,wyrmrest-accord,192,hunter,beastmastery,6,2,4
Elvkalla,aegwynn,192,hunter,beastmastery,6,2,4
Sogékíng,illidan,192,hunter,beastmastery,6,2,4
Titzyø,area-52,192,hunter,beastmastery,6,2,4
Illrannevian,garrosh,192,hunter,beastmastery,6,2,4
Bambii,fizzcrank,192,hunter,beastmastery,6,2,4
Sebastian,blackhand,192,hunter,beastmastery,6,2,4
Blickymon,wyrmrest-accord,192,hunter,beastmastery,6,2,4
Zeenuts,sargeras,192,hunter,beastmastery,6,2,4
Izanägi,sargeras,192,hunter,beastmastery,6,2,4
Rizzshot,sargeras,192,hunter,beastmastery,6,2,4
Hìrcine,nesingwary,192,hunter,beastmastery,6,2,4
Ussy,area-52,192,hunter,beastmastery,6,2,4
Powerful,aerie-peak,192,hunter,beastmastery,6,2,4
Hötdôg,kiljaeden,192,hunter,beastmastery,6,2,4
Checkhunter,frostwolf,192,hunter,beastmastery,6,2,4
Pfheign,area-52,192,hunter,beastmastery,6,2,4
Blakespace,area-52,192,hunter,beastmastery,6,2,4
Survbot,malganis,192,hunter,beastmastery,6,2,4
Thazen,sargeras,192,hunter,beastmastery,6,2,4
Bombashotz,sargeras,192,hunter,beastmastery,6,2,4
Spoojshot,frostmourne,192,hunter,beastmastery,6,2,4
Fjdominador,azralon,192,hunter,beastmastery,6,2,4
Krissiz,drakkari,192,hunter,beastmastery,6,2,4
Vanpeltz,illidan,192,hunter,beastmastery,6,2,4
Art,guldan,192,hunter,beastmastery,6,2,4
Barrelsofrum,illidan,192,hunter,beastmastery,6,2,4
Revengexyz,zuljin,192,hunter,beastmastery,6,2,4
Notoffended,sargeras,192,hunter,beastmastery,6,2,4
Warplaquee,zuljin,192,hunter,beastmastery,6,2,4
Ganderion,sargeras,192,hunter,beastmastery,6,2,4
Pudgihunt,proudmoore,192,hunter,beastmastery,6,2,4
Neverwipes,frostmourne,192,hunter,beastmastery,6,2,4
Skolzero,azralon,192,hunter,beastmastery,6,2,4
Gohan,jubeithos,192,hunter,beastmastery,6,2,4
Ikiteforfood,zuljin,192,hunter,beastmastery,6,2,4
Shootr,darkspear,192,hunter,beastmastery,6,2,4
Aaggros,sargeras,192,hunter,beastmastery,6,2,4
Equalizér,sargeras,192,hunter,beastmastery,6,2,4
Expskippy,darkspear,192,hunter,beastmastery,6,2,4
Garble,darkspear,192,hunter,beastmastery,6,2,4
Letsmakebaby,sargeras,192,hunter,beastmastery,6,2,4
Dynith,sargeras,192,hunter,beastmastery,6,2,4
Ravell,arygos,192,hunter,beastmastery,6,2,4
Jackrandall,frostmourne,192,hunter,beastmastery,6,2,4
Mennis,archimonde,192,hunter,beastmastery,6,2,4
Akigga,arthas,192,hunter,beastmastery,6,2,4
Taintz,altar-of-storms,192,hunter,beastmastery,6,2,4
Romro,norgannon,192,hunter,beastmastery,6,2,4
Solderboi,tichondrius,192,hunter,beastmastery,6,2,4
Crawl,auchindoun,192,hunter,beastmastery,6,2,4
Critaclyzm,moon-guard,192,hunter,beastmastery,6,2,4
Moonraven,laughing-skull,192,hunter,beastmastery,6,2,4
Swettx,bleeding-hollow,192,hunter,beastmastery,6,2,4
Chømp,tichondrius,192,hunter,beastmastery,6,2,4
Twocranes,tichondrius,192,hunter,beastmastery,6,2,4
Budget,emerald-dream,192,hunter,beastmastery,6,2,4
Iapsux,bleeding-hollow,192,hunter,beastmastery,6,2,4
Søapbubble,tichondrius,192,hunter,beastmastery,6,2,4
Jämmëdclïp,emerald-dream,192,hunter,beastmastery,6,2,4
Newcomb,tichondrius,192,hunter,beastmastery,6,2,4
Orkemon,emerald-dream,192,hunter,beastmastery,6,2,4
Antwonziezz,tichondrius,192,hunter,beastmastery,6,2,4
Catsualtaco,deathwing,192,hunter,beastmastery,6,2,4
Mojito,frostmourne,192,hunter,beastmastery,6,2,4
Wooftoof,frostmourne,192,hunter,beastmastery,6,2,4
Onlyflans,emerald-dream,192,hunter,beastmastery,6,2,4
Juicyfruit,bleeding-hollow,192,hunter,beastmastery,6,2,4
Hitstickk,tichondrius,192,hunter,beastmastery,6,2,4
Autoshotxprt,frostmourne,192,hunter,beastmastery,6,2,4
Elivivia,tichondrius,192,hunter,beastmastery,6,2,4
Rämbow,frostmourne,192,hunter,beastmastery,6,2,4
Greasyboi,tichondrius,192,hunter,beastmastery,6,2,4
Nfo,lightbringer,192,hunter,beastmastery,6,2,4
Estilingada,azralon,192,hunter,beastmastery,6,2,4
Purpreynolds,tichondrius,192,hunter,beastmastery,6,2,4
Slobon,tichondrius,192,hunter,beastmastery,6,2,4
Yggdrisli,moon-guard,192,hunter,beastmastery,6,2,4
Quinnshot,tichondrius,192,hunter,beastmastery,6,2,4
Sesami,tichondrius,192,hunter,beastmastery,6,2,4
Kaptincrunch,skywall,192,hunter,beastmastery,6,2,4
Jojojobo,tichondrius,192,hunter,beastmastery,6,2,4
Fancyxo,frostmourne,192,hunter,beastmastery,6,2,4
Gruì,malganis,192,hunter,beastmastery,6,2,4
Presleyjane,tichondrius,192,hunter,beastmastery,6,2,4
Averely,skywall,192,hunter,beastmastery,6,2,4
Plumbuss,tichondrius,192,hunter,beastmastery,6,2,4
Nevon,azralon,192,hunter,beastmastery,6,2,4
Boquiinha,stormrage,192,hunter,beastmastery,6,2,4
Magvez,tichondrius,192,hunter,beastmastery,6,2,4
Vyndiln,tichondrius,192,hunter,beastmastery,6,2,4
Frìtz,barthilas,192,hunter,beastmastery,6,2,4
Iskra,onyxia,192,hunter,beastmastery,6,2,4
Sylvãnâs,tichondrius,192,hunter,beastmastery,6,2,4
Jagwaar,malganis,192,hunter,beastmastery,6,2,4
Ivanjackenov,illidan,192,hunter,beastmastery,6,2,4
Tichong,tichondrius,192,hunter,beastmastery,6,2,4
Nanotorque,moon-guard,192,hunter,beastmastery,6,2,4
Singer,lothar,192,hunter,beastmastery,6,2,4
Totolol,trollbane,192,hunter,beastmastery,6,2,4
Johnnybee,demon-soul,192,hunter,beastmastery,6,2,4
Sahjana,lothar,192,hunter,beastmastery,6,2,4
Menaceqq,stormrage,192,hunter,beastmastery,6,2,4
Dnicee,stormrage,192,hunter,beastmastery,6,2,4
Dradran,kelthuzad,192,hunter,beastmastery,6,2,4
Dreadrahl,deathwing,192,hunter,beastmastery,6,2,4
Farva,tanaris,192,hunter,beastmastery,6,2,4
Caligar,tichondrius,192,hunter,beastmastery,6,2,4
Sativ,moknathal,192,hunter,beastmastery,6,2,4
Viracha,stormrage,192,hunter,beastmastery,6,2,4
Ruluu,tichondrius,192,hunter,beastmastery,6,2,4
Shådé,stormrage,192,hunter,beastmastery,6,2,4
Wayer,tichondrius,192,hunter,beastmastery,6,2,4
Slimezy,tichondrius,192,hunter,beastmastery,6,2,4
Hedshot,kelthuzad,192,hunter,beastmastery,6,2,4
Hectorbuñue,quelthalas,192,hunter,beastmastery,6,2,4
Zoopdapoop,dalaran,192,hunter,beastmastery,6,2,4
Royshot,stormrage,192,hunter,beastmastery,6,2,4
Baalboski,tichondrius,192,hunter,beastmastery,6,2,4
Saveawp,stormrage,192,hunter,beastmastery,6,2,4
Dreiya,quelthalas,192,hunter,beastmastery,6,2,4
Monffbc,tichondrius,192,hunter,beastmastery,6,2,4
Luiiguii,quelthalas,192,hunter,beastmastery,6,2,4
Bosshunter,tichondrius,192,hunter,beastmastery,6,2,4
Lockdowwnn,kelthuzad,192,hunter,beastmastery,6,2,4
Nahzah,stormrage,192,hunter,beastmastery,6,2,4
Varianhunter,kelthuzad,192,hunter,beastmastery,6,2,4
Greyk,moon-guard,192,hunter,beastmastery,6,2,4
Klepty,stormrage,192,hunter,beastmastery,6,2,4
Ramboman,stormrage,192,hunter,beastmastery,6,2,4
Ellishunter,frostmourne,192,hunter,beastmastery,6,2,4
Kekorator,illidan,192,hunter,beastmastery,11,3,8
Seratoninx,malganis,192,hunter,beastmastery,9,2,7
Thyladaern,kiljaeden,192,hunter,beastmastery,12,2,10
Hughboner,illidan,192,hunter,beastmastery,12,2,10
Alexañdra,proudmoore,192,hunter,beastmastery,12,2,10
Miannmar,proudmoore,192,hunter,beastmastery,12,2,10
Floozy,frostmane,192,hunter,beastmastery,12,2,10
Gunnpowder,malganis,192,hunter,beastmastery,12,2,10
Khabul,area-52,192,hunter,beastmastery,12,2,10
Tjota,azralon,192,hunter,beastmastery,12,2,10
Arrowzpeckt,tichondrius,192,hunter,beastmastery,12,2,10
Mygun,deathwing,192,hunter,beastmastery,12,2,10
Thundis,hellscream,192,hunter,beastmastery,12,2,10
Tánsøxøxø,tichondrius,192,hunter,beastmastery,12,2,10
Carloslaun,drakkari,192,hunter,beastmastery,12,2,10
Pakale,amanthul,192,hunter,beastmastery,12,2,10
Meetdmonster,illidan,192,hunter,beastmastery,12,2,10
Ariens,icecrown,192,hunter,beastmastery,12,2,10
Bjj,eonar,192,hunter,beastmastery,12,2,10
Ahmunra,zuljin,192,hunter,beastmastery,12,2,10
Impërïum,zuljin,192,hunter,beastmastery,12,2,10
Ãmi,moon-guard,192,hunter,beastmastery,12,2,10
Aeriladin,moon-guard,192,hunter,beastmastery,12,2,10
Sojun,jaedenar,192,hunter,beastmastery,14,2,12
Ylexziel,moon-guard,191,hunter,beastmastery,6,2,4
Stoneforged,ragnaros,191,hunter,beastmastery,6,2,4
Ninoryzen,illidan,191,hunter,beastmastery,6,2,4
Recebaa,barthilas,191,hunter,beastmastery,6,2,4
Aiilton,gallywix,191,hunter,beastmastery,6,2,4
Tuvasa,blood-furnace,191,hunter,beastmastery,6,2,4
Kolarius,emerald-dream,191,hunter,beastmastery,6,2,4
Enrage,queldorei,191,hunter,beastmastery,12,2,10
Kangarang,khazgoroth,191,hunter,beastmastery,12,2,10
Flarkarino,area-52,159,hunter,beastmastery,5,2,3
Extremis,emerald-dream,159,hunter,beastmastery,5,2,3
Helikaon,deathwing,159,hunter,beastmastery,5,2,3
Maximum,tichondrius,159,hunter,beastmastery,5,2,3
Stèlla,frostmourne,159,hunter,beastmastery,5,2,3
Skrìms,tichondrius,159,hunter,beastmastery,5,2,3
Twentyyfour,akama,144,hunter,beastmastery,3,3,0
Piess,thrall,144,hunter,beastmastery,9,2,7
Luckione,destromath,144,hunter,beastmastery,9,2,7
Bigun,emerald-dream,138,hunter,beastmastery,16,5,11
Bountybud,kiljaeden,138,hunter,beastmastery,10,3,7
Nixuis,stormrage,138,hunter,beastmastery,13,3,10
Piñg,tichondrius,128,hunter,beastmastery,4,2,2
Arrawn,illidan,128,hunter,beastmastery,4,2,2
Beastmastr,garrosh,128,hunter,beastmastery,4,2,2
Josharoni,sargeras,127,hunter,beastmastery,8,2,6
Laviè,tichondrius,112,hunter,beastmastery,4,3,1
Dakøta,wyrmrest-accord,96,hunter,beastmastery,3,2,1
Slimetime,tichondrius,96,hunter,beastmastery,6,1,5
Wamion,zuljin,96,hunter,beastmastery,6,1,5
Birggitte,the-venture-co,96,hunter,beastmastery,6,1,5
Locket,maelstrom,96,hunter,beastmastery,6,1,5
Bertiebott,zuljin,96,hunter,beastmastery,6,1,5
Cynasia,maelstrom,96,hunter,beastmastery,6,1,5
Jiawoweixin,illidan,96,hunter,beastmastery,6,1,5
Jägermeistër,twisting-nether,96,hunter,beastmastery,6,1,5
Henhøuse,illidan,96,hunter,beastmastery,6,1,5
Dasdasdds,zuljin,96,hunter,beastmastery,6,1,5
Ballinpotato,tichondrius,96,hunter,beastmastery,6,1,5
Singletap,barthilas,96,hunter,beastmastery,6,1,5
Gabanlicius,azralon,96,hunter,beastmastery,6,1,5
Jootuber,barthilas,96,hunter,beastmastery,6,1,5
Huntardness,moon-guard,96,hunter,beastmastery,6,1,5
Slideby,tichondrius,96,hunter,beastmastery,6,1,5
Mtuanwm,tichondrius,96,hunter,beastmastery,6,1,5
Dusle,azralon,96,hunter,beastmastery,6,1,5
Sobala,azralon,96,hunter,beastmastery,6,1,5
Jarless,hydraxis,96,hunter,beastmastery,6,1,5
Espaada,tichondrius,96,hunter,beastmastery,6,1,5
Matahunt,blackwing-lair,96,hunter,beastmastery,6,1,5
Robious,tichondrius,96,hunter,beastmastery,6,1,5
Darkhunterr,tichondrius,96,hunter,beastmastery,6,1,5
Ulrulk,tichondrius,96,hunter,beastmastery,6,1,5
Carot,dalaran,96,hunter,beastmastery,6,1,5
Ophois,lightbringer,96,hunter,beastmastery,6,1,5
Robinth,moon-guard,96,hunter,beastmastery,6,1,5
Audiofly,tichondrius,96,hunter,beastmastery,6,1,5
Jabbar,bleeding-hollow,96,hunter,beastmastery,6,1,5
Beefcow,barthilas,96,hunter,beastmastery,6,1,5
Gulan,draka,96,hunter,beastmastery,6,1,5
Ilîiìîìiilil,bleeding-hollow,96,hunter,beastmastery,6,1,5
Panm,runetotem,96,hunter,beastmastery,6,1,5
Remak,barthilas,96,hunter,beastmastery,6,1,5
Boido,ghostlands,96,hunter,beastmastery,6,1,5
Sõulhunter,frostmourne,96,hunter,beastmastery,6,1,5
Globlauncher,tichondrius,96,hunter,beastmastery,6,1,5
Amazoness,tichondrius,96,hunter,beastmastery,6,1,5
Oldmandave,stormrage,96,hunter,beastmastery,6,1,5
Analtraps,tichondrius,96,hunter,beastmastery,6,1,5
Ferrettss,bleeding-hollow,96,hunter,beastmastery,6,1,5
Odratnuh,bleeding-hollow,96,hunter,beastmastery,6,1,5
Rorijii,tichondrius,96,hunter,beastmastery,6,1,5
Alsomike,tichondrius,96,hunter,beastmastery,6,1,5
Shadeckz,stormrage,96,hunter,beastmastery,6,1,5
Bellaphonte,stormrage,96,hunter,beastmastery,6,1,5
Laer,archimonde,96,hunter,beastmastery,6,1,5
Justin,agamaggan,96,hunter,beastmastery,6,1,5
Uncann,boulderfist,96,hunter,beastmastery,6,1,5
Relume,agamaggan,96,hunter,beastmastery,6,1,5
Pampas,darkspear,96,hunter,beastmastery,6,1,5
Xclaw,llane,96,hunter,beastmastery,6,1,5
Deletedyou,tichondrius,96,hunter,beastmastery,6,1,5
Taumelz,sargeras,96,hunter,beastmastery,6,1,5
Chîll,frostmourne,96,hunter,beastmastery,6,1,5
Taurenseason,sargeras,96,hunter,beastmastery,6,1,5
Fourkayiv,azgalor,96,hunter,beastmastery,6,1,5
Physical,destromath,96,hunter,beastmastery,6,1,5
Shoccka,thrall,96,hunter,beastmastery,6,1,5
Teddyboy,proudmoore,96,hunter,beastmastery,6,1,5
Rexxiga,kiljaeden,96,hunter,beastmastery,6,1,5
Muckenfoose,frostmourne,96,hunter,beastmastery,6,1,5
Derekscrow,tichondrius,96,hunter,beastmastery,6,1,5
Båttousai,kiljaeden,96,hunter,beastmastery,6,1,5
Trapocalypse,blackrock,96,hunter,beastmastery,6,1,5
Penelòpe,wyrmrest-accord,96,hunter,beastmastery,6,1,5
Nachtcloverr,stormrage,96,hunter,beastmastery,6,1,5
Tiirra,sargeras,96,hunter,beastmastery,6,1,5
Varag,amanthul,96,hunter,beastmastery,6,1,5
Wixyy,aegwynn,96,hunter,beastmastery,6,1,5
Cocobread,stormreaver,96,hunter,beastmastery,6,1,5
Bosshunt,whisperwind,96,hunter,beastmastery,6,1,5
Naariko,aggramar,96,hunter,beastmastery,6,1,5
Nearsightedd,area-52,96,hunter,beastmastery,6,1,5
Brokenfoot,bonechewer,96,hunter,beastmastery,6,1,5
Hieke,nemesis,96,hunter,beastmastery,6,1,5
Bigpie,daggerspine,96,hunter,beastmastery,6,1,5
Grullandàr,hakkar,96,hunter,beastmastery,6,1,5
Tybierious,illidan,96,hunter,beastmastery,6,1,5
Richihunt,ragnaros,96,hunter,beastmastery,6,1,5
Xcopel,azralon,96,hunter,beastmastery,6,1,5
Ochunter,hyjal,96,hunter,beastmastery,6,1,5
Cuckw,nemesis,96,hunter,beastmastery,6,1,5
Brody,eitrigg,96,hunter,beastmastery,6,1,5
Datzaza,illidan,96,hunter,beastmastery,6,1,5
Trolljinyou,thrall,96,hunter,beastmastery,6,1,5
Sóggybóxers,tichondrius,96,hunter,beastmastery,6,1,5
Blåckhat,frostmourne,96,hunter,beastmastery,6,1,5
Marksmanpain,malganis,96,hunter,beastmastery,6,1,5
Opsi,ragnaros,96,hunter,beastmastery,6,1,5
Appä,lightnings-blade,96,hunter,beastmastery,6,1,5
Warpedshots,malganis,96,hunter,beastmastery,6,1,5
Allgasnocap,kelthuzad,96,hunter,beastmastery,6,1,5
Predatðr,frostmourne,96,hunter,beastmastery,6,1,5
Fadingtrapz,jubeithos,96,hunter,beastmastery,6,1,5
Arthanyz,quelthalas,96,hunter,beastmastery,6,1,5
Bendotexe,stormrage,96,hunter,beastmastery,7,1,6
Colchagua,quelthalas,96,hunter,beastmastery,8,1,7
Nakar,darkspear,96,hunter,beastmastery,10,1,9
Baehydra,frostmourne,96,hunter,beastmastery,12,1,11
Divineseraph,dentarg,96,hunter,beastmastery,12,1,11
Blackstaur,illidan,96,hunter,beastmastery,12,1,11
Mckillahoe,malganis,96,hunter,beastmastery,12,1,11
Tinsho,drakkari,96,hunter,beastmastery,12,1,11
Sylvanãs,ragnaros,96,hunter,beastmastery,12,1,11
Feignharder,stormrage,96,hunter,beastmastery,12,1,11
Rekows,stormrage,96,hunter,beastmastery,12,1,11
Tydee,nagrand,96,hunter,beastmastery,12,1,11
Tstormzz,stormrage,96,hunter,beastmastery,12,1,11
Twistedx,tichondrius,96,hunter,beastmastery,12,1,11
Lorishblood,blackrock,96,hunter,beastmastery,12,1,11
Ñordombra,quelthalas,96,hunter,beastmastery,12,1,11
Ferdphin,dalaran,96,hunter,beastmastery,12,1,11
Caletten,destromath,96,hunter,beastmastery,12,1,11
Bee,shattered-halls,96,hunter,beastmastery,12,1,11
Kornatoma,bleeding-hollow,95,hunter,beastmastery,6,1,5
Newdanni,barthilas,95,hunter,beastmastery,18,1,17
Ericcartman,drakthul,79,hunter,beastmastery,5,1,4
Dógs,illidan,79,hunter,beastmastery,5,1,4
Kölhberg,azralon,64,hunter,beastmastery,10,1,9
Yory,tol-barad,48,hunter,beastmastery,3,1,2
Temara,icecrown,48,hunter,beastmastery,3,1,2
Wonshawt,tichondrius,48,hunter,beastmastery,3,1,2
Dwrhunt,ragnaros,48,hunter,beastmastery,3,1,2
Aceventurapð,area-52,48,hunter,beastmastery,3,1,2
Jumeog,stormscale,42,hunter,beastmastery,7,2,5
Bowjoblul,stormrage,42,hunter,beastmastery,9,2,7
Backdatazzup,kiljaeden,31,hunter,beastmastery,2,1,1
Gasslight,area-52,31,hunter,beastmastery,2,1,1
Timesteal,tichondrius,31,hunter,beastmastery,2,1,1
Voladren,moon-guard,31,hunter,beastmastery,2,1,1
Alsol,drakkari,31,hunter,beastmastery,2,1,1
Dirkberkeley,moon-guard,16,hunter,beastmastery,1,1,0
Juicemage,tichondrius,2243,mage,arcane,107,58,49
Numbing,sargeras,2233,mage,arcane,100,54,46
Cvark,sargeras,2223,mage,arcane,88,51,37
Junglejape,tichondrius,2201,mage,arcane,72,47,25
Oneschool,sargeras,2174,mage,arcane,78,45,33
Ktp,tichondrius,2157,mage,arcane,101,60,41
Venruki,tichondrius,2137,mage,arcane,78,44,34
Starxen,tichondrius,1947,mage,arcane,60,35,25
Arcanemagek,tichondrius,1907,mage,arcane,48,32,16
Bíscuít,illidan,1900,mage,arcane,175,95,80
Whiterice,zuljin,1879,mage,arcane,50,31,19
Birdfather,tichondrius,1861,mage,arcane,48,33,15
Elfmage,tichondrius,1855,mage,arcane,36,25,11
Hocusjokus,frostmourne,1851,mage,arcane,47,31,16
Snortmeth,area-52,1841,mage,arcane,90,58,32
Delibro,tichondrius,1834,mage,arcane,94,52,42
Spellstéal,tichondrius,1828,mage,arcane,41,25,16
Unguided,moon-guard,1810,mage,arcane,72,43,29
Vampìrelolz,tichondrius,1809,mage,arcane,48,26,22
Ezchallenger,undermine,1782,mage,arcane,102,47,55
Sestren,zuljin,1774,mage,arcane,103,51,52
Edgkey,illidan,1771,mage,arcane,103,54,49
Magnesiium,illidan,1769,mage,arcane,60,36,24
Mokelovin,sargeras,1763,mage,arcane,65,33,32
Melkdud,wyrmrest-accord,1754,mage,arcane,36,21,15
Maegwynah,jaedenar,1753,mage,arcane,58,31,27
Dawitchery,illidan,1753,mage,arcane,58,26,32
Bambambilly,kelthuzad,1749,mage,arcane,162,81,81
Buyßitcoin,sargeras,1746,mage,arcane,36,20,16
Arçanemage,tichondrius,1745,mage,arcane,42,20,22
Aosin,wyrmrest-accord,1738,mage,arcane,42,30,12
Rhythmdog,tichondrius,1738,mage,arcane,87,45,42
Spart,runetotem,1731,mage,arcane,56,24,32
Hallat,archimonde,1726,mage,arcane,437,215,222
Tbkz,amanthul,1725,mage,arcane,54,25,29
Bananappeal,kelthuzad,1717,mage,arcane,52,26,26
Lmaginedying,illidan,1715,mage,arcane,30,24,6
Ilovejwoanna,kiljaeden,1715,mage,arcane,70,38,32
Shwaysted,burning-blade,1708,mage,arcane,66,36,30
Zps,illidan,1706,mage,arcane,72,40,32
Badboykilla,dentarg,1704,mage,arcane,39,33,6
Esien,tichondrius,1703,mage,arcane,144,68,76
Mageboy,bonechewer,1699,mage,arcane,67,33,34
Sourx,doomhammer,1693,mage,arcane,48,26,22
Clutchy,gorefiend,1672,mage,arcane,42,29,13
Nyj,tichondrius,1668,mage,arcane,65,36,29
Zhanna,nazjatar,1668,mage,arcane,152,80,72
Exterminatüs,tichondrius,1653,mage,arcane,87,44,43
Höövalt,illidan,1641,mage,arcane,30,20,10
Spitemage,tichondrius,1638,mage,arcane,109,52,57
Mairgik,proudmoore,1629,mage,arcane,42,21,21
Spellsteål,malganis,1627,mage,arcane,53,31,22
Magecombe,thrall,1617,mage,arcane,30,17,13
Dbox,stormscale,1615,mage,arcane,93,53,40
Dmgperseç,tichondrius,1612,mage,arcane,30,20,10
Zerathremar,proudmoore,1612,mage,arcane,42,25,17
Proximalol,tichondrius,1610,mage,arcane,36,20,16
Snoogma,illidan,1609,mage,arcane,42,20,22
Arianark,sargeras,1608,mage,arcane,123,68,55
Ject,ragnaros,1606,mage,arcane,155,84,71
Wïzarduous,mannoroth,1605,mage,arcane,60,33,27
Hööva,illidan,1604,mage,arcane,30,17,13
Primearcanis,tol-barad,1601,mage,arcane,48,22,26
Höövaltx,illidan,1600,mage,arcane,36,19,17
Failedwizard,frostmourne,1600,mage,arcane,58,25,33
Sky,lightnings-blade,1598,mage,arcane,143,76,67
Felsparkles,area-52,1589,mage,arcane,54,30,24
Frostituty,kiljaeden,1585,mage,arcane,35,20,15
Beerbelly,tichondrius,1584,mage,arcane,113,66,47
Waisted,kelthuzad,1573,mage,arcane,45,25,20
Balencii,kiljaeden,1573,mage,arcane,60,33,27
Xialing,tichondrius,1570,mage,arcane,63,32,31
Tbh,malganis,1555,mage,arcane,62,29,33
Clernlol,emerald-dream,1548,mage,arcane,60,27,33
Étel,nemesis,1539,mage,arcane,39,19,20
Rof,sargeras,1534,mage,arcane,30,16,14
Enthy,frostmourne,1529,mage,arcane,36,18,18
Prosperoh,burning-legion,1526,mage,arcane,48,25,23
Agoniey,illidan,1525,mage,arcane,138,69,69
Vênsêr,emerald-dream,1523,mage,arcane,36,17,19
Lucidaze,daggerspine,1521,mage,arcane,244,122,122
Alode,moon-guard,1513,mage,arcane,65,38,27
Cyphen,proudmoore,1500,mage,arcane,30,16,14
Perrc,area-52,1488,mage,arcane,180,89,91
Hustle,frostmourne,1483,mage,arcane,102,53,49
Mävra,emerald-dream,1482,mage,arcane,30,18,12
Hennimage,sargeras,1468,mage,arcane,241,132,109
Wasami,tichondrius,1461,mage,arcane,61,31,30
Missile,frostmourne,1454,mage,arcane,36,17,19
Hoçuspoçus,moon-guard,1452,mage,arcane,107,52,55
Alùcârd,tichondrius,1447,mage,arcane,41,20,21
Lünå,onyxia,1444,mage,arcane,72,44,28
Swàn,stormrage,1444,mage,arcane,42,23,19
Ligmmah,stormrage,1440,mage,arcane,69,39,30
Wretchy,ragnaros,1439,mage,arcane,73,38,35
Caseyjelly,tichondrius,1436,mage,arcane,36,20,16
Bighot,tichondrius,1428,mage,arcane,84,50,34
Parapio,tichondrius,1426,mage,arcane,38,20,18
Maplemage,akama,1416,mage,arcane,195,100,95
Allýria,stormrage,1395,mage,arcane,42,18,24
Sáron,quelthalas,1390,mage,arcane,94,47,47
Söngs,goldrinn,1387,mage,arcane,24,15,9
Frozonnee,aggramar,1379,mage,arcane,24,15,9
Toknsmoke,tichondrius,1376,mage,arcane,59,28,31
Wizzyx,illidan,1373,mage,arcane,40,21,19
Tessar,moon-guard,1373,mage,arcane,78,40,38
Castarcane,nordrassil,1370,mage,arcane,36,17,19
Pufs,stormrage,1369,mage,arcane,41,20,21
Kickpollyplx,lothar,1368,mage,arcane,71,45,26
Avandal,proudmoore,1362,mage,arcane,71,29,42
Raazzamage,moon-guard,1360,mage,arcane,81,44,37
Astrojrue,sargeras,1353,mage,arcane,41,21,20
Thewizârd,stormrage,1350,mage,arcane,358,188,170
Melkra,tichondrius,1348,mage,arcane,66,36,30
Xtymhxy,tichondrius,1343,mage,arcane,18,14,4
Valériemeow,tichondrius,1343,mage,arcane,30,14,16
Chezzmasterx,misha,1336,mage,arcane,85,44,41
Szrp,stormrage,1336,mage,arcane,57,27,30
Blaxmagic,stormrage,1333,mage,arcane,78,34,44
Måndias,tichondrius,1328,mage,arcane,34,18,16
Themagicman,whisperwind,1324,mage,arcane,42,17,25
Zayth,silvermoon,1315,mage,arcane,45,24,21
Somariais,illidan,1315,mage,arcane,161,78,83
Coôler,illidan,1313,mage,arcane,39,16,23
Zukoprince,azralon,1312,mage,arcane,24,14,10
Linkolni,azralon,1312,mage,arcane,111,59,52
Zulugara,barthilas,1308,mage,arcane,46,22,24
Orderlight,alexstrasza,1306,mage,arcane,30,14,16
Ruzam,area-52,1303,mage,arcane,186,91,95
Véyda,emerald-dream,1300,mage,arcane,60,30,30
Airbnb,area-52,1299,mage,arcane,46,26,20
Gryd,area-52,1289,mage,arcane,130,71,59
Yonzho,area-52,1286,mage,arcane,26,16,10
Garrieto,sargeras,1285,mage,arcane,36,19,17
Chelseâ,emerald-dream,1281,mage,arcane,59,28,31
Valrendor,nazjatar,1270,mage,arcane,102,56,46
Strêss,kelthuzad,1269,mage,arcane,128,63,65
Fruitdealerr,tichondrius,1266,mage,arcane,54,29,25
Jedamere,proudmoore,1260,mage,arcane,48,23,25
Nazneen,elune,1254,mage,arcane,64,36,28
Draell,drakkari,1251,mage,arcane,72,37,35
Sorankim,tichondrius,1248,mage,arcane,24,13,11
Nightsaber,blackrock,1247,mage,arcane,18,13,5
Gessin,area-52,1245,mage,arcane,100,50,50
Velvetlurker,sargeras,1243,mage,arcane,30,13,17
Sazza,tichondrius,1238,mage,arcane,24,13,11
Gin,nemesis,1238,mage,arcane,60,28,32
Unlike,sargeras,1235,mage,arcane,71,29,42
Edisia,moon-guard,1231,mage,arcane,24,13,11
Oharvestero,illidan,1230,mage,arcane,61,29,32
Magicos,frostmourne,1229,mage,arcane,24,13,11
Greenwise,illidan,1227,mage,arcane,60,33,27
Myrondor,tichondrius,1227,mage,arcane,24,13,11
Nedrin,nemesis,1216,mage,arcane,96,46,50
Celciius,stormrage,1212,mage,arcane,107,47,60
Kevymarts,tichondrius,1210,mage,arcane,36,14,22
Fearhades,drakkari,1198,mage,arcane,36,19,17
Softbody,barthilas,1196,mage,arcane,113,54,59
Skywalkerino,azralon,1194,mage,arcane,151,76,75
Smoks,stormrage,1191,mage,arcane,62,30,32
Dereliction,nagrand,1185,mage,arcane,102,52,50
Nunezz,mannoroth,1179,mage,arcane,60,32,28
Nekrobear,nemesis,1179,mage,arcane,42,20,22
Freehoñgkong,tichondrius,1177,mage,arcane,42,20,22
Privilege,dragonmaw,1174,mage,arcane,41,20,21
Kyrumage,illidan,1172,mage,arcane,70,39,31
Sceledrus,quelthalas,1158,mage,arcane,44,22,22
Numaïr,kiljaeden,1156,mage,arcane,36,17,19
Antifreezex,tichondrius,1148,mage,arcane,106,54,52
Frozorfs,tichondrius,1141,mage,arcane,36,14,22
Buffmages,malfurion,1135,mage,arcane,18,12,6
Firehawk,azralon,1133,mage,arcane,24,15,9
Billzeye,dalaran,1128,mage,arcane,24,12,12
Saladguy,thrall,1122,mage,arcane,47,21,26
Badwoman,tichondrius,1111,mage,arcane,36,13,23
Simongof,tichondrius,1109,mage,arcane,33,13,20
Kaiokenxten,bleeding-hollow,1102,mage,arcane,29,12,17
Cokézero,frostmourne,1098,mage,arcane,67,32,35
Oyagi,moon-guard,1097,mage,arcane,89,42,47
Overratedxd,moon-guard,1092,mage,arcane,26,13,13
Klausgc,sargeras,1084,mage,arcane,20,12,8
Xakura,dragonmaw,1084,mage,arcane,29,14,15
Chëryl,proudmoore,1061,mage,arcane,240,111,129
Randalf,dragonmaw,1056,mage,arcane,24,15,9
Flaux,sargeras,1055,mage,arcane,18,11,7
Tommagic,tichondrius,1055,mage,arcane,30,11,19
Glaciated,the-forgotten-coast,1053,mage,arcane,24,11,13
Shmage,dragonmaw,1050,mage,arcane,24,11,13
Zerosaspect,thrall,1047,mage,arcane,22,12,10
Baskal,area-52,1046,mage,arcane,34,12,22
Oogleymoogly,zuljin,1040,mage,arcane,24,11,13
Cassanara,moon-guard,1032,mage,arcane,36,13,23
Xplozion,lightninghoof,1029,mage,arcane,25,13,12
Lacouet,lightnings-blade,1019,mage,arcane,36,11,25
Thetodd,emerald-dream,1017,mage,arcane,24,16,8
Kittikk,tichondrius,1005,mage,arcane,119,53,66
Maiddan,azralon,1000,mage,arcane,26,12,14
Döömsage,hydraxis,999,mage,arcane,23,11,12
Knotyouagain,emerald-dream,996,mage,arcane,54,31,23
Casarenarrus,staghelm,985,mage,arcane,24,13,11
Scône,sargeras,985,mage,arcane,28,11,17
Raeign,frostmourne,972,mage,arcane,141,67,74
Mixler,feathermoon,970,mage,arcane,65,32,33
Khierlana,hellscream,961,mage,arcane,120,55,65
Windwìtch,quelthalas,960,mage,arcane,18,10,8
Lightsoran,tichondrius,960,mage,arcane,24,10,14
Jazzgroyper,sargeras,960,mage,arcane,24,10,14
Gachaguy,bleeding-hollow,960,mage,arcane,30,10,20
Icydubya,illidan,958,mage,arcane,12,10,2
Tuggernaug,malganis,958,mage,arcane,18,10,8
Eruilúvatar,nerzhul,956,mage,arcane,30,17,13
Haze,hyjal,955,mage,arcane,18,10,8
Firèballin,tichondrius,955,mage,arcane,24,10,14
Tagere,moon-guard,954,mage,arcane,24,10,14
Gusmaged,stormrage,953,mage,arcane,16,11,5
Wizfajita,malganis,951,mage,arcane,24,10,14
Funnyfrankie,tichondrius,949,mage,arcane,24,10,14
Sksteve,rexxar,948,mage,arcane,30,10,20
Wøogles,sargeras,946,mage,arcane,24,10,14
Harmful,frostmourne,944,mage,arcane,21,10,11
Morkleen,korgath,943,mage,arcane,30,10,20
Shadows,exodar,934,mage,arcane,24,10,14
Akagamix,sargeras,924,mage,arcane,36,17,19
Suicune,area-52,922,mage,arcane,28,10,18
Dietdeww,borean-tundra,913,mage,arcane,18,10,8
Tsarevich,fizzcrank,907,mage,arcane,72,29,43
Mastablastar,windrunner,899,mage,arcane,23,10,13
Arcalìte,illidan,894,mage,arcane,17,11,6
Littlefun,tichondrius,878,mage,arcane,11,10,1
Søkø,tichondrius,868,mage,arcane,30,11,19
Shawarms,tichondrius,864,mage,arcane,18,9,9
Viôlentj,area-52,863,mage,arcane,12,9,3
Pandazed,proudmoore,863,mage,arcane,18,9,9
Harshx,bleeding-hollow,863,mage,arcane,18,9,9
Eimm,stormrage,862,mage,arcane,30,9,21
Moond,drakkari,858,mage,arcane,18,9,9
Nachtt,sargeras,857,mage,arcane,18,9,9
Mageyoulooks,kelthuzad,856,mage,arcane,24,9,15
Prosperoo,aerie-peak,855,mage,arcane,30,14,16
Cubanarox,gallywix,852,mage,arcane,34,11,23
Mahe,andorhal,850,mage,arcane,86,32,54
Magicå,area-52,845,mage,arcane,12,9,3
Xunalatu,frostmourne,845,mage,arcane,18,9,9
Dchee,nerzhul,841,mage,arcane,18,9,9
Waef,quelthalas,838,mage,arcane,18,9,9
Instataterz,eonar,833,mage,arcane,29,9,20
Sherian,queldorei,832,mage,arcane,18,9,9
Jackson,altar-of-storms,809,mage,arcane,60,17,43
Fredcouples,tichondrius,803,mage,arcane,19,10,9
Kirayu,gilneas,798,mage,arcane,16,9,7
Unmix,tichondrius,794,mage,arcane,20,9,11
Lewpithy,area-52,768,mage,arcane,12,8,4
Cinnamon,boulderfist,768,mage,arcane,12,8,4
Eludin,aegwynn,768,mage,arcane,18,8,10
Hynzie,barthilas,768,mage,arcane,18,8,10
Rebornganegg,tichondrius,768,mage,arcane,18,8,10
Jööz,deathwing,768,mage,arcane,18,8,10
Watchmepog,tichondrius,767,mage,arcane,12,8,4
Crøwgawd,tichondrius,767,mage,arcane,12,8,4
Azeroth,boulderfist,767,mage,arcane,13,8,5
Arcanatos,emerald-dream,767,mage,arcane,18,8,10
Fakebusiness,area-52,767,mage,arcane,18,8,10
Fasttwitch,kiljaeden,767,mage,arcane,24,8,16
Afasge,illidan,766,mage,arcane,18,8,10
Delana,darkspear,766,mage,arcane,24,8,16
Boredmoomoo,thunderlord,765,mage,arcane,12,8,4
Gimani,tichondrius,765,mage,arcane,18,8,10
Archtype,azralon,764,mage,arcane,24,8,16
Iseltwald,proudmoore,761,mage,arcane,12,8,4
Christensen,stormrage,761,mage,arcane,18,8,10
Aycc,tichondrius,735,mage,arcane,17,8,9
Ebah,tichondrius,734,mage,arcane,20,9,11
Perkaset,turalyon,703,mage,arcane,17,8,9
Drainbamage,coilfang,691,mage,arcane,136,38,98
Noescaping,illidan,687,mage,arcane,19,8,11
Feorbxx,proudmoore,672,mage,arcane,12,7,5
Umpire,boulderfist,672,mage,arcane,12,7,5
Pizzaslimé,tichondrius,672,mage,arcane,12,7,5
Vixen,boulderfist,672,mage,arcane,12,7,5
Lavaera,illidan,672,mage,arcane,12,7,5
Bigmunkee,the-venture-co,672,mage,arcane,12,7,5
Zakume,stormrage,672,mage,arcane,12,7,5
Poggywoggy,frostmourne,672,mage,arcane,12,7,5
Mershon,tichondrius,671,mage,arcane,12,7,5
Murr,boulderfist,671,mage,arcane,12,7,5
Zezima,spirestone,671,mage,arcane,12,7,5
Ankidar,quelthalas,671,mage,arcane,18,7,11
Magekofwa,tichondrius,671,mage,arcane,18,7,11
Omnislasher,terenas,671,mage,arcane,24,7,17
Warthormage,stormrage,670,mage,arcane,12,7,5
Austere,boulderfist,670,mage,arcane,12,7,5
Derkrìeger,turalyon,670,mage,arcane,18,7,11
Zimzum,bladefist,666,mage,arcane,12,7,5
Brazcane,skullcrusher,655,mage,arcane,17,7,10
Karamzov,zuljin,652,mage,arcane,24,7,17
Arcanochillz,ghostlands,621,mage,arcane,21,8,13
Culours,stormrage,616,mage,arcane,17,7,10
Uhh,blackrock,607,mage,arcane,14,7,7
Moogician,aerie-peak,592,mage,arcane,13,7,6
Ærtai,black-dragonflight,592,mage,arcane,13,7,6
Asalumm,quelthalas,589,mage,arcane,19,8,11
Onibeef,duskwood,576,mage,arcane,12,6,6
Icecreamboy,tichondrius,576,mage,arcane,12,6,6
Muffhugga,dalaran,576,mage,arcane,12,6,6
Astroner,frostmourne,576,mage,arcane,12,6,6
Slowmobius,tichondrius,576,mage,arcane,12,6,6
Aeghis,stormrage,576,mage,arcane,12,6,6
Olympicz,kelthuzad,576,mage,arcane,12,6,6
Biscobush,turalyon,576,mage,arcane,15,7,8
Nazmagus,hydraxis,576,mage,arcane,18,6,12
Fuchsia,boulderfist,576,mage,arcane,18,6,12
Cicciozi,sargeras,576,mage,arcane,24,6,18
Snâred,aggramar,575,mage,arcane,6,6,0
Kârén,aggramar,575,mage,arcane,12,6,6
Furrblock,tichondrius,575,mage,arcane,18,6,12
Ispell,tichondrius,573,mage,arcane,24,6,18
Enfuegoe,tichondrius,571,mage,arcane,12,6,6
Francious,echo-isles,566,mage,arcane,12,6,6
Belven,proudmoore,559,mage,arcane,17,6,11
Vires,kelthuzad,543,mage,arcane,11,6,5
Tibbit,kelthuzad,480,mage,arcane,6,5,1
Zeró,frostmourne,480,mage,arcane,6,5,1
Enveas,illidan,480,mage,arcane,6,5,1
Skillsbro,arthas,480,mage,arcane,6,5,1
Lúpìn,zuljin,480,mage,arcane,12,5,7
Shäräpova,zuljin,480,mage,arcane,12,5,7
Rebdoomer,skullcrusher,480,mage,arcane,12,5,7
Lorlene,frostmourne,480,mage,arcane,12,5,7
Xariean,azuremyst,480,mage,arcane,12,5,7
Markage,stormrage,480,mage,arcane,12,5,7
Diamondx,ragnaros,480,mage,arcane,12,5,7
Arcp,illidan,480,mage,arcane,12,5,7
Hansol,farstriders,480,mage,arcane,12,5,7
Dagreatone,malganis,480,mage,arcane,12,5,7
Fatso,boulderfist,480,mage,arcane,12,5,7
Wauzcrol,quelthalas,480,mage,arcane,12,5,7
Maxtorgar,quelthalas,480,mage,arcane,12,5,7
Sumu,stormrage,480,mage,arcane,12,5,7
Inmylife,tichondrius,480,mage,arcane,15,6,9
Hogdog,illidan,480,mage,arcane,18,5,13
Corsten,aerie-peak,479,mage,arcane,12,5,7
Sweetypie,fenris,479,mage,arcane,12,5,7
Mandrakë,nemesis,478,mage,arcane,12,5,7
Shocknawes,illidan,478,mage,arcane,15,5,10
Humpadumplin,wyrmrest-accord,478,mage,arcane,24,5,19
Merlon,dalaran,476,mage,arcane,12,5,7
Combusty,sargeras,447,mage,arcane,14,6,8
Squishymage,moon-guard,446,mage,arcane,17,5,12
Tubby,boulderfist,431,mage,arcane,11,5,6
Larouse,quelthalas,415,mage,arcane,8,5,3
Kynjji,azshara,384,mage,arcane,6,4,2
Rositajonez,terenas,384,mage,arcane,6,4,2
Meroki,anetheron,384,mage,arcane,6,4,2
Cømbust,frostmourne,384,mage,arcane,6,4,2
Imbusting,kiljaeden,384,mage,arcane,6,4,2
Gandwàrf,moon-guard,384,mage,arcane,6,4,2
Gelokay,tichondrius,384,mage,arcane,6,4,2
Dogmagetw,tichondrius,384,mage,arcane,6,4,2
Skoals,thrall,384,mage,arcane,6,4,2
Hasteboy,kelthuzad,384,mage,arcane,6,4,2
Myzzl,kelthuzad,384,mage,arcane,6,4,2
Wanming,tichondrius,384,mage,arcane,6,4,2
Chilléd,tichondrius,384,mage,arcane,6,4,2
Riddickl,malfurion,384,mage,arcane,6,4,2
Bigbuttangel,borean-tundra,384,mage,arcane,12,4,8
Nesomage,destromath,384,mage,arcane,12,4,8
Gobbstoppers,dalaran,384,mage,arcane,12,4,8
Frostecho,moon-guard,384,mage,arcane,12,4,8
Granmago,azralon,384,mage,arcane,12,4,8
Yellowfevrz,thrall,384,mage,arcane,12,4,8
Sukaretto,illidan,384,mage,arcane,12,4,8
Scxut,tichondrius,384,mage,arcane,12,4,8
Khaldyn,tichondrius,384,mage,arcane,12,4,8
Forestella,tichondrius,384,mage,arcane,12,4,8
Jordèb,sargeras,384,mage,arcane,12,4,8
Biotic,kiljaeden,384,mage,arcane,12,4,8
Pwnstarx,proudmoore,384,mage,arcane,12,4,8
Hogslop,saurfang,384,mage,arcane,12,4,8
Muskinite,maiev,384,mage,arcane,12,4,8
Krazsus,tichondrius,384,mage,arcane,12,4,8
Raxxor,muradin,383,mage,arcane,6,4,2
Skoffla,executus,383,mage,arcane,6,4,2
Seaon,malganis,383,mage,arcane,6,4,2
Hànk,tichondrius,383,mage,arcane,6,4,2
Ichor,blackhand,383,mage,arcane,12,4,8
Sènding,sargeras,383,mage,arcane,18,4,14
Preckwinkle,moon-guard,382,mage,arcane,12,4,8
Keepinitnoob,tichondrius,351,mage,arcane,8,5,3
Grarg,stormrage,301,mage,arcane,13,4,9
Madpoondog,frostmourne,288,mage,arcane,6,3,3
Kasius,kelthuzad,288,mage,arcane,6,3,3
Unknownblast,kul-tiras,288,mage,arcane,6,3,3
Lambsalsa,tichondrius,288,mage,arcane,6,3,3
Adrazell,sargeras,288,mage,arcane,6,3,3
Smallbrainz,emerald-dream,288,mage,arcane,6,3,3
Crøwgxd,tichondrius,288,mage,arcane,6,3,3
Freshtowels,thrall,288,mage,arcane,6,3,3
Yaya,kargath,288,mage,arcane,6,3,3
Natzue,sargeras,288,mage,arcane,6,3,3
Fennix,ragnaros,288,mage,arcane,6,3,3
Rotaco,illidan,288,mage,arcane,6,3,3
Weewhimsy,wyrmrest-accord,288,mage,arcane,6,3,3
Bobbyyx,sargeras,288,mage,arcane,6,3,3
Xzude,korgath,288,mage,arcane,6,3,3
Kohvera,frostmourne,288,mage,arcane,6,3,3
Xythros,stormrage,288,mage,arcane,6,3,3
Zerodium,sargeras,288,mage,arcane,6,3,3
Koro,tichondrius,288,mage,arcane,6,3,3
Jizzlez,tichondrius,288,mage,arcane,6,3,3
Triuneward,tichondrius,288,mage,arcane,6,3,3
Braelind,sargeras,288,mage,arcane,6,3,3
Smãlls,sargeras,288,mage,arcane,6,3,3
Neverbroke,illidan,288,mage,arcane,6,3,3
Kogin,thrall,288,mage,arcane,6,3,3
Watchmesleep,tichondrius,288,mage,arcane,6,3,3
Ksauce,twisting-nether,288,mage,arcane,6,3,3
Kev,sentinels,288,mage,arcane,6,3,3
Annalee,ragnaros,288,mage,arcane,6,3,3
Arkanons,azralon,288,mage,arcane,12,5,7
Levalol,aggramar,288,mage,arcane,10,4,6
Heflash,azralon,288,mage,arcane,12,3,9
Skittels,azshara,288,mage,arcane,12,3,9
Elux,whisperwind,288,mage,arcane,12,3,9
Matmagic,drakkari,288,mage,arcane,13,3,10
Compactor,emerald-dream,288,mage,arcane,18,3,15
Kryptekk,area-52,287,mage,arcane,6,3,3
Calcaster,aegwynn,287,mage,arcane,6,3,3
Hýdro,ghostlands,287,mage,arcane,11,3,8
Ìgnìtìöñ,whisperwind,287,mage,arcane,12,3,9
Shinneex,ragnaros,287,mage,arcane,12,3,9
Ottsca,emerald-dream,286,mage,arcane,6,3,3
Arcanin,thunderlord,285,mage,arcane,12,3,9
Sausage,boulderfist,276,mage,arcane,16,6,10
Etyx,tichondrius,239,mage,arcane,5,3,2
Pay,nordrassil,223,mage,arcane,9,3,6
Røcco,azralon,192,mage,arcane,4,3,1
Ferdabombs,tichondrius,192,mage,arcane,6,2,4
Opiumlord,tichondrius,192,mage,arcane,6,2,4
Sheepshot,dentarg,192,mage,arcane,6,2,4
Duffs,hyjal,192,mage,arcane,6,2,4
Fakelovè,area-52,192,mage,arcane,6,2,4
Vengx,tichondrius,192,mage,arcane,6,2,4
Shimmerpoly,sargeras,192,mage,arcane,6,2,4
Mymaage,andorhal,192,mage,arcane,6,2,4
Aenomaus,stormrage,192,mage,arcane,6,2,4
Crinkit,frostmourne,192,mage,arcane,6,2,4
Emden,khadgar,192,mage,arcane,6,2,4
Thistle,boulderfist,192,mage,arcane,6,2,4
Alìv,tichondrius,192,mage,arcane,6,2,4
Chinkins,illidan,192,mage,arcane,6,2,4
Umber,dreadmaul,192,mage,arcane,6,2,4
Blinkmind,stormrage,192,mage,arcane,6,2,4
Burna,amanthul,192,mage,arcane,6,2,4
Maguín,tichondrius,192,mage,arcane,6,2,4
Xpez,stormrage,192,mage,arcane,6,2,4
Xannymancan,tichondrius,192,mage,arcane,6,2,4
Sðsa,stormrage,192,mage,arcane,6,2,4
Blastgodx,stormrage,192,mage,arcane,6,2,4
Caimil,echo-isles,192,mage,arcane,6,2,4
Powerfulguy,frostmourne,192,mage,arcane,6,2,4
Vonfrmdao,illidan,192,mage,arcane,6,2,4
Vensyr,stormrage,192,mage,arcane,6,2,4
Pullmefingy,illidan,192,mage,arcane,6,2,4
Wayferz,illidan,192,mage,arcane,6,2,4
Shareholder,stormrage,192,mage,arcane,6,2,4
Bustercraft,kelthuzad,192,mage,arcane,6,2,4
Polymedaddi,tichondrius,192,mage,arcane,6,2,4
Tarmiel,quelthalas,192,mage,arcane,6,2,4
Lilfruitsnac,illidan,192,mage,arcane,6,2,4
Akunimon,ragnaros,192,mage,arcane,6,2,4
Icebish,skullcrusher,192,mage,arcane,6,2,4
Loa,hydraxis,192,mage,arcane,6,2,4
Morganä,silver-hand,192,mage,arcane,6,2,4
Highafrn,area-52,192,mage,arcane,6,2,4
Amoredis,the-venture-co,192,mage,arcane,12,2,10
Barbarabush,hellscream,192,mage,arcane,12,2,10
Rahahm,altar-of-storms,192,mage,arcane,12,2,10
Gatka,quelthalas,192,mage,arcane,12,2,10
Mcshwackin,area-52,192,mage,arcane,12,2,10
Lifeinaday,proudmoore,191,mage,arcane,6,2,4
Darznath,drakkari,191,mage,arcane,6,2,4
Nevswrld,stormrage,191,mage,arcane,24,2,22
Vengefuly,tichondrius,138,mage,arcane,6,3,3
Milfmaster,aerie-peak,138,mage,arcane,8,3,5
Frostybihh,bonechewer,138,mage,arcane,15,3,12
Sos,kelthuzad,128,mage,arcane,4,2,2
Respektwaman,tichondrius,128,mage,arcane,4,2,2
Pyropie,frostmourne,96,mage,arcane,3,2,1
Purpledrank,nagrand,96,mage,arcane,9,2,7
Pollybot,tichondrius,96,mage,arcane,6,1,5
Pecs,kiljaeden,96,mage,arcane,6,1,5
Magicious,tichondrius,96,mage,arcane,6,1,5
Stëpsister,illidan,96,mage,arcane,6,1,5
Gôøglëlòl,nemesis,96,mage,arcane,6,1,5
Turtles,the-venture-co,96,mage,arcane,6,1,5
Mageki,ragnaros,96,mage,arcane,6,1,5
Telkham,tichondrius,96,mage,arcane,6,1,5
Hvnlyfathr,stormrage,96,mage,arcane,6,1,5
Coldrin,tichondrius,96,mage,arcane,6,1,5
Smôl,emerald-dream,96,mage,arcane,6,1,5
Priyel,hyjal,96,mage,arcane,6,1,5
Singheart,tichondrius,96,mage,arcane,6,1,5
Sabrita,proudmoore,96,mage,arcane,6,1,5
Elemenopi,thrall,96,mage,arcane,6,1,5
Darthez,darkspear,96,mage,arcane,6,1,5
Octané,illidan,96,mage,arcane,6,1,5
Harquillen,dathremar,96,mage,arcane,6,1,5
Hhavok,scarlet-crusade,96,mage,arcane,6,1,5
Noyade,illidan,96,mage,arcane,6,1,5
Trippy,senjin,96,mage,arcane,6,1,5
Quinnfreeze,boulderfist,96,mage,arcane,6,1,5
Xlordpagan,sargeras,96,mage,arcane,6,1,5
Copperfield,dreadmaul,96,mage,arcane,6,1,5
Flomin,tichondrius,96,mage,arcane,6,1,5
Ignit,stormrage,96,mage,arcane,6,1,5
Vanillã,sargeras,96,mage,arcane,6,1,5
Sula,muradin,96,mage,arcane,6,1,5
Genozyde,elune,96,mage,arcane,6,1,5
Burrbon,area-52,96,mage,arcane,6,1,5
Illúmi,moon-guard,96,mage,arcane,6,1,5
Nazztwren,bleeding-hollow,96,mage,arcane,6,1,5
Helloimazu,gilneas,96,mage,arcane,6,1,5
Needmyvape,moon-guard,96,mage,arcane,6,1,5
Nday,tichondrius,96,mage,arcane,11,1,10
Nikittomage,echo-isles,96,mage,arcane,12,1,11
Tovenaars,moon-guard,96,mage,arcane,12,1,11
Sahaquiel,tichondrius,96,mage,arcane,12,1,11
Greaterbust,tichondrius,96,mage,arcane,12,1,11
Kralien,dalaran,95,mage,arcane,6,1,5
Poofnpass,malorne,95,mage,arcane,6,1,5
Scribe,anvilmar,79,mage,arcane,5,1,4
Pyroeuphoria,dark-iron,79,mage,arcane,5,1,4
Frostmaul,dreadmaul,79,mage,arcane,11,1,10
Mokelovinwtf,tichondrius,48,mage,arcane,3,1,2
Mkownzz,tichondrius,16,mage,arcane,1,1,0
Sol,shandris,2263,mage,fire,114,60,54
Vcamus,tichondrius,2226,mage,fire,176,95,81
Ranj,tichondrius,2211,mage,fire,115,60,55
Hansol,farstriders,2197,mage,fire,120,62,58
Setback,illidan,2177,mage,fire,156,80,76
Fixrexbaxlls,tichondrius,2155,mage,fire,143,87,56
Talibandzx,sargeras,2134,mage,fire,189,95,94
Setbackx,illidan,2125,mage,fire,102,51,51
Asetback,illidan,2124,mage,fire,180,91,89
Johnpopi,malganis,2119,mage,fire,60,42,18
Poundcakezx,tichondrius,2115,mage,fire,72,43,29
Horoba,sargeras,2107,mage,fire,305,154,151
Aangx,stormrage,2102,mage,fire,58,37,21
Valériemeow,tichondrius,2097,mage,fire,115,57,58
Taylorlol,tichondrius,2090,mage,fire,153,76,77
Numbing,sargeras,2087,mage,fire,66,45,21
Aeghis,stormrage,2083,mage,fire,60,33,27
Benisp,stormrage,2070,mage,fire,98,56,42
Kyphosis,illidan,2054,mage,fire,119,71,48
Bigfirebat,tichondrius,2046,mage,fire,233,119,114
Epod,illidan,2024,mage,fire,125,66,59
Kasperkar,illidan,2018,mage,fire,340,173,167
Adjudicatory,tichondrius,2003,mage,fire,69,34,35
Undeadmerlin,zuljin,1985,mage,fire,72,39,33
Gohonn,emerald-dream,1978,mage,fire,195,108,87
Xiaoxiaochu,tichondrius,1973,mage,fire,205,119,86
Snaregodx,area-52,1972,mage,fire,60,37,23
Vcamusorz,tichondrius,1970,mage,fire,166,87,79
Udmx,zuljin,1959,mage,fire,91,54,37
Glacier,firetree,1955,mage,fire,50,35,15
Opisop,kelthuzad,1944,mage,fire,66,37,29
Dáddyshark,sargeras,1944,mage,fire,205,99,106
Getmaged,bleeding-hollow,1943,mage,fire,64,40,24
Háté,ragnaros,1931,mage,fire,217,106,111
Purpscurp,illidan,1923,mage,fire,183,101,82
Elysõna,area-52,1922,mage,fire,189,114,75
Peachygamer,stormscale,1921,mage,fire,198,99,99
Starxen,tichondrius,1915,mage,fire,54,31,23
Sorankim,tichondrius,1893,mage,fire,54,30,24
Myzzl,kelthuzad,1875,mage,fire,99,48,51
Juniel,bleeding-hollow,1874,mage,fire,41,27,14
Vazlgs,tichondrius,1872,mage,fire,78,44,34
Rmxd,malganis,1870,mage,fire,102,54,48
Nightsaber,blackrock,1869,mage,fire,42,26,16
Kindle,malorne,1869,mage,fire,110,65,45
Ròÿ,area-52,1861,mage,fire,72,37,35
Yorgøs,ragnaros,1851,mage,fire,96,53,43
Sunskim,tichondrius,1851,mage,fire,76,37,39
Julzx,hyjal,1848,mage,fire,42,27,15
Zoryack,azralon,1848,mage,fire,204,106,98
Cryogeniks,illidan,1843,mage,fire,60,32,28
Degen,laughing-skull,1842,mage,fire,46,31,15
Ksmackm,illidan,1842,mage,fire,65,34,31
Notini,azralon,1841,mage,fire,185,91,94
Neät,frostmourne,1840,mage,fire,49,31,18
Highms,stormrage,1839,mage,fire,78,44,34
Yaya,kargath,1838,mage,fire,123,62,61
Wanming,tichondrius,1831,mage,fire,78,44,34
Daddymayhem,proudmoore,1831,mage,fire,144,75,69
Pinkmagetko,tichondrius,1830,mage,fire,48,26,22
Vampìrelolz,tichondrius,1828,mage,fire,47,25,22
Volkazar,sargeras,1828,mage,fire,51,24,27
Mângo,frostmourne,1826,mage,fire,36,26,10
Csx,turalyon,1826,mage,fire,132,73,59
Cinnablast,darkspear,1824,mage,fire,26,20,6
Fwooshinator,malganis,1823,mage,fire,71,56,15
Dagreatone,malganis,1822,mage,fire,64,31,33
Dmgdaddy,zuljin,1822,mage,fire,42,20,22
Såni,tichondrius,1819,mage,fire,67,39,28
Téhflip,tichondrius,1818,mage,fire,60,37,23
Gôøglëlòl,nemesis,1818,mage,fire,122,72,50
Likebutter,tichondrius,1816,mage,fire,54,33,21
Kraxos,stormrage,1814,mage,fire,108,62,46
Ogfresh,area-52,1808,mage,fire,100,63,37
Sorcerous,bloodhoof,1807,mage,fire,205,114,91
Creaystar,area-52,1807,mage,fire,322,165,157
Blak,bleeding-hollow,1805,mage,fire,48,32,16
Wiredcc,illidan,1805,mage,fire,30,20,10
Bigdjohnson,dalaran,1802,mage,fire,84,45,39
Wotl,tichondrius,1801,mage,fire,247,134,113
Juju,tichondrius,1796,mage,fire,75,44,31
Itrinketair,area-52,1793,mage,fire,30,19,11
Lmaginedying,illidan,1780,mage,fire,42,25,17
Blockjkdead,frostmourne,1776,mage,fire,44,30,14
Easyfreeze,sargeras,1775,mage,fire,48,27,21
Snoogma,illidan,1772,mage,fire,41,30,11
Thxo,hyjal,1772,mage,fire,135,70,65
Squidio,stormrage,1771,mage,fire,42,25,17
Charkoalzz,moon-guard,1771,mage,fire,71,34,37
Alenikus,blackhand,1763,mage,fire,173,91,82
Käxs,ragnaros,1762,mage,fire,42,21,21
Elfmage,tichondrius,1759,mage,fire,42,25,17
Fmpenjoyerx,illidan,1757,mage,fire,36,24,12
Mana,shuhalo,1755,mage,fire,51,36,15
Blinkaway,ragnaros,1750,mage,fire,84,46,38
Deepgodsz,azralon,1738,mage,fire,51,28,23
Gelußabadook,kelthuzad,1733,mage,fire,36,24,12
Dexpy,tichondrius,1732,mage,fire,43,26,17
Farragan,ragnaros,1732,mage,fire,48,21,27
Stergenutfr,tichondrius,1720,mage,fire,42,27,15
Xs,stormrage,1715,mage,fire,178,103,75
Uhh,blackrock,1715,mage,fire,40,20,20
Xythros,stormrage,1711,mage,fire,30,18,12
Darmora,kelthuzad,1709,mage,fire,36,22,14
Wizarts,ragnaros,1704,mage,fire,78,34,44
Iblïs,kelthuzad,1702,mage,fire,30,22,8
Bigpøppapump,tichondrius,1701,mage,fire,48,25,23
Jazzgroyper,sargeras,1697,mage,fire,42,24,18
Affewxd,lothar,1695,mage,fire,171,95,76
Younghehe,tichondrius,1692,mage,fire,148,77,71
Myrondor,tichondrius,1691,mage,fire,106,60,46
Magekylex,proudmoore,1690,mage,fire,164,96,68
Banquetmeal,emerald-dream,1687,mage,fire,48,30,18
Benjamming,ragnaros,1687,mage,fire,48,30,18
Ufree,tichondrius,1679,mage,fire,47,26,21
Chumpp,tichondrius,1677,mage,fire,42,27,15
Lolololololo,kelthuzad,1675,mage,fire,240,127,113
Nickioxox,tichondrius,1674,mage,fire,24,18,6
Bighot,tichondrius,1673,mage,fire,90,53,37
Freaknastyxo,stormrage,1673,mage,fire,48,26,22
Englavian,frostmane,1673,mage,fire,72,35,37
Muztaccio,tichondrius,1671,mage,fire,89,48,41
Ligmmah,stormrage,1670,mage,fire,78,45,33
Dropdeadlol,bonechewer,1669,mage,fire,96,55,41
Hööva,illidan,1667,mage,fire,119,69,50
Ööf,emerald-dream,1667,mage,fire,72,33,39
Asap,frostmourne,1666,mage,fire,48,26,22
Xoese,illidan,1665,mage,fire,162,80,82
Proximalol,tichondrius,1664,mage,fire,29,23,6
Oi,frostwolf,1664,mage,fire,81,52,29
Frostymart,arthas,1663,mage,fire,36,23,13
Neverbløck,illidan,1661,mage,fire,42,24,18
Pyrod,tichondrius,1660,mage,fire,70,38,32
Poonfarmer,zangarmarsh,1659,mage,fire,42,27,15
Hadlly,tichondrius,1659,mage,fire,29,18,11
Albbano,tichondrius,1655,mage,fire,36,24,12
Enthy,frostmourne,1653,mage,fire,66,34,32
Magibe,thrall,1652,mage,fire,36,24,12
Itshug,area-52,1652,mage,fire,53,27,26
Globglob,tichondrius,1651,mage,fire,40,26,14
Lycheeoolong,frostmourne,1649,mage,fire,38,22,16
Salvick,emerald-dream,1645,mage,fire,70,35,35
Akephálos,drakkari,1643,mage,fire,35,21,14
Chainpoly,area-52,1639,mage,fire,49,32,17
Leonr,tichondrius,1639,mage,fire,109,68,41
Pootysmooch,sargeras,1639,mage,fire,54,33,21
Biscobush,turalyon,1636,mage,fire,42,27,15
Sahlokinn,stormrage,1636,mage,fire,54,28,26
Jenezis,area-52,1636,mage,fire,59,28,31
Chionê,velen,1634,mage,fire,30,18,12
Fantabulous,korgath,1633,mage,fire,42,26,16
Merlu,silver-hand,1632,mage,fire,36,23,13
Zoobiz,tichondrius,1632,mage,fire,45,26,19
Rockoe,tichondrius,1631,mage,fire,88,50,38
Trippy,senjin,1630,mage,fire,60,30,30
Vengefuly,tichondrius,1629,mage,fire,54,33,21
Garbagemage,barthilas,1628,mage,fire,84,46,38
Ârcano,ragnaros,1628,mage,fire,53,29,24
Emvepee,sargeras,1627,mage,fire,24,17,7
Murcury,tichondrius,1627,mage,fire,309,160,149
Mudohir,stormrage,1627,mage,fire,58,29,29
Sandylove,zuljin,1627,mage,fire,42,20,22
Mxdeez,tichondrius,1626,mage,fire,45,33,12
Worldonfire,ragnaros,1626,mage,fire,201,107,94
Jardz,area-52,1625,mage,fire,48,25,23
Marfaz,ravencrest,1623,mage,fire,126,65,61
Tweydey,tichondrius,1621,mage,fire,30,17,13
Icetomeetyu,bleeding-hollow,1621,mage,fire,201,97,104
Domotricks,illidan,1620,mage,fire,71,39,32
Corinthiax,wyrmrest-accord,1616,mage,fire,81,43,38
Coolhandz,tichondrius,1615,mage,fire,65,38,27
Nazmagus,hydraxis,1612,mage,fire,125,72,53
Formi,frostmourne,1611,mage,fire,88,41,47
Kawailenard,tichondrius,1610,mage,fire,30,22,8
Anuub,kelthuzad,1610,mage,fire,66,39,27
Hpthewizard,deathwing,1610,mage,fire,95,56,39
Kevymarts,tichondrius,1609,mage,fire,72,45,27
Marxeflamer,ragnaros,1609,mage,fire,50,26,24
Gigatuts,stormrage,1609,mage,fire,73,37,36
Sïthfù,tichondrius,1605,mage,fire,48,30,18
Zarkanis,tichondrius,1604,mage,fire,49,25,24
Choccookies,illidan,1603,mage,fire,38,19,19
Fookz,malganis,1602,mage,fire,90,50,40
Mushys,stormrage,1601,mage,fire,35,22,13
Grynthwzrd,stormrage,1601,mage,fire,60,37,23
Yooyar,barthilas,1601,mage,fire,221,113,108
Polypolypoly,kiljaeden,1597,mage,fire,63,37,26
Firewreckage,malganis,1594,mage,fire,74,35,39
Minverces,tichondrius,1593,mage,fire,54,33,21
Sakurai,tichondrius,1593,mage,fire,48,28,20
Tuniepop,sargeras,1592,mage,fire,94,45,49
Vênsêr,emerald-dream,1591,mage,fire,36,20,16
Kraftfull,azralon,1590,mage,fire,31,18,13
Original,ysera,1590,mage,fire,36,20,16
Omagawd,tichondrius,1590,mage,fire,36,18,18
Velvetlurker,tichondrius,1588,mage,fire,30,17,13
Kev,sentinels,1587,mage,fire,132,71,61
Xuxä,stormrage,1585,mage,fire,37,22,15
Torched,stormreaver,1585,mage,fire,108,53,55
Varroc,quelthalas,1585,mage,fire,256,122,134
Coôler,illidan,1583,mage,fire,199,104,95
Orionmage,frostmourne,1583,mage,fire,57,29,28
Bhabynahnah,tichondrius,1582,mage,fire,30,20,10
Pzaz,moon-guard,1582,mage,fire,50,30,20
Iceward,frostmourne,1579,mage,fire,66,30,36
Engage,garrosh,1578,mage,fire,48,29,19
Swaglo,illidan,1578,mage,fire,46,22,24
Wqnmlgbdy,tichondrius,1575,mage,fire,36,19,17
Syntacks,lightnings-blade,1574,mage,fire,66,41,25
Absentbrain,stormrage,1570,mage,fire,36,20,16
Toroy,wyrmrest-accord,1566,mage,fire,30,18,12
Dârkus,sargeras,1565,mage,fire,134,69,65
Waffles,ravencrest,1561,mage,fire,110,62,48
Audacy,sargeras,1561,mage,fire,161,81,80
Djpolymorph,stormrage,1560,mage,fire,108,60,48
Mageonthc,korgath,1557,mage,fire,89,49,40
Marrioo,tichondrius,1556,mage,fire,60,31,29
Willzada,azralon,1555,mage,fire,87,44,43
Sabrita,proudmoore,1552,mage,fire,78,38,40
Crazytime,tichondrius,1550,mage,fire,66,36,30
Wickymorph,barthilas,1549,mage,fire,53,25,28
Arrcadia,darkspear,1548,mage,fire,58,29,29
Yeetcannøn,illidan,1546,mage,fire,54,27,27
Trolson,sargeras,1546,mage,fire,54,26,28
Ferdabombs,tichondrius,1544,mage,fire,130,73,57
Eazzybaby,eredar,1541,mage,fire,660,341,319
Lilbabyx,stormrage,1540,mage,fire,128,67,61
Diewnuts,zuljin,1539,mage,fire,126,68,58
Imannoyingha,darkspear,1536,mage,fire,89,47,42
Zstyle,frostmourne,1533,mage,fire,89,55,34
Xanthan,runetotem,1532,mage,fire,72,41,31
Ultrá,stormscale,1528,mage,fire,84,49,35
Bajaoreily,zangarmarsh,1528,mage,fire,42,19,23
Almondcocoa,tichondrius,1526,mage,fire,36,16,20
Pecs,kiljaeden,1523,mage,fire,36,16,20
Stickylol,tichondrius,1522,mage,fire,30,16,14
Dreadparadox,bleeding-hollow,1521,mage,fire,76,37,39
Jonboym,illidan,1519,mage,fire,36,22,14
Sparklepoof,tichondrius,1519,mage,fire,47,26,21
Teetems,sargeras,1516,mage,fire,146,74,72
Squishymage,frostmourne,1515,mage,fire,37,19,18
Gadgítte,moon-guard,1514,mage,fire,30,18,12
Toastedoats,hyjal,1514,mage,fire,109,59,50
Fredcouples,tichondrius,1513,mage,fire,42,25,17
Øzmage,area-52,1509,mage,fire,33,21,12
Maplemage,akama,1509,mage,fire,114,66,48
Mager,dentarg,1508,mage,fire,62,40,22
Fruitdealerr,tichondrius,1508,mage,fire,96,49,47
Gimilzor,arthas,1507,mage,fire,96,55,41
Coneofkony,bleeding-hollow,1503,mage,fire,36,23,13
Blinkmind,stormrage,1501,mage,fire,30,16,14
Chickenspank,stormrage,1498,mage,fire,42,22,20
Pòlly,illidan,1495,mage,fire,42,25,17
Tigang,frostmourne,1492,mage,fire,92,50,42
Pyroshima,barthilas,1492,mage,fire,101,49,52
Crnomage,area-52,1490,mage,fire,35,18,17
Singheart,tichondrius,1487,mage,fire,180,90,90
Smallbrainz,emerald-dream,1485,mage,fire,84,47,37
Cam,kul-tiras,1484,mage,fire,66,37,29
Fifthelëment,emerald-dream,1484,mage,fire,137,73,64
Beerandmagic,zuljin,1482,mage,fire,36,17,19
Faetalm,tichondrius,1480,mage,fire,84,39,45
Hotrunner,sargeras,1479,mage,fire,29,16,13
Jojomage,thrall,1473,mage,fire,138,71,67
Sheepxyz,thrall,1472,mage,fire,70,33,37
Jööz,deathwing,1470,mage,fire,81,40,41
Anàrchy,emerald-dream,1469,mage,fire,51,29,22
Hannahaa,area-52,1468,mage,fire,63,35,28
Connorq,stormrage,1467,mage,fire,62,35,27
Pyroflinger,stormrage,1463,mage,fire,151,77,74
Ålmøst,tichondrius,1461,mage,fire,71,41,30
Frostpimp,anubarak,1460,mage,fire,60,22,38
Magicmaghar,area-52,1456,mage,fire,78,38,40
Aerligar,area-52,1455,mage,fire,36,20,16
Frogbum,fizzcrank,1454,mage,fire,34,19,15
Squantanimo,shadowmoon,1454,mage,fire,117,55,62
Ruzam,area-52,1450,mage,fire,72,36,36
Bettybonk,cenarius,1449,mage,fire,42,20,22
Polymedaddi,tichondrius,1449,mage,fire,70,28,42
Grymorum,ragnaros,1448,mage,fire,42,18,24
Jundead,dalaran,1445,mage,fire,85,50,35
Skryte,mannoroth,1445,mage,fire,70,35,35
Mariomario,tichondrius,1444,mage,fire,102,55,47
Firèballin,tichondrius,1441,mage,fire,31,17,14
Gasolína,stormrage,1436,mage,fire,84,48,36
Grandpapi,arthas,1433,mage,fire,35,20,15
Sorgannon,malganis,1432,mage,fire,100,53,47
Juul,emerald-dream,1430,mage,fire,156,75,81
Streetember,nemesis,1424,mage,fire,84,36,48
Dårks,area-52,1423,mage,fire,36,17,19
Snanth,black-dragonflight,1420,mage,fire,57,32,25
Elwyn,dunemaul,1415,mage,fire,66,34,32
Skoffla,executus,1411,mage,fire,48,25,23
Aarne,thrall,1410,mage,fire,42,20,22
Eekzlol,illidan,1409,mage,fire,30,16,14
Snuurf,ragnaros,1406,mage,fire,66,34,32
Etyx,tichondrius,1404,mage,fire,60,26,34
Nerfdestro,illidan,1403,mage,fire,30,16,14
Ingrumatig,tichondrius,1402,mage,fire,66,31,35
Morbøl,tichondrius,1401,mage,fire,40,25,15
Mayumî,moon-guard,1401,mage,fire,34,18,16
Quikcast,archimonde,1401,mage,fire,36,15,21
Coldcaster,mugthol,1399,mage,fire,80,45,35
Whiteyx,saurfang,1399,mage,fire,52,29,23
Cumbus,stormrage,1399,mage,fire,42,15,27
Discoinferno,kelthuzad,1398,mage,fire,29,16,13
Jjijuns,tichondrius,1398,mage,fire,86,44,42
Sydrol,area-52,1392,mage,fire,149,77,72
Jizzlez,tichondrius,1392,mage,fire,48,23,25
Isendra,bleeding-hollow,1391,mage,fire,47,23,24
Yugedamn,nazjatar,1390,mage,fire,42,25,17
Ject,ragnaros,1389,mage,fire,22,16,6
Slicktrik,area-52,1387,mage,fire,29,15,14
Purpledrank,nagrand,1385,mage,fire,85,39,46
Leaso,tichondrius,1384,mage,fire,45,22,23
Marajaade,tichondrius,1384,mage,fire,107,51,56
Tamarolfrost,illidan,1382,mage,fire,55,29,26
Wïzarduous,mannoroth,1380,mage,fire,78,41,37
Linkolni,azralon,1377,mage,fire,36,15,21
Flavaflame,mugthol,1376,mage,fire,42,24,18
Aliive,tichondrius,1375,mage,fire,30,16,14
Hempy,mannoroth,1374,mage,fire,67,31,36
Eatnu,tichondrius,1374,mage,fire,36,16,20
Amge,uldum,1373,mage,fire,26,15,11
Midewmage,proudmoore,1372,mage,fire,47,20,27
Wzrdxz,tichondrius,1370,mage,fire,36,17,19
Melkra,tichondrius,1366,mage,fire,70,35,35
Garungar,antonidas,1361,mage,fire,24,15,9
Coltrip,azralon,1359,mage,fire,83,38,45
Frðstítutè,tichondrius,1357,mage,fire,30,16,14
Magiaguarra,ragnaros,1353,mage,fire,36,17,19
Wakkaflame,stormrage,1348,mage,fire,78,33,45
Flame,arthas,1346,mage,fire,54,28,26
Prinseza,quelthalas,1345,mage,fire,55,27,28
Badaszbich,tichondrius,1344,mage,fire,36,20,16
Sikeyzlol,bleeding-hollow,1343,mage,fire,24,14,10
Papita,mugthol,1342,mage,fire,18,14,4
Smigui,azralon,1342,mage,fire,188,92,96
Mageyoulooks,shattered-hand,1341,mage,fire,36,19,17
Raisonmage,tichondrius,1341,mage,fire,96,44,52
Lightsoran,tichondrius,1340,mage,fire,24,14,10
Codeine,darkspear,1339,mage,fire,29,18,11
Cubanmage,drakkari,1336,mage,fire,24,15,9
Subscribe,malganis,1336,mage,fire,48,22,26
Zerathremar,proudmoore,1335,mage,fire,27,15,12
Dearasian,ragnaros,1335,mage,fire,60,32,28
Búrsting,kelthuzad,1334,mage,fire,31,16,15
Bis,aggramar,1333,mage,fire,24,14,10
Sahala,frostmourne,1333,mage,fire,60,25,35
Gødvana,frostmourne,1329,mage,fire,51,28,23
Lilmj,kelthuzad,1327,mage,fire,49,21,28
Alzagen,ragnaros,1326,mage,fire,92,47,45
Unknownblast,kul-tiras,1326,mage,fire,32,14,18
Sky,lightnings-blade,1324,mage,fire,33,16,17
Högnues,tichondrius,1323,mage,fire,24,14,10
Archtype,azralon,1321,mage,fire,24,17,7
Nukeit,azgalor,1320,mage,fire,48,23,25
Coldrin,tichondrius,1320,mage,fire,58,27,31
Carnelius,bleeding-hollow,1319,mage,fire,75,39,36
Majjix,illidan,1318,mage,fire,24,14,10
Alàh,stormscale,1318,mage,fire,40,19,21
Kushjointz,tichondrius,1317,mage,fire,24,14,10
Mirimida,ragnaros,1315,mage,fire,255,130,125
Magination,frostmourne,1313,mage,fire,48,22,26
Quizzard,blackrock,1310,mage,fire,28,15,13
Snoü,proudmoore,1309,mage,fire,42,14,28
Raynark,nemesis,1307,mage,fire,30,18,12
Cymbalta,azralon,1306,mage,fire,47,31,16
Xunalatu,frostmourne,1303,mage,fire,36,20,16
Supermajor,frostmourne,1301,mage,fire,49,24,25
Jnxzx,sargeras,1298,mage,fire,24,15,9
Putridìty,thrall,1293,mage,fire,36,22,14
Christjan,tichondrius,1292,mage,fire,271,140,131
Cokézero,frostmourne,1292,mage,fire,30,15,15
Rudeswizard,area-52,1291,mage,fire,73,32,41
Hypernova,vashj,1277,mage,fire,41,19,22
Adrazell,sargeras,1275,mage,fire,48,22,26
Vecna,tichondrius,1269,mage,fire,30,18,12
Helcarwen,area-52,1261,mage,fire,60,30,30
Adronicus,tichondrius,1259,mage,fire,66,33,33
Licklix,tichondrius,1258,mage,fire,52,30,22
Zulugara,barthilas,1258,mage,fire,36,19,17
Rizzlerx,stormrage,1257,mage,fire,17,14,3
Absolutepowa,bleeding-hollow,1255,mage,fire,26,14,12
Abzy,sargeras,1254,mage,fire,84,41,43
Reddfire,proudmoore,1253,mage,fire,42,15,27
Lorlene,frostmourne,1252,mage,fire,54,27,27
Babysharky,uther,1249,mage,fire,34,14,20
Glaucus,illidan,1247,mage,fire,18,13,5
Gominsi,tichondrius,1247,mage,fire,18,13,5
Burstyboi,frostmourne,1247,mage,fire,25,16,9
Chapelrat,sargeras,1247,mage,fire,24,13,11
Fullsénd,tichondrius,1247,mage,fire,24,13,11
Leakyboots,illidan,1247,mage,fire,24,13,11
Whilly,nagrand,1246,mage,fire,39,17,22
Hüz,frostmourne,1244,mage,fire,18,13,5
Hittheshower,tichondrius,1241,mage,fire,24,13,11
Kronicblast,bleeding-hollow,1240,mage,fire,63,26,37
Mageyoulooks,kelthuzad,1240,mage,fire,36,14,22
Gualter,nemesis,1239,mage,fire,36,15,21
Feogato,proudmoore,1237,mage,fire,60,29,31
Blinksz,korgath,1235,mage,fire,30,13,17
Politeness,tichondrius,1233,mage,fire,24,13,11
Mongomike,stormrage,1233,mage,fire,69,30,39
Joobi,sargeras,1232,mage,fire,36,13,23
Christensen,stormrage,1231,mage,fire,30,17,13
Slumpgodd,frostmourne,1230,mage,fire,30,13,17
Dorkski,bleeding-hollow,1225,mage,fire,187,88,99
Dragonie,nordrassil,1224,mage,fire,45,23,22
Psycles,dragonmaw,1223,mage,fire,54,21,33
Zinnos,tichondrius,1218,mage,fire,30,13,17
Vanairel,emerald-dream,1216,mage,fire,30,18,12
Genthruz,ragnaros,1215,mage,fire,48,22,26
Fíery,blades-edge,1211,mage,fire,90,42,48
Halfsquad,malfurion,1208,mage,fire,24,13,11
Pyrotactics,sargeras,1205,mage,fire,46,17,29
Agoniey,illidan,1204,mage,fire,23,13,10
Mageolisious,kelthuzad,1197,mage,fire,52,24,28
Icewrld,nemesis,1193,mage,fire,32,14,18
Zancro,ragnaros,1189,mage,fire,42,17,25
Hositonet,malganis,1188,mage,fire,78,40,38
Sorrenton,sargeras,1186,mage,fire,41,23,18
Burist,illidan,1185,mage,fire,38,19,19
Esfire,frostmourne,1185,mage,fire,48,23,25
Clapsyou,illidan,1182,mage,fire,36,14,22
Vamkari,ragnaros,1178,mage,fire,42,23,19
Eanur,azralon,1178,mage,fire,43,16,27
Zonmague,drakkari,1177,mage,fire,36,17,19
Letitgoo,azralon,1175,mage,fire,61,26,35
Novice,barthilas,1173,mage,fire,35,18,17
Arcánè,velen,1172,mage,fire,23,13,10
Othokk,tichondrius,1170,mage,fire,48,21,27
Certifried,emerald-dream,1169,mage,fire,26,13,13
Iguanodon,proudmoore,1159,mage,fire,56,29,27
Gradmage,proudmoore,1156,mage,fire,50,20,30
Coldblooded,zuljin,1153,mage,fire,68,29,39
Maxvila,kelthuzad,1152,mage,fire,18,12,6
Itension,tichondrius,1152,mage,fire,27,16,11
Technique,tichondrius,1151,mage,fire,18,12,6
Nbapinktrex,darkspear,1151,mage,fire,18,12,6
Kjuuler,moon-guard,1151,mage,fire,24,12,12
Mágos,stormrage,1150,mage,fire,18,12,6
Rhykx,malganis,1149,mage,fire,18,12,6
Frozun,sargeras,1148,mage,fire,18,12,6
Balmunc,proudmoore,1147,mage,fire,18,12,6
Aulle,whisperwind,1146,mage,fire,18,12,6
Cána,stormrage,1143,mage,fire,37,17,20
Fleët,tichondrius,1139,mage,fire,18,12,6
Drippymack,sargeras,1137,mage,fire,22,13,9
Nachtt,sargeras,1136,mage,fire,24,12,12
Usirfail,bleeding-hollow,1133,mage,fire,30,12,18
Gnarwallx,stormrage,1132,mage,fire,30,12,18
Trevihl,malganis,1131,mage,fire,32,16,16
Xzilence,aerie-peak,1118,mage,fire,30,12,18
Pyrepad,moon-guard,1112,mage,fire,30,15,15
Sánzunokawa,quelthalas,1109,mage,fire,27,16,11
Aphazia,kiljaeden,1104,mage,fire,54,28,26
Boptimus,moonrunner,1103,mage,fire,30,17,13
Noescaping,illidan,1102,mage,fire,24,12,12
Priyel,hyjal,1101,mage,fire,36,17,19
Saladguy,thrall,1101,mage,fire,48,17,31
Noyade,illidan,1099,mage,fire,24,12,12
Wawakun,ragnaros,1098,mage,fire,42,19,23
Baelthezer,moon-guard,1095,mage,fire,28,16,12
Gempette,tichondrius,1095,mage,fire,23,12,11
Wazzerd,moon-guard,1093,mage,fire,27,12,15
Frogpapi,illidan,1086,mage,fire,64,31,33
Guccilaflur,proudmoore,1082,mage,fire,27,12,15
Pyromaster,emerald-dream,1071,mage,fire,30,13,17
Pikoda,azralon,1066,mage,fire,28,12,16
Hýdro,ghostlands,1063,mage,fire,84,47,37
Exiledmage,area-52,1056,mage,fire,12,11,1
Fuegomage,tichondrius,1055,mage,fire,18,11,7
Flaux,sargeras,1055,mage,fire,18,11,7
Porthúb,illidan,1054,mage,fire,18,11,7
Piratecaster,kargath,1054,mage,fire,18,11,7
Alorae,wyrmrest-accord,1054,mage,fire,18,11,7
Dbox,stormscale,1054,mage,fire,18,11,7
Lavarain,illidan,1054,mage,fire,27,11,16
Avicci,shattered-halls,1054,mage,fire,30,11,19
Chanko,bleeding-hollow,1052,mage,fire,24,11,13
Muhfin,tichondrius,1051,mage,fire,24,11,13
Cinns,moon-guard,1051,mage,fire,24,11,13
Kazare,quelthalas,1051,mage,fire,39,16,23
Orianne,windrunner,1050,mage,fire,31,21,10
Kiz,zuljin,1050,mage,fire,24,11,13
Radakos,emerald-dream,1050,mage,fire,24,11,13
Magalí,nemesis,1049,mage,fire,78,33,45
Harlloo,the-underbog,1049,mage,fire,30,11,19
Kryptekk,area-52,1048,mage,fire,24,11,13
Pyroeuphoria,dark-iron,1044,mage,fire,32,13,19
Erlendr,moon-guard,1042,mage,fire,46,23,23
Xenagozs,antonidas,1042,mage,fire,24,11,13
Scmage,exodar,1040,mage,fire,30,11,19
Freez,garona,1037,mage,fire,27,12,15
Vaxís,proudmoore,1032,mage,fire,18,11,7
Daggoe,nazjatar,1032,mage,fire,24,11,13
Palruki,tichondrius,1030,mage,fire,23,11,12
Sasghengis,frostmourne,1029,mage,fire,66,33,33
Zniper,emerald-dream,1027,mage,fire,78,40,38
Søkø,tichondrius,1021,mage,fire,38,18,20
Asönia,illidan,1020,mage,fire,30,11,19
Suicune,area-52,1019,mage,fire,23,11,12
Suhzero,skullcrusher,1005,mage,fire,24,13,11
Minerves,tichondrius,1001,mage,fire,28,13,15
Theodosa,frostmourne,988,mage,fire,18,11,7
Ispell,tichondrius,983,mage,fire,115,49,66
Shashyta,drakkari,974,mage,fire,66,18,48
Hotjazzfarts,sargeras,971,mage,fire,67,37,30
Ops,frostmourne,971,mage,fire,154,80,74
Endmepls,ysera,965,mage,fire,96,40,56
Mithroyy,tichondrius,960,mage,fire,12,10,2
Cruelhabbits,tichondrius,960,mage,fire,12,10,2
Loopsyliu,stormrage,960,mage,fire,12,10,2
Deathlist,frostmourne,960,mage,fire,12,10,2
Aeg,stormrage,960,mage,fire,18,10,8
Refreshments,bleeding-hollow,960,mage,fire,18,10,8
Tupactopus,tichondrius,960,mage,fire,18,10,8
Littlejay,kelthuzad,960,mage,fire,18,10,8
Pollybot,tichondrius,959,mage,fire,12,10,2
Mokelovin,sargeras,959,mage,fire,18,10,8
Astanadora,tichondrius,959,mage,fire,18,10,8
Thalanar,barthilas,959,mage,fire,18,10,8
Vîgïl,feathermoon,959,mage,fire,18,10,8
Pendrake,sargeras,958,mage,fire,18,10,8
Zakume,stormrage,958,mage,fire,18,10,8
Büki,kelthuzad,957,mage,fire,18,10,8
Osh,malorne,957,mage,fire,24,10,14
Preceptør,azralon,957,mage,fire,24,10,14
Alunarassra,tichondrius,956,mage,fire,24,10,14
Ripburn,stormrage,953,mage,fire,47,20,27
Zukoprince,azralon,950,mage,fire,12,10,2
Béssie,area-52,950,mage,fire,72,38,34
Grisherina,quelthalas,949,mage,fire,30,10,20
Brànd,antonidas,947,mage,fire,18,11,7
Abstractgoat,tichondrius,946,mage,fire,30,15,15
Trollsita,thrall,945,mage,fire,18,10,8
Pwnbolt,sargeras,943,mage,fire,17,10,7
Senegau,azralon,940,mage,fire,71,35,36
Ashex,moon-guard,938,mage,fire,30,11,19
Rammers,coilfang,935,mage,fire,12,10,2
Zendrix,bonechewer,933,mage,fire,36,13,23
Skywalkerino,azralon,932,mage,fire,18,10,8
Trepid,illidan,931,mage,fire,30,13,17
Coldarei,nagrand,928,mage,fire,27,12,15
Bloomper,stormrage,928,mage,fire,63,20,43
Xxnova,moon-guard,927,mage,fire,30,11,19
Dojacute,frostmourne,910,mage,fire,17,10,7
Bàttlemage,nagrand,898,mage,fire,64,32,32
Alywgard,sargeras,894,mage,fire,22,10,12
Beji,frostmourne,894,mage,fire,38,17,21
Alaramaria,sargeras,886,mage,fire,18,10,8
Jaywazz,tichondrius,879,mage,fire,13,10,3
Jaysaucetv,tichondrius,878,mage,fire,19,10,9
Tungstentoes,shuhalo,875,mage,fire,21,12,9
Nakana,area-52,875,mage,fire,52,25,27
Strêss,kelthuzad,870,mage,fire,22,12,10
Edgkey,illidan,864,mage,fire,12,9,3
Wkndxo,emerald-dream,864,mage,fire,12,9,3
Itizar,frostmourne,864,mage,fire,12,9,3
Tribes,dalaran,864,mage,fire,12,9,3
Ñïz,bleeding-hollow,864,mage,fire,18,9,9
Amage,drakthul,864,mage,fire,18,9,9
Fullsheep,emerald-dream,863,mage,fire,12,9,3
Trés,ragnaros,863,mage,fire,12,9,3
Dabsx,moon-guard,863,mage,fire,18,9,9
Gtown,kelthuzad,863,mage,fire,18,9,9
Ddouble,tichondrius,863,mage,fire,18,9,9
Maxtorgar,quelthalas,863,mage,fire,18,9,9
Shimmerpoly,sargeras,863,mage,fire,24,9,15
Avócadó,malganis,863,mage,fire,24,9,15
Desfunz,mugthol,862,mage,fire,18,9,9
Kawner,crushridge,862,mage,fire,18,9,9
Bigmêan,boulderfist,862,mage,fire,18,9,9
Nevercs,malganis,861,mage,fire,12,9,3
Garion,moon-guard,860,mage,fire,20,9,11
Muffhugga,dalaran,860,mage,fire,24,9,15
Magja,bloodhoof,859,mage,fire,18,9,9
Skynhet,ragnaros,859,mage,fire,24,9,15
Product,mugthol,858,mage,fire,18,9,9
Keionti,dalaran,857,mage,fire,22,11,11
Gadalka,frostmourne,857,mage,fire,18,9,9
Wetworx,illidan,855,mage,fire,18,9,9
Dreaming,draktharon,855,mage,fire,18,9,9
Dánó,lightbringer,843,mage,fire,62,26,36
Umber,dreadmaul,829,mage,fire,17,9,8
Needloog,sargeras,829,mage,fire,17,9,8
Sossmage,jaedenar,815,mage,fire,15,9,6
Ljaie,lightbringer,813,mage,fire,17,9,8
Xgrave,sargeras,812,mage,fire,15,10,5
Phantose,sargeras,808,mage,fire,22,10,12
Pyrlos,terokkar,808,mage,fire,30,12,18
Arcanemain,kargath,799,mage,fire,42,18,24
Drewann,draenor,799,mage,fire,22,9,13
Convector,tichondrius,782,mage,fire,11,9,2
Tmharp,tichondrius,779,mage,fire,20,10,10
Realzedx,sargeras,768,mage,fire,12,8,4
Rendézvous,tichondrius,768,mage,fire,12,8,4
Voljezus,jubeithos,768,mage,fire,12,8,4
Delibros,tichondrius,768,mage,fire,12,8,4
Xialing,tichondrius,768,mage,fire,12,8,4
Dandrix,sargeras,768,mage,fire,12,8,4
Icyfate,stormrage,768,mage,fire,12,8,4
Octané,illidan,768,mage,fire,12,8,4
Keepv,tichondrius,768,mage,fire,12,8,4
Déathmask,drakkari,768,mage,fire,12,8,4
Pherixsw,stormrage,768,mage,fire,12,8,4
Kazmir,area-52,768,mage,fire,15,9,6
Ferchu,emerald-dream,768,mage,fire,18,8,10
Castana,tichondrius,768,mage,fire,18,8,10
Sunstry,tichondrius,768,mage,fire,18,8,10
Zajebisty,aegwynn,767,mage,fire,12,8,4
Hexed,kiljaeden,767,mage,fire,12,8,4
Herzthroh,stormrage,767,mage,fire,18,8,10
Shmoked,kelthuzad,767,mage,fire,18,8,10
Laradria,kiljaeden,767,mage,fire,18,8,10
Snowday,nerzhul,767,mage,fire,18,8,10
Rhoadies,malfurion,767,mage,fire,18,8,10
Preplex,thrall,767,mage,fire,18,8,10
Mccorkle,azshara,767,mage,fire,21,9,12
Wayferz,illidan,767,mage,fire,24,8,16
Darkisfrosty,tichondrius,767,mage,fire,24,8,16
Siayo,stormscale,767,mage,fire,30,8,22
Zafel,tichondrius,766,mage,fire,18,8,10
Numz,sargeras,766,mage,fire,18,8,10
Ashenlad,moon-guard,766,mage,fire,18,8,10
Saggytits,blackrock,765,mage,fire,18,8,10
Tarmiel,quelthalas,765,mage,fire,24,8,16
Magicmaster,quelthalas,765,mage,fire,24,8,16
Yusen,tichondrius,764,mage,fire,18,8,10
Abrhamblinkn,tichondrius,763,mage,fire,12,8,4
Wetguuch,area-52,763,mage,fire,18,8,10
Spellbrker,stormrage,763,mage,fire,24,8,16
Marrika,amanthul,762,mage,fire,18,8,10
Bennyhana,frostwolf,761,mage,fire,12,8,4
Dayv,azshara,760,mage,fire,30,8,22
Isoicast,moon-guard,759,mage,fire,22,11,11
Pyromidget,khazgoroth,756,mage,fire,18,8,10
Kibazn,sisters-of-elune,745,mage,fire,23,8,15
Yasmani,drakkari,738,mage,fire,28,11,17
Øgum,goldrinn,729,mage,fire,14,9,5
Chiatsup,tichondrius,720,mage,fire,15,9,6
Dìus,malganis,719,mage,fire,17,8,9
Eromir,dawnbringer,704,mage,fire,16,8,8
Umbriël,quelthalas,703,mage,fire,11,8,3
Flippendicus,stormrage,697,mage,fire,36,9,27
Vakina,tichondrius,690,mage,fire,27,8,19
Chukii,darkspear,686,mage,fire,13,8,5
Shmagee,azralon,684,mage,fire,13,8,5
Sos,kelthuzad,672,mage,fire,12,7,5
Moogician,aerie-peak,672,mage,fire,12,7,5
Belven,proudmoore,672,mage,fire,12,7,5
Stooki,tichondrius,672,mage,fire,12,7,5
Koadic,zuljin,672,mage,fire,12,7,5
Vamplol,tichondrius,672,mage,fire,12,7,5
Tuggernaug,malganis,672,mage,fire,12,7,5
Coldkite,tichondrius,672,mage,fire,12,7,5
Silimage,area-52,672,mage,fire,12,7,5
Warpfactor,malganis,672,mage,fire,12,7,5
Zokorzik,area-52,672,mage,fire,12,7,5
Wienerjeff,area-52,672,mage,fire,12,7,5
Tbh,malganis,672,mage,fire,12,7,5
Osirax,frostmane,672,mage,fire,12,7,5
Arcturuss,sargeras,672,mage,fire,12,7,5
Helpmestpbro,sargeras,672,mage,fire,12,7,5
Wînx,barthilas,672,mage,fire,12,7,5
Bootyslayerx,illidan,672,mage,fire,12,7,5
Nattylites,emerald-dream,672,mage,fire,12,7,5
Frankkie,mugthol,672,mage,fire,12,7,5
Sogood,tanaris,672,mage,fire,18,7,11
Vastlord,stormrage,672,mage,fire,18,7,11
Strumms,tichondrius,672,mage,fire,18,7,11
Degenhours,illidan,671,mage,fire,12,7,5
Yòkai,tichondrius,671,mage,fire,12,7,5
Mymrmage,mannoroth,671,mage,fire,12,7,5
Tráshmage,zuljin,671,mage,fire,12,7,5
Shírley,tichondrius,671,mage,fire,12,7,5
Allhitz,ragnaros,671,mage,fire,12,7,5
Blastfire,stormrage,671,mage,fire,12,7,5
Ásune,moon-guard,671,mage,fire,12,7,5
Keileon,tichondrius,671,mage,fire,12,7,5
Lucidaze,daggerspine,671,mage,fire,12,7,5
Maressara,sargeras,671,mage,fire,18,7,11
Xroz,barthilas,671,mage,fire,24,7,17
Brutalatops,terenas,670,mage,fire,12,7,5
Icepond,proudmoore,670,mage,fire,12,7,5
Gribbets,stormrage,670,mage,fire,18,8,10
Fanshen,tichondrius,670,mage,fire,17,7,10
Ddeuuk,tichondrius,670,mage,fire,18,7,11
Tmo,mannoroth,670,mage,fire,24,7,17
Astroblasty,tichondrius,669,mage,fire,24,7,17
Baelzharon,hellscream,667,mage,fire,18,7,11
Rageymagey,azshara,665,mage,fire,24,7,17
Vonfrmdao,illidan,624,mage,fire,15,8,7
Feenìx,tichondrius,618,mage,fire,12,8,4
Yeweiliang,tichondrius,608,mage,fire,10,7,3
Smalldog,malganis,607,mage,fire,11,7,4
Aofa,sargeras,607,mage,fire,11,7,4
Slipqt,tichondrius,607,mage,fire,22,7,15
Chumleyson,eonar,606,mage,fire,14,7,7
Mômö,argent-dawn,606,mage,fire,22,7,15
Mokelovinwtf,tichondrius,576,mage,fire,8,8,0
Delibro,tichondrius,576,mage,fire,6,6,0
Mzr,proudmoore,576,mage,fire,6,6,0
Strdelmaker,tichondrius,576,mage,fire,6,6,0
Frostboy,borean-tundra,576,mage,fire,12,6,6
Yupmage,tichondrius,576,mage,fire,12,6,6
Plutón,tichondrius,576,mage,fire,12,6,6
Kaylemage,tichondrius,576,mage,fire,12,6,6
Gnitraf,malganis,576,mage,fire,12,6,6
Magicmidget,malganis,576,mage,fire,12,6,6
Catchmage,bleeding-hollow,576,mage,fire,12,6,6
Kennyb,illidan,576,mage,fire,12,6,6
Crøwgxd,tichondrius,576,mage,fire,12,6,6
Bøfa,tichondrius,576,mage,fire,12,6,6
Magicmichel,malganis,576,mage,fire,12,6,6
Orangemilk,hyjal,576,mage,fire,12,6,6
Myfamilygpie,nazgrel,576,mage,fire,12,6,6
Tearsfórgód,kelthuzad,576,mage,fire,12,6,6
Eludin,aegwynn,576,mage,fire,12,6,6
Cuterthanyou,sargeras,576,mage,fire,12,6,6
Enchantress,wyrmrest-accord,576,mage,fire,12,6,6
Zenzoh,azuremyst,576,mage,fire,12,6,6
Jajaragnaros,bleeding-hollow,576,mage,fire,12,6,6
Ghili,tichondrius,576,mage,fire,12,6,6
Sourpatchkds,emerald-dream,576,mage,fire,12,6,6
Mageboy,bonechewer,576,mage,fire,12,6,6
Wakamage,area-52,576,mage,fire,12,6,6
Kylar,icecrown,576,mage,fire,12,6,6
Magnificaxd,area-52,576,mage,fire,12,6,6
Toteypotter,frostmourne,576,mage,fire,12,6,6
Stratokvn,ragnaros,576,mage,fire,12,6,6
Yourefat,emerald-dream,576,mage,fire,14,6,8
Inflow,barthilas,576,mage,fire,18,6,12
Stimml,blood-furnace,576,mage,fire,18,6,12
Lambsalsa,tichondrius,576,mage,fire,18,6,12
Shivamode,thrall,576,mage,fire,18,6,12
Choccoeu,illidan,576,mage,fire,20,6,14
Mkownzz,tichondrius,575,mage,fire,6,6,0
Insightæ,frostmourne,575,mage,fire,10,7,3
Tigerzinho,stormrage,575,mage,fire,12,6,6
Minuswizard,dalaran,575,mage,fire,12,6,6
Ellywizzle,tichondrius,575,mage,fire,12,6,6
Zäriks,kelthuzad,575,mage,fire,18,6,12
Teemage,drakthul,575,mage,fire,18,6,12
Faxandu,tichondrius,575,mage,fire,18,6,12
Calínico,quelthalas,575,mage,fire,24,6,18
Eraticmage,illidan,575,mage,fire,24,6,18
Spellpowa,khaz-modan,574,mage,fire,12,6,6
Pellemus,malganis,574,mage,fire,12,6,6
Calcaster,aegwynn,573,mage,fire,19,6,13
Xannymancan,tichondrius,573,mage,fire,30,6,24
Dedlyspells,dalaran,572,mage,fire,12,6,6
Navira,feathermoon,572,mage,fire,12,6,6
Itslilme,gurubashi,567,mage,fire,12,6,6
Jarvase,mugthol,558,mage,fire,11,6,5
Shotö,skullcrusher,558,mage,fire,23,6,17
Ordroth,borean-tundra,544,mage,fire,16,6,10
Thragè,sargeras,543,mage,fire,11,6,5
Magicke,azgalor,542,mage,fire,22,6,16
Nuzzle,boulderfist,521,mage,fire,15,7,8
Ghostrr,tichondrius,511,mage,fire,8,6,2
Rooturus,caelestrasz,480,mage,fire,6,5,1
Maxmie,sargeras,480,mage,fire,6,5,1
Frostynips,argent-dawn,480,mage,fire,6,5,1
Shaabby,shadowmoon,480,mage,fire,6,5,1
Pantsbeard,illidan,480,mage,fire,6,5,1
Slavic,sargeras,480,mage,fire,6,5,1
Ohnostepbro,malfurion,480,mage,fire,6,5,1
Stinkywinky,cairne,480,mage,fire,6,5,1
Magecombe,thrall,480,mage,fire,6,5,1
Versacejay,sargeras,480,mage,fire,6,5,1
Zaiyge,bleeding-hollow,480,mage,fire,6,5,1
Frosttwoop,moon-guard,480,mage,fire,6,5,1
Emetselchm,tichondrius,480,mage,fire,6,5,1
Gelokay,tichondrius,480,mage,fire,6,5,1
Youezdawg,tichondrius,480,mage,fire,6,5,1
Aimeim,tichondrius,480,mage,fire,6,5,1
Porthub,boulderfist,480,mage,fire,6,5,1
Aycc,tichondrius,480,mage,fire,6,5,1
Hocusjokus,frostmourne,480,mage,fire,6,5,1
Diminisher,agamaggan,480,mage,fire,9,5,4
ßutteryßoner,area-52,480,mage,fire,12,5,7
Skillcap,nagrand,480,mage,fire,12,5,7
Icestory,tichondrius,480,mage,fire,12,5,7
Imhotboi,illidan,480,mage,fire,12,5,7
Weedzerd,illidan,480,mage,fire,12,5,7
Kyriê,darkspear,480,mage,fire,12,5,7
Entomas,quelthalas,480,mage,fire,12,5,7
Littlemunkee,the-venture-co,480,mage,fire,12,5,7
Marther,whisperwind,480,mage,fire,12,5,7
Bxgs,tichondrius,480,mage,fire,12,5,7
Dawonie,frostmourne,480,mage,fire,12,5,7
Skylinem,sargeras,480,mage,fire,12,5,7
Espyy,area-52,480,mage,fire,12,5,7
Triuneward,tichondrius,480,mage,fire,12,5,7
Honeydutchss,black-dragonflight,480,mage,fire,12,5,7
Baida,kelthuzad,480,mage,fire,12,5,7
Jikario,zuljin,480,mage,fire,12,5,7
Defaultx,turalyon,480,mage,fire,12,5,7
Kazimìr,tichondrius,480,mage,fire,12,5,7
Arishasis,tichondrius,480,mage,fire,12,5,7
Diamondx,ragnaros,480,mage,fire,12,5,7
Cnumlab,proudmoore,480,mage,fire,12,5,7
Toaststrudel,tichondrius,480,mage,fire,12,5,7
Rmpisgay,tichondrius,480,mage,fire,12,5,7
Zerosaspect,thrall,480,mage,fire,12,5,7
Kqlyy,tichondrius,480,mage,fire,12,5,7
Mtphranklin,barthilas,480,mage,fire,12,5,7
Valodrin,tichondrius,480,mage,fire,12,5,7
Pugsmugg,icecrown,480,mage,fire,12,5,7
Covín,malganis,480,mage,fire,12,5,7
Hvnlyfathr,stormrage,480,mage,fire,12,5,7
Dbsheep,kul-tiras,480,mage,fire,12,5,7
Rippedkuntx,frostmourne,480,mage,fire,12,5,7
Magicalbuns,illidan,480,mage,fire,12,5,7
Chadicewayne,tichondrius,480,mage,fire,12,5,7
Rennifer,malganis,480,mage,fire,15,6,9
Aapple,tichondrius,480,mage,fire,17,5,12
Tunax,tichondrius,480,mage,fire,18,5,13
Jeffreezy,tichondrius,480,mage,fire,18,5,13
Waef,quelthalas,479,mage,fire,6,5,1
Mateusff,stormrage,479,mage,fire,11,5,6
Linric,illidan,479,mage,fire,12,5,7
Shadowgalaxy,arthas,479,mage,fire,12,5,7
Finanahs,sargeras,479,mage,fire,12,5,7
Ghostblaze,blackhand,479,mage,fire,12,5,7
Mescudi,bonechewer,479,mage,fire,12,5,7
Chuky,terokkar,479,mage,fire,12,5,7
Berrur,azralon,478,mage,fire,12,5,7
Apolarus,bonechewer,478,mage,fire,12,5,7
Infusion,ysondre,477,mage,fire,12,5,7
Gwenage,tichondrius,472,mage,fire,12,5,7
Roastbeefxd,tichondrius,447,mage,fire,11,5,6
Prepcook,dalaran,447,mage,fire,11,5,6
Khaziiong,scilla,447,mage,fire,11,5,6
Normethy,illidan,447,mage,fire,11,5,6
Jazen,quelthalas,432,mage,fire,15,6,9
Myelvenlady,proudmoore,431,mage,fire,11,5,6
Molassess,illidan,400,mage,fire,13,5,8
Tutoro,emerald-dream,384,mage,fire,6,4,2
Dersão,azralon,384,mage,fire,6,4,2
Cømbust,frostmourne,384,mage,fire,6,4,2
Pyröz,kelthuzad,384,mage,fire,6,4,2
Mithràndìr,tichondrius,384,mage,fire,6,4,2
Messiahbb,tichondrius,384,mage,fire,6,4,2
Haze,hyjal,384,mage,fire,6,4,2
Cottonmage,malganis,384,mage,fire,6,4,2
Extremeways,tichondrius,384,mage,fire,6,4,2
Animatronic,nordrassil,384,mage,fire,6,4,2
Gíldrin,proudmoore,384,mage,fire,6,4,2
Sifr,tichondrius,384,mage,fire,6,4,2
Fïtz,quelthalas,384,mage,fire,6,4,2
Zaxrie,malganis,384,mage,fire,6,4,2
Vecina,tichondrius,384,mage,fire,6,4,2
Rebornganegg,tichondrius,384,mage,fire,6,4,2
Frozonnee,aggramar,384,mage,fire,6,4,2
Floatyz,tichondrius,384,mage,fire,6,4,2
Playsfrost,skullcrusher,384,mage,fire,6,4,2
Playtimex,proudmoore,384,mage,fire,6,4,2
Adelein,earthen-ring,384,mage,fire,6,4,2
Clownspocket,tichondrius,384,mage,fire,6,4,2
Linkston,area-52,384,mage,fire,6,4,2
Mysticlotus,doomhammer,384,mage,fire,6,4,2
Drdocx,frostmourne,384,mage,fire,6,4,2
Terarosa,tichondrius,384,mage,fire,6,4,2
Crøwgawd,tichondrius,384,mage,fire,6,4,2
Zolix,malganis,384,mage,fire,6,4,2
Cbm,dalaran,384,mage,fire,6,4,2
Wolfgangs,thrall,384,mage,fire,6,4,2
Tåstydonut,bleeding-hollow,384,mage,fire,6,4,2
Bonyobo,stormrage,384,mage,fire,6,4,2
Brbsheepingx,illidan,384,mage,fire,6,4,2
Enveas,illidan,384,mage,fire,6,4,2
Darealtruth,stormrage,384,mage,fire,6,4,2
Tafa,stormrage,384,mage,fire,6,4,2
Azrick,illidan,384,mage,fire,6,4,2
Dytonie,moon-guard,384,mage,fire,9,4,5
Riencë,tol-barad,384,mage,fire,12,4,8
Pòpsmóke,tichondrius,384,mage,fire,12,4,8
Remana,anvilmar,384,mage,fire,12,4,8
Pigdancel,tichondrius,384,mage,fire,12,4,8
Alondrah,nazjatar,384,mage,fire,12,4,8
Taurencé,tichondrius,384,mage,fire,12,4,8
Sarahbeth,khadgar,384,mage,fire,12,4,8
Uwuwhatnow,tichondrius,384,mage,fire,12,4,8
Thiio,tichondrius,384,mage,fire,12,4,8
Annhubis,quelthalas,384,mage,fire,12,4,8
Cristábel,stormrage,384,mage,fire,12,4,8
Udó,proudmoore,384,mage,fire,12,4,8
Felsparkles,area-52,384,mage,fire,12,4,8
Araski,malganis,384,mage,fire,12,4,8
Koulder,zuljin,384,mage,fire,12,4,8
Tìnkerspell,stormrage,384,mage,fire,12,4,8
Fierronegro,illidan,384,mage,fire,12,4,8
Nairmage,tichondrius,384,mage,fire,12,4,8
Ejzok,dreadmaul,384,mage,fire,12,4,8
Cacaushow,stormrage,384,mage,fire,12,4,8
Missingxx,silvermoon,384,mage,fire,12,4,8
Uchihá,azgalor,384,mage,fire,12,4,8
Dasanimomo,sargeras,384,mage,fire,12,4,8
Kinrow,stormrage,384,mage,fire,12,4,8
Bojackal,illidan,384,mage,fire,12,4,8
Arialla,mannoroth,384,mage,fire,12,4,8
Hogslop,saurfang,384,mage,fire,12,4,8
Magicshroomy,frostmourne,384,mage,fire,12,4,8
Aquralina,moon-guard,384,mage,fire,12,4,8
Hèrò,barthilas,384,mage,fire,12,4,8
Percivaltp,scarlet-crusade,384,mage,fire,12,4,8
Spookydookie,dark-iron,384,mage,fire,12,4,8
Puvö,tichondrius,384,mage,fire,12,4,8
Moghedi,emerald-dream,384,mage,fire,12,4,8
Galsola,bronzebeard,384,mage,fire,12,4,8
Droppinbombs,draka,384,mage,fire,12,4,8
Paires,azralon,383,mage,fire,6,4,2
Neferpitøu,tichondrius,383,mage,fire,6,4,2
Drewzz,tichondrius,383,mage,fire,8,4,4
Chuggin,emerald-dream,383,mage,fire,15,5,10
Hockisonz,moon-guard,383,mage,fire,12,4,8
Hyndoriann,azgalor,383,mage,fire,12,4,8
Soulwiper,illidan,383,mage,fire,17,5,12
Îùx,stormrage,383,mage,fire,18,4,14
Smoney,icecrown,383,mage,fire,18,4,14
Caldian,wyrmrest-accord,383,mage,fire,18,4,14
Kopke,ragnaros,381,mage,fire,13,4,9
Hollfz,nemesis,367,mage,fire,11,4,7
Vixm,stormrage,352,mage,fire,10,5,5
Wabï,tichondrius,330,mage,fire,15,5,10
Eriktherod,maelstrom,319,mage,fire,8,4,4
Elemenopi,thrall,304,mage,fire,14,4,10
Polyburst,darkspear,288,mage,fire,6,3,3
Silverzaive,silvermoon,288,mage,fire,6,3,3
Slinkyslink,area-52,288,mage,fire,6,3,3
Kuther,draenor,288,mage,fire,6,3,3
Mugiara,azralon,288,mage,fire,6,3,3
Factszxy,area-52,288,mage,fire,6,3,3
Boorster,illidan,288,mage,fire,6,3,3
Kassekx,area-52,288,mage,fire,6,3,3
Zuhbo,moon-guard,288,mage,fire,6,3,3
Ancientmagik,area-52,288,mage,fire,6,3,3
Svips,illidan,288,mage,fire,6,3,3
Pigasus,emerald-dream,288,mage,fire,6,3,3
Guccii,bleeding-hollow,288,mage,fire,6,3,3
Limeade,ursin,288,mage,fire,6,3,3
Zazä,blackrock,288,mage,fire,6,3,3
Dicmojo,area-52,288,mage,fire,6,3,3
Bergan,sargeras,288,mage,fire,6,3,3
Jurgers,tichondrius,288,mage,fire,6,3,3
Angryßirdz,kelthuzad,288,mage,fire,6,3,3
Blinkinghobo,sargeras,288,mage,fire,6,3,3
Skw,sargeras,288,mage,fire,6,3,3
Magedango,bleeding-hollow,288,mage,fire,6,3,3
Bhalec,kelthuzad,288,mage,fire,6,3,3
Sikamikanico,kiljaeden,288,mage,fire,6,3,3
Hasteboy,kelthuzad,288,mage,fire,6,3,3
Sðsa,stormrage,288,mage,fire,6,3,3
Billionnaire,tichondrius,288,mage,fire,6,3,3
Hunchojack,tichondrius,288,mage,fire,6,3,3
Mastacombust,illidan,288,mage,fire,6,3,3
Kyliec,tichondrius,288,mage,fire,6,3,3
Bombr,sargeras,288,mage,fire,6,3,3
Hoçuspoçus,moon-guard,288,mage,fire,6,3,3
Pollylol,proudmoore,288,mage,fire,6,3,3
Rhunón,dalaran,288,mage,fire,6,3,3
Whyze,malganis,288,mage,fire,6,3,3
Lunatti,frostmourne,288,mage,fire,6,3,3
Renoria,norgannon,288,mage,fire,6,3,3
Tiktokbaddie,sargeras,288,mage,fire,6,3,3
Síra,firetree,288,mage,fire,6,3,3
Onlyfansgeno,sargeras,288,mage,fire,6,3,3
Slapmesilly,destromath,288,mage,fire,6,3,3
Craigsdad,tichondrius,288,mage,fire,6,3,3
Jimmyhendrix,wildhammer,288,mage,fire,6,3,3
Polyenjoyerx,ysera,288,mage,fire,6,3,3
Frostkage,tichondrius,288,mage,fire,6,3,3
Gåndalf,ragnaros,288,mage,fire,6,3,3
Rích,tichondrius,288,mage,fire,6,3,3
Kandyperreo,ragnaros,288,mage,fire,6,3,3
Chilléd,tichondrius,288,mage,fire,6,3,3
Sølár,ragnaros,288,mage,fire,6,3,3
Lampert,tichondrius,288,mage,fire,6,3,3
Chez,tichondrius,288,mage,fire,6,3,3
Gandrich,drakkari,288,mage,fire,6,3,3
Ave,anetheron,288,mage,fire,6,3,3
Urbadxd,llane,288,mage,fire,6,3,3
Papadolo,tichondrius,288,mage,fire,6,3,3
Timme,ravencrest,288,mage,fire,6,3,3
Gö,tichondrius,288,mage,fire,6,3,3
Rof,sargeras,288,mage,fire,6,3,3
Thecorruptor,malorne,288,mage,fire,6,3,3
Vyzo,stormrage,288,mage,fire,6,3,3
Taevy,tichondrius,288,mage,fire,6,3,3
Bandmage,exodar,288,mage,fire,6,3,3
Bungholiojr,malganis,288,mage,fire,6,3,3
Mntaindew,bleeding-hollow,288,mage,fire,6,3,3
Azuriex,tichondrius,288,mage,fire,6,3,3
Xtymhxy,tichondrius,288,mage,fire,6,3,3
Buffmages,malfurion,288,mage,fire,6,3,3
Mindthegap,tichondrius,288,mage,fire,6,3,3
Botoslàp,dragonmaw,288,mage,fire,6,3,3
Dontbeshy,bleeding-hollow,288,mage,fire,6,3,3
Rikko,gundrak,288,mage,fire,15,4,11
Chale,tichondrius,288,mage,fire,12,3,9
Danggurl,tichondrius,288,mage,fire,12,3,9
Orkinekek,frostmourne,288,mage,fire,12,3,9
Mendittorosa,tichondrius,288,mage,fire,12,3,9
Magichands,darkspear,288,mage,fire,12,3,9
Zogo,bleeding-hollow,288,mage,fire,12,3,9
Safety,stormreaver,288,mage,fire,12,3,9
Médüsa,moon-guard,288,mage,fire,12,3,9
Funkeoto,thrall,288,mage,fire,12,3,9
Twizz,haomarush,288,mage,fire,12,3,9
Voidray,queldorei,288,mage,fire,12,3,9
Spindarella,dreadmaul,288,mage,fire,12,3,9
Nilla,hyjal,288,mage,fire,12,3,9
Fatalexo,tichondrius,288,mage,fire,12,3,9
Turbogeo,shuhalo,288,mage,fire,12,3,9
Chelseâ,emerald-dream,288,mage,fire,18,3,15
Gnomegeddons,dalaran,288,mage,fire,24,3,21
Seaon,malganis,287,mage,fire,6,3,3
Frostyii,stonemaul,287,mage,fire,6,3,3
Harlen,quelthalas,287,mage,fire,6,3,3
Shutouchi,frostwolf,287,mage,fire,6,3,3
Nushala,stonemaul,287,mage,fire,11,3,8
Zipacna,antonidas,286,mage,fire,12,3,9
Mageymeows,dalaran,285,mage,fire,12,3,9
Kittikk,tichondrius,284,mage,fire,18,3,15
Nesomage,destromath,256,mage,fire,10,3,7
Rossanopolis,tichondrius,255,mage,fire,17,3,14
Nephalem,moknathal,240,mage,fire,9,3,6
Fizario,barthilas,239,mage,fire,5,3,2
Xiangfe,emerald-dream,239,mage,fire,5,3,2
Ktp,tichondrius,239,mage,fire,5,3,2
Turtles,the-venture-co,239,mage,fire,5,3,2
Genozyde,elune,239,mage,fire,5,3,2
Orderlight,alexstrasza,239,mage,fire,5,3,2
Qohoo,frostmourne,239,mage,fire,5,3,2
Danmar,durotan,239,mage,fire,5,3,2
Flomin,tichondrius,234,mage,fire,16,6,10
Djp,tichondrius,234,mage,fire,18,4,14
Magicdro,scilla,224,mage,fire,10,3,7
Mcdfries,tichondrius,208,mage,fire,7,3,4
Coldgirl,malganis,192,mage,fire,11,4,7
Gódsfather,kelthuzad,192,mage,fire,6,2,4
Rbn,tichondrius,192,mage,fire,6,2,4
Dohnutt,tichondrius,192,mage,fire,6,2,4
Ayev,tichondrius,192,mage,fire,6,2,4
Keii,bleeding-hollow,192,mage,fire,6,2,4
Friézá,stormrage,192,mage,fire,6,2,4
Likelyhard,tichondrius,192,mage,fire,6,2,4
Josephaqil,tichondrius,192,mage,fire,6,2,4
Cradic,tichondrius,192,mage,fire,6,2,4
Ignitex,bleeding-hollow,192,mage,fire,6,2,4
Gotya,tichondrius,192,mage,fire,6,2,4
Telkham,tichondrius,192,mage,fire,6,2,4
Quickwizard,tichondrius,192,mage,fire,6,2,4
Lilmager,tichondrius,192,mage,fire,6,2,4
Variex,tichondrius,192,mage,fire,6,2,4
Zerii,aggramar,192,mage,fire,6,2,4
Erîol,ragnaros,192,mage,fire,6,2,4
Parruka,warsong,192,mage,fire,6,2,4
Elhechizero,quelthalas,192,mage,fire,6,2,4
Zënith,quelthalas,192,mage,fire,6,2,4
Dubyaj,tichondrius,192,mage,fire,6,2,4
Swàn,stormrage,192,mage,fire,6,2,4
Wauzcrol,quelthalas,192,mage,fire,6,2,4
Muskinite,maiev,192,mage,fire,6,2,4
Naimi,malganis,192,mage,fire,6,2,4
Herpsgungetu,maiev,192,mage,fire,6,2,4
Avandal,proudmoore,192,mage,fire,6,2,4
Faeylyn,stormrage,192,mage,fire,6,2,4
Namechanged,malganis,192,mage,fire,6,2,4
Pipeguzzler,zuljin,192,mage,fire,6,2,4
Arcaninez,bleeding-hollow,192,mage,fire,6,2,4
Shardgodx,kelthuzad,192,mage,fire,6,2,4
Magiër,tichondrius,192,mage,fire,6,2,4
Dustychill,illidan,192,mage,fire,6,2,4
Iludron,aegwynn,192,mage,fire,6,2,4
Gunzz,aegwynn,192,mage,fire,6,2,4
Fazzlee,nathrezim,192,mage,fire,6,2,4
Maddoggs,tichondrius,192,mage,fire,6,2,4
Alïce,kelthuzad,192,mage,fire,6,2,4
Emìlia,malygos,192,mage,fire,6,2,4
Aquafiona,garona,192,mage,fire,6,2,4
Juicemage,tichondrius,192,mage,fire,6,2,4
Khelzter,area-52,192,mage,fire,6,2,4
Ÿenizä,illidan,192,mage,fire,6,2,4
Melkdud,wyrmrest-accord,192,mage,fire,6,2,4
Magicmom,wyrmrest-accord,192,mage,fire,6,2,4
Burrbon,area-52,192,mage,fire,6,2,4
Randommagi,area-52,192,mage,fire,6,2,4
Chillstep,dark-iron,192,mage,fire,6,2,4
Briklyx,zuljin,192,mage,fire,6,2,4
Clickhard,suramar,192,mage,fire,6,2,4
Ðfuego,azralon,192,mage,fire,6,2,4
Shäräpova,zuljin,192,mage,fire,6,2,4
Trebbiano,illidan,192,mage,fire,6,2,4
Mävra,emerald-dream,192,mage,fire,6,2,4
Onehitter,tichondrius,192,mage,fire,6,2,4
Starguy,terenas,192,mage,fire,6,2,4
Roggitman,emerald-dream,192,mage,fire,6,2,4
Natzue,sargeras,192,mage,fire,6,2,4
Coldnuke,stormrage,192,mage,fire,6,2,4
Zuqo,sargeras,192,mage,fire,6,2,4
Arianark,sargeras,192,mage,fire,6,2,4
Tannbone,illidan,192,mage,fire,6,2,4
Ogpdk,sargeras,192,mage,fire,6,2,4
Dîarrhea,sargeras,192,mage,fire,6,2,4
Shesy,sargeras,192,mage,fire,6,2,4
Nerff,sargeras,192,mage,fire,6,2,4
Kyns,sargeras,192,mage,fire,6,2,4
Castbars,sargeras,192,mage,fire,6,2,4
Thedodgex,sargeras,192,mage,fire,6,2,4
Kymowiz,sargeras,192,mage,fire,6,2,4
Notria,illidan,192,mage,fire,6,2,4
Foreignname,sargeras,192,mage,fire,6,2,4
Kaboodlz,stormrage,192,mage,fire,6,2,4
Magifish,malganis,192,mage,fire,6,2,4
Hellfireice,kiljaeden,192,mage,fire,6,2,4
Killemz,dragonmaw,192,mage,fire,6,2,4
Sachetti,thrall,192,mage,fire,6,2,4
Elmozezos,thrall,192,mage,fire,6,2,4
Privilege,dragonmaw,192,mage,fire,6,2,4
Yonzho,area-52,192,mage,fire,6,2,4
Jinglehz,frostmourne,192,mage,fire,6,2,4
Laf,frostmourne,192,mage,fire,6,2,4
Burna,amanthul,192,mage,fire,6,2,4
Drakcarrus,balnazzar,192,mage,fire,6,2,4
Massivepoo,barthilas,192,mage,fire,6,2,4
Crabenjoyer,frostmourne,192,mage,fire,6,2,4
Missile,frostmourne,192,mage,fire,6,2,4
Powerfulguy,frostmourne,192,mage,fire,6,2,4
Hugostiglets,dreadmaul,192,mage,fire,6,2,4
Karameltart,barthilas,192,mage,fire,6,2,4
Trízín,frostmourne,192,mage,fire,6,2,4
Copperfield,dreadmaul,192,mage,fire,6,2,4
Abrácadaver,frostwolf,192,mage,fire,10,3,7
Flamiohotman,illidan,192,mage,fire,7,2,5
Arnx,tichondrius,192,mage,fire,11,2,9
Sceledrus,quelthalas,192,mage,fire,11,2,9
Saydar,stormrage,192,mage,fire,12,2,10
Abruaa,area-52,192,mage,fire,12,2,10
Lauroca,azralon,192,mage,fire,12,2,10
Molinoren,quelthalas,192,mage,fire,12,2,10
Swiftyniifty,area-52,192,mage,fire,12,2,10
Granmago,azralon,192,mage,fire,12,2,10
Firehawk,azralon,192,mage,fire,12,2,10
Ëfc,nemesis,192,mage,fire,12,2,10
Bic,darrowmere,192,mage,fire,12,2,10
Driel,illidan,192,mage,fire,12,2,10
Tonydippin,illidan,192,mage,fire,12,2,10
Skatas,barthilas,192,mage,fire,12,2,10
Magemajor,uldum,191,mage,fire,12,2,10
Prosperoo,aerie-peak,191,mage,fire,12,2,10
Neroclover,ysera,191,mage,fire,24,2,22
Hànk,tichondrius,175,mage,fire,11,2,9
Madalon,nemesis,160,mage,fire,10,2,8
Razaklov,tichondrius,159,mage,fire,5,2,3
Kindlin,frostmourne,159,mage,fire,5,2,3
Zezima,spirestone,159,mage,fire,5,2,3
Icebish,skullcrusher,144,mage,fire,9,3,6
Fingerblaste,malganis,138,mage,fire,16,3,13
Badboykilla,dentarg,128,mage,fire,4,2,2
Danorius,laughing-skull,128,mage,fire,4,2,2
Dwayniewayni,tichondrius,128,mage,fire,4,2,2
Ratfather,the-forgotten-coast,128,mage,fire,4,2,2
Supremeboxer,tichondrius,127,mage,fire,8,2,6
Neltar,dalaran,112,mage,fire,7,2,5
Haliax,bronzebeard,96,mage,fire,3,2,1
Magetherian,frostmourne,96,mage,fire,3,2,1
Prosperoh,burning-legion,96,mage,fire,6,1,5
Memnor,amanthul,96,mage,fire,6,1,5
Omorto,illidan,96,mage,fire,6,1,5
Nazztwren,bleeding-hollow,96,mage,fire,6,1,5
Warmweather,nagrand,96,mage,fire,6,1,5
Ssmurfett,dalaran,96,mage,fire,6,1,5
Gurion,bleeding-hollow,96,mage,fire,6,1,5
Dâzk,sargeras,96,mage,fire,6,1,5
Ross,deathwing,96,mage,fire,6,1,5
Merreda,sargeras,96,mage,fire,6,1,5
Miapolyafoo,stormrage,96,mage,fire,6,1,5
Muted,frostmourne,96,mage,fire,6,1,5
Édika,area-52,96,mage,fire,6,1,5
Iamsol,area-52,96,mage,fire,6,1,5
Nomidian,area-52,96,mage,fire,6,1,5
Purpkush,zuljin,96,mage,fire,6,1,5
Clickersz,sargeras,96,mage,fire,6,1,5
Gnomoguapo,altar-of-storms,96,mage,fire,6,1,5
Flit,skullcrusher,96,mage,fire,6,1,5
Tabuta,ravenholdt,96,mage,fire,6,1,5
Aimedint,sargeras,96,mage,fire,6,1,5
Rieltar,barthilas,96,mage,fire,6,1,5
Trojay,malganis,96,mage,fire,6,1,5
Clutchy,gorefiend,96,mage,fire,6,1,5
Firemids,thrall,96,mage,fire,6,1,5
Sîmply,zuljin,96,mage,fire,6,1,5
Pyrophobia,mannoroth,96,mage,fire,6,1,5
Bbaxter,stormrage,96,mage,fire,6,1,5
Sny,bleeding-hollow,96,mage,fire,6,1,5
Litiria,burning-blade,96,mage,fire,6,1,5
Jarethleon,ragnaros,96,mage,fire,6,1,5
Wíntersun,frostmourne,96,mage,fire,6,1,5
Arkuran,proudmoore,96,mage,fire,6,1,5
Jazco,tichondrius,96,mage,fire,6,1,5
Rolypolyman,tichondrius,96,mage,fire,6,1,5
Couto,tichondrius,96,mage,fire,6,1,5
Firehazard,tichondrius,96,mage,fire,6,1,5
Lv,stormscale,96,mage,fire,6,1,5
Truewinter,tichondrius,96,mage,fire,6,1,5
Fireblast,stormscale,96,mage,fire,6,1,5
Ignit,stormrage,96,mage,fire,6,1,5
Dildope,frostmourne,96,mage,fire,6,1,5
Phrana,tichondrius,96,mage,fire,6,1,5
Auraelius,tichondrius,96,mage,fire,6,1,5
Magicmooman,thunderlord,96,mage,fire,6,1,5
Pyromaniac,stormscale,96,mage,fire,6,1,5
Jaçkjaçk,moon-guard,96,mage,fire,6,1,5
Blàzèd,proudmoore,96,mage,fire,6,1,5
Tisao,bronzebeard,96,mage,fire,6,1,5
Bdmxd,stormrage,96,mage,fire,6,1,5
Morganä,silver-hand,96,mage,fire,6,1,5
Brayni,wyrmrest-accord,96,mage,fire,6,1,5
Somnuss,barthilas,96,mage,fire,7,1,6
Zuroz,dathremar,96,mage,fire,12,1,11
Duhquarius,warsong,96,mage,fire,12,1,11
Allesanda,sargeras,96,mage,fire,12,1,11
Dezax,malfurion,96,mage,fire,12,1,11
Mideon,whisperwind,95,mage,fire,6,1,5
Doomguyx,korgath,95,mage,fire,14,1,13
Cînderellas,proudmoore,84,mage,fire,14,5,9
Savanali,kelthuzad,79,mage,fire,5,1,4
Noquemacuuh,ragnaros,79,mage,fire,5,1,4
Jaked,frostmourne,79,mage,fire,5,1,4
Hypnòs,kelthuzad,63,mage,fire,2,2,0
Skerei,azralon,48,mage,fire,3,1,2
Redeyez,arthas,48,mage,fire,9,1,8
Yellowfevrz,thrall,42,mage,fire,11,2,9
Juicemage,tichondrius,2284,mage,frost,180,99,81
Maxvila,kelthuzad,2189,mage,frost,96,50,46
Hogdog,illidan,2176,mage,frost,96,52,44
Birdfather,tichondrius,2167,mage,frost,59,45,14
Fromcanadaqc,stormrage,2108,mage,frost,83,45,38
Stonedmonkeý,tichondrius,2103,mage,frost,149,75,74
Juicechanel,tichondrius,2071,mage,frost,70,38,32
Cremgotrockd,blackrock,2061,mage,frost,113,62,51
Frostitutex,illidan,2031,mage,frost,97,54,43
Ghostrr,tichondrius,2014,mage,frost,196,102,94
Zlint,quelthalas,2007,mage,frost,115,59,56
Easyfreeze,sargeras,1996,mage,frost,48,27,21
Cunzhang,tichondrius,1989,mage,frost,78,39,39
Backjing,tichondrius,1969,mage,frost,87,42,45
Hogmantwo,illidan,1965,mage,frost,66,36,30
Lawuera,quelthalas,1965,mage,frost,107,52,55
Bamx,stormrage,1961,mage,frost,84,47,37
Smuky,stormrage,1949,mage,frost,191,95,96
Valériemeow,tichondrius,1940,mage,frost,201,98,103
Factszxy,area-52,1934,mage,frost,59,41,18
Stöpwatch,hyjal,1922,mage,frost,126,75,51
Douyuweifa,tichondrius,1917,mage,frost,119,58,61
Kassmage,skullcrusher,1913,mage,frost,162,78,84
Pigdancel,tichondrius,1911,mage,frost,60,34,26
Faynet,dalaran,1910,mage,frost,170,91,79
Elkiador,area-52,1909,mage,frost,30,21,9
Grumpyòlfart,tichondrius,1898,mage,frost,132,67,65
Vazlgs,tichondrius,1896,mage,frost,82,47,35
Miilky,tichondrius,1893,mage,frost,66,33,33
Flaux,sargeras,1892,mage,frost,88,50,38
Ams,aerie-peak,1890,mage,frost,60,33,27
Zerodium,sargeras,1887,mage,frost,113,57,56
Snaregodx,area-52,1885,mage,frost,59,31,28
Politeness,tichondrius,1873,mage,frost,42,20,22
Gelokay,tichondrius,1866,mage,frost,48,28,20
Chrisxo,azuremyst,1866,mage,frost,48,27,21
Rhythmdog,tichondrius,1866,mage,frost,73,35,38
Styler,tichondrius,1862,mage,frost,50,32,18
Messiaah,tichondrius,1862,mage,frost,42,20,22
Tupactopus,tichondrius,1861,mage,frost,54,27,27
Theydeadx,illidan,1858,mage,frost,47,31,16
Pigdancell,tichondrius,1858,mage,frost,60,25,35
Corgim,thrall,1857,mage,frost,65,33,32
Fròzt,ragnaros,1854,mage,frost,96,43,53
Mcdfries,tichondrius,1853,mage,frost,60,32,28
Sorankim,tichondrius,1853,mage,frost,55,28,27
Hunchojack,tichondrius,1852,mage,frost,66,27,39
Instincts,uldum,1850,mage,frost,48,29,19
Xanthilia,chogall,1849,mage,frost,96,49,47
Joe,llane,1849,mage,frost,207,102,105
Chunzhangfs,tichondrius,1843,mage,frost,46,23,23
Hideongp,barthilas,1842,mage,frost,108,54,54
Aapple,tichondrius,1834,mage,frost,72,39,33
Lantx,tichondrius,1834,mage,frost,141,75,66
Tris,malganis,1833,mage,frost,69,36,33
Evilnuts,quelthalas,1832,mage,frost,61,34,27
Dahp,thrall,1831,mage,frost,47,23,24
Micfiyah,thrall,1827,mage,frost,66,41,25
Feener,stormreaver,1827,mage,frost,54,26,28
Vague,tichondrius,1824,mage,frost,80,42,38
Srinshi,sargeras,1820,mage,frost,160,80,80
Miketao,tichondrius,1820,mage,frost,67,31,36
Headbake,malganis,1820,mage,frost,66,30,36
Evilear,andorhal,1819,mage,frost,66,33,33
Chez,tichondrius,1818,mage,frost,30,19,11
Cømbust,frostmourne,1816,mage,frost,72,50,22
Theetwotime,area-52,1814,mage,frost,148,77,71
Quippy,kiljaeden,1813,mage,frost,309,156,153
Leakyboots,illidan,1812,mage,frost,47,25,22
Ribot,sargeras,1812,mage,frost,60,28,32
Swagbased,tichondrius,1807,mage,frost,60,29,31
Koozay,kelthuzad,1805,mage,frost,65,38,27
Dace,tichondrius,1804,mage,frost,53,29,24
Maegwynah,stormrage,1804,mage,frost,66,29,37
Kazimìr,tichondrius,1802,mage,frost,36,24,12
Sheepard,sargeras,1800,mage,frost,42,26,16
Ligmmah,stormrage,1792,mage,frost,110,61,49
Yellowfevrz,thrall,1791,mage,frost,42,19,23
Maebalim,tichondrius,1790,mage,frost,76,39,37
Koro,tichondrius,1784,mage,frost,133,68,65
Drewdy,stormreaver,1783,mage,frost,30,19,11
Yeweiliang,tichondrius,1782,mage,frost,552,280,272
Seeu,tichondrius,1782,mage,frost,126,58,68
Valtessa,stormrage,1781,mage,frost,54,32,22
Endymiòn,tichondrius,1780,mage,frost,48,24,24
Sheepgodx,malganis,1779,mage,frost,35,20,15
Kleinz,quelthalas,1776,mage,frost,91,54,37
Golfirl,doomhammer,1774,mage,frost,54,24,30
Téfy,ragnaros,1773,mage,frost,65,38,27
Tjofmajik,stormrage,1771,mage,frost,54,28,26
Bambambilly,kelthuzad,1770,mage,frost,135,69,66
Atra,spinebreaker,1768,mage,frost,72,36,36
Riddickl,malfurion,1766,mage,frost,108,54,54
Sestren,zuljin,1766,mage,frost,54,25,29
Kissradiox,tichondrius,1763,mage,frost,138,65,73
Dtbmar,misha,1762,mage,frost,94,43,51
Dorsia,jaedenar,1761,mage,frost,82,52,30
Gôøglëlòl,nemesis,1755,mage,frost,271,139,132
Frikabust,stormrage,1747,mage,frost,65,39,26
Stealing,barthilas,1746,mage,frost,59,30,29
Mokelovin,sargeras,1744,mage,frost,47,30,17
Lemmiwïnks,area-52,1744,mage,frost,44,27,17
Kabrax,nerzhul,1743,mage,frost,60,30,30
Moyuu,proudmoore,1740,mage,frost,385,200,185
Tofusmell,illidan,1735,mage,frost,54,31,23
Bravden,area-52,1735,mage,frost,72,40,32
Jerawokee,undermine,1734,mage,frost,103,48,55
Kymowiz,sargeras,1731,mage,frost,54,26,28
Umber,dreadmaul,1730,mage,frost,294,153,141
Ingcho,tichondrius,1730,mage,frost,72,32,40
Castana,tichondrius,1729,mage,frost,116,54,62
Glaciated,the-forgotten-coast,1728,mage,frost,98,51,47
Zssy,tichondrius,1726,mage,frost,71,47,24
Vampìrelolz,tichondrius,1725,mage,frost,30,18,12
Blinkbow,tichondrius,1724,mage,frost,161,80,81
Marrioo,tichondrius,1722,mage,frost,72,35,37
Tatertots,bladefist,1721,mage,frost,53,23,30
Illumià,illidan,1719,mage,frost,26,20,6
Laserface,bleeding-hollow,1719,mage,frost,89,48,41
Traelol,blades-edge,1715,mage,frost,114,58,56
Sifr,tichondrius,1713,mage,frost,36,18,18
Isellstuff,thrall,1710,mage,frost,96,49,47
Covil,tichondrius,1710,mage,frost,126,60,66
Zinnos,tichondrius,1709,mage,frost,226,112,114
Zhangxiaowu,tichondrius,1706,mage,frost,56,37,19
Frøstdrægöñ,illidan,1705,mage,frost,24,18,6
Luckysir,illidan,1704,mage,frost,42,21,21
Polyenjoyerx,ysera,1701,mage,frost,106,55,51
Rizke,tichondrius,1701,mage,frost,35,18,17
Zaddyx,whisperwind,1697,mage,frost,58,33,25
Pitball,area-52,1691,mage,frost,155,77,78
Chinye,tichondrius,1691,mage,frost,68,32,36
Pichorrá,quelthalas,1683,mage,frost,86,49,37
Persia,illidan,1683,mage,frost,53,24,29
Blinkmind,stormrage,1682,mage,frost,54,26,28
Sabrita,proudmoore,1680,mage,frost,98,50,48
Comaner,frostmourne,1677,mage,frost,45,27,18
Deallus,tichondrius,1677,mage,frost,82,40,42
Cayoux,darkspear,1676,mage,frost,30,18,12
Luxør,aegwynn,1674,mage,frost,36,22,14
Alurion,moon-guard,1673,mage,frost,32,21,11
Factsx,area-52,1669,mage,frost,42,22,20
Bmuafgfe,tichondrius,1668,mage,frost,36,22,14
Tommagic,tichondrius,1666,mage,frost,40,23,17
Praestigium,barthilas,1665,mage,frost,98,54,44
Arcayne,tichondrius,1662,mage,frost,127,69,58
Pivnert,boulderfist,1656,mage,frost,42,21,21
Dexd,laughing-skull,1655,mage,frost,90,50,40
Bemaster,area-52,1654,mage,frost,50,33,17
Minverces,tichondrius,1653,mage,frost,40,23,17
Dve,frostmourne,1651,mage,frost,84,51,33
Entm,burning-blade,1651,mage,frost,42,22,20
Kassody,kelthuzad,1650,mage,frost,36,22,14
Hüz,frostmourne,1648,mage,frost,62,41,21
Jtizzlè,tichondrius,1647,mage,frost,71,38,33
Babyspise,nathrezim,1646,mage,frost,42,24,18
Savanali,kelthuzad,1645,mage,frost,75,39,36
Zorexx,area-52,1643,mage,frost,61,30,31
Juniel,bleeding-hollow,1643,mage,frost,46,22,24
Preceptør,azralon,1640,mage,frost,67,37,30
Horrendum,azralon,1639,mage,frost,42,24,18
Venachi,emerald-dream,1638,mage,frost,152,86,66
Fawcett,khazgoroth,1638,mage,frost,138,71,67
Qcomberoo,frostmane,1637,mage,frost,45,22,23
Charmed,black-dragonflight,1635,mage,frost,86,45,41
Gûmbÿ,illidan,1634,mage,frost,48,34,14
Mayumî,moon-guard,1632,mage,frost,42,21,21
Lambsalsa,tichondrius,1631,mage,frost,42,18,24
Stimml,blood-furnace,1630,mage,frost,72,40,32
Xuxä,stormrage,1630,mage,frost,80,39,41
Xtymhxy,tichondrius,1629,mage,frost,36,17,19
Thatlejund,tichondrius,1628,mage,frost,97,52,45
Scarablast,bleeding-hollow,1628,mage,frost,73,35,38
Deverror,frostmourne,1626,mage,frost,257,127,130
Magecombe,thrall,1626,mage,frost,67,33,34
Zezima,spirestone,1625,mage,frost,36,23,13
Nasgeth,darkspear,1625,mage,frost,30,18,12
Elyandria,proudmoore,1625,mage,frost,42,23,19
Gnitraf,malganis,1625,mage,frost,113,59,54
Xialing,tichondrius,1625,mage,frost,35,18,17
Erykk,mugthol,1622,mage,frost,63,22,41
Kouks,tichondrius,1621,mage,frost,35,21,14
Harmõny,tichondrius,1621,mage,frost,31,18,13
Fgnb,sargeras,1620,mage,frost,60,32,28
Mashii,kiljaeden,1620,mage,frost,36,17,19
Triuneward,tichondrius,1619,mage,frost,42,22,20
Yulian,tichondrius,1618,mage,frost,127,75,52
Neverblockx,kirin-tor,1618,mage,frost,30,17,13
Hotrunner,sargeras,1615,mage,frost,211,108,103
Gwyn,nemesis,1614,mage,frost,54,29,25
Whosdismage,illidan,1608,mage,frost,36,22,14
Swaxi,illidan,1606,mage,frost,42,22,20
Soulberg,emerald-dream,1606,mage,frost,107,53,54
Terarosa,tichondrius,1605,mage,frost,66,34,32
Jaked,frostmourne,1604,mage,frost,62,27,35
Sheepu,bladefist,1603,mage,frost,112,64,48
Nerfdestro,illidan,1603,mage,frost,188,104,84
Snoogensftw,tichondrius,1602,mage,frost,36,17,19
Sheepshot,dentarg,1599,mage,frost,54,25,29
Arcánè,velen,1596,mage,frost,35,20,15
Perrc,area-52,1596,mage,frost,251,120,131
Animatronic,moon-guard,1595,mage,frost,297,148,149
Frostpimp,anubarak,1594,mage,frost,62,27,35
Flâvor,illidan,1593,mage,frost,54,29,25
Littlejay,kelthuzad,1591,mage,frost,42,19,23
Aycc,tichondrius,1589,mage,frost,58,29,29
Enflame,tichondrius,1583,mage,frost,66,42,24
Tibbit,kelthuzad,1583,mage,frost,30,19,11
Mageonthcc,korgath,1583,mage,frost,98,49,49
Orderlight,alexstrasza,1583,mage,frost,156,74,82
Houndoôm,hyjal,1580,mage,frost,67,36,31
Baleiabranca,stormrage,1580,mage,frost,195,91,104
Pocsermage,drakkari,1577,mage,frost,40,18,22
Icyspring,tichondrius,1574,mage,frost,30,18,12
Agoniey,illidan,1574,mage,frost,84,39,45
Trippy,senjin,1574,mage,frost,44,20,24
Ðontßlink,illidan,1572,mage,frost,30,17,13
Alùcârd,tichondrius,1572,mage,frost,64,34,30
Choxiy,illidan,1571,mage,frost,52,23,29
Lorlene,frostmourne,1570,mage,frost,199,92,107
Magetherian,frostmourne,1569,mage,frost,135,69,66
Piecez,illidan,1568,mage,frost,36,20,16
Crithappy,baelgun,1568,mage,frost,48,26,22
Fizario,barthilas,1567,mage,frost,95,47,48
Frizbee,sargeras,1567,mage,frost,39,19,20
Rbn,tichondrius,1567,mage,frost,57,24,33
Nickioxox,tichondrius,1567,mage,frost,41,17,24
Ehcos,stormrage,1564,mage,frost,114,56,58
Hermanmiller,tichondrius,1561,mage,frost,118,65,53
Burrstful,destromath,1561,mage,frost,65,29,36
Rrite,tichondrius,1559,mage,frost,35,19,16
Affewxd,lothar,1557,mage,frost,126,65,61
Squidio,stormrage,1556,mage,frost,136,73,63
Fracxure,area-52,1554,mage,frost,47,21,26
Deathrøll,moon-guard,1552,mage,frost,84,48,36
Jayma,moon-guard,1552,mage,frost,36,19,17
Därkmägician,tichondrius,1548,mage,frost,85,50,35
Bigdjohnson,dalaran,1545,mage,frost,30,19,11
Kabonkle,drakthul,1545,mage,frost,68,32,36
Maxtorgar,quelthalas,1545,mage,frost,48,17,31
Couto,tichondrius,1544,mage,frost,71,32,39
Marisadaze,tichondrius,1542,mage,frost,79,34,45
Mcshwackin,area-52,1541,mage,frost,41,21,20
Trolson,sargeras,1541,mage,frost,108,48,60
Mkudos,ragnaros,1540,mage,frost,119,63,56
Bibi,ragnaros,1540,mage,frost,99,46,53
Axecap,tichondrius,1539,mage,frost,84,43,41
Syntacks,lightnings-blade,1539,mage,frost,348,172,176
Lilpolyx,illidan,1537,mage,frost,36,17,19
Daydreamz,lightnings-blade,1535,mage,frost,77,32,45
Kyphosis,illidan,1533,mage,frost,31,16,15
Chrislongtv,tichondrius,1533,mage,frost,678,339,339
Biglance,frostmourne,1533,mage,frost,36,17,19
Frostqt,area-52,1532,mage,frost,132,71,61
Froshar,ragnaros,1532,mage,frost,60,29,31
Yorgøs,ragnaros,1530,mage,frost,30,16,14
Mcfry,illidan,1528,mage,frost,70,40,30
Guyza,frostmourne,1528,mage,frost,179,88,91
Pëpz,emerald-dream,1527,mage,frost,42,17,25
Creatïne,stormrage,1524,mage,frost,181,95,86
Tonystonerz,lightnings-blade,1522,mage,frost,96,49,47
Renoria,norgannon,1522,mage,frost,66,28,38
Jikario,zuljin,1520,mage,frost,48,26,22
Slipqt,tichondrius,1519,mage,frost,77,38,39
Aosin,wyrmrest-accord,1519,mage,frost,36,17,19
Megladon,tichondrius,1518,mage,frost,71,44,27
Omnislasher,terenas,1517,mage,frost,149,71,78
Floofies,moon-guard,1516,mage,frost,133,65,68
Fakebusiness,area-52,1515,mage,frost,198,102,96
Snôz,illidan,1513,mage,frost,78,34,44
Kandyperreo,ragnaros,1511,mage,frost,82,41,41
Icestory,tichondrius,1511,mage,frost,138,56,82
Nairmage,tichondrius,1510,mage,frost,44,22,22
Maauie,sargeras,1508,mage,frost,33,18,15
Unseën,area-52,1508,mage,frost,36,18,18
Janchi,moon-guard,1504,mage,frost,166,75,91
Genswift,thrall,1502,mage,frost,73,34,39
Playsfrost,skullcrusher,1501,mage,frost,106,62,44
Tuçhi,tichondrius,1501,mage,frost,48,27,21
Khadberry,aerie-peak,1501,mage,frost,71,34,37
Betrian,quelthalas,1500,mage,frost,82,39,43
Dillor,tichondrius,1498,mage,frost,213,107,106
Yourefat,emerald-dream,1497,mage,frost,96,60,36
Peakd,bleeding-hollow,1497,mage,frost,42,18,24
Omgmage,tichondrius,1496,mage,frost,18,16,2
Trebbiano,illidan,1496,mage,frost,210,108,102
Warmweather,nagrand,1495,mage,frost,66,31,35
Zirkur,mannoroth,1494,mage,frost,62,31,31
Kazmir,area-52,1494,mage,frost,41,16,25
Vornz,sargeras,1493,mage,frost,102,51,51
Osnapmage,malganis,1492,mage,frost,306,153,153
Soukidiot,sargeras,1492,mage,frost,48,22,26
Galacticslug,tichondrius,1491,mage,frost,60,33,27
Clm,lightnings-blade,1491,mage,frost,168,87,81
Burritsacold,bleeding-hollow,1491,mage,frost,54,26,28
Datazonfire,illidan,1488,mage,frost,36,22,14
Aluce,frostmourne,1488,mage,frost,36,19,17
Spurski,emerald-dream,1487,mage,frost,27,17,10
Maagin,zuljin,1487,mage,frost,182,95,87
Song,sargeras,1485,mage,frost,83,42,41
Supergun,tichondrius,1485,mage,frost,45,21,24
Icegiants,tichondrius,1484,mage,frost,65,35,30
Ruzam,area-52,1484,mage,frost,119,64,55
Arcaneshally,area-52,1483,mage,frost,60,29,31
Aramire,drakkari,1483,mage,frost,69,31,38
Pibb,rivendare,1480,mage,frost,48,25,23
Léstat,quelthalas,1479,mage,frost,42,24,18
Magneto,blood-furnace,1479,mage,frost,36,17,19
Cubanmage,drakkari,1477,mage,frost,42,19,23
Qsc,barthilas,1476,mage,frost,275,135,140
Lilkyrie,senjin,1476,mage,frost,81,39,42
Fbd,bloodscalp,1473,mage,frost,30,16,14
Balencii,kiljaeden,1472,mage,frost,36,22,14
Toaststrudel,tichondrius,1472,mage,frost,105,49,56
Ado,zuluhed,1471,mage,frost,114,59,55
Snowmassive,illidan,1471,mage,frost,42,20,22
Kylar,icecrown,1470,mage,frost,66,32,34
Vecna,tichondrius,1468,mage,frost,119,57,62
Paü,illidan,1468,mage,frost,126,58,68
Dearasian,ragnaros,1467,mage,frost,30,17,13
Fròzen,moon-guard,1466,mage,frost,80,39,41
Wíntersun,frostmourne,1465,mage,frost,342,173,169
Osh,malorne,1464,mage,frost,56,27,29
Ddeuuk,tichondrius,1464,mage,frost,77,37,40
Pizzatest,area-52,1464,mage,frost,70,30,40
Enterthevoid,proudmoore,1463,mage,frost,36,21,15
Tynka,drakkari,1463,mage,frost,30,16,14
Revised,sargeras,1462,mage,frost,94,52,42
Kaïdis,nemesis,1461,mage,frost,42,16,26
Zeshilol,stormrage,1460,mage,frost,51,21,30
Corruptionz,nemesis,1455,mage,frost,72,36,36
Bruxelejolie,twisting-nether,1454,mage,frost,30,17,13
Tylers,moon-guard,1453,mage,frost,56,30,26
Drfrostie,anvilmar,1453,mage,frost,56,29,27
Üman,bleeding-hollow,1451,mage,frost,30,17,13
Coôler,illidan,1451,mage,frost,160,90,70
Kfortyone,kiljaeden,1450,mage,frost,30,16,14
Asparagoose,stormrage,1449,mage,frost,47,25,22
Noescaping,illidan,1449,mage,frost,65,29,36
Meer,stonemaul,1448,mage,frost,72,44,28
Nereidan,drakkari,1448,mage,frost,62,29,33
Myxzz,barthilas,1447,mage,frost,380,192,188
Minerves,tichondrius,1446,mage,frost,42,20,22
Roseofsharon,tichondrius,1446,mage,frost,42,18,24
Wolfgangvn,stormrage,1446,mage,frost,54,23,31
Skywalkerino,azralon,1443,mage,frost,47,24,23
Bettybonk,cenarius,1441,mage,frost,59,26,33
Pvpbilly,tichondrius,1439,mage,frost,24,15,9
Hugostiglets,dreadmaul,1438,mage,frost,152,73,79
Sáron,quelthalas,1436,mage,frost,75,38,37
Forged,tichondrius,1436,mage,frost,60,25,35
Nicemangoes,proudmoore,1435,mage,frost,36,19,17
Siayo,stormscale,1433,mage,frost,46,24,22
Cumbustyomom,illidan,1433,mage,frost,30,15,15
Getsheepedon,boulderfist,1433,mage,frost,54,22,32
Sesshomaru,emerald-dream,1433,mage,frost,51,18,33
Mmine,tichondrius,1430,mage,frost,30,15,15
Crøwgxd,tichondrius,1428,mage,frost,24,15,9
Deadsayru,drakkari,1428,mage,frost,58,29,29
Erîol,ragnaros,1428,mage,frost,200,99,101
Aloredron,illidan,1428,mage,frost,65,32,33
Baemers,tichondrius,1428,mage,frost,60,29,31
Emetah,ysera,1427,mage,frost,72,31,41
Tifrodo,azralon,1425,mage,frost,82,44,38
Arckayne,zuljin,1425,mage,frost,106,44,62
Throatdemon,hakkar,1423,mage,frost,59,31,28
Clownspocket,tichondrius,1422,mage,frost,107,61,46
Raisonmage,tichondrius,1421,mage,frost,54,28,26
Garbagemage,barthilas,1421,mage,frost,30,15,15
Scrúmp,tichondrius,1420,mage,frost,74,36,38
Linhny,tichondrius,1419,mage,frost,130,69,61
Vocaris,stormrage,1418,mage,frost,44,27,17
Shatturd,sargeras,1417,mage,frost,135,62,73
Danbì,ragnaros,1417,mage,frost,36,15,21
Lachawr,stormrage,1414,mage,frost,214,109,105
Tossdztosdoz,tichondrius,1414,mage,frost,30,15,15
Biofreze,malganis,1414,mage,frost,60,26,34
Kitenic,proudmoore,1412,mage,frost,71,37,34
Solusek,garona,1406,mage,frost,24,15,9
Canva,barthilas,1406,mage,frost,41,25,16
Slymage,illidan,1404,mage,frost,35,18,17
Nate,black-dragonflight,1404,mage,frost,128,65,63
Gunzup,lightnings-blade,1403,mage,frost,30,15,15
Nargine,tichondrius,1403,mage,frost,30,15,15
Koulder,zuljin,1400,mage,frost,62,35,27
Mâsterkush,tichondrius,1399,mage,frost,58,31,27
Archewing,azjolnerub,1399,mage,frost,42,16,26
Respectx,nemesis,1398,mage,frost,82,36,46
Rossanopolis,tichondrius,1397,mage,frost,59,30,29
Frussy,blood-furnace,1395,mage,frost,114,57,57
Starscreamm,ragnaros,1394,mage,frost,40,23,17
Crymachine,garrosh,1391,mage,frost,33,17,16
Boejanglz,frostmourne,1390,mage,frost,28,17,11
Kahili,stormrage,1390,mage,frost,77,35,42
Chadyus,illidan,1390,mage,frost,42,17,25
Fíebs,queldorei,1389,mage,frost,64,39,25
Zzyuh,proudmoore,1389,mage,frost,52,25,27
Mclanda,frostmourne,1388,mage,frost,116,55,61
Azhim,tichondrius,1387,mage,frost,56,25,31
Wienerjeff,area-52,1385,mage,frost,47,28,19
Maguín,tichondrius,1384,mage,frost,30,15,15
Gralnur,kelthuzad,1381,mage,frost,38,20,18
Valtaira,wyrmrest-accord,1379,mage,frost,160,89,71
Ultrá,stormscale,1379,mage,frost,33,16,17
Odaravla,proudmoore,1379,mage,frost,209,100,109
Mëlkart,ragnaros,1377,mage,frost,72,36,36
Vendizzle,malganis,1377,mage,frost,95,43,52
Zoidy,bleeding-hollow,1377,mage,frost,35,15,20
Lightsoran,tichondrius,1375,mage,frost,17,15,2
Kh,stormrage,1374,mage,frost,99,50,49
Cheesebuns,proudmoore,1373,mage,frost,74,32,42
Wojnova,zuljin,1372,mage,frost,24,15,9
Priyel,hyjal,1372,mage,frost,92,41,51
Hhappier,tichondrius,1371,mage,frost,65,32,33
Ciaooh,tichondrius,1371,mage,frost,105,48,57
Tagere,moon-guard,1370,mage,frost,80,38,42
Nhinsanity,ghostlands,1369,mage,frost,27,17,10
Plainblaine,illidan,1366,mage,frost,116,57,59
Dinklord,azuremyst,1365,mage,frost,36,19,17
Rích,tichondrius,1363,mage,frost,150,69,81
Kevymarts,tichondrius,1358,mage,frost,54,31,23
Gazzuu,ragnaros,1358,mage,frost,48,23,25
Starkp,ragnaros,1357,mage,frost,177,86,91
Frostitutå,eonar,1356,mage,frost,148,72,76
Puvö,tichondrius,1356,mage,frost,62,29,33
Suicune,area-52,1353,mage,frost,35,16,19
Tentaçao,stormrage,1352,mage,frost,68,34,34
Magicmooman,thunderlord,1350,mage,frost,75,36,39
Mageosaurusx,tichondrius,1350,mage,frost,45,16,29
Gualter,nemesis,1347,mage,frost,159,86,73
Radiku,blood-furnace,1347,mage,frost,31,16,15
Thatotherguy,lightnings-blade,1347,mage,frost,34,17,17
Gasolína,stormrage,1346,mage,frost,106,48,58
Freez,garona,1346,mage,frost,40,18,22
Anarista,wyrmrest-accord,1345,mage,frost,24,15,9
Aqcamus,illidan,1344,mage,frost,23,15,8
Cyberstar,proudmoore,1344,mage,frost,47,26,21
Cryogeniks,illidan,1343,mage,frost,30,14,16
Truemagician,tichondrius,1342,mage,frost,18,14,4
Harrypothead,senjin,1342,mage,frost,41,26,15
Mageyoulooks,kelthuzad,1340,mage,frost,36,17,19
Hirune,ragnaros,1340,mage,frost,76,29,47
Krabby,malganis,1337,mage,frost,66,26,40
Shäräpova,zuljin,1336,mage,frost,42,24,18
Luckysix,illidan,1336,mage,frost,36,14,22
Safu,bleeding-hollow,1335,mage,frost,120,63,57
Milambehr,elune,1335,mage,frost,60,31,29
Aherom,ragnaros,1334,mage,frost,81,45,36
Hammed,dalaran,1334,mage,frost,68,32,36
Frøzzen,quelthalas,1334,mage,frost,159,74,85
Safety,stormreaver,1330,mage,frost,146,77,69
Frostítute,alterac-mountains,1330,mage,frost,78,38,40
Bound,emerald-dream,1329,mage,frost,29,15,14
Shimmerpoly,sargeras,1329,mage,frost,36,14,22
Juul,emerald-dream,1328,mage,frost,237,109,128
Arcranium,icecrown,1328,mage,frost,48,20,28
Kyll,moon-guard,1326,mage,frost,36,17,19
Epifeni,blackrock,1326,mage,frost,73,31,42
Selless,zuljin,1325,mage,frost,66,33,33
Tyrecgosa,tichondrius,1323,mage,frost,78,44,34
Eriktherod,maelstrom,1321,mage,frost,36,15,21
Tarmiel,quelthalas,1319,mage,frost,54,28,26
Iladiin,malganis,1319,mage,frost,76,37,39
Drdocx,frostmourne,1317,mage,frost,30,14,16
Skillcap,nagrand,1315,mage,frost,30,16,14
Ankidar,quelthalas,1315,mage,frost,30,14,16
Aarne,thrall,1315,mage,frost,36,16,20
Elegantbroth,illidan,1312,mage,frost,30,14,16
Affinitty,zuljin,1311,mage,frost,60,30,30
Phergo,ragnaros,1311,mage,frost,36,14,22
Ragemage,borean-tundra,1311,mage,frost,59,20,39
Burist,illidan,1310,mage,frost,30,16,14
Plunks,bleeding-hollow,1310,mage,frost,80,30,50
Mntaindew,bleeding-hollow,1309,mage,frost,35,14,21
Vorass,kelthuzad,1305,mage,frost,48,21,27
Fireguard,azralon,1305,mage,frost,55,23,32
Menacë,tichondrius,1304,mage,frost,84,42,42
Tyning,blood-furnace,1304,mage,frost,60,30,30
Xárdas,quelthalas,1302,mage,frost,107,56,51
Soia,ragnaros,1302,mage,frost,143,72,71
Rahzac,dalaran,1302,mage,frost,62,29,33
Haruká,ragnaros,1300,mage,frost,45,15,30
Jorzan,kelthuzad,1298,mage,frost,30,15,15
Eskimoan,frostmourne,1298,mage,frost,42,15,27
Jugobomb,madoran,1295,mage,frost,46,25,21
Drewzz,tichondrius,1292,mage,frost,29,17,12
Annalee,ragnaros,1292,mage,frost,30,14,16
Remana,anvilmar,1291,mage,frost,30,15,15
Andorlin,barthilas,1287,mage,frost,59,27,32
Defarefa,frostmourne,1285,mage,frost,182,91,91
Rastafarix,ragnaros,1285,mage,frost,47,21,26
Médüsa,moon-guard,1284,mage,frost,36,16,20
Cìfel,quelthalas,1281,mage,frost,31,18,13
Dohnutt,tichondrius,1281,mage,frost,53,25,28
Alìv,tichondrius,1281,mage,frost,202,92,110
Samaë,zuljin,1281,mage,frost,47,19,28
Gsr,nerzhul,1280,mage,frost,64,30,34
Ràmdas,hyjal,1278,mage,frost,60,30,30
Derpmanjr,area-52,1277,mage,frost,60,39,21
Thergon,kul-tiras,1277,mage,frost,44,22,22
Skynhet,ragnaros,1277,mage,frost,36,16,20
Magicbunny,andorhal,1275,mage,frost,261,129,132
Peetufo,whisperwind,1274,mage,frost,47,21,26
Showtíme,spirestone,1273,mage,frost,24,16,8
Åquå,area-52,1273,mage,frost,39,23,16
Kryliak,ragnaros,1273,mage,frost,60,33,27
Abracadaver,greymane,1273,mage,frost,70,38,32
Discoinferno,kelthuzad,1273,mage,frost,45,22,23
Somethinglos,sargeras,1273,mage,frost,106,47,59
Ignit,stormrage,1272,mage,frost,40,19,21
Feogato,proudmoore,1271,mage,frost,153,76,77
Quietusllil,gurubashi,1269,mage,frost,102,60,42
Luckysi,illidan,1268,mage,frost,38,15,23
Vengefuly,tichondrius,1264,mage,frost,34,17,17
Bossmage,tichondrius,1263,mage,frost,37,15,22
Missingxx,silvermoon,1261,mage,frost,53,26,27
Whyammage,dalaran,1260,mage,frost,77,46,31
Rizzbliz,sargeras,1260,mage,frost,30,16,14
Satív,moknathal,1258,mage,frost,42,25,17
Zedroçk,shadowmoon,1256,mage,frost,42,17,25
Paidemago,azralon,1255,mage,frost,83,47,36
Nynalith,area-52,1255,mage,frost,36,18,18
Guji,area-52,1255,mage,frost,55,26,29
Sîmply,zuljin,1255,mage,frost,72,27,45
Degenhours,illidan,1253,mage,frost,51,25,26
Numz,sargeras,1252,mage,frost,148,67,81
Bubbleblower,hakkar,1249,mage,frost,42,24,18
Hýdramist,sargeras,1246,mage,frost,24,13,11
Tessar,moon-guard,1245,mage,frost,117,50,67
Mângo,frostmourne,1243,mage,frost,24,13,11
Lucyphilis,stormrage,1243,mage,frost,86,43,43
Cheapsects,drakthul,1243,mage,frost,56,28,28
Unleáshed,moonrunner,1243,mage,frost,147,73,74
Kromeus,illidan,1243,mage,frost,48,23,25
Låvazza,tichondrius,1242,mage,frost,24,13,11
Nukedat,proudmoore,1241,mage,frost,24,13,11
Finnese,medivh,1240,mage,frost,24,14,10
Vênsêr,emerald-dream,1240,mage,frost,30,13,17
Merkkinz,thrall,1239,mage,frost,65,31,34
Mageyoulooks,shattered-hand,1237,mage,frost,36,17,19
Agniih,azralon,1236,mage,frost,72,34,38
ßlitzkreig,area-52,1235,mage,frost,24,18,6
Hykkup,frostmourne,1232,mage,frost,24,13,11
Hotpeachpie,zuljin,1232,mage,frost,97,48,49
Phoenixic,frostmourne,1232,mage,frost,191,84,107
Magifish,malganis,1231,mage,frost,62,35,27
Rankryman,quelthalas,1231,mage,frost,58,29,29
Magicginger,barthilas,1231,mage,frost,52,23,29
Optic,chogall,1230,mage,frost,28,14,14
Dumblexgamer,ragnaros,1230,mage,frost,84,37,47
Frostzadan,quelthalas,1228,mage,frost,56,23,33
Arcaninez,bleeding-hollow,1224,mage,frost,24,13,11
Skizzlés,bleeding-hollow,1222,mage,frost,24,13,11
Jobar,malganis,1221,mage,frost,24,13,11
Makén,illidan,1220,mage,frost,60,38,22
Jagmag,area-52,1219,mage,frost,18,14,4
Jejihev,drakkari,1219,mage,frost,35,17,18
Juxmcmage,kiljaeden,1218,mage,frost,95,39,56
Maac,nemesis,1217,mage,frost,47,20,27
Trincando,azralon,1217,mage,frost,50,19,31
Dazby,tichondrius,1213,mage,frost,39,17,22
Fabled,stonemaul,1209,mage,frost,36,14,22
Phantombila,azralon,1207,mage,frost,39,14,25
Djp,tichondrius,1206,mage,frost,43,25,18
Iceehott,kargath,1206,mage,frost,73,38,35
Akagamix,sargeras,1206,mage,frost,53,23,30
Gunzz,aegwynn,1202,mage,frost,48,21,27
Kevdra,kelthuzad,1202,mage,frost,79,34,45
Acarilla,stormrage,1199,mage,frost,54,20,34
Lildabpen,tichondrius,1197,mage,frost,110,51,59
Saski,nathrezim,1196,mage,frost,30,16,14
Palruki,tichondrius,1193,mage,frost,60,22,38
Sturmrevenge,lightnings-blade,1192,mage,frost,202,102,100
Sahir,thaurissan,1191,mage,frost,72,34,38
Valrendor,nazjatar,1191,mage,frost,79,36,43
Copperfield,dreadmaul,1189,mage,frost,145,66,79
Dooie,sargeras,1188,mage,frost,28,19,9
Icybanter,emerald-dream,1186,mage,frost,59,24,35
Crizzpy,tichondrius,1184,mage,frost,89,44,45
Canassa,azralon,1183,mage,frost,131,66,65
Maigoddess,proudmoore,1180,mage,frost,71,29,42
Twinklestars,sargeras,1179,mage,frost,72,40,32
Numaïr,kiljaeden,1179,mage,frost,68,27,41
Featherboo,stormrage,1178,mage,frost,35,16,19
Chade,dunemaul,1178,mage,frost,53,22,31
Highafrn,area-52,1177,mage,frost,48,21,27
Icebboxx,tichondrius,1176,mage,frost,36,21,15
Daddyplease,bleeding-hollow,1176,mage,frost,54,26,28
Deadmarley,blackhand,1174,mage,frost,42,24,18
Wowenjoyer,area-52,1174,mage,frost,97,46,51
Alatria,frostmourne,1174,mage,frost,78,31,47
Surrsly,tortheldrin,1173,mage,frost,24,14,10
Corrmic,winterhoof,1172,mage,frost,78,40,38
Perfectpink,bleeding-hollow,1171,mage,frost,42,21,21
Gatka,quelthalas,1171,mage,frost,334,162,172
Layolis,area-52,1170,mage,frost,92,46,46
Pendrake,sargeras,1170,mage,frost,34,13,21
Darkrukia,tichondrius,1168,mage,frost,63,32,31
Cransmage,illidan,1168,mage,frost,30,14,16
Cocmagic,kelthuzad,1167,mage,frost,33,15,18
Aquariusmoon,bonechewer,1166,mage,frost,60,31,29
Samuoa,tichondrius,1166,mage,frost,47,22,25
Kelvii,tichondrius,1164,mage,frost,33,16,17
Akhilá,stormrage,1163,mage,frost,35,15,20
Yamitenshi,dalaran,1162,mage,frost,68,24,44
Ejzok,dreadmaul,1159,mage,frost,261,116,145
Soya,sargeras,1159,mage,frost,41,18,23
Devlux,area-52,1158,mage,frost,104,50,54
Cavit,wyrmrest-accord,1157,mage,frost,72,34,38
Khaldyn,tichondrius,1156,mage,frost,132,65,67
Hotfixes,barthilas,1154,mage,frost,24,14,10
Azzurn,doomhammer,1154,mage,frost,30,17,13
Floopse,agamaggan,1153,mage,frost,18,13,5
Bçøløñápûðgé,illidan,1152,mage,frost,18,12,6
Iceward,frostmourne,1151,mage,frost,18,12,6
Zlint,ragnaros,1151,mage,frost,24,12,12
Czq,tichondrius,1150,mage,frost,18,12,6
Damage,skullcrusher,1150,mage,frost,31,13,18
Magewara,area-52,1147,mage,frost,18,12,6
Versacejay,sargeras,1147,mage,frost,24,12,12
Snipymagus,shattered-hand,1146,mage,frost,27,13,14
Pyroshima,barthilas,1145,mage,frost,40,13,27
Yungice,hyjal,1144,mage,frost,36,14,22
Frenk,moon-guard,1143,mage,frost,42,15,27
Diixynormus,illidan,1142,mage,frost,36,20,16
Vasthrash,bleeding-hollow,1142,mage,frost,78,33,45
Letitgoo,azralon,1140,mage,frost,64,30,34
Tsuchek,tichondrius,1139,mage,frost,24,12,12
Unlike,sargeras,1139,mage,frost,24,12,12
Hiiamtay,azralon,1138,mage,frost,26,14,12
Boldwarp,dalaran,1138,mage,frost,29,14,15
Osda,azralon,1137,mage,frost,42,23,19
Rekonx,tichondrius,1136,mage,frost,143,68,75
Littlebeth,azjolnerub,1127,mage,frost,95,49,46
Rkbj,korgath,1125,mage,frost,48,18,30
Fatum,ragnaros,1124,mage,frost,32,14,18
Elwyn,dunemaul,1123,mage,frost,27,13,14
Evierix,illidan,1123,mage,frost,88,42,46
Nazneen,elune,1122,mage,frost,73,31,42
Icelordd,ragnaros,1121,mage,frost,30,14,16
Coldfrønt,moon-guard,1120,mage,frost,48,21,27
Dannyyoo,blackrock,1116,mage,frost,23,12,11
Giovannie,zuluhed,1116,mage,frost,78,35,43
Bellåtrîx,quelthalas,1115,mage,frost,18,12,6
Who,emerald-dream,1113,mage,frost,58,27,31
Sølem,frostmourne,1112,mage,frost,42,16,26
Levitaine,bleeding-hollow,1110,mage,frost,38,19,19
Ibalyn,khazgoroth,1109,mage,frost,101,49,52
Castingmommy,moon-guard,1108,mage,frost,73,37,36
Smáckington,tichondrius,1106,mage,frost,156,75,81
Granmago,azralon,1106,mage,frost,30,12,18
Skdonkay,nerzhul,1102,mage,frost,89,45,44
Xar,guldan,1100,mage,frost,28,12,16
Hollerin,whisperwind,1098,mage,frost,18,12,6
Memnor,amanthul,1098,mage,frost,24,12,12
Magedango,bleeding-hollow,1095,mage,frost,35,14,21
Esun,moon-guard,1088,mage,frost,36,17,19
Drumzter,ragnaros,1085,mage,frost,41,21,20
Ralzarek,zuluhed,1085,mage,frost,30,15,15
Finanahs,sargeras,1084,mage,frost,43,28,15
Gradivous,emerald-dream,1084,mage,frost,133,63,70
Raxxor,muradin,1084,mage,frost,48,19,29
Cuoreforte,moon-guard,1082,mage,frost,30,12,18
Mageboy,bonechewer,1082,mage,frost,35,12,23
Helcarwen,area-52,1081,mage,frost,31,13,18
Wickednoob,malganis,1080,mage,frost,132,62,70
Blancnoir,tichondrius,1080,mage,frost,51,22,29
Zould,alleria,1076,mage,frost,24,12,12
Dairian,whisperwind,1076,mage,frost,30,12,18
Kaël,area-52,1074,mage,frost,24,12,12
Mageeoh,bleeding-hollow,1072,mage,frost,47,15,32
Worknlurk,malganis,1071,mage,frost,30,16,14
Leets,mugthol,1070,mage,frost,18,12,6
Gryd,area-52,1070,mage,frost,88,43,45
Gelile,tichondrius,1070,mage,frost,65,30,35
Travarra,terenas,1069,mage,frost,60,19,41
Mageolisious,kelthuzad,1063,mage,frost,30,12,18
Twirkin,proudmoore,1061,mage,frost,51,24,27
Dealzy,malganis,1056,mage,frost,18,11,7
Justmoss,sargeras,1056,mage,frost,18,11,7
Wanming,tichondrius,1056,mage,frost,24,11,13
Saydar,stormrage,1056,mage,frost,36,11,25
Redhell,dalaran,1055,mage,frost,18,11,7
Magekingz,shattered-halls,1055,mage,frost,60,29,31
Zacx,area-52,1055,mage,frost,24,11,13
Gadogear,draka,1054,mage,frost,30,11,19
Doubledown,kiljaeden,1053,mage,frost,18,11,7
Corucia,echo-isles,1053,mage,frost,256,121,135
Xannymancan,tichondrius,1052,mage,frost,60,23,37
Walrusxo,kelthuzad,1052,mage,frost,30,11,19
Coldshouldér,nerzhul,1051,mage,frost,24,11,13
Linsz,nemesis,1051,mage,frost,24,11,13
Auralyn,wyrmrest-accord,1051,mage,frost,25,11,14
Zuqo,sargeras,1050,mage,frost,18,11,7
Mirmaduck,wyrmrest-accord,1049,mage,frost,18,11,7
Klinkr,illidan,1049,mage,frost,30,11,19
Ggtoasted,thrall,1048,mage,frost,18,11,7
Moistcream,bloodscalp,1047,mage,frost,22,12,10
Zehlks,garrosh,1047,mage,frost,30,13,17
Zibbo,ragnaros,1046,mage,frost,18,11,7
Ceadruk,darkspear,1046,mage,frost,30,14,16
Wawakun,ragnaros,1045,mage,frost,17,12,5
Cäelüm,area-52,1045,mage,frost,30,11,19
Dimmershnitz,draka,1044,mage,frost,18,11,7
Mindthegap,tichondrius,1044,mage,frost,57,30,27
Keahiláni,area-52,1043,mage,frost,27,13,14
Vyninovan,aggramar,1043,mage,frost,24,11,13
Hhavok,scarlet-crusade,1043,mage,frost,48,12,36
Magicke,azgalor,1042,mage,frost,23,14,9
Iacceptvenmo,tichondrius,1041,mage,frost,18,11,7
Ispell,tichondrius,1040,mage,frost,30,20,10
Devoh,dunemaul,1040,mage,frost,20,11,9
Limeade,ursin,1038,mage,frost,24,11,13
Xoxmage,frostmourne,1037,mage,frost,66,35,31
Arkoz,tichondrius,1035,mage,frost,24,14,10
Starguy,laughing-skull,1034,mage,frost,37,14,23
Trentos,illidan,1033,mage,frost,54,29,25
Pugsmugg,icecrown,1032,mage,frost,49,13,36
Brashen,stormrage,1030,mage,frost,55,27,28
Sluagh,terenas,1028,mage,frost,64,30,34
Aurumpaleas,moon-guard,1028,mage,frost,30,14,16
Niscra,nemesis,1026,mage,frost,40,12,28
Mugiara,azralon,1025,mage,frost,27,12,15
Sciona,suramar,1025,mage,frost,141,62,79
Drbloodmuscl,black-dragonflight,1020,mage,frost,36,15,21
Codexzero,bleeding-hollow,1017,mage,frost,66,29,37
Briélla,area-52,1015,mage,frost,80,39,41
Trollsita,thrall,1013,mage,frost,18,11,7
Landard,exodar,1012,mage,frost,48,28,20
Voidera,wyrmrest-accord,1012,mage,frost,36,11,25
Sènding,sargeras,1010,mage,frost,42,11,31
Oopsyourapig,darkspear,1007,mage,frost,48,17,31
Khrixa,illidan,1006,mage,frost,120,57,63
Rizzbot,sargeras,1005,mage,frost,75,27,48
Pizzle,perenolde,1004,mage,frost,58,27,31
Neacel,tichondrius,1004,mage,frost,24,11,13
Stankfreezer,thrall,1002,mage,frost,17,11,6
Hambürglar,garrosh,999,mage,frost,30,13,17
Jaymage,agamaggan,994,mage,frost,37,13,24
Vantus,tichondrius,993,mage,frost,32,17,15
Kannim,sargeras,992,mage,frost,66,27,39
Megapasta,illidan,989,mage,frost,23,11,12
Duwapkaine,sargeras,989,mage,frost,36,11,25
Superoirity,trollbane,988,mage,frost,48,24,24
Jayfunk,sargeras,984,mage,frost,23,11,12
Bòóyah,muradin,980,mage,frost,40,21,19
Grudel,archimonde,979,mage,frost,41,21,20
Moonfhang,azralon,977,mage,frost,293,139,154
Hugadoug,zuljin,977,mage,frost,42,13,29
Bigpinkies,korgath,976,mage,frost,42,16,26
Thaldarian,emerald-dream,975,mage,frost,31,12,19
Dejavuh,dalaran,972,mage,frost,54,25,29
Rephlex,tichondrius,970,mage,frost,19,11,8
Crankweigth,rivendare,968,mage,frost,90,43,47
Dieselonfire,the-venture-co,967,mage,frost,56,29,27
Bootnet,drakkari,964,mage,frost,66,19,47
Édika,area-52,963,mage,frost,30,11,19
Torthie,burning-blade,960,mage,frost,12,10,2
Bigsplosions,kiljaeden,960,mage,frost,15,11,4
Kygores,tichondrius,960,mage,frost,18,10,8
Thefridge,shadowmoon,960,mage,frost,18,10,8
Tainx,frostmourne,960,mage,frost,18,10,8
Hadlly,tichondrius,960,mage,frost,18,10,8
Ntys,frostmourne,959,mage,frost,18,10,8
Legendkiller,bleeding-hollow,959,mage,frost,18,10,8
Arillius,malganis,959,mage,frost,18,10,8
Boogley,bloodhoof,959,mage,frost,21,11,10
Finnancy,stormrage,959,mage,frost,24,10,14
Bigmêan,boulderfist,958,mage,frost,18,10,8
Vivàs,dalaran,958,mage,frost,18,10,8
Fineous,kalecgos,958,mage,frost,24,10,14
Hylord,tichondrius,957,mage,frost,18,10,8
Zunyu,tichondrius,957,mage,frost,18,10,8
Shephard,nemesis,956,mage,frost,24,10,14
Westii,illidan,955,mage,frost,24,10,14
Nethros,stormrage,954,mage,frost,15,11,4
Trízín,frostmourne,954,mage,frost,18,10,8
Nnenna,bonechewer,952,mage,frost,18,10,8
Raáiden,stormrage,952,mage,frost,60,25,35
Unmix,tichondrius,952,mage,frost,24,10,14
Imoen,zangarmarsh,951,mage,frost,36,15,21
Stinker,nazjatar,951,mage,frost,24,10,14
Nksbluedeath,area-52,949,mage,frost,18,10,8
Keelaron,proudmoore,949,mage,frost,24,10,14
Rasmin,greymane,948,mage,frost,40,22,18
Marschubas,drakthul,948,mage,frost,125,59,66
Vynruki,area-52,948,mage,frost,42,19,23
Shírley,tichondrius,948,mage,frost,30,10,20
Redeyez,arthas,947,mage,frost,137,65,72
Misfyre,malganis,946,mage,frost,28,11,17
Syndra,korialstrasz,942,mage,frost,30,10,20
Onlyfansme,dalaran,939,mage,frost,18,10,8
Dambea,tichondrius,938,mage,frost,23,11,12
Mystics,dawnbringer,938,mage,frost,146,62,84
Prometheus,crushridge,937,mage,frost,64,31,33
Loa,hydraxis,937,mage,frost,24,10,14
Bôsco,bleeding-hollow,936,mage,frost,20,11,9
Diegoneally,bleeding-hollow,936,mage,frost,63,26,37
Angerfrost,khazgoroth,935,mage,frost,48,23,25
Hékate,moon-guard,935,mage,frost,60,16,44
Hasty,emerald-dream,927,mage,frost,29,10,19
Maldine,tol-barad,926,mage,frost,18,10,8
Ärià,sargeras,926,mage,frost,18,10,8
Trollings,azralon,925,mage,frost,63,30,33
Crimpster,illidan,923,mage,frost,36,10,26
Fireace,emerald-dream,922,mage,frost,17,10,7
Drpeppor,blades-edge,922,mage,frost,18,10,8
Fireblast,stormscale,922,mage,frost,41,16,25
Scár,blackrock,921,mage,frost,32,16,16
Brynach,trollbane,913,mage,frost,42,20,22
Nezarrek,sargeras,912,mage,frost,59,34,25
Mongera,bonechewer,909,mage,frost,56,28,28
Moesel,emerald-dream,908,mage,frost,15,11,4
Leocius,daggerspine,906,mage,frost,23,10,13
Iesca,ragnaros,899,mage,frost,41,16,25
Lillbean,thunderlord,894,mage,frost,25,11,14
Luxfumante,azralon,874,mage,frost,30,15,15
Tristania,archimonde,872,mage,frost,119,59,60
Cawyro,caelestrasz,869,mage,frost,59,26,33
Benzos,eitrigg,864,mage,frost,12,9,3
Blurrs,illidan,864,mage,frost,12,9,3
Nalabb,illidan,864,mage,frost,12,9,3
Froznpizza,zuljin,864,mage,frost,12,9,3
Kaylemage,tichondrius,864,mage,frost,12,9,3
Variex,tichondrius,864,mage,frost,12,9,3
Rositajonez,terenas,864,mage,frost,12,9,3
Furisheep,stormrage,864,mage,frost,12,9,3
Ihaveadream,proudmoore,864,mage,frost,12,9,3
Stefanfs,tichondrius,864,mage,frost,18,9,9
Fromcanada,eitrigg,864,mage,frost,18,9,9
Hyoonsfeet,stormrage,864,mage,frost,18,9,9
Ariezx,kelthuzad,864,mage,frost,18,9,9
Isömetrics,tichondrius,864,mage,frost,18,9,9
Weathersmell,tichondrius,864,mage,frost,18,9,9
Skoals,thrall,864,mage,frost,29,10,19
Lastiari,wyrmrest-accord,863,mage,frost,18,9,9
Jottami,azralon,863,mage,frost,18,9,9
Blinkbotx,proudmoore,863,mage,frost,18,9,9
Juanmánce,quelthalas,863,mage,frost,20,9,11
Blinkharder,stormrage,863,mage,frost,24,9,15
Benjamming,ragnaros,863,mage,frost,24,9,15
Wolfsmind,frostmourne,863,mage,frost,30,9,21
Azmage,vashj,862,mage,frost,12,9,3
Cryyo,queldorei,862,mage,frost,18,9,9
Jodebabss,dalaran,862,mage,frost,18,9,9
Faire,stonemaul,862,mage,frost,18,9,9
Boredomkïlls,burning-legion,862,mage,frost,18,9,9
Åøe,tichondrius,862,mage,frost,18,9,9
Youngwiz,arthas,862,mage,frost,18,9,9
Neomage,elune,862,mage,frost,22,9,13
Corinthiax,wyrmrest-accord,862,mage,frost,24,9,15
Tunax,tichondrius,862,mage,frost,24,9,15
Converseqt,stormrage,862,mage,frost,30,9,21
Shenme,moon-guard,861,mage,frost,20,9,11
Numb,trollbane,861,mage,frost,24,9,15
Fruza,emerald-dream,860,mage,frost,16,10,6
Zaxrie,malganis,860,mage,frost,18,9,9
Pantsbeard,illidan,859,mage,frost,30,9,21
Billionnaire,tichondrius,858,mage,frost,12,9,3
Vallet,ragnaros,858,mage,frost,12,9,3
Frðstítutè,tichondrius,858,mage,frost,24,9,15
Cùrtiñ,tichondrius,858,mage,frost,30,9,21
Telios,azralon,857,mage,frost,16,10,6
Plasmah,saurfang,856,mage,frost,18,9,9
Naar,ghostlands,855,mage,frost,18,9,9
Smoney,icecrown,855,mage,frost,18,9,9
Kaboozles,area-52,853,mage,frost,24,9,15
Hýdro,ghostlands,853,mage,frost,24,9,15
Naoz,ragnaros,851,mage,frost,18,9,9
Maplemage,akama,851,mage,frost,18,9,9
Zabaione,stormrage,847,mage,frost,28,10,18
Avers,frostwolf,844,mage,frost,24,9,15
Bandagris,garrosh,840,mage,frost,21,10,11
Jarethleon,ragnaros,837,mage,frost,21,11,10
Taylorrain,arthas,836,mage,frost,42,17,25
Âürõrâ,firetree,834,mage,frost,24,9,15
Rathrizar,emerald-dream,829,mage,frost,48,21,27
Craftin,sargeras,827,mage,frost,18,9,9
Itoncruxy,tichondrius,825,mage,frost,69,30,39
Blync,emerald-dream,821,mage,frost,18,9,9
Summey,tichondrius,815,mage,frost,29,9,20
Mideon,whisperwind,810,mage,frost,49,21,28
Airgumbo,illidan,796,mage,frost,14,9,5
Zionist,earthen-ring,796,mage,frost,14,9,5
Lünâliä,bleeding-hollow,796,mage,frost,20,10,10
Powder,lightninghoof,783,mage,frost,24,12,12
Assasix,tichondrius,772,mage,frost,42,13,29
Homodilf,blackrock,771,mage,frost,30,11,19
Arrokoth,malganis,768,mage,frost,12,8,4
Eyesofrage,tichondrius,768,mage,frost,12,8,4
Brandonlol,area-52,768,mage,frost,12,8,4
Dearyuanmage,tichondrius,768,mage,frost,12,8,4
Pipendselloy,boulderfist,768,mage,frost,12,8,4
Frightmare,sargeras,768,mage,frost,12,8,4
Pandazed,stormscale,768,mage,frost,12,8,4
Edm,proudmoore,768,mage,frost,12,8,4
Nefm,frostmourne,768,mage,frost,12,8,4
Wiztopher,frostmourne,768,mage,frost,12,8,4
Lycheeoolong,frostmourne,768,mage,frost,18,8,10
Pateyz,malganis,768,mage,frost,18,8,10
Zstyle,frostmourne,768,mage,frost,18,8,10
Georgian,malfurion,768,mage,frost,18,8,10
Blinkinghobo,sargeras,768,mage,frost,18,8,10
Dead,nemesis,768,mage,frost,18,8,10
Jooblee,illidan,768,mage,frost,18,8,10
Yeetcannøn,illidan,768,mage,frost,18,8,10
Magibe,thrall,768,mage,frost,18,8,10
Mcdude,kiljaeden,768,mage,frost,18,8,10
Magnificaxd,area-52,768,mage,frost,24,8,16
Vonte,elune,767,mage,frost,12,8,4
Nôtôrious,thrall,767,mage,frost,12,8,4
Mokelovinwtf,tichondrius,767,mage,frost,12,8,4
Frosttwoop,moon-guard,767,mage,frost,12,8,4
Magicmaster,quelthalas,767,mage,frost,12,8,4
Combusty,sargeras,767,mage,frost,12,8,4
Vonfrmdao,illidan,767,mage,frost,12,8,4
Seeumaybe,proudmoore,767,mage,frost,12,8,4
Songnineone,tichondrius,767,mage,frost,12,8,4
Léras,stormrage,767,mage,frost,12,8,4
Crvarla,tichondrius,767,mage,frost,12,8,4
Leghacy,korgath,767,mage,frost,12,8,4
Mempool,darkspear,767,mage,frost,12,8,4
Centrika,emerald-dream,767,mage,frost,18,8,10
Keiiox,ragnaros,767,mage,frost,18,8,10
Wickymorph,barthilas,767,mage,frost,18,8,10
Qtqq,malganis,767,mage,frost,18,8,10
Staytrill,stormreaver,767,mage,frost,18,8,10
Vamplol,tichondrius,767,mage,frost,18,8,10
Badboykilla,dentarg,767,mage,frost,21,9,12
Failzy,darkspear,767,mage,frost,24,8,16
Gardes,tichondrius,767,mage,frost,24,8,16
Mägï,tichondrius,766,mage,frost,12,8,4
Teloiv,malganis,766,mage,frost,12,8,4
Snowybunny,emerald-dream,766,mage,frost,24,8,16
Barcilas,proudmoore,766,mage,frost,24,8,16
Moonpie,frostmane,765,mage,frost,12,8,4
Moonwater,vashj,765,mage,frost,18,8,10
Emelian,barthilas,765,mage,frost,24,8,16
Rmprmp,tichondrius,764,mage,frost,18,8,10
Snowjôb,illidan,764,mage,frost,24,8,16
Marvelcuck,sargeras,763,mage,frost,12,8,4
Frigginbeast,shattered-halls,762,mage,frost,19,8,11
Ashklabam,azralon,761,mage,frost,12,8,4
Subshero,sargeras,757,mage,frost,12,8,4
Ràisens,stormscale,755,mage,frost,12,8,4
Queimabixo,azralon,755,mage,frost,18,8,10
Scmage,exodar,755,mage,frost,18,8,10
Icepickk,blackwater-raiders,752,mage,frost,12,8,4
Ratrider,dreadmaul,752,mage,frost,12,8,4
Eisson,hyjal,751,mage,frost,17,8,9
Merlinaa,ragnaros,750,mage,frost,22,8,14
Hoecakez,tichondrius,749,mage,frost,17,9,8
Artruis,detheroc,748,mage,frost,12,8,4
Bandmaid,emerald-dream,736,mage,frost,16,9,7
Cowwboydan,malganis,735,mage,frost,14,9,5
Phalkore,dalaran,735,mage,frost,16,8,8
Omegablink,sargeras,734,mage,frost,17,8,9
Silverstrza,gnomeregan,726,mage,frost,18,8,10
Heca,tichondrius,719,mage,frost,11,8,3
Ìgnìtìöñ,whisperwind,718,mage,frost,21,8,13
Triambukh,grizzly-hills,712,mage,frost,25,10,15
Scarlin,proudmoore,703,mage,frost,11,8,3
Kahve,dalaran,672,mage,frost,12,7,5
Fakewizard,frostmane,672,mage,frost,12,7,5
Neovim,stormrage,672,mage,frost,12,7,5
Reptär,demon-soul,672,mage,frost,12,7,5
Brobo,chogall,672,mage,frost,12,7,5
Elfvis,deathwing,672,mage,frost,12,7,5
Sylendron,area-52,672,mage,frost,12,7,5
Kujousara,stormrage,672,mage,frost,12,7,5
Stinkyblinky,bleeding-hollow,672,mage,frost,12,7,5
Myfamilygpie,nazgrel,672,mage,frost,12,7,5
Mushys,stormrage,672,mage,frost,12,7,5
Kogin,thrall,672,mage,frost,12,7,5
Toteypotter,frostmourne,672,mage,frost,12,7,5
Cädemäddox,stormrage,672,mage,frost,12,7,5
Emvepee,sargeras,672,mage,frost,12,7,5
Bigchilly,malganis,672,mage,frost,12,7,5
Lessthnthree,frostmourne,672,mage,frost,12,7,5
Proximalol,tichondrius,672,mage,frost,12,7,5
Crnomage,area-52,672,mage,frost,12,7,5
Legelance,malganis,672,mage,frost,12,7,5
Playtimex,proudmoore,672,mage,frost,12,7,5
Matchstickk,tichondrius,672,mage,frost,15,8,7
Riverb,bleeding-hollow,672,mage,frost,18,7,11
Xàr,ragnaros,672,mage,frost,18,7,11
Privilege,burning-legion,672,mage,frost,18,7,11
Lillb,bleeding-hollow,672,mage,frost,18,7,11
Arynnwyll,chogall,672,mage,frost,18,7,11
Svenny,tichondrius,672,mage,frost,18,7,11
Licklix,tichondrius,672,mage,frost,18,7,11
Fortemage,tichondrius,672,mage,frost,24,7,17
Parapio,tichondrius,672,mage,frost,24,7,17
Ranidos,area-52,671,mage,frost,12,7,5
Tokiaro,tortheldrin,671,mage,frost,12,7,5
Nihilitý,malganis,671,mage,frost,12,7,5
Blinksz,korgath,671,mage,frost,12,7,5
Hermiønie,quelthalas,671,mage,frost,12,7,5
Khaziiong,scilla,671,mage,frost,12,7,5
Rekys,black-dragonflight,671,mage,frost,12,7,5
Athenaswrath,sargeras,671,mage,frost,12,7,5
Snoogma,illidan,671,mage,frost,12,7,5
Finnapoly,area-52,671,mage,frost,15,8,7
Arittamordio,sargeras,671,mage,frost,15,8,7
Msspelld,turalyon,671,mage,frost,14,7,7
Shãy,area-52,671,mage,frost,18,7,11
Elemenopi,thrall,671,mage,frost,18,7,11
Oharvestero,illidan,671,mage,frost,18,7,11
Tendies,blackwater-raiders,671,mage,frost,18,7,11
Arendelle,kiljaeden,671,mage,frost,18,7,11
Kasparhausar,garithos,671,mage,frost,18,7,11
Nickygift,tichondrius,671,mage,frost,18,7,11
Tchass,skullcrusher,670,mage,frost,12,7,5
Aulie,burning-blade,670,mage,frost,12,7,5
Ranje,kiljaeden,670,mage,frost,12,7,5
Kidfurry,wyrmrest-accord,670,mage,frost,12,7,5
Syura,ragnaros,670,mage,frost,18,7,11
Sparklmotion,cenarius,670,mage,frost,18,7,11
Putosucio,nordrassil,670,mage,frost,18,7,11
Xenagozs,antonidas,670,mage,frost,21,7,14
Criticalness,illidan,669,mage,frost,12,7,5
Scorgasm,thrall,669,mage,frost,12,7,5
Zalatirix,bleeding-hollow,669,mage,frost,12,7,5
Havôc,malorne,669,mage,frost,12,7,5
Banída,stormrage,669,mage,frost,12,7,5
Shinneex,ragnaros,669,mage,frost,18,7,11
Dchee,nerzhul,669,mage,frost,18,7,11
Xarmog,tichondrius,668,mage,frost,24,7,17
Nohealani,dragonmaw,667,mage,frost,15,8,7
Aumar,shandris,665,mage,frost,9,8,1
Evieril,tichondrius,665,mage,frost,12,7,5
Dánó,lightbringer,663,mage,frost,24,7,17
Tigoditties,emerald-dream,662,mage,frost,12,7,5
Critique,malorne,662,mage,frost,68,31,37
Deadlysok,barthilas,660,mage,frost,12,7,5
Magemochi,dalaran,658,mage,frost,12,7,5
Winstonchill,zuljin,640,mage,frost,16,7,9
Slaash,barthilas,639,mage,frost,14,8,6
Grausum,tichondrius,638,mage,frost,16,7,9
Magusia,emerald-dream,638,mage,frost,17,7,10
Shaynna,tichondrius,624,mage,frost,15,7,8
Leeandroo,quelthalas,623,mage,frost,17,7,10
Ghostblaze,blackhand,621,mage,frost,15,8,7
Krip,boulderfist,608,mage,frost,16,7,9
Ghili,tichondrius,607,mage,frost,11,7,4
Ghrámz,stormrage,607,mage,frost,16,7,9
Ineedashave,shandris,606,mage,frost,20,7,13
Skywarp,blackhand,606,mage,frost,25,7,18
Parruka,warsong,605,mage,frost,26,7,19
Iceqube,drenden,576,mage,frost,6,6,0
Lemonicee,sargeras,576,mage,frost,12,6,6
Phuzadd,tichondrius,576,mage,frost,12,6,6
Mägë,kirin-tor,576,mage,frost,12,6,6
Johncxvii,sargeras,576,mage,frost,12,6,6
Alludèd,illidan,576,mage,frost,12,6,6
Vritus,emerald-dream,576,mage,frost,12,6,6
Lunchfirst,tichondrius,576,mage,frost,12,6,6
Slicktrik,area-52,576,mage,frost,12,6,6
Decady,stormrage,576,mage,frost,12,6,6
Angelsarebad,illidan,576,mage,frost,12,6,6
Vixsiona,illidan,576,mage,frost,12,6,6
Galiax,illidan,576,mage,frost,12,6,6
Ingrumatig,tichondrius,576,mage,frost,12,6,6
Wetsocks,alexstrasza,576,mage,frost,12,6,6
Illblink,lightninghoof,576,mage,frost,12,6,6
Celia,area-52,576,mage,frost,12,6,6
Saymenre,tichondrius,576,mage,frost,12,6,6
Quinnc,tichondrius,576,mage,frost,12,6,6
Cambustion,frostmourne,576,mage,frost,12,6,6
Moogician,aerie-peak,576,mage,frost,12,6,6
Pollylol,proudmoore,576,mage,frost,12,6,6
Röcçö,tichondrius,576,mage,frost,12,6,6
Vamage,goldrinn,576,mage,frost,12,6,6
Eraticmage,illidan,576,mage,frost,12,6,6
Magemagick,mannoroth,576,mage,frost,12,6,6
Magidius,stormrage,576,mage,frost,12,6,6
Manadart,quelthalas,576,mage,frost,12,6,6
Dezz,gilneas,576,mage,frost,12,6,6
Teetems,sargeras,576,mage,frost,12,6,6
Krazemagi,stormrage,576,mage,frost,18,6,12
Polymurph,terenas,576,mage,frost,18,6,12
Fatalexo,tichondrius,576,mage,frost,18,6,12
Fromcanada,tichondrius,576,mage,frost,18,6,12
Avavava,thaurissan,576,mage,frost,18,6,12
Bustercraft,kelthuzad,576,mage,frost,18,6,12
Astería,ragnaros,576,mage,frost,20,6,14
Twiztidwitch,burning-legion,576,mage,frost,24,6,18
Polymorphlol,queldorei,576,mage,frost,24,6,18
Casual,arthas,575,mage,frost,12,6,6
Bloodpumper,thrall,575,mage,frost,12,6,6
Lisaerys,dalaran,575,mage,frost,12,6,6
Baultery,moon-guard,575,mage,frost,12,6,6
Tundraga,malganis,575,mage,frost,12,6,6
Bootygoats,emerald-dream,575,mage,frost,12,6,6
Cosï,ragnaros,575,mage,frost,12,6,6
Kickpollyplx,lothar,575,mage,frost,12,6,6
Oogabooga,lethon,575,mage,frost,12,6,6
Rieltar,barthilas,575,mage,frost,18,6,12
Lucidgaze,bonechewer,575,mage,frost,18,6,12
Nimingcn,tichondrius,575,mage,frost,18,6,12
Snowyj,khaz-modan,575,mage,frost,19,6,13
Millions,jubeithos,575,mage,frost,24,6,18
Icetooseeyou,barthilas,574,mage,frost,12,6,6
Kalzak,hyjal,574,mage,frost,12,6,6
Irrandina,moon-guard,574,mage,frost,12,6,6
Sigurð,khazgoroth,574,mage,frost,12,6,6
Bartholomew,lothar,574,mage,frost,18,6,12
Lincepotter,quelthalas,574,mage,frost,18,6,12
Harmful,frostmourne,574,mage,frost,18,6,12
Tonepedo,zuljin,574,mage,frost,18,6,12
Srloko,azralon,574,mage,frost,24,6,18
Josemayer,nemesis,573,mage,frost,12,6,6
Litiria,burning-blade,573,mage,frost,18,6,12
Sohotritenow,malganis,573,mage,frost,18,6,12
Piixxiie,sargeras,572,mage,frost,12,6,6
Sodrezinn,illidan,571,mage,frost,12,6,6
Monstermage,madoran,571,mage,frost,18,6,12
Frostitutex,malfurion,571,mage,frost,18,6,12
Eatmyfritter,stonemaul,570,mage,frost,12,6,6
Freyia,mugthol,569,mage,frost,18,6,12
Killerflaco,drakkari,566,mage,frost,30,6,24
Spellsurg,malganis,558,mage,frost,23,6,17
Meliam,tichondrius,557,mage,frost,29,6,23
Casualboy,skullcrusher,527,mage,frost,11,6,5
Ozwauld,emerald-dream,526,mage,frost,11,6,5
Pyromager,thrall,526,mage,frost,11,6,5
Gtown,kelthuzad,522,mage,frost,17,7,10
Jooss,quelthalas,521,mage,frost,18,7,11
Pidge,aggramar,519,mage,frost,22,6,16
Tatersmaccs,sargeras,517,mage,frost,20,7,13
Emieralol,tichondrius,512,mage,frost,10,6,4
Ereblink,proudmoore,511,mage,frost,11,6,5
Frostytoez,firetree,511,mage,frost,14,6,8
Korisaurus,tichondrius,496,mage,frost,13,6,7
Niccha,cenarion-circle,480,mage,frost,6,5,1
Flavaflame,mugthol,480,mage,frost,6,5,1
Roggitman,emerald-dream,480,mage,frost,6,5,1
Dasanimomo,sargeras,480,mage,frost,6,5,1
Pkf,tichondrius,480,mage,frost,6,5,1
Fromcanadaqc,zuljin,480,mage,frost,6,5,1
Magerat,icecrown,480,mage,frost,6,5,1
Buffmages,malfurion,480,mage,frost,6,5,1
Hansol,farstriders,480,mage,frost,6,5,1
Malafar,kilrogg,480,mage,frost,6,5,1
Melkdud,wyrmrest-accord,480,mage,frost,6,5,1
Fatamericanx,area-52,480,mage,frost,6,5,1
Elwynnforest,sargeras,480,mage,frost,6,5,1
Jarvase,mugthol,480,mage,frost,10,6,4
Veritas,wildhammer,480,mage,frost,10,6,4
Starguy,terenas,480,mage,frost,12,5,7
Triknology,dalaran,480,mage,frost,12,5,7
Combustya,khazgoroth,480,mage,frost,12,5,7
Razkall,shattered-hand,480,mage,frost,12,5,7
Vires,kelthuzad,480,mage,frost,12,5,7
Qordix,tichondrius,480,mage,frost,12,5,7
Adronicus,tichondrius,480,mage,frost,12,5,7
Lewpithy,area-52,480,mage,frost,12,5,7
Maelista,tichondrius,480,mage,frost,12,5,7
Iceyhott,bloodhoof,480,mage,frost,12,5,7
Gadwick,alexstrasza,480,mage,frost,12,5,7
Doodledew,bleeding-hollow,480,mage,frost,12,5,7
Harlloo,the-underbog,480,mage,frost,12,5,7
Frostyßamf,kiljaeden,480,mage,frost,12,5,7
Icetomeetyu,bleeding-hollow,480,mage,frost,12,5,7
Nunezz,mannoroth,480,mage,frost,12,5,7
Pyrod,tichondrius,480,mage,frost,12,5,7
Kayenri,area-52,480,mage,frost,12,5,7
Hustle,frostmourne,480,mage,frost,12,5,7
Foodfish,bleeding-hollow,480,mage,frost,12,5,7
Cinns,moon-guard,480,mage,frost,12,5,7
Tëy,zuljin,480,mage,frost,12,5,7
Legendary,deathwing,480,mage,frost,12,5,7
Zime,moon-guard,480,mage,frost,12,5,7
Siobhána,moon-guard,480,mage,frost,12,5,7
Emppty,tichondrius,480,mage,frost,12,5,7
Freezerburnz,illidan,480,mage,frost,12,5,7
Asönia,illidan,480,mage,frost,13,5,8
Icebish,skullcrusher,480,mage,frost,18,5,13
Coolbuts,area-52,480,mage,frost,18,5,13
Badiatorr,alterac-mountains,480,mage,frost,18,5,13
Dreddpool,barthilas,480,mage,frost,18,5,13
Artty,velen,480,mage,frost,18,5,13
Kutulu,aerie-peak,480,mage,frost,18,5,13
Mikwam,proudmoore,479,mage,frost,6,5,1
Phazora,suramar,479,mage,frost,12,5,7
Dwazam,lothar,479,mage,frost,12,5,7
Frostburned,thrall,479,mage,frost,12,5,7
Paintsicle,thunderlord,479,mage,frost,12,5,7
Diabølcangel,malganis,479,mage,frost,12,5,7
Icesickle,barthilas,479,mage,frost,12,5,7
Brokser,quelthalas,479,mage,frost,12,5,7
Raynark,nemesis,479,mage,frost,12,5,7
Odinzz,azralon,479,mage,frost,12,5,7
Cezax,frostmourne,479,mage,frost,12,5,7
Grimreefer,trollbane,479,mage,frost,12,5,7
Kpoppin,stormrage,479,mage,frost,12,5,7
Inumano,laughing-skull,479,mage,frost,13,5,8
Asthar,ursin,479,mage,frost,24,5,19
Suprido,illidan,478,mage,frost,15,6,9
Babbushka,thrall,478,mage,frost,18,5,13
Magodelphi,azralon,477,mage,frost,6,5,1
Ehduh,onyxia,477,mage,frost,12,5,7
Rawrxd,kiljaeden,477,mage,frost,12,5,7
Magotom,ragnaros,476,mage,frost,12,5,7
Locasta,kirin-tor,476,mage,frost,12,5,7
Colddevil,hyjal,476,mage,frost,19,5,14
Claddagh,kelthuzad,473,mage,frost,12,5,7
Spazzticblur,frostwolf,473,mage,frost,12,5,7
Boxslinger,illidan,462,mage,frost,23,5,18
Polyblart,hyjal,446,mage,frost,10,6,4
Barkäi,ragnaros,432,mage,frost,15,5,10
Cerisium,kiljaeden,431,mage,frost,11,5,6
Coldrin,tichondrius,426,mage,frost,18,7,11
Aggrosheep,tichondrius,416,mage,frost,10,5,5
Quinnfreeze,boulderfist,414,mage,frost,11,5,6
Vasq,area-52,414,mage,frost,14,5,9
Pew,dathremar,399,mage,frost,7,5,2
Lampert,tichondrius,384,mage,frost,6,4,2
Expozed,icecrown,384,mage,frost,6,4,2
Meendy,tichondrius,384,mage,frost,6,4,2
Poonfarmer,zangarmarsh,384,mage,frost,6,4,2
Zolix,malganis,384,mage,frost,6,4,2
Julzx,hyjal,384,mage,frost,6,4,2
Frostedtips,hakkar,384,mage,frost,6,4,2
Arkane,barthilas,384,mage,frost,6,4,2
Gnomoguapo,altar-of-storms,384,mage,frost,6,4,2
Zgodspeedz,stormrage,384,mage,frost,6,4,2
Bibidi,emerald-dream,384,mage,frost,6,4,2
Marfaz,ravencrest,384,mage,frost,6,4,2
Turbobones,tichondrius,384,mage,frost,6,4,2
Çhíllßrõ,tichondrius,384,mage,frost,6,4,2
Myrondor,tichondrius,384,mage,frost,6,4,2
Vixm,stormrage,384,mage,frost,6,4,2
Fromcanadaqc,tichondrius,384,mage,frost,6,4,2
Jamesper,tichondrius,384,mage,frost,6,4,2
Udmx,zuljin,384,mage,frost,6,4,2
Sydne,ysera,384,mage,frost,6,4,2
Frobo,mannoroth,384,mage,frost,6,4,2
Dashdoor,stormrage,384,mage,frost,6,4,2
Chrismsprsnt,tichondrius,384,mage,frost,6,4,2
Belven,proudmoore,384,mage,frost,6,4,2
Orissan,stormrage,384,mage,frost,6,4,2
Pzaz,moon-guard,384,mage,frost,6,4,2
Schwab,warsong,384,mage,frost,6,4,2
Xiaoxiaochu,tichondrius,384,mage,frost,6,4,2
Azraël,zuljin,384,mage,frost,6,4,2
Gai,lightnings-blade,384,mage,frost,6,4,2
Mèduså,tichondrius,384,mage,frost,6,4,2
Smeigol,sargeras,384,mage,frost,6,4,2
Voiddude,proudmoore,384,mage,frost,6,4,2
Cewchí,tichondrius,384,mage,frost,6,4,2
Frostkage,tichondrius,384,mage,frost,6,4,2
Kälis,zuljin,384,mage,frost,6,4,2
Zokorzik,area-52,384,mage,frost,6,4,2
Lohkey,darkspear,384,mage,frost,6,4,2
Genton,gorgonnash,384,mage,frost,6,4,2
Ratfather,the-forgotten-coast,384,mage,frost,6,4,2
Hocusjokus,frostmourne,384,mage,frost,6,4,2
Polymedaddi,tichondrius,384,mage,frost,6,4,2
Neverbroke,illidan,384,mage,frost,6,4,2
Respektwaman,tichondrius,384,mage,frost,6,4,2
Sealedfate,executus,384,mage,frost,11,4,7
Shahnazz,darkspear,384,mage,frost,14,5,9
Hemm,nemesis,384,mage,frost,12,4,8
Nexttmage,area-52,384,mage,frost,12,4,8
Caseyjelly,tichondrius,384,mage,frost,12,4,8
Wuzzo,tichondrius,384,mage,frost,12,4,8
Perkaset,turalyon,384,mage,frost,12,4,8
Yeuxbleus,tichondrius,384,mage,frost,12,4,8
Horizons,moon-guard,384,mage,frost,12,4,8
Îùx,stormrage,384,mage,frost,12,4,8
Silentsoul,argent-dawn,384,mage,frost,12,4,8
Yippmagus,area-52,384,mage,frost,12,4,8
Stefan,malganis,384,mage,frost,12,4,8
Aangx,stormrage,384,mage,frost,12,4,8
Badaszbich,tichondrius,384,mage,frost,12,4,8
Themageguy,eitrigg,384,mage,frost,12,4,8
Oneminute,tichondrius,384,mage,frost,12,4,8
Percivaltp,scarlet-crusade,384,mage,frost,12,4,8
Dallamar,frostwolf,384,mage,frost,12,4,8
Timêrmórk,kalecgos,384,mage,frost,12,4,8
Darthez,darkspear,384,mage,frost,12,4,8
Novokaine,area-52,384,mage,frost,12,4,8
Meduka,proudmoore,384,mage,frost,12,4,8
Gemaicy,sargeras,384,mage,frost,12,4,8
Slot,kirin-tor,384,mage,frost,12,4,8
Natashaeb,wyrmrest-accord,384,mage,frost,12,4,8
Slurpey,moon-guard,384,mage,frost,12,4,8
Frostongue,azralon,384,mage,frost,12,4,8
Splocke,azralon,384,mage,frost,12,4,8
Bic,darrowmere,384,mage,frost,12,4,8
Coldcaster,mugthol,384,mage,frost,12,4,8
Fishfood,bleeding-hollow,384,mage,frost,12,4,8
Arcanatos,emerald-dream,384,mage,frost,12,4,8
Fantabulous,korgath,384,mage,frost,14,4,10
Snanth,black-dragonflight,384,mage,frost,18,4,14
Bluedustfart,illidan,384,mage,frost,18,4,14
Fullmetal,jaedenar,384,mage,frost,18,4,14
Rolypolyman,tichondrius,384,mage,frost,24,4,20
Saintmage,stormrage,384,mage,frost,24,4,20
Nnexus,azralon,383,mage,frost,12,4,8
Undersky,tichondrius,383,mage,frost,12,4,8
Robinesque,moon-guard,383,mage,frost,12,4,8
Cynafox,moon-guard,383,mage,frost,12,4,8
Abstractgoat,tichondrius,383,mage,frost,12,4,8
Skazzbomb,nerzhul,383,mage,frost,12,4,8
Xzude,korgath,383,mage,frost,12,4,8
Preckwinkle,moon-guard,383,mage,frost,14,4,10
Brezman,tichondrius,382,mage,frost,12,4,8
Kuni,ghostlands,382,mage,frost,12,4,8
Georgez,ragnaros,382,mage,frost,20,4,16
Zoninsasseo,tichondrius,381,mage,frost,12,4,8
Eirwan,illidan,379,mage,frost,12,4,8
Ject,ragnaros,367,mage,frost,17,4,13
Alfaflux,nemesis,366,mage,frost,17,4,13
Eanur,azralon,352,mage,frost,16,4,12
Lirahmi,quelthalas,351,mage,frost,17,4,13
Freezeup,area-52,349,mage,frost,14,7,7
Titsncoke,proudmoore,336,mage,frost,9,4,5
Jizzlez,tichondrius,335,mage,frost,11,4,7
Devkek,area-52,330,mage,frost,22,7,15
Icëblöck,ysera,329,mage,frost,6,5,1
Lezafort,area-52,320,mage,frost,16,4,12
Crøwgawd,tichondrius,304,mage,frost,7,4,3
Simpleorz,tichondrius,288,mage,frost,6,3,3
Urbadxd,llane,288,mage,frost,6,3,3
Packaged,emerald-dream,288,mage,frost,6,3,3
Atwyxn,illidan,288,mage,frost,6,3,3
Blastoize,tichondrius,288,mage,frost,6,3,3
Abruaa,area-52,288,mage,frost,6,3,3
Omorto,illidan,288,mage,frost,6,3,3
Vértigô,illidan,288,mage,frost,6,3,3
Cruxx,ragnaros,288,mage,frost,6,3,3
Äntistar,emerald-dream,288,mage,frost,6,3,3
Índís,ragnaros,288,mage,frost,6,3,3
Dersão,azralon,288,mage,frost,6,3,3
Wabï,tichondrius,288,mage,frost,6,3,3
Aurumium,illidan,288,mage,frost,6,3,3
Coldkite,tichondrius,288,mage,frost,6,3,3
Toastmg,tichondrius,288,mage,frost,6,3,3
Zukoprince,azralon,288,mage,frost,6,3,3
Midmage,tichondrius,288,mage,frost,6,3,3
Schishmage,archimonde,288,mage,frost,6,3,3
Shiryu,thrall,288,mage,frost,6,3,3
Tessarìon,tichondrius,288,mage,frost,6,3,3
Kryptekk,area-52,288,mage,frost,6,3,3
Ellywizzle,tichondrius,288,mage,frost,6,3,3
Nofoodforu,thrall,288,mage,frost,6,3,3
Hadesmage,illidan,288,mage,frost,6,3,3
Lilsake,sargeras,288,mage,frost,6,3,3
Cuthhere,malganis,288,mage,frost,6,3,3
Dìus,malganis,288,mage,frost,6,3,3
Fredcouples,tichondrius,288,mage,frost,6,3,3
Oomoo,malganis,288,mage,frost,6,3,3
Baybespice,malganis,288,mage,frost,6,3,3
Isuikido,nemesis,288,mage,frost,6,3,3
Dylantroll,tichondrius,288,mage,frost,6,3,3
Dcup,quelthalas,288,mage,frost,6,3,3
Whatthesheep,sargeras,288,mage,frost,6,3,3
Diminisher,agamaggan,288,mage,frost,6,3,3
Whøîsýoû,kelthuzad,288,mage,frost,6,3,3
Felsparkles,area-52,288,mage,frost,6,3,3
Wasc,kelthuzad,288,mage,frost,6,3,3
Clerene,area-52,288,mage,frost,6,3,3
Captncold,area-52,288,mage,frost,6,3,3
Chriglol,black-dragonflight,288,mage,frost,6,3,3
Honchó,velen,288,mage,frost,6,3,3
Morti,sargeras,288,mage,frost,6,3,3
Bønemage,azralon,288,mage,frost,6,3,3
Cbm,dalaran,288,mage,frost,6,3,3
Tasarion,mannoroth,288,mage,frost,6,3,3
Grawmp,thunderlord,288,mage,frost,6,3,3
Thxo,hyjal,288,mage,frost,6,3,3
Benisp,stormrage,288,mage,frost,6,3,3
Gpie,jubeithos,288,mage,frost,6,3,3
Dubyaj,tichondrius,288,mage,frost,6,3,3
Mäz,malorne,288,mage,frost,6,3,3
Orangemilk,hyjal,288,mage,frost,6,3,3
Undeadmerlin,zuljin,288,mage,frost,6,3,3
Murcury,tichondrius,288,mage,frost,6,3,3
Partygawd,frostmane,288,mage,frost,6,3,3
Nalla,nerzhul,288,mage,frost,6,3,3
Botoslàp,dragonmaw,288,mage,frost,6,3,3
Jaklinburton,stormrage,288,mage,frost,6,3,3
Feldt,korgath,288,mage,frost,6,3,3
Címegripe,stormrage,288,mage,frost,6,3,3
Dotznsheep,zuljin,288,mage,frost,6,3,3
Krililin,stormrage,288,mage,frost,6,3,3
Natallyn,stormrage,288,mage,frost,6,3,3
Icecreamboy,tichondrius,288,mage,frost,6,3,3
Gadalka,frostmourne,288,mage,frost,6,3,3
Killemz,dragonmaw,288,mage,frost,6,3,3
Pyroseraph,bleeding-hollow,288,mage,frost,6,3,3
Dragonie,nordrassil,288,mage,frost,6,3,3
Kqlyy,tichondrius,288,mage,frost,6,3,3
Magicianqt,tichondrius,288,mage,frost,6,3,3
Freezypeazy,bleeding-hollow,288,mage,frost,6,3,3
Blâzer,nazjatar,288,mage,frost,6,3,3
Weewhimsy,wyrmrest-accord,288,mage,frost,6,3,3
Illúmi,moon-guard,288,mage,frost,6,3,3
Gobstpper,nagrand,288,mage,frost,6,3,3
Frostytits,spirestone,288,mage,frost,6,3,3
Coneofkony,bleeding-hollow,288,mage,frost,6,3,3
Betaduck,bleeding-hollow,288,mage,frost,6,3,3
Personah,darkspear,288,mage,frost,6,3,3
Murderlin,tichondrius,288,mage,frost,6,3,3
Faeylyn,stormrage,288,mage,frost,9,4,5
Etyx,tichondrius,288,mage,frost,10,4,6
Bootyclapper,shadowmoon,288,mage,frost,12,3,9
Maagão,azralon,288,mage,frost,12,3,9
Linadeslayer,chogall,288,mage,frost,12,3,9
Trozkov,dalaran,288,mage,frost,12,3,9
Rmprmprmp,tichondrius,288,mage,frost,12,3,9
Rabeiro,tichondrius,288,mage,frost,12,3,9
Gattmage,illidan,288,mage,frost,12,3,9
Radakos,emerald-dream,288,mage,frost,12,3,9
Albbano,tichondrius,288,mage,frost,12,3,9
Ezchallenger,undermine,288,mage,frost,12,3,9
Aderia,gorefiend,288,mage,frost,12,3,9
Frostcakes,quelthalas,288,mage,frost,12,3,9
Calcaster,aegwynn,288,mage,frost,12,3,9
Chukii,darkspear,288,mage,frost,12,3,9
Houdiinii,illidan,288,mage,frost,12,3,9
Anuub,kelthuzad,288,mage,frost,12,3,9
Worldonfire,ragnaros,288,mage,frost,12,3,9
Sukaretto,illidan,288,mage,frost,12,3,9
Stormfrieza,tichondrius,288,mage,frost,12,3,9
Hozlu,kiljaeden,288,mage,frost,12,3,9
Frstysnogirl,silvermoon,288,mage,frost,12,3,9
Grynthwzrd,stormrage,288,mage,frost,12,3,9
Vyyp,echo-isles,288,mage,frost,12,3,9
Fingeredx,zuljin,288,mage,frost,12,3,9
Steefers,arygos,288,mage,frost,12,3,9
Castermuffin,stormrage,288,mage,frost,12,3,9
Jimmygibbler,illidan,288,mage,frost,12,3,9
Nøzotica,kelthuzad,288,mage,frost,12,3,9
Technique,tichondrius,288,mage,frost,12,3,9
Tamarolfrost,illidan,288,mage,frost,12,3,9
Draell,drakkari,288,mage,frost,12,3,9
Littleguzto,garrosh,288,mage,frost,12,3,9
Argyron,fizzcrank,288,mage,frost,12,3,9
Hqscoltt,azralon,288,mage,frost,12,3,9
Tracemaker,emerald-dream,288,mage,frost,18,3,15
Exonerate,mannoroth,288,mage,frost,18,3,15
Clausolas,ragnaros,287,mage,frost,6,3,3
Applemage,ragnaros,287,mage,frost,6,3,3
Shimotama,malganis,287,mage,frost,6,3,3
Cölossus,gorefiend,287,mage,frost,6,3,3
Pyromaster,emerald-dream,287,mage,frost,6,3,3
Daimadoshi,sargeras,287,mage,frost,6,3,3
Gufi,drakkari,287,mage,frost,6,3,3
Pyroflakes,darkspear,287,mage,frost,6,3,3
Icehero,tichondrius,287,mage,frost,6,3,3
Shadomijin,bronzebeard,286,mage,frost,6,3,3
Taevy,tichondrius,256,mage,frost,10,3,7
Chuekona,ragnaros,256,mage,frost,10,3,7
Arielak,kelthuzad,239,mage,frost,5,3,2
Cheyz,onyxia,239,mage,frost,5,3,2
Unydae,frostmourne,239,mage,frost,5,3,2
Magemoney,area-52,239,mage,frost,5,3,2
Drewann,draenor,239,mage,frost,5,3,2
Kizran,frostmourne,239,mage,frost,11,3,8
Itsoveryo,jubeithos,239,mage,frost,11,3,8
Skerei,azralon,234,mage,frost,19,4,15
Brôcolîni,zuljin,233,mage,frost,11,4,7
Kinrow,stormrage,223,mage,frost,14,3,11
Ophian,shattered-hand,222,mage,frost,8,3,5
Onioneyes,area-52,192,mage,frost,4,3,1
Rayricefan,blood-furnace,192,mage,frost,4,3,1
Stìnkfîst,tichondrius,192,mage,frost,6,2,4
Jurgers,tichondrius,192,mage,frost,6,2,4
Magegpt,illidan,192,mage,frost,6,2,4
Duhquarius,warsong,192,mage,frost,6,2,4
Crazytime,tichondrius,192,mage,frost,6,2,4
Getmaged,bleeding-hollow,192,mage,frost,6,2,4
Quesomancer,illidan,192,mage,frost,6,2,4
Sparqablink,tichondrius,192,mage,frost,6,2,4
Rubybest,tichondrius,192,mage,frost,6,2,4
Tanedos,tichondrius,192,mage,frost,6,2,4
Fleët,tichondrius,192,mage,frost,6,2,4
Arkuran,proudmoore,192,mage,frost,6,2,4
Sahaquiel,tichondrius,192,mage,frost,6,2,4
Iguanodon,proudmoore,192,mage,frost,6,2,4
Roarly,stonemaul,192,mage,frost,6,2,4
Kârén,aggramar,192,mage,frost,6,2,4
Raidem,dalaran,192,mage,frost,6,2,4
Smók,ragnaros,192,mage,frost,6,2,4
Gattî,tichondrius,192,mage,frost,6,2,4
Bluishhue,thrall,192,mage,frost,6,2,4
Brapture,dalaran,192,mage,frost,6,2,4
Halimage,zuljin,192,mage,frost,6,2,4
Gradmage,proudmoore,192,mage,frost,6,2,4
Earff,kiljaeden,192,mage,frost,6,2,4
Magiaguarra,ragnaros,192,mage,frost,6,2,4
Ryusuke,thrall,192,mage,frost,6,2,4
Viccluvin,stormrage,192,mage,frost,6,2,4
Xü,stormrage,192,mage,frost,6,2,4
Kzm,illidan,192,mage,frost,6,2,4
Muskybiggie,bleeding-hollow,192,mage,frost,6,2,4
Elfmage,tichondrius,192,mage,frost,6,2,4
Indignatio,arthas,192,mage,frost,6,2,4
Portapoly,tichondrius,192,mage,frost,6,2,4
Shivamode,thrall,192,mage,frost,6,2,4
Purkinji,bleeding-hollow,192,mage,frost,6,2,4
Weedzird,thrall,192,mage,frost,6,2,4
Kammany,thrall,192,mage,frost,6,2,4
Ess,tichondrius,192,mage,frost,6,2,4
Airsickjet,kiljaeden,192,mage,frost,6,2,4
Arçanemage,tichondrius,192,mage,frost,6,2,4
Anyahs,tichondrius,192,mage,frost,6,2,4
Elhechizero,quelthalas,192,mage,frost,6,2,4
Cradic,tichondrius,192,mage,frost,6,2,4
Blînxx,bleeding-hollow,192,mage,frost,6,2,4
Cottonmage,malganis,192,mage,frost,6,2,4
Afknz,frostmourne,192,mage,frost,6,2,4
Wyss,azralon,192,mage,frost,6,2,4
Icechew,area-52,192,mage,frost,6,2,4
Fïtz,quelthalas,192,mage,frost,6,2,4
Choctøp,frostmourne,192,mage,frost,6,2,4
Firehawk,azralon,192,mage,frost,6,2,4
Vailor,whisperwind,192,mage,frost,6,2,4
Thebrain,twisting-nether,192,mage,frost,6,2,4
Echoz,frostmourne,192,mage,frost,6,2,4
Elvin,frostmourne,192,mage,frost,6,2,4
Korky,dalvengyr,192,mage,frost,6,2,4
Chelseâ,emerald-dream,192,mage,frost,6,2,4
Urmagesty,daggerspine,192,mage,frost,6,2,4
Avicci,shattered-halls,192,mage,frost,6,2,4
Aeroclouda,stormrage,192,mage,frost,6,2,4
Daxiongmiao,frostmourne,192,mage,frost,6,2,4
Jainamommy,emerald-dream,192,mage,frost,6,2,4
Vallfire,malganis,192,mage,frost,6,2,4
Massivepoo,barthilas,192,mage,frost,6,2,4
Goondalf,malganis,192,mage,frost,6,2,4
Mageethot,moon-guard,192,mage,frost,6,2,4
Rapidmage,malganis,192,mage,frost,6,2,4
Sourx,doomhammer,192,mage,frost,6,2,4
Cantblocklul,baelgun,192,mage,frost,6,2,4
Elaro,moon-guard,192,mage,frost,6,2,4
Mager,dentarg,192,mage,frost,6,2,4
Biillionaire,frostmourne,192,mage,frost,6,2,4
Audacy,sargeras,192,mage,frost,6,2,4
Myzzl,kelthuzad,192,mage,frost,6,2,4
Magika,area-52,192,mage,frost,6,2,4
Makius,area-52,192,mage,frost,6,2,4
Uhh,blackrock,192,mage,frost,6,2,4
Herzthroh,stormrage,192,mage,frost,6,2,4
Vortex,fenris,192,mage,frost,6,2,4
Sophrates,burning-blade,192,mage,frost,6,2,4
Khaosflare,stormrage,192,mage,frost,6,2,4
Kevinfan,area-52,192,mage,frost,6,2,4
Wïzarduous,mannoroth,192,mage,frost,6,2,4
Karameltart,barthilas,192,mage,frost,6,2,4
Ayci,velen,192,mage,frost,6,2,4
Elfoe,sargeras,192,mage,frost,6,2,4
Magickus,korgath,192,mage,frost,6,2,4
Lilbabyx,stormrage,192,mage,frost,6,2,4
Tzifardem,azshara,192,mage,frost,6,2,4
Pyröz,kelthuzad,192,mage,frost,6,2,4
Gusmaged,stormrage,192,mage,frost,6,2,4
Nachtt,sargeras,192,mage,frost,6,2,4
Strêss,kelthuzad,192,mage,frost,6,2,4
Whiteyx,saurfang,192,mage,frost,6,2,4
Undeadmager,nerzhul,192,mage,frost,6,2,4
Clickhard,suramar,192,mage,frost,9,2,7
Nayfrost,emerald-dream,192,mage,frost,10,2,8
Eretik,ragnaros,192,mage,frost,12,2,10
Adxion,quelthalas,192,mage,frost,12,2,10
Mônstâ,thrall,192,mage,frost,12,2,10
Hositonet,malganis,192,mage,frost,12,2,10
Èvilmage,blackrock,192,mage,frost,12,2,10
Ironwolft,tichondrius,192,mage,frost,12,2,10
Joare,area-52,192,mage,frost,12,2,10
Zyzzmirin,barthilas,192,mage,frost,12,2,10
Dylanpickles,darkspear,192,mage,frost,12,2,10
Dashonthany,arthas,192,mage,frost,12,2,10
Camstein,area-52,192,mage,frost,12,2,10
Shwack,boulderfist,192,mage,frost,12,2,10
Alode,moon-guard,192,mage,frost,12,2,10
Molassess,illidan,192,mage,frost,12,2,10
Mendittorosa,tichondrius,192,mage,frost,12,2,10
Zerg,fenris,192,mage,frost,12,2,10
Twizz,haomarush,192,mage,frost,12,2,10
Lemmepoly,illidan,192,mage,frost,12,2,10
Rán,spirestone,192,mage,frost,12,2,10
Excentral,tichondrius,192,mage,frost,12,2,10
Wqnmlgbdy,tichondrius,192,mage,frost,18,2,16
Pândàfæçé,ghostlands,191,mage,frost,4,3,1
Kahldyn,stormrage,191,mage,frost,4,3,1
Bittérs,tichondrius,191,mage,frost,6,2,4
Hense,stormrage,191,mage,frost,6,2,4
Alladen,anubarak,191,mage,frost,6,2,4
Stillborn,lethon,191,mage,frost,6,2,4
Renthalar,area-52,191,mage,frost,18,2,16
Cheapped,emerald-dream,175,mage,frost,6,3,3
Blakus,tichondrius,159,mage,frost,6,3,3
Frosteddiks,shattered-halls,159,mage,frost,5,2,3
Wizzyx,illidan,159,mage,frost,5,2,3
Csx,turalyon,144,mage,frost,3,3,0
Noyade,illidan,144,mage,frost,9,2,7
Erudit,tichondrius,144,mage,frost,15,2,13
Shardgodx,kelthuzad,138,mage,frost,8,4,4
Máximus,illidan,128,mage,frost,4,2,2
Idamnedu,crushridge,128,mage,frost,4,2,2
Firèballin,tichondrius,128,mage,frost,4,2,2
Goingmassive,frostmourne,127,mage,frost,4,2,2
Proviet,frostmourne,127,mage,frost,8,2,6
Thebraveonee,frostmourne,126,mage,frost,8,2,6
Thôrsena,ursin,96,mage,frost,3,2,1
Sillycole,emerald-dream,96,mage,frost,3,2,1
Gnòmêrcy,kelthuzad,96,mage,frost,6,1,5
Tmi,darkspear,96,mage,frost,6,1,5
Kattyy,drakkari,96,mage,frost,6,1,5
Mazark,ghostlands,96,mage,frost,6,1,5
Heksyllia,wyrmrest-accord,96,mage,frost,6,1,5
Aerodynamiq,area-52,96,mage,frost,6,1,5
Themose,sargeras,96,mage,frost,6,1,5
Magicmom,wyrmrest-accord,96,mage,frost,6,1,5
Absentbrain,stormrage,96,mage,frost,6,1,5
Magicdro,scilla,96,mage,frost,6,1,5
Ñõxx,sargeras,96,mage,frost,6,1,5
Freezy,ghostlands,96,mage,frost,6,1,5
Ogfresh,area-52,96,mage,frost,6,1,5
Oring,tichondrius,96,mage,frost,6,1,5
Truewinter,tichondrius,96,mage,frost,6,1,5
Furrblock,tichondrius,96,mage,frost,6,1,5
Oab,proudmoore,96,mage,frost,6,1,5
Heztus,area-52,96,mage,frost,6,1,5
Thewizârd,stormrage,96,mage,frost,6,1,5
Scarrgon,wyrmrest-accord,96,mage,frost,6,1,5
Fadedfire,area-52,96,mage,frost,6,1,5
Gíldrin,proudmoore,96,mage,frost,6,1,5
Quickwizard,tichondrius,96,mage,frost,6,1,5
Sky,lightnings-blade,96,mage,frost,6,1,5
Ghalador,area-52,96,mage,frost,6,1,5
Spik,sargeras,96,mage,frost,6,1,5
Thiccness,hydraxis,96,mage,frost,6,1,5
Adrazell,sargeras,96,mage,frost,6,1,5
Coolhandz,tichondrius,96,mage,frost,6,1,5
Ichirou,stormrage,96,mage,frost,6,1,5
Beerandmagic,zuljin,96,mage,frost,6,1,5
Daêgon,area-52,96,mage,frost,6,1,5
Ârcano,ragnaros,96,mage,frost,6,1,5
Zuhbo,moon-guard,96,mage,frost,6,1,5
Pyrofrost,stonemaul,96,mage,frost,6,1,5
Freezze,malganis,96,mage,frost,6,1,5
Mastacombust,illidan,96,mage,frost,6,1,5
Ricter,hyjal,96,mage,frost,6,1,5
Muskinite,maiev,96,mage,frost,6,1,5
Trevihl,malganis,96,mage,frost,6,1,5
Grandpapi,arthas,96,mage,frost,6,1,5
Soulbite,barthilas,96,mage,frost,6,1,5
Kaoz,emerald-dream,96,mage,frost,6,1,5
Kylelol,emerald-dream,96,mage,frost,6,1,5
Toat,dalaran,96,mage,frost,6,1,5
Neverworks,tichondrius,96,mage,frost,6,1,5
Pirne,executus,96,mage,frost,6,1,5
Hruine,chogall,96,mage,frost,6,1,5
Damadness,kiljaeden,96,mage,frost,6,1,5
Majx,eldrethalas,96,mage,frost,6,1,5
Åpollous,frostmourne,96,mage,frost,6,1,5
Michaelbust,tichondrius,96,mage,frost,6,1,5
Kbola,tichondrius,96,mage,frost,6,1,5
Geekm,frostmourne,96,mage,frost,6,1,5
Myle,magtheridon,96,mage,frost,6,1,5
Yeonmok,tichondrius,96,mage,frost,6,1,5
Twizzlerz,executus,96,mage,frost,6,1,5
Jayaßallard,emerald-dream,96,mage,frost,6,1,5
Naviator,tichondrius,96,mage,frost,6,1,5
Loopsyliu,stormrage,96,mage,frost,6,1,5
Pikoda,azralon,96,mage,frost,6,1,5
Futuristax,azralon,96,mage,frost,6,1,5
Braelynn,frostwolf,96,mage,frost,6,1,5
Ëfc,nemesis,96,mage,frost,6,1,5
Fookz,malganis,96,mage,frost,6,1,5
Dathoe,laughing-skull,96,mage,frost,6,1,5
Mïzzfreeze,haomarush,96,mage,frost,6,1,5
Pblastdatass,stormrage,96,mage,frost,6,1,5
Doodleydoo,dragonmaw,96,mage,frost,6,1,5
Professor,khadgar,96,mage,frost,6,1,5
Vensyr,stormrage,96,mage,frost,12,1,11
Taladas,suramar,96,mage,frost,12,1,11
Jmanpk,stormrage,96,mage,frost,12,1,11
Pyrophobia,mannoroth,96,mage,frost,12,1,11
Ldc,kelthuzad,96,mage,frost,12,1,11
Bøndu,zuljin,96,mage,frost,12,1,11
Shizdain,zuljin,96,mage,frost,12,1,11
Carmile,azralon,96,mage,frost,12,1,11
Tema,daggerspine,96,mage,frost,12,1,11
Zei,bleeding-hollow,96,mage,frost,12,1,11
Voxbluvine,hakkar,96,mage,frost,18,1,17
Icemaker,destromath,95,mage,frost,18,1,17
Ventiarcana,area-52,79,mage,frost,5,1,4
Huaerfei,thunderlord,79,mage,frost,5,1,4
Notria,illidan,79,mage,frost,5,1,4
Buckybever,illidan,79,mage,frost,11,1,10
Frostybihh,bonechewer,64,mage,frost,4,1,3
Unclekyle,skullcrusher,48,mage,frost,3,1,2
Lv,stormscale,48,mage,frost,9,1,8
Jiblemynippl,illidan,42,mage,frost,7,2,5
Kushjointz,tichondrius,42,mage,frost,11,3,8
Fizzlepops,kiljaeden,31,mage,frost,2,1,1
Mysticallx,sargeras,2314,monk,mistweaver,90,59,31
Dãnwun,tichondrius,2284,monk,mistweaver,102,63,39
Sharkpiggie,illidan,2283,monk,mistweaver,102,66,36
Akkiraa,sargeras,2283,monk,mistweaver,95,60,35
Dannycarey,tichondrius,2278,monk,mistweaver,78,55,23
Garbagemonk,scilla,2277,monk,mistweaver,191,120,71
Woezx,stormreaver,2264,monk,mistweaver,68,47,21
Linlol,tichondrius,2257,monk,mistweaver,478,278,200
Sharkpiglet,illidan,2250,monk,mistweaver,192,122,70
Meepmonk,tichondrius,2246,monk,mistweaver,120,73,47
Akkiira,sargeras,2229,monk,mistweaver,114,64,50
Raddxd,illidan,2227,monk,mistweaver,95,64,31
Mãsterpõ,tichondrius,2227,monk,mistweaver,313,170,143
Weavied,sargeras,2215,monk,mistweaver,156,84,72
Stinkycok,tichondrius,2214,monk,mistweaver,84,54,30
Boogstyle,malganis,2201,monk,mistweaver,142,81,61
Jep,tichondrius,2190,monk,mistweaver,144,91,53
Zenjj,thorium-brotherhood,2188,monk,mistweaver,240,138,102
Vaen,kelthuzad,2173,monk,mistweaver,102,61,41
Ðrägønéyèz,malygos,2168,monk,mistweaver,211,119,92
Cool,crushridge,2167,monk,mistweaver,126,75,51
Dowsk,tichondrius,2162,monk,mistweaver,105,63,42
Parodies,illidan,2162,monk,mistweaver,109,57,52
Idiotgriefer,tichondrius,2160,monk,mistweaver,78,48,30
Cuteballs,tichondrius,2158,monk,mistweaver,93,56,37
Nezly,sargeras,2153,monk,mistweaver,149,77,72
Flarks,area-52,2151,monk,mistweaver,155,80,75
Pragma,kiljaeden,2148,monk,mistweaver,90,55,35
Moonym,frostmourne,2144,monk,mistweaver,80,48,32
Hernameplz,proudmoore,2144,monk,mistweaver,171,92,79
Sloppyroppy,tichondrius,2143,monk,mistweaver,107,62,45
Oliveirarr,tichondrius,2143,monk,mistweaver,174,95,79
Dro,khadgar,2141,monk,mistweaver,66,39,27
Vramonk,area-52,2141,monk,mistweaver,115,64,51
Furiousfrank,stormrage,2140,monk,mistweaver,114,70,44
Moremoretea,tichondrius,2140,monk,mistweaver,87,53,34
Illify,tichondrius,2138,monk,mistweaver,78,56,22
Crunchyrollx,tichondrius,2135,monk,mistweaver,66,49,17
Nohandslost,blackrock,2134,monk,mistweaver,218,112,106
Xeus,darkspear,2133,monk,mistweaver,60,38,22
Jetnoob,sargeras,2132,monk,mistweaver,132,72,60
Réðçräñé,sargeras,2130,monk,mistweaver,66,42,24
Woggitie,jubeithos,2129,monk,mistweaver,68,45,23
Igriefidiots,tichondrius,2129,monk,mistweaver,71,40,31
Ringofpeace,sargeras,2128,monk,mistweaver,60,40,20
Wheatsli,malganis,2126,monk,mistweaver,138,81,57
Canghaigg,tichondrius,2122,monk,mistweaver,150,94,56
Timermørk,kalecgos,2122,monk,mistweaver,139,86,53
Natalié,caelestrasz,2122,monk,mistweaver,137,81,56
Purgenm,tichondrius,2122,monk,mistweaver,90,52,38
Slunka,tichondrius,2121,monk,mistweaver,72,42,30
Secdog,tichondrius,2118,monk,mistweaver,84,44,40
Yogapantsx,nerzhul,2117,monk,mistweaver,86,47,39
Kicub,emerald-dream,2115,monk,mistweaver,84,44,40
Oblivæon,tichondrius,2114,monk,mistweaver,78,47,31
Itzokinlol,malganis,2113,monk,mistweaver,114,70,44
Firewatches,emerald-dream,2113,monk,mistweaver,72,42,30
Tekuto,tichondrius,2112,monk,mistweaver,174,109,65
Moldboy,area-52,2112,monk,mistweaver,75,45,30
Fúrùkáùntà,sargeras,2111,monk,mistweaver,62,41,21
Wolf,shattered-hand,2111,monk,mistweaver,60,36,24
Ccain,stormrage,2111,monk,mistweaver,145,78,67
Gsdfjskpx,sargeras,2107,monk,mistweaver,306,165,141
Kris,llane,2105,monk,mistweaver,122,72,50
Praggers,proudmoore,2105,monk,mistweaver,198,104,94
Gameníne,tichondrius,2103,monk,mistweaver,72,42,30
Benneroy,moon-guard,2102,monk,mistweaver,54,34,20
Millé,frostmourne,2102,monk,mistweaver,84,52,32
Waggìes,moon-guard,2101,monk,mistweaver,83,50,33
Nakedidiot,kelthuzad,2101,monk,mistweaver,144,86,58
Melonmuncher,duskwood,2101,monk,mistweaver,135,79,56
Shadmw,barthilas,2100,monk,mistweaver,72,50,22
Pandacottoco,azralon,2100,monk,mistweaver,126,71,55
Heywhatsup,emerald-dream,2097,monk,mistweaver,102,50,52
Canghaimonk,tichondrius,2095,monk,mistweaver,190,100,90
Proghouse,illidan,2089,monk,mistweaver,90,47,43
Gogumamonk,tichondrius,2089,monk,mistweaver,126,64,62
Nfm,cairne,2085,monk,mistweaver,227,127,100
Elvenmonk,frostmane,2080,monk,mistweaver,72,44,28
Hydroz,dethecus,2080,monk,mistweaver,101,56,45
Crypomunkz,malganis,2078,monk,mistweaver,95,52,43
Vaemonka,stormrage,2077,monk,mistweaver,231,133,98
Griefgodx,tichondrius,2071,monk,mistweaver,110,62,48
Sypìì,stormrage,2062,monk,mistweaver,132,73,59
Originull,darkspear,2061,monk,mistweaver,113,62,51
Drracaryss,sargeras,2060,monk,mistweaver,203,125,78
Strugglebus,sargeras,2056,monk,mistweaver,42,31,11
Friendshipx,emerald-dream,2055,monk,mistweaver,48,36,12
Yangroumo,tichondrius,2055,monk,mistweaver,155,89,66
Glqjkglbfgdl,zuljin,2053,monk,mistweaver,156,86,70
Taichí,tichondrius,2051,monk,mistweaver,285,145,140
Breadweaver,malganis,2051,monk,mistweaver,108,52,56
Pandacottoca,azralon,2048,monk,mistweaver,108,73,35
Huaren,tichondrius,2048,monk,mistweaver,137,78,59
Emoeres,kelthuzad,2046,monk,mistweaver,128,62,66
Wagfu,moon-guard,2045,monk,mistweaver,70,40,30
Zuhak,tichondrius,2043,monk,mistweaver,96,54,42
Thèwy,tichondrius,2041,monk,mistweaver,71,45,26
Oldmanswirl,mugthol,2035,monk,mistweaver,120,67,53
Neuron,spirestone,2033,monk,mistweaver,56,30,26
Fizzlefarmer,moon-guard,2031,monk,mistweaver,89,54,35
Brazfu,skullcrusher,2031,monk,mistweaver,153,89,64
Chadweave,moon-guard,2030,monk,mistweaver,484,258,226
Babyfaceqt,skullcrusher,2027,monk,mistweaver,195,104,91
Xdfu,stormrage,2025,monk,mistweaver,137,84,53
Yasysy,tichondrius,2025,monk,mistweaver,54,30,24
Sqmw,tichondrius,2024,monk,mistweaver,60,36,24
Qtmonk,emerald-dream,2023,monk,mistweaver,183,108,75
Postmark,tichondrius,2021,monk,mistweaver,71,42,29
Zhoku,tichondrius,2020,monk,mistweaver,58,34,24
Triixxy,thrall,2018,monk,mistweaver,101,64,37
Lodbork,tichondrius,2016,monk,mistweaver,198,114,84
Bhoredom,kiljaeden,2012,monk,mistweaver,164,90,74
Drdabz,illidan,2012,monk,mistweaver,90,46,44
Danarolls,spirestone,2012,monk,mistweaver,125,63,62
Punchgodx,greymane,2010,monk,mistweaver,78,46,32
Itsbald,bleeding-hollow,2010,monk,mistweaver,174,101,73
Bungfist,stormrage,2006,monk,mistweaver,41,29,12
Jakethegreat,moknathal,2004,monk,mistweaver,217,124,93
Assez,tichondrius,2004,monk,mistweaver,85,44,41
Voidstate,stormrage,2001,monk,mistweaver,131,71,60
Àvríam,stormrage,1999,monk,mistweaver,163,79,84
Taeeun,tichondrius,1994,monk,mistweaver,57,38,19
Mcoos,tichondrius,1994,monk,mistweaver,198,118,80
Quitw,tichondrius,1994,monk,mistweaver,73,40,33
Tyrfan,sargeras,1994,monk,mistweaver,154,84,70
Ezqueue,area-52,1992,monk,mistweaver,36,27,9
Thet,sargeras,1989,monk,mistweaver,177,90,87
Wingchungus,sargeras,1987,monk,mistweaver,42,30,12
Leetcoder,tichondrius,1987,monk,mistweaver,219,131,88
Jiwå,terenas,1985,monk,mistweaver,648,328,320
Carzzy,sargeras,1984,monk,mistweaver,94,55,39
Morzmyth,nemesis,1984,monk,mistweaver,274,138,136
Nesoween,tichondrius,1979,monk,mistweaver,110,65,45
Nuriva,tichondrius,1977,monk,mistweaver,88,62,26
Esqu,sargeras,1977,monk,mistweaver,48,30,18
Vinnyd,tichondrius,1976,monk,mistweaver,39,27,12
Nilox,sargeras,1976,monk,mistweaver,198,108,90
Meepmonk,kilrogg,1975,monk,mistweaver,51,27,24
Kaylux,stormrage,1974,monk,mistweaver,60,36,24
Martiálfarts,malganis,1973,monk,mistweaver,42,30,12
Xcrispy,scilla,1969,monk,mistweaver,67,43,24
Liltuna,icecrown,1968,monk,mistweaver,42,26,16
Heha,tichondrius,1966,monk,mistweaver,346,176,170
Actualcrime,tichondrius,1965,monk,mistweaver,60,33,27
Zaqqari,wyrmrest-accord,1965,monk,mistweaver,96,51,45
Kristië,stormrage,1963,monk,mistweaver,54,37,17
Qup,lightbringer,1963,monk,mistweaver,132,88,44
Venfuki,tichondrius,1963,monk,mistweaver,60,35,25
Hawainpunch,stormscale,1961,monk,mistweaver,90,53,37
Aviee,illidan,1958,monk,mistweaver,198,97,101
Paperfist,stormrage,1955,monk,mistweaver,138,95,43
Speedcapped,area-52,1954,monk,mistweaver,138,67,71
Hafezassad,illidan,1954,monk,mistweaver,48,23,25
Wetchickennz,tichondrius,1950,monk,mistweaver,172,95,77
Cangry,area-52,1950,monk,mistweaver,77,41,36
Zamist,sargeras,1949,monk,mistweaver,84,52,32
Ekn,tichondrius,1945,monk,mistweaver,66,45,21
Poscom,tichondrius,1944,monk,mistweaver,155,104,51
Gabîmaru,area-52,1944,monk,mistweaver,192,114,78
Baychiz,sargeras,1940,monk,mistweaver,84,46,38
Discurzed,barthilas,1938,monk,mistweaver,193,111,82
Orbgodx,darkspear,1938,monk,mistweaver,78,42,36
Shlunks,illidan,1937,monk,mistweaver,303,172,131
Akiramenaide,tichondrius,1936,monk,mistweaver,64,44,20
Swurvex,bleeding-hollow,1935,monk,mistweaver,78,36,42
Físterxd,bleeding-hollow,1934,monk,mistweaver,336,179,157
Confa,ragnaros,1934,monk,mistweaver,268,135,133
Ilovekok,sargeras,1933,monk,mistweaver,84,64,20
Xzeer,illidan,1933,monk,mistweaver,53,36,17
Chimme,skywall,1932,monk,mistweaver,96,56,40
Beez,balnazzar,1931,monk,mistweaver,69,35,34
Zeçe,tichondrius,1930,monk,mistweaver,42,26,16
Stepfistz,aegwynn,1930,monk,mistweaver,154,90,64
Mixon,archimonde,1927,monk,mistweaver,36,25,11
Strongmandan,twisting-nether,1926,monk,mistweaver,72,36,36
Brews,black-dragonflight,1924,monk,mistweaver,121,65,56
Brewsome,bloodhoof,1924,monk,mistweaver,88,46,42
Imdabes,velen,1923,monk,mistweaver,72,39,33
Vethosis,illidan,1921,monk,mistweaver,43,27,16
Lmhs,tichondrius,1921,monk,mistweaver,108,59,49
Ònó,quelthalas,1919,monk,mistweaver,67,39,28
Vongg,tichondrius,1919,monk,mistweaver,84,44,40
Ahlam,tichondrius,1917,monk,mistweaver,63,39,24
Decompress,illidan,1916,monk,mistweaver,111,67,44
Sevymonk,stormrage,1915,monk,mistweaver,132,73,59
Soprà,zuljin,1914,monk,mistweaver,63,39,24
Kansú,ragnaros,1913,monk,mistweaver,100,53,47
Youstop,stormrage,1911,monk,mistweaver,108,68,40
Abellmonk,tichondrius,1910,monk,mistweaver,203,117,86
Spook,kalecgos,1909,monk,mistweaver,79,52,27
Michæ,ragnaros,1909,monk,mistweaver,285,156,129
Basedbuck,dalaran,1904,monk,mistweaver,36,23,13
Ephéyxq,area-52,1904,monk,mistweaver,36,22,14
Keshir,sargeras,1903,monk,mistweaver,111,71,40
Sillyguy,stormrage,1901,monk,mistweaver,107,69,38
Aegea,illidan,1901,monk,mistweaver,67,37,30
Xhangtu,thrall,1900,monk,mistweaver,190,120,70
Elesm,area-52,1900,monk,mistweaver,126,60,66
Canadá,bleeding-hollow,1896,monk,mistweaver,60,41,19
Rokkon,sargeras,1896,monk,mistweaver,106,59,47
Watersheep,darkspear,1896,monk,mistweaver,72,38,34
Wrxx,kelthuzad,1895,monk,mistweaver,358,177,181
Worldhopperx,area-52,1894,monk,mistweaver,89,57,32
Sniffinsteak,laughing-skull,1892,monk,mistweaver,42,33,9
Taelinn,moonrunner,1892,monk,mistweaver,72,35,37
Stonemists,ragnaros,1891,monk,mistweaver,107,64,43
Suamw,tichondrius,1888,monk,mistweaver,115,55,60
Evilfantum,illidan,1886,monk,mistweaver,54,41,13
Zengriff,ysondre,1885,monk,mistweaver,72,44,28
Adop,dark-iron,1883,monk,mistweaver,172,104,68
Flavier,illidan,1883,monk,mistweaver,60,33,27
Monktease,tichondrius,1882,monk,mistweaver,120,62,58
Poppinbrews,thrall,1880,monk,mistweaver,46,27,19
Yobeel,tichondrius,1879,monk,mistweaver,66,27,39
Pandatrainer,drakkari,1878,monk,mistweaver,66,41,25
Toyotasupra,emerald-dream,1878,monk,mistweaver,78,48,30
Fenriranger,tichondrius,1878,monk,mistweaver,172,105,67
Oppsimop,frostmourne,1877,monk,mistweaver,132,73,59
Dancah,eitrigg,1877,monk,mistweaver,47,23,24
Toozmania,stormrage,1876,monk,mistweaver,52,31,21
Vernki,laughing-skull,1875,monk,mistweaver,95,59,36
Hinåta,thrall,1874,monk,mistweaver,46,29,17
Sifu,bleeding-hollow,1873,monk,mistweaver,59,36,23
Mixflo,bleeding-hollow,1873,monk,mistweaver,45,24,21
Spicyx,kiljaeden,1871,monk,mistweaver,30,24,6
Robocto,area-52,1869,monk,mistweaver,102,61,41
Tyliyah,tichondrius,1866,monk,mistweaver,35,26,9
Shùù,tichondrius,1866,monk,mistweaver,65,37,28
Tokol,tichondrius,1866,monk,mistweaver,173,93,80
Dalillama,stormreaver,1865,monk,mistweaver,48,31,17
Logtich,moon-guard,1864,monk,mistweaver,78,42,36
Gtmdyjs,illidan,1863,monk,mistweaver,35,24,11
Hdyww,tichondrius,1862,monk,mistweaver,84,50,34
Kelstrike,sargeras,1861,monk,mistweaver,54,34,20
Pinkfairy,wyrmrest-accord,1860,monk,mistweaver,36,24,12
Papermade,barthilas,1860,monk,mistweaver,48,26,22
Ileffsinll,illidan,1859,monk,mistweaver,137,77,60
Xinergy,illidan,1858,monk,mistweaver,109,71,38
Cmonktwo,turalyon,1858,monk,mistweaver,54,31,23
Sevenmonk,tichondrius,1857,monk,mistweaver,54,36,18
Jaja,kiljaeden,1857,monk,mistweaver,60,34,26
Wpola,tichondrius,1856,monk,mistweaver,48,31,17
Cmonk,turalyon,1856,monk,mistweaver,40,24,16
Alphamist,thrall,1855,monk,mistweaver,42,26,16
Milkshayx,kiljaeden,1855,monk,mistweaver,42,25,17
Piilsburry,sargeras,1855,monk,mistweaver,48,26,22
Timbomist,kelthuzad,1855,monk,mistweaver,97,52,45
Søpra,zuljin,1853,monk,mistweaver,144,83,61
Bengotitboi,magtheridon,1853,monk,mistweaver,42,24,18
Shad,frostmourne,1853,monk,mistweaver,102,58,44
Nerf,malganis,1852,monk,mistweaver,35,24,11
Qxt,tichondrius,1852,monk,mistweaver,84,49,35
Zdeg,tichondrius,1852,monk,mistweaver,51,28,23
Senseipwnda,stormrage,1851,monk,mistweaver,77,46,31
Fluval,moon-guard,1850,monk,mistweaver,71,47,24
Bootÿmagic,tichondrius,1849,monk,mistweaver,200,119,81
Damogen,spinebreaker,1849,monk,mistweaver,54,28,26
Zipmw,tichondrius,1848,monk,mistweaver,66,36,30
Djkungfu,thrall,1847,monk,mistweaver,192,114,78
Grif,nazjatar,1847,monk,mistweaver,231,114,117
Moushindeiru,sargeras,1846,monk,mistweaver,78,58,20
Proxy,ragnaros,1846,monk,mistweaver,46,31,15
Tonyboloney,tichondrius,1845,monk,mistweaver,42,25,17
Wizlee,tichondrius,1845,monk,mistweaver,60,34,26
Cenfu,malganis,1845,monk,mistweaver,78,34,44
Dampdampdamp,tichondrius,1844,monk,mistweaver,24,20,4
Fîstweave,emerald-dream,1844,monk,mistweaver,77,45,32
Noremaç,frostmourne,1844,monk,mistweaver,48,28,20
Snuggubae,moon-guard,1844,monk,mistweaver,204,111,93
Yujiro,draktharon,1843,monk,mistweaver,36,23,13
Dwánesan,tichondrius,1843,monk,mistweaver,72,44,28
Crabfest,zuljin,1843,monk,mistweaver,60,35,25
Kriticalkush,kelthuzad,1843,monk,mistweaver,59,34,25
Wombglazer,dalaran,1841,monk,mistweaver,34,26,8
Youngsìnatra,muradin,1840,monk,mistweaver,42,26,16
Intra,exodar,1840,monk,mistweaver,180,96,84
Ensaymada,frostmourne,1839,monk,mistweaver,156,83,73
Fingies,whisperwind,1838,monk,mistweaver,60,36,24
Hugdealer,warsong,1838,monk,mistweaver,86,51,35
Caffeinated,barthilas,1838,monk,mistweaver,274,135,139
Nabunaga,illidan,1837,monk,mistweaver,42,34,8
Briàr,area-52,1837,monk,mistweaver,54,29,25
Irraeine,malganis,1836,monk,mistweaver,48,31,17
Itspoils,illidan,1835,monk,mistweaver,73,53,20
Veejaex,stormreaver,1835,monk,mistweaver,39,27,12
Zarenki,tichondrius,1835,monk,mistweaver,73,33,40
Supbro,hyjal,1834,monk,mistweaver,36,23,13
Monjimen,ragnaros,1834,monk,mistweaver,408,216,192
Blackoutmonk,stormreaver,1833,monk,mistweaver,131,80,51
Harkwind,azralon,1833,monk,mistweaver,187,108,79
Guarantee,tichondrius,1832,monk,mistweaver,182,102,80
Cmonkey,turalyon,1831,monk,mistweaver,48,31,17
Ichiros,cenarion-circle,1830,monk,mistweaver,390,219,171
Fistër,area-52,1830,monk,mistweaver,141,76,65
Chonmist,darkspear,1829,monk,mistweaver,92,60,32
Zenox,rexxar,1829,monk,mistweaver,114,65,49
Gentleuncle,tichondrius,1829,monk,mistweaver,161,90,71
Drunkenfist,chogall,1829,monk,mistweaver,71,32,39
Takugava,illidan,1828,monk,mistweaver,96,66,30
Turbokíll,proudmoore,1828,monk,mistweaver,54,30,24
Jtea,malganis,1827,monk,mistweaver,29,20,9
Baoma,tichondrius,1827,monk,mistweaver,95,55,40
Monklike,illidan,1827,monk,mistweaver,60,30,30
Macrobrewski,tichondrius,1825,monk,mistweaver,41,32,9
Mackiechan,kelthuzad,1825,monk,mistweaver,164,92,72
Jackouse,frostmourne,1824,monk,mistweaver,50,31,19
Bradyfour,moon-guard,1824,monk,mistweaver,206,118,88
Onepunçhman,stormreaver,1824,monk,mistweaver,250,141,109
Threefanandy,kelthuzad,1823,monk,mistweaver,48,28,20
Patfu,area-52,1823,monk,mistweaver,57,32,25
Velzarria,zuljin,1823,monk,mistweaver,96,53,43
Zlatan,thaurissan,1823,monk,mistweaver,54,29,25
Jojostar,shadowsong,1822,monk,mistweaver,54,32,22
Zenchi,kelthuzad,1821,monk,mistweaver,36,26,10
Vynchi,area-52,1821,monk,mistweaver,97,67,30
Tazi,chromaggus,1821,monk,mistweaver,84,50,34
Gellindra,malganis,1820,monk,mistweaver,42,32,10
Voltio,frostmane,1820,monk,mistweaver,103,68,35
Chaddington,malorne,1820,monk,mistweaver,48,30,18
Miley,lethon,1820,monk,mistweaver,39,24,15
Wigglygiggly,mannoroth,1820,monk,mistweaver,125,70,55
Centalink,barthilas,1819,monk,mistweaver,92,63,29
Barelroll,proudmoore,1819,monk,mistweaver,122,83,39
Monknutt,tichondrius,1819,monk,mistweaver,56,32,24
Ilovefrogs,stormrage,1819,monk,mistweaver,60,30,30
Fatnugly,sargeras,1818,monk,mistweaver,62,39,23
Knuqz,stormrage,1818,monk,mistweaver,48,25,23
Malibrew,proudmoore,1817,monk,mistweaver,42,29,13
Deathsteel,emerald-dream,1817,monk,mistweaver,41,25,16
Fistinator,blackrock,1817,monk,mistweaver,120,71,49
Toxicbeans,tichondrius,1817,monk,mistweaver,100,58,42
Rektral,ragnaros,1817,monk,mistweaver,127,73,54
Ándi,barthilas,1817,monk,mistweaver,53,28,25
Bubblepony,illidan,1817,monk,mistweaver,313,164,149
Chaihard,sargeras,1816,monk,mistweaver,45,25,20
Chiang,chogall,1815,monk,mistweaver,91,66,25
Raígon,ragnaros,1815,monk,mistweaver,76,47,29
Rizzdriver,moon-guard,1815,monk,mistweaver,102,63,39
Xhilong,quelthalas,1815,monk,mistweaver,48,28,20
Twoshero,tichondrius,1815,monk,mistweaver,52,30,22
Zilph,malganis,1815,monk,mistweaver,66,36,30
Shiinobi,area-52,1815,monk,mistweaver,146,77,69
Copula,illidan,1815,monk,mistweaver,322,165,157
Okchat,emerald-dream,1814,monk,mistweaver,234,131,103
Phunkymonkey,mannoroth,1814,monk,mistweaver,90,50,40
Integrity,durotan,1814,monk,mistweaver,274,148,126
Toastsmonk,tichondrius,1813,monk,mistweaver,56,36,20
Dreadgladgum,tichondrius,1813,monk,mistweaver,48,24,24
Hyori,saurfang,1812,monk,mistweaver,54,29,25
Soö,tichondrius,1812,monk,mistweaver,66,34,32
Battlecruise,tichondrius,1811,monk,mistweaver,36,24,12
Gnappyy,tichondrius,1811,monk,mistweaver,41,25,16
Mistpump,tichondrius,1811,monk,mistweaver,48,26,22
Tirionx,area-52,1810,monk,mistweaver,227,130,97
Qarmax,azralon,1809,monk,mistweaver,65,35,30
Mavvi,tichondrius,1809,monk,mistweaver,170,88,82
Epî,tichondrius,1809,monk,mistweaver,318,158,160
Izolatedrin,tichondrius,1808,monk,mistweaver,29,22,7
Phattea,thrall,1808,monk,mistweaver,48,31,17
Jiskweaver,sargeras,1808,monk,mistweaver,36,22,14
Enfold,stormrage,1808,monk,mistweaver,48,26,22
Yokuu,thunderlord,1808,monk,mistweaver,54,29,25
Khylu,kelthuzad,1807,monk,mistweaver,24,19,5
Abeldra,moon-guard,1807,monk,mistweaver,82,42,40
Sayflight,tichondrius,1807,monk,mistweaver,72,31,41
Itdreams,illidan,1806,monk,mistweaver,42,25,17
Taekwonscro,proudmoore,1806,monk,mistweaver,60,33,27
Timed,shuhalo,1806,monk,mistweaver,49,26,23
Astrino,zuljin,1805,monk,mistweaver,42,29,13
Chimaekrush,tichondrius,1805,monk,mistweaver,36,24,12
Crispeel,tichondrius,1805,monk,mistweaver,54,33,21
Proventos,azralon,1804,monk,mistweaver,483,256,227
Imdabes,destromath,1804,monk,mistweaver,87,38,49
Vrieden,illidan,1804,monk,mistweaver,99,42,57
Exmist,tichondrius,1803,monk,mistweaver,59,40,19
Bickli,tichondrius,1803,monk,mistweaver,57,32,25
Spacebar,ysondre,1803,monk,mistweaver,72,39,33
Celerein,illidan,1803,monk,mistweaver,118,61,57
Gabaan,azralon,1803,monk,mistweaver,54,27,27
Zundor,ghostlands,1802,monk,mistweaver,32,25,7
Ropturttlê,tichondrius,1802,monk,mistweaver,48,31,17
Nefazzto,ragnaros,1802,monk,mistweaver,30,19,11
Udderpunch,barthilas,1802,monk,mistweaver,83,51,32
Zenno,darkspear,1802,monk,mistweaver,51,31,20
Kungfoocious,tichondrius,1802,monk,mistweaver,57,33,24
Zeroskil,thrall,1802,monk,mistweaver,66,38,28
Sengesen,sargeras,1802,monk,mistweaver,52,29,23
ßullsack,barthilas,1802,monk,mistweaver,108,57,51
Wootzhu,zuljin,1802,monk,mistweaver,122,62,60
Séthrogèn,tichondrius,1801,monk,mistweaver,47,30,17
Mistweave,aerie-peak,1801,monk,mistweaver,54,34,20
Inalambrico,quelthalas,1801,monk,mistweaver,54,33,21
Vanmonk,eonar,1801,monk,mistweaver,54,33,21
Squalicorax,area-52,1801,monk,mistweaver,47,24,23
Jiucho,dalaran,1800,monk,mistweaver,35,23,12
Frogsarecool,stormrage,1800,monk,mistweaver,165,101,64
Exuperjun,emerald-dream,1800,monk,mistweaver,46,26,20
Mekawa,gurubashi,1799,monk,mistweaver,40,26,14
Tiptea,stormrage,1799,monk,mistweaver,42,23,19
Femalejam,darkspear,1798,monk,mistweaver,66,40,26
Mð,vashj,1798,monk,mistweaver,241,125,116
Toonington,sargeras,1797,monk,mistweaver,57,39,18
Karatechawp,bleeding-hollow,1795,monk,mistweaver,64,44,20
Swoleypoley,tichondrius,1794,monk,mistweaver,54,29,25
Senritsuh,drakkari,1793,monk,mistweaver,42,25,17
Goldenfoot,tichondrius,1793,monk,mistweaver,246,130,116
Krömbopulos,magtheridon,1792,monk,mistweaver,53,37,16
Cromulent,saurfang,1792,monk,mistweaver,134,70,64
Unclety,tichondrius,1789,monk,mistweaver,48,30,18
Chikid,barthilas,1788,monk,mistweaver,60,39,21
Bebuu,proudmoore,1787,monk,mistweaver,77,52,25
Valhira,kiljaeden,1787,monk,mistweaver,78,45,33
Roypoker,illidan,1785,monk,mistweaver,48,34,14
Ojarax,bleeding-hollow,1784,monk,mistweaver,84,45,39
Loudpäck,dalaran,1783,monk,mistweaver,65,43,22
Greenbrews,area-52,1783,monk,mistweaver,301,160,141
Rexfiend,tichondrius,1782,monk,mistweaver,24,19,5
Hansul,tichondrius,1782,monk,mistweaver,147,73,74
Triarcs,area-52,1781,monk,mistweaver,36,24,12
Hepp,stormrage,1781,monk,mistweaver,54,35,19
Dræmwalker,malygos,1781,monk,mistweaver,735,367,368
Onlyfansx,ragnaros,1780,monk,mistweaver,262,141,121
Cööked,illidan,1779,monk,mistweaver,75,40,35
Coomweaver,stormrage,1778,monk,mistweaver,42,22,20
Ttvchickchau,tichondrius,1777,monk,mistweaver,137,80,57
Velenious,tichondrius,1775,monk,mistweaver,137,84,53
Suppfastlol,nemesis,1775,monk,mistweaver,138,77,61
Lgee,kelthuzad,1774,monk,mistweaver,30,19,11
Khungfeu,area-52,1774,monk,mistweaver,60,35,25
Antriai,icecrown,1770,monk,mistweaver,66,28,38
Pp,icecrown,1769,monk,mistweaver,55,45,10
Suhjoon,bleeding-hollow,1769,monk,mistweaver,181,86,95
Trackstarx,area-52,1767,monk,mistweaver,30,25,5
Daito,jubeithos,1767,monk,mistweaver,110,62,48
Zuhakmw,tichondrius,1765,monk,mistweaver,154,70,84
Iknwmyname,proudmoore,1764,monk,mistweaver,29,23,6
Roogymw,emerald-dream,1764,monk,mistweaver,94,54,40
Tenoseven,area-52,1763,monk,mistweaver,33,25,8
Misthealz,black-dragonflight,1763,monk,mistweaver,131,80,51
Onecoolmonk,tichondrius,1762,monk,mistweaver,68,43,25
Iightning,dentarg,1762,monk,mistweaver,66,40,26
Jayvex,illidan,1762,monk,mistweaver,72,37,35
Liteup,smolderthorn,1762,monk,mistweaver,527,261,266
Mymissteak,darkspear,1760,monk,mistweaver,135,81,54
Beerflow,stormrage,1760,monk,mistweaver,118,61,57
Mistqt,illidan,1759,monk,mistweaver,65,38,27
Bouncycheeks,frostmourne,1759,monk,mistweaver,96,54,42
Zoltwo,sargeras,1757,monk,mistweaver,136,82,54
Iovegõd,tichondrius,1757,monk,mistweaver,187,109,78
Ninetrigrams,illidan,1756,monk,mistweaver,80,48,32
Bouncymoo,frostmourne,1756,monk,mistweaver,36,21,15
Kynalla,thunderlord,1756,monk,mistweaver,36,21,15
Zukki,zuljin,1756,monk,mistweaver,184,95,89
Whatdaheal,darkspear,1756,monk,mistweaver,72,31,41
Mikamonk,illidan,1755,monk,mistweaver,81,48,33
Monkeymonk,eonar,1755,monk,mistweaver,36,19,17
Rîce,burning-blade,1754,monk,mistweaver,42,29,13
Rokk,rivendare,1754,monk,mistweaver,78,44,34
Chessyx,ragnaros,1754,monk,mistweaver,48,26,22
Cyrøwø,ragnaros,1752,monk,mistweaver,60,38,22
Grabbitz,kelthuzad,1751,monk,mistweaver,42,27,15
Pichau,zuljin,1751,monk,mistweaver,57,35,22
Meâghân,bladefist,1750,monk,mistweaver,33,22,11
Spinharder,stormrage,1750,monk,mistweaver,65,38,27
Bromonster,zuljin,1749,monk,mistweaver,42,22,20
Lexxbtw,thrall,1749,monk,mistweaver,178,93,85
Ahlanna,malganis,1748,monk,mistweaver,29,19,10
Chignar,dathremar,1748,monk,mistweaver,36,23,13
Monkeyhealz,tichondrius,1748,monk,mistweaver,185,105,80
Callmekoldi,dalaran,1748,monk,mistweaver,93,52,41
Gamesuxlol,the-underbog,1747,monk,mistweaver,96,55,41
Smoovhoov,kiljaeden,1747,monk,mistweaver,48,27,21
Tippity,stormrage,1746,monk,mistweaver,37,24,13
Boomtac,moon-guard,1746,monk,mistweaver,104,60,44
Gramazen,tichondrius,1746,monk,mistweaver,72,39,33
Motogp,tichondrius,1746,monk,mistweaver,200,100,100
Mêlon,tichondrius,1745,monk,mistweaver,30,22,8
Earlyybiirdd,sargeras,1745,monk,mistweaver,36,22,14
Chérudim,malganis,1744,monk,mistweaver,36,22,14
Grublord,stormrage,1744,monk,mistweaver,53,27,26
Mxf,tichondrius,1743,monk,mistweaver,36,23,13
Cystweaver,dalaran,1743,monk,mistweaver,89,54,35
Zor,stormscale,1742,monk,mistweaver,30,20,10
Mistpowaz,stormrage,1742,monk,mistweaver,143,84,59
Solusek,korgath,1741,monk,mistweaver,60,43,17
Baittor,proudmoore,1741,monk,mistweaver,62,39,23
Monkney,tichondrius,1740,monk,mistweaver,118,77,41
Tyforprecog,kelthuzad,1739,monk,mistweaver,54,33,21
Yepcocc,lightbringer,1739,monk,mistweaver,41,24,17
Bobbytheorc,tichondrius,1738,monk,mistweaver,35,21,14
Lickthefist,sargeras,1737,monk,mistweaver,48,33,15
Bubear,stormreaver,1735,monk,mistweaver,36,23,13
Seokdenam,tichondrius,1734,monk,mistweaver,111,64,47
Phlexz,jubeithos,1733,monk,mistweaver,36,26,10
Gomon,terenas,1733,monk,mistweaver,59,37,22
Sleeks,bonechewer,1733,monk,mistweaver,114,64,50
Brewy,bloodhoof,1732,monk,mistweaver,30,24,6
Fox,azshara,1732,monk,mistweaver,42,25,17
Cloq,kelthuzad,1732,monk,mistweaver,125,65,60
Cardrik,thrall,1732,monk,mistweaver,172,83,89
Ricearolli,area-52,1731,monk,mistweaver,36,26,10
Lasagnacàt,moon-guard,1731,monk,mistweaver,180,105,75
Zenblazer,illidan,1731,monk,mistweaver,43,22,21
Nevercranex,kirin-tor,1730,monk,mistweaver,42,26,16
Monke,onyxia,1730,monk,mistweaver,54,31,23
Gummycat,bonechewer,1729,monk,mistweaver,204,107,97
Mistohh,kiljaeden,1727,monk,mistweaver,42,27,15
Gujunpyó,sargeras,1727,monk,mistweaver,105,63,42
Aramonk,tichondrius,1727,monk,mistweaver,124,74,50
Mariabaraks,darkspear,1725,monk,mistweaver,108,61,47
Fistofchanny,tichondrius,1725,monk,mistweaver,104,57,47
Ajizzaÿ,saurfang,1725,monk,mistweaver,92,46,46
Cherep,kiljaeden,1724,monk,mistweaver,151,81,70
Canadien,silver-hand,1723,monk,mistweaver,30,18,12
Smallboots,area-52,1722,monk,mistweaver,30,24,6
Steelcase,frostmourne,1722,monk,mistweaver,47,26,21
Igaku,windrunner,1721,monk,mistweaver,54,33,21
Sixsticks,tichondrius,1721,monk,mistweaver,94,53,41
Ðescubra,stormrage,1721,monk,mistweaver,80,44,36
Xblingtron,malganis,1721,monk,mistweaver,65,27,38
Calvana,tichondrius,1719,monk,mistweaver,143,63,80
Vïolët,moon-guard,1717,monk,mistweaver,231,135,96
Sixesm,dalaran,1717,monk,mistweaver,48,25,23
Joonbug,moonrunner,1715,monk,mistweaver,83,47,36
Djuice,tichondrius,1713,monk,mistweaver,60,32,28
Xtramist,tichondrius,1713,monk,mistweaver,48,24,24
Ïtächï,illidan,1713,monk,mistweaver,72,32,40
Alexìn,sargeras,1712,monk,mistweaver,79,50,29
Xitearith,ragnaros,1710,monk,mistweaver,30,18,12
Swuseng,tichondrius,1710,monk,mistweaver,75,43,32
Buhmonk,thrall,1710,monk,mistweaver,60,34,26
Ellesig,ragnaros,1710,monk,mistweaver,268,137,131
Zuen,ragnaros,1710,monk,mistweaver,230,117,113
Carlyjepsen,shadowmoon,1709,monk,mistweaver,139,74,65
Gauche,arygos,1709,monk,mistweaver,168,88,80
Trezzic,aegwynn,1709,monk,mistweaver,49,25,24
Anandamayi,emerald-dream,1708,monk,mistweaver,54,29,25
Molochko,area-52,1707,monk,mistweaver,32,24,8
Betasquadxd,bleeding-hollow,1707,monk,mistweaver,43,25,18
Gundamfish,tichondrius,1707,monk,mistweaver,42,22,20
Doomstroller,aegwynn,1706,monk,mistweaver,225,116,109
Monkyou,area-52,1705,monk,mistweaver,72,35,37
Brewtankx,tichondrius,1704,monk,mistweaver,30,21,9
Røllitup,illidan,1704,monk,mistweaver,54,34,20
Yamatoqt,frostmourne,1704,monk,mistweaver,60,35,25
Omihli,sargeras,1704,monk,mistweaver,48,28,20
Whaes,thrall,1704,monk,mistweaver,36,21,15
Bloodyxmonk,firetree,1704,monk,mistweaver,55,31,24
Spot,kelthuzad,1704,monk,mistweaver,48,24,24
Alekso,malganis,1702,monk,mistweaver,30,18,12
Manggi,tichondrius,1702,monk,mistweaver,169,98,71
Sparksgamer,ragnaros,1701,monk,mistweaver,36,18,18
Badonkadonk,kiljaeden,1701,monk,mistweaver,66,27,39
Dryungpwnz,zuljin,1699,monk,mistweaver,260,146,114
Starçandy,tichondrius,1699,monk,mistweaver,126,65,61
Moonhealsyou,moon-guard,1698,monk,mistweaver,112,70,42
Manicata,tichondrius,1698,monk,mistweaver,219,127,92
Yeji,altar-of-storms,1698,monk,mistweaver,151,73,78
Mvqws,tichondrius,1697,monk,mistweaver,50,33,17
Mexii,hellscream,1697,monk,mistweaver,247,119,128
Zawlp,sargeras,1693,monk,mistweaver,62,37,25
Phtarded,stormreaver,1693,monk,mistweaver,146,74,72
Nevershower,malganis,1692,monk,mistweaver,30,22,8
Jaige,illidan,1692,monk,mistweaver,30,18,12
Florla,illidan,1692,monk,mistweaver,46,24,22
Linsey,frostmourne,1691,monk,mistweaver,36,20,16
Jiubak,dalaran,1691,monk,mistweaver,48,26,22
Teewin,area-52,1690,monk,mistweaver,89,61,28
Jinker,malganis,1690,monk,mistweaver,53,33,20
Healmart,bloodhoof,1690,monk,mistweaver,30,18,12
Vamplyyz,kelthuzad,1690,monk,mistweaver,84,40,44
Jïngwei,proudmoore,1689,monk,mistweaver,54,31,23
Mukboo,tichondrius,1689,monk,mistweaver,48,21,27
Lu,nesingwary,1688,monk,mistweaver,42,25,17
Azurro,jubeithos,1687,monk,mistweaver,42,27,15
Kawali,thrall,1687,monk,mistweaver,138,73,65
Cohenn,tichondrius,1686,monk,mistweaver,24,18,6
Winfred,bleeding-hollow,1686,monk,mistweaver,78,49,29
Botweaver,proudmoore,1686,monk,mistweaver,80,45,35
Spencere,hyjal,1686,monk,mistweaver,84,44,40
Brucechez,tichondrius,1686,monk,mistweaver,53,25,28
Alekun,quelthalas,1685,monk,mistweaver,174,91,83
Alternatives,sargeras,1684,monk,mistweaver,24,18,6
Tazermw,sargeras,1684,monk,mistweaver,68,41,27
Hogarg,emerald-dream,1684,monk,mistweaver,36,21,15
Versachi,stormreaver,1683,monk,mistweaver,111,62,49
Monkydoo,blackhand,1682,monk,mistweaver,60,39,21
Aráshicage,malganis,1681,monk,mistweaver,48,29,19
Chopschtichs,kiljaeden,1680,monk,mistweaver,75,47,28
Fisetèrr,kelthuzad,1680,monk,mistweaver,59,35,24
Hoofweaver,proudmoore,1680,monk,mistweaver,60,25,35
Todnerey,sargeras,1679,monk,mistweaver,77,52,25
Lazeekick,sargeras,1679,monk,mistweaver,48,23,25
Dwãrf,tichondrius,1678,monk,mistweaver,36,25,11
Thraging,sargeras,1678,monk,mistweaver,54,29,25
Avm,azralon,1677,monk,mistweaver,66,36,30
Phyte,kelthuzad,1676,monk,mistweaver,54,25,29
Maicuta,thrall,1675,monk,mistweaver,42,26,16
Sickdrip,magtheridon,1674,monk,mistweaver,42,23,19
Kênpächi,rexxar,1674,monk,mistweaver,87,42,45
Aiswalle,illidan,1673,monk,mistweaver,39,22,17
Drunkentoker,illidan,1673,monk,mistweaver,48,26,22
Cbrewfeaver,malganis,1673,monk,mistweaver,58,31,27
Vybe,frostmourne,1671,monk,mistweaver,105,68,37
Tezcatyo,malganis,1671,monk,mistweaver,54,32,22
Stonymcblaze,malganis,1671,monk,mistweaver,48,28,20
Anxin,tichondrius,1671,monk,mistweaver,60,26,34
Bananaboy,tichondrius,1670,monk,mistweaver,59,35,24
Fisticufs,bleeding-hollow,1670,monk,mistweaver,42,23,19
Quitschi,tichondrius,1669,monk,mistweaver,42,26,16
Yaloon,stormrage,1669,monk,mistweaver,30,18,12
Yulfee,kelthuzad,1669,monk,mistweaver,39,22,17
Lýøp,illidan,1668,monk,mistweaver,48,29,19
Garg,malganis,1666,monk,mistweaver,30,22,8
Noneedlokita,illidan,1666,monk,mistweaver,42,26,16
Swiixm,frostmourne,1666,monk,mistweaver,82,49,33
Nahr,tichondrius,1666,monk,mistweaver,39,22,17
Valian,tichondrius,1666,monk,mistweaver,66,36,30
Nugskis,dalaran,1666,monk,mistweaver,263,135,128
Mememories,tichondrius,1665,monk,mistweaver,74,46,28
Jamerino,jubeithos,1665,monk,mistweaver,210,119,91
Cpr,blackrock,1664,monk,mistweaver,54,37,17
Yuï,bleeding-hollow,1664,monk,mistweaver,42,24,18
Mistastep,tichondrius,1663,monk,mistweaver,168,88,80
Josciel,ragnaros,1663,monk,mistweaver,595,304,291
Blasê,frostmourne,1662,monk,mistweaver,36,22,14
Crypslegacy,tichondrius,1662,monk,mistweaver,208,108,100
Èmacs,barthilas,1661,monk,mistweaver,35,24,11
Kendro,trollbane,1661,monk,mistweaver,125,73,52
Muzzye,frostmourne,1661,monk,mistweaver,340,190,150
Coldridge,bleeding-hollow,1661,monk,mistweaver,42,20,22
Jeskâi,tichondrius,1660,monk,mistweaver,45,26,19
Nicotinetap,tichondrius,1660,monk,mistweaver,42,24,18
Rectus,proudmoore,1659,monk,mistweaver,30,22,8
Julipz,tichondrius,1659,monk,mistweaver,42,23,19
Gooncave,stormrage,1659,monk,mistweaver,110,56,54
Dupaweaver,stormrage,1659,monk,mistweaver,59,26,33
Fistwrapped,illidan,1658,monk,mistweaver,42,27,15
Cheetosnmilk,malganis,1658,monk,mistweaver,35,20,15
Serikko,frostmourne,1657,monk,mistweaver,44,26,18
Zachxd,onyxia,1657,monk,mistweaver,96,54,42
Cranekicks,moon-guard,1657,monk,mistweaver,275,152,123
Sóntix,sargeras,1656,monk,mistweaver,71,38,33
Nekzí,sargeras,1655,monk,mistweaver,36,25,11
Greenrice,thrall,1655,monk,mistweaver,52,33,19
Lilsloptop,moon-guard,1655,monk,mistweaver,161,96,65
Bakanani,magtheridon,1655,monk,mistweaver,49,26,23
Luvdeluxe,skullcrusher,1655,monk,mistweaver,91,47,44
Alocxo,drakkari,1654,monk,mistweaver,34,24,10
Taekwondope,antonidas,1654,monk,mistweaver,43,27,16
Trojanz,malganis,1654,monk,mistweaver,36,20,16
Repbrew,sargeras,1653,monk,mistweaver,63,33,30
Groundways,sargeras,1653,monk,mistweaver,65,31,34
Aenian,ragnaros,1652,monk,mistweaver,47,26,21
Sushî,eonar,1651,monk,mistweaver,59,40,19
Pai,sargeras,1651,monk,mistweaver,36,22,14
Gnetic,nemesis,1651,monk,mistweaver,92,51,41
Tonytornado,proudmoore,1651,monk,mistweaver,84,40,44
Rexzilla,tichondrius,1648,monk,mistweaver,36,25,11
Búhda,tichondrius,1648,monk,mistweaver,36,20,16
Ccop,kelthuzad,1647,monk,mistweaver,36,25,11
Notblakexo,tichondrius,1647,monk,mistweaver,35,19,16
Lartridia,malganis,1645,monk,mistweaver,57,33,24
Ashamah,bleeding-hollow,1644,monk,mistweaver,30,22,8
Miillkz,zuljin,1644,monk,mistweaver,47,25,22
Lovehate,zuljin,1644,monk,mistweaver,89,41,48
Ragemore,emerald-dream,1643,monk,mistweaver,37,23,14
Ahnlev,ragnaros,1643,monk,mistweaver,116,66,50
Mistweaverxo,malganis,1643,monk,mistweaver,128,70,58
Ææøææôææôææô,illidan,1642,monk,mistweaver,138,88,50
Misooyom,moon-guard,1641,monk,mistweaver,54,35,19
Liaoran,stormrage,1641,monk,mistweaver,28,18,10
Swiftm,thrall,1641,monk,mistweaver,321,179,142
Sodamint,sargeras,1641,monk,mistweaver,78,40,38
Rhorkfist,frostmourne,1640,monk,mistweaver,43,23,20
Djux,zuljin,1639,monk,mistweaver,30,20,10
Senseii,dathremar,1639,monk,mistweaver,66,43,23
Brewjitsu,tichondrius,1639,monk,mistweaver,42,23,19
Pandareng,tichondrius,1638,monk,mistweaver,32,20,12
Floka,bleeding-hollow,1638,monk,mistweaver,36,22,14
Rañga,caelestrasz,1638,monk,mistweaver,77,45,32
Damndaniel,hyjal,1638,monk,mistweaver,220,109,111
Grizzm,sargeras,1637,monk,mistweaver,78,48,30
Slothman,nagrand,1637,monk,mistweaver,174,99,75
Genjen,bleeding-hollow,1637,monk,mistweaver,46,26,20
Liké,tichondrius,1636,monk,mistweaver,54,32,22
Rockcalm,malganis,1636,monk,mistweaver,86,48,38
Samzo,barthilas,1636,monk,mistweaver,51,27,24
Paralee,tichondrius,1635,monk,mistweaver,48,34,14
Mwgodqtxtko,nazjatar,1635,monk,mistweaver,60,36,24
Qords,tichondrius,1635,monk,mistweaver,154,81,73
Yoshinator,area-52,1635,monk,mistweaver,83,42,41
Ropgobbler,muradin,1634,monk,mistweaver,30,18,12
Jackphan,azralon,1634,monk,mistweaver,139,81,58
Revivalol,dragonmaw,1633,monk,mistweaver,83,44,39
Tiduskies,crushridge,1633,monk,mistweaver,72,37,35
Ermac,kiljaeden,1632,monk,mistweaver,47,32,15
Pandaiax,area-52,1632,monk,mistweaver,95,51,44
Minaffection,tichondrius,1632,monk,mistweaver,36,19,17
Misswalk,ragnaros,1632,monk,mistweaver,45,20,25
Coralys,sargeras,1631,monk,mistweaver,88,61,27
Chongal,whisperwind,1631,monk,mistweaver,42,24,18
Bossmonk,tichondrius,1631,monk,mistweaver,140,78,62
Sudury,tichondrius,1630,monk,mistweaver,102,59,43
Dragonwhirl,stormrage,1630,monk,mistweaver,95,54,41
Roloyolo,illidan,1630,monk,mistweaver,64,25,39
Místme,tichondrius,1629,monk,mistweaver,78,41,37
Tuesdây,wyrmrest-accord,1628,monk,mistweaver,30,20,10
Lépøissøn,tichondrius,1628,monk,mistweaver,36,21,15
Baldbutcute,darkspear,1627,monk,mistweaver,28,19,9
Brewtalìty,tichondrius,1627,monk,mistweaver,54,34,20
Mfmiscreant,illidan,1627,monk,mistweaver,57,25,32
Avãrîce,stormrage,1626,monk,mistweaver,24,17,7
Cryptmist,frostmourne,1626,monk,mistweaver,48,32,16
Valelarus,doomhammer,1626,monk,mistweaver,42,24,18
Zxenn,tichondrius,1626,monk,mistweaver,30,17,13
Craziediemon,malganis,1626,monk,mistweaver,103,55,48
Barnåcle,darkspear,1625,monk,mistweaver,72,49,23
Drama,tichondrius,1625,monk,mistweaver,56,36,20
Qoong,tichondrius,1625,monk,mistweaver,70,42,28
Wittymonk,illidan,1625,monk,mistweaver,99,57,42
Bodhisattvax,bleeding-hollow,1625,monk,mistweaver,42,24,18
Peachtea,burning-legion,1625,monk,mistweaver,45,21,24
Crentist,mannoroth,1624,monk,mistweaver,40,31,9
Innerchii,tichondrius,1624,monk,mistweaver,24,17,7
Dirtyde,sargeras,1624,monk,mistweaver,181,87,94
Fistergand,frostwolf,1623,monk,mistweaver,37,30,7
Starryysky,illidan,1623,monk,mistweaver,48,32,16
Röshi,kelthuzad,1623,monk,mistweaver,54,35,19
Zhíu,ragnaros,1623,monk,mistweaver,54,33,21
Liteup,korgath,1623,monk,mistweaver,102,62,40
Ywingtsuan,frostmourne,1622,monk,mistweaver,41,21,20
Diobrando,illidan,1621,monk,mistweaver,63,40,23
Braindi,arathor,1621,monk,mistweaver,60,34,26
Pumakicks,tichondrius,1621,monk,mistweaver,88,48,40
Rakia,moon-guard,1621,monk,mistweaver,243,123,120
Feel,frostmourne,1620,monk,mistweaver,24,17,7
Napzzxo,sargeras,1620,monk,mistweaver,60,37,23
Raymond,malganis,1620,monk,mistweaver,94,54,40
Ghðst,ragnaros,1620,monk,mistweaver,42,24,18
Monkwalker,tichondrius,1620,monk,mistweaver,66,35,31
Originalmonk,tichondrius,1619,monk,mistweaver,28,23,5
Swolington,proudmoore,1619,monk,mistweaver,41,26,15
Intertwine,frostmourne,1619,monk,mistweaver,30,17,13
Footloverx,area-52,1618,monk,mistweaver,38,29,9
Avz,azralon,1618,monk,mistweaver,30,21,9
Mlngo,illidan,1618,monk,mistweaver,36,20,16
Metakillër,ragnaros,1618,monk,mistweaver,98,53,45
Zenspice,stormrage,1617,monk,mistweaver,33,22,11
Emporertrump,bleeding-hollow,1617,monk,mistweaver,295,155,140
Stormpounder,proudmoore,1616,monk,mistweaver,60,40,20
Locusta,tichondrius,1616,monk,mistweaver,30,19,11
Drinkkin,bleeding-hollow,1616,monk,mistweaver,114,68,46
Sebsws,proudmoore,1616,monk,mistweaver,100,59,41
Immamonkey,tichondrius,1616,monk,mistweaver,200,114,86
Rattpig,sargeras,1616,monk,mistweaver,82,43,39
Wokoon,kelthuzad,1615,monk,mistweaver,27,21,6
Jedub,tichondrius,1615,monk,mistweaver,54,37,17
Spaazz,tichondrius,1615,monk,mistweaver,125,76,49
Vayce,barthilas,1615,monk,mistweaver,45,25,20
Caibiws,tichondrius,1615,monk,mistweaver,62,32,30
Bréwmaster,stormrage,1615,monk,mistweaver,36,17,19
Ggjudo,sargeras,1614,monk,mistweaver,58,34,24
Kungfuturdle,tichondrius,1614,monk,mistweaver,101,58,43
Xtacie,sargeras,1614,monk,mistweaver,66,30,36
Keiirah,zuluhed,1614,monk,mistweaver,60,24,36
Greenvan,tichondrius,1613,monk,mistweaver,24,17,7
Pacee,deathwing,1613,monk,mistweaver,24,17,7
Kûshi,stormrage,1613,monk,mistweaver,35,23,12
Whoonmonk,tichondrius,1613,monk,mistweaver,66,41,25
Somebodym,illidan,1613,monk,mistweaver,36,22,14
Merkey,tichondrius,1613,monk,mistweaver,72,39,33
Yunmen,blades-edge,1613,monk,mistweaver,113,61,52
Monkgyfatso,tichondrius,1612,monk,mistweaver,27,23,4
Tharja,bonechewer,1612,monk,mistweaver,56,34,22
Danceofchiji,tichondrius,1612,monk,mistweaver,30,17,13
Musedz,barthilas,1612,monk,mistweaver,60,23,37
Ninakittenx,staghelm,1611,monk,mistweaver,60,36,24
Dlysezzic,tichondrius,1611,monk,mistweaver,98,54,44
Tweiliax,tichondrius,1611,monk,mistweaver,51,26,25
Badnboojie,malganis,1611,monk,mistweaver,69,31,38
Kyókó,quelthalas,1610,monk,mistweaver,30,20,10
Prisonike,area-52,1610,monk,mistweaver,60,36,24
Pingpang,stormreaver,1610,monk,mistweaver,81,46,35
Korata,frostwolf,1610,monk,mistweaver,42,23,19
Mydadishere,tichondrius,1609,monk,mistweaver,18,17,1
Tarkir,quelthalas,1609,monk,mistweaver,95,58,37
Hîbîscus,illidan,1609,monk,mistweaver,32,17,15
Planetariumz,bleeding-hollow,1609,monk,mistweaver,350,183,167
Lazura,tichondrius,1609,monk,mistweaver,65,33,32
Grandsonweez,thrall,1608,monk,mistweaver,95,49,46
Bigthing,burning-blade,1608,monk,mistweaver,42,21,21
Miniswag,arthas,1608,monk,mistweaver,72,31,41
Mîstchievous,sargeras,1607,monk,mistweaver,28,21,7
Jadestørmz,illidan,1607,monk,mistweaver,30,20,10
Azahri,sargeras,1607,monk,mistweaver,46,29,17
Brosiedon,sargeras,1607,monk,mistweaver,166,81,85
Santiaguiño,ragnaros,1607,monk,mistweaver,71,27,44
Xwârz,drakkari,1606,monk,mistweaver,44,28,16
Tubby,eredar,1606,monk,mistweaver,36,22,14
Ramisan,barthilas,1606,monk,mistweaver,77,44,33
Mýthik,hyjal,1606,monk,mistweaver,66,37,29
Zugroi,frostmourne,1605,monk,mistweaver,36,30,6
Gooseoba,tichondrius,1605,monk,mistweaver,24,18,6
Tamingpanda,wildhammer,1605,monk,mistweaver,60,33,27
Jugies,emerald-dream,1604,monk,mistweaver,87,53,34
Eppsmonk,tichondrius,1604,monk,mistweaver,30,18,12
Oblivion,wildhammer,1604,monk,mistweaver,61,36,25
Morhe,the-forgotten-coast,1603,monk,mistweaver,54,38,16
Rileyreidfan,azjolnerub,1603,monk,mistweaver,36,25,11
Cymonka,sargeras,1603,monk,mistweaver,30,17,13
Greenstar,bleeding-hollow,1603,monk,mistweaver,310,156,154
Donnieyen,area-52,1603,monk,mistweaver,96,47,49
Kharazim,skullcrusher,1603,monk,mistweaver,120,52,68
Goochtickles,bleeding-hollow,1602,monk,mistweaver,128,79,49
Gess,stormscale,1602,monk,mistweaver,108,54,54
Docpalpatine,tichondrius,1602,monk,mistweaver,36,17,19
Xuenws,tichondrius,1602,monk,mistweaver,84,36,48
Bussyweaver,sargeras,1601,monk,mistweaver,147,90,57
Bowstâff,lightbringer,1601,monk,mistweaver,36,22,14
Zeroxe,area-52,1600,monk,mistweaver,42,30,12
Benedïct,korgath,1600,monk,mistweaver,30,17,13
Hunkymonky,thrall,1600,monk,mistweaver,105,59,46
Slashsmack,caelestrasz,1600,monk,mistweaver,92,49,43
Mistysweep,sargeras,1600,monk,mistweaver,85,45,40
Turbofist,bleeding-hollow,1600,monk,mistweaver,47,22,25
Furyjames,quelthalas,1600,monk,mistweaver,115,52,63
Manchu,stormrage,1599,monk,mistweaver,30,18,12
Masamunes,thrall,1598,monk,mistweaver,56,40,16
Pappaya,tichondrius,1597,monk,mistweaver,36,25,11
Bobbybiz,bleeding-hollow,1597,monk,mistweaver,152,86,66
Tahs,azralon,1596,monk,mistweaver,50,34,16
Snoozzy,kelthuzad,1596,monk,mistweaver,42,21,21
Havasupai,turalyon,1595,monk,mistweaver,24,17,7
Lightskinmon,area-52,1595,monk,mistweaver,42,23,19
Kungfused,frostmourne,1595,monk,mistweaver,66,36,30
Monkzilla,tichondrius,1593,monk,mistweaver,24,17,7
Cisneros,doomhammer,1593,monk,mistweaver,297,159,138
Flagreturned,illidan,1593,monk,mistweaver,36,19,17
Chavbrew,stormrage,1592,monk,mistweaver,85,46,39
Atruefister,tichondrius,1590,monk,mistweaver,240,132,108
Onees,tichondrius,1590,monk,mistweaver,99,49,50
Anagark,barthilas,1588,monk,mistweaver,45,34,11
Toastage,tichondrius,1587,monk,mistweaver,48,28,20
Songwei,barthilas,1587,monk,mistweaver,89,50,39
Neonep,stormrage,1586,monk,mistweaver,130,72,58
Moppz,illidan,1585,monk,mistweaver,29,19,10
Jeongkwon,tichondrius,1583,monk,mistweaver,36,19,17
Aerius,area-52,1581,monk,mistweaver,48,28,20
Scrotburg,thrall,1579,monk,mistweaver,36,19,17
Ricklee,ysera,1577,monk,mistweaver,33,23,10
Victuskk,tichondrius,1577,monk,mistweaver,67,45,22
Suntzulml,quelthalas,1576,monk,mistweaver,227,116,111
Waataafaak,malganis,1576,monk,mistweaver,93,47,46
Nxghtmarezz,tichondrius,1575,monk,mistweaver,54,38,16
Cuckoon,malganis,1575,monk,mistweaver,36,20,16
Lozza,jubeithos,1574,monk,mistweaver,54,32,22
Imnumberone,alterac-mountains,1574,monk,mistweaver,30,17,13
Tamonger,stormrage,1574,monk,mistweaver,224,119,105
Wildfists,tichondrius,1574,monk,mistweaver,738,370,368
Juchiyosamu,illidan,1573,monk,mistweaver,33,19,14
Bigpøppa,tichondrius,1573,monk,mistweaver,60,33,27
Chevvyy,azshara,1573,monk,mistweaver,36,18,18
Beboté,quelthalas,1573,monk,mistweaver,205,97,108
Nezukó,malganis,1572,monk,mistweaver,29,17,12
Brewmanchew,frostmourne,1572,monk,mistweaver,159,91,68
Bastilaqt,korgath,1571,monk,mistweaver,229,125,104
Buffmonkdmg,tichondrius,1571,monk,mistweaver,90,48,42
Ðìé,tichondrius,1570,monk,mistweaver,42,26,16
Vohdka,malganis,1569,monk,mistweaver,148,86,62
Ckqt,stormrage,1569,monk,mistweaver,41,23,18
Healzpapi,tichondrius,1569,monk,mistweaver,268,143,125
Bergoth,bleeding-hollow,1569,monk,mistweaver,36,19,17
Peege,kelthuzad,1568,monk,mistweaver,173,104,69
Voltekkor,tichondrius,1568,monk,mistweaver,50,27,23
Treessome,tichondrius,1567,monk,mistweaver,29,20,9
Gsv,sargeras,1565,monk,mistweaver,180,98,82
Bebess,moon-guard,1564,monk,mistweaver,51,28,23
Eatmykïtty,dalaran,1563,monk,mistweaver,36,23,13
Lenakai,malganis,1563,monk,mistweaver,53,26,27
Zkingmonk,stormrage,1563,monk,mistweaver,48,20,28
Hatsu,madoran,1562,monk,mistweaver,155,79,76
Muzzen,fizzcrank,1562,monk,mistweaver,40,20,20
Fistuhcuffs,sargeras,1561,monk,mistweaver,87,49,38
Wide,scarlet-crusade,1560,monk,mistweaver,30,17,13
Inebriated,auchindoun,1559,monk,mistweaver,39,22,17
Maripaulita,ragnaros,1559,monk,mistweaver,42,21,21
Musachi,barthilas,1558,monk,mistweaver,90,43,47
Buoymoose,bleeding-hollow,1557,monk,mistweaver,53,35,18
Slipperybobs,tichondrius,1557,monk,mistweaver,101,61,40
Bunnygal,thaurissan,1557,monk,mistweaver,143,73,70
Jerumay,tichondrius,1556,monk,mistweaver,93,52,41
Toysruskidx,sargeras,1555,monk,mistweaver,36,21,15
Justsidiousm,sargeras,1553,monk,mistweaver,42,31,11
Lonebamboo,tichondrius,1553,monk,mistweaver,56,28,28
Nelda,gorgonnash,1552,monk,mistweaver,115,69,46
Zerker,nagrand,1552,monk,mistweaver,61,29,32
Nelly,grizzly-hills,1552,monk,mistweaver,36,17,19
Ekèl,tichondrius,1551,monk,mistweaver,113,60,53
Hazelbazel,bleeding-hollow,1550,monk,mistweaver,54,35,19
Nailtech,tichondrius,1550,monk,mistweaver,66,37,29
Sabersatin,sargeras,1550,monk,mistweaver,42,21,21
Statue,cenarius,1549,monk,mistweaver,29,17,12
Frenchfries,dragonmaw,1547,monk,mistweaver,72,34,38
Throws,stormrage,1546,monk,mistweaver,30,17,13
Kwoon,hyjal,1544,monk,mistweaver,64,34,30
Krob,bleeding-hollow,1544,monk,mistweaver,33,17,16
Kymoshenz,sargeras,1543,monk,mistweaver,24,17,7
Xenitate,bleeding-hollow,1543,monk,mistweaver,42,23,19
Lariv,bleeding-hollow,1543,monk,mistweaver,73,39,34
Haiyà,malganis,1542,monk,mistweaver,30,17,13
Monkatron,arthas,1542,monk,mistweaver,36,20,16
Bruceki,bleeding-hollow,1540,monk,mistweaver,47,26,21
Omii,darkspear,1540,monk,mistweaver,34,17,17
Notfw,tichondrius,1540,monk,mistweaver,64,27,37
Lørðjimmy,sargeras,1539,monk,mistweaver,42,29,13
Çät,frostmourne,1539,monk,mistweaver,50,31,19
Tirêd,sargeras,1538,monk,mistweaver,131,72,59
Alianli,tichondrius,1538,monk,mistweaver,101,36,65
Oochi,illidan,1537,monk,mistweaver,72,34,38
Zeelos,kelthuzad,1536,monk,mistweaver,30,20,10
Scrapfu,proudmoore,1536,monk,mistweaver,83,44,39
Banterx,sargeras,1536,monk,mistweaver,91,45,46
Babychi,frostmourne,1535,monk,mistweaver,91,49,42
Fissg,frostmourne,1535,monk,mistweaver,48,25,23
Squaanched,emerald-dream,1535,monk,mistweaver,48,17,31
Forgèt,kelthuzad,1534,monk,mistweaver,30,16,14
Kariwanji,tichondrius,1533,monk,mistweaver,347,180,167
Austinm,tichondrius,1532,monk,mistweaver,24,16,8
Fehthermane,area-52,1531,monk,mistweaver,82,51,31
Kungpaofish,tichondrius,1531,monk,mistweaver,30,16,14
Russtie,sargeras,1531,monk,mistweaver,42,20,22
Zhuangnimane,tichondrius,1530,monk,mistweaver,65,38,27
Ghorb,boulderfist,1530,monk,mistweaver,99,54,45
Jlowbob,tichondrius,1530,monk,mistweaver,96,51,45
Sob,frostmourne,1529,monk,mistweaver,140,84,56
Glad,stormscale,1529,monk,mistweaver,336,179,157
Cungflu,crushridge,1529,monk,mistweaver,64,26,38
Carzo,area-52,1527,monk,mistweaver,38,23,15
Fister,garithos,1526,monk,mistweaver,76,49,27
Keileas,moon-guard,1526,monk,mistweaver,136,63,73
Atsugin,khazgoroth,1525,monk,mistweaver,36,16,20
Rockemsockem,gorefiend,1524,monk,mistweaver,72,41,31
Peezadelo,azralon,1523,monk,mistweaver,45,25,20
Hotpotatoee,aerie-peak,1522,monk,mistweaver,230,126,104
Marsha,tichondrius,1522,monk,mistweaver,72,31,41
Jitsu,frostmane,1521,monk,mistweaver,105,64,41
Lenee,frostmourne,1520,monk,mistweaver,45,30,15
Diagrams,tichondrius,1520,monk,mistweaver,29,19,10
Gngrbeardman,tichondrius,1519,monk,mistweaver,39,21,18
Kiqz,stormrage,1519,monk,mistweaver,30,16,14
Yurm,moon-guard,1518,monk,mistweaver,54,38,16
Brewswayne,argent-dawn,1518,monk,mistweaver,36,23,13
Aledal,agamaggan,1517,monk,mistweaver,66,41,25
Sshri,illidan,1517,monk,mistweaver,263,129,134
Ophibrew,zuljin,1516,monk,mistweaver,30,16,14
Romdansik,tichondrius,1515,monk,mistweaver,136,73,63
Ebrew,frostmourne,1514,monk,mistweaver,98,58,40
Mis,tichondrius,1514,monk,mistweaver,30,16,14
Voodubrew,area-52,1514,monk,mistweaver,48,24,24
Bachalsimple,proudmoore,1513,monk,mistweaver,60,39,21
Chelada,sargeras,1513,monk,mistweaver,48,22,26
Sorowblade,lothar,1512,monk,mistweaver,56,35,21
Fattyboy,area-52,1511,monk,mistweaver,118,73,45
Monkë,frostmourne,1511,monk,mistweaver,30,16,14
Mizzycash,malganis,1511,monk,mistweaver,44,23,21
Boneykicks,tichondrius,1511,monk,mistweaver,60,28,32
Bøkky,frostmourne,1509,monk,mistweaver,144,85,59
Aristea,emerald-dream,1509,monk,mistweaver,30,16,14
Monkash,sargeras,1509,monk,mistweaver,36,19,17
Zettelkasten,tichondrius,1508,monk,mistweaver,42,18,24
Shyntä,dalaran,1507,monk,mistweaver,66,42,24
Oakleet,bleeding-hollow,1507,monk,mistweaver,48,27,21
Chìforce,sargeras,1507,monk,mistweaver,53,23,30
Vardeh,stormscale,1505,monk,mistweaver,129,77,52
Greenpigo,tichondrius,1504,monk,mistweaver,18,17,1
Dextr,arthas,1503,monk,mistweaver,87,50,37
Aokuâng,malganis,1502,monk,mistweaver,124,72,52
Santhz,ragnaros,1501,monk,mistweaver,24,16,8
Jeolmyung,tichondrius,1501,monk,mistweaver,51,24,27
Axellrod,tichondrius,1500,monk,mistweaver,60,38,22
Grimaku,tichondrius,1500,monk,mistweaver,51,23,28
Dareelyst,arygos,1500,monk,mistweaver,42,17,25
Xomonik,borean-tundra,1499,monk,mistweaver,66,39,27
Ferrarí,quelthalas,1499,monk,mistweaver,281,153,128
Lekrosa,thrall,1499,monk,mistweaver,71,38,33
Göat,emerald-dream,1499,monk,mistweaver,87,45,42
Beejae,tichondrius,1499,monk,mistweaver,31,16,15
Ghim,frostmourne,1499,monk,mistweaver,114,50,64
Äncient,quelthalas,1497,monk,mistweaver,142,82,60
Bozzychi,illidan,1496,monk,mistweaver,66,33,33
Tinypunch,emerald-dream,1496,monk,mistweaver,72,34,38
Missweaver,sargeras,1495,monk,mistweaver,78,39,39
Shenzuu,daggerspine,1494,monk,mistweaver,66,41,25
Augustinê,tichondrius,1494,monk,mistweaver,30,16,14
Hiiyaa,tichondrius,1493,monk,mistweaver,128,63,65
Fidgetspinna,zuljin,1493,monk,mistweaver,44,21,23
Hoggs,sargeras,1492,monk,mistweaver,181,105,76
Seung,duskwood,1492,monk,mistweaver,255,121,134
Leemîn,tichondrius,1491,monk,mistweaver,42,30,12
Caellum,quelthalas,1490,monk,mistweaver,41,27,14
Fistnanweavn,dawnbringer,1488,monk,mistweaver,132,62,70
Themonkfunk,bleeding-hollow,1487,monk,mistweaver,46,29,17
Reque,illidan,1487,monk,mistweaver,303,165,138
Conormonk,tichondrius,1486,monk,mistweaver,24,18,6
Saeloon,frostmourne,1486,monk,mistweaver,77,36,41
Buddhabud,sargeras,1485,monk,mistweaver,54,28,26
Grandpå,tichondrius,1484,monk,mistweaver,42,23,19
Sourcandyx,area-52,1484,monk,mistweaver,33,16,17
Thors,gorgonnash,1483,monk,mistweaver,90,53,37
Sihgriid,tichondrius,1483,monk,mistweaver,74,43,31
Prf,ragnaros,1483,monk,mistweaver,87,50,37
Carnâge,bleeding-hollow,1483,monk,mistweaver,58,30,28
Rènh,ragnaros,1483,monk,mistweaver,35,17,18
Swiftyboi,tichondrius,1483,monk,mistweaver,132,64,68
Snoodle,korgath,1481,monk,mistweaver,192,101,91
Hakunapotata,demon-soul,1480,monk,mistweaver,30,17,13
Närza,kelthuzad,1480,monk,mistweaver,60,32,28
Âfrika,ysondre,1480,monk,mistweaver,65,31,34
Ÿipman,frostmourne,1480,monk,mistweaver,66,31,35
Themys,zuljin,1479,monk,mistweaver,48,30,18
Pimpolhona,nemesis,1479,monk,mistweaver,138,71,67
Cousycous,garithos,1478,monk,mistweaver,36,23,13
Clipping,tichondrius,1478,monk,mistweaver,48,29,19
Monkybidness,tichondrius,1478,monk,mistweaver,51,24,27
Taigared,ragnaros,1478,monk,mistweaver,45,17,28
Talented,azuremyst,1477,monk,mistweaver,63,41,22
Xyamïxo,tichondrius,1477,monk,mistweaver,134,75,59
Jèricho,thrall,1477,monk,mistweaver,102,57,45
Ungankable,sargeras,1477,monk,mistweaver,303,156,147
Drfoochi,tichondrius,1477,monk,mistweaver,60,29,31
Monkpowaz,stormrage,1476,monk,mistweaver,42,26,16
Drkeen,frostmourne,1476,monk,mistweaver,49,19,30
Gomey,bleeding-hollow,1475,monk,mistweaver,38,21,17
Mungka,tichondrius,1475,monk,mistweaver,106,55,51
Popchi,stormrage,1475,monk,mistweaver,48,18,30
Ludan,eredar,1474,monk,mistweaver,280,142,138
Bruceteå,area-52,1473,monk,mistweaver,29,19,10
Mòñk,shattered-halls,1473,monk,mistweaver,42,26,16
Hymasterlol,tichondrius,1473,monk,mistweaver,60,28,32
Sponsored,lothar,1471,monk,mistweaver,42,28,14
Mcfluffey,area-52,1471,monk,mistweaver,98,58,40
Pydelo,tichondrius,1471,monk,mistweaver,30,17,13
Willowa,frostmourne,1470,monk,mistweaver,50,30,20
Sinistuhm,tichondrius,1470,monk,mistweaver,65,38,27
Damemasduro,ragnaros,1470,monk,mistweaver,674,335,339
Fisthealz,area-52,1469,monk,mistweaver,30,22,8
Sohéi,proudmoore,1469,monk,mistweaver,29,17,12
Phoenixspark,gnomeregan,1468,monk,mistweaver,80,51,29
Chiban,misha,1468,monk,mistweaver,46,23,23
Tuss,tichondrius,1468,monk,mistweaver,76,31,45
Wohrfnok,illidan,1465,monk,mistweaver,48,28,20
Pcyesh,nemesis,1465,monk,mistweaver,110,57,53
Dovhug,draenor,1465,monk,mistweaver,66,30,36
Gotmonk,aggramar,1464,monk,mistweaver,30,19,11
Jinjunxi,tichondrius,1463,monk,mistweaver,144,78,66
Dharma,khaz-modan,1463,monk,mistweaver,154,79,75
Mustaf,stormrage,1462,monk,mistweaver,132,67,65
Iamamonk,kelthuzad,1461,monk,mistweaver,44,29,15
Docwang,malganis,1460,monk,mistweaver,60,39,21
Topnotch,malganis,1460,monk,mistweaver,66,38,28
Odindad,tichondrius,1460,monk,mistweaver,108,57,51
Himah,area-52,1460,monk,mistweaver,36,16,20
Americå,zuljin,1459,monk,mistweaver,81,51,30
Kaelastra,stormrage,1459,monk,mistweaver,126,69,57
Gnomepuncher,dalaran,1459,monk,mistweaver,48,25,23
Iluvthugnmcz,sargeras,1459,monk,mistweaver,112,58,54
Donchi,sargeras,1459,monk,mistweaver,46,22,24
Fistea,frostmourne,1459,monk,mistweaver,51,24,27
Shoumi,turalyon,1458,monk,mistweaver,36,22,14
Kazov,proudmoore,1458,monk,mistweaver,178,92,86
Hitaru,azralon,1457,monk,mistweaver,64,39,25
Phatcheeks,aegwynn,1457,monk,mistweaver,117,66,51
Bobthedrag,illidan,1457,monk,mistweaver,167,85,82
Guïnness,tichondrius,1455,monk,mistweaver,30,18,12
Fonnf,nemesis,1454,monk,mistweaver,32,16,16
Saulgóòdman,tichondrius,1453,monk,mistweaver,42,18,24
Fairyeflora,wyrmrest-accord,1452,monk,mistweaver,48,31,17
Rôbo,emerald-dream,1452,monk,mistweaver,29,16,13
Rosellina,kelthuzad,1451,monk,mistweaver,38,23,15
Chuks,nerzhul,1451,monk,mistweaver,224,124,100
Janeil,wyrmrest-accord,1451,monk,mistweaver,300,153,147
Baee,cairne,1451,monk,mistweaver,43,17,26
Pomonk,nazjatar,1450,monk,mistweaver,69,45,24
Märthä,azralon,1450,monk,mistweaver,167,86,81
Mcfisted,area-52,1450,monk,mistweaver,81,41,40
Caliroll,gorefiend,1450,monk,mistweaver,70,31,39
Xtrememisty,frostmourne,1449,monk,mistweaver,66,35,31
Sisfist,blackhand,1449,monk,mistweaver,36,18,18
Ric,gundrak,1447,monk,mistweaver,93,56,37
Bresmeatfore,barthilas,1446,monk,mistweaver,54,33,21
Monkeybooze,sargeras,1445,monk,mistweaver,68,40,28
Warzsong,azralon,1445,monk,mistweaver,66,37,29
Lidela,sargeras,1445,monk,mistweaver,52,27,25
Fudoki,area-52,1444,monk,mistweaver,186,96,90
Nyght,moon-guard,1444,monk,mistweaver,120,54,66
Darkjab,tichondrius,1442,monk,mistweaver,48,22,26
Meshugah,quelthalas,1441,monk,mistweaver,124,59,65
Chérudim,illidan,1439,monk,mistweaver,18,15,3
Kirshta,kelthuzad,1439,monk,mistweaver,38,28,10
Aleuzraz,illidan,1439,monk,mistweaver,24,15,9
Soothinn,tichondrius,1439,monk,mistweaver,78,46,32
Dbmmonk,malganis,1438,monk,mistweaver,18,15,3
Elcidx,tichondrius,1438,monk,mistweaver,24,15,9
Zzizzi,tichondrius,1438,monk,mistweaver,24,15,9
Proctology,tichondrius,1438,monk,mistweaver,40,24,16
Orgrrim,area-52,1438,monk,mistweaver,30,18,12
Zonianman,tichondrius,1438,monk,mistweaver,125,69,56
Nukeproof,stormreaver,1438,monk,mistweaver,31,16,15
Bigs,duskwood,1438,monk,mistweaver,35,15,20
Cooltran,tichondrius,1437,monk,mistweaver,36,22,14
NijlA80FE2,sargeras,1436,monk,mistweaver,18,15,3
Gnet,azralon,1435,monk,mistweaver,18,15,3
Iilgayrob,stormrage,1435,monk,mistweaver,24,15,9
Xaurian,firetree,1435,monk,mistweaver,103,59,44
Outhume,eredar,1435,monk,mistweaver,30,15,15
Dhomonk,rexxar,1434,monk,mistweaver,29,17,12
Sobuu,wyrmrest-accord,1433,monk,mistweaver,36,28,8
Limi,malganis,1433,monk,mistweaver,36,27,9
Alinejat,auchindoun,1433,monk,mistweaver,24,15,9
Fartknocker,magtheridon,1433,monk,mistweaver,30,15,15
Softer,frostmane,1432,monk,mistweaver,24,15,9
Jackâl,malganis,1432,monk,mistweaver,31,19,12
Gotosleepkid,dalaran,1432,monk,mistweaver,50,25,25
Bingqilinn,sargeras,1431,monk,mistweaver,30,15,15
Shâdòw,ragnaros,1429,monk,mistweaver,18,15,3
Midewmonk,proudmoore,1429,monk,mistweaver,58,24,34
Mistymarc,zuljin,1428,monk,mistweaver,24,15,9
Mingchen,tichondrius,1428,monk,mistweaver,42,24,18
Fuqame,kiljaeden,1428,monk,mistweaver,42,19,23
Poundmedaddi,tichondrius,1427,monk,mistweaver,139,84,55
Titanus,chogall,1427,monk,mistweaver,48,26,22
Vorikson,stormrage,1426,monk,mistweaver,228,108,120
Jooshy,tichondrius,1426,monk,mistweaver,83,39,44
Showshoway,tichondrius,1426,monk,mistweaver,247,116,131
Fistlord,zuljin,1425,monk,mistweaver,32,18,14
Míyãgí,tichondrius,1425,monk,mistweaver,48,26,22
Bbyyoda,illidan,1425,monk,mistweaver,132,70,62
Tenshu,runetotem,1425,monk,mistweaver,93,48,45
Mastamonksta,illidan,1425,monk,mistweaver,34,16,18
Pøkemonk,malganis,1424,monk,mistweaver,24,15,9
Goocn,tichondrius,1424,monk,mistweaver,66,35,31
Deadmw,thrall,1423,monk,mistweaver,24,17,7
Friskyfister,tichondrius,1422,monk,mistweaver,30,15,15
Pagtuk,daggerspine,1422,monk,mistweaver,69,30,39
Brüce,ragnaros,1421,monk,mistweaver,57,33,24
Waxxi,barthilas,1421,monk,mistweaver,144,83,61
Brewball,illidan,1421,monk,mistweaver,56,30,26
Jasonmonk,sargeras,1420,monk,mistweaver,31,19,12
Taijutzu,darkspear,1419,monk,mistweaver,24,15,9
Nornangus,sargeras,1419,monk,mistweaver,65,34,31
Telospateo,ragnaros,1418,monk,mistweaver,90,48,42
Mightbweavin,bleeding-hollow,1418,monk,mistweaver,132,61,71
Abdoolah,illidan,1417,monk,mistweaver,152,76,76
Dumbmonk,frostmourne,1416,monk,mistweaver,18,15,3
Comonk,area-52,1416,monk,mistweaver,24,15,9
Kymist,stormrage,1415,monk,mistweaver,188,99,89
Bakus,tichondrius,1414,monk,mistweaver,35,19,16
Hadryan,proudmoore,1414,monk,mistweaver,190,96,94
Srshy,drakkari,1414,monk,mistweaver,72,30,42
Kemmy,ravencrest,1413,monk,mistweaver,49,27,22
Markofzugzug,tichondrius,1413,monk,mistweaver,36,15,21
Cdeez,malganis,1412,monk,mistweaver,42,29,13
Keekirx,tichondrius,1412,monk,mistweaver,34,18,16
Punch,lothar,1412,monk,mistweaver,51,26,25
Güwop,tichondrius,1411,monk,mistweaver,87,46,41
Ralphiex,tichondrius,1411,monk,mistweaver,101,53,48
Bbunglee,tichondrius,1410,monk,mistweaver,53,33,20
Xenzas,chogall,1410,monk,mistweaver,29,17,12
Kocksnapper,stormreaver,1410,monk,mistweaver,122,68,54
Caradlevinge,ragnaros,1410,monk,mistweaver,84,34,50
Beverage,frostmourne,1409,monk,mistweaver,35,24,11
Benex,tichondrius,1409,monk,mistweaver,41,21,20
Noodalie,moon-guard,1408,monk,mistweaver,30,22,8
Hungfuu,tichondrius,1407,monk,mistweaver,18,15,3
Knucklebadge,tichondrius,1407,monk,mistweaver,47,30,17
Shandaspanda,rivendare,1407,monk,mistweaver,84,42,42
Indigojo,silver-hand,1407,monk,mistweaver,42,17,25
Vegoku,moon-guard,1406,monk,mistweaver,137,72,65
Jmonks,stormrage,1406,monk,mistweaver,66,27,39
Lotusdream,argent-dawn,1405,monk,mistweaver,120,65,55
Lindraice,illidan,1405,monk,mistweaver,30,15,15
Edbtz,illidan,1403,monk,mistweaver,30,21,9
Puoll,gallywix,1403,monk,mistweaver,157,82,75
Thirteendads,turalyon,1403,monk,mistweaver,35,17,18
Gitwwrekd,area-52,1402,monk,mistweaver,24,16,8
Vvsm,tichondrius,1402,monk,mistweaver,30,15,15
Sonicenergy,tichondrius,1402,monk,mistweaver,57,27,30
Åvå,emerald-dream,1402,monk,mistweaver,109,50,59
Zuchi,frostmourne,1401,monk,mistweaver,36,23,13
Xiang,dreadmaul,1401,monk,mistweaver,54,32,22
Zarma,stormrage,1401,monk,mistweaver,88,48,40
Lunarc,mannoroth,1401,monk,mistweaver,93,50,43
Presas,nemesis,1401,monk,mistweaver,60,29,31
Blackmist,khazgoroth,1399,monk,mistweaver,24,16,8
Awwchi,tichondrius,1399,monk,mistweaver,78,41,37
Dåßz,illidan,1399,monk,mistweaver,55,24,31
Carlosm,tichondrius,1398,monk,mistweaver,30,19,11
Alfonzó,tichondrius,1398,monk,mistweaver,30,15,15
ßrewslèè,tichondrius,1396,monk,mistweaver,157,84,73
Cthulumonk,lightnings-blade,1395,monk,mistweaver,42,18,24
Zammymonk,area-52,1393,monk,mistweaver,18,15,3
Dedracula,quelthalas,1393,monk,mistweaver,53,37,16
Ojiin,wyrmrest-accord,1393,monk,mistweaver,289,150,139
Troutline,bonechewer,1392,monk,mistweaver,124,72,52
Brewamp,zuljin,1392,monk,mistweaver,53,27,26
Htm,barthilas,1392,monk,mistweaver,41,16,25
Gèrthisha,thunderlord,1391,monk,mistweaver,34,21,13
Rômmul,azralon,1391,monk,mistweaver,66,38,28
Feynzen,frostmourne,1389,monk,mistweaver,31,20,11
Dblfistez,stormreaver,1389,monk,mistweaver,52,23,29
Twirl,mugthol,1389,monk,mistweaver,42,18,24
Hyugga,azralon,1388,monk,mistweaver,71,42,29
Taipanni,sargeras,1388,monk,mistweaver,40,16,24
Gazzoxsan,chogall,1387,monk,mistweaver,80,41,39
Verelaana,moon-guard,1386,monk,mistweaver,41,21,20
Vum,quelthalas,1385,monk,mistweaver,21,16,5
Monktor,dalaran,1385,monk,mistweaver,84,42,42
Bârcõdë,tichondrius,1384,monk,mistweaver,36,23,13
Redweave,moon-guard,1383,monk,mistweaver,36,17,19
Trüa,stormrage,1382,monk,mistweaver,42,27,15
Tayytay,kiljaeden,1382,monk,mistweaver,30,19,11
Flixz,stormrage,1382,monk,mistweaver,48,25,23
Riokhan,ragnaros,1381,monk,mistweaver,54,31,23
Valiantroar,shandris,1381,monk,mistweaver,38,16,22
Hummerkungfu,azralon,1380,monk,mistweaver,79,40,39
Tanskee,sargeras,1378,monk,mistweaver,65,38,27
Akván,ragnaros,1378,monk,mistweaver,85,43,42
Fistful,destromath,1377,monk,mistweaver,30,20,10
Pablojám,ragnaros,1375,monk,mistweaver,42,23,19
Quinoo,emerald-dream,1375,monk,mistweaver,75,33,42
Afabled,drakkari,1373,monk,mistweaver,48,26,22
Ozen,burning-blade,1373,monk,mistweaver,74,38,36
Baroon,chogall,1373,monk,mistweaver,93,40,53
Soothem,tichondrius,1372,monk,mistweaver,181,103,78
Hybrid,draenor,1371,monk,mistweaver,36,21,15
Rhynoo,lothar,1371,monk,mistweaver,96,51,45
Kylièjenner,gilneas,1370,monk,mistweaver,70,39,31
Kaølin,azralon,1369,monk,mistweaver,24,16,8
Thyfist,frostmourne,1369,monk,mistweaver,28,16,12
Xxgonchi,quelthalas,1369,monk,mistweaver,151,82,69
Vonn,drakkari,1368,monk,mistweaver,83,42,41
Caverus,jubeithos,1366,monk,mistweaver,75,45,30
Mintÿ,wyrmrest-accord,1366,monk,mistweaver,48,24,24
Salindrena,thrall,1364,monk,mistweaver,48,30,18
Lanifer,area-52,1364,monk,mistweaver,35,20,15
Tianji,malganis,1363,monk,mistweaver,42,26,16
Tert,aerie-peak,1363,monk,mistweaver,146,83,63
Bibibi,moon-guard,1362,monk,mistweaver,30,15,15
Mistcrab,tichondrius,1361,monk,mistweaver,89,51,38
Pepperoncini,korgath,1361,monk,mistweaver,93,43,50
Nuubchi,stormrage,1360,monk,mistweaver,37,22,15
Sangthos,darkspear,1360,monk,mistweaver,252,113,139
Snuzzao,darkspear,1359,monk,mistweaver,44,22,22
Metapôd,tichondrius,1359,monk,mistweaver,75,37,38
Decha,skywall,1358,monk,mistweaver,24,15,9
Trixië,vashj,1358,monk,mistweaver,29,15,14
Pandalee,skullcrusher,1357,monk,mistweaver,60,37,23
Razod,stormrage,1357,monk,mistweaver,295,157,138
Tobyblack,illidan,1357,monk,mistweaver,123,60,63
Ataxic,illidan,1355,monk,mistweaver,29,15,14
Beätfeet,tichondrius,1353,monk,mistweaver,42,24,18
Kreacher,ravencrest,1353,monk,mistweaver,107,61,46
Sodosopaw,area-52,1352,monk,mistweaver,88,43,45
Rylens,draka,1349,monk,mistweaver,58,34,24
Pandemikmonk,turalyon,1349,monk,mistweaver,48,22,26
Monkol,nemesis,1348,monk,mistweaver,36,20,16
Lõgan,azralon,1348,monk,mistweaver,64,32,32
Nîxs,frostmourne,1348,monk,mistweaver,36,15,21
Harryrichard,sargeras,1346,monk,mistweaver,35,19,16
Crankxx,malganis,1345,monk,mistweaver,27,16,11
Compacier,illidan,1345,monk,mistweaver,61,34,27
Hensing,malganis,1344,monk,mistweaver,24,14,10
Rollypunch,illidan,1344,monk,mistweaver,66,38,28
Itsnoozes,illidan,1343,monk,mistweaver,18,14,4
Hydrig,ragnaros,1343,monk,mistweaver,18,14,4
Onegai,tichondrius,1343,monk,mistweaver,18,14,4
Siserfister,sargeras,1343,monk,mistweaver,24,14,10
Akumeidakai,stormrage,1342,monk,mistweaver,42,26,16
Cnww,tichondrius,1342,monk,mistweaver,24,14,10
Clyteai,arthas,1342,monk,mistweaver,53,26,27
Vulbeast,dalaran,1341,monk,mistweaver,18,14,4
Lustymonk,kelthuzad,1341,monk,mistweaver,18,14,4
Jonnymon,sargeras,1341,monk,mistweaver,18,14,4
Cilantrõ,malorne,1341,monk,mistweaver,30,21,9
Haren,gundrak,1341,monk,mistweaver,24,14,10
Titti,korgath,1341,monk,mistweaver,24,14,10
Keeanuweaves,tichondrius,1340,monk,mistweaver,19,15,4
Evyllyn,bleeding-hollow,1340,monk,mistweaver,18,14,4
Eqoy,moon-guard,1340,monk,mistweaver,42,20,22
Anthuri,frostmourne,1339,monk,mistweaver,95,62,33
Allegedheals,tichondrius,1339,monk,mistweaver,60,26,34
Pisswalker,area-52,1338,monk,mistweaver,18,14,4
Catmonk,the-forgotten-coast,1338,monk,mistweaver,24,14,10
Kungfuchious,dalaran,1338,monk,mistweaver,31,18,13
Inkar,tichondrius,1338,monk,mistweaver,36,14,22
Jutsu,moon-guard,1337,monk,mistweaver,24,14,10
Ðamntaiyo,sargeras,1336,monk,mistweaver,35,19,16
Ryantiger,tichondrius,1336,monk,mistweaver,30,14,16
Stendari,moon-guard,1336,monk,mistweaver,42,17,25
Karynia,illidan,1335,monk,mistweaver,110,56,54
Hedgefrogs,stormrage,1335,monk,mistweaver,30,14,16
Iielia,wyrmrest-accord,1335,monk,mistweaver,35,16,19
Mystafista,tichondrius,1335,monk,mistweaver,38,17,21
Streetjezus,bloodhoof,1335,monk,mistweaver,64,28,36
Moltenbeard,trollbane,1334,monk,mistweaver,93,55,38
Mopowa,illidan,1333,monk,mistweaver,24,14,10
Chañi,ragnaros,1333,monk,mistweaver,59,33,26
Tamagotchi,emerald-dream,1332,monk,mistweaver,30,16,14
Naxanax,area-52,1332,monk,mistweaver,66,33,33
Jellobag,frostmane,1331,monk,mistweaver,24,14,10
Iloki,shuhalo,1331,monk,mistweaver,87,45,42
Keyszz,tichondrius,1330,monk,mistweaver,224,103,121
React,frostwolf,1329,monk,mistweaver,24,14,10
Omegasix,nazjatar,1327,monk,mistweaver,30,18,12
Momochi,malygos,1327,monk,mistweaver,32,18,14
Neww,tichondrius,1325,monk,mistweaver,58,25,33
Monkqi,lightbringer,1324,monk,mistweaver,36,25,11
Tenzing,azgalor,1324,monk,mistweaver,24,14,10
Metalmønk,nerzhul,1323,monk,mistweaver,55,33,22
Khamze,ragnaros,1323,monk,mistweaver,24,14,10
Daddyrugburn,area-52,1323,monk,mistweaver,89,44,45
Turkspin,smolderthorn,1322,monk,mistweaver,33,24,9
Precóggodx,tichondrius,1322,monk,mistweaver,24,14,10
Nerfmonk,spirestone,1322,monk,mistweaver,24,14,10
Bauindar,illidan,1322,monk,mistweaver,30,14,16
Evilbit,boulderfist,1321,monk,mistweaver,24,14,10
Chaotics,bleeding-hollow,1321,monk,mistweaver,98,57,41
Jeffdagnome,moon-guard,1320,monk,mistweaver,96,48,48
Zeevaliara,caelestrasz,1320,monk,mistweaver,30,15,15
Daslow,quelthalas,1319,monk,mistweaver,77,34,43
Psykhed,emerald-dream,1319,monk,mistweaver,78,33,45
Gerranni,wyrmrest-accord,1318,monk,mistweaver,24,16,8
Nazvik,quelthalas,1318,monk,mistweaver,24,14,10
Lizavet,stormrage,1316,monk,mistweaver,70,51,19
Shon,frostmourne,1316,monk,mistweaver,24,14,10
Albusventos,azralon,1315,monk,mistweaver,35,21,14
Lovechabill,darkspear,1315,monk,mistweaver,60,32,28
Smackdat,azjolnerub,1315,monk,mistweaver,58,29,29
Kungfumika,ragnaros,1314,monk,mistweaver,48,23,25
Johnkreese,andorhal,1313,monk,mistweaver,30,14,16
Harmoñize,moon-guard,1311,monk,mistweaver,30,14,16
Breezymist,doomhammer,1311,monk,mistweaver,30,14,16
Dashenna,illidan,1310,monk,mistweaver,84,32,52
Bonquavius,thrall,1309,monk,mistweaver,26,16,10
Trapeez,kelthuzad,1308,monk,mistweaver,24,16,8
Asliam,undermine,1308,monk,mistweaver,36,23,13
Tàekwondo,drakkari,1308,monk,mistweaver,30,15,15
Odogin,tichondrius,1307,monk,mistweaver,65,41,24
Chainwax,korgath,1306,monk,mistweaver,68,35,33
Sweatweaver,frostmourne,1306,monk,mistweaver,94,43,51
Mango,spirestone,1305,monk,mistweaver,42,24,18
Hafu,wildhammer,1305,monk,mistweaver,54,29,25
Shizunô,stormrage,1305,monk,mistweaver,36,17,19
Honorviejos,illidan,1304,monk,mistweaver,40,23,17
Fânnybâws,stormrage,1302,monk,mistweaver,36,18,18
Hirahxx,frostmourne,1301,monk,mistweaver,27,16,11
Melrose,kiljaeden,1301,monk,mistweaver,24,14,10
Bluemyselph,tichondrius,1300,monk,mistweaver,40,21,19
Endér,tichondrius,1300,monk,mistweaver,160,82,78
Kickbone,tichondrius,1300,monk,mistweaver,60,30,30
Raidenmnx,tichondrius,1300,monk,mistweaver,96,47,49
Twinktoez,bleeding-hollow,1299,monk,mistweaver,26,15,11
Szuka,tichondrius,1297,monk,mistweaver,36,20,16
Kung,tichondrius,1297,monk,mistweaver,30,14,16
Onlyhands,whisperwind,1296,monk,mistweaver,53,28,25
Lawroadp,tichondrius,1295,monk,mistweaver,57,33,24
Rapope,quelthalas,1294,monk,mistweaver,65,32,33
Gguldduk,tichondrius,1292,monk,mistweaver,40,26,14
Ymiron,smolderthorn,1292,monk,mistweaver,42,15,27
Freeoni,sargeras,1291,monk,mistweaver,25,16,9
Mcdubbles,korgath,1291,monk,mistweaver,75,37,38
Monkisses,bonechewer,1290,monk,mistweaver,65,36,29
Giatzo,barthilas,1290,monk,mistweaver,85,41,44
Speedymonk,malfurion,1289,monk,mistweaver,60,25,35
Theweekend,tichondrius,1289,monk,mistweaver,54,21,33
Zarakna,sargeras,1288,monk,mistweaver,210,112,98
Moonkers,tichondrius,1287,monk,mistweaver,30,15,15
Perzevel,azshara,1286,monk,mistweaver,30,19,11
Gallorex,frostmourne,1286,monk,mistweaver,42,24,18
Ninjatoots,aerie-peak,1285,monk,mistweaver,97,52,45
Polofasho,illidan,1284,monk,mistweaver,41,24,17
Onekickman,dalaran,1283,monk,mistweaver,72,41,31
Safiel,proudmoore,1283,monk,mistweaver,121,52,69
Healyboi,bronzebeard,1283,monk,mistweaver,52,22,30
Boozebear,spirestone,1282,monk,mistweaver,136,68,68
Kìmjungheal,tichondrius,1281,monk,mistweaver,41,21,20
Chnzhs,tichondrius,1281,monk,mistweaver,58,18,40
Zeiana,proudmoore,1280,monk,mistweaver,38,22,16
Holdmychi,stormrage,1279,monk,mistweaver,55,29,26
Selfhealings,korgath,1279,monk,mistweaver,77,34,43
Siddlez,frostmourne,1278,monk,mistweaver,53,36,17
Byakugan,moon-guard,1277,monk,mistweaver,41,23,18
Börg,bleeding-hollow,1277,monk,mistweaver,38,19,19
Fludz,burning-blade,1276,monk,mistweaver,66,28,38
Mortimir,echo-isles,1274,monk,mistweaver,65,33,32
Touzin,bleeding-hollow,1274,monk,mistweaver,40,20,20
Kiso,sargeras,1274,monk,mistweaver,29,14,15
Tigraxus,proudmoore,1274,monk,mistweaver,43,19,24
Monkeynut,whisperwind,1273,monk,mistweaver,143,74,69
Evilstep,tichondrius,1272,monk,mistweaver,131,68,63
Zxychi,hyjal,1271,monk,mistweaver,23,14,9
Galiplays,zangarmarsh,1271,monk,mistweaver,35,19,16
Rustedbarrel,azjolnerub,1271,monk,mistweaver,46,23,23
Ratioed,moon-guard,1270,monk,mistweaver,65,45,20
Afw,moon-guard,1270,monk,mistweaver,50,28,22
Miretunie,arathor,1269,monk,mistweaver,116,66,50
Puffpuffp,nazgrel,1268,monk,mistweaver,36,20,16
Orbí,tichondrius,1267,monk,mistweaver,84,56,28
Makimä,stormrage,1267,monk,mistweaver,80,41,39
Zenmasta,exodar,1267,monk,mistweaver,48,23,25
Fìst,hyjal,1266,monk,mistweaver,24,14,10
Tinze,bonechewer,1265,monk,mistweaver,69,36,33
Darrhon,illidan,1262,monk,mistweaver,131,69,62
Honjada,tichondrius,1261,monk,mistweaver,24,15,9
Dragonwarior,zuluhed,1261,monk,mistweaver,26,15,11
Hellcow,frostmourne,1261,monk,mistweaver,48,22,26
Valapan,tichondrius,1260,monk,mistweaver,98,50,48
Zenquadz,elune,1259,monk,mistweaver,36,25,11
Wmo,tichondrius,1258,monk,mistweaver,23,15,8
Teil,illidan,1257,monk,mistweaver,48,25,23
Bullët,tichondrius,1257,monk,mistweaver,114,59,55
Pépto,bleeding-hollow,1257,monk,mistweaver,70,35,35
Monkêy,ghostlands,1256,monk,mistweaver,84,40,44
Dirtyshef,deathwing,1256,monk,mistweaver,99,45,54
Hongmeï,illidan,1254,monk,mistweaver,48,25,23
Liamaz,amanthul,1254,monk,mistweaver,30,14,16
Enfoque,quelthalas,1253,monk,mistweaver,89,50,39
Hungrydevil,tichondrius,1253,monk,mistweaver,30,15,15
Sayd,misha,1251,monk,mistweaver,24,15,9
Lelomonk,ragnaros,1251,monk,mistweaver,103,53,50
Darkheälzz,sargeras,1251,monk,mistweaver,122,60,62
Omimonk,sargeras,1251,monk,mistweaver,56,24,32
Donnieyen,aerie-peak,1250,monk,mistweaver,19,14,5
Maiitoguy,illidan,1250,monk,mistweaver,48,24,24
Zsalcior,jaedenar,1249,monk,mistweaver,81,49,32
Drizzywow,arathor,1248,monk,mistweaver,18,13,5
Sjw,icecrown,1248,monk,mistweaver,20,13,7
Shefcurry,boulderfist,1248,monk,mistweaver,24,13,11
Mwomegalul,sargeras,1248,monk,mistweaver,30,13,17
Haruko,baelgun,1248,monk,mistweaver,64,24,40
Annisokay,bleeding-hollow,1247,monk,mistweaver,18,13,5
Beefyteet,tichondrius,1247,monk,mistweaver,18,13,5
Ticmonk,frostmourne,1247,monk,mistweaver,18,13,5
Gothamonk,tichondrius,1247,monk,mistweaver,24,13,11
Spirits,dreadmaul,1247,monk,mistweaver,24,13,11
Demisodax,tichondrius,1247,monk,mistweaver,24,13,11
Steadfastsr,black-dragonflight,1246,monk,mistweaver,18,13,5
Shinarri,thrall,1246,monk,mistweaver,141,77,64
Fheng,emerald-dream,1246,monk,mistweaver,24,13,11
Gottí,sargeras,1246,monk,mistweaver,24,13,11
Puya,nemesis,1246,monk,mistweaver,42,21,21
Cowsgonuts,gorefiend,1246,monk,mistweaver,30,13,17
Hîddëncløùdx,tichondrius,1245,monk,mistweaver,18,13,5
Nawzhy,emerald-dream,1245,monk,mistweaver,24,13,11
Drunkgiraffe,zuljin,1244,monk,mistweaver,18,13,5
Ironfistorm,stormrage,1244,monk,mistweaver,36,24,12
Monktyson,barthilas,1244,monk,mistweaver,72,44,28
Shilakamesn,tichondrius,1244,monk,mistweaver,24,13,11
Beefdadyfist,tichondrius,1244,monk,mistweaver,48,22,26
Xiaoemo,tichondrius,1243,monk,mistweaver,24,16,8
Dangerkage,stormrage,1243,monk,mistweaver,87,35,52
Ammonk,bloodhoof,1242,monk,mistweaver,18,13,5
Psypalm,zuljin,1242,monk,mistweaver,18,13,5
Brochadchó,stormrage,1242,monk,mistweaver,30,13,17
Imafqnbaby,tichondrius,1242,monk,mistweaver,30,13,17
Rehder,barthilas,1241,monk,mistweaver,24,13,11
Poppyharlow,saurfang,1240,monk,mistweaver,24,17,7
Miyung,quelthalas,1240,monk,mistweaver,30,13,17
Meldrop,tichondrius,1240,monk,mistweaver,30,13,17
Növa,alterac-mountains,1239,monk,mistweaver,18,13,5
Mïstyfïsty,moon-guard,1239,monk,mistweaver,18,13,5
Elmozosz,thrall,1239,monk,mistweaver,24,13,11
Noogiie,barthilas,1238,monk,mistweaver,22,14,8
Kungupanda,nesingwary,1238,monk,mistweaver,35,15,20
Madkickzack,blades-edge,1237,monk,mistweaver,30,13,17
Oyyo,tichondrius,1237,monk,mistweaver,95,35,60
Safigirl,doomhammer,1236,monk,mistweaver,73,42,31
Mirokushan,skywall,1236,monk,mistweaver,138,75,63
Xuxin,medivh,1234,monk,mistweaver,18,13,5
Lolkungfu,spirestone,1234,monk,mistweaver,24,13,11
Notastreamer,frostmourne,1234,monk,mistweaver,24,13,11
Madnox,sargeras,1234,monk,mistweaver,36,19,17
Kodrik,tichondrius,1234,monk,mistweaver,84,44,40
Marimonkori,stormscale,1234,monk,mistweaver,111,55,56
Vchii,tichondrius,1234,monk,mistweaver,30,13,17
Deftones,tichondrius,1234,monk,mistweaver,30,13,17
Midfrie,ghostlands,1233,monk,mistweaver,24,15,9
Knaveus,frostmourne,1233,monk,mistweaver,54,30,24
Critôris,tichondrius,1233,monk,mistweaver,24,13,11
Troutz,sargeras,1233,monk,mistweaver,30,15,15
Lothnälar,ragnaros,1231,monk,mistweaver,36,26,10
Azizyzz,barthilas,1231,monk,mistweaver,42,20,22
Dumplinz,tichondrius,1230,monk,mistweaver,17,14,3
Wraithfire,uldum,1228,monk,mistweaver,54,28,26
Zignzag,stormscale,1228,monk,mistweaver,48,18,30
Zefta,moon-guard,1227,monk,mistweaver,54,24,30
Fkedyourwife,dalaran,1227,monk,mistweaver,30,13,17
Gôrr,tichondrius,1226,monk,mistweaver,42,23,19
Tankozorr,zuljin,1225,monk,mistweaver,78,34,44
Cosetteb,proudmoore,1224,monk,mistweaver,54,28,26
Petsëmatary,bleeding-hollow,1224,monk,mistweaver,41,16,25
Taichichuan,tichondrius,1222,monk,mistweaver,77,40,37
Cheesemónk,tichondrius,1222,monk,mistweaver,30,13,17
Habuba,eredar,1221,monk,mistweaver,18,13,5
Binghe,illidan,1221,monk,mistweaver,63,35,28
Monxellius,moon-guard,1221,monk,mistweaver,111,54,57
Ninjahogan,azgalor,1221,monk,mistweaver,32,15,17
Hps,thrall,1220,monk,mistweaver,29,15,14
Cammy,aerie-peak,1219,monk,mistweaver,32,20,12
Pixelface,barthilas,1218,monk,mistweaver,18,13,5
Monkgins,area-52,1218,monk,mistweaver,24,13,11
Hashìba,kiljaeden,1217,monk,mistweaver,18,13,5
Blorkk,area-52,1217,monk,mistweaver,24,16,8
Twïst,tichondrius,1216,monk,mistweaver,24,13,11
Udmonk,tichondrius,1215,monk,mistweaver,28,16,12
Treysongz,illidan,1215,monk,mistweaver,29,13,16
Modelman,area-52,1212,monk,mistweaver,50,26,24
Ludafist,whisperwind,1212,monk,mistweaver,72,37,35
Orthôdox,tichondrius,1212,monk,mistweaver,38,15,23
Aeress,kelthuzad,1208,monk,mistweaver,30,13,17
Stephani,turalyon,1207,monk,mistweaver,43,22,21
Biggoosie,korgath,1206,monk,mistweaver,76,47,29
Drexlla,barthilas,1206,monk,mistweaver,44,27,17
Ciru,zangarmarsh,1206,monk,mistweaver,84,43,41
Chunkynorris,stormscale,1206,monk,mistweaver,38,18,20
Dower,archimonde,1205,monk,mistweaver,22,14,8
Raptortaco,thrall,1205,monk,mistweaver,38,17,21
Foomanshoes,shandris,1204,monk,mistweaver,52,14,38
Miçrosoft,area-52,1203,monk,mistweaver,127,68,59
Dokfu,tichondrius,1201,monk,mistweaver,207,113,94
Ieatshrooms,malfurion,1201,monk,mistweaver,66,26,40
Elcidw,tichondrius,1200,monk,mistweaver,21,14,7
Kushmintz,whisperwind,1199,monk,mistweaver,24,13,11
Michaeljordn,destromath,1199,monk,mistweaver,44,16,28
Çlaç,illidan,1198,monk,mistweaver,26,14,12
Menadraene,wyrmrest-accord,1198,monk,mistweaver,26,14,12
Dasubb,crushridge,1196,monk,mistweaver,23,13,10
Pompoe,kelthuzad,1192,monk,mistweaver,57,24,33
Titofresh,quelthalas,1191,monk,mistweaver,33,15,18
Raphzen,stormrage,1189,monk,mistweaver,33,17,16
Noctes,thunderlord,1188,monk,mistweaver,48,28,20
Soapy,moon-guard,1188,monk,mistweaver,35,16,19
Littlegeorge,moon-guard,1187,monk,mistweaver,36,24,12
Smokee,blackhand,1187,monk,mistweaver,30,15,15
Tusil,tichondrius,1187,monk,mistweaver,36,13,23
Kayzen,barthilas,1186,monk,mistweaver,48,27,21
Kafuru,quelthalas,1185,monk,mistweaver,28,16,12
Soderbergh,ysera,1185,monk,mistweaver,36,13,23
Illushadio,moon-guard,1184,monk,mistweaver,24,13,11
Teddybéar,illidan,1183,monk,mistweaver,20,13,7
Valdosta,bloodscalp,1183,monk,mistweaver,54,29,25
Reinah,malganis,1183,monk,mistweaver,48,18,30
Joeyfists,frostwolf,1181,monk,mistweaver,38,19,19
Xstepfister,tichondrius,1180,monk,mistweaver,76,34,42
Blackthorne,illidan,1179,monk,mistweaver,30,14,16
Kreezoo,tichondrius,1178,monk,mistweaver,51,24,27
Kromkwando,burning-blade,1177,monk,mistweaver,42,13,29
Iseeyouqt,tichondrius,1176,monk,mistweaver,20,13,7
Monkoala,illidan,1176,monk,mistweaver,42,21,21
Touchkarma,stormrage,1175,monk,mistweaver,90,45,45
Mongénoio,nemesis,1172,monk,mistweaver,26,13,13
Likkleyute,akama,1172,monk,mistweaver,35,16,19
Purging,draka,1171,monk,mistweaver,98,68,30
Yinlong,illidan,1171,monk,mistweaver,22,13,9
Orenj,boulderfist,1171,monk,mistweaver,48,24,24
Hamandchi,sargeras,1169,monk,mistweaver,23,16,7
Gobfu,emerald-dream,1169,monk,mistweaver,95,42,53
Evílryü,quelthalas,1168,monk,mistweaver,27,16,11
Lumïnous,moon-guard,1167,monk,mistweaver,36,17,19
Hie,laughing-skull,1166,monk,mistweaver,90,38,52
Kungfutofu,sentinels,1165,monk,mistweaver,21,14,7
Shwankeesha,thrall,1165,monk,mistweaver,28,14,14
Miraculer,drakkari,1163,monk,mistweaver,28,14,14
Sedition,emerald-dream,1163,monk,mistweaver,335,166,169
Chèmosh,fenris,1162,monk,mistweaver,29,13,16
Kexti,wyrmrest-accord,1159,monk,mistweaver,57,25,32
Madmint,illidan,1159,monk,mistweaver,60,26,34
Stevejabz,malganis,1156,monk,mistweaver,30,13,17
Callibella,amanthul,1155,monk,mistweaver,26,13,13
Monknificent,medivh,1155,monk,mistweaver,78,31,47
Hammonk,deathwing,1154,monk,mistweaver,36,20,16
Envymonk,tichondrius,1152,monk,mistweaver,18,12,6
Magmuruk,garrosh,1152,monk,mistweaver,18,12,6
Qimeng,sargeras,1152,monk,mistweaver,30,12,18
Tubescreamer,barthilas,1151,monk,mistweaver,18,12,6
Karaka,ysera,1151,monk,mistweaver,22,14,8
Jighte,illidan,1151,monk,mistweaver,48,26,22
Billycobham,tichondrius,1151,monk,mistweaver,24,12,12
Danceschi,area-52,1151,monk,mistweaver,24,12,12
Affrika,ragnaros,1151,monk,mistweaver,53,25,28
Møzy,darkspear,1150,monk,mistweaver,18,12,6
Pissweever,barthilas,1150,monk,mistweaver,18,12,6
Ragepalm,aegwynn,1150,monk,mistweaver,42,22,20
Habaneroz,wyrmrest-accord,1150,monk,mistweaver,24,12,12
Monkybizniss,skywall,1150,monk,mistweaver,24,12,12
Shaweaver,caelestrasz,1150,monk,mistweaver,24,12,12
Marnartou,zuljin,1149,monk,mistweaver,55,35,20
Dreamfist,emerald-dream,1149,monk,mistweaver,24,12,12
Lushona,ragnaros,1148,monk,mistweaver,48,35,13
Strixx,silvermoon,1148,monk,mistweaver,30,21,9
Onlythumbs,area-52,1148,monk,mistweaver,18,12,6
Fwisty,illidan,1148,monk,mistweaver,18,12,6
Zallie,frostmourne,1147,monk,mistweaver,18,12,6
Doicare,tichondrius,1147,monk,mistweaver,58,35,23
Monkgodx,tichondrius,1147,monk,mistweaver,24,12,12
Yuumeì,senjin,1147,monk,mistweaver,24,12,12
Smashgordon,burning-legion,1147,monk,mistweaver,30,12,18
Dewtime,area-52,1146,monk,mistweaver,18,12,6
Rizchi,tichondrius,1146,monk,mistweaver,18,12,6
Bopmykarma,kelthuzad,1146,monk,mistweaver,25,12,13
Kaniou,proudmoore,1146,monk,mistweaver,29,13,16
Azenia,barthilas,1146,monk,mistweaver,30,12,18
Jagichan,area-52,1145,monk,mistweaver,18,12,6
Kelpri,sentinels,1145,monk,mistweaver,18,12,6
Monkaveli,ursin,1145,monk,mistweaver,78,37,41
Monkgov,illidan,1144,monk,mistweaver,24,12,12
Biggddaddy,thaurissan,1143,monk,mistweaver,30,18,12
Oldfashheals,tichondrius,1142,monk,mistweaver,30,12,18
Onemonkk,tichondrius,1141,monk,mistweaver,132,72,60
Uwufistgodx,tichondrius,1141,monk,mistweaver,30,12,18
Chilliweaver,frostmourne,1141,monk,mistweaver,36,12,24
Bamboozile,arthas,1139,monk,mistweaver,24,12,12
Frothy,bleeding-hollow,1139,monk,mistweaver,24,12,12
Dreadknotz,hyjal,1139,monk,mistweaver,51,25,26
Calmemaybe,darkspear,1138,monk,mistweaver,18,12,6
Tetsuo,altar-of-storms,1137,monk,mistweaver,18,12,6
Çuß,kelthuzad,1137,monk,mistweaver,30,12,18
Chitacos,trollbane,1136,monk,mistweaver,34,14,20
Darksoult,kelthuzad,1136,monk,mistweaver,72,23,49
Tzidkiyahu,barthilas,1135,monk,mistweaver,23,14,9
Maqaveli,sargeras,1135,monk,mistweaver,36,18,18
Paraíba,azralon,1135,monk,mistweaver,35,12,23
Wangba,tichondrius,1132,monk,mistweaver,24,12,12
Herbivorous,sargeras,1131,monk,mistweaver,24,12,12
Skonk,shattered-hand,1129,monk,mistweaver,18,12,6
Chicheez,sargeras,1129,monk,mistweaver,22,13,9
Xulieng,tichondrius,1128,monk,mistweaver,380,195,185
Kongpoo,kelthuzad,1127,monk,mistweaver,21,14,7
Atiantian,proudmoore,1127,monk,mistweaver,36,12,24
Fitmonje,drakkari,1126,monk,mistweaver,43,22,21
Boostmonk,terenas,1126,monk,mistweaver,78,34,44
Fistmeister,tichondrius,1125,monk,mistweaver,30,19,11
Crãsh,quelthalas,1125,monk,mistweaver,28,15,13
Hapgido,deathwing,1125,monk,mistweaver,68,36,32
Ninjagordu,nemesis,1125,monk,mistweaver,213,95,118
Rxtea,darkspear,1124,monk,mistweaver,25,13,12
Bháv,tichondrius,1124,monk,mistweaver,24,12,12
Rabico,azralon,1122,monk,mistweaver,30,17,13
Tübes,trollbane,1122,monk,mistweaver,24,12,12
Ursorcen,frostmourne,1122,monk,mistweaver,33,16,17
Tsyatvo,illidan,1119,monk,mistweaver,24,14,10
Rosinhood,illidan,1119,monk,mistweaver,98,51,47
Fluffykitty,deathwing,1119,monk,mistweaver,45,19,26
Whiteknight,tichondrius,1118,monk,mistweaver,14,13,1
Tjitsu,zuljin,1115,monk,mistweaver,74,32,42
Sukrit,darkspear,1111,monk,mistweaver,52,24,28
Halfaling,tichondrius,1109,monk,mistweaver,18,12,6
Shaolyyn,zuljin,1107,monk,mistweaver,156,82,74
Lolcutie,shandris,1105,monk,mistweaver,37,21,16
Huëyfreeman,stormrage,1103,monk,mistweaver,131,59,72
Rowbur,thrall,1101,monk,mistweaver,57,36,21
Hastle,windrunner,1101,monk,mistweaver,90,48,42
Antimoine,saurfang,1100,monk,mistweaver,72,38,34
Smungus,bloodscalp,1097,monk,mistweaver,26,13,13
Emenboats,zuljin,1096,monk,mistweaver,70,44,26
Kimonk,proudmoore,1095,monk,mistweaver,36,21,15
Cornfist,zuljin,1093,monk,mistweaver,42,21,21
Gentle,cenarius,1093,monk,mistweaver,26,12,14
Shoguns,zuljin,1091,monk,mistweaver,48,24,24
Zendemic,thrall,1087,monk,mistweaver,60,36,24
Coachputmein,barthilas,1086,monk,mistweaver,17,12,5
Skydouken,sargeras,1086,monk,mistweaver,22,12,10
Chopy,dragonblight,1086,monk,mistweaver,90,45,45
Focalors,proudmoore,1085,monk,mistweaver,20,12,8
Taintickler,stormrage,1084,monk,mistweaver,54,28,26
Vencö,tichondrius,1083,monk,mistweaver,45,12,33
Knucklez,frostwolf,1078,monk,mistweaver,90,49,41
Pwned,ghostlands,1078,monk,mistweaver,63,21,42
Ügway,azralon,1076,monk,mistweaver,48,15,33
Lzt,ragnaros,1075,monk,mistweaver,34,13,21
Nardugo,windrunner,1073,monk,mistweaver,64,27,37
Lita,barthilas,1071,monk,mistweaver,17,12,5
Shmello,akama,1071,monk,mistweaver,42,26,16
Ishtári,tichondrius,1068,monk,mistweaver,25,13,12
Hakushin,ragnaros,1067,monk,mistweaver,36,20,16
Jackburton,deathwing,1066,monk,mistweaver,18,13,5
Shanalot,stormrage,1063,monk,mistweaver,19,12,7
Drzoid,thrall,1062,monk,mistweaver,60,28,32
Hache,azjolnerub,1062,monk,mistweaver,86,37,49
Chugs,malorne,1062,monk,mistweaver,57,16,41
Aokuang,malganis,1061,monk,mistweaver,51,15,36
Jmanownz,stormrage,1056,monk,mistweaver,12,11,1
Duelist,the-scryers,1056,monk,mistweaver,12,11,1
Giggacuck,frostmourne,1056,monk,mistweaver,18,11,7
Mxxb,illidan,1056,monk,mistweaver,18,11,7
Yangzai,tichondrius,1056,monk,mistweaver,18,11,7
Saitamâ,tichondrius,1056,monk,mistweaver,18,11,7
Mistussy,sargeras,1056,monk,mistweaver,18,11,7
Solidww,moon-guard,1055,monk,mistweaver,12,11,1
Stephenia,tichondrius,1055,monk,mistweaver,18,11,7
Iplus,thrall,1055,monk,mistweaver,18,11,7
Undertickle,illidan,1055,monk,mistweaver,18,11,7
Otzyy,turalyon,1055,monk,mistweaver,18,11,7
Yoshimiitsu,bleeding-hollow,1055,monk,mistweaver,18,11,7
Ninjachavez,tichondrius,1055,monk,mistweaver,18,11,7
Axibar,tichondrius,1055,monk,mistweaver,18,11,7
Alandis,spinebreaker,1055,monk,mistweaver,18,11,7
Ryanx,azjolnerub,1055,monk,mistweaver,18,11,7
Fkinbis,area-52,1055,monk,mistweaver,18,11,7
Dowzk,tichondrius,1055,monk,mistweaver,24,11,13
Chillionaíre,proudmoore,1055,monk,mistweaver,24,11,13
Lemmetouch,illidan,1055,monk,mistweaver,24,11,13
Faccemelter,illidan,1055,monk,mistweaver,24,11,13
Raonoc,area-52,1055,monk,mistweaver,30,11,19
Brotherdad,moon-guard,1054,monk,mistweaver,18,11,7
Brühtus,tichondrius,1054,monk,mistweaver,18,11,7
Phazorr,frostmourne,1054,monk,mistweaver,18,11,7
Børraicho,ragnaros,1054,monk,mistweaver,18,11,7
Punchopuncho,malganis,1054,monk,mistweaver,24,11,13
Shogundachi,moon-guard,1053,monk,mistweaver,21,13,8
Brokenfeels,azralon,1053,monk,mistweaver,18,11,7
Ñightingale,queldorei,1053,monk,mistweaver,18,11,7
Zoochans,tichondrius,1053,monk,mistweaver,67,40,27
Walmartguard,arthas,1053,monk,mistweaver,40,20,20
Kamiyah,tichondrius,1053,monk,mistweaver,24,11,13
Arahabaki,wyrmrest-accord,1053,monk,mistweaver,24,11,13
Topanga,azralon,1053,monk,mistweaver,42,12,30
Theymistbuda,kelthuzad,1052,monk,mistweaver,12,11,1
Djslimweaver,stormrage,1052,monk,mistweaver,14,11,3
Wungpo,the-forgotten-coast,1052,monk,mistweaver,18,11,7
Creamchop,stormreaver,1052,monk,mistweaver,18,11,7
Karnbroo,frostmourne,1052,monk,mistweaver,24,11,13
Theminivan,sargeras,1052,monk,mistweaver,24,11,13
Kallous,illidan,1051,monk,mistweaver,18,11,7
Psyx,frostmourne,1051,monk,mistweaver,18,11,7
Rolybones,boulderfist,1051,monk,mistweaver,19,11,8
Steenkk,tichondrius,1051,monk,mistweaver,60,29,31
Superbae,area-52,1051,monk,mistweaver,24,11,13
Buymymixtape,ursin,1051,monk,mistweaver,24,11,13
Fiztingfaded,area-52,1051,monk,mistweaver,36,16,20
Dégg,thrall,1050,monk,mistweaver,18,11,7
Eldrik,stormrage,1050,monk,mistweaver,18,11,7
Jimmythemist,mugthol,1050,monk,mistweaver,18,11,7
Sevenpunch,area-52,1050,monk,mistweaver,30,11,19
Dellunnax,azralon,1049,monk,mistweaver,18,11,7
Pichiquechi,frostmourne,1049,monk,mistweaver,24,11,13
Rektfu,emerald-dream,1048,monk,mistweaver,39,18,21
Lochekx,stonemaul,1048,monk,mistweaver,48,17,31
Monky,black-dragonflight,1047,monk,mistweaver,18,11,7
Ilani,malganis,1047,monk,mistweaver,18,11,7
Lepasfin,sargeras,1047,monk,mistweaver,42,23,19
Hinudhera,barthilas,1046,monk,mistweaver,125,61,64
Shaolinmists,malganis,1045,monk,mistweaver,12,11,1
Catchdismist,tichondrius,1043,monk,mistweaver,18,11,7
Xbrewtal,tichondrius,1043,monk,mistweaver,128,71,57
Philthyjutsu,moon-guard,1042,monk,mistweaver,12,11,1
Tubbytiph,ghostlands,1041,monk,mistweaver,121,47,74
Divaweaver,sargeras,1040,monk,mistweaver,30,11,19
Dragonmonk,grizzly-hills,1040,monk,mistweaver,36,11,25
Dustyweaver,illidan,1039,monk,mistweaver,55,22,33
Patman,nazjatar,1038,monk,mistweaver,18,12,6
Teancrumpets,wyrmrest-accord,1038,monk,mistweaver,48,20,28
Leësin,ragnaros,1037,monk,mistweaver,18,11,7
Hirav,khazgoroth,1036,monk,mistweaver,27,13,14
Springsummer,tichondrius,1034,monk,mistweaver,29,11,18
Tadaku,dalaran,1033,monk,mistweaver,37,17,20
Medge,kelthuzad,1033,monk,mistweaver,24,11,13
Poem,grizzly-hills,1032,monk,mistweaver,21,12,9
Mahhnaga,tichondrius,1032,monk,mistweaver,101,42,59
Merand,tichondrius,1031,monk,mistweaver,36,20,16
Baiji,gorefiend,1030,monk,mistweaver,12,11,1
Esotericzeo,mugthol,1030,monk,mistweaver,72,35,37
Ahshurra,blackhand,1029,monk,mistweaver,41,14,27
Joxo,nordrassil,1028,monk,mistweaver,18,13,5
Ambuinc,burning-blade,1024,monk,mistweaver,18,11,7
Dalillamas,sargeras,1023,monk,mistweaver,14,12,2
Koyon,sargeras,1023,monk,mistweaver,17,11,6
Schein,sargeras,1023,monk,mistweaver,17,11,6
Venomqt,laughing-skull,1021,monk,mistweaver,17,11,6
Xes,andorhal,1021,monk,mistweaver,79,43,36
Ghostmk,nagrand,1021,monk,mistweaver,30,12,18
Grizzchan,sargeras,1017,monk,mistweaver,17,11,6
Ainz,nagrand,1016,monk,mistweaver,30,15,15
Sivedrafely,arthas,1014,monk,mistweaver,47,15,32
Mistabrew,frostmourne,1008,monk,mistweaver,36,14,22
Vitcheztein,ragnaros,1007,monk,mistweaver,17,11,6
Twizzurp,magtheridon,1007,monk,mistweaver,21,12,9
Cbrewx,tichondrius,1007,monk,mistweaver,23,11,12
Bigjuicers,bleeding-hollow,1006,monk,mistweaver,17,11,6
Domisalamii,sargeras,1006,monk,mistweaver,23,11,12
Supmybrew,frostmourne,1005,monk,mistweaver,23,11,12
Melocotonn,goldrinn,1004,monk,mistweaver,30,13,17
Kpeste,tichondrius,1002,monk,mistweaver,78,41,37
Yookho,tichondrius,1000,monk,mistweaver,17,12,5
Matchuh,stormrage,1000,monk,mistweaver,55,24,31
Clutchinmist,malganis,1000,monk,mistweaver,40,12,28
Bearchi,sargeras,997,monk,mistweaver,21,12,9
Telrande,ysondre,994,monk,mistweaver,37,25,12
Gòss,azgalor,993,monk,mistweaver,61,25,36
Tisafister,kelthuzad,992,monk,mistweaver,28,12,16
Mão,stormrage,991,monk,mistweaver,18,11,7
Whitepotato,bleeding-hollow,986,monk,mistweaver,132,69,63
Lilbee,azjolnerub,986,monk,mistweaver,23,12,11
Mintbear,illidan,984,monk,mistweaver,14,11,3
Silito,drakkari,981,monk,mistweaver,138,55,83
Bomer,moknathal,980,monk,mistweaver,49,29,20
Monkgringo,azralon,978,monk,mistweaver,76,40,36
Winniethepoo,borean-tundra,975,monk,mistweaver,19,11,8
Ogsimpsonn,tichondrius,972,monk,mistweaver,20,11,9
Kfpanda,hellscream,971,monk,mistweaver,83,38,45
Soulex,blackwater-raiders,970,monk,mistweaver,23,12,11
Deadlyzz,gilneas,970,monk,mistweaver,99,51,48
Sipu,wyrmrest-accord,969,monk,mistweaver,41,20,21
Djwushu,blackhand,969,monk,mistweaver,26,11,15
Lañdo,uldaman,965,monk,mistweaver,53,30,23
Klanianhere,sargeras,960,monk,mistweaver,12,10,2
Hype,ursin,960,monk,mistweaver,12,10,2
Woes,stormreaver,960,monk,mistweaver,12,10,2
Itwonders,illidan,960,monk,mistweaver,12,10,2
Toonahroll,area-52,960,monk,mistweaver,12,10,2
Gangzmm,tichondrius,960,monk,mistweaver,12,10,2
Dapperdabz,illidan,960,monk,mistweaver,18,10,8
Greenfriend,illidan,960,monk,mistweaver,18,10,8
Mywave,bleeding-hollow,960,monk,mistweaver,18,10,8
Syro,spinebreaker,960,monk,mistweaver,18,10,8
Lynio,area-52,960,monk,mistweaver,18,10,8
Mauvem,tichondrius,960,monk,mistweaver,18,10,8
Wordword,tichondrius,960,monk,mistweaver,18,10,8
Impersonal,sargeras,960,monk,mistweaver,18,10,8
Thatfknguy,sargeras,960,monk,mistweaver,18,10,8
Chevvy,azshara,960,monk,mistweaver,18,10,8
Agilities,sargeras,960,monk,mistweaver,18,10,8
Suitosky,ragnaros,960,monk,mistweaver,24,10,14
Barlyfe,tichondrius,960,monk,mistweaver,24,10,14
Fistweebin,area-52,960,monk,mistweaver,30,10,20
Hanlover,tichondrius,959,monk,mistweaver,12,10,2
Sharpstorm,darkspear,959,monk,mistweaver,12,10,2
Nezkabad,frostmourne,959,monk,mistweaver,12,10,2
Drmoist,moon-guard,959,monk,mistweaver,12,10,2
Diâblomw,barthilas,959,monk,mistweaver,18,10,8
Beaver,zuljin,959,monk,mistweaver,18,10,8
Zenwyatt,area-52,959,monk,mistweaver,18,10,8
Katorin,tichondrius,959,monk,mistweaver,18,10,8
Melpaine,frostmourne,959,monk,mistweaver,18,10,8
Chanîng,frostmourne,959,monk,mistweaver,18,10,8
Chat,perenolde,959,monk,mistweaver,18,10,8
Truefists,stormrage,959,monk,mistweaver,18,10,8
Insidedog,frostmourne,959,monk,mistweaver,18,10,8
Monkmarz,malygos,959,monk,mistweaver,23,10,13
Anabolicx,khazgoroth,959,monk,mistweaver,24,10,14
Argoholic,proudmoore,959,monk,mistweaver,24,10,14
Pumpsx,area-52,959,monk,mistweaver,24,10,14
Ppbnodru,illidan,958,monk,mistweaver,12,10,2
Kåtê,sargeras,958,monk,mistweaver,12,10,2
Nientea,wyrmrest-accord,958,monk,mistweaver,18,10,8
Fïish,stormrage,958,monk,mistweaver,18,10,8
Lostinmistz,tichondrius,958,monk,mistweaver,18,10,8
Trazmold,emerald-dream,958,monk,mistweaver,18,10,8
Kopiomw,tichondrius,957,monk,mistweaver,12,10,2
Tye,doomhammer,957,monk,mistweaver,18,10,8
Cannenmonk,sargeras,957,monk,mistweaver,18,10,8
Fistfreak,stormrage,957,monk,mistweaver,18,10,8
Inkers,detheroc,957,monk,mistweaver,18,10,8
Strokahontas,stormreaver,957,monk,mistweaver,42,10,32
Diligentmonk,illidan,955,monk,mistweaver,27,11,16
Bojflow,dalaran,954,monk,mistweaver,18,10,8
Wessex,sargeras,954,monk,mistweaver,18,10,8
Miýagi,sargeras,954,monk,mistweaver,18,10,8
Aotd,tichondrius,954,monk,mistweaver,24,10,14
Prodivuss,stormrage,954,monk,mistweaver,24,10,14
Daddbear,kiljaeden,952,monk,mistweaver,18,10,8
Rdmptn,bleeding-hollow,952,monk,mistweaver,24,10,14
Kurtall,area-52,952,monk,mistweaver,24,10,14
Shabudinetz,stormrage,951,monk,mistweaver,12,10,2
Kailzchi,area-52,951,monk,mistweaver,18,10,8
Altf,frostmourne,950,monk,mistweaver,12,10,2
Brewtalitops,illidan,950,monk,mistweaver,18,10,8
Shinobui,jubeithos,950,monk,mistweaver,18,10,8
Julox,azralon,950,monk,mistweaver,24,13,11
Palomagozzu,ragnaros,947,monk,mistweaver,18,10,8
Howu,tichondrius,947,monk,mistweaver,35,12,23
Fruitcakezz,arthas,945,monk,mistweaver,21,12,9
Jæmz,moon-guard,944,monk,mistweaver,36,13,23
Kiyou,drakkari,940,monk,mistweaver,18,10,8
Nigondatnay,tichondrius,927,monk,mistweaver,16,11,5
Sahalee,sargeras,927,monk,mistweaver,38,18,20
Ultramaga,dentarg,927,monk,mistweaver,28,10,18
Nosweaver,malganis,926,monk,mistweaver,14,11,3
Summersoup,zuljin,926,monk,mistweaver,23,10,13
Tcoon,frostmourne,925,monk,mistweaver,26,11,15
Elfass,bleeding-hollow,924,monk,mistweaver,23,10,13
Siamack,illidan,920,monk,mistweaver,14,11,3
Kratis,doomhammer,915,monk,mistweaver,71,28,43
Karkata,sargeras,914,monk,mistweaver,48,20,28
Kangeroo,tichondrius,912,monk,mistweaver,21,11,10
Phialah,alexstrasza,911,monk,mistweaver,21,11,10
Sensey,veknilash,910,monk,mistweaver,17,10,7
Ægo,sargeras,906,monk,mistweaver,22,11,11
Madmoose,smolderthorn,899,monk,mistweaver,66,28,38
Xentra,stormrage,895,monk,mistweaver,11,10,1
Griddio,wyrmrest-accord,895,monk,mistweaver,14,10,4
Delassian,moon-guard,894,monk,mistweaver,37,16,21
Inbu,tichondrius,893,monk,mistweaver,26,10,16
Stickbundle,illidan,888,monk,mistweaver,15,11,4
Edj,drenden,884,monk,mistweaver,75,37,38
Fistofnstar,stormrage,883,monk,mistweaver,125,48,77
Kyndrïa,tichondrius,882,monk,mistweaver,239,111,128
Gino,proudmoore,881,monk,mistweaver,226,104,122
Samanosukee,illidan,881,monk,mistweaver,24,10,14
Boojaa,silvermoon,879,monk,mistweaver,95,39,56
Galyndra,darkspear,877,monk,mistweaver,13,10,3
Franqx,tichondrius,864,monk,mistweaver,12,9,3
Flicksx,arthas,864,monk,mistweaver,12,9,3
Zbhm,illidan,864,monk,mistweaver,12,9,3
Horndog,skullcrusher,864,monk,mistweaver,12,9,3
Rumor,lethon,864,monk,mistweaver,12,9,3
Daneil,illidan,864,monk,mistweaver,12,9,3
Ggonext,wyrmrest-accord,864,monk,mistweaver,12,9,3
Sâx,stormreaver,864,monk,mistweaver,12,9,3
Nickimínaj,illidan,864,monk,mistweaver,12,9,3
Mistyfisty,laughing-skull,864,monk,mistweaver,14,9,5
Pantypirate,tichondrius,864,monk,mistweaver,18,9,9
Enkcredulous,tichondrius,864,monk,mistweaver,18,9,9
Kármah,emerald-dream,864,monk,mistweaver,18,9,9
Hulkhogan,mugthol,863,monk,mistweaver,14,11,3
Brewley,thrall,863,monk,mistweaver,12,9,3
Ozáí,illidan,863,monk,mistweaver,12,9,3
Brewtillis,tichondrius,863,monk,mistweaver,12,9,3
Beastmonk,sargeras,863,monk,mistweaver,12,9,3
Kazzichi,area-52,863,monk,mistweaver,12,9,3
Ztalian,moon-guard,863,monk,mistweaver,12,9,3
Neverfake,sargeras,863,monk,mistweaver,18,9,9
Galaxygregg,area-52,863,monk,mistweaver,18,9,9
Bootytoes,emerald-dream,863,monk,mistweaver,18,9,9
Strummies,tichondrius,863,monk,mistweaver,18,9,9
Fìst,zuljin,863,monk,mistweaver,18,9,9
Tjab,kiljaeden,863,monk,mistweaver,18,9,9
Chifang,elune,863,monk,mistweaver,18,9,9
Shadowbringr,proudmoore,863,monk,mistweaver,18,9,9
Srgtbingo,azgalor,863,monk,mistweaver,18,9,9
Seltrum,quelthalas,863,monk,mistweaver,18,9,9
Melcor,ragnaros,863,monk,mistweaver,18,9,9
Sumaran,hydraxis,863,monk,mistweaver,18,9,9
Boothchi,kelthuzad,863,monk,mistweaver,18,9,9
Icytoned,kelthuzad,863,monk,mistweaver,24,9,15
Slickbeef,thrall,863,monk,mistweaver,24,9,15
Ørçhid,ravenholdt,862,monk,mistweaver,12,9,3
Pharmasee,proudmoore,862,monk,mistweaver,12,9,3
Dirtysmonk,mugthol,862,monk,mistweaver,12,9,3
Zac,veknilash,862,monk,mistweaver,12,9,3
Globalmonk,emerald-dream,862,monk,mistweaver,12,9,3
Touchofdell,illidan,862,monk,mistweaver,18,9,9
Jhaded,tichondrius,862,monk,mistweaver,24,9,15
Kromrax,stormrage,862,monk,mistweaver,24,9,15
Madussy,zuljin,862,monk,mistweaver,24,9,15
Lillyanda,lightbringer,861,monk,mistweaver,12,9,3
Justfakeit,area-52,861,monk,mistweaver,18,9,9
Ösîrîs,stormrage,861,monk,mistweaver,22,10,12
Håzê,kul-tiras,860,monk,mistweaver,18,9,9
Tasslé,illidan,860,monk,mistweaver,18,9,9
Yudrin,zuljin,859,monk,mistweaver,24,9,15
Pòrts,tichondrius,859,monk,mistweaver,24,9,15
Starskreem,tichondrius,855,monk,mistweaver,12,9,3
Monkism,warsong,855,monk,mistweaver,12,9,3
Winwakamank,sargeras,855,monk,mistweaver,24,9,15
Rauschende,feathermoon,854,monk,mistweaver,12,9,3
Gerlokfu,tichondrius,852,monk,mistweaver,12,9,3
Eago,sargeras,852,monk,mistweaver,24,9,15
Zeeboogerton,wildhammer,851,monk,mistweaver,12,9,3
Bullshido,aerie-peak,851,monk,mistweaver,18,9,9
Epptwo,aggramar,851,monk,mistweaver,30,9,21
Goodgodsz,tichondrius,849,monk,mistweaver,12,9,3
Gesir,tichondrius,848,monk,mistweaver,21,10,11
Mënace,skullcrusher,844,monk,mistweaver,18,9,9
Sìrtankallot,stormrage,837,monk,mistweaver,32,9,23
Dreamy,mugthol,833,monk,mistweaver,48,17,31
Kimchimaj,tichondrius,832,monk,mistweaver,18,9,9
Fakelove,kelthuzad,830,monk,mistweaver,28,10,18
Seaja,malganis,823,monk,mistweaver,99,26,73
Måz,malorne,822,monk,mistweaver,21,12,9
Eggwoll,velen,814,monk,mistweaver,15,10,5
Matsakaicin,azralon,809,monk,mistweaver,22,10,12
Goodluck,madoran,809,monk,mistweaver,27,10,17
Paniku,sargeras,807,monk,mistweaver,51,17,34
Tokkyo,frostmourne,804,monk,mistweaver,66,15,51
Gengibirra,illidan,801,monk,mistweaver,72,21,51
Picoree,frostmourne,799,monk,mistweaver,15,10,5
Mastahp,tichondrius,797,monk,mistweaver,22,9,13
Robochöp,emerald-dream,793,monk,mistweaver,20,9,11
Qlispe,bloodscalp,784,monk,mistweaver,76,35,41
Beerheals,kelthuzad,783,monk,mistweaver,13,9,4
Imsouglyman,tichondrius,779,monk,mistweaver,19,9,10
Funkmunk,aegwynn,768,monk,mistweaver,12,8,4
Dontchattome,sargeras,768,monk,mistweaver,12,8,4
Picklefartjr,malfurion,768,monk,mistweaver,12,8,4
Smackdownx,tichondrius,768,monk,mistweaver,12,8,4
Tuladura,tichondrius,768,monk,mistweaver,12,8,4
Kaystorm,stormrage,768,monk,mistweaver,12,8,4
Hironk,proudmoore,768,monk,mistweaver,12,8,4
Serénity,kiljaeden,768,monk,mistweaver,12,8,4
Bralex,black-dragonflight,768,monk,mistweaver,12,8,4
Kaskã,tichondrius,768,monk,mistweaver,12,8,4
Vexed,illidan,768,monk,mistweaver,12,8,4
Ericfu,tichondrius,768,monk,mistweaver,12,8,4
Goosebumps,daggerspine,768,monk,mistweaver,12,8,4
Omnly,stormrage,768,monk,mistweaver,12,8,4
Sàìñtàsønìà,kelthuzad,768,monk,mistweaver,12,8,4
Sainlaurent,tichondrius,768,monk,mistweaver,12,8,4
Snowbunny,llane,768,monk,mistweaver,12,8,4
Fangerlia,moon-guard,768,monk,mistweaver,12,8,4
Zuchi,barthilas,768,monk,mistweaver,12,8,4
Shquiz,sargeras,768,monk,mistweaver,12,8,4
Kobuya,tichondrius,768,monk,mistweaver,12,8,4
Prodigious,illidan,768,monk,mistweaver,12,8,4
Leesinga,alexstrasza,768,monk,mistweaver,12,8,4
Scrypter,proudmoore,768,monk,mistweaver,12,8,4
Ufs,illidan,768,monk,mistweaver,12,8,4
Chipapi,sargeras,768,monk,mistweaver,12,8,4
Backup,lothar,768,monk,mistweaver,17,9,8
Kwatann,bonechewer,768,monk,mistweaver,18,8,10
Guerrero,tichondrius,768,monk,mistweaver,18,8,10
Backflip,nemesis,768,monk,mistweaver,18,8,10
Watercowz,tichondrius,768,monk,mistweaver,18,8,10
Jtowne,dalaran,768,monk,mistweaver,18,8,10
Rockyßalboa,sargeras,768,monk,mistweaver,18,8,10
Mmrmonkey,tichondrius,768,monk,mistweaver,18,8,10
Torakigai,ghostlands,768,monk,mistweaver,18,8,10
Erwynz,tichondrius,768,monk,mistweaver,24,8,16
Nøzawri,area-52,767,monk,mistweaver,12,8,4
Lemoine,hakkar,767,monk,mistweaver,12,8,4
Kymosolomk,sargeras,767,monk,mistweaver,12,8,4
Mightbewôrth,thunderhorn,767,monk,mistweaver,12,8,4
Pandicapped,the-underbog,767,monk,mistweaver,12,8,4
Sììre,tichondrius,767,monk,mistweaver,12,8,4
Pungeebi,tichondrius,767,monk,mistweaver,12,8,4
Rilenn,area-52,767,monk,mistweaver,12,8,4
Abird,tichondrius,767,monk,mistweaver,12,8,4
Blitzcombo,thrall,767,monk,mistweaver,12,8,4
Jurassaf,illidan,767,monk,mistweaver,12,8,4
Dabnhash,emerald-dream,767,monk,mistweaver,18,8,10
Kungphopan,proudmoore,767,monk,mistweaver,18,8,10
Bogez,area-52,767,monk,mistweaver,18,8,10
Ocmonk,hyjal,767,monk,mistweaver,18,8,10
Dùffmán,jubeithos,767,monk,mistweaver,18,8,10
Palden,blackrock,767,monk,mistweaver,18,8,10
Barleygar,tichondrius,767,monk,mistweaver,18,8,10
Lulwport,frostmourne,767,monk,mistweaver,18,8,10
Chugginchi,illidan,767,monk,mistweaver,18,8,10
Onegai,illidan,767,monk,mistweaver,24,8,16
Bloodyhealz,tortheldrin,767,monk,mistweaver,24,8,16
Amuy,uther,766,monk,mistweaver,12,8,4
Nakiki,cenarion-circle,766,monk,mistweaver,12,8,4
Kuá,tichondrius,766,monk,mistweaver,12,8,4
Bambolee,thunderhorn,766,monk,mistweaver,12,8,4
Kennjin,spinebreaker,766,monk,mistweaver,12,8,4
Apexian,kelthuzad,766,monk,mistweaver,12,8,4
Selfiestíck,tichondrius,766,monk,mistweaver,12,8,4
Jnziww,area-52,766,monk,mistweaver,12,8,4
Artomist,stormrage,766,monk,mistweaver,12,8,4
Pripp,blackrock,766,monk,mistweaver,12,8,4
Malusiftw,tichondrius,766,monk,mistweaver,18,8,10
Tonyrelish,sargeras,766,monk,mistweaver,18,8,10
Gnomshini,proudmoore,766,monk,mistweaver,18,8,10
Fist,arygos,765,monk,mistweaver,18,8,10
Biglinky,sargeras,765,monk,mistweaver,18,8,10
Freimuth,thrall,765,monk,mistweaver,18,8,10
Wzzi,tichondrius,765,monk,mistweaver,18,8,10
Ariss,ragnaros,765,monk,mistweaver,18,8,10
Slinger,kalecgos,764,monk,mistweaver,16,9,7
Savyi,stormreaver,763,monk,mistweaver,12,8,4
Tigmo,alleria,762,monk,mistweaver,18,8,10
Fufu,terokkar,761,monk,mistweaver,18,8,10
Jb,burning-blade,758,monk,mistweaver,18,8,10
Angrybrewski,tichondrius,757,monk,mistweaver,18,8,10
Probs,sargeras,751,monk,mistweaver,23,8,15
Fusionspell,stormrage,747,monk,mistweaver,24,8,16
Prddoss,quelthalas,745,monk,mistweaver,12,8,4
Drizzimonk,thrall,735,monk,mistweaver,17,8,9
Sätsu,bleeding-hollow,735,monk,mistweaver,17,8,9
Karlrogan,stormrage,734,monk,mistweaver,16,9,7
Áasuna,ragnaros,734,monk,mistweaver,20,9,11
Senseißones,area-52,734,monk,mistweaver,23,8,15
Whosaidthat,frostmourne,723,monk,mistweaver,33,15,18
Thaliondor,stormrage,720,monk,mistweaver,15,9,6
Kryflex,frostmourne,720,monk,mistweaver,15,9,6
Bombshellxo,illidan,719,monk,mistweaver,11,8,3
Whee,wyrmrest-accord,703,monk,mistweaver,11,8,3
Kayten,nemesis,703,monk,mistweaver,11,8,3
Kármâ,darkspear,703,monk,mistweaver,14,8,6
Keloxx,ragnaros,702,monk,mistweaver,16,10,6
Shortbuss,aegwynn,696,monk,mistweaver,14,8,6
Minttea,kiljaeden,690,monk,mistweaver,28,9,19
Mansosogodx,ragnaros,672,monk,mistweaver,10,8,2
Hunchojack,undermine,672,monk,mistweaver,10,8,2
Strawberriez,kelthuzad,672,monk,mistweaver,12,7,5
Galeindra,whisperwind,672,monk,mistweaver,12,7,5
Vasera,moon-guard,672,monk,mistweaver,12,7,5
Zbell,sargeras,672,monk,mistweaver,12,7,5
Synpunch,tichondrius,672,monk,mistweaver,12,7,5
Mundane,sargeras,672,monk,mistweaver,12,7,5
Zaçh,frostmane,672,monk,mistweaver,12,7,5
Grayfanxo,malganis,672,monk,mistweaver,12,7,5
Brantkicks,tichondrius,672,monk,mistweaver,12,7,5
Moönk,tichondrius,672,monk,mistweaver,12,7,5
Arumat,shadow-council,672,monk,mistweaver,12,7,5
Jasonluv,illidan,672,monk,mistweaver,12,7,5
Kegwalker,earthen-ring,672,monk,mistweaver,12,7,5
Mwr,frostmourne,672,monk,mistweaver,12,7,5
Ikaga,barthilas,672,monk,mistweaver,12,7,5
Darong,tichondrius,672,monk,mistweaver,12,7,5
Vesaves,azralon,672,monk,mistweaver,12,7,5
Jaxvisto,dalaran,672,monk,mistweaver,12,7,5
Boorams,tichondrius,672,monk,mistweaver,12,7,5
Zõõmz,jaedenar,672,monk,mistweaver,12,7,5
Jeremih,arthas,672,monk,mistweaver,12,7,5
Zhoutai,malganis,672,monk,mistweaver,12,7,5
Loppjr,tichondrius,672,monk,mistweaver,12,7,5
Opclassxd,illidan,672,monk,mistweaver,12,7,5
Kyrap,stormscale,672,monk,mistweaver,12,7,5
Notrof,korgath,672,monk,mistweaver,12,7,5
Laggytoodope,kelthuzad,672,monk,mistweaver,12,7,5
Immersion,the-forgotten-coast,672,monk,mistweaver,12,7,5
Såd,zuljin,672,monk,mistweaver,12,7,5
Kíd,ysera,672,monk,mistweaver,12,7,5
Copamine,dalaran,672,monk,mistweaver,12,7,5
Lilpøøter,tichondrius,672,monk,mistweaver,12,7,5
Toothpick,blackrock,672,monk,mistweaver,12,7,5
Tooflyfobrew,sargeras,672,monk,mistweaver,12,7,5
Abevx,bonechewer,672,monk,mistweaver,12,7,5
Dogmonster,stormrage,672,monk,mistweaver,12,7,5
Astridia,darkspear,672,monk,mistweaver,12,7,5
Sweetröll,stormrage,672,monk,mistweaver,12,7,5
Brimhildaa,tichondrius,672,monk,mistweaver,12,7,5
Saiyañ,proudmoore,672,monk,mistweaver,12,7,5
Rookere,malganis,672,monk,mistweaver,12,7,5
Polyphia,lothar,672,monk,mistweaver,12,7,5
Ashmisty,kelthuzad,672,monk,mistweaver,12,7,5
Missclickx,azralon,672,monk,mistweaver,12,7,5
Aniwhy,tichondrius,672,monk,mistweaver,12,7,5
Rawmonk,blackrock,672,monk,mistweaver,12,7,5
Sparksito,ragnaros,672,monk,mistweaver,12,7,5
Fistay,burning-legion,672,monk,mistweaver,15,8,7
Èxpèrtisè,jubeithos,672,monk,mistweaver,14,7,7
Monktu,frostmourne,672,monk,mistweaver,18,7,11
Thutan,tichondrius,672,monk,mistweaver,18,7,11
Mythsmonkx,barthilas,672,monk,mistweaver,18,7,11
Thevy,area-52,672,monk,mistweaver,18,7,11
Audrun,frostmourne,672,monk,mistweaver,18,7,11
Matthew,ravencrest,672,monk,mistweaver,18,7,11
Catchmemaybe,stormscale,672,monk,mistweaver,24,7,17
Delightni,area-52,671,monk,mistweaver,12,7,5
Shwrmist,bleeding-hollow,671,monk,mistweaver,12,7,5
Niéh,frostmourne,671,monk,mistweaver,12,7,5
Kokochiggy,tichondrius,671,monk,mistweaver,12,7,5
Alisoly,tichondrius,671,monk,mistweaver,12,7,5
Iwonson,mugthol,671,monk,mistweaver,12,7,5
Hornymonkale,thrall,671,monk,mistweaver,12,7,5
Niculinha,nemesis,671,monk,mistweaver,12,7,5
Teawreckz,jubeithos,671,monk,mistweaver,12,7,5
Obstetrics,archimonde,671,monk,mistweaver,12,7,5
Wamii,tichondrius,671,monk,mistweaver,12,7,5
Kekekeke,dreadmaul,671,monk,mistweaver,12,7,5
Jbonk,hyjal,671,monk,mistweaver,12,7,5
Universalize,zuljin,671,monk,mistweaver,12,7,5
Shórtlived,skullcrusher,671,monk,mistweaver,13,7,6
Táishen,wyrmrest-accord,671,monk,mistweaver,16,8,8
Femifist,lightbringer,671,monk,mistweaver,18,7,11
Bükki,ragnaros,671,monk,mistweaver,18,7,11
Crakgirl,malganis,671,monk,mistweaver,18,7,11
Sterow,kiljaeden,671,monk,mistweaver,18,7,11
Paradissô,tichondrius,671,monk,mistweaver,18,7,11
Khadfu,sargeras,671,monk,mistweaver,18,7,11
Hawrang,tichondrius,671,monk,mistweaver,24,7,17
Drizzie,queldorei,671,monk,mistweaver,24,7,17
Thahomie,nordrassil,671,monk,mistweaver,24,7,17
Onlyfistss,illidan,670,monk,mistweaver,12,7,5
Jianrèn,wyrmrest-accord,670,monk,mistweaver,12,7,5
Swann,stormreaver,670,monk,mistweaver,12,7,5
Microdose,blackrock,670,monk,mistweaver,18,7,11
Khaldi,tichondrius,670,monk,mistweaver,19,7,12
Pandaranga,saurfang,670,monk,mistweaver,28,8,20
Runkfyr,ragnaros,670,monk,mistweaver,30,7,23
Unlemike,runetotem,669,monk,mistweaver,12,7,5
Nymchi,stormrage,669,monk,mistweaver,12,7,5
Melyodis,thrall,669,monk,mistweaver,18,7,11
Orurmine,kiljaeden,669,monk,mistweaver,18,7,11
Absolutvodca,nemesis,669,monk,mistweaver,24,7,17
Gímley,bleeding-hollow,667,monk,mistweaver,12,7,5
Balooballs,frostmourne,667,monk,mistweaver,18,7,11
Shihfu,azralon,667,monk,mistweaver,24,7,17
Dornix,illidan,664,monk,mistweaver,18,7,11
Wetspaghetti,malganis,661,monk,mistweaver,18,7,11
Obàma,tichondrius,659,monk,mistweaver,22,11,11
Munchan,hyjal,654,monk,mistweaver,11,9,2
Yungsun,ragnaros,653,monk,mistweaver,19,8,11
Karu,barthilas,639,monk,mistweaver,18,8,10
Reflexsivex,malganis,638,monk,mistweaver,11,7,4
Tomaz,nazjatar,632,monk,mistweaver,11,7,4
Berzerk,dalvengyr,624,monk,mistweaver,15,7,8
Saucyfists,silvermoon,624,monk,mistweaver,21,8,13
Blessedbalor,tichondrius,624,monk,mistweaver,21,7,14
Praydoh,tichondrius,623,monk,mistweaver,11,7,4
Azz,barthilas,623,monk,mistweaver,11,7,4
Winsmmafight,frostmourne,623,monk,mistweaver,11,7,4
Jetchi,proudmoore,623,monk,mistweaver,11,7,4
Aerona,stormreaver,617,monk,mistweaver,12,8,4
Mistyheals,emerald-dream,617,monk,mistweaver,17,10,7
Jayjaybrew,area-52,615,monk,mistweaver,22,8,14
Scips,fizzcrank,614,monk,mistweaver,22,8,14
Happymonk,tichondrius,613,monk,mistweaver,43,8,35
Pandamanapua,dragonmaw,608,monk,mistweaver,16,7,9
Pandica,kiljaeden,607,monk,mistweaver,11,7,4
Monjepa,illidan,604,monk,mistweaver,20,7,13
Pandamoanda,azgalor,593,monk,mistweaver,16,7,9
Erksauce,kelthuzad,592,monk,mistweaver,13,7,6
Reoc,bleeding-hollow,592,monk,mistweaver,13,7,6
Freyeä,malganis,576,monk,mistweaver,6,6,0
Minivanmom,illidan,576,monk,mistweaver,6,6,0
Kryptoniko,illidan,576,monk,mistweaver,6,6,0
Bdâwg,frostmourne,576,monk,mistweaver,6,6,0
Kruxx,anvilmar,576,monk,mistweaver,6,6,0
Crunchyhippy,hyjal,576,monk,mistweaver,6,6,0
Hoshm,area-52,576,monk,mistweaver,6,6,0
Jorts,khazgoroth,576,monk,mistweaver,6,6,0
Raìndropz,tichondrius,576,monk,mistweaver,6,6,0
Søck,malfurion,576,monk,mistweaver,6,6,0
Larkssmw,zuljin,576,monk,mistweaver,6,6,0
Worgendiff,moon-guard,576,monk,mistweaver,6,6,0
Jaghealz,area-52,576,monk,mistweaver,6,6,0
Jg,staghelm,576,monk,mistweaver,6,6,0
Chrîstmas,proudmoore,576,monk,mistweaver,6,6,0
Watty,zuljin,576,monk,mistweaver,6,6,0
Munkï,tichondrius,576,monk,mistweaver,6,6,0
Lightweaving,norgannon,576,monk,mistweaver,12,6,6
Lackofsleep,tichondrius,576,monk,mistweaver,12,6,6
Daarl,burning-blade,576,monk,mistweaver,12,6,6
Shelßy,azralon,576,monk,mistweaver,12,6,6
Steyi,nazjatar,576,monk,mistweaver,12,6,6
Broyoulined,spirestone,576,monk,mistweaver,12,6,6
Imakeplaysyo,illidan,576,monk,mistweaver,12,6,6
Brujitsu,thrall,576,monk,mistweaver,12,6,6
Boppweave,tichondrius,576,monk,mistweaver,12,6,6
Zeshmo,firetree,576,monk,mistweaver,12,6,6
Gullystylez,hellscream,576,monk,mistweaver,12,6,6
Wuwei,onyxia,576,monk,mistweaver,12,6,6
Kaztíel,ragnaros,576,monk,mistweaver,12,6,6
Frésa,ragnaros,576,monk,mistweaver,12,6,6
Emerald,emerald-dream,576,monk,mistweaver,12,6,6
Mënmä,ragnaros,576,monk,mistweaver,12,6,6
Meisterbrew,garona,576,monk,mistweaver,12,6,6
Underpants,skullcrusher,576,monk,mistweaver,12,6,6
Eightpoint,illidan,576,monk,mistweaver,12,6,6
Tunchii,sargeras,576,monk,mistweaver,12,6,6
Shaqkobe,area-52,576,monk,mistweaver,12,6,6
Janim,illidan,576,monk,mistweaver,12,6,6
Ryukenshin,proudmoore,576,monk,mistweaver,12,6,6
Até,azralon,576,monk,mistweaver,12,6,6
Silkymoves,tichondrius,576,monk,mistweaver,12,6,6
Jieterchan,malganis,576,monk,mistweaver,12,6,6
Dungfish,mugthol,576,monk,mistweaver,12,6,6
Monkshiit,area-52,576,monk,mistweaver,12,6,6
Lumiän,area-52,576,monk,mistweaver,12,6,6
Wèave,tichondrius,576,monk,mistweaver,12,6,6
Sekushî,kelthuzad,576,monk,mistweaver,12,6,6
Rajile,sargeras,576,monk,mistweaver,12,6,6
Karrigwyn,tichondrius,576,monk,mistweaver,12,6,6
Transcend,nerzhul,576,monk,mistweaver,12,6,6
Flfltmfrl,tichondrius,576,monk,mistweaver,12,6,6
Bearmode,wyrmrest-accord,576,monk,mistweaver,12,6,6
Jukez,emerald-dream,576,monk,mistweaver,12,6,6
Magnustavick,bleeding-hollow,576,monk,mistweaver,12,6,6
Rubntug,zuljin,576,monk,mistweaver,12,6,6
Zchi,zuljin,576,monk,mistweaver,12,6,6
Renzin,gilneas,576,monk,mistweaver,12,6,6
Jbg,staghelm,576,monk,mistweaver,12,6,6
Dgmonk,tichondrius,576,monk,mistweaver,12,6,6
Bamboozïe,arthas,576,monk,mistweaver,12,6,6
Trins,azjolnerub,576,monk,mistweaver,12,6,6
Aerlin,tichondrius,576,monk,mistweaver,12,6,6
Mtsalt,bleeding-hollow,576,monk,mistweaver,12,6,6
Tic,barthilas,576,monk,mistweaver,12,6,6
Cerrado,emerald-dream,576,monk,mistweaver,12,6,6
Mustard,arthas,576,monk,mistweaver,12,6,6
Dracc,zuljin,576,monk,mistweaver,12,6,6
Mesak,ragnaros,576,monk,mistweaver,15,7,8
Simarity,kelthuzad,576,monk,mistweaver,18,6,12
Tragictea,zuljin,576,monk,mistweaver,18,6,12
Mwgapper,sargeras,576,monk,mistweaver,18,6,12
Ampy,tichondrius,576,monk,mistweaver,18,6,12
Rebornmaster,moon-guard,576,monk,mistweaver,18,6,12
Chingwang,frostmourne,576,monk,mistweaver,18,6,12
Hugerichard,wyrmrest-accord,576,monk,mistweaver,18,6,12
Rollsrice,area-52,576,monk,mistweaver,18,6,12
Kynyssar,bleeding-hollow,576,monk,mistweaver,18,6,12
Yangdingtian,sargeras,576,monk,mistweaver,24,6,18
Tohkmonk,crushridge,575,monk,mistweaver,6,6,0
Haraumi,proudmoore,575,monk,mistweaver,6,6,0
Buttfists,stormrage,575,monk,mistweaver,12,6,6
Miso,nathrezim,575,monk,mistweaver,12,6,6
Deepchi,tichondrius,575,monk,mistweaver,12,6,6
Liucang,archimonde,575,monk,mistweaver,12,6,6
Almondmïlk,bonechewer,575,monk,mistweaver,12,6,6
Agrïppa,caelestrasz,575,monk,mistweaver,12,6,6
Misha,akama,575,monk,mistweaver,12,6,6
Nf,zuljin,575,monk,mistweaver,12,6,6
Xinn,kiljaeden,575,monk,mistweaver,12,6,6
Hibìscus,tichondrius,575,monk,mistweaver,12,6,6
Clytpuncher,emerald-dream,575,monk,mistweaver,12,6,6
Zargtruth,proudmoore,575,monk,mistweaver,12,6,6
Putisucia,nordrassil,575,monk,mistweaver,12,6,6
Myrsken,area-52,575,monk,mistweaver,12,6,6
Itsjohnnylol,azuremyst,575,monk,mistweaver,12,6,6
Laopow,area-52,575,monk,mistweaver,12,6,6
Soysaucë,malganis,575,monk,mistweaver,12,6,6
Glitchi,area-52,575,monk,mistweaver,12,6,6
Criarla,tichondrius,575,monk,mistweaver,12,6,6
Sknypicho,malganis,575,monk,mistweaver,12,6,6
Ormchi,stormrage,575,monk,mistweaver,13,6,7
Fortyozkilla,thrall,575,monk,mistweaver,18,6,12
Rocketfist,bleeding-hollow,575,monk,mistweaver,18,6,12
Freepunchz,frostmourne,575,monk,mistweaver,18,6,12
Opmother,elune,575,monk,mistweaver,18,6,12
Yanedin,dalaran,574,monk,mistweaver,12,6,6
Beatboxblues,skullcrusher,574,monk,mistweaver,12,6,6
Pradã,tichondrius,572,monk,mistweaver,12,6,6
Dokuho,silvermoon,572,monk,mistweaver,12,6,6
Gaturis,tichondrius,572,monk,mistweaver,21,7,14
Kowpowmoomoo,uther,572,monk,mistweaver,18,6,12
Bógus,tichondrius,571,monk,mistweaver,12,6,6
Paladinei,tichondrius,571,monk,mistweaver,12,6,6
Keekismonk,gorefiend,566,monk,mistweaver,12,6,6
Dejohnette,quelthalas,565,monk,mistweaver,12,6,6
Gyunyumanjuu,proudmoore,559,monk,mistweaver,11,6,5
Boofie,perenolde,559,monk,mistweaver,11,6,5
Bludyphister,tichondrius,558,monk,mistweaver,17,6,11
Longdukdon,illidan,543,monk,mistweaver,11,6,5
Ñoobmonk,tichondrius,543,monk,mistweaver,11,6,5
Eraticmonk,illidan,543,monk,mistweaver,14,7,7
Saltyone,firetree,543,monk,mistweaver,14,7,7
Bigolagile,velen,537,monk,mistweaver,22,6,16
Ogmonk,skullcrusher,528,monk,mistweaver,15,7,8
Tøåst,illidan,527,monk,mistweaver,11,6,5
Rakesh,azralon,525,monk,mistweaver,9,7,2
Räyè,tichondrius,511,monk,mistweaver,8,6,2
Yuløn,illidan,511,monk,mistweaver,8,6,2
Feihung,executus,511,monk,mistweaver,11,6,5
Myozen,proudmoore,511,monk,mistweaver,11,6,5
Oldmanwalker,mannoroth,511,monk,mistweaver,11,6,5
Tbrew,area-52,511,monk,mistweaver,14,6,8
Figurines,sargeras,496,monk,mistweaver,19,6,13
Akfourseven,barthilas,495,monk,mistweaver,74,32,42
Roskoh,area-52,493,monk,mistweaver,19,6,13
Genia,ragnaros,480,monk,mistweaver,6,5,1
Rollingkush,illidan,480,monk,mistweaver,6,5,1
Grumpî,tichondrius,480,monk,mistweaver,6,5,1
Rivnn,sargeras,480,monk,mistweaver,6,5,1
Kayflock,tichondrius,480,monk,mistweaver,6,5,1
Elimweaver,frostmourne,480,monk,mistweaver,6,5,1
Spicym,proudmoore,480,monk,mistweaver,6,5,1
Stepfíster,tichondrius,480,monk,mistweaver,6,5,1
Møzy,tichondrius,480,monk,mistweaver,6,5,1
Alvinete,tichondrius,480,monk,mistweaver,6,5,1
Mistwalk,tichondrius,480,monk,mistweaver,6,5,1
Zombir,frostmourne,480,monk,mistweaver,6,5,1
Yajirobei,area-52,480,monk,mistweaver,6,5,1
Pandatong,tichondrius,480,monk,mistweaver,6,5,1
Yuldaddy,tichondrius,480,monk,mistweaver,6,5,1
Binimonk,tichondrius,480,monk,mistweaver,6,5,1
Chaboixd,illidan,480,monk,mistweaver,6,5,1
Rizzyg,tichondrius,480,monk,mistweaver,6,5,1
Ninjaheals,spirestone,480,monk,mistweaver,6,5,1
Satiremaster,frostmourne,480,monk,mistweaver,6,5,1
Diabittus,thrall,480,monk,mistweaver,6,5,1
Laowaikiller,tichondrius,480,monk,mistweaver,6,5,1
Custerweave,dalaran,480,monk,mistweaver,6,5,1
Danwunwolf,tichondrius,480,monk,mistweaver,6,5,1
Pinot,dragonmaw,480,monk,mistweaver,6,5,1
Yelixing,tichondrius,480,monk,mistweaver,6,5,1
Ceronash,dalaran,480,monk,mistweaver,6,5,1
Shandilla,proudmoore,480,monk,mistweaver,6,5,1
Donatello,arthas,480,monk,mistweaver,6,5,1
Theodôn,dalaran,480,monk,mistweaver,6,5,1
Mongénoìo,nemesis,480,monk,mistweaver,6,5,1
Gauchonatoo,nemesis,480,monk,mistweaver,6,5,1
Touchoftism,proudmoore,480,monk,mistweaver,6,5,1
Khidda,barthilas,480,monk,mistweaver,6,5,1
Thegreentaco,tichondrius,480,monk,mistweaver,6,5,1
Siddharthä,barthilas,480,monk,mistweaver,6,5,1
Orcboi,darkspear,480,monk,mistweaver,6,5,1
Pyoapple,tichondrius,480,monk,mistweaver,6,5,1
Meepz,arthas,480,monk,mistweaver,6,5,1
Jisky,bleeding-hollow,480,monk,mistweaver,6,5,1
Getswept,area-52,480,monk,mistweaver,6,5,1
Choibaedal,tichondrius,480,monk,mistweaver,7,5,2
Gostop,barthilas,480,monk,mistweaver,12,5,7
Ouibaguette,kelthuzad,480,monk,mistweaver,12,5,7
Xiaotaimei,frostmourne,480,monk,mistweaver,12,5,7
Palumorww,deathwing,480,monk,mistweaver,12,5,7
Piece,blackrock,480,monk,mistweaver,12,5,7
Snooky,kiljaeden,480,monk,mistweaver,12,5,7
Bigolbootay,tichondrius,480,monk,mistweaver,12,5,7
Xavelha,tichondrius,480,monk,mistweaver,12,5,7
Gnarmony,malganis,480,monk,mistweaver,12,5,7
Monaks,barthilas,480,monk,mistweaver,12,5,7
Onak,illidan,480,monk,mistweaver,12,5,7
Mists,velen,480,monk,mistweaver,12,5,7
Chronost,sargeras,480,monk,mistweaver,12,5,7
Kungfused,antonidas,480,monk,mistweaver,12,5,7
Joggï,stormrage,480,monk,mistweaver,12,5,7
Serpp,kelthuzad,480,monk,mistweaver,12,5,7
Masonn,kiljaeden,480,monk,mistweaver,12,5,7
Tigerlust,sargeras,480,monk,mistweaver,12,5,7
Crìstiano,malganis,480,monk,mistweaver,12,5,7
Amybaby,sargeras,480,monk,mistweaver,12,5,7
Btipton,tichondrius,480,monk,mistweaver,12,5,7
Biggyballs,tichondrius,480,monk,mistweaver,12,5,7
Brewtari,whisperwind,480,monk,mistweaver,12,5,7
Wdsprdpanic,tichondrius,480,monk,mistweaver,12,5,7
Ìsrael,sargeras,480,monk,mistweaver,12,5,7
Judo,khadgar,480,monk,mistweaver,12,5,7
Rawmonk,malganis,480,monk,mistweaver,12,5,7
Cloudl,silvermoon,480,monk,mistweaver,12,5,7
Thehomìe,tichondrius,480,monk,mistweaver,12,5,7
Whipllash,tichondrius,480,monk,mistweaver,12,5,7
Zlatân,sargeras,480,monk,mistweaver,12,5,7
Rzeznik,boulderfist,480,monk,mistweaver,12,5,7
Vashnir,lothar,480,monk,mistweaver,12,5,7
Kimjongkick,sargeras,480,monk,mistweaver,12,5,7
Kaiøken,tichondrius,480,monk,mistweaver,12,5,7
Zarrend,stormrage,480,monk,mistweaver,12,5,7
Kokweaver,sargeras,480,monk,mistweaver,12,5,7
Linxiss,tichondrius,480,monk,mistweaver,12,5,7
Odradek,thunderlord,480,monk,mistweaver,12,5,7
Jumexo,sargeras,480,monk,mistweaver,12,5,7
Skyrim,tichondrius,480,monk,mistweaver,18,5,13
Sagapunch,hyjal,480,monk,mistweaver,18,5,13
Duckpond,nerzhul,480,monk,mistweaver,18,5,13
Bruiseu,illidan,480,monk,mistweaver,18,5,13
Blackflag,queldorei,480,monk,mistweaver,18,5,13
Sna,dragonmaw,480,monk,mistweaver,18,5,13
Porkmist,icecrown,480,monk,mistweaver,18,5,13
Théophila,illidan,480,monk,mistweaver,18,5,13
Màngø,ragnaros,480,monk,mistweaver,24,5,19
Cckknckr,sargeras,480,monk,mistweaver,24,5,19
Badkarmasix,tichondrius,479,monk,mistweaver,6,5,1
Monqq,tichondrius,479,monk,mistweaver,6,5,1
Paleira,emerald-dream,479,monk,mistweaver,6,5,1
Paticus,area-52,479,monk,mistweaver,12,5,7
Wisepaw,tichondrius,479,monk,mistweaver,12,5,7
Annara,tichondrius,479,monk,mistweaver,12,5,7
Deadlee,stormreaver,479,monk,mistweaver,12,5,7
Tianhu,sargeras,479,monk,mistweaver,12,5,7
Qi,draktharon,479,monk,mistweaver,12,5,7
Chimpo,ragnaros,479,monk,mistweaver,12,5,7
Bitrau,destromath,479,monk,mistweaver,12,5,7
Satchelgizmo,tichondrius,479,monk,mistweaver,18,5,13
Westchi,arthas,479,monk,mistweaver,18,5,13
Manxxin,illidan,479,monk,mistweaver,18,5,13
Ltsneaky,bladefist,479,monk,mistweaver,30,5,25
Cahuun,baelgun,478,monk,mistweaver,12,5,7
Moojìtsu,stormrage,478,monk,mistweaver,12,5,7
Squidbillie,moon-guard,478,monk,mistweaver,12,5,7
Anußisito,stormrage,478,monk,mistweaver,18,5,13
Tutulee,tichondrius,477,monk,mistweaver,6,5,1
Atsudamonk,illidan,477,monk,mistweaver,12,5,7
Sputnîk,nemesis,468,monk,mistweaver,22,10,12
Drgigglez,tichondrius,463,monk,mistweaver,11,5,6
Majinyooshi,kelthuzad,448,monk,mistweaver,10,5,5
Jentmonk,tichondrius,448,monk,mistweaver,10,5,5
Scoopyafupa,illidan,447,monk,mistweaver,8,6,2
Moistspot,frostmourne,447,monk,mistweaver,8,6,2
Graoul,thaurissan,447,monk,mistweaver,11,5,6
Bengal,arthas,447,monk,mistweaver,11,5,6
Hooverphonic,ragnaros,447,monk,mistweaver,11,5,6
Indrazzxx,jubeithos,426,monk,mistweaver,11,7,4
Bellátíx,quelthalas,426,monk,mistweaver,17,9,8
Mindengo,sargeras,426,monk,mistweaver,15,7,8
Durath,burning-blade,415,monk,mistweaver,10,5,5
Dankestkhan,korialstrasz,415,monk,mistweaver,11,5,6
Snmonk,illidan,384,monk,mistweaver,6,4,2
Raires,tichondrius,384,monk,mistweaver,6,4,2
Zamzae,tichondrius,384,monk,mistweaver,6,4,2
Balduglybaby,tichondrius,384,monk,mistweaver,6,4,2
Lingerer,aerie-peak,384,monk,mistweaver,6,4,2
Kharazina,azralon,384,monk,mistweaver,6,4,2
Fistfyre,kiljaeden,384,monk,mistweaver,6,4,2
Orangechróme,area-52,384,monk,mistweaver,6,4,2
Healkinxo,tichondrius,384,monk,mistweaver,6,4,2
Monkinator,anvilmar,384,monk,mistweaver,6,4,2
Howziexd,tichondrius,384,monk,mistweaver,6,4,2
Põng,tichondrius,384,monk,mistweaver,6,4,2
Kwazinator,area-52,384,monk,mistweaver,6,4,2
Jâzze,zuljin,384,monk,mistweaver,6,4,2
Punteeftw,sargeras,384,monk,mistweaver,6,4,2
Drchake,quelthalas,384,monk,mistweaver,6,4,2
Jabtrak,kargath,384,monk,mistweaver,6,4,2
Dakism,sargeras,384,monk,mistweaver,6,4,2
Chänx,tichondrius,384,monk,mistweaver,6,4,2
Levoz,area-52,384,monk,mistweaver,6,4,2
Blpkosher,tichondrius,384,monk,mistweaver,6,4,2
Kruznîk,illidan,384,monk,mistweaver,6,4,2
Veylana,tichondrius,384,monk,mistweaver,6,4,2
Justamönk,moon-guard,384,monk,mistweaver,6,4,2
Nipfuu,maelstrom,384,monk,mistweaver,6,4,2
Danie,nerzhul,384,monk,mistweaver,6,4,2
Avendare,tichondrius,384,monk,mistweaver,6,4,2
Kàdè,dalaran,384,monk,mistweaver,6,4,2
Notdustin,illidan,384,monk,mistweaver,6,4,2
Sleepyxo,tichondrius,384,monk,mistweaver,6,4,2
Macnia,frostmourne,384,monk,mistweaver,6,4,2
Chopana,malganis,384,monk,mistweaver,6,4,2
Lexxiara,dalaran,384,monk,mistweaver,6,4,2
Tubshark,kelthuzad,384,monk,mistweaver,6,4,2
Anzulumonk,alexstrasza,384,monk,mistweaver,6,4,2
Sunnfistway,sargeras,384,monk,mistweaver,6,4,2
Neverfake,frostmourne,384,monk,mistweaver,6,4,2
Scovillah,emerald-dream,384,monk,mistweaver,6,4,2
Keyndanlamor,sargeras,384,monk,mistweaver,6,4,2
Vetism,thrall,384,monk,mistweaver,6,4,2
Dude,tichondrius,384,monk,mistweaver,6,4,2
Brucetea,chogall,384,monk,mistweaver,6,4,2
Shakeweightt,blackrock,384,monk,mistweaver,6,4,2
Beersmonk,tichondrius,384,monk,mistweaver,6,4,2
Talker,stormrage,384,monk,mistweaver,6,4,2
Delsiya,stormrage,384,monk,mistweaver,6,4,2
Mydx,thrall,384,monk,mistweaver,6,4,2
Spoderkeeper,tichondrius,384,monk,mistweaver,6,4,2
Nikitip,tichondrius,384,monk,mistweaver,6,4,2
Keepcryin,gorefiend,384,monk,mistweaver,6,4,2
Denji,staghelm,384,monk,mistweaver,6,4,2
Saren,nordrassil,384,monk,mistweaver,6,4,2
Lyla,aegwynn,384,monk,mistweaver,6,4,2
Alshee,nagrand,384,monk,mistweaver,6,4,2
Dottings,sargeras,384,monk,mistweaver,6,4,2
Doodoodookie,thunderhorn,384,monk,mistweaver,6,4,2
Tinyboots,area-52,384,monk,mistweaver,6,4,2
Snoogiee,khazgoroth,384,monk,mistweaver,6,4,2
Glorioushole,area-52,384,monk,mistweaver,6,4,2
Chopsake,khadgar,384,monk,mistweaver,6,4,2
Wecksoe,area-52,384,monk,mistweaver,6,4,2
Facepalmx,nemesis,384,monk,mistweaver,6,4,2
Brewtea,sargeras,384,monk,mistweaver,6,4,2
Loafymonk,stormrage,384,monk,mistweaver,6,4,2
Demonfu,stormrage,384,monk,mistweaver,6,4,2
Rizzjutsu,stormrage,384,monk,mistweaver,6,4,2
Stellae,emerald-dream,384,monk,mistweaver,10,5,5
Plopnspheres,arthas,384,monk,mistweaver,10,4,6
Findorato,windrunner,384,monk,mistweaver,12,4,8
Nicolascåge,destromath,384,monk,mistweaver,12,4,8
Greentea,kaelthas,384,monk,mistweaver,12,4,8
Tanipto,tichondrius,384,monk,mistweaver,12,4,8
Fluffykaboom,destromath,384,monk,mistweaver,12,4,8
Mingfei,uther,384,monk,mistweaver,12,4,8
Macktickle,zuljin,384,monk,mistweaver,12,4,8
Yunei,tichondrius,384,monk,mistweaver,12,4,8
Darylphilbin,emerald-dream,384,monk,mistweaver,12,4,8
Jimbojenkins,bleeding-hollow,384,monk,mistweaver,12,4,8
Rìzzo,tichondrius,384,monk,mistweaver,12,4,8
Lazy,shattered-halls,384,monk,mistweaver,12,4,8
Jincíe,area-52,384,monk,mistweaver,12,4,8
Zënløvë,tichondrius,384,monk,mistweaver,12,4,8
Pax,boulderfist,384,monk,mistweaver,12,4,8
Mockz,dentarg,384,monk,mistweaver,12,4,8
Neversweep,tichondrius,384,monk,mistweaver,12,4,8
Shredmw,tichondrius,384,monk,mistweaver,12,4,8
Pandàmonium,frostmourne,384,monk,mistweaver,12,4,8
Ronash,hydraxis,384,monk,mistweaver,12,4,8
Nutbag,norgannon,384,monk,mistweaver,12,4,8
Sprinkli,sargeras,384,monk,mistweaver,12,4,8
Migchi,sargeras,384,monk,mistweaver,12,4,8
Guleum,tichondrius,384,monk,mistweaver,12,4,8
Mõnk,illidan,384,monk,mistweaver,12,4,8
Hoyocochino,quelthalas,384,monk,mistweaver,12,4,8
Windwalken,sargeras,384,monk,mistweaver,12,4,8
Fistorcstar,daggerspine,384,monk,mistweaver,12,4,8
Mccoy,quelthalas,384,monk,mistweaver,12,4,8
Galsello,moon-guard,384,monk,mistweaver,12,4,8
Sim,frostmourne,384,monk,mistweaver,12,4,8
Darkeiji,stormrage,384,monk,mistweaver,12,4,8
Frankènmonk,illidan,384,monk,mistweaver,12,4,8
Valkana,kelthuzad,384,monk,mistweaver,12,4,8
Róokie,tichondrius,384,monk,mistweaver,12,4,8
Iamapotato,tichondrius,384,monk,mistweaver,18,4,14
Therivermist,tichondrius,383,monk,mistweaver,6,4,2
Squishyfaces,wyrmrest-accord,383,monk,mistweaver,6,4,2
Tsukuyômi,thrall,383,monk,mistweaver,6,4,2
Zinque,emerald-dream,383,monk,mistweaver,6,4,2
Jigong,bleeding-hollow,383,monk,mistweaver,12,4,8
Esleif,moonrunner,383,monk,mistweaver,12,4,8
Zyemell,tichondrius,383,monk,mistweaver,12,4,8
Fvl,barthilas,383,monk,mistweaver,12,4,8
Izgoku,frostmane,383,monk,mistweaver,18,4,14
Rekque,amanthul,383,monk,mistweaver,30,4,26
Rollbot,kelthuzad,382,monk,mistweaver,6,4,2
Baaron,sargeras,382,monk,mistweaver,12,4,8
Sence,lightnings-blade,382,monk,mistweaver,18,4,14
Kurrama,twisting-nether,381,monk,mistweaver,12,4,8
Jeme,tichondrius,379,monk,mistweaver,12,4,8
Chickntendys,sargeras,361,monk,mistweaver,21,6,15
Sáble,stormrage,351,monk,mistweaver,11,4,7
Daddywarpig,tichondrius,336,monk,mistweaver,9,4,5
Zhihua,moon-guard,336,monk,mistweaver,21,4,17
Clericninja,illidan,330,monk,mistweaver,9,6,3
ßiggiesmallz,barthilas,330,monk,mistweaver,12,5,7
Yenizä,illidan,330,monk,mistweaver,15,5,10
Stunnedheals,arthas,330,monk,mistweaver,16,5,11
Xiaovega,dalaran,329,monk,mistweaver,16,5,11
Kimchidelite,gorefiend,319,monk,mistweaver,5,4,1
Mikuohashi,amanthul,319,monk,mistweaver,5,4,1
Hauntings,hellscream,319,monk,mistweaver,5,4,1
Zønnis,zuljin,298,monk,mistweaver,14,9,5
Cashina,azralon,288,monk,mistweaver,6,3,3
Fammi,stormrage,288,monk,mistweaver,6,3,3
Stigzz,stormrage,288,monk,mistweaver,6,3,3
ßöe,sargeras,288,monk,mistweaver,6,3,3
Skâ,kiljaeden,288,monk,mistweaver,6,3,3
Spacoli,stormrage,288,monk,mistweaver,6,3,3
Furrykisser,tichondrius,288,monk,mistweaver,6,3,3
Thiccstroke,illidan,288,monk,mistweaver,6,3,3
Tambher,lightbringer,288,monk,mistweaver,6,3,3
Nomonko,tichondrius,288,monk,mistweaver,6,3,3
Voguex,area-52,288,monk,mistweaver,6,3,3
Feelsogöod,tichondrius,288,monk,mistweaver,6,3,3
Psii,the-venture-co,288,monk,mistweaver,6,3,3
Kotonnoha,quelthalas,288,monk,mistweaver,6,3,3
Aphrodîîte,area-52,288,monk,mistweaver,6,3,3
Dkdakìng,stormrage,288,monk,mistweaver,6,3,3
Bosschops,illidan,288,monk,mistweaver,6,3,3
Punchberry,illidan,288,monk,mistweaver,6,3,3
Fysicalx,stormrage,288,monk,mistweaver,6,3,3
Mystï,silvermoon,288,monk,mistweaver,6,3,3
Grababutt,sargeras,288,monk,mistweaver,6,3,3
Ase,frostwolf,288,monk,mistweaver,6,3,3
Cädemaddöx,stormrage,288,monk,mistweaver,6,3,3
Rasgacrú,stormrage,288,monk,mistweaver,6,3,3
Seshiro,area-52,288,monk,mistweaver,6,3,3
Teclas,ragnaros,288,monk,mistweaver,6,3,3
Dedmk,azralon,288,monk,mistweaver,6,3,3
Lundch,tichondrius,288,monk,mistweaver,6,3,3
Austaar,frostmourne,288,monk,mistweaver,6,3,3
Madson,darkspear,288,monk,mistweaver,6,3,3
Chayim,wyrmrest-accord,288,monk,mistweaver,6,3,3
Seii,ravenholdt,288,monk,mistweaver,6,3,3
Lemeta,tichondrius,288,monk,mistweaver,6,3,3
Möösê,moon-guard,288,monk,mistweaver,6,3,3
Canofwoopas,dalaran,288,monk,mistweaver,6,3,3
Baelmao,wyrmrest-accord,288,monk,mistweaver,6,3,3
Densíty,kiljaeden,288,monk,mistweaver,6,3,3
Arinix,tichondrius,288,monk,mistweaver,6,3,3
Marçi,moon-guard,288,monk,mistweaver,6,3,3
Chingu,ragnaros,288,monk,mistweaver,6,3,3
Jtrâin,frostmourne,288,monk,mistweaver,6,3,3
Swansational,sargeras,288,monk,mistweaver,6,3,3
Gguldduck,tichondrius,288,monk,mistweaver,6,3,3
Tunaroll,tichondrius,288,monk,mistweaver,6,3,3
Flakkon,hyjal,288,monk,mistweaver,6,3,3
Omnivò,emerald-dream,288,monk,mistweaver,6,3,3
Facekandy,tichondrius,288,monk,mistweaver,6,3,3
Organiccs,tichondrius,288,monk,mistweaver,6,3,3
Chaipie,kelthuzad,288,monk,mistweaver,6,3,3
Vidrus,gorefiend,288,monk,mistweaver,6,3,3
Notcheez,area-52,288,monk,mistweaver,6,3,3
Grogio,wyrmrest-accord,288,monk,mistweaver,6,3,3
Quartztiger,sargeras,288,monk,mistweaver,6,3,3
Ðreadhot,malganis,288,monk,mistweaver,6,3,3
Kayla,ursin,288,monk,mistweaver,6,3,3
Duckingkarma,tichondrius,288,monk,mistweaver,6,3,3
Spiritmist,sargeras,288,monk,mistweaver,6,3,3
Quander,tichondrius,288,monk,mistweaver,6,3,3
Darches,quelthalas,288,monk,mistweaver,6,3,3
Hotwangs,jubeithos,288,monk,mistweaver,6,3,3
Foxjade,thrall,288,monk,mistweaver,6,3,3
Jabjabjabjab,korgath,288,monk,mistweaver,6,3,3
Drockzo,wyrmrest-accord,288,monk,mistweaver,6,3,3
Lyántrying,korgath,288,monk,mistweaver,6,3,3
Imisswodxo,illidan,288,monk,mistweaver,6,3,3
Droppinfast,sargeras,288,monk,mistweaver,6,3,3
Macproblem,malganis,288,monk,mistweaver,6,3,3
Fistin,laughing-skull,288,monk,mistweaver,6,3,3
Streetcreds,bleeding-hollow,288,monk,mistweaver,6,3,3
Ighostgirls,thrall,288,monk,mistweaver,6,3,3
Zamerà,bleeding-hollow,288,monk,mistweaver,6,3,3
Mipkek,saurfang,288,monk,mistweaver,6,3,3
Dbgzx,illidan,288,monk,mistweaver,6,3,3
Leeleeyong,tichondrius,288,monk,mistweaver,6,3,3
Maybeyooshi,kelthuzad,288,monk,mistweaver,6,3,3
Zóë,korgath,288,monk,mistweaver,6,3,3
Hundski,bleeding-hollow,288,monk,mistweaver,6,3,3
Greenteafrãp,bleeding-hollow,288,monk,mistweaver,6,3,3
Kúrios,azralon,288,monk,mistweaver,10,3,7
Powert,bleeding-hollow,288,monk,mistweaver,12,3,9
Gentlefists,sargeras,288,monk,mistweaver,12,3,9
Fitofryfitof,aegwynn,288,monk,mistweaver,12,3,9
Wørm,emerald-dream,288,monk,mistweaver,12,3,9
Katalina,alexstrasza,288,monk,mistweaver,12,3,9
Korvishka,malganis,288,monk,mistweaver,12,3,9
Wizcaulifa,stormrage,288,monk,mistweaver,12,3,9
Luckystrike,area-52,288,monk,mistweaver,12,3,9
Dreadneck,sargeras,288,monk,mistweaver,12,3,9
Hixemonk,illidan,288,monk,mistweaver,12,3,9
Mwtouch,nemesis,288,monk,mistweaver,12,3,9
Selfîe,ysera,288,monk,mistweaver,12,3,9
Øtpp,sargeras,288,monk,mistweaver,12,3,9
Imakiya,tichondrius,288,monk,mistweaver,17,3,14
Pikafist,tichondrius,287,monk,mistweaver,6,3,3
Gatsbi,arthas,287,monk,mistweaver,6,3,3
Deyseddia,azgalor,287,monk,mistweaver,6,3,3
Holandri,moon-guard,287,monk,mistweaver,6,3,3
Iarw,tichondrius,287,monk,mistweaver,6,3,3
Alanimistw,khadgar,287,monk,mistweaver,6,3,3
Fistidmi,area-52,287,monk,mistweaver,11,4,7
Shlumpuh,tichondrius,287,monk,mistweaver,16,4,12
Uninvited,perenolde,286,monk,mistweaver,6,3,3
Lilpielover,zuljin,286,monk,mistweaver,15,4,11
Klassik,thrall,286,monk,mistweaver,21,4,17
Timjongill,stormrage,271,monk,mistweaver,11,3,8
Fingies,garrosh,271,monk,mistweaver,11,3,8
Condem,malfurion,271,monk,mistweaver,17,3,14
Lildae,burning-legion,256,monk,mistweaver,4,4,0
Gaynpetty,proudmoore,256,monk,mistweaver,4,4,0
Azulinfinito,quelthalas,256,monk,mistweaver,4,4,0
Koragro,tichondrius,239,monk,mistweaver,5,3,2
Isit,vashj,234,monk,mistweaver,9,4,5
Zeisei,wyrmrest-accord,234,monk,mistweaver,10,4,6
Kåelarayn,moon-guard,234,monk,mistweaver,13,4,9
Hirado,kelthuzad,234,monk,mistweaver,16,4,12
Friedpanda,kelthuzad,234,monk,mistweaver,16,4,12
Shaotee,tichondrius,208,monk,mistweaver,7,3,4
Fujiô,illidan,192,monk,mistweaver,4,3,1
Furryfisttin,illidan,192,monk,mistweaver,8,3,5
Absurd,mannoroth,192,monk,mistweaver,8,3,5
Jaybum,sargeras,192,monk,mistweaver,6,2,4
Hitchslapz,tichondrius,192,monk,mistweaver,6,2,4
Foxmacleod,bleeding-hollow,192,monk,mistweaver,6,2,4
Torpedo,blackrock,192,monk,mistweaver,6,2,4
Ricecákez,alterac-mountains,192,monk,mistweaver,6,2,4
Omashu,nemesis,192,monk,mistweaver,6,2,4
Tarae,nagrand,192,monk,mistweaver,6,2,4
Gaudchi,tichondrius,192,monk,mistweaver,6,2,4
Vams,barthilas,192,monk,mistweaver,6,2,4
Fäded,trollbane,192,monk,mistweaver,6,2,4
Zengoku,zuljin,192,monk,mistweaver,6,2,4
Udjun,bleeding-hollow,192,monk,mistweaver,6,2,4
Apparent,lightnings-blade,192,monk,mistweaver,6,2,4
Skadouch,wyrmrest-accord,192,monk,mistweaver,6,2,4
Bamboøzled,daggerspine,192,monk,mistweaver,6,2,4
Zåz,nazgrel,192,monk,mistweaver,6,2,4
Privm,moonrunner,192,monk,mistweaver,6,2,4
Theriní,stormrage,192,monk,mistweaver,6,2,4
Flexmonk,barthilas,192,monk,mistweaver,6,2,4
Demödras,stormrage,192,monk,mistweaver,6,2,4
Djbluezx,tichondrius,192,monk,mistweaver,6,2,4
Kickflipy,dalaran,192,monk,mistweaver,6,2,4
Aquamonk,tichondrius,192,monk,mistweaver,6,2,4
Selocke,bleeding-hollow,192,monk,mistweaver,6,2,4
Caralia,exodar,192,monk,mistweaver,6,2,4
Krucíal,illidan,192,monk,mistweaver,6,2,4
Drfistyfingr,malganis,192,monk,mistweaver,6,2,4
Quickhands,dalaran,192,monk,mistweaver,6,2,4
Acena,stormrage,192,monk,mistweaver,6,2,4
Lilknucks,bonechewer,192,monk,mistweaver,6,2,4
Gyatso,aegwynn,192,monk,mistweaver,6,2,4
Touchbot,tichondrius,192,monk,mistweaver,6,2,4
Fïstbeaver,malganis,192,monk,mistweaver,6,2,4
Fortnight,emerald-dream,192,monk,mistweaver,6,2,4
Iililiililil,stormrage,192,monk,mistweaver,6,2,4
Sebasu,perenolde,192,monk,mistweaver,6,2,4
Tommywiseau,amanthul,192,monk,mistweaver,6,2,4
Bamboozle,blackrock,192,monk,mistweaver,6,2,4
Ramhemi,kiljaeden,192,monk,mistweaver,6,2,4
Jittersx,silvermoon,192,monk,mistweaver,6,2,4
Ashenn,area-52,192,monk,mistweaver,6,2,4
Kîkû,moon-guard,192,monk,mistweaver,6,2,4
Banidiin,moon-guard,192,monk,mistweaver,6,2,4
Bodyshot,area-52,192,monk,mistweaver,6,2,4
Primez,frostmourne,192,monk,mistweaver,6,2,4
Xanzee,area-52,192,monk,mistweaver,6,2,4
Mistbeard,aggramar,192,monk,mistweaver,6,2,4
Broxxenidas,quelthalas,192,monk,mistweaver,6,2,4
Nilonsso,sargeras,192,monk,mistweaver,6,2,4
Onepunch,exodar,192,monk,mistweaver,7,2,5
Coffeek,area-52,192,monk,mistweaver,8,2,6
Glowsgreenby,area-52,192,monk,mistweaver,8,2,6
Diggster,area-52,192,monk,mistweaver,9,2,7
Tacoma,sargeras,192,monk,mistweaver,12,2,10
Salzamonk,aggramar,192,monk,mistweaver,12,2,10
Monkik,laughing-skull,192,monk,mistweaver,12,2,10
Gândhi,kiljaeden,192,monk,mistweaver,12,2,10
Missmagda,darkspear,192,monk,mistweaver,12,2,10
Ðetroitsmash,sargeras,192,monk,mistweaver,12,2,10
Kick,dragonmaw,192,monk,mistweaver,12,2,10
Fuchizaki,ragnaros,192,monk,mistweaver,12,2,10
Whynotec,tichondrius,192,monk,mistweaver,12,2,10
Bubblekit,nerzhul,192,monk,mistweaver,12,2,10
Sanytea,sargeras,192,monk,mistweaver,12,2,10
Hunglikejfk,thrall,192,monk,mistweaver,12,2,10
Taymonk,stormrage,192,monk,mistweaver,12,2,10
Göönsqüäd,moon-guard,192,monk,mistweaver,12,2,10
Yomamaflo,wildhammer,192,monk,mistweaver,12,2,10
Mung,boulderfist,192,monk,mistweaver,12,2,10
Chuggernaut,illidan,192,monk,mistweaver,15,2,13
Fatde,daggerspine,192,monk,mistweaver,18,2,16
Farmerstan,sargeras,192,monk,mistweaver,18,2,16
Blazebeast,blackhand,191,monk,mistweaver,6,2,4
Senzmist,lightbringer,191,monk,mistweaver,6,2,4
Honestworkz,area-52,191,monk,mistweaver,6,2,4
Melliex,hakkar,191,monk,mistweaver,6,2,4
Realisthands,barthilas,191,monk,mistweaver,6,2,4
Rorik,deathwing,191,monk,mistweaver,12,2,10
Phystweaver,malganis,175,monk,mistweaver,11,2,9
Fistaholic,turalyon,159,monk,mistweaver,5,2,3
Pathad,stormrage,159,monk,mistweaver,5,2,3
Duskier,garithos,144,monk,mistweaver,3,3,0
Miestro,tichondrius,138,monk,mistweaver,6,3,3
Spicybrew,tichondrius,138,monk,mistweaver,7,3,4
Wifflenut,tichondrius,138,monk,mistweaver,11,4,7
Fijiwater,stormrage,138,monk,mistweaver,9,3,6
ßøøstêðçhåñ,illidan,138,monk,mistweaver,9,3,6
Slimweaver,stormrage,138,monk,mistweaver,13,4,9
Vyostao,ragnaros,138,monk,mistweaver,11,3,8
Averagéjoe,tichondrius,127,monk,mistweaver,8,2,6
Lyghtweight,stormrage,96,monk,mistweaver,3,2,1
Mysstickle,icecrown,96,monk,mistweaver,3,2,1
Rïggen,thrall,96,monk,mistweaver,3,2,1
Lainerya,moon-guard,96,monk,mistweaver,6,1,5
Dirack,quelthalas,96,monk,mistweaver,6,1,5
Rockfu,illidan,96,monk,mistweaver,6,1,5
Ruion,moon-guard,96,monk,mistweaver,6,1,5
Kayakpunch,moon-guard,96,monk,mistweaver,6,1,5
Tedbondy,moon-guard,96,monk,mistweaver,6,1,5
Meniscusmonk,emerald-dream,96,monk,mistweaver,6,1,5
Kungfucheeks,illidan,96,monk,mistweaver,6,1,5
Ünarù,area-52,96,monk,mistweaver,6,1,5
Stickyloads,illidan,96,monk,mistweaver,6,1,5
Froggie,illidan,96,monk,mistweaver,6,1,5
Jamesboong,illidan,96,monk,mistweaver,6,1,5
Criminall,aegwynn,96,monk,mistweaver,6,1,5
Fatboyswag,tichondrius,96,monk,mistweaver,6,1,5
Shrimptown,dalaran,96,monk,mistweaver,6,1,5
Limejuulpod,malganis,96,monk,mistweaver,6,1,5
Daeio,burning-legion,96,monk,mistweaver,6,1,5
Kaÿñ,area-52,96,monk,mistweaver,6,1,5
Tofugoku,area-52,96,monk,mistweaver,6,1,5
Emrose,demon-soul,96,monk,mistweaver,6,1,5
Danicah,altar-of-storms,96,monk,mistweaver,6,1,5
Zrza,tichondrius,96,monk,mistweaver,6,1,5
Cosome,tichondrius,96,monk,mistweaver,6,1,5
Turkeydinner,frostmourne,96,monk,mistweaver,6,1,5
Naveex,bleeding-hollow,96,monk,mistweaver,6,1,5
Raylá,kelthuzad,96,monk,mistweaver,6,1,5
Kimmyfists,tichondrius,96,monk,mistweaver,6,1,5
Twistedchi,stormrage,96,monk,mistweaver,6,1,5
Haandz,moon-guard,96,monk,mistweaver,6,1,5
Lomist,nazjatar,96,monk,mistweaver,6,1,5
Ezpzmonk,bloodscalp,96,monk,mistweaver,6,1,5
Monkuxe,zuljin,96,monk,mistweaver,6,1,5
Kenvuki,emerald-dream,96,monk,mistweaver,6,1,5
Notthefather,area-52,96,monk,mistweaver,6,1,5
Sheff,daggerspine,96,monk,mistweaver,6,1,5
Bannedbybliz,thrall,96,monk,mistweaver,6,1,5
Vesija,sargeras,96,monk,mistweaver,6,1,5
Punchlord,saurfang,96,monk,mistweaver,6,1,5
Tzobee,stormrage,96,monk,mistweaver,6,1,5
Súprä,stormrage,96,monk,mistweaver,6,1,5
Samaera,uther,96,monk,mistweaver,6,1,5
Charrek,zuljin,96,monk,mistweaver,6,1,5
Kiawe,zuljin,96,monk,mistweaver,6,1,5
Faméd,stormrage,96,monk,mistweaver,8,1,7
Zenmidget,kelthuzad,96,monk,mistweaver,12,1,11
Ghostsofur,tichondrius,96,monk,mistweaver,12,1,11
Eliwenn,ragnaros,96,monk,mistweaver,12,1,11
Selectra,malfurion,95,monk,mistweaver,6,1,5
Fairymonk,frostwolf,79,monk,mistweaver,5,1,4
Clixstermonk,area-52,79,monk,mistweaver,5,1,4
Thalreyzian,vashj,64,monk,mistweaver,4,1,3
Rockxtv,illidan,63,monk,mistweaver,2,2,0
Deethnutth,bleeding-hollow,63,monk,mistweaver,2,2,0
Tenptonefotm,bleeding-hollow,42,monk,mistweaver,6,2,4
Fumoo,sargeras,42,monk,mistweaver,10,3,7
Mataleao,emerald-dream,42,monk,mistweaver,10,2,8
Critorgtfo,tanaris,42,monk,mistweaver,10,2,8
Whtnyhuston,sargeras,42,monk,mistweaver,12,2,10
Ccdog,amanthul,31,monk,mistweaver,2,1,1
Vazana,moon-guard,30,monk,mistweaver,18,7,11
Worldpvp,nerzhul,1461,monk,brewmaster,45,19,26
Robbo,tichondrius,1333,monk,brewmaster,36,14,22
Epucphail,kelthuzad,1221,monk,brewmaster,78,33,45
Daesun,quelthalas,1143,monk,brewmaster,24,12,12
Omgar,frostmourne,1046,monk,brewmaster,44,17,27
Chochas,tichondrius,660,monk,brewmaster,18,7,11
Rín,dalaran,521,monk,brewmaster,19,7,12
Morpheous,whisperwind,383,monk,brewmaster,6,4,2
Doughboy,skullcrusher,383,monk,brewmaster,12,4,8
Akhar,nazgrel,288,monk,brewmaster,6,3,3
Genié,moon-guard,288,monk,brewmaster,6,3,3
Lonebamboo,tichondrius,288,monk,brewmaster,12,3,9
Quaria,moon-guard,288,monk,brewmaster,18,3,15
Daedae,quelthalas,192,monk,brewmaster,8,3,5
Sistuhfista,tichondrius,192,monk,brewmaster,6,2,4
Drunkfight,zuljin,192,monk,brewmaster,18,2,16
Encry,zuljin,191,monk,brewmaster,6,2,4
Ferrarí,quelthalas,79,monk,brewmaster,11,1,10
Iminglee,area-52,2320,monk,windwalker,130,70,60
Hwoärang,stormrage,2300,monk,windwalker,95,54,41
Neighbors,sargeras,2285,monk,windwalker,241,127,114
Keyam,illidan,2208,monk,windwalker,101,54,47
Primez,frostmourne,2206,monk,windwalker,88,46,42
Edenx,sargeras,2172,monk,windwalker,72,42,30
Judo,agamaggan,2171,monk,windwalker,92,48,44
Riversøng,frostmourne,2158,monk,windwalker,108,59,49
Sean,nazjatar,2143,monk,windwalker,72,38,34
Senseiww,sargeras,2143,monk,windwalker,126,64,62
Hypnøtìze,frostmourne,2142,monk,windwalker,215,116,99
Rytes,moon-guard,2137,monk,windwalker,207,112,95
Pacmankr,tichondrius,2135,monk,windwalker,153,80,73
Thewy,tichondrius,2132,monk,windwalker,108,55,53
Cmx,sargeras,2125,monk,windwalker,172,88,84
Bigherosixx,tichondrius,2124,monk,windwalker,144,78,66
Wwlékinhø,azralon,2118,monk,windwalker,147,85,62
Chyx,tichondrius,2113,monk,windwalker,112,57,55
Xyän,bleeding-hollow,2112,monk,windwalker,94,47,47
Flattsww,tichondrius,2111,monk,windwalker,274,140,134
Kranelo,tichondrius,2107,monk,windwalker,66,41,25
Robbo,tichondrius,2106,monk,windwalker,89,47,42
Larryjonés,area-52,2105,monk,windwalker,215,111,104
Rickybobbyx,vashj,2103,monk,windwalker,125,64,61
Catgallery,tichondrius,2102,monk,windwalker,233,119,114
Iílílílílílí,area-52,2101,monk,windwalker,84,43,41
Homun,tichondrius,2100,monk,windwalker,94,46,48
Percentx,tichondrius,2090,monk,windwalker,78,39,39
Stárset,illidan,2076,monk,windwalker,102,56,46
Chopt,zuljin,2052,monk,windwalker,119,59,60
Rosetune,area-52,2040,monk,windwalker,48,39,9
Liamllama,barthilas,2036,monk,windwalker,182,95,87
Fatal,bonechewer,2032,monk,windwalker,148,79,69
Fínzy,tichondrius,2031,monk,windwalker,279,144,135
Xølik,draenor,2019,monk,windwalker,60,43,17
Fueld,burning-legion,2013,monk,windwalker,438,218,220
Blackpandax,tichondrius,2008,monk,windwalker,107,55,52
Droguex,tichondrius,1997,monk,windwalker,308,147,161
Spotifyfan,ysera,1995,monk,windwalker,195,106,89
Helvectius,tichondrius,1994,monk,windwalker,246,122,124
Dalearnhardt,proudmoore,1991,monk,windwalker,65,38,27
Hakri,arthas,1987,monk,windwalker,30,21,9
Madtiger,scilla,1978,monk,windwalker,135,69,66
Xueyu,malganis,1971,monk,windwalker,60,33,27
Cuteirl,tichondrius,1970,monk,windwalker,84,53,31
Shïvïr,azralon,1962,monk,windwalker,207,107,100
Crashandflow,zuljin,1961,monk,windwalker,60,33,27
Imasterl,proudmoore,1958,monk,windwalker,75,39,36
Omnly,stormrage,1957,monk,windwalker,62,34,28
Inbu,tichondrius,1957,monk,windwalker,158,79,79
Bdw,tichondrius,1955,monk,windwalker,142,84,58
Mikeyx,area-52,1941,monk,windwalker,48,25,23
Wondý,quelthalas,1935,monk,windwalker,178,89,89
Repbrew,sargeras,1933,monk,windwalker,93,46,47
Touchofdeáth,stormrage,1931,monk,windwalker,173,92,81
Baddi,uldum,1931,monk,windwalker,160,82,78
Dzq,zuljin,1924,monk,windwalker,110,60,50
Nehji,illidan,1924,monk,windwalker,159,79,80
Yuujitsu,sargeras,1923,monk,windwalker,181,96,85
Threnody,malganis,1920,monk,windwalker,124,61,63
Torkscrew,bleeding-hollow,1919,monk,windwalker,42,25,17
Frootsmoothi,thrall,1919,monk,windwalker,106,52,54
Broomooster,bleeding-hollow,1919,monk,windwalker,65,29,36
Nelariah,wyrmrest-accord,1914,monk,windwalker,82,39,43
Choplo,demon-soul,1911,monk,windwalker,78,43,35
Weathermanxv,kelthuzad,1896,monk,windwalker,123,56,67
Duhäst,sargeras,1895,monk,windwalker,78,46,32
Hiurge,tichondrius,1893,monk,windwalker,108,54,54
Xuenfu,tichondrius,1890,monk,windwalker,36,20,16
Snebyos,tichondrius,1887,monk,windwalker,131,78,53
Lodbork,tichondrius,1887,monk,windwalker,437,223,214
Lhiri,moon-guard,1886,monk,windwalker,65,33,32
Sínsayer,tichondrius,1885,monk,windwalker,159,73,86
Maozhën,tichondrius,1882,monk,windwalker,60,31,29
Nyofu,moon-guard,1879,monk,windwalker,64,32,32
Unhappyclown,tichondrius,1878,monk,windwalker,191,106,85
Jaxvisto,dalaran,1868,monk,windwalker,101,51,50
Tippytap,bleeding-hollow,1867,monk,windwalker,125,62,63
Screwz,tichondrius,1867,monk,windwalker,67,33,34
Ighostgirls,thrall,1860,monk,windwalker,59,29,30
Garypool,emerald-dream,1856,monk,windwalker,33,20,13
Boeycalma,illidan,1855,monk,windwalker,60,36,24
Marçi,moon-guard,1854,monk,windwalker,145,69,76
Gaslighterr,tichondrius,1852,monk,windwalker,69,40,29
Absurd,mannoroth,1852,monk,windwalker,39,22,17
Takkeya,zuljin,1850,monk,windwalker,60,33,27
Smalltall,area-52,1850,monk,windwalker,61,31,30
Mikephoenix,tichondrius,1847,monk,windwalker,139,71,68
Alshee,nagrand,1846,monk,windwalker,45,24,21
Guylian,tichondrius,1845,monk,windwalker,58,30,28
Tschi,illidan,1844,monk,windwalker,42,29,13
Artam,thrall,1844,monk,windwalker,89,51,38
Smokechief,hyjal,1844,monk,windwalker,60,33,27
Züdo,area-52,1841,monk,windwalker,105,55,50
Shisama,area-52,1840,monk,windwalker,68,42,26
Allmight,wyrmrest-accord,1839,monk,windwalker,105,58,47
Sickbanga,barthilas,1839,monk,windwalker,66,33,33
Bunnygal,thaurissan,1838,monk,windwalker,82,43,39
Napbox,bleeding-hollow,1837,monk,windwalker,152,79,73
Vybïn,tichondrius,1837,monk,windwalker,333,166,167
Kuranchi,sargeras,1836,monk,windwalker,42,23,19
Kegrolls,proudmoore,1835,monk,windwalker,42,26,16
Sunfistway,sargeras,1835,monk,windwalker,80,48,32
Karmerr,proudmoore,1835,monk,windwalker,66,35,31
Zeati,tichondrius,1833,monk,windwalker,48,31,17
Peachcactus,sargeras,1833,monk,windwalker,42,27,15
Rockxtv,illidan,1831,monk,windwalker,60,27,33
Jümmy,area-52,1829,monk,windwalker,60,32,28
Shírÿu,azralon,1826,monk,windwalker,101,50,51
Lopez,sargeras,1825,monk,windwalker,54,35,19
Backfliptime,ragnaros,1825,monk,windwalker,46,28,18
Lahri,silvermoon,1824,monk,windwalker,80,48,32
Sckmonk,tichondrius,1824,monk,windwalker,81,34,47
Sylash,ragnaros,1821,monk,windwalker,36,21,15
Zionk,tichondrius,1820,monk,windwalker,120,82,38
Sentomaru,bleeding-hollow,1820,monk,windwalker,66,33,33
Elfoverde,stormrage,1819,monk,windwalker,48,30,18
Danzr,ragnaros,1817,monk,windwalker,54,29,25
Kryptikkyt,gilneas,1815,monk,windwalker,66,35,31
Micai,thrall,1813,monk,windwalker,42,25,17
Bakha,illidan,1812,monk,windwalker,35,22,13
Doczen,malganis,1812,monk,windwalker,60,29,31
Maomaogun,tichondrius,1810,monk,windwalker,42,29,13
Xìðñ,moon-guard,1808,monk,windwalker,102,70,32
Hailan,area-52,1808,monk,windwalker,48,29,19
Heiwei,stormrage,1806,monk,windwalker,36,22,14
Senritsuh,drakkari,1804,monk,windwalker,94,44,50
Turbofist,bleeding-hollow,1803,monk,windwalker,42,25,17
Telospateo,ragnaros,1803,monk,windwalker,50,25,25
Furiamvp,stormrage,1801,monk,windwalker,54,28,26
Accidntprone,zangarmarsh,1801,monk,windwalker,54,28,26
Ghooch,illidan,1800,monk,windwalker,66,39,27
Muhli,kiljaeden,1800,monk,windwalker,42,22,20
Monkatron,arthas,1799,monk,windwalker,125,63,62
Bussÿ,area-52,1796,monk,windwalker,181,89,92
Fátë,tichondrius,1790,monk,windwalker,114,50,64
Brewceo,area-52,1787,monk,windwalker,66,34,32
Jamut,stormrage,1785,monk,windwalker,66,28,38
Dirtypunch,proudmoore,1783,monk,windwalker,60,28,32
Mitras,dragonblight,1782,monk,windwalker,48,29,19
Kimetsu,sargeras,1782,monk,windwalker,94,53,41
Dwarfmonk,tichondrius,1782,monk,windwalker,48,22,26
Innerverse,tichondrius,1781,monk,windwalker,53,26,27
Khawai,sargeras,1780,monk,windwalker,72,40,32
Alps,darkspear,1780,monk,windwalker,48,24,24
Atsuyuki,nemesis,1778,monk,windwalker,55,25,30
Zynflex,tichondrius,1776,monk,windwalker,65,30,35
Rockyßalboa,sargeras,1774,monk,windwalker,85,50,35
Thuyvan,barthilas,1773,monk,windwalker,54,31,23
Gêrôx,sargeras,1773,monk,windwalker,60,33,27
Livitsu,aerie-peak,1770,monk,windwalker,36,21,15
Orkmonk,tichondrius,1766,monk,windwalker,48,32,16
Humonkulous,darkspear,1761,monk,windwalker,84,42,42
Tristantwo,sargeras,1761,monk,windwalker,96,47,49
Gigached,zuljin,1759,monk,windwalker,75,35,40
Akanq,tichondrius,1756,monk,windwalker,63,34,29
Capiirotta,nemesis,1751,monk,windwalker,164,95,69
Monkgyatso,drakthul,1749,monk,windwalker,132,69,63
Phistea,area-52,1749,monk,windwalker,81,40,41
Jåðëðrägøñ,sargeras,1745,monk,windwalker,61,36,25
Kagebunshin,kelthuzad,1744,monk,windwalker,42,25,17
Bruceteå,area-52,1744,monk,windwalker,36,19,17
Wât,bleeding-hollow,1742,monk,windwalker,54,27,27
Mhmmzz,sargeras,1741,monk,windwalker,120,60,60
Meniscusmonk,emerald-dream,1737,monk,windwalker,53,29,24
Danimalz,stormrage,1737,monk,windwalker,60,31,29
Conngaline,stormreaver,1736,monk,windwalker,461,222,239
Pandagirlw,tichondrius,1735,monk,windwalker,72,43,29
Syerzie,dalaran,1732,monk,windwalker,93,42,51
Lidä,tichondrius,1730,monk,windwalker,78,34,44
Jasey,area-52,1729,monk,windwalker,29,21,8
Kárma,malganis,1729,monk,windwalker,54,30,24
Jükedx,stormrage,1728,monk,windwalker,91,54,37
Xas,sentinels,1728,monk,windwalker,84,40,44
Mechamonk,aerie-peak,1728,monk,windwalker,105,46,59
Iremía,azralon,1727,monk,windwalker,48,26,22
Altaidm,ragnaros,1724,monk,windwalker,61,30,31
Raphåel,area-52,1722,monk,windwalker,35,18,17
Xanaxåddict,sargeras,1722,monk,windwalker,225,113,112
Hîddènsõündx,tichondrius,1721,monk,windwalker,36,18,18
Boostedww,bloodscalp,1720,monk,windwalker,48,25,23
Warblaze,barthilas,1720,monk,windwalker,62,31,31
Titanus,chogall,1719,monk,windwalker,464,239,225
Squidie,tichondrius,1719,monk,windwalker,66,27,39
Chunlee,tichondrius,1718,monk,windwalker,42,22,20
Vai,korgath,1716,monk,windwalker,106,52,54
Serthean,illidan,1716,monk,windwalker,242,116,126
Sterow,kiljaeden,1715,monk,windwalker,54,28,26
Jabman,stormrage,1710,monk,windwalker,69,29,40
Tenooki,illidan,1707,monk,windwalker,41,19,22
Setback,tichondrius,1706,monk,windwalker,24,18,6
Ambal,hellscream,1706,monk,windwalker,73,40,33
Hellstabberm,lightbringer,1704,monk,windwalker,54,29,25
Rakije,barthilas,1703,monk,windwalker,72,44,28
Fimeu,kiljaeden,1703,monk,windwalker,64,37,27
Ojii,tichondrius,1702,monk,windwalker,87,41,46
Goosyloosy,dathremar,1701,monk,windwalker,42,22,20
Tôpsônworld,tichondrius,1700,monk,windwalker,66,39,27
Öñlýfåñs,tichondrius,1698,monk,windwalker,65,33,32
Gigagirth,emerald-dream,1697,monk,windwalker,42,21,21
Wolffangfist,sargeras,1695,monk,windwalker,75,45,30
Daracus,kelthuzad,1694,monk,windwalker,38,24,14
Excalibrew,malganis,1694,monk,windwalker,84,45,39
Rnmedic,stormrage,1691,monk,windwalker,80,35,45
Xï,proudmoore,1688,monk,windwalker,86,47,39
Haharetsdead,illidan,1686,monk,windwalker,131,71,60
Shids,barthilas,1686,monk,windwalker,47,22,25
Tragorin,tichondrius,1684,monk,windwalker,66,32,34
Zenluckydo,grizzly-hills,1683,monk,windwalker,113,61,52
Singao,malganis,1683,monk,windwalker,86,44,42
Jaspier,quelthalas,1682,monk,windwalker,53,28,25
Haco,malganis,1682,monk,windwalker,69,36,33
Rigi,stormrage,1682,monk,windwalker,137,65,72
Vanmonk,eonar,1681,monk,windwalker,36,18,18
Jatzai,emerald-dream,1680,monk,windwalker,58,27,31
Rïggen,thrall,1676,monk,windwalker,94,54,40
Zhoku,tichondrius,1674,monk,windwalker,30,19,11
Npepper,khadgar,1673,monk,windwalker,118,63,55
Yavaxye,stormrage,1673,monk,windwalker,41,18,23
Jdanîel,ragnaros,1671,monk,windwalker,42,21,21
Zenigma,area-52,1670,monk,windwalker,45,24,21
Dea,thrall,1670,monk,windwalker,84,43,41
Watercowz,tichondrius,1669,monk,windwalker,36,22,14
Bigpoppap,tichondrius,1668,monk,windwalker,54,29,25
Madtigon,scilla,1668,monk,windwalker,42,22,20
Hèllòkîttý,illidan,1666,monk,windwalker,30,19,11
Hæt,stormrage,1665,monk,windwalker,48,23,25
Judgevr,frostmourne,1665,monk,windwalker,57,26,31
Maunk,illidan,1663,monk,windwalker,78,48,30
Shaszx,zuljin,1661,monk,windwalker,47,25,22
Windmónk,tichondrius,1657,monk,windwalker,156,76,80
Thåi,anubarak,1656,monk,windwalker,54,20,34
Galaxystrike,illidan,1655,monk,windwalker,60,32,28
Quanyaozu,ragnaros,1654,monk,windwalker,32,19,13
Nightww,area-52,1654,monk,windwalker,66,36,30
Monasticc,undermine,1654,monk,windwalker,36,18,18
Wørm,emerald-dream,1653,monk,windwalker,36,21,15
Fiddletix,stormrage,1653,monk,windwalker,67,35,32
Rubntug,zuljin,1652,monk,windwalker,36,22,14
Fuqmeh,darkspear,1650,monk,windwalker,102,52,50
Dumplíngs,emerald-dream,1647,monk,windwalker,59,27,32
Bearface,blades-edge,1646,monk,windwalker,88,36,52
Råii,sargeras,1645,monk,windwalker,36,24,12
Mists,velen,1645,monk,windwalker,54,31,23
Oxli,emerald-dream,1645,monk,windwalker,52,29,23
Ludanford,eitrigg,1643,monk,windwalker,48,22,26
Harde,thrall,1642,monk,windwalker,88,46,42
Naagg,tichondrius,1642,monk,windwalker,48,23,25
Foxchik,zuljin,1641,monk,windwalker,76,42,34
Sdns,stormrage,1641,monk,windwalker,54,26,28
Corsan,illidan,1639,monk,windwalker,66,43,23
Dïsturbedtko,azralon,1639,monk,windwalker,134,68,66
Pankekz,tichondrius,1639,monk,windwalker,192,97,95
Mastâ,kelthuzad,1637,monk,windwalker,134,69,65
Akumà,tichondrius,1636,monk,windwalker,48,19,29
Akir,zuljin,1635,monk,windwalker,29,20,9
Shôckley,tichondrius,1629,monk,windwalker,153,84,69
Kitingqt,area-52,1629,monk,windwalker,48,22,26
Kungpóa,sargeras,1628,monk,windwalker,39,23,16
Bamron,fizzcrank,1628,monk,windwalker,158,78,80
Tochtlea,wyrmrest-accord,1628,monk,windwalker,47,22,25
Lørdjåshïn,azjolnerub,1627,monk,windwalker,36,20,16
Djjackyd,stormrage,1625,monk,windwalker,30,17,13
Ddoongmonk,tichondrius,1625,monk,windwalker,48,21,27
Surgarush,moon-guard,1624,monk,windwalker,112,68,44
Plucky,tichondrius,1624,monk,windwalker,37,18,19
Tnsnow,illidan,1623,monk,windwalker,36,21,15
Themanski,area-52,1622,monk,windwalker,52,27,25
Phistycuffs,bleeding-hollow,1621,monk,windwalker,85,40,45
Jigong,bleeding-hollow,1620,monk,windwalker,42,23,19
Lavinci,area-52,1620,monk,windwalker,36,17,19
Karelio,wyrmrest-accord,1619,monk,windwalker,48,22,26
Aidenww,area-52,1618,monk,windwalker,24,17,7
Sonsia,arthas,1618,monk,windwalker,112,64,48
Fatboí,sargeras,1618,monk,windwalker,51,29,22
Hadoukeñ,thrall,1616,monk,windwalker,41,22,19
Jbills,muradin,1615,monk,windwalker,71,41,30
Banyasong,tichondrius,1615,monk,windwalker,108,62,46
Azizyzz,barthilas,1613,monk,windwalker,30,20,10
Fapmonk,illidan,1613,monk,windwalker,77,48,29
Euman,sargeras,1613,monk,windwalker,36,21,15
Yacub,tichondrius,1612,monk,windwalker,36,20,16
Xinpa,quelthalas,1612,monk,windwalker,38,19,19
Rennafgc,stormrage,1611,monk,windwalker,48,24,24
Whøru,azralon,1611,monk,windwalker,42,17,25
Ehdunno,kelthuzad,1610,monk,windwalker,68,37,31
Punchco,senjin,1610,monk,windwalker,42,21,21
Calmpunchman,mannoroth,1610,monk,windwalker,49,22,27
Hím,garrosh,1609,monk,windwalker,87,52,35
Songokusan,thrall,1609,monk,windwalker,36,18,18
Fistnu,aggramar,1608,monk,windwalker,83,49,34
Bumbleechi,azralon,1606,monk,windwalker,36,17,19
Toyotatacoma,bleeding-hollow,1605,monk,windwalker,42,27,15
Daeio,burning-legion,1605,monk,windwalker,31,19,12
Jegann,tichondrius,1605,monk,windwalker,140,71,69
Flyingfury,illidan,1604,monk,windwalker,54,25,29
Facekandy,tichondrius,1602,monk,windwalker,34,18,16
Vasconha,illidan,1601,monk,windwalker,24,17,7
Bruhmesoftly,thrall,1601,monk,windwalker,60,34,26
Hotwatertank,area-52,1601,monk,windwalker,66,36,30
Flattswwjr,tichondrius,1601,monk,windwalker,36,19,17
Pepeloser,illidan,1601,monk,windwalker,48,23,25
Hybrid,stormrage,1600,monk,windwalker,30,20,10
Ronk,the-forgotten-coast,1600,monk,windwalker,30,17,13
Homunculusx,bleeding-hollow,1600,monk,windwalker,42,19,23
Rafên,moon-guard,1600,monk,windwalker,48,19,29
Windwalker,blackhand,1597,monk,windwalker,35,19,16
Lingerer,aerie-peak,1593,monk,windwalker,110,57,53
Marcusm,bleeding-hollow,1592,monk,windwalker,33,20,13
Fistyuh,illidan,1590,monk,windwalker,54,31,23
Druta,illidan,1589,monk,windwalker,48,35,13
Rozlynnww,tichondrius,1589,monk,windwalker,30,17,13
Miýagi,sargeras,1589,monk,windwalker,68,35,33
Feyalash,stormrage,1589,monk,windwalker,74,33,41
Xogum,azralon,1588,monk,windwalker,66,35,31
Decompress,illidan,1584,monk,windwalker,30,17,13
Kuffy,kelthuzad,1584,monk,windwalker,67,37,30
Peacefulpaco,malganis,1583,monk,windwalker,54,30,24
Feelsogöod,tichondrius,1582,monk,windwalker,82,49,33
Reprap,elune,1582,monk,windwalker,58,33,25
Kogoli,frostwolf,1580,monk,windwalker,101,47,54
Wonderx,darkspear,1579,monk,windwalker,30,20,10
Gøgeta,stormrage,1579,monk,windwalker,173,86,87
Copenfist,black-dragonflight,1578,monk,windwalker,36,21,15
Yogiji,proudmoore,1578,monk,windwalker,48,26,22
Hagano,drakkari,1578,monk,windwalker,125,66,59
Udderpunch,barthilas,1578,monk,windwalker,46,21,25
Chucksandmk,barthilas,1577,monk,windwalker,74,36,38
Hamyu,illidan,1576,monk,windwalker,42,20,22
Mannkin,zuluhed,1573,monk,windwalker,44,20,24
Pinot,dragonmaw,1572,monk,windwalker,42,17,25
Cpapi,sargeras,1569,monk,windwalker,66,31,35
Daddyrugburn,area-52,1568,monk,windwalker,178,92,86
Saucyfists,silvermoon,1568,monk,windwalker,64,32,32
Meatwrap,mugthol,1566,monk,windwalker,52,26,26
Unlike,tichondrius,1566,monk,windwalker,102,49,53
Dseebee,thrall,1565,monk,windwalker,30,18,12
Panduh,moon-guard,1565,monk,windwalker,245,125,120
Wizcaulifa,stormrage,1564,monk,windwalker,36,21,15
Hòlygòd,dalaran,1564,monk,windwalker,100,53,47
Muritors,ragnaros,1564,monk,windwalker,42,20,22
Píñg,area-52,1564,monk,windwalker,39,18,21
Ráchez,tichondrius,1559,monk,windwalker,93,54,39
Jerax,thunderlord,1559,monk,windwalker,109,59,50
Drakfu,tichondrius,1558,monk,windwalker,69,39,30
Brewbaker,hyjal,1556,monk,windwalker,86,48,38
Ranchy,zuljin,1556,monk,windwalker,161,80,81
Chongzly,frostmourne,1552,monk,windwalker,90,44,46
Allmother,area-52,1552,monk,windwalker,43,19,24
Fistnafurry,tichondrius,1550,monk,windwalker,42,21,21
Currycooker,tichondrius,1548,monk,windwalker,41,20,21
Fornoraisin,thrall,1547,monk,windwalker,54,21,33
Geekweek,frostmourne,1546,monk,windwalker,36,20,16
Nagato,nemesis,1545,monk,windwalker,23,17,6
Thouther,sargeras,1545,monk,windwalker,42,17,25
Chingu,ragnaros,1543,monk,windwalker,123,59,64
Therapeutics,moon-guard,1543,monk,windwalker,102,47,55
Okoh,wyrmrest-accord,1542,monk,windwalker,50,28,22
Wind,misha,1541,monk,windwalker,73,48,25
Xradu,dawnbringer,1540,monk,windwalker,100,56,44
Fmbbasedgód,tichondrius,1540,monk,windwalker,47,24,23
Pånkekz,tichondrius,1536,monk,windwalker,139,73,66
Pokinpooters,stormrage,1536,monk,windwalker,129,65,64
Ökami,tichondrius,1534,monk,windwalker,98,51,47
Çraßsßùrgêr,bonechewer,1533,monk,windwalker,24,16,8
Adilm,illidan,1533,monk,windwalker,30,16,14
Veso,tichondrius,1532,monk,windwalker,18,16,2
Healzpapi,tichondrius,1530,monk,windwalker,120,73,47
Bakedmonk,smolderthorn,1530,monk,windwalker,82,32,50
Zaabuza,azralon,1528,monk,windwalker,60,39,21
Domiik,ragnaros,1528,monk,windwalker,36,17,19
Byakugun,wyrmrest-accord,1522,monk,windwalker,36,21,15
Yungtoochi,tichondrius,1522,monk,windwalker,66,30,36
Zòrrò,area-52,1521,monk,windwalker,24,16,8
Yoshifistsu,malganis,1521,monk,windwalker,54,26,28
Odogin,tichondrius,1520,monk,windwalker,65,42,23
Bløødÿ,ragnaros,1516,monk,windwalker,21,17,4
Wenisdeep,frostmourne,1516,monk,windwalker,94,47,47
Raskalnikov,kelthuzad,1516,monk,windwalker,42,21,21
Göllyjee,tichondrius,1515,monk,windwalker,103,45,58
Allure,frostmourne,1513,monk,windwalker,57,26,31
Minimonke,moon-guard,1512,monk,windwalker,129,67,62
Borekkar,emerald-dream,1512,monk,windwalker,47,24,23
Kutz,proudmoore,1512,monk,windwalker,81,40,41
Sockem,arthas,1512,monk,windwalker,36,16,20
Rocketfist,bleeding-hollow,1510,monk,windwalker,114,57,57
Odi,stonemaul,1509,monk,windwalker,101,48,53
Sgarbossa,tortheldrin,1509,monk,windwalker,42,16,26
Arizøna,illidan,1507,monk,windwalker,80,44,36
Jagichan,area-52,1504,monk,windwalker,52,28,24
Napoleonic,vashj,1502,monk,windwalker,42,25,17
Nject,malganis,1502,monk,windwalker,108,60,48
Beverage,frostmourne,1502,monk,windwalker,57,28,29
Varn,frostmourne,1500,monk,windwalker,95,46,49
Yeawe,tichondrius,1499,monk,windwalker,36,19,17
Ugrak,chogall,1498,monk,windwalker,30,17,13
Punchiboi,thrall,1498,monk,windwalker,48,27,21
Captnmurphy,tichondrius,1498,monk,windwalker,29,16,13
Deezfist,illidan,1497,monk,windwalker,42,19,23
Ascilica,firetree,1495,monk,windwalker,24,16,8
Tigerstrikes,sargeras,1494,monk,windwalker,30,19,11
Monkings,tichondrius,1491,monk,windwalker,65,30,35
Simonb,tichondrius,1487,monk,windwalker,54,24,30
Rockemsockem,gorefiend,1485,monk,windwalker,90,48,42
Astteell,proudmoore,1484,monk,windwalker,45,18,27
Kiulang,kelthuzad,1483,monk,windwalker,93,44,49
Yamoshì,stormrage,1482,monk,windwalker,54,30,24
Jdkick,sargeras,1482,monk,windwalker,42,16,26
Aubiemonk,malygos,1479,monk,windwalker,30,16,14
Sivedrafely,arthas,1475,monk,windwalker,60,30,30
Atreia,malganis,1474,monk,windwalker,26,17,9
Omimonk,sargeras,1472,monk,windwalker,36,21,15
Ohgiddyttv,dalaran,1468,monk,windwalker,83,43,40
ßlesséd,tichondrius,1465,monk,windwalker,85,36,49
Butjaum,stormrage,1464,monk,windwalker,70,34,36
Saiyajinsoul,ragnaros,1460,monk,windwalker,76,39,37
Gójó,tichondrius,1458,monk,windwalker,36,23,13
Tyroneßanks,stormrage,1457,monk,windwalker,36,20,16
Mastahp,tichondrius,1457,monk,windwalker,42,23,19
Kómugi,area-52,1457,monk,windwalker,149,76,73
Grimpossible,malganis,1455,monk,windwalker,94,46,48
Pepepunch,bleeding-hollow,1452,monk,windwalker,54,22,32
Senseî,altar-of-storms,1451,monk,windwalker,96,44,52
Kawasakizph,tichondrius,1451,monk,windwalker,48,22,26
Callae,dreadmaul,1449,monk,windwalker,66,34,32
Showshoway,tichondrius,1449,monk,windwalker,99,46,53
Drunkmaster,frostmourne,1447,monk,windwalker,30,17,13
Lickthefist,sargeras,1445,monk,windwalker,24,16,8
Killmachine,farstriders,1442,monk,windwalker,212,105,107
Gún,ragnaros,1441,monk,windwalker,99,51,48
Birgs,sargeras,1439,monk,windwalker,30,15,15
Katsübooy,azralon,1438,monk,windwalker,334,169,165
Chihad,stormrage,1436,monk,windwalker,54,34,20
Smoothboxing,tichondrius,1436,monk,windwalker,116,66,50
Jackdaniel,sargeras,1435,monk,windwalker,24,15,9
Aizu,ragnaros,1435,monk,windwalker,30,15,15
Wüsok,thrall,1435,monk,windwalker,30,15,15
Gesir,tichondrius,1434,monk,windwalker,85,39,46
Rocketfrogg,bleeding-hollow,1434,monk,windwalker,36,15,21
Ahrk,emerald-dream,1434,monk,windwalker,78,30,48
Kungfupurk,bleeding-hollow,1433,monk,windwalker,24,15,9
Chigang,deathwing,1433,monk,windwalker,67,37,30
Daslow,quelthalas,1433,monk,windwalker,162,84,78
Fistys,area-52,1433,monk,windwalker,117,60,57
Izu,senjin,1433,monk,windwalker,30,15,15
Soprà,zuljin,1433,monk,windwalker,30,15,15
Skippa,emerald-dream,1432,monk,windwalker,60,33,27
Sleýin,tichondrius,1432,monk,windwalker,255,131,124
Bhodie,zuljin,1431,monk,windwalker,86,38,48
Xuenws,tichondrius,1429,monk,windwalker,24,15,9
Arunaa,tichondrius,1429,monk,windwalker,24,15,9
Eçua,tichondrius,1429,monk,windwalker,25,15,10
Funji,skullcrusher,1429,monk,windwalker,38,20,18
Kaize,sargeras,1427,monk,windwalker,24,15,9
Merçeÿ,tichondrius,1425,monk,windwalker,30,17,13
Mattyj,darkspear,1423,monk,windwalker,30,15,15
Chuchinga,tichondrius,1423,monk,windwalker,96,46,50
Giatzo,barthilas,1422,monk,windwalker,78,43,35
Neonette,emerald-dream,1422,monk,windwalker,30,15,15
One,zuluhed,1421,monk,windwalker,30,15,15
Norrischucks,sargeras,1412,monk,windwalker,30,22,8
Asaltofsorts,tichondrius,1409,monk,windwalker,50,28,22
Whizz,frostmane,1408,monk,windwalker,37,17,20
Scabie,illidan,1404,monk,windwalker,50,26,24
Æeeæ,hakkar,1403,monk,windwalker,22,18,4
Reeperfist,area-52,1403,monk,windwalker,20,16,4
Sodamint,sargeras,1403,monk,windwalker,44,16,28
Tassmonk,hyjal,1401,monk,windwalker,48,23,25
Chingwang,frostmourne,1400,monk,windwalker,41,24,17
Creonus,proudmoore,1400,monk,windwalker,56,24,32
Bradyfour,moon-guard,1398,monk,windwalker,89,46,43
Rowenoa,tichondrius,1396,monk,windwalker,54,26,28
Fanetö,stormrage,1395,monk,windwalker,66,27,39
Opmother,elune,1394,monk,windwalker,71,42,29
Milkychi,frostmourne,1392,monk,windwalker,40,15,25
Goonkeg,frostmourne,1391,monk,windwalker,36,17,19
Onepunchman,quelthalas,1389,monk,windwalker,51,19,32
Versuri,azralon,1387,monk,windwalker,117,60,57
Shlumpuh,tichondrius,1385,monk,windwalker,42,18,24
Trapeez,kelthuzad,1383,monk,windwalker,70,40,30
Shishosenin,quelthalas,1383,monk,windwalker,250,118,132
Kawasakii,tichondrius,1382,monk,windwalker,166,83,83
Niked,tichondrius,1379,monk,windwalker,36,15,21
Brewmaker,sargeras,1376,monk,windwalker,75,36,39
Wartenja,frostmourne,1375,monk,windwalker,114,51,63
Shianjuo,ragnaros,1372,monk,windwalker,42,20,22
Eavale,destromath,1371,monk,windwalker,121,61,60
Varekaî,frostmourne,1365,monk,windwalker,62,32,30
Dazzler,ragnaros,1363,monk,windwalker,78,39,39
Paracetamonk,kelthuzad,1363,monk,windwalker,90,35,55
Headsmasher,wyrmrest-accord,1359,monk,windwalker,113,51,62
Sarious,lightbringer,1358,monk,windwalker,335,174,161
Kungfüsed,stormrage,1356,monk,windwalker,72,38,34
Resolver,stormscale,1355,monk,windwalker,58,31,27
Tert,aerie-peak,1354,monk,windwalker,36,17,19
Kriticalkush,kelthuzad,1353,monk,windwalker,24,17,7
Grocerymonk,malganis,1353,monk,windwalker,34,15,19
Shocclol,stormrage,1351,monk,windwalker,37,23,14
Owned,dreadmaul,1349,monk,windwalker,36,23,13
Dabzin,stormrage,1349,monk,windwalker,100,51,49
Kungfusacks,sargeras,1346,monk,windwalker,24,16,8
Sultanofwind,malganis,1344,monk,windwalker,24,14,10
Tacofox,tichondrius,1344,monk,windwalker,125,59,66
Axtîn,stormreaver,1343,monk,windwalker,22,15,7
Zuì,sargeras,1342,monk,windwalker,24,14,10
Dakenprime,tichondrius,1340,monk,windwalker,82,40,42
Samaelsin,emerald-dream,1340,monk,windwalker,48,22,26
Bluntdoctor,stormreaver,1340,monk,windwalker,66,24,42
Dkdakìng,stormrage,1339,monk,windwalker,24,14,10
Tingum,kelthuzad,1337,monk,windwalker,34,15,19
Novoctek,quelthalas,1336,monk,windwalker,30,14,16
Büster,tichondrius,1334,monk,windwalker,24,14,10
Poem,grizzly-hills,1333,monk,windwalker,18,14,4
Siddharthä,barthilas,1332,monk,windwalker,48,28,20
Arshavin,skullcrusher,1330,monk,windwalker,48,22,26
Gelgameks,eredar,1329,monk,windwalker,36,14,22
Delorenzi,hellscream,1328,monk,windwalker,30,15,15
Yeji,altar-of-storms,1326,monk,windwalker,24,14,10
Screwballz,blackrock,1325,monk,windwalker,147,67,80
Bigxthaplug,moon-guard,1324,monk,windwalker,36,16,20
Saltystepbro,illidan,1323,monk,windwalker,24,14,10
Wutangkillaß,kiljaeden,1322,monk,windwalker,54,23,31
Chopsake,khadgar,1318,monk,windwalker,96,53,43
Monksoon,tichondrius,1317,monk,windwalker,24,14,10
Kristiana,aegwynn,1316,monk,windwalker,24,14,10
Astrofu,tichondrius,1316,monk,windwalker,88,36,52
Jajabelugeng,tichondrius,1315,monk,windwalker,24,14,10
Pagtuk,daggerspine,1314,monk,windwalker,30,14,16
Londobell,frostmourne,1311,monk,windwalker,43,23,20
Acharä,tichondrius,1305,monk,windwalker,36,20,16
Madbuffz,nemesis,1304,monk,windwalker,72,32,40
Twïst,tichondrius,1303,monk,windwalker,18,14,4
Xiaowën,nemesis,1300,monk,windwalker,63,31,32
Owenxdd,stormrage,1299,monk,windwalker,62,33,29
Xøxo,trollbane,1299,monk,windwalker,48,22,26
Tino,kelthuzad,1295,monk,windwalker,66,35,31
Razielic,frostmourne,1295,monk,windwalker,84,41,43
Rbs,tichondrius,1295,monk,windwalker,122,53,69
Çhëèch,tichondrius,1291,monk,windwalker,47,20,27
Dodried,ragnaros,1290,monk,windwalker,52,24,28
Yrn,crushridge,1287,monk,windwalker,60,32,28
Zakaza,kelthuzad,1286,monk,windwalker,42,19,23
Tianhu,sargeras,1285,monk,windwalker,81,42,39
Highku,drenden,1282,monk,windwalker,30,17,13
Chaipie,kelthuzad,1278,monk,windwalker,23,14,9
Ghaelessi,senjin,1278,monk,windwalker,83,43,40
Astralsurfer,tichondrius,1276,monk,windwalker,42,22,20
Weewalker,wyrmrest-accord,1275,monk,windwalker,45,23,22
Rufaso,sargeras,1273,monk,windwalker,72,36,36
Fatuix,sargeras,1273,monk,windwalker,44,16,28
Jacquelline,moon-guard,1271,monk,windwalker,42,21,21
Hitchslapz,tichondrius,1271,monk,windwalker,30,15,15
Garmakasmonk,skullcrusher,1269,monk,windwalker,46,22,24
Convectuoso,illidan,1264,monk,windwalker,27,15,12
Weezzyboi,tichondrius,1263,monk,windwalker,42,22,20
Natus,greymane,1262,monk,windwalker,36,18,18
Anarska,thrall,1259,monk,windwalker,114,54,60
Murder,magtheridon,1256,monk,windwalker,43,21,22
Renrukie,frostmourne,1256,monk,windwalker,30,14,16
Supremekick,frostmourne,1254,monk,windwalker,43,27,16
Pangpoong,tichondrius,1249,monk,windwalker,99,44,55
Idonthustle,area-52,1249,monk,windwalker,36,14,22
Kungxxl,kiljaeden,1248,monk,windwalker,101,47,54
Baconbiscuit,area-52,1247,monk,windwalker,30,13,17
ßájkà,area-52,1247,monk,windwalker,30,13,17
Prostotak,area-52,1246,monk,windwalker,18,13,5
Molta,tichondrius,1246,monk,windwalker,24,13,11
Pamii,quelthalas,1246,monk,windwalker,36,13,23
Marstol,bleeding-hollow,1245,monk,windwalker,71,42,29
Båshkin,terenas,1245,monk,windwalker,42,19,23
Hèàvy,stormrage,1244,monk,windwalker,24,13,11
Skymonge,stormrage,1244,monk,windwalker,134,60,74
Amphíon,kelthuzad,1244,monk,windwalker,30,13,17
Bükki,ragnaros,1243,monk,windwalker,18,13,5
Bowlbreak,sargeras,1243,monk,windwalker,36,20,16
Nuclearpunch,tichondrius,1242,monk,windwalker,24,13,11
Winney,frostmourne,1241,monk,windwalker,21,14,7
Xinghao,tichondrius,1240,monk,windwalker,30,13,17
Sedition,emerald-dream,1239,monk,windwalker,95,46,49
Slapcîty,bleeding-hollow,1238,monk,windwalker,30,13,17
Honkbazz,illidan,1238,monk,windwalker,30,13,17
Bleht,moon-guard,1237,monk,windwalker,24,13,11
Blumpfu,thrall,1235,monk,windwalker,24,13,11
Ilvory,tichondrius,1235,monk,windwalker,30,13,17
Metios,aggramar,1234,monk,windwalker,52,22,30
Felgolos,azralon,1232,monk,windwalker,27,17,10
Zettelkasten,tichondrius,1232,monk,windwalker,72,35,37
Ipnam,kelthuzad,1231,monk,windwalker,22,14,8
Starymww,tichondrius,1230,monk,windwalker,24,13,11
Finesse,frostwolf,1227,monk,windwalker,18,13,5
Ruckm,stormrage,1225,monk,windwalker,24,13,11
Obiiwan,tichondrius,1224,monk,windwalker,84,34,50
Gentlefists,sargeras,1218,monk,windwalker,30,14,16
Rasta,ragnaros,1211,monk,windwalker,30,17,13
Infest,azralon,1205,monk,windwalker,72,36,36
Gurda,wyrmrest-accord,1203,monk,windwalker,72,34,38
Ofn,moon-guard,1202,monk,windwalker,96,45,51
Xéia,area-52,1201,monk,windwalker,60,23,37
Wwmonks,sargeras,1197,monk,windwalker,18,13,5
Threnz,magtheridon,1195,monk,windwalker,36,13,23
Honeyjaem,tichondrius,1193,monk,windwalker,29,14,15
Xxvbamm,thrall,1193,monk,windwalker,29,13,16
Stickyloads,illidan,1190,monk,windwalker,78,35,43
Mcnipple,moonrunner,1189,monk,windwalker,24,14,10
Kïri,wyrmrest-accord,1181,monk,windwalker,27,15,12
Slapstun,barthilas,1176,monk,windwalker,77,28,49
Hinakii,dalaran,1175,monk,windwalker,144,62,82
Sleepÿ,area-52,1171,monk,windwalker,84,34,50
Milktank,medivh,1167,monk,windwalker,69,40,29
Mommysalamii,moon-guard,1167,monk,windwalker,25,13,12
Angerday,illidan,1166,monk,windwalker,36,14,22
Leehofook,azshara,1159,monk,windwalker,125,60,65
Kandinarra,jubeithos,1156,monk,windwalker,58,31,27
Sahhalea,sargeras,1153,monk,windwalker,56,25,31
Linkya,daggerspine,1152,monk,windwalker,22,14,8
Xedou,azralon,1151,monk,windwalker,18,12,6
Moopdahoop,stormrage,1151,monk,windwalker,135,72,63
Lalpu,tichondrius,1151,monk,windwalker,30,12,18
Mcbluffin,onyxia,1150,monk,windwalker,18,12,6
Hulkapro,azralon,1150,monk,windwalker,51,30,21
Pikotaro,tichondrius,1150,monk,windwalker,24,12,12
Alêxander,boulderfist,1149,monk,windwalker,18,12,6
Antiherox,sargeras,1149,monk,windwalker,18,12,6
Bonflur,quelthalas,1148,monk,windwalker,384,194,190
Bigfel,nazjatar,1148,monk,windwalker,24,12,12
Boxxzer,kelthuzad,1147,monk,windwalker,18,12,6
Dobsy,bleeding-hollow,1147,monk,windwalker,24,12,12
Stendari,moon-guard,1147,monk,windwalker,36,12,24
Misery,stormscale,1146,monk,windwalker,23,15,8
Xunzao,emerald-dream,1146,monk,windwalker,24,12,12
Omashu,nemesis,1145,monk,windwalker,24,12,12
Matins,tichondrius,1144,monk,windwalker,18,12,6
Rodign,hyjal,1144,monk,windwalker,24,12,12
Toughmonk,tichondrius,1143,monk,windwalker,24,12,12
Tenshu,runetotem,1141,monk,windwalker,24,12,12
Mechabre,stormrage,1140,monk,windwalker,18,12,6
Acindian,malganis,1140,monk,windwalker,36,18,18
Anavara,drakkari,1134,monk,windwalker,66,32,34
Shinjiki,tichondrius,1134,monk,windwalker,29,12,17
Lexivixi,khazgoroth,1133,monk,windwalker,108,55,53
Kfpeeves,sargeras,1133,monk,windwalker,48,24,24
Duwhack,wyrmrest-accord,1133,monk,windwalker,30,12,18
Boldyr,sargeras,1128,monk,windwalker,24,12,12
Iamanangel,illidan,1127,monk,windwalker,30,20,10
Dekù,ragnaros,1125,monk,windwalker,18,12,6
Spinning,nagrand,1122,monk,windwalker,30,12,18
Stigzz,stormrage,1118,monk,windwalker,23,12,11
Jimothydab,lightbringer,1117,monk,windwalker,23,12,11
Gorton,lightbringer,1114,monk,windwalker,24,12,12
Vetism,thrall,1113,monk,windwalker,22,12,10
Imonkalot,destromath,1111,monk,windwalker,55,23,32
Lyfegiver,blackrock,1110,monk,windwalker,20,13,7
Jinpo,lightninghoof,1110,monk,windwalker,60,32,28
Loadedfries,frostmourne,1110,monk,windwalker,24,12,12
Silvopanda,azralon,1108,monk,windwalker,161,79,82
Fitmonje,drakkari,1108,monk,windwalker,28,13,15
Nika,chogall,1105,monk,windwalker,48,19,29
Monkii,bonechewer,1103,monk,windwalker,36,21,15
Drektarz,area-52,1098,monk,windwalker,111,52,59
Habana,stormreaver,1095,monk,windwalker,60,21,39
Ogre,the-venture-co,1092,monk,windwalker,30,15,15
Deadlyfist,stormrage,1089,monk,windwalker,47,19,28
Merand,tichondrius,1088,monk,windwalker,30,12,18
Hêrsh,frostmourne,1087,monk,windwalker,35,14,21
Hairybadger,destromath,1084,monk,windwalker,30,21,9
Vokarhi,whisperwind,1082,monk,windwalker,24,15,9
Lööpér,tichondrius,1081,monk,windwalker,24,13,11
Ojiin,wyrmrest-accord,1079,monk,windwalker,24,13,11
Blackychan,scilla,1070,monk,windwalker,54,24,30
Rhyskrispiez,sargeras,1056,monk,windwalker,18,11,7
Froshizzle,tichondrius,1056,monk,windwalker,18,11,7
Tokyozesty,area-52,1056,monk,windwalker,18,11,7
Hate,korialstrasz,1055,monk,windwalker,18,11,7
Whitepandax,tichondrius,1055,monk,windwalker,18,11,7
Abenobashi,malganis,1055,monk,windwalker,18,11,7
Miuss,illidan,1055,monk,windwalker,24,11,13
Monkfy,moon-guard,1054,monk,windwalker,17,11,6
Powerfisterr,stormrage,1054,monk,windwalker,18,11,7
Monkamax,tichondrius,1054,monk,windwalker,18,11,7
Mahatmä,dalaran,1054,monk,windwalker,24,11,13
Bangtanboy,tichondrius,1053,monk,windwalker,18,11,7
Zenpachi,hyjal,1053,monk,windwalker,27,11,16
Wimdrewk,quelthalas,1053,monk,windwalker,39,12,27
Razekahl,wyrmrest-accord,1052,monk,windwalker,30,11,19
Hira,zuljin,1052,monk,windwalker,30,11,19
Zenkam,ragnaros,1052,monk,windwalker,30,11,19
Lotusdream,argent-dawn,1051,monk,windwalker,23,11,12
Maziyen,thunderlord,1051,monk,windwalker,30,11,19
Turbodyne,tichondrius,1050,monk,windwalker,24,11,13
Suntzuvius,tichondrius,1050,monk,windwalker,24,11,13
Whtnyhuston,sargeras,1049,monk,windwalker,24,11,13
Chowlaos,coilfang,1048,monk,windwalker,18,11,7
Bingqilinn,sargeras,1045,monk,windwalker,18,11,7
Miyage,emerald-dream,1045,monk,windwalker,54,31,23
Caulífla,barthilas,1045,monk,windwalker,24,11,13
Chaosrose,area-52,1044,monk,windwalker,18,11,7
Aedale,emerald-dream,1044,monk,windwalker,45,23,22
Tremonk,kelthuzad,1043,monk,windwalker,18,11,7
Saks,ragnaros,1043,monk,windwalker,30,11,19
Tsubal,mugthol,1042,monk,windwalker,18,11,7
Hylithia,proudmoore,1040,monk,windwalker,30,17,13
Legsweeps,tichondrius,1039,monk,windwalker,30,11,19
Tobearus,stormscale,1038,monk,windwalker,35,18,17
Jnx,emerald-dream,1038,monk,windwalker,24,11,13
Romeonjuliet,tichondrius,1038,monk,windwalker,24,11,13
Dynamo,blackrock,1036,monk,windwalker,30,11,19
Kungfused,frostmourne,1035,monk,windwalker,30,11,19
Natintell,drakkari,1032,monk,windwalker,71,33,38
Abboo,hyjal,1030,monk,windwalker,24,12,12
Steenkk,tichondrius,1023,monk,windwalker,24,11,13
Gnomesweeper,sargeras,1022,monk,windwalker,14,12,2
Åsurã,stormrage,1021,monk,windwalker,34,11,23
Averagewang,sargeras,1020,monk,windwalker,61,32,29
Sandii,azralon,1020,monk,windwalker,129,67,62
Leafondawind,boulderfist,1020,monk,windwalker,29,11,18
Tzidkiyahu,barthilas,1018,monk,windwalker,28,16,12
Rosarìolover,stormrage,1008,monk,windwalker,36,18,18
Brewzllee,tichondrius,998,monk,windwalker,78,40,38
Nutcrakerz,tichondrius,995,monk,windwalker,30,18,12
Romeoe,muradin,992,monk,windwalker,30,11,19
Fatde,daggerspine,991,monk,windwalker,47,27,20
Mynamegeorge,area-52,990,monk,windwalker,52,25,27
Quanon,stormreaver,990,monk,windwalker,42,16,26
Onepunch,exodar,986,monk,windwalker,20,11,9
Sébástián,drakkari,983,monk,windwalker,76,39,37
Pandalex,draenor,982,monk,windwalker,24,11,13
Traxshin,kelthuzad,982,monk,windwalker,30,12,18
Rollsroycist,trollbane,975,monk,windwalker,49,27,22
Kush,dalvengyr,969,monk,windwalker,33,15,18
Shnooze,barthilas,962,monk,windwalker,114,49,65
Shadmtwo,tichondrius,960,monk,windwalker,12,10,2
Aýre,ravencrest,960,monk,windwalker,12,10,2
Ðilara,area-52,960,monk,windwalker,12,10,2
Glad,tichondrius,960,monk,windwalker,12,10,2
Fettywhopper,kaelthas,960,monk,windwalker,12,10,2
Rafyww,tichondrius,960,monk,windwalker,18,10,8
Zoomerxd,stormrage,960,monk,windwalker,18,10,8
Tribunez,stormrage,960,monk,windwalker,18,10,8
Gothamonk,tichondrius,960,monk,windwalker,18,10,8
Afrosamurai,thrall,960,monk,windwalker,18,10,8
Hitt,barthilas,960,monk,windwalker,24,10,14
Kinkykyle,emerald-dream,960,monk,windwalker,24,10,14
Rskmedaddy,tichondrius,959,monk,windwalker,12,10,2
Tazermw,sargeras,959,monk,windwalker,12,10,2
Neejitsu,malganis,959,monk,windwalker,18,10,8
Iol,whisperwind,959,monk,windwalker,18,10,8
Undertickle,illidan,959,monk,windwalker,18,10,8
Goldfornudez,area-52,959,monk,windwalker,18,10,8
Plotting,tichondrius,959,monk,windwalker,18,10,8
Birean,area-52,959,monk,windwalker,24,10,14
Tigerwoo,tichondrius,959,monk,windwalker,24,10,14
Omoplàta,illidan,958,monk,windwalker,18,10,8
Apølon,azralon,958,monk,windwalker,18,10,8
Jnco,thrall,958,monk,windwalker,18,10,8
Zunfu,tichondrius,958,monk,windwalker,18,10,8
Thiccdih,area-52,958,monk,windwalker,24,10,14
Mônkdunk,daggerspine,957,monk,windwalker,18,10,8
Frânkdux,tichondrius,957,monk,windwalker,18,10,8
Sxywind,azgalor,957,monk,windwalker,18,10,8
Mcwallets,moon-guard,957,monk,windwalker,150,70,80
Avz,azralon,957,monk,windwalker,24,10,14
Memonk,ysera,957,monk,windwalker,24,10,14
Vuadeira,azralon,957,monk,windwalker,30,10,20
Skyvaan,barthilas,956,monk,windwalker,18,10,8
Ezpzmonk,bloodscalp,956,monk,windwalker,21,11,10
Dangodxz,quelthalas,955,monk,windwalker,22,11,11
Thalreyzian,vashj,954,monk,windwalker,24,10,14
Megatraun,tichondrius,953,monk,windwalker,18,10,8
Keys,earthen-ring,953,monk,windwalker,18,10,8
Alcaquito,goldrinn,950,monk,windwalker,18,10,8
Hehex,bleeding-hollow,943,monk,windwalker,23,10,13
Madmint,illidan,941,monk,windwalker,23,11,12
Ryucko,azralon,933,monk,windwalker,18,10,8
Hyun,stormrage,931,monk,windwalker,18,10,8
Nedpanders,nagrand,930,monk,windwalker,18,11,7
Thedeäd,stormrage,930,monk,windwalker,48,16,32
Thäiländiä,bleeding-hollow,928,monk,windwalker,36,20,16
Clytpuncher,emerald-dream,926,monk,windwalker,23,10,13
Bigmoli,quelthalas,925,monk,windwalker,16,11,5
Scarlos,tichondrius,915,monk,windwalker,213,102,111
Poanda,illidan,914,monk,windwalker,24,13,11
Iarw,tichondrius,906,monk,windwalker,24,11,13
Raninn,bleeding-hollow,894,monk,windwalker,22,10,12
Ipmán,moon-guard,892,monk,windwalker,41,18,23
Veganbacon,mannoroth,875,monk,windwalker,14,10,4
Loenius,wyrmrest-accord,864,monk,windwalker,12,9,3
Wwrizz,frostmane,864,monk,windwalker,12,9,3
Poormanx,illidan,864,monk,windwalker,12,9,3
Choibaedal,tichondrius,864,monk,windwalker,12,9,3
Gucchimane,illidan,864,monk,windwalker,12,9,3
Iraww,thrall,864,monk,windwalker,18,9,9
Jaige,illidan,864,monk,windwalker,18,9,9
Brüce,ragnaros,864,monk,windwalker,18,9,9
Tmjojo,tichondrius,864,monk,windwalker,24,9,15
Arkypoo,drakkari,864,monk,windwalker,24,9,15
Chiang,chogall,864,monk,windwalker,24,9,15
Aligned,zuljin,863,monk,windwalker,12,9,3
Selfîe,ysera,863,monk,windwalker,12,9,3
Danksweaver,malganis,863,monk,windwalker,12,9,3
Crakgirl,malganis,863,monk,windwalker,18,9,9
Röllup,area-52,863,monk,windwalker,18,9,9
Vandamme,durotan,863,monk,windwalker,18,9,9
Tomatosaucin,area-52,863,monk,windwalker,18,9,9
Stepsista,sargeras,863,monk,windwalker,18,9,9
Azzmane,bronzebeard,863,monk,windwalker,18,9,9
Kahpital,azralon,863,monk,windwalker,18,9,9
Helicopter,borean-tundra,863,monk,windwalker,18,9,9
Inko,ragnaros,863,monk,windwalker,24,9,15
Somethingre,sargeras,862,monk,windwalker,12,9,3
Fearrae,sargeras,862,monk,windwalker,12,9,3
Mapaly,ragnaros,862,monk,windwalker,18,9,9
Kaishya,emerald-dream,861,monk,windwalker,12,9,3
Kentodne,stormrage,861,monk,windwalker,18,9,9
Zackesé,area-52,861,monk,windwalker,30,9,21
Pandagendon,quelthalas,860,monk,windwalker,12,9,3
Arimonk,mannoroth,860,monk,windwalker,18,9,9
Ryútt,illidan,860,monk,windwalker,24,9,15
Selfless,gilneas,858,monk,windwalker,18,9,9
Anatomyx,kelthuzad,858,monk,windwalker,18,9,9
Kajjou,illidan,858,monk,windwalker,26,9,17
Søuei,skullcrusher,857,monk,windwalker,18,9,9
Acena,stormrage,856,monk,windwalker,24,9,15
Dbrady,thrall,855,monk,windwalker,24,9,15
Pastarasta,malganis,854,monk,windwalker,18,10,8
Agroétudo,azralon,838,monk,windwalker,18,9,9
Deathgoku,norgannon,831,monk,windwalker,23,9,14
Phuumyn,llane,829,monk,windwalker,17,9,8
Thekilla,aegwynn,827,monk,windwalker,18,9,9
Knuckbutter,sargeras,824,monk,windwalker,33,11,22
Nobmaster,garrosh,815,monk,windwalker,22,9,13
Scoobfly,illidan,814,monk,windwalker,17,9,8
Lolqtxd,sargeras,810,monk,windwalker,26,10,16
Cráne,duskwood,797,monk,windwalker,14,9,5
Tulalong,area-52,797,monk,windwalker,20,9,11
Skoi,moon-guard,796,monk,windwalker,14,9,5
Yeonguo,drakthul,795,monk,windwalker,16,9,7
Rykouu,area-52,784,monk,windwalker,19,9,10
Youngnudy,sargeras,768,monk,windwalker,12,8,4
Kambrielx,zuljin,768,monk,windwalker,12,8,4
Awfulww,tichondrius,768,monk,windwalker,12,8,4
Involve,tichondrius,768,monk,windwalker,12,8,4
Sistuhfista,tichondrius,768,monk,windwalker,12,8,4
Bootowsky,zuljin,768,monk,windwalker,12,8,4
Khungfeu,area-52,768,monk,windwalker,12,8,4
Jamaldamort,sargeras,768,monk,windwalker,12,8,4
Weezym,illidan,768,monk,windwalker,12,8,4
Kkonaman,illidan,768,monk,windwalker,12,8,4
Twichyling,tichondrius,768,monk,windwalker,12,8,4
Hitman,thrall,768,monk,windwalker,12,8,4
Kungpaochicn,tichondrius,768,monk,windwalker,12,8,4
Kfchi,tichondrius,768,monk,windwalker,16,9,7
Stepfistz,aegwynn,768,monk,windwalker,18,8,10
Ballok,bleeding-hollow,768,monk,windwalker,18,8,10
Richywayne,bleeding-hollow,768,monk,windwalker,18,8,10
Leegueen,tichondrius,768,monk,windwalker,18,8,10
Gnomepuncher,dalaran,768,monk,windwalker,18,8,10
Taggz,thunderlord,768,monk,windwalker,18,8,10
Skela,emerald-dream,768,monk,windwalker,18,8,10
Slimcognito,zuljin,768,monk,windwalker,18,8,10
Ludenz,emerald-dream,768,monk,windwalker,18,8,10
Güwop,tichondrius,768,monk,windwalker,18,8,10
Goonsy,tichondrius,768,monk,windwalker,18,8,10
Rerolled,moon-guard,768,monk,windwalker,18,8,10
Röllö,tichondrius,768,monk,windwalker,21,9,12
Monke,onyxia,768,monk,windwalker,24,8,16
Blackìce,sargeras,768,monk,windwalker,24,8,16
Shinobiww,area-52,768,monk,windwalker,24,8,16
Tews,quelthalas,767,monk,windwalker,12,8,4
Punchkingx,tichondrius,767,monk,windwalker,12,8,4
Raikou,frostmourne,767,monk,windwalker,12,8,4
Prickhead,sargeras,767,monk,windwalker,15,9,6
Fumoo,sargeras,767,monk,windwalker,16,9,7
Suspicious,malfurion,767,monk,windwalker,18,8,10
Zukki,zuljin,767,monk,windwalker,18,8,10
Akrethar,medivh,767,monk,windwalker,18,8,10
Biggyballs,tichondrius,767,monk,windwalker,18,8,10
Supernam,sargeras,767,monk,windwalker,18,8,10
Metalmønk,nerzhul,767,monk,windwalker,18,8,10
Aydowon,illidan,767,monk,windwalker,18,8,10
Pipochen,ragnaros,767,monk,windwalker,18,8,10
Faashbae,illidan,767,monk,windwalker,18,8,10
Silkzy,frostwolf,767,monk,windwalker,24,8,16
Luckystrike,area-52,767,monk,windwalker,24,8,16
Limptriscuít,tichondrius,766,monk,windwalker,12,8,4
Yoshimotto,area-52,766,monk,windwalker,12,8,4
Nf,zuljin,766,monk,windwalker,12,8,4
Ragraxx,quelthalas,766,monk,windwalker,18,8,10
Karatay,tichondrius,765,monk,windwalker,12,8,4
Jackboi,the-underbog,765,monk,windwalker,24,8,16
Jãe,stormrage,764,monk,windwalker,24,8,16
Oz,vashj,763,monk,windwalker,12,8,4
Extinctión,stormscale,762,monk,windwalker,12,8,4
Sprinkli,sargeras,761,monk,windwalker,24,8,16
Kilabit,azshara,756,monk,windwalker,44,19,25
Kylièjenner,gilneas,755,monk,windwalker,18,8,10
Wodinswolf,sargeras,749,monk,windwalker,18,8,10
Hontaruk,ragnaros,749,monk,windwalker,29,8,21
Shinjaru,area-52,735,monk,windwalker,22,8,14
Habanèro,tichondrius,734,monk,windwalker,17,8,9
Alkaholik,stormrage,719,monk,windwalker,23,8,15
Trapwalker,area-52,713,monk,windwalker,21,9,12
Kurha,queldorei,690,monk,windwalker,24,8,16
Monkeymonkey,dathremar,687,monk,windwalker,11,8,3
Daewoolanos,dalaran,672,monk,windwalker,12,7,5
Kudrix,frostwolf,672,monk,windwalker,12,7,5
Dublefist,draktharon,672,monk,windwalker,12,7,5
Ázão,stormrage,672,monk,windwalker,12,7,5
Atengie,stormrage,672,monk,windwalker,12,7,5
Tag,tichondrius,672,monk,windwalker,12,7,5
Shry,kiljaeden,672,monk,windwalker,12,7,5
Shäopai,quelthalas,672,monk,windwalker,12,7,5
Redami,gnomeregan,672,monk,windwalker,12,7,5
Lilpøøter,tichondrius,672,monk,windwalker,12,7,5
Monkuban,destromath,672,monk,windwalker,12,7,5
Orurmine,kiljaeden,672,monk,windwalker,12,7,5
Jwazz,tichondrius,672,monk,windwalker,12,7,5
Touchbot,tichondrius,672,monk,windwalker,12,7,5
Shiphappens,barthilas,672,monk,windwalker,12,7,5
Dimmay,destromath,672,monk,windwalker,12,7,5
Spacefolk,quelthalas,672,monk,windwalker,12,7,5
Bibis,sargeras,672,monk,windwalker,12,7,5
Jxyfist,illidan,672,monk,windwalker,12,7,5
Bramicaye,malganis,672,monk,windwalker,12,7,5
Garofalo,tichondrius,672,monk,windwalker,12,7,5
Ristion,moon-guard,672,monk,windwalker,12,7,5
Swapto,proudmoore,672,monk,windwalker,12,7,5
Dragonwhirl,stormrage,672,monk,windwalker,12,7,5
Porxhub,tichondrius,672,monk,windwalker,12,7,5
Incaustik,ragnaros,672,monk,windwalker,12,7,5
Yoojimin,kiljaeden,672,monk,windwalker,12,7,5
Strokahontas,stormreaver,672,monk,windwalker,12,7,5
Ganjäsmoke,skullcrusher,672,monk,windwalker,12,7,5
Peterpunch,illidan,672,monk,windwalker,12,7,5
Goldx,ragnaros,672,monk,windwalker,12,7,5
Kimmyfists,tichondrius,672,monk,windwalker,12,7,5
Ftxyolo,azralon,672,monk,windwalker,12,7,5
Crittinka,bonechewer,672,monk,windwalker,12,7,5
Buffmonkdmg,tichondrius,672,monk,windwalker,15,8,7
Popchi,stormrage,672,monk,windwalker,18,7,11
Militantww,tichondrius,672,monk,windwalker,18,7,11
Verizani,stormrage,672,monk,windwalker,18,7,11
Tapzm,area-52,672,monk,windwalker,18,7,11
Stevezee,barthilas,672,monk,windwalker,18,7,11
Pandaforlife,area-52,672,monk,windwalker,18,7,11
Tubshark,kelthuzad,672,monk,windwalker,18,7,11
Awcfanboy,bleeding-hollow,672,monk,windwalker,21,8,13
Monkyun,tichondrius,672,monk,windwalker,24,7,17
Kapoerista,azralon,671,monk,windwalker,12,7,5
Reckin,frostmourne,671,monk,windwalker,12,7,5
Drainar,bleeding-hollow,671,monk,windwalker,12,7,5
Qebui,darkspear,671,monk,windwalker,12,7,5
Bataan,tichondrius,671,monk,windwalker,12,7,5
Bauddor,ragnaros,671,monk,windwalker,12,7,5
Mosaden,suramar,671,monk,windwalker,12,7,5
Quietbegger,sargeras,671,monk,windwalker,12,7,5
Døjø,dalaran,671,monk,windwalker,12,7,5
Inaruss,ragnaros,671,monk,windwalker,18,7,11
Eîr,emerald-dream,671,monk,windwalker,18,7,11
Yuufi,moon-guard,671,monk,windwalker,18,7,11
Leozen,skullcrusher,671,monk,windwalker,18,7,11
Santatsu,emerald-dream,671,monk,windwalker,18,7,11
Huángbó,blackhand,670,monk,windwalker,10,8,2
Cryptique,tichondrius,670,monk,windwalker,12,7,5
Etkai,proudmoore,670,monk,windwalker,12,7,5
Astorari,illidan,670,monk,windwalker,12,7,5
Minusmonk,dalaran,670,monk,windwalker,12,7,5
Solafyde,aerie-peak,670,monk,windwalker,16,8,8
Santiie,drakkari,669,monk,windwalker,18,7,11
Ursuschi,khazgoroth,669,monk,windwalker,24,7,17
Elmanteca,ragnaros,668,monk,windwalker,12,7,5
Kuungfoo,tichondrius,667,monk,windwalker,12,7,5
Jish,bleeding-hollow,663,monk,windwalker,18,7,11
Liänä,quelthalas,658,monk,windwalker,18,7,11
Honghong,kargath,655,monk,windwalker,17,8,9
Léesin,stormrage,655,monk,windwalker,17,7,10
Titsmagees,frostwolf,639,monk,windwalker,23,7,16
Shadowstripe,the-venture-co,638,monk,windwalker,11,7,4
Mùnkey,nagrand,638,monk,windwalker,17,7,10
Iilmachoggy,stormrage,607,monk,windwalker,11,7,4
Sistafistaa,akama,606,monk,windwalker,14,7,7
Goblinitto,archimonde,576,monk,windwalker,6,6,0
Softpourcorn,tichondrius,576,monk,windwalker,6,6,0
Makgøra,malganis,576,monk,windwalker,6,6,0
Aveium,moon-guard,576,monk,windwalker,6,6,0
Srýbrø,illidan,576,monk,windwalker,6,6,0
Griswolld,ragnaros,576,monk,windwalker,6,6,0
Brewlong,area-52,576,monk,windwalker,12,6,6
Tahs,azralon,576,monk,windwalker,12,6,6
Bonzibuddy,barthilas,576,monk,windwalker,12,6,6
Findorato,windrunner,576,monk,windwalker,12,6,6
Affected,lightninghoof,576,monk,windwalker,12,6,6
Xua,sargeras,576,monk,windwalker,12,6,6
Syffer,sargeras,576,monk,windwalker,12,6,6
Detoxalt,sargeras,576,monk,windwalker,12,6,6
Fivebears,blackwing-lair,576,monk,windwalker,12,6,6
Dippy,moon-guard,576,monk,windwalker,12,6,6
Läôtzu,fizzcrank,576,monk,windwalker,12,6,6
Cometx,darkspear,576,monk,windwalker,12,6,6
Kaminagi,proudmoore,576,monk,windwalker,12,6,6
Gaps,ragnaros,576,monk,windwalker,12,6,6
Silvyrx,boulderfist,576,monk,windwalker,12,6,6
Funtscat,zuljin,576,monk,windwalker,12,6,6
Orcslam,tichondrius,576,monk,windwalker,12,6,6
Bakacia,ragnaros,576,monk,windwalker,12,6,6
Coldridge,bleeding-hollow,576,monk,windwalker,12,6,6
Molsonicee,tichondrius,576,monk,windwalker,12,6,6
Xoir,tichondrius,576,monk,windwalker,12,6,6
Mcoos,tichondrius,576,monk,windwalker,12,6,6
Lümpz,tichondrius,576,monk,windwalker,12,6,6
Guuttzz,area-52,576,monk,windwalker,12,6,6
Jubei,dragonmaw,576,monk,windwalker,12,6,6
Varicin,zuljin,576,monk,windwalker,12,6,6
Fúgg,zuljin,576,monk,windwalker,12,6,6
Onepunchmän,zuljin,576,monk,windwalker,12,6,6
Tinypunch,emerald-dream,576,monk,windwalker,12,6,6
Yimmy,zuluhed,576,monk,windwalker,12,6,6
Grandsonweez,thrall,576,monk,windwalker,12,6,6
Jaykun,ragnaros,576,monk,windwalker,12,6,6
Creamchop,stormreaver,576,monk,windwalker,12,6,6
Forthekicks,tichondrius,576,monk,windwalker,19,8,11
Lxg,emerald-dream,576,monk,windwalker,18,6,12
Monjimen,ragnaros,576,monk,windwalker,18,6,12
Kuafu,illidan,576,monk,windwalker,18,6,12
Bollzdepe,wyrmrest-accord,576,monk,windwalker,18,6,12
Bvndio,ragnaros,576,monk,windwalker,18,6,12
Okuraseru,bleeding-hollow,576,monk,windwalker,18,6,12
Káizen,area-52,576,monk,windwalker,18,6,12
Fruitpünch,tichondrius,576,monk,windwalker,18,6,12
Tinklejuice,sargeras,576,monk,windwalker,18,6,12
Awsmonk,malygos,576,monk,windwalker,18,6,12
Frimayadri,area-52,575,monk,windwalker,12,6,6
Yoshimoku,dalaran,575,monk,windwalker,12,6,6
Atulzo,emerald-dream,575,monk,windwalker,12,6,6
Kalrsk,frostmourne,575,monk,windwalker,12,6,6
Tayden,korgath,575,monk,windwalker,12,6,6
Tsosai,wyrmrest-accord,575,monk,windwalker,12,6,6
Qma,shattered-halls,575,monk,windwalker,24,6,18
Mönk,blood-furnace,575,monk,windwalker,24,6,18
Dragorovich,aerie-peak,574,monk,windwalker,12,6,6
Linwong,garithos,574,monk,windwalker,12,6,6
Zhixx,stormrage,574,monk,windwalker,12,6,6
Fistidmi,area-52,573,monk,windwalker,12,6,6
Tøxicø,quelthalas,572,monk,windwalker,16,7,9
Yosisoy,zuljin,558,monk,windwalker,11,6,5
Liw,quelthalas,554,monk,windwalker,27,9,18
Stellae,emerald-dream,543,monk,windwalker,11,6,5
Crayóns,stormreaver,527,monk,windwalker,11,6,5
Bakicaa,dalaran,527,monk,windwalker,11,6,5
Wft,frostmourne,527,monk,windwalker,11,6,5
Rokkenstone,wyrmrest-accord,527,monk,windwalker,11,6,5
Jowtaro,azralon,522,monk,windwalker,16,7,9
Shindoro,bonechewer,521,monk,windwalker,16,10,6
Çruel,dalaran,511,monk,windwalker,14,6,8
Iflykites,zuljin,480,monk,windwalker,6,5,1
Pikadejegue,nemesis,480,monk,windwalker,6,5,1
Getmistéd,sargeras,480,monk,windwalker,6,5,1
Monkskiiz,tichondrius,480,monk,windwalker,6,5,1
Chipmonk,lightnings-blade,480,monk,windwalker,6,5,1
Cubs,sargeras,480,monk,windwalker,6,5,1
Nitrobrewed,stormrage,480,monk,windwalker,6,5,1
Pleasetouch,emerald-dream,480,monk,windwalker,6,5,1
Koochies,aegwynn,480,monk,windwalker,6,5,1
Hennyww,dalaran,480,monk,windwalker,6,5,1
Varimå,area-52,480,monk,windwalker,6,5,1
Zegood,tichondrius,480,monk,windwalker,6,5,1
Yunei,tichondrius,480,monk,windwalker,6,5,1
Shevchenkô,quelthalas,480,monk,windwalker,6,5,1
Bomba,arthas,480,monk,windwalker,6,5,1
Kuranchi,illidan,480,monk,windwalker,6,5,1
Yenjung,azralon,480,monk,windwalker,6,5,1
Miresa,kelthuzad,480,monk,windwalker,6,5,1
Iloveabby,sargeras,480,monk,windwalker,6,5,1
Blazebeast,blackhand,480,monk,windwalker,9,6,3
Ýogï,stormrage,480,monk,windwalker,10,6,4
Tyrus,kelthuzad,480,monk,windwalker,9,5,4
Xhu,kelthuzad,480,monk,windwalker,12,5,7
Transcend,nerzhul,480,monk,windwalker,12,5,7
Tripster,wyrmrest-accord,480,monk,windwalker,12,5,7
Saywha,windrunner,480,monk,windwalker,12,5,7
Zakuu,blackrock,480,monk,windwalker,12,5,7
Zadaa,alleria,480,monk,windwalker,12,5,7
Monkdruffy,tichondrius,480,monk,windwalker,12,5,7
Antril,bleeding-hollow,480,monk,windwalker,12,5,7
Browniemix,tichondrius,480,monk,windwalker,12,5,7
Chrisdamonk,stormrage,480,monk,windwalker,12,5,7
Pathad,stormrage,480,monk,windwalker,12,5,7
Bokchoii,sargeras,480,monk,windwalker,12,5,7
Mepepegaclap,malganis,480,monk,windwalker,12,5,7
Kickkick,burning-blade,480,monk,windwalker,12,5,7
Trunkx,area-52,480,monk,windwalker,12,5,7
Chakrah,laughing-skull,480,monk,windwalker,12,5,7
Valdur,sargeras,480,monk,windwalker,12,5,7
Pikx,frostmourne,480,monk,windwalker,12,5,7
Xifang,malganis,480,monk,windwalker,12,5,7
Ferknights,moon-guard,480,monk,windwalker,12,5,7
Lokimana,zuljin,480,monk,windwalker,12,5,7
Slp,frostmourne,480,monk,windwalker,12,5,7
Nomonko,tichondrius,480,monk,windwalker,12,5,7
Tenkix,zuljin,480,monk,windwalker,12,5,7
Ultraop,emerald-dream,480,monk,windwalker,12,5,7
Zhíu,ragnaros,480,monk,windwalker,12,5,7
Abdoolah,illidan,480,monk,windwalker,12,5,7
Plagai,fizzcrank,480,monk,windwalker,12,5,7
Kalsaa,illidan,480,monk,windwalker,12,5,7
Kickflipy,dalaran,480,monk,windwalker,18,7,11
Ãcé,ragnaros,480,monk,windwalker,18,5,13
Wheresmyjuul,malganis,480,monk,windwalker,18,5,13
Maisoftheart,barthilas,480,monk,windwalker,18,5,13
Smigz,area-52,480,monk,windwalker,18,5,13
Vinndz,azralon,480,monk,windwalker,18,5,13
Gabaan,azralon,480,monk,windwalker,18,5,13
Zmajevratnik,illidan,479,monk,windwalker,6,5,1
Brzy,spinebreaker,479,monk,windwalker,12,5,7
Tababtz,illidan,479,monk,windwalker,12,5,7
Shà,kelthuzad,479,monk,windwalker,12,5,7
Kiukiukiu,tichondrius,479,monk,windwalker,12,5,7
Breakbonez,dalaran,479,monk,windwalker,24,5,19
Tamonk,veknilash,478,monk,windwalker,6,5,1
Smashdmonk,gnomeregan,476,monk,windwalker,12,5,7
Leisa,jaedenar,463,monk,windwalker,17,5,12
Orcarucas,illidan,447,monk,windwalker,8,6,2
Mcmaplol,tichondrius,447,monk,windwalker,11,5,6
Chisuschrist,hyjal,432,monk,windwalker,15,5,10
Aethër,quelthalas,416,monk,windwalker,10,5,5
Prettyflacko,thrall,416,monk,windwalker,10,5,5
Turboðiesel,malganis,400,monk,windwalker,7,5,2
Diccheez,kelthuzad,384,monk,windwalker,6,4,2
Ðøhkø,nemesis,384,monk,windwalker,6,4,2
Paullyfists,garona,384,monk,windwalker,6,4,2
Ganksyou,sargeras,384,monk,windwalker,6,4,2
Thewyjr,illidan,384,monk,windwalker,6,4,2
Stevìl,medivh,384,monk,windwalker,6,4,2
Chopana,malganis,384,monk,windwalker,6,4,2
Thoraki,illidan,384,monk,windwalker,6,4,2
Champoo,executus,384,monk,windwalker,6,4,2
Milli,twisting-nether,384,monk,windwalker,6,4,2
Cowhoe,icecrown,384,monk,windwalker,6,4,2
Etrasu,thrall,384,monk,windwalker,6,4,2
Krawnick,malganis,384,monk,windwalker,6,4,2
Ezpumpm,azralon,384,monk,windwalker,6,4,2
Castiwhite,quelthalas,384,monk,windwalker,6,4,2
Freetristan,sargeras,384,monk,windwalker,6,4,2
Lowkn,sargeras,384,monk,windwalker,6,4,2
Jackphan,azralon,384,monk,windwalker,6,4,2
Cowsgonuts,gorefiend,384,monk,windwalker,6,4,2
Preceptonk,azralon,384,monk,windwalker,6,4,2
Liucang,archimonde,384,monk,windwalker,6,4,2
Zenitsu,burning-blade,384,monk,windwalker,6,4,2
Gorblox,emerald-dream,384,monk,windwalker,6,4,2
Jbebe,tichondrius,384,monk,windwalker,6,4,2
Rugalmaster,stormrage,384,monk,windwalker,6,4,2
Monkespin,stormrage,384,monk,windwalker,6,4,2
Punchbuggy,frostmourne,384,monk,windwalker,6,4,2
Orbgodx,darkspear,384,monk,windwalker,6,4,2
Chizhao,tichondrius,384,monk,windwalker,6,4,2
Donbaltica,ragnaros,384,monk,windwalker,6,4,2
Evanyfist,proudmoore,384,monk,windwalker,6,4,2
Imperio,stormrage,384,monk,windwalker,6,4,2
Vernki,laughing-skull,384,monk,windwalker,6,4,2
Shandaspanda,rivendare,384,monk,windwalker,6,4,2
Fistedby,nesingwary,384,monk,windwalker,6,4,2
Falconpaunch,bleeding-hollow,384,monk,windwalker,6,4,2
Xulieng,tichondrius,384,monk,windwalker,6,4,2
Korgark,tichondrius,384,monk,windwalker,6,4,2
Research,frostmourne,384,monk,windwalker,6,4,2
Molific,gurubashi,384,monk,windwalker,6,4,2
Saitamami,tichondrius,384,monk,windwalker,6,4,2
Mabaoguo,aerie-peak,384,monk,windwalker,6,4,2
Crave,tichondrius,384,monk,windwalker,6,4,2
Kame,moon-guard,384,monk,windwalker,6,4,2
Barleygar,tichondrius,384,monk,windwalker,6,4,2
Kiggo,bonechewer,384,monk,windwalker,6,4,2
Vetting,stormrage,384,monk,windwalker,6,4,2
Satchelgizmo,tichondrius,384,monk,windwalker,6,4,2
Delaî,dalaran,384,monk,windwalker,6,4,2
Trembull,gurubashi,384,monk,windwalker,6,4,2
Yomonk,hydraxis,384,monk,windwalker,6,4,2
Hazed,lightbringer,384,monk,windwalker,6,4,2
Jeevous,darkspear,384,monk,windwalker,6,4,2
Garyblizard,bleeding-hollow,384,monk,windwalker,6,4,2
Pàí,tichondrius,384,monk,windwalker,6,4,2
Aedalithe,stormrage,384,monk,windwalker,6,4,2
Illiea,cenarius,384,monk,windwalker,6,4,2
Torpedo,blackrock,384,monk,windwalker,6,4,2
Sobuu,wyrmrest-accord,384,monk,windwalker,6,4,2
Saucers,bleeding-hollow,384,monk,windwalker,6,4,2
Serenitys,tanaris,384,monk,windwalker,9,4,5
Piece,blackrock,384,monk,windwalker,12,4,8
Tesdra,moon-guard,384,monk,windwalker,12,4,8
Giorhno,ragnaros,384,monk,windwalker,12,4,8
Kfp,gorefiend,384,monk,windwalker,12,4,8
Jxytwo,arygos,384,monk,windwalker,12,4,8
Rookz,drakthul,384,monk,windwalker,12,4,8
Ramisan,barthilas,384,monk,windwalker,12,4,8
Sïfu,barthilas,384,monk,windwalker,12,4,8
Raekwan,area-52,384,monk,windwalker,12,4,8
Xinvictus,frostmourne,384,monk,windwalker,12,4,8
Bwan,kelthuzad,384,monk,windwalker,12,4,8
Evilstep,tichondrius,384,monk,windwalker,12,4,8
Solrise,wyrmrest-accord,384,monk,windwalker,12,4,8
Téoo,azralon,384,monk,windwalker,12,4,8
Cranjis,agamaggan,384,monk,windwalker,12,4,8
Machita,spirestone,384,monk,windwalker,12,4,8
Ohtani,frostwolf,384,monk,windwalker,12,4,8
Firepandax,ragnaros,384,monk,windwalker,12,4,8
Forestweaver,area-52,384,monk,windwalker,12,4,8
Tóru,kelthuzad,384,monk,windwalker,12,4,8
Fluffykitty,deathwing,384,monk,windwalker,12,4,8
Burningfist,stormrage,384,monk,windwalker,12,4,8
Nakwood,proudmoore,384,monk,windwalker,12,4,8
Talondien,dalaran,384,monk,windwalker,12,4,8
Chijinx,area-52,384,monk,windwalker,12,4,8
Cudzingtin,dalaran,384,monk,windwalker,12,4,8
Gai,gorgonnash,384,monk,windwalker,12,4,8
Mysticzen,tichondrius,384,monk,windwalker,12,4,8
Kygol,zuljin,384,monk,windwalker,12,4,8
Gngrbeardman,tichondrius,384,monk,windwalker,12,4,8
Ferrarí,quelthalas,384,monk,windwalker,12,4,8
Tcjwindx,bleeding-hollow,384,monk,windwalker,12,4,8
Ruì,malganis,384,monk,windwalker,18,4,14
Jayr,bleeding-hollow,384,monk,windwalker,18,4,14
Fistermus,tichondrius,384,monk,windwalker,36,4,32
Zanmonk,moon-guard,383,monk,windwalker,6,4,2
Chugs,malorne,383,monk,windwalker,18,4,14
Viko,llane,382,monk,windwalker,6,4,2
Lilutha,illidan,382,monk,windwalker,12,4,8
Sickl,blood-furnace,382,monk,windwalker,24,4,20
Broxxenidas,quelthalas,351,monk,windwalker,11,4,7
Nakuang,tichondrius,339,monk,windwalker,24,7,17
Sunraa,zuljin,330,monk,windwalker,14,5,9
Ariannahxd,malganis,330,monk,windwalker,15,5,10
Mistyfist,bleeding-hollow,330,monk,windwalker,22,5,17
Jeffspicoli,emerald-dream,319,monk,windwalker,5,4,1
Hanzøu,ragnaros,288,monk,windwalker,6,3,3
Triixxy,thrall,288,monk,windwalker,6,3,3
Niçky,tichondrius,288,monk,windwalker,6,3,3
Monklad,malganis,288,monk,windwalker,6,3,3
ßluedream,dalaran,288,monk,windwalker,6,3,3
Reflexsivex,malganis,288,monk,windwalker,6,3,3
Wungpow,magtheridon,288,monk,windwalker,6,3,3
Leemîn,tichondrius,288,monk,windwalker,6,3,3
Gulmokk,tichondrius,288,monk,windwalker,6,3,3
Oyyo,tichondrius,288,monk,windwalker,6,3,3
Badvisto,dalaran,288,monk,windwalker,6,3,3
Sýññ,illidan,288,monk,windwalker,6,3,3
Cannafist,tichondrius,288,monk,windwalker,6,3,3
Rhonco,quelthalas,288,monk,windwalker,6,3,3
Mfmiscreant,illidan,288,monk,windwalker,6,3,3
Mlngo,illidan,288,monk,windwalker,6,3,3
Brewtool,tichondrius,288,monk,windwalker,6,3,3
Mgisloth,sargeras,288,monk,windwalker,6,3,3
Mcfluffey,area-52,288,monk,windwalker,6,3,3
Sugmi,barthilas,288,monk,windwalker,6,3,3
Dripharder,tichondrius,288,monk,windwalker,6,3,3
Rumlee,sargeras,288,monk,windwalker,6,3,3
Kyzen,trollbane,288,monk,windwalker,6,3,3
Tigerlust,sargeras,288,monk,windwalker,6,3,3
Daspmonk,nagrand,288,monk,windwalker,6,3,3
Zexana,gorefiend,288,monk,windwalker,6,3,3
Thalassassin,bleeding-hollow,288,monk,windwalker,6,3,3
Oligast,tichondrius,288,monk,windwalker,6,3,3
Fistsofbeans,area-52,288,monk,windwalker,6,3,3
Pusily,tichondrius,288,monk,windwalker,6,3,3
Swurvex,bleeding-hollow,288,monk,windwalker,6,3,3
Goodluck,madoran,288,monk,windwalker,6,3,3
Burash,frostwolf,288,monk,windwalker,6,3,3
Bunnynoodle,gnomeregan,288,monk,windwalker,6,3,3
Raires,tichondrius,288,monk,windwalker,6,3,3
Lackofsleep,tichondrius,288,monk,windwalker,6,3,3
Muffinz,shattered-halls,288,monk,windwalker,6,3,3
Hábìtz,area-52,288,monk,windwalker,6,3,3
Shogún,frostmourne,288,monk,windwalker,6,3,3
Sosm,kelthuzad,288,monk,windwalker,6,3,3
Ashzen,azralon,288,monk,windwalker,6,3,3
Gageismonk,mugthol,288,monk,windwalker,6,3,3
Lomist,nazjatar,288,monk,windwalker,6,3,3
Highaskite,tichondrius,288,monk,windwalker,6,3,3
Akumuh,area-52,288,monk,windwalker,6,3,3
Mgzx,kelthuzad,288,monk,windwalker,6,3,3
Ultracosmic,sargeras,288,monk,windwalker,6,3,3
Karkata,sargeras,288,monk,windwalker,6,3,3
Tonkchi,khaz-modan,288,monk,windwalker,6,3,3
Hellcow,frostmourne,288,monk,windwalker,6,3,3
Maserati,azjolnerub,288,monk,windwalker,6,3,3
Harvex,area-52,288,monk,windwalker,6,3,3
Detox,sargeras,288,monk,windwalker,6,3,3
Akumuh,tichondrius,288,monk,windwalker,6,3,3
Bogez,area-52,288,monk,windwalker,6,3,3
Conterkick,stormrage,288,monk,windwalker,6,3,3
Zonianman,tichondrius,288,monk,windwalker,6,3,3
Mistérfister,blackrock,288,monk,windwalker,6,3,3
Evilbit,boulderfist,288,monk,windwalker,6,3,3
Kallandron,thunderhorn,288,monk,windwalker,6,3,3
Momkisserl,sargeras,288,monk,windwalker,6,3,3
Fistay,burning-legion,288,monk,windwalker,6,3,3
Rolybones,boulderfist,288,monk,windwalker,6,3,3
Carmelfist,kargath,288,monk,windwalker,6,3,3
Frogepoge,area-52,288,monk,windwalker,6,3,3
Legolos,runetotem,288,monk,windwalker,6,3,3
Fysicalx,stormrage,288,monk,windwalker,6,3,3
Nosmonk,aegwynn,288,monk,windwalker,6,3,3
Atezo,tichondrius,288,monk,windwalker,6,3,3
Bromonster,zuljin,288,monk,windwalker,6,3,3
Spaaca,kelthuzad,288,monk,windwalker,6,3,3
Slurrpslutt,proudmoore,288,monk,windwalker,6,3,3
Tictox,sargeras,288,monk,windwalker,6,3,3
Dorander,frostmourne,288,monk,windwalker,6,3,3
Rampant,anubarak,288,monk,windwalker,9,4,5
Zubon,draenor,288,monk,windwalker,10,3,7
Wwx,whisperwind,288,monk,windwalker,12,3,9
Joreg,moon-guard,288,monk,windwalker,12,3,9
Howlit,illidan,288,monk,windwalker,12,3,9
Vova,bleeding-hollow,288,monk,windwalker,12,3,9
Samanosukee,illidan,288,monk,windwalker,12,3,9
Aangg,madoran,288,monk,windwalker,12,3,9
Bvndo,illidan,288,monk,windwalker,12,3,9
Kthanïd,ragnaros,288,monk,windwalker,12,3,9
Keloxx,ragnaros,288,monk,windwalker,12,3,9
Raviolipolie,sargeras,288,monk,windwalker,12,3,9
Meatcleave,kiljaeden,288,monk,windwalker,12,3,9
Tofugoku,area-52,288,monk,windwalker,12,3,9
Snorf,lightbringer,288,monk,windwalker,12,3,9
Atarii,emerald-dream,288,monk,windwalker,12,3,9
Setzua,cairne,288,monk,windwalker,12,3,9
Paramendic,frostwolf,288,monk,windwalker,12,3,9
Shizzyowoxd,bleeding-hollow,288,monk,windwalker,12,3,9
Natörr,dalaran,288,monk,windwalker,12,3,9
Donn,illidan,288,monk,windwalker,12,3,9
Kickxy,sargeras,288,monk,windwalker,12,3,9
Saohta,quelthalas,288,monk,windwalker,12,3,9
Messym,illidan,288,monk,windwalker,12,3,9
Bujiburger,frostmourne,288,monk,windwalker,12,3,9
Senseixww,sargeras,288,monk,windwalker,12,3,9
Dankestkhan,korialstrasz,288,monk,windwalker,18,3,15
Dmhsaint,sargeras,288,monk,windwalker,18,3,15
Brewmooser,area-52,287,monk,windwalker,6,3,3
Firstfire,stormrage,287,monk,windwalker,12,3,9
Kaila,laughing-skull,287,monk,windwalker,12,3,9
Gaziee,tichondrius,271,monk,windwalker,11,3,8
Dafuqk,stormrage,256,monk,windwalker,16,3,13
Hellrosennin,area-52,239,monk,windwalker,5,3,2
Rockfu,illidan,239,monk,windwalker,5,3,2
Klamfu,thrall,192,monk,windwalker,4,3,1
Mùk,tichondrius,192,monk,windwalker,4,3,1
Igetbar,barthilas,192,monk,windwalker,4,3,1
Sù,moon-guard,192,monk,windwalker,6,2,4
Fuchizaki,ragnaros,192,monk,windwalker,6,2,4
Fistpumps,thrall,192,monk,windwalker,6,2,4
Rouladecave,zuljin,192,monk,windwalker,6,2,4
Furrykisser,tichondrius,192,monk,windwalker,6,2,4
Puraimu,sargeras,192,monk,windwalker,6,2,4
Gumrag,illidan,192,monk,windwalker,6,2,4
Toryfists,sargeras,192,monk,windwalker,6,2,4
Imafqnbaby,tichondrius,192,monk,windwalker,6,2,4
Xoulee,stormrage,192,monk,windwalker,6,2,4
Khnum,fizzcrank,192,monk,windwalker,6,2,4
Undmonge,azralon,192,monk,windwalker,6,2,4
Kitfisty,kiljaeden,192,monk,windwalker,6,2,4
Mtnbrew,sargeras,192,monk,windwalker,6,2,4
Bhoredom,kiljaeden,192,monk,windwalker,6,2,4
Gracesowner,moon-guard,192,monk,windwalker,6,2,4
Jadiel,quelthalas,192,monk,windwalker,6,2,4
Archlord,sargeras,192,monk,windwalker,6,2,4
Hossdelgadoe,kiljaeden,192,monk,windwalker,6,2,4
Smungus,bloodscalp,192,monk,windwalker,6,2,4
Itakebigpoop,dalaran,192,monk,windwalker,6,2,4
Yopper,tichondrius,192,monk,windwalker,6,2,4
Sizerp,stormrage,192,monk,windwalker,6,2,4
Ramhemi,kiljaeden,192,monk,windwalker,6,2,4
Monkash,sargeras,192,monk,windwalker,6,2,4
Halfapizza,sargeras,192,monk,windwalker,6,2,4
Merrell,area-52,192,monk,windwalker,6,2,4
Robocto,area-52,192,monk,windwalker,6,2,4
Rugis,moon-guard,192,monk,windwalker,6,2,4
Vascore,frostmourne,192,monk,windwalker,6,2,4
Averagéjoe,tichondrius,192,monk,windwalker,6,2,4
Tadaku,dalaran,192,monk,windwalker,6,2,4
Upcoming,moon-guard,192,monk,windwalker,6,2,4
Trillek,firetree,192,monk,windwalker,6,2,4
Takazawas,bonechewer,192,monk,windwalker,6,2,4
Mîstchievous,sargeras,192,monk,windwalker,6,2,4
Spirits,dreadmaul,192,monk,windwalker,6,2,4
Epî,tichondrius,192,monk,windwalker,6,2,4
Toxicaff,dalaran,192,monk,windwalker,6,2,4
Flicksx,arthas,192,monk,windwalker,6,2,4
Noget,frostmourne,192,monk,windwalker,6,2,4
Weslolz,kiljaeden,192,monk,windwalker,6,2,4
Musclemanx,tichondrius,192,monk,windwalker,6,2,4
Deyasth,zuljin,192,monk,windwalker,6,2,4
Happymonk,tichondrius,192,monk,windwalker,6,2,4
Weendwolker,moon-guard,192,monk,windwalker,6,2,4
Gøldéngødx,tichondrius,192,monk,windwalker,6,2,4
Streetcreds,bleeding-hollow,192,monk,windwalker,6,2,4
Privix,tichondrius,192,monk,windwalker,6,2,4
Mîghtguy,barthilas,192,monk,windwalker,6,2,4
Lìpz,zuljin,192,monk,windwalker,6,2,4
Boeingair,kelthuzad,192,monk,windwalker,6,2,4
Hydraoxy,moon-guard,192,monk,windwalker,6,2,4
Grëyfox,sargeras,192,monk,windwalker,6,2,4
Möösê,moon-guard,192,monk,windwalker,6,2,4
Fistnyou,norgannon,192,monk,windwalker,6,2,4
Dakunitsu,illidan,192,monk,windwalker,6,2,4
Metaxzy,sargeras,192,monk,windwalker,6,2,4
Troutz,sargeras,192,monk,windwalker,6,2,4
Coomerww,kelthuzad,192,monk,windwalker,6,2,4
Monkbro,altar-of-storms,192,monk,windwalker,6,2,4
Prf,ragnaros,192,monk,windwalker,6,2,4
Meidan,azralon,192,monk,windwalker,6,2,4
Zengawd,magtheridon,192,monk,windwalker,6,2,4
Seshiro,area-52,192,monk,windwalker,6,2,4
Jüdo,barthilas,192,monk,windwalker,6,2,4
Kakusanni,nemesis,192,monk,windwalker,6,2,4
Induhca,area-52,192,monk,windwalker,6,2,4
Ked,ragnaros,192,monk,windwalker,6,2,4
Taringa,drakkari,192,monk,windwalker,6,2,4
Bubblewater,illidan,192,monk,windwalker,6,2,4
Wrynnerverse,tichondrius,192,monk,windwalker,6,2,4
Sudoyo,tichondrius,192,monk,windwalker,6,2,4
Hutmok,dalaran,192,monk,windwalker,6,2,4
Pvptone,bleeding-hollow,192,monk,windwalker,6,2,4
Lonebamboo,tichondrius,192,monk,windwalker,6,2,4
Théwy,tichondrius,192,monk,windwalker,6,2,4
Závior,emerald-dream,192,monk,windwalker,6,2,4
Mangoxdd,kelthuzad,192,monk,windwalker,6,2,4
Tenfingers,dalaran,192,monk,windwalker,6,2,4
Brokenfeels,azralon,192,monk,windwalker,6,2,4
Dragoro,exodar,192,monk,windwalker,6,2,4
Bakusao,bleeding-hollow,192,monk,windwalker,6,2,4
Xarra,bleeding-hollow,192,monk,windwalker,6,2,4
Sinistuhm,tichondrius,192,monk,windwalker,6,2,4
Defacen,illidan,192,monk,windwalker,6,2,4
Sukrit,darkspear,192,monk,windwalker,6,2,4
Heävenly,kelthuzad,192,monk,windwalker,6,2,4
Salanzoww,bleeding-hollow,192,monk,windwalker,6,2,4
Strongmandan,twisting-nether,192,monk,windwalker,6,2,4
Akiiko,draenor,192,monk,windwalker,6,2,4
Vulpirino,drakkari,192,monk,windwalker,6,2,4
Fenghou,tichondrius,192,monk,windwalker,6,2,4
Icesmoker,frostmourne,192,monk,windwalker,6,2,4
Ðudü,azralon,192,monk,windwalker,6,2,4
Brodabren,proudmoore,192,monk,windwalker,6,2,4
Thöran,ragnaros,192,monk,windwalker,6,2,4
Brëwslee,twisting-nether,192,monk,windwalker,6,2,4
Guyfíeri,velen,192,monk,windwalker,8,2,6
Chnko,sargeras,192,monk,windwalker,12,2,10
Ellicool,frostmourne,192,monk,windwalker,12,2,10
Pongo,kelthuzad,192,monk,windwalker,12,2,10
Eliwenn,ragnaros,192,monk,windwalker,12,2,10
Motivmonk,uldum,192,monk,windwalker,12,2,10
Obozo,frostmourne,192,monk,windwalker,12,2,10
Bruceflea,gurubashi,192,monk,windwalker,18,2,16
Staypuftmm,tichondrius,191,monk,windwalker,6,2,4
Kipao,deathwing,191,monk,windwalker,12,2,10
Punch,agamaggan,175,monk,windwalker,11,2,9
Goku,frostmourne,159,monk,windwalker,5,2,3
Lazy,shattered-halls,159,monk,windwalker,5,2,3
Wheatsli,malganis,159,monk,windwalker,5,2,3
Fendi,stormrage,159,monk,windwalker,5,2,3
Shenlong,jaedenar,159,monk,windwalker,6,2,4
Heavytrain,azralon,138,monk,windwalker,10,4,6
Choyou,bleeding-hollow,138,monk,windwalker,10,4,6
Dinko,area-52,128,monk,windwalker,4,2,2
Heartsies,sargeras,128,monk,windwalker,4,2,2
Jayjaybrew,area-52,96,monk,windwalker,3,2,1
Vanishm,ragnaros,96,monk,windwalker,3,2,1
Neaxain,tichondrius,96,monk,windwalker,3,2,1
Monkwayz,emerald-dream,96,monk,windwalker,3,2,1
Banidiin,moon-guard,96,monk,windwalker,6,1,5
Vanaxi,moon-guard,96,monk,windwalker,6,1,5
Dasubb,crushridge,96,monk,windwalker,6,1,5
Minicoco,barthilas,96,monk,windwalker,6,1,5
Kåelarayn,moon-guard,96,monk,windwalker,6,1,5
Pandacottoco,azralon,96,monk,windwalker,6,1,5
Murgleh,misha,96,monk,windwalker,6,1,5
Jh,korgath,96,monk,windwalker,6,1,5
Srshy,drakkari,96,monk,windwalker,6,1,5
Quaria,moon-guard,96,monk,windwalker,6,1,5
Chipócluda,ragnaros,96,monk,windwalker,6,1,5
Cerocool,hyjal,96,monk,windwalker,6,1,5
Ravenius,moon-guard,96,monk,windwalker,6,1,5
Jg,staghelm,96,monk,windwalker,6,1,5
Rileyreidfan,azjolnerub,96,monk,windwalker,6,1,5
Friëden,quelthalas,96,monk,windwalker,6,1,5
Nbatrap,stormrage,96,monk,windwalker,6,1,5
Pwap,moon-guard,96,monk,windwalker,6,1,5
Teewin,area-52,96,monk,windwalker,6,1,5
Zinque,emerald-dream,96,monk,windwalker,6,1,5
Siserfister,sargeras,96,monk,windwalker,6,1,5
Sanemi,amanthul,96,monk,windwalker,6,1,5
Blacdaryl,destromath,96,monk,windwalker,6,1,5
Buddaba,tichondrius,96,monk,windwalker,6,1,5
Fiztingfaded,area-52,96,monk,windwalker,6,1,5
Boomboomspin,illidan,96,monk,windwalker,6,1,5
Lainerya,moon-guard,96,monk,windwalker,6,1,5
Bussyweaver,sargeras,96,monk,windwalker,6,1,5
Srgtbingo,azgalor,96,monk,windwalker,6,1,5
Espanasan,dalaran,96,monk,windwalker,6,1,5
Æsir,moon-guard,96,monk,windwalker,6,1,5
Cystweaver,dalaran,96,monk,windwalker,6,1,5
Comical,malygos,96,monk,windwalker,6,1,5
Spicybrew,tichondrius,96,monk,windwalker,6,1,5
Munnk,stormreaver,96,monk,windwalker,6,1,5
Pléb,kelthuzad,96,monk,windwalker,6,1,5
Kablam,frostmourne,96,monk,windwalker,6,1,5
Piccolo,emerald-dream,96,monk,windwalker,6,1,5
Furrwalker,tichondrius,96,monk,windwalker,6,1,5
Imingleejr,illidan,96,monk,windwalker,6,1,5
Ischys,kelthuzad,96,monk,windwalker,6,1,5
Gablle,tol-barad,96,monk,windwalker,6,1,5
Giriom,thrall,96,monk,windwalker,6,1,5
Emßerly,thrall,96,monk,windwalker,6,1,5
Stratachi,malganis,96,monk,windwalker,6,1,5
Netang,emerald-dream,96,monk,windwalker,6,1,5
Monkanome,gilneas,96,monk,windwalker,6,1,5
Tmtricks,tichondrius,96,monk,windwalker,6,1,5
Yípman,uldum,96,monk,windwalker,6,1,5
Monkspanka,nemesis,96,monk,windwalker,6,1,5
Memurk,bleeding-hollow,96,monk,windwalker,6,1,5
Cloudsinger,hellscream,96,monk,windwalker,6,1,5
Windlordx,illidan,96,monk,windwalker,6,1,5
Minimonki,bleeding-hollow,96,monk,windwalker,6,1,5
Saruyo,frostmourne,96,monk,windwalker,12,1,11
Cmon,icecrown,96,monk,windwalker,12,1,11
Tuskytwofist,kargath,96,monk,windwalker,12,1,11
Criminall,aegwynn,64,monk,windwalker,4,1,3
Hít,bonechewer,64,monk,windwalker,4,1,3
Zhatafaq,ragnaros,48,monk,windwalker,3,1,2
Stumpling,earthen-ring,42,monk,windwalker,10,3,7
Kreese,rivendare,42,monk,windwalker,9,2,7
Alzen,tichondrius,42,monk,windwalker,9,2,7
Cosetteb,proudmoore,31,monk,windwalker,2,1,1
Notamønk,bonechewer,31,monk,windwalker,2,1,1
Laggyfist,frostmourne,16,monk,windwalker,1,1,0
Rèxpéi,area-52,2157,paladin,holy,84,48,36
Tmborn,tichondrius,2152,paladin,holy,165,86,79
Holylolz,ragnaros,2129,paladin,holy,270,137,133
Overwhelm,muradin,2125,paladin,holy,64,39,25
Pattar,area-52,2107,paladin,holy,66,37,29
Dreathhammer,muradin,2107,paladin,holy,107,56,51
Sunita,arthas,2080,paladin,holy,207,107,100
Caveyodeler,zuluhed,2048,paladin,holy,77,45,32
Digglesx,area-52,2012,paladin,holy,78,35,43
Eskerda,nemesis,2010,paladin,holy,77,38,39
Bubblebuddyx,tichondrius,2010,paladin,holy,136,66,70
Bilmurii,zuljin,2001,paladin,holy,108,58,50
Curator,emerald-dream,1994,paladin,holy,86,44,42
Saacbot,area-52,1959,paladin,holy,81,34,47
Careless,malganis,1956,paladin,holy,72,37,35
Reverbz,malganis,1953,paladin,holy,120,56,64
Badnold,area-52,1952,paladin,holy,55,26,29
Flashv,barthilas,1936,paladin,holy,68,36,32
Bombboyoz,area-52,1936,paladin,holy,84,44,40
Flõw,gnomeregan,1919,paladin,holy,84,52,32
Hamsti,sargeras,1909,paladin,holy,125,63,62
Scamlikely,tichondrius,1905,paladin,holy,139,75,64
Sde,kelthuzad,1899,paladin,holy,138,66,72
Braindeadrsj,anetheron,1890,paladin,holy,185,99,86
Angrycubanx,black-dragonflight,1887,paladin,holy,50,25,25
Jaywalker,baelgun,1885,paladin,holy,78,45,33
Baelsimp,illidan,1884,paladin,holy,114,59,55
Pelletbrain,emerald-dream,1882,paladin,holy,313,160,153
Nickimahoj,tichondrius,1882,paladin,holy,98,48,50
Thejustice,tichondrius,1870,paladin,holy,162,79,83
Shxz,illidan,1869,paladin,holy,54,31,23
Cynthianna,tichondrius,1865,paladin,holy,266,137,129
Chunzhangsqs,tichondrius,1864,paladin,holy,72,36,36
Bravepala,tichondrius,1862,paladin,holy,78,35,43
Duallkore,stormrage,1861,paladin,holy,84,46,38
Thejustices,tichondrius,1860,paladin,holy,36,22,14
Chenzo,exodar,1856,paladin,holy,206,110,96
Hojula,area-52,1851,paladin,holy,28,21,7
Scrubbinton,zuljin,1850,paladin,holy,114,58,56
Judgejim,barthilas,1849,paladin,holy,270,132,138
Csupremacy,tichondrius,1848,paladin,holy,111,53,58
Ðáxø,sargeras,1846,paladin,holy,48,25,23
Eskerda,azralon,1844,paladin,holy,238,110,128
Ddeuk,tichondrius,1841,paladin,holy,593,309,284
Dýstopia,stormrage,1841,paladin,holy,41,21,20
Skillenjoyer,tichondrius,1839,paladin,holy,78,49,29
Bobthemad,illidan,1838,paladin,holy,59,33,26
Bushyy,tichondrius,1838,paladin,holy,54,26,28
Sojupapi,area-52,1826,paladin,holy,239,119,120
Ppgdx,azralon,1826,paladin,holy,78,34,44
Cyphinx,darkspear,1822,paladin,holy,103,48,55
Memnoche,frostmane,1821,paladin,holy,89,53,36
Sacbubldead,area-52,1820,paladin,holy,126,79,47
Nyctemavanna,ragnaros,1820,paladin,holy,136,70,66
Perfect,crushridge,1820,paladin,holy,56,28,28
Deadlyassian,sargeras,1819,paladin,holy,100,54,46
Zilea,kiljaeden,1818,paladin,holy,102,44,58
Everrlasting,tichondrius,1817,paladin,holy,72,36,36
Esd,kelthuzad,1817,paladin,holy,71,31,40
Fonypally,tichondrius,1815,paladin,holy,332,171,161
Waifu,area-52,1813,paladin,holy,36,22,14
Fukndibs,kiljaeden,1811,paladin,holy,172,85,87
Sd,kelthuzad,1811,paladin,holy,123,59,64
Bubblist,tichondrius,1811,paladin,holy,68,28,40
Mctacos,proudmoore,1810,paladin,holy,30,23,7
Bravepl,tichondrius,1808,paladin,holy,73,28,45
Dracfire,zuljin,1807,paladin,holy,45,24,21
Truluck,area-52,1807,paladin,holy,153,77,76
Barcie,lothar,1807,paladin,holy,108,50,58
Zetsubõ,stormrage,1806,paladin,holy,54,24,30
Insthy,illidan,1804,paladin,holy,185,97,88
Ængelic,barthilas,1803,paladin,holy,202,107,95
Dyppally,moon-guard,1803,paladin,holy,102,51,51
Wtbmana,frostmourne,1801,paladin,holy,72,39,33
Virabelle,gurubashi,1801,paladin,holy,66,33,33
Varies,kelthuzad,1801,paladin,holy,58,28,30
Tylennis,archimonde,1801,paladin,holy,172,82,90
Richpiana,nathrezim,1800,paladin,holy,106,60,46
Kevinthecube,nerzhul,1797,paladin,holy,60,44,16
Hongwoosang,tichondrius,1795,paladin,holy,188,89,99
Hats,icecrown,1791,paladin,holy,233,120,113
Chobbler,tichondrius,1788,paladin,holy,66,26,40
Amourranth,stormrage,1785,paladin,holy,52,30,22
Airbad,tichondrius,1785,paladin,holy,53,23,30
Colepal,zuljin,1777,paladin,holy,102,44,58
Veejayx,tichondrius,1775,paladin,holy,44,21,23
Ðáx,sargeras,1765,paladin,holy,177,86,91
Hps,argent-dawn,1759,paladin,holy,42,22,20
Theebus,tichondrius,1753,paladin,holy,71,28,43
Defensezone,tichondrius,1749,paladin,holy,74,36,38
Adrizzyx,barthilas,1748,paladin,holy,42,23,19
Mercedez,bleeding-hollow,1744,paladin,holy,102,53,49
Uxe,zuljin,1735,paladin,holy,126,58,68
Ihaveajob,zuluhed,1730,paladin,holy,42,23,19
Xciss,kiljaeden,1730,paladin,holy,350,173,177
Bpalaax,kelthuzad,1728,paladin,holy,93,50,43
Evylinn,burning-legion,1727,paladin,holy,150,83,67
Cewekmbek,barthilas,1727,paladin,holy,48,19,29
Peggy,azralon,1724,paladin,holy,51,27,24
Chenzio,garona,1719,paladin,holy,69,44,25
Fixyouz,mannoroth,1718,paladin,holy,118,55,63
Boomda,tichondrius,1715,paladin,holy,205,110,95
Ckaïnë,stormrage,1714,paladin,holy,68,36,32
Pallice,queldorei,1714,paladin,holy,126,61,65
Softsister,tichondrius,1713,paladin,holy,42,22,20
Bpalaayo,kelthuzad,1707,paladin,holy,110,48,62
Heaven,gurubashi,1705,paladin,holy,47,22,25
Killmoth,illidan,1703,paladin,holy,341,173,168
Bombboyozjr,area-52,1701,paladin,holy,36,24,12
Taargaryenn,tichondrius,1701,paladin,holy,60,32,28
Citylights,tichondrius,1700,paladin,holy,81,44,37
Showtíme,steamwheedle-cartel,1697,paladin,holy,31,19,12
Zunit,laughing-skull,1693,paladin,holy,52,24,28
Fortold,bloodhoof,1692,paladin,holy,54,23,31
Denthus,dragonmaw,1691,paladin,holy,53,28,25
Censy,tichondrius,1688,paladin,holy,36,21,15
Sàga,hyjal,1688,paladin,holy,94,50,44
Yuuichi,moon-guard,1688,paladin,holy,76,37,39
Mayru,ragnaros,1687,paladin,holy,63,31,32
Mattc,tichondrius,1685,paladin,holy,53,24,29
Holymooie,frostmourne,1681,paladin,holy,42,20,22
Raigha,stormrage,1675,paladin,holy,48,27,21
Beejae,stormreaver,1675,paladin,holy,53,23,30
Tenêbrae,area-52,1674,paladin,holy,52,33,19
Mangoflash,malganis,1673,paladin,holy,66,26,40
Drisx,sargeras,1670,paladin,holy,112,60,52
Mvpj,medivh,1669,paladin,holy,153,78,75
Runihaveaids,stormrage,1668,paladin,holy,268,141,127
Cheerleader,bleeding-hollow,1668,paladin,holy,138,62,76
Zacháry,sargeras,1665,paladin,holy,302,157,145
Imshmackedd,darkspear,1663,paladin,holy,84,35,49
Fary,malganis,1661,paladin,holy,36,20,16
Landrysdad,malorne,1660,paladin,holy,54,26,28
Brynnhild,stormrage,1659,paladin,holy,162,83,79
Ivan,tichondrius,1659,paladin,holy,136,62,74
Sacridas,fizzcrank,1657,paladin,holy,36,20,16
Tiernoo,illidan,1656,paladin,holy,160,76,84
Thorfinaa,moon-guard,1653,paladin,holy,71,38,33
Avengom,tichondrius,1653,paladin,holy,357,179,178
Bubbleofil,barthilas,1649,paladin,holy,65,39,26
Lalatinaford,amanthul,1647,paladin,holy,76,44,32
Moonmi,tichondrius,1646,paladin,holy,199,114,85
Kustp,tichondrius,1646,paladin,holy,189,105,84
Kensyzs,tichondrius,1644,paladin,holy,60,24,36
Boklahoma,stormrage,1643,paladin,holy,36,25,11
Ppgddxx,azralon,1643,paladin,holy,30,18,12
Nerfretpls,area-52,1642,paladin,holy,42,20,22
Dalirah,illidan,1641,paladin,holy,42,23,19
Dazargeros,moon-guard,1638,paladin,holy,132,66,66
Bushys,tichondrius,1638,paladin,holy,42,21,21
Gaelinar,tichondrius,1637,paladin,holy,60,29,31
Oing,tichondrius,1634,paladin,holy,76,45,31
Enzõ,illidan,1632,paladin,holy,48,26,22
Saveursavior,bleeding-hollow,1632,paladin,holy,189,96,93
Castleknight,tichondrius,1632,paladin,holy,77,38,39
Rhönin,sargeras,1632,paladin,holy,54,22,32
Rhunon,dalaran,1631,paladin,holy,78,41,37
Shazuwu,illidan,1630,paladin,holy,30,17,13
Xcuse,tichondrius,1630,paladin,holy,84,43,41
Gazapal,thrall,1628,paladin,holy,168,95,73
Kencyz,tichondrius,1627,paladin,holy,43,25,18
Pála,dalaran,1625,paladin,holy,164,80,84
Songminsu,proudmoore,1625,paladin,holy,99,47,52
Deepnasty,galakrond,1624,paladin,holy,215,110,105
Piïls,sargeras,1623,paladin,holy,42,20,22
Arcanux,thrall,1623,paladin,holy,48,20,28
Solfire,stormreaver,1622,paladin,holy,92,45,47
Bopbotx,area-52,1621,paladin,holy,49,17,32
Aldrion,stormrage,1617,paladin,holy,54,28,26
Beyondsausag,malganis,1617,paladin,holy,155,69,86
Rhönin,illidan,1616,paladin,holy,42,22,20
Minefujiko,tichondrius,1616,paladin,holy,381,194,187
Trevmagoosey,tichondrius,1616,paladin,holy,56,26,30
Scoopzi,frostmourne,1614,paladin,holy,53,29,24
Caitthegreat,malorne,1613,paladin,holy,42,23,19
Nodenom,blackrock,1612,paladin,holy,30,18,12
Vmxp,barthilas,1611,paladin,holy,94,56,38
Quertz,sargeras,1610,paladin,holy,178,104,74
Ricopal,frostmourne,1610,paladin,holy,36,17,19
Madorian,bleeding-hollow,1610,paladin,holy,71,31,40
Flow,spinebreaker,1610,paladin,holy,53,23,30
Denke,thrall,1609,paladin,holy,36,17,19
Leonideez,moon-guard,1609,paladin,holy,75,34,41
Jealp,sargeras,1608,paladin,holy,42,26,16
Roundhere,area-52,1608,paladin,holy,30,18,12
Naxzy,quelthalas,1608,paladin,holy,46,27,19
Larryhoova,malganis,1608,paladin,holy,36,20,16
Crâfty,bleeding-hollow,1608,paladin,holy,83,45,38
Dwarrior,quelthalas,1606,paladin,holy,39,18,21
Forsakenlite,sargeras,1606,paladin,holy,90,41,49
Ellyarian,emerald-dream,1604,paladin,holy,72,34,38
Zhula,nerzhul,1601,paladin,holy,48,31,17
Erikx,smolderthorn,1601,paladin,holy,120,66,54
Orphandog,zuljin,1600,paladin,holy,29,21,8
Gjoker,azralon,1600,paladin,holy,42,25,17
Roundbutts,stormrage,1600,paladin,holy,56,28,28
Gospel,duskwood,1598,paladin,holy,96,51,45
Jiraya,nemesis,1598,paladin,holy,79,39,40
Saphri,kiljaeden,1596,paladin,holy,364,190,174
Wuhbp,illidan,1596,paladin,holy,88,44,44
Repèntance,stormrage,1590,paladin,holy,48,28,20
Asherm,moon-guard,1590,paladin,holy,98,48,50
Paladinaiko,nemesis,1589,paladin,holy,129,64,65
Zergmé,executus,1589,paladin,holy,48,23,25
Abellpally,tichondrius,1589,paladin,holy,54,23,31
Ascion,tichondrius,1588,paladin,holy,143,69,74
Louisvuttiøn,tichondrius,1588,paladin,holy,40,19,21
Madsama,quelthalas,1587,paladin,holy,72,39,33
Retsincewod,zuluhed,1586,paladin,holy,54,28,26
Bërzerk,zuluhed,1584,paladin,holy,99,46,53
Chonsic,darkspear,1582,paladin,holy,90,40,50
Stephon,area-52,1582,paladin,holy,114,49,65
Bopthebomb,sargeras,1580,paladin,holy,71,33,38
Sevenword,tichondrius,1577,paladin,holy,67,38,29
Thelac,dalaran,1575,paladin,holy,72,39,33
Donkeydumper,wyrmrest-accord,1573,paladin,holy,142,83,59
Kaseywyd,bonechewer,1572,paladin,holy,65,35,30
Dodgeandhoj,nerzhul,1572,paladin,holy,36,19,17
Babaganôush,illidan,1571,paladin,holy,35,18,17
Sekitar,ragnaros,1571,paladin,holy,172,87,85
Gwok,thrall,1569,paladin,holy,167,89,78
Aluríel,quelthalas,1568,paladin,holy,56,28,28
Konvi,tichondrius,1566,paladin,holy,183,90,93
Peelmeree,kelthuzad,1565,paladin,holy,36,18,18
Hônòr,thrall,1564,paladin,holy,51,29,22
Ashley,sargeras,1563,paladin,holy,42,22,20
Sprjustice,frostmourne,1562,paladin,holy,36,18,18
Drägonmynuts,tichondrius,1557,paladin,holy,145,64,81
Senorbaxter,emerald-dream,1557,paladin,holy,66,27,39
Prettylightx,kelthuzad,1554,paladin,holy,277,139,138
Montageflav,illidan,1554,paladin,holy,56,27,29
Gorgona,illidan,1551,paladin,holy,107,53,54
Ilovecanada,sargeras,1550,paladin,holy,34,19,15
Crabsaladpal,illidan,1550,paladin,holy,112,62,50
Vaerume,sargeras,1550,paladin,holy,129,70,59
Xinqingle,tichondrius,1550,paladin,holy,471,237,234
Devöut,aggramar,1549,paladin,holy,151,76,75
Ricardão,emerald-dream,1549,paladin,holy,113,52,61
Whalesx,thrall,1547,paladin,holy,40,20,20
Sheriff,tanaris,1547,paladin,holy,48,22,26
Amiigo,tichondrius,1545,paladin,holy,54,24,30
Zayiro,eonar,1544,paladin,holy,42,20,22
Klam,kelthuzad,1542,paladin,holy,156,76,80
Discordnitro,illidan,1541,paladin,holy,48,26,22
Handsomedan,twisting-nether,1541,paladin,holy,84,40,44
Riptonix,stormrage,1540,paladin,holy,121,66,55
Saibasita,tichondrius,1539,paladin,holy,48,33,15
Neurôtoxins,frostmourne,1539,paladin,holy,102,53,49
Slüg,bleeding-hollow,1536,paladin,holy,264,134,130
Boundric,emerald-dream,1536,paladin,holy,54,25,29
Cynical,dalvengyr,1533,paladin,holy,138,78,60
Holyknight,veknilash,1532,paladin,holy,89,45,44
Avahir,moon-guard,1532,paladin,holy,78,39,39
Kencyxx,tichondrius,1529,paladin,holy,48,23,25
Molki,tichondrius,1523,paladin,holy,123,68,55
Kidstable,nathrezim,1523,paladin,holy,70,27,43
Airbusx,tichondrius,1522,paladin,holy,41,20,21
Nelliellx,tichondrius,1521,paladin,holy,36,16,20
Beyönd,quelthalas,1520,paladin,holy,78,39,39
Pandahorn,tichondrius,1520,paladin,holy,54,23,31
Dageraad,tichondrius,1519,paladin,holy,30,16,14
Bigoldman,tichondrius,1519,paladin,holy,72,37,35
Jeromee,area-52,1519,paladin,holy,72,32,40
Sadamell,tichondrius,1518,paladin,holy,24,16,8
Chedis,mugthol,1517,paladin,holy,30,18,12
Sanasana,spirestone,1515,paladin,holy,177,98,79
Jiberish,illidan,1515,paladin,holy,126,60,66
Teenytoots,burning-legion,1513,paladin,holy,123,48,75
Bebebig,tichondrius,1511,paladin,holy,182,100,82
Maeyz,sargeras,1511,paladin,holy,126,67,59
Lindsans,illidan,1509,paladin,holy,48,32,16
Bosat,drakkari,1509,paladin,holy,48,19,29
Kdex,tichondrius,1505,paladin,holy,84,37,47
Buqi,barthilas,1505,paladin,holy,63,27,36
Goldensmile,frostmourne,1504,paladin,holy,36,19,17
Shijielol,tichondrius,1504,paladin,holy,43,22,21
Hammersdown,stormrage,1503,paladin,holy,40,27,13
Ageroÿ,sargeras,1503,paladin,holy,61,31,30
Doofum,stormrage,1503,paladin,holy,131,58,73
Serendipidy,bleeding-hollow,1503,paladin,holy,98,43,55
Brumm,quelthalas,1501,paladin,holy,77,39,38
Rodrigo,frostmourne,1499,paladin,holy,81,39,42
Taurenheit,area-52,1497,paladin,holy,151,70,81
Harryhui,tichondrius,1496,paladin,holy,42,23,19
Humañ,tichondrius,1496,paladin,holy,72,37,35
Rg,nerzhul,1494,paladin,holy,243,119,124
Haitishammer,stormrage,1494,paladin,holy,78,37,41
Lightkillerx,thrall,1494,paladin,holy,84,37,47
Jässy,muradin,1493,paladin,holy,71,33,38
Hoopzz,illidan,1492,paladin,holy,75,35,40
Paladanim,tichondrius,1490,paladin,holy,77,23,54
Xanarïs,kiljaeden,1489,paladin,holy,84,41,43
Nickiminhoj,stormrage,1488,paladin,holy,51,29,22
Bushÿ,tichondrius,1488,paladin,holy,128,69,59
Irunnal,kelthuzad,1486,paladin,holy,41,27,14
Stophamrtime,barthilas,1484,paladin,holy,54,26,28
Condone,earthen-ring,1484,paladin,holy,96,44,52
Nontheism,malganis,1483,paladin,holy,54,20,34
Center,ragnaros,1482,paladin,holy,35,16,19
Vodokus,area-52,1480,paladin,holy,118,54,64
Baitur,zuljin,1480,paladin,holy,49,21,28
Regivan,nemesis,1479,paladin,holy,42,16,26
Aulty,sargeras,1479,paladin,holy,77,28,49
Fredward,bleeding-hollow,1478,paladin,holy,35,18,17
Dewlight,zuljin,1477,paladin,holy,161,77,84
Jorik,lightbringer,1477,paladin,holy,42,20,22
Dimix,sargeras,1476,paladin,holy,65,32,33
Cjqcjq,tichondrius,1476,paladin,holy,59,28,31
Zenkk,sargeras,1475,paladin,holy,57,23,34
Caobobby,tichondrius,1474,paladin,holy,57,25,32
Percüles,sargeras,1473,paladin,holy,66,38,28
Bubblet,bleeding-hollow,1471,paladin,holy,40,19,21
Judgemode,the-scryers,1468,paladin,holy,96,41,55
Swordstrikes,tichondrius,1467,paladin,holy,53,26,27
Palazin,frostmourne,1467,paladin,holy,182,87,95
Ryhighdi,sargeras,1467,paladin,holy,48,22,26
Pasda,frostmourne,1467,paladin,holy,77,29,48
Twìceborn,emerald-dream,1466,paladin,holy,47,23,24
Blarr,azshara,1466,paladin,holy,84,34,50
Glørythrives,tichondrius,1465,paladin,holy,57,25,32
Vitabro,bleeding-hollow,1464,paladin,holy,155,81,74
Regivän,azralon,1464,paladin,holy,108,49,59
Traumaboy,terenas,1463,paladin,holy,87,44,43
Danpros,azralon,1462,paladin,holy,84,34,50
Hughmyron,stormrage,1461,paladin,holy,40,24,16
Cohesion,draenor,1461,paladin,holy,77,35,42
Jezëbel,azralon,1460,paladin,holy,52,27,25
Wokeinator,malganis,1459,paladin,holy,267,142,125
Allitharis,tichondrius,1458,paladin,holy,112,59,53
Gotomars,tichondrius,1457,paladin,holy,89,45,44
Wonpai,frostmourne,1457,paladin,holy,57,26,31
Wonpaiv,frostmourne,1456,paladin,holy,53,21,32
Gankstapwn,tichondrius,1455,paladin,holy,59,27,32
Omfgitsyang,tichondrius,1453,paladin,holy,41,24,17
Handyandy,kelthuzad,1450,paladin,holy,118,61,57
Palladomal,azralon,1450,paladin,holy,96,49,47
Ooppa,proudmoore,1450,paladin,holy,97,43,54
Zoeyxo,tichondrius,1448,paladin,holy,80,42,38
Jdxqt,darkspear,1448,paladin,holy,48,18,30
Fiate,azralon,1447,paladin,holy,42,20,22
Kirilx,vashj,1446,paladin,holy,54,30,24
Kihluxo,frostmourne,1446,paladin,holy,101,56,45
Tigranes,proudmoore,1444,paladin,holy,36,17,19
Daenrahh,azralon,1443,paladin,holy,188,95,93
Celsica,kelthuzad,1443,paladin,holy,153,73,80
Chowdar,proudmoore,1443,paladin,holy,78,36,42
Holyprotectr,tichondrius,1442,paladin,holy,30,17,13
Luminainre,zuljin,1442,paladin,holy,197,92,105
Cykcp,burning-legion,1441,paladin,holy,72,34,38
Danyuel,zuljin,1441,paladin,holy,86,39,47
Notdjalex,zuljin,1440,paladin,holy,30,19,11
Noback,ragnaros,1438,paladin,holy,78,37,41
Sigmapepe,quelthalas,1436,paladin,holy,96,52,44
Ryhigh,sargeras,1436,paladin,holy,89,38,51
Ocean,sargeras,1436,paladin,holy,36,15,21
Lightupx,stormrage,1435,paladin,holy,97,43,54
Lliliiliil,illidan,1434,paladin,holy,146,78,68
Odiinn,stormscale,1434,paladin,holy,103,50,53
Guerrer,hyjal,1433,paladin,holy,589,293,296
Xuantianchai,tichondrius,1431,paladin,holy,30,15,15
Shagalaga,tichondrius,1431,paladin,holy,155,72,83
Kriegmeister,amanthul,1429,paladin,holy,48,24,24
Herakleitos,firetree,1428,paladin,holy,75,44,31
Solarcity,tichondrius,1428,paladin,holy,52,30,22
Lyticmartyr,bleeding-hollow,1427,paladin,holy,48,24,24
Zakath,the-underbog,1426,paladin,holy,78,33,45
Brioc,tichondrius,1424,paladin,holy,36,22,14
Lothnalar,ragnaros,1424,paladin,holy,54,23,31
Justeight,stormrage,1423,paladin,holy,66,37,29
Mastadin,illidan,1422,paladin,holy,36,19,17
Splashleyy,bleeding-hollow,1421,paladin,holy,148,69,79
Holyhades,auchindoun,1420,paladin,holy,143,78,65
Holyterror,dentarg,1420,paladin,holy,48,25,23
Graceyrae,tichondrius,1419,paladin,holy,50,30,20
Jpwx,barthilas,1419,paladin,holy,30,15,15
Superzero,area-52,1419,paladin,holy,105,51,54
Lhpal,ragnaros,1418,paladin,holy,65,34,31
Droopyz,quelthalas,1418,paladin,holy,66,27,39
Mywifeisbad,tichondrius,1417,paladin,holy,48,34,14
Decalli,tichondrius,1417,paladin,holy,69,35,34
Xöchïqüëtzäl,tichondrius,1416,paladin,holy,35,18,17
Loyantal,tichondrius,1416,paladin,holy,36,16,20
Dartpuncher,frostmourne,1414,paladin,holy,120,63,57
Realpalada,tichondrius,1414,paladin,holy,65,25,40
Alessan,nemesis,1413,paladin,holy,31,18,13
Xuanxingchai,tichondrius,1413,paladin,holy,72,30,42
Unbreakable,antonidas,1412,paladin,holy,51,36,15
Emojunz,ragnaros,1411,paladin,holy,22,16,6
Liå,frostmourne,1411,paladin,holy,162,83,79
Alphanerd,burning-blade,1410,paladin,holy,73,40,33
Waldir,silver-hand,1410,paladin,holy,54,24,30
Atelva,moon-guard,1409,paladin,holy,99,56,43
Quadrifoglio,moon-guard,1409,paladin,holy,205,106,99
Arral,malganis,1408,paladin,holy,66,31,35
Lucciuzz,tichondrius,1407,paladin,holy,80,39,41
Samaze,tichondrius,1407,paladin,holy,126,61,65
Vasar,tichondrius,1406,paladin,holy,37,26,11
Maleguz,azralon,1406,paladin,holy,309,159,150
Nume,nesingwary,1404,paladin,holy,102,51,51
Nxkita,sargeras,1403,paladin,holy,54,28,26
Galeras,norgannon,1403,paladin,holy,249,117,132
Nanøha,frostmourne,1402,paladin,holy,88,26,62
Harke,drakkari,1401,paladin,holy,48,30,18
Crüst,proudmoore,1401,paladin,holy,42,21,21
Wálker,ragnaros,1399,paladin,holy,98,48,50
Talantyr,zuljin,1398,paladin,holy,48,23,25
Uprise,chogall,1397,paladin,holy,66,33,33
Fabîan,guldan,1395,paladin,holy,42,22,20
Dadcantsac,frostmourne,1395,paladin,holy,87,41,46
Anderentonso,tichondrius,1395,paladin,holy,54,24,30
Hawtwangs,proudmoore,1394,paladin,holy,102,55,47
Vêgenace,proudmoore,1394,paladin,holy,39,19,20
Krackanut,kelthuzad,1394,paladin,holy,42,19,23
Indemnity,wildhammer,1393,paladin,holy,81,43,38
Ibury,quelthalas,1393,paladin,holy,227,103,124
Slygonjinn,area-52,1392,paladin,holy,48,21,27
Racketyman,illidan,1391,paladin,holy,30,15,15
Hruuhwa,wyrmrest-accord,1390,paladin,holy,36,21,15
Enuug,malfurion,1389,paladin,holy,96,57,39
Viviana,shadowmoon,1389,paladin,holy,52,23,29
Sapphiros,tichondrius,1388,paladin,holy,68,25,43
Summercarma,area-52,1387,paladin,holy,27,15,12
Criaharn,turalyon,1387,paladin,holy,108,43,65
Rhamadicinu,frostmourne,1384,paladin,holy,85,41,44
Granitei,quelthalas,1384,paladin,holy,50,24,26
Impaler,gorefiend,1384,paladin,holy,78,29,49
Rarth,nemesis,1382,paladin,holy,71,27,44
Ricemang,kiljaeden,1380,paladin,holy,53,24,29
Bakoø,tichondrius,1378,paladin,holy,77,37,40
Nrpzy,stormrage,1378,paladin,holy,113,52,61
Kokomö,kelthuzad,1378,paladin,holy,65,29,36
Palapoxi,arygos,1377,paladin,holy,77,36,41
Doorii,tichondrius,1377,paladin,holy,47,18,29
Hulksmash,terenas,1376,paladin,holy,65,31,34
Delilahxoxo,mugthol,1376,paladin,holy,63,26,37
Leónrey,stormrage,1376,paladin,holy,92,33,59
Lu,the-venture-co,1371,paladin,holy,34,15,19
Massivesac,frostmourne,1369,paladin,holy,36,22,14
Jimmipepe,quelthalas,1369,paladin,holy,42,24,18
Mânz,zuljin,1369,paladin,holy,60,21,39
Holyramen,illidan,1368,paladin,holy,227,106,121
Shaidd,bleeding-hollow,1368,paladin,holy,77,34,43
Sinay,azshara,1367,paladin,holy,135,74,61
Mellidi,azralon,1367,paladin,holy,42,23,19
Berseus,tichondrius,1366,paladin,holy,127,53,74
Saeranella,moon-guard,1366,paladin,holy,106,44,62
Paladinaa,lothar,1364,paladin,holy,104,41,63
Riporeo,rexxar,1362,paladin,holy,36,25,11
Gorilla,kiljaeden,1362,paladin,holy,59,15,44
Rengen,frostmourne,1360,paladin,holy,42,22,20
Zephyrvalor,sargeras,1360,paladin,holy,48,18,30
Doominusx,tichondrius,1359,paladin,holy,42,24,18
Jestiny,amanthul,1356,paladin,holy,97,55,42
Choonsly,tichondrius,1356,paladin,holy,69,36,33
Negodoskate,nemesis,1353,paladin,holy,207,105,102
Amadeo,hyjal,1353,paladin,holy,101,44,57
Rezmefool,tichondrius,1352,paladin,holy,139,63,76
Galabanja,malganis,1350,paladin,holy,42,24,18
Bulgecranker,tichondrius,1350,paladin,holy,36,20,16
Oralen,daggerspine,1350,paladin,holy,66,31,35
Hamen,frostwolf,1349,paladin,holy,41,22,19
Møcha,moon-guard,1347,paladin,holy,50,26,24
Ingrìd,ragnaros,1346,paladin,holy,24,17,7
Flippo,sargeras,1346,paladin,holy,36,17,19
Hoonjojjyanp,tichondrius,1346,paladin,holy,35,15,20
Piura,stormreaver,1345,paladin,holy,48,23,25
Aberos,stonemaul,1343,paladin,holy,69,24,45
Miswalkpally,ragnaros,1342,paladin,holy,30,14,16
Röniin,ragnaros,1341,paladin,holy,310,162,148
Htmlar,tichondrius,1338,paladin,holy,75,41,34
Stormzy,zuljin,1338,paladin,holy,98,46,52
Marretaoloco,stormrage,1338,paladin,holy,59,25,34
Xiaoladin,frostmourne,1337,paladin,holy,25,16,9
Güido,stormrage,1337,paladin,holy,42,23,19
Leonrey,stormrage,1337,paladin,holy,43,21,22
Aiakus,lightbringer,1336,paladin,holy,30,15,15
Mabia,tichondrius,1334,paladin,holy,257,129,128
Goodwood,ghostlands,1334,paladin,holy,105,50,55
Finerkane,quelthalas,1334,paladin,holy,138,62,76
Fatsoo,sargeras,1333,paladin,holy,56,25,31
Therealdeal,sargeras,1332,paladin,holy,77,41,36
Hawianbread,stormrage,1331,paladin,holy,60,33,27
Nepnade,stormrage,1331,paladin,holy,47,25,22
Clare,burning-blade,1331,paladin,holy,89,41,48
Buri,tichondrius,1330,paladin,holy,42,17,25
Phinnik,tichondrius,1329,paladin,holy,250,125,125
Wrathbourne,sargeras,1328,paladin,holy,42,14,28
Vamplyy,kelthuzad,1327,paladin,holy,24,14,10
Syrenz,khazgoroth,1327,paladin,holy,42,24,18
Ashgrim,kiljaeden,1327,paladin,holy,77,37,40
Catechism,laughing-skull,1325,paladin,holy,44,24,20
Wiley,dark-iron,1324,paladin,holy,48,27,21
Deepsearide,illidan,1324,paladin,holy,150,82,68
Minereth,quelthalas,1324,paladin,holy,65,32,33
Alcaedra,shadowsong,1324,paladin,holy,92,45,47
Jordenz,bonechewer,1324,paladin,holy,30,14,16
Consecrated,daggerspine,1324,paladin,holy,75,30,45
Mcllovin,kiljaeden,1323,paladin,holy,60,28,32
Beefyjones,illidan,1322,paladin,holy,51,30,21
Zantdemption,frostmourne,1322,paladin,holy,30,15,15
Ramphastoz,quelthalas,1321,paladin,holy,72,32,40
Îcandy,stormrage,1319,paladin,holy,24,16,8
Kektrixia,tichondrius,1318,paladin,holy,24,15,9
Taiion,proudmoore,1318,paladin,holy,36,19,17
Jurjen,quelthalas,1318,paladin,holy,30,14,16
Ùnholypally,jubeithos,1316,paladin,holy,71,42,29
Nilin,tichondrius,1316,paladin,holy,24,14,10
Valandiel,proudmoore,1315,paladin,holy,61,15,46
Hodl,barthilas,1313,paladin,holy,113,58,55
Mawning,kelthuzad,1311,paladin,holy,220,111,109
Ryhighh,sargeras,1311,paladin,holy,93,37,56
Mianheyo,quelthalas,1309,paladin,holy,71,38,33
Thrandeill,bleeding-hollow,1306,paladin,holy,24,15,9
Ozpal,burning-blade,1305,paladin,holy,38,24,14
Errant,bonechewer,1305,paladin,holy,53,31,22
Santiadin,ragnaros,1304,paladin,holy,20,15,5
Beerüs,crushridge,1303,paladin,holy,66,36,30
Quarall,blackhand,1303,paladin,holy,64,33,31
Twck,hyjal,1302,paladin,holy,191,92,99
Dreadrot,azralon,1302,paladin,holy,50,24,26
Psychorino,tichondrius,1302,paladin,holy,39,16,23
Sorkar,tichondrius,1301,paladin,holy,129,66,63
Solanin,frostmourne,1301,paladin,holy,90,45,45
Einjerhar,quelthalas,1300,paladin,holy,48,22,26
Dóminos,quelthalas,1298,paladin,holy,48,24,24
Galearn,ragnaros,1298,paladin,holy,30,14,16
Ironpaladin,sargeras,1297,paladin,holy,90,39,51
Chånïng,frostmourne,1295,paladin,holy,48,20,28
Vurian,uther,1295,paladin,holy,90,36,54
Trivv,illidan,1294,paladin,holy,78,33,45
Jacobhowda,tichondrius,1292,paladin,holy,54,25,29
Colbroggins,crushridge,1289,paladin,holy,45,24,21
Justmad,illidan,1289,paladin,holy,48,25,23
Anea,kelthuzad,1289,paladin,holy,44,22,22
Daphillen,frostmourne,1288,paladin,holy,41,23,18
Botburger,stormrage,1288,paladin,holy,48,21,27
Yadiyadiyada,barthilas,1287,paladin,holy,42,24,18
Lørdthemar,azralon,1286,paladin,holy,60,26,34
Blessthfall,bleeding-hollow,1286,paladin,holy,51,14,37
Undefeatæd,korgath,1285,paladin,holy,52,29,23
Monts,azralon,1279,paladin,holy,84,39,45
Dimior,quelthalas,1276,paladin,holy,60,30,30
Sventyn,frostmourne,1267,paladin,holy,67,36,31
Malakor,thrall,1267,paladin,holy,139,68,71
Merll,ragnaros,1267,paladin,holy,121,58,63
Klamindor,emerald-dream,1266,paladin,holy,48,22,26
Cowladino,tichondrius,1265,paladin,holy,55,27,28
Affrika,ysondre,1264,paladin,holy,104,52,52
Pallin,sargeras,1264,paladin,holy,90,41,49
Salivan,darkspear,1263,paladin,holy,33,16,17
Sneakypal,dalaran,1263,paladin,holy,58,22,36
Motoa,stormrage,1262,paladin,holy,36,19,17
Dumpytrucks,sargeras,1262,paladin,holy,48,24,24
Holyredx,bleeding-hollow,1261,paladin,holy,134,73,61
Hèró,barthilas,1261,paladin,holy,30,16,14
Coltlocks,sargeras,1261,paladin,holy,54,26,28
Thiccholy,deathwing,1260,paladin,holy,170,93,77
Lilfingered,malganis,1260,paladin,holy,57,29,28
Jaenus,azralon,1260,paladin,holy,72,33,39
Tropicorn,proudmoore,1259,paladin,holy,66,32,34
Randuir,proudmoore,1258,paladin,holy,68,38,30
Lafasíta,ragnaros,1257,paladin,holy,36,19,17
Brenenk,quelthalas,1257,paladin,holy,65,32,33
Lightleadsme,sargeras,1257,paladin,holy,322,158,164
Imabandagins,bleeding-hollow,1257,paladin,holy,109,52,57
Holyslapy,illidan,1255,paladin,holy,77,41,36
Troypolamalu,dark-iron,1255,paladin,holy,30,14,16
Holysplonk,stonemaul,1255,paladin,holy,72,30,42
Heálbót,tichondrius,1253,paladin,holy,49,27,22
Swazanaseger,frostmourne,1252,paladin,holy,42,22,20
Ckemosabe,emerald-dream,1252,paladin,holy,38,14,24
Deidei,blood-furnace,1251,paladin,holy,29,17,12
Wukongsunn,dalaran,1251,paladin,holy,30,14,16
Whitekao,illidan,1247,paladin,holy,18,13,5
Elutherios,tichondrius,1247,paladin,holy,54,26,28
Hopeyouheal,sargeras,1247,paladin,holy,30,14,16
Phpremium,dalaran,1246,paladin,holy,30,13,17
Darkbringer,frostmourne,1245,paladin,holy,76,38,38
Silvermind,tichondrius,1244,paladin,holy,30,17,13
Freyr,deathwing,1244,paladin,holy,38,21,17
Bubblepigo,tichondrius,1243,paladin,holy,36,22,14
Shámder,quelthalas,1243,paladin,holy,65,28,37
Sologriefer,sargeras,1242,paladin,holy,30,13,17
Herroprease,frostmane,1241,paladin,holy,30,13,17
Scarlet,skywall,1241,paladin,holy,30,13,17
Cudiskush,tichondrius,1237,paladin,holy,45,26,19
Anatnof,malganis,1237,paladin,holy,30,16,14
Yogafire,kelthuzad,1237,paladin,holy,48,24,24
Kristienna,boulderfist,1236,paladin,holy,35,16,19
Hamburgeryu,tichondrius,1236,paladin,holy,42,13,29
Cbm,tichondrius,1235,paladin,holy,23,14,9
Chewiipal,dalaran,1235,paladin,holy,57,31,26
Psuito,ragnaros,1234,paladin,holy,66,33,33
Judgynomnom,the-underbog,1234,paladin,holy,36,13,23
Tuor,nerzhul,1233,paladin,holy,18,13,5
Kariack,malganis,1231,paladin,holy,30,15,15
Diebeatus,zuljin,1231,paladin,holy,54,25,29
Holyquadz,elune,1229,paladin,holy,48,24,24
Sinfolly,whisperwind,1229,paladin,holy,121,57,64
Justizz,vashj,1228,paladin,holy,65,35,30
Mobitz,dalvengyr,1228,paladin,holy,36,16,20
Wodlim,azralon,1228,paladin,holy,37,13,24
Venictus,frostwolf,1227,paladin,holy,24,13,11
Gareyn,moon-guard,1227,paladin,holy,36,14,22
Mundomaloo,quelthalas,1226,paladin,holy,59,31,28
Crocfacex,tichondrius,1226,paladin,holy,46,18,28
Lovesongs,sargeras,1225,paladin,holy,24,13,11
Jessuss,shandris,1224,paladin,holy,75,34,41
Szsfstnoob,tichondrius,1224,paladin,holy,30,13,17
Zakh,proudmoore,1223,paladin,holy,56,24,32
Kenric,quelthalas,1223,paladin,holy,83,34,49
Slippyp,darkspear,1222,paladin,holy,36,18,18
Miniweiner,proudmoore,1222,paladin,holy,30,13,17
Akromma,drakkari,1221,paladin,holy,59,31,28
Aellithiene,tichondrius,1221,paladin,holy,30,13,17
Tryvor,stormrage,1221,paladin,holy,36,13,23
Chewyjitsu,tichondrius,1219,paladin,holy,60,25,35
Ramspartan,drakkari,1218,paladin,holy,106,52,54
Vithar,bleeding-hollow,1218,paladin,holy,221,106,115
Moogmodular,malganis,1218,paladin,holy,103,49,54
Saffranzord,azralon,1214,paladin,holy,73,35,38
Tandury,tichondrius,1214,paladin,holy,60,28,32
Savagegirlz,tichondrius,1213,paladin,holy,82,35,47
Kamaelyn,proudmoore,1211,paladin,holy,133,68,65
Tizzi,eredar,1210,paladin,holy,23,13,10
Marybopins,darkspear,1209,paladin,holy,18,13,5
Capedcrusade,area-52,1208,paladin,holy,24,13,11
Bárdokø,ragnaros,1208,paladin,holy,108,53,55
Yérn,barthilas,1208,paladin,holy,42,15,27
Krysalid,stormrage,1207,paladin,holy,39,22,17
Faileeria,malganis,1206,paladin,holy,42,29,13
Hitsilent,warsong,1205,paladin,holy,24,14,10
Agert,bloodhoof,1204,paladin,holy,75,23,52
Burgalveist,azgalor,1202,paladin,holy,25,15,10
Hammercy,tichondrius,1202,paladin,holy,79,43,36
Dboly,frostmourne,1202,paladin,holy,84,41,43
Contémpt,kelthuzad,1202,paladin,holy,30,14,16
Oopalaoo,azralon,1202,paladin,holy,54,19,35
Chor,tichondrius,1201,paladin,holy,22,14,8
Nikopala,tichondrius,1201,paladin,holy,39,20,19
Chopsparks,khadgar,1201,paladin,holy,147,75,72
Holyflux,winterhoof,1200,paladin,holy,18,13,5
Daik,proudmoore,1200,paladin,holy,40,25,15
Maaxxee,zuljin,1200,paladin,holy,27,13,14
Aoishie,bleeding-hollow,1200,paladin,holy,90,40,50
Boarfarmer,tichondrius,1199,paladin,holy,87,37,50
Mörphêus,tichondrius,1197,paladin,holy,54,30,24
Shorthordeon,kelthuzad,1194,paladin,holy,54,30,24
Whangsta,tichondrius,1194,paladin,holy,54,23,31
Dreemie,tichondrius,1194,paladin,holy,54,20,34
Bakoo,tichondrius,1193,paladin,holy,64,31,33
Salipally,dalaran,1192,paladin,holy,115,50,65
Swanp,stormrage,1191,paladin,holy,60,26,34
Encantado,thrall,1190,paladin,holy,43,20,23
Rogrmurtaugh,sargeras,1187,paladin,holy,115,57,58
Pallythre,proudmoore,1187,paladin,holy,54,23,31
Sinara,detheroc,1184,paladin,holy,143,69,74
Saccerball,tichondrius,1183,paladin,holy,23,13,10
Konesky,dalaran,1183,paladin,holy,35,15,20
Donoph,blades-edge,1182,paladin,holy,44,20,24
Granklol,tichondrius,1181,paladin,holy,98,41,57
Paladinomoto,sargeras,1180,paladin,holy,46,22,24
Sixtynine,nathrezim,1180,paladin,holy,78,35,43
Prosykt,sargeras,1179,paladin,holy,36,14,22
Myrthedara,kargath,1178,paladin,holy,33,16,17
Usa,dark-iron,1178,paladin,holy,58,27,31
Teloniow,quelthalas,1178,paladin,holy,50,23,27
Fedpowell,tichondrius,1177,paladin,holy,29,13,16
Barbaluzz,quelthalas,1174,paladin,holy,257,123,134
Palltard,illidan,1174,paladin,holy,53,21,32
Hobbsone,trollbane,1173,paladin,holy,143,55,88
Belmonte,greymane,1172,paladin,holy,24,15,9
Madcandy,illidan,1172,paladin,holy,24,15,9
Oldgrumpster,stormrage,1168,paladin,holy,168,77,91
Mitshuki,ragnaros,1168,paladin,holy,42,19,23
Elizzabeth,skullcrusher,1167,paladin,holy,53,27,26
Mortianna,illidan,1161,paladin,holy,30,15,15
Holodecoy,bleeding-hollow,1161,paladin,holy,60,28,32
Pemodyne,illidan,1161,paladin,holy,66,21,45
Jazzmatic,dalaran,1157,paladin,holy,53,24,29
Babylonfive,zuluhed,1157,paladin,holy,126,53,73
Stemi,kelthuzad,1157,paladin,holy,71,25,46
Dbolpala,frostmourne,1155,paladin,holy,53,27,26
Onecmpeter,kelthuzad,1152,paladin,holy,67,38,29
Odriew,sargeras,1152,paladin,holy,24,12,12
Ballsmcgee,bleeding-hollow,1152,paladin,holy,175,74,101
Dispirit,the-forgotten-coast,1151,paladin,holy,49,29,20
Slexpala,tichondrius,1151,paladin,holy,24,12,12
Ej,ragnaros,1151,paladin,holy,24,12,12
Kënsi,quelthalas,1150,paladin,holy,200,101,99
Holycowisroy,illidan,1150,paladin,holy,24,12,12
Picorii,frostmourne,1150,paladin,holy,30,12,18
Bignum,illidan,1150,paladin,holy,36,12,24
Cathode,area-52,1149,paladin,holy,24,15,9
Toroke,nemesis,1149,paladin,holy,60,33,27
Boxjang,tichondrius,1149,paladin,holy,24,12,12
Lòuisvuttion,tichondrius,1148,paladin,holy,18,12,6
Bluemitch,malfurion,1147,paladin,holy,48,20,28
Holygutzz,barthilas,1147,paladin,holy,36,12,24
Lindnerxo,malganis,1147,paladin,holy,36,12,24
Toesy,area-52,1146,paladin,holy,70,30,40
Exxin,turalyon,1145,paladin,holy,107,49,58
Elladan,illidan,1145,paladin,holy,142,52,90
Renteria,sargeras,1144,paladin,holy,24,12,12
Lycheelz,illidan,1143,paladin,holy,60,36,24
Votasha,tichondrius,1143,paladin,holy,24,12,12
Spikele,barthilas,1143,paladin,holy,36,17,19
Homiepaldino,nordrassil,1143,paladin,holy,30,12,18
Iramm,gallywix,1141,paladin,holy,18,12,6
Ihr,kiljaeden,1141,paladin,holy,90,41,49
Dazztrain,barthilas,1139,paladin,holy,24,12,12
Lightswitchx,stormrage,1139,paladin,holy,30,12,18
Elogant,mannoroth,1138,paladin,holy,58,33,25
Pallyspaz,bleeding-hollow,1138,paladin,holy,24,12,12
Flareous,moon-guard,1138,paladin,holy,30,12,18
Smitty,korgath,1137,paladin,holy,30,12,18
Zavop,tichondrius,1136,paladin,holy,24,12,12
Heniou,tichondrius,1136,paladin,holy,59,26,33
Lanzzelot,goldrinn,1135,paladin,holy,30,12,18
Lukas,vashj,1131,paladin,holy,229,117,112
Vänhélsing,tichondrius,1129,paladin,holy,49,20,29
Kipow,proudmoore,1128,paladin,holy,30,14,16
Alarter,azralon,1128,paladin,holy,36,13,23
Divinetits,sargeras,1127,paladin,holy,32,13,19
Clehley,turalyon,1126,paladin,holy,54,24,30
Rajava,gallywix,1125,paladin,holy,86,46,40
Papaa,nemesis,1124,paladin,holy,229,109,120
Jiaofu,illidan,1123,paladin,holy,24,12,12
Kentö,area-52,1123,paladin,holy,30,14,16
Bonz,ragnaros,1121,paladin,holy,24,12,12
Sloppybobby,zuljin,1119,paladin,holy,30,16,14
Ellisar,kiljaeden,1119,paladin,holy,24,12,12
Dueprøcess,elune,1119,paladin,holy,24,12,12
Pathalerix,eonar,1118,paladin,holy,36,16,20
Ziggzag,hyjal,1117,paladin,holy,78,34,44
Bunksta,kelthuzad,1116,paladin,holy,52,25,27
Thorgard,antonidas,1115,paladin,holy,60,31,29
Hulkamaniac,blackhand,1113,paladin,holy,24,12,12
Meatburger,stormrage,1113,paladin,holy,30,12,18
Onno,tichondrius,1112,paladin,holy,60,31,29
Holyhali,zuljin,1111,paladin,holy,80,27,53
Ëd,moon-guard,1110,paladin,holy,180,89,91
Holymorph,tichondrius,1108,paladin,holy,22,13,9
Zowolf,quelthalas,1108,paladin,holy,65,33,32
Acori,azralon,1108,paladin,holy,39,18,21
Kigz,illidan,1107,paladin,holy,28,12,16
Dawnhammer,mugthol,1106,paladin,holy,82,40,42
Kelthor,azralon,1104,paladin,holy,36,18,18
Freezion,aegwynn,1104,paladin,holy,33,15,18
Lovehan,tichondrius,1103,paladin,holy,27,12,15
Èmmà,stormrage,1102,paladin,holy,123,63,60
Holysols,zuljin,1102,paladin,holy,24,12,12
Lovinglight,zuljin,1101,paladin,holy,30,17,13
Lavarball,tichondrius,1098,paladin,holy,41,14,27
Tittanfalls,illidan,1097,paladin,holy,72,36,36
Keyap,illidan,1095,paladin,holy,28,13,15
Vamir,magtheridon,1093,paladin,holy,48,24,24
Whosharted,area-52,1092,paladin,holy,66,36,30
Buckybarnes,gorefiend,1087,paladin,holy,48,30,18
Unworn,proudmoore,1087,paladin,holy,66,34,32
Lobõ,ragnaros,1086,paladin,holy,48,18,30
Maín,tichondrius,1085,paladin,holy,22,12,10
Liadrin,sentinels,1085,paladin,holy,29,12,17
Ilillilil,illidan,1081,paladin,holy,30,17,13
Overthrrow,kelthuzad,1081,paladin,holy,216,111,105
Ahundo,stonemaul,1078,paladin,holy,71,39,32
Shocka,norgannon,1078,paladin,holy,90,48,42
Bloodyhull,azralon,1077,paladin,holy,18,12,6
Salitheion,queldorei,1076,paladin,holy,66,24,42
Thãnzir,wyrmrest-accord,1076,paladin,holy,63,21,42
Maldobarr,stormrage,1075,paladin,holy,30,12,18
Rykeran,warsong,1074,paladin,holy,120,66,54
Marcopolo,azralon,1071,paladin,holy,41,14,27
Vaalbara,fizzcrank,1070,paladin,holy,30,14,16
Raqu,laughing-skull,1068,paladin,holy,81,35,46
Resio,illidan,1068,paladin,holy,36,13,23
Palaadiin,sargeras,1065,paladin,holy,72,38,34
Lawroadm,tichondrius,1064,paladin,holy,24,18,6
Constantino,hakkar,1064,paladin,holy,24,13,11
Ramhammerz,sargeras,1064,paladin,holy,162,78,84
Júpiter,kiljaeden,1064,paladin,holy,40,17,23
Tacori,gorefiend,1063,paladin,holy,30,18,12
Fuzed,frostmourne,1063,paladin,holy,163,81,82
Vidalia,barthilas,1062,paladin,holy,23,12,11
Asclepiius,frostmourne,1060,paladin,holy,65,36,29
Bopanut,illidan,1059,paladin,holy,45,25,20
Guççi,thunderlord,1059,paladin,holy,38,17,21
Hivers,stormrage,1059,paladin,holy,54,24,30
Cephadrome,proudmoore,1058,paladin,holy,42,20,22
Mèdic,illidan,1057,paladin,holy,62,34,28
Narcissism,emerald-dream,1056,paladin,holy,18,11,7
Babe,crushridge,1056,paladin,holy,30,11,19
Swellowsx,tichondrius,1055,paladin,holy,18,11,7
Twichy,tichondrius,1055,paladin,holy,18,11,7
Lazio,frostmourne,1055,paladin,holy,24,11,13
Kynndra,azralon,1055,paladin,holy,24,11,13
Lickmysacx,tichondrius,1055,paladin,holy,30,11,19
Trivana,durotan,1054,paladin,holy,19,12,7
Pseudoret,tichondrius,1054,paladin,holy,18,11,7
Pality,illidan,1054,paladin,holy,24,11,13
Bloodrefuge,tichondrius,1054,paladin,holy,46,12,34
Stingay,nemesis,1052,paladin,holy,24,11,13
Eldessia,wyrmrest-accord,1052,paladin,holy,24,11,13
Doktavius,lightbringer,1051,paladin,holy,18,11,7
Malakk,zuljin,1051,paladin,holy,47,25,22
Jonfox,stormrage,1051,paladin,holy,70,35,35
Runterran,illidan,1051,paladin,holy,24,11,13
Ouken,frostmourne,1051,paladin,holy,145,66,79
Joeboomers,tichondrius,1049,paladin,holy,140,72,68
Holyginger,barthilas,1049,paladin,holy,116,44,72
Zxylight,hyjal,1048,paladin,holy,18,11,7
Rìan,tichondrius,1048,paladin,holy,24,11,13
Kolmourn,deathwing,1048,paladin,holy,30,11,19
Palooma,area-52,1047,paladin,holy,72,29,43
Boostsixty,proudmoore,1046,paladin,holy,36,13,23
Erán,quelthalas,1043,paladin,holy,224,113,111
Hybbo,runetotem,1042,paladin,holy,24,12,12
Tig,alleria,1042,paladin,holy,30,11,19
Nabora,aggramar,1042,paladin,holy,54,16,38
Cheliere,kiljaeden,1040,paladin,holy,24,11,13
Sothalas,dalaran,1039,paladin,holy,27,15,12
Holyiseasy,alleria,1039,paladin,holy,35,13,22
Tyriam,stormscale,1038,paladin,holy,18,11,7
Kymosolopal,sargeras,1038,paladin,holy,36,11,25
Paladeena,azshara,1037,paladin,holy,48,30,18
Mcduss,proudmoore,1037,paladin,holy,18,11,7
Xq,aegwynn,1037,paladin,holy,41,18,23
Cloûd,tichondrius,1036,paladin,holy,25,14,11
Bubbleosevèn,frostmourne,1036,paladin,holy,36,13,23
Whiteknight,kilrogg,1034,paladin,holy,24,11,13
Kromthael,burning-blade,1032,paladin,holy,24,11,13
Pheriox,agamaggan,1032,paladin,holy,24,11,13
Starfaith,illidan,1032,paladin,holy,67,27,40
Smalldaddy,lightninghoof,1026,paladin,holy,36,11,25
Palqq,tichondrius,1025,paladin,holy,24,11,13
Stompcomp,tichondrius,1024,paladin,holy,75,32,43
Klansey,magtheridon,1023,paladin,holy,54,30,24
Wrathmatics,arthas,1022,paladin,holy,82,38,44
Minouther,area-52,1022,paladin,holy,80,32,48
Ahsys,tichondrius,1022,paladin,holy,53,18,35
Voxoen,bleeding-hollow,1021,paladin,holy,24,11,13
Tylnish,hyjal,1021,paladin,holy,24,11,13
Lexdor,quelthalas,1021,paladin,holy,24,11,13
Balanoriaa,azralon,1020,paladin,holy,68,29,39
Va,onyxia,1018,paladin,holy,338,172,166
Varenka,stormrage,1015,paladin,holy,83,36,47
Bubblebooty,drakthul,1014,paladin,holy,63,38,25
Iamholyman,dragonmaw,1014,paladin,holy,29,14,15
Kithkannon,tichondrius,1007,paladin,holy,51,17,34
Kbot,zuljin,1005,paladin,holy,15,11,4
Tarnak,kelthuzad,1005,paladin,holy,33,11,22
Adventholy,tichondrius,1004,paladin,holy,42,19,23
Laylee,anvilmar,1002,paladin,holy,67,37,30
Sutadansa,doomhammer,1001,paladin,holy,89,47,42
Ashera,amanthul,1001,paladin,holy,38,17,21
Paulx,malganis,999,paladin,holy,87,46,41
Gigadunker,tichondrius,999,paladin,holy,29,13,16
Ðß,arthas,995,paladin,holy,30,15,15
Westlysñipes,tichondrius,995,paladin,holy,92,44,48
Allegiance,drenden,993,paladin,holy,35,19,16
Troxnar,ragnaros,992,paladin,holy,76,42,34
Gillgamesh,sentinels,991,paladin,holy,36,22,14
Raenilil,area-52,991,paladin,holy,65,30,35
Hzo,tichondrius,989,paladin,holy,17,11,6
Colombía,illidan,986,paladin,holy,54,27,27
Agravaine,moon-guard,986,paladin,holy,23,11,12
Cynotik,moon-guard,984,paladin,holy,36,18,18
Sleepadin,shadowsong,980,paladin,holy,48,23,25
Biwi,zuljin,980,paladin,holy,136,54,82
Pallyox,hellscream,978,paladin,holy,30,20,10
Luxsit,tichondrius,977,paladin,holy,36,13,23
Zhahira,hakkar,976,paladin,holy,30,12,18
Carneguisada,sargeras,975,paladin,holy,42,20,22
Fantasy,ragnaros,975,paladin,holy,60,22,38
Imajeala,thrall,973,paladin,holy,76,42,34
Huijji,illidan,967,paladin,holy,24,15,9
Speedytrol,malfurion,967,paladin,holy,66,25,41
Snnow,stormrage,966,paladin,holy,48,28,20
Photons,emerald-dream,966,paladin,holy,24,13,11
Nugsbunne,tichondrius,964,paladin,holy,131,53,78
Romeoo,silver-hand,964,paladin,holy,66,26,40
Hammerabi,moon-guard,963,paladin,holy,21,13,8
Divinadin,stormrage,961,paladin,holy,94,51,43
Thoryin,tichondrius,960,paladin,holy,12,10,2
Síríús,malganis,960,paladin,holy,15,11,4
Krritter,illidan,960,paladin,holy,18,10,8
Ezekìël,tichondrius,960,paladin,holy,34,14,20
Arevia,stormrage,959,paladin,holy,18,10,8
Kagranac,moon-guard,959,paladin,holy,24,10,14
Milkovir,quelthalas,959,paladin,holy,42,10,32
Darithos,moon-guard,958,paladin,holy,24,10,14
Mjölk,tichondrius,958,paladin,holy,30,10,20
Vajuicy,dalaran,957,paladin,holy,24,10,14
Emrys,frostmourne,956,paladin,holy,12,10,2
Paluh,sargeras,956,paladin,holy,24,10,14
Mosso,bleeding-hollow,955,paladin,holy,24,10,14
Marklite,area-52,955,paladin,holy,24,10,14
Powerassasin,tichondrius,954,paladin,holy,18,10,8
Tèhflip,tichondrius,954,paladin,holy,24,10,14
Avasti,proudmoore,953,paladin,holy,24,10,14
Dragonchaos,ragnaros,953,paladin,holy,27,11,16
Zafenate,nemesis,952,paladin,holy,24,10,14
Madnhairy,zuljin,952,paladin,holy,24,10,14
Kusotarão,nemesis,952,paladin,holy,24,10,14
Aiyoku,illidan,951,paladin,holy,18,10,8
Caike,frostmourne,950,paladin,holy,18,10,8
Chauncyboii,tichondrius,950,paladin,holy,18,10,8
Palawun,nerzhul,949,paladin,holy,45,11,34
Paladam,burning-blade,948,paladin,holy,24,10,14
Holydood,thunderhorn,947,paladin,holy,18,10,8
Asunä,bloodscalp,947,paladin,holy,31,10,21
Yacè,moon-guard,945,paladin,holy,21,11,10
Tolliver,area-52,944,paladin,holy,18,11,7
Lazygamerr,sargeras,944,paladin,holy,18,10,8
Darteon,moon-guard,944,paladin,holy,43,13,30
Lemuzinho,ragnaros,941,paladin,holy,24,10,14
Sweettartts,zuljin,941,paladin,holy,36,10,26
Joshington,stormrage,938,paladin,holy,41,10,31
Eradrae,mannoroth,935,paladin,holy,100,43,57
Doidyph,frostmourne,935,paladin,holy,24,10,14
Dissident,stormrage,932,paladin,holy,103,47,56
Kaina,wildhammer,932,paladin,holy,103,43,60
Cooldbrew,frostmourne,932,paladin,holy,34,11,23
Mikeawk,tichondrius,932,paladin,holy,36,10,26
Ramzäbeoulve,tichondrius,930,paladin,holy,96,25,71
Shanvo,tichondrius,929,paladin,holy,52,30,22
Saìdelia,moon-guard,929,paladin,holy,71,24,47
Finaldecis,zuljin,929,paladin,holy,42,10,32
Rumanjuman,bronzebeard,925,paladin,holy,18,10,8
Monad,nazjatar,925,paladin,holy,78,38,40
Svitanie,bleeding-hollow,925,paladin,holy,92,42,50
Ljusett,frostmourne,925,paladin,holy,97,43,54
Hurkalzul,azralon,923,paladin,holy,24,10,14
Swamprat,zuljin,922,paladin,holy,23,10,13
Ivyy,rivendare,922,paladin,holy,28,11,17
Powtilted,thrall,920,paladin,holy,17,10,7
Hentaiangel,kiljaeden,918,paladin,holy,39,19,20
Lysetskriger,azralon,915,paladin,holy,24,12,12
Seonghwa,kelthuzad,914,paladin,holy,110,55,55
Ilse,deathwing,911,paladin,holy,27,10,17
Judginator,boulderfist,911,paladin,holy,32,11,21
Shâka,stormrage,907,paladin,holy,75,37,38
Scorcholdman,tichondrius,906,paladin,holy,35,10,25
Grumpybubble,sargeras,905,paladin,holy,19,11,8
Ballingirl,gnomeregan,903,paladin,holy,59,24,35
Darkwingdad,illidan,902,paladin,holy,109,56,53
Thaedrun,hydraxis,896,paladin,holy,54,26,28
Durendin,bonechewer,894,paladin,holy,14,10,4
Redentor,dalaran,892,paladin,holy,44,24,20
Shananakin,azshara,892,paladin,holy,29,13,16
Takodaddy,elune,889,paladin,holy,16,10,6
Hildibrandt,stormrage,886,paladin,holy,20,10,10
Blackiron,frostmourne,883,paladin,holy,32,11,21
Nvgesus,undermine,881,paladin,holy,38,13,25
Letsirk,doomhammer,880,paladin,holy,30,11,19
Jyin,emerald-dream,880,paladin,holy,48,15,33
Papakatsu,proudmoore,878,paladin,holy,48,22,26
Ascension,amanthul,877,paladin,holy,149,58,91
Prh,frostmourne,868,paladin,holy,24,10,14
Løl,zuljin,865,paladin,holy,60,25,35
Sovice,illidan,864,paladin,holy,12,9,3
Trâshcårt,sargeras,864,paladin,holy,12,9,3
Athanaiëll,proudmoore,864,paladin,holy,22,11,11
Rachaelucky,malganis,864,paladin,holy,18,9,9
Mâdâra,stormrage,864,paladin,holy,18,9,9
Deadry,ysera,864,paladin,holy,18,9,9
Zilzag,moon-guard,864,paladin,holy,23,9,14
Diamondwater,tichondrius,864,paladin,holy,24,9,15
Mijikai,proudmoore,864,paladin,holy,24,9,15
Auraingraham,stormscale,863,paladin,holy,18,9,9
Cheers,garona,863,paladin,holy,18,9,9
Drossp,illidan,863,paladin,holy,18,9,9
Lamas,kelthuzad,863,paladin,holy,18,9,9
Proxima,laughing-skull,863,paladin,holy,24,9,15
Onlycams,sargeras,863,paladin,holy,24,9,15
Paintthinner,frostmourne,863,paladin,holy,24,9,15
Niense,wyrmrest-accord,862,paladin,holy,12,9,3
Msheen,azralon,861,paladin,holy,12,9,3
Potatopasta,area-52,861,paladin,holy,12,9,3
Selockpal,bleeding-hollow,861,paladin,holy,18,9,9
Pradå,tichondrius,857,paladin,holy,18,9,9
Gothsick,zuljin,857,paladin,holy,18,9,9
Stricken,kul-tiras,857,paladin,holy,24,9,15
Spamsalot,malganis,857,paladin,holy,24,9,15
Saxmurderz,tichondrius,853,paladin,holy,18,9,9
Nedorshock,stormrage,853,paladin,holy,24,9,15
Dewagon,area-52,853,paladin,holy,37,10,27
Veronica,sentinels,852,paladin,holy,42,9,33
Vëlar,tichondrius,851,paladin,holy,18,9,9
Mytolo,malganis,851,paladin,holy,24,9,15
Nualrossan,veknilash,850,paladin,holy,58,23,35
Gênji,eldrethalas,848,paladin,holy,66,22,44
Ðeathspire,tichondrius,846,paladin,holy,18,10,8
Alydralmao,area-52,845,paladin,holy,24,9,15
Maalik,thrall,844,paladin,holy,18,9,9
Andormu,wyrmrest-accord,841,paladin,holy,24,9,15
Jaok,tichondrius,831,paladin,holy,21,10,11
Orleenz,zuljin,831,paladin,holy,35,15,20
Supercutee,malganis,830,paladin,holy,22,9,13
Antivaxer,frostmourne,830,paladin,holy,23,9,14
Lennon,stormrage,829,paladin,holy,102,42,60
Bainn,nerzhul,822,paladin,holy,73,31,42
Alltoohuman,nagrand,821,paladin,holy,23,9,14
Palaknight,tichondrius,812,paladin,holy,60,21,39
Êctheliøn,drakkari,807,paladin,holy,18,10,8
Weenustickle,barthilas,807,paladin,holy,32,10,22
Praisin,zuljin,805,paladin,holy,18,9,9
Evanlina,bleeding-hollow,803,paladin,holy,21,10,11
Davinity,senjin,799,paladin,holy,23,9,14
Snowdawg,blackhand,794,paladin,holy,42,14,28
Alipal,area-52,794,paladin,holy,39,9,30
Mose,scilla,793,paladin,holy,17,9,8
Cyandra,moon-guard,783,paladin,holy,13,9,4
Holythunderx,tichondrius,782,paladin,holy,25,9,16
Sanastris,zuljin,778,paladin,holy,26,9,17
Holyfrénzy,thrall,776,paladin,holy,25,9,16
Bigolbittiez,tichondrius,774,paladin,holy,24,11,13
Kritzyx,stormrage,768,paladin,holy,12,8,4
Siebens,illidan,768,paladin,holy,12,8,4
Archerxx,ragnaros,768,paladin,holy,12,8,4
Notalkyna,kelthuzad,768,paladin,holy,12,8,4
Alkyna,kelthuzad,768,paladin,holy,12,8,4
Saintus,proudmoore,768,paladin,holy,18,8,10
Artús,ragnaros,768,paladin,holy,18,8,10
Loganholy,tichondrius,768,paladin,holy,18,8,10
Zero,anetheron,768,paladin,holy,18,8,10
Ahkairee,whisperwind,768,paladin,holy,24,8,16
Rawpaladin,blackrock,768,paladin,holy,24,8,16
Voladis,malganis,768,paladin,holy,30,8,22
Fupascoopa,illidan,767,paladin,holy,12,8,4
Linaiah,moon-guard,767,paladin,holy,12,8,4
Bestpally,alterac-mountains,767,paladin,holy,12,8,4
Gcmd,black-dragonflight,767,paladin,holy,12,8,4
Paradisso,tichondrius,767,paladin,holy,12,8,4
Kriegstier,scarlet-crusade,767,paladin,holy,12,8,4
Ezmødë,kelthuzad,767,paladin,holy,12,8,4
Mhera,sargeras,767,paladin,holy,12,8,4
Qadosh,sargeras,767,paladin,holy,12,8,4
Wonpai,barthilas,767,paladin,holy,18,8,10
Trancelancer,kelthuzad,767,paladin,holy,18,8,10
Technicolour,frostmourne,767,paladin,holy,18,8,10
Blackpiñk,tichondrius,767,paladin,holy,20,8,12
Bopsamdi,barthilas,767,paladin,holy,24,8,16
Cnyrla,tichondrius,766,paladin,holy,12,8,4
Wakethelight,illidan,766,paladin,holy,18,8,10
Banga,farstriders,766,paladin,holy,18,8,10
Wrekster,tichondrius,766,paladin,holy,18,8,10
Holydeath,arthas,766,paladin,holy,30,8,22
Thonar,stormrage,765,paladin,holy,12,8,4
Lightsòut,frostmourne,765,paladin,holy,24,8,16
Gromuu,azralon,765,paladin,holy,24,8,16
Qoop,tichondrius,765,paladin,holy,24,8,16
Revenere,tichondrius,765,paladin,holy,36,8,28
Grumpy,the-forgotten-coast,764,paladin,holy,12,8,4
Instaded,illidan,764,paladin,holy,18,8,10
Plsdontburst,tichondrius,763,paladin,holy,12,8,4
Pambam,thrall,763,paladin,holy,18,9,9
Etlas,windrunner,763,paladin,holy,18,8,10
Jereth,kelthuzad,763,paladin,holy,18,8,10
Árrest,tichondrius,763,paladin,holy,18,8,10
Porkwatchy,eonar,762,paladin,holy,24,8,16
Gyle,stormrage,761,paladin,holy,18,8,10
Sixthycent,kiljaeden,760,paladin,holy,18,8,10
Mixtapes,kargath,757,paladin,holy,12,8,4
Blacktemplar,area-52,755,paladin,holy,18,8,10
Crusæder,stormrage,753,paladin,holy,12,8,4
Unsungherø,skywall,752,paladin,holy,12,8,4
Willycrow,nordrassil,740,paladin,holy,18,8,10
Iwaterboy,malganis,732,paladin,holy,33,17,16
Eboi,daggerspine,732,paladin,holy,32,9,23
Granada,kirin-tor,727,paladin,holy,24,8,16
Mirotchburns,illidan,724,paladin,holy,16,9,7
Howlfrost,stormrage,719,paladin,holy,11,8,3
Kuunn,drakkari,718,paladin,holy,17,8,9
Deathblazer,blades-edge,716,paladin,holy,18,9,9
Mfn,tichondrius,714,paladin,holy,18,9,9
Visanth,bonechewer,677,paladin,holy,24,9,15
Gimmethéloot,stormrage,672,paladin,holy,12,7,5
Dgpaladin,tichondrius,672,paladin,holy,12,7,5
Zpsychotycx,tichondrius,672,paladin,holy,12,7,5
Imsuffering,zuljin,672,paladin,holy,12,7,5
Mlpx,stormrage,672,paladin,holy,12,7,5
Crinject,sargeras,672,paladin,holy,12,7,5
Canny,emerald-dream,672,paladin,holy,12,7,5
Xiaoholy,barthilas,672,paladin,holy,12,7,5
Busdid,sargeras,672,paladin,holy,12,7,5
Oîn,area-52,672,paladin,holy,12,7,5
Jachunga,bleeding-hollow,672,paladin,holy,12,7,5
Brogepi,cenarius,672,paladin,holy,12,7,5
Femsquatch,kelthuzad,672,paladin,holy,12,7,5
Farvadin,illidan,672,paladin,holy,12,7,5
Pkkcandy,archimonde,672,paladin,holy,12,7,5
Iamguess,stormscale,672,paladin,holy,18,7,11
Obllivionn,wildhammer,672,paladin,holy,18,7,11
Antigone,tichondrius,672,paladin,holy,18,7,11
Orekilol,stormrage,672,paladin,holy,18,7,11
Emmipal,tichondrius,672,paladin,holy,18,7,11
Oreki,area-52,672,paladin,holy,18,7,11
Sensible,sargeras,672,paladin,holy,24,7,17
Stompedlawl,illidan,672,paladin,holy,24,7,17
Hxnny,turalyon,672,paladin,holy,30,7,23
Boraz,bleeding-hollow,672,paladin,holy,36,7,29
Rahruan,wyrmrest-accord,671,paladin,holy,12,7,5
Scatterslol,korgath,671,paladin,holy,12,7,5
Grfauxpal,sargeras,671,paladin,holy,12,7,5
Billytwoshoe,laughing-skull,671,paladin,holy,12,7,5
Lördnextdoor,tichondrius,671,paladin,holy,12,7,5
Cirillah,quelthalas,671,paladin,holy,12,7,5
Aràyleus,kelthuzad,671,paladin,holy,12,7,5
Thin,ragnaros,671,paladin,holy,12,7,5
Demonsbane,frostmourne,671,paladin,holy,18,7,11
Shoppee,jubeithos,671,paladin,holy,18,7,11
Milonus,frostmourne,671,paladin,holy,18,7,11
Virkas,area-52,671,paladin,holy,18,7,11
Animal,korialstrasz,671,paladin,holy,18,7,11
Loguto,stormrage,671,paladin,holy,18,7,11
Lemmiéwinkzz,sargeras,671,paladin,holy,18,7,11
Hugokpz,quelthalas,671,paladin,holy,27,10,17
Sýteck,sargeras,671,paladin,holy,24,7,17
Éætûgýäëí,area-52,671,paladin,holy,42,8,34
Bolzar,zuljin,670,paladin,holy,12,7,5
Kalthorne,wyrmrest-accord,670,paladin,holy,12,7,5
Extee,proudmoore,670,paladin,holy,12,7,5
Bjdreams,ragnaros,670,paladin,holy,12,7,5
Bootymägicc,tichondrius,670,paladin,holy,12,7,5
Korvén,area-52,670,paladin,holy,12,7,5
Numenor,kiljaeden,670,paladin,holy,18,7,11
Rebelion,nagrand,670,paladin,holy,24,7,17
Drgn,azgalor,670,paladin,holy,30,7,23
Pluto,the-underbog,669,paladin,holy,12,7,5
Balkin,kelthuzad,669,paladin,holy,12,7,5
Solef,stormrage,669,paladin,holy,18,7,11
Jiralla,ragnaros,669,paladin,holy,18,7,11
Stationarity,frostmourne,669,paladin,holy,18,7,11
Røusseff,azralon,669,paladin,holy,18,7,11
Kimahri,anvilmar,669,paladin,holy,36,7,29
Annii,aegwynn,666,paladin,holy,12,7,5
Vanquishyr,stormrage,666,paladin,holy,30,7,23
Lmy,stormrage,665,paladin,holy,18,7,11
Geroden,tichondrius,665,paladin,holy,18,7,11
Bangerzzx,sargeras,663,paladin,holy,18,7,11
Nea,argent-dawn,659,paladin,holy,107,34,73
Chaós,queldorei,657,paladin,holy,18,7,11
Gnomesexer,illidan,655,paladin,holy,17,7,10
Ryuzu,arathor,640,paladin,holy,16,8,8
Josabbilra,tichondrius,639,paladin,holy,11,7,4
Mycow,tichondrius,638,paladin,holy,17,7,10
Mikiná,proudmoore,638,paladin,holy,22,7,15
Koraesta,stormrage,632,paladin,holy,17,7,10
Bullivan,sisters-of-elune,630,paladin,holy,23,7,16
Lesauceboss,tichondrius,624,paladin,holy,21,8,13
Mamothman,barthilas,622,paladin,holy,18,9,9
Usebandage,sargeras,617,paladin,holy,16,9,7
Mcpuffin,aggramar,610,paladin,holy,21,8,13
Jinguard,tichondrius,608,paladin,holy,16,7,9
Mojiberus,wyrmrest-accord,606,paladin,holy,14,7,7
Yês,proudmoore,591,paladin,holy,15,7,8
Turnevil,wyrmrest-accord,591,paladin,holy,19,7,12
Wonpait,frostmourne,576,paladin,holy,9,7,2
Tristx,illidan,576,paladin,holy,12,6,6
Holydubya,illidan,576,paladin,holy,12,6,6
Neeks,zuljin,576,paladin,holy,12,6,6
Tríno,malganis,576,paladin,holy,12,6,6
Dequincy,tichondrius,576,paladin,holy,12,6,6
Faie,frostmourne,576,paladin,holy,12,6,6
Gbj,staghelm,576,paladin,holy,12,6,6
Doradar,zuljin,576,paladin,holy,12,6,6
Vsleepeii,illidan,576,paladin,holy,12,6,6
Ùthèr,tichondrius,576,paladin,holy,12,6,6
Centimus,moon-guard,576,paladin,holy,12,6,6
Amadin,winterhoof,576,paladin,holy,12,6,6
Fadiez,sargeras,576,paladin,holy,12,6,6
Tolentino,elune,576,paladin,holy,12,6,6
Squarehammer,blackrock,576,paladin,holy,12,6,6
Catharsis,tichondrius,576,paladin,holy,12,6,6
Holymomia,blackrock,576,paladin,holy,12,6,6
Irêsha,quelthalas,576,paladin,holy,12,6,6
Jnzip,area-52,576,paladin,holy,15,7,8
Ironjudge,hakkar,576,paladin,holy,17,6,11
Okcheon,tichondrius,576,paladin,holy,18,6,12
Ghrumpy,thrall,576,paladin,holy,18,6,12
Shocksta,dalaran,576,paladin,holy,18,6,12
Imsoholy,tichondrius,576,paladin,holy,18,6,12
Lubed,aegwynn,576,paladin,holy,18,6,12
Remibear,tichondrius,576,paladin,holy,18,6,12
Jiråchi,sargeras,576,paladin,holy,18,6,12
Nikxx,tichondrius,576,paladin,holy,18,6,12
Marien,kelthuzad,576,paladin,holy,18,6,12
Kelosia,bonechewer,576,paladin,holy,18,6,12
Marleigh,kelthuzad,576,paladin,holy,18,6,12
Acpally,tichondrius,576,paladin,holy,24,6,18
Santiagolol,ragnaros,576,paladin,holy,24,6,18
Willywønka,azgalor,576,paladin,holy,30,6,24
Okx,illidan,575,paladin,holy,6,6,0
Borntocoom,stormrage,575,paladin,holy,12,6,6
Tanktopp,tichondrius,575,paladin,holy,12,6,6
Nøzawkalypse,kelthuzad,575,paladin,holy,12,6,6
Docternoon,stormrage,575,paladin,holy,12,6,6
Septimia,illidan,575,paladin,holy,12,6,6
Leatherfase,dalaran,575,paladin,holy,12,6,6
Cassiel,barthilas,575,paladin,holy,12,6,6
Bigpal,area-52,575,paladin,holy,12,6,6
Roachpally,area-52,575,paladin,holy,12,6,6
Luminouser,stormrage,575,paladin,holy,12,6,6
Mendes,stormrage,575,paladin,holy,12,6,6
Emptyjump,eredar,575,paladin,holy,12,6,6
Nochance,queldorei,575,paladin,holy,12,6,6
Auralyon,tichondrius,575,paladin,holy,12,6,6
Grombaby,lightnings-blade,575,paladin,holy,12,6,6
Anderious,moon-guard,575,paladin,holy,12,6,6
Aldrukor,quelthalas,575,paladin,holy,12,6,6
Dashhighborn,sargeras,575,paladin,holy,13,6,7
Areura,hellscream,575,paladin,holy,18,6,12
Clonazedin,ragnaros,575,paladin,holy,18,6,12
Hojadin,area-52,575,paladin,holy,18,6,12
Trycider,lightninghoof,575,paladin,holy,18,6,12
Theprimus,darkspear,574,paladin,holy,6,6,0
Vindication,nazgrel,574,paladin,holy,12,6,6
Pizzaface,stormrage,574,paladin,holy,12,6,6
Litebright,bleeding-hollow,574,paladin,holy,12,6,6
Rhonielson,tichondrius,574,paladin,holy,12,6,6
Mileihot,quelthalas,574,paladin,holy,18,6,12
Hamanjenkins,illidan,574,paladin,holy,18,6,12
Kilion,illidan,574,paladin,holy,18,6,12
Ehbowlskesk,zuljin,574,paladin,holy,20,6,14
Beefstewmre,dalaran,573,paladin,holy,18,6,12
Iluvitar,kiljaeden,573,paladin,holy,18,6,12
Metalpriest,shattered-halls,573,paladin,holy,24,6,18
Nellie,deathwing,572,paladin,holy,12,6,6
Holymomo,malganis,572,paladin,holy,12,6,6
Tehgodofdmg,tichondrius,572,paladin,holy,18,6,12
Ducii,stormrage,571,paladin,holy,18,6,12
Kratheus,azralon,569,paladin,holy,22,8,14
Maplleafs,kelthuzad,560,paladin,holy,24,6,18
Fleshoflíght,azjolnerub,559,paladin,holy,17,6,11
Glueconsumer,wyrmrest-accord,558,paladin,holy,12,7,5
Fayernaa,proudmoore,557,paladin,holy,10,7,3
Biéyihàn,tichondrius,543,paladin,holy,11,6,5
Redpally,emerald-dream,543,paladin,holy,16,6,10
Gabs,quelthalas,543,paladin,holy,16,6,10
Dorski,tichondrius,527,paladin,holy,11,6,5
Leggomyagro,fenris,522,paladin,holy,26,7,19
Tyygore,nagrand,521,paladin,holy,19,8,11
Biggestkritz,frostmourne,511,paladin,holy,14,6,8
Pakalun,area-52,510,paladin,holy,20,6,14
Clearcoms,stormrage,496,paladin,holy,13,6,7
Splyts,stormrage,490,paladin,holy,23,7,16
Zenastra,moon-guard,480,paladin,holy,6,5,1
Dlt,frostmourne,480,paladin,holy,6,5,1
Isecretly,stormrage,480,paladin,holy,6,5,1
Darfnarvis,sargeras,480,paladin,holy,6,5,1
Bigboiyahurd,sargeras,480,paladin,holy,6,5,1
Zanduncy,stormrage,480,paladin,holy,6,5,1
Badboí,azralon,480,paladin,holy,6,5,1
Cotopax,sargeras,480,paladin,holy,15,7,8
Mightypally,area-52,480,paladin,holy,12,5,7
Timeparadox,illidan,480,paladin,holy,12,5,7
Exiledpally,area-52,480,paladin,holy,12,5,7
Drunknbum,area-52,480,paladin,holy,12,5,7
Kãrmä,area-52,480,paladin,holy,12,5,7
Kongnibbax,spirestone,480,paladin,holy,12,5,7
Vicentê,ragnaros,480,paladin,holy,12,5,7
Velline,tichondrius,480,paladin,holy,12,5,7
Subotai,frostmourne,480,paladin,holy,12,5,7
Eneraxx,proudmoore,480,paladin,holy,12,5,7
Cleanprotein,tichondrius,480,paladin,holy,12,5,7
Ronnierawdog,frostmourne,480,paladin,holy,12,5,7
Zhangliyi,tichondrius,480,paladin,holy,12,5,7
Beila,illidan,480,paladin,holy,12,5,7
Garethorne,illidan,480,paladin,holy,12,5,7
Mortolla,duskwood,480,paladin,holy,12,5,7
Scubblez,zuljin,480,paladin,holy,12,5,7
Twoshockz,stormrage,480,paladin,holy,12,5,7
Keodis,suramar,480,paladin,holy,12,5,7
Leddie,stormrage,480,paladin,holy,12,5,7
Mithroe,tichondrius,480,paladin,holy,12,5,7
Ocxholly,azralon,480,paladin,holy,12,5,7
Fartburger,saurfang,480,paladin,holy,12,5,7
Inmortall,illidan,480,paladin,holy,12,5,7
Jeryko,gundrak,480,paladin,holy,12,5,7
Gøldenlight,illidan,480,paladin,holy,12,5,7
Wälly,sargeras,480,paladin,holy,12,5,7
Sixty,sargeras,480,paladin,holy,12,5,7
Gendevo,suramar,480,paladin,holy,12,5,7
Oxycleän,doomhammer,480,paladin,holy,12,5,7
Bíteme,sargeras,480,paladin,holy,15,6,9
Ashenira,barthilas,480,paladin,holy,18,5,13
Ariste,emerald-dream,480,paladin,holy,18,5,13
Stahz,illidan,480,paladin,holy,18,5,13
Wêsleypipes,crushridge,480,paladin,holy,18,5,13
Chrisgrin,malganis,480,paladin,holy,18,5,13
Chimp,kiljaeden,480,paladin,holy,18,5,13
Mootumba,boulderfist,480,paladin,holy,24,5,19
Bubbleosèven,tichondrius,479,paladin,holy,6,5,1
Pazztez,arthas,479,paladin,holy,12,5,7
Mightythorxx,tichondrius,479,paladin,holy,12,5,7
Loabandit,malorne,479,paladin,holy,12,5,7
Holyshasha,tichondrius,479,paladin,holy,12,5,7
Nielec,arygos,479,paladin,holy,12,5,7
Joelsama,area-52,479,paladin,holy,12,5,7
Judgejitsu,black-dragonflight,479,paladin,holy,12,5,7
Bubbes,nerzhul,479,paladin,holy,12,5,7
Tankgreed,quelthalas,479,paladin,holy,12,5,7
Lachaple,illidan,479,paladin,holy,12,5,7
Goksuu,ragnaros,479,paladin,holy,12,5,7
Elbarra,ragnaros,479,paladin,holy,12,5,7
Meistyr,thrall,479,paladin,holy,18,5,13
Healadelphia,illidan,479,paladin,holy,18,5,13
Lighteiron,moonrunner,478,paladin,holy,12,5,7
Mfpink,thrall,478,paladin,holy,12,5,7
Ozirus,frostmourne,478,paladin,holy,12,5,7
Yobnai,zuljin,478,paladin,holy,12,5,7
Boiducéu,azralon,478,paladin,holy,12,5,7
Sihylde,quelthalas,478,paladin,holy,18,5,13
Duecesz,area-52,478,paladin,holy,26,5,21
Sovereignt,aggramar,477,paladin,holy,12,5,7
Goingturbo,wyrmrest-accord,477,paladin,holy,12,5,7
Thaeldan,archimonde,477,paladin,holy,18,5,13
Crazykil,fenris,476,paladin,holy,12,5,7
Stilreigning,darkspear,476,paladin,holy,12,5,7
Helltec,draka,475,paladin,holy,12,5,7
Miros,wyrmrest-accord,473,paladin,holy,12,5,7
Callmeweazy,arathor,472,paladin,holy,18,5,13
Parts,aerie-peak,468,paladin,holy,30,5,25
Synasthesia,zuljin,463,paladin,holy,11,5,6
Toastedheals,stormreaver,463,paladin,holy,17,5,12
Blancaflór,ragnaros,447,paladin,holy,11,5,6
Blassphamy,chogall,447,paladin,holy,14,6,8
Ziggerqt,stormrage,432,paladin,holy,15,5,10
Paladinkofwa,tichondrius,432,paladin,holy,21,5,16
Belfordz,stormrage,430,paladin,holy,15,6,9
Nivie,moon-guard,430,paladin,holy,15,5,10
Banpally,tichondrius,426,paladin,holy,15,7,8
Rashell,garrosh,426,paladin,holy,16,7,9
Mousesack,dragonmaw,426,paladin,holy,16,7,9
Retribution,mannoroth,426,paladin,holy,23,6,17
Ziti,bonechewer,415,paladin,holy,8,5,3
Sushiopath,area-52,415,paladin,holy,14,5,9
Vgeater,ysera,397,paladin,holy,13,5,8
Tyranoss,azralon,384,paladin,holy,6,4,2
Oceania,grizzly-hills,384,paladin,holy,6,4,2
Aswaran,jaedenar,384,paladin,holy,6,4,2
Ceeten,tichondrius,384,paladin,holy,6,4,2
Lightwerk,frostmourne,384,paladin,holy,6,4,2
Tontô,barthilas,384,paladin,holy,6,4,2
Arleos,mannoroth,384,paladin,holy,6,4,2
Eladore,hakkar,384,paladin,holy,6,4,2
Immensepower,tichondrius,384,paladin,holy,6,4,2
Ladanthal,barthilas,384,paladin,holy,6,4,2
Rc,tichondrius,384,paladin,holy,6,4,2
Ohthatguy,sargeras,384,paladin,holy,6,4,2
Thesojulord,tichondrius,384,paladin,holy,6,4,2
Robötwizard,tichondrius,384,paladin,holy,6,4,2
Biz,black-dragonflight,384,paladin,holy,6,4,2
Elim,frostmourne,384,paladin,holy,6,4,2
Theonlyheals,bleeding-hollow,384,paladin,holy,6,4,2
Decree,rexxar,384,paladin,holy,6,4,2
Cenital,quelthalas,384,paladin,holy,6,4,2
Anonymvs,eredar,384,paladin,holy,6,4,2
Icac,stormrage,384,paladin,holy,6,4,2
Nickahunnid,sargeras,384,paladin,holy,6,4,2
Volphorix,illidan,384,paladin,holy,6,4,2
Nfl,moon-guard,384,paladin,holy,9,5,4
Dragnix,dalaran,384,paladin,holy,11,4,7
Penpal,sargeras,384,paladin,holy,12,4,8
Zamn,frostmourne,384,paladin,holy,12,4,8
Lánná,tichondrius,384,paladin,holy,12,4,8
Eull,skullcrusher,384,paladin,holy,12,4,8
Sacratess,area-52,384,paladin,holy,12,4,8
Palastik,malganis,384,paladin,holy,12,4,8
Purdicks,emerald-dream,384,paladin,holy,12,4,8
Lelands,alterac-mountains,384,paladin,holy,12,4,8
Floweezy,thrall,384,paladin,holy,12,4,8
Ajlol,thrall,384,paladin,holy,12,4,8
Gâbríél,maiev,384,paladin,holy,12,4,8
Zetka,tichondrius,384,paladin,holy,12,4,8
Justarius,stormrage,384,paladin,holy,12,4,8
Cubic,wyrmrest-accord,384,paladin,holy,12,4,8
Tyryan,azralon,384,paladin,holy,12,4,8
Devsrdumb,bonechewer,384,paladin,holy,12,4,8
Bighardshock,aggramar,384,paladin,holy,12,4,8
Nerfrets,stormrage,384,paladin,holy,12,4,8
Nikkixo,ysera,384,paladin,holy,12,4,8
Gotredwings,proudmoore,384,paladin,holy,12,4,8
Pladypus,dalaran,384,paladin,holy,12,4,8
Cadap,bleeding-hollow,384,paladin,holy,12,4,8
Alkina,kelthuzad,384,paladin,holy,12,4,8
Swolsus,illidan,384,paladin,holy,12,4,8
Wangzu,wildhammer,384,paladin,holy,12,4,8
Alicethemad,aerie-peak,384,paladin,holy,12,4,8
Gùmbý,illidan,384,paladin,holy,12,4,8
Derbizzle,darkspear,384,paladin,holy,12,4,8
Maicolsalanu,quelthalas,384,paladin,holy,12,4,8
Daflash,emerald-dream,384,paladin,holy,12,4,8
Sentence,moon-guard,384,paladin,holy,12,4,8
Egf,illidan,384,paladin,holy,12,4,8
Saintcassi,wyrmrest-accord,384,paladin,holy,12,4,8
Bigtimepali,tichondrius,384,paladin,holy,12,4,8
Zundralak,korgath,384,paladin,holy,12,4,8
Nexandre,ragnaros,384,paladin,holy,22,5,17
Mory,aegwynn,384,paladin,holy,18,4,14
Beebopper,illidan,384,paladin,holy,18,4,14
Bloodangelz,sargeras,384,paladin,holy,18,4,14
Luminali,frostwolf,384,paladin,holy,18,4,14
Riyu,blackrock,384,paladin,holy,18,4,14
Õblivion,jubeithos,384,paladin,holy,18,4,14
Hímüra,nemesis,384,paladin,holy,18,4,14
Retholyprot,tichondrius,384,paladin,holy,18,4,14
Kaminasol,quelthalas,384,paladin,holy,18,4,14
Ardrider,emerald-dream,384,paladin,holy,18,4,14
Shockzer,bloodscalp,384,paladin,holy,23,4,19
Scah,illidan,383,paladin,holy,6,4,2
Sabex,wyrmrest-accord,383,paladin,holy,6,4,2
Tommyjr,nazgrel,383,paladin,holy,6,4,2
Rënner,stormrage,383,paladin,holy,12,4,8
Lightbeard,feathermoon,383,paladin,holy,12,4,8
Fivestarzx,malganis,383,paladin,holy,12,4,8
Thulamon,zuljin,383,paladin,holy,12,4,8
Namaru,hellscream,383,paladin,holy,12,4,8
Vorex,ragnaros,383,paladin,holy,12,4,8
Lunchmoney,aggramar,383,paladin,holy,12,4,8
Anjøs,azralon,383,paladin,holy,18,4,14
Gokzurah,dragonmaw,383,paladin,holy,18,4,14
Tennesse,sargeras,383,paladin,holy,18,4,14
Alyosya,barthilas,383,paladin,holy,24,4,20
Outforblood,stormscale,382,paladin,holy,8,4,4
Veliona,thaurissan,382,paladin,holy,12,4,8
Densom,aggramar,381,paladin,holy,12,4,8
Rustacian,area-52,380,paladin,holy,12,4,8
Gornack,draka,379,paladin,holy,12,4,8
Valhallaborn,illidan,355,paladin,holy,23,7,16
Níkolaev,azralon,351,paladin,holy,11,4,7
Aärøn,stormrage,351,paladin,holy,11,4,7
Gnomeslapper,frostmourne,351,paladin,holy,11,4,7
Palewan,kiljaeden,351,paladin,holy,11,4,7
Cristineth,tanaris,351,paladin,holy,14,5,9
Mangchì,tichondrius,336,paladin,holy,9,5,4
Lafawndah,blackhand,333,paladin,holy,17,4,13
Eijara,shattered-hand,330,paladin,holy,32,5,27
Veeve,emerald-dream,304,paladin,holy,7,4,3
Nulric,moon-guard,304,paladin,holy,13,4,9
Nskkbr,frostmourne,304,paladin,holy,13,4,9
Rett,chogall,288,paladin,holy,8,5,3
Holzinger,quelthalas,288,paladin,holy,6,3,3
Leronos,zuljin,288,paladin,holy,6,3,3
Rheepent,hyjal,288,paladin,holy,6,3,3
Neil,kelthuzad,288,paladin,holy,6,3,3
Odinns,proudmoore,288,paladin,holy,6,3,3
Holysheesh,cenarion-circle,288,paladin,holy,6,3,3
Schwârts,blackrock,288,paladin,holy,6,3,3
Bosto,dunemaul,288,paladin,holy,6,3,3
Soapgirl,area-52,288,paladin,holy,6,3,3
Arena,mannoroth,288,paladin,holy,6,3,3
Breesh,nerzhul,288,paladin,holy,6,3,3
Kshock,proudmoore,288,paladin,holy,6,3,3
Gompa,bleeding-hollow,288,paladin,holy,6,3,3
Laythoz,hyjal,288,paladin,holy,6,3,3
Mindfoolness,sargeras,288,paladin,holy,6,3,3
Tyriån,lightbringer,288,paladin,holy,6,3,3
Tpane,kelthuzad,288,paladin,holy,6,3,3
Vanitasz,bleeding-hollow,288,paladin,holy,6,3,3
Barquin,dalaran,288,paladin,holy,6,3,3
Kaleroenin,cenarius,288,paladin,holy,6,3,3
Solkad,tichondrius,288,paladin,holy,6,3,3
Feelsögood,tichondrius,288,paladin,holy,6,3,3
Synergy,draenor,288,paladin,holy,6,3,3
Psalms,lightnings-blade,288,paladin,holy,6,3,3
Paen,area-52,288,paladin,holy,6,3,3
Phut,stormrage,288,paladin,holy,6,3,3
Thyedron,azralon,288,paladin,holy,6,3,3
Kharissia,proudmoore,288,paladin,holy,6,3,3
Aduhrawl,moon-guard,288,paladin,holy,6,3,3
Demoniret,ragnaros,288,paladin,holy,6,3,3
Miggsy,stormrage,288,paladin,holy,6,3,3
Datguysname,illidan,288,paladin,holy,6,3,3
Jackywacky,malganis,288,paladin,holy,6,3,3
Lànd,tichondrius,288,paladin,holy,6,3,3
Nipon,stormrage,288,paladin,holy,6,3,3
Zyrk,nemesis,288,paladin,holy,6,3,3
Partyplace,stormrage,288,paladin,holy,6,3,3
Brightcore,stormrage,288,paladin,holy,6,3,3
Hazkal,sargeras,288,paladin,holy,6,3,3
Antarcticala,frostmourne,288,paladin,holy,6,3,3
Fuchí,tichondrius,288,paladin,holy,6,3,3
Dayatthespa,stormrage,288,paladin,holy,6,3,3
Kusunoki,kelthuzad,288,paladin,holy,6,3,3
Marolla,frostmourne,288,paladin,holy,6,3,3
Ressia,ragnaros,288,paladin,holy,6,3,3
Alîcë,wyrmrest-accord,288,paladin,holy,6,3,3
Apally,drakthul,288,paladin,holy,6,3,3
Hitlist,frostmourne,288,paladin,holy,6,3,3
Andronik,bleeding-hollow,288,paladin,holy,6,3,3
Wonpæi,frostmourne,288,paladin,holy,6,3,3
Finishearlyx,kelthuzad,288,paladin,holy,6,3,3
Stormvikingx,darkspear,288,paladin,holy,6,3,3
Grimmey,azjolnerub,288,paladin,holy,6,3,3
Repgodx,illidan,288,paladin,holy,6,3,3
Gutzzx,frostmourne,288,paladin,holy,6,3,3
Urudith,azralon,288,paladin,holy,11,3,8
Repths,illidan,288,paladin,holy,12,3,9
Dartherion,shandris,288,paladin,holy,12,3,9
Prâytorian,illidan,288,paladin,holy,12,3,9
Drippinheals,eitrigg,288,paladin,holy,12,3,9
Haldry,wyrmrest-accord,288,paladin,holy,12,3,9
Taethelan,malganis,288,paladin,holy,12,3,9
Deckter,ragnaros,288,paladin,holy,12,3,9
Ratface,dathremar,288,paladin,holy,12,3,9
Serca,khadgar,288,paladin,holy,12,3,9
Dráugus,azralon,288,paladin,holy,12,3,9
Imabigkidnow,emerald-dream,288,paladin,holy,12,3,9
Quits,tichondrius,288,paladin,holy,12,3,9
Thichammer,frostmourne,288,paladin,holy,12,3,9
Kommuna,stormscale,288,paladin,holy,12,3,9
Buslightyear,azralon,288,paladin,holy,12,3,9
Sigfriéd,tichondrius,288,paladin,holy,12,3,9
Teerblood,illidan,288,paladin,holy,12,3,9
Paludin,deathwing,288,paladin,holy,12,3,9
Mevand,windrunner,288,paladin,holy,12,3,9
Revoraal,frostmourne,288,paladin,holy,12,3,9
Æglè,area-52,288,paladin,holy,12,3,9
Tolipos,earthen-ring,288,paladin,holy,12,3,9
Benadiction,wyrmrest-accord,288,paladin,holy,12,3,9
Afkyouheal,suramar,288,paladin,holy,12,3,9
Beeodin,malganis,288,paladin,holy,12,3,9
Geðff,burning-legion,288,paladin,holy,12,3,9
Rudez,kiljaeden,288,paladin,holy,12,3,9
Yanggongru,sargeras,288,paladin,holy,12,3,9
Sanctifyd,kiljaeden,288,paladin,holy,12,3,9
Thechoseno,tichondrius,288,paladin,holy,22,4,18
Tooholy,kiljaeden,288,paladin,holy,18,3,15
Capsiel,caelestrasz,288,paladin,holy,18,3,15
Alogagain,frostmourne,288,paladin,holy,18,3,15
Mathalt,area-52,288,paladin,holy,18,3,15
Flarisic,kelthuzad,288,paladin,holy,18,3,15
Bigboppapump,lightnings-blade,288,paladin,holy,18,3,15
Guidö,stormrage,288,paladin,holy,20,3,17
Holyslapz,nazjatar,287,paladin,holy,6,3,3
Avantasias,sargeras,287,paladin,holy,12,3,9
Spacebacon,thunderlord,287,paladin,holy,12,3,9
Fokatayew,korialstrasz,287,paladin,holy,12,3,9
Giscicatrice,firetree,287,paladin,holy,12,3,9
Rost,jaedenar,287,paladin,holy,24,3,21
Moraxeus,gundrak,286,paladin,holy,6,3,3
Kaydenkross,azralon,286,paladin,holy,6,3,3
Hehealsyou,alleria,285,paladin,holy,12,3,9
Schnabdain,exodar,285,paladin,holy,18,3,15
Sellathice,khadgar,271,paladin,holy,11,3,8
Malthisz,antonidas,265,paladin,holy,17,5,12
Iradruidz,tichondrius,255,paladin,holy,11,3,8
Purepwnage,wyrmrest-accord,239,paladin,holy,5,3,2
Holywoof,agamaggan,234,paladin,holy,11,5,6
Itheternal,dalaran,234,paladin,holy,9,4,5
Wëlch,nemesis,234,paladin,holy,16,4,12
Cutebtw,zuljin,234,paladin,holy,18,4,14
Inarit,thrall,232,paladin,holy,22,5,17
Jaxal,nordrassil,208,paladin,holy,7,3,4
Tumatauenga,burning-blade,192,paladin,holy,6,2,4
Veguê,ragnaros,192,paladin,holy,6,2,4
Breach,blades-edge,192,paladin,holy,6,2,4
Mordirhar,tichondrius,192,paladin,holy,6,2,4
Jabusty,kelthuzad,192,paladin,holy,6,2,4
Healheal,tichondrius,192,paladin,holy,6,2,4
Elchupalibre,tichondrius,192,paladin,holy,6,2,4
Raywhite,kelthuzad,192,paladin,holy,6,2,4
Lóli,azralon,192,paladin,holy,6,2,4
Romaztlan,area-52,192,paladin,holy,6,2,4
Bravomedic,emerald-dream,192,paladin,holy,6,2,4
Aqbean,area-52,192,paladin,holy,6,2,4
Nachius,ragnaros,192,paladin,holy,6,2,4
Toonchies,barthilas,192,paladin,holy,6,2,4
Goldieg,tichondrius,192,paladin,holy,6,2,4
Chinaballoon,moonrunner,192,paladin,holy,6,2,4
Enkcarnated,tichondrius,192,paladin,holy,6,2,4
Turnipfãrmer,tichondrius,192,paladin,holy,6,2,4
Bakapal,tichondrius,192,paladin,holy,6,2,4
Healnsqueal,stormrage,192,paladin,holy,6,2,4
Goldirock,quelthalas,192,paladin,holy,6,2,4
Coffeeman,barthilas,192,paladin,holy,6,2,4
Mythpally,barthilas,192,paladin,holy,6,2,4
Iolwhat,sargeras,192,paladin,holy,6,2,4
Câno,quelthalas,192,paladin,holy,6,2,4
Momhips,bloodscalp,192,paladin,holy,6,2,4
Relil,frostmourne,192,paladin,holy,6,2,4
Lazydin,tichondrius,192,paladin,holy,6,2,4
Wâr,aegwynn,192,paladin,holy,6,2,4
Svane,thunderlord,192,paladin,holy,6,2,4
Piscacha,ragnaros,192,paladin,holy,6,2,4
Jastella,illidan,192,paladin,holy,6,2,4
Stormwinter,azralon,192,paladin,holy,6,2,4
Drii,moon-guard,192,paladin,holy,6,2,4
Ironmanfrank,tichondrius,192,paladin,holy,6,2,4
Hitabull,hyjal,192,paladin,holy,6,2,4
Trâgedy,azjolnerub,192,paladin,holy,6,2,4
Gilazhar,eldrethalas,192,paladin,holy,6,2,4
Cathandrix,malganis,192,paladin,holy,6,2,4
Smôres,sargeras,192,paladin,holy,6,2,4
Xtabelcnu,illidan,192,paladin,holy,6,2,4
Borngood,tichondrius,192,paladin,holy,6,2,4
Antoniano,ragnaros,192,paladin,holy,6,2,4
Flexxborn,thrall,192,paladin,holy,6,2,4
Pearlx,ragnaros,192,paladin,holy,6,2,4
Xinane,dalaran,192,paladin,holy,6,2,4
Sainttom,sargeras,192,paladin,holy,6,2,4
Pgpal,kelthuzad,192,paladin,holy,6,2,4
Flintstone,barthilas,192,paladin,holy,6,2,4
Raiel,aegwynn,192,paladin,holy,6,2,4
Pallydeen,illidan,192,paladin,holy,6,2,4
Akj,tichondrius,192,paladin,holy,6,2,4
Eicke,malganis,192,paladin,holy,6,2,4
Misakiqs,sargeras,192,paladin,holy,6,2,4
Patpatterson,mannoroth,192,paladin,holy,6,2,4
Bubblebuddyy,tichondrius,192,paladin,holy,6,2,4
Razzypal,sargeras,192,paladin,holy,6,2,4
Eckò,malganis,192,paladin,holy,6,2,4
Kimbr,gallywix,192,paladin,holy,6,2,4
Bigdmcgee,frostmourne,192,paladin,holy,6,2,4
Illbubble,duskwood,192,paladin,holy,7,2,5
Naxzero,shadowsong,192,paladin,holy,8,2,6
Andrilsteh,malganis,192,paladin,holy,12,2,10
Märdrius,tichondrius,192,paladin,holy,12,2,10
Piupiubiu,stormrage,192,paladin,holy,12,2,10
Trojani,malganis,192,paladin,holy,12,2,10
Giuseppepee,malganis,192,paladin,holy,12,2,10
Einheilagr,stormrage,192,paladin,holy,12,2,10
Spoons,malganis,192,paladin,holy,12,2,10
Leonardò,moon-guard,192,paladin,holy,12,2,10
Streetacus,stormrage,192,paladin,holy,12,2,10
Gavril,kirin-tor,192,paladin,holy,12,2,10
Dwemeor,azuremyst,192,paladin,holy,12,2,10
Vaylindor,area-52,192,paladin,holy,12,2,10
Carmiínha,azralon,192,paladin,holy,12,2,10
Bohoqt,tichondrius,192,paladin,holy,12,2,10
Gathnannia,stormrage,192,paladin,holy,12,2,10
Cehart,windrunner,192,paladin,holy,12,2,10
Bighausse,thrall,192,paladin,holy,12,2,10
Minzyy,frostmourne,192,paladin,holy,12,2,10
Murkpal,frostmourne,192,paladin,holy,12,2,10
Krypton,tichondrius,192,paladin,holy,18,2,16
Waifupaladin,azralon,192,paladin,holy,18,2,16
Shoresy,terokkar,192,paladin,holy,18,2,16
Levarious,thunderlord,192,paladin,holy,18,2,16
Ronatiú,tichondrius,192,paladin,holy,18,2,16
Cedinea,wyrmrest-accord,191,paladin,holy,6,2,4
Basedhumpaly,moon-guard,191,paladin,holy,6,2,4
Oldmanmark,jubeithos,191,paladin,holy,6,2,4
Holygota,nemesis,191,paladin,holy,6,2,4
Arobelse,sargeras,191,paladin,holy,12,2,10
Myû,korgath,160,paladin,holy,10,3,7
Itsoverninek,emerald-dream,159,paladin,holy,17,2,15
Hearthledger,ragnaros,144,paladin,holy,3,3,0
Elrecka,stormrage,144,paladin,holy,9,2,7
Whitedozer,darkspear,138,paladin,holy,10,4,6
Zela,ghostlands,137,paladin,holy,21,3,18
Guelmin,azralon,112,paladin,holy,7,2,5
Pigeon,darkspear,96,paladin,holy,6,1,5
Thorr,trollbane,96,paladin,holy,6,1,5
Cathraga,moknathal,96,paladin,holy,6,1,5
Syrenadrel,hydraxis,96,paladin,holy,6,1,5
Yikyok,stormrage,96,paladin,holy,6,1,5
Netéro,skywall,96,paladin,holy,6,1,5
Parzsival,blood-furnace,96,paladin,holy,6,1,5
Meltedcheese,destromath,96,paladin,holy,6,1,5
Rhinno,lothar,96,paladin,holy,6,1,5
Oncehumanoid,stormrage,96,paladin,holy,6,1,5
Kurook,moon-guard,96,paladin,holy,6,1,5
Tfcpaladin,the-forgotten-coast,96,paladin,holy,6,1,5
Chakris,wyrmrest-accord,96,paladin,holy,6,1,5
Crosjudge,zuljin,96,paladin,holy,6,1,5
Therëv,zuljin,96,paladin,holy,6,1,5
Sherrill,nagrand,96,paladin,holy,6,1,5
Hibunny,thaurissan,96,paladin,holy,6,1,5
Trixzthot,barthilas,96,paladin,holy,6,1,5
Kamí,elune,96,paladin,holy,6,1,5
Deadlyassian,ysera,96,paladin,holy,6,1,5
Combidin,garrosh,96,paladin,holy,6,1,5
ßls,illidan,96,paladin,holy,6,1,5
Shartea,moon-guard,96,paladin,holy,6,1,5
Tradorel,illidan,96,paladin,holy,6,1,5
Victores,illidan,96,paladin,holy,6,1,5
Lgbtq,trollbane,96,paladin,holy,6,1,5
Arturias,kiljaeden,96,paladin,holy,6,1,5
Retattack,area-52,96,paladin,holy,6,1,5
Khaosactual,proudmoore,96,paladin,holy,6,1,5
Luxs,tichondrius,96,paladin,holy,6,1,5
Komugì,thrall,96,paladin,holy,6,1,5
Daz,spinebreaker,96,paladin,holy,6,1,5
Chucknoreis,azralon,96,paladin,holy,6,1,5
Räny,quelthalas,96,paladin,holy,6,1,5
Zoneyy,proudmoore,96,paladin,holy,6,1,5
Romeh,malganis,96,paladin,holy,6,1,5
Keltheas,rivendare,96,paladin,holy,6,1,5
Greddlok,rivendare,96,paladin,holy,6,1,5
Kaynè,senjin,96,paladin,holy,6,1,5
Kwazshock,area-52,96,paladin,holy,6,1,5
Holybuds,barthilas,96,paladin,holy,6,1,5
Dougiè,boulderfist,96,paladin,holy,6,1,5
Boppal,tichondrius,96,paladin,holy,6,1,5
Razuel,frostmourne,96,paladin,holy,6,1,5
Traditionalp,area-52,96,paladin,holy,6,1,5
Owllii,frostwolf,96,paladin,holy,6,1,5
Zwilliam,frostmourne,96,paladin,holy,6,1,5
Oofky,ragnaros,96,paladin,holy,6,1,5
Dárkness,blades-edge,96,paladin,holy,6,1,5
Sevina,twisting-nether,96,paladin,holy,6,1,5
Couchz,area-52,96,paladin,holy,6,1,5
Tesstickle,skullcrusher,96,paladin,holy,6,1,5
Jeffylolmar,sargeras,96,paladin,holy,6,1,5
Vîxey,ragnaros,96,paladin,holy,6,1,5
Palabora,kelthuzad,96,paladin,holy,6,1,5
Wings,arygos,96,paladin,holy,6,1,5
Ploppers,sargeras,96,paladin,holy,6,1,5
Elronda,malganis,96,paladin,holy,6,1,5
Cremefraichè,tichondrius,96,paladin,holy,6,1,5
Litara,malganis,96,paladin,holy,6,1,5
Tarpeeksi,tichondrius,96,paladin,holy,6,1,5
Bayraa,tichondrius,96,paladin,holy,6,1,5
Burgasari,tichondrius,96,paladin,holy,6,1,5
Hamadam,azralon,96,paladin,holy,6,1,5
Droppain,tichondrius,96,paladin,holy,6,1,5
Pïñgÿåøpälâ,sargeras,96,paladin,holy,6,1,5
Makíma,tichondrius,96,paladin,holy,6,1,5
Silreck,ragnaros,96,paladin,holy,6,1,5
Tetulia,quelthalas,96,paladin,holy,6,1,5
Ripadin,dunemaul,96,paladin,holy,11,1,10
Grîshnâkh,ragnaros,96,paladin,holy,11,1,10
Midnightboto,dragonmaw,96,paladin,holy,12,1,11
Soloist,tichondrius,96,paladin,holy,12,1,11
Nickpala,bleeding-hollow,96,paladin,holy,12,1,11
Ordained,moonrunner,96,paladin,holy,12,1,11
Yccorz,frostmourne,96,paladin,holy,12,1,11
Quinhella,quelthalas,96,paladin,holy,12,1,11
Jwilks,black-dragonflight,96,paladin,holy,12,1,11
Dapallytroll,area-52,96,paladin,holy,12,1,11
Jumahji,illidan,96,paladin,holy,12,1,11
Zentrick,whisperwind,96,paladin,holy,12,1,11
Bahkax,tichondrius,96,paladin,holy,12,1,11
Vexe,emerald-dream,96,paladin,holy,12,1,11
Pedin,stormrage,96,paladin,holy,12,1,11
Memenki,azralon,96,paladin,holy,12,1,11
Aenwyl,quelthalas,96,paladin,holy,24,1,23
Arlé,stormrage,95,paladin,holy,6,1,5
Ååron,thrall,89,paladin,holy,11,3,8
Emilywilis,sargeras,84,paladin,holy,17,5,12
Zaeris,proudmoore,79,paladin,holy,5,1,4
Athenia,moon-guard,63,paladin,holy,6,3,3
Usaýa,moon-guard,48,paladin,holy,3,1,2
Jkethuhsnake,ghostlands,48,paladin,holy,21,1,20
Burgermeat,bleeding-hollow,42,paladin,holy,9,2,7
Alpinestârs,tichondrius,42,paladin,holy,9,2,7
Justinbebr,tichondrius,42,paladin,holy,14,3,11
Beaconlol,proudmoore,42,paladin,holy,10,2,8
Kziwei,stormrage,31,paladin,holy,2,1,1
Shkafell,ragnaros,9,paladin,holy,8,2,6
Oghal,frostmourne,9,paladin,holy,23,3,20
Vânguards,tichondrius,2250,paladin,retribution,111,62,49
Imitlol,alexstrasza,2250,paladin,retribution,205,106,99
Vanguards,tichondrius,2192,paladin,retribution,78,43,35
Rexpeitaboot,azralon,2175,paladin,retribution,89,47,42
Thulêan,moon-guard,2168,paladin,retribution,239,122,117
Zozo,zuljin,2152,paladin,retribution,95,50,45
Notvelic,tichondrius,2145,paladin,retribution,158,81,77
Lvladen,sargeras,2145,paladin,retribution,108,52,56
Tramatic,sargeras,2143,paladin,retribution,138,71,67
Venguards,azralon,2120,paladin,retribution,163,85,78
Hamburgeryu,tichondrius,2119,paladin,retribution,100,49,51
Dasp,nagrand,2112,paladin,retribution,84,45,39
Condiments,earthen-ring,2110,paladin,retribution,144,77,67
Coolvelic,tichondrius,2110,paladin,retribution,156,79,77
Evanguards,tichondrius,2105,paladin,retribution,202,102,100
Ryuseiblade,ragnaros,2102,paladin,retribution,138,69,69
Yuji,darkspear,2102,paladin,retribution,108,54,54
Xalarius,illidan,2101,paladin,retribution,71,36,35
Shôtgun,tichondrius,2101,paladin,retribution,138,69,69
Getmeabag,tichondrius,2097,paladin,retribution,96,48,48
Lanteranth,drenden,2096,paladin,retribution,204,102,102
Alpinestârs,tichondrius,2091,paladin,retribution,205,106,99
Dayuanzhong,tichondrius,2089,paladin,retribution,117,60,57
Hollyflame,tichondrius,2088,paladin,retribution,245,124,121
Egirlret,tichondrius,2086,paladin,retribution,108,55,53
Picachü,ragnaros,2078,paladin,retribution,154,77,77
Xxwitcherxx,stormrage,2060,paladin,retribution,153,87,66
Angryvelic,tichondrius,2060,paladin,retribution,120,57,63
Quitzz,tichondrius,2050,paladin,retribution,117,58,59
Thørmento,azralon,2046,paladin,retribution,207,107,100
Palakanda,azralon,2044,paladin,retribution,60,35,25
Mikeqiaodan,tichondrius,2039,paladin,retribution,162,85,77
Dreamcastx,tichondrius,2037,paladin,retribution,191,96,95
Iqt,moon-guard,2030,paladin,retribution,162,82,80
Xiaoqingye,tichondrius,2026,paladin,retribution,113,59,54
Caperx,tichondrius,2026,paladin,retribution,66,31,35
Simplybést,zuljin,2024,paladin,retribution,204,102,102
Alicê,moon-guard,2018,paladin,retribution,84,41,43
Slíckhuman,spinebreaker,2014,paladin,retribution,108,64,44
Hammrekt,kelthuzad,2012,paladin,retribution,120,60,60
Furylolz,tichondrius,2009,paladin,retribution,70,35,35
Scathol,tichondrius,2007,paladin,retribution,120,61,59
Mashbringer,moon-guard,2005,paladin,retribution,108,57,51
Xexe,stormreaver,2004,paladin,retribution,156,76,80
Metallíka,nemesis,1997,paladin,retribution,139,66,73
Ozzium,ragnaros,1995,paladin,retribution,191,98,93
Kishou,stormrage,1991,paladin,retribution,69,34,35
Mcconnell,sargeras,1988,paladin,retribution,66,40,26
Aldda,azralon,1987,paladin,retribution,146,69,77
Lazypally,frostmourne,1986,paladin,retribution,96,51,45
Genericuser,sargeras,1984,paladin,retribution,82,44,38
Bartharious,malganis,1984,paladin,retribution,120,58,62
Dankrachet,thrall,1981,paladin,retribution,84,41,43
Daxxj,akama,1979,paladin,retribution,176,85,91
Animepower,moon-guard,1978,paladin,retribution,180,105,75
Swurvezx,bleeding-hollow,1976,paladin,retribution,59,37,22
Ashenhallow,alexstrasza,1973,paladin,retribution,42,27,15
Møemøeda,illidan,1973,paladin,retribution,60,28,32
Bigdickrick,ragnaros,1972,paladin,retribution,54,32,22
Ämoureux,bleeding-hollow,1970,paladin,retribution,141,67,74
Theblèss,tichondrius,1969,paladin,retribution,127,59,68
Conndiment,earthen-ring,1968,paladin,retribution,90,45,45
Holychris,shadowmoon,1968,paladin,retribution,150,70,80
Kaharule,akama,1966,paladin,retribution,88,49,39
Smortain,tichondrius,1966,paladin,retribution,95,44,51
Mikhàël,stormscale,1963,paladin,retribution,70,49,21
Caveyodeler,zuluhed,1962,paladin,retribution,66,31,35
Koyoikonan,tichondrius,1959,paladin,retribution,54,35,19
Kubota,sargeras,1958,paladin,retribution,60,36,24
Dreamcastz,tichondrius,1957,paladin,retribution,48,33,15
Kurôsh,kalecgos,1955,paladin,retribution,96,52,44
Damionblade,proudmoore,1955,paladin,retribution,277,147,130
Draenkz,quelthalas,1954,paladin,retribution,57,37,20
Ðori,tichondrius,1952,paladin,retribution,82,38,44
Kraggar,arthas,1948,paladin,retribution,78,47,31
Xuantianchai,tichondrius,1944,paladin,retribution,60,36,24
Pallehx,tichondrius,1944,paladin,retribution,83,38,45
Bøgård,sargeras,1941,paladin,retribution,299,151,148
Yccorz,frostmourne,1940,paladin,retribution,266,135,131
Dratzq,ragnaros,1938,paladin,retribution,90,49,41
Wasteddwolf,tichondrius,1934,paladin,retribution,195,95,100
Maledraenei,sargeras,1932,paladin,retribution,125,58,67
Nbtv,tichondrius,1931,paladin,retribution,78,36,42
Kamadonezuko,illidan,1930,paladin,retribution,130,66,64
Indivisionxp,tichondrius,1928,paladin,retribution,55,34,21
Fossilz,sargeras,1927,paladin,retribution,59,31,28
Shotgunzs,tichondrius,1926,paladin,retribution,66,30,36
Enjoy,frostmourne,1925,paladin,retribution,96,51,45
Sukilol,tichondrius,1925,paladin,retribution,192,100,92
Usdacertifed,lightnings-blade,1925,paladin,retribution,302,157,145
Bluerunebar,illidan,1916,paladin,retribution,66,37,29
Marthellus,quelthalas,1915,paladin,retribution,85,43,42
Mwqyyds,tichondrius,1915,paladin,retribution,148,71,77
Grifnballs,agamaggan,1913,paladin,retribution,62,35,27
Memorisë,ragnaros,1913,paladin,retribution,304,157,147
Monkeypala,dathremar,1911,paladin,retribution,54,30,24
Galatus,tichondrius,1910,paladin,retribution,71,33,38
Hammrekt,illidan,1905,paladin,retribution,48,25,23
Furgalicious,area-52,1904,paladin,retribution,125,60,65
Bestowed,moon-guard,1903,paladin,retribution,93,46,47
Omnnii,tichondrius,1902,paladin,retribution,83,43,40
Clee,sargeras,1900,paladin,retribution,129,73,56
Angelguards,tichondrius,1900,paladin,retribution,60,30,30
Clapstick,illidan,1900,paladin,retribution,72,33,39
Shiryn,illidan,1899,paladin,retribution,73,38,35
Cryof,illidan,1899,paladin,retribution,78,34,44
Luosiding,tichondrius,1898,paladin,retribution,167,76,91
Zanthus,shadow-council,1896,paladin,retribution,35,20,15
Dadadalala,tichondrius,1895,paladin,retribution,36,20,16
Velstadt,sargeras,1895,paladin,retribution,78,36,42
Awbie,moon-guard,1894,paladin,retribution,66,35,31
Danceholy,tichondrius,1894,paladin,retribution,81,39,42
Ohuo,tichondrius,1893,paladin,retribution,340,178,162
Cønk,khadgar,1892,paladin,retribution,170,100,70
Peledin,azralon,1890,paladin,retribution,95,48,47
Attkdmgcurry,illidan,1890,paladin,retribution,71,34,37
Galeatus,tichondrius,1890,paladin,retribution,90,37,53
Dtaitou,tichondrius,1889,paladin,retribution,60,28,32
Vendatha,darkspear,1887,paladin,retribution,30,25,5
Panncakeman,tichondrius,1886,paladin,retribution,92,52,40
Hellsingwolf,zuljin,1885,paladin,retribution,30,20,10
Pécorino,malganis,1884,paladin,retribution,52,31,21
Palypants,proudmoore,1881,paladin,retribution,43,21,22
Gelosagrado,illidan,1881,paladin,retribution,177,82,95
Iäl,tichondrius,1881,paladin,retribution,71,31,40
Retrachet,thrall,1880,paladin,retribution,54,29,25
Zeldoul,magtheridon,1879,paladin,retribution,71,36,35
Homelanderp,tichondrius,1879,paladin,retribution,81,41,40
Roushex,sargeras,1875,paladin,retribution,72,35,37
Matthrian,moon-guard,1875,paladin,retribution,90,38,52
Slaneesh,ragnaros,1874,paladin,retribution,107,48,59
Voidaz,stormscale,1873,paladin,retribution,60,31,29
Attkdamdam,illidan,1871,paladin,retribution,54,26,28
Beautiful,proudmoore,1870,paladin,retribution,135,72,63
Fairgame,dathremar,1869,paladin,retribution,60,28,32
Alexjones,stormrage,1866,paladin,retribution,78,43,35
Bohring,bleeding-hollow,1865,paladin,retribution,54,29,25
Parlore,moon-guard,1865,paladin,retribution,168,89,79
Xilio,tichondrius,1865,paladin,retribution,72,36,36
Forzanapoli,tichondrius,1862,paladin,retribution,60,31,29
Dubliner,garona,1862,paladin,retribution,53,25,28
Juffury,illidan,1861,paladin,retribution,66,32,34
Talymra,ragnaros,1860,paladin,retribution,72,38,34
Víkk,zuljin,1860,paladin,retribution,182,94,88
Teniale,moon-guard,1859,paladin,retribution,54,28,26
Chuoo,proudmoore,1859,paladin,retribution,46,22,24
Mesmi,moon-guard,1858,paladin,retribution,142,77,65
Htmlar,tichondrius,1858,paladin,retribution,82,39,43
Ksvoten,azralon,1856,paladin,retribution,53,31,22
Xuanxingchai,tichondrius,1856,paladin,retribution,89,36,53
Saakero,illidan,1855,paladin,retribution,60,32,28
Retroreq,tichondrius,1854,paladin,retribution,166,88,78
Alecx,tichondrius,1853,paladin,retribution,58,33,25
Subtilizer,tichondrius,1851,paladin,retribution,48,32,16
Foofs,shadowmoon,1851,paladin,retribution,53,26,27
Apollidin,malganis,1851,paladin,retribution,141,66,75
Avenging,wyrmrest-accord,1850,paladin,retribution,68,33,35
Solanin,frostmourne,1849,paladin,retribution,35,20,15
Hurv,area-52,1849,paladin,retribution,59,33,26
Burnning,tichondrius,1849,paladin,retribution,57,30,27
Moocowd,senjin,1847,paladin,retribution,66,35,31
Miktley,area-52,1847,paladin,retribution,66,32,34
Iloveqiqi,sargeras,1846,paladin,retribution,54,26,28
Mervor,quelthalas,1846,paladin,retribution,66,31,35
Retxsilver,thrall,1845,paladin,retribution,136,69,67
Sacredknight,kelthuzad,1845,paladin,retribution,48,23,25
Seantate,stormrage,1844,paladin,retribution,51,31,20
Mixz,bleeding-hollow,1843,paladin,retribution,60,36,24
Nishru,sargeras,1843,paladin,retribution,60,32,28
Auxilio,arathor,1843,paladin,retribution,60,29,31
Divinehammer,proudmoore,1843,paladin,retribution,66,31,35
Lejeñd,stormrage,1842,paladin,retribution,65,34,31
Mürlin,illidan,1842,paladin,retribution,251,126,125
Eldenblade,moon-guard,1841,paladin,retribution,66,36,30
Asukaba,sargeras,1841,paladin,retribution,104,47,57
Ðiviñe,zuluhed,1840,paladin,retribution,186,97,89
Truthkeeper,moon-guard,1840,paladin,retribution,47,23,24
Chuckvandam,illidan,1839,paladin,retribution,54,36,18
Popje,zuljin,1839,paladin,retribution,36,20,16
Roguesmoker,zuljin,1839,paladin,retribution,59,31,28
Immobilized,frostmourne,1839,paladin,retribution,58,29,29
Mvpj,medivh,1839,paladin,retribution,48,23,25
Ilaaria,moon-guard,1838,paladin,retribution,66,44,22
Goret,tichondrius,1838,paladin,retribution,54,30,24
Galedance,tichondrius,1838,paladin,retribution,58,28,30
Zanur,tichondrius,1837,paladin,retribution,160,80,80
Kushsessions,zuljin,1837,paladin,retribution,42,20,22
Alodorx,tichondrius,1836,paladin,retribution,36,23,13
Vip,frostmourne,1836,paladin,retribution,108,55,53
Ahsilum,frostmourne,1836,paladin,retribution,78,36,42
Insanity,dethecus,1836,paladin,retribution,60,24,36
Paladincane,sargeras,1835,paladin,retribution,185,99,86
Kangsang,illidan,1835,paladin,retribution,70,33,37
Coldzito,ragnaros,1835,paladin,retribution,48,22,26
Candysugar,tichondrius,1834,paladin,retribution,48,32,16
Sweetfish,kiljaeden,1834,paladin,retribution,83,44,39
Christtel,stormrage,1834,paladin,retribution,78,40,38
Lolcraftv,tichondrius,1834,paladin,retribution,60,30,30
Dkdldkdld,tichondrius,1833,paladin,retribution,36,27,9
Lilglick,illidan,1833,paladin,retribution,36,21,15
Joeschmo,area-52,1833,paladin,retribution,54,31,23
Holyfused,illidan,1833,paladin,retribution,53,28,25
Masqadin,tichondrius,1832,paladin,retribution,36,26,10
Angelicwhim,stormrage,1832,paladin,retribution,54,29,25
Leonilx,tichondrius,1832,paladin,retribution,48,21,27
Savøx,sargeras,1831,paladin,retribution,219,120,99
Kaitúr,stormrage,1831,paladin,retribution,56,29,27
ßò,area-52,1830,paladin,retribution,46,31,15
Hge,proudmoore,1830,paladin,retribution,53,32,21
Chainsapally,stormrage,1828,paladin,retribution,54,38,16
Palabora,kelthuzad,1828,paladin,retribution,53,28,25
Therëv,zuljin,1828,paladin,retribution,113,55,58
Bornterrible,queldorei,1828,paladin,retribution,54,25,29
Idenline,moon-guard,1827,paladin,retribution,59,30,29
Blake,frostmourne,1827,paladin,retribution,53,24,29
Notae,icecrown,1826,paladin,retribution,48,26,22
Wolfs,firetree,1826,paladin,retribution,66,29,37
Alxndrr,area-52,1825,paladin,retribution,108,58,50
Lyrz,sargeras,1824,paladin,retribution,115,69,46
Buckey,kilrogg,1824,paladin,retribution,81,47,34
Monchmon,tichondrius,1824,paladin,retribution,47,24,23
Praysnblaze,zuljin,1824,paladin,retribution,55,28,27
Tzakial,area-52,1824,paladin,retribution,72,34,38
Zèrà,thunderhorn,1823,paladin,retribution,54,26,28
Pantufä,stormrage,1822,paladin,retribution,53,29,24
Jonathein,barthilas,1822,paladin,retribution,144,75,69
Saradomin,kelthuzad,1822,paladin,retribution,129,66,63
Fuchí,tichondrius,1822,paladin,retribution,242,118,124
Saakadin,illidan,1821,paladin,retribution,48,29,19
Olixx,blackrock,1821,paladin,retribution,54,30,24
Promethèus,jubeithos,1821,paladin,retribution,66,34,32
Kíngkáísér,azralon,1820,paladin,retribution,29,20,9
Malakor,thrall,1820,paladin,retribution,150,79,71
Kádabrak,tichondrius,1819,paladin,retribution,66,41,25
Draidan,area-52,1819,paladin,retribution,131,81,50
Blackcandle,tichondrius,1819,paladin,retribution,48,29,19
Yorøchi,azralon,1819,paladin,retribution,57,31,26
Backdrop,proudmoore,1819,paladin,retribution,169,91,78
Geöspäwn,tichondrius,1819,paladin,retribution,39,20,19
Anbivilent,moon-guard,1819,paladin,retribution,48,23,25
Cardynivans,tichondrius,1819,paladin,retribution,67,25,42
Warstompgg,ragnaros,1818,paladin,retribution,36,25,11
Johnmacclane,azralon,1818,paladin,retribution,215,115,100
Zett,jubeithos,1818,paladin,retribution,97,45,52
Dorex,moon-guard,1817,paladin,retribution,111,72,39
Dazargeros,moon-guard,1817,paladin,retribution,30,19,11
Nr,blood-furnace,1817,paladin,retribution,54,32,22
Comeuppance,wyrmrest-accord,1817,paladin,retribution,190,103,87
Puredecuy,ragnaros,1817,paladin,retribution,78,36,42
Evangelìne,darkspear,1816,paladin,retribution,48,32,16
Dwimberlike,ragnaros,1816,paladin,retribution,56,37,19
Chadsteroid,sargeras,1816,paladin,retribution,48,29,19
Xinqingle,tichondrius,1816,paladin,retribution,76,44,32
Dippedxd,tichondrius,1816,paladin,retribution,90,50,40
Kumdonia,illidan,1816,paladin,retribution,36,19,17
Valytonz,wyrmrest-accord,1816,paladin,retribution,90,41,49
Kooi,illidan,1816,paladin,retribution,78,35,43
Tyrillian,aerie-peak,1816,paladin,retribution,48,21,27
Kíngkáiser,azralon,1815,paladin,retribution,46,27,19
Theboxx,frostmourne,1815,paladin,retribution,51,23,28
Loisterly,bladefist,1814,paladin,retribution,128,70,58
Zulmay,malganis,1814,paladin,retribution,156,78,78
Gobblerr,blackrock,1814,paladin,retribution,66,32,34
Traize,kelthuzad,1813,paladin,retribution,48,30,18
Ìshen,illidan,1813,paladin,retribution,54,30,24
Popwings,azralon,1813,paladin,retribution,58,31,27
Wîckèd,tichondrius,1813,paladin,retribution,77,40,37
Dorktanian,stormrage,1813,paladin,retribution,78,40,38
Heatyr,malganis,1813,paladin,retribution,59,28,31
Lovy,area-52,1813,paladin,retribution,66,30,36
Pallysmack,stormrage,1812,paladin,retribution,48,28,20
Arquidea,tichondrius,1812,paladin,retribution,114,61,53
Guggle,lothar,1812,paladin,retribution,60,32,28
Ashkandi,tichondrius,1812,paladin,retribution,107,56,51
Gabbynator,emerald-dream,1812,paladin,retribution,59,28,31
Incubus,rexxar,1812,paladin,retribution,72,33,39
Stolzy,tichondrius,1812,paladin,retribution,86,39,47
Rethumtv,tichondrius,1812,paladin,retribution,72,30,42
Arkadiano,drakkari,1812,paladin,retribution,78,29,49
Triston,area-52,1810,paladin,retribution,120,66,54
Lilcyans,ragnaros,1810,paladin,retribution,66,34,32
Ienhova,area-52,1810,paladin,retribution,72,36,36
Primaryee,tichondrius,1810,paladin,retribution,121,53,68
Judgejudyx,sargeras,1809,paladin,retribution,43,28,15
Ladeon,proudmoore,1809,paladin,retribution,72,44,28
Elëssar,ragnaros,1809,paladin,retribution,221,117,104
Chuizz,frostmourne,1809,paladin,retribution,81,37,44
Beaconlol,proudmoore,1808,paladin,retribution,107,67,40
Fussyotter,stormreaver,1808,paladin,retribution,103,59,44
Lasteroy,nemesis,1808,paladin,retribution,159,89,70
Raxadin,stormrage,1808,paladin,retribution,60,30,30
Rédbarön,illidan,1808,paladin,retribution,72,32,40
Màli,akama,1808,paladin,retribution,52,20,32
Stêvêts,tichondrius,1807,paladin,retribution,36,20,16
Downways,sargeras,1807,paladin,retribution,73,39,34
Profundity,area-52,1807,paladin,retribution,70,37,33
Ratg,frostmourne,1807,paladin,retribution,46,24,22
Andelko,tichondrius,1807,paladin,retribution,46,23,23
Jhasøn,quelthalas,1806,paladin,retribution,60,40,20
Pornenjoyer,dalaran,1806,paladin,retribution,30,19,11
Darcobs,ragnaros,1806,paladin,retribution,184,96,88
Pambeazley,bronzebeard,1806,paladin,retribution,46,23,23
Mortaine,moon-guard,1806,paladin,retribution,204,101,103
Zeyrox,stormrage,1806,paladin,retribution,54,26,28
Pramethious,sargeras,1806,paladin,retribution,72,34,38
Erodan,moon-guard,1806,paladin,retribution,88,38,50
Annihilàtion,frostmourne,1805,paladin,retribution,42,30,12
Ipomaikai,dragonmaw,1805,paladin,retribution,30,19,11
Çestlavie,korgath,1805,paladin,retribution,90,51,39
Antlkd,quelthalas,1805,paladin,retribution,59,31,28
Actionb,aggramar,1805,paladin,retribution,145,76,69
Koketsu,ragnaros,1805,paladin,retribution,219,109,110
Huuzhaa,tichondrius,1805,paladin,retribution,92,44,48
Ironblade,zuljin,1804,paladin,retribution,54,29,25
Outkas,area-52,1804,paladin,retribution,54,28,26
Recliner,wyrmrest-accord,1804,paladin,retribution,54,28,26
Palli,moon-guard,1804,paladin,retribution,60,31,29
Lumbersnack,moon-guard,1804,paladin,retribution,75,36,39
Thantore,scilla,1804,paladin,retribution,76,34,42
Justicejosh,frostmourne,1803,paladin,retribution,42,25,17
Mabia,tichondrius,1803,paladin,retribution,78,40,38
Reypally,dalaran,1803,paladin,retribution,132,66,66
Lucy,sargeras,1803,paladin,retribution,84,38,46
Niubcjq,tichondrius,1803,paladin,retribution,42,19,23
Disappearing,stormrage,1802,paladin,retribution,48,31,17
Arkcadius,frostmourne,1802,paladin,retribution,96,52,44
Bigdogchief,stormrage,1802,paladin,retribution,48,26,22
Sâdê,bleeding-hollow,1802,paladin,retribution,36,19,17
Rashbringer,azgalor,1801,paladin,retribution,73,39,34
Trippën,tichondrius,1801,paladin,retribution,318,169,149
Tèhflip,tichondrius,1801,paladin,retribution,36,19,17
Gunderbok,emerald-dream,1801,paladin,retribution,63,33,30
Iloveyouxoxo,tichondrius,1800,paladin,retribution,54,29,25
Duhvine,malganis,1800,paladin,retribution,41,22,19
Sôck,zuljin,1800,paladin,retribution,44,22,22
Kalgormoth,ragnaros,1800,paladin,retribution,89,43,46
Ha,bleeding-hollow,1800,paladin,retribution,64,26,38
Määx,bleeding-hollow,1799,paladin,retribution,42,25,17
Josxth,stormrage,1797,paladin,retribution,60,33,27
Ulcerà,azralon,1797,paladin,retribution,61,28,33
Dúrnir,stormscale,1794,paladin,retribution,30,19,11
Strøngkiing,bleeding-hollow,1793,paladin,retribution,72,33,39
Coldzerox,ragnaros,1792,paladin,retribution,173,87,86
ßountystrike,sargeras,1792,paladin,retribution,90,42,48
Chadatron,tichondrius,1791,paladin,retribution,42,21,21
Bbtea,frostmourne,1790,paladin,retribution,66,29,37
Galess,tichondrius,1789,paladin,retribution,66,27,39
Waffletrain,tichondrius,1788,paladin,retribution,70,36,34
Cuteluna,tichondrius,1786,paladin,retribution,72,38,34
Youguessedit,stormrage,1785,paladin,retribution,30,19,11
Borntobebad,barthilas,1785,paladin,retribution,54,27,27
Rasler,stormrage,1784,paladin,retribution,216,110,106
Areuss,tichondrius,1783,paladin,retribution,41,22,19
Abegáil,area-52,1783,paladin,retribution,54,28,26
Giørther,ragnaros,1783,paladin,retribution,57,29,28
Retsaíyan,tichondrius,1783,paladin,retribution,66,31,35
Berryblast,shadowmoon,1782,paladin,retribution,54,36,18
Palajeans,stormrage,1782,paladin,retribution,51,32,19
Émiluss,stormrage,1781,paladin,retribution,72,35,37
Lunalunar,quelthalas,1781,paladin,retribution,65,30,35
Cagowhite,tichondrius,1781,paladin,retribution,67,29,38
Moød,ragnaros,1780,paladin,retribution,95,53,42
Whathehell,black-dragonflight,1780,paladin,retribution,228,115,113
Naverpay,tichondrius,1779,paladin,retribution,40,22,18
Dampenedxd,bleeding-hollow,1779,paladin,retribution,98,45,53
Robo,tichondrius,1778,paladin,retribution,30,19,11
Zakladchick,illidan,1778,paladin,retribution,48,26,22
Allohes,area-52,1778,paladin,retribution,47,25,22
Req,barthilas,1777,paladin,retribution,54,30,24
Poppmybubble,frostmourne,1776,paladin,retribution,53,32,21
Litium,frostmourne,1776,paladin,retribution,54,30,24
Apnea,ragnaros,1776,paladin,retribution,197,94,103
Hargol,stormrage,1776,paladin,retribution,102,47,55
Mardùk,stormrage,1775,paladin,retribution,45,30,15
Hallmark,kelthuzad,1775,paladin,retribution,60,28,32
Toughxguy,sargeras,1772,paladin,retribution,121,60,61
Honeydutchtv,black-dragonflight,1771,paladin,retribution,180,80,100
Thebless,tichondrius,1770,paladin,retribution,47,27,20
Filthyape,wyrmrest-accord,1769,paladin,retribution,118,73,45
Syleith,shadow-council,1768,paladin,retribution,115,54,61
Bisket,illidan,1767,paladin,retribution,77,41,36
Rahkinishu,khaz-modan,1766,paladin,retribution,189,109,80
Aegious,darkspear,1764,paladin,retribution,42,22,20
Lecheroø,tichondrius,1762,paladin,retribution,78,45,33
Dippedlol,tichondrius,1762,paladin,retribution,66,37,29
Secksorcism,frostwolf,1761,paladin,retribution,119,68,51
Nhsvikings,bleeding-hollow,1761,paladin,retribution,94,48,46
Younghova,kelthuzad,1759,paladin,retribution,96,43,53
Marvallous,area-52,1758,paladin,retribution,90,50,40
Fylerz,blackhand,1758,paladin,retribution,102,56,46
Britanybich,area-52,1757,paladin,retribution,72,36,36
Shawra,moon-guard,1756,paladin,retribution,30,20,10
Knuckifubuck,illidan,1756,paladin,retribution,36,22,14
Danaimei,tichondrius,1755,paladin,retribution,56,31,25
Teknik,stormscale,1755,paladin,retribution,186,92,94
Quinnzel,barthilas,1754,paladin,retribution,74,41,33
Nume,nesingwary,1753,paladin,retribution,94,42,52
Dogf,tichondrius,1753,paladin,retribution,71,28,43
Neonblade,illidan,1752,paladin,retribution,88,42,46
Adamantïum,azralon,1751,paladin,retribution,72,27,45
Dréveleth,quelthalas,1750,paladin,retribution,173,78,95
Traceless,emerald-dream,1749,paladin,retribution,122,72,50
Plniss,tichondrius,1749,paladin,retribution,66,34,32
Imcomingbro,blackrock,1749,paladin,retribution,74,35,39
Genovah,sargeras,1748,paladin,retribution,42,25,17
Siire,darkspear,1748,paladin,retribution,90,51,39
Rethir,illidan,1746,paladin,retribution,77,46,31
Palban,tichondrius,1746,paladin,retribution,89,50,39
Rugay,sargeras,1745,paladin,retribution,29,19,10
Aiethyria,tichondrius,1745,paladin,retribution,42,26,16
Titannious,stormrage,1745,paladin,retribution,125,63,62
Soverejgn,bleeding-hollow,1745,paladin,retribution,518,252,266
Pérona,tichondrius,1744,paladin,retribution,48,25,23
Ibullyourmom,tichondrius,1744,paladin,retribution,137,68,69
Thebubbajay,illidan,1743,paladin,retribution,54,31,23
Bakapal,tichondrius,1743,paladin,retribution,132,71,61
Bubblemark,tichondrius,1743,paladin,retribution,97,44,53
Htnhy,aegwynn,1743,paladin,retribution,60,24,36
Yérn,barthilas,1742,paladin,retribution,42,21,21
Lokâr,lightbringer,1742,paladin,retribution,76,36,40
Jameson,andorhal,1741,paladin,retribution,30,19,11
Chestbrah,nemesis,1741,paladin,retribution,72,36,36
Tofuupal,tichondrius,1739,paladin,retribution,102,49,53
Kíbá,malganis,1738,paladin,retribution,45,23,22
Obsolete,onyxia,1737,paladin,retribution,132,63,69
Cexus,tichondrius,1736,paladin,retribution,41,19,22
Nitemareforu,stormreaver,1735,paladin,retribution,90,54,36
Gellehar,barthilas,1735,paladin,retribution,36,19,17
Palimedic,sargeras,1734,paladin,retribution,114,55,59
Shuckles,windrunner,1733,paladin,retribution,56,28,28
Vanas,stormrage,1733,paladin,retribution,69,33,36
Raelan,icecrown,1731,paladin,retribution,95,65,30
Ítsyôúñötmé,tichondrius,1731,paladin,retribution,146,81,65
Semellem,bloodhoof,1731,paladin,retribution,84,42,42
Rektwings,area-52,1731,paladin,retribution,60,28,32
Allixis,wyrmrest-accord,1730,paladin,retribution,64,29,35
Orindel,tichondrius,1729,paladin,retribution,29,19,10
Jxke,barthilas,1729,paladin,retribution,47,23,24
Galeast,tichondrius,1729,paladin,retribution,66,28,38
Alduur,aggramar,1728,paladin,retribution,48,30,18
Diebygcd,tichondrius,1728,paladin,retribution,43,25,18
Xiddin,frostmourne,1728,paladin,retribution,66,33,33
Thrax,spirestone,1727,paladin,retribution,129,59,70
Cristø,stormrage,1727,paladin,retribution,72,30,42
Triginhall,moon-guard,1726,paladin,retribution,101,49,52
Cordelight,moon-guard,1725,paladin,retribution,51,38,13
Coleta,stormrage,1725,paladin,retribution,42,28,14
Nah,emerald-dream,1725,paladin,retribution,57,30,27
Honeybunza,area-52,1725,paladin,retribution,92,46,46
Riseandgrind,tichondrius,1723,paladin,retribution,36,18,18
Sconey,andorhal,1722,paladin,retribution,40,20,20
Mihawk,drenden,1721,paladin,retribution,30,21,9
Lirtheil,quelthalas,1721,paladin,retribution,42,25,17
Marvinceo,stormreaver,1721,paladin,retribution,36,18,18
Scarotv,malganis,1721,paladin,retribution,66,31,35
Omensageiro,azralon,1721,paladin,retribution,83,33,50
Arkantion,whisperwind,1720,paladin,retribution,59,37,22
Taeret,tichondrius,1720,paladin,retribution,30,18,12
Venxpeita,azralon,1719,paladin,retribution,36,26,10
Dreneisha,malganis,1719,paladin,retribution,53,28,25
Wantsome,frostmourne,1719,paladin,retribution,55,25,30
Bizaro,malganis,1719,paladin,retribution,54,21,33
Toguro,kelthuzad,1718,paladin,retribution,97,55,42
Mønaka,tichondrius,1717,paladin,retribution,66,39,27
Aora,kiljaeden,1717,paladin,retribution,72,30,42
Vanath,bleeding-hollow,1716,paladin,retribution,54,30,24
Bigdaddypuff,cenarius,1716,paladin,retribution,36,18,18
Éætûgýäëí,area-52,1716,paladin,retribution,42,18,24
Forthestreet,tichondrius,1714,paladin,retribution,100,56,44
Jereth,kelthuzad,1714,paladin,retribution,95,51,44
Djdiogø,azralon,1714,paladin,retribution,110,54,56
Dmghack,tichondrius,1714,paladin,retribution,54,24,30
Midheaven,moon-guard,1713,paladin,retribution,65,41,24
Pomboxd,stormrage,1713,paladin,retribution,95,50,45
Immensepower,tichondrius,1713,paladin,retribution,36,18,18
Lundor,ragnaros,1712,paladin,retribution,155,74,81
Sandokhán,ragnaros,1712,paladin,retribution,79,33,46
Mmbakes,shadowsong,1711,paladin,retribution,42,24,18
Powermonster,tichondrius,1711,paladin,retribution,59,28,31
Emaus,tichondrius,1711,paladin,retribution,72,28,44
Alanthor,ragnaros,1710,paladin,retribution,198,100,98
Lánná,tichondrius,1708,paladin,retribution,36,21,15
Svinadin,emerald-dream,1708,paladin,retribution,36,21,15
Luzoscura,quelthalas,1708,paladin,retribution,78,43,35
Handyandy,kelthuzad,1708,paladin,retribution,108,47,61
Watchamebaba,malganis,1708,paladin,retribution,54,21,33
Hôtt,kul-tiras,1707,paladin,retribution,37,19,18
Sathandrä,sargeras,1706,paladin,retribution,73,36,37
Happybubbles,tichondrius,1705,paladin,retribution,54,32,22
Áldin,ragnaros,1705,paladin,retribution,68,37,31
Mílkywayx,stormrage,1705,paladin,retribution,126,66,60
Pathalerix,eonar,1704,paladin,retribution,56,32,24
Oneaßoveall,azralon,1704,paladin,retribution,103,57,46
Glowbulled,area-52,1703,paladin,retribution,60,32,28
Helldevil,zuljin,1703,paladin,retribution,63,31,32
Zensargge,tichondrius,1703,paladin,retribution,108,46,62
Bakafish,tichondrius,1702,paladin,retribution,24,18,6
Nuggetpusher,thunderlord,1702,paladin,retribution,89,51,38
Insideous,kelthuzad,1702,paladin,retribution,98,53,45
Zoliz,tichondrius,1702,paladin,retribution,90,47,43
Talivar,kelthuzad,1701,paladin,retribution,168,93,75
Umbrasanctus,daggerspine,1700,paladin,retribution,108,60,48
Aldhebarán,ragnaros,1700,paladin,retribution,48,23,25
Griffïth,thrall,1699,paladin,retribution,36,21,15
Holywaffle,nemesis,1699,paladin,retribution,139,71,68
Oneshotman,stormrage,1699,paladin,retribution,51,26,25
Alequin,stormrage,1699,paladin,retribution,42,21,21
Lepirate,emerald-dream,1699,paladin,retribution,36,18,18
Shova,nemesis,1698,paladin,retribution,48,28,20
Davinshki,stormrage,1697,paladin,retribution,61,37,24
Daylin,tichondrius,1697,paladin,retribution,77,40,37
Voodoovon,tichondrius,1697,paladin,retribution,89,42,47
Izidar,tichondrius,1696,paladin,retribution,42,29,13
Ópsv,quelthalas,1696,paladin,retribution,173,97,76
Lightslion,stormrage,1696,paladin,retribution,48,25,23
Syreqt,nemesis,1696,paladin,retribution,60,29,31
Bizzaz,moon-guard,1696,paladin,retribution,78,33,45
Lidranas,sargeras,1695,paladin,retribution,63,38,25
Bigdaddysdic,illidan,1695,paladin,retribution,120,59,61
Pheonixpally,azralon,1695,paladin,retribution,114,50,64
Ledster,kelthuzad,1695,paladin,retribution,54,22,32
Axcvnz,draka,1694,paladin,retribution,42,23,19
Nadinebb,proudmoore,1694,paladin,retribution,54,23,31
Liadrives,area-52,1693,paladin,retribution,78,46,32
Dazn,tichondrius,1693,paladin,retribution,78,26,52
Keltar,burning-blade,1692,paladin,retribution,30,18,12
Justnikop,tichondrius,1692,paladin,retribution,115,56,59
Terabyte,nazjatar,1691,paladin,retribution,75,50,25
Bizarrap,quelthalas,1691,paladin,retribution,55,34,21
Frepz,illidan,1691,paladin,retribution,52,29,23
Dârkk,tichondrius,1691,paladin,retribution,36,20,16
Rikkupìgu,sargeras,1691,paladin,retribution,38,20,18
Mazaltoff,proudmoore,1691,paladin,retribution,111,57,54
Clownfister,barthilas,1690,paladin,retribution,54,29,25
Lalatinx,quelthalas,1689,paladin,retribution,126,64,62
Shádøwy,nemesis,1688,paladin,retribution,103,56,47
Noctisu,tichondrius,1687,paladin,retribution,48,18,30
Healmeboi,tichondrius,1686,paladin,retribution,74,39,35
Schmïtty,tichondrius,1686,paladin,retribution,54,28,26
Utherparty,frostmourne,1685,paladin,retribution,103,55,48
Oathen,proudmoore,1685,paladin,retribution,62,31,31
Roachpally,area-52,1684,paladin,retribution,30,19,11
Damnhammer,tichondrius,1684,paladin,retribution,48,30,18
Wing,frostwolf,1684,paladin,retribution,96,49,47
Thoreal,thrall,1684,paladin,retribution,90,45,45
Lillm,malganis,1683,paladin,retribution,96,49,47
Konesky,dalaran,1683,paladin,retribution,57,27,30
Nizzy,caelestrasz,1683,paladin,retribution,42,18,24
Heizero,area-52,1682,paladin,retribution,30,18,12
Hînøkåmí,tichondrius,1681,paladin,retribution,42,24,18
Dentarg,garrosh,1680,paladin,retribution,114,67,47
Hólyélf,illidan,1680,paladin,retribution,102,44,58
Bravepala,tichondrius,1680,paladin,retribution,54,20,34
Sasorï,stormrage,1679,paladin,retribution,90,41,49
Hamerfall,tichondrius,1678,paladin,retribution,66,31,35
Insîght,frostmourne,1678,paladin,retribution,70,27,43
Rendyrend,frostmourne,1677,paladin,retribution,36,18,18
Lilthroatbby,malganis,1677,paladin,retribution,126,53,73
Nërfme,illidan,1676,paladin,retribution,36,22,14
Shieldheart,moon-guard,1674,paladin,retribution,42,23,19
Lanach,lightbringer,1674,paladin,retribution,82,43,39
Orivia,spirestone,1674,paladin,retribution,66,33,33
Kuico,ragnaros,1674,paladin,retribution,48,24,24
Vapanor,ragnaros,1674,paladin,retribution,71,35,36
Paladinomg,darkspear,1673,paladin,retribution,166,94,72
Jelial,chogall,1673,paladin,retribution,69,35,34
Aredel,drakkari,1673,paladin,retribution,59,28,31
Moolishous,frostmourne,1672,paladin,retribution,89,48,41
Todesgott,tichondrius,1671,paladin,retribution,42,25,17
Sugnidrom,frostmourne,1671,paladin,retribution,70,36,34
Haiden,goldrinn,1671,paladin,retribution,69,31,38
Chriskriego,frostmourne,1671,paladin,retribution,60,24,36
Bubbledober,tichondrius,1670,paladin,retribution,30,20,10
Palejandro,illidan,1670,paladin,retribution,126,65,61
Damndoi,tichondrius,1669,paladin,retribution,66,39,27
Pumperjer,tichondrius,1669,paladin,retribution,53,26,27
Boarfarmer,tichondrius,1669,paladin,retribution,48,23,25
Daleroth,ragnaros,1668,paladin,retribution,51,29,22
Angrytitan,tichondrius,1668,paladin,retribution,72,36,36
Hupa,crushridge,1668,paladin,retribution,48,24,24
Ponytail,dark-iron,1668,paladin,retribution,74,36,38
Craq,alexstrasza,1668,paladin,retribution,140,68,72
Weike,barthilas,1668,paladin,retribution,130,60,70
Reckcowning,area-52,1667,paladin,retribution,54,23,31
Theseusz,tichondrius,1666,paladin,retribution,42,30,12
Sniper,uther,1666,paladin,retribution,54,29,25
Heavenlyfire,zuljin,1665,paladin,retribution,54,31,23
Bübbleqt,exodar,1664,paladin,retribution,30,18,12
Anjurus,moon-guard,1664,paladin,retribution,42,24,18
Perturabeau,bonechewer,1664,paladin,retribution,58,33,25
Garlond,moon-guard,1663,paladin,retribution,72,38,34
Goldnhart,wyrmrest-accord,1663,paladin,retribution,108,54,54
Stompëd,proudmoore,1663,paladin,retribution,62,29,33
Shakalot,illidan,1663,paladin,retribution,126,58,68
Aleríon,ragnaros,1662,paladin,retribution,187,97,90
Finaljustice,sargeras,1661,paladin,retribution,30,19,11
Jucker,tichondrius,1661,paladin,retribution,54,23,31
Xenk,moon-guard,1659,paladin,retribution,34,18,16
Crismj,tichondrius,1659,paladin,retribution,78,41,37
Selivara,zuljin,1659,paladin,retribution,42,20,22
Fatkidslag,sargeras,1659,paladin,retribution,42,19,23
Lawdeedawh,tichondrius,1659,paladin,retribution,42,19,23
Bigjiba,proudmoore,1658,paladin,retribution,48,25,23
Alyxandr,dalaran,1658,paladin,retribution,48,24,24
Redoubt,archimonde,1658,paladin,retribution,47,23,24
Elcíd,quelthalas,1658,paladin,retribution,147,67,80
Solånar,bloodscalp,1658,paladin,retribution,61,26,35
Remethea,sargeras,1657,paladin,retribution,233,116,117
Rengen,frostmourne,1657,paladin,retribution,78,37,41
Palmangels,bleeding-hollow,1657,paladin,retribution,56,23,33
Tuuro,stormrage,1656,paladin,retribution,304,149,155
Ssjlimit,tichondrius,1656,paladin,retribution,65,31,34
Slashnroses,tichondrius,1656,paladin,retribution,44,19,25
Deepsearide,illidan,1655,paladin,retribution,178,96,82
Alexese,area-52,1654,paladin,retribution,89,55,34
Derigoth,quelthalas,1654,paladin,retribution,78,39,39
Iggÿ,illidan,1654,paladin,retribution,70,30,40
Tiddijustice,garrosh,1653,paladin,retribution,60,36,24
Itzcupcake,illidan,1653,paladin,retribution,120,69,51
Hozna,andorhal,1652,paladin,retribution,61,36,25
Konsentrate,tichondrius,1652,paladin,retribution,162,82,80
Trixtur,tichondrius,1651,paladin,retribution,60,28,32
Sonatas,ursin,1650,paladin,retribution,45,25,20
Chetmorton,emerald-dream,1650,paladin,retribution,42,18,24
Sabotsaint,tichondrius,1649,paladin,retribution,72,29,43
Likzebawlz,tichondrius,1648,paladin,retribution,42,25,17
Plusultra,moon-guard,1648,paladin,retribution,84,48,36
Ylilliana,illidan,1648,paladin,retribution,49,22,27
Alacrity,shadowsong,1647,paladin,retribution,75,42,33
Chrisader,stormrage,1647,paladin,retribution,42,22,20
Divínos,area-52,1647,paladin,retribution,66,34,32
Claudleon,drakkari,1647,paladin,retribution,41,21,20
Holychow,tichondrius,1646,paladin,retribution,66,36,30
Nasnyl,stormrage,1646,paladin,retribution,42,20,22
Xerobite,quelthalas,1646,paladin,retribution,70,32,38
Parkwons,tichondrius,1646,paladin,retribution,66,26,40
Akâme,kelthuzad,1645,paladin,retribution,28,19,9
Holdup,moon-guard,1645,paladin,retribution,83,54,29
Amgirlinv,malganis,1645,paladin,retribution,38,23,15
Bigolcriddys,barthilas,1645,paladin,retribution,36,21,15
Truesound,malganis,1645,paladin,retribution,36,21,15
Leona,stormrage,1645,paladin,retribution,52,29,23
Geedee,ysera,1645,paladin,retribution,70,39,31
Rxes,frostmourne,1645,paladin,retribution,123,58,65
Thomãs,moon-guard,1645,paladin,retribution,41,19,22
Gwff,tichondrius,1645,paladin,retribution,41,18,23
Eneraxx,proudmoore,1645,paladin,retribution,48,20,28
Vernon,ragnaros,1645,paladin,retribution,48,19,29
Yusha,barthilas,1644,paladin,retribution,47,32,15
Dazedpal,tichondrius,1644,paladin,retribution,369,194,175
Därth,azralon,1644,paladin,retribution,46,20,26
Palabeshar,area-52,1644,paladin,retribution,48,18,30
Smïthh,area-52,1643,paladin,retribution,42,24,18
Rexx,frostmourne,1643,paladin,retribution,66,36,30
Yezzyll,korgath,1643,paladin,retribution,36,19,17
Blackpie,bleeding-hollow,1643,paladin,retribution,48,23,25
Takinvcards,area-52,1643,paladin,retribution,48,23,25
Pickleret,emerald-dream,1643,paladin,retribution,120,55,65
Beardedbrute,korgath,1643,paladin,retribution,48,22,26
Jackstank,dragonmaw,1642,paladin,retribution,53,33,20
Seraphini,illidan,1642,paladin,retribution,65,34,31
Scrubble,thrall,1642,paladin,retribution,102,50,52
Furdaddylant,drenden,1641,paladin,retribution,30,18,12
Sozmsjackson,barthilas,1641,paladin,retribution,69,40,29
Practícal,moon-guard,1641,paladin,retribution,90,45,45
Demonissh,area-52,1641,paladin,retribution,57,24,33
Arturias,kiljaeden,1640,paladin,retribution,142,76,66
Lleo,nemesis,1640,paladin,retribution,118,54,64
Utherpendrag,bladefist,1640,paladin,retribution,90,39,51
Cøøkïë,frostmourne,1639,paladin,retribution,48,27,21
Radacos,emerald-dream,1639,paladin,retribution,166,84,82
Kurasi,frostmourne,1639,paladin,retribution,69,30,39
Auralyon,tichondrius,1639,paladin,retribution,54,22,32
Notneo,zuljin,1638,paladin,retribution,59,34,25
Weskar,garithos,1638,paladin,retribution,142,81,61
Beefjustice,velen,1638,paladin,retribution,79,43,36
Hellfound,bleeding-hollow,1638,paladin,retribution,47,24,23
Redarted,thrall,1638,paladin,retribution,38,19,19
Ceyh,ragnaros,1638,paladin,retribution,53,25,28
Redemptiøn,nemesis,1638,paladin,retribution,90,41,49
Benoít,zuljin,1637,paladin,retribution,90,51,39
Brightstar,azjolnerub,1637,paladin,retribution,71,39,32
Dimdabbin,malganis,1637,paladin,retribution,42,22,20
Saccro,area-52,1637,paladin,retribution,114,57,57
Amanzhul,quelthalas,1637,paladin,retribution,121,58,63
Luke,frostwolf,1637,paladin,retribution,47,19,28
Holyroro,area-52,1636,paladin,retribution,50,29,21
Kozk,quelthalas,1636,paladin,retribution,234,130,104
Ibustcheeks,sargeras,1636,paladin,retribution,77,40,37
Battlepope,thrall,1636,paladin,retribution,83,40,43
Jud,frostmourne,1636,paladin,retribution,90,43,47
Souldrainlol,quelthalas,1635,paladin,retribution,66,39,27
Gimlias,kelthuzad,1635,paladin,retribution,54,25,29
Marcêl,quelthalas,1634,paladin,retribution,48,29,19
Giulio,moon-guard,1634,paladin,retribution,172,98,74
Liaadrin,azralon,1634,paladin,retribution,38,20,18
Nattandin,ragnaros,1634,paladin,retribution,42,22,20
Lightowen,draka,1634,paladin,retribution,46,22,24
Cyanss,ragnaros,1634,paladin,retribution,47,19,28
Procs,hyjal,1633,paladin,retribution,78,55,23
Beardy,emerald-dream,1633,paladin,retribution,60,36,24
Daddytoad,tichondrius,1633,paladin,retribution,78,38,40
Elegan,frostmourne,1633,paladin,retribution,72,33,39
Shiadfang,tichondrius,1632,paladin,retribution,87,47,40
Ajulgedang,frostmourne,1632,paladin,retribution,120,57,63
Xeldar,tichondrius,1631,paladin,retribution,102,50,52
Zayblade,dragonblight,1630,paladin,retribution,40,23,17
Neovincent,aggramar,1630,paladin,retribution,93,52,41
Whosyadaddy,tichondrius,1630,paladin,retribution,202,99,103
Ascetic,barthilas,1630,paladin,retribution,241,111,130
Fistâcuffs,stormrage,1630,paladin,retribution,54,22,32
Ulrah,moon-guard,1629,paladin,retribution,120,68,52
Hammrekt,dalaran,1628,paladin,retribution,24,17,7
Âllmíght,quelthalas,1628,paladin,retribution,36,20,16
Intense,moonrunner,1628,paladin,retribution,40,20,20
Mikkylol,tichondrius,1628,paladin,retribution,40,18,22
Làzårus,area-52,1627,paladin,retribution,56,30,26
Masqadin,stormrage,1627,paladin,retribution,36,17,19
Zazaron,kiljaeden,1627,paladin,retribution,54,24,30
Ziberax,chogall,1626,paladin,retribution,64,40,24
Palieop,aerie-peak,1626,paladin,retribution,40,22,18
Gareesa,wyrmrest-accord,1626,paladin,retribution,78,39,39
Gatzu,tichondrius,1626,paladin,retribution,54,24,30
Fluffnac,tichondrius,1625,paladin,retribution,30,17,13
Notbärry,area-52,1625,paladin,retribution,48,27,21
Tatánka,ragnaros,1625,paladin,retribution,54,29,25
Ödin,scarlet-crusade,1625,paladin,retribution,60,32,28
Renckay,ragnaros,1625,paladin,retribution,99,52,47
Chajaaro,ragnaros,1625,paladin,retribution,67,33,34
Goons,frostmourne,1625,paladin,retribution,54,21,33
Cillessá,kelthuzad,1624,paladin,retribution,160,84,76
Torvus,bonechewer,1624,paladin,retribution,46,20,26
Techno,tichondrius,1623,paladin,retribution,175,89,86
Joeyrat,area-52,1623,paladin,retribution,42,20,22
Holyflopper,malganis,1623,paladin,retribution,48,21,27
Retrodino,anvilmar,1623,paladin,retribution,48,21,27
Alianór,tichondrius,1623,paladin,retribution,47,19,28
Cyrenity,tichondrius,1623,paladin,retribution,59,19,40
Litler,tichondrius,1622,paladin,retribution,44,30,14
Munaru,illidan,1621,paladin,retribution,36,22,14
Purejudgemnt,area-52,1621,paladin,retribution,60,36,24
Pandoro,tichondrius,1621,paladin,retribution,55,33,22
Bigboiszn,area-52,1621,paladin,retribution,30,17,13
Hazexd,illidan,1621,paladin,retribution,36,20,16
Dashhighborn,sargeras,1621,paladin,retribution,71,38,33
Faladrim,moon-guard,1621,paladin,retribution,190,99,91
Tævèn,tichondrius,1621,paladin,retribution,36,17,19
Michaelsmith,frostmourne,1621,paladin,retribution,36,17,19
Lêggy,moon-guard,1621,paladin,retribution,54,23,31
Auranove,azralon,1621,paladin,retribution,42,17,25
Rùckûs,tichondrius,1621,paladin,retribution,47,19,28
Rukkas,sargeras,1621,paladin,retribution,54,21,33
Thenextx,illidan,1621,paladin,retribution,78,28,50
Nqe,area-52,1620,paladin,retribution,106,57,49
Wutefuh,azgalor,1619,paladin,retribution,60,33,27
Merculios,stormrage,1619,paladin,retribution,63,34,29
Tronzyy,trollbane,1619,paladin,retribution,65,29,36
Zcho,proudmoore,1618,paladin,retribution,69,33,36
Glørious,drakkari,1618,paladin,retribution,90,42,48
Sunnix,illidan,1618,paladin,retribution,48,17,31
Holyrump,bleeding-hollow,1617,paladin,retribution,45,28,17
Holiness,stormreaver,1617,paladin,retribution,48,18,30
Bubbleblast,elune,1616,paladin,retribution,36,17,19
Milizi,zuljin,1616,paladin,retribution,96,44,52
Holycots,stormrage,1616,paladin,retribution,46,19,27
Axeliee,kiljaeden,1616,paladin,retribution,54,22,32
Jackedx,sargeras,1615,paladin,retribution,36,21,15
Inquisition,moon-guard,1615,paladin,retribution,30,17,13
Sinmca,moon-guard,1615,paladin,retribution,92,51,41
Feelsögood,tichondrius,1615,paladin,retribution,45,24,21
Swiftskillz,bleeding-hollow,1615,paladin,retribution,171,91,80
Drholypurp,tichondrius,1615,paladin,retribution,59,31,28
Øðyn,sargeras,1615,paladin,retribution,59,30,29
Reesescupz,kelthuzad,1615,paladin,retribution,134,64,70
Outstrike,tichondrius,1615,paladin,retribution,36,17,19
Daweeki,area-52,1614,paladin,retribution,24,19,5
Traditionalp,area-52,1614,paladin,retribution,49,30,19
Elizzabeth,skullcrusher,1614,paladin,retribution,42,23,19
Qunima,tichondrius,1614,paladin,retribution,36,17,19
Stax,moon-guard,1614,paladin,retribution,42,17,25
Oldsixqs,illidan,1613,paladin,retribution,50,29,21
Xalø,ragnaros,1613,paladin,retribution,30,17,13
Bramot,moon-guard,1613,paladin,retribution,36,20,16
Xbloodknight,malganis,1613,paladin,retribution,50,27,23
Gattís,stormrage,1613,paladin,retribution,79,42,37
Jessheim,emerald-dream,1613,paladin,retribution,42,18,24
Milkmemamma,nordrassil,1612,paladin,retribution,48,27,21
Telarøn,stormrage,1612,paladin,retribution,200,101,99
Hristian,tichondrius,1612,paladin,retribution,60,30,30
Kaithen,quelthalas,1612,paladin,retribution,248,123,125
Poisson,wildhammer,1612,paladin,retribution,60,27,33
Jvbai,area-52,1612,paladin,retribution,87,39,48
Jerichô,destromath,1612,paladin,retribution,42,17,25
Mcholy,thrall,1611,paladin,retribution,79,45,34
Kevybevy,stormrage,1611,paladin,retribution,150,81,69
Aoishie,bleeding-hollow,1611,paladin,retribution,126,66,60
Shirael,ragnaros,1611,paladin,retribution,126,60,66
Noholy,nemesis,1611,paladin,retribution,73,32,41
Mordirhar,tichondrius,1611,paladin,retribution,90,39,51
Rahmie,kiljaeden,1611,paladin,retribution,96,41,55
Oneblood,moonrunner,1610,paladin,retribution,24,17,7
Cålamìty,dalaran,1610,paladin,retribution,42,27,15
Limitier,proudmoore,1610,paladin,retribution,60,36,24
Kadabrak,area-52,1610,paladin,retribution,36,17,19
Atair,antonidas,1609,paladin,retribution,36,21,15
Allîe,malganis,1609,paladin,retribution,73,37,36
Regivan,nemesis,1609,paladin,retribution,54,21,33
Ragnore,shadow-council,1608,paladin,retribution,57,32,25
Smallhammer,aegwynn,1608,paladin,retribution,162,81,81
Sololeveling,malganis,1608,paladin,retribution,98,48,50
Golden,tichondrius,1608,paladin,retribution,42,20,22
Aiseyqt,frostmourne,1607,paladin,retribution,132,80,52
Humbubble,cairne,1607,paladin,retribution,41,22,19
Jianwen,kargath,1607,paladin,retribution,36,17,19
Trolladin,rivendare,1607,paladin,retribution,110,51,59
Wde,zuljin,1607,paladin,retribution,43,18,25
Marehk,thrall,1606,paladin,retribution,59,32,27
Abigaile,ragnaros,1606,paladin,retribution,72,38,34
Skilladin,zuljin,1606,paladin,retribution,77,40,37
Sneeber,stormrage,1606,paladin,retribution,90,46,44
Southerly,tichondrius,1606,paladin,retribution,78,39,39
Aefuezar,earthen-ring,1606,paladin,retribution,56,28,28
Fây,sargeras,1606,paladin,retribution,87,40,47
Lit,alexstrasza,1606,paladin,retribution,52,22,30
Pçpaladin,stormrage,1605,paladin,retribution,36,21,15
Uoenò,moon-guard,1605,paladin,retribution,41,23,18
Tobaz,azralon,1605,paladin,retribution,103,56,47
Zarrakra,daggerspine,1605,paladin,retribution,99,52,47
Dïlly,area-52,1605,paladin,retribution,90,46,44
Fuknshané,area-52,1605,paladin,retribution,74,36,38
Ragarèn,emerald-dream,1605,paladin,retribution,42,20,22
Cuchuflaiz,drakkari,1604,paladin,retribution,30,17,13
Virtuosi,area-52,1604,paladin,retribution,42,23,19
Joltie,quelthalas,1604,paladin,retribution,220,119,101
Xeniél,illidan,1604,paladin,retribution,36,19,17
Rycerzforge,ragnaros,1604,paladin,retribution,74,38,36
Trullz,illidan,1604,paladin,retribution,94,44,50
Zero,garona,1604,paladin,retribution,134,62,72
Paim,tol-barad,1604,paladin,retribution,50,21,29
Tearet,tichondrius,1603,paladin,retribution,30,19,11
Akemih,ragnaros,1603,paladin,retribution,30,17,13
Tanishalfelf,stormrage,1603,paladin,retribution,36,18,18
Ÿøzsh,azralon,1603,paladin,retribution,66,30,36
Skylinator,bleeding-hollow,1603,paladin,retribution,59,26,33
Æpaldin,tichondrius,1603,paladin,retribution,48,20,28
Tæven,tichondrius,1602,paladin,retribution,42,19,23
Dartpuncher,frostmourne,1601,paladin,retribution,57,34,23
Miguepally,ragnaros,1601,paladin,retribution,99,52,47
Beshiki,hakkar,1601,paladin,retribution,358,180,178
Aeterias,dalaran,1601,paladin,retribution,208,104,104
Jowliet,stormrage,1601,paladin,retribution,36,17,19
Tonimâster,misha,1601,paladin,retribution,47,21,26
Anafensa,malganis,1601,paladin,retribution,90,40,50
Pallydestroy,stormrage,1601,paladin,retribution,48,17,31
Capedcrusade,area-52,1600,paladin,retribution,42,27,15
Aethelwulf,stormrage,1600,paladin,retribution,42,24,18
Varekaì,frostmourne,1600,paladin,retribution,153,80,73
Inmortall,illidan,1599,paladin,retribution,90,47,43
Mcbroken,tichondrius,1599,paladin,retribution,45,22,23
Pockopea,arygos,1598,paladin,retribution,100,60,40
Connore,stormrage,1598,paladin,retribution,65,36,29
Zhaslk,ragnaros,1598,paladin,retribution,42,18,24
Thaldun,wyrmrest-accord,1597,paladin,retribution,107,49,58
Kymmy,ragnaros,1597,paladin,retribution,54,21,33
Imnoracist,thrall,1597,paladin,retribution,72,24,48
Blitzzed,area-52,1596,paladin,retribution,44,24,20
Maverickxz,nemesis,1596,paladin,retribution,35,17,18
Duffnroses,tichondrius,1596,paladin,retribution,66,28,38
Løøsè,frostmourne,1595,paladin,retribution,36,20,16
Tyirr,kelthuzad,1595,paladin,retribution,138,65,73
Ellyee,jaedenar,1595,paladin,retribution,111,51,60
Markcrisman,quelthalas,1595,paladin,retribution,71,31,40
Esçanór,darkspear,1594,paladin,retribution,79,40,39
Layonhánd,ragnaros,1593,paladin,retribution,54,25,29
Serås,silvermoon,1590,paladin,retribution,78,47,31
Torinel,illidan,1590,paladin,retribution,35,17,18
Barcar,area-52,1589,paladin,retribution,39,21,18
Rhodela,illidan,1589,paladin,retribution,107,57,50
Istril,ragnaros,1589,paladin,retribution,304,161,143
Unsignedint,hyjal,1588,paladin,retribution,59,34,25
Tìg,proudmoore,1588,paladin,retribution,167,93,74
Xytoken,tichondrius,1588,paladin,retribution,113,59,54
Spruk,greymane,1588,paladin,retribution,65,33,32
Fakesimp,illidan,1587,paladin,retribution,24,17,7
Cowsecration,ragnaros,1587,paladin,retribution,36,22,14
Royalfather,tichondrius,1587,paladin,retribution,52,31,21
Mfgspally,kelthuzad,1587,paladin,retribution,91,52,39
Hedilyan,azralon,1587,paladin,retribution,102,51,51
Lucianz,ragnaros,1587,paladin,retribution,66,32,34
Tarnyb,illidan,1587,paladin,retribution,56,27,29
Ilovecl,tichondrius,1586,paladin,retribution,54,32,22
Lawmower,sargeras,1586,paladin,retribution,66,37,29
Whyta,azralon,1586,paladin,retribution,205,105,100
Zadquel,ragnaros,1585,paladin,retribution,118,66,52
Hakson,stormrage,1585,paladin,retribution,79,43,36
Drízzy,ragnaros,1585,paladin,retribution,64,31,33
Darguen,ragnaros,1584,paladin,retribution,46,25,21
Sevik,garithos,1584,paladin,retribution,84,42,42
Ënfos,azralon,1584,paladin,retribution,42,20,22
Shïnjïtsu,tichondrius,1583,paladin,retribution,24,17,7
Rhegyna,quelthalas,1583,paladin,retribution,72,38,34
Fótm,bleeding-hollow,1583,paladin,retribution,84,42,42
Lightlana,frostwolf,1583,paladin,retribution,68,34,34
Arlanso,frostmourne,1583,paladin,retribution,46,22,24
Bubblelol,bloodhoof,1583,paladin,retribution,110,49,61
Ájummalukout,tichondrius,1583,paladin,retribution,69,29,40
Stöneblood,moon-guard,1583,paladin,retribution,54,18,36
Wasembroder,ragnaros,1582,paladin,retribution,121,65,56
Beeftink,tichondrius,1582,paladin,retribution,112,56,56
Dallyon,stormrage,1582,paladin,retribution,42,21,21
Landeren,khazgoroth,1580,paladin,retribution,72,34,38
Miniell,tichondrius,1580,paladin,retribution,36,17,19
Sventyn,frostmourne,1580,paladin,retribution,47,17,30
Maphisto,stormscale,1579,paladin,retribution,90,62,28
Borrus,malygos,1579,paladin,retribution,78,40,38
Holyjoint,uther,1579,paladin,retribution,104,46,58
Arahann,bleeding-hollow,1578,paladin,retribution,35,21,14
Detrimentãl,nagrand,1578,paladin,retribution,75,37,38
Perzeføne,quelthalas,1577,paladin,retribution,65,37,28
Rimjobrachel,barthilas,1577,paladin,retribution,86,42,44
Pirofosfato,azralon,1577,paladin,retribution,46,21,25
Hurtmypp,stormrage,1576,paladin,retribution,54,33,21
Malacriianza,quelthalas,1576,paladin,retribution,54,30,24
Leztatium,quelthalas,1576,paladin,retribution,42,21,21
Amialra,moon-guard,1576,paladin,retribution,55,27,28
Illustrata,illidan,1575,paladin,retribution,30,18,12
Yawnbringer,tichondrius,1575,paladin,retribution,158,83,75
Renzo,frostmourne,1575,paladin,retribution,93,43,50
Landryy,icecrown,1574,paladin,retribution,30,17,13
Ruhn,eldrethalas,1574,paladin,retribution,36,18,18
Tesak,emerald-dream,1573,paladin,retribution,114,58,56
Ratburger,blood-furnace,1572,paladin,retribution,59,34,25
Sacredstella,illidan,1572,paladin,retribution,171,89,82
Snussp,emerald-dream,1572,paladin,retribution,99,51,48
Plophero,moon-guard,1572,paladin,retribution,60,30,30
Stackmymoney,kelthuzad,1572,paladin,retribution,50,22,28
Chancellor,azralon,1571,paladin,retribution,282,150,132
Tatakaicjq,tichondrius,1571,paladin,retribution,129,66,63
Lorienv,sargeras,1571,paladin,retribution,42,21,21
Tagex,malganis,1571,paladin,retribution,198,96,102
Mormdring,fizzcrank,1571,paladin,retribution,77,35,42
Spala,tichondrius,1571,paladin,retribution,75,32,43
Kdym,azralon,1570,paladin,retribution,30,19,11
ßabyshark,tichondrius,1570,paladin,retribution,60,26,34
Kamí,elune,1570,paladin,retribution,51,19,32
Dgâza,tichondrius,1569,paladin,retribution,60,30,30
Tenacer,darkspear,1569,paladin,retribution,105,51,54
Bøble,thrall,1569,paladin,retribution,48,19,29
Guerrer,hyjal,1568,paladin,retribution,72,39,33
Unfairness,skullcrusher,1568,paladin,retribution,69,37,32
Coffeepal,tichondrius,1567,paladin,retribution,48,23,25
Moistbible,kelthuzad,1567,paladin,retribution,42,19,23
Hahe,tichondrius,1567,paladin,retribution,48,19,29
Pinkies,frostmourne,1566,paladin,retribution,120,63,57
Luxord,ysera,1566,paladin,retribution,40,21,19
Chiphazard,stormscale,1566,paladin,retribution,58,23,35
Howlerhead,illidan,1565,paladin,retribution,36,19,17
Nilin,tichondrius,1565,paladin,retribution,60,31,29
Andrilsteh,malganis,1565,paladin,retribution,108,48,60
Impkpal,tichondrius,1565,paladin,retribution,48,20,28
Ulrìck,quelthalas,1564,paladin,retribution,77,44,33
Naxadin,tichondrius,1564,paladin,retribution,30,17,13
Fionno,quelthalas,1564,paladin,retribution,116,58,58
Bogùs,tichondrius,1564,paladin,retribution,54,26,28
Paradisso,tichondrius,1564,paladin,retribution,42,19,23
Tantradin,area-52,1564,paladin,retribution,48,20,28
Tribiani,lightbringer,1563,paladin,retribution,30,17,13
Freddieroach,tichondrius,1563,paladin,retribution,78,37,41
Samgonz,tichondrius,1562,paladin,retribution,78,43,35
Kawkpaladin,kaelthas,1561,paladin,retribution,66,36,30
Cobaine,illidan,1561,paladin,retribution,137,67,70
Õblivion,jubeithos,1561,paladin,retribution,70,33,37
Alpengeist,turalyon,1560,paladin,retribution,69,34,35
Baeflux,kelthuzad,1560,paladin,retribution,48,19,29
Balín,quelthalas,1559,paladin,retribution,31,22,9
Atterz,azralon,1559,paladin,retribution,52,25,27
Mixnut,tichondrius,1559,paladin,retribution,83,36,47
Rethöe,tichondrius,1558,paladin,retribution,36,19,17
Snoogans,korgath,1558,paladin,retribution,42,19,23
Lawbandit,tichondrius,1557,paladin,retribution,34,19,15
Chewyjitsu,tichondrius,1557,paladin,retribution,36,20,16
Razneroka,ragnaros,1557,paladin,retribution,51,27,24
Ironcoco,ragnaros,1557,paladin,retribution,53,27,26
Luret,tichondrius,1557,paladin,retribution,34,17,17
Worder,tichondrius,1556,paladin,retribution,41,29,12
Vallahad,emerald-dream,1556,paladin,retribution,54,32,22
Vêgenace,proudmoore,1556,paladin,retribution,48,24,24
Missusomutch,azralon,1556,paladin,retribution,50,17,33
Fressbee,nathrezim,1555,paladin,retribution,59,30,29
Aaralis,ragnaros,1555,paladin,retribution,42,18,24
Grifnshlong,agamaggan,1554,paladin,retribution,33,19,14
Velyssatha,moon-guard,1553,paladin,retribution,88,46,42
Crybátt,quelthalas,1553,paladin,retribution,68,35,33
Lumaros,wyrmrest-accord,1553,paladin,retribution,72,37,35
Luminiscente,ragnaros,1553,paladin,retribution,58,29,29
Skynn,stormrage,1553,paladin,retribution,36,18,18
Alexieus,wyrmrest-accord,1553,paladin,retribution,71,32,39
Kissherlin,tichondrius,1552,paladin,retribution,36,21,15
Halrix,stormrage,1552,paladin,retribution,101,53,48
Thastrian,stormreaver,1552,paladin,retribution,60,31,29
Yree,ragnaros,1552,paladin,retribution,78,37,41
Notoriouus,bleeding-hollow,1552,paladin,retribution,42,18,24
Sammyste,elune,1551,paladin,retribution,145,78,67
Grãnd,tortheldrin,1551,paladin,retribution,47,22,25
Albïreo,drakkari,1550,paladin,retribution,54,28,26
Bubbleosevn,dragonmaw,1549,paladin,retribution,43,24,19
Feannor,drakkari,1549,paladin,retribution,76,37,39
Palaxoto,nemesis,1549,paladin,retribution,84,35,49
Nidalee,kilrogg,1549,paladin,retribution,60,25,35
Caribourider,tichondrius,1548,paladin,retribution,65,29,36
Lagwat,sargeras,1545,paladin,retribution,60,37,23
Pocserpala,drakkari,1545,paladin,retribution,48,27,21
Ezcoatl,stormrage,1545,paladin,retribution,100,52,48
Bubblless,thrall,1545,paladin,retribution,65,33,32
Varlip,wyrmrest-accord,1545,paladin,retribution,53,18,35
Oppressive,moon-guard,1544,paladin,retribution,434,211,223
Soterios,daggerspine,1544,paladin,retribution,78,37,41
Valardaharis,thunderlord,1544,paladin,retribution,124,58,66
Mjman,tichondrius,1542,paladin,retribution,34,18,16
Margit,moon-guard,1541,paladin,retribution,36,22,14
Björñ,moon-guard,1541,paladin,retribution,52,29,23
Ðoflamingo,area-52,1540,paladin,retribution,72,38,34
Quadrifoglio,moon-guard,1540,paladin,retribution,138,70,68
Misbah,stormrage,1540,paladin,retribution,62,31,31
Lygophobia,frostmourne,1539,paladin,retribution,42,22,20
Brokeniron,wyrmrest-accord,1539,paladin,retribution,66,31,35
Excalibur,amanthul,1539,paladin,retribution,43,19,24
Souyiro,sargeras,1539,paladin,retribution,74,28,46
Frùglé,sargeras,1538,paladin,retribution,36,20,16
Celethor,wyrmrest-accord,1537,paladin,retribution,54,30,24
Akabanee,ragnaros,1537,paladin,retribution,53,29,24
Thepinkdept,proudmoore,1537,paladin,retribution,38,20,18
Aberpal,illidan,1535,paladin,retribution,41,23,18
Shampin,alexstrasza,1535,paladin,retribution,78,38,40
Greciâ,ragnaros,1535,paladin,retribution,42,18,24
Hammrekt,sargeras,1534,paladin,retribution,24,16,8
Álkair,ragnaros,1534,paladin,retribution,83,36,47
Stônemôuntan,moon-guard,1534,paladin,retribution,84,29,55
Jager,medivh,1533,paladin,retribution,71,41,30
Cókelol,zuljin,1533,paladin,retribution,84,46,38
Minidin,kiljaeden,1533,paladin,retribution,126,58,68
Yukíteru,illidan,1533,paladin,retribution,111,50,61
Retcuzyaknow,illidan,1533,paladin,retribution,36,16,20
Kattkaffe,tichondrius,1531,paladin,retribution,30,16,14
Yiqieyouwei,proudmoore,1531,paladin,retribution,55,25,30
Loyality,sargeras,1530,paladin,retribution,36,16,20
Schankyy,stormrage,1529,paladin,retribution,36,19,17
Erós,azralon,1529,paladin,retribution,34,17,17
Ástridr,moon-guard,1528,paladin,retribution,95,43,52
Prettycure,illidan,1528,paladin,retribution,36,16,20
Bladetm,proudmoore,1527,paladin,retribution,154,77,77
Ezpzxd,arygos,1527,paladin,retribution,116,58,58
Sigmond,azralon,1527,paladin,retribution,69,29,40
Hefaista,ragnaros,1527,paladin,retribution,42,16,26
Muffinknight,quelthalas,1526,paladin,retribution,66,44,22
Ðivinestørm,stormrage,1526,paladin,retribution,37,18,19
Kenpachí,doomhammer,1525,paladin,retribution,42,30,12
Swiftyflower,dawnbringer,1525,paladin,retribution,24,16,8
Burstpink,zuljin,1524,paladin,retribution,46,29,17
Tinymeatgang,misha,1524,paladin,retribution,36,19,17
Holybirkkal,arthas,1524,paladin,retribution,56,29,27
Shaidd,bleeding-hollow,1524,paladin,retribution,98,49,49
Flykzu,azralon,1524,paladin,retribution,166,76,90
Jizii,tichondrius,1523,paladin,retribution,78,44,34
Bastiion,stormrage,1523,paladin,retribution,106,50,56
Xandia,aegwynn,1523,paladin,retribution,48,16,32
Holyshockss,stormrage,1522,paladin,retribution,30,16,14
Lestaroth,goldrinn,1522,paladin,retribution,60,22,38
Pvrisxx,frostmourne,1521,paladin,retribution,60,31,29
Whackadin,illidan,1521,paladin,retribution,67,32,35
Blasstar,quelthalas,1521,paladin,retribution,65,31,34
Whitearmor,draenor,1520,paladin,retribution,69,41,28
Davincintel,tichondrius,1520,paladin,retribution,48,27,21
Zalndraeda,barthilas,1520,paladin,retribution,126,63,63
Chàrron,garrosh,1519,paladin,retribution,36,21,15
Moutai,dalaran,1519,paladin,retribution,83,42,41
Sofakingloco,thunderlord,1519,paladin,retribution,85,35,50
Andallar,nordrassil,1518,paladin,retribution,60,34,26
Gude,sargeras,1518,paladin,retribution,30,16,14
Shartea,moon-guard,1518,paladin,retribution,64,32,32
Grubbyhands,tichondrius,1518,paladin,retribution,42,16,26
Worshipmex,tichondrius,1517,paladin,retribution,36,20,16
Relentless,magtheridon,1517,paladin,retribution,107,54,53
Arreliya,sargeras,1517,paladin,retribution,100,49,51
Laboøn,stormrage,1516,paladin,retribution,24,16,8
Retrolove,illidan,1516,paladin,retribution,44,24,20
Lorenzinho,azralon,1516,paladin,retribution,80,42,38
Randomwalk,illidan,1516,paladin,retribution,42,16,26
Mhelyssa,goldrinn,1515,paladin,retribution,44,26,18
Sorhihi,illidan,1515,paladin,retribution,36,19,17
Purdicks,emerald-dream,1515,paladin,retribution,164,80,84
Cloaxy,azgalor,1515,paladin,retribution,187,88,99
Sosalo,sargeras,1515,paladin,retribution,120,56,64
Gronmpa,nemesis,1514,paladin,retribution,41,25,16
Jursch,emerald-dream,1514,paladin,retribution,235,122,113
Sweetcandy,sargeras,1514,paladin,retribution,78,39,39
Castïël,area-52,1514,paladin,retribution,175,86,89
Articilia,ragnaros,1514,paladin,retribution,48,23,25
Sephiroth,hyjal,1514,paladin,retribution,86,40,46
Kendren,ragnaros,1514,paladin,retribution,36,16,20
Luminainre,zuljin,1513,paladin,retribution,39,19,20
Haunter,akama,1513,paladin,retribution,60,29,31
Rëtribution,tichondrius,1513,paladin,retribution,80,36,44
Bawek,azralon,1513,paladin,retribution,93,40,53
Ichigò,sargeras,1512,paladin,retribution,86,52,34
Dzx,nemesis,1512,paladin,retribution,377,194,183
Suro,moon-guard,1512,paladin,retribution,44,16,28
Guluge,sargeras,1510,paladin,retribution,24,16,8
Thazadin,barthilas,1510,paladin,retribution,28,17,11
Dachenkov,tichondrius,1510,paladin,retribution,30,17,13
Blindburn,ragnaros,1510,paladin,retribution,66,36,30
Kmackk,tichondrius,1510,paladin,retribution,36,16,20
Skuxxlord,khazgoroth,1509,paladin,retribution,30,16,14
Agamemnom,tichondrius,1509,paladin,retribution,244,121,123
Kaupe,barthilas,1509,paladin,retribution,41,16,25
Protein,magtheridon,1509,paladin,retribution,42,16,26
Tonytoi,aegwynn,1508,paladin,retribution,48,31,17
Taphos,icecrown,1508,paladin,retribution,119,61,58
Temote,anvilmar,1508,paladin,retribution,132,66,66
Kookamønga,tichondrius,1508,paladin,retribution,91,44,47
Jøestar,proudmoore,1508,paladin,retribution,82,39,43
Jèrico,quelthalas,1508,paladin,retribution,62,28,34
Miemiesage,illidan,1508,paladin,retribution,42,16,26
Äeriah,fizzcrank,1507,paladin,retribution,114,63,51
Sowasred,emerald-dream,1507,paladin,retribution,84,45,39
Liquidkoala,lightbringer,1507,paladin,retribution,64,31,33
Astaro,malganis,1507,paladin,retribution,53,21,32
Yazuka,wyrmrest-accord,1506,paladin,retribution,54,30,24
Preacherfudd,area-52,1506,paladin,retribution,42,21,21
Bojanglz,frostmourne,1504,paladin,retribution,39,21,18
Piea,tichondrius,1503,paladin,retribution,66,32,34
Trapqueenlol,alterac-mountains,1503,paladin,retribution,120,56,64
Rakzan,nerzhul,1502,paladin,retribution,30,16,14
Eskannór,quelthalas,1502,paladin,retribution,42,18,24
Alphanerd,burning-blade,1501,paladin,retribution,42,26,16
Lichkingdenn,stormrage,1501,paladin,retribution,54,26,28
Mesaa,illidan,1501,paladin,retribution,39,18,21
Notae,alexstrasza,1501,paladin,retribution,35,16,19
Ezael,crushridge,1501,paladin,retribution,48,21,27
Connextion,terenas,1501,paladin,retribution,70,30,40
Rillumas,wyrmrest-accord,1501,paladin,retribution,71,30,41
Eurekasret,ragnaros,1500,paladin,retribution,146,71,75
Wickedpälly,kelthuzad,1499,paladin,retribution,42,25,17
Mäýhëm,sargeras,1499,paladin,retribution,58,32,26
Norlannd,ragnaros,1499,paladin,retribution,30,16,14
Són,ragnaros,1499,paladin,retribution,70,31,39
Tehgodofdmg,tichondrius,1498,paladin,retribution,36,16,20
Mordered,proudmoore,1498,paladin,retribution,70,27,43
Hinataa,illidan,1497,paladin,retribution,81,45,36
Audris,chogall,1497,paladin,retribution,65,29,36
Snuggymuffin,barthilas,1496,paladin,retribution,46,27,19
Superpaladin,stormrage,1495,paladin,retribution,65,32,33
Sprinkills,frostmourne,1494,paladin,retribution,54,34,20
Schwârts,blackrock,1494,paladin,retribution,70,36,34
Accépting,sargeras,1494,paladin,retribution,115,52,63
Layoya,aerie-peak,1493,paladin,retribution,40,23,17
Narsys,tichondrius,1493,paladin,retribution,109,50,59
Remorâ,blackrock,1493,paladin,retribution,54,23,31
Keenos,frostmourne,1492,paladin,retribution,37,17,20
Upaitaon,stormrage,1491,paladin,retribution,58,29,29
Jiasmat,ragnaros,1491,paladin,retribution,40,19,21
Kadbury,icecrown,1491,paladin,retribution,249,115,134
Xdiegox,stormrage,1491,paladin,retribution,36,16,20
Týrael,uldum,1490,paladin,retribution,60,33,27
Cryptdog,illidan,1490,paladin,retribution,117,56,61
Sàgadegemeós,stormrage,1489,paladin,retribution,60,32,28
Onitenshi,stormscale,1489,paladin,retribution,91,46,45
Mathieü,zuljin,1488,paladin,retribution,36,20,16
Evilmerdoc,kelthuzad,1488,paladin,retribution,78,36,42
Shishoknight,quelthalas,1488,paladin,retribution,73,32,41
Steelemantle,moon-guard,1487,paladin,retribution,30,16,14
Lumíty,sargeras,1487,paladin,retribution,163,85,78
Xk,kiljaeden,1487,paladin,retribution,72,33,39
Avvenging,tichondrius,1487,paladin,retribution,36,16,20
Vólko,frostmourne,1486,paladin,retribution,32,19,13
Urpi,drakkari,1485,paladin,retribution,41,25,16
Whets,thrall,1485,paladin,retribution,96,48,48
Sancthia,area-52,1485,paladin,retribution,47,22,25
Hdmi,darkspear,1484,paladin,retribution,63,34,29
Talantyr,zuljin,1484,paladin,retribution,84,41,43
Dcountt,area-52,1484,paladin,retribution,47,22,25
Imhardirl,area-52,1483,paladin,retribution,29,17,12
Taîno,thrall,1483,paladin,retribution,172,94,78
Greasysteve,stormrage,1482,paladin,retribution,60,33,27
Orestis,stormrage,1482,paladin,retribution,63,33,30
Leihateh,moon-guard,1481,paladin,retribution,63,33,30
Janokaluo,wyrmrest-accord,1481,paladin,retribution,101,52,49
Ralo,khaz-modan,1480,paladin,retribution,30,16,14
Thalorian,azshara,1480,paladin,retribution,58,29,29
Saphiraz,wildhammer,1480,paladin,retribution,62,28,34
Forlam,sargeras,1480,paladin,retribution,108,45,63
Silvabac,illidan,1479,paladin,retribution,82,44,38
Shourins,tichondrius,1479,paladin,retribution,48,24,24
Unitiss,velen,1479,paladin,retribution,48,23,25
Imperious,anetheron,1478,paladin,retribution,60,34,26
Vaqoh,ragnaros,1478,paladin,retribution,42,17,25
Konthrus,azralon,1477,paladin,retribution,123,72,51
Smashnasty,area-52,1477,paladin,retribution,54,29,25
Buddyolpally,proudmoore,1477,paladin,retribution,48,23,25
Againstfilet,azralon,1477,paladin,retribution,106,43,63
Airz,stormrage,1476,paladin,retribution,30,17,13
Shrektacular,malganis,1476,paladin,retribution,30,16,14
Holydiver,sargeras,1476,paladin,retribution,164,78,86
Bigpin,shattered-hand,1476,paladin,retribution,53,24,29
Revent,drakkari,1475,paladin,retribution,33,18,15
Pugnosano,black-dragonflight,1475,paladin,retribution,42,21,21
Troyamat,nemesis,1475,paladin,retribution,77,36,41
Kiritazuma,ravencrest,1475,paladin,retribution,84,39,45
Reînhard,drakkari,1475,paladin,retribution,55,25,30
Azoruken,quelthalas,1475,paladin,retribution,71,31,40
Arecht,moon-guard,1474,paladin,retribution,30,19,11
Gigadorff,stormrage,1474,paladin,retribution,74,44,30
Regivän,azralon,1474,paladin,retribution,30,17,13
Yamush,silver-hand,1474,paladin,retribution,80,40,40
Sunraiz,tichondrius,1473,paladin,retribution,46,26,20
Theretpally,kelthuzad,1473,paladin,retribution,72,37,35
Aztraseneco,ragnaros,1471,paladin,retribution,140,78,62
Justicierø,aegwynn,1471,paladin,retribution,70,37,33
Ellanaria,thrall,1471,paladin,retribution,117,61,56
Yoboyindahiz,stormrage,1471,paladin,retribution,57,23,34
Rykorth,moon-guard,1470,paladin,retribution,33,20,13
Mundomaloo,quelthalas,1470,paladin,retribution,51,22,29
Maiheev,moon-guard,1469,paladin,retribution,54,24,30
Polypal,zuljin,1468,paladin,retribution,42,18,24
Prïmavera,azralon,1466,paladin,retribution,41,20,21
Vasharien,nerzhul,1466,paladin,retribution,92,44,48
Nerilliah,sargeras,1466,paladin,retribution,45,20,25
Dimmadome,frostmourne,1465,paladin,retribution,78,50,28
Édzor,area-52,1465,paladin,retribution,48,19,29
Nicret,tichondrius,1464,paladin,retribution,24,18,6
Yovan,proudmoore,1464,paladin,retribution,108,57,51
Strabic,stormrage,1464,paladin,retribution,57,23,34
Toughlife,tichondrius,1464,paladin,retribution,72,28,44
Grünt,ragnaros,1463,paladin,retribution,30,18,12
Nohpalli,kelthuzad,1463,paladin,retribution,79,43,36
Athamon,nemesis,1463,paladin,retribution,30,16,14
Freiermoth,shadowmoon,1463,paladin,retribution,237,120,117
Viclovin,stormrage,1463,paladin,retribution,68,34,34
Bañe,lightbringer,1463,paladin,retribution,81,35,46
Dimitrony,quelthalas,1462,paladin,retribution,36,23,13
Bronytime,illidan,1462,paladin,retribution,29,16,13
Cyniaria,moon-guard,1462,paladin,retribution,126,66,60
Dreyan,wyrmrest-accord,1462,paladin,retribution,47,23,24
Sanguinata,shadowsong,1461,paladin,retribution,47,30,17
Crayt,tichondrius,1461,paladin,retribution,97,40,57
Ignasius,blood-furnace,1460,paladin,retribution,72,33,39
Hunsung,tichondrius,1460,paladin,retribution,42,16,26
Konarik,stormrage,1459,paladin,retribution,46,25,21
Lusangri,thrall,1459,paladin,retribution,51,20,31
Richiggaa,illidan,1458,paladin,retribution,58,35,23
Ereksean,sargeras,1458,paladin,retribution,62,32,30
Operise,stormrage,1458,paladin,retribution,60,29,31
Athenauwu,illidan,1458,paladin,retribution,40,19,21
Kelthálas,illidan,1458,paladin,retribution,42,18,24
Dannyram,zuljin,1457,paladin,retribution,75,40,35
Bennu,sargeras,1457,paladin,retribution,62,30,32
Wwanntae,tichondrius,1457,paladin,retribution,76,34,42
Theholysword,tichondrius,1457,paladin,retribution,41,16,25
Erowyn,tichondrius,1456,paladin,retribution,42,19,23
Vindictacho,tichondrius,1456,paladin,retribution,42,18,24
Lettuceprey,the-underbog,1455,paladin,retribution,60,33,27
Folgimar,moon-guard,1455,paladin,retribution,72,37,35
Astharor,stormrage,1454,paladin,retribution,70,40,30
Mádz,ragnaros,1454,paladin,retribution,29,16,13
Jorix,stormrage,1454,paladin,retribution,33,17,16
Wesdarian,jaedenar,1454,paladin,retribution,131,62,69
Messeb,veknilash,1453,paladin,retribution,169,93,76
Quotation,silvermoon,1453,paladin,retribution,56,30,26
Sovereignt,aggramar,1453,paladin,retribution,157,84,73
Monchy,bleeding-hollow,1453,paladin,retribution,52,27,25
Cyreus,emerald-dream,1452,paladin,retribution,63,27,36
Mysticblade,sargeras,1451,paladin,retribution,60,32,28
Vexxa,nerzhul,1451,paladin,retribution,36,18,18
Tacien,tichondrius,1451,paladin,retribution,112,54,58
Cyäbyë,frostmourne,1450,paladin,retribution,30,18,12
Drtom,mannoroth,1450,paladin,retribution,39,21,18
Hammerzite,whisperwind,1450,paladin,retribution,30,16,14
Solandiis,tichondrius,1450,paladin,retribution,67,32,35
Prosykt,sargeras,1450,paladin,retribution,38,16,22
Airplane,malygos,1449,paladin,retribution,24,16,8
Andrevz,ragnaros,1449,paladin,retribution,102,58,44
Jonfox,stormrage,1449,paladin,retribution,108,54,54
Normaldude,sargeras,1449,paladin,retribution,42,20,22
Sconci,whisperwind,1449,paladin,retribution,60,28,32
Avati,sargeras,1448,paladin,retribution,22,16,6
Californía,bleeding-hollow,1448,paladin,retribution,37,23,14
Darkeclipse,area-52,1448,paladin,retribution,30,17,13
Corrán,thrall,1448,paladin,retribution,36,20,16
Lightballz,vashj,1448,paladin,retribution,29,16,13
Hamertime,wyrmrest-accord,1447,paladin,retribution,125,62,63
Eustace,thunderhorn,1446,paladin,retribution,94,45,49
Glizzybertz,bleeding-hollow,1445,paladin,retribution,36,21,15
Retrah,azralon,1445,paladin,retribution,47,27,20
Angriel,azralon,1445,paladin,retribution,83,38,45
Malandru,darrowmere,1444,paladin,retribution,111,45,66
Killmönger,tichondrius,1443,paladin,retribution,95,44,51
Eutectic,moon-guard,1443,paladin,retribution,42,18,24
Iluminadoor,nemesis,1442,paladin,retribution,29,19,10
Ogholyhands,bleeding-hollow,1442,paladin,retribution,71,37,34
Levian,spirestone,1442,paladin,retribution,96,48,48
Zuthora,alleria,1441,paladin,retribution,82,42,40
Pijbins,moon-guard,1441,paladin,retribution,74,37,37
Antarcticala,frostmourne,1441,paladin,retribution,54,24,30
Onnakishi,azralon,1441,paladin,retribution,48,20,28
Neutroo,stormrage,1440,paladin,retribution,42,25,17
Inquisídor,nemesis,1440,paladin,retribution,30,17,13
Charleyy,stormscale,1440,paladin,retribution,96,53,43
Rusinator,bonechewer,1440,paladin,retribution,53,27,26
Awake,chogall,1439,paladin,retribution,24,15,9
Kkgame,tichondrius,1439,paladin,retribution,37,19,18
Crazymikey,bleeding-hollow,1439,paladin,retribution,42,15,27
Amarnath,turalyon,1438,paladin,retribution,45,25,20
Rohrn,firetree,1438,paladin,retribution,67,36,31
Warriorlight,quelthalas,1438,paladin,retribution,30,16,14
Vânguârds,tichondrius,1438,paladin,retribution,30,15,15
Thragar,stormrage,1438,paladin,retribution,30,15,15
Holyskeeter,thunderhorn,1438,paladin,retribution,55,23,32
Getdiswork,malygos,1437,paladin,retribution,108,52,56
Dawncröwn,stormrage,1437,paladin,retribution,65,22,43
Cesah,tichondrius,1436,paladin,retribution,24,15,9
Hokkan,quelthalas,1436,paladin,retribution,59,33,26
Industry,firetree,1436,paladin,retribution,45,25,20
Exwars,moon-guard,1436,paladin,retribution,50,27,23
Morneau,malganis,1436,paladin,retribution,322,162,160
Kêrmit,zuljin,1435,paladin,retribution,43,26,17
Devvn,laughing-skull,1434,paladin,retribution,24,15,9
Bilbain,proudmoore,1434,paladin,retribution,225,114,111
Hasmere,tichondrius,1434,paladin,retribution,30,15,15
Gimli,mannoroth,1434,paladin,retribution,36,15,21
Kemono,dathremar,1433,paladin,retribution,91,49,42
Poobiotic,frostmourne,1433,paladin,retribution,30,16,14
Mgjun,ragnaros,1433,paladin,retribution,36,18,18
Badbad,icecrown,1433,paladin,retribution,30,15,15
Bloodrefuge,tichondrius,1433,paladin,retribution,30,15,15
Deafheavens,moon-guard,1433,paladin,retribution,54,25,29
Sakicc,dalaran,1433,paladin,retribution,60,26,34
Modjytech,tichondrius,1433,paladin,retribution,105,44,61
Gummybearz,doomhammer,1433,paladin,retribution,48,20,28
Egufro,frostwolf,1432,paladin,retribution,78,44,34
Inexcusable,wyrmrest-accord,1432,paladin,retribution,47,25,22
Lhacius,drakkari,1432,paladin,retribution,34,16,18
Mercuryx,tichondrius,1432,paladin,retribution,36,15,21
Hatchet,skullcrusher,1431,paladin,retribution,30,15,15
Acallysta,moon-guard,1431,paladin,retribution,60,29,31
Sukmyret,sargeras,1431,paladin,retribution,36,15,21
Lmd,tichondrius,1430,paladin,retribution,66,35,31
Bapped,dalaran,1430,paladin,retribution,60,26,34
Supercharged,area-52,1429,paladin,retribution,30,15,15
Gorriuke,wyrmrest-accord,1428,paladin,retribution,30,18,12
Biloro,azralon,1428,paladin,retribution,66,38,28
Falaran,azralon,1428,paladin,retribution,62,32,30
Alexandros,nordrassil,1428,paladin,retribution,30,15,15
Gogofisco,moonrunner,1428,paladin,retribution,60,25,35
Artherion,kelthuzad,1428,paladin,retribution,87,35,52
Runö,frostmourne,1428,paladin,retribution,49,15,34
Holyfilers,thunderlord,1427,paladin,retribution,42,22,20
Bebopin,tichondrius,1427,paladin,retribution,64,31,33
Murtag,bloodscalp,1427,paladin,retribution,60,28,32
Cammack,thrall,1427,paladin,retribution,93,39,54
Mechelle,thrall,1426,paladin,retribution,128,71,57
Zolktro,stormrage,1426,paladin,retribution,64,33,31
Faowin,sargeras,1426,paladin,retribution,89,40,49
Saven,proudmoore,1426,paladin,retribution,36,15,21
Mathalt,area-52,1425,paladin,retribution,51,26,25
Rasc,barthilas,1425,paladin,retribution,132,63,69
Floquiinhos,azralon,1425,paladin,retribution,36,15,21
Dalgren,quelthalas,1425,paladin,retribution,111,43,68
Yukiikaze,sargeras,1424,paladin,retribution,76,40,36
Natsîrt,bleeding-hollow,1424,paladin,retribution,58,30,28
Emmastoned,bleeding-hollow,1424,paladin,retribution,102,49,53
Tekar,altar-of-storms,1424,paladin,retribution,42,17,25
Ruinlite,emerald-dream,1423,paladin,retribution,54,35,19
Donao,illidan,1423,paladin,retribution,136,71,65
Qpal,area-52,1423,paladin,retribution,42,18,24
Gànnicus,korgath,1422,paladin,retribution,36,15,21
Dfbattlepass,kelthuzad,1421,paladin,retribution,97,53,44
Pallyzo,zuljin,1421,paladin,retribution,30,15,15
Internadi,frostmourne,1421,paladin,retribution,66,32,34
Dragin,azralon,1421,paladin,retribution,87,40,47
Pallyseeker,thrall,1420,paladin,retribution,24,15,9
Emethala,windrunner,1420,paladin,retribution,48,26,22
Boozier,ragnaros,1420,paladin,retribution,30,16,14
Dividin,stormrage,1420,paladin,retribution,30,15,15
Tåine,suramar,1420,paladin,retribution,48,16,32
Cuffaladin,fenris,1418,paladin,retribution,54,30,24
Holyshôckz,stormrage,1418,paladin,retribution,86,47,39
Elowod,frostmourne,1418,paladin,retribution,48,24,24
Annhette,sargeras,1418,paladin,retribution,31,15,16
Nocomus,andorhal,1418,paladin,retribution,78,35,43
Lolslikeomg,malganis,1418,paladin,retribution,108,45,63
Verdicts,moon-guard,1418,paladin,retribution,36,15,21
Glorious,drakkari,1417,paladin,retribution,24,16,8
Galanblack,dalaran,1417,paladin,retribution,56,31,25
Blackop,gallywix,1417,paladin,retribution,30,16,14
Napstër,ragnaros,1417,paladin,retribution,36,15,21
Refulgent,moon-guard,1416,paladin,retribution,82,50,32
Lyricism,tichondrius,1416,paladin,retribution,49,28,21
Øxøxø,emerald-dream,1416,paladin,retribution,129,69,60
Blulux,ragnaros,1416,paladin,retribution,107,56,51
Wagyou,skywall,1416,paladin,retribution,30,15,15
Deosfires,ragnaros,1416,paladin,retribution,40,17,23
Jaikerino,emerald-dream,1416,paladin,retribution,42,15,27
Bullzor,aerie-peak,1415,paladin,retribution,84,51,33
Hrrothgar,muradin,1415,paladin,retribution,60,31,29
Balrok,cenarius,1415,paladin,retribution,185,93,92
Mitchyc,stormrage,1415,paladin,retribution,90,45,45
Minzyy,frostmourne,1414,paladin,retribution,24,15,9
Esixtytwoone,area-52,1414,paladin,retribution,36,22,14
Grîshnâkh,ragnaros,1414,paladin,retribution,127,64,63
Puresight,kelthuzad,1413,paladin,retribution,60,31,29
Savagedemise,barthilas,1413,paladin,retribution,55,28,27
Hägär,tichondrius,1413,paladin,retribution,67,27,40
Rhoche,ysera,1412,paladin,retribution,36,17,19
Oppression,kul-tiras,1412,paladin,retribution,77,29,48
Jagehbombs,tichondrius,1411,paladin,retribution,60,31,29
Sote,lightnings-blade,1410,paladin,retribution,51,25,26
Pàladwarf,stormrage,1410,paladin,retribution,99,47,52
Hasla,tichondrius,1410,paladin,retribution,51,19,32
Belgrieve,proudmoore,1409,paladin,retribution,54,26,28
Releváncé,barthilas,1409,paladin,retribution,66,31,35
Ashess,sargeras,1409,paladin,retribution,42,19,23
Icepondpal,proudmoore,1408,paladin,retribution,59,35,24
Kalboko,twisting-nether,1408,paladin,retribution,45,23,22
Anivan,moon-guard,1408,paladin,retribution,60,27,33
Reìarthur,stormrage,1408,paladin,retribution,72,32,40
Søøka,azralon,1408,paladin,retribution,84,36,48
Uholypala,dalaran,1408,paladin,retribution,78,33,45
Kulandis,stormrage,1408,paladin,retribution,57,24,33
Milke,chogall,1407,paladin,retribution,36,17,19
Keegân,area-52,1406,paladin,retribution,34,25,9
Tooholy,kiljaeden,1406,paladin,retribution,87,54,33
Peil,illidan,1406,paladin,retribution,36,15,21
Sophany,shattered-halls,1405,paladin,retribution,40,26,14
Szeq,tichondrius,1405,paladin,retribution,32,16,16
Outlivz,hyjal,1404,paladin,retribution,33,17,16
Chandlerrj,area-52,1404,paladin,retribution,42,21,21
Zadragon,sargeras,1404,paladin,retribution,72,35,37
Gstbubble,hyjal,1404,paladin,retribution,36,15,21
Zimzob,stormscale,1403,paladin,retribution,30,15,15
Keltec,bonechewer,1403,paladin,retribution,67,28,39
Swietomierz,proudmoore,1403,paladin,retribution,48,20,28
Holyginger,barthilas,1402,paladin,retribution,41,23,18
Oschy,moon-guard,1401,paladin,retribution,101,51,50
Holytémplar,proudmoore,1401,paladin,retribution,54,27,27
Sellenagomez,malganis,1401,paladin,retribution,60,29,31
Wésters,quelthalas,1401,paladin,retribution,163,77,86
Jdgmnt,sargeras,1401,paladin,retribution,72,33,39
Véxv,emerald-dream,1401,paladin,retribution,92,36,56
Salaminhoo,azralon,1400,paladin,retribution,30,19,11
Eamon,kelthuzad,1400,paladin,retribution,29,15,14
Retman,azuremyst,1400,paladin,retribution,66,30,36
Lustros,stormrage,1400,paladin,retribution,87,37,50
Dorzwaz,draka,1399,paladin,retribution,30,20,10
Palabing,stormrage,1399,paladin,retribution,24,15,9
Trg,azralon,1398,paladin,retribution,30,17,13
Holyham,fizzcrank,1398,paladin,retribution,48,27,21
Bosutai,dalaran,1398,paladin,retribution,48,22,26
Tinithis,tichondrius,1397,paladin,retribution,47,28,19
Chuckman,skullcrusher,1397,paladin,retribution,30,16,14
Pathed,aerie-peak,1396,paladin,retribution,32,16,16
Delanadras,kelthuzad,1396,paladin,retribution,59,26,33
Siaaryn,darkspear,1396,paladin,retribution,42,17,25
Krypton,tichondrius,1395,paladin,retribution,42,23,19
Carnagias,bleeding-hollow,1395,paladin,retribution,101,51,50
Ktwocrank,dalaran,1395,paladin,retribution,43,16,27
Tmac,azralon,1393,paladin,retribution,68,35,33
Rafaela,alterac-mountains,1393,paladin,retribution,36,18,18
Shlaps,crushridge,1393,paladin,retribution,96,47,49
Tsunin,area-52,1393,paladin,retribution,94,46,48
Gokuu,korgath,1393,paladin,retribution,108,51,57
Fìlìgree,tichondrius,1393,paladin,retribution,97,45,52
Belregn,illidan,1393,paladin,retribution,78,36,42
Andronik,bleeding-hollow,1392,paladin,retribution,39,19,20
Jazztice,mannoroth,1392,paladin,retribution,46,22,24
Sthrealys,quelthalas,1391,paladin,retribution,30,16,14
Judgmentor,malganis,1391,paladin,retribution,82,34,48
Droden,tichondrius,1390,paladin,retribution,55,29,26
Carliitoz,quelthalas,1389,paladin,retribution,144,62,82
Coffiecup,frostmane,1388,paladin,retribution,24,15,9
Tutankhammer,stormrage,1388,paladin,retribution,106,55,51
Schalpy,illidan,1388,paladin,retribution,60,28,32
Miitt,blackrock,1387,paladin,retribution,36,20,16
Slowedreverb,stormrage,1387,paladin,retribution,81,42,39
Granisdh,aegwynn,1387,paladin,retribution,54,27,27
Pablito,fizzcrank,1387,paladin,retribution,39,17,22
Pallytoot,aerie-peak,1386,paladin,retribution,60,35,25
Valikyr,mugthol,1386,paladin,retribution,36,18,18
Smitetheweak,rivendare,1385,paladin,retribution,30,17,13
Simplesam,draenor,1385,paladin,retribution,36,15,21
Mareaaturbo,azralon,1384,paladin,retribution,59,34,25
Kanyewes,zuluhed,1384,paladin,retribution,83,38,45
Kaladini,jubeithos,1383,paladin,retribution,28,16,12
Xalixxa,wyrmrest-accord,1382,paladin,retribution,84,44,40
Psadin,thunderlord,1382,paladin,retribution,72,32,40
Ozirus,frostmourne,1381,paladin,retribution,75,32,43
Luðo,moon-guard,1380,paladin,retribution,35,15,20
Saîntpaul,shattered-halls,1380,paladin,retribution,36,15,21
Dresdén,skullcrusher,1379,paladin,retribution,24,17,7
Fulgal,jubeithos,1379,paladin,retribution,39,15,24
Aeroßlaze,dragonmaw,1378,paladin,retribution,42,22,20
Auka,zuljin,1378,paladin,retribution,42,21,21
Elsinore,senjin,1377,paladin,retribution,35,19,16
Öpäf,steamwheedle-cartel,1377,paladin,retribution,60,26,34
Kizaru,shuhalo,1376,paladin,retribution,28,16,12
Kaelthasar,azralon,1376,paladin,retribution,30,15,15
Lebowski,nordrassil,1375,paladin,retribution,66,31,35
Gorostas,kelthuzad,1375,paladin,retribution,34,15,19
Chippo,aegwynn,1374,paladin,retribution,53,26,27
Stdee,zuljin,1372,paladin,retribution,63,33,30
Rhodius,dalaran,1372,paladin,retribution,63,32,31
Adrockiller,quelthalas,1372,paladin,retribution,68,34,34
Nevanethus,frostmourne,1371,paladin,retribution,30,15,15
Lornd,quelthalas,1371,paladin,retribution,30,15,15
Brenaluna,tichondrius,1371,paladin,retribution,61,26,35
Holyqunt,dalaran,1370,paladin,retribution,63,37,26
Dawsonthebos,grizzly-hills,1370,paladin,retribution,30,16,14
Superzooted,sargeras,1370,paladin,retribution,34,15,19
Sona,jubeithos,1370,paladin,retribution,42,18,24
Hurrîcane,illidan,1370,paladin,retribution,48,15,33
Minitas,blackrock,1369,paladin,retribution,42,15,27
Jxo,tichondrius,1368,paladin,retribution,30,17,13
Kellissandra,aerie-peak,1368,paladin,retribution,84,34,50
Modafinil,bonechewer,1368,paladin,retribution,67,27,40
Olikono,tichondrius,1367,paladin,retribution,30,16,14
Vaelinarys,ragnaros,1366,paladin,retribution,30,20,10
Huitz,drakkari,1366,paladin,retribution,102,55,47
Tøpbløke,frostmourne,1366,paladin,retribution,121,60,61
Hazmât,illidan,1366,paladin,retribution,100,42,58
Hurukpaly,azralon,1365,paladin,retribution,52,23,29
Formergf,crushridge,1364,paladin,retribution,90,48,42
Scubàlicous,magtheridon,1364,paladin,retribution,43,19,24
Shecara,malygos,1363,paladin,retribution,78,44,34
Áthz,ragnaros,1363,paladin,retribution,41,21,20
Nest,stormrage,1363,paladin,retribution,30,15,15
Hùck,alexstrasza,1363,paladin,retribution,112,52,60
Alvick,icecrown,1363,paladin,retribution,39,16,23
Aretwin,dalaran,1361,paladin,retribution,54,27,27
Arlizu,quelthalas,1361,paladin,retribution,35,17,18
Ðetroity,stormrage,1359,paladin,retribution,105,57,48
Pal,blackhand,1359,paladin,retribution,44,23,21
Pvppaulx,moon-guard,1359,paladin,retribution,77,39,38
Kalendawn,moon-guard,1358,paladin,retribution,76,43,33
Mobitz,dalvengyr,1357,paladin,retribution,75,40,35
Lightcast,moon-guard,1357,paladin,retribution,72,34,38
Willzaum,azralon,1356,paladin,retribution,60,32,28
Urfavxbf,baelgun,1356,paladin,retribution,213,111,102
Wickedwingz,sargeras,1356,paladin,retribution,30,15,15
Mïkhael,nemesis,1356,paladin,retribution,86,37,49
Arbarrus,stormrage,1354,paladin,retribution,31,19,12
Cinacalcet,dalaran,1354,paladin,retribution,29,15,14
Philfred,frostmourne,1353,paladin,retribution,31,21,10
Theldart,ragnaros,1353,paladin,retribution,59,30,29
Oopalaoo,azralon,1353,paladin,retribution,36,17,19
Lunchhboxx,kelthuzad,1353,paladin,retribution,47,22,25
Adapa,azralon,1353,paladin,retribution,36,16,20
Dwk,thrall,1353,paladin,retribution,36,15,21
Hrizul,drakthul,1353,paladin,retribution,36,15,21
Warspyder,alterac-mountains,1351,paladin,retribution,48,28,20
Avengercc,tichondrius,1351,paladin,retribution,34,15,19
Tlahtoani,illidan,1350,paladin,retribution,23,15,8
Avantasias,sargeras,1350,paladin,retribution,99,48,51
Chinsta,zuljin,1349,paladin,retribution,36,22,14
Zantdemption,frostmourne,1349,paladin,retribution,29,15,14
Solgrïm,wyrmrest-accord,1348,paladin,retribution,60,28,32
Sländers,sargeras,1348,paladin,retribution,107,49,58
Demihoj,illidan,1348,paladin,retribution,42,16,26
Vanthor,emerald-dream,1347,paladin,retribution,36,17,19
Retligious,kelthuzad,1346,paladin,retribution,29,18,11
Dwurim,moon-guard,1346,paladin,retribution,48,26,22
Ddeadwhisper,executus,1345,paladin,retribution,104,56,48
Säj,aggramar,1344,paladin,retribution,30,15,15
Lightvader,illidan,1344,paladin,retribution,36,15,21
Bossmin,tichondrius,1343,paladin,retribution,24,14,10
Sarayan,proudmoore,1343,paladin,retribution,36,17,19
Dyskrazia,thrall,1343,paladin,retribution,32,15,17
Zugzugondeez,illidan,1343,paladin,retribution,30,14,16
Bignum,illidan,1343,paladin,retribution,30,14,16
Expiate,tichondrius,1342,paladin,retribution,18,14,4
Dublek,tichondrius,1342,paladin,retribution,18,14,4
Oxoslayeroxo,firetree,1342,paladin,retribution,37,18,19
Xygra,stormrage,1342,paladin,retribution,30,14,16
Wrathofangus,nesingwary,1342,paladin,retribution,30,14,16
Pallynation,korgath,1342,paladin,retribution,48,21,27
Uxd,tichondrius,1342,paladin,retribution,76,33,43
Addisen,malganis,1341,paladin,retribution,30,14,16
Kikazaru,moon-guard,1341,paladin,retribution,36,14,22
Sweatylight,bleeding-hollow,1340,paladin,retribution,80,42,38
Fabolouss,tichondrius,1340,paladin,retribution,132,69,63
Retsonictwo,tichondrius,1340,paladin,retribution,30,14,16
Flynnee,illidan,1340,paladin,retribution,50,22,28
Bubblestar,ragnaros,1340,paladin,retribution,56,23,33
Samphlty,azralon,1340,paladin,retribution,36,14,22
Minikalina,ragnaros,1339,paladin,retribution,24,14,10
Hoodmeatflap,stonemaul,1339,paladin,retribution,30,17,13
Pennedurma,akama,1339,paladin,retribution,46,24,22
Hèlfar,wyrmrest-accord,1339,paladin,retribution,30,14,16
Allpower,azralon,1339,paladin,retribution,30,14,16
Arlleth,area-52,1339,paladin,retribution,48,22,26
Palpinga,kelthuzad,1339,paladin,retribution,71,28,43
Thadose,bonechewer,1338,paladin,retribution,195,108,87
Neró,quelthalas,1338,paladin,retribution,67,31,36
Akiralons,ragnaros,1338,paladin,retribution,36,15,21
Healsonyou,windrunner,1338,paladin,retribution,36,14,22
Iceburg,shadowmoon,1337,paladin,retribution,30,17,13
Bleeked,emerald-dream,1337,paladin,retribution,31,16,15
Redspine,azralon,1337,paladin,retribution,36,14,22
Eomàr,barthilas,1336,paladin,retribution,30,18,12
Lortrin,quelthalas,1336,paladin,retribution,30,16,14
Minereth,quelthalas,1336,paladin,retribution,29,15,14
Nightz,eonar,1336,paladin,retribution,36,14,22
Roxiomoxa,ragnaros,1335,paladin,retribution,30,14,16
Albagail,draka,1335,paladin,retribution,46,20,26
Prôphêt,stormrage,1334,paladin,retribution,18,14,4
Justsmiteit,dalaran,1334,paladin,retribution,30,17,13
Treizen,frostmourne,1334,paladin,retribution,43,18,25
Warmpôcket,proudmoore,1334,paladin,retribution,87,33,54
Oioo,proudmoore,1333,paladin,retribution,21,15,6
Reptila,bonechewer,1333,paladin,retribution,30,14,16
Väkariän,quelthalas,1333,paladin,retribution,30,14,16
Thortanous,icecrown,1333,paladin,retribution,54,25,29
Faaqmee,gorefiend,1332,paladin,retribution,30,19,11
Pallyhealed,tichondrius,1332,paladin,retribution,37,17,20
Malorian,azgalor,1332,paladin,retribution,48,21,27
Covidin,quelthalas,1332,paladin,retribution,75,29,46
Lüuz,area-52,1332,paladin,retribution,42,15,27
Fallóut,proudmoore,1332,paladin,retribution,48,14,34
Trogdorpwn,bonechewer,1331,paladin,retribution,30,17,13
Bonkky,whisperwind,1331,paladin,retribution,30,16,14
Mattilla,tichondrius,1331,paladin,retribution,30,14,16
Elivathord,trollbane,1330,paladin,retribution,35,20,15
Bootcrusader,thrall,1330,paladin,retribution,27,15,12
Däkh,sargeras,1329,paladin,retribution,24,14,10
Overbet,area-52,1329,paladin,retribution,27,15,12
Bigdoosa,frostmourne,1329,paladin,retribution,40,19,21
Xoxoxoxoxoxo,aegwynn,1329,paladin,retribution,60,28,32
Orin,guldan,1328,paladin,retribution,30,14,16
Nerfashen,zuljin,1327,paladin,retribution,24,14,10
Clayban,stormrage,1327,paladin,retribution,42,22,20
Oneminute,nerzhul,1327,paladin,retribution,48,25,23
Azajudgeman,nemesis,1327,paladin,retribution,33,14,19
Malavon,azralon,1326,paladin,retribution,27,17,10
Rycard,moon-guard,1326,paladin,retribution,24,14,10
Levarious,thunderlord,1326,paladin,retribution,132,64,68
Garcinddra,vashj,1326,paladin,retribution,34,16,18
Ennvy,nemesis,1326,paladin,retribution,30,14,16
Brolando,hyjal,1326,paladin,retribution,30,14,16
Melize,area-52,1325,paladin,retribution,118,57,61
Mikezheng,tichondrius,1325,paladin,retribution,42,19,23
Dexko,silvermoon,1324,paladin,retribution,34,24,10
Lomis,azgalor,1324,paladin,retribution,24,15,9
Nerfmehpls,ragnaros,1324,paladin,retribution,114,66,48
Kiergann,quelthalas,1324,paladin,retribution,71,33,38
Gixpal,skullcrusher,1323,paladin,retribution,59,31,28
Christman,illidan,1323,paladin,retribution,78,33,45
Brsjak,frostmourne,1321,paladin,retribution,89,46,43
Sprezzatura,illidan,1321,paladin,retribution,30,15,15
Herrit,frostmourne,1318,paladin,retribution,150,81,69
Dekho,quelthalas,1318,paladin,retribution,77,33,44
Dralkou,kaelthas,1318,paladin,retribution,87,35,52
Serran,durotan,1318,paladin,retribution,54,20,34
Elri,ragnaros,1317,paladin,retribution,54,27,27
Wookpally,area-52,1317,paladin,retribution,41,19,22
Toyotasupra,azgalor,1316,paladin,retribution,51,31,20
Balango,azralon,1316,paladin,retribution,24,14,10
Hiikari,silver-hand,1316,paladin,retribution,36,18,18
Holyfaxis,rexxar,1316,paladin,retribution,44,20,24
Zoobro,tichondrius,1316,paladin,retribution,71,32,39
Pallypapa,galakrond,1315,paladin,retribution,35,22,13
Sigismud,quelthalas,1315,paladin,retribution,30,15,15
Hapii,tichondrius,1315,paladin,retribution,47,18,29
Crematória,azralon,1314,paladin,retribution,24,14,10
Thoti,tichondrius,1314,paladin,retribution,31,15,16
Killeralan,quelthalas,1314,paladin,retribution,79,36,43
Lostkanvas,azralon,1313,paladin,retribution,46,27,19
Hoelï,stormrage,1313,paladin,retribution,24,14,10
Phokboi,shattered-hand,1313,paladin,retribution,57,31,26
Siberios,stormrage,1313,paladin,retribution,30,14,16
Arnblass,magtheridon,1313,paladin,retribution,69,31,38
Çløúdéd,area-52,1313,paladin,retribution,36,16,20
Ludvigsen,hakkar,1313,paladin,retribution,36,14,22
Autoattacker,mannoroth,1312,paladin,retribution,24,14,10
Hays,barthilas,1311,paladin,retribution,18,14,4
Easiestcomp,sargeras,1311,paladin,retribution,30,16,14
Bravomedic,emerald-dream,1311,paladin,retribution,39,20,19
Melloow,azralon,1311,paladin,retribution,91,43,48
Weenerboy,nerzhul,1310,paladin,retribution,36,22,14
Hølyavenger,darkspear,1310,paladin,retribution,24,14,10
Darthhelios,illidan,1310,paladin,retribution,36,14,22
Bruhstice,area-52,1309,paladin,retribution,30,14,16
Lumberjack,bloodhoof,1309,paladin,retribution,41,16,25
Lashlan,barthilas,1308,paladin,retribution,47,27,20
Wlq,frostmourne,1308,paladin,retribution,83,34,49
Erethonis,bladefist,1307,paladin,retribution,78,36,42
Chbestafera,nemesis,1306,paladin,retribution,30,20,10
Heraolympian,black-dragonflight,1306,paladin,retribution,69,36,33
Shamo,stormreaver,1306,paladin,retribution,36,14,22
Unknownplay,tichondrius,1305,paladin,retribution,24,14,10
Bayaz,emerald-dream,1304,paladin,retribution,67,36,31
Holybalsagna,garrosh,1304,paladin,retribution,72,37,35
Nadrela,burning-blade,1303,paladin,retribution,54,32,22
Uvatah,quelthalas,1303,paladin,retribution,24,14,10
Quickthing,dalaran,1303,paladin,retribution,89,51,38
Happywow,tichondrius,1302,paladin,retribution,59,30,29
Synthetic,moon-guard,1300,paladin,retribution,90,47,43
Stealhearsp,tichondrius,1300,paladin,retribution,53,22,31
Ultralord,dragonmaw,1299,paladin,retribution,28,14,14
Sunwrath,quelthalas,1299,paladin,retribution,87,37,50
Släyèr,tichondrius,1299,paladin,retribution,42,15,27
Mürdøx,illidan,1298,paladin,retribution,27,15,12
Krinkin,illidan,1297,paladin,retribution,42,14,28
Lainn,zuljin,1296,paladin,retribution,77,41,36
Youwillatone,zuljin,1296,paladin,retribution,42,22,20
Brightsaber,tichondrius,1294,paladin,retribution,69,36,33
Arkanica,moon-guard,1294,paladin,retribution,59,24,35
Velarelan,moon-guard,1294,paladin,retribution,36,14,22
Paladingirl,darkspear,1292,paladin,retribution,92,50,42
Mendaltv,dalaran,1292,paladin,retribution,36,17,19
Vosailer,illidan,1290,paladin,retribution,34,16,18
Walleis,moon-guard,1290,paladin,retribution,58,22,36
Casko,wyrmrest-accord,1289,paladin,retribution,36,20,16
Vlandor,area-52,1288,paladin,retribution,47,27,20
Asunima,wyrmrest-accord,1288,paladin,retribution,30,17,13
Sïrenek,tichondrius,1288,paladin,retribution,73,37,36
Guidö,stormrage,1288,paladin,retribution,39,15,24
Sóapbubble,tichondrius,1287,paladin,retribution,27,14,13
Jugheadqc,mugthol,1287,paladin,retribution,81,40,41
Critxx,tichondrius,1287,paladin,retribution,83,38,45
Bahkax,tichondrius,1287,paladin,retribution,40,18,22
Jerratt,thrall,1287,paladin,retribution,90,40,50
Vêndar,ragnaros,1287,paladin,retribution,102,45,57
Dedsxy,tichondrius,1286,paladin,retribution,30,14,16
Punative,darkspear,1286,paladin,retribution,54,20,34
Hwanko,tichondrius,1285,paladin,retribution,40,25,15
Meanlight,zuljin,1285,paladin,retribution,116,63,53
Broxon,tichondrius,1285,paladin,retribution,64,33,31
Gainen,illidan,1285,paladin,retribution,47,24,23
ßlððdyßðnez,malganis,1283,paladin,retribution,36,20,16
Hanael,quelthalas,1283,paladin,retribution,31,15,16
Verguetas,ragnaros,1283,paladin,retribution,90,40,50
Bulioevn,emerald-dream,1283,paladin,retribution,57,25,32
Buffalosaucé,illidan,1282,paladin,retribution,38,15,23
Retneyspears,darkspear,1280,paladin,retribution,53,25,28
Brifos,sargeras,1280,paladin,retribution,43,14,29
Navicc,zuljin,1279,paladin,retribution,29,14,15
Justicefox,thrall,1278,paladin,retribution,24,14,10
Dirkadirkka,stormrage,1276,paladin,retribution,30,16,14
Bennygee,moonrunner,1276,paladin,retribution,42,19,23
Theuss,nerzhul,1276,paladin,retribution,59,25,34
Dewlight,zuljin,1275,paladin,retribution,77,45,32
Yuccalicious,area-52,1275,paladin,retribution,53,23,30
Carolena,thaurissan,1274,paladin,retribution,74,31,43
Dredberserk,stormrage,1273,paladin,retribution,30,16,14
Edjr,stormrage,1273,paladin,retribution,30,16,14
Throwable,illidan,1273,paladin,retribution,64,26,38
Webothhateme,tichondrius,1272,paladin,retribution,36,20,16
Skylexx,ragnaros,1272,paladin,retribution,66,31,35
Eddwardo,emerald-dream,1272,paladin,retribution,48,18,30
Khorgus,gundrak,1271,paladin,retribution,54,27,27
Linias,quelthalas,1270,paladin,retribution,27,18,9
Playmaker,mannoroth,1270,paladin,retribution,69,30,39
Såssy,moon-guard,1270,paladin,retribution,72,31,41
Pâpito,drakkari,1270,paladin,retribution,38,16,22
Draeneihead,gnomeregan,1270,paladin,retribution,60,25,35
Lemonliime,moon-guard,1270,paladin,retribution,36,14,22
Albion,sargeras,1270,paladin,retribution,42,14,28
Saucepally,laughing-skull,1269,paladin,retribution,67,35,32
Thankyouswen,tichondrius,1269,paladin,retribution,70,31,39
Artaxerxes,stormrage,1269,paladin,retribution,44,18,26
Gramaton,malfurion,1268,paladin,retribution,54,25,29
Xandish,illidan,1266,paladin,retribution,26,14,12
Giltronix,thrall,1266,paladin,retribution,60,30,30
Palacamâ,quelthalas,1266,paladin,retribution,34,15,19
Sabêr,ragnaros,1265,paladin,retribution,23,14,9
Mindfoolness,sargeras,1265,paladin,retribution,42,21,21
Atrayeus,dawnbringer,1265,paladin,retribution,72,32,40
Areura,hellscream,1264,paladin,retribution,27,19,8
Kregar,kelthuzad,1264,paladin,retribution,88,45,43
Wosy,azralon,1263,paladin,retribution,24,15,9
Onemorelight,sargeras,1263,paladin,retribution,54,27,27
Alberich,tichondrius,1263,paladin,retribution,52,24,28
Quinnl,dreadmaul,1262,paladin,retribution,38,18,20
Athenariel,bleeding-hollow,1262,paladin,retribution,55,24,31
Garruckadin,dalaran,1261,paladin,retribution,25,14,11
Vtyr,nemesis,1260,paladin,retribution,89,40,49
Revent,stormrage,1260,paladin,retribution,60,24,36
Sahbabii,baelgun,1260,paladin,retribution,35,14,21
Rynis,arthas,1259,paladin,retribution,58,28,30
Canadianeh,malganis,1259,paladin,retribution,78,34,44
Spartus,area-52,1258,paladin,retribution,32,19,13
Minlarkwa,frostmourne,1257,paladin,retribution,30,16,14
Restitution,area-52,1257,paladin,retribution,35,14,21
Fortueni,illidan,1254,paladin,retribution,118,71,47
Alucardlh,ragnaros,1254,paladin,retribution,70,38,32
Ajoladin,illidan,1253,paladin,retribution,117,53,64
Guanglong,malganis,1253,paladin,retribution,38,14,24
Kettlebaby,wildhammer,1252,paladin,retribution,23,14,9
Denhoward,proudmoore,1252,paladin,retribution,42,16,26
Paliodin,dalaran,1252,paladin,retribution,48,18,30
Lvlone,sargeras,1250,paladin,retribution,30,17,13
Menaus,duskwood,1250,paladin,retribution,39,20,19
Barbesacrer,zuljin,1249,paladin,retribution,27,15,12
Aellâ,bloodscalp,1249,paladin,retribution,206,107,99
Brucedwal,moon-guard,1249,paladin,retribution,69,35,34
Smorezz,bonechewer,1249,paladin,retribution,108,50,58
Eleonorr,proudmoore,1248,paladin,retribution,30,16,14
Dárí,stormrage,1248,paladin,retribution,138,65,73
Chopsparks,khadgar,1248,paladin,retribution,62,26,36
Wölfheärt,tichondrius,1247,paladin,retribution,18,13,5
Davinchi,laughing-skull,1247,paladin,retribution,47,27,20
Canadapants,kelthuzad,1247,paladin,retribution,42,24,18
Krawmwell,lothar,1247,paladin,retribution,96,53,43
Solidifyxz,area-52,1247,paladin,retribution,24,13,11
Caution,rexxar,1247,paladin,retribution,24,13,11
Billystacks,illidan,1247,paladin,retribution,24,13,11
Venturep,azralon,1247,paladin,retribution,24,13,11
Tlawn,tichondrius,1247,paladin,retribution,24,13,11
Daion,quelthalas,1247,paladin,retribution,24,13,11
Thin,ragnaros,1247,paladin,retribution,30,14,16
Drriz,stormrage,1247,paladin,retribution,30,13,17
Bdaws,tichondrius,1247,paladin,retribution,30,13,17
Hojdin,tichondrius,1247,paladin,retribution,30,13,17
Doxan,quelthalas,1247,paladin,retribution,36,13,23
Mythbuster,frostwolf,1246,paladin,retribution,24,13,11
Talvyr,icecrown,1246,paladin,retribution,30,14,16
Revendreth,caelestrasz,1246,paladin,retribution,48,22,26
Steelbreaker,deathwing,1246,paladin,retribution,47,21,26
Loudpaq,guldan,1246,paladin,retribution,30,13,17
Boopif,sargeras,1246,paladin,retribution,30,13,17
Beyönd,quelthalas,1246,paladin,retribution,30,13,17
Zephyrvalor,sargeras,1245,paladin,retribution,54,32,22
Leslievernon,ursin,1245,paladin,retribution,24,13,11
Snowcrow,tichondrius,1245,paladin,retribution,173,80,93
Paladinaa,lothar,1245,paladin,retribution,30,13,17
Onemassacre,spirestone,1245,paladin,retribution,36,13,23
Kasoon,illidan,1244,paladin,retribution,18,13,5
Xamo,drakkari,1244,paladin,retribution,24,13,11
Hammerina,antonidas,1244,paladin,retribution,35,16,19
Mákis,ragnaros,1244,paladin,retribution,30,13,17
Aduhrawl,moon-guard,1244,paladin,retribution,38,14,24
Pauliss,sargeras,1244,paladin,retribution,36,13,23
Wryly,mannoroth,1244,paladin,retribution,42,13,29
Jaimi,stormreaver,1243,paladin,retribution,18,13,5
Wonpaiv,frostmourne,1243,paladin,retribution,24,13,11
Yugee,doomhammer,1243,paladin,retribution,24,13,11
Doktavius,lightbringer,1243,paladin,retribution,24,13,11
Krixes,firetree,1243,paladin,retribution,30,16,14
Deployed,kaelthas,1243,paladin,retribution,36,13,23
Giovannas,tichondrius,1243,paladin,retribution,36,13,23
Fierfox,moon-guard,1242,paladin,retribution,21,14,7
Bebitufiufiu,illidan,1242,paladin,retribution,24,13,11
Rockbell,kiljaeden,1242,paladin,retribution,24,13,11
Tedward,emerald-dream,1242,paladin,retribution,24,13,11
Evact,moon-guard,1242,paladin,retribution,64,28,36
Justeight,stormrage,1242,paladin,retribution,33,13,20
Ricocheto,ragnaros,1241,paladin,retribution,24,13,11
Anastos,anvilmar,1241,paladin,retribution,24,13,11
Glorgrim,emerald-dream,1241,paladin,retribution,24,13,11
Midnightboto,dragonmaw,1241,paladin,retribution,30,13,17
Djangø,azuremyst,1241,paladin,retribution,30,13,17
Aurken,ragnaros,1241,paladin,retribution,30,13,17
Amadin,emerald-dream,1240,paladin,retribution,24,13,11
Mavrixz,illidan,1240,paladin,retribution,30,13,17
Saintpower,stormscale,1239,paladin,retribution,24,13,11
Tifalockhart,dathremar,1239,paladin,retribution,24,13,11
Belena,jaedenar,1239,paladin,retribution,42,18,24
Grimmune,illidan,1238,paladin,retribution,30,13,17
Ràmetep,illidan,1238,paladin,retribution,30,13,17
Svane,thunderlord,1237,paladin,retribution,30,13,17
Rigotakp,illidan,1237,paladin,retribution,30,13,17
Pristinne,darkspear,1237,paladin,retribution,82,34,48
Ablunedion,illidan,1237,paladin,retribution,41,14,27
Nornix,fenris,1236,paladin,retribution,24,13,11
Perfectgirl,maiev,1236,paladin,retribution,90,42,48
Sialectra,illidan,1236,paladin,retribution,30,13,17
Terrordin,illidan,1236,paladin,retribution,38,13,25
Carenye,thunderhorn,1235,paladin,retribution,37,16,21
Soana,alexstrasza,1234,paladin,retribution,89,53,36
Balster,moon-guard,1234,paladin,retribution,97,45,52
Malicia,malorne,1234,paladin,retribution,42,19,23
Noblelight,saurfang,1233,paladin,retribution,29,17,12
Savethejelly,moon-guard,1232,paladin,retribution,30,13,17
Eljefee,emerald-dream,1232,paladin,retribution,41,16,25
Pasterõ,ragnaros,1231,paladin,retribution,28,16,12
Gys,ragnaros,1231,paladin,retribution,78,40,38
Shusekki,drakkari,1231,paladin,retribution,117,58,59
Pìerre,ragnaros,1231,paladin,retribution,140,69,71
Ôdenswrath,stormscale,1231,paladin,retribution,98,45,53
Irand,area-52,1231,paladin,retribution,67,26,41
Hodne,blackhand,1230,paladin,retribution,67,33,34
Uunjaaku,kiljaeden,1230,paladin,retribution,45,22,23
Dragomnnm,stormrage,1230,paladin,retribution,34,14,20
Yoash,quelthalas,1229,paladin,retribution,30,13,17
Soopadupa,trollbane,1228,paladin,retribution,80,44,36
Legible,tichondrius,1228,paladin,retribution,28,15,13
Featscrows,nemesis,1228,paladin,retribution,48,20,28
Uhklathel,quelthalas,1228,paladin,retribution,63,25,38
Heindallr,nemesis,1227,paladin,retribution,60,28,32
Forged,steamwheedle-cartel,1227,paladin,retribution,135,56,79
Holyshoc,kiljaeden,1225,paladin,retribution,74,37,37
Haawkala,ragnaros,1225,paladin,retribution,30,13,17
Misskilljoy,proudmoore,1225,paladin,retribution,30,13,17
Hellcallerl,quelthalas,1224,paladin,retribution,24,13,11
Trainstorm,emerald-dream,1224,paladin,retribution,60,27,33
Dankpaladin,frostwolf,1224,paladin,retribution,30,13,17
Heälmeñow,tichondrius,1224,paladin,retribution,30,13,17
Amarith,queldorei,1224,paladin,retribution,76,31,45
Ulessys,bleeding-hollow,1223,paladin,retribution,54,27,27
Tonnerre,silvermoon,1223,paladin,retribution,72,33,39
Ekyu,sargeras,1222,paladin,retribution,25,15,10
Pappablanco,stormrage,1222,paladin,retribution,24,14,10
Reaslovak,jubeithos,1222,paladin,retribution,24,13,11
Lungjuice,stormrage,1222,paladin,retribution,53,21,32
Karimpro,emerald-dream,1221,paladin,retribution,50,20,30
Vick,zuljin,1220,paladin,retribution,24,15,9
Areaky,khazgoroth,1220,paladin,retribution,44,25,19
Imrahilaf,korialstrasz,1220,paladin,retribution,36,13,23
Andrinn,nemesis,1219,paladin,retribution,89,36,53
Naghret,area-52,1218,paladin,retribution,24,13,11
Deftonia,stormrage,1218,paladin,retribution,80,38,42
Uglymugz,area-52,1218,paladin,retribution,37,16,21
Sycomaniac,illidan,1218,paladin,retribution,35,13,22
Marshman,kelthuzad,1217,paladin,retribution,30,17,13
Thorviim,azralon,1217,paladin,retribution,54,26,28
Redeviliu,tichondrius,1217,paladin,retribution,41,15,26
Vassen,echo-isles,1216,paladin,retribution,33,16,17
Ròwdy,area-52,1214,paladin,retribution,23,13,10
Thorsmites,sargeras,1213,paladin,retribution,54,22,32
Madalynn,quelthalas,1213,paladin,retribution,60,24,36
Páláx,stormrage,1212,paladin,retribution,57,26,31
Scoopzi,frostmourne,1212,paladin,retribution,29,13,16
Pistis,kelthuzad,1212,paladin,retribution,34,13,21
Gloryana,arthas,1211,paladin,retribution,24,13,11
Wrath,frostmourne,1210,paladin,retribution,31,14,17
Armstrongz,bleeding-hollow,1210,paladin,retribution,36,13,23
Thorsenâ,sargeras,1209,paladin,retribution,33,19,14
Vanndetta,thrall,1209,paladin,retribution,38,15,23
Azëitona,azralon,1208,paladin,retribution,24,13,11
Xupalaa,azralon,1208,paladin,retribution,44,23,21
Barbaluzz,quelthalas,1207,paladin,retribution,31,16,15
Xenagos,akama,1207,paladin,retribution,30,13,17
Gwendolyynn,moon-guard,1206,paladin,retribution,40,24,16
Longinus,eredar,1206,paladin,retribution,24,13,11
Amyrana,medivh,1206,paladin,retribution,30,13,17
Noskill,moonrunner,1205,paladin,retribution,54,33,21
Bubbleöseven,agamaggan,1205,paladin,retribution,57,27,30
Skankysocks,tichondrius,1204,paladin,retribution,24,14,10
Snowcrest,cenarius,1204,paladin,retribution,88,38,50
Botïs,sargeras,1203,paladin,retribution,36,22,14
Webby,azjolnerub,1202,paladin,retribution,44,20,24
Winbott,sargeras,1202,paladin,retribution,42,13,29
Hibrael,azralon,1201,paladin,retribution,56,32,24
Stõnêdpimp,agamaggan,1201,paladin,retribution,29,13,16
Fogonaventa,nemesis,1201,paladin,retribution,66,23,43
Sturka,illidan,1199,paladin,retribution,60,29,31
Rinneblack,ragnaros,1199,paladin,retribution,30,13,17
Oathden,area-52,1198,paladin,retribution,34,18,16
Hellhawk,hellscream,1198,paladin,retribution,45,20,25
Finishearlyx,kelthuzad,1198,paladin,retribution,35,13,22
Rebukezz,dalaran,1196,paladin,retribution,29,13,16
Strobeyjr,tichondrius,1194,paladin,retribution,30,13,17
Xanamun,magtheridon,1194,paladin,retribution,30,13,17
Mandragor,borean-tundra,1193,paladin,retribution,72,41,31
Eetswaz,frostmourne,1193,paladin,retribution,36,20,16
Virrata,tichondrius,1193,paladin,retribution,26,14,12
Hoodlumz,kiljaeden,1192,paladin,retribution,24,13,11
Pikatripa,quelthalas,1192,paladin,retribution,38,17,21
Siranvil,silver-hand,1192,paladin,retribution,36,16,20
Avelane,caelestrasz,1191,paladin,retribution,70,33,37
Galaxahan,bonechewer,1191,paladin,retribution,83,37,46
Noblearthur,feathermoon,1190,paladin,retribution,24,15,9
Unsung,stormreaver,1190,paladin,retribution,47,23,24
Unicochori,drakkari,1190,paladin,retribution,35,17,18
Dinpal,tichondrius,1190,paladin,retribution,36,13,23
Imposstopzc,chogall,1189,paladin,retribution,135,65,70
Reptaur,bleeding-hollow,1185,paladin,retribution,64,31,33
Holycower,tichondrius,1182,paladin,retribution,24,15,9
Oraborra,area-52,1180,paladin,retribution,40,17,23
Dsio,bleeding-hollow,1180,paladin,retribution,34,13,21
Ezekìël,tichondrius,1179,paladin,retribution,24,15,9
Beastyone,tichondrius,1179,paladin,retribution,140,71,69
Jerseÿ,sargeras,1176,paladin,retribution,39,18,21
Cederas,sargeras,1175,paladin,retribution,60,30,30
Soledad,tichondrius,1175,paladin,retribution,36,16,20
Basstian,bleeding-hollow,1174,paladin,retribution,100,40,60
Greasy,quelthalas,1173,paladin,retribution,32,13,19
Jswyrm,quelthalas,1172,paladin,retribution,42,14,28
Schnabdain,exodar,1171,paladin,retribution,66,36,30
Scudstock,tichondrius,1171,paladin,retribution,77,38,39
Rediems,drakkari,1171,paladin,retribution,48,23,25
Crosshammer,quelthalas,1170,paladin,retribution,42,20,22
Veguê,ragnaros,1170,paladin,retribution,30,13,17
Popwingzz,sargeras,1170,paladin,retribution,66,23,43
Holyrõller,malganis,1169,paladin,retribution,30,14,16
Pengideath,barthilas,1168,paladin,retribution,30,14,16
Souljahgirl,demon-soul,1168,paladin,retribution,42,18,24
Eldirn,bleeding-hollow,1167,paladin,retribution,24,15,9
Lucigiorna,stormrage,1166,paladin,retribution,68,30,38
Hyperforce,area-52,1166,paladin,retribution,50,21,29
Vargonha,azralon,1165,paladin,retribution,102,47,55
Füriøsa,quelthalas,1163,paladin,retribution,65,30,35
Solomonss,frostmourne,1163,paladin,retribution,58,21,37
Irantir,drakkari,1162,paladin,retribution,144,65,79
Suncrashkid,nerzhul,1161,paladin,retribution,181,97,84
Thaly,shadowmoon,1161,paladin,retribution,49,20,29
Draerys,drakkari,1159,paladin,retribution,36,26,10
Anbor,azralon,1154,paladin,retribution,28,13,15
Thørîm,nazjatar,1154,paladin,retribution,36,15,21
Huavi,tichondrius,1152,paladin,retribution,18,12,6
Greatwyrm,illidan,1152,paladin,retribution,18,12,6
Furylolx,tichondrius,1152,paladin,retribution,18,12,6
Ghøjan,malganis,1152,paladin,retribution,23,15,8
Critwink,illidan,1152,paladin,retribution,21,12,9
Jdisco,bonechewer,1152,paladin,retribution,25,13,12
Pique,malganis,1152,paladin,retribution,24,12,12
Jivvy,eredar,1152,paladin,retribution,30,12,18
Ândy,zuljin,1151,paladin,retribution,18,12,6
Brotherjon,stormrage,1151,paladin,retribution,18,12,6
Cöjax,dalaran,1151,paladin,retribution,18,12,6
Cutebtw,zuljin,1151,paladin,retribution,22,13,9
Torosagrado,drakkari,1151,paladin,retribution,24,12,12
Talions,illidan,1151,paladin,retribution,24,12,12
ßrittany,gnomeregan,1151,paladin,retribution,24,12,12
Johnyfresh,jubeithos,1151,paladin,retribution,55,23,32
Softmograne,tichondrius,1151,paladin,retribution,30,12,18
Fâmed,tichondrius,1151,paladin,retribution,30,12,18
Dynamism,frostmourne,1151,paladin,retribution,30,12,18
Geospawn,tichondrius,1151,paladin,retribution,30,12,18
Dragynfist,malganis,1151,paladin,retribution,30,12,18
Goldmembër,malganis,1151,paladin,retribution,36,12,24
Alvinsane,proudmoore,1150,paladin,retribution,24,12,12
Licestr,lightbringer,1150,paladin,retribution,24,12,12
Trinade,stormrage,1150,paladin,retribution,30,12,18
Kelleybelly,black-dragonflight,1150,paladin,retribution,34,13,21
Andrixi,bonechewer,1149,paladin,retribution,18,12,6
Vaaga,quelthalas,1149,paladin,retribution,24,12,12
Yeeter,thrall,1149,paladin,retribution,24,12,12
Emisoul,sargeras,1149,paladin,retribution,30,12,18
Retosterone,stormrage,1149,paladin,retribution,30,12,18
Saffuki,frostmourne,1149,paladin,retribution,30,12,18
Kadryck,drakkari,1148,paladin,retribution,18,12,6
Daukan,quelthalas,1148,paladin,retribution,24,12,12
Locustknight,illidan,1148,paladin,retribution,24,12,12
Dontaylor,tichondrius,1148,paladin,retribution,30,12,18
Bigdpally,frostmourne,1148,paladin,retribution,36,12,24
Pocacoco,azralon,1147,paladin,retribution,22,13,9
Rickadin,bleeding-hollow,1147,paladin,retribution,22,13,9
Thirtyfivemm,area-52,1147,paladin,retribution,76,39,37
Dontsleep,magtheridon,1147,paladin,retribution,24,12,12
Arkoth,kelthuzad,1147,paladin,retribution,24,12,12
Phanna,the-forgotten-coast,1147,paladin,retribution,24,12,12
Smudgexy,frostmourne,1147,paladin,retribution,30,12,18
Rohad,thrall,1147,paladin,retribution,30,12,18
Saifollah,area-52,1147,paladin,retribution,36,12,24
Deathodin,tichondrius,1146,paladin,retribution,24,12,12
Mongerr,drakkari,1146,paladin,retribution,24,12,12
Ireckon,stormrage,1146,paladin,retribution,24,12,12
Røshea,hydraxis,1146,paladin,retribution,24,12,12
Strattaltork,ragnaros,1146,paladin,retribution,24,12,12
Marhaus,emerald-dream,1146,paladin,retribution,24,12,12
Mikehawkhuge,area-52,1146,paladin,retribution,60,26,34
Adathan,ghostlands,1146,paladin,retribution,30,12,18
Cathode,area-52,1145,paladin,retribution,24,12,12
Mateeka,malganis,1145,paladin,retribution,30,12,18
Bigblackbull,whisperwind,1144,paladin,retribution,24,12,12
Riggen,thrall,1144,paladin,retribution,30,12,18
Lightshope,coilfang,1143,paladin,retribution,18,12,6
Elbigboy,tichondrius,1143,paladin,retribution,95,48,47
Joeseph,stormrage,1143,paladin,retribution,30,12,18
Seongje,tichondrius,1143,paladin,retribution,39,13,26
Stormwinter,azralon,1143,paladin,retribution,36,12,24
Thal,silvermoon,1142,paladin,retribution,42,21,21
Oniizuna,thrall,1142,paladin,retribution,24,12,12
Ginbirdup,kelthuzad,1141,paladin,retribution,18,12,6
Swiftxheal,stormrage,1141,paladin,retribution,24,12,12
Kegmight,emerald-dream,1141,paladin,retribution,59,22,37
Beachyo,tichondrius,1140,paladin,retribution,18,12,6
Bingbingcd,tichondrius,1140,paladin,retribution,30,13,17
Atreuss,moon-guard,1139,paladin,retribution,60,34,26
Babyshuangs,illidan,1139,paladin,retribution,24,12,12
Athenax,area-52,1139,paladin,retribution,24,12,12
Rektodin,tichondrius,1139,paladin,retribution,30,12,18
Victidin,quelthalas,1138,paladin,retribution,24,12,12
Indemnity,wildhammer,1138,paladin,retribution,36,12,24
Gläd,tichondrius,1137,paladin,retribution,18,12,6
Brahion,icecrown,1137,paladin,retribution,62,33,29
Olsen,stormrage,1137,paladin,retribution,24,12,12
Sarkorius,moon-guard,1137,paladin,retribution,24,12,12
Mágna,illidan,1137,paladin,retribution,24,12,12
Ðrâgøønz,ragnaros,1137,paladin,retribution,24,12,12
Gavrill,thrall,1137,paladin,retribution,30,13,17
Narcolepso,azralon,1137,paladin,retribution,30,12,18
Haiyaa,frostwolf,1137,paladin,retribution,66,25,41
Drekgor,drakkari,1136,paladin,retribution,42,21,21
Soyafed,mugthol,1135,paladin,retribution,58,30,28
Vejita,frostmourne,1135,paladin,retribution,24,12,12
Holygerp,darrowmere,1134,paladin,retribution,30,18,12
Vynlorderan,area-52,1134,paladin,retribution,24,12,12
Scyni,kelthuzad,1134,paladin,retribution,37,15,22
Ranthoril,hydraxis,1133,paladin,retribution,15,13,2
Hanno,azshara,1132,paladin,retribution,18,12,6
Meltedcheese,destromath,1132,paladin,retribution,30,15,15
Ðß,arthas,1132,paladin,retribution,30,13,17
Jeinova,barthilas,1131,paladin,retribution,123,70,53
Durothar,dalaran,1131,paladin,retribution,48,26,22
Ringout,tichondrius,1131,paladin,retribution,24,12,12
Dynamais,barthilas,1131,paladin,retribution,72,28,44
Nuisances,illidan,1130,paladin,retribution,42,27,15
Joelanson,blood-furnace,1130,paladin,retribution,54,29,25
Jdn,ysera,1130,paladin,retribution,60,29,31
Salasong,hellscream,1129,paladin,retribution,60,20,40
Stepurgameup,ghostlands,1128,paladin,retribution,54,29,25
Arun,arthas,1128,paladin,retribution,33,15,18
Follower,sargeras,1128,paladin,retribution,83,35,48
Gamber,frostmourne,1127,paladin,retribution,38,16,22
Ducii,stormrage,1126,paladin,retribution,46,22,24
Goldfînger,zuljin,1126,paladin,retribution,36,14,22
Redyomi,drakkari,1126,paladin,retribution,36,13,23
Sparkchaser,proudmoore,1125,paladin,retribution,24,12,12
Newerlight,tichondrius,1124,paladin,retribution,25,13,12
Reivilly,azralon,1124,paladin,retribution,30,13,17
Cowhair,tichondrius,1123,paladin,retribution,29,12,17
Palavittar,azralon,1122,paladin,retribution,23,13,10
Dannoruk,ragnaros,1121,paladin,retribution,30,12,18
Shadowarius,aerie-peak,1118,paladin,retribution,84,39,45
Baloria,stormrage,1117,paladin,retribution,22,12,10
Necrodar,ragnaros,1116,paladin,retribution,26,16,10
Zaklehblue,daggerspine,1116,paladin,retribution,114,51,63
Epòc,frostmourne,1116,paladin,retribution,32,13,19
Deathwyz,thunderlord,1116,paladin,retribution,36,14,22
Xcream,nemesis,1116,paladin,retribution,38,13,25
Yenkmeilleur,zuljin,1115,paladin,retribution,24,13,11
Statícx,ragnaros,1115,paladin,retribution,133,58,75
Diablosgrim,stormrage,1114,paladin,retribution,24,18,6
Streetsaint,frostmourne,1114,paladin,retribution,66,32,34
Hashmaal,tichondrius,1114,paladin,retribution,60,29,31
Adelsman,quelthalas,1113,paladin,retribution,30,14,16
Cheesetitan,tichondrius,1109,paladin,retribution,81,37,44
Drágons,stormrage,1109,paladin,retribution,72,30,42
Wilmâ,ragnaros,1109,paladin,retribution,30,12,18
Zir,frostmourne,1108,paladin,retribution,53,28,25
Rcon,khadgar,1107,paladin,retribution,24,13,11
Pardan,tichondrius,1106,paladin,retribution,24,12,12
Gilmax,emerald-dream,1106,paladin,retribution,30,14,16
Greatgirthy,hyjal,1106,paladin,retribution,30,13,17
Vanillur,tichondrius,1103,paladin,retribution,55,24,31
Gtate,azjolnerub,1102,paladin,retribution,23,12,11
Decareos,tichondrius,1102,paladin,retribution,29,12,17
Driuling,frostmourne,1102,paladin,retribution,54,20,34
Thanatiel,area-52,1099,paladin,retribution,71,39,32
Gämä,azralon,1099,paladin,retribution,36,16,20
Volorick,dalaran,1099,paladin,retribution,44,18,26
Kaysonso,thunderlord,1098,paladin,retribution,55,19,36
Soukaa,illidan,1097,paladin,retribution,23,12,11
Gorgrand,gorgonnash,1097,paladin,retribution,39,14,25
Holladrik,frostmourne,1096,paladin,retribution,36,12,24
Lucifuge,twisting-nether,1095,paladin,retribution,18,12,6
Holyzeen,darkspear,1095,paladin,retribution,34,22,12
Savagefck,sargeras,1094,paladin,retribution,33,19,14
Aowynd,tichondrius,1094,paladin,retribution,79,39,40
Rétribution,farstriders,1094,paladin,retribution,52,24,28
Riggar,uther,1094,paladin,retribution,77,31,46
Kittylickers,tichondrius,1092,paladin,retribution,108,56,52
Omenix,laughing-skull,1091,paladin,retribution,29,12,17
Holyfunsack,frostmourne,1089,paladin,retribution,20,13,7
Mcbraín,quelthalas,1089,paladin,retribution,30,12,18
Alairius,tichondrius,1087,paladin,retribution,23,15,8
Killumminati,tichondrius,1087,paladin,retribution,21,13,8
Pldd,tichondrius,1087,paladin,retribution,76,33,43
Mybadfoo,lethon,1085,paladin,retribution,18,13,5
Sanctïon,bleeding-hollow,1085,paladin,retribution,23,12,11
Salvations,queldorei,1085,paladin,retribution,60,30,30
Darkknes,quelthalas,1085,paladin,retribution,47,22,25
Bubblegums,nagrand,1084,paladin,retribution,69,39,30
Grimhammer,the-scryers,1083,paladin,retribution,61,31,30
Narthres,drakkari,1083,paladin,retribution,34,12,22
Slar,emerald-dream,1082,paladin,retribution,30,13,17
Sandicang,azuremyst,1079,paladin,retribution,60,29,31
Eliasor,illidan,1077,paladin,retribution,18,13,5
Lízandor,ragnaros,1077,paladin,retribution,17,12,5
Phankro,quelthalas,1077,paladin,retribution,24,13,11
Warswordz,stormrage,1077,paladin,retribution,40,16,24
Clefairy,arathor,1076,paladin,retribution,39,23,16
Navex,tichondrius,1076,paladin,retribution,22,12,10
Missoutale,aerie-peak,1074,paladin,retribution,88,38,50
Jonsnou,tol-barad,1074,paladin,retribution,36,14,22
Zorkus,turalyon,1073,paladin,retribution,42,22,20
Kaidao,black-dragonflight,1073,paladin,retribution,26,13,13
Trappadin,sargeras,1073,paladin,retribution,47,22,25
Aladid,aggramar,1071,paladin,retribution,65,35,30
Eddardstark,agamaggan,1070,paladin,retribution,74,32,42
Pleasureman,gallywix,1067,paladin,retribution,30,15,15
Krønos,nordrassil,1067,paladin,retribution,40,16,24
Heiinneken,queldorei,1065,paladin,retribution,20,12,8
Zela,ghostlands,1065,paladin,retribution,29,12,17
Morddrohung,hyjal,1063,paladin,retribution,18,12,6
Rspect,trollbane,1062,paladin,retribution,17,12,5
Damorte,ragnaros,1060,paladin,retribution,42,18,24
Anyatay,ragnaros,1060,paladin,retribution,77,28,49
Andras,emerald-dream,1059,paladin,retribution,22,12,10
Dweezill,daggerspine,1059,paladin,retribution,28,14,14
Saamuus,quelthalas,1059,paladin,retribution,71,27,44
Caitlyn,nazjatar,1058,paladin,retribution,30,17,13
Lessera,tichondrius,1057,paladin,retribution,26,12,14
Retsupreme,tichondrius,1056,paladin,retribution,18,11,7
Pals,bronzebeard,1056,paladin,retribution,18,11,7
Zözo,zuljin,1056,paladin,retribution,18,11,7
Makayla,kiljaeden,1056,paladin,retribution,24,11,13
Hardnow,emerald-dream,1056,paladin,retribution,24,11,13
Imcjq,tichondrius,1056,paladin,retribution,24,11,13
Tiduz,tichondrius,1056,paladin,retribution,24,11,13
Siq,arthas,1056,paladin,retribution,30,11,19
Wogharder,stormrage,1056,paladin,retribution,30,11,19
Bakednub,malganis,1056,paladin,retribution,35,11,24
Volcathos,moon-guard,1055,paladin,retribution,18,11,7
Soulyholy,tichondrius,1055,paladin,retribution,18,11,7
Ärlex,moon-guard,1055,paladin,retribution,21,12,9
Thrandeill,bleeding-hollow,1055,paladin,retribution,24,11,13
Sóláris,moon-guard,1055,paladin,retribution,24,11,13
Armstrong,azralon,1055,paladin,retribution,24,11,13
Jakkatähn,malganis,1055,paladin,retribution,24,11,13
Koreancannon,tichondrius,1055,paladin,retribution,27,12,15
Pugnacity,stormrage,1055,paladin,retribution,30,11,19
Noxcy,area-52,1054,paladin,retribution,18,11,7
Safename,area-52,1054,paladin,retribution,18,11,7
Grimven,stormrage,1054,paladin,retribution,18,11,7
Gannecus,bleeding-hollow,1054,paladin,retribution,18,11,7
Hrota,laughing-skull,1054,paladin,retribution,18,11,7
Telvannî,sargeras,1054,paladin,retribution,24,11,13
Jeralldo,ragnaros,1054,paladin,retribution,24,11,13
Arena,mannoroth,1054,paladin,retribution,24,11,13
Protarena,zuljin,1054,paladin,retribution,24,11,13
Cheesy,frostmourne,1054,paladin,retribution,30,11,19
Theehopper,shandris,1054,paladin,retribution,30,11,19
Varaben,sargeras,1054,paladin,retribution,36,11,25
Nutonhands,moon-guard,1053,paladin,retribution,18,11,7
Irushthots,tichondrius,1053,paladin,retribution,18,11,7
Ðreschí,ragnaros,1053,paladin,retribution,22,11,11
Divineknight,moonrunner,1053,paladin,retribution,24,11,13
Vincible,illidan,1053,paladin,retribution,24,11,13
Dithfeo,tichondrius,1053,paladin,retribution,30,11,19
Invictus,onyxia,1052,paladin,retribution,18,11,7
Cripplemakër,stormrage,1052,paladin,retribution,18,11,7
Vynesonia,emerald-dream,1052,paladin,retribution,21,12,9
Vorne,tortheldrin,1052,paladin,retribution,25,11,14
Jåckél,wyrmrest-accord,1052,paladin,retribution,30,11,19
Iesous,kiljaeden,1051,paladin,retribution,18,11,7
Exulta,illidan,1051,paladin,retribution,60,32,28
Dominance,blackrock,1051,paladin,retribution,24,11,13
Sleekz,moon-guard,1051,paladin,retribution,24,11,13
Daeriius,moon-guard,1051,paladin,retribution,24,11,13
Holyplaise,tichondrius,1051,paladin,retribution,24,11,13
Hermacles,stormrage,1051,paladin,retribution,25,11,14
Libertylol,tichondrius,1051,paladin,retribution,28,12,16
Caonizumu,area-52,1051,paladin,retribution,30,11,19
Taurendin,frostmourne,1050,paladin,retribution,18,11,7
Vankaer,uldum,1050,paladin,retribution,18,11,7
Kaélthas,eonar,1050,paladin,retribution,24,11,13
Tacohuntter,stormrage,1050,paladin,retribution,24,11,13
Ridethispony,tichondrius,1050,paladin,retribution,44,13,31
Ødin,turalyon,1049,paladin,retribution,18,11,7
Freÿdis,tichondrius,1049,paladin,retribution,18,11,7
Camcam,thrall,1049,paladin,retribution,18,11,7
Bebedor,azralon,1049,paladin,retribution,21,11,10
Tharkeves,cenarius,1049,paladin,retribution,28,13,15
Gringi,blackrock,1049,paladin,retribution,24,11,13
Amlovích,quelthalas,1049,paladin,retribution,24,11,13
Mangguo,tichondrius,1049,paladin,retribution,24,11,13
Wingalings,malganis,1049,paladin,retribution,28,12,16
Morghelm,stormrage,1048,paladin,retribution,12,11,1
Lïgma,dalaran,1048,paladin,retribution,18,11,7
Jajabola,zuljin,1048,paladin,retribution,24,11,13
Rönän,sargeras,1048,paladin,retribution,32,14,18
Astralweed,quelthalas,1048,paladin,retribution,79,30,49
Dorka,illidan,1048,paladin,retribution,30,11,19
Tieberion,bleeding-hollow,1048,paladin,retribution,30,11,19
Teewrecks,frostmourne,1048,paladin,retribution,30,11,19
Lowkeyy,tichondrius,1047,paladin,retribution,18,11,7
Everyni,area-52,1047,paladin,retribution,18,11,7
Grim,eonar,1047,paladin,retribution,24,11,13
Checkeettpal,sargeras,1047,paladin,retribution,24,11,13
Bigboytime,area-52,1047,paladin,retribution,29,13,16
Karelys,area-52,1047,paladin,retribution,26,11,15
Jinfandi,gurubashi,1047,paladin,retribution,54,22,32
Stonekey,warsong,1046,paladin,retribution,18,11,7
Kiboko,tichondrius,1046,paladin,retribution,19,11,8
Pickypally,moon-guard,1046,paladin,retribution,55,30,25
Lunchboxz,nazjatar,1046,paladin,retribution,24,11,13
Flashbang,nazgrel,1046,paladin,retribution,30,11,19
Brightfire,dawnbringer,1046,paladin,retribution,42,15,27
Doogo,cenarius,1045,paladin,retribution,18,11,7
Souiler,thunderlord,1045,paladin,retribution,22,12,10
Chilenoman,ragnaros,1045,paladin,retribution,54,25,29
Guji,jubeithos,1045,paladin,retribution,24,11,13
Kènjii,sargeras,1044,paladin,retribution,40,20,20
Billnighy,alleria,1044,paladin,retribution,84,39,45
Rensvall,frostmourne,1043,paladin,retribution,24,13,11
Biblestomp,laughing-skull,1042,paladin,retribution,18,11,7
Pallyjs,anetheron,1042,paladin,retribution,18,11,7
Berthalas,stormrage,1042,paladin,retribution,18,11,7
Brocolinî,zuljin,1042,paladin,retribution,24,11,13
Ilumine,mannoroth,1041,paladin,retribution,24,11,13
Dragonbait,khadgar,1038,paladin,retribution,24,11,13
Ceebuck,thrall,1038,paladin,retribution,24,11,13
Pittypally,bleeding-hollow,1038,paladin,retribution,25,11,14
Wasimodo,emerald-dream,1037,paladin,retribution,90,43,47
Bainn,nerzhul,1033,paladin,retribution,49,28,21
Mortika,frostmourne,1033,paladin,retribution,36,17,19
Kryzshine,frostmourne,1030,paladin,retribution,18,11,7
Dreadain,gilneas,1027,paladin,retribution,24,11,13
Micurs,hyjal,1027,paladin,retribution,36,11,25
Murtsza,ragnaros,1026,paladin,retribution,66,24,42
Leennoox,quelthalas,1025,paladin,retribution,50,24,26
Kapaw,windrunner,1023,paladin,retribution,24,12,12
Bullpaladin,barthilas,1023,paladin,retribution,23,11,12
Leyon,alterac-mountains,1022,paladin,retribution,24,12,12
Bradoxx,thorium-brotherhood,1021,paladin,retribution,96,48,48
Retartin,kelthuzad,1021,paladin,retribution,26,12,14
Moraxeus,gundrak,1020,paladin,retribution,18,11,7
Theseuus,stormrage,1020,paladin,retribution,60,27,33
Wunderbread,dalaran,1020,paladin,retribution,29,11,18
Furnost,drenden,1019,paladin,retribution,23,11,12
Zägä,quelthalas,1015,paladin,retribution,34,12,22
Sponce,kirin-tor,1015,paladin,retribution,42,11,31
Sisterbubble,dathremar,1013,paladin,retribution,29,11,18
Dirtfunk,illidan,1011,paladin,retribution,48,18,30
Nejie,nazjatar,1009,paladin,retribution,42,21,21
Tuff,ysera,1008,paladin,retribution,36,21,15
Keu,emerald-dream,1008,paladin,retribution,63,26,37
Judgingu,proudmoore,1006,paladin,retribution,27,11,16
Kealthamar,wyrmrest-accord,1005,paladin,retribution,16,12,4
Pappábear,tichondrius,1005,paladin,retribution,32,17,15
Loween,thunderlord,1002,paladin,retribution,54,22,32
Zentrick,whisperwind,1000,paladin,retribution,65,31,34
Hølydiver,rivendare,998,paladin,retribution,34,14,20
Smithulu,kelthuzad,997,paladin,retribution,45,24,21
Retgasm,drakthul,997,paladin,retribution,22,11,11
Tyrswrath,sargeras,992,paladin,retribution,36,19,17
Bigsamtp,laughing-skull,992,paladin,retribution,23,11,12
Whitepally,kiljaeden,992,paladin,retribution,28,11,17
Iammj,skywall,990,paladin,retribution,17,11,6
Ssparkk,stormrage,989,paladin,retribution,35,12,23
Veroth,caelestrasz,988,paladin,retribution,26,11,15
Lêe,dalaran,987,paladin,retribution,15,12,3
Amorimbr,area-52,985,paladin,retribution,29,11,18
Playandrunn,illidan,984,paladin,retribution,22,11,11
Willhookah,azralon,982,paladin,retribution,60,26,34
Fenfrineflo,azralon,978,paladin,retribution,48,14,34
Vinjonc,drenden,977,paladin,retribution,60,30,30
Kpopsicle,frostmourne,974,paladin,retribution,17,11,6
Hammerhitter,lightbringer,972,paladin,retribution,36,14,22
Cès,tichondrius,960,paladin,retribution,12,10,2
Bigfkndam,dathremar,960,paladin,retribution,12,10,2
Zelowrath,emerald-dream,960,paladin,retribution,12,10,2
Meridional,tichondrius,960,paladin,retribution,18,10,8
Eloinflated,malganis,960,paladin,retribution,18,10,8
Ripsader,stormrage,960,paladin,retribution,18,10,8
Èmmà,stormrage,960,paladin,retribution,18,10,8
Meleegodx,darkspear,960,paladin,retribution,18,10,8
Khanid,emerald-dream,960,paladin,retribution,18,10,8
Überlin,whisperwind,960,paladin,retribution,18,10,8
Hyphenated,frostmourne,960,paladin,retribution,18,10,8
Emiaru,illidan,960,paladin,retribution,22,11,11
Fumaçaa,nemesis,960,paladin,retribution,27,13,14
Alodor,dalaran,960,paladin,retribution,24,10,14
Komonai,illidan,960,paladin,retribution,24,10,14
Friendfriend,proudmoore,960,paladin,retribution,24,10,14
Miketavius,moon-guard,960,paladin,retribution,24,10,14
Legèndaïry,tichondrius,960,paladin,retribution,24,10,14
Talionz,illidan,960,paladin,retribution,24,10,14
Layson,uldum,960,paladin,retribution,24,10,14
Porxhux,tichondrius,960,paladin,retribution,24,10,14
Ohmyglob,bleeding-hollow,960,paladin,retribution,24,10,14
Gompa,bleeding-hollow,960,paladin,retribution,30,10,20
Laurenlight,tichondrius,960,paladin,retribution,36,10,26
Bop,azralon,959,paladin,retribution,12,10,2
Kaydenkross,azralon,959,paladin,retribution,18,11,7
Yugawn,maiev,959,paladin,retribution,18,10,8
Lawzaddy,tichondrius,959,paladin,retribution,18,10,8
Lightsheart,lightbringer,959,paladin,retribution,18,10,8
Uprisen,daggerspine,959,paladin,retribution,18,10,8
Kaetix,frostmourne,959,paladin,retribution,18,10,8
Andriaana,moon-guard,959,paladin,retribution,18,10,8
Lyghts,darkspear,959,paladin,retribution,18,10,8
ßöbby,sargeras,959,paladin,retribution,18,10,8
Kayaman,tichondrius,959,paladin,retribution,18,10,8
Astraelon,bleeding-hollow,959,paladin,retribution,18,10,8
Bruxx,twisting-nether,959,paladin,retribution,18,10,8
Daeyang,tichondrius,959,paladin,retribution,18,10,8
Zetka,tichondrius,959,paladin,retribution,24,10,14
Roddaric,nerzhul,959,paladin,retribution,24,10,14
Déathkiing,area-52,959,paladin,retribution,24,10,14
Tazanian,aegwynn,959,paladin,retribution,24,10,14
Onixx,kargath,959,paladin,retribution,30,10,20
Digider,area-52,959,paladin,retribution,36,10,26
Littlebadbad,tichondrius,958,paladin,retribution,12,10,2
Masemune,bonechewer,958,paladin,retribution,18,10,8
Noitra,azralon,958,paladin,retribution,18,10,8
Svenn,eredar,958,paladin,retribution,18,10,8
Zyden,hellscream,958,paladin,retribution,18,10,8
Lilnattyy,area-52,958,paladin,retribution,18,10,8
Sathras,madoran,958,paladin,retribution,18,10,8
Kegman,thrall,958,paladin,retribution,18,10,8
Deadpoolman,emerald-dream,958,paladin,retribution,18,10,8
Benevolént,area-52,958,paladin,retribution,24,10,14
Holyshifts,exodar,958,paladin,retribution,24,10,14
Korranix,sargeras,958,paladin,retribution,28,11,17
Fokatayew,korialstrasz,958,paladin,retribution,30,10,20
Donmi,dalaran,957,paladin,retribution,15,11,4
Retxmack,lightnings-blade,957,paladin,retribution,24,10,14
Petunias,malganis,957,paladin,retribution,30,10,20
Pallyfreddyy,frostmourne,957,paladin,retribution,30,10,20
Vulkaros,azralon,956,paladin,retribution,12,10,2
Vacoro,tichondrius,956,paladin,retribution,18,10,8
Caylorn,illidan,956,paladin,retribution,18,10,8
Reinharth,quelthalas,956,paladin,retribution,18,10,8
Ryumi,lightbringer,956,paladin,retribution,24,10,14
Ollyollyawks,bloodscalp,956,paladin,retribution,30,10,20
Ballsmcgee,bleeding-hollow,956,paladin,retribution,36,10,26
Elhoj81FDE7,illidan,955,paladin,retribution,18,10,8
Runscapemain,feathermoon,955,paladin,retribution,22,11,11
Ailo,nemesis,955,paladin,retribution,24,10,14
Sonicblazer,darrowmere,955,paladin,retribution,24,10,14
Flyinpankake,illidan,955,paladin,retribution,24,10,14
Ashbrînger,emerald-dream,955,paladin,retribution,30,10,20
Torujo,drakkari,954,paladin,retribution,18,10,8
Lunchboxpaly,stormrage,954,paladin,retribution,18,10,8
Cacaine,goldrinn,954,paladin,retribution,21,11,10
Ranknoob,khazgoroth,954,paladin,retribution,24,10,14
Sòl,stormrage,954,paladin,retribution,24,10,14
Kelenis,bonechewer,954,paladin,retribution,24,10,14
Tomcat,bladefist,954,paladin,retribution,24,10,14
Didymus,boulderfist,954,paladin,retribution,41,17,24
Llght,hydraxis,952,paladin,retribution,18,10,8
Aura,stormreaver,952,paladin,retribution,18,10,8
Exeneyder,elune,952,paladin,retribution,25,10,15
Buslightyear,azralon,952,paladin,retribution,30,10,20
Housemix,gurubashi,951,paladin,retribution,18,12,6
Giancenna,illidan,950,paladin,retribution,18,10,8
Aewein,ragnaros,950,paladin,retribution,23,10,13
Lionag,ragnaros,950,paladin,retribution,24,10,14
Xhotbutters,korgath,945,paladin,retribution,31,13,18
Millicentt,quelthalas,944,paladin,retribution,23,11,12
Deltajk,drakkari,943,paladin,retribution,48,25,23
Taego,tichondrius,943,paladin,retribution,23,10,13
Lailaa,balnazzar,940,paladin,retribution,32,15,17
Charopiinho,azralon,938,paladin,retribution,30,10,20
Aetol,proudmoore,938,paladin,retribution,30,10,20
Pallydin,smolderthorn,936,paladin,retribution,30,15,15
Sanctum,barthilas,936,paladin,retribution,153,72,81
Cuthroat,area-52,933,paladin,retribution,384,189,195
Nikanikanomi,tichondrius,931,paladin,retribution,23,12,11
Bigjwpb,illidan,929,paladin,retribution,256,122,134
Cherrypally,area-52,927,paladin,retribution,23,10,13
Tacoroll,tichondrius,927,paladin,retribution,36,10,26
Nerfret,zuljin,926,paladin,retribution,14,11,3
Celerios,stormreaver,926,paladin,retribution,19,11,8
Luluwu,stormrage,926,paladin,retribution,19,10,9
Tayvar,stormrage,925,paladin,retribution,14,11,3
Freewilly,illidan,924,paladin,retribution,23,10,13
Biggin,garona,924,paladin,retribution,142,54,88
Bukkning,tichondrius,922,paladin,retribution,58,17,41
Pallyoh,moknathal,921,paladin,retribution,41,23,18
Vengecide,proudmoore,920,paladin,retribution,24,13,11
Kokuryuha,quelthalas,919,paladin,retribution,58,27,31
Diësëlsmoke,bronzebeard,917,paladin,retribution,18,10,8
Slædgæhæmmær,bonechewer,917,paladin,retribution,42,13,29
Brandforge,thunderlord,916,paladin,retribution,18,10,8
Goldranger,hakkar,916,paladin,retribution,42,22,20
Appolas,shattered-hand,915,paladin,retribution,18,10,8
Elgigante,azshara,914,paladin,retribution,48,25,23
Avlystein,wyrmrest-accord,914,paladin,retribution,89,29,60
Alpine,nordrassil,911,paladin,retribution,120,58,62
Taéyeon,quelthalas,911,paladin,retribution,21,10,11
Stinaz,quelthalas,911,paladin,retribution,23,10,13
Heathen,spirestone,910,paladin,retribution,15,10,5
Toepuller,doomhammer,905,paladin,retribution,66,32,34
Lilsquirt,proudmoore,901,paladin,retribution,23,14,9
Kilidin,illidan,899,paladin,retribution,21,10,11
Iralyn,frostmane,899,paladin,retribution,24,10,14
Denthor,lightbringer,894,paladin,retribution,20,10,10
Àmárìs,tichondrius,882,paladin,retribution,22,10,12
Releváncé,frostmourne,879,paladin,retribution,33,10,23
Allandaa,frostmourne,878,paladin,retribution,25,10,15
Dragollias,anvilmar,874,paladin,retribution,30,10,20
Jonnywick,duskwood,872,paladin,retribution,36,13,23
Reti,ursin,871,paladin,retribution,205,100,105
Juang,arthas,866,paladin,retribution,54,24,30
Palagan,frostmourne,864,paladin,retribution,12,9,3
Chrigpal,tichondrius,864,paladin,retribution,12,9,3
Akumasakana,earthen-ring,864,paladin,retribution,12,9,3
Skinnipeen,frostmourne,864,paladin,retribution,12,9,3
Sonô,sargeras,864,paladin,retribution,12,9,3
Divenelena,sargeras,864,paladin,retribution,12,9,3
Arimae,turalyon,864,paladin,retribution,12,9,3
Arukan,ragnaros,864,paladin,retribution,12,9,3
Slivkoff,wyrmrest-accord,864,paladin,retribution,12,9,3
Naughtygames,area-52,864,paladin,retribution,12,9,3
Notprot,zuljin,864,paladin,retribution,12,9,3
Raggnarokk,kelthuzad,864,paladin,retribution,12,9,3
Swegswog,frostmourne,864,paladin,retribution,12,9,3
Crimsonjudge,sargeras,864,paladin,retribution,18,9,9
Wogyu,area-52,864,paladin,retribution,18,9,9
Nite,thrall,864,paladin,retribution,18,9,9
Depøpulatìng,moon-guard,864,paladin,retribution,18,9,9
Zzerox,ragnaros,864,paladin,retribution,18,9,9
Héber,nemesis,864,paladin,retribution,18,9,9
Beefdaddyx,tichondrius,864,paladin,retribution,18,9,9
Rockdeath,sargeras,864,paladin,retribution,18,9,9
Brohtato,area-52,864,paladin,retribution,18,9,9
Strodvarn,proudmoore,864,paladin,retribution,18,9,9
Flavor,cairne,864,paladin,retribution,18,9,9
Bigdixss,tichondrius,864,paladin,retribution,18,9,9
Yáhtzee,tichondrius,864,paladin,retribution,22,10,12
Althsar,thunderlord,864,paladin,retribution,26,11,15
Stoof,arygos,864,paladin,retribution,24,9,15
Hulfsark,stormrage,864,paladin,retribution,24,9,15
Bageru,gnomeregan,864,paladin,retribution,24,9,15
Valinorean,nemesis,864,paladin,retribution,24,9,15
Ownedcrazy,stormrage,864,paladin,retribution,24,9,15
Traevel,moon-guard,864,paladin,retribution,24,9,15
Yowanehaku,illidan,864,paladin,retribution,24,9,15
Manryux,tichondrius,864,paladin,retribution,24,9,15
Dentonio,illidan,864,paladin,retribution,24,9,15
Lânnâ,tichondrius,864,paladin,retribution,24,9,15
Saintgeórge,frostmourne,864,paladin,retribution,25,9,16
Pallyofhell,area-52,863,paladin,retribution,12,9,3
Mightymagnus,silvermoon,863,paladin,retribution,12,9,3
Zára,eitrigg,863,paladin,retribution,12,9,3
Mightythorxx,tichondrius,863,paladin,retribution,12,9,3
Lenlaar,shadowsong,863,paladin,retribution,12,9,3
Beepsmash,executus,863,paladin,retribution,12,9,3
Veliona,thaurissan,863,paladin,retribution,12,9,3
Escanøor,stormrage,863,paladin,retribution,18,9,9
Oynx,emerald-dream,863,paladin,retribution,18,9,9
Wimans,quelthalas,863,paladin,retribution,18,9,9
Hailsatans,ragnaros,863,paladin,retribution,18,9,9
Valandur,kelthuzad,863,paladin,retribution,18,9,9
Wideloadphd,malganis,863,paladin,retribution,18,9,9
Relsetta,sargeras,863,paladin,retribution,18,9,9
Cratos,nemesis,863,paladin,retribution,18,9,9
Semamnohands,illidan,863,paladin,retribution,18,9,9
Ltt,dalaran,863,paladin,retribution,18,9,9
Hammertime,boulderfist,863,paladin,retribution,18,9,9
Enril,azgalor,863,paladin,retribution,18,9,9
Fermion,illidan,863,paladin,retribution,18,9,9
Drinkn,kelthuzad,863,paladin,retribution,18,9,9
Thüridan,azralon,863,paladin,retribution,18,9,9
Avacii,illidan,863,paladin,retribution,18,9,9
Holyweaponz,sargeras,863,paladin,retribution,18,9,9
Longtai,proudmoore,863,paladin,retribution,18,9,9
Dreamlightz,tichondrius,863,paladin,retribution,18,9,9
Wálker,ragnaros,863,paladin,retribution,18,9,9
Ironprice,tichondrius,863,paladin,retribution,18,9,9
Bolthore,wyrmrest-accord,863,paladin,retribution,18,9,9
Loocille,frostmourne,863,paladin,retribution,18,9,9
Ahzalon,azralon,863,paladin,retribution,18,9,9
Loraven,wyrmrest-accord,863,paladin,retribution,18,9,9
Jhaann,tichondrius,863,paladin,retribution,18,9,9
Exorcìst,barthilas,863,paladin,retribution,18,9,9
Mohrdeth,bonechewer,863,paladin,retribution,18,9,9
Paliwarrior,illidan,863,paladin,retribution,18,9,9
Abregut,ragnaros,863,paladin,retribution,24,9,15
Nuuska,dalaran,863,paladin,retribution,24,9,15
Stricken,kul-tiras,863,paladin,retribution,24,9,15
Zippzyx,tichondrius,863,paladin,retribution,24,9,15
Wreathy,sargeras,863,paladin,retribution,24,9,15
Trevion,malganis,863,paladin,retribution,24,9,15
Roländ,thrall,863,paladin,retribution,24,9,15
Amntir,sargeras,863,paladin,retribution,24,9,15
Rivzx,tichondrius,863,paladin,retribution,24,9,15
Galadriele,zuljin,863,paladin,retribution,24,9,15
Thickdam,korgath,863,paladin,retribution,24,9,15
Delvious,proudmoore,863,paladin,retribution,24,9,15
Deddy,malganis,863,paladin,retribution,30,9,21
Tenethor,area-52,863,paladin,retribution,30,9,21
Zerohöur,emerald-dream,863,paladin,retribution,30,9,21
Zrkoria,ragnaros,863,paladin,retribution,36,9,27
Keiora,sargeras,862,paladin,retribution,12,9,3
Ástedór,ragnaros,862,paladin,retribution,12,9,3
Badboí,azralon,862,paladin,retribution,12,9,3
Fante,alleria,862,paladin,retribution,16,10,6
Naritan,greymane,862,paladin,retribution,18,9,9
Omegaziion,garrosh,862,paladin,retribution,18,9,9
Pinelli,aegwynn,862,paladin,retribution,18,9,9
Lightblade,stormrage,862,paladin,retribution,18,9,9
Illëst,stormrage,862,paladin,retribution,18,9,9
Darksaint,hellscream,862,paladin,retribution,18,9,9
Rocknpally,icecrown,862,paladin,retribution,18,9,9
Surrogat,ragnaros,862,paladin,retribution,18,9,9
Xlnc,illidan,862,paladin,retribution,18,9,9
Santamuerte,firetree,862,paladin,retribution,18,9,9
Aeoliá,moon-guard,862,paladin,retribution,18,9,9
Boogerred,korialstrasz,862,paladin,retribution,24,9,15
Aewynn,nemesis,862,paladin,retribution,24,9,15
Gerian,altar-of-storms,862,paladin,retribution,24,9,15
Moosgo,emerald-dream,862,paladin,retribution,24,9,15
Starski,korgath,862,paladin,retribution,24,9,15
Ashric,moon-guard,862,paladin,retribution,24,9,15
Kelimir,dathremar,861,paladin,retribution,12,9,3
Stevas,khazgoroth,861,paladin,retribution,12,9,3
Borélock,kelthuzad,861,paladin,retribution,18,9,9
Aerandír,stormrage,861,paladin,retribution,18,9,9
Yuliu,magtheridon,861,paladin,retribution,18,9,9
Darawin,korgath,861,paladin,retribution,18,9,9
Loctár,tichondrius,861,paladin,retribution,18,9,9
Guttis,nemesis,861,paladin,retribution,18,9,9
Clamhammer,malganis,861,paladin,retribution,18,9,9
Kommuna,stormscale,861,paladin,retribution,18,9,9
Rennalux,stormrage,861,paladin,retribution,24,9,15
Deztrom,dalaran,860,paladin,retribution,12,9,3
Punjabeast,illidan,860,paladin,retribution,16,10,6
Majinpal,illidan,860,paladin,retribution,24,9,15
Unholypally,suramar,860,paladin,retribution,24,9,15
Rusticles,aerie-peak,860,paladin,retribution,24,9,15
Lexdor,quelthalas,860,paladin,retribution,30,9,21
Khetzi,thunderhorn,859,paladin,retribution,18,9,9
Kylarha,stormrage,859,paladin,retribution,18,9,9
Mòse,emerald-dream,859,paladin,retribution,18,9,9
Desrexen,malganis,859,paladin,retribution,18,9,9
Layonthis,the-venture-co,859,paladin,retribution,18,9,9
Dalance,draka,859,paladin,retribution,24,9,15
Atularis,tichondrius,858,paladin,retribution,12,9,3
Derethen,emerald-dream,858,paladin,retribution,18,9,9
Alysca,tichondrius,858,paladin,retribution,18,9,9
Irongiant,grizzly-hills,858,paladin,retribution,18,9,9
Abuenano,ragnaros,857,paladin,retribution,12,9,3
Alerz,moon-guard,857,paladin,retribution,15,9,6
Zeprikito,nemesis,857,paladin,retribution,18,9,9
Jojoboskies,aegwynn,857,paladin,retribution,18,9,9
Übermane,illidan,857,paladin,retribution,18,9,9
Frostbitee,nerzhul,856,paladin,retribution,18,9,9
Atilas,ragnaros,856,paladin,retribution,18,9,9
Zerolayer,proudmoore,855,paladin,retribution,12,9,3
Persefaní,moon-guard,855,paladin,retribution,18,9,9
Maraboujan,nemesis,855,paladin,retribution,18,9,9
Clariten,ghostlands,855,paladin,retribution,24,9,15
Agonyss,quelthalas,853,paladin,retribution,18,9,9
Jade,black-dragonflight,853,paladin,retribution,30,9,21
Synnderilla,wyrmrest-accord,851,paladin,retribution,24,9,15
Annashiaa,moon-guard,848,paladin,retribution,18,9,9
Iceddcoffee,barthilas,847,paladin,retribution,30,9,21
Takz,daggerspine,847,paladin,retribution,32,9,23
Elysés,stormrage,846,paladin,retribution,17,9,8
Alphönsë,quelthalas,845,paladin,retribution,18,9,9
Morthalos,moon-guard,845,paladin,retribution,23,9,14
Beskar,shadow-council,843,paladin,retribution,12,9,3
Hotdgwatr,bleeding-hollow,843,paladin,retribution,24,10,14
Avaheal,dragonmaw,842,paladin,retribution,23,9,14
Captdangle,stormrage,834,paladin,retribution,17,10,7
Palgiga,tichondrius,834,paladin,retribution,18,9,9
Palee,garrosh,833,paladin,retribution,44,19,25
Brioc,tichondrius,832,paladin,retribution,22,9,13
Lemuzinho,ragnaros,831,paladin,retribution,14,10,4
Teléza,illidan,831,paladin,retribution,17,9,8
Mehchelol,azgalor,831,paladin,retribution,48,21,27
Lodin,kalecgos,831,paladin,retribution,23,9,14
Bellamor,burning-blade,830,paladin,retribution,17,9,8
Palaðu,azralon,820,paladin,retribution,18,10,8
Hallowgrave,moon-guard,815,paladin,retribution,11,9,2
Sinica,barthilas,815,paladin,retribution,17,9,8
Fiate,azralon,815,paladin,retribution,23,9,14
ßirdie,ragnaros,814,paladin,retribution,23,9,14
Yulzypal,tichondrius,813,paladin,retribution,17,9,8
Perallta,tichondrius,810,paladin,retribution,15,10,5
Cozzey,amanthul,810,paladin,retribution,17,9,8
Lilbursty,tichondrius,810,paladin,retribution,25,10,15
Naeamen,dragonmaw,808,paladin,retribution,15,10,5
Porterhousee,bleeding-hollow,807,paladin,retribution,23,11,12
Sondaar,madoran,807,paladin,retribution,65,18,47
Tectorr,proudmoore,806,paladin,retribution,90,42,48
Azerothmajor,tichondrius,799,paladin,retribution,17,9,8
Lizzyz,illidan,799,paladin,retribution,20,9,11
Witewolf,illidan,798,paladin,retribution,19,10,9
Gryphin,moon-guard,797,paladin,retribution,20,9,11
Lightfdre,rexxar,797,paladin,retribution,33,11,22
Kûrâmâ,ragnaros,796,paladin,retribution,16,9,7
Sevothart,goldrinn,796,paladin,retribution,30,13,17
Kiloalpha,area-52,791,paladin,retribution,22,9,13
Lítebearer,kelthuzad,787,paladin,retribution,17,9,8
Kletüs,quelthalas,784,paladin,retribution,13,9,4
Retributión,darkspear,784,paladin,retribution,19,9,10
Wrekkin,stormrage,772,paladin,retribution,37,9,28
Retpa,tichondrius,768,paladin,retribution,12,8,4
Lastjedi,whisperwind,768,paladin,retribution,12,8,4
Unicornslayr,antonidas,768,paladin,retribution,12,8,4
Swellows,tichondrius,768,paladin,retribution,12,8,4
Luzmu,azralon,768,paladin,retribution,12,8,4
Céllash,tichondrius,768,paladin,retribution,12,8,4
Syorì,wyrmrest-accord,768,paladin,retribution,12,8,4
Twobuttons,draktharon,768,paladin,retribution,12,8,4
Ghostdik,ghostlands,768,paladin,retribution,12,8,4
Hypheríon,ragnaros,768,paladin,retribution,12,8,4
Mortalbeef,zuljin,768,paladin,retribution,12,8,4
Pennywenny,barthilas,768,paladin,retribution,12,8,4
Zelo,emerald-dream,768,paladin,retribution,12,8,4
Pochanaw,wyrmrest-accord,768,paladin,retribution,12,8,4
Meady,area-52,768,paladin,retribution,12,8,4
Wizdum,frostmourne,768,paladin,retribution,12,8,4
Arellis,barthilas,768,paladin,retribution,12,8,4
Spellshield,barthilas,768,paladin,retribution,12,8,4
Stlthykilla,cenarion-circle,768,paladin,retribution,12,8,4
Sebbytheman,tichondrius,768,paladin,retribution,12,8,4
Liangguang,tichondrius,768,paladin,retribution,12,8,4
Meditaté,emerald-dream,768,paladin,retribution,12,8,4
Valoren,spinebreaker,768,paladin,retribution,12,8,4
Franckz,ragnaros,768,paladin,retribution,12,8,4
Eskynor,sargeras,768,paladin,retribution,12,8,4
Lotarow,wyrmrest-accord,768,paladin,retribution,12,8,4
Tolliver,area-52,768,paladin,retribution,12,8,4
Chillpal,illidan,768,paladin,retribution,12,8,4
Soymilkdrnka,sargeras,768,paladin,retribution,12,8,4
Grimreaperx,azralon,768,paladin,retribution,17,8,9
Maanuel,ragnaros,768,paladin,retribution,18,8,10
Antarez,ragnaros,768,paladin,retribution,18,8,10
Mizumaru,sargeras,768,paladin,retribution,18,8,10
Nozfferatu,drakkari,768,paladin,retribution,18,8,10
Smiteup,sargeras,768,paladin,retribution,18,8,10
Inquísítor,stormrage,768,paladin,retribution,18,8,10
Tekkies,barthilas,768,paladin,retribution,18,8,10
Normnom,area-52,768,paladin,retribution,18,8,10
Vanquishy,burning-legion,768,paladin,retribution,18,8,10
Roshord,quelthalas,768,paladin,retribution,18,8,10
Zøzø,zuljin,768,paladin,retribution,18,8,10
Smashpally,sargeras,768,paladin,retribution,18,8,10
Lowther,bleeding-hollow,768,paladin,retribution,18,8,10
Zaxxous,hyjal,768,paladin,retribution,18,8,10
Noansr,proudmoore,768,paladin,retribution,18,8,10
Turaylon,bloodscalp,768,paladin,retribution,18,8,10
Ratkiller,barthilas,768,paladin,retribution,18,8,10
Condexx,quelthalas,768,paladin,retribution,18,8,10
Jebpal,tichondrius,768,paladin,retribution,18,8,10
Adrexious,dalaran,768,paladin,retribution,18,8,10
Nikho,thunderlord,768,paladin,retribution,18,8,10
Trensei,emerald-dream,768,paladin,retribution,18,8,10
Tarà,sargeras,768,paladin,retribution,18,8,10
Quiznossubs,kelthuzad,768,paladin,retribution,18,8,10
Gersin,azralon,768,paladin,retribution,18,8,10
Jachugz,tichondrius,768,paladin,retribution,18,8,10
Bubbletaunt,frostmourne,768,paladin,retribution,18,8,10
Deltronzerø,area-52,768,paladin,retribution,24,8,16
Marcopolo,azralon,768,paladin,retribution,24,8,16
Forgivers,kiljaeden,768,paladin,retribution,24,8,16
Divineera,frostmourne,768,paladin,retribution,24,8,16
Isayas,tichondrius,768,paladin,retribution,24,8,16
Bergz,agamaggan,768,paladin,retribution,24,8,16
Fixyouz,mannoroth,768,paladin,retribution,24,8,16
Bubbleblade,burning-blade,768,paladin,retribution,24,8,16
Jimxeung,tichondrius,768,paladin,retribution,24,8,16
Vibránium,tichondrius,768,paladin,retribution,24,8,16
Goldskìn,sargeras,768,paladin,retribution,24,8,16
Cnret,tichondrius,768,paladin,retribution,24,8,16
Immunelf,azgalor,768,paladin,retribution,24,8,16
Crasíus,quelthalas,768,paladin,retribution,30,8,22
Garethorne,illidan,768,paladin,retribution,30,8,22
Roundhere,area-52,768,paladin,retribution,30,8,22
Holydaddyy,area-52,767,paladin,retribution,12,8,4
Hqknight,moon-guard,767,paladin,retribution,12,8,4
Mægenta,tichondrius,767,paladin,retribution,12,8,4
Greybrox,barthilas,767,paladin,retribution,12,8,4
Akadios,azralon,767,paladin,retribution,12,8,4
Gospel,duskwood,767,paladin,retribution,12,8,4
Faith,thorium-brotherhood,767,paladin,retribution,12,8,4
Husurdaddy,dalaran,767,paladin,retribution,12,8,4
Rhumil,tichondrius,767,paladin,retribution,12,8,4
Dinapal,frostmourne,767,paladin,retribution,12,8,4
Cratt,chromaggus,767,paladin,retribution,12,8,4
Awsem,barthilas,767,paladin,retribution,12,8,4
Jarlsirius,tichondrius,767,paladin,retribution,12,8,4
Atheistqtlol,illidan,767,paladin,retribution,12,8,4
Darkestday,hellscream,767,paladin,retribution,12,8,4
Acidhammer,kelthuzad,767,paladin,retribution,12,8,4
Meatyblessin,area-52,767,paladin,retribution,12,8,4
Baladine,zuljin,767,paladin,retribution,12,8,4
Sauceclock,illidan,767,paladin,retribution,12,8,4
Snajky,sargeras,767,paladin,retribution,12,8,4
Infamoustool,barthilas,767,paladin,retribution,12,8,4
Keit,moon-guard,767,paladin,retribution,12,8,4
Jeffprobstt,kelthuzad,767,paladin,retribution,18,8,10
Yoiro,stormrage,767,paladin,retribution,18,8,10
Avasti,proudmoore,767,paladin,retribution,18,8,10
Swiftdan,moon-guard,767,paladin,retribution,18,8,10
Stroods,stormrage,767,paladin,retribution,18,8,10
Holytrev,tichondrius,767,paladin,retribution,18,8,10
Nutsmashèr,illidan,767,paladin,retribution,18,8,10
Zyras,whisperwind,767,paladin,retribution,18,8,10
Yurinos,illidan,767,paladin,retribution,18,8,10
Nooplug,illidan,767,paladin,retribution,18,8,10
Verbum,malfurion,767,paladin,retribution,18,8,10
Gåbrîel,emerald-dream,767,paladin,retribution,18,8,10
Doobiehigh,proudmoore,767,paladin,retribution,18,8,10
Janumbers,frostwolf,767,paladin,retribution,18,8,10
Hikarae,bleeding-hollow,767,paladin,retribution,18,8,10
Brubb,illidan,767,paladin,retribution,18,8,10
Retrimuution,emerald-dream,767,paladin,retribution,18,8,10
Sermon,moon-guard,767,paladin,retribution,18,8,10
Blackmuu,malganis,767,paladin,retribution,18,8,10
Jaslexa,illidan,767,paladin,retribution,18,8,10
Retroactive,thunderlord,767,paladin,retribution,18,8,10
Rodsley,zuljin,767,paladin,retribution,18,8,10
Mhortái,stormrage,767,paladin,retribution,18,8,10
Nightfallz,farstriders,767,paladin,retribution,18,8,10
Angeluquis,quelthalas,767,paladin,retribution,18,8,10
Airmight,frostmourne,767,paladin,retribution,18,8,10
Yehdardi,frostmourne,767,paladin,retribution,18,8,10
Pudgë,bleeding-hollow,767,paladin,retribution,18,8,10
Heamis,thunderlord,767,paladin,retribution,18,8,10
Urmumsbeefer,thrall,767,paladin,retribution,18,8,10
Hughkane,tichondrius,767,paladin,retribution,18,8,10
Raveen,veknilash,767,paladin,retribution,18,8,10
Toxanator,frostmourne,767,paladin,retribution,18,8,10
Yyh,illidan,767,paladin,retribution,18,8,10
Shãnks,illidan,767,paladin,retribution,24,8,16
Felwythe,emerald-dream,767,paladin,retribution,24,8,16
Chriscoz,korgath,767,paladin,retribution,24,8,16
Dubledeez,malganis,766,paladin,retribution,12,8,4
Palapeludo,azralon,766,paladin,retribution,12,8,4
Bübbleboy,malganis,766,paladin,retribution,12,8,4
Deesqueezie,area-52,766,paladin,retribution,12,8,4
Passion,wyrmrest-accord,766,paladin,retribution,12,8,4
Judgementalz,frostwolf,766,paladin,retribution,12,8,4
Otorten,bladefist,766,paladin,retribution,12,8,4
Dreek,azralon,766,paladin,retribution,12,8,4
Nussaar,kelthuzad,766,paladin,retribution,18,8,10
Pallyalli,burning-blade,766,paladin,retribution,18,8,10
Wehrmachtt,emerald-dream,766,paladin,retribution,18,8,10
Masho,skullcrusher,766,paladin,retribution,18,8,10
Crtinsideyou,skullcrusher,766,paladin,retribution,21,9,12
Sholmaht,frostmourne,765,paladin,retribution,12,8,4
Zuljaboi,thrall,765,paladin,retribution,12,8,4
Holyhammered,kelthuzad,765,paladin,retribution,12,8,4
Kristary,ragnaros,765,paladin,retribution,12,8,4
Irongrizzle,barthilas,765,paladin,retribution,12,8,4
Gírthbrooks,hyjal,765,paladin,retribution,12,8,4
Mothh,terokkar,765,paladin,retribution,12,8,4
Peepilled,uldum,765,paladin,retribution,12,8,4
Nikinaki,stormrage,765,paladin,retribution,12,8,4
Darktaron,ragnaros,765,paladin,retribution,18,8,10
Wexting,ragnaros,765,paladin,retribution,18,8,10
Lightahean,proudmoore,765,paladin,retribution,24,8,16
Butchur,area-52,765,paladin,retribution,30,8,22
Angelz,garrosh,764,paladin,retribution,18,8,10
Calithia,destromath,764,paladin,retribution,18,8,10
Freesorrow,area-52,764,paladin,retribution,19,8,11
Palade,proudmoore,763,paladin,retribution,18,8,10
Mooroy,moon-guard,763,paladin,retribution,18,8,10
Guccii,quelthalas,763,paladin,retribution,18,8,10
Deathblazer,blades-edge,763,paladin,retribution,18,8,10
Cowsavior,terenas,763,paladin,retribution,18,8,10
Jebadia,proudmoore,762,paladin,retribution,12,8,4
Faerdrik,emerald-dream,762,paladin,retribution,18,8,10
Flisk,garona,761,paladin,retribution,12,8,4
Kief,emerald-dream,761,paladin,retribution,30,8,22
Mordrime,moon-guard,760,paladin,retribution,18,8,10
Hadrianus,azralon,760,paladin,retribution,30,8,22
Palman,frostmourne,759,paladin,retribution,18,8,10
Trodos,quelthalas,758,paladin,retribution,12,8,4
Chombe,tichondrius,758,paladin,retribution,18,8,10
Gureisufiru,uther,757,paladin,retribution,24,8,16
Populate,tichondrius,752,paladin,retribution,12,8,4
Piojopaladin,quelthalas,752,paladin,retribution,25,8,17
Jâiná,frostmourne,751,paladin,retribution,23,8,15
Supreme,farstriders,751,paladin,retribution,29,8,21
Cleavix,tichondrius,751,paladin,retribution,35,8,27
Dunecan,tichondrius,750,paladin,retribution,17,8,9
Chaosbubble,burning-legion,750,paladin,retribution,24,8,16
Maelie,shadowmoon,749,paladin,retribution,12,8,4
Oogablah,wyrmrest-accord,749,paladin,retribution,12,8,4
Feelmenu,deathwing,749,paladin,retribution,23,8,15
Gemutlich,khazgoroth,748,paladin,retribution,23,8,15
Jorkoh,the-scryers,747,paladin,retribution,29,8,21
Shanuslight,moon-guard,742,paladin,retribution,21,9,12
Yulasa,area-52,735,paladin,retribution,14,9,5
Hekki,ragnaros,735,paladin,retribution,19,8,11
Kumahdori,stormrage,734,paladin,retribution,14,9,5
Swholly,senjin,733,paladin,retribution,21,10,11
Felordron,silvermoon,731,paladin,retribution,22,9,13
Darkpalaa,gallywix,722,paladin,retribution,18,8,10
Bomdia,stormrage,720,paladin,retribution,15,8,7
Whisk,tichondrius,720,paladin,retribution,15,8,7
Holyhali,zuljin,719,paladin,retribution,17,8,9
Kelvor,thaurissan,718,paladin,retribution,11,8,3
Língnafòx,tichondrius,718,paladin,retribution,15,9,6
Reth,aerie-peak,718,paladin,retribution,17,8,9
Romonite,bleeding-hollow,715,paladin,retribution,29,8,21
Newwow,tichondrius,714,paladin,retribution,21,9,12
Andorsi,elune,714,paladin,retribution,21,9,12
Ryanslover,kelthuzad,714,paladin,retribution,23,9,14
Kloud,sargeras,713,paladin,retribution,27,9,18
Pantheeon,altar-of-storms,713,paladin,retribution,30,9,21
Marlynx,tichondrius,712,paladin,retribution,29,11,18
Lecarde,cenarion-circle,711,paladin,retribution,34,9,25
Kaallell,blackhand,710,paladin,retribution,22,9,13
Kalayton,nesingwary,709,paladin,retribution,15,9,6
Andelk,tichondrius,703,paladin,retribution,14,9,5
Chstypuller,tichondrius,703,paladin,retribution,22,8,14
Dwarfineas,dalaran,702,paladin,retribution,11,8,3
Mujika,area-52,702,paladin,retribution,14,8,6
Wadalee,tichondrius,702,paladin,retribution,26,8,18
Tridon,zuljin,701,paladin,retribution,20,8,12
Kromcrush,azralon,700,paladin,retribution,16,8,8
Akirahikarii,frostwolf,699,paladin,retribution,23,10,13
Bratette,fenris,691,paladin,retribution,68,23,45
Fizzlewig,malganis,688,paladin,retribution,19,8,11
Paullokis,gallywix,686,paladin,retribution,13,8,5
Turtlehoof,thrall,684,paladin,retribution,19,8,11
Sparklepuss,turalyon,676,paladin,retribution,23,8,15
Slighted,illidan,672,paladin,retribution,12,7,5
Boxader,dalaran,672,paladin,retribution,12,7,5
Cëlestial,drakkari,672,paladin,retribution,12,7,5
Holreshee,tichondrius,672,paladin,retribution,12,7,5
Chubbychode,sargeras,672,paladin,retribution,12,7,5
Wèbb,burning-legion,672,paladin,retribution,12,7,5
Mikâel,cairne,672,paladin,retribution,12,7,5
Shadoweelite,sargeras,672,paladin,retribution,12,7,5
Garzzy,tichondrius,672,paladin,retribution,12,7,5
Noxtrael,frostmourne,672,paladin,retribution,12,7,5
Aurðra,kiljaeden,672,paladin,retribution,12,7,5
Balduin,quelthalas,672,paladin,retribution,12,7,5
Irahan,stormrage,672,paladin,retribution,12,7,5
Shibbx,quelthalas,672,paladin,retribution,12,7,5
Holycar,illidan,672,paladin,retribution,12,7,5
Holyåvenger,thunderhorn,672,paladin,retribution,12,7,5
Uríel,frostmourne,672,paladin,retribution,12,7,5
Threeroses,emerald-dream,672,paladin,retribution,12,7,5
Merkzz,arthas,672,paladin,retribution,12,7,5
Netflixnfeet,stormreaver,672,paladin,retribution,12,7,5
Míkau,barthilas,672,paladin,retribution,12,7,5
Khêll,sargeras,672,paladin,retribution,12,7,5
Tmwesker,azralon,672,paladin,retribution,12,7,5
Aurelea,frostmourne,672,paladin,retribution,12,7,5
Trejetë,tichondrius,672,paladin,retribution,12,7,5
Mes,dragonmaw,672,paladin,retribution,12,7,5
Azaril,jubeithos,672,paladin,retribution,12,7,5
Araguaney,bleeding-hollow,672,paladin,retribution,12,7,5
Turner,skullcrusher,672,paladin,retribution,12,7,5
Popwingsz,nemesis,672,paladin,retribution,12,7,5
Thephreak,madoran,672,paladin,retribution,12,7,5
Supernampal,sargeras,672,paladin,retribution,12,7,5
Jellybrah,stormrage,672,paladin,retribution,12,7,5
Condign,moon-guard,672,paladin,retribution,12,7,5
Nailuj,moon-guard,672,paladin,retribution,12,7,5
Qsx,bleeding-hollow,672,paladin,retribution,12,7,5
Paltarrd,bleeding-hollow,672,paladin,retribution,12,7,5
Kanaki,gilneas,672,paladin,retribution,12,7,5
Paredes,demon-soul,672,paladin,retribution,12,7,5
Skylightz,area-52,672,paladin,retribution,12,7,5
Schecterbug,stormrage,672,paladin,retribution,12,7,5
Rexinarr,area-52,672,paladin,retribution,12,7,5
Iloveket,blackrock,672,paladin,retribution,12,7,5
Eduardoap,azralon,672,paladin,retribution,12,7,5
Alahster,sargeras,672,paladin,retribution,12,7,5
Nutbro,tichondrius,672,paladin,retribution,12,7,5
Homelord,drakkari,672,paladin,retribution,12,7,5
Vozy,bronzebeard,672,paladin,retribution,12,7,5
Bootyfùnk,tichondrius,672,paladin,retribution,12,7,5
Brookeh,frostmourne,672,paladin,retribution,12,7,5
Motivlight,area-52,672,paladin,retribution,12,7,5
Near,saurfang,672,paladin,retribution,12,7,5
Rektributíon,area-52,672,paladin,retribution,12,7,5
Steezyret,barthilas,672,paladin,retribution,12,7,5
Attackonpal,illidan,672,paladin,retribution,12,7,5
Chäinswellx,area-52,672,paladin,retribution,12,7,5
Deathbybonk,maiev,672,paladin,retribution,12,7,5
Bighoochie,moon-guard,672,paladin,retribution,12,7,5
Montyer,ragnaros,672,paladin,retribution,12,7,5
Pallisix,barthilas,672,paladin,retribution,12,7,5
Montecrîsto,area-52,672,paladin,retribution,12,7,5
Dabbicus,tichondrius,672,paladin,retribution,12,7,5
Bielin,area-52,672,paladin,retribution,12,7,5
Wackobeef,barthilas,672,paladin,retribution,12,7,5
Nosferätu,illidan,672,paladin,retribution,12,7,5
Griezadin,azgalor,672,paladin,retribution,12,7,5
Leaelda,wyrmrest-accord,672,paladin,retribution,16,8,8
Paladan,tichondrius,672,paladin,retribution,17,7,10
Rebelion,nagrand,672,paladin,retribution,18,7,11
Kentö,area-52,672,paladin,retribution,18,7,11
Hølyshyt,tichondrius,672,paladin,retribution,18,7,11
Solambul,tichondrius,672,paladin,retribution,18,7,11
Xvetis,thrall,672,paladin,retribution,18,7,11
Geospawn,bleeding-hollow,672,paladin,retribution,18,7,11
Knaring,aggramar,672,paladin,retribution,18,7,11
Mayoclinic,frostmane,672,paladin,retribution,18,7,11
Strykerrz,tanaris,672,paladin,retribution,18,7,11
Eyecandý,tichondrius,672,paladin,retribution,18,7,11
Anjocaído,nemesis,672,paladin,retribution,18,7,11
Tutle,nathrezim,672,paladin,retribution,18,7,11
Absolution,gurubashi,672,paladin,retribution,18,7,11
ßraveheart,zuljin,672,paladin,retribution,18,7,11
Delightt,sargeras,672,paladin,retribution,18,7,11
Nawwll,stonemaul,672,paladin,retribution,18,7,11
Roundbutts,stormrage,672,paladin,retribution,18,7,11
Serinos,zuljin,672,paladin,retribution,18,7,11
Bubzfordubz,sargeras,672,paladin,retribution,18,7,11
Aledin,frostmourne,672,paladin,retribution,18,7,11
Eurthswrath,lightbringer,672,paladin,retribution,18,7,11
Ziti,bonechewer,672,paladin,retribution,18,7,11
Eillonwy,nerzhul,672,paladin,retribution,18,7,11
Vodulight,tichondrius,672,paladin,retribution,18,7,11
Teamamerica,proudmoore,672,paladin,retribution,18,7,11
Shoresy,terokkar,672,paladin,retribution,18,7,11
Lowhp,tichondrius,672,paladin,retribution,18,7,11
Lmac,frostmourne,672,paladin,retribution,18,7,11
Tothegravetv,illidan,672,paladin,retribution,18,7,11
Atalzel,kiljaeden,672,paladin,retribution,18,7,11
Urukap,goldrinn,672,paladin,retribution,18,7,11
Zugonomics,proudmoore,672,paladin,retribution,18,7,11
Valantor,anvilmar,672,paladin,retribution,18,7,11
Cliftôn,illidan,672,paladin,retribution,18,7,11
Paintpumper,malganis,672,paladin,retribution,18,7,11
Zotro,sargeras,672,paladin,retribution,18,7,11
Zenek,zuljin,672,paladin,retribution,18,7,11
Kipow,proudmoore,672,paladin,retribution,18,7,11
Yedema,tichondrius,672,paladin,retribution,18,7,11
Gigantidab,tichondrius,672,paladin,retribution,18,7,11
Trfreedomz,frostmourne,672,paladin,retribution,18,7,11
Lakera,proudmoore,672,paladin,retribution,18,7,11
Neverwogx,kirin-tor,672,paladin,retribution,18,7,11
Cylano,tichondrius,672,paladin,retribution,18,7,11
Heilige,thrall,672,paladin,retribution,24,7,17
Heavener,tichondrius,672,paladin,retribution,24,7,17
Ganan,frostmane,672,paladin,retribution,24,7,17
Hayden,stormscale,672,paladin,retribution,24,7,17
Kyuubî,bloodhoof,672,paladin,retribution,24,7,17
Goozlight,area-52,672,paladin,retribution,24,7,17
Haimdallr,azralon,672,paladin,retribution,24,7,17
Tanesdeline,area-52,671,paladin,retribution,12,7,5
Ironpaladin,sargeras,671,paladin,retribution,12,7,5
Shivaku,area-52,671,paladin,retribution,12,7,5
Miangder,tichondrius,671,paladin,retribution,12,7,5
Jåy,nazjatar,671,paladin,retribution,12,7,5
Guthdrak,azgalor,671,paladin,retribution,12,7,5
Kaynè,senjin,671,paladin,retribution,12,7,5
Holypillager,zuljin,671,paladin,retribution,12,7,5
Annii,aegwynn,671,paladin,retribution,12,7,5
Ruca,icecrown,671,paladin,retribution,12,7,5
Elemezs,tichondrius,671,paladin,retribution,12,7,5
Ðrêâð,kirin-tor,671,paladin,retribution,12,7,5
Joobas,zuljin,671,paladin,retribution,12,7,5
Gyle,stormrage,671,paladin,retribution,12,7,5
Thorean,sargeras,671,paladin,retribution,12,7,5
Prophesied,zuljin,671,paladin,retribution,12,7,5
Xfiles,alterac-mountains,671,paladin,retribution,12,7,5
Mimitos,frostmane,671,paladin,retribution,12,7,5
Smuglý,wyrmrest-accord,671,paladin,retribution,12,7,5
Koohny,stormrage,671,paladin,retribution,12,7,5
Dabnpaladin,thunderlord,671,paladin,retribution,12,7,5
Dillysdilly,zuljin,671,paladin,retribution,12,7,5
Zerofans,ragnaros,671,paladin,retribution,12,7,5
Hopebreaker,spinebreaker,671,paladin,retribution,12,7,5
Palameme,hyjal,671,paladin,retribution,12,7,5
Shadd,destromath,671,paladin,retribution,12,7,5
Darktank,malganis,671,paladin,retribution,12,7,5
Krossret,thrall,671,paladin,retribution,12,7,5
Jaybbers,malganis,671,paladin,retribution,12,7,5
Holyretribut,tichondrius,671,paladin,retribution,12,7,5
Lystia,malfurion,671,paladin,retribution,12,7,5
Blingster,hellscream,671,paladin,retribution,12,7,5
Åphrodite,bleeding-hollow,671,paladin,retribution,12,7,5
Níkolaev,azralon,671,paladin,retribution,15,8,7
Callmesauced,dalaran,671,paladin,retribution,16,8,8
Auriol,azshara,671,paladin,retribution,14,7,7
Tittanfalls,illidan,671,paladin,retribution,18,7,11
Littlemoses,exodar,671,paladin,retribution,18,7,11
Titamn,area-52,671,paladin,retribution,18,7,11
Valtariel,wyrmrest-accord,671,paladin,retribution,18,7,11
Bettyböp,bleeding-hollow,671,paladin,retribution,18,7,11
Ibull,stormscale,671,paladin,retribution,18,7,11
Hisenberg,drakkari,671,paladin,retribution,18,7,11
Bahfoi,azralon,671,paladin,retribution,18,7,11
Inareus,agamaggan,671,paladin,retribution,18,7,11
Thadrian,nazgrel,671,paladin,retribution,18,7,11
Ottiepal,kelthuzad,671,paladin,retribution,18,7,11
Basslinee,quelthalas,671,paladin,retribution,18,7,11
Blaeng,shandris,671,paladin,retribution,18,7,11
Drpawg,tichondrius,671,paladin,retribution,18,7,11
Wolfgrad,stormrage,671,paladin,retribution,18,7,11
Arhyei,ragnaros,671,paladin,retribution,18,7,11
Golozzakum,tichondrius,671,paladin,retribution,18,7,11
Bubbleôsevèn,stormrage,671,paladin,retribution,18,7,11
Sixty,sargeras,671,paladin,retribution,18,7,11
Ane,gorefiend,671,paladin,retribution,18,7,11
Nibuwolfx,daggerspine,671,paladin,retribution,18,7,11
Hinamattsuri,velen,671,paladin,retribution,18,7,11
Giorgyos,ragnaros,671,paladin,retribution,18,7,11
Kaidoz,aegwynn,671,paladin,retribution,18,7,11
Jakkburton,stormrage,671,paladin,retribution,18,7,11
Kedubb,stormrage,671,paladin,retribution,18,7,11
Vaelicus,emerald-dream,671,paladin,retribution,18,7,11
Tyelca,zuljin,671,paladin,retribution,18,7,11
Supramario,dragonmaw,671,paladin,retribution,18,7,11
Hasbi,area-52,671,paladin,retribution,18,7,11
Contritus,kiljaeden,671,paladin,retribution,18,7,11
Doraléous,illidan,671,paladin,retribution,24,7,17
Petsmacker,dalaran,671,paladin,retribution,30,7,23
Biggwill,proudmoore,670,paladin,retribution,12,7,5
Blackflare,undermine,670,paladin,retribution,12,7,5
Swissalami,proudmoore,670,paladin,retribution,12,7,5
Chiraqret,thunderhorn,670,paladin,retribution,12,7,5
Capsiel,caelestrasz,670,paladin,retribution,12,7,5
Tomaz,ragnaros,670,paladin,retribution,12,7,5
Holychach,tichondrius,670,paladin,retribution,12,7,5
Itsapoc,sargeras,670,paladin,retribution,12,7,5
Riek,sargeras,670,paladin,retribution,16,8,8
Zaeris,proudmoore,670,paladin,retribution,18,7,11
Jorgevercilo,azralon,670,paladin,retribution,18,7,11
Rampetos,mannoroth,670,paladin,retribution,18,7,11
Delukk,azralon,670,paladin,retribution,18,7,11
Augus,arygos,670,paladin,retribution,18,7,11
Holiesthoe,mannoroth,670,paladin,retribution,18,7,11
Tpane,kelthuzad,670,paladin,retribution,18,7,11
Grindlimg,dalaran,670,paladin,retribution,18,7,11
Zealotry,tichondrius,670,paladin,retribution,24,7,17
Exer,ragnaros,670,paladin,retribution,24,7,17
Murdameek,area-52,670,paladin,retribution,24,7,17
Terroll,bonechewer,669,paladin,retribution,13,7,6
Denstain,kul-tiras,669,paladin,retribution,18,7,11
Sîegfried,moon-guard,669,paladin,retribution,18,7,11
Tpaartes,mannoroth,669,paladin,retribution,18,7,11
Salvø,tichondrius,669,paladin,retribution,24,7,17
Praisin,zuljin,668,paladin,retribution,12,7,5
Vooltron,bonechewer,668,paladin,retribution,12,7,5
Alexanderrex,illidan,668,paladin,retribution,18,7,11
Velkh,illidan,668,paladin,retribution,18,7,11
Glowstone,emerald-dream,668,paladin,retribution,18,7,11
Tenshí,windrunner,667,paladin,retribution,12,7,5
Tacosmells,thunderlord,667,paladin,retribution,18,7,11
Mandow,tichondrius,667,paladin,retribution,22,8,14
Batix,malfurion,666,paladin,retribution,12,7,5
Imsoosmall,sargeras,666,paladin,retribution,12,7,5
Calmador,proudmoore,666,paladin,retribution,12,7,5
Mereoleona,elune,666,paladin,retribution,18,7,11
Toogud,moon-guard,666,paladin,retribution,21,8,13
Boomeers,emerald-dream,666,paladin,retribution,24,7,17
Kithrin,emerald-dream,664,paladin,retribution,12,7,5
Trutax,black-dragonflight,662,paladin,retribution,18,7,11
Elderbill,emerald-dream,659,paladin,retribution,12,7,5
Olstonie,garrosh,658,paladin,retribution,12,7,5
Nicepally,moon-guard,657,paladin,retribution,18,7,11
Mèdic,illidan,654,paladin,retribution,17,7,10
Palliful,runetotem,651,paladin,retribution,18,7,11
Tooperilous,exodar,639,paladin,retribution,16,7,9
Vietnomeez,tichondrius,639,paladin,retribution,17,7,10
Bigmilkdog,tichondrius,639,paladin,retribution,17,7,10
Goldclaw,moon-guard,639,paladin,retribution,20,8,12
Hanicon,dragonmaw,638,paladin,retribution,16,7,9
Unversed,illidan,637,paladin,retribution,18,9,9
Fatalpally,antonidas,633,paladin,retribution,17,7,10
Arkeon,shadowsong,631,paladin,retribution,17,7,10
Táçô,illidan,623,paladin,retribution,11,7,4
Ethernaly,quelthalas,623,paladin,retribution,17,7,10
Krossfyre,kiljaeden,623,paladin,retribution,17,7,10
Jortesh,tichondrius,622,paladin,retribution,15,7,8
Alkon,quelthalas,619,paladin,retribution,33,7,26
Grinzin,azralon,618,paladin,retribution,17,9,8
Antoniano,ragnaros,617,paladin,retribution,13,8,5
Vanaris,blackrock,615,paladin,retribution,15,7,8
Saltytaco,gurubashi,608,paladin,retribution,16,7,9
Frêyr,barthilas,608,paladin,retribution,22,7,15
Anarkay,frostmourne,607,paladin,retribution,10,7,3
Kelhell,stormrage,607,paladin,retribution,11,7,4
Orellios,moon-guard,607,paladin,retribution,17,7,10
Tolkki,dalaran,607,paladin,retribution,26,7,19
Captqueso,stormrage,606,paladin,retribution,14,7,7
Hottest,wyrmrest-accord,606,paladin,retribution,28,12,16
Ráky,quelthalas,605,paladin,retribution,26,7,19
Omenpachi,moon-guard,604,paladin,retribution,20,7,13
Climaximum,gorgonnash,603,paladin,retribution,11,7,4
Hydroponicz,tichondrius,592,paladin,retribution,13,7,6
Sixtynine,nathrezim,592,paladin,retribution,31,7,24
Unïk,zuljin,591,paladin,retribution,11,7,4
Warbird,lightnings-blade,591,paladin,retribution,13,7,6
Theomere,sargeras,586,paladin,retribution,27,10,17
Thøradin,moon-guard,576,paladin,retribution,6,6,0
Detruiso,area-52,576,paladin,retribution,6,6,0
Próx,barthilas,576,paladin,retribution,6,6,0
Lucard,drakkari,576,paladin,retribution,6,6,0
Liht,blood-furnace,576,paladin,retribution,6,6,0
Hinnamnor,tichondrius,576,paladin,retribution,6,6,0
Xandiê,sargeras,576,paladin,retribution,6,6,0
Fibonaci,sargeras,576,paladin,retribution,6,6,0
Odegaret,illidan,576,paladin,retribution,10,7,3
Gánico,ragnaros,576,paladin,retribution,12,6,6
Crânkdât,frostmourne,576,paladin,retribution,12,6,6
Koûtt,ragnaros,576,paladin,retribution,12,6,6
Nyroxz,quelthalas,576,paladin,retribution,12,6,6
Vozy,shandris,576,paladin,retribution,12,6,6
Beato,silvermoon,576,paladin,retribution,12,6,6
Sneely,kelthuzad,576,paladin,retribution,12,6,6
Obeliskk,frostmourne,576,paladin,retribution,12,6,6
Hammerd,area-52,576,paladin,retribution,12,6,6
Piscacha,ragnaros,576,paladin,retribution,12,6,6
Nýze,area-52,576,paladin,retribution,12,6,6
Vàrrðw,bleeding-hollow,576,paladin,retribution,12,6,6
Emetselchs,tichondrius,576,paladin,retribution,12,6,6
Venter,bleeding-hollow,576,paladin,retribution,12,6,6
Ironaddict,frostmourne,576,paladin,retribution,12,6,6
Bootacious,tichondrius,576,paladin,retribution,12,6,6
Legelight,malganis,576,paladin,retribution,12,6,6
Dogecoln,bleeding-hollow,576,paladin,retribution,12,6,6
Wyon,stormrage,576,paladin,retribution,12,6,6
Vixybae,illidan,576,paladin,retribution,12,6,6
Raywhite,kelthuzad,576,paladin,retribution,12,6,6
Fallenp,hakkar,576,paladin,retribution,12,6,6
Zeröcoöl,malganis,576,paladin,retribution,12,6,6
Careyprice,area-52,576,paladin,retribution,12,6,6
Cjq,tichondrius,576,paladin,retribution,12,6,6
Lyà,area-52,576,paladin,retribution,12,6,6
Pokeyabutt,hydraxis,576,paladin,retribution,12,6,6
Zägreus,moon-guard,576,paladin,retribution,12,6,6
Thaléros,tichondrius,576,paladin,retribution,12,6,6
Healplzz,tichondrius,576,paladin,retribution,12,6,6
Cybopig,kelthuzad,576,paladin,retribution,12,6,6
Piroc,tichondrius,576,paladin,retribution,12,6,6
Hjolgrim,sargeras,576,paladin,retribution,12,6,6
Afterdawn,dreadmaul,576,paladin,retribution,12,6,6
Gambitdin,moon-guard,576,paladin,retribution,12,6,6
Hæsh,sargeras,576,paladin,retribution,12,6,6
Mystictoast,area-52,576,paladin,retribution,12,6,6
Rhoruk,turalyon,576,paladin,retribution,12,6,6
Evelimash,bloodhoof,576,paladin,retribution,12,6,6
Zuther,spirestone,576,paladin,retribution,12,6,6
Kulikahn,terenas,576,paladin,retribution,12,6,6
Holycrusador,bleeding-hollow,576,paladin,retribution,12,6,6
Everith,bleeding-hollow,576,paladin,retribution,12,6,6
Memepaladin,area-52,576,paladin,retribution,12,6,6
Gàreth,aerie-peak,576,paladin,retribution,12,6,6
Octaviak,moon-guard,576,paladin,retribution,12,6,6
Soapgirl,area-52,576,paladin,retribution,12,6,6
Skarlagen,moon-guard,576,paladin,retribution,12,6,6
Tdm,bleeding-hollow,576,paladin,retribution,12,6,6
Mónstër,ragnaros,576,paladin,retribution,12,6,6
Aëriy,moon-guard,576,paladin,retribution,12,6,6
Arraladin,tichondrius,576,paladin,retribution,12,6,6
Sacerbelator,zuluhed,576,paladin,retribution,12,6,6
Seballedo,drakkari,576,paladin,retribution,12,6,6
Yungcheezy,illidan,576,paladin,retribution,12,6,6
Zercker,ragnaros,576,paladin,retribution,12,6,6
Vilert,balnazzar,576,paladin,retribution,12,6,6
Alphali,quelthalas,576,paladin,retribution,12,6,6
Snivasgo,ragnaros,576,paladin,retribution,12,6,6
Cvpal,stormrage,576,paladin,retribution,12,6,6
Andreck,ragnaros,576,paladin,retribution,12,6,6
Bernahl,amanthul,576,paladin,retribution,12,6,6
Òp,illidan,576,paladin,retribution,12,6,6
Accept,frostmourne,576,paladin,retribution,12,6,6
Potatopasta,area-52,576,paladin,retribution,12,6,6
Heliösdark,quelthalas,576,paladin,retribution,12,6,6
Thiccpala,tichondrius,576,paladin,retribution,12,6,6
Trixzthot,barthilas,576,paladin,retribution,12,6,6
Cübe,malganis,576,paladin,retribution,12,6,6
Leonkennedyx,stormrage,576,paladin,retribution,12,6,6
Proctrlx,tichondrius,576,paladin,retribution,12,6,6
Xavorn,illidan,576,paladin,retribution,12,6,6
Bloodeladin,deathwing,576,paladin,retribution,12,6,6
Beluros,tichondrius,576,paladin,retribution,12,6,6
Jabrohnie,sargeras,576,paladin,retribution,12,6,6
Aura,emerald-dream,576,paladin,retribution,12,6,6
Ashley,sargeras,576,paladin,retribution,12,6,6
Bloodyängel,emerald-dream,576,paladin,retribution,12,6,6
Totalaustin,sargeras,576,paladin,retribution,12,6,6
Lightsbane,azgalor,576,paladin,retribution,12,6,6
Seeys,tichondrius,576,paladin,retribution,12,6,6
Koyourfamily,proudmoore,576,paladin,retribution,12,6,6
Mikeyqt,nemesis,576,paladin,retribution,12,6,6
Klamindor,emerald-dream,576,paladin,retribution,12,6,6
Geesworld,nazjatar,576,paladin,retribution,12,6,6
Dumbledwarf,hyjal,576,paladin,retribution,12,6,6
Holycrp,proudmoore,576,paladin,retribution,12,6,6
Brpistol,azralon,576,paladin,retribution,12,6,6
Germ,korgath,576,paladin,retribution,12,6,6
Epicbro,kiljaeden,576,paladin,retribution,12,6,6
Dýnamo,azralon,576,paladin,retribution,12,6,6
Loridaris,illidan,576,paladin,retribution,12,6,6
Zoroastrø,azralon,576,paladin,retribution,12,6,6
Antonn,stormrage,576,paladin,retribution,12,6,6
Insidous,galakrond,576,paladin,retribution,12,6,6
Sparticuss,frostmane,576,paladin,retribution,12,6,6
Bigkspally,korgath,576,paladin,retribution,12,6,6
Enj,stormrage,576,paladin,retribution,12,6,6
Bigdig,stormrage,576,paladin,retribution,12,6,6
Deadlyskills,arathor,576,paladin,retribution,12,6,6
Brightness,lightbringer,576,paladin,retribution,12,6,6
Sabêr,mannoroth,576,paladin,retribution,12,6,6
Retboy,archimonde,576,paladin,retribution,12,6,6
Byebyetwinks,khaz-modan,576,paladin,retribution,12,6,6
Panicbubblin,stormrage,576,paladin,retribution,12,6,6
Glynisir,sargeras,576,paladin,retribution,12,6,6
Thuggrnaut,darkspear,576,paladin,retribution,12,6,6
Banzz,azralon,576,paladin,retribution,12,6,6
Necrøzado,azralon,576,paladin,retribution,12,6,6
Mollymatt,drenden,576,paladin,retribution,12,6,6
Palladini,jubeithos,576,paladin,retribution,12,6,6
Zèró,terokkar,576,paladin,retribution,12,6,6
Cause,farstriders,576,paladin,retribution,12,6,6
Lebubbles,azuremyst,576,paladin,retribution,12,6,6
Troegenator,stormrage,576,paladin,retribution,12,6,6
Pállyho,tichondrius,576,paladin,retribution,12,6,6
Breid,sargeras,576,paladin,retribution,12,6,6
Çhñkzrèt,illidan,576,paladin,retribution,12,6,6
Nragedpal,illidan,576,paladin,retribution,12,6,6
Jacklo,the-venture-co,576,paladin,retribution,12,6,6
Retsuxks,twisting-nether,576,paladin,retribution,12,6,6
Heniou,tichondrius,576,paladin,retribution,15,7,8
Smaugg,boulderfist,576,paladin,retribution,15,7,8
Trulymental,bleeding-hollow,576,paladin,retribution,13,6,7
Xanaxlol,sargeras,576,paladin,retribution,16,7,9
Sunwalker,tichondrius,576,paladin,retribution,17,6,11
Joshington,stormrage,576,paladin,retribution,21,7,14
Xpect,spinebreaker,576,paladin,retribution,18,6,12
Shiftybugar,tichondrius,576,paladin,retribution,18,6,12
Kreigvar,moon-guard,576,paladin,retribution,18,6,12
Bovasaur,illidan,576,paladin,retribution,18,6,12
Femaledog,ragnaros,576,paladin,retribution,18,6,12
Kaïty,azralon,576,paladin,retribution,18,6,12
Coachcarter,nerzhul,576,paladin,retribution,18,6,12
Ålltimer,stormrage,576,paladin,retribution,18,6,12
Júdgedredd,illidan,576,paladin,retribution,18,6,12
Respect,moon-guard,576,paladin,retribution,18,6,12
Astolfo,tortheldrin,576,paladin,retribution,18,6,12
Uneazyxx,tichondrius,576,paladin,retribution,18,6,12
Sourpatchh,stormrage,576,paladin,retribution,18,6,12
Slowmoshend,illidan,576,paladin,retribution,18,6,12
Simplychi,area-52,576,paladin,retribution,18,6,12
Retz,tichondrius,576,paladin,retribution,18,6,12
Actionman,bleeding-hollow,576,paladin,retribution,18,6,12
Kräthöz,quelthalas,576,paladin,retribution,18,6,12
Hetodo,blood-furnace,576,paladin,retribution,18,6,12
Kronicle,bleeding-hollow,576,paladin,retribution,18,6,12
Revivemeplzs,tichondrius,576,paladin,retribution,18,6,12
Cairdk,ragnaros,576,paladin,retribution,18,6,12
Shaktii,ragnaros,576,paladin,retribution,18,6,12
Kochinodin,ragnaros,576,paladin,retribution,18,6,12
Ishuffle,malganis,576,paladin,retribution,18,6,12
Líghts,caelestrasz,576,paladin,retribution,18,6,12
Kramsìb,ragnaros,576,paladin,retribution,18,6,12
Nufi,magtheridon,576,paladin,retribution,18,6,12
Washavy,drakkari,576,paladin,retribution,18,6,12
Liandroa,stormrage,576,paladin,retribution,18,6,12
Jafbe,mugthol,576,paladin,retribution,18,6,12
Omniknìght,stormrage,576,paladin,retribution,18,6,12
Gafgarrion,stormrage,576,paladin,retribution,18,6,12
Càséy,zuljin,576,paladin,retribution,18,6,12
Niksilp,malfurion,576,paladin,retribution,18,6,12
Cupcaked,blackrock,576,paladin,retribution,23,6,17
Hojpack,tichondrius,576,paladin,retribution,24,6,18
Holyhymen,mannoroth,576,paladin,retribution,24,6,18
Exorcìst,tichondrius,576,paladin,retribution,24,6,18
Pusshoof,malganis,576,paladin,retribution,24,6,18
Typheuz,wyrmrest-accord,576,paladin,retribution,24,6,18
Spoons,malganis,576,paladin,retribution,24,6,18
Supermetroid,vashj,576,paladin,retribution,24,6,18
Dragrias,altar-of-storms,575,paladin,retribution,10,7,3
Skullblood,stormrage,575,paladin,retribution,12,6,6
Ikanacanyon,stormrage,575,paladin,retribution,12,6,6
Skyangel,illidan,575,paladin,retribution,12,6,6
Sihylde,quelthalas,575,paladin,retribution,12,6,6
Detk,darrowmere,575,paladin,retribution,12,6,6
Blankei,stormrage,575,paladin,retribution,12,6,6
Jolandrine,sargeras,575,paladin,retribution,12,6,6
Vanmauren,quelthalas,575,paladin,retribution,12,6,6
Onecmpeter,kelthuzad,575,paladin,retribution,12,6,6
Crixius,eredar,575,paladin,retribution,12,6,6
Knobody,emerald-dream,575,paladin,retribution,12,6,6
Fimm,quelthalas,575,paladin,retribution,12,6,6
Killmode,kelthuzad,575,paladin,retribution,12,6,6
Enpyrian,azralon,575,paladin,retribution,12,6,6
Potiguar,azralon,575,paladin,retribution,12,6,6
Vincentnero,runetotem,575,paladin,retribution,12,6,6
Shaggrilla,trollbane,575,paladin,retribution,12,6,6
Uritank,thrall,575,paladin,retribution,12,6,6
Apollon,zuljin,575,paladin,retribution,12,6,6
Jovolur,dalaran,575,paladin,retribution,12,6,6
Ekhia,ragnaros,575,paladin,retribution,12,6,6
Arkmedys,azralon,575,paladin,retribution,12,6,6
Laluce,malganis,575,paladin,retribution,12,6,6
Jotajotamz,quelthalas,575,paladin,retribution,12,6,6
Butterbeanz,tanaris,575,paladin,retribution,12,6,6
Blëssëd,zuljin,575,paladin,retribution,12,6,6
Yuzuru,mannoroth,575,paladin,retribution,12,6,6
Drágônbôrn,tichondrius,575,paladin,retribution,12,6,6
Toscadin,ragnaros,575,paladin,retribution,12,6,6
Skelà,sargeras,575,paladin,retribution,12,6,6
Kelbii,sargeras,575,paladin,retribution,12,6,6
Rymondo,sargeras,575,paladin,retribution,15,7,8
Warboard,tichondrius,575,paladin,retribution,15,7,8
Trekpii,area-52,575,paladin,retribution,13,6,7
Faffyi,thunderlord,575,paladin,retribution,18,6,12
Valdi,stonemaul,575,paladin,retribution,18,6,12
Palpaladines,quelthalas,575,paladin,retribution,18,6,12
Cropcircles,whisperwind,575,paladin,retribution,18,6,12
Rheddbull,bonechewer,575,paladin,retribution,18,6,12
Nashtty,guldan,575,paladin,retribution,18,6,12
Paladatrox,ragnaros,575,paladin,retribution,18,6,12
Oceangal,illidan,575,paladin,retribution,18,6,12
Goomie,icecrown,575,paladin,retribution,18,6,12
Anoleak,tichondrius,575,paladin,retribution,18,6,12
Haziel,darkspear,575,paladin,retribution,18,6,12
Killstien,illidan,575,paladin,retribution,24,6,18
Vecknilashx,quelthalas,575,paladin,retribution,24,6,18
Korann,proudmoore,574,paladin,retribution,12,6,6
Freiror,azralon,574,paladin,retribution,12,6,6
Crithealss,dalaran,574,paladin,retribution,12,6,6
Ihmperiuus,quelthalas,574,paladin,retribution,12,6,6
Runebane,doomhammer,574,paladin,retribution,12,6,6
Clasheoff,mannoroth,574,paladin,retribution,12,6,6
Zuezz,korialstrasz,574,paladin,retribution,12,6,6
Kkrewk,illidan,574,paladin,retribution,12,6,6
Waycooltwo,darrowmere,574,paladin,retribution,12,6,6
Belzibuth,zuljin,574,paladin,retribution,12,6,6
Akeero,khaz-modan,574,paladin,retribution,12,6,6
Tamahu,azralon,574,paladin,retribution,18,6,12
Darqtank,smolderthorn,574,paladin,retribution,18,6,12
Halordriest,tichondrius,574,paladin,retribution,18,6,12
Judgemèntal,illidan,574,paladin,retribution,20,6,14
Tauyoshi,azjolnerub,573,paladin,retribution,12,6,6
Kuoch,shandris,573,paladin,retribution,18,6,12
Gotbrogurt,hyjal,573,paladin,retribution,24,6,18
Alluxian,zuljin,573,paladin,retribution,24,6,18
Chadrickk,tichondrius,572,paladin,retribution,12,6,6
Thorbrecht,moon-guard,572,paladin,retribution,12,6,6
Callahan,frostwolf,572,paladin,retribution,12,6,6
Kalerien,wildhammer,571,paladin,retribution,12,6,6
Ajaex,area-52,571,paladin,retribution,12,6,6
Lucent,duskwood,571,paladin,retribution,18,6,12
Bunkalunk,lightbringer,570,paladin,retribution,15,6,9
Niáa,quelthalas,570,paladin,retribution,18,6,12
Ginwow,hakkar,570,paladin,retribution,18,6,12
Palâdino,azralon,568,paladin,retribution,21,7,14
Halldhyr,quelthalas,566,paladin,retribution,12,6,6
Lorawynn,cenarion-circle,557,paladin,retribution,11,6,5
Ssggk,proudmoore,553,paladin,retribution,17,6,11
Litara,malganis,544,paladin,retribution,16,6,10
Bringbackrmp,tichondrius,543,paladin,retribution,11,6,5
Zyllo,area-52,543,paladin,retribution,14,7,7
Holymanè,tichondrius,543,paladin,retribution,14,7,7
Gloren,garrosh,543,paladin,retribution,17,6,11
Silvversun,moon-guard,543,paladin,retribution,17,6,11
Suslazin,area-52,543,paladin,retribution,20,7,13
Fødãø,azralon,542,paladin,retribution,11,6,5
Sevrick,dalaran,542,paladin,retribution,11,6,5
Taegwyn,thunderlord,542,paladin,retribution,22,6,16
Criskaruz,ragnaros,542,paladin,retribution,23,6,17
Bruujqt,moon-guard,528,paladin,retribution,15,7,8
Hadagoodlay,zuljin,528,paladin,retribution,15,6,9
Svaanah,moon-guard,527,paladin,retribution,11,6,5
Sucris,kelthuzad,527,paladin,retribution,11,6,5
Tazzul,turalyon,527,paladin,retribution,15,7,8
Vardrik,darkspear,527,paladin,retribution,15,6,9
Yuriie,stormrage,527,paladin,retribution,17,6,11
Radiantheart,norgannon,525,paladin,retribution,11,6,5
Naarumaster,stormrage,522,paladin,retribution,17,8,9
Briaelyne,tichondrius,522,paladin,retribution,25,8,17
Spoelstra,dragonmaw,522,paladin,retribution,35,8,27
Swiftysh,ragnaros,521,paladin,retribution,15,7,8
Parkhwi,tichondrius,521,paladin,retribution,28,7,21
Holyjoe,area-52,512,paladin,retribution,10,6,4
Nathaniel,galakrond,511,paladin,retribution,14,6,8
Vonmagnus,sargeras,511,paladin,retribution,16,6,10
Phelix,lightninghoof,511,paladin,retribution,16,6,10
ßìgdám,bleeding-hollow,511,paladin,retribution,17,6,11
Javiermiléi,quelthalas,511,paladin,retribution,26,6,20
Pemodyne,illidan,495,paladin,retribution,13,6,7
Spàrhawke,stormrage,495,paladin,retribution,13,6,7
Fionax,frostmourne,495,paladin,retribution,21,6,15
Senorwang,dalaran,494,paladin,retribution,13,6,7
Jùnmå,tichondrius,480,paladin,retribution,6,5,1
Mmrdonator,icecrown,480,paladin,retribution,6,5,1
Fistrozenemy,illidan,480,paladin,retribution,6,5,1
Gramsby,aggramar,480,paladin,retribution,6,5,1
Pickleparker,stormrage,480,paladin,retribution,6,5,1
Mandymuze,illidan,480,paladin,retribution,6,5,1
Kimitail,tichondrius,480,paladin,retribution,6,5,1
Bubblybuns,proudmoore,480,paladin,retribution,6,5,1
Moozafa,kiljaeden,480,paladin,retribution,6,5,1
Corevp,frostmourne,480,paladin,retribution,6,5,1
Everwaken,ragnaros,480,paladin,retribution,6,5,1
Ganrof,mugthol,480,paladin,retribution,6,5,1
Bauschret,thrall,480,paladin,retribution,6,5,1
Lafasíta,ragnaros,480,paladin,retribution,6,5,1
Mardrïus,tichondrius,480,paladin,retribution,6,5,1
Van,tichondrius,480,paladin,retribution,6,5,1
Zormzer,saurfang,480,paladin,retribution,6,5,1
Rekindle,barthilas,480,paladin,retribution,6,5,1
Adrieoss,stormrage,480,paladin,retribution,6,5,1
Speedlight,ragnaros,480,paladin,retribution,6,5,1
Tenkäi,quelthalas,480,paladin,retribution,6,5,1
Oldlemon,tichondrius,480,paladin,retribution,6,5,1
Ezas,moon-guard,480,paladin,retribution,6,5,1
Rangedmelee,stormrage,480,paladin,retribution,6,5,1
Mythîcxd,tichondrius,480,paladin,retribution,6,5,1
Einjerhar,quelthalas,480,paladin,retribution,6,5,1
Riival,stormrage,480,paladin,retribution,6,5,1
Iamurpal,hakkar,480,paladin,retribution,6,5,1
Dragon,uldum,480,paladin,retribution,6,5,1
Silviis,stormrage,480,paladin,retribution,6,5,1
Wambo,emerald-dream,480,paladin,retribution,6,5,1
Mcjudgin,kilrogg,480,paladin,retribution,6,5,1
Wabnote,twisting-nether,480,paladin,retribution,6,5,1
Gayonhands,proudmoore,480,paladin,retribution,6,5,1
Demetriusxy,tichondrius,480,paladin,retribution,6,5,1
Kongo,darkspear,480,paladin,retribution,6,5,1
Dawnhammer,mugthol,480,paladin,retribution,6,5,1
Romeh,malganis,480,paladin,retribution,8,5,3
Biggbraiin,drakkari,480,paladin,retribution,10,6,4
Bootscrapper,sargeras,480,paladin,retribution,11,6,5
Siamac,illidan,480,paladin,retribution,13,7,6
Goodwood,ghostlands,480,paladin,retribution,12,6,6
Bigbleuu,kiljaeden,480,paladin,retribution,12,5,7
Vain,shuhalo,480,paladin,retribution,12,5,7
Mikeawk,tichondrius,480,paladin,retribution,12,5,7
Cedwarlancy,sargeras,480,paladin,retribution,12,5,7
Hekcthor,ragnaros,480,paladin,retribution,12,5,7
Minzyp,illidan,480,paladin,retribution,12,5,7
Critadins,thrall,480,paladin,retribution,12,5,7
Saulhudson,bleeding-hollow,480,paladin,retribution,12,5,7
Stamptime,emerald-dream,480,paladin,retribution,12,5,7
Crucifuk,sargeras,480,paladin,retribution,12,5,7
Holydawa,zuljin,480,paladin,retribution,12,5,7
Holyyness,bleeding-hollow,480,paladin,retribution,12,5,7
Diplomacy,illidan,480,paladin,retribution,12,5,7
Akain,tichondrius,480,paladin,retribution,12,5,7
Dimsimbar,frostmourne,480,paladin,retribution,12,5,7
Isevp,illidan,480,paladin,retribution,12,5,7
Foxesshadow,tichondrius,480,paladin,retribution,12,5,7
Cranick,bleeding-hollow,480,paladin,retribution,12,5,7
Callandør,illidan,480,paladin,retribution,12,5,7
Liadryn,kiljaeden,480,paladin,retribution,12,5,7
Swishey,tichondrius,480,paladin,retribution,12,5,7
Banglin,draenor,480,paladin,retribution,12,5,7
Pirupiru,quelthalas,480,paladin,retribution,12,5,7
Nohtu,quelthalas,480,paladin,retribution,12,5,7
Thickgirl,bleeding-hollow,480,paladin,retribution,12,5,7
Seratonyn,malganis,480,paladin,retribution,12,5,7
Gotenks,trollbane,480,paladin,retribution,12,5,7
Gennara,ragnaros,480,paladin,retribution,12,5,7
Gavriel,quelthalas,480,paladin,retribution,12,5,7
Baelmun,thrall,480,paladin,retribution,12,5,7
Wahpop,sargeras,480,paladin,retribution,12,5,7
Merphy,tichondrius,480,paladin,retribution,12,5,7
Shadòw,emerald-dream,480,paladin,retribution,12,5,7
Aaronciy,tichondrius,480,paladin,retribution,12,5,7
Keelroi,sargeras,480,paladin,retribution,12,5,7
Thrasheric,ragnaros,480,paladin,retribution,12,5,7
Luxetveritas,tichondrius,480,paladin,retribution,12,5,7
Òtis,illidan,480,paladin,retribution,12,5,7
Jadedx,stormrage,480,paladin,retribution,12,5,7
Mickelodeon,sargeras,480,paladin,retribution,12,5,7
Hkingx,frostwolf,480,paladin,retribution,12,5,7
Rikku,undermine,480,paladin,retribution,12,5,7
Chenghisret,tichondrius,480,paladin,retribution,12,5,7
Jonbonholy,sargeras,480,paladin,retribution,12,5,7
Lastal,kiljaeden,480,paladin,retribution,12,5,7
Theraptos,frostmourne,480,paladin,retribution,12,5,7
Maxduo,bleeding-hollow,480,paladin,retribution,12,5,7
Luminali,frostwolf,480,paladin,retribution,12,5,7
Shieldgrab,illidan,480,paladin,retribution,12,5,7
Aeolus,uldaman,480,paladin,retribution,12,5,7
Wreckina,tichondrius,480,paladin,retribution,12,5,7
Dillionharpr,quelthalas,480,paladin,retribution,12,5,7
Wonas,ragnaros,480,paladin,retribution,12,5,7
Holybubble,silvermoon,480,paladin,retribution,12,5,7
Heyboboh,sargeras,480,paladin,retribution,12,5,7
Perasticus,garrosh,480,paladin,retribution,12,5,7
Ganster,dreadmaul,480,paladin,retribution,12,5,7
Hallastus,stormrage,480,paladin,retribution,12,5,7
Metalpriest,shattered-halls,480,paladin,retribution,12,5,7
Suddify,area-52,480,paladin,retribution,12,5,7
Methor,thrall,480,paladin,retribution,12,5,7
Supasavage,maiev,480,paladin,retribution,12,5,7
Jaenus,azralon,480,paladin,retribution,12,5,7
Silreck,ragnaros,480,paladin,retribution,12,5,7
Faithkiller,garrosh,480,paladin,retribution,12,5,7
Níngjìngy,tichondrius,480,paladin,retribution,12,5,7
Delaswing,quelthalas,480,paladin,retribution,12,5,7
PlayerJVYTBC,hyjal,480,paladin,retribution,12,5,7
Sabericdos,proudmoore,480,paladin,retribution,12,5,7
Líønheart,stormrage,480,paladin,retribution,12,5,7
Redearth,bleeding-hollow,480,paladin,retribution,12,5,7
Beatman,blades-edge,480,paladin,retribution,12,5,7
Joonzu,frostmane,480,paladin,retribution,12,5,7
Swoliikus,kelthuzad,480,paladin,retribution,12,5,7
Adorhon,staghelm,480,paladin,retribution,12,5,7
Funk,sargeras,480,paladin,retribution,12,5,7
Röniin,ragnaros,480,paladin,retribution,12,5,7
Principe,queldorei,480,paladin,retribution,12,5,7
Fistopain,staghelm,480,paladin,retribution,12,5,7
Dipho,illidan,480,paladin,retribution,12,5,7
Polisexüs,azralon,480,paladin,retribution,12,5,7
Kirklandbeef,gorefiend,480,paladin,retribution,12,5,7
Berapal,tichondrius,480,paladin,retribution,12,5,7
Judexd,frostmourne,480,paladin,retribution,12,5,7
Holyham,bonechewer,480,paladin,retribution,12,5,7
Tisu,kiljaeden,480,paladin,retribution,12,5,7
Hegarth,archimonde,480,paladin,retribution,12,5,7
Bigolhammer,khadgar,480,paladin,retribution,12,5,7
Yellowmay,sargeras,480,paladin,retribution,12,5,7
Héathèn,area-52,480,paladin,retribution,12,5,7
Undefeatæd,korgath,480,paladin,retribution,12,5,7
Rhaegorn,drakkari,480,paladin,retribution,12,5,7
Itaghí,sargeras,480,paladin,retribution,12,5,7
Hotnchocolat,stormrage,480,paladin,retribution,12,5,7
Dirtbagg,demon-soul,480,paladin,retribution,12,5,7
Randvi,sargeras,480,paladin,retribution,12,5,7
Jinuhn,illidan,480,paladin,retribution,12,5,7
Morganlily,moon-guard,480,paladin,retribution,12,5,7
Farmerzonly,tichondrius,480,paladin,retribution,12,5,7
Kitkatkiller,illidan,480,paladin,retribution,12,5,7
Noleyboo,proudmoore,480,paladin,retribution,12,5,7
Dehya,sargeras,480,paladin,retribution,12,5,7
Selentia,shadowmoon,480,paladin,retribution,12,5,7
Namiiswan,area-52,480,paladin,retribution,12,5,7
Valkaurus,drakkari,480,paladin,retribution,12,5,7
Lightknight,lothar,480,paladin,retribution,12,5,7
Pussandboots,cairne,480,paladin,retribution,12,5,7
Airane,sargeras,480,paladin,retribution,12,5,7
Balmain,moon-guard,480,paladin,retribution,12,5,7
Shinymoo,laughing-skull,480,paladin,retribution,12,5,7
Mikewazowski,chogall,480,paladin,retribution,12,5,7
Rakkhalar,ragnaros,480,paladin,retribution,12,5,7
Emotiza,illidan,480,paladin,retribution,12,5,7
Varezion,vashj,480,paladin,retribution,12,5,7
Alexpalad,sargeras,480,paladin,retribution,12,5,7
Gotwingz,moon-guard,480,paladin,retribution,12,5,7
Holytankadin,alleria,480,paladin,retribution,12,5,7
Ravage,lothar,480,paladin,retribution,12,5,7
Yahjp,khazgoroth,480,paladin,retribution,12,5,7
Utheer,quelthalas,480,paladin,retribution,12,5,7
Loctherion,ragnaros,480,paladin,retribution,12,5,7
Kaelel,barthilas,480,paladin,retribution,12,5,7
Ssawsy,illidan,480,paladin,retribution,12,5,7
Netguru,ragnaros,480,paladin,retribution,12,5,7
Kithrah,dathremar,480,paladin,retribution,12,5,7
Meith,ragnaros,480,paladin,retribution,12,5,7
Eonos,durotan,480,paladin,retribution,12,5,7
Trinkhammer,illidan,480,paladin,retribution,12,5,7
Yoroding,tichondrius,480,paladin,retribution,12,5,7
Toojazzyleah,proudmoore,480,paladin,retribution,12,5,7
Shiningtendi,aerie-peak,480,paladin,retribution,12,5,7
Nydenn,area-52,480,paladin,retribution,12,5,7
Únhøly,aegwynn,480,paladin,retribution,12,5,7
Xizzor,darkspear,480,paladin,retribution,12,5,7
Daddyspit,arthas,480,paladin,retribution,12,5,7
Wetterguuch,area-52,480,paladin,retribution,12,5,7
Shadomourne,arthas,480,paladin,retribution,12,5,7
Hattie,arthas,480,paladin,retribution,12,5,7
Ankmael,ragnaros,480,paladin,retribution,12,5,7
Lücid,arthas,480,paladin,retribution,12,5,7
Zulyourmom,tichondrius,480,paladin,retribution,12,5,7
Dinobe,arthas,480,paladin,retribution,12,5,7
Lumpylot,sargeras,480,paladin,retribution,12,5,7
Pallypallyy,aerie-peak,480,paladin,retribution,12,5,7
Morbop,proudmoore,480,paladin,retribution,12,5,7
Kuyueh,tichondrius,480,paladin,retribution,12,5,7
Bold,frostmourne,480,paladin,retribution,12,5,7
Freerating,moon-guard,480,paladin,retribution,15,6,9
Ckrim,malganis,480,paladin,retribution,16,5,11
Thepeony,tichondrius,480,paladin,retribution,17,5,12
Moltensilver,emerald-dream,480,paladin,retribution,18,5,13
Reehzlol,stormrage,480,paladin,retribution,18,5,13
Ztpz,illidan,480,paladin,retribution,18,5,13
Zightmare,azralon,480,paladin,retribution,18,5,13
Downs,tichondrius,480,paladin,retribution,18,5,13
Purged,wyrmrest-accord,480,paladin,retribution,18,5,13
Spunkbringer,zuljin,480,paladin,retribution,18,5,13
Iridicent,quelthalas,480,paladin,retribution,18,5,13
Seraphim,tichondrius,480,paladin,retribution,18,5,13
Gashlycrumb,tichondrius,480,paladin,retribution,18,5,13
Tikkun,area-52,480,paladin,retribution,18,5,13
Odiato,stormrage,480,paladin,retribution,18,5,13
Bigboynathan,frostmourne,480,paladin,retribution,18,5,13
Gingibeno,tichondrius,480,paladin,retribution,18,5,13
Unspankable,burning-legion,480,paladin,retribution,18,5,13
Ilsey,ragnaros,480,paladin,retribution,18,5,13
Kallandar,moon-guard,480,paladin,retribution,18,5,13
Sleepybiden,darkspear,480,paladin,retribution,18,5,13
Spótt,stormrage,480,paladin,retribution,18,5,13
Melgamis,quelthalas,480,paladin,retribution,18,5,13
Tivorr,proudmoore,480,paladin,retribution,18,5,13
Harke,drakkari,480,paladin,retribution,18,5,13
Alibuda,tichondrius,480,paladin,retribution,18,5,13
Papazon,tichondrius,480,paladin,retribution,18,5,13
Razuel,frostmourne,480,paladin,retribution,18,5,13
Furrpally,tichondrius,480,paladin,retribution,18,5,13
Photons,emerald-dream,480,paladin,retribution,18,5,13
Theril,kelthuzad,480,paladin,retribution,18,5,13
Alínna,ragnaros,480,paladin,retribution,18,5,13
Deecompose,sargeras,480,paladin,retribution,18,5,13
Grïmaldus,moon-guard,480,paladin,retribution,19,5,14
Firexfist,gurubashi,480,paladin,retribution,24,5,19
Azdan,ragnaros,480,paladin,retribution,30,5,25
Kremation,zuljin,479,paladin,retribution,6,5,1
Palaknight,tichondrius,479,paladin,retribution,6,5,1
Reidolitrao,nemesis,479,paladin,retribution,6,5,1
Ajaxen,azshara,479,paladin,retribution,6,5,1
Asttryd,barthilas,479,paladin,retribution,12,7,5
Orrvar,tichondrius,479,paladin,retribution,12,5,7
Giricoret,azralon,479,paladin,retribution,12,5,7
Murderous,frostmourne,479,paladin,retribution,12,5,7
Sgtskittles,aggramar,479,paladin,retribution,12,5,7
Inqa,thunderlord,479,paladin,retribution,12,5,7
Ashera,amanthul,479,paladin,retribution,12,5,7
Maswell,emerald-dream,479,paladin,retribution,12,5,7
Farvadin,illidan,479,paladin,retribution,12,5,7
Zelrich,moon-guard,479,paladin,retribution,12,5,7
Krabbiepatty,wyrmrest-accord,479,paladin,retribution,12,5,7
Chrisqwa,sargeras,479,paladin,retribution,12,5,7
Evielia,tichondrius,479,paladin,retribution,12,5,7
Reedeemer,bonechewer,479,paladin,retribution,12,5,7
Memoríez,zuljin,479,paladin,retribution,12,5,7
Noctis,nerzhul,479,paladin,retribution,12,5,7
Minjikim,tichondrius,479,paladin,retribution,12,5,7
Heneaz,quelthalas,479,paladin,retribution,12,5,7
Robz,malygos,479,paladin,retribution,12,5,7
Shakemup,stormrage,479,paladin,retribution,12,5,7
Cóg,area-52,479,paladin,retribution,12,5,7
Ðarksealz,laughing-skull,479,paladin,retribution,12,5,7
Kaylafell,kelthuzad,479,paladin,retribution,12,5,7
Khels,gilneas,479,paladin,retribution,12,5,7
Rayrunner,tanaris,479,paladin,retribution,12,5,7
Chillstone,tichondrius,479,paladin,retribution,15,6,9
Jankytank,area-52,479,paladin,retribution,17,5,12
Griz,magtheridon,479,paladin,retribution,18,5,13
Provail,stormrage,479,paladin,retribution,18,5,13
Holyzolt,zuljin,479,paladin,retribution,18,5,13
Agelikos,moon-guard,479,paladin,retribution,18,5,13
Oilme,bleeding-hollow,479,paladin,retribution,18,5,13
Disconnect,azjolnerub,479,paladin,retribution,24,5,19
Kajoruun,bleeding-hollow,479,paladin,retribution,24,5,19
Palypunchh,darrowmere,478,paladin,retribution,12,6,6
Chengduqq,illidan,478,paladin,retribution,12,5,7
Ashheart,the-venture-co,478,paladin,retribution,12,5,7
Impia,tichondrius,478,paladin,retribution,12,5,7
Lagun,wyrmrest-accord,478,paladin,retribution,12,5,7
Herbzilla,haomarush,478,paladin,retribution,12,5,7
Neipala,ragnaros,478,paladin,retribution,12,5,7
Vonfraud,lightbringer,478,paladin,retribution,18,5,13
Alvis,kiljaeden,478,paladin,retribution,24,5,19
Benzen,bleeding-hollow,477,paladin,retribution,12,5,7
Jammsheed,arthas,477,paladin,retribution,12,5,7
Anard,eredar,477,paladin,retribution,13,5,8
Kaminasol,quelthalas,477,paladin,retribution,18,5,13
Nastenatren,steamwheedle-cartel,477,paladin,retribution,24,5,19
Pedromuulos,misha,477,paladin,retribution,24,5,19
Solstein,dalaran,474,paladin,retribution,12,5,7
Dubaron,burning-blade,473,paladin,retribution,12,5,7
Torms,illidan,463,paladin,retribution,15,7,8
Kforty,kiljaeden,458,paladin,retribution,18,7,11
Thepallyx,silvermoon,448,paladin,retribution,16,5,11
Lamp,lothar,447,paladin,retribution,8,6,2
Gexqt,dalaran,447,paladin,retribution,8,6,2
Remake,stormrage,447,paladin,retribution,8,6,2
Bloodybill,frostmane,447,paladin,retribution,11,5,6
Jireen,tichondrius,447,paladin,retribution,11,5,6
Asarul,ragnaros,447,paladin,retribution,14,6,8
Clarïtý,stormrage,446,paladin,retribution,20,6,14
Holythanos,bleeding-hollow,445,paladin,retribution,17,5,12
Árèz,frostmourne,441,paladin,retribution,17,7,10
Darkgoku,malfurion,432,paladin,retribution,9,6,3
Lorgax,alterac-mountains,432,paladin,retribution,15,5,10
Zzf,turalyon,431,paladin,retribution,11,5,6
Dreadrein,tichondrius,431,paladin,retribution,11,5,6
Dolorîo,ragnaros,431,paladin,retribution,11,5,6
Thomir,tichondrius,431,paladin,retribution,11,5,6
Neverforgot,quelthalas,431,paladin,retribution,11,5,6
Sinsy,moon-guard,431,paladin,retribution,11,5,6
Anoxis,tichondrius,431,paladin,retribution,11,5,6
Ahzreal,garona,426,paladin,retribution,16,8,8
Hálløwéð,firetree,426,paladin,retribution,14,6,8
Stankylordz,sargeras,426,paladin,retribution,19,8,11
Fálko,azralon,426,paladin,retribution,17,6,11
Rashrind,moon-guard,426,paladin,retribution,23,8,15
Sundher,ragnaros,426,paladin,retribution,29,7,22
Kimochiyuh,illidan,425,paladin,retribution,17,7,10
Retoric,maelstrom,425,paladin,retribution,22,6,16
Yemotis,emerald-dream,416,paladin,retribution,10,5,5
Ææøææøææøææø,illidan,416,paladin,retribution,10,5,5
Molodino,nemesis,416,paladin,retribution,10,5,5
Lndrenk,gallywix,416,paladin,retribution,13,5,8
Divinedabs,stormrage,416,paladin,retribution,22,5,17
Stahny,thrall,415,paladin,retribution,10,5,5
Hrödric,stormrage,415,paladin,retribution,11,5,6
Saviorsavior,bleeding-hollow,415,paladin,retribution,11,5,6
Argonis,shadowsong,415,paladin,retribution,14,5,9
Epxilon,ragnaros,415,paladin,retribution,14,5,9
Waffulzz,moonrunner,415,paladin,retribution,20,5,15
Rainingrets,tichondrius,404,paladin,retribution,28,10,18
Thechoseno,tichondrius,400,paladin,retribution,13,5,8
Iamriched,illidan,400,paladin,retribution,13,5,8
Sydnneeyy,kelthuzad,399,paladin,retribution,5,5,0
Anstyl,moon-guard,384,paladin,retribution,6,4,2
Restarting,tichondrius,384,paladin,retribution,6,4,2
Truekylos,tichondrius,384,paladin,retribution,6,4,2
Rohlin,boulderfist,384,paladin,retribution,6,4,2
Dévour,dalaran,384,paladin,retribution,6,4,2
Plottwists,bleeding-hollow,384,paladin,retribution,6,4,2
Dörisseline,bleeding-hollow,384,paladin,retribution,6,4,2
Inactive,gilneas,384,paladin,retribution,6,4,2
Wyrmblood,moon-guard,384,paladin,retribution,6,4,2
Mesiaussx,area-52,384,paladin,retribution,6,4,2
Lilpéep,area-52,384,paladin,retribution,6,4,2
Ödïösïtä,area-52,384,paladin,retribution,6,4,2
Heyroe,madoran,384,paladin,retribution,6,4,2
Tyranoss,azralon,384,paladin,retribution,6,4,2
Salithan,gilneas,384,paladin,retribution,6,4,2
Crocfacex,tichondrius,384,paladin,retribution,6,4,2
Trynith,area-52,384,paladin,retribution,6,4,2
Impitoyable,illidan,384,paladin,retribution,6,4,2
Warspite,caelestrasz,384,paladin,retribution,6,4,2
Vxm,illidan,384,paladin,retribution,6,4,2
Xs,nagrand,384,paladin,retribution,6,4,2
Holywingz,moon-guard,384,paladin,retribution,6,4,2
Darklyght,madoran,384,paladin,retribution,6,4,2
Easiestclass,azshara,384,paladin,retribution,6,4,2
Temptrez,bleeding-hollow,384,paladin,retribution,6,4,2
Goontaa,staghelm,384,paladin,retribution,6,4,2
Gooeylouie,thunderlord,384,paladin,retribution,6,4,2
Luviah,proudmoore,384,paladin,retribution,6,4,2
Sensatione,tichondrius,384,paladin,retribution,6,4,2
Raphaelo,tichondrius,384,paladin,retribution,6,4,2
Pronther,ragnaros,384,paladin,retribution,6,4,2
Seven,blackwing-lair,384,paladin,retribution,6,4,2
Anaxxie,azralon,384,paladin,retribution,6,4,2
Stavs,tichondrius,384,paladin,retribution,6,4,2
Dartárok,ragnaros,384,paladin,retribution,6,4,2
Couraegus,azgalor,384,paladin,retribution,6,4,2
Pray,thunderlord,384,paladin,retribution,6,4,2
Mhuzz,nemesis,384,paladin,retribution,6,4,2
Chunggus,eredar,384,paladin,retribution,6,4,2
Smunder,wyrmrest-accord,384,paladin,retribution,6,4,2
Crewsade,sargeras,384,paladin,retribution,6,4,2
Trisøn,area-52,384,paladin,retribution,6,4,2
Taiffan,azralon,384,paladin,retribution,6,4,2
Lalatinaford,amanthul,384,paladin,retribution,6,4,2
Bubblebùtt,tichondrius,384,paladin,retribution,6,4,2
Heilsleicht,thrall,384,paladin,retribution,6,4,2
Slakyph,zuljin,384,paladin,retribution,6,4,2
Doç,stormrage,384,paladin,retribution,6,4,2
Laventus,area-52,384,paladin,retribution,6,4,2
Kaypross,area-52,384,paladin,retribution,6,4,2
Aohxmathoss,zuljin,384,paladin,retribution,6,4,2
Xöchïqüëtzäl,tichondrius,384,paladin,retribution,6,4,2
Gilgamesh,moonrunner,384,paladin,retribution,6,4,2
Drakewood,moon-guard,384,paladin,retribution,6,4,2
Reclusiarch,tichondrius,384,paladin,retribution,6,4,2
Daylit,proudmoore,384,paladin,retribution,6,4,2
Lothremar,stormrage,384,paladin,retribution,6,4,2
Protopally,zuljin,384,paladin,retribution,6,4,2
Bastila,zuljin,384,paladin,retribution,6,4,2
Patrikuu,tichondrius,384,paladin,retribution,6,4,2
Flfltmf,tichondrius,384,paladin,retribution,6,4,2
Plateßound,black-dragonflight,384,paladin,retribution,6,4,2
Thottylight,stormrage,384,paladin,retribution,6,4,2
Bmorezaddy,tichondrius,384,paladin,retribution,6,4,2
Babylonfive,zuluhed,384,paladin,retribution,6,4,2
Yehovah,frostmourne,384,paladin,retribution,6,4,2
Sentence,moon-guard,384,paladin,retribution,6,4,2
Fxxku,tichondrius,384,paladin,retribution,6,4,2
Hugëhammer,emerald-dream,384,paladin,retribution,6,4,2
Tanrid,moon-guard,384,paladin,retribution,6,4,2
Dazztrain,barthilas,384,paladin,retribution,6,4,2
Ashlín,sargeras,384,paladin,retribution,6,4,2
Canibaluy,ragnaros,384,paladin,retribution,6,4,2
Holykevobird,maiev,384,paladin,retribution,6,4,2
Täintcrusher,illidan,384,paladin,retribution,6,4,2
Leoros,blackrock,384,paladin,retribution,6,4,2
Juiol,frostmourne,384,paladin,retribution,6,4,2
Reckoniing,moon-guard,384,paladin,retribution,6,4,2
Koal,area-52,384,paladin,retribution,6,4,2
Dyreilas,stormrage,384,paladin,retribution,6,4,2
Notaefc,icecrown,384,paladin,retribution,6,4,2
Aymer,thrall,384,paladin,retribution,6,4,2
Holysimp,anetheron,384,paladin,retribution,6,4,2
Debonaire,cenarion-circle,384,paladin,retribution,6,4,2
Shadp,frostmourne,384,paladin,retribution,6,4,2
Giancarloss,quelthalas,384,paladin,retribution,6,4,2
Krewe,uldaman,384,paladin,retribution,6,4,2
Liebesleid,quelthalas,384,paladin,retribution,6,4,2
Rubain,kiljaeden,384,paladin,retribution,6,4,2
Legionare,quelthalas,384,paladin,retribution,6,4,2
Aswaran,jaedenar,384,paladin,retribution,6,4,2
Ironpallyx,garrosh,384,paladin,retribution,6,4,2
Redempshun,drenden,384,paladin,retribution,6,4,2
Ascencer,spirestone,384,paladin,retribution,6,4,2
Sasukee,quelthalas,384,paladin,retribution,6,4,2
Maeldart,quelthalas,384,paladin,retribution,6,4,2
Owllii,frostwolf,384,paladin,retribution,6,4,2
Farlayne,quelthalas,384,paladin,retribution,6,4,2
Ashgrim,kiljaeden,384,paladin,retribution,6,4,2
Cenital,quelthalas,384,paladin,retribution,6,4,2
Merlinä,illidan,384,paladin,retribution,7,4,3
Bigddady,quelthalas,384,paladin,retribution,8,4,4
Armilus,area-52,384,paladin,retribution,11,5,6
Minaxx,dalaran,384,paladin,retribution,9,4,5
Unluckopal,illidan,384,paladin,retribution,11,4,7
Thõre,frostmourne,384,paladin,retribution,15,5,10
Smöke,frostmourne,384,paladin,retribution,12,4,8
Kyrianjutsu,area-52,384,paladin,retribution,12,4,8
Niolite,ragnaros,384,paladin,retribution,12,4,8
Zexion,azralon,384,paladin,retribution,12,4,8
Korijame,area-52,384,paladin,retribution,12,4,8
Salvatores,ragnaros,384,paladin,retribution,12,4,8
Goodgardener,hyjal,384,paladin,retribution,12,4,8
Jimithing,senjin,384,paladin,retribution,12,4,8
Kynndra,azralon,384,paladin,retribution,12,4,8
Réxul,ragnaros,384,paladin,retribution,12,4,8
Maelificus,aggramar,384,paladin,retribution,12,4,8
Dohsevèn,tichondrius,384,paladin,retribution,12,4,8
Blargnarg,area-52,384,paladin,retribution,12,4,8
Holywrecked,khazgoroth,384,paladin,retribution,12,4,8
Andromëdä,hyjal,384,paladin,retribution,12,4,8
Bauldrin,moon-guard,384,paladin,retribution,12,4,8
Grimdel,moon-guard,384,paladin,retribution,12,4,8
Varuul,nerzhul,384,paladin,retribution,12,4,8
Ippótis,sargeras,384,paladin,retribution,12,4,8
Turahk,amanthul,384,paladin,retribution,12,4,8
Passinpeace,tichondrius,384,paladin,retribution,12,4,8
Veshral,arthas,384,paladin,retribution,12,4,8
Thorkell,moon-guard,384,paladin,retribution,12,4,8
Blikzy,caelestrasz,384,paladin,retribution,12,4,8
Mashy,moon-guard,384,paladin,retribution,12,4,8
Avataar,blades-edge,384,paladin,retribution,12,4,8
Gripadin,tichondrius,384,paladin,retribution,12,4,8
Vhaun,cairne,384,paladin,retribution,12,4,8
Oppaladin,elune,384,paladin,retribution,12,4,8
Joepepperoni,korgath,384,paladin,retribution,12,4,8
Nicc,kelthuzad,384,paladin,retribution,12,4,8
Givinpowpows,korgath,384,paladin,retribution,12,4,8
Goloh,shadowmoon,384,paladin,retribution,12,4,8
Baptism,shattered-hand,384,paladin,retribution,12,4,8
Øathßreaker,laughing-skull,384,paladin,retribution,12,4,8
Prettylightx,kelthuzad,384,paladin,retribution,12,4,8
Picorii,frostmourne,384,paladin,retribution,12,4,8
Lokkillos,drakkari,384,paladin,retribution,12,4,8
Leail,frostmourne,384,paladin,retribution,12,4,8
Crazysyco,proudmoore,384,paladin,retribution,12,4,8
Illhaveacoke,moon-guard,384,paladin,retribution,12,4,8
Lenneth,nordrassil,384,paladin,retribution,12,4,8
Strøngwin,bleeding-hollow,384,paladin,retribution,12,4,8
Juliusplzher,area-52,384,paladin,retribution,12,4,8
Ddawz,proudmoore,384,paladin,retribution,12,4,8
Remm,emerald-dream,384,paladin,retribution,12,4,8
Zakh,proudmoore,384,paladin,retribution,12,4,8
Tëmplar,bleeding-hollow,384,paladin,retribution,12,4,8
Treboroyal,area-52,384,paladin,retribution,12,4,8
Catuvalos,kiljaeden,384,paladin,retribution,12,4,8
Simpforomenx,emerald-dream,384,paladin,retribution,12,4,8
Bracen,emerald-dream,384,paladin,retribution,12,4,8
Strugglèbus,thrall,384,paladin,retribution,12,4,8
Justsaiyen,bleeding-hollow,384,paladin,retribution,12,4,8
Botch,drenden,384,paladin,retribution,12,4,8
Rightz,muradin,384,paladin,retribution,12,4,8
Wards,thunderlord,384,paladin,retribution,12,4,8
Eddf,ursin,384,paladin,retribution,12,4,8
Roodictz,zuljin,384,paladin,retribution,12,4,8
Dose,moon-guard,384,paladin,retribution,12,4,8
Sweettartts,zuljin,384,paladin,retribution,12,4,8
Slimxx,burning-blade,384,paladin,retribution,12,4,8
Tyronethebbc,tichondrius,384,paladin,retribution,12,4,8
Aricen,thunderhorn,384,paladin,retribution,12,4,8
Lépéedophil,zuljin,384,paladin,retribution,12,4,8
Tirinor,malganis,384,paladin,retribution,12,4,8
Lightmodel,sargeras,384,paladin,retribution,12,4,8
Kratosq,tichondrius,384,paladin,retribution,12,4,8
Fiorena,malganis,384,paladin,retribution,12,4,8
Pallyforeva,sargeras,384,paladin,retribution,12,4,8
Bubblestuft,illidan,384,paladin,retribution,12,4,8
Dionysius,silvermoon,384,paladin,retribution,12,4,8
Craphtyßop,zuljin,384,paladin,retribution,12,4,8
Kegari,tichondrius,384,paladin,retribution,12,4,8
Fengyutongqs,tichondrius,384,paladin,retribution,12,4,8
Greenracer,kiljaeden,384,paladin,retribution,12,4,8
Smontis,sargeras,384,paladin,retribution,12,4,8
Whoowhat,zuljin,384,paladin,retribution,12,4,8
Dezul,stormscale,384,paladin,retribution,12,4,8
Kurook,moon-guard,384,paladin,retribution,12,4,8
Ihitthose,moon-guard,384,paladin,retribution,12,4,8
Hølyknìght,tichondrius,384,paladin,retribution,12,4,8
Rouzygoozy,illidan,384,paladin,retribution,12,4,8
Icekiss,tichondrius,384,paladin,retribution,12,4,8
Àpolo,stormrage,384,paladin,retribution,12,4,8
Paldan,illidan,384,paladin,retribution,12,4,8
Volphorix,illidan,384,paladin,retribution,12,4,8
Senion,velen,384,paladin,retribution,12,4,8
Palinator,bleeding-hollow,384,paladin,retribution,12,4,8
Tufybighamer,malganis,384,paladin,retribution,12,4,8
Aidillon,shadowsong,384,paladin,retribution,12,4,8
Norider,trollbane,384,paladin,retribution,12,4,8
Ðorlie,malganis,384,paladin,retribution,12,4,8
Elflicious,illidan,384,paladin,retribution,12,4,8
Gloryholy,shattered-hand,384,paladin,retribution,12,4,8
Retspec,darkspear,384,paladin,retribution,12,4,8
Thejüdge,malfurion,384,paladin,retribution,12,4,8
Coltoniac,kaelthas,384,paladin,retribution,12,4,8
Tymy,tichondrius,384,paladin,retribution,12,4,8
Sethy,feathermoon,384,paladin,retribution,12,4,8
Evilmoocow,grizzly-hills,384,paladin,retribution,12,4,8
Exolust,dalaran,384,paladin,retribution,12,4,8
Phattpump,tichondrius,384,paladin,retribution,12,4,8
Mikeelul,tichondrius,384,paladin,retribution,12,4,8
Mirâ,tichondrius,384,paladin,retribution,12,4,8
Taelpalx,stormrage,384,paladin,retribution,12,4,8
Oroürke,stormrage,384,paladin,retribution,12,4,8
Gerudö,stormrage,384,paladin,retribution,12,4,8
Simonis,windrunner,384,paladin,retribution,12,4,8
Ifearphil,illidan,384,paladin,retribution,12,4,8
Pogwogs,illidan,384,paladin,retribution,12,4,8
Kiami,tichondrius,384,paladin,retribution,12,4,8
Drakensang,tichondrius,384,paladin,retribution,12,4,8
Msjudged,blackrock,384,paladin,retribution,12,4,8
Uver,tichondrius,384,paladin,retribution,12,4,8
Thêirin,lightbringer,384,paladin,retribution,12,4,8
Bubblendash,stormrage,384,paladin,retribution,12,4,8
Glexann,sargeras,384,paladin,retribution,12,4,8
Jeddmaus,tichondrius,384,paladin,retribution,12,4,8
Adauto,illidan,384,paladin,retribution,12,4,8
Thaleros,tichondrius,384,paladin,retribution,12,4,8
Sigmapepe,quelthalas,384,paladin,retribution,12,4,8
Kamianna,tichondrius,384,paladin,retribution,12,4,8
Cafre,illidan,384,paladin,retribution,12,4,8
Adrn,tichondrius,384,paladin,retribution,12,4,8
Tacsi,daggerspine,384,paladin,retribution,12,4,8
Bangerr,bonechewer,384,paladin,retribution,12,4,8
Eettooko,aegwynn,384,paladin,retribution,12,4,8
Crystahlmeth,sargeras,384,paladin,retribution,12,4,8
Acquiesce,bleeding-hollow,384,paladin,retribution,16,5,11
Batmanp,quelthalas,384,paladin,retribution,13,4,9
Siton,rexxar,384,paladin,retribution,17,5,12
Androgeos,hyjal,384,paladin,retribution,18,4,14
Essexqt,blackhand,384,paladin,retribution,18,4,14
Fragnum,barthilas,384,paladin,retribution,18,4,14
Xinoh,area-52,384,paladin,retribution,18,4,14
Powercelest,quelthalas,384,paladin,retribution,18,4,14
Tylnish,hyjal,384,paladin,retribution,18,4,14
Theadona,runetotem,384,paladin,retribution,18,4,14
Ccpx,area-52,384,paladin,retribution,18,4,14
Momhips,bloodscalp,384,paladin,retribution,18,4,14
Cronodxl,quelthalas,384,paladin,retribution,18,4,14
Milfcrusader,tichondrius,384,paladin,retribution,18,4,14
Malisaa,tichondrius,384,paladin,retribution,18,4,14
Talurius,azralon,384,paladin,retribution,18,4,14
Draknals,illidan,384,paladin,retribution,18,4,14
Retsáiyan,tichondrius,384,paladin,retribution,18,4,14
ßén,bleeding-hollow,384,paladin,retribution,18,4,14
Deathret,tichondrius,384,paladin,retribution,18,4,14
Aeltharix,blackwater-raiders,384,paladin,retribution,18,4,14
Balancelight,azgalor,384,paladin,retribution,18,4,14
Caityaj,illidan,384,paladin,retribution,18,4,14
Deva,tichondrius,384,paladin,retribution,18,4,14
Axiskai,gorgonnash,384,paladin,retribution,18,4,14
Ongang,illidan,384,paladin,retribution,18,4,14
Iskándar,tichondrius,384,paladin,retribution,24,4,20
Matrium,kiljaeden,384,paladin,retribution,24,4,20
Mhakoi,bleeding-hollow,384,paladin,retribution,24,4,20
Backfattammy,bleeding-hollow,384,paladin,retribution,24,4,20
Sinficha,quelthalas,383,paladin,retribution,6,4,2
Tëxas,proudmoore,383,paladin,retribution,6,4,2
Themachon,stormrage,383,paladin,retribution,6,4,2
Pajjy,azralon,383,paladin,retribution,6,4,2
Charmeine,zuljin,383,paladin,retribution,6,4,2
Nasumi,emerald-dream,383,paladin,retribution,6,4,2
Balador,uldum,383,paladin,retribution,6,4,2
Keepitholy,tichondrius,383,paladin,retribution,6,4,2
Memorabilia,quelthalas,383,paladin,retribution,6,4,2
Adandon,dalaran,383,paladin,retribution,6,4,2
Dabsmaster,dalaran,383,paladin,retribution,6,4,2
Thaerim,ragnaros,383,paladin,retribution,6,4,2
Kennysun,azralon,383,paladin,retribution,12,4,8
Holyqt,thunderlord,383,paladin,retribution,12,4,8
Marijuanza,kalecgos,383,paladin,retribution,12,4,8
Sonecaks,gallywix,383,paladin,retribution,12,4,8
Holyburger,hakkar,383,paladin,retribution,12,4,8
Øexørcistta,nemesis,383,paladin,retribution,12,4,8
Escanorr,kargath,383,paladin,retribution,12,4,8
Gromuu,azralon,383,paladin,retribution,12,4,8
Amazarak,stormrage,383,paladin,retribution,12,4,8
Zko,frostmourne,383,paladin,retribution,12,4,8
Mugann,malganis,383,paladin,retribution,12,4,8
Thormonger,dalaran,383,paladin,retribution,20,5,15
Balnot,blackrock,383,paladin,retribution,18,4,14
Imimmune,garithos,383,paladin,retribution,18,4,14
Dago,azralon,383,paladin,retribution,18,4,14
Funkknight,sargeras,383,paladin,retribution,18,4,14
Stunnaax,frostmourne,383,paladin,retribution,18,4,14
Ðrekai,moon-guard,383,paladin,retribution,24,4,20
Paladocka,stormrage,383,paladin,retribution,24,4,20
Kenbad,aegwynn,382,paladin,retribution,6,4,2
Kungrowl,emerald-dream,382,paladin,retribution,6,4,2
Sundreland,moon-guard,382,paladin,retribution,12,4,8
Derpnstein,gorgonnash,382,paladin,retribution,12,4,8
Zedekia,aerie-peak,382,paladin,retribution,12,4,8
Amerok,malfurion,378,paladin,retribution,18,4,14
Nyms,gallywix,374,paladin,retribution,36,4,32
Vegetå,malganis,372,paladin,retribution,37,8,29
Novachrono,bladefist,367,paladin,retribution,9,5,4
Goinglarge,frostmourne,367,paladin,retribution,11,4,7
Barzø,tichondrius,367,paladin,retribution,11,4,7
Laydarus,frostmourne,367,paladin,retribution,11,4,7
Crucifine,wyrmrest-accord,367,paladin,retribution,11,4,7
Bostonbird,sargeras,367,paladin,retribution,17,4,13
Mop,eitrigg,367,paladin,retribution,17,4,13
Ssjgalen,tichondrius,352,paladin,retribution,10,4,6
Nohozano,area-52,352,paladin,retribution,10,4,6
Bibimbop,boulderfist,352,paladin,retribution,13,5,8
Gordonryan,bleeding-hollow,352,paladin,retribution,16,4,12
Trippierett,bloodscalp,352,paladin,retribution,22,4,18
Seasondbeef,shandris,351,paladin,retribution,11,4,7
Sesshomâru,nemesis,351,paladin,retribution,11,4,7
Joshius,argent-dawn,351,paladin,retribution,11,4,7
Sorgeno,ursin,351,paladin,retribution,11,4,7
Páladian,quelthalas,351,paladin,retribution,11,4,7
Conquistador,proudmoore,351,paladin,retribution,11,4,7
Estarosta,azralon,351,paladin,retribution,17,4,13
Titansnake,illidan,336,paladin,retribution,9,4,5
Meduselda,kelthuzad,335,paladin,retribution,9,5,4
Yellowflash,sentinels,330,paladin,retribution,17,7,10
Returdstrenf,illidan,330,paladin,retribution,20,5,15
Asolace,dark-iron,320,paladin,retribution,10,4,6
Dubbz,silvermoon,320,paladin,retribution,10,4,6
Junmá,tichondrius,319,paladin,retribution,5,4,1
Ruulight,tichondrius,319,paladin,retribution,5,4,1
Karig,sargeras,319,paladin,retribution,8,4,4
Jadelong,azshara,319,paladin,retribution,8,4,4
Holyshasha,tichondrius,319,paladin,retribution,8,4,4
Holynaps,malganis,319,paladin,retribution,9,4,5
Darkjewmagic,frostmourne,319,paladin,retribution,14,4,10
Lhury,quelthalas,319,paladin,retribution,14,4,10
Slopzy,sargeras,304,paladin,retribution,7,4,3
Torrthak,area-52,304,paladin,retribution,7,4,3
Naizen,tichondrius,304,paladin,retribution,7,4,3
Moobroken,shadowsong,304,paladin,retribution,7,4,3
Tûrbotax,sargeras,288,paladin,retribution,6,3,3
Lencelia,deathwing,288,paladin,retribution,6,3,3
Bigdmcgee,frostmourne,288,paladin,retribution,6,3,3
Lowbb,sargeras,288,paladin,retribution,6,3,3
Nickahunnid,sargeras,288,paladin,retribution,6,3,3
Vaels,sargeras,288,paladin,retribution,6,3,3
Chicoweather,sargeras,288,paladin,retribution,6,3,3
Xizima,ragnaros,288,paladin,retribution,6,3,3
Rectaluse,dalaran,288,paladin,retribution,6,3,3
Vük,destromath,288,paladin,retribution,6,3,3
Menjo,malganis,288,paladin,retribution,6,3,3
Wonpai,frostmourne,288,paladin,retribution,6,3,3
Morlunè,tichondrius,288,paladin,retribution,6,3,3
Gorillawings,tichondrius,288,paladin,retribution,6,3,3
Dfz,mannoroth,288,paladin,retribution,6,3,3
Therocker,darkspear,288,paladin,retribution,6,3,3
Astasia,laughing-skull,288,paladin,retribution,6,3,3
Spacebacon,thunderlord,288,paladin,retribution,6,3,3
Lynchmob,tichondrius,288,paladin,retribution,6,3,3
Qoop,tichondrius,288,paladin,retribution,6,3,3
Orangepa,dalaran,288,paladin,retribution,6,3,3
Alexrt,frostmourne,288,paladin,retribution,6,3,3
Transwoman,frostmourne,288,paladin,retribution,6,3,3
Mcfleye,malganis,288,paladin,retribution,6,3,3
Konyfotm,bleeding-hollow,288,paladin,retribution,6,3,3
Bubblet,bleeding-hollow,288,paladin,retribution,6,3,3
Reiot,sargeras,288,paladin,retribution,6,3,3
Moox,wyrmrest-accord,288,paladin,retribution,6,3,3
Divinebehind,laughing-skull,288,paladin,retribution,6,3,3
Boehab,silvermoon,288,paladin,retribution,6,3,3
Zilladin,darkspear,288,paladin,retribution,6,3,3
Shibbz,illidan,288,paladin,retribution,6,3,3
Kahleesy,sargeras,288,paladin,retribution,6,3,3
Mayfirepal,hyjal,288,paladin,retribution,6,3,3
Snippdeux,garrosh,288,paladin,retribution,6,3,3
Tahonto,malganis,288,paladin,retribution,6,3,3
Zenpally,doomhammer,288,paladin,retribution,6,3,3
Ulfsark,garrosh,288,paladin,retribution,6,3,3
Sâbër,moon-guard,288,paladin,retribution,6,3,3
Mvpp,dalaran,288,paladin,retribution,6,3,3
Ýøg,tichondrius,288,paladin,retribution,6,3,3
Flalis,gurubashi,288,paladin,retribution,6,3,3
Daigorro,illidan,288,paladin,retribution,6,3,3
Toomuchrac,tichondrius,288,paladin,retribution,6,3,3
Supawings,mugthol,288,paladin,retribution,6,3,3
Lituation,sargeras,288,paladin,retribution,6,3,3
Nyxkithar,nagrand,288,paladin,retribution,6,3,3
Twochains,aegwynn,288,paladin,retribution,6,3,3
Varo,laughing-skull,288,paladin,retribution,6,3,3
Bíteme,sargeras,288,paladin,retribution,6,3,3
Bootboi,thrall,288,paladin,retribution,6,3,3
Ilovedookie,destromath,288,paladin,retribution,6,3,3
Yês,proudmoore,288,paladin,retribution,6,3,3
Brodyb,malganis,288,paladin,retribution,6,3,3
Jazielh,quelthalas,288,paladin,retribution,6,3,3
Haarun,blackrock,288,paladin,retribution,6,3,3
Babar,doomhammer,288,paladin,retribution,6,3,3
Makiligos,area-52,288,paladin,retribution,6,3,3
Danks,arthas,288,paladin,retribution,6,3,3
Ludicrus,tichondrius,288,paladin,retribution,6,3,3
Légolas,llane,288,paladin,retribution,6,3,3
Jónò,tichondrius,288,paladin,retribution,6,3,3
Divinetits,sargeras,288,paladin,retribution,6,3,3
Zeroret,tichondrius,288,paladin,retribution,6,3,3
Bigdamham,tichondrius,288,paladin,retribution,6,3,3
Roaren,ragnaros,288,paladin,retribution,6,3,3
Kloernstarr,sargeras,288,paladin,retribution,6,3,3
Theßest,baelgun,288,paladin,retribution,6,3,3
Purekiller,destromath,288,paladin,retribution,6,3,3
Nerfretpls,area-52,288,paladin,retribution,6,3,3
Chickenlover,tichondrius,288,paladin,retribution,6,3,3
Krackanut,kelthuzad,288,paladin,retribution,6,3,3
Exaltedthot,zuljin,288,paladin,retribution,6,3,3
Açaelus,wyrmrest-accord,288,paladin,retribution,6,3,3
Radbout,blackrock,288,paladin,retribution,6,3,3
Assaultron,dalaran,288,paladin,retribution,6,3,3
Marof,spirestone,288,paladin,retribution,6,3,3
Cocodog,kiljaeden,288,paladin,retribution,6,3,3
Otame,quelthalas,288,paladin,retribution,6,3,3
Ouken,frostmourne,288,paladin,retribution,6,3,3
Vynlen,uldaman,288,paladin,retribution,6,3,3
Deathret,stonemaul,288,paladin,retribution,6,3,3
Vanitasz,bleeding-hollow,288,paladin,retribution,6,3,3
Tsubakî,norgannon,288,paladin,retribution,6,3,3
Xbertiize,tichondrius,288,paladin,retribution,6,3,3
Hadory,shattered-halls,288,paladin,retribution,6,3,3
Ataraxy,bleeding-hollow,288,paladin,retribution,6,3,3
Gapingpooter,shadowmoon,288,paladin,retribution,6,3,3
Slüg,bleeding-hollow,288,paladin,retribution,6,3,3
Lasonil,zuljin,288,paladin,retribution,6,3,3
Kyperion,stormrage,288,paladin,retribution,6,3,3
Xaospaladin,frostmourne,288,paladin,retribution,6,3,3
Rost,jaedenar,288,paladin,retribution,6,3,3
Itzon,proudmoore,288,paladin,retribution,6,3,3
Hydaer,barthilas,288,paladin,retribution,6,3,3
Salamislappr,stormrage,288,paladin,retribution,6,3,3
Nickotines,kelthuzad,288,paladin,retribution,6,3,3
Bussyrrhea,kelthuzad,288,paladin,retribution,6,3,3
Mki,kargath,288,paladin,retribution,6,3,3
Timu,suramar,288,paladin,retribution,6,3,3
Ironboxer,tichondrius,288,paladin,retribution,6,3,3
Gender,kelthuzad,288,paladin,retribution,6,3,3
Borisdablade,bleeding-hollow,288,paladin,retribution,6,3,3
Executiveceo,tichondrius,288,paladin,retribution,6,3,3
Klam,kelthuzad,288,paladin,retribution,6,3,3
Victorria,archimonde,288,paladin,retribution,6,3,3
Lovelàce,proudmoore,288,paladin,retribution,6,3,3
Pallyson,thunderhorn,288,paladin,retribution,6,3,3
Nalenne,alexstrasza,288,paladin,retribution,6,3,3
Apocryphx,stormrage,288,paladin,retribution,6,3,3
Kickflipped,dalaran,288,paladin,retribution,6,3,3
Casadorez,tichondrius,288,paladin,retribution,6,3,3
Jaktpal,spinebreaker,288,paladin,retribution,6,3,3
Lightheartx,proudmoore,288,paladin,retribution,6,3,3
Darthalion,quelthalas,288,paladin,retribution,6,3,3
Shockdoctor,stormrage,288,paladin,retribution,6,3,3
Holytank,korgath,288,paladin,retribution,6,3,3
Àxçël,hyjal,288,paladin,retribution,6,3,3
Arngrim,the-venture-co,288,paladin,retribution,6,3,3
Nerfmywings,frostmourne,288,paladin,retribution,6,3,3
Eldanx,stormrage,288,paladin,retribution,6,3,3
Sadamell,tichondrius,288,paladin,retribution,6,3,3
Brimmakor,ravenholdt,288,paladin,retribution,6,3,3
Mikieal,tichondrius,288,paladin,retribution,6,3,3
Víctor,quelthalas,288,paladin,retribution,6,3,3
Pahlevahn,stormrage,288,paladin,retribution,6,3,3
Dev,frostwolf,288,paladin,retribution,6,3,3
Obbzz,spirestone,288,paladin,retribution,6,3,3
Absolvus,emerald-dream,288,paladin,retribution,6,3,3
Rhoynar,quelthalas,288,paladin,retribution,6,3,3
Sinhero,area-52,288,paladin,retribution,6,3,3
Frawlless,azralon,288,paladin,retribution,6,3,3
Taynos,tichondrius,288,paladin,retribution,6,3,3
Hybrix,tichondrius,288,paladin,retribution,6,3,3
Karwryn,magtheridon,288,paladin,retribution,6,3,3
Tren,burning-blade,288,paladin,retribution,6,3,3
Nâtion,cenarius,288,paladin,retribution,6,3,3
Nhanless,tichondrius,288,paladin,retribution,6,3,3
Aelael,icecrown,288,paladin,retribution,6,3,3
Buttflapster,proudmoore,288,paladin,retribution,6,3,3
Siyepaladin,illidan,288,paladin,retribution,6,3,3
Bivol,whisperwind,288,paladin,retribution,6,3,3
Sycoticbunny,icecrown,288,paladin,retribution,6,3,3
Scamadin,tichondrius,288,paladin,retribution,6,3,3
Luxuriousman,fizzcrank,288,paladin,retribution,6,3,3
Valadinna,tichondrius,288,paladin,retribution,6,3,3
Ðova,moon-guard,288,paladin,retribution,6,3,3
Linook,illidan,288,paladin,retribution,6,3,3
Pallynatir,ragnaros,288,paladin,retribution,6,3,3
Numela,moon-guard,288,paladin,retribution,6,3,3
Rétrïbution,stormrage,288,paladin,retribution,6,3,3
Holycenter,stormrage,288,paladin,retribution,6,3,3
Pipay,proudmoore,288,paladin,retribution,6,3,3
Holyoverdose,laughing-skull,288,paladin,retribution,6,3,3
Kôld,tichondrius,288,paladin,retribution,6,3,3
Flareous,moon-guard,288,paladin,retribution,6,3,3
Halnarran,area-52,288,paladin,retribution,6,3,3
Alocr,drakkari,288,paladin,retribution,6,3,3
Baladinn,tichondrius,288,paladin,retribution,6,3,3
Pâllywhacker,bleeding-hollow,288,paladin,retribution,6,3,3
Ankhz,area-52,288,paladin,retribution,6,3,3
Teazie,ursin,288,paladin,retribution,6,3,3
Thecrusaders,proudmoore,288,paladin,retribution,6,3,3
Pixilade,barthilas,288,paladin,retribution,6,3,3
Reallyfe,skullcrusher,288,paladin,retribution,6,3,3
Stepbrodi,moon-guard,288,paladin,retribution,6,3,3
Finnthepally,proudmoore,288,paladin,retribution,6,3,3
Holyshrekt,frostmourne,288,paladin,retribution,6,3,3
Efilios,tichondrius,288,paladin,retribution,6,3,3
Lorainn,ragnaros,288,paladin,retribution,6,3,3
Judgem,tichondrius,288,paladin,retribution,6,3,3
Lóli,azralon,288,paladin,retribution,6,3,3
Coldverdict,tichondrius,288,paladin,retribution,6,3,3
Dráugus,azralon,288,paladin,retribution,6,3,3
Leá,illidan,288,paladin,retribution,6,3,3
Burkpally,azralon,288,paladin,retribution,6,3,3
Leroye,tichondrius,288,paladin,retribution,6,3,3
Acelaidis,cenarius,288,paladin,retribution,6,3,3
Jestiny,amanthul,288,paladin,retribution,6,3,3
Warchaos,skullcrusher,288,paladin,retribution,6,3,3
Zugzorr,azralon,288,paladin,retribution,6,3,3
Senisse,illidan,288,paladin,retribution,6,3,3
Aldars,illidan,288,paladin,retribution,6,3,3
Boladosx,azralon,288,paladin,retribution,6,3,3
Feikonia,queldorei,288,paladin,retribution,6,3,3
Jacobelaylo,moon-guard,288,paladin,retribution,6,3,3
Syvir,area-52,288,paladin,retribution,6,3,3
Kanachi,bleeding-hollow,288,paladin,retribution,6,3,3
Ximenita,ragnaros,288,paladin,retribution,6,3,3
Aphrrodite,lightbringer,288,paladin,retribution,6,3,3
Pvar,stormrage,288,paladin,retribution,6,3,3
Tadaki,dalaran,288,paladin,retribution,6,3,3
Brahlix,area-52,288,paladin,retribution,6,3,3
Bigdumpy,thaurissan,288,paladin,retribution,6,3,3
Stømpdøwn,tichondrius,288,paladin,retribution,6,3,3
Lighttzz,azralon,288,paladin,retribution,6,3,3
Zaghad,ragnaros,288,paladin,retribution,9,4,5
Ivanko,dalaran,288,paladin,retribution,7,3,4
Retattack,area-52,288,paladin,retribution,10,4,6
Josepala,stormrage,288,paladin,retribution,9,3,6
Thunddarr,stormrage,288,paladin,retribution,12,3,9
Amega,bleeding-hollow,288,paladin,retribution,12,3,9
Brutaldeath,area-52,288,paladin,retribution,12,3,9
Lue,boulderfist,288,paladin,retribution,12,3,9
Sessybrexy,bleeding-hollow,288,paladin,retribution,12,3,9
Pelegroot,azralon,288,paladin,retribution,12,3,9
Koltar,stormrage,288,paladin,retribution,12,3,9
Jontapally,stormrage,288,paladin,retribution,12,3,9
Donsagrado,quelthalas,288,paladin,retribution,12,3,9
Sbpluss,illidan,288,paladin,retribution,12,3,9
Energizzed,azralon,288,paladin,retribution,12,3,9
Vintibusca,azralon,288,paladin,retribution,12,3,9
Ashlïe,moon-guard,288,paladin,retribution,12,3,9
Darkkantares,ragnaros,288,paladin,retribution,12,3,9
Corthic,area-52,288,paladin,retribution,12,3,9
Kãrën,emerald-dream,288,paladin,retribution,12,3,9
Leronos,zuljin,288,paladin,retribution,12,3,9
Tarkovkappa,illidan,288,paladin,retribution,12,3,9
Benn,eldrethalas,288,paladin,retribution,12,3,9
Säv,tichondrius,288,paladin,retribution,12,3,9
Bubblebooty,drakthul,288,paladin,retribution,12,3,9
Slania,area-52,288,paladin,retribution,12,3,9
Uzbadkhazad,ragnaros,288,paladin,retribution,12,3,9
Johnus,lightbringer,288,paladin,retribution,12,3,9
Lxwd,tichondrius,288,paladin,retribution,12,3,9
Crusticus,stormrage,288,paladin,retribution,12,3,9
Lìghtning,stormrage,288,paladin,retribution,12,3,9
Dordrolan,frostmourne,288,paladin,retribution,12,3,9
Laelias,lightbringer,288,paladin,retribution,12,3,9
Wälly,garona,288,paladin,retribution,12,3,9
Tarpeeksi,tichondrius,288,paladin,retribution,12,3,9
Somite,stormrage,288,paladin,retribution,12,3,9
Kreigan,hellscream,288,paladin,retribution,12,3,9
Holydiarrhea,illidan,288,paladin,retribution,12,3,9
Darkshield,stormrage,288,paladin,retribution,12,3,9
Homeboywill,hyjal,288,paladin,retribution,12,3,9
Bulbi,emerald-dream,288,paladin,retribution,12,3,9
Fknnoath,frostmourne,288,paladin,retribution,12,3,9
Nik,the-underbog,288,paladin,retribution,12,3,9
Rxxkiee,tichondrius,288,paladin,retribution,12,3,9
Xkillz,korgath,288,paladin,retribution,12,3,9
Ultrah,area-52,288,paladin,retribution,12,3,9
Asellusarc,kelthuzad,288,paladin,retribution,12,3,9
Thnannan,tichondrius,288,paladin,retribution,12,3,9
Bigplucker,kelthuzad,288,paladin,retribution,12,3,9
Ajara,moon-guard,288,paladin,retribution,12,3,9
Martin,haomarush,288,paladin,retribution,12,3,9
Calvary,stormscale,288,paladin,retribution,12,3,9
Sivan,crushridge,288,paladin,retribution,12,3,9
Tharinty,ragnaros,288,paladin,retribution,12,3,9
Flashstark,area-52,288,paladin,retribution,12,3,9
Tíron,dalaran,288,paladin,retribution,12,3,9
Eljosco,nordrassil,288,paladin,retribution,12,3,9
Trenbolóne,area-52,288,paladin,retribution,12,3,9
Mwanmwa,blades-edge,288,paladin,retribution,12,3,9
Perdiseus,stormrage,288,paladin,retribution,12,3,9
Dárkness,blades-edge,288,paladin,retribution,12,3,9
Theodrei,darrowmere,288,paladin,retribution,12,3,9
Sac,sargeras,288,paladin,retribution,12,3,9
Quelite,sargeras,288,paladin,retribution,12,3,9
Dävis,ragnaros,288,paladin,retribution,12,3,9
Corni,kiljaeden,288,paladin,retribution,12,3,9
Ucvnt,illidan,288,paladin,retribution,12,3,9
Aggromatik,zuljin,288,paladin,retribution,12,3,9
Lightfûry,kelthuzad,288,paladin,retribution,12,3,9
Cromsecrate,dalaran,288,paladin,retribution,12,3,9
Burom,kelthuzad,288,paladin,retribution,12,3,9
Olorunn,tichondrius,288,paladin,retribution,12,3,9
Kloerny,sargeras,288,paladin,retribution,12,3,9
Palâdin,zuljin,288,paladin,retribution,12,3,9
Fpaladin,tichondrius,288,paladin,retribution,12,3,9
Asukaxt,illidan,288,paladin,retribution,12,3,9
Yeluh,malganis,288,paladin,retribution,12,3,9
Walkerbait,nazgrel,288,paladin,retribution,12,3,9
Spiritkeep,veknilash,288,paladin,retribution,12,3,9
Dalden,trollbane,288,paladin,retribution,12,3,9
Wasabipal,malganis,288,paladin,retribution,12,3,9
Pallypòwer,garrosh,288,paladin,retribution,12,3,9
Varthinator,stormrage,288,paladin,retribution,12,3,9
Yepsqorz,tichondrius,288,paladin,retribution,12,3,9
Geekpala,thrall,288,paladin,retribution,12,3,9
Smokeys,sargeras,288,paladin,retribution,12,3,9
Oralen,daggerspine,288,paladin,retribution,12,3,9
Aenwyl,quelthalas,288,paladin,retribution,12,3,9
Elpal,thrall,288,paladin,retribution,12,3,9
Bringbakbuff,illidan,288,paladin,retribution,12,3,9
Aafushou,proudmoore,288,paladin,retribution,12,3,9
Ashy,bonechewer,288,paladin,retribution,12,3,9
Slantee,illidan,288,paladin,retribution,12,3,9
Lìnkzq,frostmourne,288,paladin,retribution,12,3,9
Madworld,moon-guard,288,paladin,retribution,12,3,9
Vaaleria,dalaran,288,paladin,retribution,12,3,9
Sanction,the-forgotten-coast,288,paladin,retribution,12,3,9
Hardclimacks,frostmourne,288,paladin,retribution,12,3,9
Tolleytrain,malganis,288,paladin,retribution,12,3,9
Aválerion,proudmoore,288,paladin,retribution,12,3,9
Marrike,moon-guard,288,paladin,retribution,12,3,9
Clorpi,drakkari,288,paladin,retribution,12,3,9
Kaorah,drakkari,288,paladin,retribution,12,3,9
Merothin,drakkari,288,paladin,retribution,12,3,9
Ogtandoness,azgalor,288,paladin,retribution,12,3,9
Bigjoetheceo,mannoroth,288,paladin,retribution,12,3,9
Sàber,tichondrius,288,paladin,retribution,12,3,9
Treezey,durotan,288,paladin,retribution,12,3,9
Påladin,area-52,288,paladin,retribution,12,3,9
Aduynn,tichondrius,288,paladin,retribution,12,3,9
Mightbeard,proudmoore,288,paladin,retribution,14,3,11
Pepepally,area-52,288,paladin,retribution,18,3,15
Zoriå,sargeras,288,paladin,retribution,18,3,15
Fourchon,tichondrius,288,paladin,retribution,18,3,15
Retski,thrall,288,paladin,retribution,18,3,15
Mollybop,stormrage,288,paladin,retribution,18,3,15
Bullworm,ragnaros,288,paladin,retribution,18,3,15
Taredowo,area-52,288,paladin,retribution,18,3,15
Holymight,gurubashi,288,paladin,retribution,18,3,15
Rohland,illidan,288,paladin,retribution,18,3,15
Bellzebut,sargeras,288,paladin,retribution,18,3,15
Voorrkk,kelthuzad,288,paladin,retribution,18,3,15
Whangsta,tichondrius,288,paladin,retribution,24,3,21
Holytrails,sargeras,287,paladin,retribution,6,3,3
Matøs,stormrage,287,paladin,retribution,6,3,3
Bolidan,terokkar,287,paladin,retribution,6,3,3
Sweetpally,moonrunner,287,paladin,retribution,6,3,3
Kimbr,gallywix,287,paladin,retribution,6,3,3
Nøxus,azralon,287,paladin,retribution,6,3,3
Covidxlx,hakkar,287,paladin,retribution,6,3,3
Nalahra,moon-guard,287,paladin,retribution,9,4,5
Paladinkofwa,tichondrius,287,paladin,retribution,12,4,8
Stainless,magtheridon,287,paladin,retribution,12,3,9
Reathe,llane,287,paladin,retribution,12,3,9
Tatgrim,drakkari,287,paladin,retribution,12,3,9
Níka,turalyon,287,paladin,retribution,12,3,9
Divinetank,amanthul,287,paladin,retribution,12,3,9
Mynnorath,emerald-dream,287,paladin,retribution,12,3,9
Laylee,anvilmar,287,paladin,retribution,12,3,9
Berylemonade,the-underbog,286,paladin,retribution,7,3,4
Yakobazee,illidan,286,paladin,retribution,13,4,9
Cruz,silver-hand,286,paladin,retribution,12,3,9
Hukah,darkspear,286,paladin,retribution,18,3,15
Milkmi,frostmourne,271,paladin,retribution,11,3,8
Tyrack,ragnaros,271,paladin,retribution,11,3,8
Ronatiú,tichondrius,271,paladin,retribution,11,3,8
Ôv,norgannon,256,paladin,retribution,4,4,0
Gabrielú,lightninghoof,256,paladin,retribution,10,3,7
Wingsproc,stormrage,256,paladin,retribution,10,3,7
Logaen,stormrage,256,paladin,retribution,16,3,13
Gusset,tichondrius,255,paladin,retribution,8,4,4
Hoeliekow,dalaran,255,paladin,retribution,12,5,7
Oates,sargeras,255,paladin,retribution,11,3,8
Serazan,moon-guard,255,paladin,retribution,11,3,8
Vero,agamaggan,254,paladin,retribution,23,3,20
Sôsaboy,tichondrius,239,paladin,retribution,5,3,2
Badmix,tichondrius,239,paladin,retribution,5,3,2
Luvstopwn,akama,239,paladin,retribution,5,3,2
Wegie,emerald-dream,239,paladin,retribution,5,3,2
Egu,mugthol,239,paladin,retribution,5,3,2
Helberth,stormrage,239,paladin,retribution,5,3,2
Ðablordx,tichondrius,239,paladin,retribution,9,4,5
Palitard,tichondrius,234,paladin,retribution,7,5,2
Carneguisada,sargeras,234,paladin,retribution,10,5,5
Westee,stormrage,234,paladin,retribution,8,4,4
Inarit,thrall,234,paladin,retribution,8,4,4
Stinkystan,korgath,234,paladin,retribution,10,4,6
Filoz,ragnaros,234,paladin,retribution,17,5,12
Sølaire,stormrage,234,paladin,retribution,14,4,10
Matts,sargeras,234,paladin,retribution,15,4,11
Needbuffs,ysondre,234,paladin,retribution,15,4,11
Pearlx,ragnaros,234,paladin,retribution,16,4,12
Eldruin,amanthul,234,paladin,retribution,17,4,13
Píkachü,azralon,224,paladin,retribution,10,3,7
Livalil,chogall,224,paladin,retribution,16,3,13
Wabukis,illidan,223,paladin,retribution,8,3,5
Xyandrena,draka,223,paladin,retribution,8,3,5
Fallan,khaz-modan,223,paladin,retribution,8,3,5
Tydrialin,tichondrius,223,paladin,retribution,8,3,5
Diotiz,area-52,208,paladin,retribution,11,4,7
Moistsaiyan,blood-furnace,206,paladin,retribution,7,3,4
Powerassasin,tichondrius,192,paladin,retribution,4,3,1
Undrgrndman,dalaran,192,paladin,retribution,4,3,1
Katonpala,ragnaros,192,paladin,retribution,4,3,1
Zlx,emerald-dream,192,paladin,retribution,4,3,1
Zhspeilian,tichondrius,192,paladin,retribution,11,4,7
Anonymvs,eredar,192,paladin,retribution,9,3,6
Abivion,stormrage,192,paladin,retribution,6,2,4
Çßitching,baelgun,192,paladin,retribution,6,2,4
Buri,tichondrius,192,paladin,retribution,6,2,4
Lightkillerx,thrall,192,paladin,retribution,6,2,4
Shanehere,thrall,192,paladin,retribution,6,2,4
Tyrfall,akama,192,paladin,retribution,6,2,4
Ordinary,greymane,192,paladin,retribution,6,2,4
Zenix,tanaris,192,paladin,retribution,6,2,4
Crânkz,blackrock,192,paladin,retribution,6,2,4
Juanvaldez,muradin,192,paladin,retribution,6,2,4
Streetacus,stormrage,192,paladin,retribution,6,2,4
Whittia,wyrmrest-accord,192,paladin,retribution,6,2,4
Amarexp,stormrage,192,paladin,retribution,6,2,4
Stlgunna,tichondrius,192,paladin,retribution,6,2,4
Tearra,blackrock,192,paladin,retribution,6,2,4
Retbullvodka,tichondrius,192,paladin,retribution,6,2,4
Verzuhazadon,tichondrius,192,paladin,retribution,6,2,4
Repèntance,stormrage,192,paladin,retribution,6,2,4
Outofholy,stormrage,192,paladin,retribution,6,2,4
Mexipaladin,thrall,192,paladin,retribution,6,2,4
Homiepaldino,nordrassil,192,paladin,retribution,6,2,4
Yamn,tichondrius,192,paladin,retribution,6,2,4
Cloudx,shattered-hand,192,paladin,retribution,6,2,4
Virisanctii,stormrage,192,paladin,retribution,6,2,4
Angelscrÿ,stormrage,192,paladin,retribution,6,2,4
Spanx,blackwing-lair,192,paladin,retribution,6,2,4
Ramsés,stormrage,192,paladin,retribution,6,2,4
Mendes,stormrage,192,paladin,retribution,6,2,4
Pallylyfe,wyrmrest-accord,192,paladin,retribution,6,2,4
Lawnrunna,thunderlord,192,paladin,retribution,6,2,4
Trøn,kalecgos,192,paladin,retribution,6,2,4
Smitinbadger,the-venture-co,192,paladin,retribution,6,2,4
Kêy,the-venture-co,192,paladin,retribution,6,2,4
Forprophet,blackrock,192,paladin,retribution,6,2,4
Xoppo,tichondrius,192,paladin,retribution,6,2,4
Pushabuton,illidan,192,paladin,retribution,6,2,4
Noscajj,tichondrius,192,paladin,retribution,6,2,4
Issac,tichondrius,192,paladin,retribution,6,2,4
Schooiez,tichondrius,192,paladin,retribution,6,2,4
Smolbeef,tichondrius,192,paladin,retribution,6,2,4
Einheit,destromath,192,paladin,retribution,6,2,4
Tysads,darkspear,192,paladin,retribution,6,2,4
Juiicebox,darrowmere,192,paladin,retribution,6,2,4
Legionret,thrall,192,paladin,retribution,6,2,4
Holywafu,tichondrius,192,paladin,retribution,6,2,4
Hurkalzul,azralon,192,paladin,retribution,6,2,4
Shaqueefah,illidan,192,paladin,retribution,6,2,4
Vindified,tichondrius,192,paladin,retribution,6,2,4
Fairbairn,tichondrius,192,paladin,retribution,6,2,4
Jaok,tichondrius,192,paladin,retribution,6,2,4
Reepr,tichondrius,192,paladin,retribution,6,2,4
Tâbris,tichondrius,192,paladin,retribution,6,2,4
Wyot,tichondrius,192,paladin,retribution,6,2,4
Sigurd,khadgar,192,paladin,retribution,6,2,4
Rây,stormrage,192,paladin,retribution,6,2,4
Anjøs,azralon,192,paladin,retribution,6,2,4
Nyc,sargeras,192,paladin,retribution,6,2,4
Mazexd,illidan,192,paladin,retribution,6,2,4
Blackbeerd,stormrage,192,paladin,retribution,6,2,4
Guelmin,azralon,192,paladin,retribution,6,2,4
Izaacckk,hakkar,192,paladin,retribution,6,2,4
Acehoodz,azralon,192,paladin,retribution,6,2,4
Lørdthemar,azralon,192,paladin,retribution,6,2,4
Egf,illidan,192,paladin,retribution,6,2,4
Heartsend,nerzhul,192,paladin,retribution,6,2,4
Mashem,stormrage,192,paladin,retribution,6,2,4
Avengzeus,tichondrius,192,paladin,retribution,6,2,4
Tormentoxd,azralon,192,paladin,retribution,6,2,4
Ghatte,azralon,192,paladin,retribution,6,2,4
Variexpal,tichondrius,192,paladin,retribution,6,2,4
Haznthley,proudmoore,192,paladin,retribution,6,2,4
Atan,emerald-dream,192,paladin,retribution,6,2,4
Brucitenjr,illidan,192,paladin,retribution,6,2,4
Soundscape,proudmoore,192,paladin,retribution,6,2,4
Roity,proudmoore,192,paladin,retribution,6,2,4
Strîkes,emerald-dream,192,paladin,retribution,6,2,4
Nestus,shuhalo,192,paladin,retribution,6,2,4
Ramises,nemesis,192,paladin,retribution,6,2,4
Sleepynug,proudmoore,192,paladin,retribution,6,2,4
Pállymán,proudmoore,192,paladin,retribution,6,2,4
Bluewaves,tichondrius,192,paladin,retribution,6,2,4
Roseheart,emerald-dream,192,paladin,retribution,6,2,4
Astherian,stormrage,192,paladin,retribution,6,2,4
Æyden,azgalor,192,paladin,retribution,6,2,4
Brand,emerald-dream,192,paladin,retribution,6,2,4
Cyliex,illidan,192,paladin,retribution,6,2,4
Gîmply,proudmoore,192,paladin,retribution,6,2,4
Dritan,lightbringer,192,paladin,retribution,6,2,4
Tyberas,wyrmrest-accord,192,paladin,retribution,6,2,4
Twck,hyjal,192,paladin,retribution,6,2,4
Holysmokz,emerald-dream,192,paladin,retribution,6,2,4
Guacamello,emerald-dream,192,paladin,retribution,6,2,4
Helioos,stormrage,192,paladin,retribution,6,2,4
Piousgecko,illidan,192,paladin,retribution,6,2,4
Kanaloä,stormreaver,192,paladin,retribution,6,2,4
Pincheds,emerald-dream,192,paladin,retribution,6,2,4
Litjoint,hyjal,192,paladin,retribution,6,2,4
Granada,kirin-tor,192,paladin,retribution,6,2,4
Alexandros,the-underbog,192,paladin,retribution,6,2,4
Islain,smolderthorn,192,paladin,retribution,6,2,4
Reverend,thunderlord,192,paladin,retribution,6,2,4
Calmpressure,tichondrius,192,paladin,retribution,6,2,4
Rochet,kiljaeden,192,paladin,retribution,6,2,4
Pallycow,kargath,192,paladin,retribution,6,2,4
Metalsword,tichondrius,192,paladin,retribution,6,2,4
Holypoizan,tichondrius,192,paladin,retribution,6,2,4
Adrasil,wyrmrest-accord,192,paladin,retribution,6,2,4
Motrîn,sargeras,192,paladin,retribution,6,2,4
Míguelito,sargeras,192,paladin,retribution,6,2,4
Bøzø,stormrage,192,paladin,retribution,6,2,4
Ríf,sargeras,192,paladin,retribution,6,2,4
Retku,tichondrius,192,paladin,retribution,6,2,4
Lightninlink,sargeras,192,paladin,retribution,6,2,4
Toto,sargeras,192,paladin,retribution,6,2,4
Trê,sargeras,192,paladin,retribution,6,2,4
Whataio,tichondrius,192,paladin,retribution,6,2,4
Vengx,sargeras,192,paladin,retribution,6,2,4
Axelx,sargeras,192,paladin,retribution,6,2,4
Rite,azralon,192,paladin,retribution,6,2,4
Shebas,kilrogg,192,paladin,retribution,6,2,4
Dwarfpaladin,dragonmaw,192,paladin,retribution,6,2,4
Qwickness,garrosh,192,paladin,retribution,6,2,4
Carmelito,hakkar,192,paladin,retribution,6,2,4
Lèo,ghostlands,192,paladin,retribution,6,2,4
Palix,bonechewer,192,paladin,retribution,6,2,4
Astrøworld,sargeras,192,paladin,retribution,6,2,4
Lightgasm,alterac-mountains,192,paladin,retribution,6,2,4
Omegabubble,garrosh,192,paladin,retribution,6,2,4
Neydisa,sargeras,192,paladin,retribution,6,2,4
Killmoth,illidan,192,paladin,retribution,6,2,4
Moistplop,aegwynn,192,paladin,retribution,6,2,4
Davethunder,hakkar,192,paladin,retribution,6,2,4
Gredel,sargeras,192,paladin,retribution,6,2,4
Ohthatguy,sargeras,192,paladin,retribution,6,2,4
Achalius,queldorei,192,paladin,retribution,6,2,4
Itechs,sargeras,192,paladin,retribution,6,2,4
Zenarus,stormrage,192,paladin,retribution,6,2,4
Ookcoo,tichondrius,192,paladin,retribution,6,2,4
Nightreavers,sargeras,192,paladin,retribution,6,2,4
Bradybub,sargeras,192,paladin,retribution,6,2,4
Kåshmïr,tichondrius,192,paladin,retribution,6,2,4
Zeliq,silvermoon,192,paladin,retribution,6,2,4
Byonsay,zuljin,192,paladin,retribution,6,2,4
Ogretchair,zuljin,192,paladin,retribution,6,2,4
Cudiskush,tichondrius,192,paladin,retribution,6,2,4
Oxycleän,doomhammer,192,paladin,retribution,6,2,4
Ihoj,illidan,192,paladin,retribution,6,2,4
Adavinn,azjolnerub,192,paladin,retribution,6,2,4
Rúdely,tichondrius,192,paladin,retribution,6,2,4
Jarkeion,tichondrius,192,paladin,retribution,6,2,4
Gasunits,stormrage,192,paladin,retribution,6,2,4
Juggerat,barthilas,192,paladin,retribution,6,2,4
Whyurunning,area-52,192,paladin,retribution,6,2,4
Theodden,tichondrius,192,paladin,retribution,6,2,4
Aleio,moon-guard,192,paladin,retribution,6,2,4
Daddykronz,magtheridon,192,paladin,retribution,6,2,4
Malakk,zuljin,192,paladin,retribution,6,2,4
Blastoise,drakkari,192,paladin,retribution,6,2,4
Madnhairy,zuljin,192,paladin,retribution,6,2,4
Maviskuku,tichondrius,192,paladin,retribution,6,2,4
Angeluzlk,quelthalas,192,paladin,retribution,6,2,4
Rekos,zuljin,192,paladin,retribution,6,2,4
Stépz,frostmourne,192,paladin,retribution,6,2,4
Felourian,malganis,192,paladin,retribution,6,2,4
Psychlight,quelthalas,192,paladin,retribution,6,2,4
Taddedpally,tichondrius,192,paladin,retribution,6,2,4
Crosjudge,zuljin,192,paladin,retribution,6,2,4
Thorrh,malganis,192,paladin,retribution,6,2,4
Extramustard,frostmourne,192,paladin,retribution,6,2,4
Ugotburstt,arthas,192,paladin,retribution,6,2,4
Mousesack,dragonmaw,192,paladin,retribution,6,2,4
Ddeuk,tichondrius,192,paladin,retribution,6,2,4
Ilirax,drakkari,192,paladin,retribution,6,2,4
Alasper,malganis,192,paladin,retribution,6,2,4
Freslys,zuljin,192,paladin,retribution,6,2,4
Gangsta,silvermoon,192,paladin,retribution,6,2,4
Blessinofsac,nagrand,192,paladin,retribution,6,2,4
Honeydews,zuljin,192,paladin,retribution,6,2,4
Barragañ,malganis,192,paladin,retribution,6,2,4
Twatiegodx,malganis,192,paladin,retribution,6,2,4
Kigz,illidan,192,paladin,retribution,6,2,4
Duz,malganis,192,paladin,retribution,6,2,4
Exalter,malganis,192,paladin,retribution,6,2,4
Hafra,zuljin,192,paladin,retribution,6,2,4
Dimensions,spirestone,192,paladin,retribution,6,2,4
Retro,magtheridon,192,paladin,retribution,6,2,4
Kolten,kelthuzad,192,paladin,retribution,6,2,4
Sqwuril,area-52,192,paladin,retribution,6,2,4
Speedophile,kelthuzad,192,paladin,retribution,6,2,4
Ohsoclose,bleeding-hollow,192,paladin,retribution,6,2,4
Zoeyxo,tichondrius,192,paladin,retribution,6,2,4
Disastroùs,frostmourne,192,paladin,retribution,6,2,4
Hogù,tichondrius,192,paladin,retribution,6,2,4
Thejokermp,kelthuzad,192,paladin,retribution,6,2,4
Varianpally,kelthuzad,192,paladin,retribution,6,2,4
Stöny,illidan,192,paladin,retribution,6,2,4
Athreuz,kelthuzad,192,paladin,retribution,6,2,4
Desterro,quelthalas,192,paladin,retribution,6,2,4
Bubblethis,frostmourne,192,paladin,retribution,6,2,4
Skurps,kelthuzad,192,paladin,retribution,6,2,4
Runterran,illidan,192,paladin,retribution,6,2,4
Tuama,frostmourne,192,paladin,retribution,6,2,4
Spyglas,quelthalas,192,paladin,retribution,6,2,4
Ladner,tichondrius,192,paladin,retribution,6,2,4
Tyrkisovj,quelthalas,192,paladin,retribution,6,2,4
Felkor,caelestrasz,192,paladin,retribution,6,2,4
Bharan,dalaran,192,paladin,retribution,6,2,4
Galdraxis,dalaran,192,paladin,retribution,6,2,4
Moshio,nagrand,192,paladin,retribution,6,2,4
Paladam,burning-blade,192,paladin,retribution,6,2,4
Retikulous,tichondrius,192,paladin,retribution,6,2,4
Tomackin,quelthalas,192,paladin,retribution,6,2,4
Invïctus,dalaran,192,paladin,retribution,6,2,4
Holycakes,malygos,192,paladin,retribution,6,2,4
Dakoo,burning-blade,192,paladin,retribution,6,2,4
Honeyduw,moon-guard,192,paladin,retribution,6,2,4
Dorados,gallywix,192,paladin,retribution,6,2,4
Azúlá,garona,192,paladin,retribution,6,2,4
Gieser,burning-blade,192,paladin,retribution,6,2,4
Lilpally,frostmourne,192,paladin,retribution,6,2,4
Prèèd,frostmourne,192,paladin,retribution,6,2,4
Johnygoodboi,khazgoroth,192,paladin,retribution,6,2,4
Hulc,ysera,192,paladin,retribution,6,2,4
Frankjenkins,nagrand,192,paladin,retribution,6,2,4
Ret,onyxia,192,paladin,retribution,6,2,4
Dayim,moon-guard,192,paladin,retribution,6,2,4
Eull,skullcrusher,192,paladin,retribution,6,2,4
Stinkypinkyy,moon-guard,192,paladin,retribution,6,2,4
Moohulk,ragnaros,192,paladin,retribution,6,2,4
Akhahd,aerie-peak,192,paladin,retribution,6,2,4
Cowlomus,ragnaros,192,paladin,retribution,6,2,4
Bërzerk,zuluhed,192,paladin,retribution,6,2,4
Halot,skullcrusher,192,paladin,retribution,6,2,4
Dexstarr,frostmourne,192,paladin,retribution,6,2,4
Holypumper,moon-guard,192,paladin,retribution,6,2,4
Dynastyhero,area-52,192,paladin,retribution,6,2,4
Oroth,ragnaros,192,paladin,retribution,6,2,4
Mosés,area-52,192,paladin,retribution,6,2,4
Brizdiz,area-52,192,paladin,retribution,6,2,4
Awarena,area-52,192,paladin,retribution,6,2,4
Jazzmatic,dalaran,192,paladin,retribution,6,2,4
Durotar,ragnaros,192,paladin,retribution,6,2,4
Thaidron,area-52,192,paladin,retribution,6,2,4
Tôhru,ragnaros,192,paladin,retribution,6,2,4
Scoobs,bleeding-hollow,192,paladin,retribution,6,2,4
Domiet,bleeding-hollow,192,paladin,retribution,6,2,4
Luke,moon-guard,192,paladin,retribution,6,2,4
Citadehl,bleeding-hollow,192,paladin,retribution,6,2,4
Xenophanes,dalaran,192,paladin,retribution,6,2,4
Diänë,ragnaros,192,paladin,retribution,6,2,4
Caeson,moon-guard,192,paladin,retribution,6,2,4
Bigdret,moon-guard,192,paladin,retribution,6,2,4
Crijr,ragnaros,192,paladin,retribution,6,2,4
Drintense,area-52,192,paladin,retribution,6,2,4
Armasexodus,barthilas,192,paladin,retribution,6,2,4
Nëø,moon-guard,192,paladin,retribution,6,2,4
Ðuel,area-52,192,paladin,retribution,6,2,4
Morcant,drakkari,192,paladin,retribution,6,2,4
Quessillo,ragnaros,192,paladin,retribution,6,2,4
Nicerice,dalaran,192,paladin,retribution,6,2,4
Révolution,barthilas,192,paladin,retribution,6,2,4
Hbatalha,gallywix,192,paladin,retribution,6,2,4
Palåth,barthilas,192,paladin,retribution,6,2,4
Logust,area-52,192,paladin,retribution,6,2,4
Greatblade,barthilas,192,paladin,retribution,6,2,4
Yoúngdolph,elune,192,paladin,retribution,6,2,4
Machoo,laughing-skull,192,paladin,retribution,6,2,4
Ryuuku,gilneas,192,paladin,retribution,6,2,4
Badchicken,ragnaros,192,paladin,retribution,6,2,4
Crnoshock,area-52,192,paladin,retribution,6,2,4
Voro,barthilas,192,paladin,retribution,6,2,4
Réalg,area-52,192,paladin,retribution,6,2,4
Gordyn,khazgoroth,192,paladin,retribution,6,2,4
Yeshayah,dalaran,192,paladin,retribution,6,2,4
Liht,khazgoroth,192,paladin,retribution,6,2,4
Lumpypotatos,aegwynn,192,paladin,retribution,10,3,7
Retgodxo,tichondrius,192,paladin,retribution,7,2,5
Pòßà,malganis,192,paladin,retribution,7,2,5
Jessecash,tichondrius,192,paladin,retribution,12,3,9
Murgly,tichondrius,192,paladin,retribution,8,2,6
Raylewis,ghostlands,192,paladin,retribution,9,2,7
Smirnøv,ragnaros,192,paladin,retribution,9,2,7
Misease,illidan,192,paladin,retribution,9,2,7
Renorhal,moon-guard,192,paladin,retribution,12,2,10
Krístem,stormrage,192,paladin,retribution,12,2,10
Fazoéli,stormrage,192,paladin,retribution,12,2,10
Rayli,dalaran,192,paladin,retribution,12,2,10
Terppy,stormrage,192,paladin,retribution,12,2,10
Ghratadin,bleeding-hollow,192,paladin,retribution,12,2,10
Jachug,tichondrius,192,paladin,retribution,12,2,10
Seltzer,tichondrius,192,paladin,retribution,12,2,10
Léa,illidan,192,paladin,retribution,12,2,10
Goldfaith,sargeras,192,paladin,retribution,12,2,10
Grimsfate,emerald-dream,192,paladin,retribution,12,2,10
Vantz,tichondrius,192,paladin,retribution,12,2,10
Criixx,malganis,192,paladin,retribution,12,2,10
Seratox,illidan,192,paladin,retribution,12,2,10
Rîf,malganis,192,paladin,retribution,12,2,10
Nygardian,sargeras,192,paladin,retribution,12,2,10
Spîke,sargeras,192,paladin,retribution,12,2,10
Kaiyleigh,sargeras,192,paladin,retribution,12,2,10
Arminhamer,sargeras,192,paladin,retribution,12,2,10
Octí,quelthalas,192,paladin,retribution,12,2,10
Jarvin,kiljaeden,192,paladin,retribution,12,2,10
Yawnday,farstriders,192,paladin,retribution,12,2,10
Cabacarl,quelthalas,192,paladin,retribution,12,2,10
Simbelmyne,thrall,192,paladin,retribution,12,2,10
Garddar,ragnaros,192,paladin,retribution,12,2,10
Vamplyy,kelthuzad,192,paladin,retribution,12,2,10
Ðáddý,zuljin,192,paladin,retribution,12,2,10
Hurlnix,stormscale,192,paladin,retribution,12,2,10
Sïncere,frostmourne,192,paladin,retribution,12,2,10
Lamer,proudmoore,192,paladin,retribution,12,2,10
Donk,frostmane,192,paladin,retribution,12,2,10
Phawkes,eredar,192,paladin,retribution,12,2,10
Clrty,area-52,192,paladin,retribution,12,2,10
Dánteé,ragnaros,192,paladin,retribution,12,2,10
Flexedonyou,sentinels,192,paladin,retribution,12,2,10
Gilfan,proudmoore,192,paladin,retribution,12,2,10
Elarilein,emerald-dream,192,paladin,retribution,12,2,10
Slithix,stormreaver,192,paladin,retribution,12,2,10
Alyosya,barthilas,192,paladin,retribution,12,2,10
Ricopal,frostmourne,192,paladin,retribution,12,2,10
Calferx,area-52,192,paladin,retribution,12,2,10
Killerspally,area-52,192,paladin,retribution,12,2,10
Anahl,icecrown,192,paladin,retribution,12,2,10
Kheltas,area-52,192,paladin,retribution,12,2,10
Zatoci,shadowsong,192,paladin,retribution,17,2,15
Leonardogv,quelthalas,192,paladin,retribution,18,2,16
Runandhide,aerie-peak,192,paladin,retribution,18,2,16
Dorisseline,emerald-dream,192,paladin,retribution,18,2,16
Holyelfs,boulderfist,192,paladin,retribution,18,2,16
Dkpally,doomhammer,191,paladin,retribution,6,2,4
Oldmanmark,jubeithos,191,paladin,retribution,6,2,4
Lahila,area-52,191,paladin,retribution,6,2,4
Túss,khazgoroth,191,paladin,retribution,6,2,4
Jaidun,stormrage,190,paladin,retribution,12,2,10
Larlanos,bloodhoof,190,paladin,retribution,12,2,10
Thugmuffin,thrall,176,paladin,retribution,7,3,4
Wokeinator,malganis,175,paladin,retribution,11,3,8
Hivers,stormrage,175,paladin,retribution,14,3,11
Divinetoco,stormrage,175,paladin,retribution,11,2,9
Baalduru,borean-tundra,175,paladin,retribution,11,2,9
Wellowar,moon-guard,170,paladin,retribution,11,4,7
Bubbletop,tichondrius,169,paladin,retribution,11,4,7
Jnxzster,sargeras,169,paladin,retribution,11,4,7
Laysonus,moon-guard,169,paladin,retribution,11,4,7
Healingherbz,illidan,159,paladin,retribution,5,2,3
Kaorii,mannoroth,159,paladin,retribution,5,2,3
Hobbsone,trollbane,159,paladin,retribution,5,2,3
Pallydeen,illidan,159,paladin,retribution,5,2,3
Whoopsie,dragonmaw,159,paladin,retribution,5,2,3
Maldayn,quelthalas,159,paladin,retribution,5,2,3
Beelzebøss,frostmourne,159,paladin,retribution,5,2,3
Ubbhe,quelthalas,159,paladin,retribution,5,2,3
Erédin,draenor,159,paladin,retribution,5,2,3
Bubbledown,bleeding-hollow,159,paladin,retribution,5,2,3
Maldituss,azralon,159,paladin,retribution,8,3,5
Jwilks,black-dragonflight,159,paladin,retribution,8,2,6
Whiplashlol,frostwolf,144,paladin,retribution,3,3,0
Holeesheett,tichondrius,144,paladin,retribution,9,2,7
Chancéllor,stormrage,138,paladin,retribution,6,3,3
Leevii,azralon,138,paladin,retribution,11,4,7
Åddict,kelthuzad,138,paladin,retribution,10,3,7
Iæl,stormrage,138,paladin,retribution,10,3,7
Baconsock,kelthuzad,138,paladin,retribution,15,4,11
Lilby,lightbringer,138,paladin,retribution,14,3,11
Ðeathguise,ysera,138,paladin,retribution,15,3,12
Dathromir,stormrage,138,paladin,retribution,15,3,12
Bubbleosèven,tichondrius,138,paladin,retribution,16,3,13
Stârfôx,area-52,128,paladin,retribution,4,2,2
Seebastian,kelthuzad,128,paladin,retribution,4,2,2
Sweetbunz,altar-of-storms,128,paladin,retribution,4,2,2
Telaenchufo,ragnaros,128,paladin,retribution,4,2,2
Mikwa,ragnaros,128,paladin,retribution,4,2,2
Comptoncody,area-52,128,paladin,retribution,9,3,6
Sofiora,thunderlord,128,paladin,retribution,10,2,8
Khileeha,sargeras,128,paladin,retribution,10,2,8
Vishpal,malganis,112,paladin,retribution,7,2,5
Utho,wyrmrest-accord,96,paladin,retribution,3,2,1
Gaismagorm,ragnaros,96,paladin,retribution,3,2,1
Leadyth,moon-guard,96,paladin,retribution,3,2,1
Swordstrikes,tichondrius,96,paladin,retribution,3,2,1
Shalith,thrall,96,paladin,retribution,3,2,1
Dazak,ragnaros,96,paladin,retribution,3,2,1
Simple,ghostlands,96,paladin,retribution,16,3,13
Riçky,tichondrius,96,paladin,retribution,6,1,5
Këys,earthen-ring,96,paladin,retribution,6,1,5
Chainjustice,area-52,96,paladin,retribution,6,1,5
Conámi,ragnaros,96,paladin,retribution,6,1,5
Alk,windrunner,96,paladin,retribution,6,1,5
Daivdsonbr,azralon,96,paladin,retribution,6,1,5
Chuggawhugga,area-52,96,paladin,retribution,6,1,5
Killerofmind,azralon,96,paladin,retribution,6,1,5
Lays,suramar,96,paladin,retribution,6,1,5
Goksuu,ragnaros,96,paladin,retribution,6,1,5
Skadooshh,illidan,96,paladin,retribution,6,1,5
Mentalíssues,moon-guard,96,paladin,retribution,6,1,5
Rg,nerzhul,96,paladin,retribution,6,1,5
Raams,moon-guard,96,paladin,retribution,6,1,5
Gdesign,tichondrius,96,paladin,retribution,6,1,5
Pipesmoke,dunemaul,96,paladin,retribution,6,1,5
Ágirlzinha,azralon,96,paladin,retribution,6,1,5
Duecesz,area-52,96,paladin,retribution,6,1,5
Urudith,azralon,96,paladin,retribution,6,1,5
Skeeta,area-52,96,paladin,retribution,6,1,5
Rodt,dalaran,96,paladin,retribution,6,1,5
Gabrielwrynn,nemesis,96,paladin,retribution,6,1,5
Chøcølatte,azralon,96,paladin,retribution,6,1,5
Bosmoklikdat,moon-guard,96,paladin,retribution,6,1,5
Tyrannos,tichondrius,96,paladin,retribution,6,1,5
Ünkøwn,stormrage,96,paladin,retribution,6,1,5
Lâskó,area-52,96,paladin,retribution,6,1,5
Talahar,boulderfist,96,paladin,retribution,6,1,5
Cucomangera,ragnaros,96,paladin,retribution,6,1,5
Ashlane,tichondrius,96,paladin,retribution,6,1,5
Ariolo,baelgun,96,paladin,retribution,6,1,5
Brutalize,moon-guard,96,paladin,retribution,6,1,5
Krelya,ragnaros,96,paladin,retribution,6,1,5
Jeeb,blackrock,96,paladin,retribution,6,1,5
Cots,azralon,96,paladin,retribution,6,1,5
Holyxsmokes,illidan,96,paladin,retribution,6,1,5
Vicentez,area-52,96,paladin,retribution,6,1,5
Scyfher,stormrage,96,paladin,retribution,6,1,5
Sanddor,moon-guard,96,paladin,retribution,6,1,5
Rodrigo,frostmourne,96,paladin,retribution,6,1,5
Zpaladino,azralon,96,paladin,retribution,6,1,5
Daelann,moon-guard,96,paladin,retribution,6,1,5
Teupaiécornu,azralon,96,paladin,retribution,6,1,5
Chawbanger,proudmoore,96,paladin,retribution,6,1,5
Isskandar,moon-guard,96,paladin,retribution,6,1,5
Maldobarr,stormrage,96,paladin,retribution,6,1,5
Carloss,drakkari,96,paladin,retribution,6,1,5
Justtrollin,black-dragonflight,96,paladin,retribution,6,1,5
Wakethelight,illidan,96,paladin,retribution,6,1,5
Nvrbubble,area-52,96,paladin,retribution,6,1,5
Shamashjoel,black-dragonflight,96,paladin,retribution,6,1,5
Samsaratry,proudmoore,96,paladin,retribution,6,1,5
Bigdampally,tichondrius,96,paladin,retribution,6,1,5
Holyclapzy,stormrage,96,paladin,retribution,6,1,5
Chapichapi,illidan,96,paladin,retribution,6,1,5
Cantbecosby,scilla,96,paladin,retribution,6,1,5
Astolan,runetotem,96,paladin,retribution,6,1,5
Retrib,tichondrius,96,paladin,retribution,6,1,5
Spikeriu,ragnaros,96,paladin,retribution,6,1,5
Balloony,stormrage,96,paladin,retribution,6,1,5
Prahv,shuhalo,96,paladin,retribution,6,1,5
Kytheon,zuluhed,96,paladin,retribution,6,1,5
Lightmessiah,perenolde,96,paladin,retribution,6,1,5
Ryudoshël,nemesis,96,paladin,retribution,6,1,5
Scah,illidan,96,paladin,retribution,6,1,5
Kuribohs,tichondrius,96,paladin,retribution,6,1,5
Adjudicator,shuhalo,96,paladin,retribution,6,1,5
Jüstice,tichondrius,96,paladin,retribution,6,1,5
Bubbllicious,thrall,96,paladin,retribution,6,1,5
Dûälïpä,barthilas,96,paladin,retribution,6,1,5
Febimus,magtheridon,96,paladin,retribution,6,1,5
Vatherollin,proudmoore,96,paladin,retribution,6,1,5
Àurorâ,tichondrius,96,paladin,retribution,6,1,5
Erindor,emerald-dream,96,paladin,retribution,6,1,5
Gazef,proudmoore,96,paladin,retribution,6,1,5
Slayalot,icecrown,96,paladin,retribution,6,1,5
Bromango,emerald-dream,96,paladin,retribution,6,1,5
Poonxx,frostmourne,96,paladin,retribution,6,1,5
Falconone,tichondrius,96,paladin,retribution,6,1,5
Scuffedhoj,tichondrius,96,paladin,retribution,6,1,5
Boundric,emerald-dream,96,paladin,retribution,6,1,5
Ssjgodvy,illidan,96,paladin,retribution,6,1,5
Judgémental,bleeding-hollow,96,paladin,retribution,6,1,5
Tehbeasty,hyjal,96,paladin,retribution,6,1,5
Nytto,lightnings-blade,96,paladin,retribution,6,1,5
Franchy,stormrage,96,paladin,retribution,6,1,5
Tharok,spirestone,96,paladin,retribution,6,1,5
Yesdaddyxo,emerald-dream,96,paladin,retribution,6,1,5
Angusbeef,hyjal,96,paladin,retribution,6,1,5
Palajem,stormrage,96,paladin,retribution,6,1,5
Redderick,illidan,96,paladin,retribution,6,1,5
Scrubdin,illidan,96,paladin,retribution,6,1,5
Partenna,quelthalas,96,paladin,retribution,6,1,5
Zwilliam,frostmourne,96,paladin,retribution,6,1,5
Dafoq,stormrage,96,paladin,retribution,6,1,5
Carnefix,wyrmrest-accord,96,paladin,retribution,6,1,5
Palagwen,emerald-dream,96,paladin,retribution,6,1,5
Hxnny,turalyon,96,paladin,retribution,6,1,5
Englishdude,tichondrius,96,paladin,retribution,6,1,5
Lakinipally,lightbringer,96,paladin,retribution,6,1,5
Orthín,stormrage,96,paladin,retribution,6,1,5
Ret,burning-legion,96,paladin,retribution,6,1,5
Parts,aerie-peak,96,paladin,retribution,6,1,5
Murzo,hyjal,96,paladin,retribution,6,1,5
Respiratoryy,kelthuzad,96,paladin,retribution,6,1,5
Bhaba,frostmourne,96,paladin,retribution,6,1,5
Madtrollaids,kiljaeden,96,paladin,retribution,6,1,5
Donoph,blades-edge,96,paladin,retribution,6,1,5
Chootoy,tichondrius,96,paladin,retribution,6,1,5
Forexqt,blackhand,96,paladin,retribution,6,1,5
Brank,agamaggan,96,paladin,retribution,6,1,5
Djset,blackhand,96,paladin,retribution,6,1,5
Wrongnumber,blackrock,96,paladin,retribution,6,1,5
Luiiguii,drakkari,96,paladin,retribution,6,1,5
Coffeebean,quelthalas,96,paladin,retribution,6,1,5
Chakin,burning-legion,96,paladin,retribution,6,1,5
Meanervini,kiljaeden,96,paladin,retribution,6,1,5
Mastadin,illidan,96,paladin,retribution,6,1,5
Silencestorm,tichondrius,96,paladin,retribution,6,1,5
Zulzander,kelthuzad,96,paladin,retribution,6,1,5
Lythos,dathremar,96,paladin,retribution,6,1,5
Fourwives,sargeras,96,paladin,retribution,6,1,5
Lòuisvuttion,tichondrius,96,paladin,retribution,6,1,5
Grimsical,kelthuzad,96,paladin,retribution,6,1,5
Cloudwalker,spirestone,96,paladin,retribution,6,1,5
Ding,wyrmrest-accord,96,paladin,retribution,6,1,5
Tooshka,azshara,96,paladin,retribution,6,1,5
Salennai,daggerspine,96,paladin,retribution,6,1,5
Kírí,quelthalas,96,paladin,retribution,6,1,5
Holykhan,blades-edge,96,paladin,retribution,6,1,5
Akirahikarri,frostwolf,96,paladin,retribution,6,1,5
Palium,stormrage,96,paladin,retribution,6,1,5
Beebopper,illidan,96,paladin,retribution,6,1,5
Liongolden,azralon,96,paladin,retribution,6,1,5
Tfym,tichondrius,96,paladin,retribution,6,1,5
Bruwdblood,bleeding-hollow,96,paladin,retribution,6,1,5
Warhero,sargeras,96,paladin,retribution,6,1,5
Aldwyn,deathwing,96,paladin,retribution,6,1,5
Maeyz,sargeras,96,paladin,retribution,6,1,5
Acpally,tichondrius,96,paladin,retribution,6,1,5
Bravsirrobin,firetree,96,paladin,retribution,6,1,5
Cupidxbye,tichondrius,96,paladin,retribution,6,1,5
Thòrisòn,stormrage,96,paladin,retribution,6,1,5
Adobro,tichondrius,96,paladin,retribution,6,1,5
Krylaa,madoran,96,paladin,retribution,6,1,5
Krulu,thrall,96,paladin,retribution,6,1,5
Deviill,winterhoof,96,paladin,retribution,6,1,5
Cyona,gallywix,96,paladin,retribution,6,1,5
Sleyn,stormrage,96,paladin,retribution,6,1,5
Kroman,quelthalas,96,paladin,retribution,6,1,5
Checkmater,malganis,96,paladin,retribution,6,1,5
Pùteduvilage,zuljin,96,paladin,retribution,6,1,5
Odos,zuljin,96,paladin,retribution,6,1,5
Retx,arthas,96,paladin,retribution,6,1,5
Krusade,hydraxis,96,paladin,retribution,6,1,5
Shortj,malganis,96,paladin,retribution,6,1,5
Yøu,tichondrius,96,paladin,retribution,6,1,5
Poeboyz,stormrage,96,paladin,retribution,6,1,5
Mîrrors,barthilas,96,paladin,retribution,6,1,5
Aragonns,illidan,96,paladin,retribution,6,1,5
Angelichaze,hyjal,96,paladin,retribution,6,1,5
Kamakazê,sargeras,96,paladin,retribution,6,1,5
Djotto,sargeras,96,paladin,retribution,6,1,5
Giita,quelthalas,96,paladin,retribution,6,1,5
Yikesidk,stormrage,96,paladin,retribution,6,1,5
Repsforjêsus,hydraxis,96,paladin,retribution,6,1,5
Ahrieze,moon-guard,96,paladin,retribution,6,1,5
Crixos,quelthalas,96,paladin,retribution,6,1,5
Asheryte,sargeras,96,paladin,retribution,6,1,5
Flashbubble,sargeras,96,paladin,retribution,6,1,5
Sneakycastro,bleeding-hollow,96,paladin,retribution,6,1,5
Fydepala,stormrage,96,paladin,retribution,6,1,5
Latchpaladin,sargeras,96,paladin,retribution,6,1,5
Scarllye,illidan,96,paladin,retribution,6,1,5
Gressilin,arthas,96,paladin,retribution,6,1,5
Tidds,sargeras,96,paladin,retribution,6,1,5
Trashslinger,sargeras,96,paladin,retribution,6,1,5
Marcovk,quelthalas,96,paladin,retribution,6,1,5
Bajindaa,sargeras,96,paladin,retribution,6,1,5
Anisaria,skywall,96,paladin,retribution,6,1,5
Thumos,sargeras,96,paladin,retribution,6,1,5
Retsarro,frostmourne,96,paladin,retribution,6,1,5
Dìlf,zuljin,96,paladin,retribution,6,1,5
Topsid,sargeras,96,paladin,retribution,6,1,5
Bigshaftt,gorgonnash,96,paladin,retribution,6,1,5
Hungheracles,thrall,96,paladin,retribution,6,1,5
Brynleigh,malganis,96,paladin,retribution,6,1,5
Tradalia,illidan,96,paladin,retribution,6,1,5
Måtrix,sargeras,96,paladin,retribution,6,1,5
Valadinn,tichondrius,96,paladin,retribution,6,1,5
Freyrr,azralon,96,paladin,retribution,6,1,5
Adrel,ragnaros,96,paladin,retribution,6,1,5
Thorgard,antonidas,96,paladin,retribution,6,1,5
Lelythia,bleeding-hollow,96,paladin,retribution,7,1,6
Trinkysteve,frostmane,96,paladin,retribution,7,1,6
Gotdrò,tichondrius,96,paladin,retribution,16,2,14
Cherix,thrall,96,paladin,retribution,9,1,8
Yoropal,tichondrius,96,paladin,retribution,12,1,11
Lorenzojr,sargeras,96,paladin,retribution,12,1,11
Zalacar,azralon,96,paladin,retribution,12,1,11
Hojpocketx,tichondrius,96,paladin,retribution,12,1,11
Catholica,tichondrius,96,paladin,retribution,12,1,11
Hondacivicsi,mannoroth,96,paladin,retribution,12,1,11
Oshia,destromath,96,paladin,retribution,12,1,11
Zalcan,vashj,96,paladin,retribution,12,1,11
Siglud,tichondrius,96,paladin,retribution,12,1,11
Roosterface,azjolnerub,96,paladin,retribution,12,1,11
Kënsi,quelthalas,96,paladin,retribution,12,1,11
Yobnai,zuljin,96,paladin,retribution,12,1,11
Bregalad,bleeding-hollow,96,paladin,retribution,12,1,11
Whosyourdady,azjolnerub,96,paladin,retribution,12,1,11
Séykän,ragnaros,96,paladin,retribution,12,1,11
Imbackk,quelthalas,96,paladin,retribution,12,1,11
Reinhardburm,quelthalas,96,paladin,retribution,12,1,11
Miniminx,malganis,96,paladin,retribution,12,1,11
Rimorse,illidan,96,paladin,retribution,12,1,11
Geykum,tichondrius,96,paladin,retribution,17,1,16
ßleider,quelthalas,1906,paladin,protection,55,39,16
Ëlmaster,nemesis,1831,paladin,protection,126,80,46
Sigmapepe,quelthalas,1802,paladin,protection,155,111,44
Degenratebri,moon-guard,1774,paladin,protection,99,67,32
Aluvia,malygos,1741,paladin,protection,70,50,20
Sutadansa,doomhammer,1733,paladin,protection,176,90,86
Zhspeilian,tichondrius,1730,paladin,protection,84,47,37
Höpönpöppö,frostmourne,1729,paladin,protection,48,26,22
Kierolechita,ragnaros,1721,paladin,protection,262,135,127
Crâfty,bleeding-hollow,1717,paladin,protection,113,65,48
Motates,malganis,1706,paladin,protection,93,48,45
Blackmiya,tichondrius,1687,paladin,protection,49,32,17
Thulêan,moon-guard,1678,paladin,protection,48,21,27
Wilder,turalyon,1676,paladin,protection,47,27,20
Dankerton,tichondrius,1670,paladin,protection,38,20,18
Jimmipepe,quelthalas,1668,paladin,protection,164,107,57
Zealna,tichondrius,1663,paladin,protection,35,24,11
Eclipsor,bleeding-hollow,1657,paladin,protection,48,30,18
Sôlux,quelthalas,1657,paladin,protection,62,36,26
Vondonna,moon-guard,1655,paladin,protection,113,65,48
Lxwd,tichondrius,1636,paladin,protection,131,66,65
Uglyboyryan,sargeras,1632,paladin,protection,102,57,45
Zephyrvalor,sargeras,1628,paladin,protection,170,84,86
Cusino,tichondrius,1604,paladin,protection,74,40,34
Bighardshock,aggramar,1598,paladin,protection,48,26,22
Gredo,queldorei,1572,paladin,protection,47,25,22
Rehtua,bleeding-hollow,1557,paladin,protection,83,35,48
Poppadock,veknilash,1555,paladin,protection,126,73,53
Chozverialyz,ysondre,1552,paladin,protection,80,39,41
Demloc,doomhammer,1544,paladin,protection,54,25,29
Øziris,goldrinn,1525,paladin,protection,103,47,56
Wowmike,sargeras,1516,paladin,protection,162,85,77
Trågédy,zuljin,1509,paladin,protection,18,16,2
Xbloodknight,malganis,1494,paladin,protection,48,16,32
Tooholy,kiljaeden,1486,paladin,protection,41,22,19
Borrus,malygos,1480,paladin,protection,48,28,20
Aeythyr,wyrmrest-accord,1472,paladin,protection,86,39,47
Aopidsfihjov,stormrage,1471,paladin,protection,113,58,55
Zexion,azralon,1450,paladin,protection,45,19,26
Alekvin,moon-guard,1442,paladin,protection,36,19,17
Íaan,drakkari,1433,paladin,protection,70,43,27
Arcilys,illidan,1427,paladin,protection,107,47,60
Taillien,bonechewer,1422,paladin,protection,76,43,33
Bubblemark,tichondrius,1420,paladin,protection,41,15,26
Whëëls,stormreaver,1411,paladin,protection,41,22,19
Bt,quelthalas,1410,paladin,protection,47,31,16
Terayus,veknilash,1409,paladin,protection,42,23,19
Lorec,zuljin,1395,paladin,protection,54,25,29
Modafinil,bonechewer,1390,paladin,protection,117,53,64
Domocho,azgalor,1387,paladin,protection,47,24,23
Herimi,drakkari,1379,paladin,protection,107,43,64
Goldjade,khazgoroth,1374,paladin,protection,119,49,70
Rakasho,azralon,1370,paladin,protection,60,23,37
Goeun,destromath,1369,paladin,protection,37,16,21
Almeta,kelthuzad,1350,paladin,protection,36,18,18
Jenesis,illidan,1348,paladin,protection,30,20,10
Khrome,cenarion-circle,1346,paladin,protection,217,80,137
Stormvikingx,darkspear,1336,paladin,protection,24,14,10
Palahogx,sargeras,1333,paladin,protection,30,14,16
Fredward,bleeding-hollow,1329,paladin,protection,30,14,16
Canibaluy,ragnaros,1329,paladin,protection,40,18,22
Ronor,thorium-brotherhood,1323,paladin,protection,48,24,24
Jkethuhsnake,ghostlands,1306,paladin,protection,51,31,20
Thorsmites,sargeras,1273,paladin,protection,48,18,30
Poorly,thorium-brotherhood,1266,paladin,protection,48,24,24
Protdream,tichondrius,1245,paladin,protection,18,13,5
Lythos,dathremar,1238,paladin,protection,42,19,23
Imthabromb,dragonblight,1204,paladin,protection,47,24,23
Kittié,proudmoore,1163,paladin,protection,44,14,30
Lelythia,bleeding-hollow,1161,paladin,protection,65,25,40
Ratzon,dalaran,1156,paladin,protection,23,14,9
Trâgedy,azjolnerub,1149,paladin,protection,24,12,12
Chanimalf,tichondrius,1118,paladin,protection,18,13,5
Zakh,proudmoore,1053,paladin,protection,18,11,7
Bronislav,draka,1053,paladin,protection,18,11,7
Penitent,barthilas,1052,paladin,protection,18,11,7
Holybull,maiev,1039,paladin,protection,24,11,13
Blicka,dragonblight,1031,paladin,protection,30,11,19
Ndnpaly,bonechewer,1017,paladin,protection,24,11,13
Bullivan,sisters-of-elune,963,paladin,protection,40,14,26
Devonius,sargeras,959,paladin,protection,18,10,8
Holyknight,veknilash,959,paladin,protection,26,11,15
Strontimus,moon-guard,958,paladin,protection,12,10,2
Danthorin,malfurion,940,paladin,protection,44,10,34
Matadore,arygos,908,paladin,protection,22,11,11
Dyllionaire,thrall,863,paladin,protection,12,9,3
Alexcydragon,quelthalas,863,paladin,protection,18,9,9
Hittit,thrall,859,paladin,protection,30,9,21
Cherubic,sargeras,858,paladin,protection,30,9,21
Negativeiq,moon-guard,798,paladin,protection,10,10,0
Courageousz,dalaran,768,paladin,protection,18,8,10
Zackthepally,area-52,768,paladin,protection,24,8,16
Crusâder,area-52,767,paladin,protection,24,8,16
Lothwrynn,senjin,762,paladin,protection,18,8,10
Dirkdigglerz,bleeding-hollow,746,paladin,protection,23,8,15
Halnoth,dethecus,702,paladin,protection,11,8,3
Buslightyear,azralon,672,paladin,protection,12,7,5
Kurokodieru,dalaran,672,paladin,protection,18,7,11
Valkaire,area-52,671,paladin,protection,12,7,5
Nobleblood,emerald-dream,669,paladin,protection,18,7,11
Drágons,stormrage,576,paladin,protection,12,6,6
Lessera,tichondrius,576,paladin,protection,12,6,6
Holykura,thrall,576,paladin,protection,12,6,6
Sølis,alleria,576,paladin,protection,12,6,6
Huwglyndur,trollbane,575,paladin,protection,12,6,6
Paldyn,illidan,575,paladin,protection,12,6,6
Cots,azralon,556,paladin,protection,23,6,17
Mattis,malganis,480,paladin,protection,6,5,1
Steverógers,frostmourne,480,paladin,protection,6,5,1
Tankfest,sargeras,480,paladin,protection,12,5,7
Typhoontravv,thrall,480,paladin,protection,12,5,7
Kiehui,lightbringer,480,paladin,protection,12,5,7
Gotankz,moon-guard,480,paladin,protection,12,5,7
Lewstelamon,korialstrasz,446,paladin,protection,10,6,4
Ibubblë,wildhammer,384,paladin,protection,6,4,2
Guidö,stormrage,384,paladin,protection,6,4,2
Thorkell,moon-guard,384,paladin,protection,6,4,2
Belmorlin,moon-guard,384,paladin,protection,12,4,8
Valisari,korialstrasz,384,paladin,protection,12,4,8
Gîmply,proudmoore,384,paladin,protection,12,4,8
Ilovéyou,barthilas,384,paladin,protection,12,4,8
Bullheaded,silvermoon,384,paladin,protection,12,4,8
Zaeris,proudmoore,384,paladin,protection,12,4,8
Rikurena,bonechewer,383,paladin,protection,6,4,2
Jahirie,aegwynn,351,paladin,protection,17,4,13
Isecretly,stormrage,335,paladin,protection,7,7,0
Cheers,garona,288,paladin,protection,6,3,3
Santovaca,anubarak,288,paladin,protection,6,3,3
Thortanous,icecrown,288,paladin,protection,6,3,3
Shieldret,drakthul,288,paladin,protection,6,3,3
Harterin,stormrage,288,paladin,protection,6,3,3
Eliteyahtzee,kelthuzad,288,paladin,protection,12,3,9
Threesixteen,proudmoore,288,paladin,protection,12,3,9
Kooshh,thunderlord,288,paladin,protection,12,3,9
Irahan,stormrage,288,paladin,protection,12,3,9
Urfavxbf,baelgun,288,paladin,protection,13,3,10
Saeranella,moon-guard,240,paladin,protection,9,3,6
Blâckhârt,saurfang,234,paladin,protection,9,4,5
Zatheus,area-52,192,paladin,protection,6,2,4
Troxnar,ragnaros,192,paladin,protection,6,2,4
Stompem,zuljin,192,paladin,protection,6,2,4
Immensepower,tichondrius,192,paladin,protection,6,2,4
Xinqingle,tichondrius,192,paladin,protection,6,2,4
Òp,illidan,192,paladin,protection,10,3,7
Consecrated,daggerspine,192,paladin,protection,12,2,10
Zifre,ragnaros,192,paladin,protection,12,2,10
Protbeeff,area-52,192,paladin,protection,12,2,10
Dwarvendude,sargeras,159,paladin,protection,11,2,9
Smökë,area-52,127,paladin,protection,8,2,6
Combidin,garrosh,96,paladin,protection,6,1,5
Qtipds,moon-guard,96,paladin,protection,6,1,5
Lasonil,zuljin,96,paladin,protection,6,1,5
Siire,darkspear,96,paladin,protection,6,1,5
Airane,sargeras,96,paladin,protection,6,1,5
Thrandaic,frostmourne,96,paladin,protection,6,1,5
Mtanchokeme,stormrage,96,paladin,protection,9,1,8
Chàrron,garrosh,79,paladin,protection,5,1,4
Garbagedisc,scilla,2139,priest,holy,114,56,58
Yötönyö,sargeras,2082,priest,holy,114,57,57
Bjorke,tichondrius,2051,priest,holy,102,57,45
Ømegagødx,illidan,2046,priest,holy,72,38,34
Priestlike,tichondrius,2007,priest,holy,133,70,63
Dogbutt,burning-legion,1996,priest,holy,222,111,111
Rustymvp,nagrand,1988,priest,holy,269,132,137
Pickle,illidan,1974,priest,holy,86,49,37
Pianohouse,illidan,1964,priest,holy,156,82,74
Zxxkawaii,tichondrius,1961,priest,holy,184,102,82
Fluent,emerald-dream,1952,priest,holy,234,113,121
Fusira,gurubashi,1941,priest,holy,48,25,23
Ninbara,tichondrius,1940,priest,holy,144,72,72
Tookiex,stormrage,1936,priest,holy,73,35,38
Saintjpii,tichondrius,1910,priest,holy,161,96,65
Tirrify,frostmourne,1899,priest,holy,54,29,25
Cokeheals,kelthuzad,1897,priest,holy,42,26,16
Onemission,whisperwind,1889,priest,holy,72,27,45
Walnut,kelthuzad,1876,priest,holy,48,29,19
Cinnalite,darkspear,1870,priest,holy,42,29,13
Dreckie,sargeras,1869,priest,holy,219,114,105
Whalexo,kelthuzad,1869,priest,holy,290,144,146
Zazul,frostmane,1859,priest,holy,125,75,50
Teslashield,bleeding-hollow,1856,priest,holy,54,25,29
Mynaevis,malganis,1855,priest,holy,120,64,56
Mastuti,azralon,1854,priest,holy,149,74,75
Onikûdaki,sargeras,1850,priest,holy,113,52,61
Peat,hyjal,1844,priest,holy,54,27,27
Fanatic,lightbringer,1841,priest,holy,54,31,23
Superduperr,illidan,1840,priest,holy,66,33,33
Falsegodx,tichondrius,1837,priest,holy,180,99,81
Vandalia,shadowsong,1837,priest,holy,181,89,92
Cosmicyiff,area-52,1833,priest,holy,124,69,55
Gerpe,stormrage,1830,priest,holy,189,106,83
Quicklight,sargeras,1826,priest,holy,131,76,55
Lagemela,quelthalas,1825,priest,holy,101,47,54
Pmos,sargeras,1823,priest,holy,40,21,19
Lilyxo,bleeding-hollow,1823,priest,holy,84,41,43
Flamboyant,sisters-of-elune,1817,priest,holy,66,38,28
Meatboxmoldy,blood-furnace,1817,priest,holy,82,41,41
Iniquitatem,tichondrius,1817,priest,holy,60,23,37
Tromnasty,area-52,1816,priest,holy,90,53,37
Whitetails,illidan,1816,priest,holy,54,31,23
Lëønë,nemesis,1815,priest,holy,154,95,59
Rootandboot,frostmourne,1815,priest,holy,49,29,20
Sweatynick,proudmoore,1813,priest,holy,227,109,118
Immthuggin,tichondrius,1813,priest,holy,120,53,67
Scyner,bleeding-hollow,1811,priest,holy,152,87,65
Dmgisop,illidan,1811,priest,holy,141,80,61
Clarifytwo,arathor,1809,priest,holy,48,29,19
Appleshampoo,black-dragonflight,1807,priest,holy,54,31,23
Qnzo,tichondrius,1806,priest,holy,60,39,21
Stonemonkeyp,sargeras,1806,priest,holy,320,179,141
Pipelayerx,illidan,1804,priest,holy,50,25,25
Murkd,tichondrius,1804,priest,holy,145,68,77
Citrinesta,illidan,1803,priest,holy,445,241,204
Gill,proudmoore,1800,priest,holy,148,78,70
Holypopocat,tichondrius,1790,priest,holy,93,58,35
Cokeheals,tichondrius,1786,priest,holy,54,28,26
Goodlife,frostmourne,1784,priest,holy,125,62,63
Moonideli,moon-guard,1783,priest,holy,90,46,44
Turnipp,sargeras,1780,priest,holy,42,19,23
Icychain,area-52,1779,priest,holy,41,23,18
Pigogo,tichondrius,1778,priest,holy,181,100,81
Elbowbeans,tichondrius,1778,priest,holy,148,76,72
Zenelu,tichondrius,1775,priest,holy,482,239,243
Noniok,blackrock,1774,priest,holy,122,78,44
Haruspex,azralon,1774,priest,holy,129,61,68
Dream,kelthuzad,1767,priest,holy,102,52,50
Shoepooper,kelthuzad,1766,priest,holy,36,22,14
Illmindofmoo,sargeras,1757,priest,holy,53,24,29
Jjmms,akama,1755,priest,holy,275,137,138
ßsimp,darrowmere,1750,priest,holy,130,65,65
Óst,tichondrius,1747,priest,holy,54,23,31
Heavyflo,kelthuzad,1746,priest,holy,114,58,56
Hyouka,area-52,1745,priest,holy,321,166,155
Jüdaspriest,gorefiend,1744,priest,holy,53,20,33
Nanatoo,sargeras,1743,priest,holy,42,22,20
Soloqqt,tichondrius,1740,priest,holy,48,28,20
Iovesosa,kelthuzad,1739,priest,holy,39,22,17
Verymuscular,stormrage,1737,priest,holy,73,37,36
Moldymeatbox,blood-furnace,1735,priest,holy,53,30,23
Qtasiangirl,emerald-dream,1735,priest,holy,129,60,69
Wøo,area-52,1730,priest,holy,220,118,102
Minipriest,sargeras,1726,priest,holy,48,23,25
Tookz,stormrage,1725,priest,holy,42,26,16
Bloodlinex,malganis,1724,priest,holy,207,116,91
Snookp,kiljaeden,1723,priest,holy,209,115,94
Iluvthgnmicz,sargeras,1722,priest,holy,81,44,37
Blazedpri,tichondrius,1721,priest,holy,30,18,12
Nildryck,malganis,1720,priest,holy,42,19,23
Cheekypriest,stormrage,1714,priest,holy,66,30,36
Eccentricx,sargeras,1712,priest,holy,30,18,12
Sinthe,stormrage,1711,priest,holy,36,18,18
Wisdumos,frostmourne,1710,priest,holy,102,55,47
Hannavi,illidan,1707,priest,holy,120,76,44
Ioved,sisters-of-elune,1705,priest,holy,218,115,103
Qnarisha,tichondrius,1702,priest,holy,155,85,70
Snowymooie,frostmourne,1697,priest,holy,54,25,29
Baip,sargeras,1696,priest,holy,42,25,17
Illooj,eonar,1696,priest,holy,61,36,25
Packet,zuluhed,1694,priest,holy,42,28,14
Geoffrred,illidan,1686,priest,holy,54,21,33
Candohp,frostmourne,1682,priest,holy,54,28,26
Dypkillet,moon-guard,1679,priest,holy,168,84,84
Soulghast,gorefiend,1676,priest,holy,65,34,31
Gaudthree,tichondrius,1675,priest,holy,48,26,22
Yyuan,tichondrius,1673,priest,holy,78,37,41
Sukeena,malganis,1672,priest,holy,151,79,72
Tylexus,tichondrius,1671,priest,holy,48,23,25
Ishyeboi,stormrage,1670,priest,holy,36,22,14
Myles,alexstrasza,1667,priest,holy,42,24,18
Santyel,ragnaros,1666,priest,holy,138,71,67
Endure,moon-guard,1665,priest,holy,54,28,26
Pws,azralon,1663,priest,holy,96,43,53
Lemmiewinkzx,sargeras,1661,priest,holy,42,26,16
Iaz,darkspear,1661,priest,holy,80,37,43
Kottssanius,illidan,1660,priest,holy,44,25,19
Moosepriestx,sargeras,1660,priest,holy,42,19,23
Cryptron,tichondrius,1660,priest,holy,114,50,64
Lisnup,tichondrius,1659,priest,holy,75,39,36
Fyne,kelthuzad,1653,priest,holy,224,115,109
Djdazzle,kargath,1652,priest,holy,35,18,17
Pancakeboi,tichondrius,1649,priest,holy,191,89,102
Nielbomb,tichondrius,1647,priest,holy,442,225,217
Irídium,area-52,1643,priest,holy,48,24,24
Gosilly,tichondrius,1640,priest,holy,48,30,18
Dadcantdeath,frostmourne,1640,priest,holy,80,36,44
Phatheals,proudmoore,1639,priest,holy,36,19,17
Thisistragic,frostmourne,1636,priest,holy,40,31,9
Fhenomenal,tichondrius,1636,priest,holy,48,21,27
Dinosmeow,sargeras,1635,priest,holy,96,45,51
Leoshi,turalyon,1634,priest,holy,109,59,50
Bopang,emerald-dream,1634,priest,holy,80,39,41
Dfâc,moon-guard,1633,priest,holy,44,23,21
Wankenobi,stormrage,1632,priest,holy,315,157,158
Dntchekpvpme,tichondrius,1630,priest,holy,42,23,19
Hardiness,tichondrius,1627,priest,holy,66,45,21
Jaytee,aggramar,1624,priest,holy,32,19,13
Dgpriest,tichondrius,1620,priest,holy,48,23,25
Holydome,daggerspine,1619,priest,holy,54,20,34
Edmen,stormrage,1618,priest,holy,144,77,67
Pej,emerald-dream,1615,priest,holy,78,34,44
Clarify,arathor,1615,priest,holy,84,35,49
Miserable,emerald-dream,1614,priest,holy,102,56,46
Lickless,illidan,1613,priest,holy,48,23,25
Hpcando,frostmourne,1612,priest,holy,49,29,20
Kernelious,illidan,1611,priest,holy,48,22,26
Krobs,bleeding-hollow,1606,priest,holy,54,25,29
Fotmtrash,the-underbog,1602,priest,holy,24,17,7
Tytusx,stormrage,1601,priest,holy,74,38,36
Archbishop,stormscale,1601,priest,holy,172,87,85
Dylbags,frostmourne,1600,priest,holy,35,21,14
Vatan,dalaran,1600,priest,holy,42,24,18
Madomie,bladefist,1597,priest,holy,36,20,16
Cûrry,bleeding-hollow,1591,priest,holy,48,32,16
Evilpriest,stormrage,1591,priest,holy,48,24,24
Washdp,frostmourne,1591,priest,holy,60,26,34
Manbooty,illidan,1588,priest,holy,39,22,17
Shïryn,illidan,1585,priest,holy,59,29,30
Cerebrill,bleeding-hollow,1585,priest,holy,51,24,27
Operandi,sargeras,1583,priest,holy,41,22,19
Alathea,elune,1583,priest,holy,237,113,124
Joeschmoe,proudmoore,1577,priest,holy,72,40,32
Bloodyx,bleeding-hollow,1573,priest,holy,30,19,11
Iaptop,tichondrius,1569,priest,holy,36,20,16
Avis,illidan,1569,priest,holy,134,67,67
Cutiepriest,gnomeregan,1565,priest,holy,151,86,65
Padrecarras,ragnaros,1565,priest,holy,60,30,30
ßeautiful,sargeras,1562,priest,holy,42,22,20
Bubbles,drakthul,1561,priest,holy,568,287,281
Invincible,ragnaros,1560,priest,holy,26,19,7
Cantheel,stormrage,1560,priest,holy,271,142,129
Pootyspanked,daggerspine,1559,priest,holy,113,66,47
Boundword,emerald-dream,1555,priest,holy,72,40,32
Senzy,tichondrius,1553,priest,holy,36,18,18
Macko,wyrmrest-accord,1549,priest,holy,87,44,43
Exploded,moon-guard,1548,priest,holy,192,98,94
Leonerey,azralon,1544,priest,holy,36,17,19
Beli,dunemaul,1542,priest,holy,42,24,18
Praggy,proudmoore,1542,priest,holy,53,24,29
Hatxsu,emerald-dream,1540,priest,holy,123,61,62
Arçhángël,moon-guard,1539,priest,holy,114,65,49
Downturn,tichondrius,1539,priest,holy,66,30,36
Preebs,warsong,1539,priest,holy,48,19,29
Heluupa,illidan,1538,priest,holy,113,71,42
Punkndrublic,sargeras,1537,priest,holy,189,91,98
Tarlex,illidan,1536,priest,holy,118,54,64
Auntbrittany,tichondrius,1534,priest,holy,225,115,110
Natahlia,area-52,1534,priest,holy,36,17,19
Cardinalpéll,frostmourne,1533,priest,holy,104,56,48
Hynzor,barthilas,1533,priest,holy,58,23,35
Opeli,stormrage,1530,priest,holy,110,55,55
Jiñx,destromath,1529,priest,holy,66,30,36
Rubymisfit,sargeras,1528,priest,holy,30,16,14
Gentlewoman,ragnaros,1526,priest,holy,24,16,8
Bibleblak,stormrage,1525,priest,holy,60,30,30
Intrav,malganis,1523,priest,holy,34,17,17
Dispassion,stormrage,1523,priest,holy,182,90,92
Charbosan,gorgonnash,1522,priest,holy,48,22,26
Healinsucks,proudmoore,1519,priest,holy,52,29,23
Anguishment,stormrage,1517,priest,holy,385,193,192
Amayå,kelthuzad,1517,priest,holy,60,27,33
Meiev,quelthalas,1516,priest,holy,60,37,23
Handsumheals,kiljaeden,1515,priest,holy,55,32,23
Ducky,drakthul,1513,priest,holy,66,38,28
Miamama,hydraxis,1513,priest,holy,42,17,25
Boboxiao,illidan,1512,priest,holy,47,16,31
Justjoekingh,gurubashi,1507,priest,holy,46,24,22
Vampiric,laughing-skull,1506,priest,holy,92,51,41
Tortellino,hyjal,1505,priest,holy,30,19,11
Oyy,barthilas,1505,priest,holy,150,76,74
Badgoy,dalaran,1505,priest,holy,62,23,39
Psytrance,proudmoore,1504,priest,holy,42,23,19
Einheit,stormrage,1502,priest,holy,48,28,20
Nerfdisc,azralon,1502,priest,holy,49,25,24
Cruxave,aegwynn,1498,priest,holy,124,68,56
Saetia,drenden,1497,priest,holy,84,50,34
Sanojaz,ragnaros,1497,priest,holy,102,52,50
Symbolofhope,moon-guard,1495,priest,holy,75,36,39
Tazzi,chromaggus,1494,priest,holy,79,35,44
Illyasviel,terenas,1494,priest,holy,109,45,64
Painpaws,moon-guard,1493,priest,holy,36,26,10
Daddyguaga,tichondrius,1493,priest,holy,54,29,25
Sacrifer,moon-guard,1488,priest,holy,127,63,64
Griddly,alterac-mountains,1488,priest,holy,121,51,70
Matthiass,thrall,1485,priest,holy,220,107,113
Kostantina,kelthuzad,1484,priest,holy,42,18,24
Tranquilty,tichondrius,1480,priest,holy,84,36,48
Xedus,mannoroth,1478,priest,holy,80,37,43
Ksâh,bleeding-hollow,1476,priest,holy,60,33,27
Goyimhealer,area-52,1476,priest,holy,53,23,30
Soaphia,kelthuzad,1474,priest,holy,154,75,79
Swrvlol,emerald-dream,1471,priest,holy,42,29,13
Adrenalinn,illidan,1471,priest,holy,60,34,26
Deadpape,tichondrius,1470,priest,holy,48,23,25
Shieldspamx,tichondrius,1468,priest,holy,38,29,9
Ayanamil,tichondrius,1467,priest,holy,81,59,22
Exol,ragnaros,1465,priest,holy,48,25,23
Soleyxo,frostmourne,1464,priest,holy,90,47,43
Artiannaa,bleeding-hollow,1460,priest,holy,81,49,32
Rolence,tichondrius,1457,priest,holy,92,50,42
Chadopri,stormrage,1457,priest,holy,78,42,36
Chandracath,draktharon,1456,priest,holy,48,23,25
Discconnect,dark-iron,1456,priest,holy,41,19,22
Dapcum,illidan,1455,priest,holy,54,32,22
Dawnside,wyrmrest-accord,1454,priest,holy,755,399,356
Reverenced,stormrage,1452,priest,holy,126,72,54
Maplesyrupz,moonrunner,1452,priest,holy,40,16,24
Ðemi,zuljin,1449,priest,holy,81,43,38
Camedy,illidan,1447,priest,holy,173,85,88
Sooyáaa,illidan,1447,priest,holy,288,131,157
Pics,emerald-dream,1446,priest,holy,40,22,18
Giveheadpats,moon-guard,1445,priest,holy,176,84,92
Owlchubz,mannoroth,1443,priest,holy,121,57,64
Chervz,chogall,1443,priest,holy,78,32,46
Zallp,sargeras,1440,priest,holy,23,16,7
Cuaiminator,ragnaros,1438,priest,holy,77,42,35
Breathkeeper,proudmoore,1434,priest,holy,48,19,29
Hypepriest,sargeras,1433,priest,holy,30,20,10
Necroplasma,area-52,1433,priest,holy,55,31,24
ßugsy,illidan,1433,priest,holy,96,49,47
Leggoscams,tichondrius,1432,priest,holy,50,28,22
Iggyp,hyjal,1430,priest,holy,217,113,104
Plebiss,burning-blade,1429,priest,holy,423,218,205
Pesca,proudmoore,1429,priest,holy,36,15,21
Marïmba,azralon,1428,priest,holy,42,20,22
Lavigne,tichondrius,1427,priest,holy,30,15,15
Wrinkletink,whisperwind,1426,priest,holy,61,30,31
Qtcookiebunz,proudmoore,1424,priest,holy,35,17,18
Bradythree,moon-guard,1423,priest,holy,46,29,17
Doob,ghostlands,1423,priest,holy,66,36,30
Taashigi,frostmourne,1423,priest,holy,58,31,27
Applepieyum,illidan,1421,priest,holy,125,55,70
Vìxèn,zuljin,1419,priest,holy,127,57,70
Loosejeans,blackrock,1418,priest,holy,39,21,18
Mizzbehavn,tichondrius,1416,priest,holy,62,32,30
Aisperwind,shadowsong,1413,priest,holy,156,78,78
Tòxìç,stormrage,1411,priest,holy,187,96,91
Kovaxx,frostmourne,1410,priest,holy,165,79,86
Strivedaily,proudmoore,1409,priest,holy,290,138,152
Berzum,chogall,1406,priest,holy,36,17,19
Îcarus,tichondrius,1406,priest,holy,36,17,19
Akëla,nemesis,1404,priest,holy,86,50,36
Sacredforce,sargeras,1400,priest,holy,66,21,45
Pettypriest,dalaran,1394,priest,holy,201,95,106
Voïdx,emerald-dream,1394,priest,holy,75,30,45
Bestgirlna,area-52,1393,priest,holy,144,64,80
Drelia,jubeithos,1393,priest,holy,47,17,30
Musashibo,kelthuzad,1391,priest,holy,73,25,48
Soapfan,kelthuzad,1387,priest,holy,195,94,101
Dreäveler,stormrage,1385,priest,holy,27,15,12
Fenty,nemesis,1384,priest,holy,59,33,26
Padreamarol,ragnaros,1382,priest,holy,113,62,51
Glaius,kiljaeden,1381,priest,holy,102,49,53
Tonybanderas,shattered-halls,1381,priest,holy,42,19,23
Plod,kelthuzad,1380,priest,holy,42,25,17
Etain,bloodscalp,1380,priest,holy,65,35,30
Akaneo,tichondrius,1380,priest,holy,36,18,18
Xenatic,emerald-dream,1380,priest,holy,138,67,71
Niná,arathor,1379,priest,holy,26,16,10
Mikeyxo,gnomeregan,1379,priest,holy,50,30,20
Suirr,tichondrius,1377,priest,holy,36,16,20
Methodist,proudmoore,1377,priest,holy,90,34,56
Holyb,tichondrius,1375,priest,holy,99,50,49
Åutumn,tichondrius,1374,priest,holy,26,18,8
Lolcrafthd,ragnaros,1372,priest,holy,54,21,33
Hérò,barthilas,1371,priest,holy,56,32,24
Discospider,sargeras,1366,priest,holy,61,30,31
Holiermilk,demon-soul,1360,priest,holy,263,125,138
Aiwa,winterhoof,1359,priest,holy,74,41,33
Maddrox,sargeras,1359,priest,holy,47,26,21
Rihen,tichondrius,1358,priest,holy,525,257,268
Chemod,quelthalas,1355,priest,holy,47,26,21
Cyelena,quelthalas,1355,priest,holy,72,32,40
Quartzolio,azralon,1353,priest,holy,59,35,24
Muffinecho,sargeras,1353,priest,holy,85,36,49
Legoland,skullcrusher,1352,priest,holy,45,34,11
Sabene,greymane,1349,priest,holy,120,58,62
Shaldra,bleeding-hollow,1348,priest,holy,109,64,45
Ghostiepants,tichondrius,1347,priest,holy,53,25,28
Sappes,area-52,1346,priest,holy,54,27,27
Bigtizzle,illidan,1345,priest,holy,42,18,24
Nylaza,kiljaeden,1342,priest,holy,102,48,54
Debussynjoyr,malganis,1339,priest,holy,24,14,10
Sugarlorde,destromath,1339,priest,holy,46,23,23
Andruel,ragnaros,1338,priest,holy,109,56,53
Esvary,quelthalas,1337,priest,holy,134,71,63
Kurandies,nemesis,1337,priest,holy,73,37,36
Urdaisyy,kelthuzad,1337,priest,holy,42,15,27
Hizha,tichondrius,1335,priest,holy,42,24,18
Ænußís,stormrage,1335,priest,holy,84,46,38
Atenai,sargeras,1335,priest,holy,30,14,16
Lightwell,blackrock,1333,priest,holy,24,14,10
Spriest,kul-tiras,1332,priest,holy,74,41,33
Preacherr,bonechewer,1331,priest,holy,54,29,25
Kaelsgf,kaelthas,1331,priest,holy,60,25,35
Trufumthunzi,illidan,1330,priest,holy,26,17,9
Xumer,quelthalas,1329,priest,holy,68,35,33
Droneboy,moon-guard,1327,priest,holy,36,20,16
Gracarix,frostmourne,1326,priest,holy,52,30,22
Merellia,moon-guard,1324,priest,holy,108,52,56
Kaelthos,quelthalas,1324,priest,holy,125,59,66
Holyshytt,tichondrius,1323,priest,holy,59,31,28
Mkenze,moon-guard,1323,priest,holy,198,92,106
Healztonic,dalaran,1323,priest,holy,85,38,47
Faerielee,thrall,1322,priest,holy,64,29,35
Dispersed,thrall,1319,priest,holy,92,42,50
Priestlie,malganis,1318,priest,holy,98,43,55
Aurorias,burning-legion,1317,priest,holy,84,34,50
Freshtodeath,malganis,1316,priest,holy,48,28,20
Yuritzi,duskwood,1316,priest,holy,24,14,10
Arterrmis,barthilas,1316,priest,holy,101,51,50
Potatopriest,frostmourne,1315,priest,holy,24,14,10
Dunanan,moon-guard,1313,priest,holy,50,27,23
Lectra,firetree,1313,priest,holy,40,21,19
Milldogz,korgath,1312,priest,holy,30,14,16
Mercý,zuljin,1309,priest,holy,60,34,26
Klondikebar,whisperwind,1306,priest,holy,66,32,34
Animè,zuluhed,1305,priest,holy,89,52,37
Greytness,tichondrius,1305,priest,holy,36,16,20
Xinferesia,sargeras,1305,priest,holy,61,25,36
Jovon,frostmourne,1305,priest,holy,55,21,34
Floquii,area-52,1304,priest,holy,76,34,42
Snuffsnorter,kelthuzad,1304,priest,holy,41,16,25
Cutensoft,moon-guard,1302,priest,holy,60,28,32
Deathrina,moon-guard,1301,priest,holy,57,33,24
Xrafa,azralon,1301,priest,holy,84,38,46
Msdash,tichondrius,1300,priest,holy,31,20,11
Yujawang,sargeras,1300,priest,holy,36,17,19
Mímì,wyrmrest-accord,1299,priest,holy,37,20,17
Cristobal,chogall,1299,priest,holy,30,15,15
Giusep,tichondrius,1297,priest,holy,48,22,26
Athull,ragnaros,1296,priest,holy,24,14,10
Duhàst,sargeras,1296,priest,holy,95,43,52
Littlebat,proudmoore,1294,priest,holy,82,41,41
Holyfromrmp,tichondrius,1294,priest,holy,99,44,55
Healfouru,frostmourne,1290,priest,holy,24,14,10
Pastorb,burning-blade,1289,priest,holy,95,45,50
Deemmortii,stormrage,1289,priest,holy,43,18,25
Xanky,frostmourne,1287,priest,holy,34,18,16
Dagaen,thunderlord,1286,priest,holy,258,131,127
Dioecesis,moon-guard,1285,priest,holy,95,34,61
Amaristinaa,frostmourne,1279,priest,holy,52,24,28
Hycinamun,malganis,1277,priest,holy,37,17,20
Spïcÿ,frostmourne,1276,priest,holy,60,29,31
Duskherald,zuljin,1274,priest,holy,96,45,51
Visse,auchindoun,1273,priest,holy,42,29,13
Santamuerte,agamaggan,1272,priest,holy,42,22,20
Holyphodays,sargeras,1270,priest,holy,59,20,39
Lilyanná,tichondrius,1269,priest,holy,72,34,38
Raskreia,dragonmaw,1268,priest,holy,30,14,16
Bwaka,dalaran,1266,priest,holy,30,20,10
Tegridyfarm,malganis,1265,priest,holy,35,19,16
Krukam,sargeras,1264,priest,holy,67,31,36
Phearix,zuljin,1264,priest,holy,72,31,41
Helgar,frostmourne,1263,priest,holy,30,15,15
Fanseband,dalaran,1262,priest,holy,47,26,21
Threesclass,tichondrius,1262,priest,holy,29,14,15
Mirshadow,tichondrius,1260,priest,holy,54,27,27
Æsir,skullcrusher,1259,priest,holy,48,22,26
Pílí,drakkari,1258,priest,holy,84,43,41
Karrera,kelthuzad,1254,priest,holy,122,60,62
Dotsallover,sargeras,1254,priest,holy,56,27,29
Alrüna,moon-guard,1253,priest,holy,62,30,32
Benjamints,thrall,1252,priest,holy,30,15,15
Galadrael,quelthalas,1252,priest,holy,35,16,19
Tranith,jubeithos,1251,priest,holy,60,30,30
Allaras,eldrethalas,1250,priest,holy,36,17,19
Zallstan,zuljin,1249,priest,holy,30,15,15
Veni,kiljaeden,1249,priest,holy,35,16,19
Edessa,lothar,1248,priest,holy,150,68,82
Firewatcher,sisters-of-elune,1247,priest,holy,60,33,27
Steve,drakthul,1247,priest,holy,24,13,11
Oxynor,zuljin,1246,priest,holy,24,13,11
Wabie,illidan,1246,priest,holy,30,13,17
Robdàwg,illidan,1243,priest,holy,24,13,11
Zumnb,quelthalas,1243,priest,holy,134,61,73
Priestprease,malganis,1242,priest,holy,50,24,26
Cheereos,stormrage,1242,priest,holy,68,23,45
Bmouth,tichondrius,1241,priest,holy,24,13,11
Daisie,bleeding-hollow,1240,priest,holy,150,78,72
Manocloth,frostmourne,1239,priest,holy,25,15,10
Fearnfaith,zuljin,1239,priest,holy,36,13,23
Valiann,lightbringer,1238,priest,holy,24,13,11
Cléah,sargeras,1235,priest,holy,113,53,60
Altera,drakkari,1233,priest,holy,30,13,17
Ukizeal,moknathal,1232,priest,holy,175,85,90
Junatoh,area-52,1231,priest,holy,55,29,26
Healgirls,dalaran,1230,priest,holy,59,28,31
Ishtana,bleeding-hollow,1228,priest,holy,74,35,39
Etros,wyrmrest-accord,1226,priest,holy,175,82,93
Snoorklizzak,malganis,1225,priest,holy,24,13,11
Zerolimitzz,arthas,1225,priest,holy,54,25,29
Whitepigogo,tichondrius,1225,priest,holy,30,13,17
Celinsa,ragnaros,1223,priest,holy,36,18,18
Xarithea,caelestrasz,1222,priest,holy,41,19,22
Tïto,blackrock,1220,priest,holy,50,23,27
Frïsk,illidan,1219,priest,holy,64,30,34
Titô,frostmourne,1215,priest,holy,53,28,25
Bonsana,shadowsong,1213,priest,holy,72,40,32
Valkur,aegwynn,1213,priest,holy,230,109,121
Destïnÿ,zuljin,1213,priest,holy,51,24,27
Hamburgle,blackrock,1211,priest,holy,22,14,8
Lexiié,area-52,1211,priest,holy,79,41,38
Ísábella,ragnaros,1209,priest,holy,34,16,18
Floppytatas,illidan,1207,priest,holy,303,157,146
Salaknib,frostmourne,1206,priest,holy,40,17,23
Dóctóre,thrall,1205,priest,holy,61,24,37
Dumbthott,illidan,1203,priest,holy,28,13,15
Cusquena,caelestrasz,1201,priest,holy,72,34,38
Akö,jubeithos,1200,priest,holy,30,14,16
Vernis,nazjatar,1200,priest,holy,36,15,21
Danerÿ,ragnaros,1195,priest,holy,79,38,41
Qelient,proudmoore,1192,priest,holy,48,26,22
Mêgumin,area-52,1191,priest,holy,24,18,6
Theophobe,illidan,1190,priest,holy,85,45,40
Suzzanna,frostmourne,1189,priest,holy,65,37,28
Stennic,emerald-dream,1183,priest,holy,33,17,16
Dolandir,quelthalas,1181,priest,holy,30,18,12
Kazehanaa,ragnaros,1180,priest,holy,42,22,20
Flemyth,eitrigg,1180,priest,holy,40,16,24
Löstský,azralon,1176,priest,holy,61,32,29
Holynug,stormrage,1175,priest,holy,45,21,24
Pôê,blood-furnace,1171,priest,holy,24,13,11
Hälø,moon-guard,1170,priest,holy,42,20,22
Veane,tichondrius,1169,priest,holy,98,45,53
Bismund,chogall,1166,priest,holy,48,24,24
Haushauha,azralon,1164,priest,holy,48,23,25
Darkheals,azralon,1163,priest,holy,58,22,36
Aftercare,moon-guard,1157,priest,holy,72,27,45
Ranøth,deathwing,1155,priest,holy,74,31,43
Kälashnikova,ragnaros,1154,priest,holy,128,62,66
Tewiyakichkn,tichondrius,1152,priest,holy,24,12,12
Milkgulper,illidan,1152,priest,holy,24,12,12
Leonihpriest,nemesis,1151,priest,holy,30,12,18
Trompiscola,quelthalas,1151,priest,holy,30,12,18
Arguseonp,proudmoore,1150,priest,holy,24,12,12
Veltaxis,moon-guard,1148,priest,holy,209,97,112
Glöws,area-52,1148,priest,holy,30,12,18
Kasiry,ragnaros,1146,priest,holy,96,41,55
Pikachuwu,moon-guard,1145,priest,holy,29,21,8
Konãn,ragnaros,1145,priest,holy,18,12,6
Ôôöô,sargeras,1145,priest,holy,24,13,11
Selket,stormscale,1145,priest,holy,96,42,54
Xavios,alexstrasza,1144,priest,holy,24,12,12
Gronix,blood-furnace,1144,priest,holy,54,26,28
Urisaegin,senjin,1143,priest,holy,76,32,44
Fiction,kelthuzad,1142,priest,holy,18,13,5
Luxar,aegwynn,1141,priest,holy,18,12,6
Anemonie,gorefiend,1138,priest,holy,122,52,70
Voidthulhu,stormrage,1134,priest,holy,167,66,101
Akainuu,nazjatar,1130,priest,holy,91,35,56
Chaynal,proudmoore,1126,priest,holy,24,12,12
Tianqing,tichondrius,1126,priest,holy,34,12,22
Aprocalypse,malganis,1123,priest,holy,42,17,25
Dchi,tichondrius,1120,priest,holy,24,12,12
Dactylion,moon-guard,1119,priest,holy,24,12,12
Delthas,nagrand,1115,priest,holy,302,151,151
Zojhira,khazgoroth,1114,priest,holy,66,32,34
Carray,goldrinn,1113,priest,holy,49,16,33
Fayth,maiev,1111,priest,holy,65,36,29
Adjectives,nerzhul,1111,priest,holy,30,12,18
Atlana,gilneas,1107,priest,holy,24,16,8
Mailboxxy,kelthuzad,1107,priest,holy,42,18,24
Fallaner,destromath,1106,priest,holy,89,39,50
Divona,blackhand,1106,priest,holy,66,23,43
Tiestô,tichondrius,1102,priest,holy,23,12,11
Kytiana,blackwing-lair,1099,priest,holy,747,367,380
Nowwow,tichondrius,1097,priest,holy,50,23,27
Runalor,zuljin,1094,priest,holy,29,15,14
Healle,proudmoore,1093,priest,holy,29,12,17
Ascian,daggerspine,1091,priest,holy,24,13,11
Sanaconda,sargeras,1090,priest,holy,36,12,24
Whitelabel,proudmoore,1086,priest,holy,30,12,18
Rdvark,stormrage,1085,priest,holy,26,12,14
Sôlîånia,alterac-mountains,1081,priest,holy,39,27,12
Gewbrr,malganis,1073,priest,holy,24,12,12
Beckzz,illidan,1070,priest,holy,26,17,9
Mavuiss,barthilas,1069,priest,holy,25,12,13
Malacanter,stormrage,1069,priest,holy,49,19,30
Irar,tichondrius,1056,priest,holy,12,11,1
Ímhotep,sargeras,1055,priest,holy,18,11,7
Pesian,dalaran,1055,priest,holy,22,12,10
Sorrowful,mannoroth,1055,priest,holy,30,11,19
Iilmama,area-52,1054,priest,holy,18,11,7
Conifer,emerald-dream,1053,priest,holy,18,11,7
Chavvy,tichondrius,1053,priest,holy,18,11,7
Anathamaz,stormrage,1053,priest,holy,24,11,13
Saltypepper,thunderhorn,1052,priest,holy,30,14,16
Amynthel,tichondrius,1052,priest,holy,30,11,19
Alicia,nazjatar,1050,priest,holy,24,16,8
Jsky,wyrmrest-accord,1050,priest,holy,21,11,10
Karenpigbear,area-52,1050,priest,holy,243,107,136
Dotdotdead,earthen-ring,1049,priest,holy,18,11,7
Jol,aggramar,1049,priest,holy,30,13,17
Soulhealer,shadowmoon,1048,priest,holy,24,13,11
Webbii,frostmourne,1048,priest,holy,24,11,13
Paradoxbot,kelthuzad,1045,priest,holy,18,11,7
Dylirium,dathremar,1044,priest,holy,18,11,7
Masqdispel,barthilas,1044,priest,holy,89,41,48
Fadedvi,wyrmrest-accord,1042,priest,holy,45,21,24
Shadowowns,blackrock,1040,priest,holy,18,11,7
Titoj,tichondrius,1035,priest,holy,38,19,19
Zhideevskiy,trollbane,1033,priest,holy,42,20,22
Stayhealed,tichondrius,1033,priest,holy,48,22,26
Lieuwe,kelthuzad,1032,priest,holy,30,12,18
Seventeen,hyjal,1029,priest,holy,30,11,19
Celani,gilneas,1026,priest,holy,24,11,13
Ninbará,stormrage,1023,priest,holy,26,12,14
Krishpriest,azshara,1018,priest,holy,24,15,9
Yepidk,bleeding-hollow,1018,priest,holy,23,11,12
Fivestarz,malganis,1014,priest,holy,24,11,13
Pandamila,azralon,1004,priest,holy,19,11,8
Aldryth,lightbringer,1004,priest,holy,24,13,11
Zantara,lightbringer,1002,priest,holy,24,12,12
Artyòm,stormrage,1002,priest,holy,333,160,173
Skywritten,area-52,1001,priest,holy,23,11,12
Rienis,sargeras,1001,priest,holy,102,40,62
Maiyennefer,proudmoore,996,priest,holy,36,13,23
Sybenela,proudmoore,994,priest,holy,61,28,33
Souljourner,stormrage,993,priest,holy,95,46,49
Pottime,tichondrius,989,priest,holy,76,33,43
Friarbirkkal,arthas,988,priest,holy,41,25,16
Yinaiteen,drakkari,985,priest,holy,64,33,31
Cultofsins,tichondrius,982,priest,holy,23,11,12
Priesttess,skullcrusher,981,priest,holy,23,11,12
Holyfizzle,dethecus,972,priest,holy,60,33,27
Ragekiller,lothar,964,priest,holy,59,28,31
Eredwarraim,akama,964,priest,holy,48,21,27
Nïkkï,sargeras,960,priest,holy,18,10,8
Onion,garona,960,priest,holy,18,10,8
Adephene,illidan,960,priest,holy,18,10,8
Jameswarren,silvermoon,959,priest,holy,11,11,0
Bunbuns,spirestone,959,priest,holy,18,10,8
Trezz,hakkar,959,priest,holy,18,10,8
Naxray,quelthalas,959,priest,holy,18,10,8
Scarlèttè,wyrmrest-accord,959,priest,holy,24,11,13
Pèrona,tichondrius,959,priest,holy,24,10,14
Trickyhobo,area-52,958,priest,holy,12,10,2
Spx,frostmourne,958,priest,holy,18,10,8
Folate,frostmourne,957,priest,holy,18,10,8
Wockus,dalaran,956,priest,holy,18,10,8
Bugshott,tichondrius,956,priest,holy,32,10,22
Noobepriest,thrall,955,priest,holy,18,10,8
Priestybear,illidan,955,priest,holy,18,10,8
Cappoo,tichondrius,955,priest,holy,36,10,26
Xoraya,proudmoore,954,priest,holy,18,10,8
Rottigus,skullcrusher,951,priest,holy,18,10,8
Turkings,proudmoore,951,priest,holy,24,10,14
Tmturnt,tichondrius,946,priest,holy,16,10,6
Novous,area-52,944,priest,holy,30,10,20
Horimiya,silvermoon,943,priest,holy,23,11,12
Meibuff,frostmourne,937,priest,holy,100,43,57
Aszdriel,azralon,936,priest,holy,18,10,8
Taylorsmites,emerald-dream,931,priest,holy,42,18,24
Dipanddøts,area-52,926,priest,holy,17,10,7
Bienhechora,quelthalas,924,priest,holy,18,10,8
Zelaya,hellscream,919,priest,holy,45,17,28
Seråphim,sargeras,911,priest,holy,90,45,45
Aliorixa,stormrage,908,priest,holy,26,11,15
Pharmacee,korgath,903,priest,holy,138,52,86
Pibkac,stormrage,895,priest,holy,28,13,15
Boogiedo,area-52,894,priest,holy,17,10,7
Teheleopapi,quelthalas,877,priest,holy,75,19,56
Calence,aegwynn,865,priest,holy,40,10,30
Shwayp,zuljin,864,priest,holy,18,9,9
Rustymvpfan,nagrand,864,priest,holy,18,9,9
Holyxb,bleeding-hollow,863,priest,holy,18,9,9
Xtcbtc,sargeras,863,priest,holy,18,9,9
Haduth,area-52,863,priest,holy,18,9,9
Mhp,illidan,863,priest,holy,18,9,9
Xhadow,sargeras,863,priest,holy,18,9,9
Bootleg,crushridge,863,priest,holy,24,9,15
Epicnoobpwnr,sargeras,863,priest,holy,26,9,17
Staypressed,moon-guard,862,priest,holy,12,9,3
Mëïsoön,quelthalas,862,priest,holy,18,9,9
Tassadaraiur,tichondrius,862,priest,holy,18,9,9
Çummiñs,malganis,862,priest,holy,18,9,9
Leapofdoubt,zuljin,861,priest,holy,12,9,3
Ilurvyou,frostwolf,861,priest,holy,24,9,15
Design,frostmourne,860,priest,holy,14,9,5
Meowforheals,sargeras,859,priest,holy,18,9,9
Duonaiameng,illidan,859,priest,holy,18,9,9
Blaydun,elune,859,priest,holy,18,9,9
Faedre,smolderthorn,858,priest,holy,18,9,9
Swis,area-52,857,priest,holy,24,9,15
Dtbündertree,nordrassil,854,priest,holy,12,9,3
Shkeyia,stonemaul,852,priest,holy,30,9,21
Lohila,kiljaeden,850,priest,holy,27,11,16
Sondrak,doomhammer,843,priest,holy,59,25,34
Psïren,quelthalas,831,priest,holy,28,9,19
Conno,thunderlord,829,priest,holy,54,27,27
Bigmommyxo,whisperwind,811,priest,holy,36,10,26
Xpenance,ragnaros,809,priest,holy,31,10,21
Enzö,frostmourne,801,priest,holy,27,11,16
Dovoso,kargath,801,priest,holy,31,11,20
Híkarí,windrunner,796,priest,holy,14,9,5
Gbumy,tichondrius,784,priest,holy,13,9,4
Yikari,sargeras,783,priest,holy,11,9,2
Saceryito,quelthalas,770,priest,holy,13,9,4
Releknosleep,frostwolf,769,priest,holy,20,10,10
Sengmin,burning-blade,768,priest,holy,12,8,4
Powerwordsuc,malganis,768,priest,holy,12,8,4
Turnip,zuljin,768,priest,holy,12,8,4
Gudóngmáe,tichondrius,768,priest,holy,12,8,4
Voidzx,tichondrius,768,priest,holy,18,8,10
Becrixx,thunderlord,768,priest,holy,18,8,10
Ugotknocked,bleeding-hollow,768,priest,holy,18,8,10
Yanyo,skullcrusher,768,priest,holy,18,8,10
Superheals,nordrassil,767,priest,holy,12,8,4
Khalesî,ragnaros,767,priest,holy,12,8,4
Sunwarden,dalaran,767,priest,holy,12,8,4
Unhöly,norgannon,767,priest,holy,12,8,4
Pomdom,tichondrius,767,priest,holy,18,8,10
Imnewsorry,illidan,767,priest,holy,18,8,10
Prayzar,illidan,766,priest,holy,12,8,4
Raphan,stormrage,766,priest,holy,12,8,4
Ofmanyfaces,illidan,766,priest,holy,12,8,4
Diablomonk,warsong,766,priest,holy,24,8,16
Zeroo,maiev,765,priest,holy,12,8,4
Velyndra,icecrown,765,priest,holy,18,8,10
Manatea,moon-guard,765,priest,holy,18,8,10
Prayboy,aerie-peak,765,priest,holy,24,8,16
Olivinpain,malganis,765,priest,holy,30,8,22
Morticiá,blackrock,764,priest,holy,18,8,10
Lenlune,bloodscalp,763,priest,holy,18,8,10
Laj,proudmoore,763,priest,holy,30,8,22
Papergaruru,illidan,762,priest,holy,30,8,22
Uzakichan,arygos,760,priest,holy,30,8,22
Priestognic,azralon,759,priest,holy,16,9,7
Shadøwreaper,azralon,758,priest,holy,27,10,17
Powergoods,stormrage,750,priest,holy,12,8,4
Fäñcÿ,tichondrius,734,priest,holy,17,8,9
Whehaw,kelthuzad,732,priest,holy,23,8,15
Rylance,burning-blade,720,priest,holy,21,8,13
Leist,ragnaros,719,priest,holy,24,9,15
Saintfulsins,sargeras,716,priest,holy,15,8,7
Amunsu,stormrage,711,priest,holy,30,11,19
Messra,dathremar,707,priest,holy,30,8,22
Humz,ragnaros,703,priest,holy,14,8,6
Jâmïè,gurubashi,702,priest,holy,17,8,9
Glizzylizzyx,tichondrius,672,priest,holy,12,7,5
Qiahariya,emerald-dream,672,priest,holy,12,7,5
Privx,bleeding-hollow,672,priest,holy,12,7,5
Shadedlight,dalaran,672,priest,holy,12,7,5
Pgpriest,kelthuzad,672,priest,holy,12,7,5
Nwok,frostmourne,672,priest,holy,12,7,5
Deevious,barthilas,672,priest,holy,12,7,5
Hehehealyou,emerald-dream,672,priest,holy,12,7,5
Undevout,tichondrius,672,priest,holy,12,7,5
Teiam,skullcrusher,672,priest,holy,12,7,5
Pevis,thrall,672,priest,holy,12,7,5
Beliana,boulderfist,672,priest,holy,16,8,8
Nicksfury,stormrage,672,priest,holy,18,7,11
Selidri,proudmoore,672,priest,holy,18,7,11
Celestian,malganis,672,priest,holy,24,7,17
Suppòrt,stormrage,671,priest,holy,12,7,5
Jordandoesnt,tichondrius,671,priest,holy,12,7,5
Deidre,illidan,671,priest,holy,16,8,8
Braevera,wyrmrest-accord,671,priest,holy,18,7,11
Cataline,emerald-dream,671,priest,holy,18,7,11
Razakam,tichondrius,671,priest,holy,18,7,11
Compåctdisc,sargeras,671,priest,holy,21,7,14
Exlord,illidan,670,priest,holy,12,7,5
Dankpope,malganis,670,priest,holy,12,7,5
Mooneye,emerald-dream,670,priest,holy,12,7,5
Lndsynbritny,darkspear,670,priest,holy,18,7,11
Context,mannoroth,669,priest,holy,12,7,5
Arena,lothar,669,priest,holy,12,7,5
Skeyfyr,frostmourne,669,priest,holy,18,7,11
Dëâth,ghostlands,669,priest,holy,21,8,13
Sêtsunà,dalaran,668,priest,holy,48,7,41
Kisstina,tichondrius,667,priest,holy,24,7,17
Vichealer,firetree,660,priest,holy,12,7,5
Shadowchárm,bleeding-hollow,638,priest,holy,17,7,10
Kohengadol,sargeras,623,priest,holy,11,7,4
Yidra,illidan,623,priest,holy,17,7,10
ßöp,sargeras,620,priest,holy,11,7,4
Blackprez,dathremar,613,priest,holy,17,7,10
Punishing,illidan,606,priest,holy,16,7,9
Papadarkness,tichondrius,603,priest,holy,14,7,7
Sizuré,frostmourne,591,priest,holy,11,7,4
Ggwizkaboo,tichondrius,576,priest,holy,6,6,0
Hectorz,zuljin,576,priest,holy,6,6,0
Didntâsk,arthas,576,priest,holy,12,6,6
Unsubbedd,sargeras,576,priest,holy,12,6,6
Hysteria,dalaran,576,priest,holy,12,6,6
Egbius,proudmoore,576,priest,holy,12,6,6
Calissy,proudmoore,576,priest,holy,12,6,6
Shockterror,area-52,576,priest,holy,12,6,6
Benedictiion,tichondrius,576,priest,holy,12,6,6
Feverx,tichondrius,576,priest,holy,12,6,6
Muertabella,kiljaeden,576,priest,holy,12,6,6
Hairypenance,sargeras,576,priest,holy,12,6,6
Meifeilesi,tichondrius,576,priest,holy,12,6,6
Sìnz,area-52,576,priest,holy,12,6,6
Nonbinary,trollbane,576,priest,holy,12,6,6
Everest,barthilas,576,priest,holy,12,6,6
Kittler,illidan,576,priest,holy,12,6,6
Skylust,azralon,576,priest,holy,12,6,6
Archaellia,area-52,576,priest,holy,12,6,6
Jezebëll,nemesis,576,priest,holy,12,6,6
Neverbeen,tichondrius,576,priest,holy,12,6,6
Zraken,emerald-dream,576,priest,holy,12,6,6
Lyleth,lightnings-blade,576,priest,holy,12,6,6
Sigx,area-52,576,priest,holy,12,6,6
Linvial,moon-guard,576,priest,holy,12,6,6
Telarith,sargeras,576,priest,holy,12,6,6
Xhirra,quelthalas,576,priest,holy,18,6,12
Misatomori,tichondrius,576,priest,holy,18,6,12
Estaria,the-forgotten-coast,576,priest,holy,18,6,12
Gustáv,sargeras,576,priest,holy,18,6,12
Sätîvá,tichondrius,576,priest,holy,18,6,12
Fertalize,maiev,576,priest,holy,24,6,18
Mattkoster,mannoroth,575,priest,holy,12,6,6
Xue,whisperwind,575,priest,holy,12,6,6
Youngwavy,area-52,575,priest,holy,12,6,6
Handgina,frostmourne,575,priest,holy,12,6,6
Nevifell,area-52,575,priest,holy,13,6,7
Kephrek,eonar,575,priest,holy,18,6,12
Vøido,whisperwind,575,priest,holy,18,6,12
Grindr,ragnaros,575,priest,holy,18,6,12
Dundamer,shattered-hand,575,priest,holy,18,6,12
Därkness,azralon,575,priest,holy,18,6,12
Sacerdetiza,drakkari,574,priest,holy,12,6,6
Cassíopeía,blackhand,574,priest,holy,12,6,6
Laiya,nathrezim,574,priest,holy,15,6,9
Ruhaani,moon-guard,574,priest,holy,18,6,12
Muino,zuljin,573,priest,holy,18,6,12
Aeoliana,laughing-skull,572,priest,holy,12,6,6
Zual,hakkar,569,priest,holy,12,6,6
Altara,malygos,569,priest,holy,12,6,6
Sanntana,echo-isles,563,priest,holy,24,6,18
Postymalone,azgalor,561,priest,holy,18,6,12
Skalzi,thrall,559,priest,holy,11,6,5
París,mannoroth,559,priest,holy,17,6,11
Remixcandoit,malganis,559,priest,holy,18,6,12
Smellybox,area-52,558,priest,holy,19,7,12
Satíva,dark-iron,543,priest,holy,11,6,5
Eatsoupbro,tichondrius,543,priest,holy,17,6,11
Aladdinlol,tichondrius,528,priest,holy,9,7,2
Mips,saurfang,527,priest,holy,11,6,5
Thünderbird,area-52,526,priest,holy,9,7,2
Albina,kelthuzad,526,priest,holy,11,6,5
Canibumsmoke,illidan,522,priest,holy,15,7,8
Ftheman,tichondrius,521,priest,holy,23,7,16
Klassy,thrall,518,priest,holy,19,8,11
Jesaminealbe,quelthalas,516,priest,holy,21,7,14
Trupriest,alleria,511,priest,holy,8,6,2
Vandamnation,barthilas,511,priest,holy,14,6,8
Matiuca,stormrage,511,priest,holy,20,6,14
Helorren,nagrand,506,priest,holy,20,6,14
Yokoshukumeì,aerie-peak,495,priest,holy,14,6,8
Huxleypoo,boulderfist,480,priest,holy,6,5,1
Bigdám,sargeras,480,priest,holy,6,5,1
Klttzz,sargeras,480,priest,holy,6,5,1
Jaaregis,area-52,480,priest,holy,6,5,1
Geartrixy,darkspear,480,priest,holy,6,5,1
Kethseth,ragnaros,480,priest,holy,6,5,1
Malpraktice,mugthol,480,priest,holy,6,5,1
Tarwow,alterac-mountains,480,priest,holy,6,5,1
Gurgs,emerald-dream,480,priest,holy,6,5,1
Serana,maelstrom,480,priest,holy,6,5,1
Toje,korgath,480,priest,holy,13,6,7
Nzkbr,frostmourne,480,priest,holy,12,5,7
Írithyll,sargeras,480,priest,holy,12,5,7
Bunnykinz,moon-guard,480,priest,holy,12,5,7
Gad,moon-guard,480,priest,holy,12,5,7
Timbobaloo,thrall,480,priest,holy,12,5,7
Mindgoblin,terokkar,480,priest,holy,12,5,7
Angelface,darkspear,480,priest,holy,12,5,7
Maelei,ragnaros,480,priest,holy,12,5,7
Buttercupx,vashj,480,priest,holy,12,5,7
Yevøn,ragnaros,480,priest,holy,12,5,7
Xeras,ravencrest,480,priest,holy,12,5,7
Blackoss,sargeras,480,priest,holy,12,5,7
Capriestsun,hydraxis,480,priest,holy,12,5,7
Vaíl,wyrmrest-accord,480,priest,holy,12,5,7
Secrèt,tichondrius,480,priest,holy,12,5,7
Meif,tichondrius,480,priest,holy,12,5,7
Shadowblazed,arthas,480,priest,holy,12,5,7
Meehx,illidan,480,priest,holy,12,5,7
Ratpriest,chogall,480,priest,holy,12,5,7
Anahka,tichondrius,480,priest,holy,12,5,7
Drkwispers,stormrage,480,priest,holy,12,5,7
Vaibye,dalaran,480,priest,holy,12,5,7
Anomoly,kiljaeden,480,priest,holy,12,5,7
Rysie,winterhoof,480,priest,holy,12,5,7
Benance,tichondrius,480,priest,holy,18,5,13
Holyharlot,sargeras,480,priest,holy,18,5,13
Chûrch,malganis,480,priest,holy,18,5,13
Halfsorrow,tichondrius,480,priest,holy,18,5,13
Dankenz,darkspear,480,priest,holy,18,5,13
Nancynibbler,bleeding-hollow,480,priest,holy,24,5,19
Freshblubear,blood-furnace,479,priest,holy,12,5,7
Pûrplehaze,aegwynn,479,priest,holy,12,5,7
Dayatthaspa,stormrage,479,priest,holy,12,5,7
Freezingmøøn,area-52,479,priest,holy,12,5,7
Threreye,sargeras,479,priest,holy,12,5,7
Miganmarkle,sargeras,479,priest,holy,12,5,7
Hottaters,tichondrius,479,priest,holy,18,5,13
Pactru,ragnaros,479,priest,holy,18,5,13
Unni,azralon,479,priest,holy,18,5,13
Mythica,gurubashi,479,priest,holy,18,5,13
Asuryani,lightbringer,477,priest,holy,12,5,7
Elusha,sargeras,447,priest,holy,8,6,2
Jeraphìm,tichondrius,447,priest,holy,18,9,9
Ráava,spirestone,415,priest,holy,8,5,3
Nolar,shadowmoon,415,priest,holy,11,5,6
Xusin,tichondrius,384,priest,holy,6,4,2
Cityboyy,tichondrius,384,priest,holy,6,4,2
Dookieate,destromath,384,priest,holy,6,4,2
Ticheals,tichondrius,384,priest,holy,6,4,2
Faukauf,zuljin,384,priest,holy,6,4,2
Halfdeath,sargeras,384,priest,holy,6,4,2
Chañing,frostmourne,384,priest,holy,6,4,2
Amorous,fizzcrank,384,priest,holy,6,4,2
Ænìma,tichondrius,384,priest,holy,6,4,2
Stromile,tichondrius,384,priest,holy,6,4,2
Patchyemoly,frostmourne,384,priest,holy,6,4,2
Chanyt,azralon,384,priest,holy,6,4,2
Farielle,blackwing-lair,384,priest,holy,6,4,2
Káldorei,proudmoore,384,priest,holy,6,4,2
Nomsayin,stormrage,384,priest,holy,6,4,2
Schátten,spirestone,384,priest,holy,6,4,2
Millép,frostmourne,384,priest,holy,6,4,2
Ghøstfaces,illidan,384,priest,holy,6,4,2
Khallmir,goldrinn,384,priest,holy,6,4,2
Yav,exodar,384,priest,holy,6,4,2
Arcmage,malganis,384,priest,holy,6,4,2
Hermanmiller,frostmourne,384,priest,holy,6,4,2
Unholywood,lightbringer,384,priest,holy,10,5,5
Yumä,kiljaeden,384,priest,holy,12,4,8
Darknuzs,sargeras,384,priest,holy,12,4,8
Ithardtoheal,sargeras,384,priest,holy,12,4,8
Depressednun,moon-guard,384,priest,holy,12,4,8
Spags,nagrand,384,priest,holy,12,4,8
Hazzang,tichondrius,384,priest,holy,12,4,8
Spshady,aegwynn,384,priest,holy,12,4,8
Karmapi,malganis,384,priest,holy,12,4,8
Shauyia,uther,384,priest,holy,12,4,8
Frozencherry,elune,384,priest,holy,12,4,8
Salyd,onyxia,384,priest,holy,12,4,8
Döyöuliftbro,tichondrius,384,priest,holy,12,4,8
Asatruu,stormrage,384,priest,holy,12,4,8
Voidrachet,thrall,384,priest,holy,12,4,8
Cheeseycake,illidan,384,priest,holy,12,4,8
Râven,proudmoore,384,priest,holy,12,4,8
Rachelstarrx,hyjal,384,priest,holy,12,4,8
Hoglet,moon-guard,384,priest,holy,12,4,8
Hoshx,sargeras,384,priest,holy,12,4,8
Carti,bleeding-hollow,384,priest,holy,12,4,8
Zapix,tichondrius,384,priest,holy,12,4,8
Sfr,frostmourne,384,priest,holy,12,4,8
Mellow,tichondrius,384,priest,holy,12,4,8
Rofrofmu,aegwynn,384,priest,holy,12,4,8
Aeøns,sargeras,384,priest,holy,18,4,14
Chambler,aegwynn,384,priest,holy,18,4,14
Pavle,laughing-skull,384,priest,holy,19,4,15
Fesix,akama,383,priest,holy,6,4,2
Hexy,bonechewer,383,priest,holy,9,4,5
Healia,tichondrius,383,priest,holy,12,4,8
Dyianah,wyrmrest-accord,383,priest,holy,12,4,8
Zeruhl,kiljaeden,382,priest,holy,12,4,8
Stradey,tichondrius,367,priest,holy,11,4,7
Brownsnooter,sargeras,367,priest,holy,11,4,7
Sharkda,frostmourne,350,priest,holy,17,4,13
Enzö,illidan,327,priest,holy,25,8,17
Rybbukk,wyrmrest-accord,319,priest,holy,11,4,7
Kabutta,stormrage,318,priest,holy,14,4,10
Ärchangél,tichondrius,288,priest,holy,6,3,3
Mucada,tichondrius,288,priest,holy,6,3,3
Franquitó,illidan,288,priest,holy,6,3,3
Pristik,malganis,288,priest,holy,6,3,3
Pridesp,tichondrius,288,priest,holy,6,3,3
Shredh,tichondrius,288,priest,holy,6,3,3
Glycol,illidan,288,priest,holy,6,3,3
Smalltoad,lightnings-blade,288,priest,holy,6,3,3
Discountay,burning-legion,288,priest,holy,6,3,3
Oohso,chogall,288,priest,holy,6,3,3
Ñÿx,arthas,288,priest,holy,6,3,3
Plánemo,azralon,288,priest,holy,6,3,3
Trying,ysera,288,priest,holy,6,3,3
Healdog,thrall,288,priest,holy,6,3,3
Purgeoften,sargeras,288,priest,holy,6,3,3
Crypthion,emerald-dream,288,priest,holy,6,3,3
Lullabya,tichondrius,288,priest,holy,6,3,3
Kustem,tichondrius,288,priest,holy,6,3,3
Orderic,ragnaros,288,priest,holy,6,3,3
Enkcoherent,tichondrius,288,priest,holy,6,3,3
Zombyrot,tichondrius,288,priest,holy,6,3,3
Elphié,sargeras,288,priest,holy,6,3,3
Clárity,ragnaros,288,priest,holy,6,3,3
Canswersp,sargeras,288,priest,holy,6,3,3
Deeznuhh,tichondrius,288,priest,holy,6,3,3
Bagoheals,area-52,288,priest,holy,6,3,3
Stinkiez,area-52,288,priest,holy,6,3,3
Zornor,drakkari,288,priest,holy,6,3,3
Meatguzzler,tichondrius,288,priest,holy,6,3,3
Tseirpyeroc,area-52,288,priest,holy,6,3,3
Alwaystry,tichondrius,288,priest,holy,6,3,3
Dunrirck,quelthalas,288,priest,holy,6,3,3
Vynlanesh,illidan,288,priest,holy,6,3,3
Calvisper,thunderlord,288,priest,holy,6,3,3
Imagees,stormscale,288,priest,holy,6,3,3
Barclan,destromath,288,priest,holy,6,3,3
Zesho,firetree,288,priest,holy,6,3,3
Whitezz,frostmourne,288,priest,holy,6,3,3
Manadeath,moon-guard,288,priest,holy,6,3,3
Aardyx,frostmourne,288,priest,holy,6,3,3
Wubbi,blackrock,288,priest,holy,6,3,3
Roseriela,moon-guard,288,priest,holy,6,3,3
Darkmoonsun,frostmourne,288,priest,holy,6,3,3
Rbmxp,barthilas,288,priest,holy,6,3,3
Clockwororan,tichondrius,288,priest,holy,6,3,3
Laurens,fenris,288,priest,holy,6,3,3
Foreva,lightbringer,288,priest,holy,6,3,3
Akeila,stormrage,288,priest,holy,6,3,3
Dividëd,stormrage,288,priest,holy,6,3,3
Greet,hyjal,288,priest,holy,6,3,3
Cessar,proudmoore,288,priest,holy,6,3,3
Sagapriest,hyjal,288,priest,holy,6,3,3
Whitewalls,moonrunner,288,priest,holy,6,3,3
Smiteyducks,stormrage,288,priest,holy,6,3,3
Palastiel,hyjal,288,priest,holy,6,3,3
Iamjakehill,area-52,288,priest,holy,9,4,5
Likelydapper,tichondrius,288,priest,holy,7,3,4
Irilde,proudmoore,288,priest,holy,12,3,9
Sarkozzlol,tichondrius,288,priest,holy,12,3,9
Lalight,tichondrius,288,priest,holy,12,3,9
Healiûm,bleeding-hollow,288,priest,holy,12,3,9
Jezuz,aerie-peak,288,priest,holy,12,3,9
Trolldaddy,burning-legion,288,priest,holy,12,3,9
Disperse,vashj,288,priest,holy,12,3,9
Zhadowbolts,thrall,288,priest,holy,12,3,9
Lifesvr,kiljaeden,288,priest,holy,12,3,9
Haedn,azralon,288,priest,holy,12,3,9
Pèngotnerfed,exodar,288,priest,holy,12,3,9
Jichu,blackrock,288,priest,holy,12,3,9
Hubbabubble,wyrmrest-accord,288,priest,holy,12,3,9
Øliverxp,lightbringer,288,priest,holy,12,3,9
Murderballad,tichondrius,288,priest,holy,12,3,9
Hòwen,tichondrius,288,priest,holy,12,3,9
Moc,jubeithos,288,priest,holy,12,3,9
Smitepie,malganis,288,priest,holy,12,3,9
Mushtakraken,mugthol,288,priest,holy,12,3,9
Fairylìght,stormrage,288,priest,holy,12,3,9
Holyvulpin,barthilas,288,priest,holy,15,3,12
Vyvanse,azuremyst,288,priest,holy,18,3,15
Pringlés,suramar,288,priest,holy,24,3,21
Fìngerbanger,lightnings-blade,287,priest,holy,6,3,3
Korhíl,ragnaros,287,priest,holy,6,3,3
Kïlljãh,kaelthas,287,priest,holy,12,3,9
Auradaluz,stormrage,287,priest,holy,12,3,9
Mloki,rivendare,285,priest,holy,12,3,9
Mikeliteo,blades-edge,283,priest,holy,18,3,15
Terripriest,sargeras,239,priest,holy,5,3,2
Titò,tichondrius,239,priest,holy,13,4,9
Gnepe,sargeras,234,priest,holy,7,4,3
Bofin,stormrage,234,priest,holy,16,4,12
Halö,doomhammer,223,priest,holy,14,3,11
Argotron,moon-guard,208,priest,holy,7,3,4
Damokek,tichondrius,192,priest,holy,9,3,6
Silentprayer,area-52,192,priest,holy,6,2,4
Invisibler,tichondrius,192,priest,holy,6,2,4
Jonhey,tichondrius,192,priest,holy,6,2,4
Nikci,tichondrius,192,priest,holy,6,2,4
Jakemies,arathor,192,priest,holy,6,2,4
Bilbopriest,illidan,192,priest,holy,6,2,4
Pandap,dalaran,192,priest,holy,6,2,4
Zetk,tichondrius,192,priest,holy,6,2,4
Voltstein,dalaran,192,priest,holy,6,2,4
Lilblackguys,stormrage,192,priest,holy,6,2,4
Dorraheals,tichondrius,192,priest,holy,6,2,4
Tuulipp,aegwynn,192,priest,holy,6,2,4
Sensitive,eitrigg,192,priest,holy,6,2,4
Kelfax,sargeras,192,priest,holy,6,2,4
Jilt,aerie-peak,192,priest,holy,6,2,4
Lebwonjamdi,tichondrius,192,priest,holy,6,2,4
Daddyhammer,area-52,192,priest,holy,6,2,4
Swipathefox,tichondrius,192,priest,holy,6,2,4
Mevix,firetree,192,priest,holy,6,2,4
Makeshiftz,zuljin,192,priest,holy,6,2,4
ßræcher,black-dragonflight,192,priest,holy,6,2,4
Mizriz,emerald-dream,192,priest,holy,6,2,4
Belfortx,tichondrius,192,priest,holy,6,2,4
Littlegnome,azralon,192,priest,holy,6,2,4
Starzard,kelthuzad,192,priest,holy,6,2,4
Ajonti,emerald-dream,192,priest,holy,6,2,4
Krazyapollo,tichondrius,192,priest,holy,6,2,4
Opas,rivendare,192,priest,holy,6,2,4
Verboden,kelthuzad,192,priest,holy,6,2,4
Schatzié,malganis,192,priest,holy,6,2,4
Speyside,medivh,192,priest,holy,6,2,4
Keicel,zuljin,192,priest,holy,6,2,4
Aiss,malganis,192,priest,holy,6,2,4
Xarid,moon-guard,192,priest,holy,6,2,4
Mommyafk,moon-guard,192,priest,holy,6,2,4
Chernota,kiljaeden,192,priest,holy,6,2,4
Skeemask,moon-guard,192,priest,holy,6,2,4
Mutedox,frostmourne,192,priest,holy,6,2,4
Wagnerr,jubeithos,192,priest,holy,6,2,4
Mendx,tichondrius,192,priest,holy,6,2,4
Mitras,moon-guard,192,priest,holy,6,2,4
Felmnir,ragnaros,192,priest,holy,6,2,4
Dentwo,aggramar,192,priest,holy,6,2,4
Arodar,wyrmrest-accord,192,priest,holy,6,2,4
Aethriem,bleeding-hollow,192,priest,holy,6,2,4
Dëëdëëpants,moon-guard,192,priest,holy,6,2,4
Hypodontia,caelestrasz,192,priest,holy,6,2,4
Eblis,the-underbog,192,priest,holy,6,2,4
Saenax,area-52,192,priest,holy,6,2,4
Igotubrah,malganis,192,priest,holy,6,2,4
Gusho,frostmourne,192,priest,holy,6,2,4
Hansa,ragnaros,192,priest,holy,6,2,4
Nodorme,quelthalas,192,priest,holy,6,2,4
Niftÿ,tichondrius,192,priest,holy,6,2,4
Drippyjoones,sargeras,192,priest,holy,6,2,4
Xhaajyh,area-52,192,priest,holy,6,2,4
Janisce,ragnaros,192,priest,holy,6,2,4
Rootai,quelthalas,192,priest,holy,6,2,4
Prescella,sargeras,192,priest,holy,6,2,4
Gles,quelthalas,192,priest,holy,6,2,4
Ôp,sargeras,192,priest,holy,6,2,4
Mamabless,quelthalas,192,priest,holy,6,2,4
Shemhazai,ragnaros,192,priest,holy,6,2,4
Saintguard,tichondrius,192,priest,holy,11,3,8
Langyi,tichondrius,192,priest,holy,10,2,8
Althir,ragnaros,192,priest,holy,12,2,10
Pinoculus,illidan,192,priest,holy,12,2,10
Dawnwind,warsong,192,priest,holy,12,2,10
Excellency,tichondrius,192,priest,holy,12,2,10
Okitoki,tichondrius,192,priest,holy,12,2,10
Lunay,tichondrius,192,priest,holy,12,2,10
Berrymuffin,moon-guard,192,priest,holy,12,2,10
Nevertelsp,malganis,192,priest,holy,12,2,10
Fraggydaddy,frostmourne,192,priest,holy,12,2,10
Påticus,area-52,192,priest,holy,13,2,11
Gillís,thrall,192,priest,holy,18,2,16
Baroux,drakkari,191,priest,holy,6,2,4
Purplepills,skullcrusher,159,priest,holy,5,2,3
Sneaks,frostmourne,159,priest,holy,5,2,3
Identìty,moon-guard,138,priest,holy,8,3,5
Sweetvoyeur,stormrage,138,priest,holy,9,3,6
Pestee,quelthalas,138,priest,holy,9,3,6
Pumpss,area-52,138,priest,holy,11,3,8
Bigvuqoffdam,area-52,138,priest,holy,16,3,13
Denarel,frostmourne,137,priest,holy,17,4,13
Iilmommy,area-52,112,priest,holy,4,3,1
Pasmalade,zuljin,112,priest,holy,7,2,5
Luciellis,sargeras,96,priest,holy,6,1,5
Alvorr,ragnaros,96,priest,holy,6,1,5
Lasaldra,quelthalas,96,priest,holy,6,1,5
Criticaal,aegwynn,96,priest,holy,6,1,5
Missjules,illidan,96,priest,holy,6,1,5
Mepisth,sargeras,96,priest,holy,6,1,5
Minamy,tichondrius,96,priest,holy,6,1,5
Dontgome,proudmoore,96,priest,holy,6,1,5
Bofuri,barthilas,96,priest,holy,6,1,5
Bloodcure,ysera,96,priest,holy,6,1,5
Yungmazikeen,proudmoore,96,priest,holy,6,1,5
Alaskaa,moon-guard,96,priest,holy,6,1,5
Faithmelter,stormrage,96,priest,holy,6,1,5
Tuuros,wyrmrest-accord,96,priest,holy,6,1,5
Sukmysplooge,queldorei,96,priest,holy,6,1,5
Sarïya,moon-guard,96,priest,holy,6,1,5
Kastwalker,earthen-ring,96,priest,holy,6,1,5
Liph,frostmourne,96,priest,holy,6,1,5
Yungsherm,tichondrius,96,priest,holy,6,1,5
Chrystella,nagrand,96,priest,holy,6,1,5
Lilpaprika,sargeras,96,priest,holy,6,1,5
Tammyone,emerald-dream,96,priest,holy,6,1,5
Makenaide,nemesis,96,priest,holy,6,1,5
Asmødeus,bleeding-hollow,96,priest,holy,6,1,5
Majjic,proudmoore,96,priest,holy,6,1,5
Voodooloa,tichondrius,96,priest,holy,6,1,5
Hiroshikun,azshara,96,priest,holy,6,1,5
Dietcokee,stormrage,96,priest,holy,6,1,5
Gamepastors,illidan,96,priest,holy,6,1,5
Novoul,stormrage,96,priest,holy,6,1,5
Thorzan,eredar,96,priest,holy,6,1,5
Viehweg,azralon,96,priest,holy,6,1,5
Janova,tichondrius,96,priest,holy,6,1,5
Dayquills,illidan,96,priest,holy,6,1,5
Angelicduck,illidan,96,priest,holy,6,1,5
Shadyvoodoo,barthilas,96,priest,holy,6,1,5
Olassi,stormrage,96,priest,holy,6,1,5
Lerien,thrall,96,priest,holy,6,1,5
Akami,tichondrius,96,priest,holy,6,1,5
Rakel,nathrezim,96,priest,holy,6,1,5
Deryus,dalaran,96,priest,holy,6,1,5
Tichealstwo,tichondrius,96,priest,holy,6,1,5
Thotsteal,lightbringer,96,priest,holy,6,1,5
Milkymana,tichondrius,96,priest,holy,6,1,5
Alëssana,illidan,96,priest,holy,6,1,5
Burtier,zuljin,96,priest,holy,6,1,5
Bigboyadam,frostmourne,96,priest,holy,6,1,5
Burpees,dalaran,96,priest,holy,6,1,5
Bunked,bleeding-hollow,96,priest,holy,6,1,5
Kagura,dunemaul,96,priest,holy,6,1,5
Grasy,ragnaros,96,priest,holy,6,1,5
Acpriest,tichondrius,96,priest,holy,12,1,11
Hüde,stormrage,96,priest,holy,12,1,11
Djriest,sargeras,96,priest,holy,12,1,11
Barryp,wyrmrest-accord,96,priest,holy,12,1,11
Gutrose,area-52,96,priest,holy,12,1,11
Donmartin,tichondrius,96,priest,holy,12,1,11
Wiralyn,nathrezim,79,priest,holy,11,1,10
Aeroalisson,azralon,42,priest,holy,6,2,4
Tmyunggravy,sargeras,42,priest,holy,8,2,6
Xinpingole,azralon,42,priest,holy,9,2,7
Shazdo,illidan,2300,priest,discipline,84,56,28
Undrcvr,sargeras,2273,priest,discipline,132,73,59
Èfflux,sargeras,2257,priest,discipline,103,61,42
Whammiez,tichondrius,2243,priest,discipline,84,50,34
Gentlewoman,ragnaros,2236,priest,discipline,93,56,37
Strickmaney,nathrezim,2202,priest,discipline,317,169,148
Proxs,sargeras,2184,priest,discipline,258,137,121
Reedyjrrtv,tichondrius,2181,priest,discipline,191,101,90
Pesian,dalaran,2153,priest,discipline,233,121,112
Cinnamontage,illidan,2142,priest,discipline,114,64,50
Castsmite,tichondrius,2141,priest,discipline,99,52,47
Søryn,madoran,2134,priest,discipline,114,60,54
Shikinomi,illidan,2133,priest,discipline,78,46,32
Reecepack,moon-guard,2126,priest,discipline,89,49,40
Wcnmb,blackrock,2123,priest,discipline,72,46,26
Jiangfeng,tichondrius,2120,priest,discipline,72,37,35
Devinere,tichondrius,2119,priest,discipline,580,317,263
Celestiah,kelthuzad,2119,priest,discipline,72,37,35
Zxxkawaii,tichondrius,2118,priest,discipline,169,90,79
Rukiyou,frostwolf,2117,priest,discipline,210,105,105
Baldzx,sargeras,2116,priest,discipline,292,160,132
Idkmyname,proudmoore,2115,priest,discipline,76,40,36
Yefri,ravencrest,2114,priest,discipline,295,166,129
Nusrah,tichondrius,2114,priest,discipline,87,45,42
Twocrshort,area-52,2112,priest,discipline,185,110,75
Frksake,area-52,2111,priest,discipline,192,114,78
Sylvphrena,stormrage,2111,priest,discipline,78,42,36
Kkelly,stormrage,2111,priest,discipline,262,134,128
Lemonmint,tichondrius,2109,priest,discipline,202,104,98
Klydasoreass,malganis,2107,priest,discipline,83,47,36
Kovulol,area-52,2107,priest,discipline,126,67,59
Néylo,illidan,2106,priest,discipline,112,56,56
Psyches,dalaran,2106,priest,discipline,109,50,59
Amberturd,cenarius,2103,priest,discipline,102,48,54
Woolp,frostmourne,2102,priest,discipline,100,58,42
Changwongpk,kelthuzad,2101,priest,discipline,237,124,113
Veivei,tichondrius,2095,priest,discipline,59,38,21
Cavityx,illidan,2094,priest,discipline,82,45,37
Ante,stonemaul,2075,priest,discipline,108,59,49
Instoway,illidan,2071,priest,discipline,174,103,71
Pancakeboi,tichondrius,2070,priest,discipline,131,64,67
Mauvex,stormrage,2067,priest,discipline,643,315,328
Blessxo,ragnaros,2063,priest,discipline,120,59,61
Cosmicyiff,area-52,2062,priest,discipline,212,115,97
Natoshi,illidan,2055,priest,discipline,66,40,26
Classmaster,stormrage,2054,priest,discipline,183,100,83
Soupbean,zuljin,2046,priest,discipline,90,45,45
Esqueue,illidan,2044,priest,discipline,54,26,28
Hairyleg,kelthuzad,2042,priest,discipline,96,43,53
Veiveilol,tichondrius,2038,priest,discipline,89,42,47
Wheresmyvape,tichondrius,2034,priest,discipline,73,42,31
Clearclouds,tichondrius,2025,priest,discipline,332,176,156
Astroverse,tichondrius,2024,priest,discipline,118,67,51
Crutched,blackhand,2022,priest,discipline,60,35,25
Bholebender,tichondrius,2022,priest,discipline,101,50,51
Zámmy,area-52,2021,priest,discipline,65,44,21
Houseaddict,illidan,2019,priest,discipline,115,63,52
Praemal,tichondrius,2017,priest,discipline,102,47,55
Crabsp,illidan,2013,priest,discipline,150,78,72
Namilol,tichondrius,2011,priest,discipline,78,45,33
Adûnaic,frostmourne,2011,priest,discipline,463,232,231
Rmpmeeper,kilrogg,2008,priest,discipline,132,72,60
Stinkiez,area-52,2006,priest,discipline,255,141,114
Sinthe,stormrage,2006,priest,discipline,95,50,45
Jiangfenglol,tichondrius,2006,priest,discipline,156,74,82
Reilacoste,moon-guard,2002,priest,discipline,83,41,42
Nucypher,illidan,2000,priest,discipline,216,124,92
Sodezz,stormrage,2000,priest,discipline,90,50,40
Poporeborn,tichondrius,1995,priest,discipline,277,138,139
Fannyny,tichondrius,1991,priest,discipline,208,120,88
Néy,illidan,1990,priest,discipline,84,58,26
Boykoz,zuljin,1990,priest,discipline,163,84,79
Syllè,area-52,1988,priest,discipline,78,40,38
Jakemies,arathor,1983,priest,discipline,96,52,44
Crutch,blackhand,1980,priest,discipline,54,30,24
Etharass,illidan,1976,priest,discipline,84,36,48
Dayx,malganis,1975,priest,discipline,108,54,54
Hugemilkys,tichondrius,1974,priest,discipline,164,95,69
Solecíto,ragnaros,1974,priest,discipline,237,136,101
Fhenomenal,tichondrius,1972,priest,discipline,126,57,69
Jtheals,illidan,1971,priest,discipline,59,29,30
Xajen,illidan,1971,priest,discipline,102,46,56
Cklifer,tichondrius,1970,priest,discipline,58,33,25
Azzäm,tichondrius,1970,priest,discipline,90,48,42
Artíst,sargeras,1969,priest,discipline,149,81,68
Deathblind,kelthuzad,1968,priest,discipline,101,52,49
Goodlife,frostmourne,1967,priest,discipline,71,34,37
Robdàwg,illidan,1966,priest,discipline,78,39,39
Penanceperry,bleeding-hollow,1966,priest,discipline,322,156,166
Kayern,kelthuzad,1965,priest,discipline,58,38,20
Muhfinx,tichondrius,1965,priest,discipline,71,41,30
Peruggia,tichondrius,1965,priest,discipline,157,79,78
Eluneslight,tichondrius,1963,priest,discipline,120,59,61
Loopzw,tichondrius,1962,priest,discipline,72,38,34
Jthealz,tichondrius,1962,priest,discipline,72,36,36
Aratis,bleeding-hollow,1961,priest,discipline,90,44,46
Sÿnpriest,illidan,1960,priest,discipline,432,210,222
Neverbeen,tichondrius,1958,priest,discipline,1075,567,508
Ilovemia,zuljin,1957,priest,discipline,80,46,34
Degenerates,blood-furnace,1956,priest,discipline,84,42,42
Hospetal,tichondrius,1955,priest,discipline,146,74,72
Ogneus,crushridge,1955,priest,discipline,75,35,40
Awàken,sargeras,1952,priest,discipline,57,35,22
Invincible,ragnaros,1952,priest,discipline,112,60,52
Didy,dark-iron,1952,priest,discipline,154,79,75
Sonicboomsz,azralon,1952,priest,discipline,128,64,64
Allhubris,stormrage,1951,priest,discipline,54,31,23
Amine,tichondrius,1950,priest,discipline,138,71,67
Iilmama,area-52,1948,priest,discipline,105,55,50
Nerfthedoc,blackrock,1946,priest,discipline,85,48,37
Miamama,hydraxis,1946,priest,discipline,177,94,83
Stepxo,sargeras,1942,priest,discipline,183,96,87
Gosharbg,tichondrius,1940,priest,discipline,34,24,10
Budings,tichondrius,1938,priest,discipline,149,81,68
Sarkozzlol,tichondrius,1938,priest,discipline,84,43,41
Markers,spinebreaker,1938,priest,discipline,142,68,74
Mimz,trollbane,1936,priest,discipline,178,91,87
Curachon,darkspear,1936,priest,discipline,129,59,70
Supaflute,tichondrius,1935,priest,discipline,102,47,55
Evicereith,ragnaros,1933,priest,discipline,60,33,27
Highskrizzle,thrall,1932,priest,discipline,79,43,36
Plaedo,stormscale,1932,priest,discipline,52,28,24
Fádé,illidan,1932,priest,discipline,97,48,49
Bnn,arathor,1930,priest,discipline,35,26,9
Darkvss,illidan,1929,priest,discipline,72,39,33
Donmartin,tichondrius,1929,priest,discipline,94,50,44
Kalyndaxo,frostmourne,1928,priest,discipline,108,54,54
Velftrixi,sargeras,1927,priest,discipline,180,94,86
Hectorz,zuljin,1925,priest,discipline,136,62,74
Ccgo,tichondrius,1924,priest,discipline,142,72,70
Alisas,malganis,1924,priest,discipline,190,90,100
Balsak,zuljin,1924,priest,discipline,152,72,80
Antts,tichondrius,1922,priest,discipline,60,39,21
Layons,nemesis,1922,priest,discipline,182,114,68
Lovelike,tichondrius,1922,priest,discipline,74,41,33
Duw,icecrown,1922,priest,discipline,187,95,92
Walterwhite,bleeding-hollow,1920,priest,discipline,54,25,29
Qipriest,tichondrius,1919,priest,discipline,102,46,56
Vinnydiesel,tichondrius,1918,priest,discipline,66,32,34
Likethis,ragnaros,1916,priest,discipline,484,246,238
Fotmvark,stormrage,1916,priest,discipline,78,36,42
Leorid,stormrage,1915,priest,discipline,208,100,108
Praeyer,area-52,1914,priest,discipline,422,212,210
Yeeseafood,tichondrius,1913,priest,discipline,76,34,42
Anasuzana,stormrage,1911,priest,discipline,66,38,28
Rawze,tichondrius,1911,priest,discipline,93,44,49
Varenon,stormrage,1910,priest,discipline,159,90,69
Tinyheal,sargeras,1910,priest,discipline,202,109,93
Bearfriend,malorne,1910,priest,discipline,58,30,28
Shallwedance,tichondrius,1906,priest,discipline,86,50,36
Fallspriest,frostmourne,1905,priest,discipline,48,31,17
Omhz,tichondrius,1905,priest,discipline,96,49,47
Cosenzza,tichondrius,1905,priest,discipline,78,37,41
Ohsop,chogall,1904,priest,discipline,116,70,46
Mumrah,antonidas,1904,priest,discipline,178,88,90
Sabalonely,tichondrius,1904,priest,discipline,54,24,30
Reydehaiti,ragnaros,1903,priest,discipline,253,126,127
Dairy,the-underbog,1902,priest,discipline,61,37,24
June,dragonmaw,1899,priest,discipline,72,36,36
Fotmtrash,the-underbog,1897,priest,discipline,48,26,22
Praitne,tichondrius,1897,priest,discipline,119,59,60
Riseandshine,illidan,1896,priest,discipline,54,38,16
Testzpriests,dalaran,1896,priest,discipline,60,34,26
Pølupoker,illidan,1895,priest,discipline,59,27,32
Amãnita,illidan,1894,priest,discipline,65,29,36
Quaree,stormrage,1893,priest,discipline,809,416,393
Boriz,frostmourne,1892,priest,discipline,79,44,35
Høwtokill,azralon,1892,priest,discipline,215,98,117
Noted,aegwynn,1890,priest,discipline,212,126,86
Zerorizz,tichondrius,1890,priest,discipline,42,20,22
Ndzy,malganis,1890,priest,discipline,48,21,27
Aitri,hakkar,1889,priest,discipline,211,102,109
Niniua,tichondrius,1887,priest,discipline,47,25,22
Wapriest,blades-edge,1887,priest,discipline,677,339,338
Notatk,tichondrius,1887,priest,discipline,227,103,124
Eudog,zuljin,1886,priest,discipline,24,20,4
Athênå,tichondrius,1886,priest,discipline,192,110,82
Haunting,nerzhul,1886,priest,discipline,209,103,106
Discopenguin,kelthuzad,1885,priest,discipline,60,34,26
Frostinal,illidan,1884,priest,discipline,268,141,127
Usefirstaid,sargeras,1883,priest,discipline,42,26,16
Easywins,sargeras,1883,priest,discipline,42,25,17
Grimacê,sargeras,1883,priest,discipline,122,62,60
Cupitan,tichondrius,1883,priest,discipline,62,27,35
Abt,proudmoore,1882,priest,discipline,66,31,35
Usedwrap,sargeras,1881,priest,discipline,78,43,35
Saviorlol,tichondrius,1881,priest,discipline,77,38,39
Throatgoated,moon-guard,1881,priest,discipline,47,21,26
Rubymisfit,sargeras,1881,priest,discipline,84,37,47
Mackulate,tichondrius,1880,priest,discipline,83,44,39
Bswagxx,illidan,1878,priest,discipline,42,27,15
Meloxicamm,tichondrius,1877,priest,discipline,239,122,117
Jangbi,tichondrius,1877,priest,discipline,76,33,43
Breakmoon,tichondrius,1876,priest,discipline,78,33,45
Chee,bleeding-hollow,1875,priest,discipline,72,39,33
Sñ,illidan,1874,priest,discipline,48,27,21
Astroluma,illidan,1874,priest,discipline,154,86,68
Drnn,thrall,1874,priest,discipline,186,96,90
Kfcchicken,proudmoore,1874,priest,discipline,84,39,45
Kebab,tichondrius,1873,priest,discipline,42,25,17
Rileymcgerr,tichondrius,1873,priest,discipline,42,24,18
Tarlex,illidan,1873,priest,discipline,192,108,84
Fordranger,frostmourne,1873,priest,discipline,64,32,32
Redonkulos,wyrmrest-accord,1873,priest,discipline,210,102,108
Dellaptop,sargeras,1871,priest,discipline,88,51,37
Capcana,tichondrius,1871,priest,discipline,140,74,66
Discflips,dalaran,1871,priest,discipline,287,148,139
Hadoka,ragnaros,1871,priest,discipline,66,29,37
Cokeheals,kelthuzad,1869,priest,discipline,60,31,29
Renfury,bleeding-hollow,1869,priest,discipline,54,25,29
Montagehey,illidan,1868,priest,discipline,83,43,40
Thaldrum,tichondrius,1868,priest,discipline,103,45,58
Candyshack,area-52,1867,priest,discipline,117,66,51
Lidoradra,zuljin,1867,priest,discipline,77,36,41
Summersetisl,tichondrius,1867,priest,discipline,78,35,43
Bkwhopper,emerald-dream,1866,priest,discipline,239,130,109
Xtcbtc,sargeras,1865,priest,discipline,99,50,49
Tiestô,tichondrius,1864,priest,discipline,48,29,19
Pitayakiller,tichondrius,1864,priest,discipline,59,32,27
Angelforcez,frostmourne,1863,priest,discipline,62,26,36
Shugelol,tichondrius,1862,priest,discipline,30,21,9
Cursèlol,tichondrius,1862,priest,discipline,112,61,51
Spoõks,darkspear,1862,priest,discipline,141,69,72
Dannycarrier,tichondrius,1861,priest,discipline,48,27,21
Tormybew,illidan,1861,priest,discipline,53,29,24
Cokeheals,tichondrius,1861,priest,discipline,60,29,31
Bamboon,tanaris,1860,priest,discipline,168,90,78
Cremona,tichondrius,1860,priest,discipline,96,45,51
Bubblekanush,tichondrius,1859,priest,discipline,36,22,14
Thefiveoh,malganis,1858,priest,discipline,62,38,24
Melshiesty,stormrage,1858,priest,discipline,65,32,33
Usebindwound,sargeras,1857,priest,discipline,108,65,43
Mautmaut,quelthalas,1856,priest,discipline,83,56,27
Ravnica,kelthuzad,1856,priest,discipline,82,43,39
Presence,blood-furnace,1855,priest,discipline,42,23,19
Vànhendrix,tichondrius,1855,priest,discipline,59,32,27
Shadey,onyxia,1855,priest,discipline,54,26,28
Nayzoh,darkspear,1855,priest,discipline,78,37,41
Vidzar,area-52,1854,priest,discipline,42,28,14
Drsquiddy,tichondrius,1854,priest,discipline,47,30,17
Stayspooked,moon-guard,1852,priest,discipline,54,31,23
Yaksa,proudmoore,1852,priest,discipline,78,35,43
Mancito,mannoroth,1851,priest,discipline,267,137,130
Centalinkxo,frostmourne,1851,priest,discipline,72,36,36
ßeyonder,tichondrius,1851,priest,discipline,152,71,81
Curney,stormrage,1850,priest,discipline,71,51,20
Shieldspamx,tichondrius,1850,priest,discipline,89,41,48
Whiterhino,spirestone,1849,priest,discipline,67,32,35
Corvenna,zuljin,1848,priest,discipline,60,33,27
Tekneeq,barthilas,1848,priest,discipline,214,115,99
Polarnight,zuljin,1848,priest,discipline,59,29,30
Paidtowin,frostmourne,1848,priest,discipline,68,30,38
Chiot,tichondrius,1847,priest,discipline,71,55,16
Nickzx,tichondrius,1847,priest,discipline,88,60,28
Bigshieldlol,illidan,1847,priest,discipline,60,39,21
Buhroketwo,thrall,1847,priest,discipline,84,52,32
Chromielol,tichondrius,1847,priest,discipline,54,31,23
Tzïñåçåñ,tichondrius,1847,priest,discipline,54,29,25
Voidnoodles,area-52,1846,priest,discipline,60,32,28
Ultradumb,ragnaros,1846,priest,discipline,42,21,21
Jmjeezy,tichondrius,1846,priest,discipline,48,22,26
Rylla,illidan,1845,priest,discipline,72,38,34
Leonilcx,tichondrius,1845,priest,discipline,902,456,446
Koalakazamzy,shadow-council,1845,priest,discipline,58,29,29
Gotdro,kelthuzad,1845,priest,discipline,80,39,41
Quèénstar,tichondrius,1845,priest,discipline,85,35,50
Fancydisc,barthilas,1843,priest,discipline,42,26,16
Troja,malganis,1843,priest,discipline,78,43,35
Pregnantmale,area-52,1843,priest,discipline,262,136,126
Steelcity,tichondrius,1843,priest,discipline,54,28,26
Dacine,illidan,1843,priest,discipline,60,30,30
Xiaoqunzi,tichondrius,1843,priest,discipline,239,115,124
Bubbliez,frostmourne,1843,priest,discipline,59,28,31
Flamboyant,sisters-of-elune,1843,priest,discipline,66,31,35
Anyra,stormrage,1842,priest,discipline,57,29,28
Zelená,trollbane,1841,priest,discipline,128,77,51
Yezhua,zuljin,1841,priest,discipline,95,51,44
Vampirê,tichondrius,1841,priest,discipline,66,35,31
Smokezter,area-52,1841,priest,discipline,177,85,92
Lexiahp,frostmourne,1841,priest,discipline,73,35,38
Kck,sentinels,1841,priest,discipline,95,44,51
Meoveryou,stormrage,1840,priest,discipline,92,50,42
Syliva,frostmourne,1840,priest,discipline,65,30,35
Donutpriest,kelthuzad,1839,priest,discipline,78,44,34
Koalakazamza,shadow-council,1839,priest,discipline,62,28,34
Katalad,wyrmrest-accord,1838,priest,discipline,66,40,26
Furydos,zuljin,1838,priest,discipline,48,26,22
Tistapriest,proudmoore,1837,priest,discipline,70,41,29
Waggers,moon-guard,1837,priest,discipline,42,23,19
Lotion,icecrown,1837,priest,discipline,48,25,23
Tmversace,tichondrius,1837,priest,discipline,123,64,59
Chk,moon-guard,1837,priest,discipline,148,72,76
Rayllyn,bleeding-hollow,1836,priest,discipline,30,22,8
Miraclesoul,tichondrius,1836,priest,discipline,38,26,12
Celestiah,illidan,1836,priest,discipline,60,30,30
Wpj,barthilas,1836,priest,discipline,93,41,52
Binipriest,tichondrius,1835,priest,discipline,67,40,27
Jamino,jubeithos,1835,priest,discipline,111,60,51
Tmeugene,tichondrius,1835,priest,discipline,40,21,19
Icychain,area-52,1835,priest,discipline,76,34,42
Bugweeb,sargeras,1834,priest,discipline,87,56,31
Twopiece,blackrock,1834,priest,discipline,54,31,23
Rÿzo,tichondrius,1834,priest,discipline,111,63,48
Thottsteal,queldorei,1834,priest,discipline,60,31,29
Rigxy,arthas,1833,priest,discipline,147,92,55
Hairypenance,sargeras,1833,priest,discipline,96,51,45
Joezyxz,tichondrius,1833,priest,discipline,222,116,106
Bearz,the-underbog,1833,priest,discipline,78,40,38
Ameliarys,sargeras,1833,priest,discipline,103,51,52
Rèvrin,sargeras,1833,priest,discipline,132,65,67
Jadon,sargeras,1832,priest,discipline,54,42,12
Sons,zuljin,1832,priest,discipline,54,29,25
Oloriinn,stormrage,1831,priest,discipline,36,24,12
Mastaspell,illidan,1831,priest,discipline,49,28,21
Shenanigans,illidan,1831,priest,discipline,44,24,20
Antagzy,bleeding-hollow,1830,priest,discipline,108,69,39
Ksâh,bleeding-hollow,1830,priest,discipline,87,55,32
Clockwororan,tichondrius,1830,priest,discipline,96,56,40
Yotinha,stormrage,1830,priest,discipline,48,28,20
Imissdave,dethecus,1830,priest,discipline,54,31,23
Pzx,zuljin,1830,priest,discipline,54,31,23
Obsolete,area-52,1830,priest,discipline,60,33,27
Abepriest,zuljin,1830,priest,discipline,283,138,145
Eyolo,tichondrius,1830,priest,discipline,162,78,84
Strvnge,malganis,1830,priest,discipline,60,28,32
Faeleath,emerald-dream,1830,priest,discipline,80,37,43
Veejae,tichondrius,1829,priest,discipline,54,29,25
Cpks,tichondrius,1828,priest,discipline,76,48,28
Baphomet,hyjal,1828,priest,discipline,88,53,35
Orderic,ragnaros,1828,priest,discipline,75,44,31
Misatomori,tichondrius,1828,priest,discipline,54,28,26
Tiernocookie,illidan,1828,priest,discipline,520,264,256
Falsity,kelthuzad,1828,priest,discipline,84,41,43
Epitoh,bleeding-hollow,1828,priest,discipline,78,36,42
Sleetherp,barthilas,1827,priest,discipline,64,37,27
Fishondabeat,proudmoore,1827,priest,discipline,42,23,19
Fracxured,sargeras,1827,priest,discipline,68,31,37
Bohomagz,tichondrius,1826,priest,discipline,42,24,18
Bloodyxx,bleeding-hollow,1825,priest,discipline,34,23,11
Buffle,zuluhed,1825,priest,discipline,66,38,28
Yokuz,thunderlord,1825,priest,discipline,48,26,22
Aprîl,quelthalas,1825,priest,discipline,72,37,35
Däzzlë,quelthalas,1825,priest,discipline,72,35,37
Pnsp,perenolde,1824,priest,discipline,42,30,12
Xholyshietz,emerald-dream,1824,priest,discipline,71,48,23
Pervysaged,sargeras,1824,priest,discipline,60,40,20
Mixful,bleeding-hollow,1824,priest,discipline,56,37,19
Archìtects,wyrmrest-accord,1824,priest,discipline,108,68,40
Cya,deathwing,1824,priest,discipline,54,30,24
Zygotes,tichondrius,1824,priest,discipline,39,21,18
Temérios,azralon,1824,priest,discipline,60,30,30
Aethestan,zuljin,1824,priest,discipline,102,50,52
Tuxen,wyrmrest-accord,1823,priest,discipline,48,29,19
Swurvexo,bleeding-hollow,1823,priest,discipline,47,28,19
Guiila,azralon,1823,priest,discipline,71,38,33
Barthol,malygos,1823,priest,discipline,225,115,110
Sprankels,bleeding-hollow,1823,priest,discipline,108,55,53
Luhkx,stormrage,1823,priest,discipline,54,25,29
Lands,ragnaros,1822,priest,discipline,120,69,51
Ggwizkaboo,tichondrius,1822,priest,discipline,60,30,30
Zachon,sargeras,1822,priest,discipline,54,27,27
Partypack,stormrage,1821,priest,discipline,55,32,23
Rerollpriest,firetree,1821,priest,discipline,53,25,28
Ultrà,ragnaros,1820,priest,discipline,71,44,27
Wreklol,tichondrius,1820,priest,discipline,60,34,26
Haduth,area-52,1820,priest,discipline,392,205,187
Dietcokee,stormrage,1820,priest,discipline,62,31,31
Ujelin,kiljaeden,1820,priest,discipline,48,24,24
Legendary,ragnaros,1820,priest,discipline,84,36,48
Tophr,illidan,1819,priest,discipline,41,24,17
Soojwa,frostmourne,1819,priest,discipline,54,24,30
Nanoboost,dark-iron,1818,priest,discipline,843,427,416
Claverr,stormrage,1818,priest,discipline,57,28,29
Novel,moon-guard,1817,priest,discipline,30,24,6
Despairx,tichondrius,1817,priest,discipline,102,66,36
Guerisser,hyjal,1817,priest,discipline,176,104,72
Gaudthree,tichondrius,1817,priest,discipline,46,25,21
Exdric,kiljaeden,1817,priest,discipline,108,51,57
Akuzaki,illidan,1817,priest,discipline,54,25,29
Sliktrik,area-52,1817,priest,discipline,65,29,36
Dapp,barthilas,1817,priest,discipline,77,33,44
Cynthus,dalvengyr,1816,priest,discipline,102,60,42
Lichtschreit,zuljin,1816,priest,discipline,41,24,17
Juicyturon,moon-guard,1816,priest,discipline,77,45,32
Dispassion,dalaran,1816,priest,discipline,58,33,25
Zulazane,azralon,1816,priest,discipline,378,207,171
Tryfekta,frostmourne,1816,priest,discipline,114,62,52
Woodowl,tichondrius,1816,priest,discipline,46,25,21
Kragenn,malganis,1816,priest,discipline,195,103,92
Jackski,nemesis,1816,priest,discipline,48,25,23
Hideonlight,barthilas,1816,priest,discipline,645,332,313
Diabloluckie,tichondrius,1816,priest,discipline,149,72,77
Mødilon,nemesis,1815,priest,discipline,47,29,18
Rythmzz,kiljaeden,1815,priest,discipline,108,59,49
Selenitax,sargeras,1815,priest,discipline,104,52,52
Badnsweaty,sargeras,1815,priest,discipline,76,38,38
Ousïa,quelthalas,1815,priest,discipline,164,81,83
Mommyafk,moon-guard,1815,priest,discipline,54,25,29
Myeryc,frostmourne,1815,priest,discipline,53,21,32
Diwara,ragnaros,1814,priest,discipline,60,37,23
Fullmetals,azralon,1814,priest,discipline,53,30,23
Memoriesorz,tichondrius,1814,priest,discipline,553,294,259
Zuwukey,kirin-tor,1814,priest,discipline,163,85,78
Tanmo,illidan,1814,priest,discipline,96,50,46
Nearo,barthilas,1814,priest,discipline,107,55,52
Moonstin,bleeding-hollow,1814,priest,discipline,83,38,45
Fibbre,tichondrius,1814,priest,discipline,121,54,67
Razdaz,twisting-nether,1814,priest,discipline,66,29,37
Relicx,firetree,1813,priest,discipline,54,33,21
Youhealme,area-52,1813,priest,discipline,90,54,36
Hoonjojjyang,tichondrius,1813,priest,discipline,66,37,29
Morboo,proudmoore,1813,priest,discipline,78,43,35
Svzy,illidan,1813,priest,discipline,48,26,22
Crypcanheal,sargeras,1813,priest,discipline,551,277,274
Sasha,muradin,1813,priest,discipline,142,70,72
Sixfourtank,tichondrius,1813,priest,discipline,53,26,27
Ahoy,sargeras,1812,priest,discipline,75,46,29
Wîlly,moon-guard,1812,priest,discipline,45,27,18
Abstention,area-52,1812,priest,discipline,66,35,31
Cardinaldave,frostmourne,1812,priest,discipline,54,28,26
Fatbellyx,sargeras,1812,priest,discipline,72,36,36
Snackermz,tichondrius,1812,priest,discipline,190,83,107
Iyoui,tichondrius,1811,priest,discipline,42,28,14
Tyrrshadow,skywall,1811,priest,discipline,104,58,46
Tallïa,stormrage,1811,priest,discipline,155,82,73
Louisé,hydraxis,1811,priest,discipline,90,46,44
Cellestine,aggramar,1811,priest,discipline,157,80,77
Leticia,magtheridon,1811,priest,discipline,189,96,93
Trengodqt,destromath,1810,priest,discipline,235,129,106
Pawnza,tichondrius,1810,priest,discipline,120,65,55
Thedude,spirestone,1810,priest,discipline,95,46,49
Arguseonp,proudmoore,1809,priest,discipline,54,37,17
Ãbelladanger,area-52,1809,priest,discipline,65,43,22
Jemine,tichondrius,1809,priest,discipline,108,64,44
Scrollozaddy,illidan,1809,priest,discipline,306,181,125
Thepumps,sargeras,1809,priest,discipline,73,43,30
Narakku,sargeras,1809,priest,discipline,113,62,51
Wübbie,emerald-dream,1809,priest,discipline,84,46,38
Paramour,laughing-skull,1809,priest,discipline,108,59,49
Drée,zuljin,1809,priest,discipline,62,32,30
Jaquels,area-52,1809,priest,discipline,130,65,65
Jaytee,aggramar,1809,priest,discipline,89,44,45
Cearáa,azralon,1809,priest,discipline,65,32,33
Paytin,illidan,1809,priest,discipline,119,57,62
Varbirttok,sargeras,1809,priest,discipline,61,29,32
Dabaojian,tichondrius,1809,priest,discipline,60,28,32
Aube,frostmourne,1809,priest,discipline,51,23,28
Nudithree,malganis,1808,priest,discipline,38,26,12
Bingleboi,area-52,1808,priest,discipline,405,224,181
Vbear,dunemaul,1808,priest,discipline,71,39,32
Shadowcakes,tichondrius,1808,priest,discipline,60,32,28
Pkkdestiny,archimonde,1808,priest,discipline,71,37,34
Catbabyorz,tichondrius,1808,priest,discipline,84,41,43
Pns,perenolde,1808,priest,discipline,66,32,34
Exøtic,tichondrius,1807,priest,discipline,60,38,22
Marcìano,bleeding-hollow,1807,priest,discipline,85,49,36
Dopeypriest,area-52,1807,priest,discipline,120,68,52
Nomsayin,stormrage,1806,priest,discipline,48,32,16
Gices,area-52,1806,priest,discipline,36,24,12
Ayakashi,frostmourne,1806,priest,discipline,75,46,29
Wormface,moon-guard,1806,priest,discipline,58,35,23
Senzy,tichondrius,1806,priest,discipline,150,81,69
Releriel,area-52,1806,priest,discipline,58,31,27
Ðiscipline,kelthuzad,1806,priest,discipline,253,134,119
Inthemix,stormreaver,1806,priest,discipline,376,197,179
Änanti,tichondrius,1806,priest,discipline,190,98,92
Danceslol,area-52,1806,priest,discipline,59,28,31
Reignen,tichondrius,1805,priest,discipline,189,104,85
Deathwisher,illidan,1805,priest,discipline,251,127,124
Maghobou,tichondrius,1805,priest,discipline,66,30,36
Öxhö,tichondrius,1804,priest,discipline,44,31,13
Lchcl,tichondrius,1804,priest,discipline,36,24,12
Ðsco,tichondrius,1804,priest,discipline,36,24,12
Absorbs,stormrage,1804,priest,discipline,30,19,11
Drtyror,area-52,1804,priest,discipline,203,114,89
Selath,ragnaros,1804,priest,discipline,47,26,21
Angelumlucis,frostmane,1804,priest,discipline,145,80,65
Syrillia,wildhammer,1804,priest,discipline,142,78,64
Inquisitionx,frostmourne,1804,priest,discipline,301,164,137
Barrenbuffet,zuljin,1804,priest,discipline,278,139,139
Cln,bleeding-hollow,1804,priest,discipline,65,32,33
Taipriest,frostmourne,1804,priest,discipline,222,103,119
Krisup,kelthuzad,1804,priest,discipline,59,27,32
Jinais,zuluhed,1803,priest,discipline,48,33,15
Phillthevoid,sargeras,1803,priest,discipline,45,29,16
Applecare,illidan,1803,priest,discipline,102,60,42
Goldsunx,emerald-dream,1803,priest,discipline,152,85,67
Tjphess,zuljin,1803,priest,discipline,240,130,110
Luciuz,tichondrius,1803,priest,discipline,84,45,39
Cbalnom,tichondrius,1803,priest,discipline,70,37,33
Sußlime,frostwolf,1803,priest,discipline,90,47,43
Vinvictus,tichondrius,1803,priest,discipline,456,232,224
Criil,area-52,1803,priest,discipline,42,19,23
Manyhot,tichondrius,1802,priest,discipline,51,32,19
Yrñwiotøø,illidan,1802,priest,discipline,54,33,21
Dijkstracted,ragnaros,1802,priest,discipline,187,106,81
Seifong,frostmourne,1802,priest,discipline,125,68,57
Deathallpoly,tichondrius,1802,priest,discipline,431,227,204
Ritzzx,ragnaros,1802,priest,discipline,107,55,52
Hotpockets,detheroc,1802,priest,discipline,53,25,28
Retardèr,tichondrius,1801,priest,discipline,97,68,29
Reverendtun,area-52,1801,priest,discipline,83,55,28
Merit,emerald-dream,1801,priest,discipline,165,92,73
Sinday,zuljin,1801,priest,discipline,72,38,34
Lípjju,tichondrius,1801,priest,discipline,54,24,30
Geekynerd,frostmourne,1800,priest,discipline,151,98,53
Bonigan,sargeras,1800,priest,discipline,215,126,89
Bigmomcook,tichondrius,1800,priest,discipline,215,125,90
Fearmen,tichondrius,1800,priest,discipline,89,50,39
Winston,tichondrius,1800,priest,discipline,37,20,17
Holyhõ,stormrage,1800,priest,discipline,60,32,28
Bwgyx,area-52,1800,priest,discipline,42,22,20
Bibleblak,stormrage,1800,priest,discipline,102,53,49
Alola,illidan,1800,priest,discipline,135,69,66
Shamáng,tichondrius,1800,priest,discipline,152,73,79
Shenanígans,malganis,1800,priest,discipline,42,19,23
Bomí,tichondrius,1799,priest,discipline,84,41,43
Fearinoculúm,bleeding-hollow,1798,priest,discipline,24,19,5
Vaaynee,ragnaros,1797,priest,discipline,114,61,53
Secondes,azralon,1797,priest,discipline,36,19,17
Zãrrãlis,arthas,1797,priest,discipline,348,182,166
Comebaack,stormrage,1797,priest,discipline,98,51,47
Horzp,bleeding-hollow,1797,priest,discipline,72,32,40
Epicp,sargeras,1796,priest,discipline,36,22,14
Xsy,stormrage,1796,priest,discipline,72,41,31
Sezyks,stormrage,1795,priest,discipline,65,37,28
Impvp,tichondrius,1795,priest,discipline,89,49,40
Marython,tichondrius,1794,priest,discipline,148,76,72
Onikûdaki,sargeras,1794,priest,discipline,59,27,32
Topbruv,tichondrius,1792,priest,discipline,60,36,24
Wandynha,nemesis,1792,priest,discipline,161,83,78
Leapofdoubt,zuljin,1790,priest,discipline,268,140,128
Ryno,cenarion-circle,1788,priest,discipline,80,43,37
Kostantina,kelthuzad,1788,priest,discipline,184,86,98
Euphorz,tichondrius,1786,priest,discipline,36,19,17
Priceléss,tichondrius,1784,priest,discipline,30,22,8
Rlzpriest,tichondrius,1784,priest,discipline,124,65,59
Pride,moon-guard,1784,priest,discipline,148,66,82
Lesx,tichondrius,1783,priest,discipline,102,54,48
Gochuxx,tichondrius,1783,priest,discipline,72,38,34
Msai,tichondrius,1781,priest,discipline,137,77,60
Gibens,tichondrius,1781,priest,discipline,149,79,70
Lumies,tichondrius,1781,priest,discipline,48,21,27
Usedmedkit,sargeras,1780,priest,discipline,47,28,19
Philmacrakn,stormrage,1780,priest,discipline,185,92,93
Deadpla,ragnaros,1780,priest,discipline,149,74,75
Blesstwo,ragnaros,1779,priest,discipline,48,24,24
Kóba,bleeding-hollow,1778,priest,discipline,48,33,15
Høðj,tichondrius,1778,priest,discipline,36,19,17
Koopy,kiljaeden,1778,priest,discipline,353,185,168
Wânda,tichondrius,1778,priest,discipline,117,58,59
Meltmeltz,nerzhul,1778,priest,discipline,104,51,53
Sätîvá,tichondrius,1777,priest,discipline,50,28,22
Ancilx,area-52,1777,priest,discipline,107,55,52
Khorium,stormrage,1776,priest,discipline,64,29,35
Fleckyy,tichondrius,1776,priest,discipline,42,19,23
Whalexo,kelthuzad,1774,priest,discipline,155,82,73
Lamont,archimonde,1774,priest,discipline,62,26,36
Pnub,aggramar,1772,priest,discipline,105,52,53
Haruspex,azralon,1772,priest,discipline,131,62,69
Purplebeauty,tichondrius,1771,priest,discipline,240,138,102
Barley,chogall,1770,priest,discipline,58,30,28
Heart,misha,1769,priest,discipline,162,88,74
Deathlullaby,malganis,1769,priest,discipline,72,37,35
Mcgg,tichondrius,1769,priest,discipline,210,99,111
Auxp,tichondrius,1769,priest,discipline,59,23,36
Jackski,aerie-peak,1768,priest,discipline,36,24,12
Smitelytius,tichondrius,1768,priest,discipline,36,21,15
Kabugi,illidan,1768,priest,discipline,96,52,44
Bellaelle,stormrage,1768,priest,discipline,69,35,34
Catbabyeah,tichondrius,1767,priest,discipline,54,42,12
Írithyll,stormrage,1767,priest,discipline,59,33,26
Sobamian,tichondrius,1766,priest,discipline,146,66,80
Tonydatiger,the-forgotten-coast,1765,priest,discipline,48,27,21
Healum,nemesis,1765,priest,discipline,106,59,47
Badrapture,sargeras,1764,priest,discipline,104,73,31
Sebpriest,proudmoore,1764,priest,discipline,42,20,22
Raysx,stormrage,1764,priest,discipline,89,40,49
Rúbybest,tichondrius,1764,priest,discipline,72,30,42
Shadowbuzz,barthilas,1763,priest,discipline,102,52,50
Rmxx,illidan,1762,priest,discipline,173,98,75
Darbybean,bleeding-hollow,1762,priest,discipline,54,28,26
Bloodyx,bleeding-hollow,1762,priest,discipline,232,119,113
Grimoz,illidan,1762,priest,discipline,77,35,42
Obscure,malygos,1762,priest,discipline,80,36,44
Meatguzzler,tichondrius,1761,priest,discipline,85,51,34
Matin,frostmourne,1761,priest,discipline,51,27,24
Osis,rivendare,1760,priest,discipline,174,84,90
Compxx,barthilas,1758,priest,discipline,84,47,37
Sacredmoon,dreadmaul,1757,priest,discipline,48,25,23
Kaddy,mannoroth,1757,priest,discipline,130,60,70
Mindseye,azgalor,1756,priest,discipline,156,74,82
Powerwordwap,malganis,1756,priest,discipline,71,33,38
Discgoddess,proudmoore,1755,priest,discipline,243,130,113
Spliffs,tichondrius,1755,priest,discipline,176,87,89
Memoria,emerald-dream,1755,priest,discipline,147,71,76
Papabrokuttv,sargeras,1755,priest,discipline,42,19,23
Rilad,icecrown,1753,priest,discipline,234,120,114
Skunkbishop,sargeras,1753,priest,discipline,243,117,126
Goneqt,illidan,1752,priest,discipline,96,48,48
Barbequechip,proudmoore,1751,priest,discipline,54,26,28
Séxgodx,tichondrius,1751,priest,discipline,59,28,31
Zins,emerald-dream,1750,priest,discipline,114,54,60
Hrdz,zuljin,1748,priest,discipline,52,29,23
Ukishizumi,tichondrius,1748,priest,discipline,155,81,74
Nyluh,deathwing,1748,priest,discipline,74,38,36
Sweetnipsbro,tichondrius,1748,priest,discipline,148,75,73
Raizy,stormrage,1748,priest,discipline,53,26,27
Madmilesstv,zuljin,1748,priest,discipline,63,29,34
Dudebanger,sargeras,1745,priest,discipline,36,26,10
Bmouth,tichondrius,1745,priest,discipline,108,60,48
Alarin,whisperwind,1745,priest,discipline,60,30,30
Evilear,tichondrius,1745,priest,discipline,66,31,35
Luwoona,tichondrius,1745,priest,discipline,112,52,60
Ninbara,tichondrius,1745,priest,discipline,59,27,32
Dipadre,azralon,1744,priest,discipline,108,73,35
Pomdom,tichondrius,1744,priest,discipline,78,37,41
Pisshorse,tichondrius,1743,priest,discipline,65,47,18
Hamstip,sargeras,1743,priest,discipline,98,58,40
Psyjes,stormrage,1743,priest,discipline,122,72,50
Hotgirlshiit,dalaran,1743,priest,discipline,388,190,198
Byck,tichondrius,1743,priest,discipline,60,26,34
Xxqq,illidan,1742,priest,discipline,131,70,61
Seleniax,sargeras,1742,priest,discipline,47,20,27
Jabberwolky,blackrock,1742,priest,discipline,60,23,37
Envio,moon-guard,1740,priest,discipline,60,36,24
Pibkac,stormrage,1740,priest,discipline,81,37,44
Karmapi,malganis,1739,priest,discipline,78,50,28
Cody,magtheridon,1738,priest,discipline,90,59,31
Stinkypinkÿ,bleeding-hollow,1738,priest,discipline,45,27,18
Aloxc,drakkari,1738,priest,discipline,36,19,17
Auntbrittany,tichondrius,1738,priest,discipline,42,21,21
Chaner,scarlet-crusade,1738,priest,discipline,127,61,66
Jimmythedon,mugthol,1738,priest,discipline,82,38,44
Surfgang,tichondrius,1738,priest,discipline,77,35,42
Marejaynez,tichondrius,1737,priest,discipline,289,141,148
Creamedcorn,tichondrius,1736,priest,discipline,40,21,19
Priestass,bleeding-hollow,1736,priest,discipline,266,138,128
Adrio,malorne,1736,priest,discipline,404,202,202
Dontlineme,tichondrius,1736,priest,discipline,160,74,86
Kelthax,sargeras,1736,priest,discipline,54,23,31
Niark,frostmourne,1736,priest,discipline,48,20,28
Maybedead,tichondrius,1734,priest,discipline,42,26,16
Aupascamarad,tichondrius,1734,priest,discipline,35,19,16
Oohso,chogall,1734,priest,discipline,144,67,77
Conezy,frostmourne,1733,priest,discipline,135,76,59
Oghealz,lightnings-blade,1733,priest,discipline,96,43,53
Cazuex,ragnaros,1732,priest,discipline,42,26,16
Larisa,moon-guard,1732,priest,discipline,66,38,28
Verymuscular,stormrage,1732,priest,discipline,66,34,32
Castsmites,tichondrius,1731,priest,discipline,51,27,24
Phludd,malganis,1731,priest,discipline,154,76,78
Nha,stormrage,1731,priest,discipline,42,20,22
Goatedpriest,kelthuzad,1730,priest,discipline,36,25,11
Saelom,frostmourne,1730,priest,discipline,78,49,29
Bombdevil,quelthalas,1730,priest,discipline,138,79,59
Johanna,tichondrius,1729,priest,discipline,41,26,15
Aarei,stormrage,1729,priest,discipline,42,22,20
Dirtydebbie,lightnings-blade,1729,priest,discipline,64,30,34
Iamgess,kilrogg,1728,priest,discipline,84,46,38
Dëàthwîsh,tichondrius,1728,priest,discipline,53,26,27
Deeznuhh,tichondrius,1728,priest,discipline,47,19,28
Suspexyz,stormrage,1727,priest,discipline,77,47,30
Blasphêmy,malganis,1727,priest,discipline,86,52,34
Thatruth,duskwood,1727,priest,discipline,48,26,22
Sanddglokta,tichondrius,1727,priest,discipline,344,172,172
Beeffdaddy,tichondrius,1727,priest,discipline,198,98,100
Olark,durotan,1727,priest,discipline,501,245,256
Oogs,tichondrius,1727,priest,discipline,244,108,136
Åpples,tichondrius,1727,priest,discipline,71,31,40
Apoorstudent,tichondrius,1726,priest,discipline,116,72,44
Mxfd,tichondrius,1726,priest,discipline,47,27,20
Dévore,dalaran,1726,priest,discipline,46,25,21
Plumpkinn,kiljaeden,1726,priest,discipline,106,54,52
Flagiddyflag,kelthuzad,1726,priest,discipline,48,24,24
Analogxz,nemesis,1726,priest,discipline,168,81,87
Vonpaolo,emerald-dream,1725,priest,discipline,24,20,4
Vtp,frostmourne,1725,priest,discipline,82,49,33
Conifer,emerald-dream,1725,priest,discipline,72,41,31
Barthbelro,kiljaeden,1725,priest,discipline,87,49,38
Ferguss,ragnaros,1725,priest,discipline,97,50,47
Litterfeet,moon-guard,1725,priest,discipline,101,51,50
Jezebëll,nemesis,1724,priest,discipline,192,99,93
Mååxxee,zuljin,1722,priest,discipline,30,18,12
Vegetable,suramar,1722,priest,discipline,36,18,18
Bublehead,zuljin,1722,priest,discipline,156,74,82
Downturn,tichondrius,1722,priest,discipline,54,23,31
Cryptron,tichondrius,1721,priest,discipline,90,47,43
Dojacatx,frostmourne,1721,priest,discipline,132,67,65
Canibumsmoke,illidan,1721,priest,discipline,99,50,49
Fhinky,tichondrius,1721,priest,discipline,213,105,108
Clydeington,illidan,1720,priest,discipline,61,36,25
Flamédøtz,ragnaros,1720,priest,discipline,54,30,24
Opriest,queldorei,1718,priest,discipline,54,27,27
Ooit,tichondrius,1717,priest,discipline,24,22,2
Septmoon,tichondrius,1717,priest,discipline,66,34,32
Cixelpvp,area-52,1717,priest,discipline,53,27,26
Wizpell,area-52,1717,priest,discipline,42,18,24
Pissfeet,tichondrius,1716,priest,discipline,30,18,12
Airelia,sargeras,1716,priest,discipline,66,32,34
Rotbaron,bleeding-hollow,1716,priest,discipline,108,48,60
Whatsadot,tichondrius,1715,priest,discipline,72,51,21
Zlowbly,ragnaros,1715,priest,discipline,36,21,15
Ganapati,the-underbog,1715,priest,discipline,36,18,18
Kavxo,sargeras,1714,priest,discipline,155,83,72
Hm,the-scryers,1713,priest,discipline,42,29,13
Benance,tichondrius,1713,priest,discipline,50,29,21
Slickwilly,bloodhoof,1713,priest,discipline,325,164,161
Indiglo,arthas,1713,priest,discipline,138,68,70
Mygameslaggy,area-52,1713,priest,discipline,78,33,45
Marminator,stormrage,1713,priest,discipline,66,24,42
Pastapizza,zuljin,1712,priest,discipline,24,22,2
Rachell,emerald-dream,1712,priest,discipline,36,26,10
Twixicecream,sargeras,1712,priest,discipline,35,24,11
Shrooks,frostmourne,1712,priest,discipline,56,30,26
Bakara,jubeithos,1712,priest,discipline,42,18,24
Nxghtmares,tichondrius,1711,priest,discipline,428,210,218
Aetyn,tichondrius,1710,priest,discipline,101,56,45
Trebrooke,sargeras,1710,priest,discipline,161,88,73
Touchrr,tichondrius,1710,priest,discipline,108,58,50
Demaholy,illidan,1710,priest,discipline,163,82,81
Valothrian,area-52,1710,priest,discipline,172,86,86
Dorgondra,wyrmrest-accord,1709,priest,discipline,48,26,22
Luvenia,sargeras,1709,priest,discipline,286,152,134
Jexso,tichondrius,1709,priest,discipline,220,108,112
Pgpriest,kelthuzad,1709,priest,discipline,126,61,65
Shadzx,andorhal,1709,priest,discipline,71,34,37
Silkydeath,frostmourne,1708,priest,discipline,112,61,51
Andreslol,sargeras,1707,priest,discipline,54,32,22
Bobbyrich,sargeras,1707,priest,discipline,42,24,18
Caveria,emerald-dream,1707,priest,discipline,283,146,137
Zunitpriest,laughing-skull,1706,priest,discipline,42,22,20
Asthenia,saurfang,1706,priest,discipline,120,59,61
Bfts,illidan,1705,priest,discipline,227,119,108
Mellow,tichondrius,1705,priest,discipline,170,89,81
Dippyboi,whisperwind,1705,priest,discipline,102,50,52
Forti,sargeras,1705,priest,discipline,156,74,82
Squaanchy,bleeding-hollow,1705,priest,discipline,129,61,68
Highprofile,proudmoore,1705,priest,discipline,42,19,23
Anmu,illidan,1704,priest,discipline,30,19,11
Dream,kelthuzad,1704,priest,discipline,36,21,15
Staars,ragnaros,1704,priest,discipline,66,37,29
Justafkoutpr,gorefiend,1703,priest,discipline,54,36,18
Toastspriest,tichondrius,1703,priest,discipline,119,66,53
Slùm,barthilas,1702,priest,discipline,55,34,21
Sùlyvahñ,tichondrius,1702,priest,discipline,30,18,12
Gfayde,sargeras,1702,priest,discipline,36,20,16
Snakedoc,emerald-dream,1702,priest,discipline,102,54,48
Nightcráwler,illidan,1702,priest,discipline,89,47,42
Shnozberry,tichondrius,1702,priest,discipline,114,46,68
Hadtogothere,kelthuzad,1701,priest,discipline,265,137,128
Umadcüzubad,azralon,1701,priest,discipline,165,83,82
Irenesome,tichondrius,1701,priest,discipline,45,21,24
Laggytwodope,tichondrius,1699,priest,discipline,60,39,21
Bigbrother,andorhal,1699,priest,discipline,36,21,15
Beowulfy,stormrage,1699,priest,discipline,48,27,21
Kälëy,ragnaros,1699,priest,discipline,286,156,130
Nexp,tichondrius,1698,priest,discipline,141,90,51
Cruces,malorne,1698,priest,discipline,33,18,15
Chañing,frostmourne,1698,priest,discipline,114,56,58
Scab,anetheron,1698,priest,discipline,167,82,85
Nasser,tichondrius,1698,priest,discipline,42,18,24
Prïestitute,zuljin,1697,priest,discipline,150,92,58
Nancynibbler,bleeding-hollow,1697,priest,discipline,70,32,38
Bigdaddios,dalaran,1696,priest,discipline,69,36,33
Frymii,frostmourne,1696,priest,discipline,48,25,23
Syo,dreadmaul,1696,priest,discipline,173,87,86
Hollowsp,tichondrius,1696,priest,discipline,36,18,18
Ayabae,illidan,1696,priest,discipline,1077,534,543
Fádéd,tichondrius,1695,priest,discipline,41,21,20
Pìuzera,azralon,1695,priest,discipline,89,45,44
Scryphe,kelthuzad,1695,priest,discipline,241,120,121
Metaverse,lightbringer,1694,priest,discipline,39,21,18
Mealmassttr,frostmourne,1694,priest,discipline,195,94,101
Deadpriesst,arthas,1694,priest,discipline,114,54,60
Howiecakes,bloodhoof,1694,priest,discipline,105,49,56
Jennyle,sargeras,1693,priest,discipline,90,50,40
Stepsistér,ragnaros,1693,priest,discipline,54,29,25
Deathtones,barthilas,1693,priest,discipline,167,85,82
Geon,sargeras,1693,priest,discipline,113,56,57
Gothmidget,illidan,1693,priest,discipline,84,38,46
Afflickzz,kelthuzad,1692,priest,discipline,42,26,16
Smyted,tichondrius,1692,priest,discipline,79,43,36
Ghøstfaces,illidan,1692,priest,discipline,60,27,33
Muffinboy,illidan,1692,priest,discipline,66,22,44
Bosspriest,tichondrius,1691,priest,discipline,48,23,25
Drethor,saurfang,1691,priest,discipline,76,36,40
Starpass,illidan,1690,priest,discipline,72,47,25
Pigogo,tichondrius,1690,priest,discipline,45,26,19
Elybele,sargeras,1689,priest,discipline,114,61,53
Toopriestly,deathwing,1689,priest,discipline,112,56,56
Yobell,tichondrius,1688,priest,discipline,36,23,13
Duubz,kelthuzad,1688,priest,discipline,102,54,48
Argylemomo,emerald-dream,1688,priest,discipline,202,103,99
Chewey,tichondrius,1688,priest,discipline,77,38,39
Lalaliza,kelthuzad,1688,priest,discipline,41,20,21
Zrn,bleeding-hollow,1688,priest,discipline,102,47,55
Backhairbb,tichondrius,1688,priest,discipline,54,24,30
Verboden,kelthuzad,1687,priest,discipline,36,25,11
Murth,laughing-skull,1687,priest,discipline,65,37,28
Onineko,bleeding-hollow,1687,priest,discipline,63,35,28
Synsparks,tichondrius,1687,priest,discipline,77,35,42
Klttzz,sargeras,1686,priest,discipline,106,57,49
Khaoshealer,destromath,1686,priest,discipline,215,97,118
Andypr,illidan,1686,priest,discipline,66,25,41
Raxekk,stormrage,1685,priest,discipline,60,33,27
Crysknife,korgath,1685,priest,discipline,53,27,26
Isilador,moon-guard,1685,priest,discipline,137,62,75
Pesca,proudmoore,1685,priest,discipline,143,64,79
Hasby,area-52,1684,priest,discipline,222,122,100
Oopsy,bleeding-hollow,1684,priest,discipline,78,40,38
Salvation,tichondrius,1684,priest,discipline,60,27,33
Turtlez,area-52,1684,priest,discipline,78,35,43
Krewesin,ravencrest,1683,priest,discipline,55,29,26
Tastyloads,illidan,1683,priest,discipline,222,117,105
Alphôn,bleeding-hollow,1683,priest,discipline,42,21,21
Flagiddy,kelthuzad,1683,priest,discipline,75,36,39
Engle,arathor,1683,priest,discipline,84,36,48
Rámmstein,wyrmrest-accord,1682,priest,discipline,126,68,58
Fyshme,frostmourne,1682,priest,discipline,42,22,20
Skvmbag,tichondrius,1681,priest,discipline,40,26,14
Märzy,thrall,1681,priest,discipline,42,26,16
Tokoyo,sargeras,1681,priest,discipline,214,125,89
Shrimpouh,illidan,1681,priest,discipline,78,43,35
Giveheadpats,moon-guard,1681,priest,discipline,271,141,130
Plaguebaby,stormrage,1681,priest,discipline,45,23,22
Goatspriesta,kelthuzad,1681,priest,discipline,50,25,25
Serrahs,tichondrius,1681,priest,discipline,59,29,30
Melforn,moon-guard,1681,priest,discipline,59,28,31
Ieveling,skywall,1681,priest,discipline,65,30,35
Saelvar,ragnaros,1680,priest,discipline,90,57,33
Lingdums,tichondrius,1680,priest,discipline,31,18,13
Meshuggah,archimonde,1680,priest,discipline,57,28,29
Wildsmite,hyjal,1680,priest,discipline,258,120,138
Xidis,vashj,1680,priest,discipline,77,30,47
Washdp,frostmourne,1679,priest,discipline,47,24,23
Poosydoodlez,malganis,1679,priest,discipline,105,48,57
Qtasiangirl,emerald-dream,1679,priest,discipline,109,47,62
Jmlz,tichondrius,1678,priest,discipline,39,25,14
Dotsfortots,malfurion,1678,priest,discipline,47,27,20
Littleshower,illidan,1678,priest,discipline,49,28,21
Yunnan,executus,1678,priest,discipline,137,73,64
Jammeslight,quelthalas,1678,priest,discipline,160,85,75
Derpmodé,staghelm,1678,priest,discipline,54,28,26
Nabukom,destromath,1678,priest,discipline,52,25,27
Dayquills,illidan,1678,priest,discipline,54,23,31
Kazgry,illidan,1677,priest,discipline,48,25,23
Holyfall,sargeras,1676,priest,discipline,226,119,107
Gurgs,emerald-dream,1676,priest,discipline,38,19,19
Probs,frostmourne,1676,priest,discipline,149,73,76
Natahlia,area-52,1676,priest,discipline,108,52,56
Likehisname,tichondrius,1676,priest,discipline,78,29,49
Narodiz,nemesis,1675,priest,discipline,48,26,22
Bonoo,tichondrius,1675,priest,discipline,365,192,173
Bonehead,warsong,1675,priest,discipline,48,23,25
Hoglet,moon-guard,1674,priest,discipline,71,45,26
Szx,akama,1673,priest,discipline,68,35,33
Dakp,sargeras,1673,priest,discipline,48,20,28
Aco,tichondrius,1672,priest,discipline,150,79,71
Acpriest,tichondrius,1672,priest,discipline,135,69,66
Eetsqt,barthilas,1671,priest,discipline,120,74,46
Meemó,area-52,1671,priest,discipline,36,22,14
Räpture,andorhal,1671,priest,discipline,46,28,18
Archecho,area-52,1671,priest,discipline,60,36,24
Vatikn,stormrage,1671,priest,discipline,60,30,30
Jjmms,akama,1671,priest,discipline,465,224,241
Vandamnation,barthilas,1671,priest,discipline,307,147,160
Tshik,ragnaros,1671,priest,discipline,62,28,34
Holymagetv,tichondrius,1671,priest,discipline,68,29,39
Flatlining,illidan,1670,priest,discipline,120,68,52
Perothon,garrosh,1670,priest,discipline,153,82,71
Sermøn,azuremyst,1670,priest,discipline,489,259,230
Zilah,ravencrest,1670,priest,discipline,138,72,66
Dachenchen,tichondrius,1669,priest,discipline,36,27,9
Serakiki,nemesis,1669,priest,discipline,102,56,46
Kagemetsu,sargeras,1669,priest,discipline,152,74,78
Boostedpi,tichondrius,1669,priest,discipline,44,21,23
Elilium,tichondrius,1668,priest,discipline,80,48,32
Alomari,zuljin,1668,priest,discipline,32,19,13
Milkkz,zuljin,1668,priest,discipline,54,30,24
Klitarus,barthilas,1668,priest,discipline,48,23,25
Dpendant,frostmourne,1668,priest,discipline,149,71,78
Maximiliano,barthilas,1668,priest,discipline,43,19,24
Rdson,malganis,1668,priest,discipline,61,24,37
Mcfref,tichondrius,1667,priest,discipline,135,70,65
Hypes,korgath,1666,priest,discipline,145,80,65
Muffingal,tichondrius,1666,priest,discipline,36,19,17
Mortteus,agamaggan,1666,priest,discipline,84,43,41
Nelpesh,tichondrius,1666,priest,discipline,60,27,33
Fullfear,lothar,1665,priest,discipline,66,38,28
Stoneflute,emerald-dream,1665,priest,discipline,258,139,119
Icemocha,tichondrius,1665,priest,discipline,54,25,29
Meren,kelthuzad,1664,priest,discipline,36,24,12
Góndhi,tichondrius,1664,priest,discipline,42,25,17
Amayå,kelthuzad,1664,priest,discipline,78,39,39
Rmx,illidan,1664,priest,discipline,64,30,34
Kujox,tichondrius,1664,priest,discipline,94,44,50
Moalboal,tichondrius,1663,priest,discipline,313,161,152
Lostmind,malganis,1663,priest,discipline,53,23,30
Gekko,azgalor,1663,priest,discipline,54,21,33
Shocklol,stormrage,1662,priest,discipline,29,22,7
Niik,tichondrius,1662,priest,discipline,36,25,11
Nancya,stormrage,1662,priest,discipline,75,48,27
Syrul,tichondrius,1662,priest,discipline,87,50,37
Jzd,dreadmaul,1662,priest,discipline,89,49,40
Hallucinogen,kelthuzad,1662,priest,discipline,95,51,44
Tecnica,kelthuzad,1662,priest,discipline,268,138,130
Pontiffvelen,area-52,1662,priest,discipline,84,36,48
Fugazy,barthilas,1661,priest,discipline,44,24,20
Nutshotxx,skullcrusher,1661,priest,discipline,262,126,136
Fisp,moon-guard,1661,priest,discipline,72,33,39
Bvh,kelthuzad,1661,priest,discipline,57,22,35
Joeyslaps,frostwolf,1660,priest,discipline,64,34,30
Shastea,crushridge,1660,priest,discipline,98,51,47
Resisted,gorefiend,1660,priest,discipline,238,120,118
Yotz,destromath,1660,priest,discipline,72,33,39
Sidepiëce,area-52,1660,priest,discipline,52,23,29
Priestreto,zuljin,1659,priest,discipline,137,76,61
Cayleey,stormrage,1659,priest,discipline,90,40,50
Fronkeytko,tichondrius,1658,priest,discipline,36,21,15
Randomprist,area-52,1658,priest,discipline,33,18,15
Luciellis,sargeras,1658,priest,discipline,162,83,79
Imms,tichondrius,1658,priest,discipline,48,21,27
Teddyy,tichondrius,1658,priest,discipline,54,22,32
Caveron,tichondrius,1657,priest,discipline,42,23,19
Persimmons,lightbringer,1657,priest,discipline,137,72,65
Honeyduutch,black-dragonflight,1657,priest,discipline,186,95,91
Holyster,tichondrius,1657,priest,discipline,59,26,33
Pocket,alleria,1656,priest,discipline,36,21,15
Obstetrician,tichondrius,1656,priest,discipline,42,24,18
Swaheally,frostmourne,1656,priest,discipline,48,25,23
Frenezyz,ragnaros,1656,priest,discipline,112,56,56
Gutrìck,tichondrius,1656,priest,discipline,48,24,24
Yaz,emerald-dream,1656,priest,discipline,71,34,37
Sarïya,moon-guard,1656,priest,discipline,143,68,75
Theravus,moon-guard,1655,priest,discipline,124,67,57
Dances,emerald-dream,1655,priest,discipline,42,22,20
Hermanmiller,frostmourne,1655,priest,discipline,48,25,23
Shádowman,thrall,1655,priest,discipline,126,65,61
Hungrybone,proudmoore,1655,priest,discipline,1063,535,528
Vcainyfairy,stormrage,1655,priest,discipline,531,267,264
Holyneuro,illidan,1655,priest,discipline,48,24,24
Catonement,moon-guard,1655,priest,discipline,696,337,359
Naranjitá,ragnaros,1654,priest,discipline,66,42,24
Darknuz,sargeras,1654,priest,discipline,53,27,26
Falsegodxd,tichondrius,1654,priest,discipline,48,22,26
Bloodybunnie,tichondrius,1653,priest,discipline,30,22,8
Tammyone,emerald-dream,1653,priest,discipline,75,48,27
Perceptions,dalaran,1653,priest,discipline,48,29,19
Woobgasm,sargeras,1653,priest,discipline,90,52,38
Kathere,tichondrius,1653,priest,discipline,42,23,19
Dènalí,area-52,1653,priest,discipline,66,35,31
Timbobaloo,thrall,1652,priest,discipline,82,47,35
Kelime,azralon,1652,priest,discipline,60,34,26
Glassbirds,stormrage,1652,priest,discipline,48,25,23
Zaryx,wildhammer,1652,priest,discipline,78,40,38
Peelforheals,nordrassil,1651,priest,discipline,84,42,42
Airalia,bleeding-hollow,1650,priest,discipline,36,23,13
Hpalisdawg,malorne,1650,priest,discipline,49,29,20
Packa,khaz-modan,1649,priest,discipline,42,26,16
Zyklonova,frostmourne,1649,priest,discipline,54,31,23
Hanley,tichondrius,1649,priest,discipline,85,48,37
Haill,quelthalas,1649,priest,discipline,115,59,56
Larry,tichondrius,1649,priest,discipline,65,31,34
Lanäthel,sargeras,1648,priest,discipline,28,19,9
Dreamteller,tichondrius,1648,priest,discipline,48,24,24
Papafajita,area-52,1648,priest,discipline,113,53,60
Eazyp,stormrage,1647,priest,discipline,40,22,18
Bigtomwudi,illidan,1647,priest,discipline,82,43,39
Trollpreist,tichondrius,1647,priest,discipline,148,75,73
Whitecaster,tichondrius,1647,priest,discipline,78,39,39
Lòthnalar,ragnaros,1647,priest,discipline,60,29,31
Appleshampoo,black-dragonflight,1647,priest,discipline,52,25,27
Dorazòn,bleeding-hollow,1647,priest,discipline,54,25,29
Twistynipple,malganis,1646,priest,discipline,42,25,17
Lîk,tichondrius,1646,priest,discipline,217,121,96
Pvprashida,tichondrius,1646,priest,discipline,308,161,147
Saintguard,tichondrius,1646,priest,discipline,246,127,119
Iamjakehill,area-52,1646,priest,discipline,154,79,75
Knucklesandy,tichondrius,1646,priest,discipline,47,21,26
Rosaparksxo,sargeras,1645,priest,discipline,70,35,35
Piils,sargeras,1645,priest,discipline,42,21,21
Cavatea,illidan,1645,priest,discipline,42,21,21
Crøws,ragnaros,1645,priest,discipline,306,152,154
Kastep,tichondrius,1645,priest,discipline,130,63,67
Maatrrixx,drakkari,1645,priest,discipline,60,19,41
Delai,dalaran,1644,priest,discipline,34,23,11
Opscurum,bleeding-hollow,1644,priest,discipline,90,50,40
Primalshadow,kaelthas,1644,priest,discipline,42,23,19
Cptcancer,tichondrius,1644,priest,discipline,54,23,31
Toddmund,tichondrius,1644,priest,discipline,64,25,39
Ssgpak,tichondrius,1643,priest,discipline,77,53,24
Maxla,tichondrius,1643,priest,discipline,131,78,53
Psycozis,hyjal,1643,priest,discipline,351,184,167
Judis,barthilas,1643,priest,discipline,78,39,39
Kuell,ragnaros,1642,priest,discipline,53,29,24
Ixchelune,kelthuzad,1642,priest,discipline,243,122,121
Ibubble,chromaggus,1642,priest,discipline,50,24,26
Reiae,malganis,1642,priest,discipline,70,27,43
Hõlyshìt,whisperwind,1641,priest,discipline,42,26,16
Mabisyo,wyrmrest-accord,1641,priest,discipline,56,33,23
Oiled,barthilas,1641,priest,discipline,158,93,65
Machinecoach,stormrage,1641,priest,discipline,36,19,17
Batiatus,moon-guard,1641,priest,discipline,321,161,160
Pocserpriest,drakkari,1641,priest,discipline,50,24,26
Halliburton,illidan,1640,priest,discipline,278,154,124
Fearnought,stormrage,1640,priest,discipline,242,129,113
Jiñx,destromath,1640,priest,discipline,284,151,133
Alguîen,ragnaros,1640,priest,discipline,115,61,54
Zymmie,moon-guard,1640,priest,discipline,138,64,74
Life,amanthul,1639,priest,discipline,143,84,59
Spx,frostmourne,1639,priest,discipline,102,57,45
Randompreest,stormrage,1639,priest,discipline,42,23,19
Purged,shadowmoon,1639,priest,discipline,391,209,182
Purplepil,sargeras,1639,priest,discipline,36,18,18
Mkowns,tichondrius,1638,priest,discipline,94,56,38
Tooziq,stormrage,1638,priest,discipline,35,18,17
Lunarina,hyjal,1638,priest,discipline,167,75,92
Yungbaker,area-52,1637,priest,discipline,35,20,15
Fila,azralon,1637,priest,discipline,36,19,17
Manryu,tichondrius,1637,priest,discipline,132,68,64
Evvylou,stormrage,1637,priest,discipline,42,19,23
Choochang,sargeras,1636,priest,discipline,35,27,8
Aethriem,bleeding-hollow,1636,priest,discipline,54,33,21
Planchebois,zuljin,1636,priest,discipline,54,31,23
Notkim,zuljin,1636,priest,discipline,83,47,36
Takomochi,sargeras,1636,priest,discipline,41,22,19
Shesaidthat,stormrage,1636,priest,discipline,292,150,142
Döllyy,illidan,1636,priest,discipline,48,22,26
Nightz,illidan,1635,priest,discipline,48,28,20
Frag,frostmourne,1635,priest,discipline,132,72,60
Mutedox,frostmourne,1635,priest,discipline,47,24,23
Arcosis,turalyon,1635,priest,discipline,54,22,32
Mangolatte,frostmourne,1634,priest,discipline,55,41,14
Thirdplace,tichondrius,1634,priest,discipline,36,24,12
Bater,mugthol,1634,priest,discipline,64,40,24
Ngin,queldorei,1634,priest,discipline,36,21,15
Hårper,area-52,1634,priest,discipline,75,37,38
Twêet,frostmourne,1634,priest,discipline,228,106,122
Beejaex,stormreaver,1634,priest,discipline,48,22,26
Benedictiion,tichondrius,1634,priest,discipline,86,38,48
Zëref,azralon,1633,priest,discipline,88,52,36
Creòle,area-52,1633,priest,discipline,42,23,19
Huxleypoo,boulderfist,1633,priest,discipline,42,22,20
Kazuret,ragnaros,1633,priest,discipline,272,141,131
Bacpack,area-52,1633,priest,discipline,177,89,88
Pleasant,dathremar,1633,priest,discipline,129,56,73
Neuterednuts,zuljin,1632,priest,discipline,48,27,21
Somefire,proudmoore,1632,priest,discipline,197,98,99
Magnuscorp,illidan,1632,priest,discipline,48,23,25
Buhroke,thrall,1632,priest,discipline,62,29,33
Soulcleave,dark-iron,1632,priest,discipline,84,38,46
Kayare,area-52,1632,priest,discipline,53,23,30
Haquin,malganis,1632,priest,discipline,42,18,24
Kellogss,magtheridon,1631,priest,discipline,36,21,15
Valith,bleeding-hollow,1631,priest,discipline,88,49,39
Swartzp,tichondrius,1631,priest,discipline,134,71,63
Gödtier,frostwolf,1631,priest,discipline,42,18,24
Meip,illidan,1630,priest,discipline,24,17,7
Jâldabaoth,area-52,1630,priest,discipline,72,45,27
Skadín,stormrage,1630,priest,discipline,155,92,63
Gamepass,tichondrius,1630,priest,discipline,60,30,30
Megz,zuljin,1630,priest,discipline,46,23,23
Asj,illidan,1629,priest,discipline,45,30,15
Healzyea,eonar,1629,priest,discipline,130,71,59
Valyx,tichondrius,1629,priest,discipline,189,102,87
Bluecho,tichondrius,1629,priest,discipline,48,25,23
Astrøpriest,tichondrius,1629,priest,discipline,72,31,41
Bustit,azgalor,1628,priest,discipline,52,28,24
Bhoyka,ragnaros,1628,priest,discipline,57,29,28
Chookspriest,tichondrius,1628,priest,discipline,179,90,89
Azurestorm,tichondrius,1628,priest,discipline,66,33,33
Glöws,area-52,1628,priest,discipline,36,18,18
Crunchywater,stormrage,1628,priest,discipline,42,19,23
Jaysshadow,illidan,1627,priest,discipline,35,23,12
Leviathanh,tichondrius,1627,priest,discipline,116,73,43
Oesobagi,tichondrius,1627,priest,discipline,113,66,47
Saltlevels,sargeras,1627,priest,discipline,174,94,80
Crionicz,bleeding-hollow,1627,priest,discipline,52,28,24
Djc,tichondrius,1627,priest,discipline,96,50,46
Ärchangél,tichondrius,1627,priest,discipline,152,79,73
Çammy,frostmourne,1626,priest,discipline,24,17,7
Andrew,sargeras,1626,priest,discipline,30,20,10
Discavow,bleeding-hollow,1626,priest,discipline,51,31,20
Krupticus,tichondrius,1626,priest,discipline,40,24,16
Valtres,tichondrius,1626,priest,discipline,36,20,16
Brothercarl,stormrage,1626,priest,discipline,95,51,44
Odealp,stormscale,1626,priest,discipline,42,20,22
Uroka,malganis,1626,priest,discipline,42,19,23
Bòngu,tichondrius,1626,priest,discipline,58,24,34
Mylo,azralon,1625,priest,discipline,48,28,20
Aexdawg,malganis,1625,priest,discipline,144,83,61
Wtfamdoing,quelthalas,1625,priest,discipline,90,51,39
Tcfx,bleeding-hollow,1625,priest,discipline,30,17,13
Zórg,stormrage,1625,priest,discipline,96,53,43
Luhhx,sargeras,1625,priest,discipline,134,70,64
Linarindil,hyjal,1625,priest,discipline,132,66,66
Highmoon,kelthuzad,1625,priest,discipline,42,20,22
Frikapp,stormrage,1625,priest,discipline,42,20,22
Beelzebul,illidan,1625,priest,discipline,81,35,46
Jâmïè,gurubashi,1624,priest,discipline,52,36,16
Velandrys,earthen-ring,1624,priest,discipline,80,41,39
Zunari,thrall,1624,priest,discipline,54,27,27
Momorabbit,tichondrius,1624,priest,discipline,36,17,19
Ussmissouri,area-52,1624,priest,discipline,141,63,78
Pennumbra,barthilas,1624,priest,discipline,102,43,59
Caesus,sargeras,1623,priest,discipline,124,70,54
Catmints,illidan,1623,priest,discipline,132,69,63
Hereges,azralon,1623,priest,discipline,48,24,24
Badhabit,zuluhed,1623,priest,discipline,121,57,64
Elbeefsteak,ragnaros,1622,priest,discipline,54,32,22
Tricklee,tichondrius,1622,priest,discipline,53,30,23
Grizzlysmite,stormrage,1622,priest,discipline,361,177,184
Vsat,illidan,1622,priest,discipline,54,26,28
Wickedpriest,malganis,1622,priest,discipline,54,25,29
Kûrtt,azralon,1622,priest,discipline,42,19,23
Abbydaddy,illidan,1622,priest,discipline,63,28,35
Woodricks,frostmourne,1622,priest,discipline,71,27,44
Spicer,eredar,1621,priest,discipline,41,25,16
Tuniepope,sargeras,1621,priest,discipline,75,45,30
Pedobearx,ragnaros,1621,priest,discipline,178,89,89
Deathsmoke,ragnaros,1621,priest,discipline,112,55,57
Fialiadia,illidan,1621,priest,discipline,54,20,34
Lukaspriest,proudmoore,1620,priest,discipline,71,46,25
Pigro,area-52,1620,priest,discipline,30,19,11
Wodturbo,bleeding-hollow,1620,priest,discipline,61,36,25
Holyphodays,sargeras,1620,priest,discipline,193,105,88
Darknuzs,sargeras,1620,priest,discipline,42,21,21
Cityboyy,tichondrius,1620,priest,discipline,49,22,27
Skylark,bronzebeard,1620,priest,discipline,48,21,27
Gosarix,tichondrius,1619,priest,discipline,24,17,7
Lolcrafthd,ragnaros,1619,priest,discipline,153,81,72
Dfâc,moon-guard,1619,priest,discipline,96,47,49
Baddmachine,illidan,1619,priest,discipline,47,21,26
Skcits,sargeras,1618,priest,discipline,42,26,16
Tickleme,zuljin,1618,priest,discipline,30,17,13
Brickzy,dalaran,1618,priest,discipline,40,21,19
Arcalon,thrall,1618,priest,discipline,101,53,48
Nohéalforu,stormrage,1618,priest,discipline,48,25,23
Altarboy,agamaggan,1618,priest,discipline,80,38,42
Shunpei,ragnaros,1618,priest,discipline,90,41,49
Jmr,onyxia,1617,priest,discipline,24,17,7
Khathor,kargath,1617,priest,discipline,30,17,13
Ezelra,frostmourne,1617,priest,discipline,47,25,22
Ingladforx,azralon,1617,priest,discipline,83,41,42
Mingoms,illidan,1616,priest,discipline,80,46,34
Hølycrit,icecrown,1616,priest,discipline,93,52,41
Prayussy,tichondrius,1616,priest,discipline,141,75,66
Charbosan,gorgonnash,1616,priest,discipline,746,383,363
Zyonn,chogall,1616,priest,discipline,36,18,18
Shadheda,andorhal,1616,priest,discipline,116,51,65
Ahealer,alterac-mountains,1616,priest,discipline,48,21,27
Anahka,tichondrius,1616,priest,discipline,48,21,27
Shaddäye,andorhal,1616,priest,discipline,48,20,28
Elliepls,tichondrius,1615,priest,discipline,49,31,18
Apathist,sargeras,1615,priest,discipline,72,45,27
Saintpleb,sargeras,1615,priest,discipline,30,18,12
Kraamur,area-52,1615,priest,discipline,96,57,39
Predolph,illidan,1615,priest,discipline,60,34,26
Androalis,thaurissan,1615,priest,discipline,114,62,52
Jîtters,silvermoon,1615,priest,discipline,84,45,39
Flarkyllama,area-52,1615,priest,discipline,48,20,28
Fenty,nemesis,1614,priest,discipline,137,73,64
Hottymcdotty,black-dragonflight,1614,priest,discipline,42,21,21
Sanitizer,frostmourne,1614,priest,discipline,78,38,40
Galandora,kelthuzad,1614,priest,discipline,48,23,25
Getgudwtrada,frostmourne,1614,priest,discipline,57,26,31
Twistèr,zuljin,1614,priest,discipline,81,35,46
Selfless,barthilas,1614,priest,discipline,66,28,38
Iovedoctor,tichondrius,1614,priest,discipline,78,25,53
Sâsh,stormrage,1613,priest,discipline,72,40,32
Aåurøra,stormrage,1613,priest,discipline,46,23,23
Trezz,hakkar,1613,priest,discipline,46,23,23
ßðßßÿ,area-52,1613,priest,discipline,42,21,21
Mattgarska,tichondrius,1613,priest,discipline,48,17,31
Practition,bleeding-hollow,1612,priest,discipline,36,25,11
Alfié,kelthuzad,1612,priest,discipline,48,33,15
Tyszie,sargeras,1612,priest,discipline,66,40,26
Draxxankou,tanaris,1612,priest,discipline,103,59,44
Itachî,ravencrest,1612,priest,discipline,42,23,19
Kks,tichondrius,1612,priest,discipline,90,46,44
Rafers,tichondrius,1612,priest,discipline,48,20,28
Spicey,korgath,1611,priest,discipline,51,37,14
Gsek,nemesis,1611,priest,discipline,36,23,13
Knoskeezy,proudmoore,1611,priest,discipline,42,26,16
Jamzae,tichondrius,1611,priest,discipline,36,21,15
Scruge,frostmourne,1611,priest,discipline,55,32,23
Yugewap,hyjal,1611,priest,discipline,256,143,113
Vincejddp,zuljin,1611,priest,discipline,199,105,94
Tonybanderas,shattered-halls,1611,priest,discipline,120,63,57
Shadoris,antonidas,1611,priest,discipline,48,23,25
Ggsaurusrex,area-52,1611,priest,discipline,84,36,48
Cinsare,moon-guard,1610,priest,discipline,84,49,35
Psychic,bladefist,1610,priest,discipline,130,75,55
Rima,stormscale,1610,priest,discipline,30,17,13
Kencyx,tichondrius,1610,priest,discipline,36,20,16
Yidra,illidan,1610,priest,discipline,36,19,17
Blathers,malganis,1610,priest,discipline,98,51,47
Blobble,tichondrius,1610,priest,discipline,138,69,69
Billybobjane,jubeithos,1610,priest,discipline,42,21,21
Lawbster,jubeithos,1610,priest,discipline,40,20,20
Oyy,barthilas,1610,priest,discipline,108,52,56
Interworld,illidan,1610,priest,discipline,50,24,26
Angeldawn,stormrage,1610,priest,discipline,58,24,34
Másterclass,stormrage,1609,priest,discipline,29,22,7
Notoriousmmä,illidan,1609,priest,discipline,99,59,40
Smashhley,bleeding-hollow,1609,priest,discipline,200,114,86
Inuyasha,stormrage,1609,priest,discipline,30,17,13
Auras,boulderfist,1609,priest,discipline,98,52,46
Krusheal,tichondrius,1609,priest,discipline,47,22,25
Gránd,emerald-dream,1609,priest,discipline,54,22,32
Katjaa,quelthalas,1609,priest,discipline,74,27,47
Gsek,azralon,1608,priest,discipline,54,34,20
Alcázardeyo,area-52,1608,priest,discipline,150,84,66
Wrekkit,area-52,1608,priest,discipline,84,42,42
Reginaa,nemesis,1608,priest,discipline,65,30,35
Buttfive,illidan,1608,priest,discipline,58,24,34
Azurebaba,tichondrius,1607,priest,discipline,181,100,81
Orzington,laughing-skull,1607,priest,discipline,158,86,72
Lines,sargeras,1607,priest,discipline,88,47,41
Aphrodìtë,tichondrius,1607,priest,discipline,181,95,86
Kaeda,drenden,1607,priest,discipline,84,44,40
Hootheals,illidan,1607,priest,discipline,46,24,22
Preeste,stormrage,1607,priest,discipline,44,22,22
Darknus,sargeras,1607,priest,discipline,78,37,41
Powerwordqt,kalecgos,1607,priest,discipline,72,32,40
Wormclergy,tichondrius,1607,priest,discipline,134,58,76
Teewat,illidan,1606,priest,discipline,42,23,19
Säcrilege,drakkari,1606,priest,discipline,243,130,113
Swagraptor,stormreaver,1606,priest,discipline,192,102,90
Gurlyounasty,khazgoroth,1606,priest,discipline,127,67,60
Xhadow,sargeras,1606,priest,discipline,161,84,77
Mclyte,whisperwind,1606,priest,discipline,203,103,100
Fõrcedtowipe,tichondrius,1606,priest,discipline,245,124,121
Lovesy,burning-legion,1606,priest,discipline,60,30,30
Darkispriest,tichondrius,1606,priest,discipline,36,17,19
Trojanphobia,bleeding-hollow,1605,priest,discipline,54,29,25
Yoggismydad,emerald-dream,1605,priest,discipline,185,95,90
Halfcutt,tichondrius,1605,priest,discipline,114,57,57
Shiromar,tichondrius,1605,priest,discipline,102,51,51
Takosoufflé,emerald-dream,1605,priest,discipline,48,22,26
Lolkwtf,sargeras,1605,priest,discipline,49,22,27
Míkò,sargeras,1604,priest,discipline,18,17,1
Tanthsondis,illidan,1604,priest,discipline,54,28,26
Staywild,tichondrius,1604,priest,discipline,66,34,32
Tidbitsy,malganis,1604,priest,discipline,108,55,53
Giblettz,lightbringer,1604,priest,discipline,147,72,75
Renghost,illidan,1604,priest,discipline,42,20,22
Punisherror,area-52,1604,priest,discipline,64,28,36
Zerokool,moonrunner,1603,priest,discipline,48,29,19
Fukneasy,darkspear,1603,priest,discipline,37,20,17
Khrystalhero,nagrand,1603,priest,discipline,54,29,25
Feymuhsjr,black-dragonflight,1603,priest,discipline,54,29,25
Kripple,tichondrius,1603,priest,discipline,56,30,26
Pinchevato,ragnaros,1603,priest,discipline,288,147,141
Jubinátor,tichondrius,1603,priest,discipline,48,23,25
Tooeasy,vashj,1603,priest,discipline,36,17,19
Xävier,farstriders,1603,priest,discipline,48,22,26
Swagdemøn,kelthuzad,1603,priest,discipline,42,19,23
Overshields,caelestrasz,1603,priest,discipline,58,23,35
Resortv,illidan,1602,priest,discipline,42,32,10
Keaina,malganis,1602,priest,discipline,83,45,38
Gromkekz,area-52,1602,priest,discipline,73,38,35
Ragretsxo,darkspear,1602,priest,discipline,150,75,75
Manstench,tichondrius,1602,priest,discipline,81,40,41
Crizem,bleeding-hollow,1602,priest,discipline,242,119,123
Bennito,moon-guard,1602,priest,discipline,211,96,115
Cindyloux,tichondrius,1602,priest,discipline,42,19,23
Ünagi,thrall,1602,priest,discipline,77,34,43
Psyclick,zuljin,1601,priest,discipline,30,21,9
Invicta,frostwolf,1601,priest,discipline,27,18,9
Cythrinx,bleeding-hollow,1601,priest,discipline,30,19,11
Azaleth,sargeras,1601,priest,discipline,41,24,17
Bistek,bleeding-hollow,1601,priest,discipline,166,83,83
Mhp,illidan,1601,priest,discipline,51,20,31
Cyntech,area-52,1600,priest,discipline,29,23,6
Jhivagosp,tichondrius,1600,priest,discipline,42,23,19
Mepisth,sargeras,1600,priest,discipline,66,36,30
Zarakonna,illidan,1600,priest,discipline,60,32,28
Nijoral,tichondrius,1600,priest,discipline,368,194,174
Eccentrixx,mannoroth,1600,priest,discipline,54,28,26
Kukion,uldum,1600,priest,discipline,48,22,26
Brahp,frostmourne,1600,priest,discipline,107,49,58
Smoochinz,sargeras,1600,priest,discipline,52,23,29
Ÿsk,tichondrius,1599,priest,discipline,240,123,117
Arianagrande,garona,1599,priest,discipline,106,54,52
Bigsmart,tichondrius,1598,priest,discipline,56,25,31
Dupaforted,stormrage,1598,priest,discipline,71,26,45
Valeilah,illidan,1597,priest,discipline,126,80,46
Soùlsista,sargeras,1597,priest,discipline,47,29,18
Zackor,maiev,1597,priest,discipline,64,34,30
Shutkap,sargeras,1597,priest,discipline,48,23,25
Mdibaxx,tichondrius,1597,priest,discipline,89,40,49
Universe,spinebreaker,1596,priest,discipline,82,47,35
Vorazzun,quelthalas,1596,priest,discipline,135,70,65
Marshpillow,barthilas,1596,priest,discipline,242,123,119
Pettypriest,dalaran,1596,priest,discipline,79,39,40
Ivorytiger,bleeding-hollow,1596,priest,discipline,42,19,23
Takethat,emerald-dream,1595,priest,discipline,90,58,32
Jabreez,illidan,1595,priest,discipline,71,43,28
Incisions,moon-guard,1595,priest,discipline,120,65,55
Healbaby,illidan,1595,priest,discipline,388,196,192
Serenewisp,tichondrius,1595,priest,discipline,101,48,53
Zombiz,tichondrius,1594,priest,discipline,77,42,35
Purgen,tichondrius,1594,priest,discipline,88,46,42
Onezor,frostmourne,1594,priest,discipline,78,39,39
Tooze,draka,1594,priest,discipline,66,33,33
ßlackøut,sargeras,1594,priest,discipline,48,23,25
Gummachine,tichondrius,1594,priest,discipline,36,17,19
Comana,frostmourne,1594,priest,discipline,53,25,28
Blacklog,darkspear,1593,priest,discipline,50,25,25
Ariês,tichondrius,1593,priest,discipline,60,22,38
Vehex,malganis,1591,priest,discipline,30,20,10
Astalail,emerald-dream,1591,priest,discipline,40,21,19
Dellitor,illidan,1591,priest,discipline,65,33,32
Darenlor,tichondrius,1591,priest,discipline,165,82,83
Upwind,tichondrius,1590,priest,discipline,36,19,17
Meepsw,stormrage,1590,priest,discipline,125,63,62
Aralia,ragnaros,1590,priest,discipline,152,76,76
Isteri,thrall,1590,priest,discipline,52,26,26
Woosanghong,tichondrius,1590,priest,discipline,90,44,46
Emotionally,sargeras,1589,priest,discipline,30,20,10
Luthiene,area-52,1589,priest,discipline,263,141,122
Shastyr,tichondrius,1589,priest,discipline,120,63,57
Ems,dawnbringer,1589,priest,discipline,243,122,121
Ooft,tichondrius,1589,priest,discipline,46,23,23
Lilbaldjosh,frostmourne,1589,priest,discipline,120,54,66
Daleyn,ragnaros,1588,priest,discipline,54,30,24
Scpzi,frostmourne,1588,priest,discipline,42,21,21
Raffimilk,tichondrius,1588,priest,discipline,45,22,23
Eggsdenny,illidan,1588,priest,discipline,36,17,19
Bigolbush,moon-guard,1587,priest,discipline,36,22,14
Buchöna,quelthalas,1587,priest,discipline,113,58,55
Flexeggette,illidan,1587,priest,discipline,49,23,26
Primael,tichondrius,1587,priest,discipline,40,18,22
Dreaminz,tichondrius,1586,priest,discipline,48,30,18
Powerranger,senjin,1586,priest,discipline,42,25,17
Motions,frostmourne,1586,priest,discipline,56,23,33
Medikhurts,bleeding-hollow,1585,priest,discipline,54,31,23
Playsoon,illidan,1585,priest,discipline,130,70,60
Deadnyx,tichondrius,1585,priest,discipline,42,22,20
Hennywhite,sargeras,1585,priest,discipline,142,70,72
Akëla,nemesis,1585,priest,discipline,159,78,81
Tazzi,chromaggus,1584,priest,discipline,157,89,68
Indigojuly,sargeras,1584,priest,discipline,88,49,39
Cezure,stormrage,1584,priest,discipline,356,194,162
Smalltoad,lightnings-blade,1584,priest,discipline,58,30,28
Lonpriest,stormrage,1584,priest,discipline,306,152,154
Tý,frostmourne,1584,priest,discipline,54,24,30
Lovesthebox,frostmourne,1584,priest,discipline,108,47,61
Halö,area-52,1583,priest,discipline,282,143,139
Cigarillõ,thrall,1583,priest,discipline,35,17,18
Vern,laughing-skull,1583,priest,discipline,102,42,60
Puttles,tichondrius,1583,priest,discipline,83,33,50
Brezi,azralon,1582,priest,discipline,60,36,24
Safetyy,bleeding-hollow,1582,priest,discipline,50,27,23
Skwishee,illidan,1582,priest,discipline,106,57,49
Rourk,medivh,1582,priest,discipline,179,92,87
Sacrify,ragnaros,1582,priest,discipline,231,114,117
Vanderbeek,frostmourne,1582,priest,discipline,84,39,45
Bisholan,frostwolf,1582,priest,discipline,97,43,54
Ananiel,moon-guard,1581,priest,discipline,60,38,22
Weapestrong,tichondrius,1581,priest,discipline,48,24,24
Shieldharder,stormrage,1581,priest,discipline,39,18,21
Kihlupr,frostmourne,1581,priest,discipline,76,35,41
Jatral,azralon,1581,priest,discipline,88,39,49
Gus,the-venture-co,1580,priest,discipline,78,44,34
Dasaq,sargeras,1580,priest,discipline,48,19,29
Mxst,frostmourne,1579,priest,discipline,24,20,4
Cringepriest,area-52,1579,priest,discipline,54,33,21
Jagita,kelthuzad,1579,priest,discipline,37,22,15
Faithmelter,stormrage,1579,priest,discipline,167,89,78
Csjy,illidan,1579,priest,discipline,78,37,41
Allysheedy,sargeras,1578,priest,discipline,78,44,34
Carti,bleeding-hollow,1578,priest,discipline,244,135,109
Jönsnow,ghostlands,1578,priest,discipline,84,42,42
Zizziz,tichondrius,1577,priest,discipline,66,33,33
Umbrous,ysera,1577,priest,discipline,48,22,26
Decastro,silvermoon,1576,priest,discipline,29,18,11
Rexîfy,zuljin,1576,priest,discipline,75,43,32
Lolweedbro,illidan,1576,priest,discipline,160,90,70
Someonesxy,aggramar,1576,priest,discipline,52,26,26
Staysmall,stormrage,1576,priest,discipline,42,19,23
Taboogie,tichondrius,1576,priest,discipline,84,37,47
Descubra,stormrage,1575,priest,discipline,102,60,42
Blindingstar,area-52,1575,priest,discipline,69,39,30
Nenedada,tichondrius,1575,priest,discipline,75,40,35
Ketapriest,frostmourne,1575,priest,discipline,142,67,75
Roxann,firetree,1574,priest,discipline,59,33,26
Mathits,frostmourne,1574,priest,discipline,36,20,16
Esseks,tichondrius,1574,priest,discipline,42,20,22
Ivf,darrowmere,1574,priest,discipline,137,65,72
Jodaa,sargeras,1574,priest,discipline,48,21,27
Kepp,korgath,1574,priest,discipline,105,45,60
Fleshsack,area-52,1573,priest,discipline,30,17,13
Hopanda,tichondrius,1573,priest,discipline,89,47,42
Madhairy,ragnaros,1573,priest,discipline,198,103,95
Blacklightz,korgath,1573,priest,discipline,133,67,66
Catpictures,stormrage,1573,priest,discipline,54,26,28
Cäpriestsunn,thrall,1572,priest,discipline,36,22,14
Overpriest,ragnaros,1572,priest,discipline,40,22,18
Jerome,tichondrius,1572,priest,discipline,129,68,61
Seriosity,kelthuzad,1572,priest,discipline,54,23,31
Anastasìá,barthilas,1572,priest,discipline,64,23,41
Archeo,area-52,1572,priest,discipline,60,19,41
Madpriest,blades-edge,1571,priest,discipline,36,20,16
Cultxo,sargeras,1571,priest,discipline,92,51,41
Bushybush,darkspear,1571,priest,discipline,120,63,57
Tokaru,frostmourne,1571,priest,discipline,56,26,30
Kencyy,tichondrius,1570,priest,discipline,36,22,14
Suekmydisc,frostmourne,1570,priest,discipline,60,35,25
Slippedadisc,kelthuzad,1570,priest,discipline,126,70,56
Dics,barthilas,1569,priest,discipline,48,31,17
Soõ,tichondrius,1569,priest,discipline,33,21,12
Goo,boulderfist,1569,priest,discipline,48,29,19
Brxddx,sargeras,1569,priest,discipline,131,65,66
Ol,firetree,1569,priest,discipline,57,28,29
Liteztvp,tichondrius,1569,priest,discipline,212,98,114
Zprist,illidan,1569,priest,discipline,72,29,43
Lelyna,stormrage,1568,priest,discipline,36,24,12
Jazmiine,ragnaros,1568,priest,discipline,81,43,38
Holécriss,tichondrius,1568,priest,discipline,173,88,85
Lelenia,tichondrius,1568,priest,discipline,136,68,68
Aleana,ragnaros,1568,priest,discipline,54,25,29
Chinstrap,zuljin,1567,priest,discipline,48,33,15
Padrekevedø,azralon,1567,priest,discipline,42,27,15
Highasf,sargeras,1567,priest,discipline,90,52,38
Feymuhs,blackrock,1567,priest,discipline,90,48,42
Preacharóund,frostmourne,1567,priest,discipline,170,90,80
Karebenniian,area-52,1567,priest,discipline,117,59,58
Fairlightpp,zuljin,1567,priest,discipline,78,39,39
Itsmurphy,sargeras,1567,priest,discipline,156,72,84
Gospels,tichondrius,1566,priest,discipline,52,37,15
Googolplex,tichondrius,1566,priest,discipline,111,64,47
Lavenderism,moon-guard,1566,priest,discipline,132,70,62
Alex,boulderfist,1566,priest,discipline,207,100,107
Kflexx,hydraxis,1566,priest,discipline,158,64,94
Sacredlight,malygos,1565,priest,discipline,123,64,59
Jacksreturne,kelthuzad,1565,priest,discipline,582,297,285
Nayng,tichondrius,1565,priest,discipline,94,44,50
Feivalentine,illidan,1565,priest,discipline,42,17,25
Croissånt,illidan,1564,priest,discipline,36,20,16
Holyclappah,illidan,1564,priest,discipline,305,159,146
Scarabless,bleeding-hollow,1564,priest,discipline,138,62,76
Whateverbrah,tichondrius,1564,priest,discipline,45,20,25
Ppsp,azralon,1563,priest,discipline,47,27,20
Goodvybes,tichondrius,1563,priest,discipline,89,46,43
Myles,alexstrasza,1563,priest,discipline,186,93,93
Hermeneutic,illidan,1563,priest,discipline,57,27,30
Soyul,tichondrius,1563,priest,discipline,47,19,28
Ricekak,haomarush,1562,priest,discipline,102,59,43
Sêlbus,stormrage,1562,priest,discipline,299,154,145
Samirah,arthas,1562,priest,discipline,96,47,49
Zortkis,garithos,1562,priest,discipline,58,25,33
Rustypinball,bleeding-hollow,1561,priest,discipline,117,66,51
Jylertason,kelthuzad,1561,priest,discipline,58,26,32
Antifaithx,frostmourne,1560,priest,discipline,36,21,15
Verna,dunemaul,1560,priest,discipline,97,53,44
Holyvoice,wyrmrest-accord,1560,priest,discipline,75,40,35
Esciel,ragnaros,1560,priest,discipline,140,63,77
Shathraxi,crushridge,1560,priest,discipline,48,21,27
Marethelia,stonemaul,1559,priest,discipline,78,41,37
Idolize,proudmoore,1559,priest,discipline,122,58,64
Moustachío,stormrage,1559,priest,discipline,59,27,32
Sleezi,emerald-dream,1558,priest,discipline,84,49,35
Melitele,magtheridon,1558,priest,discipline,36,21,15
Wöödy,area-52,1558,priest,discipline,46,26,20
Shadyhoe,alterac-mountains,1558,priest,discipline,75,42,33
Vanco,tichondrius,1558,priest,discipline,59,32,27
Twistinfate,hyjal,1558,priest,discipline,119,58,61
Bloottyy,proudmoore,1558,priest,discipline,54,21,33
Bobelgum,emerald-dream,1557,priest,discipline,42,31,11
Qenq,tichondrius,1557,priest,discipline,30,17,13
Zachlol,area-52,1557,priest,discipline,108,61,47
Gucciflops,tichondrius,1557,priest,discipline,48,25,23
Dontgome,proudmoore,1557,priest,discipline,42,21,21
Ropriest,frostmourne,1557,priest,discipline,59,29,30
Zelfina,arthas,1557,priest,discipline,42,20,22
Labraidor,tichondrius,1557,priest,discipline,216,100,116
Datdarnbéar,stormrage,1557,priest,discipline,54,25,29
Chocopp,illidan,1557,priest,discipline,78,33,45
Luxah,bloodhoof,1556,priest,discipline,51,31,20
Qoon,tichondrius,1556,priest,discipline,30,17,13
Koizs,frostmourne,1556,priest,discipline,65,32,33
Vicara,moon-guard,1556,priest,discipline,129,57,72
Tarlonypp,malganis,1555,priest,discipline,45,22,23
Avashar,illidan,1555,priest,discipline,42,20,22
Gustavustus,barthilas,1555,priest,discipline,60,27,33
Sinnskløft,tichondrius,1555,priest,discipline,56,23,33
Ringofvalor,lightnings-blade,1554,priest,discipline,208,112,96
Josquin,illidan,1554,priest,discipline,120,60,60
Marantbourge,frostmourne,1554,priest,discipline,152,74,78
Hiraa,frostmourne,1553,priest,discipline,36,23,13
Kessavannell,frostwolf,1553,priest,discipline,150,83,67
Cario,emerald-dream,1553,priest,discipline,45,24,21
Vullena,moon-guard,1553,priest,discipline,168,88,80
Sïlvermoon,ravencrest,1552,priest,discipline,48,26,22
Gilthðniel,quelthalas,1552,priest,discipline,231,111,120
Grannieslove,sargeras,1551,priest,discipline,48,28,20
Magazíne,tichondrius,1551,priest,discipline,42,23,19
Leliane,tichondrius,1551,priest,discipline,66,35,31
Størmy,kiljaeden,1551,priest,discipline,312,161,151
Sorrowful,mannoroth,1550,priest,discipline,30,19,11
Sensitive,eitrigg,1550,priest,discipline,36,22,14
Unisia,tichondrius,1550,priest,discipline,98,41,57
Rebzyyx,tichondrius,1549,priest,discipline,38,25,13
Senpriest,ragnaros,1549,priest,discipline,35,21,14
Rousesz,ragnaros,1549,priest,discipline,42,23,19
Unholyhand,moon-guard,1549,priest,discipline,126,68,58
Vezaxx,barthilas,1549,priest,discipline,184,96,88
Önagashøw,azralon,1549,priest,discipline,277,140,137
Spacecowboyz,stormrage,1549,priest,discipline,60,30,30
Disperse,vashj,1549,priest,discipline,203,98,105
Imcringing,illidan,1548,priest,discipline,76,46,30
Nisagerx,tichondrius,1548,priest,discipline,33,19,14
Mudshadow,tichondrius,1548,priest,discipline,138,71,67
Nelfpriest,khadgar,1548,priest,discipline,89,44,45
Shadlo,chogall,1548,priest,discipline,48,21,27
Inerluna,tichondrius,1548,priest,discipline,75,31,44
Chillaxin,dreadmaul,1547,priest,discipline,42,25,17
Lyrä,kiljaeden,1547,priest,discipline,143,76,67
Gankdez,kelthuzad,1547,priest,discipline,142,73,69
Azureslaps,tichondrius,1547,priest,discipline,218,109,109
Sevÿ,malygos,1547,priest,discipline,56,28,28
Famemolol,tichondrius,1547,priest,discipline,515,251,264
Frankoizz,quelthalas,1546,priest,discipline,121,64,57
Uriyel,quelthalas,1546,priest,discipline,119,62,57
Rhima,tichondrius,1546,priest,discipline,139,71,68
Discobish,sargeras,1546,priest,discipline,54,23,31
Bóì,barthilas,1545,priest,discipline,36,26,10
Thyrians,ragnaros,1545,priest,discipline,60,37,23
Jtrxyz,tichondrius,1545,priest,discipline,30,18,12
Cléríc,moon-guard,1545,priest,discipline,145,79,66
Shadöwtest,quelthalas,1545,priest,discipline,113,49,64
Juckerr,tichondrius,1544,priest,discipline,251,132,119
Inssania,ragnaros,1544,priest,discipline,65,32,33
Rondrica,stormscale,1543,priest,discipline,54,32,22
Curemeste,illidan,1543,priest,discipline,151,81,70
Matics,tichondrius,1543,priest,discipline,62,33,29
Maomaoangel,tichondrius,1543,priest,discipline,63,30,33
Dawnsy,arygos,1543,priest,discipline,56,26,30
Played,dark-iron,1543,priest,discipline,62,24,38
Happylonely,farstriders,1542,priest,discipline,33,20,13
Bonnieron,frostmourne,1542,priest,discipline,89,46,43
Digop,azralon,1542,priest,discipline,47,22,25
Sëv,stormrage,1542,priest,discipline,47,21,26
Metick,illidan,1542,priest,discipline,48,18,30
Mfynch,sargeras,1541,priest,discipline,114,63,51
Makuwu,area-52,1541,priest,discipline,93,49,44
Healther,firetree,1541,priest,discipline,79,37,42
Slipzie,sargeras,1540,priest,discipline,95,55,40
Qmabayteckkl,tichondrius,1540,priest,discipline,42,23,19
Klowdz,burning-blade,1540,priest,discipline,346,183,163
Voltstein,dalaran,1540,priest,discipline,245,124,121
Galestick,illidan,1540,priest,discipline,36,18,18
Holyhusky,area-52,1539,priest,discipline,60,38,22
Daddydoeet,zuljin,1539,priest,discipline,42,22,20
Discoteqe,korgath,1539,priest,discipline,69,32,37
Akayayuelol,tichondrius,1538,priest,discipline,37,28,9
Besó,proudmoore,1538,priest,discipline,186,104,82
Saentha,sargeras,1538,priest,discipline,80,42,38
Life,thrall,1538,priest,discipline,113,56,57
Brakála,ragnaros,1538,priest,discipline,54,26,28
Priestykro,stormrage,1538,priest,discipline,73,32,41
Mutilla,tichondrius,1537,priest,discipline,32,22,10
Shadowdaddy,barthilas,1537,priest,discipline,96,55,41
Yangpriest,malfurion,1537,priest,discipline,51,26,25
Babirygen,khaz-modan,1537,priest,discipline,48,23,25
Voidrachet,thrall,1537,priest,discipline,48,18,30
Sportsgloss,tichondrius,1536,priest,discipline,132,73,59
Lifeswaplol,kelthuzad,1536,priest,discipline,66,36,30
Calientaeggs,drakkari,1536,priest,discipline,382,202,180
Vemilli,tichondrius,1536,priest,discipline,70,37,33
Valdurai,stormrage,1536,priest,discipline,56,28,28
Psyclicker,zuljin,1536,priest,discipline,47,23,24
Shadowgobbo,thrall,1536,priest,discipline,72,34,38
Nopang,tichondrius,1536,priest,discipline,200,89,111
Priestsz,stormrage,1535,priest,discipline,169,90,79
Supôrte,nemesis,1535,priest,discipline,107,55,52
Santhiel,ragnaros,1535,priest,discipline,42,18,24
Mattkoster,mannoroth,1535,priest,discipline,44,17,27
Djdarkxd,bleeding-hollow,1534,priest,discipline,24,16,8
Hoshx,sargeras,1534,priest,discipline,110,61,49
Shadowglezy,area-52,1534,priest,discipline,113,62,51
Mswatermelon,malganis,1534,priest,discipline,44,24,20
Alaran,magtheridon,1534,priest,discipline,89,43,46
Dopeyspriest,area-52,1534,priest,discipline,50,24,26
Zugzugheal,bleeding-hollow,1534,priest,discipline,111,52,59
Maid,demon-soul,1534,priest,discipline,63,28,35
Anastasiá,barthilas,1534,priest,discipline,48,21,27
Baìter,zuljin,1533,priest,discipline,89,47,42
Wiñtér,tichondrius,1533,priest,discipline,54,28,26
Ajazz,zuljin,1533,priest,discipline,58,30,28
Priesmatco,area-52,1533,priest,discipline,81,40,41
Razledazzled,grizzly-hills,1533,priest,discipline,157,75,82
Nesx,azuremyst,1532,priest,discipline,66,40,26
Bigkey,malganis,1532,priest,discipline,30,18,12
Lydra,ragnaros,1532,priest,discipline,243,114,129
Zsofi,rivendare,1532,priest,discipline,116,54,62
Zinnar,dalaran,1532,priest,discipline,174,79,95
Fámóus,stormrage,1532,priest,discipline,118,47,71
Wbu,frostmourne,1531,priest,discipline,28,17,11
Pryst,bonechewer,1531,priest,discipline,54,28,26
Bubblebuddí,tichondrius,1531,priest,discipline,74,38,36
Vañity,malganis,1531,priest,discipline,66,33,33
Nonbinary,trollbane,1531,priest,discipline,60,26,34
Healthyadult,zuluhed,1530,priest,discipline,30,16,14
Merkinhealz,darkspear,1530,priest,discipline,112,59,53
Emytoty,ragnaros,1530,priest,discipline,190,99,91
Aríola,frostmourne,1529,priest,discipline,69,37,32
Word,korgath,1529,priest,discipline,30,16,14
Skyzaddie,area-52,1529,priest,discipline,55,28,27
Truce,moon-guard,1528,priest,discipline,77,39,38
Bigwap,illidan,1528,priest,discipline,66,30,36
Epijho,area-52,1527,priest,discipline,42,25,17
Durtybubz,tichondrius,1527,priest,discipline,203,115,88
Lightsight,burning-blade,1527,priest,discipline,30,16,14
Luxury,blackrock,1527,priest,discipline,54,27,27
Alëssana,illidan,1526,priest,discipline,128,63,65
Mastahspell,illidan,1526,priest,discipline,36,16,20
Wonpaipri,frostmourne,1526,priest,discipline,110,48,62
Gonchar,bleeding-hollow,1526,priest,discipline,60,26,34
Notwrek,tichondrius,1525,priest,discipline,77,41,36
Voidmutex,emerald-dream,1525,priest,discipline,59,30,29
Ghostchant,thrall,1525,priest,discipline,41,20,21
Pilixil,bleeding-hollow,1525,priest,discipline,72,35,37
Jugeumx,proudmoore,1525,priest,discipline,60,24,36
Meditåtion,tichondrius,1524,priest,discipline,310,159,151
Rómmul,azralon,1524,priest,discipline,71,34,37
Drupmonst,dalaran,1524,priest,discipline,65,30,35
Psÿçhë,stormrage,1524,priest,discipline,36,16,20
Somethingkoo,sargeras,1523,priest,discipline,83,46,37
Sonofbetch,emerald-dream,1523,priest,discipline,55,30,25
Swiggster,thrall,1523,priest,discipline,84,44,40
Tajee,area-52,1523,priest,discipline,319,166,153
Lellos,tichondrius,1523,priest,discipline,36,18,18
Bloodytears,kiljaeden,1523,priest,discipline,138,65,73
Antonietta,drakkari,1522,priest,discipline,24,16,8
Ricopri,frostmourne,1522,priest,discipline,36,23,13
Justashadow,zangarmarsh,1522,priest,discipline,187,101,86
Extel,sargeras,1522,priest,discipline,65,34,31
Sadistic,hyjal,1522,priest,discipline,130,67,63
Niurouchuan,tichondrius,1522,priest,discipline,123,60,63
Lauretânia,nemesis,1522,priest,discipline,146,71,75
Arkeyz,quelthalas,1522,priest,discipline,66,31,35
Zenobiai,hyjal,1521,priest,discipline,163,87,76
Elysiana,wyrmrest-accord,1521,priest,discipline,66,33,33
Arianthe,darrowmere,1521,priest,discipline,44,22,22
Pheener,stormreaver,1521,priest,discipline,198,97,101
Magpul,arthas,1521,priest,discipline,36,16,20
Vhexz,sargeras,1520,priest,discipline,104,68,36
Herder,zuljin,1520,priest,discipline,52,30,22
Hawtzp,stormrage,1520,priest,discipline,49,28,21
Angusb,sargeras,1520,priest,discipline,170,85,85
Ezzy,bleeding-hollow,1520,priest,discipline,54,27,27
Oneinurdome,moknathal,1520,priest,discipline,66,31,35
Vegfem,dalaran,1520,priest,discipline,64,27,37
Intrav,malganis,1519,priest,discipline,29,18,11
Radackan,quelthalas,1519,priest,discipline,123,64,59
Kimjongdots,illidan,1519,priest,discipline,56,29,27
Tyksu,area-52,1519,priest,discipline,228,118,110
Hideyason,area-52,1519,priest,discipline,60,31,29
Zllik,illidan,1519,priest,discipline,101,52,49
Friendzonefw,illidan,1519,priest,discipline,144,71,73
Dædrà,stormrage,1519,priest,discipline,76,37,39
Blessrish,icecrown,1519,priest,discipline,66,31,35
Teamz,illidan,1519,priest,discipline,48,21,27
Akuhei,illidan,1518,priest,discipline,24,16,8
Remuni,tichondrius,1518,priest,discipline,36,20,16
Bugsbright,tichondrius,1518,priest,discipline,364,194,170
Peacewrench,moon-guard,1518,priest,discipline,118,59,59
Sinsuu,tichondrius,1517,priest,discipline,222,122,100
Cexcexyomi,tichondrius,1517,priest,discipline,94,50,44
Joní,malganis,1517,priest,discipline,41,18,23
Melancholies,moon-guard,1517,priest,discipline,43,18,25
Ilickdeadppl,sargeras,1516,priest,discipline,88,50,38
Swapsy,illidan,1516,priest,discipline,53,29,24
Noxientp,bleeding-hollow,1516,priest,discipline,54,27,27
Triangle,draka,1516,priest,discipline,36,17,19
Vels,blackrock,1515,priest,discipline,30,18,12
Justanoutlaw,darkspear,1515,priest,discipline,156,86,70
Dsls,daggerspine,1515,priest,discipline,30,16,14
Undevout,tichondrius,1515,priest,discipline,36,16,20
Stickypriest,dreadmaul,1514,priest,discipline,18,16,2
Defilex,tichondrius,1514,priest,discipline,56,39,17
Shnítzel,thrall,1514,priest,discipline,168,89,79
Thranduil,kiljaeden,1514,priest,discipline,142,75,67
Gamist,area-52,1514,priest,discipline,206,102,104
Vonyka,area-52,1514,priest,discipline,48,23,25
Illuminare,sargeras,1513,priest,discipline,207,105,102
Mettypws,tichondrius,1513,priest,discipline,101,45,56
Mombi,bloodhoof,1512,priest,discipline,48,25,23
Gustáv,sargeras,1512,priest,discipline,72,37,35
Mse,eonar,1511,priest,discipline,48,26,22
Holdentudikz,area-52,1511,priest,discipline,118,55,63
Ulzaar,nerzhul,1511,priest,discipline,89,37,52
Greymatterx,tichondrius,1510,priest,discipline,48,25,23
Manascythe,illidan,1510,priest,discipline,46,22,24
Zroheals,illidan,1510,priest,discipline,107,48,59
Vøidroid,malganis,1509,priest,discipline,168,90,78
Agraheals,barthilas,1509,priest,discipline,42,22,20
Myds,sargeras,1508,priest,discipline,30,24,6
Xtty,thrall,1508,priest,discipline,55,31,24
Sadnez,illidan,1508,priest,discipline,181,100,81
Aleykz,illidan,1508,priest,discipline,101,54,47
Ballzach,ysera,1508,priest,discipline,197,102,95
Mandymuze,barthilas,1508,priest,discipline,77,37,40
Melsebek,stormrage,1508,priest,discipline,58,26,32
Lildeen,area-52,1507,priest,discipline,44,26,18
Huevos,blackwing-lair,1507,priest,discipline,162,88,74
Billzerian,nemesis,1507,priest,discipline,141,75,66
Boujeeheals,darkspear,1507,priest,discipline,48,22,26
Propagàndhi,daggerspine,1507,priest,discipline,158,72,86
Sâishâ,proudmoore,1507,priest,discipline,194,85,109
Ndeezy,malganis,1506,priest,discipline,30,16,14
Diskope,kelthuzad,1505,priest,discipline,24,16,8
Dadcantdeath,frostmourne,1504,priest,discipline,93,51,42
Yaholyfather,aerie-peak,1504,priest,discipline,30,16,14
Pootzy,malganis,1504,priest,discipline,87,36,51
Aleistria,emerald-dream,1503,priest,discipline,60,37,23
Shonkee,tichondrius,1503,priest,discipline,33,20,13
Saren,dethecus,1503,priest,discipline,92,55,37
Lexaprö,moon-guard,1503,priest,discipline,82,46,36
Høllywood,nazgrel,1503,priest,discipline,82,42,40
Khaoticdark,stormrage,1502,priest,discipline,42,23,19
Xillak,ragnaros,1502,priest,discipline,60,29,31
Wisher,tichondrius,1502,priest,discipline,212,99,113
Educated,tichondrius,1502,priest,discipline,44,17,27
Jamesxupttv,draenor,1501,priest,discipline,88,50,38
Artista,quelthalas,1501,priest,discipline,100,54,46
Brian,lightnings-blade,1501,priest,discipline,64,34,30
Ruffhouz,tichondrius,1501,priest,discipline,182,96,86
Gommacura,stormrage,1501,priest,discipline,435,220,215
Yoozi,sargeras,1501,priest,discipline,126,63,63
Sensaye,dalaran,1501,priest,discipline,186,91,95
Compromise,the-scryers,1501,priest,discipline,64,30,34
Xtri,kelthuzad,1500,priest,discipline,36,19,17
Katlø,stormrage,1500,priest,discipline,91,47,44
Winss,tichondrius,1500,priest,discipline,244,124,120
Kaguyä,ragnaros,1500,priest,discipline,101,51,50
Braffuki,frostmourne,1500,priest,discipline,107,54,53
Absørptiøn,area-52,1500,priest,discipline,323,162,161
Somnix,emerald-dream,1499,priest,discipline,140,70,70
Erinzdern,quelthalas,1499,priest,discipline,94,45,49
Temnah,sargeras,1499,priest,discipline,56,26,30
Shunio,illidan,1499,priest,discipline,60,25,35
Vexyy,tichondrius,1498,priest,discipline,56,36,20
Jpray,bleeding-hollow,1498,priest,discipline,121,65,56
Delrey,sargeras,1498,priest,discipline,56,28,28
Daburnz,bleeding-hollow,1498,priest,discipline,156,76,80
Inkders,detheroc,1498,priest,discipline,58,26,32
Ketaminè,tichondrius,1497,priest,discipline,66,37,29
Mistàclean,tichondrius,1497,priest,discipline,101,51,50
Yorp,tichondrius,1497,priest,discipline,72,36,36
Thottee,bleeding-hollow,1497,priest,discipline,120,55,65
Valixia,sargeras,1497,priest,discipline,96,44,52
Venustas,daggerspine,1497,priest,discipline,72,29,43
Prniss,tichondrius,1496,priest,discipline,41,25,16
Notfandy,tichondrius,1496,priest,discipline,54,24,30
Doutoodou,tichondrius,1495,priest,discipline,94,55,39
Icykal,tichondrius,1495,priest,discipline,36,20,16
Mtito,drakkari,1495,priest,discipline,49,27,22
Billymaays,azgalor,1495,priest,discipline,175,96,79
Penummbra,frostmourne,1495,priest,discipline,30,16,14
Amarexlol,stormrage,1495,priest,discipline,60,30,30
Sineater,zuljin,1495,priest,discipline,89,44,45
Legó,illidan,1495,priest,discipline,78,38,40
Winsforgoldd,area-52,1495,priest,discipline,72,32,40
Lily,blackrock,1494,priest,discipline,48,26,22
Oncemore,khazgoroth,1494,priest,discipline,48,24,24
Inveritu,kiljaeden,1494,priest,discipline,59,28,31
Guccísandals,emerald-dream,1494,priest,discipline,43,18,25
Späcehulk,illidan,1494,priest,discipline,55,22,33
Sgiath,alleria,1493,priest,discipline,42,30,12
Healthreat,area-52,1493,priest,discipline,76,42,34
Twinkøgøâøàd,azralon,1493,priest,discipline,30,16,14
Bradythree,moon-guard,1493,priest,discipline,38,20,18
Keyoshe,altar-of-storms,1493,priest,discipline,295,146,149
Boundword,emerald-dream,1493,priest,discipline,145,67,78
Weezyxo,tichondrius,1493,priest,discipline,46,19,27
Ðohko,ragnaros,1492,priest,discipline,60,36,24
Silnetlee,tichondrius,1492,priest,discipline,42,23,19
Phasmaaxd,tichondrius,1492,priest,discipline,95,51,44
Paare,stormrage,1492,priest,discipline,166,86,80
Dbod,tichondrius,1492,priest,discipline,251,126,125
Bubblerwrapp,malganis,1492,priest,discipline,36,17,19
Rezee,kelthuzad,1491,priest,discipline,28,17,11
Constin,doomhammer,1491,priest,discipline,36,20,16
Triggaz,tichondrius,1491,priest,discipline,168,90,78
Kountchocula,illidan,1491,priest,discipline,60,30,30
Saiyana,frostmourne,1491,priest,discipline,178,87,91
Nécrofear,drakkari,1490,priest,discipline,38,23,15
Cobjr,frostmourne,1490,priest,discipline,52,29,23
Eshimä,quelthalas,1490,priest,discipline,192,106,86
Kalilol,tichondrius,1490,priest,discipline,132,61,71
Sjah,whisperwind,1490,priest,discipline,77,33,44
Vìní,azralon,1490,priest,discipline,73,29,44
Saintclac,illidan,1489,priest,discipline,64,41,23
Somberr,dalaran,1489,priest,discipline,47,26,21
Amaranth,the-forgotten-coast,1489,priest,discipline,107,52,55
Azaradet,ragnaros,1489,priest,discipline,147,68,79
Alelith,quelthalas,1489,priest,discipline,59,27,32
Akåsha,zuljin,1489,priest,discipline,128,58,70
Discobluntzz,tichondrius,1488,priest,discipline,54,31,23
Sibble,boulderfist,1488,priest,discipline,101,49,52
Ruminationz,stormrage,1488,priest,discipline,286,135,151
Thelondon,tichondrius,1487,priest,discipline,33,19,14
Bailez,malganis,1487,priest,discipline,69,37,32
Watchemeyolo,tichondrius,1487,priest,discipline,66,35,31
Siddhar,illidan,1487,priest,discipline,73,32,41
Luxyel,azralon,1487,priest,discipline,149,65,84
Coldphobia,uldum,1486,priest,discipline,245,132,113
Windroseh,proudmoore,1486,priest,discipline,60,32,28
Sennaj,sargeras,1486,priest,discipline,53,17,36
Lavazzå,tichondrius,1485,priest,discipline,42,22,20
Kiritomauti,ragnaros,1485,priest,discipline,58,28,30
Priesteen,tichondrius,1485,priest,discipline,42,20,22
Aerdaras,illidan,1485,priest,discipline,80,36,44
Plztrainme,spinebreaker,1485,priest,discipline,36,16,20
Drully,moon-guard,1484,priest,discipline,172,86,86
Chernota,kiljaeden,1484,priest,discipline,108,52,56
Ipód,tichondrius,1483,priest,discipline,33,22,11
Sterycraiied,stormreaver,1483,priest,discipline,110,72,38
Griddly,alterac-mountains,1483,priest,discipline,108,57,51
Dingldangle,tichondrius,1483,priest,discipline,144,70,74
Arzaei,quelthalas,1483,priest,discipline,130,61,69
Prff,ragnaros,1483,priest,discipline,42,19,23
Faxingberlin,sargeras,1483,priest,discipline,52,21,31
Minimelo,stormrage,1482,priest,discipline,41,22,19
Trickyhobo,area-52,1482,priest,discipline,151,80,71
Rháényra,tichondrius,1482,priest,discipline,48,25,23
Nottahealer,anvilmar,1482,priest,discipline,42,20,22
Lumia,quelthalas,1482,priest,discipline,45,19,26
Iinu,tichondrius,1481,priest,discipline,137,72,65
Bakøo,tichondrius,1480,priest,discipline,49,32,17
Pipete,frostmourne,1480,priest,discipline,174,98,76
Draazja,dalaran,1480,priest,discipline,182,92,90
Dontstopxo,lightbringer,1480,priest,discipline,76,37,39
Toxictampax,azjolnerub,1480,priest,discipline,114,55,59
Sstar,area-52,1479,priest,discipline,24,16,8
Holymeta,dunemaul,1479,priest,discipline,78,45,33
Steefe,arygos,1479,priest,discipline,38,21,17
Minii,tichondrius,1479,priest,discipline,103,55,48
Ibangedaqt,malganis,1479,priest,discipline,47,25,22
Eridan,moon-guard,1479,priest,discipline,83,44,39
Randyortonn,tichondrius,1479,priest,discipline,42,22,20
Nvroom,illidan,1479,priest,discipline,55,28,27
Aumsi,illidan,1479,priest,discipline,104,48,56
Slewt,aggramar,1478,priest,discipline,141,82,59
Mintadnade,nemesis,1478,priest,discipline,221,108,113
Mørathy,ragnaros,1477,priest,discipline,72,46,26
Jinxaleyster,ragnaros,1477,priest,discipline,173,96,77
Diableero,barthilas,1477,priest,discipline,89,48,41
Thorzan,eredar,1477,priest,discipline,54,29,25
Jaindoe,illidan,1477,priest,discipline,207,110,97
Shaylari,kelthuzad,1477,priest,discipline,225,110,115
Hydra,ursin,1477,priest,discipline,51,20,31
Jilt,aerie-peak,1476,priest,discipline,114,67,47
Drhutchinson,illidan,1476,priest,discipline,36,21,15
Bushwaker,darkspear,1476,priest,discipline,71,39,32
Shelak,frostmourne,1476,priest,discipline,119,64,55
Zerolyn,tichondrius,1476,priest,discipline,131,70,61
Zenfromwish,frostmourne,1476,priest,discipline,86,43,43
Thadino,nagrand,1476,priest,discipline,126,61,65
Shaytyme,tichondrius,1476,priest,discipline,68,26,42
Hellagud,kargath,1475,priest,discipline,108,62,46
Luanwanx,tichondrius,1475,priest,discipline,91,51,40
Mightydrëk,malganis,1475,priest,discipline,29,16,13
Daelynne,area-52,1475,priest,discipline,34,17,17
Bittyheals,illidan,1475,priest,discipline,48,22,26
Nerfdisc,azralon,1474,priest,discipline,165,85,80
Haizsu,tichondrius,1474,priest,discipline,77,38,39
Dabaksp,area-52,1474,priest,discipline,63,31,32
Dumbboxx,emerald-dream,1474,priest,discipline,72,34,38
Visìons,tichondrius,1474,priest,discipline,66,30,36
Xîîaotong,tichondrius,1473,priest,discipline,37,23,14
Zarfel,ragnaros,1473,priest,discipline,30,18,12
Alyndral,illidan,1473,priest,discipline,50,29,21
Swagndragon,zuljin,1473,priest,discipline,86,42,44
Benin,shattered-hand,1472,priest,discipline,54,28,26
Euphotic,tichondrius,1472,priest,discipline,75,38,37
Marcuse,ragnaros,1472,priest,discipline,115,52,63
Talripington,area-52,1471,priest,discipline,41,25,16
Confesiional,area-52,1471,priest,discipline,71,32,39
Pics,emerald-dream,1471,priest,discipline,60,27,33
Sargasm,darkspear,1470,priest,discipline,27,19,8
Bigtimeplay,tichondrius,1470,priest,discipline,42,25,17
Madjak,lightnings-blade,1470,priest,discipline,138,78,60
Kiddonia,whisperwind,1470,priest,discipline,51,25,26
Suitoo,ragnaros,1470,priest,discipline,78,34,44
Doesine,area-52,1469,priest,discipline,48,28,20
Zjqf,akama,1469,priest,discipline,185,94,91
Travoidicus,wyrmrest-accord,1469,priest,discipline,109,55,54
Apâthy,area-52,1469,priest,discipline,75,35,40
Vacyle,azralon,1468,priest,discipline,174,93,81
Zerola,sargeras,1468,priest,discipline,71,34,37
Dazull,bleeding-hollow,1468,priest,discipline,41,16,25
Dorashadows,tichondrius,1467,priest,discipline,24,17,7
Sandfire,thrall,1467,priest,discipline,30,16,14
Stargoddess,illidan,1467,priest,discipline,168,84,84
Krymze,tichondrius,1467,priest,discipline,36,16,20
Chirimoyacon,ragnaros,1466,priest,discipline,36,25,11
Saxy,quelthalas,1466,priest,discipline,68,38,30
Sistamaggie,bleeding-hollow,1466,priest,discipline,111,58,53
Blodwell,illidan,1466,priest,discipline,133,67,66
Basisc,frostmourne,1465,priest,discipline,219,122,97
Whehaw,kelthuzad,1465,priest,discipline,143,71,72
Wallywanker,illidan,1465,priest,discipline,277,133,144
Aizetsu,sargeras,1464,priest,discipline,36,21,15
Zivn,tichondrius,1464,priest,discipline,814,421,393
Forsakenz,jaedenar,1464,priest,discipline,108,51,57
Tbirdpriest,tichondrius,1463,priest,discipline,58,31,27
Jubalie,guldan,1462,priest,discipline,69,36,33
Yeyoz,tichondrius,1462,priest,discipline,124,60,64
Tmchicken,tichondrius,1462,priest,discipline,42,20,22
Blavkata,area-52,1462,priest,discipline,76,30,46
Tallshiraz,destromath,1461,priest,discipline,76,46,30
Fallenumbra,area-52,1461,priest,discipline,77,44,33
Javox,drakkari,1461,priest,discipline,36,19,17
Chainsalight,stormrage,1461,priest,discipline,156,81,75
Holypuffs,burning-legion,1461,priest,discipline,77,35,42
Peristalsis,nesingwary,1461,priest,discipline,42,19,23
Bloodify,azralon,1461,priest,discipline,121,54,67
Syfy,thrall,1461,priest,discipline,114,48,66
Haetas,zuljin,1461,priest,discipline,41,16,25
Joktips,proudmoore,1460,priest,discipline,174,94,80
Wale,akama,1459,priest,discipline,59,30,29
Forprophet,proudmoore,1459,priest,discipline,76,35,41
Docpriestelf,kelthuzad,1459,priest,discipline,36,16,20
Stynke,bleeding-hollow,1459,priest,discipline,90,31,59
Femìnazzi,ragnaros,1458,priest,discipline,88,48,40
Renewed,frostmourne,1458,priest,discipline,52,28,24
Akovob,tichondrius,1458,priest,discipline,56,28,28
Zaemyn,dalaran,1458,priest,discipline,50,22,28
Sublîme,sargeras,1457,priest,discipline,105,61,44
Kafarmer,frostmourne,1457,priest,discipline,119,68,51
Fleshliight,area-52,1456,priest,discipline,51,31,20
Shykaii,azralon,1456,priest,discipline,108,61,47
Payperbuff,tichondrius,1455,priest,discipline,30,20,10
Tiannatrump,stormrage,1455,priest,discipline,59,34,25
Sappes,area-52,1455,priest,discipline,200,110,90
Bryelx,ragnaros,1455,priest,discipline,270,133,137
Sauile,kelthuzad,1454,priest,discipline,180,99,81
Dib,arathor,1454,priest,discipline,60,31,29
Solkadp,tichondrius,1454,priest,discipline,34,16,18
Hysteria,dalaran,1454,priest,discipline,76,35,41
Modotszilla,bleeding-hollow,1454,priest,discipline,36,16,20
Grimspriest,moon-guard,1453,priest,discipline,47,23,24
Prayf,area-52,1453,priest,discipline,280,137,143
Thoaxx,magtheridon,1453,priest,discipline,54,24,30
Havocshadows,deathwing,1452,priest,discipline,219,129,90
Aubieheal,malygos,1452,priest,discipline,91,50,41
Akash,ragnaros,1452,priest,discipline,71,39,32
Skillfull,chogall,1452,priest,discipline,348,179,169
Jjojae,illidan,1452,priest,discipline,40,20,20
Bobet,zuljin,1452,priest,discipline,73,28,45
Tonesandi,malganis,1451,priest,discipline,42,27,15
Noblesx,illidan,1451,priest,discipline,54,30,24
Spookynun,moon-guard,1450,priest,discipline,216,122,94
Bedläm,kilrogg,1449,priest,discipline,84,44,40
Helarix,malganis,1449,priest,discipline,276,134,142
Eirua,proudmoore,1449,priest,discipline,78,35,43
Nek,malganis,1448,priest,discipline,103,61,42
Spazmode,malganis,1448,priest,discipline,81,43,38
Tomseleck,frostmourne,1448,priest,discipline,35,16,19
Buqisama,barthilas,1448,priest,discipline,114,52,62
Linkolln,sargeras,1447,priest,discipline,36,23,13
Iivelaughluv,kiljaeden,1447,priest,discipline,69,40,29
Welovan,sargeras,1447,priest,discipline,94,52,42
Velzirya,zuljin,1447,priest,discipline,89,39,50
Newchaos,hakkar,1446,priest,discipline,40,24,16
Leviosa,bleeding-hollow,1446,priest,discipline,50,29,21
Battlemage,magtheridon,1446,priest,discipline,111,58,53
Mileslol,azgalor,1446,priest,discipline,68,34,34
Supski,destromath,1446,priest,discipline,42,21,21
Zeusqt,azralon,1445,priest,discipline,180,94,86
Krillan,ysera,1445,priest,discipline,120,61,59
Augustrox,ragnaros,1445,priest,discipline,164,78,86
Aloo,zuljin,1444,priest,discipline,57,37,20
Iavenderism,moon-guard,1444,priest,discipline,54,29,25
Fakechow,nathrezim,1444,priest,discipline,139,71,68
Xeras,misha,1444,priest,discipline,65,29,36
Blakalicious,illidan,1443,priest,discipline,39,27,12
Rvxy,tichondrius,1443,priest,discipline,118,67,51
Neuro,barthilas,1443,priest,discipline,36,19,17
Inot,nemesis,1443,priest,discipline,151,69,82
Jeresh,sargeras,1443,priest,discipline,65,21,44
Napzz,sargeras,1442,priest,discipline,51,30,21
Winnzhor,bonechewer,1442,priest,discipline,100,57,43
Shalters,tichondrius,1442,priest,discipline,60,31,29
Namî,barthilas,1441,priest,discipline,277,151,126
Easypriest,tichondrius,1441,priest,discipline,96,50,46
Sreykalip,frostmourne,1441,priest,discipline,48,24,24
Tëmpting,moon-guard,1441,priest,discipline,68,33,35
Voidathon,sargeras,1441,priest,discipline,36,17,19
Shadowblax,thrall,1441,priest,discipline,166,78,88
Punkndrublic,sargeras,1440,priest,discipline,129,66,63
Docmcstufins,darkspear,1440,priest,discipline,65,31,34
Kristyenna,boulderfist,1440,priest,discipline,42,20,22
Ínfocus,area-52,1440,priest,discipline,138,65,73
Zhatfko,illidan,1440,priest,discipline,78,31,47
Pissgóblin,stormrage,1439,priest,discipline,30,15,15
Littledog,velen,1439,priest,discipline,117,56,61
Scrubx,malganis,1438,priest,discipline,18,15,3
Pretzah,barthilas,1438,priest,discipline,66,50,16
Bohomag,tichondrius,1438,priest,discipline,24,15,9
Magicßoy,magtheridon,1438,priest,discipline,364,191,173
Mason,winterhoof,1437,priest,discipline,24,15,9
Tartapelle,zuljin,1437,priest,discipline,102,54,48
Miaria,chogall,1437,priest,discipline,138,69,69
Joesus,kelthuzad,1437,priest,discipline,38,17,21
Arfaxad,quelthalas,1436,priest,discipline,18,15,3
Càptain,moon-guard,1436,priest,discipline,33,19,14
Vivián,tichondrius,1436,priest,discipline,115,63,52
Miketython,chogall,1436,priest,discipline,33,18,15
Syruhl,tichondrius,1436,priest,discipline,35,16,19
Howdaw,tichondrius,1436,priest,discipline,89,39,50
Pphill,aegwynn,1436,priest,discipline,48,19,29
Floratil,ragnaros,1436,priest,discipline,60,23,37
Raakun,stormrage,1435,priest,discipline,30,16,14
Bootycough,malganis,1435,priest,discipline,63,32,31
Conorpriest,tichondrius,1435,priest,discipline,30,15,15
Sliding,wyrmrest-accord,1435,priest,discipline,30,15,15
Earface,blades-edge,1435,priest,discipline,56,19,37
Addisonraee,tichondrius,1434,priest,discipline,18,15,3
Miix,proudmoore,1434,priest,discipline,18,15,3
Yea,shadow-council,1434,priest,discipline,33,22,11
Baali,moon-guard,1434,priest,discipline,41,27,14
Evpray,area-52,1434,priest,discipline,54,35,19
Xzliak,area-52,1434,priest,discipline,24,15,9
Mosarra,agamaggan,1434,priest,discipline,30,16,14
Luminous,moon-guard,1434,priest,discipline,137,73,64
Ååron,illidan,1434,priest,discipline,88,46,42
Detainedz,malganis,1434,priest,discipline,30,15,15
Meatboxmoldy,blood-furnace,1434,priest,discipline,30,15,15
Scræm,sargeras,1434,priest,discipline,162,72,90
Priestmode,garona,1434,priest,discipline,78,34,44
Remusha,dalaran,1434,priest,discipline,42,16,26
Chumpster,moon-guard,1433,priest,discipline,37,24,13
Juliusceazer,skywall,1433,priest,discipline,157,93,64
Fashion,bleeding-hollow,1433,priest,discipline,60,34,26
Vampiric,laughing-skull,1433,priest,discipline,72,37,35
Giomoreno,tichondrius,1433,priest,discipline,30,15,15
Thalyssarah,azralon,1433,priest,discipline,59,28,31
Zaneshy,azralon,1433,priest,discipline,49,19,30
Amorus,illidan,1432,priest,discipline,60,40,20
Wøo,area-52,1432,priest,discipline,113,60,53
Necrodiva,magtheridon,1432,priest,discipline,84,43,41
Hyoeun,dragonmaw,1432,priest,discipline,30,15,15
Rôôk,kiljaeden,1432,priest,discipline,56,26,30
Fathersean,sargeras,1431,priest,discipline,24,15,9
Lullabya,tichondrius,1431,priest,discipline,24,15,9
Fatherjerry,kiljaeden,1431,priest,discipline,54,33,21
Alexsp,amanthul,1431,priest,discipline,120,65,55
Kuriyasu,emerald-dream,1431,priest,discipline,239,126,113
Swu,tichondrius,1431,priest,discipline,44,18,26
Mateekie,malganis,1430,priest,discipline,60,35,25
Davinatrans,azralon,1430,priest,discipline,111,57,54
Zuss,tichondrius,1430,priest,discipline,52,23,29
Wincenn,moon-guard,1429,priest,discipline,24,15,9
Kwaremont,sargeras,1429,priest,discipline,30,15,15
Tainna,quelthalas,1428,priest,discipline,78,44,34
Elexy,tichondrius,1428,priest,discipline,72,37,35
Beefoverload,durotan,1428,priest,discipline,159,74,85
Solestro,malganis,1428,priest,discipline,36,15,21
Fleische,thrall,1427,priest,discipline,48,27,21
Bakí,hyjal,1427,priest,discipline,32,17,15
Sunenergy,tichondrius,1427,priest,discipline,100,53,47
Cherryfuzz,sargeras,1427,priest,discipline,89,45,44
Scriptz,frostwolf,1427,priest,discipline,78,38,40
Pumtootoot,tichondrius,1427,priest,discipline,36,15,21
Buffrmppls,ragnaros,1427,priest,discipline,36,15,21
Xarid,moon-guard,1426,priest,discipline,36,24,12
Celeztiah,area-52,1426,priest,discipline,24,15,9
Alphe,sargeras,1426,priest,discipline,42,25,17
What,moon-guard,1426,priest,discipline,144,75,69
Empty,frostmourne,1425,priest,discipline,24,18,6
Hugépenance,tichondrius,1425,priest,discipline,30,20,10
Covnite,bloodscalp,1425,priest,discipline,48,26,22
Voicekal,sargeras,1425,priest,discipline,77,41,36
Camisoda,smolderthorn,1425,priest,discipline,34,17,17
Yeshùa,drakkari,1425,priest,discipline,143,71,72
Teeds,stormrage,1425,priest,discipline,69,34,35
Flexxwzkaboo,thrall,1425,priest,discipline,68,33,35
Calcifer,drakkari,1425,priest,discipline,36,16,20
Yözsh,azralon,1425,priest,discipline,63,27,36
Wíckéd,frostmourne,1425,priest,discipline,57,23,34
ßlest,stormrage,1424,priest,discipline,150,84,66
Sinzex,tichondrius,1424,priest,discipline,90,46,44
Roshik,stormrage,1423,priest,discipline,54,33,21
Jjløver,tichondrius,1423,priest,discipline,37,20,17
Shakky,queldorei,1423,priest,discipline,84,37,47
Pungentonion,tichondrius,1423,priest,discipline,36,15,21
Nolan,drakkari,1422,priest,discipline,47,27,20
Zørb,area-52,1422,priest,discipline,54,31,23
Priøst,tichondrius,1422,priest,discipline,75,43,32
Norastanne,moon-guard,1422,priest,discipline,35,19,16
Ohgiddyy,dalaran,1422,priest,discipline,79,38,41
Glorpy,proudmoore,1422,priest,discipline,60,27,33
Tyzrapture,illidan,1422,priest,discipline,53,21,32
Bloatie,zuljin,1421,priest,discipline,42,28,14
Poine,tichondrius,1421,priest,discipline,36,20,16
Sumrand,frostmourne,1421,priest,discipline,30,16,14
Betterheals,tichondrius,1421,priest,discipline,169,88,81
Izikial,illidan,1421,priest,discipline,48,24,24
Holycast,arygos,1420,priest,discipline,24,15,9
Aesudan,dalaran,1420,priest,discipline,93,52,41
Sentactic,illidan,1420,priest,discipline,33,17,16
Idhealthat,tichondrius,1420,priest,discipline,38,19,19
Inmotion,tichondrius,1420,priest,discipline,30,15,15
Ariste,tichondrius,1420,priest,discipline,30,15,15
Mannius,tichondrius,1420,priest,discipline,166,80,86
Compåctdisc,sargeras,1420,priest,discipline,78,37,41
Feloxi,lightnings-blade,1420,priest,discipline,142,65,77
Lîghtsaber,illidan,1420,priest,discipline,69,30,39
Kaeso,magtheridon,1420,priest,discipline,42,16,26
Mosquito,tichondrius,1420,priest,discipline,42,15,27
Eavin,laughing-skull,1419,priest,discipline,482,242,240
Caèlum,area-52,1419,priest,discipline,42,21,21
Brotatochip,andorhal,1419,priest,discipline,49,24,25
Nolar,shadowmoon,1419,priest,discipline,114,51,63
Malavidax,malganis,1419,priest,discipline,108,45,63
Jbtytime,proudmoore,1419,priest,discipline,42,15,27
Ransomm,tichondrius,1418,priest,discipline,28,19,9
Helianna,whisperwind,1418,priest,discipline,223,110,113
Shufflnjoyer,sargeras,1418,priest,discipline,114,54,60
Holyish,proudmoore,1418,priest,discipline,42,19,23
Vundead,tichondrius,1418,priest,discipline,36,16,20
Ammcho,tichondrius,1418,priest,discipline,42,16,26
Boycrazy,nerzhul,1417,priest,discipline,24,15,9
Lebanese,frostmourne,1417,priest,discipline,30,18,12
Ekros,illidan,1417,priest,discipline,40,23,17
Puddín,area-52,1417,priest,discipline,96,47,49
Amarøth,illidan,1417,priest,discipline,36,17,19
Nidüz,stormrage,1417,priest,discipline,156,72,84
Bllaazze,frostwolf,1417,priest,discipline,60,25,35
Nutsin,tichondrius,1417,priest,discipline,36,15,21
Sæýfír,illidan,1416,priest,discipline,68,41,27
Zäelly,moon-guard,1416,priest,discipline,198,100,98
Lethalrosé,thrall,1416,priest,discipline,48,23,25
Tumatauengha,burning-blade,1415,priest,discipline,42,25,17
Bent,gurubashi,1415,priest,discipline,41,22,19
Dagónet,sargeras,1415,priest,discipline,72,38,34
Sungji,tichondrius,1415,priest,discipline,30,15,15
Sasaberry,frostmourne,1415,priest,discipline,169,80,89
Anthoras,stormrage,1414,priest,discipline,36,23,13
Dtsgx,tichondrius,1414,priest,discipline,27,16,11
Kayluhn,area-52,1414,priest,discipline,42,24,18
Soméone,sargeras,1414,priest,discipline,254,132,122
Muromsnel,proudmoore,1414,priest,discipline,132,65,67
Ankhxiety,area-52,1414,priest,discipline,71,33,38
Faerline,kelthuzad,1414,priest,discipline,35,15,20
Aubine,sargeras,1414,priest,discipline,41,15,26
Frogfrompad,tichondrius,1413,priest,discipline,95,55,40
Benedictüs,tichondrius,1413,priest,discipline,202,104,98
Clancygilroy,thrall,1413,priest,discipline,96,47,49
Emmelly,whisperwind,1413,priest,discipline,78,33,45
Daluu,tichondrius,1413,priest,discipline,51,18,33
Snoog,tichondrius,1413,priest,discipline,54,17,37
Feløre,quelthalas,1412,priest,discipline,51,32,19
Sýpha,dalaran,1412,priest,discipline,51,25,26
Accismus,khadgar,1412,priest,discipline,78,37,41
Smegmancer,korgath,1412,priest,discipline,72,34,38
Raileight,illidan,1412,priest,discipline,56,25,31
Rëckful,area-52,1411,priest,discipline,830,417,413
Snoozemaster,cenarius,1411,priest,discipline,30,15,15
Sierrastorms,moon-guard,1411,priest,discipline,30,15,15
Posabilties,bleeding-hollow,1411,priest,discipline,42,20,22
Ihealusall,illidan,1411,priest,discipline,53,23,30
Karmatron,chogall,1411,priest,discipline,42,17,25
Macnabber,malganis,1410,priest,discipline,42,27,15
Finnabustt,tichondrius,1410,priest,discipline,149,70,79
Taiji,whisperwind,1409,priest,discipline,41,31,10
Elsanto,stormrage,1409,priest,discipline,24,15,9
Theboogieman,magtheridon,1409,priest,discipline,134,74,60
Specialed,wildhammer,1409,priest,discipline,82,43,39
Murdock,the-forgotten-coast,1409,priest,discipline,92,48,44
Penetron,tichondrius,1409,priest,discipline,207,105,102
Chaøz,emerald-dream,1408,priest,discipline,71,44,27
Bandèl,tichondrius,1408,priest,discipline,54,32,22
Oomed,bonechewer,1408,priest,discipline,182,96,86
Eatmyfear,quelthalas,1408,priest,discipline,247,122,125
Tiskka,magtheridon,1408,priest,discipline,74,32,42
Midoopriest,proudmoore,1408,priest,discipline,36,15,21
Verchou,shattered-hand,1408,priest,discipline,36,15,21
Fujinpriest,azralon,1408,priest,discipline,45,17,28
Grapeedrank,tichondrius,1407,priest,discipline,51,36,15
Kawin,goldrinn,1407,priest,discipline,101,54,47
Jaeza,azralon,1407,priest,discipline,93,45,48
Ïndis,ragnaros,1407,priest,discipline,40,16,24
Lavvari,durotan,1406,priest,discipline,42,28,14
Dokthekim,frostmourne,1406,priest,discipline,62,34,28
Ünarû,illidan,1406,priest,discipline,120,65,55
Kurobankai,tichondrius,1406,priest,discipline,57,27,30
Unholyshield,frostmourne,1406,priest,discipline,40,18,22
Axelrod,tichondrius,1406,priest,discipline,72,29,43
Seáoflions,aggramar,1405,priest,discipline,24,15,9
Dmlx,frostmourne,1405,priest,discipline,156,90,66
Mangueroide,quelthalas,1405,priest,discipline,123,63,60
Chimiechurro,proudmoore,1405,priest,discipline,90,45,45
Namecusein,ragnaros,1405,priest,discipline,30,15,15
Akkassha,zuljin,1405,priest,discipline,48,22,26
Tryst,the-underbog,1404,priest,discipline,60,37,23
Rxpriest,the-forgotten-coast,1403,priest,discipline,35,18,17
Zawi,zuljin,1403,priest,discipline,127,65,62
Aveil,bloodscalp,1402,priest,discipline,52,33,19
Kjpriest,kelthuzad,1402,priest,discipline,54,34,20
Therialjp,ragnaros,1402,priest,discipline,42,25,17
Izanemi,sargeras,1402,priest,discipline,71,39,32
Heladio,ragnaros,1402,priest,discipline,38,17,21
Discalaneous,tichondrius,1402,priest,discipline,45,20,25
Irais,ragnaros,1402,priest,discipline,45,20,25
Nicety,skywall,1402,priest,discipline,50,22,28
Emotionless,bonechewer,1401,priest,discipline,163,90,73
Saegusa,tichondrius,1401,priest,discipline,94,46,48
Bubbahotep,laughing-skull,1401,priest,discipline,52,25,27
Yishaarj,tichondrius,1401,priest,discipline,53,24,29
Stoutqt,arthas,1400,priest,discipline,36,28,8
Laopao,proudmoore,1400,priest,discipline,71,37,34
Kibariyb,drakkari,1400,priest,discipline,40,19,21
Gðttlich,stormrage,1400,priest,discipline,56,26,30
Stormìst,korgath,1399,priest,discipline,30,18,12
Krané,area-52,1399,priest,discipline,75,41,34
Coldvbs,barthilas,1398,priest,discipline,46,26,20
Guccigriimes,tichondrius,1398,priest,discipline,111,50,61
Zmpr,area-52,1397,priest,discipline,44,30,14
Moonarie,draka,1397,priest,discipline,42,25,17
Namemetwo,malganis,1397,priest,discipline,126,59,67
Jasonlol,sargeras,1396,priest,discipline,47,26,21
Holymagic,lightnings-blade,1396,priest,discipline,193,104,89
Relaax,illidan,1396,priest,discipline,30,15,15
Shiikari,terenas,1396,priest,discipline,30,15,15
Mørphina,azralon,1395,priest,discipline,42,26,16
Rabbix,aggramar,1395,priest,discipline,36,20,16
Jacob,shadowmoon,1395,priest,discipline,171,82,89
Photos,stormrage,1394,priest,discipline,126,71,55
Vøíd,sargeras,1394,priest,discipline,41,23,18
Luffzie,barthilas,1394,priest,discipline,162,85,77
Tikel,ragnaros,1394,priest,discipline,83,43,40
Prilance,hyjal,1394,priest,discipline,36,18,18
Kayzen,frostmourne,1394,priest,discipline,42,19,23
Karminha,azralon,1393,priest,discipline,24,17,7
Undefiled,rexxar,1393,priest,discipline,114,66,48
Megdelight,deathwing,1393,priest,discipline,36,20,16
Icônz,malganis,1393,priest,discipline,59,31,28
Lilblackguys,stormrage,1393,priest,discipline,120,59,61
Voyou,icecrown,1393,priest,discipline,136,62,74
Raggasoca,malganis,1393,priest,discipline,99,44,55
Oprawinfree,tichondrius,1392,priest,discipline,130,72,58
Velastirra,saurfang,1392,priest,discipline,412,210,202
Uhatetoseeit,malganis,1392,priest,discipline,42,15,27
Letkidscome,archimonde,1391,priest,discipline,33,18,15
Tluoc,nemesis,1391,priest,discipline,47,25,22
Ggums,tichondrius,1391,priest,discipline,108,54,54
Heelznfeelz,tichondrius,1391,priest,discipline,51,24,27
Sofluffy,burning-blade,1391,priest,discipline,65,29,36
Necroshine,vashj,1391,priest,discipline,63,26,37
Discrepancy,sargeras,1390,priest,discipline,42,26,16
Smittën,barthilas,1390,priest,discipline,72,40,32
Phayzz,area-52,1390,priest,discipline,123,63,60
Sleepiest,wyrmrest-accord,1390,priest,discipline,65,33,32
Mursey,sargeras,1390,priest,discipline,129,60,69
Beastpriest,dalvengyr,1390,priest,discipline,35,16,19
Moneymurph,blackrock,1390,priest,discipline,44,16,28
Chofis,nathrezim,1389,priest,discipline,36,24,12
Pyta,frostmourne,1389,priest,discipline,68,36,32
Cella,frostmourne,1389,priest,discipline,54,26,28
Burroviejo,quelthalas,1389,priest,discipline,52,24,28
Goseoa,tichondrius,1389,priest,discipline,95,43,52
Triazolam,illidan,1389,priest,discipline,72,29,43
Illen,nemesis,1388,priest,discipline,102,59,43
Soaphia,kelthuzad,1388,priest,discipline,160,91,69
Xyló,area-52,1388,priest,discipline,118,65,53
Tungus,shadowsong,1388,priest,discipline,103,54,49
Itsme,quelthalas,1388,priest,discipline,113,54,59
Psílocybín,icecrown,1387,priest,discipline,62,35,27
Handyheals,frostmourne,1387,priest,discipline,137,73,64
Aimeé,chromaggus,1387,priest,discipline,96,40,56
Astraetus,zuljin,1386,priest,discipline,39,23,16
Krindil,korgath,1386,priest,discipline,107,60,47
Unholywizard,sargeras,1386,priest,discipline,66,37,29
Gimmedomex,tichondrius,1386,priest,discipline,131,72,59
Dlysexic,barthilas,1386,priest,discipline,72,39,33
Ripscrew,area-52,1386,priest,discipline,30,16,14
Strawson,quelthalas,1386,priest,discipline,117,56,61
Kobayashy,ragnaros,1385,priest,discipline,48,29,19
Kevarsin,dalaran,1385,priest,discipline,60,31,29
Scortum,goldrinn,1385,priest,discipline,84,43,41
Kìttý,cenarius,1385,priest,discipline,48,23,25
Laüren,ragnaros,1385,priest,discipline,103,46,57
Atyourcervix,emerald-dream,1384,priest,discipline,32,20,12
Spacelaces,stormrage,1384,priest,discipline,36,22,14
Artiannaa,bleeding-hollow,1384,priest,discipline,102,54,48
Kaonn,frostmourne,1384,priest,discipline,321,167,154
Misfyt,emerald-dream,1384,priest,discipline,78,40,38
Yanye,tichondrius,1384,priest,discipline,161,78,83
Kms,sargeras,1383,priest,discipline,74,41,33
Arkenes,dalaran,1383,priest,discipline,78,41,37
Feedya,tichondrius,1383,priest,discipline,537,263,274
Kerahk,drakkari,1383,priest,discipline,44,20,24
Wholeness,kelthuzad,1383,priest,discipline,48,21,27
Holykushed,tichondrius,1382,priest,discipline,38,19,19
Aurajade,queldorei,1382,priest,discipline,36,18,18
Dessire,ragnaros,1382,priest,discipline,35,17,18
Shrax,emerald-dream,1382,priest,discipline,149,68,81
Sukmysplooge,queldorei,1382,priest,discipline,66,28,38
Èuneekz,thrall,1382,priest,discipline,42,16,26
Sílvia,durotan,1381,priest,discipline,60,28,32
Moresbo,frostmourne,1380,priest,discipline,42,24,18
Itsmaám,moon-guard,1380,priest,discipline,54,30,24
Elagabal,tichondrius,1380,priest,discipline,104,52,52
Spacebeard,tichondrius,1380,priest,discipline,46,22,24
Armî,ragnaros,1380,priest,discipline,82,39,43
Jinniu,azralon,1380,priest,discipline,42,17,25
Pegwraith,sargeras,1379,priest,discipline,64,36,28
Gristus,twisting-nether,1378,priest,discipline,47,27,20
Tyreliy,eitrigg,1378,priest,discipline,199,104,95
Lìlí,tichondrius,1378,priest,discipline,66,34,32
Doggyy,tichondrius,1378,priest,discipline,178,91,87
Joichua,sargeras,1378,priest,discipline,62,30,32
Shadowcrash,zuljin,1378,priest,discipline,36,17,19
Mäe,nemesis,1378,priest,discipline,66,26,40
Doubt,eredar,1377,priest,discipline,34,19,15
Humpbackz,tichondrius,1377,priest,discipline,52,28,24
Oldris,darkspear,1377,priest,discipline,47,25,22
Dominantz,khazgoroth,1377,priest,discipline,96,51,45
Goosemongler,bleeding-hollow,1377,priest,discipline,36,18,18
Kivz,stormrage,1377,priest,discipline,96,47,49
Nightheals,sargeras,1377,priest,discipline,60,27,33
Smallbrains,emerald-dream,1377,priest,discipline,42,16,26
Lexinalis,stormrage,1376,priest,discipline,29,17,12
Bøness,area-52,1376,priest,discipline,142,73,69
Feorlar,tichondrius,1376,priest,discipline,120,56,64
Sixfiggas,darkspear,1375,priest,discipline,24,17,7
Aldrych,malganis,1375,priest,discipline,61,35,26
Rickjames,laughing-skull,1375,priest,discipline,104,58,46
Drinkndrive,tichondrius,1375,priest,discipline,57,30,27
Rufían,quelthalas,1375,priest,discipline,103,49,54
Piskel,vashj,1375,priest,discipline,66,29,37
Fluffsterr,thrall,1374,priest,discipline,42,24,18
Jelzz,area-52,1374,priest,discipline,33,18,15
Tursai,frostmourne,1374,priest,discipline,82,41,41
Yótecuro,quelthalas,1374,priest,discipline,96,43,53
Kwitty,tichondrius,1373,priest,discipline,83,44,39
Palpitine,kiljaeden,1373,priest,discipline,67,35,32
Zombieheals,gundrak,1373,priest,discipline,53,27,26
Quinnx,tichondrius,1373,priest,discipline,54,27,27
Cyphrus,hyjal,1373,priest,discipline,59,28,31
Mäí,ragnaros,1372,priest,discipline,120,67,53
Fanatic,nemesis,1372,priest,discipline,444,229,215
Malpractíce,zuljin,1372,priest,discipline,149,69,80
Halcyon,eonar,1372,priest,discipline,74,34,40
Mauriel,proudmoore,1372,priest,discipline,42,19,23
Rrain,proudmoore,1372,priest,discipline,53,23,30
Avis,illidan,1371,priest,discipline,60,37,23
Zortroz,tichondrius,1371,priest,discipline,28,17,11
Wildmanfrank,tichondrius,1371,priest,discipline,55,33,22
Xaerwolaeth,area-52,1371,priest,discipline,58,29,29
Gnralways,andorhal,1371,priest,discipline,87,41,46
Karazhan,burning-legion,1371,priest,discipline,44,19,25
Methodist,proudmoore,1371,priest,discipline,94,39,55
Miserable,emerald-dream,1371,priest,discipline,101,40,61
Tatereh,illidan,1370,priest,discipline,64,34,30
Endeshealer,suramar,1370,priest,discipline,66,34,32
Jìtters,silvermoon,1370,priest,discipline,42,19,23
Growth,fizzcrank,1370,priest,discipline,72,26,46
Arvida,ragnaros,1369,priest,discipline,66,39,27
Kyoku,tanaris,1369,priest,discipline,47,27,20
Mawlaana,frostmourne,1369,priest,discipline,42,21,21
Gwyneth,whisperwind,1369,priest,discipline,110,49,61
Onjah,kiljaeden,1369,priest,discipline,60,25,35
Jesisapollo,blackrock,1368,priest,discipline,23,15,8
Allivan,frostwolf,1368,priest,discipline,30,19,11
Anymoon,tichondrius,1368,priest,discipline,96,53,43
Zènó,bleeding-hollow,1368,priest,discipline,36,19,17
Bigfirebet,tichondrius,1368,priest,discipline,31,16,15
Slumpbusterx,bonechewer,1368,priest,discipline,296,140,156
Vandaley,tichondrius,1367,priest,discipline,44,28,16
Diabiitus,stormrage,1367,priest,discipline,123,69,54
Ðiplø,tichondrius,1367,priest,discipline,59,32,27
Donzorro,ragnaros,1367,priest,discipline,99,51,48
Rhapsodias,area-52,1366,priest,discipline,24,16,8
Hödü,tichondrius,1366,priest,discipline,48,26,22
Abbot,zangarmarsh,1366,priest,discipline,227,119,108
Haø,stormrage,1366,priest,discipline,360,182,178
Solsano,stormrage,1365,priest,discipline,76,44,32
Purgingsyns,illidan,1364,priest,discipline,56,34,22
Nars,draka,1364,priest,discipline,30,16,14
Míssdank,tichondrius,1364,priest,discipline,42,22,20
Hideyourkids,stormreaver,1364,priest,discipline,83,42,41
Naelsaze,tichondrius,1363,priest,discipline,22,15,7
Shortty,arthas,1363,priest,discipline,36,23,13
Kynsias,stormrage,1363,priest,discipline,27,16,11
Halfyo,dragonmaw,1363,priest,discipline,90,49,41
Holyjibs,moon-guard,1362,priest,discipline,37,26,11
Nepy,stormrage,1362,priest,discipline,93,47,46
Andariel,quelthalas,1361,priest,discipline,54,33,21
Blackbubba,tichondrius,1361,priest,discipline,116,64,52
Temkcalb,ragnaros,1361,priest,discipline,90,46,44
Sinnertitanz,quelthalas,1361,priest,discipline,90,46,44
Rakpriest,nerzhul,1360,priest,discipline,43,29,14
Curasia,drakkari,1360,priest,discipline,57,37,20
Trummp,tichondrius,1359,priest,discipline,75,40,35
Powerwordzz,dragonmaw,1359,priest,discipline,72,36,36
Crucïfïx,stormrage,1358,priest,discipline,70,41,29
Nexoox,drakkari,1358,priest,discipline,42,23,19
Swagmasta,doomhammer,1358,priest,discipline,30,15,15
Ålexánder,quelthalas,1358,priest,discipline,54,23,31
Oniizanagi,thrall,1358,priest,discipline,36,15,21
Replacednewb,chogall,1357,priest,discipline,57,30,27
Khaleth,suramar,1357,priest,discipline,78,38,40
Eiju,proudmoore,1357,priest,discipline,42,19,23
Steezyy,black-dragonflight,1356,priest,discipline,167,91,76
Aerdune,dalaran,1356,priest,discipline,68,36,32
Smirkinlive,illidan,1356,priest,discipline,51,27,24
Hunanbeef,kiljaeden,1356,priest,discipline,112,55,57
Matchakatt,tichondrius,1355,priest,discipline,65,41,24
Kymmei,warsong,1354,priest,discipline,30,15,15
Smileshadowx,frostmourne,1353,priest,discipline,27,16,11
Msdash,tichondrius,1353,priest,discipline,42,23,19
Renews,azralon,1353,priest,discipline,52,28,24
Rêvelation,trollbane,1353,priest,discipline,159,85,74
Vaticly,hyjal,1353,priest,discipline,132,62,70
Langyi,tichondrius,1352,priest,discipline,78,41,37
Chìbiusa,proudmoore,1352,priest,discipline,106,52,54
Ayakoji,proudmoore,1352,priest,discipline,72,34,38
Hootin,whisperwind,1351,priest,discipline,62,35,27
Risedead,azralon,1351,priest,discipline,132,70,62
Djefe,tichondrius,1350,priest,discipline,106,53,53
Starshollow,ragnaros,1350,priest,discipline,117,55,62
Pagän,illidan,1349,priest,discipline,45,25,20
Nøfaith,area-52,1349,priest,discipline,42,23,19
Selenthea,moon-guard,1349,priest,discipline,100,52,48
Padragon,tichondrius,1349,priest,discipline,36,15,21
Beñzi,sargeras,1348,priest,discipline,26,16,10
Rickitz,bleeding-hollow,1348,priest,discipline,60,32,28
Toysqt,sargeras,1348,priest,discipline,29,15,14
Yayoo,exodar,1348,priest,discipline,45,23,22
Howdydoo,azshara,1348,priest,discipline,73,33,40
Skadim,azralon,1348,priest,discipline,156,68,88
Panelopie,maiev,1346,priest,discipline,24,17,7
Gomer,stormrage,1346,priest,discipline,42,24,18
Weakwind,burning-blade,1346,priest,discipline,59,33,26
Giyom,tichondrius,1346,priest,discipline,35,18,17
Eblis,the-underbog,1346,priest,discipline,63,26,37
Xmasmiracle,korgath,1345,priest,discipline,190,107,83
Kerez,skywall,1345,priest,discipline,69,36,33
Pelagius,suramar,1345,priest,discipline,44,19,25
Athëlstân,quelthalas,1345,priest,discipline,36,15,21
ßræcher,black-dragonflight,1344,priest,discipline,36,24,12
Myspacegirl,tichondrius,1344,priest,discipline,43,23,20
Vehlind,quelthalas,1344,priest,discipline,107,55,52
Hoppus,stormrage,1344,priest,discipline,96,47,49
Eziri,goldrinn,1344,priest,discipline,92,45,47
Scaloni,proudmoore,1343,priest,discipline,29,18,11
Textmepls,barthilas,1343,priest,discipline,54,32,22
Swaggie,skullcrusher,1343,priest,discipline,24,14,10
Censyz,tichondrius,1343,priest,discipline,24,14,10
Mthwz,tichondrius,1343,priest,discipline,24,14,10
Elciid,tichondrius,1343,priest,discipline,24,14,10
Fadewench,sargeras,1343,priest,discipline,41,21,20
Lucsor,malganis,1343,priest,discipline,119,60,59
Mitoloshi,ragnaros,1343,priest,discipline,126,61,65
Marywanna,stormrage,1343,priest,discipline,30,14,16
Crazykitsune,thaurissan,1342,priest,discipline,42,27,15
Gabrieleron,quelthalas,1342,priest,discipline,77,48,29
Demimo,frostwolf,1342,priest,discipline,42,25,17
Annefrank,azjolnerub,1342,priest,discipline,24,14,10
Lawroade,tichondrius,1342,priest,discipline,67,36,31
Flab,tichondrius,1342,priest,discipline,34,17,17
Scenekîd,moon-guard,1342,priest,discipline,54,26,28
Spursky,emerald-dream,1341,priest,discipline,18,14,4
Carlita,ravenholdt,1341,priest,discipline,24,14,10
Redcoolaid,moon-guard,1341,priest,discipline,24,14,10
Ophailea,thrall,1341,priest,discipline,70,39,31
Worstpriest,stormscale,1341,priest,discipline,48,24,24
Psyfriend,area-52,1341,priest,discipline,30,14,16
Zoap,stormrage,1341,priest,discipline,60,26,34
Gnomelester,kiljaeden,1340,priest,discipline,36,21,15
Teiam,skullcrusher,1340,priest,discipline,24,14,10
Bathenape,bleeding-hollow,1340,priest,discipline,52,29,23
Phonomena,malganis,1340,priest,discipline,162,85,77
Bionix,stormrage,1340,priest,discipline,72,37,35
Victordaddy,illidan,1340,priest,discipline,30,14,16
Storylord,malganis,1340,priest,discipline,30,14,16
Moralism,moon-guard,1339,priest,discipline,99,60,39
Pactosombrio,azralon,1339,priest,discipline,134,78,56
Huck,khazgoroth,1339,priest,discipline,54,27,27
Rondebarber,thunderlord,1338,priest,discipline,90,47,43
Kallixprime,ragnaros,1338,priest,discipline,105,54,51
Cathiah,darkspear,1338,priest,discipline,271,139,132
Kasiry,ragnaros,1338,priest,discipline,78,38,40
Ucksy,blackrock,1338,priest,discipline,30,14,16
Halcyonzx,tichondrius,1338,priest,discipline,30,14,16
Inmøthep,ragnaros,1338,priest,discipline,92,38,54
Lildubs,bloodhoof,1337,priest,discipline,18,14,4
Seniro,tichondrius,1337,priest,discipline,42,27,15
Kazandraah,quelthalas,1337,priest,discipline,36,23,13
Thoughtcrime,doomhammer,1337,priest,discipline,78,44,34
Zenthaz,thrall,1337,priest,discipline,110,57,53
Muuq,frostmourne,1337,priest,discipline,221,110,111
Cathêlay,bleeding-hollow,1337,priest,discipline,142,70,72
Ricksanchez,moonrunner,1337,priest,discipline,36,17,19
Monâ,sargeras,1337,priest,discipline,30,14,16
Foxspritques,area-52,1337,priest,discipline,58,16,42
Chaseshadow,kelthuzad,1336,priest,discipline,23,18,5
Lilazngirl,stormrage,1336,priest,discipline,30,19,11
Devout,dentarg,1336,priest,discipline,24,14,10
Elrywn,stormrage,1336,priest,discipline,59,26,33
Metagameswag,tichondrius,1335,priest,discipline,24,14,10
Vìrus,jubeithos,1335,priest,discipline,30,17,13
Krukam,sargeras,1335,priest,discipline,84,47,37
Icyspicy,shadowsong,1335,priest,discipline,91,49,42
Nenemsis,drakkari,1335,priest,discipline,50,24,26
Crashed,frostmourne,1335,priest,discipline,60,27,33
Scrubnubz,barthilas,1335,priest,discipline,36,16,20
Shadina,gorefiend,1335,priest,discipline,36,14,22
Spacegrassfx,bleeding-hollow,1334,priest,discipline,36,23,13
Aipata,stormrage,1334,priest,discipline,80,47,33
Pherïox,drakkari,1334,priest,discipline,36,19,17
Talbadontu,thrall,1334,priest,discipline,42,22,20
Erossenin,proudmoore,1334,priest,discipline,30,15,15
Papafuego,stormrage,1333,priest,discipline,18,14,4
Empower,garrosh,1333,priest,discipline,57,34,23
Galnaine,emerald-dream,1333,priest,discipline,24,14,10
Bubblerenew,altar-of-storms,1333,priest,discipline,30,14,16
Rblood,emerald-dream,1332,priest,discipline,54,33,21
Wísh,emerald-dream,1332,priest,discipline,108,65,43
Fatherbrah,kelthuzad,1332,priest,discipline,27,15,12
Devilwithin,moon-guard,1332,priest,discipline,53,29,24
Leprêtre,hakkar,1332,priest,discipline,67,35,32
Phenic,aggramar,1332,priest,discipline,41,18,23
Feltsmaces,shadowmoon,1332,priest,discipline,35,14,21
Layu,azralon,1332,priest,discipline,36,14,22
Oouuh,illidan,1331,priest,discipline,24,14,10
Noveh,tichondrius,1331,priest,discipline,36,17,19
Bigskill,proudmoore,1331,priest,discipline,48,21,27
Fatherßrian,draktharon,1330,priest,discipline,88,49,39
Holyfromrmp,tichondrius,1330,priest,discipline,72,35,37
Decline,balnazzar,1330,priest,discipline,30,14,16
Bøøblover,tichondrius,1329,priest,discipline,36,27,9
Náay,ragnaros,1329,priest,discipline,47,30,17
Vodhka,arthas,1328,priest,discipline,24,14,10
Themoon,tichondrius,1328,priest,discipline,24,14,10
Jeanbi,ragnaros,1328,priest,discipline,42,23,19
Médic,guldan,1328,priest,discipline,39,21,18
Zóe,eredar,1327,priest,discipline,70,37,33
Khyonne,nemesis,1327,priest,discipline,88,44,44
Nêrô,dalaran,1327,priest,discipline,66,29,37
Danrien,azralon,1326,priest,discipline,34,20,14
Effsinstinks,illidan,1326,priest,discipline,24,14,10
Srwilly,ragnaros,1326,priest,discipline,99,52,47
Honypot,ysondre,1326,priest,discipline,101,53,48
Healmedaddyy,korgath,1326,priest,discipline,207,99,108
Healznfeel,tichondrius,1326,priest,discipline,54,23,31
Turrec,illidan,1325,priest,discipline,18,14,4
Mpshield,kiljaeden,1325,priest,discipline,47,27,20
Durgen,stormreaver,1325,priest,discipline,43,20,23
Zapix,tichondrius,1325,priest,discipline,36,15,21
Lalo,bleeding-hollow,1325,priest,discipline,58,23,35
Blessedelf,tichondrius,1325,priest,discipline,66,26,40
Trýíing,nemesis,1324,priest,discipline,38,23,15
Edmust,black-dragonflight,1324,priest,discipline,24,14,10
Coutúre,illidan,1324,priest,discipline,31,17,14
Kintok,tichondrius,1324,priest,discipline,36,19,17
Füuzin,stormrage,1324,priest,discipline,140,70,70
Emmarîl,sargeras,1324,priest,discipline,35,14,21
Plasmax,ragnaros,1324,priest,discipline,56,19,37
Amäo,illidan,1323,priest,discipline,41,23,18
Xerzosh,area-52,1323,priest,discipline,154,81,73
Jaysontatum,gurubashi,1323,priest,discipline,33,17,16
Kaeshia,proudmoore,1322,priest,discipline,36,21,15
Gariell,ragnaros,1322,priest,discipline,24,14,10
Methodist,sargeras,1322,priest,discipline,30,17,13
Dreadpriate,emerald-dream,1321,priest,discipline,172,81,91
Eleeira,zuljin,1321,priest,discipline,48,21,27
Blinxed,tichondrius,1320,priest,discipline,143,69,74
Powerwordshy,area-52,1320,priest,discipline,30,14,16
Sanarion,area-52,1319,priest,discipline,66,39,27
Volkova,quelthalas,1319,priest,discipline,54,30,24
Nadiaxo,moon-guard,1319,priest,discipline,65,35,30
Nøzmonica,kelthuzad,1319,priest,discipline,32,15,17
Instanoodlz,proudmoore,1319,priest,discipline,41,16,25
Chiri,tichondrius,1318,priest,discipline,24,14,10
Ohnotready,tichondrius,1318,priest,discipline,36,18,18
Youngboys,stormreaver,1318,priest,discipline,65,32,33
Raydz,altar-of-storms,1318,priest,discipline,325,156,169
Nellisei,barthilas,1318,priest,discipline,66,27,39
Neutrino,quelthalas,1317,priest,discipline,29,14,15
Rookieone,thrall,1317,priest,discipline,92,44,48
Sackura,quelthalas,1317,priest,discipline,131,62,69
Köto,dalaran,1316,priest,discipline,83,44,39
Rbgeezus,lightnings-blade,1316,priest,discipline,137,72,65
Malevolently,illidan,1316,priest,discipline,137,62,75
Typhia,moon-guard,1315,priest,discipline,24,14,10
Scryden,area-52,1315,priest,discipline,24,14,10
Hustleplay,tichondrius,1315,priest,discipline,48,27,21
Deadlydocc,illidan,1313,priest,discipline,50,32,18
Moontearss,tichondrius,1313,priest,discipline,48,25,23
Holyninfo,quelthalas,1312,priest,discipline,198,102,96
Mindblasterx,kelthuzad,1312,priest,discipline,409,198,211
Darkquinn,boulderfist,1312,priest,discipline,284,132,152
Discgolfsux,sargeras,1312,priest,discipline,68,29,39
Jsuschristix,zuljin,1311,priest,discipline,36,23,13
Peavzian,kiljaeden,1311,priest,discipline,64,30,34
Fearufaraway,tichondrius,1311,priest,discipline,42,17,25
Goodwin,darkspear,1310,priest,discipline,48,29,19
Chloangel,frostmourne,1310,priest,discipline,24,14,10
Conney,mugthol,1310,priest,discipline,24,14,10
Eclìpsè,barthilas,1310,priest,discipline,50,23,27
Slyoda,area-52,1310,priest,discipline,42,19,23
Rhayzel,ragnaros,1309,priest,discipline,120,68,52
Yunganal,sargeras,1309,priest,discipline,30,17,13
Bloo,draktharon,1309,priest,discipline,71,39,32
Malarkie,sargeras,1309,priest,discipline,30,14,16
Healmegently,bonechewer,1309,priest,discipline,86,34,52
Kakera,tichondrius,1308,priest,discipline,24,14,10
Booyâh,muradin,1308,priest,discipline,54,27,27
Aeroz,quelthalas,1308,priest,discipline,48,24,24
Popeofdope,queldorei,1308,priest,discipline,54,24,30
Majesticar,moon-guard,1307,priest,discipline,30,20,10
Rompenepes,drakkari,1307,priest,discipline,24,14,10
Clickbait,spirestone,1307,priest,discipline,24,14,10
Médíc,dalaran,1307,priest,discipline,63,32,31
Pinkhandcuff,gorefiend,1307,priest,discipline,68,34,34
Fìngerbanger,lightnings-blade,1307,priest,discipline,198,98,100
Jinicuil,quelthalas,1307,priest,discipline,54,25,29
Dominie,area-52,1306,priest,discipline,18,14,4
Pahdre,tichondrius,1306,priest,discipline,30,19,11
Discbubbles,moonrunner,1306,priest,discipline,30,18,12
Victrix,tichondrius,1306,priest,discipline,153,66,87
Xedus,mannoroth,1306,priest,discipline,36,15,21
Priestgobrr,emerald-dream,1305,priest,discipline,50,30,20
Mommyshere,vashj,1305,priest,discipline,71,41,30
Ruthlèss,ragnaros,1305,priest,discipline,54,28,26
Filterd,azshara,1305,priest,discipline,30,14,16
Exploded,moon-guard,1305,priest,discipline,85,34,51
Phaille,chromaggus,1304,priest,discipline,253,133,120
Phrìke,illidan,1304,priest,discipline,30,14,16
Nooice,dalaran,1304,priest,discipline,30,14,16
Tarny,tichondrius,1303,priest,discipline,52,32,20
Rahmynpriest,tichondrius,1303,priest,discipline,30,18,12
Dahrwin,thrall,1303,priest,discipline,42,24,18
Vákc,quelthalas,1303,priest,discipline,57,29,28
Webbii,frostmourne,1303,priest,discipline,103,52,51
Testament,greymane,1303,priest,discipline,182,90,92
ßoogey,tichondrius,1303,priest,discipline,47,22,25
Foremender,illidan,1303,priest,discipline,114,47,67
Noopnoop,burning-blade,1302,priest,discipline,29,15,14
Dalowks,area-52,1302,priest,discipline,54,24,30
Poorass,sargeras,1301,priest,discipline,30,19,11
Aedarelyn,ysera,1301,priest,discipline,42,22,20
Slickbakk,illidan,1301,priest,discipline,92,43,49
Helibix,bleeding-hollow,1301,priest,discipline,162,74,88
Evilnyllah,stormrage,1300,priest,discipline,32,20,12
Gurbooz,illidan,1300,priest,discipline,62,35,27
Ktqt,moon-guard,1300,priest,discipline,277,139,138
Pêrsephône,tichondrius,1300,priest,discipline,320,157,163
Priést,stormrage,1300,priest,discipline,45,19,26
Snowly,moonrunner,1299,priest,discipline,43,24,19
Deckardkane,stormrage,1299,priest,discipline,68,33,35
Pkriest,illidan,1299,priest,discipline,60,26,34
Trallyn,emerald-dream,1299,priest,discipline,54,18,36
Franku,quelthalas,1298,priest,discipline,51,33,18
Kantareller,tichondrius,1298,priest,discipline,184,100,84
Sofhya,ragnaros,1298,priest,discipline,124,66,58
Sinnon,turalyon,1298,priest,discipline,36,19,17
Bandagebabe,sargeras,1298,priest,discipline,36,15,21
Timeglass,kelthuzad,1297,priest,discipline,47,26,21
Mechahomo,dalaran,1297,priest,discipline,52,28,24
Ahane,wyrmrest-accord,1297,priest,discipline,66,31,35
Zephxd,illidan,1296,priest,discipline,97,49,48
Sòraka,tichondrius,1296,priest,discipline,130,65,65
Dabbinton,chogall,1296,priest,discipline,52,26,26
Hydramîst,ragnaros,1296,priest,discipline,36,15,21
Pottime,tichondrius,1295,priest,discipline,50,30,20
Iloveshannon,stormrage,1295,priest,discipline,45,25,20
Fenian,frostmourne,1295,priest,discipline,123,60,63
Nylaza,kiljaeden,1295,priest,discipline,77,32,45
Anastasius,lightbringer,1294,priest,discipline,23,20,3
Vyndïllïn,tichondrius,1294,priest,discipline,23,14,9
Kikyo,antonidas,1294,priest,discipline,49,22,27
Travita,quelthalas,1293,priest,discipline,54,29,25
Orìsel,wyrmrest-accord,1293,priest,discipline,159,76,83
Dadthegreat,bonechewer,1292,priest,discipline,42,25,17
Ryboski,sargeras,1292,priest,discipline,53,30,23
Poilu,laughing-skull,1292,priest,discipline,43,24,19
Usmond,azralon,1292,priest,discipline,48,23,25
Spitefuldirk,dalaran,1291,priest,discipline,24,16,8
Shadowmiilf,illidan,1291,priest,discipline,24,14,10
Pico,spirestone,1291,priest,discipline,123,66,57
Unfriend,sargeras,1291,priest,discipline,48,22,26
Rakket,moon-guard,1291,priest,discipline,36,16,20
Spõt,stormrage,1291,priest,discipline,63,26,37
Soulclap,sargeras,1291,priest,discipline,35,14,21
Kinhilo,ragnaros,1291,priest,discipline,72,27,45
Lunett,area-52,1291,priest,discipline,52,19,33
Lyxx,kelthuzad,1290,priest,discipline,22,15,7
Angelicus,ragnaros,1290,priest,discipline,410,209,201
Avarice,magtheridon,1289,priest,discipline,40,24,16
Chîna,hyjal,1289,priest,discipline,271,149,122
Cubski,darkspear,1289,priest,discipline,31,15,16
Leejungjae,tichondrius,1289,priest,discipline,63,29,34
Ermec,azralon,1289,priest,discipline,51,22,29
Loki,uldaman,1289,priest,discipline,69,27,42
Bandaidvibes,tichondrius,1288,priest,discipline,30,18,12
Blaydun,elune,1288,priest,discipline,128,72,56
Jaskil,skywall,1288,priest,discipline,118,62,56
Troublmaker,illidan,1288,priest,discipline,46,24,22
Bibops,area-52,1288,priest,discipline,37,15,22
Prignues,tichondrius,1287,priest,discipline,30,20,10
Bbm,stormscale,1287,priest,discipline,105,52,53
Poefosho,stormrage,1287,priest,discipline,307,152,155
Tûbes,trollbane,1287,priest,discipline,125,51,74
Thalladori,area-52,1286,priest,discipline,28,17,11
Kadkne,stormrage,1286,priest,discipline,53,30,23
Kencys,tichondrius,1286,priest,discipline,28,15,13
Iwonthealu,senjin,1286,priest,discipline,30,16,14
Prelate,moon-guard,1286,priest,discipline,36,15,21
Rôxxy,thrall,1285,priest,discipline,48,27,21
Brounly,drakkari,1285,priest,discipline,72,36,36
Boibussy,tichondrius,1285,priest,discipline,36,15,21
Dolm,tichondrius,1284,priest,discipline,250,124,126
Vineller,malganis,1284,priest,discipline,38,15,23
Voidmaker,area-52,1284,priest,discipline,48,17,31
Antxres,sargeras,1283,priest,discipline,29,14,15
Penancepapi,stormrage,1283,priest,discipline,30,14,16
Fesix,akama,1282,priest,discipline,48,27,21
Boojanglez,exodar,1282,priest,discipline,48,25,23
Rotass,hyjal,1282,priest,discipline,106,55,51
Súlfuro,quelthalas,1282,priest,discipline,131,65,66
Ragnarøk,warsong,1282,priest,discipline,42,17,25
Canharm,tichondrius,1282,priest,discipline,73,29,44
Presto,kalecgos,1281,priest,discipline,24,19,5
Crackneesha,tichondrius,1281,priest,discipline,30,19,11
Whitezz,frostmourne,1281,priest,discipline,60,34,26
Dismybracket,tichondrius,1281,priest,discipline,42,20,22
Warmth,moon-guard,1280,priest,discipline,123,64,59
Touchér,whisperwind,1280,priest,discipline,29,14,15
Briefs,stormrage,1278,priest,discipline,21,15,6
Goingserious,frostmourne,1278,priest,discipline,189,104,85
Bloodsorrow,ragnaros,1278,priest,discipline,72,39,33
Radgars,frostmourne,1278,priest,discipline,61,31,30
Kakao,stormreaver,1278,priest,discipline,120,51,69
Slimshieldy,illidan,1277,priest,discipline,28,15,13
Revreal,thrall,1277,priest,discipline,106,52,54
Morningzz,tichondrius,1277,priest,discipline,139,64,75
Mëïsoön,quelthalas,1276,priest,discipline,29,15,14
Endereth,skullcrusher,1276,priest,discipline,354,158,196
Fairylìght,stormrage,1276,priest,discipline,73,27,46
Ttakayasu,bleeding-hollow,1275,priest,discipline,180,102,78
Lowkii,malfurion,1275,priest,discipline,35,17,18
Gäindalt,tichondrius,1274,priest,discipline,48,25,23
Inferis,ragnaros,1274,priest,discipline,411,207,204
Zenjitsu,quelthalas,1274,priest,discipline,36,15,21
Dottinu,area-52,1273,priest,discipline,30,23,7
Gungagingong,queldorei,1273,priest,discipline,84,47,37
Ðiviniti,moon-guard,1273,priest,discipline,46,24,22
Icetraygang,suramar,1272,priest,discipline,425,224,201
Medo,dalaran,1272,priest,discipline,88,46,42
Strict,the-forgotten-coast,1272,priest,discipline,29,14,15
Braindrip,thrall,1272,priest,discipline,54,25,29
Drilbitt,jaedenar,1271,priest,discipline,21,15,6
Rashad,proudmoore,1271,priest,discipline,107,59,48
Toorshul,tichondrius,1271,priest,discipline,65,35,30
Lodekiim,tichondrius,1271,priest,discipline,48,24,24
Flatëarth,tichondrius,1271,priest,discipline,406,193,213
Tuoday,agamaggan,1271,priest,discipline,33,15,18
Kìn,tol-barad,1271,priest,discipline,54,22,32
Markspell,stormrage,1270,priest,discipline,145,77,68
Derlanger,frostmourne,1270,priest,discipline,48,25,23
Foose,suramar,1270,priest,discipline,48,23,25
Leya,kiljaeden,1269,priest,discipline,30,22,8
Cilpri,emerald-dream,1269,priest,discipline,25,14,11
Twotimechamp,azshara,1269,priest,discipline,50,26,24
Termiina,hyjal,1269,priest,discipline,85,41,44
Theheal,ragnaros,1269,priest,discipline,63,21,42
Eluko,tichondrius,1268,priest,discipline,33,18,15
Forliang,proudmoore,1268,priest,discipline,27,14,13
Lätöxïkä,alleria,1268,priest,discipline,65,33,32
Jjayleroux,hyjal,1268,priest,discipline,54,26,28
Holyrotape,nemesis,1268,priest,discipline,87,38,49
Lifeswap,area-52,1268,priest,discipline,97,42,55
Dispelbot,kelthuzad,1267,priest,discipline,164,93,71
Sojumike,proudmoore,1267,priest,discipline,60,31,29
Aggravating,mugthol,1267,priest,discipline,176,89,87
Iseeyoulookn,stormrage,1266,priest,discipline,41,24,17
Miraz,the-venture-co,1266,priest,discipline,53,29,24
Boocharni,wyrmrest-accord,1266,priest,discipline,92,50,42
Xavaat,nerzhul,1266,priest,discipline,84,38,46
Releknosleep,frostwolf,1266,priest,discipline,31,14,17
Nometh,emerald-dream,1266,priest,discipline,90,38,52
Atemlos,malorne,1265,priest,discipline,42,24,18
Elixia,maiev,1265,priest,discipline,76,40,36
Penitentrowr,illidan,1265,priest,discipline,77,40,37
Deadlykíss,sargeras,1265,priest,discipline,54,26,28
Docvalentino,malganis,1264,priest,discipline,24,14,10
Cromekolo,tichondrius,1264,priest,discipline,33,19,14
Karnival,aggramar,1264,priest,discipline,48,23,25
Lanakill,hyjal,1264,priest,discipline,80,38,42
Welorian,mannoroth,1264,priest,discipline,91,42,49
Keskima,malganis,1263,priest,discipline,87,54,33
Jahsheer,kiljaeden,1263,priest,discipline,26,16,10
Kethal,area-52,1263,priest,discipline,37,19,18
Koide,moon-guard,1263,priest,discipline,48,23,25
Butdidüdie,tichondrius,1263,priest,discipline,54,24,30
Samàél,frostmourne,1262,priest,discipline,59,27,32
Saràh,stormscale,1262,priest,discipline,94,43,51
Reindharth,quelthalas,1262,priest,discipline,90,38,52
Kristt,thrall,1262,priest,discipline,41,16,25
Emlix,tichondrius,1262,priest,discipline,42,14,28
Belletrael,wyrmrest-accord,1261,priest,discipline,77,39,38
Ghettobarbie,kelthuzad,1260,priest,discipline,36,22,14
Vanszz,area-52,1260,priest,discipline,54,26,28
Mynigajeff,zuljin,1259,priest,discipline,104,50,54
Greif,garrosh,1259,priest,discipline,54,25,29
Heniupriest,tichondrius,1259,priest,discipline,48,22,26
Alawn,wyrmrest-accord,1259,priest,discipline,120,52,68
Atelios,azralon,1258,priest,discipline,30,20,10
Quasenada,stormrage,1258,priest,discipline,23,14,9
Kymosolop,sargeras,1258,priest,discipline,25,14,11
Skall,kirin-tor,1258,priest,discipline,41,21,20
Capricornio,nemesis,1258,priest,discipline,60,30,30
Saadboii,thrall,1257,priest,discipline,61,31,30
Themøn,quelthalas,1257,priest,discipline,36,18,18
Dralaan,proudmoore,1257,priest,discipline,92,44,48
Kenzao,nemesis,1257,priest,discipline,64,30,34
Lge,kelthuzad,1257,priest,discipline,31,14,17
Kethseth,ragnaros,1257,priest,discipline,137,61,76
Dartonya,thrall,1257,priest,discipline,36,15,21
Hawktalonuke,moon-guard,1256,priest,discipline,90,50,40
Nìght,trollbane,1256,priest,discipline,102,54,48
Grudgin,turalyon,1255,priest,discipline,41,24,17
Boostvoid,terenas,1255,priest,discipline,299,158,141
Knifê,moon-guard,1255,priest,discipline,108,54,54
Kauldër,illidan,1255,priest,discipline,58,21,37
Norriam,moon-guard,1254,priest,discipline,41,27,14
Thotznprayrz,bleeding-hollow,1254,priest,discipline,36,23,13
Sureno,muradin,1254,priest,discipline,66,36,30
Dotersacer,quelthalas,1254,priest,discipline,55,29,26
Ðelight,ragnaros,1254,priest,discipline,72,36,36
Chavkoraken,stormrage,1254,priest,discipline,38,15,23
Adaele,ragnaros,1253,priest,discipline,96,50,46
Saviorsélf,tichondrius,1253,priest,discipline,162,76,86
Lampfood,alterac-mountains,1253,priest,discipline,42,18,24
Snowinvan,tichondrius,1252,priest,discipline,124,62,62
Snevini,azralon,1252,priest,discipline,72,35,37
Kinkykween,tichondrius,1252,priest,discipline,30,14,16
Nightmxs,tichondrius,1252,priest,discipline,54,25,29
Këyglock,kelthuzad,1252,priest,discipline,252,111,141
Dosarix,sargeras,1250,priest,discipline,40,23,17
Zumanîty,zangarmarsh,1249,priest,discipline,24,15,9
Eirenth,bleeding-hollow,1249,priest,discipline,58,35,23
Zaroki,sargeras,1249,priest,discipline,24,14,10
Eneco,alleria,1249,priest,discipline,315,166,149
Cvstodia,tichondrius,1249,priest,discipline,42,22,20
Armspriest,stormrage,1249,priest,discipline,71,37,34
Tmspongwo,tichondrius,1248,priest,discipline,30,21,9
Sophistdew,proudmoore,1248,priest,discipline,46,23,23
Curiosities,kiljaeden,1248,priest,discipline,30,13,17
Holycwap,stormrage,1248,priest,discipline,45,14,31
Iatemykids,tichondrius,1247,priest,discipline,24,13,11
Thokrül,lightbringer,1247,priest,discipline,51,27,24
Lvcia,thrall,1247,priest,discipline,70,35,35
Redkiwi,illidan,1247,priest,discipline,30,13,17
Calamithus,illidan,1247,priest,discipline,30,13,17
Pianohouse,illidan,1247,priest,discipline,30,13,17
Shinomiko,frostmourne,1247,priest,discipline,218,93,125
Pce,korialstrasz,1247,priest,discipline,34,13,21
Holyycrit,kelthuzad,1246,priest,discipline,70,38,32
Picurry,frostmourne,1246,priest,discipline,24,13,11
Peacetreaty,bleeding-hollow,1246,priest,discipline,24,13,11
Spellpower,azralon,1246,priest,discipline,53,27,26
Crawly,illidan,1246,priest,discipline,137,63,74
Iol,spinebreaker,1246,priest,discipline,30,13,17
Physics,frostmane,1246,priest,discipline,30,13,17
Strippadora,azralon,1245,priest,discipline,18,13,5
Keepfit,proudmoore,1245,priest,discipline,52,29,23
Casstiell,proudmoore,1245,priest,discipline,62,30,32
Aanora,illidan,1245,priest,discipline,43,19,24
Youaint,sargeras,1245,priest,discipline,30,13,17
Epophy,stormrage,1244,priest,discipline,18,13,5
Elivice,ragnaros,1244,priest,discipline,24,13,11
Vancake,quelthalas,1244,priest,discipline,251,119,132
Tubrisildris,zuljin,1244,priest,discipline,30,13,17
Seí,barthilas,1244,priest,discipline,30,13,17
Bingoreferee,kelthuzad,1243,priest,discipline,24,13,11
Mkx,illidan,1243,priest,discipline,24,13,11
Cypress,dreadmaul,1243,priest,discipline,180,97,83
Hanuloa,tichondrius,1243,priest,discipline,150,76,74
Amorathin,darkspear,1243,priest,discipline,42,21,21
Carboload,thrall,1243,priest,discipline,30,13,17
Cyaja,moon-guard,1243,priest,discipline,31,13,18
Meiev,quelthalas,1243,priest,discipline,36,13,23
Deagled,tichondrius,1243,priest,discipline,36,13,23
Okiin,malganis,1243,priest,discipline,36,13,23
Dragndatwagn,malganis,1242,priest,discipline,99,50,49
Grapës,jubeithos,1242,priest,discipline,48,23,25
Matafuka,ragnaros,1242,priest,discipline,57,27,30
Breeannà,doomhammer,1242,priest,discipline,34,16,18
Cajl,dathremar,1242,priest,discipline,185,86,99
Cuddly,shandris,1242,priest,discipline,119,54,65
Döyöuliftbro,tichondrius,1242,priest,discipline,30,13,17
Touchyouboy,stormrage,1242,priest,discipline,35,15,20
Keleset,area-52,1242,priest,discipline,36,13,23
Quickq,barthilas,1241,priest,discipline,42,24,18
Olibreaker,tichondrius,1241,priest,discipline,24,13,11
Healaryduff,skullcrusher,1241,priest,discipline,24,13,11
Frotters,kiljaeden,1241,priest,discipline,24,13,11
Zadae,area-52,1241,priest,discipline,92,49,43
Moresex,azralon,1241,priest,discipline,85,43,42
Harborcoat,whisperwind,1241,priest,discipline,35,14,21
Tubz,boulderfist,1241,priest,discipline,36,13,23
Wantsumcandy,illidan,1240,priest,discipline,102,61,41
Kapriestun,tichondrius,1240,priest,discipline,85,47,38
Ruaba,area-52,1240,priest,discipline,24,13,11
Datspice,stormrage,1240,priest,discipline,24,13,11
Gabanzyta,azralon,1240,priest,discipline,24,13,11
Thiella,azralon,1240,priest,discipline,24,13,11
Biggerstaff,icecrown,1240,priest,discipline,33,16,17
Rando,shattered-halls,1240,priest,discipline,59,28,31
Arodar,wyrmrest-accord,1240,priest,discipline,30,14,16
Voodooloa,tichondrius,1240,priest,discipline,96,36,60
Runemidgard,illidan,1239,priest,discipline,43,26,17
Sadury,tichondrius,1239,priest,discipline,246,135,111
Discyple,ysera,1239,priest,discipline,47,24,23
Raisonpriest,tichondrius,1239,priest,discipline,224,106,118
Sunwalken,stormrage,1239,priest,discipline,30,13,17
Playdohxz,frostmourne,1239,priest,discipline,42,13,29
Daegal,malfurion,1238,priest,discipline,18,13,5
Mosher,zuluhed,1238,priest,discipline,24,16,8
Saviorkaï,barthilas,1238,priest,discipline,45,25,20
Exgirlfren,tichondrius,1238,priest,discipline,24,13,11
Tunare,dalaran,1238,priest,discipline,24,13,11
Barrieroflig,tichondrius,1238,priest,discipline,51,27,24
Misaosan,azralon,1238,priest,discipline,60,29,31
Fumes,ghostlands,1238,priest,discipline,138,66,72
Wisher,gorefiend,1237,priest,discipline,53,29,24
Masochist,barthilas,1237,priest,discipline,152,83,69
Jesstor,frostmourne,1237,priest,discipline,24,13,11
Xuxao,azralon,1237,priest,discipline,35,15,20
Tdmheals,zuluhed,1236,priest,discipline,36,25,11
Holycoww,lightnings-blade,1236,priest,discipline,24,13,11
Whitesharks,tichondrius,1236,priest,discipline,24,13,11
Holyren,sargeras,1236,priest,discipline,134,69,65
Hellsembrace,lightbringer,1236,priest,discipline,30,13,17
Naniwa,ragnaros,1236,priest,discipline,39,16,23
Mikori,tichondrius,1235,priest,discipline,18,13,5
Nerylia,stormrage,1235,priest,discipline,18,13,5
Kideater,quelthalas,1235,priest,discipline,24,13,11
Bonkerwaffle,kelthuzad,1235,priest,discipline,54,29,25
Duatneter,quelthalas,1235,priest,discipline,84,39,45
Rhennythal,tichondrius,1235,priest,discipline,30,13,17
Tossôff,proudmoore,1234,priest,discipline,18,13,5
Lyrynne,emerald-dream,1234,priest,discipline,24,16,8
Awyn,elune,1234,priest,discipline,48,25,23
Hobbs,trollbane,1234,priest,discipline,48,24,24
Léto,burning-blade,1234,priest,discipline,48,21,27
Chervz,chogall,1234,priest,discipline,30,13,17
Miznewbooty,garona,1233,priest,discipline,30,17,13
Ickarus,anubarak,1233,priest,discipline,90,49,41
Sichuankeith,frostmourne,1233,priest,discipline,24,13,11
Kinkypriest,tichondrius,1233,priest,discipline,24,13,11
Anöa,emerald-dream,1233,priest,discipline,36,16,20
Glitterballs,khazgoroth,1232,priest,discipline,24,13,11
Tigop,alleria,1232,priest,discipline,24,13,11
Alarind,kelthuzad,1232,priest,discipline,32,17,15
Kuroyanagi,ragnaros,1232,priest,discipline,36,13,23
Xora,frostmourne,1232,priest,discipline,36,13,23
Ihealyoudeal,korgath,1231,priest,discipline,30,17,13
Demimang,emerald-dream,1231,priest,discipline,30,13,17
Holyxb,bleeding-hollow,1231,priest,discipline,36,13,23
Shïtheals,frostmourne,1230,priest,discipline,42,25,17
Krypticus,tichondrius,1230,priest,discipline,66,37,29
Jeffo,baelgun,1230,priest,discipline,84,47,37
Tenchü,azralon,1230,priest,discipline,38,18,20
Alenio,sargeras,1230,priest,discipline,30,14,16
Ón,tichondrius,1230,priest,discipline,30,13,17
Lynnar,stormrage,1229,priest,discipline,91,54,37
Riotgearmd,sargeras,1229,priest,discipline,30,17,13
Wanaatlarboy,dark-iron,1229,priest,discipline,41,23,18
Bröke,nemesis,1229,priest,discipline,144,75,69
Klingande,tichondrius,1229,priest,discipline,81,41,40
Lichae,ragnaros,1229,priest,discipline,48,24,24
Yürika,emerald-dream,1229,priest,discipline,168,73,95
Kodaks,frostmourne,1228,priest,discipline,99,50,49
Mxrru,stonemaul,1228,priest,discipline,166,82,84
Darkills,tichondrius,1228,priest,discipline,33,13,20
Kractdp,tichondrius,1228,priest,discipline,47,18,29
Aape,frostmourne,1227,priest,discipline,24,13,11
Swolequadz,elune,1227,priest,discipline,38,20,18
Senliastra,medivh,1226,priest,discipline,30,18,12
Notdavido,illidan,1226,priest,discipline,48,26,22
Yotinha,nemesis,1226,priest,discipline,24,13,11
Healtomuch,nagrand,1226,priest,discipline,148,73,75
Pavarotti,laughing-skull,1226,priest,discipline,44,19,25
Gurbooz,tichondrius,1225,priest,discipline,77,35,42
Zouras,garona,1225,priest,discipline,40,18,22
Bendoverbb,tichondrius,1225,priest,discipline,30,13,17
Gäindalf,tichondrius,1224,priest,discipline,22,14,8
Londy,area-52,1224,priest,discipline,106,51,55
Celf,ragnaros,1224,priest,discipline,42,16,26
Hpriest,barthilas,1224,priest,discipline,35,13,22
Kälashnikova,ragnaros,1223,priest,discipline,51,28,23
Castnngcouch,tichondrius,1223,priest,discipline,217,103,114
Ahitaro,ragnaros,1223,priest,discipline,60,18,42
Aud,kiljaeden,1222,priest,discipline,18,14,4
Kummar,burning-blade,1222,priest,discipline,24,13,11
Kosiris,stormrage,1222,priest,discipline,102,41,61
Hoffmanx,emerald-dream,1221,priest,discipline,24,13,11
Hymn,zuljin,1221,priest,discipline,30,16,14
Exigyo,quelthalas,1221,priest,discipline,27,14,13
Dittless,stormrage,1221,priest,discipline,60,29,31
Beecakes,illidan,1220,priest,discipline,29,16,13
Dårc,tichondrius,1220,priest,discipline,125,64,61
Jestiann,aegwynn,1220,priest,discipline,275,139,136
Pòba,malganis,1220,priest,discipline,30,13,17
Aerîs,magtheridon,1220,priest,discipline,46,19,27
Gdlsheretic,sargeras,1219,priest,discipline,24,13,11
Séraphin,proudmoore,1219,priest,discipline,37,16,21
Gdessairmed,exodar,1219,priest,discipline,49,21,28
Jic,barthilas,1219,priest,discipline,66,25,41
Snekboy,hakkar,1218,priest,discipline,78,45,33
Nonamegame,sargeras,1218,priest,discipline,78,42,36
Wrathchildd,azralon,1218,priest,discipline,156,78,78
Pyper,medivh,1218,priest,discipline,29,14,15
Chopstix,senjin,1218,priest,discipline,35,16,19
Gobnik,illidan,1217,priest,discipline,42,26,16
Yvága,ragnaros,1217,priest,discipline,48,27,21
Forestpriest,area-52,1217,priest,discipline,24,13,11
Pacopriest,tichondrius,1217,priest,discipline,24,13,11
Alexena,senjin,1217,priest,discipline,49,23,26
Khamata,kelthuzad,1216,priest,discipline,46,22,24
Novous,area-52,1216,priest,discipline,68,29,39
Göats,emerald-dream,1215,priest,discipline,24,13,11
Rohee,illidan,1215,priest,discipline,84,43,41
Mob,garona,1215,priest,discipline,38,17,21
Russbell,ragnaros,1215,priest,discipline,131,57,74
Plznokill,tichondrius,1215,priest,discipline,60,26,34
Eîr,tichondrius,1215,priest,discipline,72,29,43
Vandwrath,moon-guard,1214,priest,discipline,24,14,10
Såge,chogall,1214,priest,discipline,326,167,159
Myvanwy,silvermoon,1214,priest,discipline,30,13,17
Capnjazz,illidan,1213,priest,discipline,36,13,23
Xpera,dalaran,1212,priest,discipline,209,100,109
Nóin,tichondrius,1212,priest,discipline,72,33,39
Butterblessr,thunderlord,1212,priest,discipline,55,25,30
Foxu,frostmourne,1211,priest,discipline,24,13,11
Lightshizzle,illidan,1211,priest,discipline,26,14,12
Tassadaraiur,tichondrius,1211,priest,discipline,104,44,60
Rachia,barthilas,1210,priest,discipline,78,46,32
Anakou,emerald-dream,1210,priest,discipline,35,20,15
Abhu,quelthalas,1210,priest,discipline,77,41,36
Invocational,moon-guard,1210,priest,discipline,141,69,72
Svrite,area-52,1210,priest,discipline,35,17,18
Livin,kelthuzad,1210,priest,discipline,40,13,27
Stunsilence,malganis,1209,priest,discipline,26,14,12
Keliedeyn,emerald-dream,1209,priest,discipline,60,28,32
Ariavish,area-52,1208,priest,discipline,48,25,23
Nerzghoul,sargeras,1208,priest,discipline,54,28,26
Stusy,tichondrius,1207,priest,discipline,18,13,5
Aynone,blood-furnace,1207,priest,discipline,161,76,85
Pixa,tichondrius,1207,priest,discipline,72,33,39
Nsquared,illidan,1207,priest,discipline,35,15,20
Tmpriest,tichondrius,1207,priest,discipline,115,46,69
Nardhead,sargeras,1206,priest,discipline,66,38,28
Nothinsexual,frostmourne,1206,priest,discipline,26,14,12
Flavorgrave,tichondrius,1206,priest,discipline,28,13,15
Cast,bronzebeard,1206,priest,discipline,82,37,45
Dpshealer,azralon,1206,priest,discipline,66,29,37
Discotecno,tichondrius,1205,priest,discipline,48,25,23
Gurkorr,boulderfist,1205,priest,discipline,57,24,33
Discs,detheroc,1205,priest,discipline,31,13,18
Kafzial,zuljin,1204,priest,discipline,80,48,32
Olêander,tichondrius,1204,priest,discipline,115,62,53
Laggin,queldorei,1204,priest,discipline,47,25,22
Visse,auchindoun,1204,priest,discipline,435,209,226
Rowman,frostmourne,1204,priest,discipline,47,22,25
Libationz,area-52,1204,priest,discipline,108,49,59
Alimony,chogall,1204,priest,discipline,29,13,16
Nêcrô,tichondrius,1203,priest,discipline,22,13,9
Vynlanesh,illidan,1203,priest,discipline,88,43,45
Ithvedriel,moon-guard,1203,priest,discipline,67,32,35
Tsunadae,hakkar,1202,priest,discipline,21,14,7
Mamabless,quelthalas,1202,priest,discipline,788,393,395
Kyrabon,ragnaros,1201,priest,discipline,30,17,13
Healzyew,dragonmaw,1201,priest,discipline,79,31,48
Xïlencer,tichondrius,1200,priest,discipline,132,74,58
Siabo,tichondrius,1199,priest,discipline,22,14,8
Nocturnalx,moon-guard,1199,priest,discipline,109,67,42
Eirana,skywall,1199,priest,discipline,113,57,56
Karamapang,illidan,1199,priest,discipline,144,65,79
Terenor,thrall,1199,priest,discipline,48,13,35
Jawdypriest,barthilas,1198,priest,discipline,44,27,17
Mythica,gurubashi,1198,priest,discipline,230,116,114
Blisses,blackrock,1198,priest,discipline,30,15,15
Yukih,tichondrius,1198,priest,discipline,64,29,35
Lebwonjamdi,tichondrius,1197,priest,discipline,28,13,15
Paidessanto,azralon,1196,priest,discipline,134,69,65
Docbek,illidan,1196,priest,discipline,83,40,43
Healbilli,archimonde,1196,priest,discipline,30,13,17
Chaniste,moon-guard,1195,priest,discipline,109,49,60
Bombmarley,azralon,1195,priest,discipline,36,16,20
Metius,smolderthorn,1194,priest,discipline,21,14,7
Freck,stormrage,1194,priest,discipline,47,25,22
Karaasbull,tichondrius,1194,priest,discipline,46,22,24
Fantasyx,ragnaros,1193,priest,discipline,53,31,22
Sasafras,feathermoon,1193,priest,discipline,87,43,44
Vampriest,frostmourne,1193,priest,discipline,43,21,22
Holyhog,whisperwind,1193,priest,discipline,69,33,36
Glauga,azralon,1193,priest,discipline,84,30,54
Brooklyn,draka,1192,priest,discipline,30,16,14
Bladam,bleeding-hollow,1192,priest,discipline,27,13,14
Babino,illidan,1192,priest,discipline,72,29,43
Kriseria,moon-guard,1191,priest,discipline,24,17,7
Healyoudead,draenor,1191,priest,discipline,41,15,26
Evelien,kiljaeden,1190,priest,discipline,66,31,35
Sanitater,frostmourne,1190,priest,discipline,102,47,55
Dzpi,azralon,1190,priest,discipline,96,43,53
Protega,illidan,1189,priest,discipline,22,14,8
Ödin,tichondrius,1189,priest,discipline,60,31,29
Menorsita,tichondrius,1189,priest,discipline,120,57,63
Gregorovich,ragnaros,1189,priest,discipline,95,43,52
Maiyennefer,proudmoore,1189,priest,discipline,48,20,28
Rinmaru,dark-iron,1188,priest,discipline,24,14,10
Iltharaph,illidan,1188,priest,discipline,25,14,11
Sluttiness,tichondrius,1188,priest,discipline,85,47,38
Kruciphix,tichondrius,1187,priest,discipline,29,20,9
Kaxleigh,emerald-dream,1187,priest,discipline,29,18,11
Inarius,dragonblight,1187,priest,discipline,55,23,32
Yusarin,garona,1186,priest,discipline,30,14,16
Valonar,emerald-dream,1185,priest,discipline,47,20,27
Idel,runetotem,1185,priest,discipline,45,16,29
Fozil,area-52,1184,priest,discipline,104,54,50
Tesserak,tichondrius,1184,priest,discipline,105,49,56
Burpees,dalaran,1183,priest,discipline,115,53,62
Unwòke,dalaran,1182,priest,discipline,24,14,10
Happydot,stormrage,1182,priest,discipline,30,14,16
Kßnstuff,area-52,1182,priest,discipline,37,15,22
Doubtmyfaith,frostmourne,1181,priest,discipline,42,21,21
Artermis,barthilas,1180,priest,discipline,85,37,48
Psychiatrist,darkspear,1180,priest,discipline,76,33,43
Holywarrior,smolderthorn,1180,priest,discipline,44,19,25
Skruffles,black-dragonflight,1179,priest,discipline,41,25,16
Kiaras,stormrage,1179,priest,discipline,48,25,23
Feetishh,frostmourne,1179,priest,discipline,38,18,20
Omgpeeldude,akama,1179,priest,discipline,33,13,20
Susannahh,goldrinn,1178,priest,discipline,36,17,19
Qbanota,drakkari,1178,priest,discipline,180,76,104
Ohnahnah,khadgar,1178,priest,discipline,32,13,19
Redchord,kiljaeden,1177,priest,discipline,39,17,22
Iwillsaveyou,tichondrius,1177,priest,discipline,40,16,24
Damoclexz,area-52,1176,priest,discipline,78,41,37
Fenwyr,stormrage,1176,priest,discipline,58,27,31
Feumanchu,area-52,1176,priest,discipline,32,14,18
Angeolita,nemesis,1176,priest,discipline,42,16,26
Mindkilla,area-52,1175,priest,discipline,273,141,132
Goldenfatty,blackrock,1175,priest,discipline,26,13,13
Jagelclam,gorefiend,1175,priest,discipline,47,22,25
Onef,quelthalas,1175,priest,discipline,35,15,20
Hiheals,anvilmar,1174,priest,discipline,36,20,16
Sacredream,illidan,1174,priest,discipline,24,13,11
Xsqt,stormrage,1174,priest,discipline,72,34,38
Fallenängel,senjin,1173,priest,discipline,35,19,16
Mindlames,bleeding-hollow,1173,priest,discipline,68,30,38
Spyzz,gilneas,1172,priest,discipline,36,18,18
Darrong,darkspear,1172,priest,discipline,52,24,28
Aoeprophet,area-52,1172,priest,discipline,29,13,16
Anddori,moknathal,1171,priest,discipline,54,25,29
Merlynaah,azralon,1171,priest,discipline,60,18,42
Näme,frostmourne,1170,priest,discipline,105,46,59
Zulkmoon,ragnaros,1170,priest,discipline,90,32,58
Nanabritches,moon-guard,1169,priest,discipline,199,99,100
Kerazul,sargeras,1169,priest,discipline,42,20,22
Nadjika,moon-guard,1169,priest,discipline,67,30,37
Kostadinov,tichondrius,1169,priest,discipline,30,13,17
Zumbaoqepdqt,quelthalas,1168,priest,discipline,77,33,44
Pushap,blood-furnace,1167,priest,discipline,108,58,50
Moirâ,silvermoon,1166,priest,discipline,36,14,22
Junss,tichondrius,1165,priest,discipline,23,13,10
Eluv,area-52,1165,priest,discipline,52,29,23
Aladelre,aerie-peak,1165,priest,discipline,80,33,47
Blessings,aerie-peak,1163,priest,discipline,108,57,51
Deadshöt,gorefiend,1163,priest,discipline,26,13,13
Abalowpt,nemesis,1163,priest,discipline,48,22,26
Betrthenadam,bleeding-hollow,1163,priest,discipline,72,32,40
Rileau,tichondrius,1162,priest,discipline,71,34,37
Sontïx,sargeras,1162,priest,discipline,31,13,18
Theryan,ragnaros,1161,priest,discipline,72,31,41
Psïcopata,gallywix,1161,priest,discipline,84,30,54
Heallarious,stormrage,1160,priest,discipline,52,30,22
Rancidcookie,tichondrius,1160,priest,discipline,31,13,18
Mäy,greymane,1160,priest,discipline,36,14,22
Eveilar,sargeras,1159,priest,discipline,24,15,9
Donoras,ursin,1158,priest,discipline,57,27,30
Semirg,moon-guard,1158,priest,discipline,30,13,17
Velinna,tichondrius,1158,priest,discipline,42,16,26
Sunael,quelthalas,1157,priest,discipline,53,28,25
Everluna,stormrage,1155,priest,discipline,18,13,5
Kaladaz,destromath,1154,priest,discipline,27,17,10
Chastised,moon-guard,1153,priest,discipline,877,433,444
Deacoderx,area-52,1152,priest,discipline,18,12,6
Bangseight,sargeras,1152,priest,discipline,18,12,6
Maraagsdad,tichondrius,1152,priest,discipline,18,12,6
Souvlaki,amanthul,1152,priest,discipline,24,12,12
Çherish,stormrage,1152,priest,discipline,24,12,12
Xinnie,illidan,1152,priest,discipline,108,48,60
Ømegagødx,illidan,1152,priest,discipline,30,12,18
Milesa,korgath,1151,priest,discipline,18,12,6
Soupbeanx,zuljin,1151,priest,discipline,18,12,6
Faithbuild,emerald-dream,1151,priest,discipline,18,12,6
Woolly,tichondrius,1151,priest,discipline,18,12,6
Souriel,tichondrius,1151,priest,discipline,96,51,45
Randrimm,stormrage,1151,priest,discipline,24,12,12
Kiriko,mannoroth,1151,priest,discipline,24,12,12
Sshhaaddooww,tichondrius,1151,priest,discipline,24,12,12
Pewwpew,malganis,1151,priest,discipline,24,12,12
Abraz,kiljaeden,1151,priest,discipline,24,12,12
Marmintor,stormrage,1151,priest,discipline,24,12,12
Spicyhealz,arthas,1151,priest,discipline,74,36,38
Kaztorz,tichondrius,1151,priest,discipline,28,12,16
Graymorick,malganis,1151,priest,discipline,30,12,18
Attenea,illidan,1151,priest,discipline,36,12,24
Ilmx,illidan,1150,priest,discipline,12,12,0
Agrolazor,frostwolf,1150,priest,discipline,12,12,0
Chickadies,barthilas,1150,priest,discipline,24,16,8
Rapturebtw,sargeras,1150,priest,discipline,18,12,6
Wizeau,dalaran,1150,priest,discipline,18,12,6
Tomp,tichondrius,1150,priest,discipline,18,12,6
Aaff,tichondrius,1150,priest,discipline,18,12,6
Chkashaa,emerald-dream,1150,priest,discipline,42,21,21
Rhaist,sargeras,1150,priest,discipline,36,18,18
Wartrix,bonechewer,1150,priest,discipline,24,12,12
Longday,kelthuzad,1150,priest,discipline,24,12,12
Cenrtrix,stormrage,1150,priest,discipline,24,12,12
Icesnowli,tichondrius,1150,priest,discipline,24,12,12
Abercromby,malganis,1150,priest,discipline,25,12,13
Yoxxoo,tichondrius,1150,priest,discipline,36,17,19
Penancedeez,moon-guard,1150,priest,discipline,35,15,20
Maxximuss,bleeding-hollow,1150,priest,discipline,44,18,26
Troubler,tichondrius,1149,priest,discipline,18,12,6
Profpepper,tichondrius,1149,priest,discipline,18,12,6
Whitenoiz,kiljaeden,1149,priest,discipline,24,12,12
Nerfholyplz,illidan,1149,priest,discipline,24,12,12
Pakc,tichondrius,1149,priest,discipline,24,12,12
Technetium,illidan,1149,priest,discipline,24,12,12
Shadowchaos,malganis,1149,priest,discipline,24,12,12
Kitenix,proudmoore,1149,priest,discipline,35,14,21
Jacqueline,tichondrius,1149,priest,discipline,30,12,18
Lindsanp,illidan,1149,priest,discipline,30,12,18
Való,stormrage,1148,priest,discipline,18,12,6
Tslacalls,malganis,1148,priest,discipline,18,12,6
Nelf,warsong,1148,priest,discipline,26,14,12
Highelfpally,sargeras,1148,priest,discipline,24,12,12
Littlegiirl,illidan,1148,priest,discipline,24,12,12
Luminatio,quelthalas,1148,priest,discipline,76,36,40
Revolki,azralon,1148,priest,discipline,48,12,36
Zhuyin,illidan,1147,priest,discipline,12,12,0
Tegridyfarm,malganis,1147,priest,discipline,18,12,6
Hínáta,kelthuzad,1147,priest,discipline,18,12,6
Rlkeyboard,sargeras,1147,priest,discipline,18,12,6
Puralux,balnazzar,1147,priest,discipline,54,32,22
Audacy,azuremyst,1147,priest,discipline,69,38,31
Profetico,ragnaros,1147,priest,discipline,83,43,40
Tranquilty,tichondrius,1147,priest,discipline,24,12,12
Mylà,ragnaros,1147,priest,discipline,32,12,20
Scrubgames,garrosh,1146,priest,discipline,12,12,0
Bakerstr,tichondrius,1146,priest,discipline,18,12,6
Níaa,ragnaros,1146,priest,discipline,24,12,12
Smightful,garona,1146,priest,discipline,24,12,12
Derowent,emerald-dream,1146,priest,discipline,30,13,17
Fearthepain,lethon,1146,priest,discipline,30,12,18
Kreon,tichondrius,1145,priest,discipline,18,12,6
Jivita,lightbringer,1145,priest,discipline,30,16,14
Jejer,moon-guard,1145,priest,discipline,24,12,12
Leensay,mannoroth,1145,priest,discipline,24,12,12
Beansofdean,proudmoore,1145,priest,discipline,24,12,12
Halidiir,frostmourne,1144,priest,discipline,18,13,5
Hoochiemomma,kelthuzad,1144,priest,discipline,24,13,11
Mashpotato,aerie-peak,1144,priest,discipline,24,13,11
Honeyweiss,cairne,1144,priest,discipline,30,16,14
Doibhli,frostmourne,1144,priest,discipline,25,13,12
Notskynet,tichondrius,1144,priest,discipline,24,12,12
Fatäl,moon-guard,1144,priest,discipline,140,60,80
Voidrisu,sargeras,1144,priest,discipline,30,12,18
Depressedboy,wyrmrest-accord,1143,priest,discipline,24,12,12
Tygrr,kelthuzad,1143,priest,discipline,24,12,12
Tenet,stormscale,1143,priest,discipline,47,23,24
Wise,wildhammer,1143,priest,discipline,165,80,85
Vyvanse,azuremyst,1143,priest,discipline,99,32,67
Moc,jubeithos,1143,priest,discipline,42,12,30
Ryuuka,sargeras,1142,priest,discipline,18,12,6
Unagidrop,malganis,1142,priest,discipline,22,13,9
Telrane,aggramar,1142,priest,discipline,24,12,12
Raivn,illidan,1142,priest,discipline,24,12,12
Ferilla,illidan,1142,priest,discipline,24,12,12
Itha,illidan,1142,priest,discipline,30,12,18
Múd,mannoroth,1142,priest,discipline,42,12,30
Vanhealsing,tichondrius,1141,priest,discipline,24,12,12
Lumentusk,stormscale,1141,priest,discipline,24,12,12
Mchinder,tanaris,1141,priest,discipline,100,49,51
Chickchautv,tichondrius,1140,priest,discipline,20,13,7
Meddyglyn,area-52,1140,priest,discipline,24,13,11
Samloomis,zuluhed,1140,priest,discipline,24,12,12
Scalpell,tichondrius,1139,priest,discipline,18,12,6
Núgz,tichondrius,1139,priest,discipline,47,31,16
Holygriz,skywall,1139,priest,discipline,44,26,18
Tyrea,kiljaeden,1139,priest,discipline,24,12,12
Satanshealer,terokkar,1139,priest,discipline,24,12,12
Criticaal,aegwynn,1139,priest,discipline,30,14,16
Kippin,frostmourne,1138,priest,discipline,18,12,6
Draniev,azralon,1138,priest,discipline,83,44,39
Goodbyekiss,illidan,1138,priest,discipline,118,59,59
Shooshanaa,stormrage,1138,priest,discipline,24,12,12
Zetk,tichondrius,1138,priest,discipline,24,12,12
Elvspriesly,doomhammer,1138,priest,discipline,104,51,53
Papergaruru,illidan,1138,priest,discipline,102,47,55
Claireredfld,lightbringer,1137,priest,discipline,18,12,6
Drywàter,tichondrius,1137,priest,discipline,81,45,36
Feelmyheels,frostmourne,1137,priest,discipline,48,24,24
Holnderoth,malganis,1137,priest,discipline,98,39,59
Jugeum,proudmoore,1137,priest,discipline,36,12,24
Barrysanders,zuljin,1136,priest,discipline,72,38,34
Voidwyrm,tichondrius,1136,priest,discipline,144,75,69
Hanuroa,tichondrius,1136,priest,discipline,184,92,92
Brotherheals,nagrand,1136,priest,discipline,66,33,33
Sprinkling,sargeras,1136,priest,discipline,34,15,19
Sölemn,barthilas,1136,priest,discipline,59,26,33
Gromkor,ragnaros,1135,priest,discipline,18,12,6
Leuviáh,ragnaros,1135,priest,discipline,24,12,12
Khallmir,goldrinn,1135,priest,discipline,126,61,65
Skokie,area-52,1135,priest,discipline,30,12,18
Calliah,moknathal,1134,priest,discipline,35,19,16
Alizeë,illidan,1134,priest,discipline,137,74,63
Linarelitha,area-52,1134,priest,discipline,92,47,45
Senumbra,tichondrius,1134,priest,discipline,24,12,12
Sassygayboyx,bleeding-hollow,1132,priest,discipline,33,13,20
Yddwin,quelthalas,1131,priest,discipline,58,30,28
Theleena,malorne,1131,priest,discipline,36,17,19
Superpriestz,alexstrasza,1131,priest,discipline,42,15,27
Looneý,drakkari,1130,priest,discipline,123,69,54
Melithor,frostmourne,1130,priest,discipline,24,12,12
Coachbombae,tichondrius,1129,priest,discipline,18,13,5
Charybdis,bonechewer,1129,priest,discipline,92,56,36
Tsukihí,ragnaros,1129,priest,discipline,30,14,16
Makkima,area-52,1129,priest,discipline,48,20,28
Corthien,thrall,1129,priest,discipline,30,12,18
Hëstia,darkspear,1128,priest,discipline,30,18,12
Galaxypepe,medivh,1128,priest,discipline,29,12,17
Bornindeath,proudmoore,1128,priest,discipline,30,12,18
Zil,spinebreaker,1127,priest,discipline,18,12,6
Cyrilien,tichondrius,1127,priest,discipline,52,29,23
Psïren,quelthalas,1127,priest,discipline,119,59,60
Killían,darkspear,1126,priest,discipline,61,31,30
Pizdük,stormrage,1126,priest,discipline,24,12,12
Priestvamp,azralon,1126,priest,discipline,42,19,23
Shadowbu,tichondrius,1126,priest,discipline,30,12,18
Holyshart,stonemaul,1125,priest,discipline,35,19,16
Anäster,ragnaros,1125,priest,discipline,71,37,34
Priestøuchme,tichondrius,1125,priest,discipline,35,18,17
Sänctus,emerald-dream,1125,priest,discipline,24,12,12
Osombra,azralon,1125,priest,discipline,48,23,25
Xiöm,quelthalas,1125,priest,discipline,30,12,18
Zolibeth,azshara,1124,priest,discipline,24,15,9
Haidees,akama,1124,priest,discipline,46,28,18
Thrudarkness,thrall,1124,priest,discipline,25,15,10
Finake,kelthuzad,1124,priest,discipline,86,48,38
Xuun,illidan,1124,priest,discipline,81,44,37
Fatherfilth,frostwolf,1124,priest,discipline,53,26,27
Velriana,tichondrius,1124,priest,discipline,30,12,18
Tkawesome,area-52,1124,priest,discipline,60,23,37
Mucgib,frostmourne,1124,priest,discipline,74,27,47
Weregonnadie,stormrage,1123,priest,discipline,30,12,18
Ðåmìéñ,tichondrius,1122,priest,discipline,24,12,12
Imbot,ragnaros,1122,priest,discipline,24,12,12
Exsufficate,frostmourne,1122,priest,discipline,34,15,19
Islandpink,malganis,1122,priest,discipline,42,12,30
Primeevil,black-dragonflight,1119,priest,discipline,24,14,10
Deehilie,illidan,1119,priest,discipline,49,25,24
Manaburnout,blackhand,1119,priest,discipline,36,12,24
Kerith,ragnaros,1118,priest,discipline,46,34,12
Viehweg,azralon,1118,priest,discipline,24,12,12
Serraphinaa,tichondrius,1117,priest,discipline,52,29,23
Cyberpriest,stormrage,1117,priest,discipline,66,27,39
Antihealz,kiljaeden,1117,priest,discipline,30,12,18
Ravenusius,azralon,1116,priest,discipline,18,12,6
Avipriest,area-52,1116,priest,discipline,35,12,23
Zinr,tichondrius,1115,priest,discipline,383,181,202
Depressíøn,moon-guard,1114,priest,discipline,42,21,21
Vitalizes,nagrand,1114,priest,discipline,30,13,17
Kelelin,frostwolf,1114,priest,discipline,30,12,18
Deadäss,sargeras,1113,priest,discipline,54,14,40
Yamahaz,lethon,1112,priest,discipline,30,13,17
Foxyy,wildhammer,1112,priest,discipline,35,14,21
Clergy,arthas,1111,priest,discipline,27,20,7
Fushia,emerald-dream,1107,priest,discipline,45,16,29
Enkognito,tichondrius,1106,priest,discipline,52,33,19
Mortecraft,sargeras,1106,priest,discipline,44,25,19
Pûrplehaze,aegwynn,1106,priest,discipline,23,12,11
Optîmuskrayt,tichondrius,1106,priest,discipline,83,40,43
Tootsieroll,dark-iron,1106,priest,discipline,53,25,28
Raihn,garrosh,1106,priest,discipline,37,14,23
Kithlas,emerald-dream,1105,priest,discipline,32,17,15
Cuckfist,darkspear,1105,priest,discipline,77,34,43
Ataraksija,sargeras,1103,priest,discipline,21,13,8
Cøwbøycrytøø,azralon,1103,priest,discipline,72,21,51
Shadowpáin,ragnaros,1102,priest,discipline,42,18,24
Zatroux,ragnaros,1101,priest,discipline,92,41,51
Azkillatroll,quelthalas,1101,priest,discipline,84,34,50
Dirtyone,dark-iron,1100,priest,discipline,36,15,21
Jtewatch,zuljin,1098,priest,discipline,66,38,28
Cpalian,tichondrius,1098,priest,discipline,22,12,10
Gorechop,aegwynn,1098,priest,discipline,72,29,43
Tetha,fizzcrank,1097,priest,discipline,54,23,31
Darkxrp,bleeding-hollow,1096,priest,discipline,30,13,17
Draiger,quelthalas,1096,priest,discipline,36,14,22
Fistavert,stormreaver,1095,priest,discipline,24,12,12
Preezoo,tichondrius,1095,priest,discipline,64,25,39
Zhaann,kelthuzad,1094,priest,discipline,48,23,25
Londog,vashj,1094,priest,discipline,102,46,56
Marhuana,stormreaver,1094,priest,discipline,64,27,37
Happyholy,tichondrius,1094,priest,discipline,36,14,22
Mcdizzle,bloodscalp,1093,priest,discipline,90,41,49
Nuvea,tichondrius,1093,priest,discipline,27,12,15
Annaphilaxis,sargeras,1091,priest,discipline,44,22,22
Stroodle,illidan,1091,priest,discipline,95,44,51
Ketone,malganis,1090,priest,discipline,125,65,60
Zacksnotcool,sargeras,1090,priest,discipline,33,13,20
Thinmintt,wyrmrest-accord,1089,priest,discipline,108,47,61
Kidha,stormrage,1089,priest,discipline,66,22,44
Divinity,hellscream,1089,priest,discipline,36,12,24
Papipreach,sargeras,1088,priest,discipline,24,15,9
Bigdaddyku,hyjal,1088,priest,discipline,34,20,14
Mylkshakez,emerald-dream,1088,priest,discipline,31,13,18
Salovoth,area-52,1088,priest,discipline,48,17,31
Fhelurian,quelthalas,1088,priest,discipline,36,12,24
Holysmokesx,tichondrius,1087,priest,discipline,22,12,10
Mellerwine,azralon,1087,priest,discipline,578,293,285
Kelody,zuljin,1087,priest,discipline,30,13,17
Maccten,tichondrius,1086,priest,discipline,21,13,8
Antiraus,aerie-peak,1086,priest,discipline,24,13,11
Athzziry,ragnaros,1086,priest,discipline,51,24,27
Slaac,malfurion,1085,priest,discipline,23,12,11
Quavö,tichondrius,1085,priest,discipline,68,29,39
Elbowbeans,tichondrius,1085,priest,discipline,34,12,22
Ariyaned,quelthalas,1084,priest,discipline,18,12,6
Todrecas,ragnaros,1084,priest,discipline,24,13,11
Painpaws,moon-guard,1084,priest,discipline,28,12,16
Ezklapz,malganis,1084,priest,discipline,39,16,23
Vaddaru,kirin-tor,1083,priest,discipline,66,38,28
Lördgrim,stormrage,1083,priest,discipline,37,21,16
Tigrania,proudmoore,1083,priest,discipline,23,12,11
Scirzzy,tichondrius,1083,priest,discipline,29,14,15
Chroly,stormrage,1083,priest,discipline,65,29,36
Grapedraankk,kelthuzad,1082,priest,discipline,18,12,6
Watdahealydo,darkspear,1081,priest,discipline,24,13,11
Nostrande,stormrage,1080,priest,discipline,21,12,9
Aliciab,andorhal,1080,priest,discipline,115,51,64
Synes,bleeding-hollow,1080,priest,discipline,34,12,22
Benmem,illidan,1078,priest,discipline,141,68,73
Averli,moon-guard,1078,priest,discipline,48,20,28
Opri,andorhal,1078,priest,discipline,66,27,39
Fregè,ysera,1078,priest,discipline,30,12,18
Sheriff,lightbringer,1076,priest,discipline,153,80,73
Gaaq,stormrage,1075,priest,discipline,24,12,12
Jinxheal,tichondrius,1075,priest,discipline,26,12,14
Strithe,kiljaeden,1074,priest,discipline,18,13,5
Sístermary,stormrage,1074,priest,discipline,42,24,18
Pochis,bleeding-hollow,1074,priest,discipline,90,45,45
Justinagnpr,tichondrius,1072,priest,discipline,30,14,16
Nervinia,tichondrius,1072,priest,discipline,30,12,18
Drtesak,illidan,1070,priest,discipline,17,12,5
Astartés,area-52,1070,priest,discipline,24,14,10
Yosicuro,ragnaros,1070,priest,discipline,33,19,14
Curánderá,ragnaros,1070,priest,discipline,27,13,14
Jessikal,quelthalas,1069,priest,discipline,25,12,13
Darkmolt,vashj,1069,priest,discipline,26,12,14
Chinsta,tichondrius,1069,priest,discipline,38,15,23
Berzap,frostmourne,1068,priest,discipline,30,18,12
Zathanel,ragnaros,1066,priest,discipline,30,12,18
Shemhazai,ragnaros,1065,priest,discipline,28,14,14
Kloudypriest,moon-guard,1065,priest,discipline,53,26,27
Twinkmuncher,proudmoore,1065,priest,discipline,25,12,13
Newheal,quelthalas,1064,priest,discipline,30,16,14
Trustheals,tichondrius,1064,priest,discipline,134,71,63
Vahlen,azralon,1062,priest,discipline,23,12,11
Fulldesire,dalaran,1061,priest,discipline,69,39,30
Xojelas,quelthalas,1060,priest,discipline,24,13,11
Amphion,skullcrusher,1059,priest,discipline,25,12,13
Sivamint,aerie-peak,1058,priest,discipline,42,16,26
Roentgen,sargeras,1056,priest,discipline,18,11,7
Littlehcl,tichondrius,1056,priest,discipline,18,11,7
Lespaula,ragnaros,1056,priest,discipline,24,12,12
Smiliebomb,tichondrius,1056,priest,discipline,24,11,13
Lilbabynaga,stormrage,1056,priest,discipline,75,27,48
Crucifer,proudmoore,1055,priest,discipline,12,11,1
Normill,bonechewer,1055,priest,discipline,19,12,7
Neonpriest,tichondrius,1055,priest,discipline,18,11,7
Ròen,tichondrius,1055,priest,discipline,18,11,7
Hly,frostmourne,1055,priest,discipline,18,11,7
Penanced,tichondrius,1055,priest,discipline,18,11,7
Piftw,illidan,1055,priest,discipline,18,11,7
Elfgasmic,blackwater-raiders,1055,priest,discipline,18,11,7
Chawp,kelthuzad,1055,priest,discipline,18,11,7
Ilovedailies,frostmourne,1055,priest,discipline,24,11,13
Ffej,bleeding-hollow,1055,priest,discipline,24,11,13
Jangma,tichondrius,1055,priest,discipline,24,11,13
Pro,proudmoore,1055,priest,discipline,24,11,13
Cency,tichondrius,1055,priest,discipline,24,11,13
Jonesy,tichondrius,1055,priest,discipline,24,11,13
Wintrow,sargeras,1055,priest,discipline,30,11,19
Voidgames,area-52,1055,priest,discipline,30,11,19
Goobiesz,tichondrius,1055,priest,discipline,30,11,19
Disconelf,barthilas,1055,priest,discipline,30,11,19
Hokutos,tichondrius,1055,priest,discipline,30,11,19
Oymay,illidan,1055,priest,discipline,30,11,19
Lampvpgerl,illidan,1055,priest,discipline,36,11,25
Aiss,malganis,1054,priest,discipline,16,12,4
Anneyann,fenris,1054,priest,discipline,30,19,11
Náñí,area-52,1054,priest,discipline,18,11,7
Missyoung,tichondrius,1054,priest,discipline,18,11,7
Owlchubz,mannoroth,1054,priest,discipline,24,11,13
Dpsmercy,sargeras,1054,priest,discipline,24,11,13
Aikinorz,tichondrius,1054,priest,discipline,24,11,13
Aguavenditaa,quelthalas,1054,priest,discipline,24,11,13
Gumiho,drakkari,1054,priest,discipline,87,39,48
Syndrox,kelthuzad,1053,priest,discipline,12,11,1
Malhotra,amanthul,1053,priest,discipline,28,18,10
Whitepigogo,tichondrius,1053,priest,discipline,18,11,7
Amoureuxz,bleeding-hollow,1053,priest,discipline,18,11,7
Holyshiiet,area-52,1053,priest,discipline,18,11,7
Kajhy,ragnaros,1053,priest,discipline,48,22,26
Polteageist,frostmourne,1053,priest,discipline,24,11,13
Orisons,bleeding-hollow,1053,priest,discipline,24,11,13
Ayezex,tichondrius,1053,priest,discipline,48,21,27
Rezy,darkspear,1053,priest,discipline,30,11,19
Màva,zuljin,1053,priest,discipline,30,11,19
Holystink,malganis,1052,priest,discipline,18,11,7
Wâtermelon,stormrage,1052,priest,discipline,18,11,7
Slavoj,gurubashi,1052,priest,discipline,41,19,22
Buffhpriest,tichondrius,1052,priest,discipline,24,11,13
Slenden,illidan,1052,priest,discipline,24,11,13
Kovie,twisting-nether,1052,priest,discipline,24,11,13
Frye,bleeding-hollow,1052,priest,discipline,30,11,19
Rhulvin,fizzcrank,1051,priest,discipline,18,11,7
Vikks,tichondrius,1051,priest,discipline,24,11,13
Xanderp,thrall,1051,priest,discipline,30,11,19
Saviorr,dalaran,1051,priest,discipline,30,11,19
Jayqwellen,bleeding-hollow,1051,priest,discipline,30,11,19
Moopha,zuljin,1050,priest,discipline,12,11,1
Healdog,thrall,1050,priest,discipline,18,11,7
Lightschosen,malganis,1050,priest,discipline,18,11,7
Jebadiia,tichondrius,1050,priest,discipline,129,65,64
Zeun,spinebreaker,1050,priest,discipline,72,34,38
Thotsteal,lightbringer,1050,priest,discipline,24,11,13
Darkmoonsun,frostmourne,1050,priest,discipline,24,11,13
Príest,nordrassil,1050,priest,discipline,24,11,13
Lalight,tichondrius,1050,priest,discipline,30,11,19
Bunked,bleeding-hollow,1049,priest,discipline,35,14,21
Sofunchode,illidan,1049,priest,discipline,30,11,19
Inmortar,dalaran,1049,priest,discipline,30,11,19
Exanthrope,stormrage,1048,priest,discipline,18,11,7
Sajahsa,moon-guard,1048,priest,discipline,25,15,10
Crossbones,cenarion-circle,1048,priest,discipline,109,57,52
Elexianpi,stormrage,1048,priest,discipline,30,11,19
Jackflashh,hakkar,1047,priest,discipline,78,35,43
Sinwifi,ragnaros,1047,priest,discipline,64,27,37
Gawlas,azshara,1046,priest,discipline,18,11,7
Skinnyfat,azralon,1046,priest,discipline,18,11,7
Mixxd,shuhalo,1046,priest,discipline,96,50,46
Classifiedcc,illidan,1046,priest,discipline,264,132,132
Feff,shuhalo,1046,priest,discipline,30,11,19
Trienolone,emerald-dream,1045,priest,discipline,18,11,7
Hangingmeat,jubeithos,1045,priest,discipline,24,11,13
Nippols,skullcrusher,1045,priest,discipline,24,11,13
Whoôx,khazgoroth,1044,priest,discipline,29,11,18
Ahualol,tichondrius,1043,priest,discipline,18,11,7
Azztiel,tichondrius,1043,priest,discipline,24,11,13
Lilbabe,stormrage,1043,priest,discipline,24,11,13
Sendia,hydraxis,1038,priest,discipline,66,31,35
Skeepsi,area-52,1037,priest,discipline,78,39,39
Lovetotouch,malganis,1037,priest,discipline,24,11,13
Kuppel,tichondrius,1037,priest,discipline,30,11,19
Kiilltic,sargeras,1037,priest,discipline,36,13,23
Deusthanatos,medivh,1036,priest,discipline,70,36,34
Lzzp,azralon,1036,priest,discipline,24,11,13
Gudnewsevone,illidan,1035,priest,discipline,24,11,13
Holdmypriest,sargeras,1035,priest,discipline,68,28,40
Gongá,moon-guard,1035,priest,discipline,108,43,65
Kuwapre,proudmoore,1032,priest,discipline,25,13,12
Uchihalol,tichondrius,1032,priest,discipline,24,11,13
Prawda,area-52,1031,priest,discipline,30,11,19
Tapel,khazgoroth,1030,priest,discipline,60,38,22
Geulis,illidan,1030,priest,discipline,65,30,35
Bubbleyo,shandris,1029,priest,discipline,18,11,7
Erelim,durotan,1029,priest,discipline,89,36,53
Gãmbino,wyrmrest-accord,1029,priest,discipline,40,14,26
Egraner,drakkari,1027,priest,discipline,24,11,13
Cynthir,stormrage,1026,priest,discipline,24,11,13
Efrem,tichondrius,1025,priest,discipline,69,32,37
Chêrubim,arthas,1025,priest,discipline,24,11,13
Elomszz,tichondrius,1024,priest,discipline,22,11,11
Naxiest,stormrage,1024,priest,discipline,29,11,18
Bakharftw,nemesis,1023,priest,discipline,28,17,11
Harlei,tichondrius,1023,priest,discipline,24,14,10
Biggunsaint,icecrown,1022,priest,discipline,26,12,14
Mxd,bleeding-hollow,1021,priest,discipline,20,12,8
Treenewbeems,tichondrius,1020,priest,discipline,49,25,24
Mgfoxxie,scarlet-crusade,1020,priest,discipline,30,12,18
Kenray,sargeras,1020,priest,discipline,48,18,30
Deemmortii,stormrage,1020,priest,discipline,40,11,29
Thadan,uldaman,1019,priest,discipline,24,11,13
Sév,frostmane,1017,priest,discipline,190,89,101
Rahna,azralon,1017,priest,discipline,30,11,19
Steck,illidan,1016,priest,discipline,64,27,37
Nightmxres,zuljin,1016,priest,discipline,30,11,19
Jèf,stormrage,1015,priest,discipline,23,11,12
Shaydeep,nagrand,1015,priest,discipline,28,12,16
Profît,stormrage,1014,priest,discipline,24,12,12
Hathamet,thrall,1013,priest,discipline,60,25,35
Rigityrekt,aggramar,1012,priest,discipline,30,22,8
Covfefe,draka,1012,priest,discipline,96,38,58
Touchedbygud,frostmourne,1011,priest,discipline,62,33,29
Rescueherø,tichondrius,1010,priest,discipline,56,30,26
Drãith,magtheridon,1009,priest,discipline,24,12,12
Uljinoo,blackwing-lair,1009,priest,discipline,92,41,51
Azrïel,mannoroth,1007,priest,discipline,48,28,20
Buschlatte,frostmane,1007,priest,discipline,23,11,12
Dazzlingduck,illidan,1007,priest,discipline,23,11,12
Dynopriest,kelthuzad,1007,priest,discipline,29,11,18
Lesserfaith,sargeras,1006,priest,discipline,21,11,10
Fluxus,sargeras,1005,priest,discipline,18,11,7
Causeoflife,eitrigg,1005,priest,discipline,23,11,12
Ehmacros,kelthuzad,1005,priest,discipline,35,11,24
Ioudas,ragnaros,1004,priest,discipline,35,11,24
Knowknows,tichondrius,1003,priest,discipline,23,11,12
Vidzz,silvermoon,1003,priest,discipline,23,11,12
Mando,area-52,1001,priest,discipline,152,82,70
Sharkda,frostmourne,1000,priest,discipline,69,39,30
Stinkyfingr,frostmourne,1000,priest,discipline,42,15,27
Sharayu,madoran,999,priest,discipline,42,22,20
Lytherina,aegwynn,999,priest,discipline,42,19,23
Whitewidowx,eredar,997,priest,discipline,21,12,9
Jaster,proudmoore,996,priest,discipline,70,39,31
Bårriër,darkspear,996,priest,discipline,23,12,11
Rbmxp,barthilas,994,priest,discipline,21,12,9
Robertsmurda,emerald-dream,992,priest,discipline,22,11,11
Acenthe,sargeras,991,priest,discipline,22,11,11
Jonnycanuckz,duskwood,991,priest,discipline,36,14,22
Moomagic,sargeras,989,priest,discipline,71,36,35
Jikoguu,stormscale,989,priest,discipline,36,11,25
Lilflexi,lightbringer,988,priest,discipline,22,11,11
Carbonated,zuljin,986,priest,discipline,17,11,6
Antonella,malganis,985,priest,discipline,33,12,21
Icemeilarda,illidan,979,priest,discipline,111,49,62
Macoa,zuljin,978,priest,discipline,96,46,50
Diamontie,tichondrius,977,priest,discipline,26,16,10
Mikkik,zuljin,977,priest,discipline,54,32,22
Toastanator,wyrmrest-accord,977,priest,discipline,286,139,147
Alurand,bleeding-hollow,976,priest,discipline,18,11,7
Ðrip,burning-legion,976,priest,discipline,22,11,11
Kahari,perenolde,976,priest,discipline,28,11,17
Epiipen,area-52,975,priest,discipline,25,11,14
Hèáls,tichondrius,975,priest,discipline,66,29,37
Nipseys,frostmourne,973,priest,discipline,24,12,12
Noriniani,sargeras,972,priest,discipline,33,18,15
Terric,shattered-hand,972,priest,discipline,30,14,16
Leoi,fenris,968,priest,discipline,63,31,32
Perzeval,azshara,967,priest,discipline,28,11,17
Voidwulf,azgalor,962,priest,discipline,119,59,60
Laeral,quelthalas,962,priest,discipline,41,16,25
Åphrødite,bonechewer,961,priest,discipline,22,12,10
Åz,quelthalas,961,priest,discipline,24,12,12
Cezanne,tichondrius,961,priest,discipline,125,52,73
Charón,tichondrius,960,priest,discipline,12,10,2
Mxchsm,stormrage,960,priest,discipline,12,10,2
Ishyeboi,stormrage,960,priest,discipline,18,10,8
Priesticules,illidan,960,priest,discipline,18,10,8
Squigic,turalyon,960,priest,discipline,18,10,8
Fyne,kelthuzad,960,priest,discipline,21,10,11
Notlowboy,area-52,960,priest,discipline,24,10,14
Junethegreat,tichondrius,960,priest,discipline,24,10,14
Nobodystarx,steamwheedle-cartel,960,priest,discipline,24,10,14
Ajxoz,thrall,960,priest,discipline,24,10,14
Iexii,frostmourne,960,priest,discipline,24,10,14
Lilpurp,sargeras,960,priest,discipline,28,10,18
Futuuncle,tichondrius,960,priest,discipline,30,10,20
Drossv,shadowmoon,960,priest,discipline,30,10,20
Luzhú,illidan,960,priest,discipline,30,10,20
Jinforever,tichondrius,959,priest,discipline,12,10,2
Henchwoman,stormrage,959,priest,discipline,12,10,2
Trailmixx,bleeding-hollow,959,priest,discipline,12,10,2
Kk,fizzcrank,959,priest,discipline,12,10,2
Strawberryzz,area-52,959,priest,discipline,12,10,2
Elimix,frostmourne,959,priest,discipline,12,10,2
Biomadd,hellscream,959,priest,discipline,15,11,4
Dubai,tichondrius,959,priest,discipline,18,10,8
Minnowhead,kelthuzad,959,priest,discipline,18,10,8
Ruinr,illidan,959,priest,discipline,18,10,8
Filthmaster,moon-guard,959,priest,discipline,18,10,8
Chaxiubao,stormrage,959,priest,discipline,18,10,8
Elphié,sargeras,959,priest,discipline,18,10,8
Sgno,ragnaros,959,priest,discipline,18,10,8
Tamzy,eredar,959,priest,discipline,18,10,8
Hundski,darkspear,959,priest,discipline,18,10,8
Budlyy,dalaran,959,priest,discipline,18,10,8
Bicardii,area-52,959,priest,discipline,18,10,8
Groove,kelthuzad,959,priest,discipline,18,10,8
Cigma,magtheridon,959,priest,discipline,18,10,8
Recoverys,illidan,959,priest,discipline,18,10,8
Oduum,tichondrius,959,priest,discipline,18,10,8
Floppeh,khazgoroth,959,priest,discipline,18,10,8
Dudurr,zuluhed,959,priest,discipline,18,10,8
Kelaara,gnomeregan,959,priest,discipline,19,10,9
Tamtwo,the-forgotten-coast,959,priest,discipline,24,10,14
Calahra,malganis,959,priest,discipline,24,10,14
Johadorr,shadowsong,959,priest,discipline,24,10,14
Abbyy,barthilas,959,priest,discipline,24,10,14
Rum,kirin-tor,959,priest,discipline,24,10,14
Stylébender,tichondrius,959,priest,discipline,24,10,14
Zanyp,akama,959,priest,discipline,32,12,20
Stríkes,emerald-dream,959,priest,discipline,30,10,20
Kelsxö,tichondrius,958,priest,discipline,12,10,2
Azide,mannoroth,958,priest,discipline,12,10,2
Janna,jubeithos,958,priest,discipline,18,10,8
Gothii,tichondrius,958,priest,discipline,18,10,8
Josephlin,quelthalas,958,priest,discipline,18,10,8
Amonerpriest,tichondrius,958,priest,discipline,18,10,8
Chknhealer,darkspear,958,priest,discipline,18,10,8
Tîg,nemesis,958,priest,discipline,21,10,11
Ritzien,jubeithos,958,priest,discipline,24,10,14
Câstiêl,malganis,958,priest,discipline,24,10,14
Mïnðtrÿx,darkspear,958,priest,discipline,24,10,14
Taedrid,stormrage,958,priest,discipline,101,41,60
Wilburre,sargeras,957,priest,discipline,18,10,8
Bubblebeasst,area-52,957,priest,discipline,18,10,8
Joanoarc,destromath,957,priest,discipline,18,10,8
Bigchalupaz,sargeras,957,priest,discipline,18,10,8
Rellington,frostwolf,957,priest,discipline,24,10,14
Jagsp,area-52,957,priest,discipline,24,10,14
Chanyt,azralon,956,priest,discipline,12,10,2
Xøspëélls,ragnaros,956,priest,discipline,12,10,2
Mevix,firetree,956,priest,discipline,24,10,14
Kissmyvoìd,frostmourne,956,priest,discipline,24,10,14
Mottomami,nemesis,956,priest,discipline,24,10,14
Synthas,tichondrius,955,priest,discipline,18,10,8
Dorlala,tichondrius,955,priest,discipline,18,10,8
Bachaterah,skullcrusher,955,priest,discipline,24,10,14
Çõrlëøñè,illidan,955,priest,discipline,24,10,14
Glassbones,kelthuzad,955,priest,discipline,30,10,20
Felmnir,ragnaros,955,priest,discipline,30,10,20
Fidalus,stormrage,955,priest,discipline,38,10,28
Ihelp,altar-of-storms,954,priest,discipline,18,10,8
Lauriestrode,andorhal,954,priest,discipline,18,10,8
Liloffended,sargeras,954,priest,discipline,18,10,8
Febronia,aerie-peak,954,priest,discipline,18,10,8
Hanklin,lightnings-blade,954,priest,discipline,18,10,8
Hateznamez,bladefist,954,priest,discipline,18,10,8
Xyberius,barthilas,954,priest,discipline,24,10,14
Acésnóf,stormrage,954,priest,discipline,24,10,14
Judgejudyx,tichondrius,954,priest,discipline,24,10,14
Bubblebuster,lightbringer,954,priest,discipline,61,25,36
Discjuice,tichondrius,954,priest,discipline,36,10,26
Discomon,lightnings-blade,953,priest,discipline,12,10,2
Kirigäya,quelthalas,953,priest,discipline,18,10,8
Kajagoogoö,emerald-dream,953,priest,discipline,18,10,8
Lusch,stormscale,953,priest,discipline,70,37,33
Ôvr,area-52,953,priest,discipline,26,11,15
Flagged,azgalor,953,priest,discipline,24,10,14
Xenonfaith,bleeding-hollow,952,priest,discipline,17,12,5
Anonymoûs,silver-hand,952,priest,discipline,24,14,10
Vazara,tichondrius,952,priest,discipline,18,10,8
Stennic,emerald-dream,952,priest,discipline,18,10,8
Actiop,stormrage,952,priest,discipline,18,10,8
Jessicä,malganis,952,priest,discipline,18,10,8
Unholyio,barthilas,952,priest,discipline,18,10,8
Worthy,runetotem,952,priest,discipline,18,10,8
Aqurielen,turalyon,951,priest,discipline,18,10,8
Daijoubu,lightnings-blade,951,priest,discipline,24,10,14
Possumvendor,dalaran,951,priest,discipline,30,10,20
Ppinmuhbutt,tichondrius,951,priest,discipline,36,10,26
Artmend,malganis,950,priest,discipline,24,10,14
Nythrin,llane,950,priest,discipline,24,10,14
Zeas,moon-guard,950,priest,discipline,66,23,43
Zhadowbolts,thrall,949,priest,discipline,18,10,8
Threlad,elune,949,priest,discipline,18,10,8
Thirddps,illidan,949,priest,discipline,24,12,12
Dreamskull,aegwynn,949,priest,discipline,26,11,15
Dwennalous,stormrage,949,priest,discipline,24,10,14
Novoc,blackhand,949,priest,discipline,54,22,32
Hypnogypsy,malganis,948,priest,discipline,18,10,8
Lasslìn,bonechewer,948,priest,discipline,18,10,8
Filterz,korgath,948,priest,discipline,24,10,14
Prófessór,tichondrius,948,priest,discipline,24,10,14
Futatsi,zuljin,948,priest,discipline,46,18,28
Samsunglions,tichondrius,947,priest,discipline,18,10,8
Arkathus,stormrage,947,priest,discipline,24,10,14
Serana,maelstrom,946,priest,discipline,158,82,76
Fallenfaith,dathremar,946,priest,discipline,43,21,22
Mottsarella,mugthol,945,priest,discipline,96,50,46
Heelium,spirestone,945,priest,discipline,24,10,14
Tjxx,zuljin,944,priest,discipline,30,10,20
Nikkazul,drakkari,943,priest,discipline,30,14,16
Praiz,tichondrius,942,priest,discipline,24,15,9
Prlest,proudmoore,941,priest,discipline,60,26,34
Lookfig,frostmourne,941,priest,discipline,24,10,14
Sinnz,emerald-dream,939,priest,discipline,30,11,19
Sisterdeáth,area-52,938,priest,discipline,24,11,13
Throwinshadê,stormrage,937,priest,discipline,237,120,117
Neehow,hyjal,936,priest,discipline,12,10,2
Boosserbro,dawnbringer,936,priest,discipline,42,21,21
Ophiuchus,jubeithos,936,priest,discipline,32,12,20
Miel,kargath,935,priest,discipline,60,22,38
Pugsmugglerr,icecrown,934,priest,discipline,31,10,21
Mcmorphy,stormrage,931,priest,discipline,53,23,30
Alexz,area-52,927,priest,discipline,14,11,3
Siokeena,stormrage,927,priest,discipline,17,10,7
Toastedheal,stormreaver,927,priest,discipline,20,11,9
Sublety,aerie-peak,927,priest,discipline,72,33,39
Thehealinck,magtheridon,927,priest,discipline,22,10,12
Peacebewithu,echo-isles,926,priest,discipline,24,13,11
Fenders,stormrage,926,priest,discipline,23,10,13
Gankchange,tichondrius,926,priest,discipline,26,11,15
Touchmylight,suramar,925,priest,discipline,53,27,26
Tonymòntana,area-52,923,priest,discipline,18,10,8
Kaladîn,dark-iron,921,priest,discipline,20,11,9
Divinebones,gurubashi,921,priest,discipline,42,17,25
Braxxten,tichondrius,919,priest,discipline,56,23,33
Rymzxx,ragnaros,918,priest,discipline,19,11,8
Thekingheals,draenor,918,priest,discipline,28,14,14
Jeanmarc,aerie-peak,918,priest,discipline,78,32,46
Xiaz,lightbringer,912,priest,discipline,18,12,6
Supersede,sargeras,912,priest,discipline,294,144,150
Belielosong,moon-guard,912,priest,discipline,63,30,33
Twistedead,illidan,911,priest,discipline,21,11,10
Kurtsheals,destromath,911,priest,discipline,66,31,35
Katalla,spirestone,911,priest,discipline,27,10,17
Mègadèath,area-52,911,priest,discipline,35,10,25
Healloween,stormrage,910,priest,discipline,27,14,13
Priestrix,frostmourne,910,priest,discipline,55,22,33
Diefidel,sargeras,910,priest,discipline,64,19,45
Jrøc,sargeras,908,priest,discipline,21,11,10
Shadowdeathx,bleeding-hollow,906,priest,discipline,23,10,13
Brock,lightbringer,905,priest,discipline,27,11,16
Ðanté,the-venture-co,904,priest,discipline,22,13,9
Corrûpt,stormrage,904,priest,discipline,20,11,9
Asfw,chogall,903,priest,discipline,24,12,12
Ohashi,ragnaros,902,priest,discipline,18,11,7
Mvqjlm,tichondrius,895,priest,discipline,14,10,4
Plaedito,stormscale,895,priest,discipline,23,10,13
Bellack,emerald-dream,895,priest,discipline,73,31,42
Càipirinha,tichondrius,895,priest,discipline,28,10,18
Shayylii,stormrage,894,priest,discipline,32,10,22
Aladdinlol,tichondrius,894,priest,discipline,34,10,24
Chapitä,drakkari,893,priest,discipline,16,10,6
Unholydomina,zuljin,892,priest,discipline,83,38,45
Tezcatyo,area-52,891,priest,discipline,17,10,7
Kaizzen,gorgonnash,891,priest,discipline,17,10,7
Iovesauce,stormrage,891,priest,discipline,22,10,12
Archcerion,stormreaver,891,priest,discipline,28,11,17
Sadier,moon-guard,883,priest,discipline,32,11,21
Catbabyslim,tichondrius,879,priest,discipline,14,11,3
Frojasensei,tichondrius,879,priest,discipline,17,10,7
Skellybells,sargeras,871,priest,discipline,26,16,10
Dinar,tichondrius,864,priest,discipline,12,9,3
Gillette,thunderlord,864,priest,discipline,12,9,3
Xxmewo,sargeras,864,priest,discipline,12,9,3
Tarwow,alterac-mountains,864,priest,discipline,12,9,3
Squiddyjr,tichondrius,864,priest,discipline,12,9,3
Trinaty,senjin,864,priest,discipline,12,9,3
Photic,malganis,864,priest,discipline,12,9,3
Elise,ravenholdt,864,priest,discipline,12,9,3
Dirtydickdan,sargeras,864,priest,discipline,12,9,3
Marcalus,garrosh,864,priest,discipline,15,9,6
Wv,kelthuzad,864,priest,discipline,18,9,9
Illstyles,tichondrius,864,priest,discipline,18,9,9
Stubby,shadowsong,864,priest,discipline,18,9,9
Shoepooper,kelthuzad,864,priest,discipline,18,9,9
Nißirøux,sargeras,864,priest,discipline,18,9,9
Tobaiss,arygos,864,priest,discipline,18,9,9
Æßøäîètîÿ,sargeras,864,priest,discipline,18,9,9
Abbyc,barthilas,864,priest,discipline,18,9,9
Irar,tichondrius,864,priest,discipline,18,9,9
Seyvyur,black-dragonflight,864,priest,discipline,18,9,9
Cinnalite,darkspear,864,priest,discipline,18,9,9
Makdaddy,skullcrusher,864,priest,discipline,18,9,9
Træway,tichondrius,864,priest,discipline,18,9,9
Toteme,proudmoore,864,priest,discipline,18,9,9
Phurbosjr,sargeras,864,priest,discipline,18,9,9
Dimanche,thunderlord,864,priest,discipline,18,9,9
Challengerz,suramar,864,priest,discipline,18,9,9
Shadooe,tichondrius,864,priest,discipline,18,9,9
Norikoo,malganis,864,priest,discipline,18,9,9
Celerisp,malganis,864,priest,discipline,18,9,9
Arcmage,malganis,864,priest,discipline,18,9,9
Omgnerfz,zuljin,864,priest,discipline,18,9,9
Trezz,aegwynn,864,priest,discipline,18,9,9
Drbønghitmd,tichondrius,864,priest,discipline,18,9,9
Ninbará,stormrage,864,priest,discipline,24,9,15
Spankdealer,illidan,864,priest,discipline,24,9,15
Soll,veknilash,864,priest,discipline,24,9,15
Samsypriest,frostmourne,863,priest,discipline,12,9,3
Maplesyrupz,moonrunner,863,priest,discipline,12,9,3
Djxkidrock,moon-guard,863,priest,discipline,12,9,3
Stroserous,hyjal,863,priest,discipline,12,9,3
Maleklek,azralon,863,priest,discipline,12,9,3
Helleamh,tichondrius,863,priest,discipline,12,9,3
Softqt,tichondrius,863,priest,discipline,12,9,3
Dkarla,lightnings-blade,863,priest,discipline,16,10,6
Oprst,tichondrius,863,priest,discipline,18,9,9
Piece,tichondrius,863,priest,discipline,18,9,9
Ifalna,nemesis,863,priest,discipline,18,9,9
Iamrisen,tichondrius,863,priest,discipline,18,9,9
Xellda,azjolnerub,863,priest,discipline,18,9,9
Ytrexious,stormreaver,863,priest,discipline,18,9,9
Darkrecovery,sargeras,863,priest,discipline,18,9,9
Pillböx,tichondrius,863,priest,discipline,18,9,9
Eyepod,bleeding-hollow,863,priest,discipline,18,9,9
Deean,demon-soul,863,priest,discipline,18,9,9
Kumzamboni,dalaran,863,priest,discipline,18,9,9
Saucelord,barthilas,863,priest,discipline,18,9,9
Sentenel,duskwood,863,priest,discipline,18,9,9
Kamisamakiss,illidan,863,priest,discipline,18,9,9
Gäüga,burning-legion,863,priest,discipline,18,9,9
Lemmiewinkzx,sargeras,863,priest,discipline,18,9,9
Healsforcash,bleeding-hollow,863,priest,discipline,21,9,12
Poonanixo,gundrak,863,priest,discipline,22,9,13
Mudbuttman,kelthuzad,863,priest,discipline,24,9,15
Løøtgoblin,skullcrusher,863,priest,discipline,24,9,15
Kamasutra,drakthul,863,priest,discipline,24,9,15
Kyüra,sargeras,863,priest,discipline,30,9,21
Bree,area-52,863,priest,discipline,30,9,21
Bugshott,tichondrius,863,priest,discipline,31,9,22
Tinyjunk,stormrage,862,priest,discipline,12,9,3
Felina,maiev,862,priest,discipline,12,9,3
Mothra,ragnaros,862,priest,discipline,12,9,3
Ocxpriest,azralon,862,priest,discipline,18,9,9
Lacerating,illidan,862,priest,discipline,18,9,9
Neuroflex,proudmoore,862,priest,discipline,18,9,9
Ppomx,tichondrius,862,priest,discipline,18,9,9
Zælya,stormrage,862,priest,discipline,18,9,9
Drerrdaytv,kelthuzad,862,priest,discipline,18,9,9
Aheneas,quelthalas,862,priest,discipline,18,9,9
Redclover,tichondrius,862,priest,discipline,18,9,9
Runnow,area-52,862,priest,discipline,18,9,9
Pandia,quelthalas,862,priest,discipline,18,9,9
Jasolini,area-52,862,priest,discipline,18,9,9
Asmødeus,bleeding-hollow,862,priest,discipline,24,9,15
Ershackleton,illidan,862,priest,discipline,24,9,15
Monvireaux,area-52,862,priest,discipline,24,9,15
Giannis,garrosh,862,priest,discipline,24,9,15
Fäÿë,tichondrius,862,priest,discipline,24,9,15
Drinkmymilk,hakkar,861,priest,discipline,12,9,3
Çøçø,tichondrius,861,priest,discipline,12,9,3
Cremexo,tichondrius,861,priest,discipline,16,9,7
Sorros,cenarion-circle,861,priest,discipline,18,10,8
Synapse,moon-guard,861,priest,discipline,18,9,9
Discountay,burning-legion,861,priest,discipline,18,9,9
Adrameléch,area-52,861,priest,discipline,18,9,9
Kaldric,korgath,861,priest,discipline,18,9,9
Seader,alterac-mountains,861,priest,discipline,24,9,15
Pain,bloodscalp,861,priest,discipline,24,9,15
Vania,tortheldrin,861,priest,discipline,24,9,15
Drzz,tichondrius,860,priest,discipline,18,9,9
Jeraphìm,tichondrius,860,priest,discipline,18,9,9
Desterk,quelthalas,860,priest,discipline,24,9,15
Griggleslol,tichondrius,859,priest,discipline,12,9,3
Demonwizard,sargeras,859,priest,discipline,18,9,9
Belamir,wyrmrest-accord,859,priest,discipline,18,9,9
Selson,stormrage,859,priest,discipline,30,9,21
Notahero,tichondrius,858,priest,discipline,12,9,3
Jacktractive,area-52,858,priest,discipline,15,10,5
Pulso,area-52,858,priest,discipline,18,9,9
Preachermang,laughing-skull,858,priest,discipline,18,9,9
Ricflayer,lothar,858,priest,discipline,24,9,15
Asatruu,stormrage,858,priest,discipline,24,9,15
Roßyn,quelthalas,857,priest,discipline,18,9,9
Prncesspeech,kiljaeden,857,priest,discipline,18,9,9
Rugaru,emerald-dream,857,priest,discipline,21,10,11
Jhonka,nerzhul,856,priest,discipline,12,9,3
Damushi,frostmourne,856,priest,discipline,18,9,9
Sipmemaster,tichondrius,856,priest,discipline,24,9,15
Caiitlynn,quelthalas,856,priest,discipline,24,9,15
Vynthorian,frostmourne,854,priest,discipline,18,9,9
Igotdots,scilla,854,priest,discipline,42,18,24
Sunayriah,illidan,853,priest,discipline,12,9,3
Mangoes,scilla,853,priest,discipline,20,9,11
Uckuck,illidan,851,priest,discipline,18,9,9
Crusifixx,tichondrius,851,priest,discipline,30,9,21
Whitegirlirl,blackrock,850,priest,discipline,12,9,3
Discodeath,tichondrius,848,priest,discipline,18,9,9
Averageheals,stormrage,848,priest,discipline,24,9,15
Nubzin,tichondrius,846,priest,discipline,18,9,9
Brahskeet,illidan,841,priest,discipline,30,9,21
Darkblesxd,quelthalas,837,priest,discipline,12,9,3
Delithara,tichondrius,834,priest,discipline,20,10,10
Thelonioüs,tichondrius,832,priest,discipline,55,20,35
Rockrock,zuljin,831,priest,discipline,14,11,3
Creepa,kul-tiras,831,priest,discipline,16,9,7
Lixer,stormrage,831,priest,discipline,22,9,13
Holyshield,jubeithos,825,priest,discipline,19,10,9
Gnepe,sargeras,824,priest,discipline,29,11,18
Mydranol,tichondrius,824,priest,discipline,29,9,20
Khinthazin,barthilas,815,priest,discipline,48,20,28
Såx,stormreaver,814,priest,discipline,21,9,12
Capriestsunn,turalyon,814,priest,discipline,23,9,14
Arizztocrat,tichondrius,814,priest,discipline,23,9,14
Mikebroowwnn,firetree,813,priest,discipline,22,11,11
Jnglpriestx,thrall,810,priest,discipline,21,10,11
Sincorel,whisperwind,810,priest,discipline,29,11,18
Breathkeeper,proudmoore,810,priest,discipline,27,10,17
Ryukim,tichondrius,809,priest,discipline,26,12,14
Enrika,stormrage,806,priest,discipline,29,13,16
Wellheeled,norgannon,806,priest,discipline,21,9,12
Wingchick,azshara,805,priest,discipline,66,24,42
Alterboy,garrosh,802,priest,discipline,54,21,33
Smíght,thrall,799,priest,discipline,17,9,8
Safewurd,sargeras,796,priest,discipline,14,9,5
Fátima,tichondrius,783,priest,discipline,11,9,2
Tidepodzxo,moon-guard,783,priest,discipline,11,9,2
Butdidudied,sargeras,783,priest,discipline,17,9,8
Pasquell,emerald-dream,779,priest,discipline,15,10,5
Discipline,the-scryers,768,priest,discipline,12,8,4
Voltekkeh,tichondrius,768,priest,discipline,12,8,4
Bubbletrubbl,blackrock,768,priest,discipline,12,8,4
Soloqqt,tichondrius,768,priest,discipline,12,8,4
Sallydaddy,wyrmrest-accord,768,priest,discipline,12,8,4
Spriestbro,emerald-dream,768,priest,discipline,12,8,4
Nydrosia,frostmourne,768,priest,discipline,12,8,4
Mindboink,executus,768,priest,discipline,12,8,4
Smilebomb,tichondrius,768,priest,discipline,12,8,4
Evèlyn,dathremar,768,priest,discipline,12,8,4
Twwety,thrall,768,priest,discipline,12,8,4
Sharkbones,tichondrius,768,priest,discipline,12,8,4
Zenelu,tichondrius,768,priest,discipline,12,8,4
Hallak,gorefiend,768,priest,discipline,12,8,4
Pws,azralon,768,priest,discipline,12,8,4
Criiltwo,area-52,768,priest,discipline,12,8,4
Qohoo,tichondrius,768,priest,discipline,12,8,4
Ñightelf,area-52,768,priest,discipline,12,8,4
Bambi,dunemaul,768,priest,discipline,12,8,4
Goofs,moon-guard,768,priest,discipline,12,8,4
Nausitoo,ragnaros,768,priest,discipline,12,8,4
Bananass,sargeras,768,priest,discipline,12,8,4
Skerrz,illidan,768,priest,discipline,12,8,4
Chigge,area-52,768,priest,discipline,12,8,4
Sìkarìa,illidan,768,priest,discipline,12,8,4
Spitonmejuli,illidan,768,priest,discipline,12,8,4
Myòvó,tichondrius,768,priest,discipline,12,8,4
Slpox,sargeras,768,priest,discipline,12,8,4
Zeepew,tichondrius,768,priest,discipline,12,8,4
Sweethole,illidan,768,priest,discipline,12,8,4
Yansuanmu,tichondrius,768,priest,discipline,12,8,4
Abbyc,frostmourne,768,priest,discipline,12,8,4
Plosux,tichondrius,768,priest,discipline,12,8,4
Heeka,kelthuzad,768,priest,discipline,12,8,4
Fzz,queldorei,768,priest,discipline,12,8,4
Dabû,tichondrius,768,priest,discipline,12,8,4
Xactly,sargeras,768,priest,discipline,12,8,4
Angeldúst,the-forgotten-coast,768,priest,discipline,12,8,4
Notsquishy,tichondrius,768,priest,discipline,12,8,4
Sip,sargeras,768,priest,discipline,12,8,4
Yannigirl,area-52,768,priest,discipline,18,8,10
Robinophelia,sargeras,768,priest,discipline,18,8,10
Sussywussy,stormrage,768,priest,discipline,18,8,10
Dehf,bleeding-hollow,768,priest,discipline,18,8,10
Pearlhaps,darkspear,768,priest,discipline,18,8,10
Jpgpng,tichondrius,768,priest,discipline,18,8,10
Xtradotz,tichondrius,768,priest,discipline,18,8,10
Immörtality,stormrage,768,priest,discipline,18,8,10
Shadowkenlol,tichondrius,768,priest,discipline,18,8,10
Sotore,bleeding-hollow,768,priest,discipline,18,8,10
Mellisonant,stormrage,768,priest,discipline,18,8,10
Punchyxz,illidan,768,priest,discipline,18,8,10
Cowboydanpri,malganis,768,priest,discipline,18,8,10
Melielectra,tichondrius,768,priest,discipline,18,8,10
Drpez,frostmourne,768,priest,discipline,18,8,10
Thewaker,tichondrius,768,priest,discipline,18,8,10
Ifortalot,lothar,768,priest,discipline,18,8,10
Yosps,tichondrius,768,priest,discipline,18,8,10
Alcoric,illidan,768,priest,discipline,18,8,10
Manbelow,bleeding-hollow,768,priest,discipline,27,9,18
Hugeshield,stormrage,768,priest,discipline,24,8,16
Mavalie,zuljin,768,priest,discipline,24,8,16
Dylan,shuhalo,768,priest,discipline,24,8,16
Fréákk,ragnaros,768,priest,discipline,24,8,16
Synnlawl,bleeding-hollow,768,priest,discipline,24,8,16
Minyeong,tichondrius,768,priest,discipline,24,8,16
Jinzp,area-52,768,priest,discipline,24,8,16
Ayani,khadgar,768,priest,discipline,24,8,16
Nuditwo,malganis,768,priest,discipline,24,8,16
Tubshark,moon-guard,767,priest,discipline,12,8,4
Lucènt,frostmourne,767,priest,discipline,12,8,4
Ahnightmares,tichondrius,767,priest,discipline,12,8,4
Piusxll,tichondrius,767,priest,discipline,12,8,4
Geniusidiot,area-52,767,priest,discipline,12,8,4
Pandaboots,illidan,767,priest,discipline,12,8,4
Urgetopurge,dunemaul,767,priest,discipline,12,8,4
Alarisa,chogall,767,priest,discipline,12,8,4
Rainny,proudmoore,767,priest,discipline,12,8,4
Maga,laughing-skull,767,priest,discipline,12,8,4
Cassiuss,kelthuzad,767,priest,discipline,12,8,4
Emiyawagrano,tichondrius,767,priest,discipline,12,8,4
Bittyboom,daggerspine,767,priest,discipline,12,8,4
Mariels,quelthalas,767,priest,discipline,12,8,4
Shinemyhead,stormrage,767,priest,discipline,12,8,4
Hölymöly,moon-guard,767,priest,discipline,12,8,4
Elkies,area-52,767,priest,discipline,12,8,4
Clerkpriest,dragonmaw,767,priest,discipline,12,8,4
Iulu,doomhammer,767,priest,discipline,12,8,4
Holyslap,nerzhul,767,priest,discipline,18,8,10
Hesus,deathwing,767,priest,discipline,18,8,10
Doublesix,malganis,767,priest,discipline,18,8,10
Phobe,windrunner,767,priest,discipline,18,8,10
Idkhowtoheàl,darkspear,767,priest,discipline,18,8,10
Jùdas,ravencrest,767,priest,discipline,18,8,10
Grotti,ragnaros,767,priest,discipline,18,8,10
Analiesa,moon-guard,767,priest,discipline,18,8,10
Byrez,kelthuzad,767,priest,discipline,18,8,10
Wobzqq,tichondrius,767,priest,discipline,18,8,10
Pehkthree,hyjal,767,priest,discipline,18,8,10
Äpriest,sargeras,767,priest,discipline,18,8,10
Weston,bleeding-hollow,767,priest,discipline,24,8,16
Dawnside,wyrmrest-accord,767,priest,discipline,24,8,16
Providennce,tichondrius,767,priest,discipline,24,8,16
Fatherdan,blackrock,767,priest,discipline,24,8,16
Hl,dalaran,767,priest,discipline,24,8,16
Falro,tichondrius,767,priest,discipline,24,8,16
Showakoi,ragnaros,767,priest,discipline,28,9,19
Shirley,skywall,767,priest,discipline,30,8,22
Grizzblessed,sargeras,766,priest,discipline,12,8,4
Eiderwood,moon-guard,766,priest,discipline,12,8,4
Imb,nagrand,766,priest,discipline,12,8,4
Shockalishus,stormrage,766,priest,discipline,12,8,4
Mineral,sargeras,766,priest,discipline,12,8,4
Ariel,veknilash,766,priest,discipline,12,8,4
Jerserra,emerald-dream,766,priest,discipline,12,8,4
Juniorfloyd,tichondrius,766,priest,discipline,12,8,4
Abzorbed,stormrage,766,priest,discipline,12,8,4
Kynnen,mannoroth,766,priest,discipline,12,8,4
Fakér,illidan,766,priest,discipline,12,8,4
Dorós,coilfang,766,priest,discipline,12,8,4
Xhaajyh,area-52,766,priest,discipline,12,8,4
Mondrielris,tichondrius,766,priest,discipline,18,8,10
Spriest,kul-tiras,766,priest,discipline,18,8,10
Saphet,draktharon,766,priest,discipline,18,8,10
Killä,area-52,766,priest,discipline,18,8,10
Gõd,zuluhed,766,priest,discipline,18,8,10
Via,chogall,766,priest,discipline,18,8,10
Yarock,kelthuzad,766,priest,discipline,18,8,10
Hotdice,bleeding-hollow,766,priest,discipline,18,8,10
Shaerel,dalaran,766,priest,discipline,18,8,10
Invisapowa,hyjal,766,priest,discipline,18,8,10
Nogetget,frostmourne,766,priest,discipline,18,8,10
Imhðtep,ragnaros,766,priest,discipline,18,8,10
Purus,tichondrius,766,priest,discipline,18,8,10
Autocorrect,moon-guard,766,priest,discipline,24,8,16
Pollyphia,kiljaeden,765,priest,discipline,12,8,4
Kamelaia,area-52,765,priest,discipline,12,8,4
Bübbler,tichondrius,765,priest,discipline,12,8,4
Frekigeri,dalaran,765,priest,discipline,18,8,10
Lilyanná,tichondrius,765,priest,discipline,18,8,10
Aybaby,kiljaeden,765,priest,discipline,18,8,10
Georgialina,moon-guard,765,priest,discipline,18,8,10
Dirtyprïest,bonechewer,765,priest,discipline,18,8,10
Nursébeardy,whisperwind,765,priest,discipline,18,8,10
Shalther,thrall,765,priest,discipline,18,8,10
Sahray,quelthalas,765,priest,discipline,18,8,10
Xiphz,stormrage,765,priest,discipline,24,8,16
Brosbeforeho,tichondrius,765,priest,discipline,24,8,16
Velinthra,proudmoore,764,priest,discipline,12,8,4
Kathlick,thrall,764,priest,discipline,12,8,4
Lobstersock,malganis,764,priest,discipline,18,8,10
Healrat,thrall,764,priest,discipline,18,8,10
Iciana,proudmoore,764,priest,discipline,18,8,10
Chandrella,zuljin,764,priest,discipline,18,8,10
Glepstein,emerald-dream,764,priest,discipline,18,8,10
Cravex,stormrage,764,priest,discipline,41,18,23
Alinastarkov,area-52,764,priest,discipline,20,8,12
Denarson,kiljaeden,764,priest,discipline,24,8,16
Glownoodle,stormrage,763,priest,discipline,12,8,4
Itchybubble,emerald-dream,763,priest,discipline,12,8,4
Deadheadfred,bonechewer,763,priest,discipline,18,8,10
Rókue,silvermoon,763,priest,discipline,18,8,10
Ashlìe,moon-guard,763,priest,discipline,18,8,10
Squatrack,tichondrius,763,priest,discipline,24,8,16
Reitherïn,drakkari,763,priest,discipline,30,8,22
Nuell,malganis,762,priest,discipline,12,8,4
Yurick,garrosh,762,priest,discipline,12,8,4
Stumbelz,stormrage,762,priest,discipline,12,8,4
Badazzfrank,tichondrius,762,priest,discipline,18,8,10
Preach,boulderfist,761,priest,discipline,24,8,16
Oniyuri,dark-iron,760,priest,discipline,12,8,4
Cheuksin,korgath,759,priest,discipline,12,8,4
Lifesavér,tichondrius,759,priest,discipline,12,8,4
Tâmpîcö,ragnaros,759,priest,discipline,18,8,10
Zalementor,frostmane,758,priest,discipline,24,8,16
Kasamm,nazjatar,756,priest,discipline,18,8,10
Flannigan,veknilash,753,priest,discipline,12,8,4
Alleviate,frostmourne,751,priest,discipline,17,8,9
Chadeux,bleeding-hollow,751,priest,discipline,18,8,10
Whitepi,tichondrius,751,priest,discipline,21,9,12
Àngelheals,proudmoore,750,priest,discipline,14,9,5
Worldhealer,area-52,749,priest,discipline,18,8,10
Knez,ragnaros,745,priest,discipline,21,11,10
Kuazi,frostmourne,745,priest,discipline,29,8,21
Phathighs,nagrand,739,priest,discipline,18,8,10
Doíboó,tichondrius,736,priest,discipline,10,9,1
Pokebox,frostmourne,735,priest,discipline,16,8,8
Jeanclaud,sargeras,735,priest,discipline,17,8,9
Álûcard,illidan,734,priest,discipline,13,9,4
Krewed,ravencrest,734,priest,discipline,14,9,5
Itssehctap,chogall,732,priest,discipline,14,9,5
Aloragon,tichondrius,732,priest,discipline,17,8,9
Priestmain,thrall,731,priest,discipline,17,8,9
Notarealdoc,uldaman,726,priest,discipline,20,9,11
Kloevu,stormrage,725,priest,discipline,17,8,9
Itxo,quelthalas,723,priest,discipline,16,9,7
Invoice,bloodscalp,719,priest,discipline,17,8,9
Pðpë,area-52,718,priest,discipline,11,8,3
Clarity,arthas,718,priest,discipline,15,9,6
Nikniknak,bleeding-hollow,715,priest,discipline,15,9,6
Divìne,kiljaeden,714,priest,discipline,18,9,9
Nås,elune,711,priest,discipline,22,10,12
Trashdiscx,stormrage,707,priest,discipline,25,11,14
Cylocibin,kiljaeden,705,priest,discipline,23,10,13
Sölei,tichondrius,704,priest,discipline,22,8,14
Noneedruid,ragnaros,703,priest,discipline,11,8,3
Aenbubble,tichondrius,703,priest,discipline,14,8,6
Gwenoviere,whisperwind,700,priest,discipline,22,8,14
Styléßéndérx,illidan,687,priest,discipline,11,8,3
Hateraide,galakrond,687,priest,discipline,11,8,3
Zylemm,malganis,687,priest,discipline,17,8,9
Väin,proudmoore,685,priest,discipline,27,10,17
Läsombra,area-52,684,priest,discipline,17,9,8
Xantard,malganis,672,priest,discipline,12,7,5
Eneldz,quelthalas,672,priest,discipline,12,7,5
Whataday,tichondrius,672,priest,discipline,12,7,5
Holyhand,auchindoun,672,priest,discipline,12,7,5
Merkurial,illidan,672,priest,discipline,12,7,5
Dwarfxomp,ragnaros,672,priest,discipline,12,7,5
Pandaniaco,drakkari,672,priest,discipline,12,7,5
Sadsadge,sargeras,672,priest,discipline,12,7,5
Goyqqp,illidan,672,priest,discipline,12,7,5
Imeldaa,illidan,672,priest,discipline,12,7,5
Holyscuz,zuljin,672,priest,discipline,12,7,5
Jennaôrtega,tichondrius,672,priest,discipline,12,7,5
Oshlyn,tichondrius,672,priest,discipline,12,7,5
Fireflyly,tichondrius,672,priest,discipline,12,7,5
Scandi,tichondrius,672,priest,discipline,12,7,5
Kymomeh,sargeras,672,priest,discipline,12,7,5
Sevros,moon-guard,672,priest,discipline,12,7,5
Brehzy,zuljin,672,priest,discipline,12,7,5
Yodud,tichondrius,672,priest,discipline,12,7,5
Burgersl,illidan,672,priest,discipline,12,7,5
Tuladim,tichondrius,672,priest,discipline,12,7,5
Nellìel,whisperwind,672,priest,discipline,12,7,5
Mixedprotein,tichondrius,672,priest,discipline,12,7,5
Babe,aerie-peak,672,priest,discipline,12,7,5
Greenteababy,tichondrius,672,priest,discipline,12,7,5
Aeyde,proudmoore,672,priest,discipline,12,7,5
Kiloe,tichondrius,672,priest,discipline,12,7,5
Sabrino,azralon,672,priest,discipline,12,7,5
Ahnit,azralon,672,priest,discipline,12,7,5
Morcelina,illidan,672,priest,discipline,12,7,5
Pinkprincess,tichondrius,672,priest,discipline,12,7,5
Toyz,arthas,672,priest,discipline,12,7,5
Sideform,tichondrius,672,priest,discipline,12,7,5
Walpurgis,skywall,672,priest,discipline,12,7,5
Rickmason,frostmane,672,priest,discipline,12,7,5
Shadion,sargeras,672,priest,discipline,12,7,5
Untainted,malganis,672,priest,discipline,12,7,5
Blackoss,sargeras,672,priest,discipline,12,7,5
Basedgód,arathor,672,priest,discipline,12,7,5
Omsi,emerald-dream,672,priest,discipline,12,7,5
Horízon,illidan,672,priest,discipline,12,7,5
Ogdisc,gallywix,672,priest,discipline,12,7,5
Ikkemen,tichondrius,672,priest,discipline,12,7,5
Nerfdisc,elune,672,priest,discipline,12,7,5
Snootlel,sargeras,672,priest,discipline,12,7,5
Mesuki,malganis,672,priest,discipline,12,7,5
Moondèx,maelstrom,672,priest,discipline,12,7,5
Marejayne,tichondrius,672,priest,discipline,12,7,5
Harrydisc,shattered-hand,672,priest,discipline,12,7,5
Dráugr,ragnaros,672,priest,discipline,12,7,5
Ìceheals,tichondrius,672,priest,discipline,12,7,5
Vadrenp,skullcrusher,672,priest,discipline,12,7,5
Pavesarii,proudmoore,672,priest,discipline,12,7,5
Absorbn,barthilas,672,priest,discipline,12,7,5
Artirie,darkspear,672,priest,discipline,12,7,5
Eddic,wyrmrest-accord,672,priest,discipline,12,7,5
Onipapae,frostmourne,672,priest,discipline,12,7,5
Powerwôrdhug,destromath,672,priest,discipline,12,7,5
Tòodles,stormrage,672,priest,discipline,12,7,5
Asgà,azgalor,672,priest,discipline,12,7,5
Gucciboon,frostmourne,672,priest,discipline,12,7,5
Interacts,darkspear,672,priest,discipline,12,7,5
Djwienerbum,darkspear,672,priest,discipline,12,7,5
Jenhawkinsx,frostmourne,672,priest,discipline,12,7,5
Clevelandboy,blackrock,672,priest,discipline,12,7,5
Ninielly,stormrage,672,priest,discipline,14,8,6
Photicz,thrall,672,priest,discipline,17,8,9
Manbooty,illidan,672,priest,discipline,18,7,11
Sagapriest,hyjal,672,priest,discipline,18,7,11
Dingledot,sargeras,672,priest,discipline,18,7,11
Aryeinna,illidan,672,priest,discipline,18,7,11
Azari,illidan,672,priest,discipline,18,7,11
Xayda,area-52,672,priest,discipline,18,7,11
Rigotakx,illidan,672,priest,discipline,18,7,11
Imagees,stormscale,672,priest,discipline,18,7,11
Lidole,barthilas,672,priest,discipline,18,7,11
Dxs,hydraxis,672,priest,discipline,18,7,11
Joeybats,frostwolf,672,priest,discipline,18,7,11
Hayna,emerald-dream,672,priest,discipline,18,7,11
Criminalsp,frostmourne,672,priest,discipline,18,7,11
Tisifone,ragnaros,672,priest,discipline,18,7,11
Townbicyclé,area-52,672,priest,discipline,18,7,11
Burblespue,burning-blade,672,priest,discipline,18,7,11
Cryptoccocus,zuljin,672,priest,discipline,18,7,11
Brotheraram,kelthuzad,672,priest,discipline,18,7,11
Iwillrezguys,tichondrius,672,priest,discipline,18,7,11
Upsahl,area-52,672,priest,discipline,18,7,11
Burkett,sargeras,672,priest,discipline,18,7,11
Mockr,kiljaeden,672,priest,discipline,18,7,11
Ayumihamaski,tichondrius,672,priest,discipline,18,7,11
Xalty,emerald-dream,672,priest,discipline,25,8,17
Spampws,aerie-peak,672,priest,discipline,24,7,17
Diebetus,zuljin,672,priest,discipline,24,7,17
Pïque,proudmoore,672,priest,discipline,24,7,17
Mindfak,bleeding-hollow,672,priest,discipline,24,7,17
Ezrah,kelthuzad,672,priest,discipline,24,7,17
Autogenic,malganis,672,priest,discipline,24,7,17
Babymieo,illidan,672,priest,discipline,24,7,17
Polyesterp,frostmourne,672,priest,discipline,24,7,17
Discpriestxo,malganis,672,priest,discipline,30,7,23
Milkymommies,tichondrius,671,priest,discipline,12,7,5
Crossblèssèr,sargeras,671,priest,discipline,12,7,5
Altari,whisperwind,671,priest,discipline,12,7,5
Esohpr,frostmourne,671,priest,discipline,12,7,5
Kenprizle,sargeras,671,priest,discipline,12,7,5
Serafím,goldrinn,671,priest,discipline,12,7,5
Saintsnap,bleeding-hollow,671,priest,discipline,12,7,5
Debigheal,stormrage,671,priest,discipline,12,7,5
Skgangmm,tichondrius,671,priest,discipline,12,7,5
Geyforpray,tichondrius,671,priest,discipline,12,7,5
Azhley,sargeras,671,priest,discipline,12,7,5
Zarfs,burning-blade,671,priest,discipline,12,7,5
Beocca,nerzhul,671,priest,discipline,12,7,5
Atheenia,icecrown,671,priest,discipline,12,7,5
Jeremey,darkspear,671,priest,discipline,12,7,5
Mahelet,drakkari,671,priest,discipline,12,7,5
Asilberixi,tichondrius,671,priest,discipline,12,7,5
Tiffk,hydraxis,671,priest,discipline,12,7,5
Travakel,proudmoore,671,priest,discipline,12,7,5
Bombinburbon,durotan,671,priest,discipline,12,7,5
Danílo,quelthalas,671,priest,discipline,12,7,5
Donkeycube,tichondrius,671,priest,discipline,12,7,5
Lumyra,malganis,671,priest,discipline,12,7,5
Fatherleem,tichondrius,671,priest,discipline,12,7,5
Moonpeace,tichondrius,671,priest,discipline,12,7,5
Curra,frostmourne,671,priest,discipline,12,7,5
Trinidy,illidan,671,priest,discipline,12,7,5
Thattpriest,thrall,671,priest,discipline,12,7,5
Clerkbum,emerald-dream,671,priest,discipline,12,7,5
Maenard,emerald-dream,671,priest,discipline,12,7,5
Linlight,stormrage,671,priest,discipline,12,7,5
Windwolf,dalvengyr,671,priest,discipline,12,7,5
Synesth,area-52,671,priest,discipline,12,7,5
Hammersholy,stormrage,671,priest,discipline,12,7,5
Epik,moknathal,671,priest,discipline,15,8,7
Painkiller,lightbringer,671,priest,discipline,17,7,10
Revivemepls,tichondrius,671,priest,discipline,18,7,11
Adofthealer,illidan,671,priest,discipline,18,7,11
Pecadu,azralon,671,priest,discipline,18,7,11
Noiri,aegwynn,671,priest,discipline,18,7,11
Slobmygnob,illidan,671,priest,discipline,18,7,11
Twisturfait,tichondrius,671,priest,discipline,18,7,11
Xalatath,stormrage,671,priest,discipline,18,7,11
Randomheal,dunemaul,671,priest,discipline,18,7,11
Merxy,bleeding-hollow,671,priest,discipline,18,7,11
Spyderco,mugthol,671,priest,discipline,18,7,11
Rillding,tichondrius,671,priest,discipline,18,7,11
Gringøtt,bloodscalp,671,priest,discipline,18,7,11
Ganelm,vashj,671,priest,discipline,18,7,11
Xiaozhui,tichondrius,671,priest,discipline,24,7,17
Caeda,icecrown,671,priest,discipline,24,7,17
Beetrap,wyrmrest-accord,671,priest,discipline,24,7,17
Floorpray,tichondrius,671,priest,discipline,24,7,17
Vodussy,stormrage,671,priest,discipline,24,7,17
Dirtydogma,zuljin,671,priest,discipline,30,7,23
Malansuo,wyrmrest-accord,671,priest,discipline,30,7,23
Cromagnøn,dalaran,670,priest,discipline,12,7,5
Fatherhands,illidan,670,priest,discipline,12,7,5
Fedge,kelthuzad,670,priest,discipline,12,7,5
Donus,frostmane,670,priest,discipline,12,7,5
Xð,jubeithos,670,priest,discipline,12,7,5
Mortïmer,alleria,670,priest,discipline,12,7,5
Triplekil,tichondrius,670,priest,discipline,12,7,5
Antìdote,tichondrius,670,priest,discipline,12,7,5
Réíayánámí,jubeithos,670,priest,discipline,12,7,5
Mitras,moon-guard,670,priest,discipline,12,7,5
Dotsrboe,illidan,670,priest,discipline,12,7,5
Angelicduck,illidan,670,priest,discipline,12,7,5
Madskills,shadow-council,670,priest,discipline,12,7,5
Kastwalker,earthen-ring,670,priest,discipline,12,7,5
Brokennurse,area-52,670,priest,discipline,13,7,6
Spiceenjoyer,emerald-dream,670,priest,discipline,15,8,7
Râku,area-52,670,priest,discipline,18,7,11
Xeras,ravencrest,670,priest,discipline,18,7,11
Texmix,stormrage,670,priest,discipline,26,9,17
Zgzz,stormrage,670,priest,discipline,24,7,17
Kerfos,azralon,669,priest,discipline,10,8,2
Ðowörk,illidan,669,priest,discipline,12,7,5
Holyulf,ragnaros,669,priest,discipline,12,7,5
Dorst,bonechewer,669,priest,discipline,18,7,11
Gabryanna,emerald-dream,669,priest,discipline,18,7,11
Waterßoÿ,emerald-dream,669,priest,discipline,21,8,13
Laj,proudmoore,669,priest,discipline,24,7,17
Yuricksus,malganis,669,priest,discipline,24,7,17
Nielic,arygos,668,priest,discipline,12,7,5
Darthvalak,illidan,668,priest,discipline,12,7,5
Tílanga,azralon,668,priest,discipline,12,7,5
Butterflyblu,ragnaros,668,priest,discipline,13,7,6
Typhon,blackhand,668,priest,discipline,18,7,11
Albertth,ragnaros,668,priest,discipline,18,7,11
Turdsyn,sargeras,668,priest,discipline,18,7,11
Bwonshanji,thrall,667,priest,discipline,18,7,11
Healzutwo,tichondrius,667,priest,discipline,18,7,11
Nikasaur,azgalor,667,priest,discipline,18,7,11
Tassik,dalaran,667,priest,discipline,18,7,11
Glisserin,zuljin,666,priest,discipline,12,7,5
Sihua,illidan,666,priest,discipline,18,7,11
Charlie,azshara,665,priest,discipline,12,7,5
Pharaoh,deathwing,665,priest,discipline,18,7,11
Crossblesser,alleria,663,priest,discipline,12,7,5
Linndy,illidan,659,priest,discipline,12,7,5
Rcx,sargeras,655,priest,discipline,17,7,10
Devivi,malganis,654,priest,discipline,17,7,10
Plasticbag,frostmourne,654,priest,discipline,17,7,10
Lonerush,hyjal,652,priest,discipline,19,7,12
Germanica,area-52,645,priest,discipline,42,14,28
Posivibesz,tichondrius,639,priest,discipline,14,8,6
Pridesp,tichondrius,639,priest,discipline,14,8,6
Dreadxshadow,stormrage,628,priest,discipline,24,12,12
Clubmoneth,sargeras,624,priest,discipline,9,8,1
Swagacious,malganis,624,priest,discipline,13,8,5
Holysmegma,dreadmaul,623,priest,discipline,11,7,4
Ezpríest,kelthuzad,623,priest,discipline,11,7,4
Discotec,stormrage,623,priest,discipline,11,7,4
Praisedalort,illidan,621,priest,discipline,15,8,7
Tmnaarcanttv,tichondrius,618,priest,discipline,13,8,5
Wyldpiece,frostmourne,617,priest,discipline,25,9,16
Elevatez,stormrage,608,priest,discipline,10,7,3
Poøpoopeepee,tichondrius,607,priest,discipline,11,7,4
Åffliction,sargeras,607,priest,discipline,11,7,4
Limumu,barthilas,607,priest,discipline,11,7,4
Coolzo,dethecus,607,priest,discipline,14,8,6
Jimyo,tichondrius,607,priest,discipline,15,7,8
Codiroli,tichondrius,606,priest,discipline,14,7,7
Voif,proudmoore,606,priest,discipline,16,7,9
Silverspöön,bleeding-hollow,590,priest,discipline,19,7,12
Applekrisp,sargeras,589,priest,discipline,25,8,17
Icecoldmarg,illidan,576,priest,discipline,6,6,0
Eldoras,zuljin,576,priest,discipline,6,6,0
Pearl,chogall,576,priest,discipline,6,6,0
Gód,moonrunner,576,priest,discipline,6,6,0
Chop,kelthuzad,576,priest,discipline,6,6,0
Porffy,malygos,576,priest,discipline,6,6,0
Healia,tichondrius,576,priest,discipline,6,6,0
Smashfacëwin,tichondrius,576,priest,discipline,6,6,0
Darkxd,bleeding-hollow,576,priest,discipline,6,6,0
Illmatíc,malganis,576,priest,discipline,6,6,0
Madelyn,stormrage,576,priest,discipline,6,6,0
Kwx,tichondrius,576,priest,discipline,6,6,0
Zaperama,tichondrius,576,priest,discipline,12,6,6
Riasgremøry,stormrage,576,priest,discipline,12,6,6
Imfresh,illidan,576,priest,discipline,12,6,6
Akinap,thrall,576,priest,discipline,12,6,6
Xiaochenchen,tichondrius,576,priest,discipline,12,6,6
Xanarcine,moon-guard,576,priest,discipline,12,6,6
Taviesh,tichondrius,576,priest,discipline,12,6,6
Decades,moon-guard,576,priest,discipline,12,6,6
Ikancastt,tichondrius,576,priest,discipline,12,6,6
Nokzo,dalaran,576,priest,discipline,12,6,6
Flapjakked,tichondrius,576,priest,discipline,12,6,6
Saelomism,frostmourne,576,priest,discipline,12,6,6
Priesterson,tichondrius,576,priest,discipline,12,6,6
Stat,thrall,576,priest,discipline,12,6,6
Kawasakix,tichondrius,576,priest,discipline,12,6,6
Ereessea,hyjal,576,priest,discipline,12,6,6
Ripret,tichondrius,576,priest,discipline,12,6,6
Purpskurp,stormrage,576,priest,discipline,12,6,6
Surletoit,tichondrius,576,priest,discipline,12,6,6
Mediterranee,tichondrius,576,priest,discipline,12,6,6
Bernietopper,tichondrius,576,priest,discipline,12,6,6
Saviorsëlf,tichondrius,576,priest,discipline,12,6,6
Estyy,tichondrius,576,priest,discipline,12,6,6
Saintjpii,tichondrius,576,priest,discipline,12,6,6
Kujoh,tichondrius,576,priest,discipline,12,6,6
Panikâ,thrall,576,priest,discipline,12,6,6
Wodpriestx,stormrage,576,priest,discipline,12,6,6
Luun,bleeding-hollow,576,priest,discipline,12,6,6
Annuli,stormrage,576,priest,discipline,12,6,6
Lisau,tichondrius,576,priest,discipline,12,6,6
Kurtx,tichondrius,576,priest,discipline,12,6,6
Syncope,garona,576,priest,discipline,12,6,6
Darkinfusion,illidan,576,priest,discipline,12,6,6
Kzo,gnomeregan,576,priest,discipline,12,6,6
Celypriest,moon-guard,576,priest,discipline,12,6,6
Wabie,illidan,576,priest,discipline,12,6,6
Scripture,stormreaver,576,priest,discipline,12,6,6
Keldrii,sentinels,576,priest,discipline,12,6,6
Rëy,bleeding-hollow,576,priest,discipline,12,6,6
Velýs,moon-guard,576,priest,discipline,12,6,6
Rin,ghostlands,576,priest,discipline,12,6,6
Ahnassi,stormrage,576,priest,discipline,12,6,6
Wøah,stormrage,576,priest,discipline,12,6,6
Nieni,wyrmrest-accord,576,priest,discipline,12,6,6
Babburger,tichondrius,576,priest,discipline,12,6,6
Treri,bleeding-hollow,576,priest,discipline,12,6,6
Seléne,tichondrius,576,priest,discipline,12,6,6
Bloodfaith,stormrage,576,priest,discipline,12,6,6
Datwunguy,sargeras,576,priest,discipline,12,6,6
Johnio,tichondrius,576,priest,discipline,12,6,6
Bìgdisc,sargeras,576,priest,discipline,12,6,6
Puritykitty,zuljin,576,priest,discipline,12,6,6
Nineoneoneh,stormrage,576,priest,discipline,12,6,6
Warlocks,lightbringer,576,priest,discipline,12,6,6
Capriestsunx,malfurion,576,priest,discipline,12,6,6
Bumps,zuljin,576,priest,discipline,12,6,6
Yuntingmingo,tichondrius,576,priest,discipline,12,6,6
Helacia,jubeithos,576,priest,discipline,12,6,6
Raichu,blackrock,576,priest,discipline,12,6,6
Chicoryx,illidan,576,priest,discipline,12,6,6
Jaybudhope,tichondrius,576,priest,discipline,12,6,6
Missrachel,kiljaeden,576,priest,discipline,12,6,6
Bns,perenolde,576,priest,discipline,12,6,6
Inukimi,sargeras,576,priest,discipline,12,6,6
Moselol,tichondrius,576,priest,discipline,12,6,6
Shwayp,zuljin,576,priest,discipline,12,6,6
Electricdisc,korgath,576,priest,discipline,12,6,6
Padrë,tichondrius,576,priest,discipline,12,6,6
Ugork,gundrak,576,priest,discipline,12,6,6
Jopocket,bleeding-hollow,576,priest,discipline,12,6,6
Nethir,moon-guard,576,priest,discipline,12,6,6
Priil,emerald-dream,576,priest,discipline,12,6,6
Bigsàd,proudmoore,576,priest,discipline,12,6,6
Mykillakilla,wyrmrest-accord,576,priest,discipline,12,6,6
Altheria,malganis,576,priest,discipline,12,6,6
Dimebahg,mugthol,576,priest,discipline,12,6,6
Stankychimpo,malganis,576,priest,discipline,12,6,6
Neep,turalyon,576,priest,discipline,12,6,6
Scrublahr,the-venture-co,576,priest,discipline,12,6,6
Aenai,sargeras,576,priest,discipline,12,6,6
Chaotikx,kelthuzad,576,priest,discipline,12,6,6
Photicz,malganis,576,priest,discipline,12,6,6
Elbruha,frostmourne,576,priest,discipline,12,6,6
Asleep,sargeras,576,priest,discipline,12,6,6
Skiza,stormrage,576,priest,discipline,12,6,6
Kabutta,stormrage,576,priest,discipline,12,6,6
Boppdot,tichondrius,576,priest,discipline,12,6,6
Johnnysyns,barthilas,576,priest,discipline,12,6,6
Bawahaka,proudmoore,576,priest,discipline,12,6,6
Armour,kelthuzad,576,priest,discipline,12,6,6
Fatherjohnny,azuremyst,576,priest,discipline,12,6,6
Prostrat,deathwing,576,priest,discipline,12,6,6
Napr,proudmoore,576,priest,discipline,12,6,6
Rïshloo,ragnaros,576,priest,discipline,12,6,6
Instaboned,sargeras,576,priest,discipline,12,6,6
Moqoro,azralon,576,priest,discipline,12,6,6
Slouch,emerald-dream,576,priest,discipline,12,6,6
Astralshadow,barthilas,576,priest,discipline,12,6,6
Bambucha,ragnaros,576,priest,discipline,12,6,6
Thelastfight,frostmourne,576,priest,discipline,12,6,6
Bootypudding,moon-guard,576,priest,discipline,12,6,6
Mayineedruid,ragnaros,576,priest,discipline,17,8,9
Holytickles,stormrage,576,priest,discipline,15,7,8
Kimchpower,tichondrius,576,priest,discipline,13,6,7
Preyforme,tichondrius,576,priest,discipline,13,6,7
Holytitanzz,quelthalas,576,priest,discipline,16,7,9
Speedboat,frostmourne,576,priest,discipline,14,6,8
Brodel,dark-iron,576,priest,discipline,15,6,9
Shadowdoc,illidan,576,priest,discipline,15,6,9
Mayzal,emerald-dream,576,priest,discipline,24,9,15
Fiéstah,illidan,576,priest,discipline,21,7,14
Voldenmort,dragonmaw,576,priest,discipline,18,6,12
Spøokz,stormreaver,576,priest,discipline,18,6,12
Khegan,area-52,576,priest,discipline,18,6,12
Jiedx,tichondrius,576,priest,discipline,18,6,12
Lildes,tichondrius,576,priest,discipline,18,6,12
Averages,stormrage,576,priest,discipline,18,6,12
Dots,tichondrius,576,priest,discipline,18,6,12
Shinck,ragnaros,576,priest,discipline,18,6,12
Xpenance,ragnaros,576,priest,discipline,18,6,12
Keepsleepin,stormrage,576,priest,discipline,18,6,12
Sandelios,aggramar,576,priest,discipline,18,6,12
Thedeadheal,malganis,576,priest,discipline,18,6,12
Purifyhoes,sargeras,576,priest,discipline,18,6,12
Dgpriest,tichondrius,576,priest,discipline,18,6,12
Peaky,moonrunner,576,priest,discipline,18,6,12
Priestmass,dalaran,576,priest,discipline,18,6,12
Fartnutts,dalaran,576,priest,discipline,18,6,12
Jarzo,thunderhorn,576,priest,discipline,18,6,12
Sojang,tichondrius,576,priest,discipline,18,6,12
Ímgucci,malganis,576,priest,discipline,18,6,12
Nupanda,tichondrius,576,priest,discipline,18,6,12
Starp,tichondrius,576,priest,discipline,18,6,12
Snupyfangirl,area-52,576,priest,discipline,18,6,12
Fadedhalo,magtheridon,576,priest,discipline,18,6,12
Soulheal,zuljin,576,priest,discipline,18,6,12
Greenzombiez,area-52,576,priest,discipline,18,6,12
Deadlylight,frostmourne,576,priest,discipline,18,6,12
Stepbrohelp,barthilas,576,priest,discipline,18,6,12
Çørrúptíøñz,tichondrius,576,priest,discipline,18,6,12
Decokim,tichondrius,576,priest,discipline,18,6,12
Repriest,malganis,576,priest,discipline,18,6,12
Synaptikk,proudmoore,576,priest,discipline,18,6,12
Slthrysnake,area-52,576,priest,discipline,18,6,12
Komicks,tichondrius,576,priest,discipline,18,6,12
Aquinas,executus,576,priest,discipline,18,6,12
Pekeatz,tichondrius,576,priest,discipline,18,6,12
Slimshadylp,illidan,576,priest,discipline,18,6,12
Faya,proudmoore,576,priest,discipline,18,6,12
Drupith,dalaran,576,priest,discipline,24,6,18
Cûrry,bleeding-hollow,576,priest,discipline,24,6,18
Fearles,thrall,576,priest,discipline,24,6,18
Felixfire,moon-guard,576,priest,discipline,24,6,18
Nachòs,wildhammer,575,priest,discipline,6,6,0
Astrìx,tichondrius,575,priest,discipline,6,6,0
Kephrek,eonar,575,priest,discipline,6,6,0
Gdrf,sargeras,575,priest,discipline,12,6,6
Khaibit,stormrage,575,priest,discipline,12,6,6
Grasy,ragnaros,575,priest,discipline,12,6,6
Lúçíd,sargeras,575,priest,discipline,12,6,6
Supermelt,emerald-dream,575,priest,discipline,12,6,6
Paqwee,tichondrius,575,priest,discipline,12,6,6
Wickedmoon,emerald-dream,575,priest,discipline,12,6,6
Haedn,azralon,575,priest,discipline,12,6,6
Spiritbear,thrall,575,priest,discipline,12,6,6
Shaellito,goldrinn,575,priest,discipline,12,6,6
Brahmin,nazjatar,575,priest,discipline,12,6,6
Krossvoid,thrall,575,priest,discipline,12,6,6
Nineoneone,kilrogg,575,priest,discipline,12,6,6
Silveri,thrall,575,priest,discipline,12,6,6
Nejisaiyan,sargeras,575,priest,discipline,12,6,6
Nevertelsp,malganis,575,priest,discipline,12,6,6
Mcfluffin,aggramar,575,priest,discipline,12,6,6
Belïeve,sargeras,575,priest,discipline,12,6,6
Uncensøred,tichondrius,575,priest,discipline,12,6,6
Chowdä,kiljaeden,575,priest,discipline,12,6,6
Akapegando,ragnaros,575,priest,discipline,12,6,6
Pinaybebe,kiljaeden,575,priest,discipline,12,6,6
Porltrazlok,area-52,575,priest,discipline,12,6,6
Eclipsos,dalaran,575,priest,discipline,12,6,6
Forroc,stormrage,575,priest,discipline,12,6,6
Umbramortìs,tichondrius,575,priest,discipline,12,6,6
Herzattacken,malganis,575,priest,discipline,12,6,6
Imhotap,illidan,575,priest,discipline,12,6,6
Andriloveyou,barthilas,575,priest,discipline,12,6,6
Juress,area-52,575,priest,discipline,12,6,6
Swaptohealer,misha,575,priest,discipline,12,6,6
Amgen,bleeding-hollow,575,priest,discipline,12,6,6
Moarhaste,kelthuzad,575,priest,discipline,12,6,6
Nordheal,stormrage,575,priest,discipline,12,6,6
Peeinbottles,stormrage,575,priest,discipline,16,7,9
Biltpeter,tichondrius,575,priest,discipline,15,6,9
Alpacasama,illidan,575,priest,discipline,18,6,12
Runecarver,anvilmar,575,priest,discipline,18,6,12
Mortaroth,doomhammer,575,priest,discipline,18,6,12
Villageidiot,lightbringer,575,priest,discipline,18,6,12
Barrist,wyrmrest-accord,575,priest,discipline,18,6,12
Templár,dalaran,575,priest,discipline,18,6,12
Snuzziest,darkspear,575,priest,discipline,18,6,12
Beymax,moon-guard,575,priest,discipline,24,6,18
Required,eonar,575,priest,discipline,24,6,18
Baldpate,tichondrius,575,priest,discipline,24,6,18
Wilita,drakkari,574,priest,discipline,12,6,6
Epicaah,quelthalas,574,priest,discipline,12,6,6
Darkphoxy,azralon,574,priest,discipline,12,6,6
Donmuneco,aerie-peak,574,priest,discipline,12,6,6
Tirapiedras,ragnaros,574,priest,discipline,12,6,6
Chalmersyo,tichondrius,574,priest,discipline,12,6,6
Evilmajor,icecrown,574,priest,discipline,12,6,6
Senareyn,thrall,574,priest,discipline,12,6,6
Mikol,eredar,574,priest,discipline,12,6,6
Xahlia,darkspear,574,priest,discipline,18,6,12
Mezervescent,thrall,574,priest,discipline,24,6,18
Papadarkness,tichondrius,574,priest,discipline,24,6,18
Ambulam,draenor,573,priest,discipline,12,6,6
Reilean,sargeras,573,priest,discipline,12,6,6
Myhealz,agamaggan,573,priest,discipline,12,6,6
Axhia,dentarg,573,priest,discipline,12,6,6
Ságrádá,area-52,573,priest,discipline,12,6,6
Prebruisz,baelgun,573,priest,discipline,12,6,6
Fanaeth,arathor,573,priest,discipline,12,6,6
Phantoms,moon-guard,573,priest,discipline,18,6,12
Izzymariepie,dragonmaw,573,priest,discipline,18,6,12
Naimillia,stormrage,573,priest,discipline,18,6,12
Banepriest,sargeras,573,priest,discipline,18,6,12
Bigchip,sargeras,573,priest,discipline,24,6,18
Aragingclue,burning-legion,572,priest,discipline,12,6,6
Marpi,quelthalas,572,priest,discipline,24,6,18
Xidems,frostmourne,572,priest,discipline,24,6,18
Voidlordd,kelthuzad,571,priest,discipline,12,6,6
Trialla,medivh,571,priest,discipline,24,6,18
Grandraf,dreadmaul,570,priest,discipline,12,6,6
Antipreist,bonechewer,567,priest,discipline,12,6,6
Eumalfa,dalaran,567,priest,discipline,12,6,6
Gwynne,barthilas,559,priest,discipline,11,6,5
Adeptphd,tichondrius,559,priest,discipline,23,6,17
Justfaith,barthilas,558,priest,discipline,17,6,11
Ohmzi,auchindoun,558,priest,discipline,17,6,11
Garyhooves,zuljin,558,priest,discipline,17,6,11
Zeno,haomarush,557,priest,discipline,11,6,5
Gringotaco,tichondrius,554,priest,discipline,26,9,17
Ãdolfhealer,dalaran,544,priest,discipline,10,7,3
Healzium,blackwater-raiders,544,priest,discipline,16,6,10
Zaroff,turalyon,543,priest,discipline,11,6,5
Potatopriest,frostmourne,543,priest,discipline,11,6,5
Qberto,illidan,543,priest,discipline,17,6,11
Mørbol,tichondrius,541,priest,discipline,20,7,13
Moonlightx,destromath,528,priest,discipline,9,7,2
Tealien,dalaran,527,priest,discipline,11,6,5
Quartzolio,azralon,527,priest,discipline,17,6,11
Nosgoróth,quelthalas,522,priest,discipline,13,7,6
Dotdotdead,earthen-ring,522,priest,discipline,16,7,9
Balikina,stormrage,521,priest,discipline,17,7,10
Onahaihu,tichondrius,521,priest,discipline,20,7,13
Bhavu,tichondrius,521,priest,discipline,22,7,15
Identìty,moon-guard,521,priest,discipline,28,7,21
Øçñæøæçñøñçæ,sargeras,520,priest,discipline,12,7,5
Scratchmyear,tichondrius,520,priest,discipline,16,7,9
Ethari,crushridge,520,priest,discipline,21,7,14
Enphý,quelthalas,511,priest,discipline,11,6,5
Bigtang,kiljaeden,511,priest,discipline,14,6,8
Nickerbocker,nazgrel,511,priest,discipline,16,6,10
Lilmad,stormrage,511,priest,discipline,20,6,14
Yiyoperro,quelthalas,511,priest,discipline,22,6,16
Horridheals,shandris,505,priest,discipline,10,6,4
Earys,ragnaros,496,priest,discipline,22,6,16
Aquandrelea,aegwynn,495,priest,discipline,7,6,1
Leist,ragnaros,495,priest,discipline,11,6,5
Yait,tichondrius,495,priest,discipline,14,7,7
Reâpêr,kelthuzad,489,priest,discipline,19,7,12
Kazedx,barthilas,480,priest,discipline,6,5,1
Corov,korgath,480,priest,discipline,6,5,1
Sixnoh,moonrunner,480,priest,discipline,6,5,1
Privx,bleeding-hollow,480,priest,discipline,6,5,1
Xorriz,bleeding-hollow,480,priest,discipline,6,5,1
Stegp,kelthuzad,480,priest,discipline,6,5,1
Veldin,malfurion,480,priest,discipline,6,5,1
Kénnypowers,tichondrius,480,priest,discipline,6,5,1
Phantømz,zuljin,480,priest,discipline,6,5,1
Aetonyx,anvilmar,480,priest,discipline,6,5,1
Prettyxelinz,barthilas,480,priest,discipline,6,5,1
Tamajka,the-forgotten-coast,480,priest,discipline,6,5,1
Djd,frostmourne,480,priest,discipline,6,5,1
Bulleitrye,emerald-dream,480,priest,discipline,6,5,1
Armanp,hyjal,480,priest,discipline,6,5,1
Danawhitex,thrall,480,priest,discipline,6,5,1
Hansa,ragnaros,480,priest,discipline,6,5,1
Kiwioom,frostmourne,480,priest,discipline,6,5,1
Pèngotnerfed,exodar,480,priest,discipline,6,5,1
Mercedés,alleria,480,priest,discipline,6,5,1
Káldorei,proudmoore,480,priest,discipline,6,5,1
Thugliffe,frostmourne,480,priest,discipline,6,5,1
Deathdreamer,azjolnerub,480,priest,discipline,6,5,1
Bebyyourside,malganis,480,priest,discipline,6,5,1
Cxmplex,malganis,480,priest,discipline,6,5,1
Uncletouchy,illidan,480,priest,discipline,6,5,1
Dzikuss,aegwynn,480,priest,discipline,6,5,1
Shadowgïrl,azralon,480,priest,discipline,6,5,1
Snugzee,sargeras,480,priest,discipline,6,5,1
Elitejustin,area-52,480,priest,discipline,6,5,1
Nawtyforever,tichondrius,480,priest,discipline,6,5,1
Catfiend,moon-guard,480,priest,discipline,6,5,1
Mestíza,quelthalas,480,priest,discipline,6,5,1
Felesindra,illidan,480,priest,discipline,6,5,1
Markzugrberg,emerald-dream,480,priest,discipline,6,5,1
Pertril,stormrage,480,priest,discipline,6,5,1
Kardinalkeso,frostmourne,480,priest,discipline,6,5,1
Hateutoo,sargeras,480,priest,discipline,6,5,1
Noite,azralon,480,priest,discipline,6,5,1
Unishooter,illidan,480,priest,discipline,6,5,1
Mindtrick,zuljin,480,priest,discipline,8,5,3
Gineska,tichondrius,480,priest,discipline,10,6,4
Imwithham,tichondrius,480,priest,discipline,10,6,4
Twinkogood,nemesis,480,priest,discipline,9,5,4
Serenderpity,moon-guard,480,priest,discipline,12,5,7
Drmattydubz,tichondrius,480,priest,discipline,12,5,7
Mud,mannoroth,480,priest,discipline,12,5,7
Taikosqt,azralon,480,priest,discipline,12,5,7
Lmäo,azralon,480,priest,discipline,12,5,7
Idryn,quelthalas,480,priest,discipline,12,5,7
Kallenk,proudmoore,480,priest,discipline,12,5,7
Harrygazm,shattered-hand,480,priest,discipline,12,5,7
Robbailey,dalvengyr,480,priest,discipline,12,5,7
Meatytrash,area-52,480,priest,discipline,12,5,7
Ricekrispies,alterac-mountains,480,priest,discipline,12,5,7
Jackymv,kelthuzad,480,priest,discipline,12,5,7
Stunzeed,staghelm,480,priest,discipline,12,5,7
Mellowrush,kelthuzad,480,priest,discipline,12,5,7
Zaradomin,kelthuzad,480,priest,discipline,12,5,7
Holyshafted,kelthuzad,480,priest,discipline,12,5,7
Bidensniffer,kelthuzad,480,priest,discipline,12,5,7
Toonahx,area-52,480,priest,discipline,12,5,7
Dolovis,kelthuzad,480,priest,discipline,12,5,7
Shadowjisha,emerald-dream,480,priest,discipline,12,5,7
Powerwordkfc,kelthuzad,480,priest,discipline,12,5,7
Humblemumble,barthilas,480,priest,discipline,12,5,7
Vyrah,area-52,480,priest,discipline,12,5,7
Htx,dunemaul,480,priest,discipline,12,5,7
Derisha,ragnaros,480,priest,discipline,12,5,7
Vérse,stormrage,480,priest,discipline,12,5,7
Tarwow,moon-guard,480,priest,discipline,12,5,7
Shôta,kelthuzad,480,priest,discipline,12,5,7
Raeana,area-52,480,priest,discipline,12,5,7
Lastbubble,area-52,480,priest,discipline,12,5,7
Pwl,area-52,480,priest,discipline,12,5,7
Wreklol,sargeras,480,priest,discipline,12,5,7
Blackdeathx,tichondrius,480,priest,discipline,12,5,7
Augus,velen,480,priest,discipline,12,5,7
Whosjoe,tichondrius,480,priest,discipline,12,5,7
Starzard,kelthuzad,480,priest,discipline,12,5,7
Bluffzp,boulderfist,480,priest,discipline,12,5,7
Ellipsiz,area-52,480,priest,discipline,12,5,7
Kävanagh,ragnaros,480,priest,discipline,12,5,7
Kopipriest,barthilas,480,priest,discipline,12,5,7
Apbrady,sargeras,480,priest,discipline,12,5,7
Mywifesaidno,sargeras,480,priest,discipline,12,5,7
Pumice,destromath,480,priest,discipline,12,5,7
Anellas,sargeras,480,priest,discipline,12,5,7
Drippyjoones,sargeras,480,priest,discipline,12,5,7
Iforted,sargeras,480,priest,discipline,12,5,7
Dredre,aggramar,480,priest,discipline,12,5,7
Hopenä,dragonmaw,480,priest,discipline,12,5,7
Matadur,lightnings-blade,480,priest,discipline,12,5,7
Tòxìç,stormrage,480,priest,discipline,12,5,7
Mikes,sargeras,480,priest,discipline,12,5,7
Gudóngmae,stormrage,480,priest,discipline,12,5,7
Younext,sargeras,480,priest,discipline,12,5,7
Tigawoods,khaz-modan,480,priest,discipline,12,5,7
Supernamp,sargeras,480,priest,discipline,12,5,7
Himslashhe,moon-guard,480,priest,discipline,12,5,7
Hotlink,daggerspine,480,priest,discipline,12,5,7
Discogs,frostmourne,480,priest,discipline,12,5,7
Ripngor,tichondrius,480,priest,discipline,12,5,7
Lingt,drakkari,480,priest,discipline,12,5,7
Giraffebaitt,zuljin,480,priest,discipline,12,5,7
Gstvsrrn,tichondrius,480,priest,discipline,12,5,7
Yujawang,sargeras,480,priest,discipline,12,5,7
Dweem,stormrage,480,priest,discipline,12,5,7
Yukishield,illidan,480,priest,discipline,12,5,7
Icarryozz,darkspear,480,priest,discipline,12,5,7
Lourrdz,tichondrius,480,priest,discipline,12,5,7
Cw,wildhammer,480,priest,discipline,12,5,7
Kelpyd,tichondrius,480,priest,discipline,12,5,7
Rockdroid,illidan,480,priest,discipline,12,5,7
Morcelina,stormrage,480,priest,discipline,12,5,7
Krazyapollo,tichondrius,480,priest,discipline,12,5,7
Hello,tichondrius,480,priest,discipline,12,5,7
Istvala,zuljin,480,priest,discipline,12,5,7
Sabela,moon-guard,480,priest,discipline,12,5,7
Makeshiftz,zuljin,480,priest,discipline,12,5,7
Thadopepope,tichondrius,480,priest,discipline,12,5,7
Amperx,wyrmrest-accord,480,priest,discipline,12,5,7
Mistify,bleeding-hollow,480,priest,discipline,12,5,7
Altaeres,tichondrius,480,priest,discipline,12,5,7
Justgoon,tichondrius,480,priest,discipline,12,5,7
Shwrma,bleeding-hollow,480,priest,discipline,12,5,7
Alleeyy,tichondrius,480,priest,discipline,12,5,7
Piffbadar,tichondrius,480,priest,discipline,12,5,7
Angelvoid,chogall,480,priest,discipline,12,5,7
Eltanji,wyrmrest-accord,480,priest,discipline,12,5,7
Castholy,nordrassil,480,priest,discipline,12,5,7
Yaheals,gorefiend,480,priest,discipline,12,5,7
Felskie,tichondrius,480,priest,discipline,12,5,7
Kurahashe,moon-guard,480,priest,discipline,12,5,7
Stambuff,tichondrius,480,priest,discipline,12,5,7
Jadpad,gorefiend,480,priest,discipline,12,5,7
Tommyjr,tichondrius,480,priest,discipline,12,5,7
Spîteful,illidan,480,priest,discipline,12,5,7
Feyns,illidan,480,priest,discipline,12,5,7
Pillowfinger,illidan,480,priest,discipline,12,5,7
Aelriah,thrall,480,priest,discipline,12,5,7
Numinous,wyrmrest-accord,480,priest,discipline,12,5,7
Ianiezd,illidan,480,priest,discipline,12,5,7
Yauntoo,tichondrius,480,priest,discipline,12,5,7
Fatalpush,moon-guard,480,priest,discipline,12,5,7
Azngød,tichondrius,480,priest,discipline,12,5,7
Rofrofmu,aegwynn,480,priest,discipline,12,5,7
Inflate,frostmourne,480,priest,discipline,12,5,7
Seraphang,stormrage,480,priest,discipline,12,5,7
Voidquil,bonechewer,480,priest,discipline,12,5,7
Widewinks,thrall,480,priest,discipline,12,5,7
Scyndar,bonechewer,480,priest,discipline,12,5,7
Shelfedelf,gurubashi,480,priest,discipline,12,5,7
Jmanhealz,stormrage,480,priest,discipline,12,5,7
Shädyönë,tichondrius,480,priest,discipline,12,5,7
Soulbane,frostmourne,480,priest,discipline,12,5,7
Goonie,spirestone,480,priest,discipline,12,5,7
Raslin,bonechewer,480,priest,discipline,12,5,7
Lejn,illidan,480,priest,discipline,12,5,7
Drooz,illidan,480,priest,discipline,12,5,7
Fancycorpse,tichondrius,480,priest,discipline,12,5,7
Ptam,tichondrius,480,priest,discipline,12,5,7
Jentbekk,tichondrius,480,priest,discipline,12,5,7
Gatty,kiljaeden,480,priest,discipline,13,5,8
Jedmosby,korgath,480,priest,discipline,14,5,9
Vetisrx,thrall,480,priest,discipline,18,5,13
Ticheals,tichondrius,480,priest,discipline,18,5,13
Canswersp,sargeras,480,priest,discipline,18,5,13
Touchèr,sargeras,480,priest,discipline,18,5,13
Kark,tichondrius,480,priest,discipline,18,5,13
Pasher,sargeras,480,priest,discipline,18,5,13
Sypii,stormrage,480,priest,discipline,18,5,13
Healiesuwu,kiljaeden,480,priest,discipline,18,5,13
Klerick,kiljaeden,480,priest,discipline,18,5,13
Bebe,fizzcrank,480,priest,discipline,18,5,13
Flayed,frostmourne,480,priest,discipline,18,5,13
Kershl,aegwynn,480,priest,discipline,18,5,13
Ludens,bleeding-hollow,480,priest,discipline,18,5,13
Mustyfribble,korgath,480,priest,discipline,18,5,13
Ollarlamente,zuljin,480,priest,discipline,18,5,13
Levingurt,darkspear,480,priest,discipline,18,5,13
Jahratu,tichondrius,480,priest,discipline,18,5,13
Repthsp,illidan,480,priest,discipline,18,5,13
Cheekypriest,stormrage,480,priest,discipline,18,5,13
Aguadejamica,tichondrius,480,priest,discipline,18,5,13
Sevenlions,stormrage,480,priest,discipline,18,5,13
Tethy,saurfang,480,priest,discipline,18,5,13
Georgepells,barthilas,480,priest,discipline,24,5,19
Velkorvasa,saurfang,480,priest,discipline,30,5,25
Priuhpism,tichondrius,479,priest,discipline,6,5,1
Bossay,icecrown,479,priest,discipline,6,5,1
Confuses,area-52,479,priest,discipline,6,5,1
Remixcandoit,malganis,479,priest,discipline,6,5,1
Syrissa,thrall,479,priest,discipline,6,5,1
Sevioletté,wyrmrest-accord,479,priest,discipline,6,5,1
Krisdavra,thrall,479,priest,discipline,6,5,1
Sanaconda,sargeras,479,priest,discipline,7,5,2
Berzum,chogall,479,priest,discipline,10,6,4
Coldvb,barthilas,479,priest,discipline,12,5,7
Frazzysparks,stormrage,479,priest,discipline,12,5,7
Aalicya,tanaris,479,priest,discipline,12,5,7
Photogirl,area-52,479,priest,discipline,12,5,7
Machiomora,dunemaul,479,priest,discipline,12,5,7
Mistnamed,emerald-dream,479,priest,discipline,12,5,7
Pandaball,frostwolf,479,priest,discipline,12,5,7
Atheíst,tichondrius,479,priest,discipline,12,5,7
Hypnottik,tichondrius,479,priest,discipline,12,5,7
Fadêd,wildhammer,479,priest,discipline,12,5,7
Sanso,drakkari,479,priest,discipline,12,5,7
Chadlyfe,tichondrius,479,priest,discipline,12,5,7
Ibuyfeetpics,tichondrius,479,priest,discipline,12,5,7
Drayen,korgath,479,priest,discipline,12,5,7
Selea,frostwolf,479,priest,discipline,12,5,7
Techninë,chogall,479,priest,discipline,12,5,7
Omgimissher,black-dragonflight,479,priest,discipline,12,5,7
Greatzapan,tichondrius,479,priest,discipline,12,5,7
Mythine,moon-guard,479,priest,discipline,12,5,7
Torrantt,bonechewer,479,priest,discipline,12,5,7
Azhaell,quelthalas,479,priest,discipline,12,5,7
Clerical,skullcrusher,479,priest,discipline,12,5,7
Aurørà,quelthalas,479,priest,discipline,12,5,7
Xenedart,quelthalas,479,priest,discipline,12,5,7
Krynoobz,senjin,479,priest,discipline,12,5,7
Preesia,misha,479,priest,discipline,12,5,7
Tubelight,sargeras,479,priest,discipline,12,5,7
Demished,zuljin,479,priest,discipline,12,5,7
Dabrat,darkspear,479,priest,discipline,18,6,12
Goodboyyoshi,tichondrius,479,priest,discipline,15,5,10
Cxview,sargeras,479,priest,discipline,18,5,13
Wort,cairne,479,priest,discipline,18,5,13
Asmitä,stormrage,479,priest,discipline,24,5,19
Liñkzq,frostmourne,478,priest,discipline,12,5,7
Pylenn,emerald-dream,478,priest,discipline,12,5,7
Ansgar,eonar,478,priest,discipline,12,5,7
Tsuxsurf,darkspear,478,priest,discipline,12,5,7
Invisibler,tichondrius,478,priest,discipline,24,5,19
Pingleangel,tichondrius,477,priest,discipline,12,5,7
Solzal,korgath,477,priest,discipline,12,5,7
Goldenlilly,moon-guard,477,priest,discipline,18,5,13
Laydrel,sargeras,476,priest,discipline,12,5,7
Lotzofhealz,wyrmrest-accord,476,priest,discipline,12,5,7
Rescueworker,kelthuzad,473,priest,discipline,12,5,7
Mesiausx,stormrage,468,priest,discipline,24,9,15
Forober,queldorei,466,priest,discipline,39,14,25
Bboo,draenor,463,priest,discipline,11,5,6
Bitterwish,maiev,448,priest,discipline,10,5,5
Faíthless,sargeras,447,priest,discipline,11,5,6
Ishnudaldieb,bleeding-hollow,447,priest,discipline,11,5,6
Hungzilla,malganis,447,priest,discipline,11,5,6
Shadowkr,tichondrius,447,priest,discipline,11,5,6
Ihazhealzz,area-52,447,priest,discipline,11,5,6
Darkascended,arthas,447,priest,discipline,14,6,8
Guillotinee,ragnaros,447,priest,discipline,13,5,8
Cuisino,tichondrius,446,priest,discipline,11,5,6
Rollforrezz,frostmourne,446,priest,discipline,11,5,6
Sorzartluz,malganis,432,priest,discipline,9,6,3
Proftimothy,tichondrius,432,priest,discipline,15,6,9
Agrotothemax,tichondrius,432,priest,discipline,15,5,10
Terraqq,barthilas,432,priest,discipline,16,5,11
Fxxkdamn,tichondrius,432,priest,discipline,21,6,15
Kishoengi,sargeras,2359,priest,shadow,138,85,53
Orchidp,tichondrius,2334,priest,shadow,300,185,115
Luvkak,tichondrius,2304,priest,shadow,100,55,45
Yeazy,stormrage,2296,priest,shadow,108,62,46
Jennaôrtega,tichondrius,2273,priest,shadow,126,77,49
Pboo,tichondrius,2272,priest,shadow,90,54,36
Disembly,illidan,2223,priest,shadow,87,50,37
Scandi,tichondrius,2215,priest,shadow,102,59,43
Edd,tichondrius,2215,priest,shadow,164,87,77
Yeona,tichondrius,2195,priest,shadow,101,60,41
Mearas,kelthuzad,2189,priest,shadow,88,52,36
Claudiosip,tichondrius,2188,priest,shadow,91,59,32
Disemble,illidan,2186,priest,shadow,78,44,34
Techbadar,tichondrius,2185,priest,shadow,125,65,60
Strwbrynaner,sargeras,2182,priest,shadow,210,112,98
Painpaws,moon-guard,2176,priest,shadow,128,76,52
Healingstats,tichondrius,2165,priest,shadow,89,47,42
Zçythe,tichondrius,2158,priest,shadow,84,51,33
Oohhmágáá,azralon,2157,priest,shadow,84,60,24
Louloudots,malganis,2141,priest,shadow,178,98,80
Moraver,kelthuzad,2141,priest,shadow,74,39,35
Ousïa,quelthalas,2136,priest,shadow,194,102,92
Sin,guldan,2135,priest,shadow,395,214,181
Apbrady,sargeras,2132,priest,shadow,144,75,69
Welplayedman,emerald-dream,2130,priest,shadow,88,53,35
Ejr,altar-of-storms,2130,priest,shadow,157,76,81
Eradication,frostmourne,2129,priest,shadow,111,69,42
Ivn,tichondrius,2123,priest,shadow,136,77,59
Palumorp,deathwing,2118,priest,shadow,90,57,33
Amyyds,illidan,2110,priest,shadow,166,103,63
Kottun,stormrage,2110,priest,shadow,66,38,28
Lìám,frostmourne,2110,priest,shadow,187,102,85
Pdfileclass,tichondrius,2106,priest,shadow,72,47,25
Bayter,frostmourne,2105,priest,shadow,181,97,84
Geovanni,barthilas,2105,priest,shadow,107,54,53
Zyrith,sargeras,2102,priest,shadow,123,63,60
Wetleaftx,chogall,2101,priest,shadow,66,45,21
Yenïza,illidan,2101,priest,shadow,202,107,95
Zlipz,frostmourne,2099,priest,shadow,78,47,31
Xiaozhui,tichondrius,2098,priest,shadow,129,69,60
Holydose,moon-guard,2090,priest,shadow,150,75,75
Alisasa,tichondrius,2083,priest,shadow,72,40,32
Darkvagician,malganis,2079,priest,shadow,65,39,26
Spamndam,tichondrius,2076,priest,shadow,78,45,33
Mamísonga,ragnaros,2071,priest,shadow,95,49,46
Dream,tichondrius,2066,priest,shadow,180,88,92
Omenx,emerald-dream,2060,priest,shadow,132,69,63
Babyh,tichondrius,2054,priest,shadow,89,49,40
Shibuu,moon-guard,2053,priest,shadow,88,50,38
Vtp,frostmourne,2052,priest,shadow,116,66,50
Royx,stormreaver,2051,priest,shadow,83,46,37
Criminalsp,frostmourne,2050,priest,shadow,83,42,41
Urelz,illidan,2045,priest,shadow,54,36,18
Yoggsarodney,tichondrius,2044,priest,shadow,55,37,18
Rileyreidx,ragnaros,2043,priest,shadow,74,47,27
Kuraga,bleeding-hollow,2043,priest,shadow,416,223,193
Metricdotem,terenas,2041,priest,shadow,66,40,26
Eunu,tichondrius,2039,priest,shadow,251,125,126
Expr,area-52,2037,priest,shadow,132,72,60
Stinkiez,area-52,2031,priest,shadow,342,180,162
Whysoserious,duskwood,2026,priest,shadow,60,38,22
Laundryday,korgath,2026,priest,shadow,132,68,64
Jags,area-52,2021,priest,shadow,96,50,46
Targora,lightninghoof,2020,priest,shadow,186,97,89
Pbxx,tichondrius,2018,priest,shadow,64,36,28
Kiriko,mannoroth,2004,priest,shadow,119,66,53
Gâdzêd,kelthuzad,2003,priest,shadow,62,38,24
Greaterfade,stormrage,2000,priest,shadow,66,37,29
Remixsp,malganis,1998,priest,shadow,60,33,27
Metasp,sargeras,1996,priest,shadow,96,51,45
Netheerix,tichondrius,1996,priest,shadow,87,44,43
Heheheg,tichondrius,1994,priest,shadow,190,95,95
Swswswswswsw,stormrage,1990,priest,shadow,125,75,50
Talbadar,tichondrius,1985,priest,shadow,90,54,36
Erebusz,tichondrius,1983,priest,shadow,211,109,102
Bibleblak,stormrage,1982,priest,shadow,138,78,60
Gromkekz,area-52,1982,priest,shadow,131,67,64
Ombravuota,blades-edge,1982,priest,shadow,312,159,153
Keygodx,illidan,1977,priest,shadow,60,36,24
Viyana,stormrage,1977,priest,shadow,204,104,100
Arobahn,tichondrius,1972,priest,shadow,184,95,89
Shadowkenlol,tichondrius,1969,priest,shadow,107,59,48
Delasoul,malganis,1965,priest,shadow,111,64,47
Taylorsp,tichondrius,1964,priest,shadow,94,55,39
Maskali,tichondrius,1963,priest,shadow,262,126,136
Dyrr,barthilas,1960,priest,shadow,263,129,134
Blax,stormscale,1959,priest,shadow,126,66,60
Soapee,illidan,1955,priest,shadow,221,113,108
Psyfiend,alterac-mountains,1953,priest,shadow,81,46,35
Brokenspc,tichondrius,1953,priest,shadow,196,109,87
Jugeumx,proudmoore,1951,priest,shadow,66,36,30
Kydraah,ragnaros,1950,priest,shadow,71,41,30
Nozp,stormrage,1950,priest,shadow,54,29,25
Garpd,tichondrius,1947,priest,shadow,138,80,58
Niark,frostmourne,1946,priest,shadow,82,41,41
Zlips,frostmourne,1942,priest,shadow,116,54,62
Helmsman,tichondrius,1940,priest,shadow,224,117,107
Pengwinxl,agamaggan,1936,priest,shadow,66,36,30
Yberisa,zuljin,1936,priest,shadow,155,81,74
Cozies,stormreaver,1934,priest,shadow,208,107,101
Fatherfeet,tichondrius,1932,priest,shadow,114,64,50
Ysuran,moon-guard,1930,priest,shadow,184,106,78
Puppyboyx,moon-guard,1929,priest,shadow,80,41,39
Headbrake,malganis,1927,priest,shadow,66,36,30
Voidkay,tichondrius,1926,priest,shadow,54,40,14
Katallyst,tichondrius,1926,priest,shadow,77,36,41
Bobbyvagene,area-52,1918,priest,shadow,98,46,52
Stresscube,tichondrius,1915,priest,shadow,46,28,18
Jthreetx,kelthuzad,1915,priest,shadow,58,33,25
Cheesëburg,illidan,1915,priest,shadow,54,28,26
Missyoung,tichondrius,1912,priest,shadow,73,42,31
Asmødeus,bleeding-hollow,1912,priest,shadow,101,54,47
Ilovevivien,spirestone,1911,priest,shadow,54,30,24
Bubbyflay,area-52,1910,priest,shadow,65,40,25
Plaguesus,dalaran,1909,priest,shadow,76,43,33
Nekroscream,queldorei,1909,priest,shadow,115,58,57
Ensanity,stormrage,1908,priest,shadow,149,76,73
Itkev,area-52,1907,priest,shadow,41,31,10
Wizkxjwap,tichondrius,1906,priest,shadow,42,26,16
Aro,tichondrius,1906,priest,shadow,96,48,48
Sodíum,wyrmrest-accord,1905,priest,shadow,125,62,63
Çræmgøtsøçkd,blackrock,1904,priest,shadow,30,21,9
Tomcruisé,zuljin,1902,priest,shadow,66,37,29
Blackoss,sargeras,1901,priest,shadow,141,72,69
Griffsp,sargeras,1900,priest,shadow,215,109,106
Vamp,proudmoore,1899,priest,shadow,82,52,30
Inflate,frostmourne,1896,priest,shadow,126,71,55
Xaneo,kelthuzad,1895,priest,shadow,59,37,22
Sênju,thrall,1894,priest,shadow,89,47,42
Mindburn,nemesis,1891,priest,shadow,132,67,65
Brwnricetuna,frostmourne,1887,priest,shadow,57,31,26
Comana,frostmourne,1886,priest,shadow,30,24,6
Ssupasonic,tichondrius,1880,priest,shadow,103,63,40
Mindblastx,kelthuzad,1880,priest,shadow,63,35,28
Qreckful,proudmoore,1878,priest,shadow,64,40,24
Marfas,illidan,1878,priest,shadow,104,49,55
Stunsilence,sargeras,1877,priest,shadow,48,25,23
Johai,uldum,1874,priest,shadow,84,54,30
Bornagain,gundrak,1874,priest,shadow,59,30,29
Giriosp,thrall,1873,priest,shadow,37,26,11
Nutdrip,tichondrius,1872,priest,shadow,47,28,19
Mythsnake,ragnaros,1872,priest,shadow,49,29,20
Soar,ravencrest,1872,priest,shadow,47,26,21
Drmuhammad,sargeras,1870,priest,shadow,46,28,18
Årann,azralon,1869,priest,shadow,36,26,10
Fxxkdamn,tichondrius,1869,priest,shadow,47,32,15
Cmg,sargeras,1869,priest,shadow,60,31,29
Atarri,illidan,1868,priest,shadow,54,31,23
Dí,illidan,1868,priest,shadow,90,51,39
Blindingstar,area-52,1867,priest,shadow,53,33,20
Creapture,zuluhed,1864,priest,shadow,42,24,18
Xayp,kelthuzad,1863,priest,shadow,101,73,28
Swurvexo,bleeding-hollow,1863,priest,shadow,53,28,25
Theophobe,illidan,1862,priest,shadow,42,32,10
Celypriest,moon-guard,1861,priest,shadow,36,28,8
Slpox,sargeras,1861,priest,shadow,36,20,16
Shortwombat,korgath,1860,priest,shadow,60,29,31
Christmasgal,uldum,1859,priest,shadow,30,27,3
Yayonaise,tichondrius,1859,priest,shadow,54,33,21
Maìden,sargeras,1858,priest,shadow,90,45,45
Fungame,malganis,1855,priest,shadow,50,35,15
Hástür,quelthalas,1855,priest,shadow,157,87,70
Evenly,tichondrius,1855,priest,shadow,138,76,62
Ericzssp,tichondrius,1854,priest,shadow,63,36,27
Couldntbeme,sargeras,1852,priest,shadow,54,31,23
Knowknow,tichondrius,1852,priest,shadow,168,81,87
Flamédøtz,ragnaros,1850,priest,shadow,48,29,19
Echoos,proudmoore,1849,priest,shadow,42,28,14
Healingstat,tichondrius,1849,priest,shadow,45,27,18
Nevertelsp,malganis,1848,priest,shadow,140,89,51
Bagjoe,illidan,1848,priest,shadow,212,112,100
Yoggismydad,emerald-dream,1847,priest,shadow,48,29,19
Wafflezsp,frostmourne,1847,priest,shadow,120,62,58
Sapoopettas,quelthalas,1845,priest,shadow,54,26,28
Xhadow,sargeras,1843,priest,shadow,96,50,46
Vtplz,bleeding-hollow,1843,priest,shadow,65,33,32
Kattallyst,tichondrius,1842,priest,shadow,89,45,44
Psyphi,duskwood,1841,priest,shadow,84,40,44
Ayumihamaski,tichondrius,1840,priest,shadow,57,39,18
Voidgodtko,tichondrius,1840,priest,shadow,48,26,22
Tidals,sargeras,1839,priest,shadow,60,38,22
Pnub,aggramar,1838,priest,shadow,65,34,31
Ptam,tichondrius,1838,priest,shadow,65,33,32
Keliarc,sargeras,1836,priest,shadow,102,54,48
Stankychimpo,malganis,1834,priest,shadow,54,32,22
Estéve,wyrmrest-accord,1834,priest,shadow,113,58,55
Niurouchuan,tichondrius,1834,priest,shadow,62,31,31
Furbog,area-52,1833,priest,shadow,42,31,11
Jomm,area-52,1833,priest,shadow,75,41,34
Esteedees,bonechewer,1833,priest,shadow,150,81,69
Priestpogger,tichondrius,1831,priest,shadow,48,31,17
Soyul,tichondrius,1831,priest,shadow,132,73,59
Yb,kelthuzad,1831,priest,shadow,94,51,43
Remedio,emerald-dream,1830,priest,shadow,33,21,12
Cøtt,emerald-dream,1829,priest,shadow,48,30,18
Doma,malganis,1829,priest,shadow,43,26,17
Auttø,area-52,1829,priest,shadow,45,26,19
Mepisth,sargeras,1828,priest,shadow,84,55,29
Kalantris,ragnaros,1828,priest,shadow,64,41,23
Throwshade,moon-guard,1828,priest,shadow,89,56,33
Akuvurá,nemesis,1827,priest,shadow,173,100,73
Kfcpriest,barthilas,1827,priest,shadow,54,26,28
Ventusp,azralon,1826,priest,shadow,105,61,44
Voiders,area-52,1826,priest,shadow,288,164,124
What,drakthul,1825,priest,shadow,54,35,19
Silero,dalaran,1824,priest,shadow,116,76,40
Idiotgarbage,moon-guard,1824,priest,shadow,48,26,22
Hÿperion,quelthalas,1823,priest,shadow,60,38,22
Insanity,azuremyst,1823,priest,shadow,137,77,60
Snòzberry,illidan,1822,priest,shadow,66,36,30
Jojotwo,illidan,1822,priest,shadow,108,56,52
Samsypriest,frostmourne,1821,priest,shadow,64,38,26
Xmewo,sargeras,1820,priest,shadow,47,29,18
Bearoom,frostmourne,1820,priest,shadow,66,39,27
Nhela,kelthuzad,1820,priest,shadow,60,29,31
Vil,lightnings-blade,1819,priest,shadow,90,50,40
Ellindria,spinebreaker,1818,priest,shadow,95,57,38
Peggable,moon-guard,1818,priest,shadow,59,32,27
Moralism,moon-guard,1817,priest,shadow,259,150,109
Disxlyec,barthilas,1817,priest,shadow,142,79,63
Derisha,ragnaros,1817,priest,shadow,170,91,79
Ayniah,tichondrius,1817,priest,shadow,52,25,27
Mcbot,illidan,1816,priest,shadow,36,27,9
Dots,tichondrius,1816,priest,shadow,53,33,20
Minðgãmès,illidan,1816,priest,shadow,63,39,24
Katarot,area-52,1816,priest,shadow,51,30,21
Keser,kelthuzad,1816,priest,shadow,70,39,31
Discipline,chogall,1816,priest,shadow,48,26,22
Hollister,illidan,1816,priest,shadow,246,132,114
Havocshadows,deathwing,1815,priest,shadow,94,58,36
Blissily,sargeras,1814,priest,shadow,75,47,28
Manic,skywall,1814,priest,shadow,168,96,72
Irasponsible,stormrage,1814,priest,shadow,42,23,19
Holytalk,tichondrius,1814,priest,shadow,60,30,30
Drupith,dalaran,1814,priest,shadow,54,27,27
Milan,dalaran,1813,priest,shadow,99,61,38
Nawzyh,emerald-dream,1813,priest,shadow,48,26,22
Melonsoda,stormrage,1813,priest,shadow,48,26,22
Resonator,laughing-skull,1813,priest,shadow,46,22,24
Invain,executus,1812,priest,shadow,30,24,6
Ussmissouri,area-52,1812,priest,shadow,300,156,144
Snoog,tichondrius,1812,priest,shadow,72,36,36
Felrynpr,malganis,1811,priest,shadow,47,28,19
Chazzwizz,area-52,1811,priest,shadow,48,26,22
Ðantex,thrall,1811,priest,shadow,296,155,141
Xannè,tichondrius,1811,priest,shadow,60,30,30
Relapse,emerald-dream,1810,priest,shadow,36,25,11
Alykus,emerald-dream,1810,priest,shadow,82,47,35
Llamabush,malganis,1809,priest,shadow,39,26,13
Doublesix,malganis,1809,priest,shadow,72,43,29
Krelaeren,tichondrius,1809,priest,shadow,65,33,32
Cixelpvp,area-52,1809,priest,shadow,54,26,28
Pootzy,malganis,1808,priest,shadow,56,30,26
Deuz,quelthalas,1808,priest,shadow,243,125,118
Arthrix,sargeras,1807,priest,shadow,72,46,26
Bumps,zuljin,1807,priest,shadow,76,43,33
Mindgoblin,terokkar,1807,priest,shadow,96,48,48
Avraf,sargeras,1807,priest,shadow,72,36,36
Ericxd,area-52,1807,priest,shadow,77,38,39
Edai,malganis,1806,priest,shadow,229,124,105
Pettypriest,dalaran,1806,priest,shadow,236,127,109
Exoticfather,stormrage,1806,priest,shadow,66,33,33
Tidbitsy,malganis,1806,priest,shadow,175,87,88
Dispel,agamaggan,1805,priest,shadow,32,24,8
Ghostz,alleria,1805,priest,shadow,60,39,21
Kurindrize,illidan,1805,priest,shadow,60,37,23
Shelize,kirin-tor,1805,priest,shadow,336,173,163
Brickzyhehe,dalaran,1805,priest,shadow,113,58,55
Naosoupriest,azralon,1804,priest,shadow,53,40,13
Secrèt,tichondrius,1804,priest,shadow,30,19,11
Manofmystery,dalaran,1804,priest,shadow,48,28,20
Cathery,tichondrius,1804,priest,shadow,48,24,24
Bearzugzug,frostmourne,1803,priest,shadow,36,23,13
Inmotion,tichondrius,1803,priest,shadow,30,19,11
Panndaz,tichondrius,1803,priest,shadow,30,19,11
Antorieth,area-52,1803,priest,shadow,60,33,27
Euthanasìa,deathwing,1803,priest,shadow,70,31,39
Potatopriest,stormrage,1802,priest,shadow,42,31,11
Korrà,turalyon,1802,priest,shadow,30,19,11
Dilonpi,area-52,1801,priest,shadow,66,47,19
Meehx,illidan,1801,priest,shadow,114,68,46
Eclipsë,malganis,1800,priest,shadow,24,19,5
Nerfmehard,tichondrius,1800,priest,shadow,72,51,21
Sheiizy,azralon,1800,priest,shadow,90,52,38
Phubar,stormreaver,1800,priest,shadow,84,36,48
Sleepynuj,stormrage,1792,priest,shadow,78,48,30
Axelrod,tichondrius,1792,priest,shadow,48,29,19
Zhiwanam,tichondrius,1786,priest,shadow,59,34,25
Lillyp,malganis,1786,priest,shadow,42,21,21
Gìdem,aggramar,1781,priest,shadow,57,35,22
Jydge,tichondrius,1780,priest,shadow,39,22,17
Nutdrip,kelthuzad,1778,priest,shadow,36,27,9
Sinning,kelthuzad,1777,priest,shadow,54,35,19
Almycn,tichondrius,1776,priest,shadow,56,30,26
Plztrainme,spinebreaker,1776,priest,shadow,124,65,59
Pinguisursi,kelthuzad,1774,priest,shadow,36,27,9
Míslead,kelthuzad,1771,priest,shadow,36,27,9
Pikeysplol,illidan,1771,priest,shadow,44,30,14
Shadowforsho,sargeras,1771,priest,shadow,64,30,34
Shalla,blackrock,1770,priest,shadow,102,57,45
Griffsp,stormrage,1765,priest,shadow,77,44,33
Jangbi,tichondrius,1761,priest,shadow,36,20,16
Laokele,tichondrius,1760,priest,shadow,60,35,25
Kovie,twisting-nether,1758,priest,shadow,206,119,87
Jeseck,quelthalas,1757,priest,shadow,140,72,68
Krovnp,stormrage,1756,priest,shadow,36,24,12
Hriest,tichondrius,1756,priest,shadow,78,46,32
Orgasmiq,frostmourne,1755,priest,shadow,84,45,39
Eklunð,proudmoore,1754,priest,shadow,53,28,25
Carbsauce,tichondrius,1753,priest,shadow,66,37,29
Invincible,ragnaros,1750,priest,shadow,84,45,39
Øvøxø,emerald-dream,1749,priest,shadow,45,23,22
Bhadbhaabie,lethon,1748,priest,shadow,30,21,9
Shadowblastx,sargeras,1748,priest,shadow,62,39,23
Snookp,kiljaeden,1747,priest,shadow,279,142,137
Zanthix,tichondrius,1745,priest,shadow,54,26,28
Impérial,stormrage,1744,priest,shadow,179,107,72
Nucypher,illidan,1742,priest,shadow,51,27,24
Dispèrsion,darkspear,1742,priest,shadow,97,47,50
Krytical,illidan,1738,priest,shadow,184,107,77
Emopriestqt,tichondrius,1737,priest,shadow,144,79,65
Saevita,area-52,1737,priest,shadow,66,34,32
Iceveins,illidan,1736,priest,shadow,46,27,19
Ticklefingrs,malganis,1734,priest,shadow,60,35,25
Tamajka,the-forgotten-coast,1734,priest,shadow,117,57,60
Plushys,emerald-dream,1733,priest,shadow,66,44,22
Saintpleb,sargeras,1732,priest,shadow,146,89,57
Ikillfast,tichondrius,1731,priest,shadow,286,155,131
Dildocrates,darkspear,1730,priest,shadow,48,28,20
Messiahp,illidan,1730,priest,shadow,53,25,28
Aristedes,thrall,1729,priest,shadow,35,20,15
Voltétt,tichondrius,1726,priest,shadow,62,37,25
Lebronjâmes,tichondrius,1726,priest,shadow,42,25,17
Dxsc,tichondrius,1725,priest,shadow,72,41,31
Drohung,sargeras,1723,priest,shadow,54,30,24
Umbrah,veknilash,1720,priest,shadow,48,26,22
Ðemi,zuljin,1720,priest,shadow,135,71,64
Iamjakehill,area-52,1719,priest,shadow,42,26,16
Brokentrojan,moon-guard,1718,priest,shadow,48,23,25
Perfectz,stormrage,1716,priest,shadow,42,24,18
Sukes,korgath,1716,priest,shadow,156,84,72
Pesca,proudmoore,1716,priest,shadow,99,51,48
Álvarez,tichondrius,1716,priest,shadow,110,56,54
Soný,stormrage,1715,priest,shadow,75,41,34
Saintjudys,tichondrius,1714,priest,shadow,36,23,13
Gusho,frostmourne,1713,priest,shadow,226,118,108
Dreaminz,tichondrius,1712,priest,shadow,60,37,23
Chewthefat,darkspear,1712,priest,shadow,41,19,22
Alyndral,illidan,1710,priest,shadow,78,43,35
Mindslips,tichondrius,1710,priest,shadow,168,90,78
Holyxb,bleeding-hollow,1708,priest,shadow,149,83,66
Brothofnzoth,emerald-dream,1708,priest,shadow,124,68,56
Nishishabi,tichondrius,1707,priest,shadow,48,24,24
Finfangfoom,laughing-skull,1707,priest,shadow,81,40,41
Esppx,barthilas,1706,priest,shadow,30,18,12
Thaumaturgy,chogall,1706,priest,shadow,48,25,23
Tsmc,moon-guard,1705,priest,shadow,102,55,47
Zlowbly,ragnaros,1705,priest,shadow,183,95,88
Jessticalz,frostmourne,1703,priest,shadow,48,24,24
Shwayp,zuljin,1702,priest,shadow,36,22,14
Moonideli,moon-guard,1702,priest,shadow,49,29,20
Twoboo,bleeding-hollow,1701,priest,shadow,72,40,32
Sochron,stormrage,1701,priest,shadow,140,74,66
Teddysedai,tichondrius,1700,priest,shadow,36,25,11
Darkenside,moon-guard,1699,priest,shadow,54,31,23
Likesshadows,tichondrius,1698,priest,shadow,155,96,59
Evelën,azralon,1698,priest,shadow,48,26,22
Lauretânia,nemesis,1698,priest,shadow,90,45,45
Ddark,tichondrius,1697,priest,shadow,66,41,25
Palmerin,ravencrest,1697,priest,shadow,102,53,49
Cavaliersr,ragnaros,1696,priest,shadow,96,56,40
Vashrapani,stormrage,1696,priest,shadow,334,173,161
Badbwoi,frostmourne,1696,priest,shadow,61,29,32
Nvøsuperstar,zuljin,1695,priest,shadow,72,37,35
Nickdeath,tichondrius,1694,priest,shadow,54,28,26
Hurtfeet,sargeras,1693,priest,shadow,120,62,58
Afromon,suramar,1692,priest,shadow,90,52,38
Scarabless,bleeding-hollow,1692,priest,shadow,102,55,47
Shadelink,tichondrius,1692,priest,shadow,42,22,20
Madcaddies,bonechewer,1691,priest,shadow,114,56,58
Arion,wyrmrest-accord,1689,priest,shadow,54,35,19
Lucsor,malganis,1687,priest,shadow,190,100,90
Kadralin,illidan,1685,priest,shadow,114,66,48
Rizzle,emerald-dream,1684,priest,shadow,76,46,30
Shadhoee,sargeras,1684,priest,shadow,64,29,35
Iuka,emerald-dream,1683,priest,shadow,183,96,87
Hadoka,ragnaros,1682,priest,shadow,28,19,9
Nonamegame,sargeras,1681,priest,shadow,106,60,46
Himikko,illidan,1680,priest,shadow,40,19,21
Yåmi,arthas,1679,priest,shadow,36,25,11
Brownie,blackrock,1679,priest,shadow,56,29,27
Silkyx,tichondrius,1679,priest,shadow,36,18,18
Giveheadpats,moon-guard,1678,priest,shadow,234,127,107
Woodney,ragnaros,1676,priest,shadow,30,19,11
Mitogen,malganis,1676,priest,shadow,30,18,12
Littlewench,sargeras,1676,priest,shadow,86,49,37
Mimósa,quelthalas,1676,priest,shadow,139,75,64
Crayon,stormrage,1676,priest,shadow,48,25,23
Nobutter,archimonde,1674,priest,shadow,42,23,19
Evx,demon-soul,1673,priest,shadow,96,50,46
Dirtyysanta,tichondrius,1671,priest,shadow,40,24,16
Clownface,tichondrius,1671,priest,shadow,42,24,18
Aspéct,aegwynn,1670,priest,shadow,36,21,15
Fantasía,moon-guard,1670,priest,shadow,114,54,60
Ightdoe,zuljin,1668,priest,shadow,75,47,28
Delbringer,moon-guard,1668,priest,shadow,155,85,70
Desaros,tichondrius,1668,priest,shadow,102,52,50
Cxrsed,illidan,1667,priest,shadow,48,27,21
Slasheal,caelestrasz,1666,priest,shadow,90,47,43
Jhené,malganis,1665,priest,shadow,48,27,21
Nuggs,mannoroth,1665,priest,shadow,42,21,21
Mscleo,lothar,1665,priest,shadow,290,140,150
Uploading,moon-guard,1664,priest,shadow,42,24,18
Mockr,kiljaeden,1664,priest,shadow,150,81,69
Shadork,area-52,1663,priest,shadow,61,39,22
Salvate,tichondrius,1663,priest,shadow,48,26,22
Luzira,stormrage,1662,priest,shadow,42,25,17
Xdipi,proudmoore,1662,priest,shadow,44,25,19
Goseikae,tichondrius,1662,priest,shadow,101,53,48
Murkqz,stormrage,1661,priest,shadow,66,37,29
Swaggylee,tichondrius,1661,priest,shadow,40,22,18
Scalpell,tichondrius,1661,priest,shadow,269,140,129
Gineska,tichondrius,1660,priest,shadow,42,27,15
Zachlol,area-52,1658,priest,shadow,66,36,30
Luciellis,sargeras,1657,priest,shadow,51,29,22
Deadsp,thrall,1657,priest,shadow,115,58,57
Shadowkr,tichondrius,1656,priest,shadow,42,26,16
Pluse,bonechewer,1655,priest,shadow,52,31,21
Raptorjésus,azjolnerub,1654,priest,shadow,42,22,20
Ilovealina,gorefiend,1653,priest,shadow,30,21,9
Priestzerath,azralon,1652,priest,shadow,69,38,31
Djcyrus,barthilas,1652,priest,shadow,54,28,26
Kultil,dalaran,1651,priest,shadow,102,57,45
Vaporachi,emerald-dream,1650,priest,shadow,42,28,14
Nevermôre,area-52,1650,priest,shadow,66,42,24
Stivche,frostmourne,1650,priest,shadow,62,37,25
Dovoso,kargath,1650,priest,shadow,54,30,24
Spõõky,illidan,1650,priest,shadow,40,21,19
Skrillô,emerald-dream,1650,priest,shadow,53,27,26
Fenix,bloodhoof,1650,priest,shadow,52,25,27
Ajazz,zuljin,1649,priest,shadow,48,30,18
Caricius,ravenholdt,1649,priest,shadow,36,20,16
Partypriest,tichondrius,1648,priest,shadow,77,42,35
Docbek,illidan,1647,priest,shadow,44,28,16
Snuffp,sargeras,1647,priest,shadow,137,85,52
Girthed,bloodscalp,1647,priest,shadow,98,50,48
Griddly,alterac-mountains,1646,priest,shadow,72,41,31
Painful,malganis,1645,priest,shadow,62,36,26
Xammys,malganis,1644,priest,shadow,71,49,22
Sigx,area-52,1643,priest,shadow,30,21,9
Gaymalenurse,sargeras,1643,priest,shadow,48,25,23
Mankbadar,tichondrius,1643,priest,shadow,76,37,39
Swungzebra,stormrage,1642,priest,shadow,140,83,57
Destta,stormrage,1641,priest,shadow,34,19,15
Voidazepam,zuljin,1641,priest,shadow,102,56,46
Trenbologni,illidan,1639,priest,shadow,174,99,75
Salanzosp,bleeding-hollow,1638,priest,shadow,30,18,12
Faedyspriest,sargeras,1638,priest,shadow,54,31,23
Folesian,tichondrius,1638,priest,shadow,54,31,23
Despairx,tichondrius,1638,priest,shadow,36,19,17
Shadylotion,stormrage,1637,priest,shadow,42,24,18
Nullreferenc,frostmourne,1637,priest,shadow,81,45,36
Pumpss,area-52,1636,priest,shadow,73,41,32
Voidrisu,sargeras,1636,priest,shadow,78,36,42
Fancycorpse,tichondrius,1635,priest,shadow,60,27,33
Darkness,azralon,1634,priest,shadow,73,34,39
Grimdox,tichondrius,1631,priest,shadow,48,36,12
Cixelp,area-52,1631,priest,shadow,42,23,19
Mushill,tichondrius,1631,priest,shadow,102,51,51
Bbeaie,tichondrius,1631,priest,shadow,36,18,18
Xtcbtc,sargeras,1631,priest,shadow,41,20,21
Safe,illidan,1629,priest,shadow,97,51,46
Irangara,gorefiend,1628,priest,shadow,86,46,40
Sempiternus,barthilas,1628,priest,shadow,46,24,22
Kaidow,wyrmrest-accord,1627,priest,shadow,29,20,9
Holylip,frostmourne,1626,priest,shadow,39,26,13
Rhick,azralon,1626,priest,shadow,89,55,34
Sarâda,moon-guard,1626,priest,shadow,177,95,82
Fireballingg,tichondrius,1625,priest,shadow,30,18,12
Xarid,moon-guard,1625,priest,shadow,36,20,16
Arataxx,area-52,1625,priest,shadow,87,48,39
Irritated,vashj,1623,priest,shadow,36,24,12
Dontpvponme,illidan,1623,priest,shadow,36,24,12
Mêdúsa,area-52,1621,priest,shadow,58,30,28
Dorraheals,tichondrius,1620,priest,shadow,41,22,19
Shmage,malganis,1620,priest,shadow,65,34,31
Cyanovoid,thrall,1619,priest,shadow,53,29,24
Solstunn,moon-guard,1619,priest,shadow,48,24,24
Ilostmybible,quelthalas,1619,priest,shadow,46,23,23
Gershwinner,daggerspine,1619,priest,shadow,36,17,19
Iogical,kelthuzad,1618,priest,shadow,116,70,46
Caramelos,moon-guard,1618,priest,shadow,43,23,20
Thenamesnorm,tichondrius,1617,priest,shadow,59,36,23
Dustnbonez,area-52,1617,priest,shadow,36,20,16
Sècret,tichondrius,1617,priest,shadow,40,20,20
Darkestzell,azralon,1616,priest,shadow,41,20,21
Drossv,shadowmoon,1614,priest,shadow,42,20,22
Nihenben,illidan,1613,priest,shadow,78,42,36
Hieken,nemesis,1612,priest,shadow,70,43,27
Vallfiresp,malganis,1612,priest,shadow,40,22,18
Biubiubium,tichondrius,1611,priest,shadow,42,26,16
Pegwraith,sargeras,1611,priest,shadow,53,31,22
Snackabre,moon-guard,1611,priest,shadow,36,20,16
Márceline,stormrage,1610,priest,shadow,82,52,30
Benjamints,thrall,1610,priest,shadow,104,61,43
Dumpesitwo,frostmourne,1610,priest,shadow,30,17,13
Cheereos,stormrage,1610,priest,shadow,108,58,50
Kwõnc,tichondrius,1610,priest,shadow,64,33,31
Jeffgordo,tichondrius,1609,priest,shadow,86,52,34
Warklaw,frostmourne,1609,priest,shadow,72,34,38
Nodoubt,barthilas,1609,priest,shadow,58,26,32
Adopted,wyrmrest-accord,1608,priest,shadow,72,40,32
Pwrwordsquee,lightbringer,1607,priest,shadow,30,17,13
Brotherrob,area-52,1607,priest,shadow,71,38,33
Lightskinxo,kelthuzad,1606,priest,shadow,29,18,11
Alip,tichondrius,1606,priest,shadow,70,43,27
Iggyp,hyjal,1606,priest,shadow,48,28,20
Ludapriest,moon-guard,1606,priest,shadow,42,21,21
Helleamh,tichondrius,1606,priest,shadow,36,17,19
Moc,jubeithos,1605,priest,shadow,36,22,14
Fight,icecrown,1605,priest,shadow,60,33,27
Bubbzy,daggerspine,1605,priest,shadow,78,40,38
Gelato,velen,1605,priest,shadow,36,17,19
Krooked,kelthuzad,1604,priest,shadow,84,53,31
Imabeast,stormrage,1604,priest,shadow,102,53,49
Calientaeggs,drakkari,1604,priest,shadow,71,36,35
Clamchowdy,kiljaeden,1603,priest,shadow,27,18,9
Ayooblitz,guldan,1603,priest,shadow,48,29,19
Fâêlyn,wyrmrest-accord,1603,priest,shadow,94,46,48
Plenipotent,moon-guard,1603,priest,shadow,56,27,29
Quartzolio,azralon,1602,priest,shadow,24,17,7
Cloax,azgalor,1602,priest,shadow,48,29,19
Tënëbrë,nemesis,1601,priest,shadow,85,51,34
Crazyherb,azralon,1601,priest,shadow,161,88,73
Suery,hyjal,1601,priest,shadow,96,45,51
Hotphoyou,moon-guard,1600,priest,shadow,60,39,21
Thrageqt,sargeras,1600,priest,shadow,44,27,17
Manifestor,illidan,1600,priest,shadow,86,51,35
Machinecoach,stormrage,1600,priest,shadow,40,20,20
Nottonightqt,barthilas,1599,priest,shadow,102,54,48
Nktxc,tichondrius,1598,priest,shadow,48,26,22
Wifegrip,tichondrius,1598,priest,shadow,42,19,23
Amarexlol,stormrage,1597,priest,shadow,78,42,36
Radicional,azralon,1596,priest,shadow,36,20,16
Deiz,tichondrius,1596,priest,shadow,71,37,34
Minamy,tichondrius,1593,priest,shadow,30,17,13
Ìnfìnite,bleeding-hollow,1592,priest,shadow,24,17,7
Ulqüiorra,azralon,1592,priest,shadow,42,23,19
Antìdote,tichondrius,1592,priest,shadow,194,106,88
Priestine,dreadmaul,1592,priest,shadow,186,95,91
Thrie,ragnaros,1592,priest,shadow,42,18,24
Graviton,tichondrius,1591,priest,shadow,78,43,35
Lolshadow,amanthul,1590,priest,shadow,99,50,49
Heihunüwang,kargath,1586,priest,shadow,32,18,14
Shadowzypher,wyrmrest-accord,1586,priest,shadow,42,23,19
Skgangmm,tichondrius,1585,priest,shadow,35,22,13
Chillypriest,azjolnerub,1585,priest,shadow,42,23,19
Ranthrough,tichondrius,1584,priest,shadow,90,53,37
Fluttershÿ,ragnaros,1584,priest,shadow,54,28,26
Voidork,tichondrius,1583,priest,shadow,48,30,18
Nexumbra,dunemaul,1583,priest,shadow,144,76,68
Ezrashade,tichondrius,1583,priest,shadow,138,70,68
Kuazi,frostmourne,1581,priest,shadow,78,43,35
Vaala,jubeithos,1580,priest,shadow,60,30,30
Teddipriest,tichondrius,1578,priest,shadow,35,19,16
Dillydackx,sargeras,1577,priest,shadow,114,61,53
Brothercarl,stormrage,1576,priest,shadow,48,24,24
Darkshadows,ravenholdt,1575,priest,shadow,30,20,10
Çummiñs,malganis,1575,priest,shadow,36,21,15
Kaldrir,malganis,1574,priest,shadow,42,27,15
Boogiê,illidan,1574,priest,shadow,114,64,50
Heàvenly,moon-guard,1573,priest,shadow,36,21,15
Ibringgears,tichondrius,1572,priest,shadow,127,66,61
Ratleen,malganis,1570,priest,shadow,212,103,109
Xæl,tichondrius,1569,priest,shadow,108,65,43
Seedisc,kelthuzad,1569,priest,shadow,63,37,26
Mealmassttr,frostmourne,1569,priest,shadow,42,21,21
Raahsty,malganis,1569,priest,shadow,36,17,19
Nizeurflayzz,tichondrius,1568,priest,shadow,56,32,24
Milkgrabber,bleeding-hollow,1567,priest,shadow,145,77,68
Csonka,stormrage,1567,priest,shadow,62,30,32
Amentia,area-52,1565,priest,shadow,42,23,19
Xdlolqt,sargeras,1563,priest,shadow,72,33,39
Xiphoidz,frostmourne,1562,priest,shadow,49,23,26
Healypants,eonar,1560,priest,shadow,41,23,18
Bugsbright,tichondrius,1560,priest,shadow,177,96,81
Frankeebutt,stormrage,1559,priest,shadow,54,33,21
Aqurielen,turalyon,1559,priest,shadow,118,66,52
Vicara,moon-guard,1559,priest,shadow,101,50,51
Ethandryl,kelthuzad,1558,priest,shadow,39,23,16
Dahliá,frostmourne,1558,priest,shadow,83,45,38
Alex,boulderfist,1557,priest,shadow,54,31,23
Nightelffeet,stormrage,1557,priest,shadow,30,17,13
Methandrial,hyjal,1557,priest,shadow,147,77,70
Occult,bloodscalp,1556,priest,shadow,111,53,58
Powerwordcry,stormrage,1555,priest,shadow,81,43,38
Healzium,blackwater-raiders,1555,priest,shadow,74,35,39
Dottydaddy,emerald-dream,1554,priest,shadow,36,24,12
Fig,nazgrel,1554,priest,shadow,84,42,42
Nightcráwler,illidan,1553,priest,shadow,42,25,17
Coral,stormscale,1553,priest,shadow,65,33,32
Rhima,tichondrius,1552,priest,shadow,24,17,7
Rogspriest,sargeras,1552,priest,shadow,30,18,12
Vyabl,thrall,1552,priest,shadow,48,25,23
Suicider,emerald-dream,1552,priest,shadow,218,110,108
Krazé,tichondrius,1552,priest,shadow,80,40,40
Shadzie,sargeras,1551,priest,shadow,86,52,34
Sindawen,kiljaeden,1551,priest,shadow,66,38,28
Greyyan,wyrmrest-accord,1551,priest,shadow,297,160,137
Volkova,quelthalas,1549,priest,shadow,30,19,11
Iminyou,kelthuzad,1549,priest,shadow,101,58,43
Softs,area-52,1549,priest,shadow,83,42,41
Slottie,malganis,1548,priest,shadow,54,28,26
Wdnmmd,proudmoore,1548,priest,shadow,208,106,102
Proudigy,lightninghoof,1547,priest,shadow,93,54,39
Relicsa,proudmoore,1547,priest,shadow,71,36,35
Terranle,tichondrius,1545,priest,shadow,124,63,61
Nøfaith,area-52,1544,priest,shadow,118,53,65
Sylvane,silvermoon,1542,priest,shadow,89,55,34
Deffaultz,turalyon,1541,priest,shadow,70,40,30
Zhadowbolts,thrall,1540,priest,shadow,47,24,23
Abientot,tichondrius,1539,priest,shadow,84,47,37
Stepho,dalaran,1539,priest,shadow,42,19,23
Bigboyadam,frostmourne,1538,priest,shadow,88,55,33
Lilithice,moon-guard,1537,priest,shadow,48,25,23
Deeaann,tichondrius,1537,priest,shadow,327,169,158
Faeinia,elune,1534,priest,shadow,105,61,44
Mightyp,malganis,1534,priest,shadow,42,19,23
Jah,frostmourne,1533,priest,shadow,30,16,14
Shadowylorka,sargeras,1533,priest,shadow,48,22,26
Aethestan,zuljin,1533,priest,shadow,83,37,46
Beloriath,ragnaros,1532,priest,shadow,41,24,17
Shadowdurps,area-52,1532,priest,shadow,72,36,36
Anrop,illidan,1531,priest,shadow,48,31,17
Dotdotwin,illidan,1531,priest,shadow,71,43,28
Dikdik,tichondrius,1531,priest,shadow,75,42,33
Originull,emerald-dream,1531,priest,shadow,30,16,14
Iuvrainee,area-52,1531,priest,shadow,96,50,46
Halselin,senjin,1528,priest,shadow,136,83,53
ßluedreamx,tichondrius,1527,priest,shadow,41,26,15
Büd,sargeras,1527,priest,shadow,30,17,13
Matchacat,tichondrius,1527,priest,shadow,30,16,14
Whorticiå,area-52,1527,priest,shadow,191,94,97
Slogger,illidan,1527,priest,shadow,35,17,18
Tutuhx,quelthalas,1526,priest,shadow,24,16,8
Púrg,frostmourne,1526,priest,shadow,48,27,21
Jojoxxz,illidan,1526,priest,shadow,49,27,22
Pepps,proudmoore,1525,priest,shadow,605,309,296
Wenger,crushridge,1525,priest,shadow,174,85,89
Purpskurp,stormrage,1525,priest,shadow,42,20,22
Nòemis,quelthalas,1524,priest,shadow,30,18,12
Hungrybone,proudmoore,1524,priest,shadow,36,17,19
Jmanhealz,stormrage,1523,priest,shadow,24,16,8
Mellow,tichondrius,1523,priest,shadow,44,24,20
Mastuti,azralon,1523,priest,shadow,33,18,15
Beckðn,tichondrius,1523,priest,shadow,94,50,44
Voidshift,tichondrius,1523,priest,shadow,390,197,193
Olrightt,stormrage,1522,priest,shadow,42,24,18
Crbandit,moon-guard,1520,priest,shadow,112,65,47
Harisleidy,quelthalas,1520,priest,shadow,65,37,28
Ablatiøn,illidan,1520,priest,shadow,36,20,16
Emlix,tichondrius,1520,priest,shadow,86,46,40
Spriesto,frostmourne,1520,priest,shadow,35,18,17
Tíosam,ragnaros,1519,priest,shadow,30,16,14
Catmasters,area-52,1518,priest,shadow,40,20,20
Kilal,sargeras,1517,priest,shadow,42,30,12
Pics,emerald-dream,1517,priest,shadow,46,25,21
Bearuwu,frostmourne,1516,priest,shadow,36,16,20
Thiazine,kiljaeden,1515,priest,shadow,51,33,18
Keepitlegal,sargeras,1515,priest,shadow,30,16,14
Toddmund,tichondrius,1515,priest,shadow,173,86,87
Èvil,tichondrius,1514,priest,shadow,24,16,8
Bandages,stormreaver,1512,priest,shadow,115,59,56
Rotass,hyjal,1511,priest,shadow,65,40,25
Saitii,dalaran,1511,priest,shadow,30,16,14
Theorym,tichondrius,1509,priest,shadow,46,32,14
Luminous,moon-guard,1509,priest,shadow,68,39,29
Popejack,stormrage,1509,priest,shadow,45,24,21
Sorrentin,ragnaros,1508,priest,shadow,76,38,38
Rhoku,nesingwary,1507,priest,shadow,98,52,46
Thelordx,barthilas,1507,priest,shadow,66,34,32
Amideus,dunemaul,1507,priest,shadow,42,18,24
Pestee,quelthalas,1506,priest,shadow,179,97,82
Chibii,kelthuzad,1505,priest,shadow,83,55,28
Blakeak,hyjal,1505,priest,shadow,59,39,20
Lowkii,malfurion,1505,priest,shadow,75,47,28
Wobbleskank,tichondrius,1505,priest,shadow,84,50,34
Krythe,laughing-skull,1505,priest,shadow,41,19,22
Xannis,thrall,1504,priest,shadow,91,49,42
Csheweishan,aerie-peak,1504,priest,shadow,84,44,40
Justfaith,barthilas,1504,priest,shadow,73,35,38
Sezyks,stormrage,1503,priest,shadow,36,28,8
Aeonar,alleria,1503,priest,shadow,57,34,23
Lucael,durotan,1503,priest,shadow,60,33,27
Shadowhazed,tichondrius,1503,priest,shadow,42,23,19
Twistedtéa,garrosh,1503,priest,shadow,42,20,22
Shadowthief,magtheridon,1501,priest,shadow,30,16,14
Vynlanesh,illidan,1501,priest,shadow,132,65,67
Danoc,tichondrius,1500,priest,shadow,108,53,55
Marantbourge,frostmourne,1499,priest,shadow,108,65,43
Debbie,cairne,1499,priest,shadow,66,37,29
Goodlife,frostmourne,1499,priest,shadow,36,16,20
Markzugrberg,emerald-dream,1498,priest,shadow,36,18,18
Whitemagic,frostmourne,1497,priest,shadow,70,38,32
Ravinny,nemesis,1497,priest,shadow,88,43,45
Ed,crushridge,1496,priest,shadow,71,42,29
Bestwizardx,tichondrius,1495,priest,shadow,45,28,17
Bullma,boulderfist,1494,priest,shadow,22,17,5
Creedence,jubeithos,1493,priest,shadow,65,33,32
Dischaffy,shadowmoon,1491,priest,shadow,42,29,13
Bradythree,moon-guard,1491,priest,shadow,30,19,11
Palutena,drakkari,1491,priest,shadow,42,22,20
Nekkz,sargeras,1490,priest,shadow,29,21,8
Stellur,kelthuzad,1490,priest,shadow,29,18,11
Azheel,stormrage,1490,priest,shadow,71,29,42
Yeeko,kiljaeden,1489,priest,shadow,42,23,19
Uncletouches,thrall,1488,priest,shadow,58,31,27
Fïonan,proudmoore,1488,priest,shadow,72,35,37
Ivyslays,area-52,1487,priest,shadow,77,42,35
Cpoppa,sargeras,1487,priest,shadow,72,39,33
Suirr,tichondrius,1486,priest,shadow,36,22,14
Shadowlife,bonechewer,1486,priest,shadow,72,37,35
Abnormality,trollbane,1485,priest,shadow,18,16,2
Synkiz,darkspear,1485,priest,shadow,101,56,45
Supremezx,frostmourne,1484,priest,shadow,98,54,44
Propumper,dalaran,1483,priest,shadow,47,27,20
Numinous,wyrmrest-accord,1483,priest,shadow,74,39,35
Fzz,tichondrius,1482,priest,shadow,41,21,20
Exigyo,quelthalas,1481,priest,shadow,41,22,19
Shadowflux,thunderlord,1481,priest,shadow,48,19,29
Carniosso,azralon,1480,priest,shadow,140,70,70
Jhivagosp,tichondrius,1480,priest,shadow,40,19,21
Revóra,kelthuzad,1478,priest,shadow,84,51,33
Razzamun,lothar,1478,priest,shadow,36,19,17
Azagthøth,ravenholdt,1478,priest,shadow,239,122,117
Swp,sargeras,1476,priest,shadow,54,32,22
Teeprie,drakthul,1476,priest,shadow,70,41,29
Astoshan,moon-guard,1475,priest,shadow,125,73,52
Spoõks,darkspear,1475,priest,shadow,62,28,34
Juicymist,moon-guard,1471,priest,shadow,323,174,149
Jeanbi,ragnaros,1469,priest,shadow,150,81,69
Zeromisx,proudmoore,1469,priest,shadow,34,16,18
Shädë,emerald-dream,1467,priest,shadow,54,23,31
Srenity,zuljin,1466,priest,shadow,30,17,13
Shadowbee,kargath,1466,priest,shadow,32,18,14
Shådøw,destromath,1466,priest,shadow,48,21,27
Sînkaî,demon-soul,1465,priest,shadow,202,107,95
Shrax,emerald-dream,1464,priest,shadow,33,17,16
Flickmybick,sargeras,1464,priest,shadow,105,52,53
Cuaiminator,ragnaros,1463,priest,shadow,87,47,40
Shadeven,nagrand,1463,priest,shadow,39,18,21
Muurielle,quelthalas,1462,priest,shadow,207,108,99
Bigvoidman,area-52,1462,priest,shadow,64,32,32
Plzdontlos,hyjal,1461,priest,shadow,36,22,14
Prickled,zuljin,1461,priest,shadow,96,47,49
Ghedeloco,tichondrius,1460,priest,shadow,36,21,15
Malikeht,drakkari,1460,priest,shadow,74,40,34
Eraseme,bleeding-hollow,1460,priest,shadow,48,23,25
ßuffysummer,illidan,1460,priest,shadow,42,18,24
Fritzi,shattered-hand,1456,priest,shadow,30,17,13
Healtheze,kelthuzad,1456,priest,shadow,44,22,22
Maynard,ragnaros,1455,priest,shadow,101,55,46
Mikeysp,tichondrius,1453,priest,shadow,48,26,22
Creata,frostmourne,1450,priest,shadow,25,16,9
Scarsdeath,azralon,1449,priest,shadow,82,44,38
Drpopepurp,tichondrius,1447,priest,shadow,44,21,23
Zatthanea,hellscream,1445,priest,shadow,24,16,8
Grizzlysmite,stormrage,1445,priest,shadow,37,17,20
Boneappletee,area-52,1445,priest,shadow,36,16,20
Shén,barthilas,1444,priest,shadow,107,70,37
Lelyna,stormrage,1443,priest,shadow,46,27,19
Vizioz,tichondrius,1441,priest,shadow,36,16,20
Kokai,area-52,1440,priest,shadow,18,15,3
Mentalprison,khazgoroth,1439,priest,shadow,30,15,15
Yungjim,the-forgotten-coast,1439,priest,shadow,30,15,15
Sìnz,area-52,1438,priest,shadow,69,39,30
Øbara,frostmourne,1438,priest,shadow,141,74,67
Dawnkìn,bleeding-hollow,1437,priest,shadow,138,72,66
Rachelstarrx,hyjal,1436,priest,shadow,24,15,9
ßarracuda,illidan,1436,priest,shadow,114,65,49
Holydestroyr,dentarg,1436,priest,shadow,54,28,26
Onegil,tichondrius,1436,priest,shadow,75,38,37
Moistfather,kelthuzad,1435,priest,shadow,47,29,18
Theodorous,frostmourne,1435,priest,shadow,63,34,29
Papadoll,malganis,1435,priest,shadow,38,20,18
Mindfulness,tichondrius,1434,priest,shadow,24,15,9
Allsmite,aerie-peak,1433,priest,shadow,60,31,29
Whitehandpr,tichondrius,1433,priest,shadow,468,232,236
Duatneter,quelthalas,1432,priest,shadow,72,41,31
Stromile,tichondrius,1431,priest,shadow,24,17,7
Covidchamp,proudmoore,1431,priest,shadow,24,15,9
Ciem,tichondrius,1431,priest,shadow,24,15,9
Aguitardient,ragnaros,1431,priest,shadow,45,26,19
Spacethug,illidan,1431,priest,shadow,30,15,15
Leach,darkspear,1431,priest,shadow,100,48,52
Fadedatm,illidan,1431,priest,shadow,36,15,21
Kellsyo,hyjal,1429,priest,shadow,18,15,3
Yuhstin,sargeras,1429,priest,shadow,24,15,9
Aabye,nemesis,1428,priest,shadow,35,23,12
Sandrö,sargeras,1427,priest,shadow,24,15,9
Shadøwheal,stormrage,1427,priest,shadow,79,49,30
Stusy,tichondrius,1426,priest,shadow,77,47,30
Younext,sargeras,1425,priest,shadow,63,22,41
Mitoloshi,ragnaros,1424,priest,shadow,42,19,23
Zarøw,tichondrius,1423,priest,shadow,24,15,9
Ashtahius,ragnaros,1423,priest,shadow,149,84,65
Corthien,thrall,1422,priest,shadow,18,15,3
Frorgnence,stormrage,1422,priest,shadow,36,26,10
Grianné,mannoroth,1422,priest,shadow,48,30,18
Fathersmits,area-52,1422,priest,shadow,24,15,9
Holyren,sargeras,1419,priest,shadow,122,59,63
Anmu,illidan,1418,priest,shadow,29,16,13
Lilmix,hydraxis,1417,priest,shadow,41,26,15
Huajie,lightnings-blade,1417,priest,shadow,36,20,16
Saltheril,burning-blade,1417,priest,shadow,49,25,24
Aghorï,sargeras,1417,priest,shadow,133,65,68
Lostmybible,stormrage,1415,priest,shadow,72,44,28
Strokkerx,azralon,1414,priest,shadow,110,59,51
Moogyvoid,tichondrius,1414,priest,shadow,42,19,23
Ramaven,arygos,1413,priest,shadow,78,39,39
Grympriest,wyrmrest-accord,1412,priest,shadow,36,24,12
Showakoi,ragnaros,1412,priest,shadow,54,29,25
Oldmanlou,spirestone,1410,priest,shadow,30,17,13
Aedaki,garona,1410,priest,shadow,166,92,74
Pastortee,sargeras,1409,priest,shadow,65,35,30
Nüt,malganis,1409,priest,shadow,65,34,31
Nyctelis,sargeras,1409,priest,shadow,52,25,27
Wongÿ,tichondrius,1408,priest,shadow,30,24,6
Sandelios,aggramar,1408,priest,shadow,42,28,14
Janesville,tichondrius,1408,priest,shadow,42,27,15
Vílja,moon-guard,1407,priest,shadow,135,68,67
Plebcakès,sargeras,1404,priest,shadow,61,30,31
ßroßraßroski,sargeras,1403,priest,shadow,42,24,18
Niias,hyjal,1402,priest,shadow,93,52,41
Bastét,skullcrusher,1402,priest,shadow,108,60,48
Shirubamoya,gurubashi,1401,priest,shadow,41,23,18
Rida,zuljin,1401,priest,shadow,74,41,33
Pandarue,tichondrius,1401,priest,shadow,87,47,40
Mindboink,malganis,1401,priest,shadow,88,47,41
Zeroghp,tichondrius,1401,priest,shadow,30,15,15
Kuazi,khazgoroth,1398,priest,shadow,125,59,66
Imhðtep,ragnaros,1397,priest,shadow,84,40,44
Hypochondria,moon-guard,1396,priest,shadow,93,49,44
Elogant,frostmourne,1395,priest,shadow,112,47,65
Haø,stormrage,1393,priest,shadow,98,50,48
Ellipses,bleeding-hollow,1393,priest,shadow,78,31,47
Zyræl,stormrage,1392,priest,shadow,184,92,92
Dyé,hydraxis,1391,priest,shadow,30,16,14
Daysgone,bleeding-hollow,1391,priest,shadow,293,154,139
Onipapae,frostmourne,1390,priest,shadow,131,70,61
Dipírex,azralon,1389,priest,shadow,84,40,44
Mãstermerlin,frostmourne,1388,priest,shadow,47,23,24
Barelylegalx,tichondrius,1387,priest,shadow,36,16,20
Mindeas,the-forgotten-coast,1387,priest,shadow,38,15,23
Fäÿë,tichondrius,1386,priest,shadow,54,26,28
Vinasky,moon-guard,1386,priest,shadow,38,16,22
Achíllesheal,stormrage,1385,priest,shadow,101,53,48
Bloodify,azralon,1385,priest,shadow,53,26,27
Healztonic,dalaran,1380,priest,shadow,72,32,40
Ampela,dalaran,1379,priest,shadow,69,35,34
Littlebagel,nesingwary,1378,priest,shadow,63,36,27
Tye,medivh,1378,priest,shadow,30,15,15
Lawgiva,thrall,1377,priest,shadow,30,19,11
Jadon,sargeras,1377,priest,shadow,38,22,16
Miniimenx,azralon,1375,priest,shadow,41,29,12
Khelleya,moon-guard,1375,priest,shadow,51,26,25
Voidscrypt,thrall,1374,priest,shadow,106,62,44
Saphet,draktharon,1373,priest,shadow,94,58,36
Wowgreatgame,tichondrius,1373,priest,shadow,77,38,39
Discobish,sargeras,1371,priest,shadow,48,26,22
Coors,lightnings-blade,1371,priest,shadow,30,15,15
Urspareparts,sargeras,1370,priest,shadow,89,48,41
Onixió,ragnaros,1369,priest,shadow,30,15,15
Tyisanity,tichondrius,1368,priest,shadow,68,32,36
Scriptö,fizzcrank,1365,priest,shadow,78,51,27
Aránhell,ragnaros,1365,priest,shadow,48,28,20
Lolcrafthd,ragnaros,1364,priest,shadow,30,16,14
Phantomz,malganis,1362,priest,shadow,47,30,17
Chaas,ragnaros,1361,priest,shadow,126,65,61
Scadie,goldrinn,1360,priest,shadow,30,15,15
Manofmystery,drenden,1359,priest,shadow,23,15,8
Bibledave,whisperwind,1358,priest,shadow,45,22,23
Bigmollet,tichondrius,1357,priest,shadow,100,41,59
Irilde,proudmoore,1356,priest,shadow,42,21,21
Hollowed,drakkari,1355,priest,shadow,59,28,31
Hephiron,area-52,1355,priest,shadow,91,43,48
Stellaryn,moon-guard,1354,priest,shadow,66,29,37
Dockavok,bloodhoof,1353,priest,shadow,24,15,9
Icytaken,frostmourne,1353,priest,shadow,48,22,26
Ràvn,emerald-dream,1350,priest,shadow,22,17,5
Andso,azralon,1348,priest,shadow,36,17,19
Londy,area-52,1347,priest,shadow,539,271,268
Abc,spirestone,1344,priest,shadow,18,14,4
Slimfo,sargeras,1344,priest,shadow,24,14,10
Cartus,emerald-dream,1344,priest,shadow,52,26,26
Píty,ragnaros,1343,priest,shadow,18,14,4
Poague,area-52,1343,priest,shadow,24,14,10
Habann,frostmourne,1343,priest,shadow,146,72,74
Verbane,frostmourne,1343,priest,shadow,30,14,16
Task,korgath,1343,priest,shadow,41,18,23
Ukishizumi,tichondrius,1342,priest,shadow,18,14,4
Flay,dragonmaw,1342,priest,shadow,18,14,4
Cixelp,tichondrius,1342,priest,shadow,30,14,16
Haracka,quelthalas,1341,priest,shadow,30,14,16
Mudkrab,gundrak,1340,priest,shadow,18,14,4
Xionys,sargeras,1340,priest,shadow,66,31,35
Keicel,zuljin,1339,priest,shadow,30,14,16
Verbeka,nemesis,1338,priest,shadow,18,14,4
Cptnrockwèll,dalaran,1337,priest,shadow,98,53,45
Labraidor,tichondrius,1336,priest,shadow,105,44,61
Qadris,tichondrius,1336,priest,shadow,36,14,22
Biodot,sargeras,1335,priest,shadow,19,15,4
Bûdussy,bonechewer,1335,priest,shadow,95,46,49
Scenekîd,moon-guard,1334,priest,shadow,54,25,29
Osmatspriest,firetree,1334,priest,shadow,33,15,18
Boogle,frostmourne,1333,priest,shadow,59,26,33
Chenny,darkspear,1332,priest,shadow,72,40,32
Zeas,moon-guard,1331,priest,shadow,42,23,19
Bakedlord,malganis,1326,priest,shadow,51,21,30
Sacerthu,goldrinn,1325,priest,shadow,36,20,16
Brshki,tichondrius,1324,priest,shadow,18,14,4
Hecáte,dalaran,1324,priest,shadow,24,14,10
Pozcas,blood-furnace,1324,priest,shadow,30,16,14
Mortemus,drenden,1323,priest,shadow,32,21,11
Reverendpope,tichondrius,1323,priest,shadow,48,19,29
Bublethenrun,cenarius,1322,priest,shadow,23,15,8
Badnfluence,kiljaeden,1322,priest,shadow,30,17,13
Cymin,dalaran,1322,priest,shadow,31,16,15
Pacmanlol,greymane,1319,priest,shadow,18,14,4
Faithplusone,zuljin,1318,priest,shadow,24,15,9
Mortivore,azralon,1318,priest,shadow,30,14,16
Maniwa,dentarg,1317,priest,shadow,42,15,27
Chádeervas,nemesis,1315,priest,shadow,39,24,15
Vanisa,hellscream,1314,priest,shadow,76,41,35
Etan,thrall,1314,priest,shadow,85,44,41
Rammstèin,sargeras,1314,priest,shadow,30,14,16
Naieth,aerie-peak,1314,priest,shadow,75,32,43
Spriest,kul-tiras,1312,priest,shadow,24,14,10
Gnow,moon-guard,1312,priest,shadow,83,41,42
Nyktøs,quelthalas,1312,priest,shadow,60,27,33
Eskettit,korgath,1308,priest,shadow,24,14,10
Alisaie,dalvengyr,1308,priest,shadow,52,27,25
Goodvybz,illidan,1306,priest,shadow,44,18,26
Shadowtreta,azralon,1305,priest,shadow,42,26,16
Marni,akama,1305,priest,shadow,103,49,54
Roylwcheese,illidan,1304,priest,shadow,24,16,8
Kflexx,hydraxis,1303,priest,shadow,24,15,9
Mettz,malganis,1302,priest,shadow,24,14,10
Hüde,stormrage,1302,priest,shadow,109,55,54
Ilumus,lightnings-blade,1300,priest,shadow,24,14,10
Luzsombraa,stormrage,1300,priest,shadow,42,20,22
Cheez,tichondrius,1300,priest,shadow,130,60,70
Duckdemon,ragnaros,1299,priest,shadow,124,59,65
Flyingherps,tichondrius,1298,priest,shadow,24,15,9
Dioscura,malganis,1298,priest,shadow,26,15,11
Sekhen,area-52,1298,priest,shadow,49,23,26
Bustmybubble,tichondrius,1297,priest,shadow,50,34,16
Mamofwar,arthas,1296,priest,shadow,66,29,37
Bobbeans,area-52,1295,priest,shadow,30,18,12
Astari,illidan,1295,priest,shadow,44,15,29
Commotion,dalaran,1294,priest,shadow,23,14,9
Reos,jubeithos,1294,priest,shadow,54,32,22
Beautifulgir,illidan,1294,priest,shadow,54,30,24
Jilt,aerie-peak,1294,priest,shadow,30,14,16
Alvorr,ragnaros,1291,priest,shadow,88,45,43
Pfl,area-52,1291,priest,shadow,170,86,84
Ancene,illidan,1290,priest,shadow,42,24,18
Àx,draka,1290,priest,shadow,32,18,14
Alphawon,area-52,1290,priest,shadow,138,68,70
Hervert,area-52,1289,priest,shadow,36,19,17
Thotsndots,blood-furnace,1288,priest,shadow,26,15,11
Tjxx,zuljin,1287,priest,shadow,72,36,36
Milojac,hyjal,1285,priest,shadow,24,14,10
Timreaper,barthilas,1283,priest,shadow,53,29,24
Lilpika,illidan,1283,priest,shadow,66,31,35
Ketchuslipin,illidan,1283,priest,shadow,74,33,41
Puerquirri,quelthalas,1280,priest,shadow,36,19,17
Valloren,kalecgos,1278,priest,shadow,26,15,11
Mindtrip,korgath,1277,priest,shadow,98,49,49
Abolita,korgath,1276,priest,shadow,120,65,55
Zinr,tichondrius,1276,priest,shadow,42,20,22
Furìøns,nemesis,1275,priest,shadow,24,15,9
Janke,malganis,1274,priest,shadow,26,14,12
Ralphiez,tichondrius,1273,priest,shadow,52,27,25
Omenous,area-52,1273,priest,shadow,82,37,45
Lirien,kelthuzad,1273,priest,shadow,78,29,49
Dralaan,proudmoore,1272,priest,shadow,73,46,27
Healixd,area-52,1271,priest,shadow,36,14,22
Rakÿna,nemesis,1268,priest,shadow,24,15,9
Layrissa,whisperwind,1266,priest,shadow,24,15,9
Lyriczx,kelthuzad,1265,priest,shadow,42,18,24
Maricotä,azralon,1263,priest,shadow,42,24,18
Shadyvoodoo,barthilas,1262,priest,shadow,122,61,61
Sovix,sargeras,1259,priest,shadow,24,17,7
Festær,area-52,1258,priest,shadow,64,34,30
Uvebeendead,the-forgotten-coast,1257,priest,shadow,84,46,38
Uikaren,tichondrius,1256,priest,shadow,41,21,20
Synergize,korgath,1254,priest,shadow,60,30,30
Raoel,proudmoore,1253,priest,shadow,24,15,9
Kapriestsun,malorne,1252,priest,shadow,26,17,9
Stankylegz,tichondrius,1251,priest,shadow,30,16,14
Zolgeta,exodar,1250,priest,shadow,47,31,16
Gothii,tichondrius,1250,priest,shadow,47,16,31
Jwx,malganis,1248,priest,shadow,18,13,5
Madcuzyaknow,bleeding-hollow,1248,priest,shadow,24,13,11
Envyion,sargeras,1248,priest,shadow,24,13,11
Wombitpurple,azgalor,1247,priest,shadow,24,13,11
Quinlan,dreadmaul,1246,priest,shadow,40,19,21
Bubblepop,blackhand,1245,priest,shadow,18,13,5
Demples,darkspear,1245,priest,shadow,30,20,10
Kristt,thrall,1245,priest,shadow,192,88,104
Fanfansp,tichondrius,1244,priest,shadow,18,13,5
Spookytorch,illidan,1244,priest,shadow,24,13,11
Jahz,zuljin,1243,priest,shadow,18,13,5
Sakuraginero,illidan,1243,priest,shadow,24,13,11
Shadowjisha,emerald-dream,1243,priest,shadow,33,14,19
Aeingel,amanthul,1243,priest,shadow,53,19,34
Pri,jubeithos,1242,priest,shadow,18,13,5
Ashidox,proudmoore,1242,priest,shadow,27,14,13
Nonbinary,trollbane,1242,priest,shadow,30,14,16
Jexso,tichondrius,1242,priest,shadow,37,13,24
Houzz,frostmourne,1241,priest,shadow,18,13,5
Constentien,tichondrius,1240,priest,shadow,31,16,15
Xedus,mannoroth,1240,priest,shadow,74,37,37
Nóin,tichondrius,1240,priest,shadow,83,34,49
Rucati,cenarius,1239,priest,shadow,39,17,22
Ascian,daggerspine,1239,priest,shadow,30,13,17
Dilly,tichondrius,1238,priest,shadow,21,14,7
Oncemore,khazgoroth,1238,priest,shadow,42,16,26
Xijinping,chogall,1237,priest,shadow,24,13,11
Estelars,aggramar,1237,priest,shadow,251,128,123
Kàiju,zuljin,1237,priest,shadow,42,19,23
Nums,tichondrius,1236,priest,shadow,48,25,23
Xz,black-dragonflight,1236,priest,shadow,28,14,14
Matafuka,ragnaros,1235,priest,shadow,115,58,57
Bec,khadgar,1235,priest,shadow,30,14,16
Rykispriest,tichondrius,1234,priest,shadow,18,13,5
Dernièreplac,blackrock,1234,priest,shadow,27,16,11
Shadowyeti,illidan,1233,priest,shadow,18,13,5
Vikingkøng,ragnaros,1233,priest,shadow,18,13,5
Cykle,blackrock,1233,priest,shadow,42,13,29
Jiedx,tichondrius,1230,priest,shadow,35,14,21
Elam,ragnaros,1229,priest,shadow,53,19,34
Boill,illidan,1228,priest,shadow,18,13,5
Fadedvoid,malorne,1228,priest,shadow,18,13,5
Cowabungá,azralon,1227,priest,shadow,18,13,5
Kaermor,stormrage,1227,priest,shadow,66,28,38
Simplyfaded,black-dragonflight,1226,priest,shadow,24,13,11
Willibald,eldrethalas,1226,priest,shadow,52,20,32
Payan,barthilas,1224,priest,shadow,54,27,27
Overcastedxo,kelthuzad,1223,priest,shadow,74,43,31
Bmô,stormrage,1223,priest,shadow,53,24,29
Antoz,kelthuzad,1222,priest,shadow,49,28,21
Daemoon,deathwing,1220,priest,shadow,24,16,8
Paganpain,tichondrius,1220,priest,shadow,50,22,28
Mindraker,turalyon,1217,priest,shadow,18,13,5
Eggmccheese,stormrage,1216,priest,shadow,47,26,21
Moon,moonrunner,1215,priest,shadow,53,27,26
Holydarkness,quelthalas,1210,priest,shadow,70,30,40
Sorrowful,mannoroth,1208,priest,shadow,29,13,16
Castnngcouch,tichondrius,1207,priest,shadow,42,21,21
Galedry,ragnaros,1206,priest,shadow,65,26,39
Choupidou,illidan,1205,priest,shadow,30,13,17
Tylored,zuljin,1205,priest,shadow,42,16,26
Khenshin,ragnaros,1202,priest,shadow,80,47,33
Discpi,illidan,1202,priest,shadow,78,34,44
Senumbra,tichondrius,1200,priest,shadow,36,16,20
Hurrdurr,shattered-hand,1198,priest,shadow,18,13,5
Priestmain,thrall,1196,priest,shadow,42,20,22
Likeleela,azshara,1196,priest,shadow,104,48,56
Hairypenance,sargeras,1194,priest,shadow,23,13,10
Dockani,sargeras,1194,priest,shadow,66,31,35
Flaytonmanin,korgath,1193,priest,shadow,28,13,15
Whisper,zuljin,1190,priest,shadow,43,23,20
Pestî,area-52,1189,priest,shadow,66,30,36
Foli,zuljin,1187,priest,shadow,22,14,8
Aflstan,frostmourne,1185,priest,shadow,57,34,23
Yaann,zuljin,1185,priest,shadow,54,29,25
Locjawbe,area-52,1183,priest,shadow,65,29,36
Pristoleiro,azralon,1182,priest,shadow,17,13,4
Anathamaz,stormrage,1182,priest,shadow,36,13,23
Fullfear,lothar,1178,priest,shadow,26,13,13
Darksheals,barthilas,1176,priest,shadow,30,22,8
Vynardis,arygos,1173,priest,shadow,61,27,34
Deadcode,frostmane,1173,priest,shadow,58,22,36
Brokenpriest,wyrmrest-accord,1171,priest,shadow,89,39,50
Urmorphine,area-52,1170,priest,shadow,215,112,103
Zelashan,proudmoore,1170,priest,shadow,30,14,16
Lyxorr,area-52,1170,priest,shadow,42,18,24
Thedarkshade,area-52,1168,priest,shadow,45,28,17
Clayphace,darkspear,1167,priest,shadow,30,13,17
Amestroada,nemesis,1166,priest,shadow,27,14,13
Tanthdrel,proudmoore,1166,priest,shadow,36,18,18
Agraciada,illidan,1164,priest,shadow,57,32,25
Beneficium,nazjatar,1163,priest,shadow,66,35,31
Lùcìd,dalaran,1159,priest,shadow,36,22,14
Trollypriest,darkspear,1157,priest,shadow,94,44,50
Shinyspriest,tichondrius,1154,priest,shadow,95,45,50
Snakklè,illidan,1152,priest,shadow,18,13,5
Taxzury,tichondrius,1152,priest,shadow,18,12,6
Raxii,area-52,1152,priest,shadow,18,12,6
Mmys,tichondrius,1152,priest,shadow,24,12,12
Playsoon,illidan,1151,priest,shadow,18,12,6
Whosjoe,tichondrius,1151,priest,shadow,18,12,6
Wojangles,zuljin,1151,priest,shadow,18,12,6
Enchantrez,frostmourne,1151,priest,shadow,24,12,12
Rmpmeeper,kilrogg,1150,priest,shadow,12,12,0
Airil,mugthol,1150,priest,shadow,18,12,6
Shadowp,shattered-halls,1150,priest,shadow,24,12,12
Bàttlepriest,caelestrasz,1150,priest,shadow,36,16,20
Nohealerhere,frostmourne,1149,priest,shadow,18,12,6
Oxytoxin,sargeras,1149,priest,shadow,25,13,12
Nùm,tichondrius,1147,priest,shadow,21,13,8
Teccalil,tichondrius,1146,priest,shadow,24,12,12
Adolescents,bonechewer,1146,priest,shadow,24,12,12
Fouroneo,tichondrius,1146,priest,shadow,24,12,12
Delai,dalaran,1146,priest,shadow,24,12,12
Abednego,area-52,1145,priest,shadow,21,13,8
Dayquills,illidan,1145,priest,shadow,24,12,12
Growth,fizzcrank,1145,priest,shadow,24,12,12
Lidole,barthilas,1145,priest,shadow,30,12,18
Omnivoîd,tichondrius,1144,priest,shadow,24,12,12
Kk,fizzcrank,1144,priest,shadow,24,12,12
Luokni,illidan,1143,priest,shadow,18,12,6
Îcecube,sargeras,1142,priest,shadow,24,12,12
Kibariyb,drakkari,1139,priest,shadow,30,12,18
Thaedreu,area-52,1138,priest,shadow,33,14,19
Holyfüry,ragnaros,1134,priest,shadow,18,12,6
Khaibit,stormrage,1133,priest,shadow,51,31,20
Unholyreáper,magtheridon,1132,priest,shadow,24,12,12
Ëlliot,stormrage,1129,priest,shadow,39,19,20
Demoñ,deathwing,1128,priest,shadow,30,13,17
Drethor,saurfang,1126,priest,shadow,18,12,6
Vvti,quelthalas,1125,priest,shadow,28,15,13
Soonya,arygos,1121,priest,shadow,33,17,16
Lilmermaid,laughing-skull,1118,priest,shadow,24,12,12
Faithhealing,zuljin,1118,priest,shadow,97,47,50
Lõkî,malganis,1117,priest,shadow,18,12,6
Shmmoie,frostmourne,1115,priest,shadow,24,12,12
Saura,aegwynn,1111,priest,shadow,22,12,10
Knglizward,stormrage,1110,priest,shadow,71,38,33
Võid,tichondrius,1103,priest,shadow,23,12,11
Jeängrey,tichondrius,1100,priest,shadow,21,13,8
Shämus,dalaran,1097,priest,shadow,82,41,41
Angro,ragnaros,1094,priest,shadow,36,21,15
Thrilas,silver-hand,1092,priest,shadow,24,12,12
Rëckful,area-52,1088,priest,shadow,18,12,6
Misslost,nerzhul,1081,priest,shadow,23,12,11
Tinypuppyy,sargeras,1076,priest,shadow,49,19,30
Neehow,hyjal,1075,priest,shadow,35,22,13
Scormm,runetotem,1073,priest,shadow,24,13,11
Kundalini,boulderfist,1072,priest,shadow,41,17,24
Galice,archimonde,1066,priest,shadow,78,39,39
Eslaughter,twisting-nether,1061,priest,shadow,24,16,8
Robhàlford,ragnaros,1061,priest,shadow,31,15,16
Valeknun,stormrage,1060,priest,shadow,36,24,12
Chinchillin,demon-soul,1057,priest,shadow,189,92,97
Freebolte,frostmourne,1056,priest,shadow,12,11,1
Lastbubble,area-52,1056,priest,shadow,24,11,13
Patagoniabae,kelthuzad,1055,priest,shadow,12,11,1
Hakirn,bleeding-hollow,1055,priest,shadow,12,11,1
Icychain,area-52,1055,priest,shadow,18,11,7
Mòrbídìtý,area-52,1055,priest,shadow,25,11,14
Toddo,trollbane,1054,priest,shadow,18,11,7
Rattyp,barthilas,1054,priest,shadow,18,11,7
Sleezi,emerald-dream,1054,priest,shadow,18,11,7
Voidariah,tichondrius,1054,priest,shadow,24,11,13
Roterick,wyrmrest-accord,1053,priest,shadow,18,11,7
Mabisyo,wyrmrest-accord,1053,priest,shadow,18,11,7
Eatmyspells,malganis,1053,priest,shadow,24,11,13
Posest,darkspear,1053,priest,shadow,24,11,13
Voidhearted,tichondrius,1053,priest,shadow,30,11,19
Talkura,tichondrius,1052,priest,shadow,12,11,1
Tydïus,illidan,1052,priest,shadow,18,11,7
Melterdecara,tichondrius,1052,priest,shadow,18,11,7
Bhruno,proudmoore,1052,priest,shadow,18,11,7
Legitgayirl,zuljin,1052,priest,shadow,24,11,13
Fancyspork,illidan,1052,priest,shadow,24,11,13
Féarlust,demon-soul,1051,priest,shadow,18,11,7
Norbon,mugthol,1050,priest,shadow,18,11,7
Donttrainplz,tichondrius,1050,priest,shadow,20,11,9
Azrothlol,kul-tiras,1050,priest,shadow,30,11,19
Doctafuzz,muradin,1049,priest,shadow,24,12,12
Semillion,tichondrius,1049,priest,shadow,24,11,13
Halleßerry,illidan,1046,priest,shadow,18,11,7
Nocturnalx,moon-guard,1045,priest,shadow,18,11,7
Battlepope,the-scryers,1043,priest,shadow,61,34,27
Shadynasti,azshara,1041,priest,shadow,24,14,10
Tomseleck,frostmourne,1039,priest,shadow,24,11,13
Kushie,saurfang,1039,priest,shadow,24,11,13
Floofball,medivh,1038,priest,shadow,18,11,7
Ssphex,tichondrius,1038,priest,shadow,74,37,37
Yddwin,quelthalas,1036,priest,shadow,27,12,15
Lotros,area-52,1025,priest,shadow,18,11,7
Alzu,ragnaros,1023,priest,shadow,23,11,12
Drkvagician,tichondrius,1016,priest,shadow,30,11,19
Fedodesubaco,gallywix,1010,priest,shadow,54,29,25
Oglilptown,thunderlord,1005,priest,shadow,60,33,27
Ipse,azshara,1004,priest,shadow,84,46,38
Nadrii,illidan,1002,priest,shadow,36,17,19
Sinkz,ragnaros,992,priest,shadow,16,11,5
Pocket,alleria,991,priest,shadow,22,11,11
Coolbie,korgath,990,priest,shadow,26,11,15
Hørçrùx,tichondrius,989,priest,shadow,17,11,6
Mastahmind,illidan,983,priest,shadow,26,12,14
Discountay,burning-legion,965,priest,shadow,20,11,9
Insindious,sargeras,963,priest,shadow,15,12,3
Mmrassassin,stormrage,960,priest,shadow,12,10,2
Icarryozz,darkspear,960,priest,shadow,12,10,2
Kissmyvoìd,frostmourne,960,priest,shadow,18,10,8
Kong,shandris,960,priest,shadow,18,10,8
Spôoky,illidan,960,priest,shadow,18,10,8
Plumpkinn,kiljaeden,960,priest,shadow,18,10,8
Jugeum,proudmoore,960,priest,shadow,18,10,8
Evilgeniusx,area-52,960,priest,shadow,18,10,8
Pèrona,tichondrius,960,priest,shadow,18,10,8
Anoumenon,tichondrius,960,priest,shadow,18,10,8
Rendoss,arathor,959,priest,shadow,12,10,2
Diyel,area-52,959,priest,shadow,12,10,2
Inflìctìøn,frostmourne,959,priest,shadow,12,10,2
Synergia,drakkari,959,priest,shadow,12,10,2
Ayzen,emerald-dream,959,priest,shadow,18,10,8
Vixova,illidan,959,priest,shadow,18,10,8
Philmacrakn,stormrage,959,priest,shadow,18,10,8
Bestpimp,frostmane,959,priest,shadow,18,10,8
Wrinkletink,whisperwind,959,priest,shadow,18,10,8
Pxrnhxb,tichondrius,959,priest,shadow,18,10,8
Didy,dark-iron,959,priest,shadow,18,10,8
Xtradotz,tichondrius,959,priest,shadow,18,10,8
Hevnlyst,proudmoore,959,priest,shadow,24,10,14
Terý,dalaran,959,priest,shadow,24,10,14
Keepsleepin,stormrage,959,priest,shadow,24,10,14
Felskie,tichondrius,958,priest,shadow,12,10,2
Deckx,khazgoroth,958,priest,shadow,16,11,5
Bratty,hellscream,958,priest,shadow,15,10,5
Tatzis,frostmourne,958,priest,shadow,18,10,8
Missiønary,area-52,958,priest,shadow,18,10,8
Cerriôus,baelgun,958,priest,shadow,18,10,8
Deawalker,khaz-modan,958,priest,shadow,18,10,8
Madomie,bladefist,958,priest,shadow,18,10,8
Porffy,malygos,958,priest,shadow,18,10,8
Ccnu,tichondrius,957,priest,shadow,18,10,8
Såx,stormreaver,956,priest,shadow,24,10,14
Pottime,tichondrius,956,priest,shadow,24,10,14
Boocharni,wyrmrest-accord,955,priest,shadow,12,10,2
Gankdalf,draktharon,955,priest,shadow,18,10,8
Spamnhealz,illidan,955,priest,shadow,18,10,8
Mathertia,dalaran,954,priest,shadow,18,10,8
Slctivhealng,area-52,954,priest,shadow,18,10,8
Lätöxïkä,alleria,954,priest,shadow,24,10,14
Ragnálodbrok,ragnaros,953,priest,shadow,18,10,8
Xora,frostmourne,952,priest,shadow,18,10,8
Pewzy,malganis,951,priest,shadow,18,10,8
Fearmongrol,bleeding-hollow,950,priest,shadow,24,10,14
Hitful,azralon,949,priest,shadow,12,10,2
Turkings,proudmoore,936,priest,shadow,16,11,5
Vandamnation,barthilas,927,priest,shadow,16,11,5
Farnkxd,bleeding-hollow,925,priest,shadow,32,11,21
Arzeuz,ragnaros,923,priest,shadow,20,11,9
Capitancook,ragnaros,913,priest,shadow,48,13,35
Rassalor,frostmane,910,priest,shadow,17,10,7
Romero,blood-furnace,907,priest,shadow,102,44,58
Beeds,sargeras,907,priest,shadow,111,47,64
Silmeriá,darkspear,904,priest,shadow,29,11,18
Khall,sargeras,895,priest,shadow,40,17,23
Exen,moon-guard,894,priest,shadow,18,11,7
Datcuban,illidan,894,priest,shadow,26,13,13
Berixa,stormscale,883,priest,shadow,11,10,1
Lockerest,sargeras,868,priest,shadow,41,13,28
Jâmïè,gurubashi,864,priest,shadow,12,9,3
Powerwordhim,malganis,864,priest,shadow,12,9,3
Beibeihang,tichondrius,864,priest,shadow,12,9,3
Adeptphd,tichondrius,864,priest,shadow,12,9,3
Æë,area-52,864,priest,shadow,12,9,3
Feverx,tichondrius,864,priest,shadow,12,9,3
Voidcult,area-52,864,priest,shadow,18,9,9
Wololo,emerald-dream,864,priest,shadow,18,9,9
Boxcombo,kelthuzad,864,priest,shadow,18,9,9
Bumbleedot,azralon,864,priest,shadow,18,9,9
Tiernocookie,illidan,864,priest,shadow,18,9,9
Achllia,proudmoore,864,priest,shadow,18,9,9
Jdcii,tichondrius,864,priest,shadow,24,9,15
Powerwordkék,area-52,863,priest,shadow,12,9,3
Pumtootoot,tichondrius,863,priest,shadow,12,9,3
Dyhm,gorgonnash,863,priest,shadow,12,9,3
Charity,maelstrom,863,priest,shadow,12,9,3
Sadomyhusein,eitrigg,863,priest,shadow,12,9,3
Givenchy,arygos,863,priest,shadow,18,9,9
Ðecease,thrall,863,priest,shadow,18,9,9
Valerift,moon-guard,863,priest,shadow,18,9,9
Dnn,malganis,863,priest,shadow,18,9,9
Delrey,sargeras,863,priest,shadow,18,9,9
Küno,kelthuzad,863,priest,shadow,18,9,9
Woosanghong,tichondrius,863,priest,shadow,18,9,9
Iamgayx,kelthuzad,863,priest,shadow,18,9,9
Acpriest,tichondrius,863,priest,shadow,24,9,15
Druicytwo,illidan,863,priest,shadow,24,9,15
Efxsp,sargeras,863,priest,shadow,24,9,15
Zêrø,aerie-peak,863,priest,shadow,24,9,15
Everblack,executus,862,priest,shadow,12,9,3
Nazgúl,lothar,862,priest,shadow,18,9,9
Vzell,kiljaeden,862,priest,shadow,18,9,9
Tyreliy,eitrigg,862,priest,shadow,18,9,9
Dóctóre,thrall,862,priest,shadow,18,9,9
Touchypriest,jaedenar,862,priest,shadow,18,9,9
Faashrmpbtw,darkspear,861,priest,shadow,12,9,3
Tmspongwo,tichondrius,861,priest,shadow,18,9,9
Kovidcure,tichondrius,861,priest,shadow,18,9,9
Fósho,khadgar,861,priest,shadow,24,9,15
Falsegodx,tichondrius,861,priest,shadow,24,9,15
Melas,stormrage,861,priest,shadow,24,9,15
Viejiyoh,ragnaros,860,priest,shadow,18,9,9
Webba,azshara,860,priest,shadow,18,9,9
Adíos,malganis,860,priest,shadow,18,9,9
Krypts,shadow-council,859,priest,shadow,18,9,9
Nuttsope,kiljaeden,859,priest,shadow,18,9,9
Wankenobi,stormrage,859,priest,shadow,18,9,9
Methodist,sargeras,859,priest,shadow,24,9,15
Healzahoe,sargeras,859,priest,shadow,24,9,15
Frëÿjä,proudmoore,858,priest,shadow,12,9,3
Sãoleozinho,azralon,858,priest,shadow,18,9,9
Beansontoast,wyrmrest-accord,857,priest,shadow,12,9,3
Beliál,ragnaros,857,priest,shadow,24,9,15
Theophii,tichondrius,854,priest,shadow,24,9,15
Zaxine,moon-guard,854,priest,shadow,30,9,21
Tictactoejc,tichondrius,852,priest,shadow,12,9,3
Mazahr,stormrage,852,priest,shadow,12,9,3
Hibot,illidan,849,priest,shadow,30,9,21
Lightbanter,emerald-dream,846,priest,shadow,24,9,15
Kagamì,frostmane,843,priest,shadow,31,9,22
Pipiwiwi,tichondrius,831,priest,shadow,16,9,7
Maldicius,emerald-dream,830,priest,shadow,23,9,14
Stylonious,hyjal,815,priest,shadow,15,9,6
Buc,barthilas,813,priest,shadow,15,9,6
Rigotakx,illidan,805,priest,shadow,27,10,17
Fledgeling,frostmourne,799,priest,shadow,14,9,5
Ochae,stormrage,798,priest,shadow,11,9,2
Bingleboi,area-52,798,priest,shadow,20,9,11
Blonkie,azgalor,791,priest,shadow,30,12,18
Lôvecraft,frostmourne,781,priest,shadow,19,9,10
Reignsp,malganis,781,priest,shadow,19,9,10
Xqz,zuljin,768,priest,shadow,12,8,4
Drinky,tichondrius,768,priest,shadow,12,8,4
Popebenedix,barthilas,768,priest,shadow,12,8,4
Púrplenurple,area-52,768,priest,shadow,12,8,4
Sickfear,korgath,768,priest,shadow,12,8,4
Oxycodex,thrall,768,priest,shadow,12,8,4
Eridan,moon-guard,768,priest,shadow,12,8,4
Härpocrates,area-52,768,priest,shadow,12,8,4
Hockula,kiljaeden,768,priest,shadow,12,8,4
Silentólògy,malganis,768,priest,shadow,12,8,4
Nohesita,stormrage,768,priest,shadow,12,8,4
Ahleven,tichondrius,768,priest,shadow,12,8,4
Dazull,bleeding-hollow,768,priest,shadow,12,8,4
Ydonburi,tichondrius,768,priest,shadow,12,8,4
Ruzhi,moon-guard,768,priest,shadow,12,8,4
Lnoh,area-52,768,priest,shadow,12,8,4
Skraitbussin,tichondrius,768,priest,shadow,12,8,4
Likeness,proudmoore,768,priest,shadow,12,8,4
Darkascended,arthas,768,priest,shadow,12,8,4
Stungods,frostmourne,768,priest,shadow,12,8,4
Mumsmilk,sargeras,768,priest,shadow,12,8,4
Cenfade,sargeras,768,priest,shadow,18,8,10
Àústîn,moon-guard,768,priest,shadow,18,8,10
Ripchadman,tichondrius,768,priest,shadow,18,8,10
Mydixi,stormrage,768,priest,shadow,18,8,10
Pâm,drakkari,768,priest,shadow,18,8,10
Heàl,akama,768,priest,shadow,18,8,10
Kemsety,azralon,768,priest,shadow,18,8,10
Pineappleqt,skullcrusher,768,priest,shadow,18,8,10
Iluvwizkx,malganis,768,priest,shadow,18,8,10
Deacoderx,area-52,768,priest,shadow,18,8,10
Duhpriest,frostmourne,768,priest,shadow,18,8,10
Skepix,lightbringer,768,priest,shadow,18,8,10
Madmelter,emerald-dream,768,priest,shadow,18,8,10
Drosslolz,illidan,768,priest,shadow,18,8,10
Alucardibee,turalyon,768,priest,shadow,24,8,16
Synesis,bladefist,768,priest,shadow,24,8,16
Mugiwarà,stormrage,767,priest,shadow,12,8,4
Drteabaghaam,zuljin,767,priest,shadow,12,8,4
Hairyboxx,frostmourne,767,priest,shadow,12,8,4
Moojoke,zuljin,767,priest,shadow,12,8,4
Shadowlords,emerald-dream,767,priest,shadow,12,8,4
Valsong,argent-dawn,767,priest,shadow,12,8,4
Viq,stormrage,767,priest,shadow,12,8,4
Homonid,moon-guard,767,priest,shadow,12,8,4
Xexeth,quelthalas,767,priest,shadow,12,8,4
Sgssg,illidan,767,priest,shadow,12,8,4
Easyrevenge,kelthuzad,767,priest,shadow,12,8,4
Yackle,dawnbringer,767,priest,shadow,12,8,4
Voidathon,sargeras,767,priest,shadow,12,8,4
Tungus,shadowsong,767,priest,shadow,12,8,4
Trenance,barthilas,767,priest,shadow,18,8,10
Omygawd,tichondrius,767,priest,shadow,18,8,10
Lostnlight,aggramar,767,priest,shadow,18,8,10
Badxjuju,frostmourne,767,priest,shadow,18,8,10
Shattershade,bleeding-hollow,767,priest,shadow,18,8,10
Smitepie,malganis,767,priest,shadow,18,8,10
Igotubrah,malganis,767,priest,shadow,18,8,10
Valothrian,area-52,767,priest,shadow,18,8,10
Zonozan,lightnings-blade,767,priest,shadow,18,8,10
Tuggyp,tichondrius,767,priest,shadow,18,8,10
Solrina,khazgoroth,766,priest,shadow,12,8,4
Gorebones,emerald-dream,766,priest,shadow,18,8,10
Chroma,amanthul,766,priest,shadow,18,8,10
Jinzan,stormrage,766,priest,shadow,18,8,10
Faydes,arthas,766,priest,shadow,19,8,11
Sadinho,azralon,766,priest,shadow,24,8,16
Rustinheber,stormscale,765,priest,shadow,12,8,4
Kumojorno,gilneas,765,priest,shadow,18,8,10
Nachòs,wildhammer,765,priest,shadow,24,8,16
Pactosombrio,azralon,763,priest,shadow,24,8,16
Drkwispers,stormrage,762,priest,shadow,18,8,10
Speckilz,area-52,762,priest,shadow,26,8,18
Sôuljah,skywall,760,priest,shadow,26,10,16
Aqusia,crushridge,753,priest,shadow,12,8,4
Hydroman,black-dragonflight,753,priest,shadow,18,9,9
Memoria,emerald-dream,751,priest,shadow,15,9,6
Runswithrain,lethon,750,priest,shadow,23,8,15
Gedtemanager,dalaran,749,priest,shadow,12,8,4
Vorial,cenarion-circle,735,priest,shadow,17,8,9
Harmlot,tichondrius,733,priest,shadow,14,9,5
Bobe,sisters-of-elune,729,priest,shadow,48,16,32
Strazloraz,baelgun,719,priest,shadow,11,8,3
Meegoshy,azuremyst,718,priest,shadow,17,8,9
Gorry,ragnaros,717,priest,shadow,18,9,9
Mikó,dawnbringer,714,priest,shadow,29,10,19
Yrrep,kelthuzad,703,priest,shadow,16,8,8
Peazyqt,tichondrius,687,priest,shadow,13,8,5
Fatzoid,the-forgotten-coast,672,priest,shadow,12,7,5
Kyerñ,stormrage,672,priest,shadow,12,7,5
Javakhp,illidan,672,priest,shadow,12,7,5
Chicoryx,illidan,672,priest,shadow,12,7,5
Vyrus,tichondrius,672,priest,shadow,12,7,5
Twítch,bonechewer,672,priest,shadow,12,7,5
Kwiksi,arthas,672,priest,shadow,12,7,5
Prizler,tichondrius,672,priest,shadow,12,7,5
Kastwalker,earthen-ring,672,priest,shadow,12,7,5
Grëýmåttèr,moon-guard,672,priest,shadow,12,7,5
Zuuji,frostmourne,672,priest,shadow,12,7,5
Rottedjezus,dalaran,672,priest,shadow,12,7,5
Negans,tichondrius,672,priest,shadow,12,7,5
Phéonìx,zuljin,672,priest,shadow,12,7,5
Lilsweet,stonemaul,672,priest,shadow,12,7,5
Cryptoccocus,zuljin,672,priest,shadow,12,7,5
Nutzz,malganis,672,priest,shadow,12,7,5
Scøøb,malganis,672,priest,shadow,12,7,5
Lillyspr,malganis,672,priest,shadow,12,7,5
Xousa,area-52,672,priest,shadow,12,7,5
Freebolt,barthilas,672,priest,shadow,12,7,5
Tailsy,tichondrius,672,priest,shadow,12,7,5
Hårper,area-52,672,priest,shadow,12,7,5
Blackaries,frostmourne,672,priest,shadow,12,7,5
Naùtilus,icecrown,672,priest,shadow,12,7,5
Karkoza,proudmoore,672,priest,shadow,12,7,5
Diddlur,black-dragonflight,672,priest,shadow,12,7,5
Bucksp,zuljin,672,priest,shadow,12,7,5
Wodturbo,bleeding-hollow,672,priest,shadow,12,7,5
Cheach,echo-isles,672,priest,shadow,12,7,5
Discs,detheroc,672,priest,shadow,12,7,5
Lontra,zangarmarsh,672,priest,shadow,12,7,5
Bugweeb,sargeras,672,priest,shadow,12,7,5
Aeøns,sargeras,672,priest,shadow,12,7,5
Haruspex,azralon,672,priest,shadow,12,7,5
Obeseheals,silvermoon,672,priest,shadow,12,7,5
Rubymisfit,sargeras,672,priest,shadow,12,7,5
Leorid,stormrage,672,priest,shadow,12,7,5
Ácÿd,nemesis,672,priest,shadow,12,7,5
Moonlightx,destromath,672,priest,shadow,12,7,5
Gles,quelthalas,672,priest,shadow,13,7,6
Aurilain,emerald-dream,672,priest,shadow,18,7,11
Bigbrother,andorhal,672,priest,shadow,18,7,11
Frúdgé,illidan,672,priest,shadow,18,7,11
Jesstical,frostmourne,672,priest,shadow,18,7,11
Nightious,malganis,672,priest,shadow,18,7,11
Gálfore,malganis,672,priest,shadow,18,7,11
Donmartin,tichondrius,672,priest,shadow,18,7,11
Tenaebreu,tichondrius,672,priest,shadow,19,7,12
Veressà,quelthalas,672,priest,shadow,22,8,14
Chês,tichondrius,672,priest,shadow,24,7,17
Temnah,sargeras,672,priest,shadow,30,7,23
Socknapper,sargeras,671,priest,shadow,12,7,5
Stasis,korialstrasz,671,priest,shadow,12,7,5
Spshady,aegwynn,671,priest,shadow,12,7,5
Gaho,tichondrius,671,priest,shadow,12,7,5
Faukauf,zuljin,671,priest,shadow,12,7,5
Nastyyshadow,aegwynn,671,priest,shadow,12,7,5
Preyforme,tichondrius,671,priest,shadow,12,7,5
Darkrics,barthilas,671,priest,shadow,12,7,5
Chinstrap,zuljin,671,priest,shadow,12,7,5
Dovakhamut,illidan,671,priest,shadow,12,7,5
Voltstein,dalaran,671,priest,shadow,12,7,5
Moonpenance,windrunner,671,priest,shadow,12,7,5
Via,chogall,671,priest,shadow,13,7,6
Sagis,moon-guard,671,priest,shadow,18,7,11
Digitalangel,area-52,671,priest,shadow,18,7,11
Torangi,tichondrius,671,priest,shadow,18,7,11
Shimz,andorhal,671,priest,shadow,18,7,11
Pokeyoobutt,hydraxis,671,priest,shadow,18,7,11
Minarhy,moon-guard,671,priest,shadow,18,7,11
Havefaith,whisperwind,671,priest,shadow,18,7,11
Heion,detheroc,671,priest,shadow,18,7,11
Influencing,moon-guard,671,priest,shadow,18,7,11
Montcrief,tichondrius,670,priest,shadow,12,7,5
Zaixse,illidan,670,priest,shadow,12,7,5
Tonybromoo,kelthuzad,670,priest,shadow,12,7,5
Nerfdisc,azralon,670,priest,shadow,12,7,5
Roommatethor,thaurissan,670,priest,shadow,12,7,5
Showmemoney,saurfang,670,priest,shadow,12,7,5
Iseeyoulookn,stormrage,670,priest,shadow,16,8,8
Fruitbasketz,malganis,670,priest,shadow,24,7,17
Bojanglings,undermine,670,priest,shadow,24,7,17
Voiddark,thrall,669,priest,shadow,13,7,6
Rhapsidy,barthilas,669,priest,shadow,15,8,7
Gabryanna,emerald-dream,669,priest,shadow,24,7,17
Nyrbana,onyxia,668,priest,shadow,10,8,2
Solraea,stormrage,668,priest,shadow,12,7,5
Rijonkulous,area-52,668,priest,shadow,18,7,11
Bellalugosi,auchindoun,667,priest,shadow,12,7,5
Lampshayd,sargeras,665,priest,shadow,12,7,5
Crashed,frostmourne,654,priest,shadow,23,7,16
Bwansandi,blackrock,651,priest,shadow,44,11,33
Lucifena,darkspear,639,priest,shadow,11,7,4
Metaila,aerie-peak,639,priest,shadow,11,7,4
Holliebell,zuljin,639,priest,shadow,17,7,10
Astraetus,zuljin,639,priest,shadow,17,7,10
Bouffantbibl,tichondrius,639,priest,shadow,20,8,12
Wzrdtrx,tichondrius,638,priest,shadow,14,8,6
Emmitson,scarlet-crusade,638,priest,shadow,28,7,21
Schelleyyuki,tichondrius,623,priest,shadow,11,7,4
Chiliy,frostmourne,623,priest,shadow,11,7,4
Lzzp,azralon,623,priest,shadow,17,7,10
Winss,tichondrius,608,priest,shadow,10,7,3
Glek,tichondrius,608,priest,shadow,16,7,9
Dispersed,thrall,607,priest,shadow,14,7,7
Hölyfury,illidan,607,priest,shadow,17,7,10
Xodarap,frostmourne,607,priest,shadow,20,7,13
Seniorpickle,emerald-dream,606,priest,shadow,14,7,7
Flowerpetals,emerald-dream,599,priest,shadow,21,7,14
Nylaza,kiljaeden,592,priest,shadow,19,7,12
Ìforted,zuljin,587,priest,shadow,19,7,12
Umberries,dreadmaul,585,priest,shadow,19,10,9
Overpriest,ragnaros,576,priest,shadow,6,6,0
Nayzarh,darkspear,576,priest,shadow,6,6,0
Applepiezz,tichondrius,576,priest,shadow,6,6,0
Innovate,dragonmaw,576,priest,shadow,6,6,0
Lukuku,barthilas,576,priest,shadow,6,6,0
Moonwald,moon-guard,576,priest,shadow,6,6,0
Henrywhopper,fizzcrank,576,priest,shadow,6,6,0
Sydgames,area-52,576,priest,shadow,6,6,0
Dradinx,illidan,576,priest,shadow,7,6,1
Faenzal,area-52,576,priest,shadow,12,6,6
Rebdomine,magtheridon,576,priest,shadow,12,6,6
Zeacho,proudmoore,576,priest,shadow,12,6,6
Iemon,vashj,576,priest,shadow,12,6,6
Shiikari,terenas,576,priest,shadow,12,6,6
Jeremyissped,proudmoore,576,priest,shadow,12,6,6
Yiptawh,area-52,576,priest,shadow,12,6,6
Dellah,stormrage,576,priest,shadow,12,6,6
Drognar,lightbringer,576,priest,shadow,12,6,6
Fitchbucker,sargeras,576,priest,shadow,12,6,6
Sacerdotick,gallywix,576,priest,shadow,12,6,6
Faztwo,illidan,576,priest,shadow,12,6,6
Nelfonshelf,hyjal,576,priest,shadow,12,6,6
Virsyti,area-52,576,priest,shadow,12,6,6
Carosene,thrall,576,priest,shadow,12,6,6
Kessavannell,frostwolf,576,priest,shadow,12,6,6
Enaan,proudmoore,576,priest,shadow,12,6,6
Shadowspain,stormrage,576,priest,shadow,12,6,6
Ôverweight,sargeras,576,priest,shadow,12,6,6
Heb,thrall,576,priest,shadow,12,6,6
Ershackleton,illidan,576,priest,shadow,12,6,6
Bipölar,area-52,576,priest,shadow,12,6,6
Spookyman,malganis,576,priest,shadow,12,6,6
Càipirinha,tichondrius,576,priest,shadow,12,6,6
Shuterx,tichondrius,576,priest,shadow,12,6,6
Imshadow,azralon,576,priest,shadow,12,6,6
Froackey,agamaggan,576,priest,shadow,12,6,6
Mks,barthilas,576,priest,shadow,12,6,6
Evansong,frostmane,576,priest,shadow,12,6,6
Silverblacks,quelthalas,576,priest,shadow,12,6,6
Xpenance,ragnaros,576,priest,shadow,12,6,6
Secretpriest,tichondrius,576,priest,shadow,12,6,6
Ossirus,emerald-dream,576,priest,shadow,12,6,6
Studiosxz,tichondrius,576,priest,shadow,12,6,6
Vengep,sargeras,576,priest,shadow,12,6,6
Bllitzxkreig,tichondrius,576,priest,shadow,12,6,6
Lisau,tichondrius,576,priest,shadow,12,6,6
Tomriddlle,sargeras,576,priest,shadow,12,6,6
Lleak,tichondrius,576,priest,shadow,12,6,6
Sped,saurfang,576,priest,shadow,12,6,6
Rahtals,malganis,576,priest,shadow,12,6,6
Pønt,sargeras,576,priest,shadow,12,6,6
Jrøck,malganis,576,priest,shadow,12,6,6
Wheelson,wildhammer,576,priest,shadow,12,6,6
Spriestbro,emerald-dream,576,priest,shadow,12,6,6
Caeda,icecrown,576,priest,shadow,18,6,12
Soulrulerx,tichondrius,576,priest,shadow,18,6,12
Mindgamez,stormreaver,576,priest,shadow,18,6,12
Evaldi,proudmoore,576,priest,shadow,18,6,12
Fruitjuice,arthas,576,priest,shadow,18,6,12
Spriestes,thrall,575,priest,shadow,6,6,0
Ricksanchez,moonrunner,575,priest,shadow,12,6,6
Morboo,proudmoore,575,priest,shadow,12,6,6
Çovidònenine,tichondrius,575,priest,shadow,12,6,6
Xð,jubeithos,575,priest,shadow,12,6,6
Mìdnìght,ragnaros,575,priest,shadow,12,6,6
Alienà,arthas,575,priest,shadow,12,6,6
Unclelively,dragonmaw,575,priest,shadow,12,6,6
Vashyy,stormrage,575,priest,shadow,12,6,6
Empower,garrosh,575,priest,shadow,12,6,6
Epijho,area-52,575,priest,shadow,12,6,6
Mêrlin,duskwood,575,priest,shadow,12,6,6
Rezzn,wyrmrest-accord,575,priest,shadow,12,6,6
Rustydisc,area-52,575,priest,shadow,12,6,6
Boogieboop,frostmourne,575,priest,shadow,12,6,6
Xinthra,stormrage,575,priest,shadow,12,6,6
Rtdarkcraft,ragnaros,575,priest,shadow,12,6,6
Drsonny,proudmoore,575,priest,shadow,12,6,6
Linarastia,blackrock,575,priest,shadow,12,6,6
Asmitä,stormrage,575,priest,shadow,18,6,12
Makade,sargeras,575,priest,shadow,18,6,12
Vøíd,sargeras,575,priest,shadow,18,6,12
Juícifer,illidan,575,priest,shadow,18,6,12
Mäe,nemesis,575,priest,shadow,18,6,12
Ðaddÿ,bleeding-hollow,574,priest,shadow,12,6,6
Duhk,moon-guard,574,priest,shadow,12,6,6
Xandir,kaelthas,574,priest,shadow,12,6,6
Halainpriest,undermine,574,priest,shadow,12,6,6
Papipreach,sargeras,574,priest,shadow,12,6,6
Dhader,area-52,574,priest,shadow,20,6,14
Lunypriest,azralon,574,priest,shadow,24,6,18
Machiomora,dunemaul,573,priest,shadow,12,6,6
Shadowpáin,ragnaros,573,priest,shadow,12,6,6
Midboss,illidan,572,priest,shadow,12,6,6
Jamashud,mannoroth,571,priest,shadow,12,6,6
Raelintha,kelthuzad,571,priest,shadow,15,7,8
Amazo,nemesis,570,priest,shadow,12,6,6
Shadowbishop,barthilas,570,priest,shadow,12,6,6
Daisydux,quelthalas,568,priest,shadow,10,7,3
Kkpriest,frostmourne,566,priest,shadow,12,6,6
Holysheht,icecrown,566,priest,shadow,12,6,6
Sarkozzlol,tichondrius,543,priest,shadow,8,7,1
Yourlife,baelgun,543,priest,shadow,11,6,5
Chapyh,malganis,543,priest,shadow,11,6,5
Anttila,ragnaros,543,priest,shadow,17,6,11
Holyfok,thrall,528,priest,shadow,11,7,4
Shadolord,illidan,527,priest,shadow,17,6,11
Sársaukis,illidan,527,priest,shadow,21,6,15
Totorostarp,tichondrius,521,priest,shadow,22,8,14
Ceoofvoid,moon-guard,511,priest,shadow,8,6,2
Pulpitò,ragnaros,511,priest,shadow,14,6,8
Hoshx,sargeras,496,priest,shadow,13,6,7
Batil,proudmoore,480,priest,shadow,6,5,1
Liloffended,sargeras,480,priest,shadow,6,5,1
Death,firetree,480,priest,shadow,6,5,1
Saucy,muradin,480,priest,shadow,6,5,1
Altera,drakkari,480,priest,shadow,6,5,1
Polarnight,zuljin,480,priest,shadow,6,5,1
Novasp,sargeras,480,priest,shadow,6,5,1
Tensorflow,tichondrius,480,priest,shadow,6,5,1
Megamind,elune,480,priest,shadow,6,5,1
Atheistbtw,sargeras,480,priest,shadow,6,5,1
Chervz,chogall,480,priest,shadow,6,5,1
Nawtyforever,tichondrius,480,priest,shadow,6,5,1
Komy,tichondrius,480,priest,shadow,6,5,1
Plaguepumper,sargeras,480,priest,shadow,6,5,1
Myòvó,tichondrius,480,priest,shadow,6,5,1
Tricklee,tichondrius,480,priest,shadow,6,5,1
Topg,icecrown,480,priest,shadow,6,5,1
Flynni,bleeding-hollow,480,priest,shadow,6,5,1
Likelydapper,tichondrius,480,priest,shadow,6,5,1
Fiéstah,illidan,480,priest,shadow,6,5,1
Jezebëll,nemesis,480,priest,shadow,6,5,1
Keynath,burning-blade,480,priest,shadow,6,5,1
Bigpenance,illidan,480,priest,shadow,6,5,1
Ãbelladanger,area-52,480,priest,shadow,6,5,1
Seanuts,emerald-dream,480,priest,shadow,6,5,1
Barroq,azralon,480,priest,shadow,12,5,7
Impur,zuljin,480,priest,shadow,12,5,7
Rätcömpx,bleeding-hollow,480,priest,shadow,12,5,7
Fatzzbtw,illidan,480,priest,shadow,12,5,7
Bunked,bleeding-hollow,480,priest,shadow,12,5,7
Hygeïa,lightbringer,480,priest,shadow,12,5,7
Jenastreaux,wyrmrest-accord,480,priest,shadow,12,5,7
Nås,elune,480,priest,shadow,12,5,7
Minnowhead,kelthuzad,480,priest,shadow,12,5,7
Dmlx,frostmourne,480,priest,shadow,12,5,7
Melaní,stormrage,480,priest,shadow,12,5,7
Senadori,azjolnerub,480,priest,shadow,12,5,7
Seraphims,moon-guard,480,priest,shadow,12,5,7
Taofang,wyrmrest-accord,480,priest,shadow,12,5,7
Shádôws,blackhand,480,priest,shadow,12,5,7
Mookelina,stormrage,480,priest,shadow,12,5,7
Eazye,shadowmoon,480,priest,shadow,12,5,7
Viroga,stormrage,480,priest,shadow,12,5,7
Clistyn,quelthalas,480,priest,shadow,12,5,7
Kabutta,stormrage,480,priest,shadow,12,5,7
Müyrica,ragnaros,480,priest,shadow,12,5,7
Onizukakeiji,hyjal,480,priest,shadow,12,5,7
Soulistic,arygos,480,priest,shadow,12,5,7
Burfdaycake,malganis,480,priest,shadow,12,5,7
Coutúre,illidan,480,priest,shadow,12,5,7
Sâltý,stormrage,480,priest,shadow,12,5,7
Littledog,velen,480,priest,shadow,12,5,7
Priestology,echo-isles,480,priest,shadow,12,5,7
Lucariö,area-52,480,priest,shadow,12,5,7
Ariellie,area-52,480,priest,shadow,12,5,7
Goblindruid,bleeding-hollow,480,priest,shadow,12,5,7
Ajonti,emerald-dream,480,priest,shadow,12,5,7
Orderic,ragnaros,480,priest,shadow,12,5,7
Moä,nemesis,480,priest,shadow,12,5,7
Flukex,tichondrius,480,priest,shadow,12,5,7
Bomanic,sargeras,480,priest,shadow,12,5,7
Saxyniknowit,nerzhul,480,priest,shadow,12,5,7
Faxingberlin,sargeras,480,priest,shadow,12,5,7
Sohalexs,tichondrius,480,priest,shadow,12,5,7
Optimism,frostmane,480,priest,shadow,12,5,7
Mdt,tichondrius,480,priest,shadow,12,5,7
Nogroupies,tichondrius,480,priest,shadow,12,5,7
Cryptron,tichondrius,480,priest,shadow,12,5,7
Mistweaver,tichondrius,480,priest,shadow,12,5,7
Everest,barthilas,480,priest,shadow,12,5,7
Zhangtanchi,moon-guard,480,priest,shadow,12,5,7
Zerohoür,emerald-dream,480,priest,shadow,16,6,10
Stillmatick,tichondrius,480,priest,shadow,16,6,10
Nedajoon,tichondrius,480,priest,shadow,17,6,11
Drakracs,doomhammer,480,priest,shadow,18,5,13
Spõt,stormrage,480,priest,shadow,18,5,13
Sybal,suramar,480,priest,shadow,19,5,14
Notahero,tichondrius,479,priest,shadow,6,5,1
Merlynaah,azralon,479,priest,shadow,6,5,1
Paradoxbot,kelthuzad,479,priest,shadow,6,5,1
Chiavenatto,quelthalas,479,priest,shadow,6,5,1
Wolfeclipse,sargeras,479,priest,shadow,12,5,7
Devî,magtheridon,479,priest,shadow,12,5,7
Synisteria,sargeras,479,priest,shadow,12,5,7
Knoxy,fizzcrank,479,priest,shadow,12,5,7
Rippmmr,frostmourne,479,priest,shadow,18,5,13
Brosbeforeho,tichondrius,479,priest,shadow,18,5,13
Malacanter,stormrage,479,priest,shadow,24,5,19
Noodloctopus,area-52,478,priest,shadow,10,6,4
Antiraus,aerie-peak,478,priest,shadow,12,5,7
Murtrudin,andorhal,478,priest,shadow,12,5,7
Playdohxz,frostmourne,463,priest,shadow,11,5,6
Estarì,proudmoore,463,priest,shadow,11,5,6
Thehern,tichondrius,463,priest,shadow,11,5,6
Wiiuwiiu,malganis,447,priest,shadow,11,5,6
Forober,queldorei,446,priest,shadow,10,6,4
Aerena,anvilmar,442,priest,shadow,21,7,14
Ryanrealz,tichondrius,432,priest,shadow,9,6,3
Veilozity,tichondrius,432,priest,shadow,15,5,10
Aquathicks,alexstrasza,431,priest,shadow,11,6,5
Sohalex,tichondrius,431,priest,shadow,11,5,6
Bernhard,azralon,431,priest,shadow,11,5,6
Shietamazon,tichondrius,426,priest,shadow,16,6,10
Garbagépg,zuljin,415,priest,shadow,8,5,3
Shaurana,stormrage,412,priest,shadow,18,6,12
Nizr,bleeding-hollow,399,priest,shadow,5,5,0
Devinere,tichondrius,384,priest,shadow,6,4,2
Zork,wildhammer,384,priest,shadow,6,4,2
Thänatós,quelthalas,384,priest,shadow,6,4,2
Jaysshadow,illidan,384,priest,shadow,6,4,2
Magiccoon,tichondrius,384,priest,shadow,6,4,2
Zulkmoon,ragnaros,384,priest,shadow,6,4,2
Mindflay,tichondrius,384,priest,shadow,6,4,2
Haedn,azralon,384,priest,shadow,6,4,2
Kks,tichondrius,384,priest,shadow,6,4,2
Gudóngmáe,tichondrius,384,priest,shadow,6,4,2
Footx,tichondrius,384,priest,shadow,6,4,2
Lgt,tichondrius,384,priest,shadow,6,4,2
Valtres,tichondrius,384,priest,shadow,6,4,2
Yuricksus,malganis,384,priest,shadow,6,4,2
Gojo,khadgar,384,priest,shadow,6,4,2
Genevieve,aggramar,384,priest,shadow,6,4,2
Prydas,tichondrius,384,priest,shadow,6,4,2
Marcusalan,emerald-dream,384,priest,shadow,6,4,2
Aladarian,tichondrius,384,priest,shadow,6,4,2
Judgejudyx,tichondrius,384,priest,shadow,6,4,2
Falsegöd,emerald-dream,384,priest,shadow,6,4,2
Tiinkerbell,moon-guard,384,priest,shadow,6,4,2
Inmøthep,ragnaros,384,priest,shadow,6,4,2
Træway,tichondrius,384,priest,shadow,6,4,2
Feminizm,tichondrius,384,priest,shadow,6,4,2
Piftw,illidan,384,priest,shadow,6,4,2
Iifa,medivh,384,priest,shadow,6,4,2
Prostrat,deathwing,384,priest,shadow,6,4,2
Balverix,tichondrius,384,priest,shadow,6,4,2
Notlowboy,area-52,384,priest,shadow,6,4,2
Capnjazz,illidan,384,priest,shadow,6,4,2
Mygameslaggy,area-52,384,priest,shadow,6,4,2
Quiglius,tichondrius,384,priest,shadow,6,4,2
Didittouchme,sargeras,384,priest,shadow,6,4,2
Unclecam,tichondrius,384,priest,shadow,6,4,2
Bramstein,jubeithos,384,priest,shadow,6,4,2
Næzha,thrall,384,priest,shadow,6,4,2
Fåtê,area-52,384,priest,shadow,6,4,2
Ferzhump,tichondrius,384,priest,shadow,6,4,2
Willibob,spirestone,384,priest,shadow,6,4,2
Comoli,tichondrius,384,priest,shadow,6,4,2
Rôss,tichondrius,384,priest,shadow,6,4,2
Kynyssaelz,proudmoore,384,priest,shadow,6,4,2
Choppery,laughing-skull,384,priest,shadow,6,4,2
Mäte,bleeding-hollow,384,priest,shadow,6,4,2
Káldorei,proudmoore,384,priest,shadow,6,4,2
Lovvely,drakkari,384,priest,shadow,6,4,2
Whitewindmil,tichondrius,384,priest,shadow,6,4,2
Rvxy,tichondrius,384,priest,shadow,6,4,2
Hèxxen,moon-guard,384,priest,shadow,6,4,2
Sungsh,zuljin,384,priest,shadow,6,4,2
Bigskill,proudmoore,384,priest,shadow,6,4,2
Trufumthunzi,illidan,384,priest,shadow,6,4,2
Rolettana,stormrage,384,priest,shadow,6,4,2
Mutedox,frostmourne,384,priest,shadow,6,4,2
Bax,kilrogg,384,priest,shadow,6,4,2
Dotznbubblez,zuljin,384,priest,shadow,6,4,2
Ikiteforhash,zuljin,384,priest,shadow,6,4,2
Tethy,saurfang,384,priest,shadow,6,4,2
Priestodan,frostmourne,384,priest,shadow,6,4,2
Dzikuss,aegwynn,384,priest,shadow,6,4,2
Shutkap,sargeras,384,priest,shadow,6,4,2
Urdaisyy,kelthuzad,384,priest,shadow,6,4,2
Itha,illidan,384,priest,shadow,6,4,2
Shieldspamx,tichondrius,384,priest,shadow,6,4,2
Ðrip,burning-legion,384,priest,shadow,6,4,2
Bigpurple,crushridge,384,priest,shadow,6,4,2
Nimabe,tichondrius,384,priest,shadow,6,4,2
Diskordia,stormrage,384,priest,shadow,6,4,2
Robertlee,stormrage,384,priest,shadow,6,4,2
Pootang,hyjal,384,priest,shadow,6,4,2
Cånnibäl,tichondrius,384,priest,shadow,6,4,2
Lenigrast,blackrock,384,priest,shadow,6,4,2
Killían,darkspear,384,priest,shadow,6,4,2
Shoelacey,sargeras,384,priest,shadow,6,4,2
Polygons,bronzebeard,384,priest,shadow,6,4,2
Äni,sargeras,384,priest,shadow,6,4,2
Moomoomilker,blackrock,384,priest,shadow,6,4,2
Liquidhorror,tichondrius,384,priest,shadow,7,4,3
Mfn,deathwing,384,priest,shadow,11,4,7
Oligan,quelthalas,384,priest,shadow,12,4,8
Holydrop,sargeras,384,priest,shadow,12,4,8
Vundead,tichondrius,384,priest,shadow,12,4,8
Junethegreat,tichondrius,384,priest,shadow,12,4,8
Heretoflay,tichondrius,384,priest,shadow,12,4,8
Dipidorko,proudmoore,384,priest,shadow,12,4,8
Mannyelf,ragnaros,384,priest,shadow,12,4,8
Fhelurian,quelthalas,384,priest,shadow,12,4,8
Fatäl,moon-guard,384,priest,shadow,12,4,8
Guillotine,azralon,384,priest,shadow,12,4,8
Nôtthehealer,sargeras,384,priest,shadow,12,4,8
Jinbo,frostmane,384,priest,shadow,12,4,8
Prescella,sargeras,384,priest,shadow,12,4,8
Zacksnotcool,sargeras,384,priest,shadow,12,4,8
Mïndgames,kelthuzad,384,priest,shadow,12,4,8
Jeezzmus,borean-tundra,384,priest,shadow,12,4,8
Grimmyreap,malygos,384,priest,shadow,12,4,8
Mìçah,fizzcrank,384,priest,shadow,12,4,8
Fnllen,blackrock,384,priest,shadow,12,4,8
Thalladori,area-52,384,priest,shadow,12,4,8
Eazydots,area-52,384,priest,shadow,12,4,8
Syncopy,azshara,384,priest,shadow,12,4,8
Chen,chogall,384,priest,shadow,12,4,8
Knowufearme,auchindoun,384,priest,shadow,12,4,8
Fáll,bleeding-hollow,384,priest,shadow,12,4,8
Vaeryl,stormrage,384,priest,shadow,12,4,8
Xebrios,zuljin,384,priest,shadow,12,4,8
Jikoguu,stormscale,384,priest,shadow,12,4,8
Shademán,stormrage,384,priest,shadow,12,4,8
Bigkey,malganis,384,priest,shadow,12,4,8
Eeffoc,zuljin,384,priest,shadow,12,4,8
Éx,alterac-mountains,384,priest,shadow,12,4,8
Çïöÿêüäüöàüê,stormrage,384,priest,shadow,12,4,8
Aexdawg,malganis,384,priest,shadow,12,4,8
Nèurósis,area-52,384,priest,shadow,12,4,8
Aerith,barthilas,384,priest,shadow,12,4,8
Vinatt,illidan,384,priest,shadow,12,4,8
Aliciari,illidan,384,priest,shadow,12,4,8
Brickzy,dalaran,384,priest,shadow,12,4,8
Deathbyhot,gorefiend,384,priest,shadow,12,4,8
Tokaru,frostmourne,384,priest,shadow,12,4,8
Dialis,frostmourne,384,priest,shadow,12,4,8
Jxkep,frostmourne,384,priest,shadow,12,4,8
Aliorixa,stormrage,384,priest,shadow,18,4,14
Skky,nagrand,383,priest,shadow,6,4,2
Thefiveoh,malganis,383,priest,shadow,6,4,2
Luísthian,quelthalas,383,priest,shadow,12,4,8
Holydork,sargeras,383,priest,shadow,12,4,8
Jammý,burning-legion,383,priest,shadow,12,4,8
Unfriend,sargeras,383,priest,shadow,12,4,8
Hermïs,stormrage,383,priest,shadow,12,4,8
Zyte,stormrage,383,priest,shadow,14,4,10
Nocappappy,tichondrius,383,priest,shadow,18,4,14
Leshlight,azuremyst,383,priest,shadow,24,4,20
Honeybunns,skywall,382,priest,shadow,6,4,2
Geulis,illidan,382,priest,shadow,12,4,8
Durgen,stormreaver,367,priest,shadow,17,4,13
Deathzpirit,kiljaeden,352,priest,shadow,10,4,6
Tünt,barthilas,335,priest,shadow,11,4,7
Bionix,stormrage,330,priest,shadow,11,5,6
Sgiath,alleria,330,priest,shadow,15,6,9
Libationz,area-52,329,priest,shadow,19,7,12
Arca,cenarion-circle,329,priest,shadow,24,5,19
Dtbündertree,nordrassil,319,priest,shadow,5,4,1
Babywetwipes,area-52,319,priest,shadow,5,4,1
Vaynnx,stormrage,319,priest,shadow,5,4,1
Xxmewo,sargeras,288,priest,shadow,6,3,3
Lemmecastpls,sargeras,288,priest,shadow,6,3,3
Xuxu,frostmourne,288,priest,shadow,6,3,3
Elitë,frostmourne,288,priest,shadow,6,3,3
Champ,norgannon,288,priest,shadow,6,3,3
Fiziixjr,darkspear,288,priest,shadow,6,3,3
Toxictampax,azjolnerub,288,priest,shadow,6,3,3
Chewit,kargath,288,priest,shadow,6,3,3
Persimmons,lightbringer,288,priest,shadow,6,3,3
Raptorjesùs,azjolnerub,288,priest,shadow,6,3,3
Reginaa,nemesis,288,priest,shadow,6,3,3
Monytrain,emerald-dream,288,priest,shadow,6,3,3
Limèria,emerald-dream,288,priest,shadow,6,3,3
Pepsí,kaelthas,288,priest,shadow,6,3,3
Foxu,frostmourne,288,priest,shadow,6,3,3
Linarindil,hyjal,288,priest,shadow,6,3,3
Stroserous,hyjal,288,priest,shadow,6,3,3
Lustily,zuljin,288,priest,shadow,6,3,3
Layyton,anvilmar,288,priest,shadow,6,3,3
Leya,kiljaeden,288,priest,shadow,6,3,3
Suki,alleria,288,priest,shadow,6,3,3
Holyhoward,moon-guard,288,priest,shadow,6,3,3
Strokkerzin,azralon,288,priest,shadow,6,3,3
Vorva,kiljaeden,288,priest,shadow,6,3,3
Mlkchocolate,kelthuzad,288,priest,shadow,6,3,3
Pheegawn,proudmoore,288,priest,shadow,6,3,3
Noanswerr,proudmoore,288,priest,shadow,6,3,3
Oongawa,sargeras,288,priest,shadow,6,3,3
Hypixyl,proudmoore,288,priest,shadow,6,3,3
Lucènt,frostmourne,288,priest,shadow,6,3,3
Sealife,kelthuzad,288,priest,shadow,6,3,3
Mynameis,dethecus,288,priest,shadow,6,3,3
Runakk,stonemaul,288,priest,shadow,6,3,3
Auras,boulderfist,288,priest,shadow,6,3,3
Polyxenus,moon-guard,288,priest,shadow,6,3,3
Cappoo,tichondrius,288,priest,shadow,6,3,3
Wrathhealer,hellscream,288,priest,shadow,6,3,3
Leyspring,moon-guard,288,priest,shadow,6,3,3
ßìrth,kelthuzad,288,priest,shadow,6,3,3
Quantumgoat,tichondrius,288,priest,shadow,6,3,3
Voidballs,tichondrius,288,priest,shadow,6,3,3
Brxddx,sargeras,288,priest,shadow,6,3,3
Bubblebuddí,tichondrius,288,priest,shadow,6,3,3
Sumrand,frostmourne,288,priest,shadow,6,3,3
Henrykane,azgalor,288,priest,shadow,6,3,3
Vullena,moon-guard,288,priest,shadow,6,3,3
Kinkypriest,tichondrius,288,priest,shadow,6,3,3
Egraner,drakkari,288,priest,shadow,6,3,3
Pengwu,moon-guard,288,priest,shadow,6,3,3
Menorsita,tichondrius,288,priest,shadow,6,3,3
Clearclouds,tichondrius,288,priest,shadow,6,3,3
Soloqqt,tichondrius,288,priest,shadow,6,3,3
Nécrofear,drakkari,288,priest,shadow,6,3,3
Squatchlace,tichondrius,288,priest,shadow,6,3,3
Osarin,sargeras,288,priest,shadow,6,3,3
Kíraki,stormrage,288,priest,shadow,6,3,3
Nuclease,turalyon,288,priest,shadow,6,3,3
Bubbleguppyx,tichondrius,288,priest,shadow,6,3,3
Nellìel,whisperwind,288,priest,shadow,6,3,3
Studpriest,tichondrius,288,priest,shadow,6,3,3
Randyortonn,tichondrius,288,priest,shadow,6,3,3
Shakarot,illidan,288,priest,shadow,6,3,3
Khallmir,goldrinn,288,priest,shadow,6,3,3
Ontherise,kelthuzad,288,priest,shadow,6,3,3
Ohmylaanta,stormrage,288,priest,shadow,6,3,3
Ascundead,tichondrius,288,priest,shadow,6,3,3
Banmi,tichondrius,288,priest,shadow,6,3,3
Ozzx,stormrage,288,priest,shadow,6,3,3
Moselol,tichondrius,288,priest,shadow,6,3,3
Pezziate,tichondrius,288,priest,shadow,6,3,3
Exploded,moon-guard,288,priest,shadow,6,3,3
Prosight,tichondrius,288,priest,shadow,6,3,3
Eddysmokes,tichondrius,288,priest,shadow,6,3,3
Drelia,jubeithos,288,priest,shadow,6,3,3
Wâtermelon,stormrage,288,priest,shadow,6,3,3
Halîth,terenas,288,priest,shadow,6,3,3
Gód,moonrunner,288,priest,shadow,6,3,3
Ej,altar-of-storms,288,priest,shadow,6,3,3
Pogchamp,alterac-mountains,288,priest,shadow,6,3,3
Dottiemcfee,alterac-mountains,288,priest,shadow,6,3,3
Reâpêr,kelthuzad,288,priest,shadow,6,3,3
ßoy,amanthul,288,priest,shadow,6,3,3
Crazchinkin,tichondrius,288,priest,shadow,6,3,3
Prignues,tichondrius,288,priest,shadow,6,3,3
Pgpriest,kelthuzad,288,priest,shadow,6,3,3
Whittysp,tichondrius,288,priest,shadow,6,3,3
Spspsp,illidan,288,priest,shadow,6,3,3
Forbiddance,bloodhoof,288,priest,shadow,6,3,3
Shadymac,sargeras,288,priest,shadow,6,3,3
Avadrah,tichondrius,288,priest,shadow,6,3,3
Ceebomb,tichondrius,288,priest,shadow,6,3,3
Issaley,tichondrius,288,priest,shadow,6,3,3
Nzuth,dalaran,288,priest,shadow,6,3,3
Gospels,tichondrius,288,priest,shadow,6,3,3
Worldhealer,area-52,288,priest,shadow,6,3,3
Mhorkarion,quelthalas,288,priest,shadow,6,3,3
Intheway,bleeding-hollow,288,priest,shadow,6,3,3
Empyreanlite,dalaran,288,priest,shadow,6,3,3
ßellaßellz,tichondrius,288,priest,shadow,6,3,3
Amanopriest,illidan,288,priest,shadow,6,3,3
Healiûm,bleeding-hollow,288,priest,shadow,6,3,3
Lucydrop,area-52,288,priest,shadow,6,3,3
Earebus,dalaran,288,priest,shadow,6,3,3
Samio,area-52,288,priest,shadow,6,3,3
Caiitlynn,quelthalas,288,priest,shadow,6,3,3
Jol,aggramar,288,priest,shadow,6,3,3
Sìkarìa,illidan,288,priest,shadow,6,3,3
Kirarii,ragnaros,288,priest,shadow,6,3,3
Vizzo,azralon,288,priest,shadow,6,3,3
Ohsop,chogall,288,priest,shadow,6,3,3
Scaadoosh,dalaran,288,priest,shadow,6,3,3
Kindyx,ragnaros,288,priest,shadow,6,3,3
Russbell,ragnaros,288,priest,shadow,6,3,3
Mallox,quelthalas,288,priest,shadow,6,3,3
Aliciab,andorhal,288,priest,shadow,6,3,3
Slickbakk,illidan,288,priest,shadow,6,3,3
Whalexo,kelthuzad,288,priest,shadow,6,3,3
Austul,guldan,288,priest,shadow,6,3,3
Dumbboxx,emerald-dream,288,priest,shadow,6,3,3
Adelen,illidan,288,priest,shadow,6,3,3
Döllyy,illidan,288,priest,shadow,6,3,3
Bubblebeasst,area-52,288,priest,shadow,6,3,3
Lolsodacans,malganis,288,priest,shadow,6,3,3
Jaliera,malganis,288,priest,shadow,6,3,3
Etherrion,area-52,288,priest,shadow,6,3,3
Compactdisc,gundrak,288,priest,shadow,6,3,3
Therev,malganis,288,priest,shadow,6,3,3
Shaðows,malganis,288,priest,shadow,6,3,3
Haransimongo,area-52,288,priest,shadow,6,3,3
Nizanz,illidan,288,priest,shadow,6,3,3
Judeath,area-52,288,priest,shadow,6,3,3
Oxxymoron,malganis,288,priest,shadow,6,3,3
Onahaihu,tichondrius,288,priest,shadow,9,4,5
Epithet,moon-guard,288,priest,shadow,9,4,5
Xeras,ravencrest,288,priest,shadow,12,3,9
Giantqid,malganis,288,priest,shadow,12,3,9
Airn,tichondrius,288,priest,shadow,12,3,9
Dunnbledore,area-52,288,priest,shadow,12,3,9
Farnzz,malganis,288,priest,shadow,12,3,9
Poppyp,stormrage,288,priest,shadow,12,3,9
Shadøwbølt,tichondrius,288,priest,shadow,12,3,9
Maraquinn,bleeding-hollow,288,priest,shadow,12,3,9
Stantz,burning-legion,288,priest,shadow,12,3,9
Shadowpain,the-underbog,288,priest,shadow,12,3,9
Mistmare,dalaran,288,priest,shadow,12,3,9
Devøid,thrall,288,priest,shadow,12,3,9
Sybenela,proudmoore,288,priest,shadow,12,3,9
Demonllama,duskwood,288,priest,shadow,12,3,9
Valuations,tichondrius,288,priest,shadow,12,3,9
Tastyloads,illidan,288,priest,shadow,12,3,9
Jylertason,kelthuzad,288,priest,shadow,12,3,9
Scaryspise,nathrezim,288,priest,shadow,12,3,9
Mandisa,skywall,288,priest,shadow,12,3,9
Aphôtic,moon-guard,288,priest,shadow,18,3,15
Cultists,tichondrius,288,priest,shadow,18,3,15
Twistedbunny,zuljin,287,priest,shadow,6,3,3
Grímmz,veknilash,287,priest,shadow,7,3,4
Telamorstus,illidan,287,priest,shadow,12,3,9
Kyriana,doomhammer,287,priest,shadow,18,3,15
Drzz,tichondrius,256,priest,shadow,4,4,0
Davidx,tichondrius,255,priest,shadow,6,4,2
Izoth,tichondrius,239,priest,shadow,5,3,2
Nmm,ravencrest,239,priest,shadow,5,3,2
Youcute,norgannon,239,priest,shadow,5,3,2
Nuggetree,tichondrius,239,priest,shadow,5,3,2
Shadowpope,azralon,239,priest,shadow,5,3,2
Kikkomán,tichondrius,239,priest,shadow,11,3,8
Mindrip,illidan,234,priest,shadow,6,4,2
Risedead,azralon,234,priest,shadow,10,4,6
Beeffdaddy,tichondrius,223,priest,shadow,8,3,5
Actiop,stormrage,223,priest,shadow,8,3,5
Donkeycube,tichondrius,192,priest,shadow,4,3,1
Holyhand,auchindoun,192,priest,shadow,4,3,1
Suppòrt,stormrage,192,priest,shadow,4,3,1
Shadowblax,thrall,192,priest,shadow,4,3,1
Vladsacer,nemesis,192,priest,shadow,9,3,6
Jjaeminkim,area-52,192,priest,shadow,6,2,4
Apâthy,area-52,192,priest,shadow,6,2,4
Pugsmugglerr,icecrown,192,priest,shadow,6,2,4
Zarkos,area-52,192,priest,shadow,6,2,4
Detainedz,malganis,192,priest,shadow,6,2,4
Horsegirls,kelthuzad,192,priest,shadow,6,2,4
Cxmplex,malganis,192,priest,shadow,6,2,4
Fleshliight,area-52,192,priest,shadow,6,2,4
Massivepuss,illidan,192,priest,shadow,6,2,4
Projectalice,ravencrest,192,priest,shadow,6,2,4
Anxìetý,area-52,192,priest,shadow,6,2,4
Onlyphantoms,kelthuzad,192,priest,shadow,6,2,4
Edhelin,illidan,192,priest,shadow,6,2,4
Reckless,kirin-tor,192,priest,shadow,6,2,4
Psychohazard,area-52,192,priest,shadow,6,2,4
Kryoff,illidan,192,priest,shadow,6,2,4
Moonshoes,tichondrius,192,priest,shadow,6,2,4
Fatherleem,tichondrius,192,priest,shadow,6,2,4
Sungai,thrall,192,priest,shadow,6,2,4
Voidnoodles,area-52,192,priest,shadow,6,2,4
Fatfinger,stormrage,192,priest,shadow,6,2,4
Clairvoyantt,tichondrius,192,priest,shadow,6,2,4
Obscuriôn,moon-guard,192,priest,shadow,6,2,4
Byungsik,terenas,192,priest,shadow,6,2,4
Nodorme,quelthalas,192,priest,shadow,6,2,4
Voidwyrm,tichondrius,192,priest,shadow,6,2,4
Auntiegrimm,silvermoon,192,priest,shadow,6,2,4
Lemmiewinkzx,sargeras,192,priest,shadow,6,2,4
Lifejuice,tichondrius,192,priest,shadow,6,2,4
Biggina,vashj,192,priest,shadow,6,2,4
Kälashnikova,ragnaros,192,priest,shadow,6,2,4
Juliusceazer,skywall,192,priest,shadow,6,2,4
Murkqz,azralon,192,priest,shadow,6,2,4
Fadeoff,tichondrius,192,priest,shadow,6,2,4
Pandiwoodney,ragnaros,192,priest,shadow,6,2,4
Unholywood,lightbringer,192,priest,shadow,6,2,4
Spacepaq,bleeding-hollow,192,priest,shadow,6,2,4
Melithor,frostmourne,192,priest,shadow,6,2,4
Clickbait,spirestone,192,priest,shadow,6,2,4
Kapriestsun,sargeras,192,priest,shadow,6,2,4
Notgoodatsp,bleeding-hollow,192,priest,shadow,6,2,4
Layons,nemesis,192,priest,shadow,6,2,4
Fraggydaddy,frostmourne,192,priest,shadow,6,2,4
Furryoflife,suramar,192,priest,shadow,6,2,4
Brounly,drakkari,192,priest,shadow,6,2,4
Spøokz,stormreaver,192,priest,shadow,6,2,4
Midget,darkspear,192,priest,shadow,6,2,4
Hootz,arygos,192,priest,shadow,6,2,4
Dotdotdead,earthen-ring,192,priest,shadow,6,2,4
Kalibaby,darkspear,192,priest,shadow,6,2,4
Dagaen,thunderlord,192,priest,shadow,6,2,4
Zombiejeesus,sargeras,192,priest,shadow,6,2,4
Thewizard,blackrock,192,priest,shadow,6,2,4
Nynaeve,emerald-dream,192,priest,shadow,6,2,4
Félurian,frostmourne,192,priest,shadow,6,2,4
Mentalprism,khazgoroth,192,priest,shadow,6,2,4
Ateras,emerald-dream,192,priest,shadow,6,2,4
Theono,sargeras,192,priest,shadow,6,2,4
Freibs,tichondrius,192,priest,shadow,6,2,4
Sorojín,zuljin,192,priest,shadow,6,2,4
Kahine,thaurissan,192,priest,shadow,6,2,4
Avanise,blackrock,192,priest,shadow,6,2,4
Shadoword,moon-guard,192,priest,shadow,6,2,4
Innergee,aegwynn,192,priest,shadow,6,2,4
Optt,zuljin,192,priest,shadow,6,2,4
Shanshan,bladefist,192,priest,shadow,6,2,4
Hrathren,caelestrasz,192,priest,shadow,6,2,4
Xyanydê,zuljin,192,priest,shadow,6,2,4
Lolsithlord,tichondrius,192,priest,shadow,6,2,4
Laq,proudmoore,192,priest,shadow,6,2,4
Purrpleelff,saurfang,192,priest,shadow,6,2,4
Thaldrum,tichondrius,192,priest,shadow,6,2,4
Chellelia,stormrage,192,priest,shadow,6,2,4
Lyontnmetal,moon-guard,192,priest,shadow,6,2,4
Enochian,hyjal,192,priest,shadow,6,2,4
Pipete,frostmourne,192,priest,shadow,6,2,4
Dippyzs,alterac-mountains,192,priest,shadow,6,2,4
Beertriarch,frostmourne,192,priest,shadow,6,2,4
Dogfrompark,illidan,192,priest,shadow,6,2,4
Azshauna,hyjal,192,priest,shadow,6,2,4
Hail,kaelthas,192,priest,shadow,6,2,4
Nicksfury,stormrage,192,priest,shadow,6,2,4
Apparìtions,khazgoroth,192,priest,shadow,6,2,4
Hgbvljag,proudmoore,192,priest,shadow,6,2,4
Jatral,azralon,192,priest,shadow,6,2,4
Sshhaaddooww,tichondrius,192,priest,shadow,6,2,4
Fadestepx,stormrage,192,priest,shadow,6,2,4
Alukel,moon-guard,192,priest,shadow,6,2,4
Judis,barthilas,192,priest,shadow,6,2,4
Deprive,tichondrius,192,priest,shadow,6,2,4
Aape,frostmourne,192,priest,shadow,6,2,4
Priést,stormrage,192,priest,shadow,6,2,4
Quinnx,tichondrius,192,priest,shadow,6,2,4
Offwhit,azralon,192,priest,shadow,6,2,4
Meehow,lightninghoof,192,priest,shadow,6,2,4
Teetams,sargeras,192,priest,shadow,6,2,4
Sashatwo,proudmoore,192,priest,shadow,6,2,4
Geoat,barthilas,192,priest,shadow,6,2,4
Löstský,azralon,192,priest,shadow,6,2,4
Sâishâ,proudmoore,192,priest,shadow,6,2,4
Slowbreeze,sargeras,192,priest,shadow,6,2,4
Ptheld,tichondrius,192,priest,shadow,6,2,4
Vanzera,thrall,192,priest,shadow,6,2,4
Orethon,thrall,192,priest,shadow,6,2,4
Selspriest,kelthuzad,192,priest,shadow,6,2,4
Caristae,kelthuzad,192,priest,shadow,12,2,10
Kulrig,shuhalo,192,priest,shadow,12,2,10
Jimmyjangle,kelthuzad,192,priest,shadow,12,2,10
Killuminati,hyjal,192,priest,shadow,12,2,10
Painful,arathor,192,priest,shadow,12,2,10
Dalyeth,blackrock,192,priest,shadow,12,2,10
Alizhe,ragnaros,192,priest,shadow,12,2,10
Karamapang,illidan,192,priest,shadow,12,2,10
Belfalst,shandris,192,priest,shadow,12,2,10
Kodaks,frostmourne,192,priest,shadow,12,2,10
Ozztwo,tichondrius,192,priest,shadow,12,2,10
Murdangus,moon-guard,192,priest,shadow,18,2,16
Mythica,gurubashi,191,priest,shadow,6,2,4
Tmpriest,tichondrius,175,priest,shadow,11,2,9
Dawnbréaker,azralon,175,priest,shadow,11,2,9
Chü,dalaran,169,priest,shadow,12,5,7
Nychka,kelthuzad,160,priest,shadow,10,2,8
Lilpurp,sargeras,159,priest,shadow,5,2,3
Tlolopolopo,quelthalas,159,priest,shadow,5,2,3
Gobananas,bleeding-hollow,159,priest,shadow,5,2,3
Tiizz,malganis,159,priest,shadow,5,2,3
Juckerr,tichondrius,159,priest,shadow,5,2,3
Pugadin,bleeding-hollow,159,priest,shadow,5,2,3
Myndz,stormrage,159,priest,shadow,5,2,3
Dekomori,quelthalas,159,priest,shadow,5,2,3
Xeevoos,nemesis,159,priest,shadow,5,2,3
Gaeira,azralon,159,priest,shadow,11,2,9
Dingldangle,tichondrius,128,priest,shadow,4,2,2
Cravex,stormrage,128,priest,shadow,4,2,2
Melbourn,kalecgos,112,priest,shadow,7,2,5
Sätîvá,tichondrius,96,priest,shadow,3,2,1
Priestthingz,area-52,96,priest,shadow,8,2,6
Fámóus,stormrage,96,priest,shadow,6,1,5
Kalzu,tichondrius,96,priest,shadow,6,1,5
Powerwordkfc,kelthuzad,96,priest,shadow,6,1,5
Slspookyx,tichondrius,96,priest,shadow,6,1,5
Mental,deathwing,96,priest,shadow,6,1,5
Cáscá,stormrage,96,priest,shadow,6,1,5
Sterther,stormrage,96,priest,shadow,6,1,5
Dravi,azuremyst,96,priest,shadow,6,1,5
Nightboxer,tichondrius,96,priest,shadow,6,1,5
Syrillia,wildhammer,96,priest,shadow,6,1,5
Vyndictus,shattered-hand,96,priest,shadow,6,1,5
Rezzerection,gorefiend,96,priest,shadow,6,1,5
Sadury,tichondrius,96,priest,shadow,6,1,5
Galestick,illidan,96,priest,shadow,6,1,5
Amenbrother,proudmoore,96,priest,shadow,6,1,5
Lukaspriest,proudmoore,96,priest,shadow,6,1,5
Wallywanker,illidan,96,priest,shadow,6,1,5
Cärdi,frostmourne,96,priest,shadow,6,1,5
Theboss,gorefiend,96,priest,shadow,6,1,5
Peterlongrod,malganis,96,priest,shadow,6,1,5
Nostrande,stormrage,96,priest,shadow,6,1,5
Jaquels,area-52,96,priest,shadow,6,1,5
Syrul,tichondrius,96,priest,shadow,6,1,5
Lightxp,illidan,96,priest,shadow,6,1,5
Mauriel,proudmoore,96,priest,shadow,6,1,5
Manryu,tichondrius,96,priest,shadow,6,1,5
Vdip,illidan,96,priest,shadow,6,1,5
Baerybonds,kiljaeden,96,priest,shadow,6,1,5
Psyward,tichondrius,96,priest,shadow,6,1,5
Marleylei,nesingwary,96,priest,shadow,6,1,5
Amikam,barthilas,96,priest,shadow,6,1,5
Stunsilence,tichondrius,96,priest,shadow,6,1,5
Shadowreck,malganis,96,priest,shadow,6,1,5
Tusket,black-dragonflight,96,priest,shadow,6,1,5
Powerwordwap,malganis,96,priest,shadow,6,1,5
Pmpn,tichondrius,96,priest,shadow,6,1,5
Bailez,malganis,96,priest,shadow,6,1,5
Dazzlems,tichondrius,96,priest,shadow,6,1,5
Digop,azralon,96,priest,shadow,6,1,5
Prayussy,tichondrius,96,priest,shadow,6,1,5
Icespice,anvilmar,96,priest,shadow,6,1,5
Drdragonlee,illidan,96,priest,shadow,6,1,5
Dadsalad,zuljin,96,priest,shadow,6,1,5
Shadowftw,illidan,96,priest,shadow,6,1,5
Bigdaddios,dalaran,96,priest,shadow,6,1,5
Unclefelix,rexxar,96,priest,shadow,6,1,5
Torturex,zuljin,96,priest,shadow,6,1,5
Voidzx,tichondrius,96,priest,shadow,6,1,5
Milliyakk,area-52,96,priest,shadow,6,1,5
Kelody,zuljin,96,priest,shadow,6,1,5
Whatsittoya,tichondrius,96,priest,shadow,6,1,5
Óst,tichondrius,96,priest,shadow,6,1,5
Althlon,emerald-dream,96,priest,shadow,6,1,5
Quadrela,baelgun,96,priest,shadow,6,1,5
Lilskizz,dalaran,96,priest,shadow,6,1,5
Nancynibbler,bleeding-hollow,96,priest,shadow,6,1,5
Mangemoélqc,darkspear,96,priest,shadow,6,1,5
Paingivër,drakkari,96,priest,shadow,6,1,5
Rays,drakkari,96,priest,shadow,6,1,5
Oxyy,aerie-peak,96,priest,shadow,6,1,5
Zhanay,ragnaros,96,priest,shadow,6,1,5
Dwarfxomp,ragnaros,96,priest,shadow,6,1,5
Squekp,laughing-skull,96,priest,shadow,6,1,5
Poilu,laughing-skull,96,priest,shadow,6,1,5
Vineller,malganis,96,priest,shadow,6,1,5
Iyanne,nemesis,96,priest,shadow,6,1,5
Ibangedaqt,malganis,96,priest,shadow,6,1,5
Melisandray,illidan,96,priest,shadow,6,1,5
Sprinkling,sargeras,96,priest,shadow,6,1,5
Tiskka,magtheridon,96,priest,shadow,6,1,5
Leliane,tichondrius,96,priest,shadow,6,1,5
Jèf,stormrage,96,priest,shadow,6,1,5
Zymmie,moon-guard,96,priest,shadow,6,1,5
Drippyjoones,sargeras,96,priest,shadow,6,1,5
Sjah,whisperwind,96,priest,shadow,6,1,5
Voidlordx,jubeithos,96,priest,shadow,6,1,5
Zway,moon-guard,96,priest,shadow,6,1,5
Allaras,eldrethalas,96,priest,shadow,6,1,5
Onlysams,sargeras,96,priest,shadow,6,1,5
Chreistana,sargeras,96,priest,shadow,6,1,5
Releknosleep,frostwolf,96,priest,shadow,6,1,5
Yaelahi,illidan,96,priest,shadow,11,1,10
Xïlencer,tichondrius,96,priest,shadow,12,1,11
Tallary,azralon,96,priest,shadow,12,1,11
Zenorik,thrall,96,priest,shadow,12,1,11
Jpray,bleeding-hollow,96,priest,shadow,12,1,11
Kellandis,jubeithos,96,priest,shadow,12,1,11
ßugsy,illidan,96,priest,shadow,12,1,11
Kunof,ragnaros,79,priest,shadow,5,1,4
Xic,thrall,79,priest,shadow,5,1,4
Cervasa,bleeding-hollow,63,priest,shadow,2,2,0
Joktips,proudmoore,48,priest,shadow,3,1,2
Richard,doomhammer,48,priest,shadow,3,1,2
Fadehojx,illidan,42,priest,shadow,9,2,7
Turelim,illidan,31,priest,shadow,2,1,1
Trågédy,azjolnerub,16,priest,shadow,1,1,0
Pilixil,bleeding-hollow,16,priest,shadow,1,1,0
Yellowrose,kelthuzad,2108,rogue,outlaw,121,69,52
Weran,tichondrius,1976,rogue,outlaw,66,34,32
Sadiator,illidan,1876,rogue,outlaw,65,36,29
Dvn,stormrage,1844,rogue,outlaw,54,32,22
Millspec,zuljin,1840,rogue,outlaw,54,33,21
Supherr,sargeras,1806,rogue,outlaw,95,54,41
Onethiccboi,tichondrius,1796,rogue,outlaw,78,41,37
Millspec,tichondrius,1762,rogue,outlaw,117,58,59
Welinth,thunderlord,1754,rogue,outlaw,450,228,222
Gothamzzing,tichondrius,1738,rogue,outlaw,49,28,21
Xylvána,kiljaeden,1726,rogue,outlaw,127,64,63
Dennerdz,tichondrius,1688,rogue,outlaw,47,19,28
Fryphilip,dalaran,1676,rogue,outlaw,64,29,35
Redimído,quelthalas,1674,rogue,outlaw,56,28,28
Lycanthropî,illidan,1655,rogue,outlaw,80,37,43
Arena,uldum,1631,rogue,outlaw,141,67,74
Lardiconn,thrall,1628,rogue,outlaw,42,30,12
Deadracer,moon-guard,1627,rogue,outlaw,60,32,28
Lazeestab,sargeras,1618,rogue,outlaw,172,95,77
Càgil,stormrage,1607,rogue,outlaw,34,19,15
Jmaxx,wyrmrest-accord,1603,rogue,outlaw,51,32,19
Gnover,ragnaros,1585,rogue,outlaw,88,45,43
Dogeggs,area-52,1578,rogue,outlaw,54,25,29
Corevis,moon-guard,1562,rogue,outlaw,60,28,32
Trêl,velen,1540,rogue,outlaw,159,81,78
Supine,illidan,1539,rogue,outlaw,109,58,51
Asdestroyerr,tichondrius,1526,rogue,outlaw,38,18,20
Skaven,dunemaul,1525,rogue,outlaw,32,19,13
Omnïslash,stormrage,1519,rogue,outlaw,54,25,29
Kentaki,tichondrius,1515,rogue,outlaw,60,33,27
Houlton,moon-guard,1512,rogue,outlaw,42,22,20
Swingonya,stormrage,1508,rogue,outlaw,48,20,28
Karambit,frostmourne,1486,rogue,outlaw,120,54,66
Trillkage,tichondrius,1483,rogue,outlaw,90,44,46
Mgzx,tichondrius,1475,rogue,outlaw,183,99,84
Heliopolis,bleeding-hollow,1465,rogue,outlaw,36,17,19
Mõtaru,stormrage,1449,rogue,outlaw,66,33,33
Jenaki,gurubashi,1442,rogue,outlaw,62,32,30
Combo,norgannon,1438,rogue,outlaw,173,96,77
Squigglies,aerie-peak,1436,rogue,outlaw,53,28,25
Mirâge,illidan,1432,rogue,outlaw,61,30,31
Velskud,area-52,1430,rogue,outlaw,82,41,41
Gotosor,quelthalas,1415,rogue,outlaw,144,73,71
Jolly,frostmourne,1413,rogue,outlaw,71,30,41
Fastblast,wyrmrest-accord,1411,rogue,outlaw,30,15,15
Shadowstryfe,tichondrius,1409,rogue,outlaw,47,22,25
Snakeblisken,emerald-dream,1401,rogue,outlaw,42,17,25
Shindeiru,area-52,1399,rogue,outlaw,43,30,13
Disrawen,ragnaros,1392,rogue,outlaw,509,249,260
Luolan,kargath,1378,rogue,outlaw,44,16,28
Blackmont,bleeding-hollow,1368,rogue,outlaw,204,104,100
Itsuksiko,quelthalas,1368,rogue,outlaw,63,30,33
Jakamungo,area-52,1329,rogue,outlaw,52,26,26
Slitherex,thunderlord,1327,rogue,outlaw,57,31,26
Dross,shadowmoon,1325,rogue,outlaw,30,14,16
Chrisdorner,area-52,1316,rogue,outlaw,25,14,11
Cidi,moon-guard,1315,rogue,outlaw,68,27,41
Hobblefoot,proudmoore,1314,rogue,outlaw,64,32,32
Bleaklord,emerald-dream,1305,rogue,outlaw,115,48,67
Reyskywalker,kelthuzad,1303,rogue,outlaw,24,15,9
Shyzuku,drakkari,1303,rogue,outlaw,44,20,24
Sandorrogue,stormrage,1267,rogue,outlaw,28,14,14
Ntrfighter,tichondrius,1258,rogue,outlaw,71,36,35
Cheddery,dalaran,1247,rogue,outlaw,92,49,43
Straite,area-52,1244,rogue,outlaw,24,13,11
Aitreena,stormrage,1210,rogue,outlaw,24,13,11
Walyo,stormrage,1210,rogue,outlaw,28,14,14
Johnnyelbows,tichondrius,1197,rogue,outlaw,39,20,19
Zanith,wyrmrest-accord,1194,rogue,outlaw,28,15,13
Wátchyoúrbák,wyrmrest-accord,1194,rogue,outlaw,48,18,30
Lovedemtings,dark-iron,1191,rogue,outlaw,28,13,15
Mechamind,draka,1187,rogue,outlaw,24,15,9
Rynica,illidan,1151,rogue,outlaw,53,27,26
Peteylee,stormrage,1150,rogue,outlaw,24,12,12
Emoond,ragnaros,1137,rogue,outlaw,51,29,22
Mabushi,sargeras,1135,rogue,outlaw,42,15,27
Amorfirion,frostmourne,1131,rogue,outlaw,30,14,16
Zogbu,stormrage,1128,rogue,outlaw,42,17,25
Adevoir,hakkar,1126,rogue,outlaw,84,44,40
Geratyere,trollbane,1112,rogue,outlaw,32,14,18
Vanorn,aerie-peak,1109,rogue,outlaw,60,20,40
Itricku,tichondrius,1093,rogue,outlaw,60,23,37
Vilthoon,sargeras,1092,rogue,outlaw,48,20,28
Zarthrox,bladefist,1086,rogue,outlaw,48,24,24
Bonizzi,stormrage,1085,rogue,outlaw,24,13,11
Abatoire,wyrmrest-accord,1083,rogue,outlaw,87,44,43
Valefarr,emerald-dream,1075,rogue,outlaw,65,32,33
Azarha,zuljin,1060,rogue,outlaw,66,34,32
Hezi,area-52,1056,rogue,outlaw,24,11,13
Tanadoril,wyrmrest-accord,1051,rogue,outlaw,24,11,13
Wujn,tichondrius,1050,rogue,outlaw,24,11,13
Lumifer,quelthalas,1050,rogue,outlaw,54,18,36
Xyleth,azgalor,1048,rogue,outlaw,53,20,33
Cathat,area-52,1047,rogue,outlaw,24,11,13
Thèory,sargeras,1044,rogue,outlaw,24,11,13
Badpatatas,proudmoore,1043,rogue,outlaw,52,15,37
Nicademos,bleeding-hollow,1037,rogue,outlaw,18,11,7
Lawyergamer,bonechewer,1027,rogue,outlaw,50,23,27
Thuganomics,dark-iron,1008,rogue,outlaw,27,12,15
Farstrider,tichondrius,974,rogue,outlaw,84,33,51
Hokagesasuke,bleeding-hollow,972,rogue,outlaw,36,14,22
Listrew,stormrage,970,rogue,outlaw,24,12,12
Larmx,tichondrius,960,rogue,outlaw,24,10,14
Inhume,eredar,960,rogue,outlaw,24,10,14
Quapi,tichondrius,959,rogue,outlaw,18,10,8
Preceptor,azralon,956,rogue,outlaw,24,10,14
Nitroxy,quelthalas,950,rogue,outlaw,24,10,14
Stabbymcgee,duskwood,941,rogue,outlaw,24,11,13
Tootled,wyrmrest-accord,917,rogue,outlaw,25,14,11
Shninzy,senjin,910,rogue,outlaw,31,11,20
Pigshank,proudmoore,906,rogue,outlaw,18,10,8
Zeed,ragnaros,866,rogue,outlaw,66,30,36
Steviekìcks,frostmourne,864,rogue,outlaw,24,9,15
Donstevano,frostmourne,864,rogue,outlaw,24,9,15
Stabbythorus,stormrage,862,rogue,outlaw,18,9,9
Gour,ragnaros,861,rogue,outlaw,24,9,15
Bebesita,sisters-of-elune,860,rogue,outlaw,18,9,9
Phraze,silvermoon,859,rogue,outlaw,30,14,16
Vîllâîn,tichondrius,859,rogue,outlaw,24,9,15
Yerehmi,quelthalas,852,rogue,outlaw,18,10,8
Evilkoreanz,tichondrius,851,rogue,outlaw,18,9,9
Ningaturtle,korgath,844,rogue,outlaw,48,19,29
Gfuel,azgalor,827,rogue,outlaw,22,9,13
Fennick,tanaris,823,rogue,outlaw,37,9,28
Elitejigsaw,perenolde,822,rogue,outlaw,24,9,15
Sabbathe,kargath,817,rogue,outlaw,26,10,16
Coalie,tichondrius,816,rogue,outlaw,15,9,6
Synj,frostmourne,798,rogue,outlaw,14,9,5
Mhdz,tichondrius,789,rogue,outlaw,24,10,14
Cireene,proudmoore,768,rogue,outlaw,12,8,4
Lesty,kelthuzad,768,rogue,outlaw,12,8,4
Upcrazylol,area-52,768,rogue,outlaw,12,8,4
Yodiegang,tichondrius,768,rogue,outlaw,12,8,4
Deepsyo,frostmourne,768,rogue,outlaw,12,8,4
Airi,darkspear,768,rogue,outlaw,18,8,10
Tarnished,ravenholdt,766,rogue,outlaw,24,8,16
Nvirus,quelthalas,765,rogue,outlaw,18,8,10
Shmoked,moon-guard,763,rogue,outlaw,24,8,16
Sasskei,malganis,760,rogue,outlaw,18,8,10
Nordedge,stormrage,756,rogue,outlaw,24,8,16
Marraya,area-52,750,rogue,outlaw,18,8,10
Zeetwntyeght,stormrage,747,rogue,outlaw,35,8,27
Gnòme,frostmourne,701,rogue,outlaw,11,8,3
Alexdelion,tichondrius,672,rogue,outlaw,12,7,5
Thompson,bloodscalp,672,rogue,outlaw,12,7,5
Tëmpestas,quelthalas,672,rogue,outlaw,12,7,5
Invisidubya,illidan,671,rogue,outlaw,12,7,5
Minuss,rivendare,671,rogue,outlaw,12,7,5
Slowtime,quelthalas,671,rogue,outlaw,18,7,11
Drsinz,tichondrius,671,rogue,outlaw,18,7,11
Cosmicò,trollbane,670,rogue,outlaw,12,7,5
Lacero,bonechewer,670,rogue,outlaw,12,7,5
Uzell,sargeras,670,rogue,outlaw,12,7,5
Jamesallen,silvermoon,659,rogue,outlaw,12,7,5
Adrala,thunderlord,657,rogue,outlaw,12,7,5
Furrykneecap,hyjal,655,rogue,outlaw,12,9,3
Roxy,ghostlands,623,rogue,outlaw,17,7,10
Esky,tichondrius,576,rogue,outlaw,12,6,6
Deeppockets,sargeras,576,rogue,outlaw,12,6,6
Xylvana,kiljaeden,576,rogue,outlaw,12,6,6
Riprorin,stormrage,576,rogue,outlaw,18,6,12
Dalaranxp,illidan,576,rogue,outlaw,18,6,12
Drakariano,ragnaros,575,rogue,outlaw,18,6,12
Sprork,kiljaeden,575,rogue,outlaw,18,6,12
Deddyy,zuljin,574,rogue,outlaw,18,6,12
Maglove,nemesis,571,rogue,outlaw,12,6,6
Gheez,quelthalas,570,rogue,outlaw,12,6,6
Chapex,ragnaros,511,rogue,outlaw,14,6,8
Sotypical,area-52,480,rogue,outlaw,6,5,1
Tsubamë,tichondrius,480,rogue,outlaw,6,5,1
Tmpikaboo,tichondrius,480,rogue,outlaw,6,5,1
Eatcheese,sargeras,480,rogue,outlaw,12,5,7
Sekkelx,moon-guard,480,rogue,outlaw,12,5,7
Dultz,tichondrius,480,rogue,outlaw,12,5,7
Galfuran,burning-legion,480,rogue,outlaw,12,5,7
Bootypie,hyjal,480,rogue,outlaw,12,5,7
Hachiwari,moon-guard,480,rogue,outlaw,12,5,7
Loktark,stormreaver,480,rogue,outlaw,12,5,7
Matheuzaum,goldrinn,480,rogue,outlaw,12,5,7
Alexyy,blades-edge,480,rogue,outlaw,12,5,7
Dicenslice,proudmoore,480,rogue,outlaw,12,5,7
Evaru,tichondrius,480,rogue,outlaw,12,5,7
Violetrose,kelthuzad,480,rogue,outlaw,12,5,7
Spikiera,silvermoon,480,rogue,outlaw,18,5,13
Earthinhorn,frostmourne,480,rogue,outlaw,18,5,13
Pez,barthilas,480,rogue,outlaw,18,5,13
Kasharo,tichondrius,479,rogue,outlaw,12,5,7
Falloran,nerzhul,479,rogue,outlaw,12,5,7
Universalize,proudmoore,479,rogue,outlaw,12,5,7
Aylyus,kiljaeden,478,rogue,outlaw,12,5,7
Xzarfi,moon-guard,478,rogue,outlaw,30,5,25
Mangaleón,wildhammer,475,rogue,outlaw,12,5,7
Gnork,twisting-nether,475,rogue,outlaw,12,5,7
Aleranah,frostmourne,474,rogue,outlaw,12,5,7
Darthkelso,arathor,465,rogue,outlaw,24,5,19
Robbin,bleeding-hollow,412,rogue,outlaw,14,5,9
Alandoril,tichondrius,384,rogue,outlaw,6,4,2
Kents,tichondrius,384,rogue,outlaw,6,4,2
Letty,area-52,384,rogue,outlaw,6,4,2
Velox,kiljaeden,384,rogue,outlaw,6,4,2
Flashmob,zuljin,384,rogue,outlaw,6,4,2
Xavar,malganis,384,rogue,outlaw,6,4,2
Krypticstab,malganis,384,rogue,outlaw,6,4,2
Showclass,stormrage,384,rogue,outlaw,12,4,8
Sazor,ysera,384,rogue,outlaw,12,4,8
Nello,runetotem,384,rogue,outlaw,12,4,8
Darthol,muradin,384,rogue,outlaw,12,4,8
Dayvanie,area-52,384,rogue,outlaw,12,4,8
Blingtronx,malganis,384,rogue,outlaw,12,4,8
Nestha,quelthalas,384,rogue,outlaw,12,4,8
Jsyn,kiljaeden,384,rogue,outlaw,12,4,8
Subnini,kelthuzad,384,rogue,outlaw,18,4,14
Katanië,moon-guard,383,rogue,outlaw,12,4,8
Keenstar,moon-guard,383,rogue,outlaw,18,4,14
Pelussy,kiljaeden,383,rogue,outlaw,21,4,17
Houdinilogic,skullcrusher,381,rogue,outlaw,12,4,8
Daftjack,bleeding-hollow,381,rogue,outlaw,12,4,8
Shádyj,velen,381,rogue,outlaw,18,4,14
Hîzzÿ,ghostlands,350,rogue,outlaw,26,5,21
Siamés,quelthalas,319,rogue,outlaw,14,4,10
Pikartz,stormrage,288,rogue,outlaw,6,3,3
Bàndit,wyrmrest-accord,288,rogue,outlaw,6,3,3
Bigcolumn,tichondrius,288,rogue,outlaw,6,3,3
Vierhy,proudmoore,288,rogue,outlaw,6,3,3
Skoalr,thrall,288,rogue,outlaw,6,3,3
Hellstabber,lightbringer,288,rogue,outlaw,6,3,3
Movze,area-52,288,rogue,outlaw,6,3,3
Instructor,area-52,288,rogue,outlaw,6,3,3
Slapjak,dalaran,288,rogue,outlaw,6,3,3
Ghøstfäce,tichondrius,288,rogue,outlaw,6,3,3
Daehyun,moknathal,288,rogue,outlaw,6,3,3
Pockettsand,firetree,288,rogue,outlaw,6,3,3
Wolfmother,nemesis,288,rogue,outlaw,6,3,3
Rotjaw,hydraxis,288,rogue,outlaw,6,3,3
Twnk,stormrage,288,rogue,outlaw,6,3,3
Karmagoodttv,stormrage,288,rogue,outlaw,6,3,3
Hobblefoot,tichondrius,288,rogue,outlaw,6,3,3
Machos,azralon,288,rogue,outlaw,6,3,3
Pilurfs,thrall,288,rogue,outlaw,6,3,3
Rujkah,archimonde,288,rogue,outlaw,6,3,3
Homeschoolx,moon-guard,288,rogue,outlaw,6,3,3
Hepatocyte,anvilmar,288,rogue,outlaw,6,3,3
Dookienotop,thunderhorn,288,rogue,outlaw,6,3,3
Whaazz,emerald-dream,288,rogue,outlaw,6,3,3
Drpibb,ghostlands,288,rogue,outlaw,12,3,9
Nippsy,aerie-peak,288,rogue,outlaw,18,3,15
Ñinjå,alleria,288,rogue,outlaw,18,3,15
Adysius,malganis,287,rogue,outlaw,6,3,3
Stabyou,sentinels,287,rogue,outlaw,6,3,3
Vampireshade,bloodhoof,286,rogue,outlaw,12,3,9
Grimthorn,icecrown,285,rogue,outlaw,12,3,9
Fenrul,thunderlord,285,rogue,outlaw,12,3,9
Smilinjack,ysera,284,rogue,outlaw,12,3,9
Hotboxthefox,illidan,253,rogue,outlaw,11,3,8
Mud,saurfang,192,rogue,outlaw,6,2,4
Nïck,korialstrasz,192,rogue,outlaw,6,2,4
ßuu,sargeras,192,rogue,outlaw,6,2,4
Prisonshank,arthas,192,rogue,outlaw,6,2,4
Jebubs,tichondrius,192,rogue,outlaw,6,2,4
Duskeron,cenarius,192,rogue,outlaw,6,2,4
Dillwilly,moon-guard,192,rogue,outlaw,6,2,4
Kpr,sargeras,192,rogue,outlaw,6,2,4
Slobernocker,stormrage,192,rogue,outlaw,6,2,4
Creamcakepop,stormrage,192,rogue,outlaw,6,2,4
Remonezero,moon-guard,192,rogue,outlaw,6,2,4
Touchthetip,bleeding-hollow,192,rogue,outlaw,6,2,4
Vizimyr,malganis,192,rogue,outlaw,12,2,10
Nikosneako,tichondrius,192,rogue,outlaw,12,2,10
Kensley,amanthul,192,rogue,outlaw,12,2,10
Sxs,kiljaeden,192,rogue,outlaw,12,2,10
Òklahomie,frostwolf,191,rogue,outlaw,6,2,4
Landrik,trollbane,191,rogue,outlaw,6,2,4
Manoq,drakkari,191,rogue,outlaw,6,2,4
Philliamson,azgalor,190,rogue,outlaw,12,2,10
Zugthug,perenolde,159,rogue,outlaw,11,2,9
Hedillyan,azralon,138,rogue,outlaw,9,3,6
Keylâ,thrall,138,rogue,outlaw,10,3,7
Vandalyze,sargeras,96,rogue,outlaw,6,1,5
Takeiapika,azralon,96,rogue,outlaw,6,1,5
Rinestiria,arthas,96,rogue,outlaw,6,1,5
Whatsåpp,gallywix,96,rogue,outlaw,6,1,5
Madge,area-52,96,rogue,outlaw,6,1,5
Happyslice,stormrage,96,rogue,outlaw,6,1,5
Sindor,azralon,96,rogue,outlaw,6,1,5
Dessenia,illidan,96,rogue,outlaw,6,1,5
Xm,sargeras,96,rogue,outlaw,6,1,5
Lu,lethon,96,rogue,outlaw,6,1,5
Tegernako,firetree,96,rogue,outlaw,6,1,5
Leiffer,ragnaros,96,rogue,outlaw,6,1,5
Loruk,ragnaros,96,rogue,outlaw,6,1,5
Fateapocryph,azralon,96,rogue,outlaw,6,1,5
Downsix,sargeras,96,rogue,outlaw,6,1,5
Denlox,moon-guard,96,rogue,outlaw,6,1,5
Neilyo,barthilas,96,rogue,outlaw,6,1,5
Theft,gorefiend,96,rogue,outlaw,6,1,5
Reginageorge,azuremyst,96,rogue,outlaw,6,1,5
Scottsparks,stormrage,96,rogue,outlaw,6,1,5
Burt,akama,96,rogue,outlaw,6,1,5
Raimondo,frostmourne,96,rogue,outlaw,6,1,5
Sleepstryke,stormrage,96,rogue,outlaw,12,1,11
Koxz,stormrage,96,rogue,outlaw,12,1,11
Culpera,undermine,95,rogue,outlaw,6,1,5
Vladdracc,quelthalas,48,rogue,outlaw,3,1,2
Teklore,arthas,16,rogue,outlaw,1,1,0
Aliasfaker,stormrage,16,rogue,outlaw,1,1,0
Spymafia,ragnaros,16,rogue,outlaw,6,1,5
Erebüs,thunderlord,2268,rogue,subtlety,150,91,59
Fotg,tichondrius,2265,rogue,subtlety,78,48,30
Battzii,wyrmrest-accord,2234,rogue,subtlety,1010,525,485
Alexdelion,tichondrius,2231,rogue,subtlety,102,57,45
Howton,kelthuzad,2225,rogue,subtlety,48,38,10
Æsshayádlay,tichondrius,2131,rogue,subtlety,81,42,39
Ymxxworld,tichondrius,2107,rogue,subtlety,96,49,47
Thèllè,sargeras,2104,rogue,subtlety,78,46,32
Røgüë,malganis,2100,rogue,subtlety,96,53,43
Roguesparrow,illidan,2066,rogue,subtlety,218,123,95
Ajl,drenden,2037,rogue,subtlety,208,108,100
Cydonian,ragnaros,2028,rogue,subtlety,172,99,73
Flashmob,zuljin,2024,rogue,subtlety,80,41,39
Xiaochulol,tichondrius,2020,rogue,subtlety,60,41,19
Kidcutti,proudmoore,2017,rogue,subtlety,110,60,50
Incoherentz,frostmourne,2016,rogue,subtlety,84,47,37
Yázim,tichondrius,1997,rogue,subtlety,85,53,32
Kenpàchi,kelthuzad,1996,rogue,subtlety,176,97,79
Hiyõ,tichondrius,1995,rogue,subtlety,190,106,84
Swadeecup,nagrand,1991,rogue,subtlety,90,45,45
Danrathm,sargeras,1990,rogue,subtlety,109,59,50
Vendettita,quelthalas,1983,rogue,subtlety,84,47,37
Zerogh,tichondrius,1969,rogue,subtlety,153,93,60
Stunsofpuns,sargeras,1960,rogue,subtlety,102,58,44
Maulline,tichondrius,1960,rogue,subtlety,72,34,38
Yellowdeep,tichondrius,1952,rogue,subtlety,56,40,16
Lycanthropî,illidan,1944,rogue,subtlety,42,32,10
Ulley,sargeras,1944,rogue,subtlety,186,104,82
Zurza,proudmoore,1943,rogue,subtlety,95,44,51
Slashthunder,blades-edge,1942,rogue,subtlety,60,33,27
Rangoons,tichondrius,1938,rogue,subtlety,66,39,27
Wazowskiy,tichondrius,1935,rogue,subtlety,265,133,132
Lies,dalaran,1920,rogue,subtlety,188,90,98
Esky,tichondrius,1918,rogue,subtlety,75,40,35
Damrat,tichondrius,1915,rogue,subtlety,78,46,32
Scuffedjr,tichondrius,1912,rogue,subtlety,126,60,66
Norbury,tichondrius,1907,rogue,subtlety,139,69,70
Minaciki,tichondrius,1898,rogue,subtlety,72,41,31
Wizlysnipz,tichondrius,1892,rogue,subtlety,102,59,43
Antoninez,tichondrius,1892,rogue,subtlety,54,29,25
Coopi,tichondrius,1889,rogue,subtlety,146,77,69
Aaronjlol,tichondrius,1886,rogue,subtlety,71,35,36
Shankntwist,malganis,1885,rogue,subtlety,72,47,25
Wetit,illidan,1876,rogue,subtlety,90,60,30
Vyll,stormrage,1870,rogue,subtlety,77,39,38
Spèèd,proudmoore,1869,rogue,subtlety,107,65,42
Asoj,tichondrius,1868,rogue,subtlety,66,33,33
Needbuff,tichondrius,1865,rogue,subtlety,54,25,29
Shinigâmì,tichondrius,1864,rogue,subtlety,174,104,70
Coregx,tichondrius,1842,rogue,subtlety,36,24,12
Rõý,area-52,1837,rogue,subtlety,42,23,19
Silentkush,arthas,1829,rogue,subtlety,66,39,27
Ahsokatona,emerald-dream,1827,rogue,subtlety,60,32,28
Fátálíty,tichondrius,1827,rogue,subtlety,60,30,30
Seengivenchy,zuljin,1825,rogue,subtlety,60,39,21
Smkgpvp,stormrage,1823,rogue,subtlety,68,43,25
Brucerogue,tichondrius,1822,rogue,subtlety,348,181,167
Himitu,tichondrius,1821,rogue,subtlety,115,58,57
Ivanrah,zuljin,1818,rogue,subtlety,24,19,5
Clern,emerald-dream,1818,rogue,subtlety,65,35,30
Ðèãth,area-52,1818,rogue,subtlety,36,19,17
Poizzon,emerald-dream,1817,rogue,subtlety,103,59,44
Okaylmao,tichondrius,1817,rogue,subtlety,80,45,35
Ideology,azgalor,1817,rogue,subtlety,70,35,35
Celèphaïs,tichondrius,1817,rogue,subtlety,63,30,33
Jsnlol,zuljin,1815,rogue,subtlety,42,27,15
Ganknvanish,tichondrius,1815,rogue,subtlety,195,99,96
Stealthyxd,arthas,1815,rogue,subtlety,48,20,28
Votekanye,bleeding-hollow,1812,rogue,subtlety,36,28,8
Sasugay,sargeras,1809,rogue,subtlety,104,64,40
Bigpump,lothar,1809,rogue,subtlety,60,33,27
Díor,azralon,1807,rogue,subtlety,124,70,54
Shizz,tichondrius,1803,rogue,subtlety,36,23,13
Turtlespeed,thrall,1803,rogue,subtlety,123,74,49
Vellexsis,sargeras,1802,rogue,subtlety,91,51,40
Tyrrantxo,agamaggan,1802,rogue,subtlety,100,54,46
ßaltø,bleeding-hollow,1799,rogue,subtlety,42,19,23
Yunggodmalik,whisperwind,1799,rogue,subtlety,48,19,29
Beanlord,spinebreaker,1796,rogue,subtlety,99,57,42
Stealthypoop,kelthuzad,1796,rogue,subtlety,192,93,99
Scuffedsr,tichondrius,1792,rogue,subtlety,48,25,23
Airi,darkspear,1791,rogue,subtlety,85,44,41
Nightcloud,tichondrius,1785,rogue,subtlety,80,44,36
Decóm,zuljin,1784,rogue,subtlety,64,35,29
Kellenx,moon-guard,1780,rogue,subtlety,145,73,72
Onîkudaki,sargeras,1779,rogue,subtlety,60,26,34
Ojibwe,tichondrius,1777,rogue,subtlety,40,21,19
Bruítzy,barthilas,1777,rogue,subtlety,168,87,81
Chitovera,tichondrius,1772,rogue,subtlety,48,32,16
Dvin,stormrage,1770,rogue,subtlety,54,30,24
Gyokkó,sargeras,1770,rogue,subtlety,36,20,16
Larmx,tichondrius,1769,rogue,subtlety,27,21,6
Sohardtoplay,zuljin,1769,rogue,subtlety,53,27,26
Queuethunder,blades-edge,1756,rogue,subtlety,34,28,6
Eazyg,tichondrius,1754,rogue,subtlety,83,46,37
Stabem,moon-guard,1754,rogue,subtlety,153,83,70
Nuhiva,tichondrius,1753,rogue,subtlety,85,45,40
Nines,icecrown,1753,rogue,subtlety,36,19,17
ßuu,sargeras,1749,rogue,subtlety,36,21,15
Trc,illidan,1746,rogue,subtlety,50,28,22
Dysxliec,dalaran,1740,rogue,subtlety,215,109,106
Marcusr,tichondrius,1739,rogue,subtlety,60,33,27
Lxw,frostmourne,1739,rogue,subtlety,61,29,32
Assassìn,moon-guard,1729,rogue,subtlety,193,104,89
Gnover,ragnaros,1728,rogue,subtlety,252,144,108
Greyyfox,illidan,1727,rogue,subtlety,75,35,40
Baeruto,thunderlord,1726,rogue,subtlety,24,18,6
Jaos,tichondrius,1725,rogue,subtlety,54,25,29
Smang,mugthol,1724,rogue,subtlety,30,18,12
Qtq,malganis,1723,rogue,subtlety,48,29,19
Kyubïx,ragnaros,1721,rogue,subtlety,126,76,50
Ziyanbaby,thunderlord,1716,rogue,subtlety,54,37,17
Runakó,kelthuzad,1716,rogue,subtlety,63,29,34
Bobsaget,kiljaeden,1714,rogue,subtlety,100,52,48
Saprìse,darkspear,1710,rogue,subtlety,72,44,28
Skitsöu,tichondrius,1706,rogue,subtlety,54,27,27
Pxb,sargeras,1705,rogue,subtlety,88,40,48
Majk,eldrethalas,1703,rogue,subtlety,76,37,39
Eekz,illidan,1702,rogue,subtlety,310,172,138
Yurasick,lightbringer,1701,rogue,subtlety,48,29,19
Mirâge,illidan,1701,rogue,subtlety,161,89,72
Muggzy,emerald-dream,1701,rogue,subtlety,36,18,18
Yoskit,tichondrius,1700,rogue,subtlety,36,21,15
Vavnmusic,illidan,1698,rogue,subtlety,126,74,52
Cahlee,sargeras,1696,rogue,subtlety,171,86,85
Whoox,khazgoroth,1695,rogue,subtlety,42,29,13
Saltymann,bleeding-hollow,1695,rogue,subtlety,60,35,25
Xiaozhi,tichondrius,1692,rogue,subtlety,52,26,26
Stepcurry,tichondrius,1690,rogue,subtlety,42,31,11
Axtually,proudmoore,1686,rogue,subtlety,132,71,61
Nugator,illidan,1681,rogue,subtlety,30,18,12
Buffsu56B592,tichondrius,1681,rogue,subtlety,96,53,43
Blakezilla,tichondrius,1677,rogue,subtlety,72,42,30
Akorag,area-52,1676,rogue,subtlety,36,27,9
Cut,ragnaros,1672,rogue,subtlety,136,72,64
Energy,auchindoun,1669,rogue,subtlety,80,48,32
Originalfake,sargeras,1669,rogue,subtlety,45,24,21
Submissions,khazgoroth,1669,rogue,subtlety,72,38,34
Acid,warsong,1667,rogue,subtlety,48,33,15
Steef,arygos,1667,rogue,subtlety,98,58,40
Errorless,moon-guard,1666,rogue,subtlety,107,61,46
Vanishcdc,area-52,1664,rogue,subtlety,48,29,19
Zeiss,tichondrius,1663,rogue,subtlety,54,27,27
Termkilledu,moon-guard,1655,rogue,subtlety,210,123,87
Camlaw,area-52,1655,rogue,subtlety,90,52,38
Aman,frostmourne,1653,rogue,subtlety,47,29,18
Siyeong,tichondrius,1653,rogue,subtlety,102,59,43
Themosk,malganis,1653,rogue,subtlety,60,29,31
Feinting,moon-guard,1649,rogue,subtlety,36,24,12
Ðankbud,barthilas,1649,rogue,subtlety,39,19,20
Catatonic,moon-guard,1647,rogue,subtlety,54,29,25
Pngöd,area-52,1642,rogue,subtlety,76,48,28
Zipperx,tichondrius,1641,rogue,subtlety,65,34,31
Bezeta,azralon,1639,rogue,subtlety,275,146,129
Mutingall,tichondrius,1638,rogue,subtlety,35,23,12
Îzu,ysera,1636,rogue,subtlety,63,36,27
Fence,moon-guard,1635,rogue,subtlety,48,28,20
Tmskitsou,tichondrius,1634,rogue,subtlety,34,20,14
Zaszune,stormrage,1633,rogue,subtlety,66,38,28
Psÿchð,azralon,1633,rogue,subtlety,42,24,18
Furt,frostmourne,1633,rogue,subtlety,44,25,19
Tiladar,tichondrius,1633,rogue,subtlety,36,19,17
Nicoaa,tichondrius,1631,rogue,subtlety,194,99,95
Garrotte,tichondrius,1631,rogue,subtlety,140,67,73
Lxke,stormrage,1630,rogue,subtlety,34,22,12
Frusciante,nemesis,1630,rogue,subtlety,90,52,38
Haiev,tichondrius,1630,rogue,subtlety,72,36,36
Ateabug,wyrmrest-accord,1629,rogue,subtlety,48,25,23
Antonines,tichondrius,1628,rogue,subtlety,24,17,7
Shreddér,tichondrius,1628,rogue,subtlety,41,20,21
Notty,kelthuzad,1626,rogue,subtlety,111,63,48
Ninjamf,bleeding-hollow,1625,rogue,subtlety,38,22,16
Insanctus,malganis,1623,rogue,subtlety,34,22,12
Gotto,icecrown,1623,rogue,subtlety,47,24,23
Gptcodeplay,tichondrius,1622,rogue,subtlety,36,25,11
Bruitzygg,barthilas,1619,rogue,subtlety,44,20,24
Klawz,norgannon,1618,rogue,subtlety,53,32,21
Neonjk,ragnaros,1618,rogue,subtlety,78,43,35
Vyrenn,destromath,1618,rogue,subtlety,127,63,64
Amonn,arthas,1617,rogue,subtlety,135,67,68
Tigerinu,stormreaver,1615,rogue,subtlety,76,38,38
Astroz,sargeras,1615,rogue,subtlety,42,21,21
Nightthug,tichondrius,1615,rogue,subtlety,48,23,25
Wansuiye,tichondrius,1613,rogue,subtlety,30,20,10
Esmeraldas,frostmourne,1613,rogue,subtlety,77,39,38
Spötty,stormrage,1612,rogue,subtlety,30,17,13
Eekz,sargeras,1612,rogue,subtlety,315,161,154
Frez,amanthul,1611,rogue,subtlety,30,20,10
Sparqxx,tichondrius,1611,rogue,subtlety,116,64,52
Topfloorboss,illidan,1610,rogue,subtlety,44,24,20
Ozzinton,kelthuzad,1609,rogue,subtlety,30,17,13
Lululee,tichondrius,1609,rogue,subtlety,63,28,35
Piscís,sargeras,1606,rogue,subtlety,60,31,29
Kazzo,tichondrius,1605,rogue,subtlety,45,32,13
Skoalr,thrall,1604,rogue,subtlety,64,43,21
Bombman,tichondrius,1604,rogue,subtlety,125,62,63
Rogsky,tichondrius,1604,rogue,subtlety,36,17,19
Misthios,chogall,1604,rogue,subtlety,41,19,22
Taidath,area-52,1603,rogue,subtlety,42,20,22
Karmagoodttv,stormrage,1602,rogue,subtlety,34,22,12
Saltypwncake,illidan,1601,rogue,subtlety,47,23,24
Techie,frostmane,1600,rogue,subtlety,68,38,30
Whoô,khazgoroth,1600,rogue,subtlety,96,52,44
Hayzarc,malfurion,1598,rogue,subtlety,42,21,21
Kalvish,dalaran,1597,rogue,subtlety,29,17,12
Roguetrix,stormrage,1597,rogue,subtlety,179,86,93
Mtvcribs,emerald-dream,1596,rogue,subtlety,37,22,15
Åer,dalaran,1595,rogue,subtlety,177,93,84
Abssall,tichondrius,1594,rogue,subtlety,30,19,11
Spookyboogie,aegwynn,1593,rogue,subtlety,82,44,38
Fancen,drakthul,1591,rogue,subtlety,54,31,23
Cbdoil,proudmoore,1591,rogue,subtlety,36,18,18
Unshut,tichondrius,1588,rogue,subtlety,30,19,11
Nargonis,illidan,1587,rogue,subtlety,56,35,21
Fela,crushridge,1586,rogue,subtlety,172,89,83
Wowamaze,aegwynn,1584,rogue,subtlety,124,67,57
Preceptor,azralon,1584,rogue,subtlety,134,66,68
Clicksbtns,area-52,1583,rogue,subtlety,54,28,26
Yesua,ragnaros,1583,rogue,subtlety,333,166,167
Wowcode,tichondrius,1577,rogue,subtlety,36,18,18
Rinhon,windrunner,1574,rogue,subtlety,30,19,11
Welinth,thunderlord,1574,rogue,subtlety,96,51,45
Jawnrogue,tichondrius,1572,rogue,subtlety,30,22,8
Cuizhudi,tichondrius,1572,rogue,subtlety,72,40,32
Jolly,frostmourne,1572,rogue,subtlety,112,62,50
Xvds,tichondrius,1572,rogue,subtlety,47,24,23
Jibdorf,destromath,1571,rogue,subtlety,60,38,22
Alts,tichondrius,1568,rogue,subtlety,36,19,17
Overdríver,emerald-dream,1566,rogue,subtlety,36,17,19
Cheapdeal,frostmourne,1566,rogue,subtlety,43,20,23
Murked,barthilas,1564,rogue,subtlety,70,43,27
Trizin,frostmourne,1563,rogue,subtlety,84,45,39
Ghyile,stormreaver,1563,rogue,subtlety,48,24,24
Turec,illidan,1558,rogue,subtlety,35,17,18
Saintt,khaz-modan,1557,rogue,subtlety,61,41,20
Luradfate,dalaran,1557,rogue,subtlety,290,153,137
Ninetaildfox,arthas,1555,rogue,subtlety,24,17,7
Faelanna,stormrage,1554,rogue,subtlety,79,40,39
Grelinho,stormrage,1554,rogue,subtlety,66,26,40
Mayhemghost,rexxar,1552,rogue,subtlety,78,44,34
Qq,doomhammer,1552,rogue,subtlety,54,28,26
Rufian,ursin,1550,rogue,subtlety,82,44,38
Usernameqtxo,kelthuzad,1549,rogue,subtlety,141,72,69
Gardianstep,stormrage,1548,rogue,subtlety,36,18,18
Bobbyflay,velen,1546,rogue,subtlety,30,18,12
Kinbaal,bleeding-hollow,1544,rogue,subtlety,48,29,19
Sandorroguee,stormrage,1544,rogue,subtlety,36,18,18
Danielsylerr,drakkari,1543,rogue,subtlety,42,18,24
Mesqeets,kelthuzad,1542,rogue,subtlety,58,34,24
Kolander,tichondrius,1542,rogue,subtlety,70,40,30
Shigoo,sargeras,1540,rogue,subtlety,41,20,21
Tootsio,tichondrius,1539,rogue,subtlety,55,28,27
Threeplates,silvermoon,1538,rogue,subtlety,93,50,43
Rosoma,kelthuzad,1538,rogue,subtlety,71,38,33
Revelationzz,turalyon,1538,rogue,subtlety,145,74,71
Clownboots,tichondrius,1538,rogue,subtlety,145,72,73
Worrglaive,dalaran,1537,rogue,subtlety,224,118,106
Prrey,hydraxis,1536,rogue,subtlety,103,46,57
Mitsurí,sargeras,1534,rogue,subtlety,24,16,8
Eviscerator,moon-guard,1532,rogue,subtlety,107,48,59
Zernaz,thrall,1531,rogue,subtlety,102,54,48
Horyx,zuljin,1527,rogue,subtlety,33,18,15
Tapwaterx,illidan,1527,rogue,subtlety,114,56,58
Rhythmic,ysera,1526,rogue,subtlety,24,16,8
Dogpaws,moon-guard,1526,rogue,subtlety,70,39,31
Eridian,tichondrius,1525,rogue,subtlety,127,65,62
Axerax,draka,1525,rogue,subtlety,48,24,24
ßeep,windrunner,1525,rogue,subtlety,48,24,24
Corde,hyjal,1523,rogue,subtlety,32,20,12
Dissociated,stormrage,1523,rogue,subtlety,47,17,30
Tarny,illidan,1521,rogue,subtlety,82,35,47
Hotcarl,kiljaeden,1519,rogue,subtlety,52,31,21
Jon,the-venture-co,1519,rogue,subtlety,30,16,14
Beatcat,tichondrius,1519,rogue,subtlety,66,35,31
Plado,tichondrius,1517,rogue,subtlety,83,44,39
Whispx,malganis,1517,rogue,subtlety,36,18,18
Scenna,stormrage,1515,rogue,subtlety,96,44,52
Killmebaby,lightnings-blade,1514,rogue,subtlety,54,29,25
Woollord,frostmourne,1513,rogue,subtlety,66,39,27
Broddz,sargeras,1512,rogue,subtlety,54,30,24
Greasybbsea,illidan,1511,rogue,subtlety,126,63,63
Swanl,stormrage,1510,rogue,subtlety,77,43,34
Laaggul,tichondrius,1509,rogue,subtlety,24,16,8
ßecomeðeath,tichondrius,1509,rogue,subtlety,59,32,27
Morriz,tichondrius,1505,rogue,subtlety,84,52,32
Brangs,ragnaros,1505,rogue,subtlety,48,27,21
Wongski,darkspear,1503,rogue,subtlety,34,23,11
Illmatíc,kelthuzad,1502,rogue,subtlety,29,16,13
Cheepz,emerald-dream,1500,rogue,subtlety,30,17,13
Cerut,illidan,1499,rogue,subtlety,52,27,25
Galaxybrain,icecrown,1498,rogue,subtlety,120,76,44
Jmaxx,wyrmrest-accord,1497,rogue,subtlety,42,22,20
Taliwis,burning-blade,1497,rogue,subtlety,48,21,27
Stunz,mugthol,1495,rogue,subtlety,80,48,32
Sit,frostwolf,1492,rogue,subtlety,70,39,31
Linkzq,frostmourne,1492,rogue,subtlety,41,17,24
Saulgoodz,tichondrius,1491,rogue,subtlety,54,25,29
Slap,icecrown,1491,rogue,subtlety,48,20,28
Abacura,moon-guard,1489,rogue,subtlety,142,80,62
Saraelith,moon-guard,1489,rogue,subtlety,75,42,33
Delphyax,azralon,1489,rogue,subtlety,30,16,14
Greasymarheo,area-52,1488,rogue,subtlety,67,33,34
Aghanaar,burning-legion,1488,rogue,subtlety,56,27,29
Blinky,blades-edge,1487,rogue,subtlety,30,17,13
Pressuret,frostmourne,1483,rogue,subtlety,52,31,21
Bugser,tichondrius,1483,rogue,subtlety,102,54,48
Fkrueger,thrall,1480,rogue,subtlety,81,45,36
Pichichi,frostmourne,1479,rogue,subtlety,69,41,28
Speedboi,skullcrusher,1479,rogue,subtlety,146,86,60
Jinglez,frostmourne,1478,rogue,subtlety,36,22,14
Ironfistofcn,tichondrius,1478,rogue,subtlety,82,47,35
Twotimed,magtheridon,1478,rogue,subtlety,71,39,32
Mosedz,tichondrius,1474,rogue,subtlety,48,28,20
Luolan,kargath,1472,rogue,subtlety,60,33,27
Roguechamp,aggramar,1471,rogue,subtlety,41,20,21
Pince,black-dragonflight,1470,rogue,subtlety,39,22,17
Cutx,frostmourne,1470,rogue,subtlety,46,25,21
Ctrlfreak,hellscream,1468,rogue,subtlety,96,55,41
Swiftdeaths,queldorei,1468,rogue,subtlety,74,37,37
Kaliasteddin,area-52,1467,rogue,subtlety,80,40,40
Goopthicc,sargeras,1466,rogue,subtlety,49,18,31
Lesty,kelthuzad,1464,rogue,subtlety,29,16,13
Steffmaister,tichondrius,1463,rogue,subtlety,34,20,14
Kainm,stormrage,1463,rogue,subtlety,278,143,135
Xandroesh,darkspear,1462,rogue,subtlety,60,34,26
Oldgate,azralon,1462,rogue,subtlety,41,23,18
Stankyx,bleeding-hollow,1460,rogue,subtlety,66,37,29
Vigílant,proudmoore,1460,rogue,subtlety,84,41,43
Toxsith,tichondrius,1459,rogue,subtlety,74,43,31
Wowtheskill,illidan,1459,rogue,subtlety,54,26,28
Hmmkek,frostmourne,1455,rogue,subtlety,41,24,17
Axiy,stormrage,1455,rogue,subtlety,65,35,30
Superharry,tichondrius,1453,rogue,subtlety,78,42,36
Weenies,illidan,1453,rogue,subtlety,59,31,28
Neilyo,barthilas,1453,rogue,subtlety,107,55,52
Incognitony,proudmoore,1453,rogue,subtlety,55,23,32
Klâng,tichondrius,1452,rogue,subtlety,184,91,93
Trucidovaco,daggerspine,1449,rogue,subtlety,88,40,48
Tamsy,the-forgotten-coast,1448,rogue,subtlety,27,19,8
Géminis,sargeras,1444,rogue,subtlety,30,17,13
Pleodonis,tichondrius,1444,rogue,subtlety,112,58,54
Rougething,bleeding-hollow,1443,rogue,subtlety,72,35,37
Lagault,muradin,1442,rogue,subtlety,108,64,44
Bloodylegend,altar-of-storms,1442,rogue,subtlety,36,21,15
Vanvanlords,azralon,1442,rogue,subtlety,84,40,44
Huskyi,dalaran,1442,rogue,subtlety,66,31,35
Clownvish,dalaran,1440,rogue,subtlety,18,15,3
Stabasaurus,blood-furnace,1438,rogue,subtlety,24,15,9
Kents,tichondrius,1438,rogue,subtlety,36,15,21
Calebrogue,illidan,1436,rogue,subtlety,24,15,9
Escapeartist,darkspear,1435,rogue,subtlety,24,15,9
Leftyleaf,proudmoore,1435,rogue,subtlety,42,25,17
Hykoo,tichondrius,1435,rogue,subtlety,66,31,35
Ricros,bleeding-hollow,1435,rogue,subtlety,43,20,23
Humphugull,skullcrusher,1435,rogue,subtlety,65,27,38
Noxik,blackrock,1434,rogue,subtlety,169,93,76
Snoogly,tichondrius,1433,rogue,subtlety,47,18,29
Tulis,frostmourne,1432,rogue,subtlety,186,106,80
Donstevano,frostmourne,1432,rogue,subtlety,30,15,15
Dismayx,tichondrius,1432,rogue,subtlety,45,22,23
Nítzy,quelthalas,1432,rogue,subtlety,66,30,36
Epipenqt,dark-iron,1431,rogue,subtlety,42,26,16
Hunchó,area-52,1431,rogue,subtlety,77,44,33
Clayton,frostmourne,1431,rogue,subtlety,61,33,28
Deadguys,tichondrius,1430,rogue,subtlety,72,37,35
Drsinz,tichondrius,1430,rogue,subtlety,95,45,50
Hakuchi,tichondrius,1429,rogue,subtlety,105,53,52
Kløud,uther,1427,rogue,subtlety,30,18,12
Bakedpotato,garithos,1425,rogue,subtlety,78,40,38
Lazzi,tichondrius,1424,rogue,subtlety,24,18,6
Grinjuk,area-52,1424,rogue,subtlety,35,18,17
Lilshanker,tichondrius,1424,rogue,subtlety,98,45,53
Kibbs,korgath,1422,rogue,subtlety,60,30,30
Smolblade,nordrassil,1422,rogue,subtlety,35,17,18
Zefeckz,tichondrius,1420,rogue,subtlety,59,29,30
Tolthe,hyjal,1418,rogue,subtlety,80,40,40
Quinity,wyrmrest-accord,1416,rogue,subtlety,234,119,115
Lyfallah,proudmoore,1415,rogue,subtlety,141,79,62
Arakine,uldaman,1410,rogue,subtlety,44,30,14
Fulkrem,wyrmrest-accord,1410,rogue,subtlety,74,34,40
Smormu,bonechewer,1410,rogue,subtlety,42,18,24
Morpheûs,tichondrius,1408,rogue,subtlety,82,40,42
Revenantss,moon-guard,1406,rogue,subtlety,30,15,15
Gøblìn,tichondrius,1406,rogue,subtlety,132,56,76
Stanley,mugthol,1404,rogue,subtlety,75,42,33
Cv,proudmoore,1404,rogue,subtlety,42,23,19
Jirokun,illidan,1402,rogue,subtlety,36,16,20
Hickery,frostmourne,1396,rogue,subtlety,36,21,15
Miraclesap,stormrage,1396,rogue,subtlety,207,120,87
Guiguzidr,illidan,1396,rogue,subtlety,152,84,68
Harlyfknquin,jubeithos,1396,rogue,subtlety,154,83,71
Lurios,rivendare,1396,rogue,subtlety,111,54,57
Seaki,illidan,1395,rogue,subtlety,23,15,8
Pãx,stormrage,1395,rogue,subtlety,24,15,9
Lilplato,area-52,1395,rogue,subtlety,24,15,9
Yanh,tichondrius,1395,rogue,subtlety,36,16,20
Xleo,drakkari,1394,rogue,subtlety,197,96,101
Eryx,mugthol,1393,rogue,subtlety,51,33,18
Orîon,scilla,1393,rogue,subtlety,42,23,19
Luriél,stormrage,1392,rogue,subtlety,34,20,14
Manersi,akama,1391,rogue,subtlety,24,15,9
Darkìs,tichondrius,1390,rogue,subtlety,36,19,17
Oksanaastan,tichondrius,1390,rogue,subtlety,71,29,42
Fofree,hyjal,1389,rogue,subtlety,76,41,35
Sapyalater,thrall,1389,rogue,subtlety,210,108,102
Loquen,ragnaros,1388,rogue,subtlety,99,53,46
Odelöt,drakkari,1387,rogue,subtlety,108,59,49
Neuschurke,warsong,1386,rogue,subtlety,42,23,19
Frèyjä,bleeding-hollow,1386,rogue,subtlety,176,95,81
Faxingberlin,skullcrusher,1386,rogue,subtlety,54,25,29
Sgtbuttfat,dalaran,1385,rogue,subtlety,41,20,21
Najohn,tichondrius,1384,rogue,subtlety,42,20,22
Secrettecbot,barthilas,1383,rogue,subtlety,36,20,16
Nooz,thrall,1382,rogue,subtlety,107,62,45
Shaoriel,zuljin,1380,rogue,subtlety,24,15,9
Søprøle,ragnaros,1380,rogue,subtlety,98,57,41
Bossrogue,tichondrius,1378,rogue,subtlety,43,18,25
Pikabuu,bleeding-hollow,1377,rogue,subtlety,75,32,43
Krolczz,tichondrius,1375,rogue,subtlety,105,58,47
Hahaurblind,perenolde,1375,rogue,subtlety,83,43,40
Gloòm,stormrage,1373,rogue,subtlety,24,16,8
Lozion,malganis,1372,rogue,subtlety,54,25,29
Rezy,lightbringer,1372,rogue,subtlety,53,19,34
Goatforsale,tichondrius,1371,rogue,subtlety,28,16,12
Overzz,azralon,1371,rogue,subtlety,39,21,18
Orteker,tichondrius,1370,rogue,subtlety,84,42,42
Suhwooh,area-52,1366,rogue,subtlety,67,37,30
Gnomerogue,sargeras,1365,rogue,subtlety,57,31,26
Köfy,quelthalas,1364,rogue,subtlety,38,19,19
Narcoleptic,dalaran,1363,rogue,subtlety,91,44,47
Nihue,terenas,1362,rogue,subtlety,60,29,31
Jadier,emerald-dream,1361,rogue,subtlety,47,24,23
Emrogr,tichondrius,1360,rogue,subtlety,81,44,37
Mistnazgul,quelthalas,1360,rogue,subtlety,118,64,54
Chãlons,tichondrius,1360,rogue,subtlety,96,45,51
Eraticrogue,illidan,1360,rogue,subtlety,47,20,27
Bledstepelin,frostmourne,1356,rogue,subtlety,29,15,14
Raymga,tichondrius,1355,rogue,subtlety,48,29,19
Jujudaddy,sargeras,1353,rogue,subtlety,69,36,33
Denoms,area-52,1351,rogue,subtlety,54,23,31
Stêf,zuljin,1347,rogue,subtlety,109,64,45
Helzzit,ragnaros,1343,rogue,subtlety,38,22,16
Demìurge,tichondrius,1342,rogue,subtlety,75,32,43
Sketchyweas,sargeras,1342,rogue,subtlety,44,17,27
Peaches,akama,1341,rogue,subtlety,24,14,10
Corrier,tichondrius,1340,rogue,subtlety,24,14,10
Sícarii,emerald-dream,1338,rogue,subtlety,36,22,14
Adept,whisperwind,1338,rogue,subtlety,24,14,10
Notxerian,stormrage,1338,rogue,subtlety,24,14,10
Spacebase,illidan,1337,rogue,subtlety,24,14,10
Tonjuras,uther,1337,rogue,subtlety,48,26,22
Mendiant,azralon,1337,rogue,subtlety,149,78,71
Täy,thrall,1337,rogue,subtlety,110,56,54
Progeriagodx,darkspear,1336,rogue,subtlety,24,14,10
Sighzy,sargeras,1336,rogue,subtlety,78,27,51
Donnice,area-52,1335,rogue,subtlety,30,15,15
Ikerz,tichondrius,1334,rogue,subtlety,31,16,15
Lisnp,tichondrius,1334,rogue,subtlety,212,102,110
Brendantko,arthas,1334,rogue,subtlety,30,14,16
Thugspice,stormrage,1333,rogue,subtlety,73,38,35
Kidneyisntop,illidan,1332,rogue,subtlety,74,34,40
Genève,dreadmaul,1327,rogue,subtlety,24,14,10
Pegglerogue,fizzcrank,1326,rogue,subtlety,184,90,94
Vex,durotan,1325,rogue,subtlety,36,15,21
Hollowshade,hydraxis,1323,rogue,subtlety,30,16,14
Dustt,stormrage,1322,rogue,subtlety,30,21,9
Lagula,ragnaros,1320,rogue,subtlety,35,24,11
Peacetou,kelthuzad,1320,rogue,subtlety,30,14,16
Sabedoria,barthilas,1319,rogue,subtlety,119,61,58
Lilstab,hakkar,1318,rogue,subtlety,143,74,69
Zhuodouqiaga,tichondrius,1318,rogue,subtlety,29,14,15
Gankolicious,nerzhul,1317,rogue,subtlety,18,14,4
Coh,sargeras,1315,rogue,subtlety,30,14,16
Shilaya,dreadmaul,1311,rogue,subtlety,36,14,22
Leprocy,tichondrius,1309,rogue,subtlety,22,15,7
Rigotak,illidan,1308,rogue,subtlety,110,56,54
Vap,azralon,1305,rogue,subtlety,54,25,29
Khorgan,mugthol,1301,rogue,subtlety,36,18,18
Învîsîßull,illidan,1301,rogue,subtlety,34,14,20
Raqed,eredar,1300,rogue,subtlety,30,14,16
Pocketman,barthilas,1299,rogue,subtlety,59,24,35
Vaith,wyrmrest-accord,1291,rogue,subtlety,78,33,45
Orangez,malfurion,1289,rogue,subtlety,36,21,15
Sinnister,queldorei,1287,rogue,subtlety,30,20,10
Gothblade,malganis,1285,rogue,subtlety,36,19,17
Vellkann,azralon,1284,rogue,subtlety,30,21,9
Oatmealcrisp,thrall,1284,rogue,subtlety,36,21,15
Oilyrock,tichondrius,1284,rogue,subtlety,78,44,34
Kahlx,azralon,1284,rogue,subtlety,102,47,55
Lefteex,tichondrius,1282,rogue,subtlety,80,43,37
Pgo,tichondrius,1281,rogue,subtlety,36,21,15
Liryth,lightninghoof,1281,rogue,subtlety,51,29,22
Ikmagine,icecrown,1281,rogue,subtlety,42,17,25
Shellby,tichondrius,1277,rogue,subtlety,92,49,43
Macsap,frostmourne,1277,rogue,subtlety,66,35,31
Sapùwú,stormrage,1277,rogue,subtlety,112,56,56
Merek,scarlet-crusade,1273,rogue,subtlety,39,19,20
Ambushr,tichondrius,1271,rogue,subtlety,66,38,28
Hypermix,tichondrius,1271,rogue,subtlety,54,25,29
Mcromance,khadgar,1268,rogue,subtlety,75,34,41
Dionavelynn,area-52,1267,rogue,subtlety,42,19,23
Flockavelli,zuljin,1266,rogue,subtlety,85,41,44
Pargo,quelthalas,1266,rogue,subtlety,67,30,37
Hollfex,nemesis,1265,rogue,subtlety,44,22,22
Vangroen,quelthalas,1261,rogue,subtlety,42,27,15
Nocte,goldrinn,1261,rogue,subtlety,41,18,23
Kawagreen,tichondrius,1260,rogue,subtlety,51,27,24
Xoltin,tichondrius,1258,rogue,subtlety,80,36,44
Variat,azralon,1255,rogue,subtlety,78,38,40
Glíz,bloodscalp,1250,rogue,subtlety,54,28,26
Arbitér,moonrunner,1250,rogue,subtlety,64,25,39
Smertin,area-52,1249,rogue,subtlety,30,15,15
Tmpikaboo,tichondrius,1248,rogue,subtlety,18,13,5
Ballflicker,malganis,1248,rogue,subtlety,47,19,28
Kilerhid,quelthalas,1248,rogue,subtlety,48,15,33
Jdmg,azralon,1247,rogue,subtlety,28,17,11
Sahima,tichondrius,1247,rogue,subtlety,242,124,118
Kalamarii,stormrage,1246,rogue,subtlety,53,21,32
Shadówl,tichondrius,1245,rogue,subtlety,18,13,5
Seshtime,tichondrius,1245,rogue,subtlety,18,13,5
Mirajoo,tichondrius,1245,rogue,subtlety,88,42,46
Gladlol,stormrage,1245,rogue,subtlety,30,13,17
Mylovejunex,tichondrius,1244,rogue,subtlety,18,13,5
Harkknight,sargeras,1244,rogue,subtlety,237,129,108
Dyane,gilneas,1243,rogue,subtlety,121,63,58
Endlesswaltz,zuljin,1243,rogue,subtlety,30,13,17
Towncar,kelthuzad,1242,rogue,subtlety,24,13,11
Moonvertz,barthilas,1242,rogue,subtlety,24,13,11
Vyla,barthilas,1240,rogue,subtlety,30,17,13
Vlone,icecrown,1240,rogue,subtlety,30,13,17
Aleh,exodar,1239,rogue,subtlety,24,13,11
Swingonya,stormrage,1239,rogue,subtlety,24,13,11
Chakal,illidan,1239,rogue,subtlety,24,13,11
Yurkarogue,tichondrius,1238,rogue,subtlety,18,13,5
Stealthkid,tichondrius,1237,rogue,subtlety,24,13,11
Hawwtkunnk,emerald-dream,1237,rogue,subtlety,24,13,11
Autumnsedge,area-52,1237,rogue,subtlety,67,25,42
Riggz,burning-blade,1236,rogue,subtlety,74,35,39
Poofus,vashj,1236,rogue,subtlety,36,14,22
Wiman,quelthalas,1235,rogue,subtlety,30,13,17
Pinksleep,sargeras,1234,rogue,subtlety,54,22,32
Oddblade,stormrage,1232,rogue,subtlety,24,14,10
Poolover,barthilas,1232,rogue,subtlety,24,13,11
Vuye,moon-guard,1228,rogue,subtlety,71,28,43
Johnnymayhem,kelthuzad,1227,rogue,subtlety,30,13,17
Dèàdly,korgath,1225,rogue,subtlety,24,13,11
Draculà,wyrmrest-accord,1225,rogue,subtlety,111,59,52
Lapuamagnum,illidan,1225,rogue,subtlety,30,13,17
Zenshin,tichondrius,1225,rogue,subtlety,46,16,30
Hattrìck,area-52,1224,rogue,subtlety,56,28,28
Scallywag,illidan,1223,rogue,subtlety,24,13,11
Draef,illidan,1223,rogue,subtlety,24,13,11
Abatoire,wyrmrest-accord,1223,rogue,subtlety,79,40,39
Elmabrox,quelthalas,1222,rogue,subtlety,57,27,30
Noriel,dathremar,1218,rogue,subtlety,48,25,23
Stuntedscamp,bleeding-hollow,1218,rogue,subtlety,36,13,23
Iilewisii,mannoroth,1217,rogue,subtlety,42,22,20
Trâshy,stormrage,1215,rogue,subtlety,25,14,11
Riezzoo,malfurion,1214,rogue,subtlety,36,19,17
Boredomkills,frostmane,1213,rogue,subtlety,24,13,11
Sxs,kiljaeden,1213,rogue,subtlety,53,28,25
Quickxsilver,tichondrius,1213,rogue,subtlety,78,35,43
Suñg,tichondrius,1211,rogue,subtlety,30,14,16
Dessenia,illidan,1208,rogue,subtlety,79,47,32
Suffêr,dalaran,1206,rogue,subtlety,42,30,12
Maløkeirø,stormrage,1202,rogue,subtlety,91,41,50
Gougemebaby,emerald-dream,1202,rogue,subtlety,36,15,21
Taroo,ragnaros,1197,rogue,subtlety,71,35,36
Jagó,malganis,1196,rogue,subtlety,24,15,9
Vonyx,area-52,1196,rogue,subtlety,36,16,20
Kylerxius,korgath,1192,rogue,subtlety,36,21,15
Arÿaa,azralon,1189,rogue,subtlety,60,30,30
Geeo,emerald-dream,1188,rogue,subtlety,48,20,28
Felistrien,wyrmrest-accord,1187,rogue,subtlety,75,28,47
Bríng,illidan,1186,rogue,subtlety,65,34,31
Roxeni,tichondrius,1181,rogue,subtlety,28,13,15
Tigbits,frostmourne,1181,rogue,subtlety,32,14,18
Uchihaputin,tichondrius,1181,rogue,subtlety,30,13,17
Gatõ,quelthalas,1181,rogue,subtlety,60,24,36
Rykojin,dalaran,1177,rogue,subtlety,54,29,25
Winze,scilla,1176,rogue,subtlety,66,39,27
Meer,balnazzar,1175,rogue,subtlety,60,39,21
Oilydaimon,tichondrius,1175,rogue,subtlety,71,35,36
Lesliechow,sargeras,1173,rogue,subtlety,88,52,36
Studders,kiljaeden,1172,rogue,subtlety,77,35,42
Writhes,sargeras,1169,rogue,subtlety,20,13,7
Abdullahh,tichondrius,1168,rogue,subtlety,45,25,20
Wokemeup,bleeding-hollow,1168,rogue,subtlety,30,15,15
Pro,burning-legion,1168,rogue,subtlety,42,20,22
Xzert,frostmourne,1164,rogue,subtlety,36,15,21
Bloodraina,hyjal,1163,rogue,subtlety,182,85,97
Betrayerz,darkspear,1157,rogue,subtlety,39,21,18
Gyrfalcon,spirestone,1156,rogue,subtlety,154,72,82
Paulpitation,blood-furnace,1155,rogue,subtlety,39,15,24
Ayo,exodar,1154,rogue,subtlety,30,18,12
Håkünämãtåtä,stormrage,1152,rogue,subtlety,18,12,6
Bèstworld,dalaran,1152,rogue,subtlety,24,12,12
Ppdx,malganis,1150,rogue,subtlety,18,12,6
Alrynik,stormrage,1150,rogue,subtlety,24,14,10
Tizzyb,bleeding-hollow,1149,rogue,subtlety,24,12,12
Teamskitsou,tichondrius,1148,rogue,subtlety,12,12,0
Itskanashi,frostmourne,1148,rogue,subtlety,81,36,45
Terpsaucey,tichondrius,1148,rogue,subtlety,42,14,28
Bswagx,illidan,1147,rogue,subtlety,18,12,6
Drapezz,kelthuzad,1147,rogue,subtlety,59,32,27
Dawkx,thrall,1147,rogue,subtlety,25,13,12
Jalaroot,frostmourne,1146,rogue,subtlety,29,16,13
Dezly,tichondrius,1146,rogue,subtlety,42,12,30
Natalya,stormreaver,1145,rogue,subtlety,18,12,6
Abogansterr,ragnaros,1144,rogue,subtlety,164,84,80
Codeplay,tichondrius,1144,rogue,subtlety,24,12,12
Kaminokage,barthilas,1144,rogue,subtlety,45,15,30
Allirra,ragnaros,1143,rogue,subtlety,56,36,20
Yesuz,illidan,1143,rogue,subtlety,34,19,15
Hattorikun,proudmoore,1142,rogue,subtlety,24,12,12
Poohpants,frostmourne,1140,rogue,subtlety,81,38,43
Smokepipe,nerzhul,1139,rogue,subtlety,24,14,10
Sappedwap,thrall,1138,rogue,subtlety,36,19,17
Zetkx,tichondrius,1138,rogue,subtlety,24,12,12
Smashol,barthilas,1136,rogue,subtlety,54,23,31
Vyserate,malfurion,1136,rogue,subtlety,30,12,18
Salätzar,quelthalas,1135,rogue,subtlety,27,13,14
Gank,jubeithos,1134,rogue,subtlety,24,12,12
Raidei,elune,1134,rogue,subtlety,24,12,12
Zarkans,proudmoore,1133,rogue,subtlety,84,42,42
Bladefang,quelthalas,1131,rogue,subtlety,27,16,11
Micromoon,windrunner,1131,rogue,subtlety,36,13,23
Ninjadoo,tichondrius,1128,rogue,subtlety,18,12,6
Chuckydoll,sargeras,1128,rogue,subtlety,30,12,18
Darkdevilx,tichondrius,1126,rogue,subtlety,36,12,24
Vanishman,ragnaros,1125,rogue,subtlety,30,15,15
Weckful,kelthuzad,1123,rogue,subtlety,24,12,12
Doklim,spinebreaker,1122,rogue,subtlety,74,42,32
Dtelkham,tichondrius,1122,rogue,subtlety,33,13,20
Cutthroat,aegwynn,1121,rogue,subtlety,45,20,25
Sildin,sargeras,1116,rogue,subtlety,36,16,20
Jhors,tichondrius,1114,rogue,subtlety,24,12,12
Cosmogenesis,tichondrius,1114,rogue,subtlety,24,12,12
Jeri,gundrak,1113,rogue,subtlety,30,17,13
Defaces,illidan,1111,rogue,subtlety,18,12,6
Witherblade,area-52,1110,rogue,subtlety,18,12,6
Highwire,stormrage,1108,rogue,subtlety,41,20,21
Kelelor,kelthuzad,1108,rogue,subtlety,57,18,39
Venace,agamaggan,1104,rogue,subtlety,23,12,11
Dagasombria,drakkari,1101,rogue,subtlety,154,77,77
Hayatö,ragnaros,1098,rogue,subtlety,54,30,24
Iheyji,quelthalas,1094,rogue,subtlety,24,14,10
Favès,thrall,1094,rogue,subtlety,102,40,62
Aynrand,drakkari,1094,rogue,subtlety,45,16,29
Prisonshank,arthas,1093,rogue,subtlety,61,36,25
Indivisible,thunderlord,1093,rogue,subtlety,65,33,32
Hellainuis,kelthuzad,1093,rogue,subtlety,41,12,29
Shadownibba,illidan,1091,rogue,subtlety,48,26,22
Stunjunky,area-52,1091,rogue,subtlety,29,12,17
Fangskin,dunemaul,1090,rogue,subtlety,36,19,17
Abaløne,tichondrius,1085,rogue,subtlety,61,26,35
Jaanmonty,frostmourne,1081,rogue,subtlety,24,12,12
Zwielicht,quelthalas,1081,rogue,subtlety,30,14,16
Hiarolson,stormrage,1081,rogue,subtlety,43,20,23
Esker,dragonmaw,1080,rogue,subtlety,192,94,98
Relaxsingh,tichondrius,1076,rogue,subtlety,94,40,54
Romerick,galakrond,1076,rogue,subtlety,36,12,24
Kilrogga,azshara,1074,rogue,subtlety,48,27,21
Peeryl,daggerspine,1071,rogue,subtlety,38,20,18
Riskgo,frostwolf,1071,rogue,subtlety,24,12,12
Imgunnacrumb,malganis,1070,rogue,subtlety,179,85,94
Skallywagg,emerald-dream,1064,rogue,subtlety,80,41,39
Santyno,ragnaros,1058,rogue,subtlety,161,76,85
Sixcombopts,area-52,1056,rogue,subtlety,18,11,7
Deepsyo,frostmourne,1055,rogue,subtlety,18,11,7
Defthands,tichondrius,1055,rogue,subtlety,18,11,7
Silentmoralz,tichondrius,1055,rogue,subtlety,60,24,36
Elwynë,tichondrius,1054,rogue,subtlety,24,11,13
Toestumper,sargeras,1054,rogue,subtlety,41,15,26
Avizura,dragonmaw,1053,rogue,subtlety,18,11,7
Kachimodo,illidan,1053,rogue,subtlety,78,39,39
Rabe,nagrand,1053,rogue,subtlety,24,11,13
Exacerbatê,mannoroth,1052,rogue,subtlety,18,11,7
Sagatha,bleeding-hollow,1052,rogue,subtlety,18,11,7
Brilliance,skywall,1051,rogue,subtlety,24,11,13
Boonee,frostmourne,1051,rogue,subtlety,24,11,13
Zelzaramor,ravenholdt,1051,rogue,subtlety,34,13,21
Roguish,kiljaeden,1051,rogue,subtlety,38,14,24
Distract,quelthalas,1050,rogue,subtlety,18,11,7
Corntens,area-52,1050,rogue,subtlety,20,11,9
Stelarstop,drakkari,1050,rogue,subtlety,54,18,36
Varyk,amanthul,1049,rogue,subtlety,18,11,7
Omgmoon,ragnaros,1048,rogue,subtlety,12,11,1
Liquidmojo,tichondrius,1048,rogue,subtlety,18,11,7
Négrá,ragnaros,1048,rogue,subtlety,18,11,7
Nadari,cenarius,1048,rogue,subtlety,66,31,35
Ðarkrøøxs,stormrage,1048,rogue,subtlety,24,11,13
Waytoosext,tichondrius,1048,rogue,subtlety,24,11,13
Trolladrão,goldrinn,1048,rogue,subtlety,24,11,13
Mermm,burning-blade,1048,rogue,subtlety,24,11,13
Sneaknfizzle,dethecus,1047,rogue,subtlety,30,15,15
Xalsathoth,sargeras,1045,rogue,subtlety,24,11,13
Laotrec,nemesis,1045,rogue,subtlety,33,12,21
Ivanapavlov,kelthuzad,1045,rogue,subtlety,41,14,27
Srmazakre,ragnaros,1044,rogue,subtlety,30,12,18
Olg,arathor,1043,rogue,subtlety,71,36,35
Hyperdexia,stormrage,1042,rogue,subtlety,88,47,41
Prõdigy,blackrock,1041,rogue,subtlety,20,13,7
Lyliym,frostmourne,1041,rogue,subtlety,18,11,7
Soulvex,barthilas,1040,rogue,subtlety,18,11,7
Topsailor,uther,1039,rogue,subtlety,54,26,28
Glatzkaus,shattered-hand,1039,rogue,subtlety,24,11,13
Yunaka,grizzly-hills,1039,rogue,subtlety,54,18,36
Rarkalth,azralon,1033,rogue,subtlety,53,18,35
Relidria,thrall,1032,rogue,subtlety,36,22,14
Drpepzi,tichondrius,1025,rogue,subtlety,81,31,50
Undreas,kiljaeden,1022,rogue,subtlety,423,211,212
Topapple,mugthol,1021,rogue,subtlety,30,14,16
Maewyn,aerie-peak,1019,rogue,subtlety,25,11,14
Sneakyshots,emerald-dream,1017,rogue,subtlety,13,11,2
Emøtions,darkspear,1016,rogue,subtlety,18,11,7
Slackness,bleeding-hollow,1015,rogue,subtlety,67,38,29
Fateapocryph,azralon,1014,rogue,subtlety,26,13,13
Bimbogirl,dalaran,1011,rogue,subtlety,52,29,23
Korviz,area-52,1008,rogue,subtlety,60,30,30
Bloodwish,tichondrius,1007,rogue,subtlety,23,11,12
Ghost,shattered-halls,1006,rogue,subtlety,68,27,41
Log,blackhand,1004,rogue,subtlety,36,18,18
Onara,quelthalas,1003,rogue,subtlety,30,18,12
Kidcudi,bonechewer,1000,rogue,subtlety,48,18,30
Respia,proudmoore,995,rogue,subtlety,26,12,14
Frostybeers,kelthuzad,994,rogue,subtlety,48,17,31
Feragho,tichondrius,992,rogue,subtlety,34,11,23
Sadtears,thrall,990,rogue,subtlety,16,11,5
Pilz,malganis,990,rogue,subtlety,30,11,19
Deathwishx,tichondrius,988,rogue,subtlety,22,11,11
Trïxxy,stormrage,981,rogue,subtlety,48,21,27
Bubblesr,whisperwind,980,rogue,subtlety,48,22,26
Darthdad,bleeding-hollow,974,rogue,subtlety,42,12,30
Mcghanhain,aegwynn,967,rogue,subtlety,54,23,31
Toe,boulderfist,964,rogue,subtlety,51,25,26
Ascherx,veknilash,960,rogue,subtlety,12,10,2
Lilacdiesel,stormrage,960,rogue,subtlety,12,10,2
Geckø,sargeras,959,rogue,subtlety,12,10,2
Geartrix,darkspear,959,rogue,subtlety,16,11,5
Spaca,kelthuzad,959,rogue,subtlety,18,10,8
Clerncc,emerald-dream,959,rogue,subtlety,18,10,8
Caldø,tichondrius,958,rogue,subtlety,12,10,2
Sapnfappqt,dalaran,958,rogue,subtlety,15,10,5
Fystrong,kelthuzad,958,rogue,subtlety,18,10,8
Lucki,tichondrius,958,rogue,subtlety,18,10,8
Lenik,azuremyst,958,rogue,subtlety,18,10,8
Jannie,rexxar,958,rogue,subtlety,18,10,8
Aszombie,tichondrius,957,rogue,subtlety,12,10,2
Teribád,area-52,957,rogue,subtlety,18,10,8
Rooke,draktharon,957,rogue,subtlety,24,10,14
Reclusivexo,tichondrius,956,rogue,subtlety,24,10,14
Merkules,dalaran,955,rogue,subtlety,16,11,5
Smakkey,tichondrius,955,rogue,subtlety,18,10,8
Flavored,bloodhoof,955,rogue,subtlety,24,10,14
Înfêrnô,emerald-dream,955,rogue,subtlety,24,10,14
Atulano,wyrmrest-accord,955,rogue,subtlety,24,10,14
Poogodx,proudmoore,954,rogue,subtlety,12,10,2
Keepitshadow,frostmourne,953,rogue,subtlety,18,10,8
Moufwash,sargeras,952,rogue,subtlety,24,10,14
Crucifur,anvilmar,952,rogue,subtlety,24,10,14
Thejizz,kiljaeden,952,rogue,subtlety,24,10,14
Wolfsfang,frostmourne,951,rogue,subtlety,19,10,9
Juanightstnd,bleeding-hollow,950,rogue,subtlety,24,10,14
Burningfury,arthas,950,rogue,subtlety,24,10,14
Bootyboo,tichondrius,948,rogue,subtlety,25,16,9
Arwy,stormrage,948,rogue,subtlety,19,11,8
Wubbz,stormrage,947,rogue,subtlety,12,10,2
Drspreader,area-52,946,rogue,subtlety,21,11,10
Definitioni,area-52,945,rogue,subtlety,19,10,9
Backstàb,durotan,944,rogue,subtlety,24,13,11
Aruldyr,zuljin,938,rogue,subtlety,31,11,20
Trinktick,doomhammer,931,rogue,subtlety,30,10,20
Blindedu,dalaran,930,rogue,subtlety,24,10,14
Zamji,tichondrius,928,rogue,subtlety,26,12,14
Machinshin,dalaran,927,rogue,subtlety,30,10,20
Shadowspain,malganis,926,rogue,subtlety,24,10,14
Timat,emerald-dream,924,rogue,subtlety,23,10,13
Poisonstrike,khazgoroth,920,rogue,subtlety,17,10,7
Swayo,tichondrius,920,rogue,subtlety,18,10,8
Beartøøth,stormrage,919,rogue,subtlety,18,10,8
Rouzh,sargeras,910,rogue,subtlety,17,10,7
Êxx,jubeithos,909,rogue,subtlety,17,10,7
Deathben,tichondrius,908,rogue,subtlety,71,21,50
Spleen,aerie-peak,906,rogue,subtlety,21,10,11
Degrok,quelthalas,902,rogue,subtlety,77,38,39
Cerel,baelgun,896,rogue,subtlety,48,13,35
Mhün,malganis,891,rogue,subtlety,22,10,12
Chancelör,illidan,890,rogue,subtlety,18,11,7
Dyverse,stormrage,877,rogue,subtlety,17,12,5
Lemeeng,uldum,869,rogue,subtlety,36,16,20
Poonqtxo,frostmourne,864,rogue,subtlety,12,9,3
Slyborg,tichondrius,864,rogue,subtlety,12,9,3
Chainsarogue,stormrage,864,rogue,subtlety,12,9,3
Scythix,firetree,864,rogue,subtlety,12,9,3
Yodiegang,tichondrius,864,rogue,subtlety,12,9,3
Xvic,bleeding-hollow,864,rogue,subtlety,12,9,3
Nerfretnow,tichondrius,864,rogue,subtlety,12,9,3
Sitdownplz,darkspear,864,rogue,subtlety,15,10,5
Stopthecap,tichondrius,863,rogue,subtlety,18,9,9
Nemoye,tichondrius,863,rogue,subtlety,18,9,9
Shadaux,frostmourne,863,rogue,subtlety,18,9,9
Indiecompany,moon-guard,863,rogue,subtlety,18,9,9
Lunatixz,emerald-dream,863,rogue,subtlety,18,9,9
Wimpz,hyjal,863,rogue,subtlety,18,9,9
Uglysrogue,sargeras,863,rogue,subtlety,18,9,9
Popss,whisperwind,863,rogue,subtlety,18,9,9
Ãnimefãnx,moon-guard,863,rogue,subtlety,18,9,9
Rassiter,stonemaul,863,rogue,subtlety,24,9,15
Twnice,tichondrius,863,rogue,subtlety,24,9,15
Jexy,barthilas,863,rogue,subtlety,24,9,15
Alaeá,stormrage,863,rogue,subtlety,24,9,15
Illoo,frostmourne,863,rogue,subtlety,24,9,15
Proddivus,stormrage,863,rogue,subtlety,30,9,21
Jácket,area-52,863,rogue,subtlety,30,9,21
Athletik,tichondrius,862,rogue,subtlety,18,9,9
Jamo,kiljaeden,862,rogue,subtlety,18,9,9
Letsparty,malganis,862,rogue,subtlety,18,9,9
Confianzudo,ragnaros,862,rogue,subtlety,54,24,30
Blitzree,thrall,861,rogue,subtlety,12,9,3
Cosmicò,trollbane,861,rogue,subtlety,12,9,3
Snewdaddy,malganis,861,rogue,subtlety,18,9,9
Filid,frostmourne,861,rogue,subtlety,18,9,9
Lennysnephew,tichondrius,861,rogue,subtlety,24,9,15
Biggisdiggis,tichondrius,860,rogue,subtlety,12,9,3
Lanres,stormrage,860,rogue,subtlety,12,9,3
Christiaan,area-52,860,rogue,subtlety,18,9,9
Mcnastier,dunemaul,860,rogue,subtlety,18,9,9
Beretta,nemesis,860,rogue,subtlety,24,9,15
Larceny,emerald-dream,860,rogue,subtlety,24,9,15
Gaonasi,tichondrius,859,rogue,subtlety,12,9,3
Oío,ragnaros,859,rogue,subtlety,15,10,5
Aoki,tichondrius,859,rogue,subtlety,24,9,15
Brand,bonechewer,859,rogue,subtlety,36,9,27
Gannjalord,frostmane,858,rogue,subtlety,22,10,12
Pumpp,dentarg,858,rogue,subtlety,24,9,15
Chebs,illidan,857,rogue,subtlety,24,9,15
Bubblesrr,whisperwind,857,rogue,subtlety,32,9,23
Calvin,moon-guard,856,rogue,subtlety,18,9,9
Wrekstun,area-52,855,rogue,subtlety,24,9,15
Drekha,tichondrius,854,rogue,subtlety,28,10,18
Vendettã,skullcrusher,853,rogue,subtlety,12,9,3
Aitormenta,ragnaros,851,rogue,subtlety,18,9,9
Dizzm,area-52,847,rogue,subtlety,12,9,3
Shadowpunx,nemesis,846,rogue,subtlety,12,9,3
Aelnoor,ragnaros,846,rogue,subtlety,24,9,15
Caveil,stormrage,845,rogue,subtlety,17,9,8
Cutindle,illidan,842,rogue,subtlety,18,9,9
Brocolini,zuljin,841,rogue,subtlety,30,12,18
Elßronkas,quelthalas,836,rogue,subtlety,48,21,27
Ýazim,tichondrius,832,rogue,subtlety,16,9,7
Sorieg,azralon,831,rogue,subtlety,22,11,11
Paraisbae,tichondrius,829,rogue,subtlety,14,10,4
Zôliath,tichondrius,829,rogue,subtlety,28,9,19
Eversincee,illidan,814,rogue,subtlety,15,9,6
Xmystery,illidan,812,rogue,subtlety,21,9,12
Fearnomore,destromath,811,rogue,subtlety,120,46,74
Raylo,blackhand,807,rogue,subtlety,24,11,13
Vandalyze,sargeras,805,rogue,subtlety,19,10,9
Autumn,boulderfist,803,rogue,subtlety,42,17,25
Dogedealer,ragnaros,801,rogue,subtlety,22,11,11
Hezi,area-52,799,rogue,subtlety,11,9,2
Zaghat,ragnaros,799,rogue,subtlety,22,9,13
Xaidra,bleeding-hollow,798,rogue,subtlety,17,9,8
Mercaderps,frostmourne,798,rogue,subtlety,33,9,24
Nakedps,garona,797,rogue,subtlety,18,9,9
Sheinnér,ragnaros,797,rogue,subtlety,24,9,15
Trillkage,tichondrius,797,rogue,subtlety,26,9,17
Alexon,wyrmrest-accord,791,rogue,subtlety,89,36,53
Zelthy,frostmourne,790,rogue,subtlety,17,9,8
Redtvco,blackrock,789,rogue,subtlety,17,9,8
Samllnuts,area-52,789,rogue,subtlety,30,11,19
Treeless,wyrmrest-accord,785,rogue,subtlety,31,11,20
Zeenxz,tichondrius,768,rogue,subtlety,12,8,4
Astutý,illidan,768,rogue,subtlety,12,8,4
Wîzz,bleeding-hollow,768,rogue,subtlety,12,8,4
Khyrax,tichondrius,768,rogue,subtlety,12,8,4
Cójáx,dalaran,768,rogue,subtlety,12,8,4
Nicørøbin,tichondrius,768,rogue,subtlety,12,8,4
Austínrh,sargeras,768,rogue,subtlety,12,8,4
Evilthunder,illidan,768,rogue,subtlety,12,8,4
Czd,frostmourne,768,rogue,subtlety,12,8,4
Commodore,arthas,768,rogue,subtlety,12,8,4
Jòwtzy,ragnaros,768,rogue,subtlety,18,8,10
Nlynn,veknilash,768,rogue,subtlety,18,8,10
Ascénd,sargeras,768,rogue,subtlety,18,8,10
Heegawn,proudmoore,768,rogue,subtlety,18,8,10
Bungou,tichondrius,768,rogue,subtlety,18,8,10
Calxnnight,terenas,768,rogue,subtlety,18,8,10
Getfkdkid,tichondrius,768,rogue,subtlety,24,8,16
Swippz,tichondrius,768,rogue,subtlety,24,8,16
Drunknclapz,bleeding-hollow,767,rogue,subtlety,12,8,4
Assasinww,sargeras,767,rogue,subtlety,12,8,4
Kiingspade,tichondrius,767,rogue,subtlety,12,8,4
Gankbang,mugthol,767,rogue,subtlety,12,8,4
Pokekek,stormrage,767,rogue,subtlety,18,8,10
Ilesire,frostmourne,767,rogue,subtlety,18,8,10
Candren,area-52,767,rogue,subtlety,18,8,10
Steeldiesel,sargeras,767,rogue,subtlety,18,8,10
Siyerogue,illidan,767,rogue,subtlety,18,8,10
Antmang,bleeding-hollow,767,rogue,subtlety,18,8,10
Microcore,sargeras,767,rogue,subtlety,18,8,10
Zapstr,bleeding-hollow,766,rogue,subtlety,12,8,4
Unholydood,bonechewer,766,rogue,subtlety,18,8,10
Razmir,malfurion,766,rogue,subtlety,18,8,10
Twinkrogue,firetree,766,rogue,subtlety,18,8,10
Ntshaav,illidan,766,rogue,subtlety,18,8,10
Pipit,barthilas,765,rogue,subtlety,16,9,7
Kody,dalaran,765,rogue,subtlety,21,9,12
Yato,mugthol,764,rogue,subtlety,12,8,4
Subtlepuddle,bleeding-hollow,764,rogue,subtlety,24,8,16
Vexyz,tichondrius,763,rogue,subtlety,18,8,10
ßackshots,kelthuzad,763,rogue,subtlety,18,8,10
Shadonas,maelstrom,763,rogue,subtlety,24,8,16
Gaiuscaesa,moon-guard,763,rogue,subtlety,24,8,16
Wolfmans,trollbane,762,rogue,subtlety,12,8,4
Shivlightnin,tichondrius,762,rogue,subtlety,24,8,16
Veatrix,zuljin,761,rogue,subtlety,24,8,16
Píxíedúst,black-dragonflight,761,rogue,subtlety,24,8,16
Psychostabby,tichondrius,761,rogue,subtlety,30,8,22
Mhasto,azralon,759,rogue,subtlety,18,8,10
Swisha,dathremar,759,rogue,subtlety,18,8,10
Sathrion,zuljin,758,rogue,subtlety,26,10,16
Kerimoynihan,barthilas,757,rogue,subtlety,28,11,17
Nijanari,wyrmrest-accord,754,rogue,subtlety,24,8,16
Screwzx,tichondrius,750,rogue,subtlety,17,8,9
Nuff,emerald-dream,736,rogue,subtlety,16,8,8
Tyroshiv,area-52,732,rogue,subtlety,24,9,15
Dedrater,shadowmoon,728,rogue,subtlety,23,8,15
Lilshortyaya,stormrage,719,rogue,subtlety,15,8,7
Reportlowdps,tichondrius,718,rogue,subtlety,11,8,3
Foxolnite,illidan,718,rogue,subtlety,21,8,13
Lerosi,malganis,718,rogue,subtlety,75,21,54
Yurico,zuljin,717,rogue,subtlety,17,8,9
Earkeeper,wildhammer,714,rogue,subtlety,14,9,5
Papiplunders,sargeras,687,rogue,subtlety,13,8,5
Voldir,cenarion-circle,672,rogue,subtlety,12,7,5
Frooty,stormrage,672,rogue,subtlety,12,7,5
Darkstár,bladefist,672,rogue,subtlety,12,7,5
Yangsol,stormrage,672,rogue,subtlety,12,7,5
Ustunned,stormrage,672,rogue,subtlety,12,7,5
Bloodyhairy,area-52,672,rogue,subtlety,12,7,5
Joeyzord,stormrage,672,rogue,subtlety,12,7,5
Ascherx,illidan,672,rogue,subtlety,12,7,5
Slÿborg,tichondrius,672,rogue,subtlety,12,7,5
Coughsyrup,sargeras,672,rogue,subtlety,12,7,5
Bobfoonk,tichondrius,672,rogue,subtlety,12,7,5
Xaander,nazjatar,672,rogue,subtlety,12,7,5
Adhd,ravencrest,672,rogue,subtlety,12,7,5
Roguekofwa,tichondrius,672,rogue,subtlety,12,7,5
Invokesap,area-52,672,rogue,subtlety,12,7,5
Saraku,barthilas,672,rogue,subtlety,12,7,5
Syxs,sargeras,672,rogue,subtlety,12,7,5
Feyahni,wyrmrest-accord,672,rogue,subtlety,12,7,5
Caliph,malganis,672,rogue,subtlety,12,7,5
Anßu,malganis,672,rogue,subtlety,12,7,5
Àsgà,area-52,672,rogue,subtlety,12,7,5
Orctheripper,garona,672,rogue,subtlety,12,7,5
Flaremagnet,whisperwind,672,rogue,subtlety,12,7,5
Djsyn,bleeding-hollow,672,rogue,subtlety,12,7,5
Gertrix,darkspear,672,rogue,subtlety,12,7,5
Loria,cenarion-circle,672,rogue,subtlety,15,8,7
Spytes,kiljaeden,672,rogue,subtlety,18,7,11
Patey,malganis,672,rogue,subtlety,18,7,11
Dupababayaga,stormrage,672,rogue,subtlety,18,7,11
Dycrons,lightbringer,672,rogue,subtlety,18,7,11
Memoríst,frostmourne,672,rogue,subtlety,18,7,11
Adao,tichondrius,672,rogue,subtlety,18,7,11
Niwbor,azralon,672,rogue,subtlety,24,7,17
Tekrul,area-52,672,rogue,subtlety,30,7,23
Skitnim,tichondrius,671,rogue,subtlety,12,7,5
Flattsr,tichondrius,671,rogue,subtlety,12,7,5
Energetìc,stormrage,671,rogue,subtlety,12,7,5
Deadsilenth,daggerspine,671,rogue,subtlety,12,7,5
Kidkillz,tichondrius,671,rogue,subtlety,12,7,5
Chokonet,gurubashi,671,rogue,subtlety,12,7,5
Keytürns,frostmourne,671,rogue,subtlety,12,7,5
Shadowoog,tichondrius,671,rogue,subtlety,12,7,5
Xemnxnt,stormrage,671,rogue,subtlety,12,7,5
Nezumikami,malganis,671,rogue,subtlety,18,7,11
Calimari,frostmourne,671,rogue,subtlety,18,7,11
Sapzz,tichondrius,671,rogue,subtlety,18,7,11
Henya,magtheridon,671,rogue,subtlety,18,7,11
Multik,tichondrius,671,rogue,subtlety,18,7,11
Rotjaw,hydraxis,670,rogue,subtlety,18,7,11
Zavrus,kelthuzad,670,rogue,subtlety,18,7,11
Takamoto,windrunner,670,rogue,subtlety,18,7,11
Ohnoyoudont,dragonmaw,669,rogue,subtlety,12,7,5
Anteccessor,tichondrius,669,rogue,subtlety,18,7,11
Bõjack,stormrage,669,rogue,subtlety,18,7,11
Rovvo,queldorei,669,rogue,subtlety,24,7,17
Projectx,tichondrius,668,rogue,subtlety,15,8,7
Brettmckjnr,saurfang,668,rogue,subtlety,18,7,11
Chompycat,tichondrius,667,rogue,subtlety,18,7,11
Zapersapp,malygos,666,rogue,subtlety,24,7,17
Schnozz,lightbringer,665,rogue,subtlety,12,7,5
Dritzt,eredar,659,rogue,subtlety,12,7,5
Gotchabak,stormrage,659,rogue,subtlety,12,7,5
Jjp,tichondrius,655,rogue,subtlety,17,7,10
Knife,moon-guard,651,rogue,subtlety,24,7,17
Howlrunner,medivh,650,rogue,subtlety,17,8,9
Sodomh,aegwynn,644,rogue,subtlety,65,29,36
Zaozaa,frostmourne,639,rogue,subtlety,14,8,6
Phyzzi,kargath,639,rogue,subtlety,17,7,10
Flazy,sargeras,623,rogue,subtlety,11,7,4
Coldkill,bleeding-hollow,623,rogue,subtlety,11,7,4
Diox,nemesis,623,rogue,subtlety,17,7,10
Undalack,ragnaros,621,rogue,subtlety,21,7,14
Carpe,barthilas,618,rogue,subtlety,24,8,16
Namig,cenarion-circle,608,rogue,subtlety,10,7,3
Deadshank,bleeding-hollow,576,rogue,subtlety,6,6,0
Donçorleone,stormrage,576,rogue,subtlety,6,6,0
Homarx,quelthalas,576,rogue,subtlety,10,7,3
Lymon,azralon,576,rogue,subtlety,12,6,6
Avelmire,sargeras,576,rogue,subtlety,12,6,6
Rdt,durotan,576,rogue,subtlety,12,6,6
Shadxr,tichondrius,576,rogue,subtlety,12,6,6
Gibsons,quelthalas,576,rogue,subtlety,12,6,6
Whooxx,khazgoroth,576,rogue,subtlety,12,6,6
Sivni,tichondrius,576,rogue,subtlety,12,6,6
Tußshark,kelthuzad,576,rogue,subtlety,12,6,6
Palumor,deathwing,576,rogue,subtlety,12,6,6
Pingwii,ragnaros,576,rogue,subtlety,12,6,6
Tmpikaboo,mugthol,576,rogue,subtlety,12,6,6
Wongcha,darkspear,576,rogue,subtlety,12,6,6
Pamaaj,sargeras,576,rogue,subtlety,12,6,6
Rogueaqui,azralon,576,rogue,subtlety,12,6,6
Dërpt,tichondrius,576,rogue,subtlety,12,6,6
Revila,bleeding-hollow,576,rogue,subtlety,12,6,6
Littlescrub,frostmourne,576,rogue,subtlety,12,6,6
Kindasorry,illidan,576,rogue,subtlety,12,6,6
Daradria,stormrage,576,rogue,subtlety,12,6,6
Evaru,tichondrius,576,rogue,subtlety,12,6,6
Xedi,illidan,576,rogue,subtlety,12,6,6
Subgodx,stormrage,576,rogue,subtlety,12,6,6
Donpeon,hellscream,576,rogue,subtlety,12,6,6
Baßyøða,stormrage,576,rogue,subtlety,12,6,6
Draiygo,nerzhul,576,rogue,subtlety,12,6,6
Fkq,emerald-dream,576,rogue,subtlety,12,6,6
Mistrjack,kelthuzad,576,rogue,subtlety,12,6,6
Sevrow,wyrmrest-accord,576,rogue,subtlety,13,6,7
Drakariano,ragnaros,576,rogue,subtlety,18,6,12
Dralax,ragnaros,576,rogue,subtlety,18,6,12
Veterån,tichondrius,576,rogue,subtlety,18,6,12
Ghosted,thrall,576,rogue,subtlety,18,6,12
Cinnashank,darkspear,576,rogue,subtlety,18,6,12
Subterfuge,sargeras,576,rogue,subtlety,19,6,13
Struggle,sargeras,576,rogue,subtlety,24,6,18
Whothekilla,tichondrius,575,rogue,subtlety,12,6,6
Azanax,area-52,575,rogue,subtlety,12,6,6
Maulgryve,frostwolf,575,rogue,subtlety,12,6,6
Jinxkiller,tichondrius,575,rogue,subtlety,12,6,6
Bumboklaat,bleeding-hollow,575,rogue,subtlety,12,6,6
Hhushh,thunderlord,575,rogue,subtlety,12,6,6
Jôrach,area-52,575,rogue,subtlety,12,6,6
Nikosneako,tichondrius,575,rogue,subtlety,12,6,6
Zogbu,stormrage,575,rogue,subtlety,18,6,12
Dreamcatcher,azralon,575,rogue,subtlety,18,6,12
Hindpaw,wyrmrest-accord,575,rogue,subtlety,18,6,12
Ekans,aegwynn,574,rogue,subtlety,6,6,0
Tòúka,stormrage,574,rogue,subtlety,18,6,12
Karing,onyxia,574,rogue,subtlety,18,6,12
Catoline,bleeding-hollow,574,rogue,subtlety,18,6,12
Alttee,proudmoore,573,rogue,subtlety,12,6,6
Strôbéy,tichondrius,573,rogue,subtlety,24,6,18
Jowelyrandy,drakkari,573,rogue,subtlety,25,6,19
Warghostpvp,illidan,572,rogue,subtlety,12,6,6
Darkpaths,hyjal,572,rogue,subtlety,12,6,6
Vozzy,proudmoore,572,rogue,subtlety,12,6,6
Iapologize,area-52,572,rogue,subtlety,12,6,6
Supminty,stormrage,571,rogue,subtlety,12,6,6
Xylow,garona,571,rogue,subtlety,27,6,21
Rotbreath,bleeding-hollow,557,rogue,subtlety,23,6,17
Pancakestab,saurfang,543,rogue,subtlety,14,7,7
Elsegador,tichondrius,527,rogue,subtlety,21,7,14
Wildtrick,greymane,511,rogue,subtlety,32,8,24
Calamityx,cenarius,480,rogue,subtlety,6,5,1
Ghoarie,sargeras,480,rogue,subtlety,6,5,1
Kwins,cenarion-circle,480,rogue,subtlety,6,5,1
Alathir,tichondrius,480,rogue,subtlety,6,5,1
Lowkn,tichondrius,480,rogue,subtlety,6,5,1
Matek,darkspear,480,rogue,subtlety,6,5,1
Oceboomer,frostmourne,480,rogue,subtlety,6,5,1
Jowtzsimp,ragnaros,480,rogue,subtlety,6,5,1
Ethxn,sargeras,480,rogue,subtlety,6,5,1
Sneekyb,gorefiend,480,rogue,subtlety,6,5,1
Nodeßurglar,kelthuzad,480,rogue,subtlety,6,5,1
Killdrunk,stormrage,480,rogue,subtlety,12,5,7
Shivalri,tichondrius,480,rogue,subtlety,12,5,7
Wadge,zuljin,480,rogue,subtlety,12,5,7
Pwnsauce,frostmourne,480,rogue,subtlety,12,5,7
Hassanssin,area-52,480,rogue,subtlety,12,5,7
Mikènuttz,sargeras,480,rogue,subtlety,12,5,7
Blakezillax,tichondrius,480,rogue,subtlety,12,5,7
Reaperprime,tichondrius,480,rogue,subtlety,12,5,7
Liqwid,stormrage,480,rogue,subtlety,12,5,7
Pjh,sargeras,480,rogue,subtlety,12,5,7
Chimpo,ravencrest,480,rogue,subtlety,12,5,7
Jâm,nerzhul,480,rogue,subtlety,12,5,7
Uni,khadgar,480,rogue,subtlety,12,5,7
Sunalor,malganis,480,rogue,subtlety,12,5,7
Minimumwage,bleeding-hollow,480,rogue,subtlety,12,5,7
Invkill,azralon,480,rogue,subtlety,12,5,7
Drunknchaos,bleeding-hollow,480,rogue,subtlety,12,5,7
Cheese,the-venture-co,480,rogue,subtlety,12,5,7
Kenyel,frostmourne,480,rogue,subtlety,12,5,7
Wooluncle,tichondrius,480,rogue,subtlety,12,5,7
Milafortnite,tichondrius,480,rogue,subtlety,12,5,7
Bruitzyttv,barthilas,480,rogue,subtlety,12,5,7
Mitra,eredar,480,rogue,subtlety,12,5,7
Harasna,emerald-dream,480,rogue,subtlety,12,5,7
Scrubzz,barthilas,480,rogue,subtlety,12,5,7
Tessialith,azralon,480,rogue,subtlety,12,5,7
Sinary,cenarion-circle,480,rogue,subtlety,12,5,7
Ricosap,frostmourne,480,rogue,subtlety,12,5,7
Söda,emerald-dream,480,rogue,subtlety,12,5,7
Biöhazard,ragnaros,480,rogue,subtlety,12,5,7
Ninjintwo,illidan,480,rogue,subtlety,12,5,7
Recktzful,ragnaros,480,rogue,subtlety,12,5,7
Ifríend,emerald-dream,480,rogue,subtlety,12,5,7
Jean,tichondrius,480,rogue,subtlety,12,5,7
Shaisty,malganis,480,rogue,subtlety,12,5,7
Caras,tichondrius,480,rogue,subtlety,12,5,7
Beefdaddydev,kargath,480,rogue,subtlety,12,5,7
Aldessa,draka,480,rogue,subtlety,12,5,7
Isonlydosex,tichondrius,480,rogue,subtlety,12,5,7
Monkeykongr,lightnings-blade,480,rogue,subtlety,12,5,7
Arsènè,whisperwind,480,rogue,subtlety,13,5,8
Valrec,stormrage,480,rogue,subtlety,16,5,11
Greyleywin,azralon,480,rogue,subtlety,18,5,13
Åmg,tichondrius,480,rogue,subtlety,18,5,13
Marshischunk,illidan,480,rogue,subtlety,18,5,13
Whyumadbrah,shattered-halls,480,rogue,subtlety,18,5,13
Seerenai,moon-guard,480,rogue,subtlety,18,5,13
Zitihait,amanthul,479,rogue,subtlety,6,5,1
Lacero,bonechewer,479,rogue,subtlety,12,5,7
Qlog,tichondrius,479,rogue,subtlety,12,5,7
Deathbeacøn,sargeras,479,rogue,subtlety,12,5,7
Smokapõtamus,tichondrius,479,rogue,subtlety,12,5,7
Toodlles,stormrage,479,rogue,subtlety,12,5,7
Minato,eredar,479,rogue,subtlety,12,5,7
Crypblade,sargeras,479,rogue,subtlety,12,5,7
Luoan,emerald-dream,479,rogue,subtlety,12,5,7
Jakeharvey,dalaran,479,rogue,subtlety,18,5,13
Corchô,moon-guard,479,rogue,subtlety,18,5,13
Marìus,moon-guard,479,rogue,subtlety,18,5,13
Killerupdown,muradin,479,rogue,subtlety,18,5,13
Gutpunch,kelthuzad,479,rogue,subtlety,18,5,13
Tikirum,tichondrius,479,rogue,subtlety,18,5,13
Kekdasneak,dragonmaw,479,rogue,subtlety,18,5,13
Roba,quelthalas,478,rogue,subtlety,6,5,1
Fouzz,stormrage,478,rogue,subtlety,15,6,9
Falra,wyrmrest-accord,478,rogue,subtlety,18,5,13
Muffens,alterac-mountains,476,rogue,subtlety,12,5,7
Liamoz,amanthul,475,rogue,subtlety,12,5,7
Hyunco,tichondrius,474,rogue,subtlety,12,5,7
Murdistino,tichondrius,472,rogue,subtlety,12,5,7
Soultakerr,whisperwind,461,rogue,subtlety,23,5,18
Bernardi,uther,447,rogue,subtlety,11,5,6
Anbuartist,dalaran,447,rogue,subtlety,11,5,6
Backtoch,sargeras,447,rogue,subtlety,11,5,6
Fingolfin,terenas,447,rogue,subtlety,11,5,6
Notlim,azralon,432,rogue,subtlety,15,5,10
Pangppy,tichondrius,431,rogue,subtlety,11,5,6
Akhila,stormrage,431,rogue,subtlety,11,5,6
Picaropanda,quelthalas,425,rogue,subtlety,22,6,16
Mdrogue,sargeras,416,rogue,subtlety,10,5,5
Cayladin,tichondrius,416,rogue,subtlety,10,5,5
Kathërïnë,azralon,415,rogue,subtlety,16,5,11
Carnagê,zuljin,413,rogue,subtlety,14,5,9
Snobbish,tichondrius,384,rogue,subtlety,6,4,2
Kurosh,kalecgos,384,rogue,subtlety,6,4,2
Starhound,kiljaeden,384,rogue,subtlety,6,4,2
Gloóm,stormrage,384,rogue,subtlety,6,4,2
Dåve,tichondrius,384,rogue,subtlety,6,4,2
Rïddïck,tichondrius,384,rogue,subtlety,6,4,2
Bøyz,blackrock,384,rogue,subtlety,6,4,2
Zerorog,zuljin,384,rogue,subtlety,6,4,2
Onezik,stormrage,384,rogue,subtlety,6,4,2
Chauva,zuljin,384,rogue,subtlety,6,4,2
Sorv,tichondrius,384,rogue,subtlety,6,4,2
Mirlol,stormrage,384,rogue,subtlety,6,4,2
Suggmadi,stormrage,384,rogue,subtlety,6,4,2
Nichala,tichondrius,384,rogue,subtlety,6,4,2
Vexaryon,quelthalas,384,rogue,subtlety,6,4,2
Mcjagerx,darkspear,384,rogue,subtlety,6,4,2
Foreverioi,tichondrius,384,rogue,subtlety,6,4,2
Blackkula,tichondrius,384,rogue,subtlety,6,4,2
Sapntapx,malganis,384,rogue,subtlety,6,4,2
Prepcoin,malganis,384,rogue,subtlety,6,4,2
Bilbobagginz,malganis,384,rogue,subtlety,6,4,2
Emvee,kelthuzad,384,rogue,subtlety,6,4,2
Agilityrush,stormrage,384,rogue,subtlety,6,4,2
Mastrshreddr,kelthuzad,384,rogue,subtlety,6,4,2
Evasionx,tichondrius,384,rogue,subtlety,6,4,2
Deadopps,stormrage,384,rogue,subtlety,6,4,2
Wrldstars,illidan,384,rogue,subtlety,6,4,2
Bootimus,illidan,384,rogue,subtlety,6,4,2
Unoshade,illidan,384,rogue,subtlety,6,4,2
Memnõch,emerald-dream,384,rogue,subtlety,6,4,2
Sapafapa,illidan,384,rogue,subtlety,6,4,2
Averagerogue,thrall,384,rogue,subtlety,6,4,2
Scarablade,bleeding-hollow,384,rogue,subtlety,6,4,2
Malgoria,tichondrius,384,rogue,subtlety,6,4,2
Fortie,moon-guard,384,rogue,subtlety,6,4,2
Roberto,darkspear,384,rogue,subtlety,6,4,2
Smackíngton,tichondrius,384,rogue,subtlety,6,4,2
Mud,saurfang,384,rogue,subtlety,6,4,2
Austínr,sargeras,384,rogue,subtlety,6,4,2
Altaureen,thrall,384,rogue,subtlety,6,4,2
Deejey,frostmourne,384,rogue,subtlety,6,4,2
Skargis,hellscream,384,rogue,subtlety,6,4,2
Jasam,daggerspine,384,rogue,subtlety,9,5,4
Moshington,kelthuzad,384,rogue,subtlety,8,4,4
Xikoro,emerald-dream,384,rogue,subtlety,12,4,8
Etyop,azralon,384,rogue,subtlety,12,4,8
Tàlion,emerald-dream,384,rogue,subtlety,12,4,8
Elishadowed,proudmoore,384,rogue,subtlety,12,4,8
Freshcakes,darkspear,384,rogue,subtlety,12,4,8
Dions,ragnaros,384,rogue,subtlety,12,4,8
Rictorr,ragnaros,384,rogue,subtlety,12,4,8
Saberbane,tichondrius,384,rogue,subtlety,12,4,8
Lolgoturbase,hyjal,384,rogue,subtlety,12,4,8
Velandros,eonar,384,rogue,subtlety,12,4,8
Blackstabyth,thrall,384,rogue,subtlety,12,4,8
Cron,arygos,384,rogue,subtlety,12,4,8
Usapped,tichondrius,384,rogue,subtlety,12,4,8
Codeine,windrunner,384,rogue,subtlety,12,4,8
Potatotott,area-52,384,rogue,subtlety,12,4,8
Zzffqsm,tichondrius,384,rogue,subtlety,12,4,8
Nevermoon,gallywix,384,rogue,subtlety,12,4,8
Maxparkhurst,moon-guard,384,rogue,subtlety,12,4,8
Cytôn,bleeding-hollow,384,rogue,subtlety,12,4,8
Restinpeacex,bleeding-hollow,384,rogue,subtlety,12,4,8
Tomas,bloodscalp,384,rogue,subtlety,12,4,8
Irkalla,frostmourne,384,rogue,subtlety,12,4,8
Woodsapdat,sargeras,384,rogue,subtlety,12,4,8
Mãtthew,tichondrius,384,rogue,subtlety,12,4,8
Astol,frostmourne,384,rogue,subtlety,12,4,8
Booitsdrew,sargeras,384,rogue,subtlety,12,4,8
Gotothegym,tichondrius,384,rogue,subtlety,12,4,8
Miamiganster,lothar,384,rogue,subtlety,12,4,8
Keylight,tichondrius,384,rogue,subtlety,12,4,8
Alcinah,sargeras,384,rogue,subtlety,12,4,8
Diamondx,proudmoore,384,rogue,subtlety,12,4,8
Flankks,sargeras,384,rogue,subtlety,12,4,8
Seutobinhaa,stormrage,384,rogue,subtlety,12,4,8
Lazaruslong,stormrage,384,rogue,subtlety,12,4,8
Hoodiesneaks,stormrage,384,rogue,subtlety,14,4,10
Asneakyfox,thunderlord,384,rogue,subtlety,30,4,26
Morphina,gilneas,383,rogue,subtlety,6,4,2
Gentlesaop,blackrock,383,rogue,subtlety,6,4,2
Xanthinic,mugthol,383,rogue,subtlety,6,4,2
Stabsolutely,moon-guard,383,rogue,subtlety,6,4,2
Prxfxt,stormrage,383,rogue,subtlety,6,4,2
Freego,quelthalas,383,rogue,subtlety,6,4,2
Superhattie,tichondrius,383,rogue,subtlety,12,4,8
Ràinê,dalaran,383,rogue,subtlety,12,4,8
Majimae,sargeras,383,rogue,subtlety,12,4,8
Hènnéssy,frostmourne,383,rogue,subtlety,12,4,8
Toxiccarnage,ghostlands,383,rogue,subtlety,14,4,10
Roguebasic,frostmourne,383,rogue,subtlety,18,4,14
Theevaelfie,quelthalas,383,rogue,subtlety,18,4,14
Medalist,darkspear,383,rogue,subtlety,18,4,14
Xô,lothar,383,rogue,subtlety,24,4,20
Rascallion,tichondrius,381,rogue,subtlety,12,4,8
Lemíly,emerald-dream,361,rogue,subtlety,25,8,17
Sinice,draka,351,rogue,subtlety,8,5,3
Opensap,tichondrius,350,rogue,subtlety,11,4,7
Samuraii,zuljin,335,rogue,subtlety,11,4,7
Idsapdat,illidan,330,rogue,subtlety,9,6,3
Rosê,daggerspine,327,rogue,subtlety,14,7,7
Uchihà,sargeras,321,rogue,subtlety,23,5,18
Rawdawged,illidan,320,rogue,subtlety,16,4,12
Apocalypse,azshara,319,rogue,subtlety,8,4,4
Grima,azralon,319,rogue,subtlety,14,4,10
Niujaky,illidan,312,rogue,subtlety,28,5,23
Gotkick,stormrage,288,rogue,subtlety,6,3,3
Liljonx,tichondrius,288,rogue,subtlety,6,3,3
Woundzx,tichondrius,288,rogue,subtlety,6,3,3
Asherian,wyrmrest-accord,288,rogue,subtlety,6,3,3
Seloc,wyrmrest-accord,288,rogue,subtlety,6,3,3
Japz,sargeras,288,rogue,subtlety,6,3,3
Hemorrhages,tichondrius,288,rogue,subtlety,6,3,3
Schneric,stormrage,288,rogue,subtlety,6,3,3
Sonymf,frostmourne,288,rogue,subtlety,6,3,3
Delaroze,sargeras,288,rogue,subtlety,6,3,3
Amatoxin,tichondrius,288,rogue,subtlety,6,3,3
Garnoghan,stormrage,288,rogue,subtlety,6,3,3
Thargal,tichondrius,288,rogue,subtlety,6,3,3
Valaq,tichondrius,288,rogue,subtlety,6,3,3
Drstealthy,tichondrius,288,rogue,subtlety,6,3,3
Kelbrelor,stormrage,288,rogue,subtlety,6,3,3
Seanr,stormrage,288,rogue,subtlety,6,3,3
Ralæriel,wyrmrest-accord,288,rogue,subtlety,6,3,3
Shivsac,tichondrius,288,rogue,subtlety,6,3,3
Slilsp,sargeras,288,rogue,subtlety,6,3,3
Oj,frostmourne,288,rogue,subtlety,6,3,3
Dödoubleg,stormrage,288,rogue,subtlety,6,3,3
Latetext,tichondrius,288,rogue,subtlety,6,3,3
Rógue,aerie-peak,288,rogue,subtlety,6,3,3
Driizzel,sargeras,288,rogue,subtlety,6,3,3
Zarrth,malganis,288,rogue,subtlety,6,3,3
Gåñðøñ,stormscale,288,rogue,subtlety,6,3,3
Castsequence,khaz-modan,288,rogue,subtlety,6,3,3
Zêrøghgødx,tichondrius,288,rogue,subtlety,6,3,3
Shadowreapz,barthilas,288,rogue,subtlety,6,3,3
Haeqn,azralon,288,rogue,subtlety,6,3,3
Thompson,bloodscalp,288,rogue,subtlety,6,3,3
Izula,spirestone,288,rogue,subtlety,6,3,3
Raego,frostmourne,288,rogue,subtlety,6,3,3
Dägger,barthilas,288,rogue,subtlety,6,3,3
Privz,sargeras,288,rogue,subtlety,6,3,3
Rogecoin,illidan,288,rogue,subtlety,6,3,3
Dairykeen,misha,288,rogue,subtlety,6,3,3
Sharmoc,ragnaros,288,rogue,subtlety,6,3,3
Gongarn,thrall,288,rogue,subtlety,6,3,3
Knifetalk,moon-guard,288,rogue,subtlety,6,3,3
Støné,azjolnerub,288,rogue,subtlety,6,3,3
Spcz,malganis,288,rogue,subtlety,6,3,3
Frostheartyy,azralon,288,rogue,subtlety,6,3,3
Trainhealers,tichondrius,288,rogue,subtlety,6,3,3
Reverel,tichondrius,288,rogue,subtlety,6,3,3
Snackable,tichondrius,288,rogue,subtlety,6,3,3
Sinfate,bleeding-hollow,288,rogue,subtlety,6,3,3
Enferna,kelthuzad,288,rogue,subtlety,6,3,3
Bøbinette,sargeras,288,rogue,subtlety,6,3,3
Antijax,stormrage,288,rogue,subtlety,6,3,3
Redspoison,dalaran,288,rogue,subtlety,6,3,3
Jackcurtis,kelthuzad,288,rogue,subtlety,6,3,3
Wikkihx,emerald-dream,288,rogue,subtlety,6,3,3
Aiber,sargeras,288,rogue,subtlety,6,3,3
Thoxic,barthilas,288,rogue,subtlety,6,3,3
Roollz,nemesis,288,rogue,subtlety,6,3,3
Ced,medivh,288,rogue,subtlety,6,3,3
Powaah,emerald-dream,288,rogue,subtlety,6,3,3
Gangstsprdse,tichondrius,288,rogue,subtlety,6,3,3
Belialas,thrall,288,rogue,subtlety,6,3,3
Compadrer,area-52,288,rogue,subtlety,6,3,3
Pvptóne,steamwheedle-cartel,288,rogue,subtlety,6,3,3
Dross,shadowmoon,288,rogue,subtlety,6,3,3
Metalz,exodar,288,rogue,subtlety,6,3,3
Maliora,area-52,288,rogue,subtlety,6,3,3
Irnoob,ursin,288,rogue,subtlety,6,3,3
Repatriate,dark-iron,288,rogue,subtlety,6,3,3
Dìngapoof,tichondrius,288,rogue,subtlety,6,3,3
Junemylove,tichondrius,288,rogue,subtlety,6,3,3
Creayuncle,area-52,288,rogue,subtlety,6,3,3
Mondeaux,moon-guard,288,rogue,subtlety,6,3,3
Xotourlife,frostwolf,288,rogue,subtlety,9,4,5
Taraminkadot,sargeras,288,rogue,subtlety,9,4,5
Keytonx,tichondrius,288,rogue,subtlety,7,3,4
ßutthead,malganis,288,rogue,subtlety,7,3,4
Ünaru,sargeras,288,rogue,subtlety,7,3,4
Zeetwntyeght,stormrage,288,rogue,subtlety,12,3,9
Yottsu,proudmoore,288,rogue,subtlety,12,3,9
Nystee,sargeras,288,rogue,subtlety,12,3,9
Yodoctor,sargeras,288,rogue,subtlety,12,3,9
Eaxlol,sargeras,288,rogue,subtlety,12,3,9
Terala,perenolde,288,rogue,subtlety,12,3,9
Smashfacewïn,tichondrius,288,rogue,subtlety,12,3,9
Kowabungii,tichondrius,288,rogue,subtlety,12,3,9
Miloandotis,malganis,288,rogue,subtlety,12,3,9
Ukspecial,tichondrius,288,rogue,subtlety,12,3,9
Wrekage,emerald-dream,288,rogue,subtlety,12,3,9
Badonka,aggramar,288,rogue,subtlety,12,3,9
Cincyhirou,exodar,288,rogue,subtlety,12,3,9
Penguineater,tichondrius,288,rogue,subtlety,12,3,9
Ovrfivethosn,malganis,288,rogue,subtlety,12,3,9
Mégân,ragnaros,288,rogue,subtlety,12,3,9
Nobarå,veknilash,288,rogue,subtlety,12,3,9
Coolswag,tichondrius,288,rogue,subtlety,12,3,9
Hogstradamus,malganis,288,rogue,subtlety,12,3,9
Khazii,scilla,288,rogue,subtlety,12,3,9
Woboi,area-52,288,rogue,subtlety,12,3,9
Bumpamoose,aggramar,288,rogue,subtlety,12,3,9
Yülia,skywall,288,rogue,subtlety,12,3,9
Palla,tichondrius,288,rogue,subtlety,12,3,9
Yamillpgk,ragnaros,288,rogue,subtlety,12,3,9
Foofz,kelthuzad,288,rogue,subtlety,12,3,9
Imbe,nagrand,288,rogue,subtlety,12,3,9
Grinz,sargeras,288,rogue,subtlety,12,3,9
Nikkî,hyjal,288,rogue,subtlety,12,3,9
Heretodance,tichondrius,288,rogue,subtlety,18,3,15
Urukzog,ragnaros,287,rogue,subtlety,6,3,3
Xsneakski,jubeithos,287,rogue,subtlety,6,3,3
Janglebang,arthas,287,rogue,subtlety,6,3,3
Bajeebus,azshara,287,rogue,subtlety,6,3,3
Framsteg,kelthuzad,287,rogue,subtlety,6,3,3
Stealheartsr,tichondrius,287,rogue,subtlety,7,3,4
Backstabya,barthilas,287,rogue,subtlety,9,3,6
Bromen,ragnaros,287,rogue,subtlety,12,3,9
Namiic,thrall,287,rogue,subtlety,12,3,9
Heserth,ragnaros,287,rogue,subtlety,12,3,9
Teach,illidan,287,rogue,subtlety,18,3,15
Minnicent,amanthul,287,rogue,subtlety,18,3,15
Aycaramba,skywall,286,rogue,subtlety,6,3,3
Cerebrian,malygos,286,rogue,subtlety,6,3,3
Tareduwu,area-52,286,rogue,subtlety,18,3,15
Wickedstuns,malganis,271,rogue,subtlety,17,3,14
Reflexiv,malganis,256,rogue,subtlety,10,3,7
Youngdraco,tichondrius,239,rogue,subtlety,5,3,2
Wulfcrest,moon-guard,239,rogue,subtlety,5,3,2
Uncleblinker,proudmoore,239,rogue,subtlety,5,3,2
Radagon,fenris,234,rogue,subtlety,9,4,5
Rocanról,quelthalas,234,rogue,subtlety,12,4,8
Twinkasz,nemesis,234,rogue,subtlety,16,5,11
Durzoblïnt,ragnaros,207,rogue,subtlety,8,3,5
Ibuuki,bleeding-hollow,192,rogue,subtlety,6,2,4
Peteroc,stormreaver,192,rogue,subtlety,6,2,4
Pilurfs,thrall,192,rogue,subtlety,6,2,4
Pixils,bleeding-hollow,192,rogue,subtlety,6,2,4
Chêckmatê,darkspear,192,rogue,subtlety,6,2,4
Shadowmagikk,sargeras,192,rogue,subtlety,6,2,4
Rhayu,emerald-dream,192,rogue,subtlety,6,2,4
Xyltann,bleeding-hollow,192,rogue,subtlety,6,2,4
Shankmcganks,chogall,192,rogue,subtlety,6,2,4
Åaron,thrall,192,rogue,subtlety,6,2,4
Ërëbus,greymane,192,rogue,subtlety,6,2,4
Alakie,cenarius,192,rogue,subtlety,6,2,4
Benjisuwu,area-52,192,rogue,subtlety,6,2,4
Shankums,thrall,192,rogue,subtlety,6,2,4
ßroke,emerald-dream,192,rogue,subtlety,6,2,4
Vatolord,azralon,192,rogue,subtlety,6,2,4
Liesll,thrall,192,rogue,subtlety,6,2,4
Pëaches,area-52,192,rogue,subtlety,6,2,4
Wètdream,sargeras,192,rogue,subtlety,6,2,4
Lmorningstar,altar-of-storms,192,rogue,subtlety,6,2,4
Pizzarollplz,kelthuzad,192,rogue,subtlety,6,2,4
Sizak,kelthuzad,192,rogue,subtlety,6,2,4
Wyyre,hyjal,192,rogue,subtlety,6,2,4
Bambooßobby,area-52,192,rogue,subtlety,6,2,4
Nemminem,sargeras,192,rogue,subtlety,6,2,4
Opwanshinobi,azralon,192,rogue,subtlety,6,2,4
Kami,kelthuzad,192,rogue,subtlety,6,2,4
Macklittle,area-52,192,rogue,subtlety,6,2,4
Tothegravetv,sargeras,192,rogue,subtlety,6,2,4
Stateless,kelthuzad,192,rogue,subtlety,6,2,4
Dillwilly,moon-guard,192,rogue,subtlety,6,2,4
Coalie,tichondrius,192,rogue,subtlety,6,2,4
Ðøñtàrmørýmè,tichondrius,192,rogue,subtlety,6,2,4
Tìlt,whisperwind,192,rogue,subtlety,6,2,4
Meadview,bleeding-hollow,192,rogue,subtlety,6,2,4
Gnoescape,burning-legion,192,rogue,subtlety,6,2,4
Blackmont,bleeding-hollow,192,rogue,subtlety,6,2,4
Brutalpocket,malganis,192,rogue,subtlety,6,2,4
Sîlver,dragonblight,192,rogue,subtlety,6,2,4
Joegamer,sargeras,192,rogue,subtlety,6,2,4
Anímosity,darkspear,192,rogue,subtlety,6,2,4
Rehze,area-52,192,rogue,subtlety,6,2,4
Vanquief,sargeras,192,rogue,subtlety,6,2,4
Letsgobranon,sargeras,192,rogue,subtlety,6,2,4
Indicadeath,stormrage,192,rogue,subtlety,6,2,4
Elvesnknives,stormrage,192,rogue,subtlety,6,2,4
Ikthemon,khaz-modan,192,rogue,subtlety,6,2,4
Nubes,illidan,192,rogue,subtlety,6,2,4
Shinobick,kelthuzad,192,rogue,subtlety,6,2,4
Brustent,icecrown,192,rogue,subtlety,6,2,4
Slycndice,tortheldrin,192,rogue,subtlety,6,2,4
Buddymelon,thrall,192,rogue,subtlety,6,2,4
Jeezy,shadowmoon,192,rogue,subtlety,6,2,4
Skorsh,wyrmrest-accord,192,rogue,subtlety,6,2,4
Tcjx,area-52,192,rogue,subtlety,6,2,4
Rujkah,archimonde,192,rogue,subtlety,6,2,4
Stymie,malorne,192,rogue,subtlety,6,2,4
Zzu,azralon,192,rogue,subtlety,6,2,4
Happyunhappy,illidan,192,rogue,subtlety,6,2,4
Sicksix,bleeding-hollow,192,rogue,subtlety,6,2,4
Tryedge,moon-guard,192,rogue,subtlety,6,2,4
Womanx,tichondrius,192,rogue,subtlety,6,2,4
Gzl,frostmourne,192,rogue,subtlety,6,2,4
Icantsleep,tichondrius,192,rogue,subtlety,6,2,4
Mgzx,tichondrius,192,rogue,subtlety,6,2,4
Ectrelor,moon-guard,192,rogue,subtlety,6,2,4
Shinnex,quelthalas,192,rogue,subtlety,6,2,4
Shadowstryfe,tichondrius,192,rogue,subtlety,6,2,4
Runescape,frostmourne,192,rogue,subtlety,6,2,4
Terrorstrike,tichondrius,192,rogue,subtlety,6,2,4
Sparklepuffy,tichondrius,192,rogue,subtlety,6,2,4
Bloodhounder,illidan,192,rogue,subtlety,6,2,4
Ow,eldrethalas,192,rogue,subtlety,6,2,4
Exwhite,proudmoore,192,rogue,subtlety,6,2,4
Surplus,stormscale,192,rogue,subtlety,6,2,4
Gannet,spirestone,192,rogue,subtlety,6,2,4
Tleary,tichondrius,192,rogue,subtlety,6,2,4
Sneakyt,shadow-council,192,rogue,subtlety,6,2,4
Yourhomieaj,tichondrius,192,rogue,subtlety,6,2,4
Xolli,fizzcrank,192,rogue,subtlety,6,2,4
Sticksnstabs,tichondrius,192,rogue,subtlety,6,2,4
Pootymunchin,daggerspine,192,rogue,subtlety,6,2,4
Guacpls,tichondrius,192,rogue,subtlety,6,2,4
Roastful,tichondrius,192,rogue,subtlety,6,2,4
Slíçk,tichondrius,192,rogue,subtlety,6,2,4
Zerø,barthilas,192,rogue,subtlety,6,2,4
Toomuchcap,aggramar,192,rogue,subtlety,6,2,4
Chariakin,tichondrius,192,rogue,subtlety,6,2,4
Magottx,shattered-hand,192,rogue,subtlety,6,2,4
Grue,gundrak,192,rogue,subtlety,6,2,4
Theweeknd,kiljaeden,192,rogue,subtlety,7,2,5
Nattaku,tichondrius,192,rogue,subtlety,7,2,5
Bâerâ,bloodscalp,192,rogue,subtlety,8,2,6
Xenitech,bleeding-hollow,192,rogue,subtlety,8,2,6
Beribani,azralon,192,rogue,subtlety,12,2,10
Zabava,malganis,192,rogue,subtlety,12,2,10
Brickjohnson,illidan,192,rogue,subtlety,12,2,10
Krius,blood-furnace,192,rogue,subtlety,12,2,10
Ezmate,frostmourne,192,rogue,subtlety,12,2,10
Myhandisfull,tichondrius,192,rogue,subtlety,12,2,10
Ghostdragons,tichondrius,192,rogue,subtlety,12,2,10
Barmiah,stormrage,192,rogue,subtlety,12,2,10
Soupline,area-52,192,rogue,subtlety,12,2,10
Zeriek,stormrage,192,rogue,subtlety,12,2,10
Flèè,illidan,192,rogue,subtlety,12,2,10
Noxîc,zuljin,192,rogue,subtlety,12,2,10
Pouet,caelestrasz,192,rogue,subtlety,12,2,10
Wildstory,tichondrius,192,rogue,subtlety,12,2,10
Mitchrogue,barthilas,192,rogue,subtlety,12,2,10
Bloodyblades,blackhand,192,rogue,subtlety,12,2,10
Rogmin,tichondrius,192,rogue,subtlety,12,2,10
Kestor,barthilas,192,rogue,subtlety,12,2,10
Onulyo,tichondrius,192,rogue,subtlety,12,2,10
Souporcereal,aegwynn,192,rogue,subtlety,12,2,10
Jashyy,tichondrius,192,rogue,subtlety,12,2,10
Nigthdead,nemesis,192,rogue,subtlety,12,2,10
Diabsoule,amanthul,192,rogue,subtlety,12,2,10
Roguessy,dalaran,192,rogue,subtlety,18,2,16
Bleedszfreak,illidan,192,rogue,subtlety,18,2,16
Seth,stonemaul,191,rogue,subtlety,6,2,4
Vitalz,bloodscalp,191,rogue,subtlety,6,2,4
Lancarlorïus,ragnaros,191,rogue,subtlety,6,2,4
Sheiv,shadow-council,190,rogue,subtlety,5,3,2
Tenr,tichondrius,170,rogue,subtlety,13,4,9
Eliasael,moon-guard,159,rogue,subtlety,5,2,3
Khrezin,stonemaul,159,rogue,subtlety,5,2,3
Koobbo,tichondrius,159,rogue,subtlety,5,2,3
Kanablis,tichondrius,159,rogue,subtlety,5,2,3
Driprat,area-52,159,rogue,subtlety,5,2,3
Tèdy,sargeras,138,rogue,subtlety,7,3,4
Ganksterqt,dentarg,138,rogue,subtlety,10,3,7
Ladelmono,tichondrius,138,rogue,subtlety,15,3,12
Uhtrred,ragnaros,137,rogue,subtlety,10,3,7
Fadedx,darkspear,128,rogue,subtlety,4,2,2
Earthinhorn,frostmourne,127,rogue,subtlety,8,2,6
Swickwockdus,azralon,112,rogue,subtlety,7,2,5
Rickgone,bleeding-hollow,96,rogue,subtlety,3,2,1
Gríma,moon-guard,96,rogue,subtlety,3,2,1
Finlander,area-52,96,rogue,subtlety,5,2,3
Lásko,area-52,96,rogue,subtlety,9,2,7
Sadgedeeznut,dalaran,96,rogue,subtlety,6,1,5
Valekk,stormscale,96,rogue,subtlety,6,1,5
Mercer,area-52,96,rogue,subtlety,6,1,5
Grindaicha,dentarg,96,rogue,subtlety,6,1,5
Aenaesx,malygos,96,rogue,subtlety,6,1,5
Srrmortte,gallywix,96,rogue,subtlety,6,1,5
Kizakuo,moon-guard,96,rogue,subtlety,6,1,5
Treasy,malganis,96,rogue,subtlety,6,1,5
Meatballjr,frostmane,96,rogue,subtlety,6,1,5
Koraliya,kiljaeden,96,rogue,subtlety,6,1,5
Yoodoo,nemesis,96,rogue,subtlety,6,1,5
Ohsapmyjaw,thrall,96,rogue,subtlety,6,1,5
Cotuffa,drakkari,96,rogue,subtlety,6,1,5
Solideoglria,tichondrius,96,rogue,subtlety,6,1,5
Reurog,garrosh,96,rogue,subtlety,6,1,5
Thottie,bleeding-hollow,96,rogue,subtlety,6,1,5
Halion,nagrand,96,rogue,subtlety,6,1,5
Adysius,malganis,96,rogue,subtlety,6,1,5
Covìn,malganis,96,rogue,subtlety,6,1,5
Onetwostep,tichondrius,96,rogue,subtlety,6,1,5
Vivas,dalaran,96,rogue,subtlety,6,1,5
Deepcutz,barthilas,96,rogue,subtlety,6,1,5
Sawred,bonechewer,96,rogue,subtlety,6,1,5
Wabi,tichondrius,96,rogue,subtlety,6,1,5
Nevatell,malganis,96,rogue,subtlety,6,1,5
Macc,khazgoroth,96,rogue,subtlety,6,1,5
Sapstick,kiljaeden,96,rogue,subtlety,6,1,5
Xone,saurfang,96,rogue,subtlety,6,1,5
Caalo,quelthalas,96,rogue,subtlety,6,1,5
Rooster,muradin,96,rogue,subtlety,6,1,5
Wrin,sargeras,96,rogue,subtlety,6,1,5
Veleno,uldum,96,rogue,subtlety,6,1,5
Quackerjacks,lightnings-blade,96,rogue,subtlety,6,1,5
Whaazz,tichondrius,96,rogue,subtlety,6,1,5
Jokerr,proudmoore,96,rogue,subtlety,6,1,5
Soosung,moon-guard,96,rogue,subtlety,6,1,5
Docheatt,dalaran,96,rogue,subtlety,6,1,5
Bloodbrawl,caelestrasz,96,rogue,subtlety,6,1,5
Satanicrizz,tichondrius,96,rogue,subtlety,6,1,5
Dnb,warsong,96,rogue,subtlety,6,1,5
Swipeah,nathrezim,96,rogue,subtlety,6,1,5
Soggysenpai,kelthuzad,96,rogue,subtlety,6,1,5
Lawyergamer,bonechewer,96,rogue,subtlety,6,1,5
Grfaux,sargeras,96,rogue,subtlety,6,1,5
Dagarah,quelthalas,96,rogue,subtlety,6,1,5
Imvenom,tichondrius,96,rogue,subtlety,6,1,5
Ghostyd,tichondrius,96,rogue,subtlety,6,1,5
Anistreya,wyrmrest-accord,96,rogue,subtlety,6,1,5
Rolomon,tichondrius,96,rogue,subtlety,6,1,5
Eimr,stormrage,96,rogue,subtlety,6,1,5
Dabrat,frostwolf,96,rogue,subtlety,6,1,5
Teleqraph,frostmourne,96,rogue,subtlety,6,1,5
Bigcolumn,tichondrius,96,rogue,subtlety,6,1,5
Azrek,sargeras,96,rogue,subtlety,6,1,5
Frootylol,stormrage,96,rogue,subtlety,6,1,5
Dragosha,antonidas,96,rogue,subtlety,6,1,5
Herian,caelestrasz,96,rogue,subtlety,6,1,5
Robomom,illidan,96,rogue,subtlety,6,1,5
Mikea,stormrage,96,rogue,subtlety,6,1,5
Mídnìght,aegwynn,96,rogue,subtlety,6,1,5
Toxína,quelthalas,96,rogue,subtlety,6,1,5
Gothshawty,stormrage,96,rogue,subtlety,6,1,5
Liloudarog,tichondrius,96,rogue,subtlety,6,1,5
Páige,ragnaros,96,rogue,subtlety,6,1,5
Akilesx,quelthalas,96,rogue,subtlety,6,1,5
Slobernocker,stormrage,96,rogue,subtlety,6,1,5
Heimlichkeit,tichondrius,96,rogue,subtlety,6,1,5
Zandrìn,tichondrius,96,rogue,subtlety,6,1,5
Skinnymayne,laughing-skull,96,rogue,subtlety,6,1,5
Borre,kiljaeden,96,rogue,subtlety,6,1,5
Aitreena,stormrage,96,rogue,subtlety,6,1,5
Spöke,dalvengyr,96,rogue,subtlety,6,1,5
Originkorean,terenas,96,rogue,subtlety,6,1,5
Ironrod,shadowmoon,96,rogue,subtlety,6,1,5
Crÿptø,azralon,96,rogue,subtlety,6,1,5
Anadrol,sargeras,96,rogue,subtlety,6,1,5
Sudokill,tichondrius,96,rogue,subtlety,6,1,5
Takeiapika,azralon,96,rogue,subtlety,6,1,5
Mintirogue,sargeras,96,rogue,subtlety,6,1,5
Bonizzi,stormrage,96,rogue,subtlety,6,1,5
Sathrael,deathwing,96,rogue,subtlety,6,1,5
Trebyoyoyo,haomarush,96,rogue,subtlety,6,1,5
Scowl,dethecus,96,rogue,subtlety,6,1,5
Illidin,executus,96,rogue,subtlety,6,1,5
Flelfo,quelthalas,96,rogue,subtlety,12,1,11
Whouzie,frostmourne,96,rogue,subtlety,12,1,11
Mccarter,bonechewer,87,rogue,subtlety,17,3,14
Zhaanth,bonechewer,79,rogue,subtlety,5,1,4
Minkys,azralon,79,rogue,subtlety,5,1,4
Vùdõõ,area-52,64,rogue,subtlety,4,1,3
Vetisx,thrall,64,rogue,subtlety,4,1,3
Drpibb,ghostlands,63,rogue,subtlety,2,2,0
Blackbutton,illidan,63,rogue,subtlety,2,2,0
Swøøpy,stormrage,48,rogue,subtlety,3,1,2
Thenelis,dalaran,42,rogue,subtlety,11,2,9
Archazx,sargeras,42,rogue,subtlety,12,2,10
Toetime,dragonmaw,31,rogue,subtlety,2,1,1
Betakong,quelthalas,31,rogue,subtlety,2,1,1
Nekosneako,frostmourne,31,rogue,subtlety,2,1,1
Traumashears,proudmoore,31,rogue,subtlety,2,1,1
Demonioverde,ragnaros,31,rogue,subtlety,2,1,1
Zarkk,kelthuzad,2206,rogue,assassination,329,166,163
Mirrorx,tichondrius,2194,rogue,assassination,246,124,122
Sllabymkcus,sargeras,2126,rogue,assassination,72,37,35
Larmx,tichondrius,2111,rogue,assassination,78,40,38
Xiaochulol,tichondrius,2097,rogue,assassination,96,51,45
Ånko,tichondrius,2036,rogue,assassination,119,56,63
Snortedgfuel,drenden,2015,rogue,assassination,83,41,42
Alethal,tichondrius,1972,rogue,assassination,90,48,42
Sinepymkcus,illidan,1961,rogue,assassination,108,49,59
Ymxxlolz,tichondrius,1960,rogue,assassination,108,54,54
Kenteenx,tichondrius,1915,rogue,assassination,72,35,37
Sanira,illidan,1900,rogue,assassination,69,34,35
Ajúmma,tichondrius,1877,rogue,assassination,63,26,37
Niarzz,tichondrius,1870,rogue,assassination,104,62,42
Topfloorboss,illidan,1865,rogue,assassination,83,45,38
Sio,bleeding-hollow,1865,rogue,assassination,72,37,35
Endlesswaltz,zuljin,1861,rogue,assassination,39,20,19
Lemon,arygos,1851,rogue,assassination,47,20,27
Poonanixo,frostmourne,1846,rogue,assassination,78,38,40
Alterfate,wyrmrest-accord,1839,rogue,assassination,66,33,33
Feinting,moon-guard,1839,rogue,assassination,76,35,41
Jon,the-venture-co,1838,rogue,assassination,54,27,27
Jjp,tichondrius,1827,rogue,assassination,65,33,32
Hypnothot,tichondrius,1827,rogue,assassination,186,89,97
Omnìslash,area-52,1817,rogue,assassination,44,27,17
Raj,blood-furnace,1810,rogue,assassination,66,29,37
Beaconlight,tichondrius,1808,rogue,assassination,77,31,46
Relän,ragnaros,1805,rogue,assassination,59,33,26
Sairak,tichondrius,1804,rogue,assassination,101,49,52
Peepoclown,illidan,1782,rogue,assassination,58,29,29
Köfy,quelthalas,1782,rogue,assassination,93,43,50
Jonuts,bleeding-hollow,1752,rogue,assassination,48,22,26
Lunatixz,emerald-dream,1749,rogue,assassination,59,31,28
Olé,azralon,1744,rogue,assassination,108,54,54
Plumblossomx,tichondrius,1742,rogue,assassination,78,34,44
Lycanthropî,illidan,1742,rogue,assassination,84,35,49
Doraz,tichondrius,1736,rogue,assassination,174,91,83
Bloodlessftw,azralon,1734,rogue,assassination,200,94,106
Stealthdeath,quelthalas,1728,rogue,assassination,42,24,18
Wujn,tichondrius,1728,rogue,assassination,228,122,106
Vmoney,draenor,1727,rogue,assassination,69,37,32
Thargal,tichondrius,1717,rogue,assassination,83,42,41
Poonaniqt,gundrak,1716,rogue,assassination,48,24,24
Nsns,drenden,1714,rogue,assassination,272,140,132
Bellamor,tichondrius,1711,rogue,assassination,114,66,48
Viicky,ghostlands,1711,rogue,assassination,94,45,49
Bellicoses,tichondrius,1708,rogue,assassination,186,101,85
Impkasn,tichondrius,1708,rogue,assassination,96,39,57
Slickyo,area-52,1705,rogue,assassination,42,23,19
Elinarra,sargeras,1704,rogue,assassination,54,28,26
Pkkrevolt,archimonde,1704,rogue,assassination,99,50,49
Bukaboo,tichondrius,1701,rogue,assassination,54,40,14
Katmira,tichondrius,1699,rogue,assassination,72,30,42
Xagreth,illidan,1692,rogue,assassination,58,32,26
Cutercarver,proudmoore,1689,rogue,assassination,141,67,74
Stabasaurus,blood-furnace,1687,rogue,assassination,54,24,30
Inaniss,tichondrius,1678,rogue,assassination,56,30,26
Øsi,icecrown,1677,rogue,assassination,42,18,24
Girio,thrall,1675,rogue,assassination,41,22,19
Vél,blackrock,1674,rogue,assassination,42,22,20
Entrerí,illidan,1667,rogue,assassination,33,21,12
Seroth,tichondrius,1656,rogue,assassination,36,23,13
Ybby,tichondrius,1655,rogue,assassination,86,41,45
Stabu,dalvengyr,1652,rogue,assassination,42,23,19
Ivanrah,zuljin,1648,rogue,assassination,45,20,25
Riventrix,zuljin,1640,rogue,assassination,101,47,54
Kk,dalaran,1635,rogue,assassination,52,28,24
Rapcher,illidan,1632,rogue,assassination,148,75,73
Kenyel,frostmourne,1632,rogue,assassination,108,52,56
Josex,lightbringer,1632,rogue,assassination,48,20,28
Saiine,drenden,1629,rogue,assassination,104,55,49
Sheerlol,stormrage,1626,rogue,assassination,49,24,25
Kiddmurphy,sargeras,1625,rogue,assassination,52,22,30
Poisonous,emerald-dream,1620,rogue,assassination,51,25,26
Sênorita,tichondrius,1619,rogue,assassination,42,17,25
Lemonlemon,arygos,1618,rogue,assassination,30,17,13
Assassìn,moon-guard,1618,rogue,assassination,48,27,21
Ultranumb,sargeras,1618,rogue,assassination,51,27,24
Whooxx,khazgoroth,1616,rogue,assassination,78,33,45
Shyzuku,drakkari,1613,rogue,assassination,54,23,31
Vasherr,zuljin,1611,rogue,assassination,55,33,22
Rîa,area-52,1611,rogue,assassination,48,21,27
Miamiganster,lothar,1606,rogue,assassination,126,59,67
Sanozü,azralon,1606,rogue,assassination,54,21,33
Yenrab,illidan,1606,rogue,assassination,50,19,31
Foreverioi,tichondrius,1603,rogue,assassination,54,31,23
Slapjak,dalaran,1600,rogue,assassination,74,33,41
Onetwostep,tichondrius,1600,rogue,assassination,45,20,25
Johnnycryp,barthilas,1595,rogue,assassination,59,28,31
Lucidstorm,tichondrius,1593,rogue,assassination,30,17,13
Entropyphi,daggerspine,1591,rogue,assassination,36,17,19
Chêckmatê,darkspear,1589,rogue,assassination,54,25,29
Devstrike,sargeras,1587,rogue,assassination,53,25,28
Bladä,area-52,1585,rogue,assassination,70,35,35
Zeth,frostmourne,1583,rogue,assassination,117,52,65
Katovo,tichondrius,1581,rogue,assassination,53,28,25
Htez,frostmourne,1580,rogue,assassination,42,22,20
Sparqxx,tichondrius,1577,rogue,assassination,233,117,116
Happyslice,stormrage,1575,rogue,assassination,45,25,20
Ãnimefãnx,moon-guard,1574,rogue,assassination,165,81,84
Nightdelphya,azralon,1572,rogue,assassination,48,19,29
Wxvi,tichondrius,1563,rogue,assassination,54,30,24
Quefist,sargeras,1561,rogue,assassination,92,43,49
Purplechil,garrosh,1559,rogue,assassination,183,89,94
Stabem,moon-guard,1558,rogue,assassination,171,93,78
Zirkir,mannoroth,1558,rogue,assassination,62,31,31
Nayle,dalaran,1557,rogue,assassination,71,33,38
Dairykeen,misha,1552,rogue,assassination,83,39,44
Valaq,tichondrius,1550,rogue,assassination,142,70,72
Driprat,area-52,1549,rogue,assassination,36,23,13
Wxva,tichondrius,1548,rogue,assassination,48,21,27
Isàputàp,tichondrius,1542,rogue,assassination,72,37,35
Nhic,tichondrius,1542,rogue,assassination,57,23,34
Spikiera,silvermoon,1541,rogue,assassination,69,35,34
Amaretta,tichondrius,1541,rogue,assassination,36,17,19
Skeezy,vashj,1539,rogue,assassination,76,31,45
Khrezin,stonemaul,1537,rogue,assassination,79,36,43
Sapmepapi,illidan,1533,rogue,assassination,30,17,13
Lyapunov,tichondrius,1532,rogue,assassination,66,30,36
Turec,illidan,1532,rogue,assassination,42,16,26
Kidneyshiv,stormrage,1531,rogue,assassination,36,20,16
Gyutaro,black-dragonflight,1518,rogue,assassination,348,172,176
Garrotte,tichondrius,1517,rogue,assassination,271,129,142
Notjawn,arthas,1513,rogue,assassination,226,119,107
Tryedge,moon-guard,1512,rogue,assassination,36,19,17
Shninzy,senjin,1509,rogue,assassination,39,19,20
Rinhon,windrunner,1508,rogue,assassination,118,61,57
Sprigzey,frostmourne,1507,rogue,assassination,78,39,39
Ulley,sargeras,1499,rogue,assassination,62,30,32
Strîkér,tichondrius,1499,rogue,assassination,49,22,27
Lcl,proudmoore,1494,rogue,assassination,317,163,154
Shizunö,stormrage,1494,rogue,assassination,62,31,31
Yanhuaa,illidan,1493,rogue,assassination,109,58,51
Staabzz,thrall,1493,rogue,assassination,77,32,45
Brendantko,arthas,1486,rogue,assassination,30,16,14
Osuba,proudmoore,1486,rogue,assassination,116,51,65
Sizka,sargeras,1483,rogue,assassination,102,48,54
Camlaw,area-52,1477,rogue,assassination,55,26,29
Vindzl,azralon,1476,rogue,assassination,50,21,29
Gøblìn,tichondrius,1471,rogue,assassination,97,44,53
Paraisbae,tichondrius,1470,rogue,assassination,46,24,22
Lancin,azjolnerub,1470,rogue,assassination,48,23,25
Ezmate,frostmourne,1465,rogue,assassination,154,72,82
Cálí,azralon,1464,rogue,assassination,90,36,54
Tri,the-underbog,1463,rogue,assassination,42,17,25
Replayz,stormrage,1461,rogue,assassination,142,64,78
Smkgpvp,stormrage,1456,rogue,assassination,29,16,13
Blackmont,bleeding-hollow,1456,rogue,assassination,60,26,34
Dianiss,ragnaros,1452,rogue,assassination,30,17,13
Madge,area-52,1451,rogue,assassination,82,39,43
Kiosh,tichondrius,1449,rogue,assassination,96,44,52
Stillsol,stormrage,1438,rogue,assassination,48,30,18
Shankeez,tichondrius,1437,rogue,assassination,36,17,19
Cleam,darkspear,1432,rogue,assassination,36,19,17
Hookahrogue,area-52,1432,rogue,assassination,48,24,24
Hickery,frostmourne,1432,rogue,assassination,113,48,65
Lakeshark,stormrage,1431,rogue,assassination,42,15,27
Pirrow,moon-guard,1429,rogue,assassination,52,28,24
Leônhart,trollbane,1428,rogue,assassination,54,25,29
Evilsanta,sargeras,1424,rogue,assassination,52,23,29
Boonee,frostmourne,1422,rogue,assassination,89,44,45
Depressedx,illidan,1414,rogue,assassination,54,31,23
Xilorio,skullcrusher,1407,rogue,assassination,66,30,36
Lyliym,frostmourne,1405,rogue,assassination,32,16,16
Vendëttä,quelthalas,1399,rogue,assassination,48,27,21
Valråvn,bloodscalp,1399,rogue,assassination,29,16,13
Swexee,area-52,1398,rogue,assassination,67,32,35
Playmaker,frostwolf,1396,rogue,assassination,156,82,74
Kahlx,azralon,1388,rogue,assassination,191,96,95
Xvds,tichondrius,1382,rogue,assassination,42,18,24
Itokuri,ysera,1379,rogue,assassination,42,19,23
Theblindsap,dalaran,1377,rogue,assassination,42,22,20
Chakarr,stormrage,1374,rogue,assassination,32,22,10
Galaily,proudmoore,1373,rogue,assassination,95,46,49
Nikolus,dreadmaul,1371,rogue,assassination,36,16,20
Creamypeach,stormrage,1371,rogue,assassination,87,38,49
Swingonya,stormrage,1371,rogue,assassination,42,15,27
Kindasorry,illidan,1367,rogue,assassination,185,92,93
Páïgèvêntürã,bleeding-hollow,1367,rogue,assassination,32,15,17
Pandrogue,shadowsong,1363,rogue,assassination,53,25,28
Kzx,illidan,1356,rogue,assassination,30,16,14
Worlddark,quelthalas,1351,rogue,assassination,42,18,24
Youwho,kiljaeden,1348,rogue,assassination,237,115,122
Hiddencosts,proudmoore,1345,rogue,assassination,127,65,62
Bigchimpin,frostmourne,1343,rogue,assassination,24,14,10
Harlyquinn,barthilas,1342,rogue,assassination,142,73,69
Liesll,thrall,1340,rogue,assassination,36,14,22
Wansuiye,tichondrius,1340,rogue,assassination,42,14,28
Røgüë,malganis,1338,rogue,assassination,30,14,16
Paradias,moonrunner,1335,rogue,assassination,30,17,13
Apocalipto,barthilas,1332,rogue,assassination,95,41,54
Wongcha,darkspear,1331,rogue,assassination,36,14,22
Vannisshh,shattered-halls,1329,rogue,assassination,196,95,101
Doomcore,barthilas,1328,rogue,assassination,54,29,25
Sgnome,quelthalas,1323,rogue,assassination,36,16,20
Ykvo,illidan,1322,rogue,assassination,30,14,16
Poisønous,tichondrius,1322,rogue,assassination,33,15,18
Møfshanks,sargeras,1314,rogue,assassination,48,28,20
Rêdrum,illidan,1313,rogue,assassination,108,39,69
Ambushr,tichondrius,1312,rogue,assassination,24,16,8
Sneakoh,illidan,1312,rogue,assassination,65,24,41
Vimit,tichondrius,1310,rogue,assassination,66,29,37
Coquìn,proudmoore,1303,rogue,assassination,88,43,45
Enyr,frostmourne,1300,rogue,assassination,103,50,53
Regios,shadowmoon,1294,rogue,assassination,89,41,48
Urukzog,ragnaros,1289,rogue,assassination,72,36,36
Skoorbals,tichondrius,1284,rogue,assassination,56,33,23
Gorgdrake,illidan,1283,rogue,assassination,78,39,39
Timat,emerald-dream,1282,rogue,assassination,48,22,26
Aynrand,drakkari,1281,rogue,assassination,36,16,20
Keepitshadow,frostmourne,1279,rogue,assassination,89,45,44
Powerjuicer,tichondrius,1279,rogue,assassination,96,46,50
Grasiel,tichondrius,1277,rogue,assassination,68,30,38
Papadopolous,zuluhed,1275,rogue,assassination,38,18,20
Kidneyisntop,illidan,1274,rogue,assassination,59,29,30
Thepitt,stormrage,1272,rogue,assassination,48,23,25
Torshe,sargeras,1271,rogue,assassination,24,14,10
Keylâ,thrall,1264,rogue,assassination,62,33,29
Seengivenchy,zuljin,1262,rogue,assassination,26,14,12
Ninjadoo,tichondrius,1262,rogue,assassination,68,27,41
Eliasael,moon-guard,1258,rogue,assassination,39,18,21
Lambs,blackhand,1258,rogue,assassination,35,14,21
Senpaifuta,proudmoore,1254,rogue,assassination,30,17,13
Blindfun,emerald-dream,1247,rogue,assassination,39,21,18
Helecho,tichondrius,1244,rogue,assassination,30,13,17
Xhau,moon-guard,1243,rogue,assassination,93,51,42
Jaganz,stormrage,1243,rogue,assassination,24,13,11
Kriszov,moon-guard,1243,rogue,assassination,212,109,103
Beedie,malganis,1241,rogue,assassination,135,67,68
Worm,demon-soul,1240,rogue,assassination,36,16,20
Roollz,nemesis,1240,rogue,assassination,33,14,19
Pál,quelthalas,1239,rogue,assassination,36,17,19
Laotrec,nemesis,1231,rogue,assassination,43,19,24
Drapezz,kelthuzad,1230,rogue,assassination,30,16,14
Uxaen,tichondrius,1230,rogue,assassination,62,32,30
Raskapashan,moon-guard,1229,rogue,assassination,36,13,23
Pst,spirestone,1227,rogue,assassination,24,14,10
Stepper,aegwynn,1226,rogue,assassination,36,19,17
Dragoonz,nemesis,1226,rogue,assassination,41,17,24
Jarcus,aggramar,1225,rogue,assassination,36,13,23
Shinobick,kelthuzad,1216,rogue,assassination,53,26,27
Riggie,turalyon,1202,rogue,assassination,35,17,18
Dismayx,tichondrius,1198,rogue,assassination,47,20,27
Mìtsuru,proudmoore,1194,rogue,assassination,42,24,18
Zxytox,hyjal,1191,rogue,assassination,33,17,16
Jeshka,wyrmrest-accord,1189,rogue,assassination,42,20,22
Andreals,ragnaros,1189,rogue,assassination,42,20,22
Lórdx,illidan,1189,rogue,assassination,56,25,31
Jagó,malganis,1187,rogue,assassination,42,19,23
Arlom,daggerspine,1186,rogue,assassination,24,13,11
Betakong,quelthalas,1180,rogue,assassination,30,15,15
Slycndice,tortheldrin,1177,rogue,assassination,84,49,35
Lethun,zuljin,1177,rogue,assassination,26,13,13
Stepic,illidan,1177,rogue,assassination,65,30,35
Engels,quelthalas,1171,rogue,assassination,102,45,57
Greenlemons,lightnings-blade,1163,rogue,assassination,101,49,52
Roguecity,tichondrius,1158,rogue,assassination,223,104,119
Chingado,kaelthas,1157,rogue,assassination,70,31,39
Lycanthropì,illidan,1151,rogue,assassination,18,12,6
Peaches,akama,1151,rogue,assassination,24,12,12
Gùderman,tichondrius,1150,rogue,assassination,18,12,6
Lesentixd,stormrage,1149,rogue,assassination,30,12,18
Odetodindel,nerzhul,1146,rogue,assassination,60,32,28
Sergioz,quelthalas,1144,rogue,assassination,62,27,35
Eldan,moon-guard,1143,rogue,assassination,78,31,47
Nikhlaus,ragnaros,1139,rogue,assassination,36,18,18
Rodanheim,burning-blade,1137,rogue,assassination,102,49,53
Ixìa,vashj,1135,rogue,assassination,30,12,18
Spectremg,azralon,1134,rogue,assassination,30,12,18
Revlul,darkspear,1133,rogue,assassination,30,12,18
Ràinê,dalaran,1128,rogue,assassination,24,13,11
Spooky,bleeding-hollow,1128,rogue,assassination,112,50,62
Thontz,sargeras,1127,rogue,assassination,30,18,12
Lakki,chromaggus,1127,rogue,assassination,30,12,18
Dothras,stormrage,1119,rogue,assassination,87,43,44
Shivsac,tichondrius,1117,rogue,assassination,47,20,27
Indivisible,thunderlord,1115,rogue,assassination,102,51,51
Sinnister,queldorei,1110,rogue,assassination,65,24,41
Copler,tichondrius,1110,rogue,assassination,48,17,31
Roguepvp,stormrage,1108,rogue,assassination,64,35,29
Altarys,ragnaros,1103,rogue,assassination,27,15,12
Respia,proudmoore,1103,rogue,assassination,40,16,24
Dysxliec,dalaran,1101,rogue,assassination,35,12,23
Esraxo,frostmourne,1100,rogue,assassination,20,13,7
Pusufox,tichondrius,1099,rogue,assassination,24,12,12
Irunaway,thrall,1095,rogue,assassination,35,12,23
Wìndrunner,dalaran,1083,rogue,assassination,48,30,18
Vastørogue,azralon,1082,rogue,assassination,76,41,35
Ziggee,sargeras,1082,rogue,assassination,68,35,33
Smoketoad,tichondrius,1081,rogue,assassination,30,15,15
Roguebasic,frostmourne,1078,rogue,assassination,42,16,26
Fakie,quelthalas,1073,rogue,assassination,49,23,26
Trebyoyoyo,haomarush,1062,rogue,assassination,66,23,43
Osiriko,thunderlord,1061,rogue,assassination,114,61,53
Cashbigknife,area-52,1061,rogue,assassination,70,28,42
Morgoophh,azralon,1060,rogue,assassination,246,125,121
Aiden,burning-legion,1056,rogue,assassination,18,11,7
Ratlips,zuljin,1056,rogue,assassination,22,12,10
Frez,amanthul,1056,rogue,assassination,30,11,19
Vaporwavey,frostmourne,1055,rogue,assassination,18,11,7
Grafting,tichondrius,1055,rogue,assassination,24,11,13
Djfortníte,tichondrius,1055,rogue,assassination,24,11,13
Macsap,frostmourne,1053,rogue,assassination,24,11,13
Zipperx,tichondrius,1053,rogue,assassination,30,11,19
Stuns,azshara,1052,rogue,assassination,18,11,7
Effikacy,uldum,1051,rogue,assassination,24,11,13
Shigoo,sargeras,1051,rogue,assassination,24,11,13
Lefthook,kelthuzad,1051,rogue,assassination,37,15,22
Kazzo,tichondrius,1050,rogue,assassination,18,11,7
Nigthdead,nemesis,1049,rogue,assassination,18,11,7
Adrianstab,dalaran,1049,rogue,assassination,77,39,38
Venefix,windrunner,1049,rogue,assassination,52,24,28
Tortador,quelthalas,1048,rogue,assassination,74,35,39
Sinistro,bleeding-hollow,1046,rogue,assassination,30,14,16
Looprevil,andorhal,1043,rogue,assassination,24,14,10
Dochap,blackrock,1036,rogue,assassination,106,48,58
Caydeseis,stormrage,1031,rogue,assassination,18,11,7
Ñovä,tichondrius,1030,rogue,assassination,30,16,14
Cripstaet,spinebreaker,1029,rogue,assassination,25,12,13
Cjayy,bleeding-hollow,1028,rogue,assassination,37,13,24
Alavennian,tichondrius,1027,rogue,assassination,24,11,13
Brobrando,tichondrius,1026,rogue,assassination,24,11,13
Deathshadow,dethecus,1025,rogue,assassination,30,11,19
Oddblade,stormrage,1025,rogue,assassination,36,11,25
Picaroxp,drakkari,1020,rogue,assassination,18,11,7
Skigskag,shadowsong,1017,rogue,assassination,157,76,81
Vandalyze,sargeras,1010,rogue,assassination,23,11,12
Gygáx,terenas,1009,rogue,assassination,66,36,30
Edvardd,moon-guard,1007,rogue,assassination,67,34,33
Velsad,sargeras,1006,rogue,assassination,47,16,31
Elithr,nemesis,1002,rogue,assassination,24,11,13
Escape,elune,1001,rogue,assassination,30,14,16
Thoxic,barthilas,995,rogue,assassination,27,12,15
Daggerback,bleeding-hollow,994,rogue,assassination,77,41,36
Artymesia,medivh,988,rogue,assassination,30,15,15
Karing,onyxia,977,rogue,assassination,22,11,11
Pegglerogue,fizzcrank,977,rogue,assassination,84,37,47
Wolgan,nemesis,975,rogue,assassination,61,30,31
Lilgoosie,korgath,973,rogue,assassination,72,29,43
Lethalist,whisperwind,972,rogue,assassination,24,12,12
Slizard,boulderfist,971,rogue,assassination,19,11,8
Sheinnér,ragnaros,970,rogue,assassination,55,23,32
Cruelworld,stormrage,966,rogue,assassination,54,22,32
Gersonq,moon-guard,965,rogue,assassination,25,13,12
Swiftbones,burning-blade,964,rogue,assassination,30,14,16
Pokiri,wyrmrest-accord,963,rogue,assassination,90,40,50
Loligotyou,stormrage,962,rogue,assassination,64,20,44
Peeryl,daggerspine,961,rogue,assassination,139,77,62
Lakeshark,tichondrius,960,rogue,assassination,18,10,8
Gogothirteen,kiljaeden,960,rogue,assassination,32,15,17
Kents,tichondrius,960,rogue,assassination,24,10,14
Dizzymoods,stormrage,960,rogue,assassination,24,10,14
Synixi,moon-guard,960,rogue,assassination,24,10,14
Zareys,malorne,959,rogue,assassination,18,10,8
Nikjawar,illidan,959,rogue,assassination,24,11,13
Downsix,sargeras,959,rogue,assassination,24,10,14
Jxxs,zuljin,959,rogue,assassination,24,10,14
Joelpinkelit,illidan,958,rogue,assassination,29,10,19
Cerut,illidan,957,rogue,assassination,18,10,8
Combo,norgannon,956,rogue,assassination,24,10,14
Vhiper,azralon,956,rogue,assassination,30,10,20
Dylan,frostmourne,955,rogue,assassination,24,10,14
Orcwarhammer,tichondrius,954,rogue,assassination,28,15,13
Average,burning-blade,954,rogue,assassination,27,10,17
Snuzzy,darkspear,954,rogue,assassination,36,10,26
Sangreale,nemesis,953,rogue,assassination,18,10,8
Dockside,stormrage,953,rogue,assassination,18,10,8
Mcstabbface,tichondrius,951,rogue,assassination,18,10,8
Problemchild,rexxar,949,rogue,assassination,24,10,14
Wolfsire,queldorei,949,rogue,assassination,24,10,14
Gábagool,kiljaeden,949,rogue,assassination,36,10,26
Vozzy,proudmoore,947,rogue,assassination,30,17,13
Snoopdrogado,sargeras,947,rogue,assassination,76,37,39
Heimlichkeit,tichondrius,947,rogue,assassination,24,10,14
Xalsathoth,sargeras,946,rogue,assassination,36,10,26
Feote,ragnaros,943,rogue,assassination,40,22,18
Roguetwo,the-venture-co,943,rogue,assassination,30,15,15
Hattrìck,area-52,943,rogue,assassination,30,10,20
Kuntyou,barthilas,941,rogue,assassination,36,10,26
Headless,dragonmaw,934,rogue,assassination,76,38,38
Atomicgoat,tichondrius,928,rogue,assassination,33,12,21
Soupspoon,terenas,924,rogue,assassination,24,10,14
Euweu,azralon,914,rogue,assassination,24,10,14
Snub,aerie-peak,912,rogue,assassination,40,13,27
Pantypeelz,frostmourne,907,rogue,assassination,29,10,19
Sneakyfoot,gorgonnash,906,rogue,assassination,116,48,68
Requiescat,bleeding-hollow,902,rogue,assassination,27,10,17
Dabrat,frostwolf,899,rogue,assassination,90,40,50
Thenelis,dalaran,897,rogue,assassination,43,10,33
Streetjesuz,barthilas,896,rogue,assassination,16,10,6
Cryptixx,blades-edge,896,rogue,assassination,41,16,25
Yslkyle,skullcrusher,876,rogue,assassination,17,10,7
Emrogue,ragnaros,876,rogue,assassination,30,15,15
Criptoniø,azralon,873,rogue,assassination,63,30,33
Turyx,azralon,871,rogue,assassination,90,28,62
Endworldlife,stormrage,864,rogue,assassination,12,9,3
Unlucký,sargeras,864,rogue,assassination,12,9,3
Ka,blackhand,864,rogue,assassination,12,9,3
Chizza,frostmourne,864,rogue,assassination,18,10,8
Cmòón,tichondrius,864,rogue,assassination,18,9,9
Ahjii,malganis,864,rogue,assassination,30,9,21
Aah,doomhammer,863,rogue,assassination,12,9,3
Dezly,tichondrius,863,rogue,assassination,18,9,9
Whoox,khazgoroth,863,rogue,assassination,30,9,21
Mcskipa,sargeras,862,rogue,assassination,12,9,3
Shímira,azralon,862,rogue,assassination,18,9,9
Csguixuan,aerie-peak,862,rogue,assassination,24,9,15
Darkdessoft,ragnaros,861,rogue,assassination,24,9,15
Moardner,dalaran,860,rogue,assassination,84,30,54
Vayllie,zuljin,859,rogue,assassination,18,9,9
Nikosneako,tichondrius,859,rogue,assassination,36,9,27
Ballflicker,malganis,857,rogue,assassination,30,9,21
Shumira,tichondrius,856,rogue,assassination,18,9,9
Macabre,the-forgotten-coast,856,rogue,assassination,18,9,9
Cynalia,sargeras,854,rogue,assassination,21,9,12
Vanishman,ragnaros,853,rogue,assassination,12,9,3
Wreatus,moon-guard,853,rogue,assassination,108,44,64
Sneakynight,bleeding-hollow,850,rogue,assassination,24,9,15
Teach,illidan,849,rogue,assassination,102,37,65
Alkal,stormreaver,846,rogue,assassination,32,14,18
Revozy,azralon,831,rogue,assassination,42,15,27
Lanottee,sargeras,829,rogue,assassination,17,10,7
Ripsaw,muradin,829,rogue,assassination,18,9,9
Píxíedúst,black-dragonflight,812,rogue,assassination,34,10,24
Chersy,tichondrius,810,rogue,assassination,32,10,22
Zamorant,emerald-dream,806,rogue,assassination,53,11,42
Zapersapp,malygos,803,rogue,assassination,28,10,18
Luckycrit,frostwolf,788,rogue,assassination,36,14,22
Roadog,azralon,771,rogue,assassination,36,12,24
Elsegador,tichondrius,768,rogue,assassination,12,8,4
Ôñéèýèdkíñg,stormrage,768,rogue,assassination,12,8,4
Chickfilaye,auchindoun,768,rogue,assassination,18,8,10
Apssal,tichondrius,768,rogue,assassination,18,8,10
Lsdlover,tichondrius,768,rogue,assassination,18,8,10
Drakariano,ragnaros,768,rogue,assassination,18,8,10
Clairered,tichondrius,768,rogue,assassination,18,8,10
Lululee,tichondrius,768,rogue,assassination,18,8,10
Snakegødx,sargeras,768,rogue,assassination,21,9,12
Kdrx,thrall,768,rogue,assassination,24,8,16
Atulano,wyrmrest-accord,768,rogue,assassination,24,8,16
Warmode,zuluhed,767,rogue,assassination,12,8,4
Pike,barthilas,767,rogue,assassination,12,8,4
Exeg,tichondrius,767,rogue,assassination,12,8,4
Gøblìn,stormrage,767,rogue,assassination,15,9,6
Sagatha,bleeding-hollow,767,rogue,assassination,18,8,10
Gilbertgr,boulderfist,767,rogue,assassination,18,8,10
Kágé,ragnaros,767,rogue,assassination,18,8,10
Zetéra,ragnaros,767,rogue,assassination,18,8,10
Shiddlesz,area-52,767,rogue,assassination,18,8,10
Drtypzzaknfe,kelthuzad,767,rogue,assassination,24,8,16
Xshadowt,ragnaros,767,rogue,assassination,24,8,16
Frëdlock,kelthuzad,767,rogue,assassination,24,8,16
Sindor,azralon,767,rogue,assassination,32,8,24
Mylovejunex,tichondrius,766,rogue,assassination,12,8,4
ßackshots,kelthuzad,766,rogue,assassination,18,8,10
Moreover,tichondrius,766,rogue,assassination,18,8,10
Ssigma,tichondrius,765,rogue,assassination,24,8,16
Manersi,akama,764,rogue,assassination,24,8,16
Ðisappéar,ragnaros,764,rogue,assassination,33,9,24
Skîttlês,kul-tiras,762,rogue,assassination,18,8,10
Zropi,quelthalas,762,rogue,assassination,24,8,16
Slashinsteev,dalaran,761,rogue,assassination,18,8,10
Pikacuulo,ragnaros,760,rogue,assassination,31,9,22
Núm,tichondrius,756,rogue,assassination,32,12,20
Jaggeddagger,darrowmere,756,rogue,assassination,30,8,22
Banrouge,tichondrius,755,rogue,assassination,21,8,13
Snoor,nemesis,753,rogue,assassination,21,9,12
Killua,dalaran,752,rogue,assassination,18,8,10
Duonati,stormreaver,750,rogue,assassination,36,13,23
Dogedealer,ragnaros,747,rogue,assassination,12,8,4
Anyiele,stormrage,747,rogue,assassination,18,8,10
Smum,tichondrius,735,rogue,assassination,17,8,9
Savagedeeps,stormreaver,730,rogue,assassination,18,8,10
Djpopsicle,chogall,720,rogue,assassination,15,8,7
Slickdude,stormrage,717,rogue,assassination,66,14,52
Zoupa,sargeras,711,rogue,assassination,20,9,11
Cox,bleeding-hollow,708,rogue,assassination,14,10,4
Ghoulzer,tichondrius,704,rogue,assassination,10,8,2
Superharry,tichondrius,702,rogue,assassination,22,8,14
Youbleedred,frostmourne,672,rogue,assassination,12,7,5
Matic,skullcrusher,672,rogue,assassination,12,7,5
Jebubs,tichondrius,672,rogue,assassination,12,7,5
Carcass,moon-guard,672,rogue,assassination,12,7,5
Toxicplyer,malganis,672,rogue,assassination,12,7,5
Dzd,stormrage,672,rogue,assassination,12,7,5
Sotypical,area-52,672,rogue,assassination,12,7,5
Skitsöu,tichondrius,672,rogue,assassination,12,7,5
Lxw,frostmourne,672,rogue,assassination,12,7,5
Zunwick,tichondrius,672,rogue,assassination,12,7,5
Chriseanrock,illidan,672,rogue,assassination,12,7,5
Zaszune,stormrage,672,rogue,assassination,18,7,11
Elwynë,tichondrius,672,rogue,assassination,18,7,11
Nogodplsno,stormrage,672,rogue,assassination,18,7,11
Twoheaded,frostmourne,672,rogue,assassination,18,7,11
Mydearest,tichondrius,672,rogue,assassination,18,7,11
Alizashea,stormrage,671,rogue,assassination,12,7,5
Jackbuster,area-52,671,rogue,assassination,12,7,5
Løgîc,tichondrius,671,rogue,assassination,12,7,5
Deepman,gorefiend,671,rogue,assassination,12,7,5
Bootiebandit,tichondrius,671,rogue,assassination,12,7,5
Alithileria,moon-guard,671,rogue,assassination,12,7,5
Johnthefum,malganis,671,rogue,assassination,18,7,11
Ezzdeath,tichondrius,671,rogue,assassination,18,7,11
Showclass,stormrage,671,rogue,assassination,18,7,11
Takeiapika,azralon,671,rogue,assassination,18,7,11
Mhortai,stormrage,671,rogue,assassination,18,7,11
Gucciboo,sargeras,671,rogue,assassination,18,7,11
Tìnkerton,wyrmrest-accord,671,rogue,assassination,24,7,17
Mõtaru,stormrage,671,rogue,assassination,24,7,17
Mayyhem,caelestrasz,671,rogue,assassination,24,7,17
Schleazy,emerald-dream,670,rogue,assassination,12,7,5
Habock,ragnaros,670,rogue,assassination,17,7,10
Xhampu,ragnaros,670,rogue,assassination,18,7,11
Sap,garrosh,670,rogue,assassination,18,7,11
Hoochzors,deathwing,670,rogue,assassination,24,7,17
Anyiel,stormrage,670,rogue,assassination,24,7,17
Çrëeper,illidan,670,rogue,assassination,24,7,17
Jakkov,blackrock,666,rogue,assassination,18,7,11
Diamondiâ,moon-guard,666,rogue,assassination,30,7,23
Kiorz,tichondrius,665,rogue,assassination,12,7,5
Crowroyal,emerald-dream,665,rogue,assassination,24,7,17
Bityellow,tichondrius,663,rogue,assassination,12,7,5
Muffens,alterac-mountains,662,rogue,assassination,18,7,11
Slootslayer,azshara,662,rogue,assassination,18,7,11
Vladtsepesh,stormrage,662,rogue,assassination,30,7,23
Tralisong,azshara,660,rogue,assassination,18,7,11
Killdead,warsong,646,rogue,assassination,18,7,11
Tiptoez,bleeding-hollow,637,rogue,assassination,18,8,10
Runakó,kelthuzad,623,rogue,assassination,11,7,4
Pochomän,ragnaros,618,rogue,assassination,16,9,7
Onulyo,tichondrius,618,rogue,assassination,16,8,8
Passoafaca,azralon,616,rogue,assassination,26,8,18
Twinkasz,nemesis,615,rogue,assassination,22,8,14
Geratyere,trollbane,590,rogue,assassination,19,7,12
Saltoss,frostmourne,576,rogue,assassination,12,6,6
Jaywas,tichondrius,576,rogue,assassination,12,6,6
Movze,area-52,576,rogue,assassination,12,6,6
Chipetan,hyjal,576,rogue,assassination,12,6,6
Yggskuggi,moon-guard,576,rogue,assassination,12,6,6
Arcess,ragnaros,576,rogue,assassination,12,6,6
Mochachaya,tichondrius,576,rogue,assassination,12,6,6
Kayriss,antonidas,576,rogue,assassination,12,6,6
Bloodygoat,area-52,576,rogue,assassination,12,6,6
Nicknasty,kelthuzad,576,rogue,assassination,12,6,6
Mosedz,tichondrius,576,rogue,assassination,12,6,6
Luriél,stormrage,576,rogue,assassination,12,6,6
Lgy,chogall,576,rogue,assassination,12,6,6
Slipperydog,jubeithos,576,rogue,assassination,18,6,12
Ishtabbedyou,velen,576,rogue,assassination,18,6,12
Benielfman,illidan,576,rogue,assassination,18,6,12
Ahji,malganis,576,rogue,assassination,18,6,12
Daggerthorne,sargeras,576,rogue,assassination,18,6,12
Karlemagne,blackrock,576,rogue,assassination,18,6,12
Çõvìd,malganis,576,rogue,assassination,30,6,24
Virez,kelthuzad,576,rogue,assassination,30,6,24
Robinsony,tichondrius,575,rogue,assassination,12,6,6
Blaçkout,thrall,575,rogue,assassination,12,6,6
Slain,dark-iron,575,rogue,assassination,15,6,9
Ethaniel,bronzebeard,575,rogue,assassination,15,6,9
Miloandotis,malganis,575,rogue,assassination,18,6,12
Înfêrnô,emerald-dream,575,rogue,assassination,18,6,12
Goutetsu,area-52,575,rogue,assassination,24,6,18
Drcritalot,spinebreaker,574,rogue,assassination,12,6,6
Aurrora,kiljaeden,574,rogue,assassination,17,6,11
Mcvillain,kelthuzad,573,rogue,assassination,12,6,6
Vegettaa,azralon,573,rogue,assassination,18,6,12
Abuse,gundrak,571,rogue,assassination,12,6,6
Akalio,laughing-skull,571,rogue,assassination,18,6,12
Addvilpm,wyrmrest-accord,570,rogue,assassination,12,6,6
Annastasiya,moon-guard,568,rogue,assassination,18,6,12
Vitalz,bloodscalp,568,rogue,assassination,18,6,12
Nektulos,illidan,566,rogue,assassination,13,6,7
Hellwolf,azgalor,565,rogue,assassination,13,6,7
Drpepzi,tichondrius,565,rogue,assassination,24,6,18
Stabsizzle,tichondrius,558,rogue,assassination,23,6,17
Julius,malganis,543,rogue,assassination,14,7,7
Lvx,frostmourne,528,rogue,assassination,9,6,3
Genève,dreadmaul,526,rogue,assassination,11,6,5
Redspoison,dalaran,512,rogue,assassination,10,6,4
Sìcarìus,tichondrius,512,rogue,assassination,22,6,16
Offlinepk,area-52,511,rogue,assassination,12,7,5
Cassini,gorefiend,488,rogue,assassination,21,8,13
Purcius,moon-guard,480,rogue,assassination,6,5,1
Pwnsauce,frostmourne,480,rogue,assassination,7,5,2
Carnagê,zuljin,480,rogue,assassination,11,5,6
Toxan,emerald-dream,480,rogue,assassination,12,5,7
Váléntíná,tichondrius,480,rogue,assassination,12,5,7
Gomma,stormrage,480,rogue,assassination,12,5,7
Thâïßòÿgøóñ,jubeithos,480,rogue,assassination,12,5,7
Mercenàrioh,azralon,480,rogue,assassination,12,5,7
Vlayd,ragnaros,480,rogue,assassination,12,5,7
Akayod,tichondrius,480,rogue,assassination,12,5,7
Surprises,azralon,480,rogue,assassination,12,5,7
Bloore,fizzcrank,480,rogue,assassination,12,5,7
Cintan,barthilas,480,rogue,assassination,12,5,7
Bleedzbuttah,proudmoore,480,rogue,assassination,12,5,7
Fuzzyslow,stormrage,480,rogue,assassination,12,5,7
Roguespawn,dark-iron,480,rogue,assassination,12,5,7
Luan,tichondrius,480,rogue,assassination,12,5,7
Gaige,muradin,480,rogue,assassination,12,5,7
Venomsnáke,tichondrius,480,rogue,assassination,12,5,7
Sonymf,frostmourne,480,rogue,assassination,12,5,7
Ppdx,malganis,480,rogue,assassination,12,5,7
Maciota,area-52,480,rogue,assassination,12,5,7
Thugrz,illidan,480,rogue,assassination,12,5,7
Breakxcvii,bleeding-hollow,480,rogue,assassination,12,5,7
Outsap,tichondrius,480,rogue,assassination,12,5,7
Tberg,emerald-dream,480,rogue,assassination,12,5,7
Jezus,ghostlands,480,rogue,assassination,12,5,7
Gutshøt,tichondrius,480,rogue,assassination,12,5,7
Steffmaister,tichondrius,480,rogue,assassination,12,5,7
Dtelkham,tichondrius,480,rogue,assassination,16,6,10
Limitbreakkz,tichondrius,480,rogue,assassination,18,5,13
Joeyzord,stormrage,480,rogue,assassination,18,5,13
Yellowdawt,stormrage,480,rogue,assassination,18,5,13
Xm,sargeras,480,rogue,assassination,18,5,13
Beartøøth,stormrage,479,rogue,assassination,6,5,1
Paradise,smolderthorn,479,rogue,assassination,6,5,1
Poofhottie,lightbringer,479,rogue,assassination,12,5,7
Dessenia,illidan,479,rogue,assassination,12,5,7
Mashad,moon-guard,479,rogue,assassination,12,5,7
Bigcolumn,tichondrius,479,rogue,assassination,12,5,7
Kimomo,tichondrius,479,rogue,assassination,12,5,7
Prinseraegar,tichondrius,479,rogue,assassination,12,5,7
Teeice,bladefist,479,rogue,assassination,12,5,7
Scarrog,wyrmrest-accord,479,rogue,assassination,12,5,7
Slayersama,ragnaros,479,rogue,assassination,12,5,7
Meilh,emerald-dream,479,rogue,assassination,12,5,7
Vore,elune,479,rogue,assassination,12,5,7
Rinestiria,arthas,479,rogue,assassination,18,5,13
Bonzaipopo,stormrage,479,rogue,assassination,18,5,13
Villainrogue,stormrage,478,rogue,assassination,12,5,7
Bonizzi,stormrage,478,rogue,assassination,12,5,7
Maison,ragnaros,478,rogue,assassination,12,5,7
Adysius,malganis,475,rogue,assassination,12,5,7
Gurreth,zuljin,473,rogue,assassination,12,5,7
Donamarillo,sargeras,462,rogue,assassination,11,5,6
Gnaark,bleeding-hollow,447,rogue,assassination,11,5,6
Shizz,tichondrius,447,rogue,assassination,14,6,8
Elixera,sargeras,425,rogue,assassination,16,6,10
Minnicent,amanthul,413,rogue,assassination,10,5,5
Grima,azralon,384,rogue,assassination,6,4,2
Shaisty,malganis,384,rogue,assassination,6,4,2
Colom,moon-guard,384,rogue,assassination,6,4,2
Zervá,dalaran,384,rogue,assassination,6,4,2
Yurkarogue,tichondrius,384,rogue,assassination,6,4,2
Ballchinian,tichondrius,384,rogue,assassination,6,4,2
Chokonet,gurubashi,384,rogue,assassination,6,4,2
Silentzero,quelthalas,384,rogue,assassination,6,4,2
Endworldlife,tichondrius,384,rogue,assassination,6,4,2
Fofree,hyjal,384,rogue,assassination,6,4,2
Buckbreaker,stormrage,384,rogue,assassination,6,4,2
Taessin,kelthuzad,384,rogue,assassination,6,4,2
Tmpikaboo,tichondrius,384,rogue,assassination,6,4,2
Hollowtipzz,tichondrius,384,rogue,assassination,6,4,2
Crøøkedman,tichondrius,384,rogue,assassination,6,4,2
Vinrhayle,sargeras,384,rogue,assassination,6,4,2
Xaw,mannoroth,384,rogue,assassination,8,4,4
Ikerz,tichondrius,384,rogue,assassination,9,4,5
Frostheartyy,azralon,384,rogue,assassination,15,5,10
Deepsyo,frostmourne,384,rogue,assassination,12,4,8
Streetjudas,barthilas,384,rogue,assassination,12,4,8
Kargargar,thrall,384,rogue,assassination,12,4,8
Kehkoa,thrall,384,rogue,assassination,12,4,8
Señorcheddar,thrall,384,rogue,assassination,12,4,8
Akhila,stormrage,384,rogue,assassination,12,4,8
Bu,zuljin,384,rogue,assassination,12,4,8
Shadøw,the-forgotten-coast,384,rogue,assassination,12,4,8
Mirâge,illidan,384,rogue,assassination,12,4,8
Edaeda,tichondrius,384,rogue,assassination,12,4,8
Ccainy,stormrage,384,rogue,assassination,12,4,8
Cv,proudmoore,384,rogue,assassination,12,4,8
Psilocin,sargeras,384,rogue,assassination,12,4,8
Sillikitti,tichondrius,384,rogue,assassination,12,4,8
Muwop,barthilas,384,rogue,assassination,12,4,8
Inunofun,stormrage,384,rogue,assassination,12,4,8
Bungkhole,kiljaeden,384,rogue,assassination,12,4,8
Celèphaïs,tichondrius,384,rogue,assassination,12,4,8
Eski,kul-tiras,384,rogue,assassination,12,4,8
Sellers,tichondrius,384,rogue,assassination,12,4,8
Hirian,misha,384,rogue,assassination,12,4,8
Ninjamf,bleeding-hollow,384,rogue,assassination,12,4,8
Gridisx,wyrmrest-accord,384,rogue,assassination,12,4,8
Ghost,lightninghoof,384,rogue,assassination,12,4,8
Stabbyboy,malganis,384,rogue,assassination,12,4,8
Ròry,dark-iron,384,rogue,assassination,12,4,8
Gerpstab,darrowmere,384,rogue,assassination,12,4,8
Cryoph,illidan,384,rogue,assassination,12,4,8
Wowslayer,bleeding-hollow,384,rogue,assassination,12,4,8
Mansa,zangarmarsh,384,rogue,assassination,12,4,8
Aygon,laughing-skull,384,rogue,assassination,12,4,8
Skinnymayne,laughing-skull,384,rogue,assassination,18,4,14
Escurecer,azralon,384,rogue,assassination,18,4,14
Azrek,sargeras,384,rogue,assassination,18,4,14
Ggassasin,tichondrius,384,rogue,assassination,18,4,14
Denoms,area-52,384,rogue,assassination,18,4,14
Gladlol,stormrage,384,rogue,assassination,18,4,14
Wikkihx,emerald-dream,384,rogue,assassination,24,4,20
Eversincee,illidan,383,rogue,assassination,6,4,2
Shizz,malorne,383,rogue,assassination,6,4,2
Sapstabdead,blackrock,383,rogue,assassination,12,4,8
Diser,quelthalas,383,rogue,assassination,12,4,8
Moiatropos,ragnaros,383,rogue,assassination,12,4,8
Ñinjå,alleria,383,rogue,assassination,12,4,8
Corteleve,nemesis,383,rogue,assassination,12,4,8
Jestertyv,hyjal,383,rogue,assassination,12,4,8
Steeldiesel,sargeras,383,rogue,assassination,12,4,8
Setsu,sargeras,383,rogue,assassination,13,4,9
Hésta,moon-guard,382,rogue,assassination,12,4,8
Wrinklevoss,proudmoore,382,rogue,assassination,12,4,8
Kalandar,moon-guard,382,rogue,assassination,12,4,8
Ðerpius,proudmoore,381,rogue,assassination,12,4,8
Fllokii,arygos,381,rogue,assassination,12,4,8
Slobernocker,stormrage,381,rogue,assassination,12,4,8
Euphylezz,garrosh,379,rogue,assassination,12,4,8
Tolthe,hyjal,351,rogue,assassination,11,4,7
Atrreyu,lightninghoof,350,rogue,assassination,11,4,7
Merek,scarlet-crusade,336,rogue,assassination,9,4,5
Griefs,tichondrius,330,rogue,assassination,17,5,12
Whatsåpp,gallywix,320,rogue,assassination,10,4,6
Coopi,tichondrius,320,rogue,assassination,10,4,6
Pícáróóná,ragnaros,320,rogue,assassination,16,4,12
Suffêr,dalaran,319,rogue,assassination,8,4,4
Ziedrich,frostmourne,318,rogue,assassination,10,4,6
Ieu,tichondrius,288,rogue,assassination,6,3,3
Traviisto,sargeras,288,rogue,assassination,6,3,3
Velandros,eonar,288,rogue,assassination,6,3,3
Laralia,quelthalas,288,rogue,assassination,6,3,3
Emvee,kelthuzad,288,rogue,assassination,6,3,3
Jannie,rexxar,288,rogue,assassination,6,3,3
Bledstepelin,frostmourne,288,rogue,assassination,6,3,3
Deeshdosh,illidan,288,rogue,assassination,6,3,3
Saltypwncake,illidan,288,rogue,assassination,6,3,3
Vahrheit,tichondrius,288,rogue,assassination,6,3,3
Mcjagerx,darkspear,288,rogue,assassination,6,3,3
Gulvzer,tichondrius,288,rogue,assassination,6,3,3
Gbg,arathor,288,rogue,assassination,6,3,3
Tiladar,tichondrius,288,rogue,assassination,6,3,3
Ubun,quelthalas,288,rogue,assassination,6,3,3
Grîmmjow,ragnaros,288,rogue,assassination,6,3,3
Ghoststrider,sargeras,288,rogue,assassination,6,3,3
Wowamaze,aegwynn,288,rogue,assassination,6,3,3
Usernameqtxo,kelthuzad,288,rogue,assassination,6,3,3
Shninzy,stormrage,288,rogue,assassination,6,3,3
Brlsels,azralon,288,rogue,assassination,6,3,3
Anímosity,darkspear,288,rogue,assassination,6,3,3
Prodixybn,illidan,288,rogue,assassination,6,3,3
Cron,arygos,288,rogue,assassination,6,3,3
Kimorak,ragnaros,288,rogue,assassination,6,3,3
Dannodan,proudmoore,288,rogue,assassination,6,3,3
Dïeb,zuljin,288,rogue,assassination,6,3,3
Crohnns,barthilas,288,rogue,assassination,6,3,3
Bigtengu,tichondrius,288,rogue,assassination,6,3,3
Worrglaive,dalaran,288,rogue,assassination,6,3,3
Kurosh,kalecgos,288,rogue,assassination,6,3,3
Mügi,ragnaros,288,rogue,assassination,6,3,3
Pikabuu,bleeding-hollow,288,rogue,assassination,6,3,3
Greasybbsea,illidan,288,rogue,assassination,6,3,3
Bigheadtony,hellscream,288,rogue,assassination,6,3,3
Ncb,bleeding-hollow,288,rogue,assassination,6,3,3
Calebrogue,illidan,288,rogue,assassination,6,3,3
Corrier,tichondrius,288,rogue,assassination,6,3,3
Rýuu,bleeding-hollow,288,rogue,assassination,6,3,3
Punkyass,azralon,288,rogue,assassination,6,3,3
Kerasphorus,the-underbog,288,rogue,assassination,6,3,3
Syxs,sargeras,288,rogue,assassination,6,3,3
Mgv,aegwynn,288,rogue,assassination,7,3,4
Rokkhan,blackrock,288,rogue,assassination,12,3,9
Karmagoodttv,stormrage,288,rogue,assassination,12,3,9
Knav,destromath,288,rogue,assassination,12,3,9
Axm,azralon,288,rogue,assassination,12,3,9
Alttee,proudmoore,288,rogue,assassination,12,3,9
Tattoo,zuljin,288,rogue,assassination,12,3,9
Aevaela,duskwood,288,rogue,assassination,12,3,9
Trinktick,doomhammer,288,rogue,assassination,12,3,9
Åmg,tichondrius,288,rogue,assassination,12,3,9
Bubbski,area-52,288,rogue,assassination,12,3,9
Finlander,area-52,288,rogue,assassination,12,3,9
Flattsr,tichondrius,288,rogue,assassination,12,3,9
Redlïne,tichondrius,288,rogue,assassination,12,3,9
Brianä,quelthalas,288,rogue,assassination,12,3,9
Brudashmurda,tichondrius,288,rogue,assassination,12,3,9
Cydonian,ragnaros,288,rogue,assassination,12,3,9
Arïa,drakkari,288,rogue,assassination,12,3,9
Cut,ragnaros,288,rogue,assassination,12,3,9
Pintofwoc,area-52,288,rogue,assassination,12,3,9
Shortcut,khadgar,288,rogue,assassination,12,3,9
Sunshinezx,frostmourne,288,rogue,assassination,12,3,9
Pantsed,sargeras,288,rogue,assassination,12,3,9
Tìlt,whisperwind,288,rogue,assassination,12,3,9
Elevorra,frostmourne,288,rogue,assassination,12,3,9
Pezcore,illidan,288,rogue,assassination,12,3,9
Ereshkigall,ragnaros,288,rogue,assassination,18,3,15
Veridank,emerald-dream,287,rogue,assassination,6,3,3
Stunedya,destromath,287,rogue,assassination,6,3,3
Loruk,ragnaros,287,rogue,assassination,6,3,3
Shadownibba,illidan,287,rogue,assassination,6,3,3
Moridra,demon-soul,287,rogue,assassination,6,3,3
Clipp,wildhammer,287,rogue,assassination,6,3,3
Ghutrencha,area-52,287,rogue,assassination,6,3,3
Gilhela,bloodhoof,287,rogue,assassination,6,3,3
Talinô,moknathal,287,rogue,assassination,12,3,9
Tracemakerr,emerald-dream,287,rogue,assassination,12,3,9
Anarusekkusu,wyrmrest-accord,287,rogue,assassination,12,3,9
Lyndra,thunderlord,287,rogue,assassination,12,3,9
Olg,arathor,287,rogue,assassination,12,3,9
Chïdaruma,azralon,287,rogue,assassination,12,3,9
Cricketts,kalecgos,287,rogue,assassination,16,3,13
Greekstryker,durotan,286,rogue,assassination,6,3,3
Clothies,zuljin,285,rogue,assassination,12,3,9
Lupindathird,frostmane,285,rogue,assassination,12,3,9
Sanguinnar,nemesis,285,rogue,assassination,12,3,9
Synesh,moon-guard,255,rogue,assassination,11,3,8
Fatass,tichondrius,255,rogue,assassination,11,3,8
Pitfirex,area-52,239,rogue,assassination,5,3,2
Tamsy,the-forgotten-coast,239,rogue,assassination,5,3,2
Drøverînsane,thrall,239,rogue,assassination,5,3,2
Shigoku,tichondrius,239,rogue,assassination,11,3,8
Walnutrog,area-52,234,rogue,assassination,11,5,6
Pãndã,stormrage,234,rogue,assassination,13,4,9
Skairipa,agamaggan,232,rogue,assassination,7,4,3
Estabo,daggerspine,223,rogue,assassination,8,3,5
Borre,kiljaeden,206,rogue,assassination,13,3,10
Roguegirl,alexstrasza,202,rogue,assassination,18,4,14
Ryunøka,quelthalas,192,rogue,assassination,4,3,1
Swickwockdus,azralon,192,rogue,assassination,6,2,4
Ssjseem,sargeras,192,rogue,assassination,6,2,4
Kwins,cenarion-circle,192,rogue,assassination,6,2,4
Wildtrick,greymane,192,rogue,assassination,6,2,4
Cktko,stormrage,192,rogue,assassination,6,2,4
Darkfalleng,azralon,192,rogue,assassination,6,2,4
Thianir,emerald-dream,192,rogue,assassination,6,2,4
Amysix,antonidas,192,rogue,assassination,6,2,4
Ennmaa,azralon,192,rogue,assassination,6,2,4
Fishbae,sargeras,192,rogue,assassination,6,2,4
Galfuran,burning-legion,192,rogue,assassination,6,2,4
Gabrielgray,firetree,192,rogue,assassination,6,2,4
Himitu,tichondrius,192,rogue,assassination,6,2,4
Ninja,jubeithos,192,rogue,assassination,6,2,4
Guazona,stormrage,192,rogue,assassination,6,2,4
Kazúmi,stormrage,192,rogue,assassination,6,2,4
Someone,ravencrest,192,rogue,assassination,6,2,4
Kellthzard,goldrinn,192,rogue,assassination,6,2,4
Zogbu,stormrage,192,rogue,assassination,6,2,4
Toestumper,sargeras,192,rogue,assassination,6,2,4
Asneakyfox,thunderlord,192,rogue,assassination,6,2,4
Procz,kirin-tor,192,rogue,assassination,6,2,4
Quickflash,bloodhoof,192,rogue,assassination,6,2,4
Corchô,moon-guard,192,rogue,assassination,6,2,4
Letmesap,lothar,192,rogue,assassination,6,2,4
Allidoisstun,kelthuzad,192,rogue,assassination,6,2,4
Ganksterqt,dentarg,192,rogue,assassination,6,2,4
Lesty,kelthuzad,192,rogue,assassination,6,2,4
Ýûñí,tichondrius,192,rogue,assassination,6,2,4
Happyunhappy,illidan,192,rogue,assassination,6,2,4
Brand,bonechewer,192,rogue,assassination,6,2,4
Jpw,barthilas,192,rogue,assassination,6,2,4
Asyncore,tichondrius,192,rogue,assassination,6,2,4
Novarra,tichondrius,192,rogue,assassination,6,2,4
Historymaker,tichondrius,192,rogue,assassination,6,2,4
Garatan,nemesis,192,rogue,assassination,6,2,4
Poolover,barthilas,192,rogue,assassination,6,2,4
Smormu,bonechewer,192,rogue,assassination,6,2,4
Omnilol,zuljin,192,rogue,assassination,6,2,4
Zenshin,tichondrius,192,rogue,assassination,6,2,4
Yoodoo,nemesis,192,rogue,assassination,6,2,4
Haeqn,nemesis,192,rogue,assassination,6,2,4
Sneakyboye,barthilas,192,rogue,assassination,6,2,4
Roguemain,smolderthorn,192,rogue,assassination,6,2,4
Wolfmother,nemesis,192,rogue,assassination,6,2,4
Jaanmonty,frostmourne,192,rogue,assassination,6,2,4
Daisuky,nemesis,192,rogue,assassination,6,2,4
Dardeath,bleeding-hollow,192,rogue,assassination,6,2,4
Jolly,frostmourne,192,rogue,assassination,6,2,4
Militant,tichondrius,192,rogue,assassination,6,2,4
Baalos,medivh,192,rogue,assassination,6,2,4
Wyyre,hyjal,192,rogue,assassination,6,2,4
Robomom,illidan,192,rogue,assassination,6,2,4
Zaozaa,frostmourne,192,rogue,assassination,6,2,4
Yanh,tichondrius,192,rogue,assassination,6,2,4
Ilesire,frostmourne,192,rogue,assassination,6,2,4
Ccýs,tichondrius,192,rogue,assassination,6,2,4
Karmakula,wildhammer,192,rogue,assassination,6,2,4
Mermm,burning-blade,192,rogue,assassination,6,2,4
Shini,malganis,192,rogue,assassination,6,2,4
Gentlesaop,blackrock,192,rogue,assassination,6,2,4
Deathben,tichondrius,192,rogue,assassination,6,2,4
Savyt,dalaran,192,rogue,assassination,6,2,4
Ryoushei,ragnaros,192,rogue,assassination,6,2,4
Ninjapandax,arthas,192,rogue,assassination,6,2,4
Märlboro,ragnaros,192,rogue,assassination,6,2,4
Miklos,area-52,192,rogue,assassination,6,2,4
Tagerung,malganis,192,rogue,assassination,6,2,4
Soizhiro,ragnaros,192,rogue,assassination,6,2,4
Sneakysharky,frostmourne,192,rogue,assassination,6,2,4
Poohkié,malganis,192,rogue,assassination,6,2,4
Støné,azjolnerub,192,rogue,assassination,6,2,4
Salätzar,quelthalas,192,rogue,assassination,6,2,4
Vanishcdc,area-52,192,rogue,assassination,6,2,4
Ddeadlykiss,hydraxis,192,rogue,assassination,6,2,4
Nítzy,quelthalas,192,rogue,assassination,6,2,4
Benjisuwu,area-52,192,rogue,assassination,6,2,4
Itskanashi,frostmourne,192,rogue,assassination,6,2,4
Liridor,quelthalas,192,rogue,assassination,11,2,9
Monnarn,emerald-dream,192,rogue,assassination,11,2,9
Youngtugger,daggerspine,192,rogue,assassination,11,2,9
Seltzie,bleeding-hollow,192,rogue,assassination,12,2,10
Chuckydoll,sargeras,192,rogue,assassination,12,2,10
Jisatsu,undermine,192,rogue,assassination,12,2,10
Manyt,alterac-mountains,192,rogue,assassination,12,2,10
Antons,hellscream,192,rogue,assassination,12,2,10
Triarc,area-52,192,rogue,assassination,12,2,10
Leyff,stormrage,192,rogue,assassination,12,2,10
Stabsmcslice,laughing-skull,192,rogue,assassination,12,2,10
Geradyn,stormrage,192,rogue,assassination,12,2,10
Alts,tichondrius,192,rogue,assassination,12,2,10
Novocãin,draka,192,rogue,assassination,12,2,10
Slowtime,quelthalas,192,rogue,assassination,12,2,10
Bloodwish,tichondrius,192,rogue,assassination,12,2,10
Pleodonis,tichondrius,192,rogue,assassination,12,2,10
Nines,icecrown,192,rogue,assassination,12,2,10
Aghanaar,burning-legion,192,rogue,assassination,12,2,10
Watto,ragnaros,192,rogue,assassination,12,2,10
Subculture,emerald-dream,192,rogue,assassination,12,2,10
Swipeah,nathrezim,192,rogue,assassination,12,2,10
Dralax,ragnaros,192,rogue,assassination,18,2,16
Luuper,azralon,192,rogue,assassination,20,2,18
Jelloshots,blackhand,191,rogue,assassination,12,4,8
Wetwille,area-52,191,rogue,assassination,6,2,4
Cretos,jaedenar,191,rogue,assassination,6,2,4
Bekaa,nemesis,191,rogue,assassination,6,2,4
Diatonic,illidan,191,rogue,assassination,6,2,4
Shadowwolfe,saurfang,191,rogue,assassination,18,2,16
Donpablò,area-52,175,rogue,assassination,11,2,9
ßalto,bleeding-hollow,160,rogue,assassination,10,2,8
Swiftchen,illidan,159,rogue,assassination,5,2,3
Xavar,malganis,159,rogue,assassination,5,2,3
Slithroat,stormrage,159,rogue,assassination,5,2,3
Chronisch,area-52,159,rogue,assassination,5,2,3
Minato,eredar,138,rogue,assassination,9,4,5
Hazara,sargeras,138,rogue,assassination,11,3,8
Stâbitha,bloodscalp,138,rogue,assassination,20,4,16
Dopestalien,sargeras,96,rogue,assassination,6,1,5
Wuzi,azralon,96,rogue,assassination,6,1,5
Troclar,quelthalas,96,rogue,assassination,6,1,5
Assakiller,azralon,96,rogue,assassination,6,1,5
Deathxx,destromath,96,rogue,assassination,6,1,5
Ninjasasory,azralon,96,rogue,assassination,6,1,5
Elbryán,ragnaros,96,rogue,assassination,6,1,5
Freqax,quelthalas,96,rogue,assassination,6,1,5
Clicksbtns,area-52,96,rogue,assassination,6,1,5
Preceptor,azralon,96,rogue,assassination,6,1,5
Kiskapolyus,thrall,96,rogue,assassination,6,1,5
Yohigo,quelthalas,96,rogue,assassination,6,1,5
Rykojin,dalaran,96,rogue,assassination,6,1,5
Docheatt,dalaran,96,rogue,assassination,6,1,5
Valeeryn,thrall,96,rogue,assassination,6,1,5
Twotimed,magtheridon,96,rogue,assassination,6,1,5
Ntshaav,illidan,96,rogue,assassination,6,1,5
Meritra,ragnaros,96,rogue,assassination,6,1,5
Scylas,stormrage,96,rogue,assassination,6,1,5
Buhuhbles,area-52,96,rogue,assassination,6,1,5
Suturamaster,ragnaros,96,rogue,assassination,6,1,5
Erebüs,thunderlord,96,rogue,assassination,6,1,5
Vùdõõ,area-52,96,rogue,assassination,6,1,5
Rafikaa,ragnaros,96,rogue,assassination,6,1,5
Irtehpoke,tichondrius,96,rogue,assassination,6,1,5
Brutalpocket,malganis,96,rogue,assassination,6,1,5
Greased,arthas,96,rogue,assassination,6,1,5
Gianniv,chogall,96,rogue,assassination,6,1,5
Pocketwaffle,dalaran,96,rogue,assassination,6,1,5
Saintjon,bleeding-hollow,96,rogue,assassination,6,1,5
Tzs,sargeras,96,rogue,assassination,6,1,5
Dubiaroaches,tichondrius,96,rogue,assassination,6,1,5
Omnisc,tichondrius,96,rogue,assassination,6,1,5
Uppi,bleeding-hollow,96,rogue,assassination,6,1,5
Icantsleep,tichondrius,96,rogue,assassination,6,1,5
Zitihait,amanthul,96,rogue,assassination,6,1,5
Privz,sargeras,96,rogue,assassination,6,1,5
Catbreath,moonrunner,96,rogue,assassination,6,1,5
Nubes,illidan,96,rogue,assassination,6,1,5
Touchthetip,bleeding-hollow,96,rogue,assassination,6,1,5
Detektor,stormrage,96,rogue,assassination,6,1,5
Khlapncheeks,emerald-dream,96,rogue,assassination,6,1,5
Meadview,bleeding-hollow,96,rogue,assassination,6,1,5
Liesmith,kelthuzad,96,rogue,assassination,6,1,5
Canesuckr,stormrage,96,rogue,assassination,6,1,5
Lu,lethon,96,rogue,assassination,6,1,5
Sømeøne,malygos,96,rogue,assassination,6,1,5
Combøz,tichondrius,96,rogue,assassination,6,1,5
Hellgaa,zuljin,96,rogue,assassination,6,1,5
Stêf,zuljin,96,rogue,assassination,6,1,5
Illmurk,zuljin,96,rogue,assassination,6,1,5
Flinchyy,dalaran,96,rogue,assassination,6,1,5
Giftschlange,azralon,96,rogue,assassination,6,1,5
Tòúka,stormrage,96,rogue,assassination,6,1,5
Drsinz,tichondrius,96,rogue,assassination,6,1,5
Panamarojo,tichondrius,96,rogue,assassination,6,1,5
Slycraft,gorgonnash,96,rogue,assassination,6,1,5
Shhquiettime,norgannon,96,rogue,assassination,6,1,5
Burtonee,aegwynn,96,rogue,assassination,6,1,5
Zhaanth,bonechewer,96,rogue,assassination,6,1,5
Nebiroth,illidan,96,rogue,assassination,6,1,5
Sevrow,wyrmrest-accord,96,rogue,assassination,6,1,5
Tmterminel,moon-guard,96,rogue,assassination,6,1,5
Codeine,windrunner,96,rogue,assassination,6,1,5
Mizrogue,suramar,96,rogue,assassination,6,1,5
Muhtaal,moon-guard,96,rogue,assassination,6,1,5
Stabyou,sentinels,96,rogue,assassination,6,1,5
Spookyswap,blackrock,96,rogue,assassination,6,1,5
Twinkrogue,firetree,96,rogue,assassination,6,1,5
Nightmarës,frostmourne,96,rogue,assassination,6,1,5
Vehx,azjolnerub,96,rogue,assassination,6,1,5
Bourrasque,frostmourne,96,rogue,assassination,6,1,5
Roogue,frostmourne,96,rogue,assassination,6,1,5
Deejey,frostmourne,96,rogue,assassination,6,1,5
Razss,stormrage,96,rogue,assassination,8,1,7
Damídia,stormrage,96,rogue,assassination,10,1,9
Acrona,dathremar,96,rogue,assassination,12,1,11
Rabidlynsane,deathwing,96,rogue,assassination,12,1,11
Armonica,wyrmrest-accord,96,rogue,assassination,12,1,11
Kistef,tichondrius,96,rogue,assassination,12,1,11
Boogiedewitt,emerald-dream,96,rogue,assassination,12,1,11
Karparog,ragnaros,96,rogue,assassination,12,1,11
Keljadian,black-dragonflight,96,rogue,assassination,12,1,11
Voidbrain,area-52,96,rogue,assassination,12,1,11
Lilko,daggerspine,96,rogue,assassination,12,1,11
Véndéttá,area-52,96,rogue,assassination,12,1,11
Trecutter,grizzly-hills,96,rogue,assassination,12,1,11
Xô,lothar,96,rogue,assassination,12,1,11
Irotanin,thrall,95,rogue,assassination,6,1,5
Radiantrogue,nordrassil,79,rogue,assassination,5,1,4
Averagepimpn,tichondrius,79,rogue,assassination,5,1,4
Hadez,nemesis,63,rogue,assassination,4,1,3
Botches,bonechewer,48,rogue,assassination,3,1,2
Stabbindude,illidan,48,rogue,assassination,3,1,2
Raqed,eredar,48,rogue,assassination,3,1,2
Entriped,stormrage,48,rogue,assassination,3,1,2
Sûshì,tichondrius,48,rogue,assassination,9,1,8
Gilbarblo,skywall,48,rogue,assassination,9,1,8
Naoyuki,stormrage,42,rogue,assassination,7,2,5
Nargonis,illidan,42,rogue,assassination,8,2,6
Snazzyboots,sargeras,42,rogue,assassination,10,2,8
Parmigianore,ragnaros,42,rogue,assassination,10,2,8
Jerzs,tichondrius,42,rogue,assassination,11,2,9
Najmoiran,area-52,31,rogue,assassination,2,1,1
Ajy,tichondrius,31,rogue,assassination,2,1,1
Dàmìan,mugthol,31,rogue,assassination,2,1,1
Ascherx,illidan,16,rogue,assassination,1,1,0
Rompoloyo,quelthalas,15,rogue,assassination,1,1,0
Dyllbar,tichondrius,2283,shaman,restoration,157,89,68
Dadbar,tichondrius,2281,shaman,restoration,108,67,41
Samyeh,tichondrius,2252,shaman,restoration,83,55,28
Yooseafood,tichondrius,2248,shaman,restoration,113,70,43
Orochisháman,stormrage,2222,shaman,restoration,96,55,41
Aameng,tichondrius,2212,shaman,restoration,126,70,56
Illiteratex,tichondrius,2168,shaman,restoration,88,49,39
Plewt,zuljin,2166,shaman,restoration,218,118,100
Skipperx,thrall,2157,shaman,restoration,84,50,34
Ttvfoxyllama,tichondrius,2157,shaman,restoration,88,45,43
Akwesy,stormrage,2151,shaman,restoration,151,84,67
Xtremeorc,area-52,2148,shaman,restoration,72,41,31
Uncleilli,tichondrius,2139,shaman,restoration,101,55,46
Tréway,area-52,2135,shaman,restoration,66,41,25
Crazyshamañ,akama,2131,shaman,restoration,127,69,58
Restobyte,moon-guard,2124,shaman,restoration,78,47,31
Svanteson,wyrmrest-accord,2110,shaman,restoration,126,67,59
Spagetje,tichondrius,2098,shaman,restoration,371,190,181
Selketh,area-52,2082,shaman,restoration,85,48,37
Iissham,darkspear,2072,shaman,restoration,206,110,96
Chairstain,kelthuzad,2070,shaman,restoration,211,121,90
Kantok,quelthalas,2051,shaman,restoration,89,55,34
Nemix,barthilas,2049,shaman,restoration,66,38,28
Vicioushands,illidan,2047,shaman,restoration,66,37,29
Corianderism,tichondrius,2043,shaman,restoration,95,51,44
Madoka,llane,2035,shaman,restoration,107,57,50
Nediar,tichondrius,2031,shaman,restoration,72,47,25
Jîneth,tichondrius,2028,shaman,restoration,113,60,53
Abovesky,proudmoore,2022,shaman,restoration,198,99,99
Timpossible,tichondrius,2020,shaman,restoration,479,240,239
Lötus,tichondrius,2010,shaman,restoration,110,61,49
Itsallgoodx,tichondrius,2008,shaman,restoration,114,55,59
Gratiens,zuljin,2006,shaman,restoration,198,101,97
Breadx,khaz-modan,2002,shaman,restoration,36,21,15
Coreygunz,illidan,2001,shaman,restoration,60,32,28
Smlz,garrosh,1998,shaman,restoration,68,38,30
Sizure,frostmourne,1998,shaman,restoration,124,64,60
Kwesy,tichondrius,1995,shaman,restoration,54,31,23
Slimdavey,tichondrius,1991,shaman,restoration,214,118,96
Kurtcx,tichondrius,1987,shaman,restoration,473,241,232
Boyfromhell,stormrage,1985,shaman,restoration,103,50,53
Devilsham,tichondrius,1984,shaman,restoration,42,21,21
Berquon,tichondrius,1974,shaman,restoration,78,40,38
Hódoong,tichondrius,1972,shaman,restoration,58,30,28
Zavoky,tichondrius,1971,shaman,restoration,246,126,120
Shamaen,kelthuzad,1971,shaman,restoration,125,64,61
Üchihamadarâ,tichondrius,1968,shaman,restoration,67,37,30
Breuer,tichondrius,1966,shaman,restoration,128,64,64
Flarkology,area-52,1951,shaman,restoration,48,25,23
Blaiserpub,tichondrius,1947,shaman,restoration,82,42,40
Ilavayoualot,malganis,1940,shaman,restoration,148,68,80
Aureal,malganis,1938,shaman,restoration,198,116,82
Yungtooth,emerald-dream,1938,shaman,restoration,107,57,50
Terapatrik,area-52,1935,shaman,restoration,170,87,83
Plorenz,illidan,1934,shaman,restoration,60,36,24
Oryxx,kiljaeden,1934,shaman,restoration,84,40,44
Hodoongs,tichondrius,1932,shaman,restoration,61,32,29
Stormtitan,malganis,1932,shaman,restoration,140,71,69
Peyn,shadowsong,1930,shaman,restoration,90,43,47
Nayro,bleeding-hollow,1928,shaman,restoration,635,338,297
Muscleyuan,tichondrius,1927,shaman,restoration,71,33,38
Menc,frostmourne,1924,shaman,restoration,114,56,58
Ratedpvp,thrall,1923,shaman,restoration,200,115,85
Angrygochuxx,tichondrius,1920,shaman,restoration,35,21,14
Shamanbini,tichondrius,1920,shaman,restoration,71,35,36
Oridean,area-52,1911,shaman,restoration,48,26,22
Ogctkoy,illidan,1911,shaman,restoration,172,88,84
Stormlashx,sargeras,1909,shaman,restoration,42,24,18
Wâgu,moon-guard,1906,shaman,restoration,46,21,25
Cruv,thrall,1901,shaman,restoration,114,55,59
Shamanese,emerald-dream,1901,shaman,restoration,42,20,22
Kafkaesk,tichondrius,1900,shaman,restoration,72,32,40
Totempack,stormrage,1892,shaman,restoration,60,30,30
Nepos,dragonmaw,1891,shaman,restoration,66,34,32
Bigbadsac,frostmourne,1891,shaman,restoration,220,110,110
Lignipzyo,doomhammer,1888,shaman,restoration,54,28,26
Huáxià,tichondrius,1888,shaman,restoration,166,86,80
Däbü,tichondrius,1887,shaman,restoration,84,40,44
Onlytides,malganis,1885,shaman,restoration,66,46,20
Mandleman,tichondrius,1884,shaman,restoration,140,85,55
Smrtdeath,zuljin,1884,shaman,restoration,53,30,23
Bóòchainz,tichondrius,1881,shaman,restoration,34,21,13
Epicthesloth,sargeras,1881,shaman,restoration,59,32,27
Eboy,thrall,1877,shaman,restoration,265,137,128
Tisaa,illidan,1876,shaman,restoration,30,20,10
Fàlc,stormrage,1875,shaman,restoration,48,26,22
Sewerperson,zuljin,1873,shaman,restoration,60,32,28
Gragomga,area-52,1872,shaman,restoration,162,81,81
Nanosec,tichondrius,1871,shaman,restoration,42,27,15
Esqueue,sargeras,1871,shaman,restoration,48,29,19
Hulan,tichondrius,1865,shaman,restoration,36,20,16
Kellogsz,malganis,1864,shaman,restoration,102,46,56
Pedaphil,frostmourne,1863,shaman,restoration,66,37,29
Patzog,area-52,1861,shaman,restoration,42,25,17
Bômi,tichondrius,1861,shaman,restoration,184,96,88
Laydboiyo,tichondrius,1861,shaman,restoration,66,32,34
Badshock,tichondrius,1859,shaman,restoration,48,35,13
Haedodae,tichondrius,1857,shaman,restoration,81,32,49
Bigmontana,tichondrius,1856,shaman,restoration,54,31,23
Exceedër,ragnaros,1854,shaman,restoration,66,36,30
Cardïß,tichondrius,1854,shaman,restoration,48,26,22
Moistbeans,tichondrius,1854,shaman,restoration,48,26,22
Cmsi,tichondrius,1852,shaman,restoration,48,26,22
Torrentzx,sargeras,1848,shaman,restoration,66,31,35
Semtechs,tichondrius,1847,shaman,restoration,474,236,238
Moldymeatbox,emerald-dream,1847,shaman,restoration,96,47,49
Wtbtotem,tichondrius,1846,shaman,restoration,66,33,33
Helga,hellscream,1845,shaman,restoration,48,29,19
Solam,greymane,1845,shaman,restoration,60,31,29
Upyourtotem,illidan,1842,shaman,restoration,30,22,8
Shamcena,the-scryers,1842,shaman,restoration,51,28,23
Ogran,stormscale,1840,shaman,restoration,60,27,33
Chocopuff,bleeding-hollow,1838,shaman,restoration,66,33,33
Fluxxy,tichondrius,1838,shaman,restoration,115,53,62
Conjunction,azjolnerub,1837,shaman,restoration,65,29,36
Caibeeshammy,tichondrius,1836,shaman,restoration,241,123,118
Sokta,azgalor,1834,shaman,restoration,163,81,82
Stylesp,tichondrius,1833,shaman,restoration,60,32,28
Chontastic,darkspear,1833,shaman,restoration,60,27,33
Suzhixie,akama,1831,shaman,restoration,175,82,93
Raeoki,area-52,1830,shaman,restoration,215,114,101
Wanghaisham,kelthuzad,1830,shaman,restoration,123,63,60
Waymond,khadgar,1830,shaman,restoration,266,135,131
Chobawn,tichondrius,1829,shaman,restoration,60,32,28
Pingatronx,ragnaros,1829,shaman,restoration,60,29,31
Bluekid,barthilas,1828,shaman,restoration,54,30,24
Mybbro,kiljaeden,1827,shaman,restoration,110,54,56
Snoozeshaman,ragnaros,1826,shaman,restoration,36,21,15
Beyoncé,lethon,1826,shaman,restoration,53,30,23
Chazzwozza,area-52,1826,shaman,restoration,53,30,23
Hathul,bleeding-hollow,1826,shaman,restoration,60,33,27
Vlly,tichondrius,1826,shaman,restoration,59,27,32
Gweemextreme,tichondrius,1825,shaman,restoration,141,76,65
Tuskcrusher,dalaran,1825,shaman,restoration,72,30,42
Hehew,kelthuzad,1824,shaman,restoration,200,113,87
Gjök,nemesis,1824,shaman,restoration,54,22,32
Dehsaw,illidan,1821,shaman,restoration,108,54,54
Cryochemist,tichondrius,1819,shaman,restoration,29,23,6
Notmugg,sargeras,1819,shaman,restoration,54,31,23
Tarròò,bleeding-hollow,1819,shaman,restoration,60,34,26
Lavalavalava,eonar,1819,shaman,restoration,54,26,28
Itsyabøiwill,area-52,1818,shaman,restoration,90,54,36
Sunyang,tichondrius,1818,shaman,restoration,72,34,38
Bigspaghetti,thrall,1818,shaman,restoration,66,31,35
Muggz,sargeras,1818,shaman,restoration,72,33,39
Terrasham,barthilas,1818,shaman,restoration,47,20,27
Purpose,nerzhul,1817,shaman,restoration,54,33,21
Gyrogg,scilla,1816,shaman,restoration,525,278,247
Cigaretter,tichondrius,1816,shaman,restoration,80,33,47
Ryuubi,illidan,1815,shaman,restoration,54,34,20
Immabòt,tichondrius,1813,shaman,restoration,59,36,23
Overtax,tichondrius,1813,shaman,restoration,96,53,43
Dadidun,tichondrius,1813,shaman,restoration,48,25,23
Ericzlassoz,tichondrius,1812,shaman,restoration,66,42,24
Grymn,sargeras,1812,shaman,restoration,264,132,132
Kobecoopper,sargeras,1812,shaman,restoration,78,39,39
Kurtxc,tichondrius,1810,shaman,restoration,36,25,11
Dantheman,twisting-nether,1810,shaman,restoration,42,23,19
Seimitsu,tichondrius,1810,shaman,restoration,47,24,23
Kimflo,tichondrius,1810,shaman,restoration,508,254,254
Waterbro,tichondrius,1809,shaman,restoration,101,57,44
Annte,stonemaul,1809,shaman,restoration,64,32,32
Meatballs,kirin-tor,1809,shaman,restoration,62,31,31
Desee,bleeding-hollow,1809,shaman,restoration,54,27,27
Wulfey,sargeras,1808,shaman,restoration,53,28,25
Kandshamy,azralon,1807,shaman,restoration,118,69,49
Ookmetide,bleeding-hollow,1807,shaman,restoration,52,29,23
Wraethy,illidan,1807,shaman,restoration,368,192,176
Ghomragar,antonidas,1807,shaman,restoration,82,42,40
Willy,icecrown,1807,shaman,restoration,87,44,43
Ganvitchenko,illidan,1807,shaman,restoration,114,56,58
Totemgripper,moon-guard,1804,shaman,restoration,65,39,26
Hydrocheck,tichondrius,1804,shaman,restoration,94,54,40
Astrøcyte,tichondrius,1804,shaman,restoration,96,46,50
Tolík,ragnaros,1803,shaman,restoration,54,26,28
Earthspeaker,bleeding-hollow,1802,shaman,restoration,54,33,21
Lemmehex,illidan,1802,shaman,restoration,61,37,24
Zoeyzour,illidan,1802,shaman,restoration,445,235,210
Oceangrown,emerald-dream,1802,shaman,restoration,51,22,29
Joyrex,spinebreaker,1802,shaman,restoration,75,30,45
Jìmmybuckets,tichondrius,1801,shaman,restoration,59,37,22
Papatooties,tichondrius,1801,shaman,restoration,269,129,140
Stórmstruck,area-52,1800,shaman,restoration,72,41,31
Nktx,tichondrius,1800,shaman,restoration,118,66,52
Holdmytotum,tichondrius,1800,shaman,restoration,52,29,23
Zaapi,dalaran,1800,shaman,restoration,108,60,48
Nazugresha,bleeding-hollow,1800,shaman,restoration,42,23,19
Baseballcap,sargeras,1800,shaman,restoration,78,37,41
Shockmematty,tichondrius,1798,shaman,restoration,36,25,11
Inmø,ragnaros,1797,shaman,restoration,36,19,17
Dxxlol,tichondrius,1795,shaman,restoration,54,29,25
Haard,area-52,1795,shaman,restoration,42,22,20
Splashz,illidan,1792,shaman,restoration,107,52,55
Chessyc,ragnaros,1792,shaman,restoration,71,32,39
Fierymoo,frostmourne,1790,shaman,restoration,48,23,25
Zingysham,tichondrius,1785,shaman,restoration,93,48,45
Rollintotems,bleeding-hollow,1785,shaman,restoration,84,39,45
Drupman,dalaran,1784,shaman,restoration,48,24,24
Kromgul,malfurion,1784,shaman,restoration,102,48,54
Petrafk,illidan,1783,shaman,restoration,161,72,89
Bombadil,korgath,1782,shaman,restoration,42,22,20
Bubbacheeks,area-52,1781,shaman,restoration,84,50,34
Sleepysham,kelthuzad,1781,shaman,restoration,162,85,77
Booramqt,tichondrius,1780,shaman,restoration,47,27,20
Erbicklet,ragnaros,1780,shaman,restoration,202,107,95
Cpplol,tichondrius,1779,shaman,restoration,59,35,24
Boxfour,tichondrius,1777,shaman,restoration,105,50,55
Jangbi,malganis,1776,shaman,restoration,300,148,152
Hiermy,tichondrius,1775,shaman,restoration,53,29,24
Blazingtotem,dunemaul,1775,shaman,restoration,125,64,61
Taronì,zuljin,1775,shaman,restoration,108,50,58
Petzah,barthilas,1774,shaman,restoration,54,25,29
Ligegelol,tichondrius,1772,shaman,restoration,48,26,22
Badhealerip,tichondrius,1770,shaman,restoration,86,47,39
Shanasty,bleeding-hollow,1769,shaman,restoration,60,31,29
Ravaburst,sargeras,1769,shaman,restoration,111,51,60
Ränton,bleeding-hollow,1764,shaman,restoration,54,28,26
Diulama,tichondrius,1763,shaman,restoration,75,49,26
Charlesby,tichondrius,1763,shaman,restoration,216,124,92
Laji,cairne,1763,shaman,restoration,239,119,120
Vogaz,ragnaros,1761,shaman,restoration,70,35,35
Bozzyy,illidan,1761,shaman,restoration,114,56,58
Linkandwink,nerzhul,1760,shaman,restoration,42,24,18
Julíp,tichondrius,1760,shaman,restoration,58,23,35
Héadshot,bleeding-hollow,1758,shaman,restoration,172,87,85
Rawdogginher,dalaran,1757,shaman,restoration,42,26,16
Kolanji,akama,1756,shaman,restoration,78,48,30
Chomang,stormreaver,1755,shaman,restoration,132,62,70
Victorin,zuljin,1754,shaman,restoration,72,48,24
Treemanp,tichondrius,1753,shaman,restoration,132,89,43
Groundingtot,hydraxis,1753,shaman,restoration,66,36,30
Bobbybigdam,tichondrius,1752,shaman,restoration,93,50,43
Sylicious,barthilas,1751,shaman,restoration,36,24,12
Onagi,frostmourne,1751,shaman,restoration,108,62,46
Deephole,illidan,1751,shaman,restoration,241,120,121
Hotknifez,tichondrius,1749,shaman,restoration,36,19,17
Shawmen,zuljin,1748,shaman,restoration,208,110,98
Gatorwavez,bleeding-hollow,1746,shaman,restoration,89,51,38
Warríed,sargeras,1746,shaman,restoration,59,29,30
Suyy,tichondrius,1746,shaman,restoration,54,26,28
Shamangpt,illidan,1745,shaman,restoration,74,46,28
Camer,sargeras,1745,shaman,restoration,54,33,21
Toazty,stormscale,1745,shaman,restoration,75,44,31
Mastashamsta,illidan,1745,shaman,restoration,48,25,23
Svondo,illidan,1744,shaman,restoration,37,25,12
Blackfancy,thrall,1744,shaman,restoration,56,32,24
Chonchastic,darkspear,1741,shaman,restoration,54,27,27
Baodan,azshara,1740,shaman,restoration,143,68,75
Meepsham,kilrogg,1739,shaman,restoration,48,25,23
Aiyoubro,tichondrius,1738,shaman,restoration,47,26,21
Ftp,kelthuzad,1738,shaman,restoration,47,26,21
Esqueue,tichondrius,1736,shaman,restoration,36,22,14
Pookiexo,illidan,1736,shaman,restoration,41,25,16
Hoshwear,azralon,1733,shaman,restoration,57,40,17
Rantòn,bleeding-hollow,1733,shaman,restoration,59,27,32
Blackpïnk,tichondrius,1732,shaman,restoration,191,96,95
Moorgl,tichondrius,1732,shaman,restoration,53,26,27
Bacon,lightninghoof,1732,shaman,restoration,204,94,110
Multiduelist,bleeding-hollow,1731,shaman,restoration,60,40,20
Redds,tichondrius,1730,shaman,restoration,126,83,43
Juicedbydad,kelthuzad,1730,shaman,restoration,48,25,23
Flõp,dalaran,1729,shaman,restoration,32,22,10
Éspresso,moon-guard,1728,shaman,restoration,66,36,30
Xzxz,sargeras,1727,shaman,restoration,199,113,86
Funkesapien,tichondrius,1727,shaman,restoration,54,27,27
Slowpo,illidan,1727,shaman,restoration,65,26,39
Maloran,zuljin,1727,shaman,restoration,65,24,41
Lilgeeh,kelthuzad,1726,shaman,restoration,58,30,28
Oninobu,sargeras,1724,shaman,restoration,70,44,26
Evilabev,bonechewer,1724,shaman,restoration,30,18,12
Mitchestic,illidan,1724,shaman,restoration,119,50,69
Phxhouse,illidan,1722,shaman,restoration,324,159,165
Spampurge,emerald-dream,1721,shaman,restoration,36,21,15
Shamanesè,emerald-dream,1721,shaman,restoration,36,18,18
Sìxnìne,tichondrius,1716,shaman,restoration,68,32,36
Hoonjojjyans,tichondrius,1715,shaman,restoration,24,18,6
Inpantsment,barthilas,1714,shaman,restoration,151,78,73
Sln,bleeding-hollow,1714,shaman,restoration,36,18,18
Strives,icecrown,1713,shaman,restoration,96,49,47
Krazyc,sargeras,1713,shaman,restoration,96,49,47
Bizzarro,azgalor,1713,shaman,restoration,79,40,39
Ðiglett,frostmourne,1713,shaman,restoration,146,72,74
Tôôz,stormrage,1712,shaman,restoration,30,18,12
Duregar,tichondrius,1709,shaman,restoration,60,35,25
Belarix,emerald-dream,1709,shaman,restoration,229,111,118
Chiggys,area-52,1708,shaman,restoration,65,33,32
Fkwithme,burning-blade,1707,shaman,restoration,78,36,42
Tobírama,bleeding-hollow,1705,shaman,restoration,54,23,31
Slm,bleeding-hollow,1704,shaman,restoration,24,18,6
Hustlenflow,tichondrius,1704,shaman,restoration,60,32,28
Elementz,tichondrius,1703,shaman,restoration,222,116,106
Specifyz,arathor,1702,shaman,restoration,42,24,18
Elemka,sargeras,1700,shaman,restoration,36,24,12
Bigdictuna,sargeras,1700,shaman,restoration,278,150,128
Renghostwolf,illidan,1698,shaman,restoration,36,18,18
Lingduacn,tichondrius,1698,shaman,restoration,36,18,18
Doubletåp,emerald-dream,1697,shaman,restoration,41,20,21
Ozmats,malganis,1697,shaman,restoration,88,42,46
Bogz,korgath,1697,shaman,restoration,227,107,120
Xoweeknd,bleeding-hollow,1697,shaman,restoration,42,19,23
Magma,spirestone,1695,shaman,restoration,102,62,40
Shockxd,illidan,1695,shaman,restoration,48,25,23
Montageb,illidan,1694,shaman,restoration,39,29,10
Bootybpoppin,mugthol,1694,shaman,restoration,120,72,48
Møp,spirestone,1694,shaman,restoration,143,72,71
Namso,tichondrius,1693,shaman,restoration,42,23,19
Drammah,malganis,1691,shaman,restoration,72,33,39
Eletius,tichondrius,1690,shaman,restoration,29,26,3
Vrom,whisperwind,1690,shaman,restoration,90,51,39
Sin,bleeding-hollow,1690,shaman,restoration,36,20,16
Raywhiter,tichondrius,1690,shaman,restoration,84,40,44
Wegoagain,tichondrius,1690,shaman,restoration,42,20,22
Shacewoman,altar-of-storms,1690,shaman,restoration,198,92,106
Xruok,kelthuzad,1689,shaman,restoration,39,24,15
Ittøki,tichondrius,1689,shaman,restoration,41,24,17
Gunrose,proudmoore,1689,shaman,restoration,191,100,91
Hairyrichard,zuljin,1689,shaman,restoration,955,498,457
Anasyed,emerald-dream,1688,shaman,restoration,30,18,12
Rockzoa,tichondrius,1688,shaman,restoration,60,27,33
Shk,illidan,1686,shaman,restoration,42,27,15
Yehbeen,tichondrius,1686,shaman,restoration,42,25,17
Fatdixb,illidan,1684,shaman,restoration,52,30,22
Solidhomme,tichondrius,1684,shaman,restoration,42,23,19
Flappygooch,illidan,1683,shaman,restoration,113,51,62
Weoo,doomhammer,1683,shaman,restoration,71,32,39
Benjaminx,tichondrius,1682,shaman,restoration,113,70,43
Platewalrus,illidan,1682,shaman,restoration,42,24,18
Bizzarra,azshara,1681,shaman,restoration,39,26,13
Savs,tichondrius,1681,shaman,restoration,36,22,14
Naweiv,caelestrasz,1681,shaman,restoration,66,36,30
Ibreakanklez,bleeding-hollow,1681,shaman,restoration,42,20,22
Shozen,bonechewer,1679,shaman,restoration,125,61,64
Cosmô,sargeras,1679,shaman,restoration,48,20,28
Tanta,gurubashi,1678,shaman,restoration,57,25,32
Isagii,stormrage,1677,shaman,restoration,65,38,27
Windmyl,emerald-dream,1677,shaman,restoration,62,34,28
Dingfu,sargeras,1676,shaman,restoration,202,117,85
Rynoh,dalaran,1675,shaman,restoration,121,64,57
Nethyxsoy,frostmourne,1673,shaman,restoration,48,33,15
Sorgal,area-52,1673,shaman,restoration,66,26,40
Plzdontlos,illidan,1672,shaman,restoration,161,96,65
Urga,hyjal,1672,shaman,restoration,36,20,16
Devastaterr,bleeding-hollow,1671,shaman,restoration,134,69,65
Paoran,sargeras,1670,shaman,restoration,70,35,35
Tpokes,sargeras,1669,shaman,restoration,42,22,20
Qksilverz,nemesis,1669,shaman,restoration,83,43,40
Thelphor,nemesis,1669,shaman,restoration,48,24,24
Peegee,zuluhed,1669,shaman,restoration,90,41,49
Wûbbie,emerald-dream,1669,shaman,restoration,55,20,35
Shamanceylol,barthilas,1668,shaman,restoration,134,73,61
Tokuma,illidan,1667,shaman,restoration,58,26,32
Drekkhal,area-52,1666,shaman,restoration,178,104,74
Horizonsham,stormrage,1666,shaman,restoration,66,36,30
Skipler,stormrage,1666,shaman,restoration,66,36,30
Zeonard,ragnaros,1666,shaman,restoration,270,141,129
Animus,dark-iron,1665,shaman,restoration,48,30,18
Toxidizetkö,azralon,1664,shaman,restoration,48,26,22
Kelta,kelthuzad,1664,shaman,restoration,54,27,27
Semnicktotem,area-52,1663,shaman,restoration,72,36,36
Gabant,azralon,1663,shaman,restoration,48,23,25
Heniu,tichondrius,1663,shaman,restoration,60,27,33
Durogh,darkspear,1663,shaman,restoration,68,28,40
Shadowz,alexstrasza,1662,shaman,restoration,92,56,36
Hamrok,moon-guard,1662,shaman,restoration,84,42,42
Reppinsix,sargeras,1662,shaman,restoration,58,24,34
Ribbeye,tichondrius,1661,shaman,restoration,166,80,86
Bluepigo,tichondrius,1660,shaman,restoration,59,24,35
Tizm,stormrage,1659,shaman,restoration,42,26,16
Prêttylights,bleeding-hollow,1659,shaman,restoration,36,20,16
Youliuhua,tichondrius,1659,shaman,restoration,36,19,17
Exshocks,tichondrius,1658,shaman,restoration,54,30,24
Imd,tichondrius,1658,shaman,restoration,42,21,21
Lingdusm,tichondrius,1657,shaman,restoration,36,20,16
Gorillox,chogall,1657,shaman,restoration,42,23,19
Vayces,barthilas,1657,shaman,restoration,199,103,96
Nerfmytotems,barthilas,1656,shaman,restoration,48,27,21
Zuescannon,kelthuzad,1656,shaman,restoration,84,39,45
Restosêxual,tichondrius,1655,shaman,restoration,42,21,21
Meskthemage,barthilas,1654,shaman,restoration,47,23,24
Novoz,tichondrius,1653,shaman,restoration,42,24,18
Whameradetu,suramar,1653,shaman,restoration,71,31,40
Goobie,crushridge,1651,shaman,restoration,68,43,25
Win,blackwing-lair,1651,shaman,restoration,36,21,15
Blueteam,blackrock,1651,shaman,restoration,42,21,21
Cmz,bleeding-hollow,1650,shaman,restoration,137,76,61
Rogrim,malganis,1650,shaman,restoration,66,36,30
Mixxt,illidan,1649,shaman,restoration,36,19,17
Bolteon,malganis,1648,shaman,restoration,30,21,9
Okïòmó,proudmoore,1648,shaman,restoration,47,21,26
Prowdt,azralon,1646,shaman,restoration,430,225,205
Jsell,zuljin,1646,shaman,restoration,56,28,28
Amdshaman,thrall,1645,shaman,restoration,67,37,30
Luckyscatter,frostmourne,1645,shaman,restoration,48,23,25
Badclass,the-underbog,1644,shaman,restoration,53,30,23
Zechary,proudmoore,1643,shaman,restoration,65,40,25
Scroogz,emerald-dream,1642,shaman,restoration,120,59,61
Mastlau,tichondrius,1642,shaman,restoration,72,35,37
Ekss,tichondrius,1642,shaman,restoration,48,19,29
Redek,sargeras,1641,shaman,restoration,268,147,121
Squimbert,tichondrius,1641,shaman,restoration,48,21,27
Singleorigin,tichondrius,1641,shaman,restoration,105,41,64
Darcheros,quelthalas,1640,shaman,restoration,78,42,36
Akheeta,tichondrius,1639,shaman,restoration,69,47,22
Chainstuff,area-52,1639,shaman,restoration,53,29,24
Ciroc,sargeras,1639,shaman,restoration,35,19,16
Ethikas,tichondrius,1638,shaman,restoration,42,24,18
Erwin,bonechewer,1638,shaman,restoration,225,123,102
Beastofmagic,illidan,1638,shaman,restoration,125,68,57
Dgshaman,tichondrius,1637,shaman,restoration,32,20,12
Cheddaman,kiljaeden,1637,shaman,restoration,48,21,27
Unbreakable,illidan,1635,shaman,restoration,97,47,50
Angelbie,tichondrius,1635,shaman,restoration,80,37,43
Daddybeaarr,thrall,1635,shaman,restoration,55,25,30
Humiliated,stormrage,1635,shaman,restoration,42,18,24
Randomshammy,stormrage,1634,shaman,restoration,78,44,34
Dolshamizzy,tichondrius,1634,shaman,restoration,84,41,43
Gjok,nemesis,1634,shaman,restoration,59,20,39
Quitnectar,aggramar,1633,shaman,restoration,48,24,24
Okinn,malganis,1632,shaman,restoration,35,20,15
Totemslol,ysera,1632,shaman,restoration,95,47,48
Pèpé,sargeras,1631,shaman,restoration,61,36,25
Rocksbury,malganis,1631,shaman,restoration,36,21,15
Shortbusqt,hyjal,1631,shaman,restoration,42,23,19
Wawsham,tichondrius,1631,shaman,restoration,48,19,29
Biguaga,tichondrius,1629,shaman,restoration,42,24,18
Raxshock,stormrage,1629,shaman,restoration,48,26,22
Colterr,thunderhorn,1628,shaman,restoration,51,25,26
Stormstrikes,tichondrius,1628,shaman,restoration,88,39,49
Intruzionall,barthilas,1627,shaman,restoration,241,130,111
Wonima,tichondrius,1627,shaman,restoration,34,18,16
Badjojò,ragnaros,1627,shaman,restoration,36,17,19
Laodo,tichondrius,1627,shaman,restoration,40,18,22
Dadauera,azralon,1626,shaman,restoration,87,48,39
Rugmat,tichondrius,1626,shaman,restoration,96,50,46
Baern,thrall,1626,shaman,restoration,98,47,51
Streamsnipe,sargeras,1624,shaman,restoration,100,68,32
Bigamez,azuremyst,1624,shaman,restoration,171,95,76
Drfentanylx,emerald-dream,1623,shaman,restoration,30,17,13
Thunderspark,tichondrius,1622,shaman,restoration,54,30,24
Dbmx,tichondrius,1622,shaman,restoration,36,20,16
Spiritry,tichondrius,1622,shaman,restoration,204,107,97
Blck,malorne,1622,shaman,restoration,53,25,28
Sasgöb,illidan,1622,shaman,restoration,101,43,58
Enfusiontv,tichondrius,1621,shaman,restoration,30,21,9
Texmawave,moon-guard,1621,shaman,restoration,125,71,54
Thuntard,bleeding-hollow,1621,shaman,restoration,48,23,25
Abulailah,sargeras,1620,shaman,restoration,114,58,56
Purgedubx,tichondrius,1619,shaman,restoration,332,178,154
Keekballx,tichondrius,1619,shaman,restoration,60,28,32
Yoshìmìtsu,illidan,1618,shaman,restoration,102,53,49
Kimchimi,tichondrius,1616,shaman,restoration,192,108,84
Dazu,drakkari,1614,shaman,restoration,57,38,19
World,frostmourne,1614,shaman,restoration,47,25,22
Quendella,aggramar,1613,shaman,restoration,42,25,17
Gordonramsai,sargeras,1613,shaman,restoration,325,173,152
Polared,hyjal,1613,shaman,restoration,52,25,27
Velar,frostwolf,1613,shaman,restoration,48,19,29
Todems,kalecgos,1612,shaman,restoration,42,24,18
Gödöfbüdå,tichondrius,1611,shaman,restoration,42,22,20
Makocc,tichondrius,1611,shaman,restoration,48,24,24
Dreadxtotems,illidan,1610,shaman,restoration,77,42,35
Catchclause,eonar,1610,shaman,restoration,54,29,25
Grizze,bonechewer,1610,shaman,restoration,96,43,53
Orbys,illidan,1609,shaman,restoration,62,34,28
Jazzlightnin,tichondrius,1609,shaman,restoration,77,35,42
Mcwindyfists,zuljin,1609,shaman,restoration,84,38,46
Tesle,illidan,1609,shaman,restoration,54,24,30
Ðoomed,kiljaeden,1608,shaman,restoration,30,19,11
Alett,arathor,1608,shaman,restoration,60,29,31
Moosk,zuluhed,1607,shaman,restoration,57,32,25
Harigomi,tichondrius,1607,shaman,restoration,360,186,174
Flêùrs,zuljin,1607,shaman,restoration,45,23,22
Rainingheals,auchindoun,1607,shaman,restoration,44,19,25
Randomshammy,area-52,1606,shaman,restoration,30,17,13
Astrauk,nemesis,1606,shaman,restoration,76,43,33
Neosham,frostwolf,1606,shaman,restoration,94,43,51
Chingobling,illidan,1605,shaman,restoration,54,31,23
Hexrz,area-52,1605,shaman,restoration,42,21,21
Surginate,zuljin,1605,shaman,restoration,42,18,24
Sliditin,tichondrius,1604,shaman,restoration,36,25,11
Steveyy,frostmourne,1604,shaman,restoration,51,31,20
Tevya,dalvengyr,1604,shaman,restoration,107,60,47
Spampurge,blackwing-lair,1604,shaman,restoration,37,19,18
Ssaotizi,tichondrius,1604,shaman,restoration,353,179,174
Improvize,malganis,1604,shaman,restoration,70,35,35
Polarities,malganis,1604,shaman,restoration,54,21,33
Kratór,kelthuzad,1603,shaman,restoration,47,31,16
Snooze,ragnaros,1603,shaman,restoration,42,25,17
Uglybastrd,stormrage,1603,shaman,restoration,30,17,13
Fernetbrança,ragnaros,1603,shaman,restoration,48,26,22
Yarzin,azjolnerub,1603,shaman,restoration,48,25,23
Specify,arathor,1603,shaman,restoration,114,53,61
Lebs,barthilas,1602,shaman,restoration,32,21,11
Telchar,quelthalas,1602,shaman,restoration,102,62,40
Sacredcowxd,tichondrius,1602,shaman,restoration,66,34,32
Tarritos,ragnaros,1602,shaman,restoration,52,26,26
Centalinkxox,frostmourne,1602,shaman,restoration,63,31,32
Lacid,tichondrius,1601,shaman,restoration,68,42,26
Belshiro,sargeras,1601,shaman,restoration,108,51,57
Latorius,frostmourne,1600,shaman,restoration,171,99,72
Shocksfuker,stormrage,1600,shaman,restoration,104,58,46
Succmytotems,tichondrius,1600,shaman,restoration,93,47,46
Foilcap,bonechewer,1600,shaman,restoration,296,144,152
Improvedx,akama,1600,shaman,restoration,52,24,28
Ddogz,illidan,1600,shaman,restoration,48,21,27
Gulmuwu,zuljin,1599,shaman,restoration,38,22,16
Yeeraldyn,quelthalas,1599,shaman,restoration,60,29,31
Ryeqt,illidan,1598,shaman,restoration,47,23,24
Noolube,barthilas,1598,shaman,restoration,54,25,29
Gemoz,tichondrius,1597,shaman,restoration,30,22,8
Óompaloompa,frostmourne,1596,shaman,restoration,36,17,19
Bestbrook,tichondrius,1596,shaman,restoration,153,71,82
Wastedlink,tichondrius,1594,shaman,restoration,30,17,13
Tideoverdose,tichondrius,1594,shaman,restoration,36,19,17
Dumerslayer,ragnaros,1594,shaman,restoration,42,22,20
Cherryboy,illidan,1593,shaman,restoration,112,55,57
Sleepowl,tichondrius,1593,shaman,restoration,42,20,22
Shocknrot,maelstrom,1592,shaman,restoration,44,24,20
Asøg,emerald-dream,1592,shaman,restoration,75,35,40
Gki,tichondrius,1591,shaman,restoration,55,36,19
Yeamn,saurfang,1591,shaman,restoration,165,97,68
Shocksauce,tichondrius,1591,shaman,restoration,106,56,50
Lazie,perenolde,1590,shaman,restoration,30,19,11
Aishel,area-52,1589,shaman,restoration,42,21,21
Turborundat,area-52,1586,shaman,restoration,225,127,98
Besylate,illidan,1586,shaman,restoration,86,42,44
Snakesoul,area-52,1585,shaman,restoration,133,73,60
Vywolf,frostmourne,1583,shaman,restoration,80,46,34
Goranzo,emerald-dream,1582,shaman,restoration,72,31,41
Lilcaju,sargeras,1581,shaman,restoration,29,18,11
Macksimas,tichondrius,1581,shaman,restoration,36,19,17
Vernzi,laughing-skull,1579,shaman,restoration,42,27,15
Hruggol,bleeding-hollow,1579,shaman,restoration,108,59,49
Skoobasteeve,sargeras,1579,shaman,restoration,99,52,47
Insîdious,thrall,1578,shaman,restoration,30,19,11
Pkx,eitrigg,1578,shaman,restoration,47,20,27
Hexxercise,area-52,1577,shaman,restoration,74,52,22
Packspiritqt,tichondrius,1577,shaman,restoration,48,27,21
Asnalda,emerald-dream,1577,shaman,restoration,81,44,37
Fuzzymuzzy,illidan,1574,shaman,restoration,88,47,41
Rainz,aggramar,1574,shaman,restoration,42,22,20
Arkerus,emerald-dream,1573,shaman,restoration,42,25,17
Goatedsham,dalaran,1573,shaman,restoration,71,40,31
Nessannix,stormrage,1573,shaman,restoration,240,129,111
Chitoss,gorgonnash,1573,shaman,restoration,221,116,105
Onepunchsham,illidan,1573,shaman,restoration,213,110,103
Tides,skullcrusher,1573,shaman,restoration,96,45,51
Shamix,area-52,1573,shaman,restoration,84,39,45
Dawnyshock,arygos,1573,shaman,restoration,41,19,22
Harth,zuljin,1572,shaman,restoration,128,72,56
Draidosh,area-52,1571,shaman,restoration,101,59,42
Sikotics,area-52,1571,shaman,restoration,117,61,56
Ivìxi,area-52,1571,shaman,restoration,64,30,34
Shakrakhan,tichondrius,1571,shaman,restoration,48,21,27
Chacham,tichondrius,1570,shaman,restoration,115,63,52
Enalen,argent-dawn,1567,shaman,restoration,85,48,37
Zuralah,nemesis,1566,shaman,restoration,160,85,75
Dduddaddu,tichondrius,1565,shaman,restoration,72,37,35
Deathwards,frostmane,1564,shaman,restoration,78,36,42
Spurske,emerald-dream,1564,shaman,restoration,78,32,46
Bigdampurge,illidan,1563,shaman,restoration,95,49,46
Waater,lightbringer,1562,shaman,restoration,86,49,37
Kencyzz,tichondrius,1561,shaman,restoration,29,17,12
Wilmar,ragnaros,1560,shaman,restoration,66,33,33
Stonetides,tichondrius,1560,shaman,restoration,78,33,45
Dogecoincäsh,sargeras,1559,shaman,restoration,72,39,33
Ophitotem,zuljin,1559,shaman,restoration,36,19,17
Shulace,area-52,1559,shaman,restoration,84,41,43
Halfinha,nemesis,1558,shaman,restoration,352,180,172
Rulf,proudmoore,1558,shaman,restoration,90,34,56
Bwinthewomb,stormrage,1557,shaman,restoration,154,83,71
Vzla,ragnaros,1555,shaman,restoration,96,54,42
Chlckenx,tichondrius,1552,shaman,restoration,129,62,67
Eatmymeatbal,illidan,1551,shaman,restoration,65,26,39
Pherolex,tichondrius,1550,shaman,restoration,42,23,19
Muruaic,dentarg,1549,shaman,restoration,160,83,77
Ryukims,tichondrius,1549,shaman,restoration,47,23,24
Goosha,tichondrius,1548,shaman,restoration,48,33,15
Kuhdos,caelestrasz,1548,shaman,restoration,42,24,18
Vanella,malganis,1548,shaman,restoration,66,34,32
Lustlolol,korgath,1547,shaman,restoration,167,86,81
Mistarklean,malganis,1546,shaman,restoration,117,52,65
Kayadee,stormrage,1545,shaman,restoration,86,42,44
Tideful,area-52,1545,shaman,restoration,60,28,32
Hennytides,zuljin,1543,shaman,restoration,48,25,23
Trouvaille,tichondrius,1543,shaman,restoration,47,23,24
Tyar,area-52,1543,shaman,restoration,137,64,73
Shaminham,barthilas,1543,shaman,restoration,72,31,41
Isekai,alterac-mountains,1542,shaman,restoration,137,70,67
Tzyorz,illidan,1542,shaman,restoration,198,101,97
Allcatraz,zuljin,1542,shaman,restoration,88,42,46
Pedren,thrall,1541,shaman,restoration,33,25,8
Shamxrob,sargeras,1541,shaman,restoration,78,46,32
Purgebotx,bleeding-hollow,1541,shaman,restoration,294,162,132
Deso,terenas,1541,shaman,restoration,124,64,60
Koomrog,frostmourne,1540,shaman,restoration,44,29,15
Lunds,tichondrius,1539,shaman,restoration,36,19,17
Hooldcool,tichondrius,1538,shaman,restoration,295,167,128
Totesmcgoatz,arthas,1538,shaman,restoration,75,39,36
Tenyks,tichondrius,1537,shaman,restoration,75,42,33
Wolfsokar,emerald-dream,1537,shaman,restoration,102,39,63
Akubai,kelthuzad,1535,shaman,restoration,78,39,39
Girthquake,agamaggan,1535,shaman,restoration,48,20,28
Fwwrs,illidan,1534,shaman,restoration,31,19,12
Tripsit,illidan,1531,shaman,restoration,42,16,26
Kacham,nerzhul,1530,shaman,restoration,36,20,16
Turtleinmud,frostmourne,1530,shaman,restoration,78,42,36
Booramz,tichondrius,1529,shaman,restoration,24,16,8
Xotheweeknd,bleeding-hollow,1529,shaman,restoration,30,16,14
Rookieshaman,tichondrius,1528,shaman,restoration,24,16,8
Oldguy,ragnaros,1526,shaman,restoration,227,114,113
Starrey,frostmourne,1526,shaman,restoration,36,17,19
Kaytahn,proudmoore,1525,shaman,restoration,72,39,33
Woobsz,sargeras,1524,shaman,restoration,24,17,7
Repang,tichondrius,1523,shaman,restoration,36,19,17
Vexxs,shadowmoon,1522,shaman,restoration,30,16,14
Riptideafk,sargeras,1521,shaman,restoration,66,34,32
Moocatpie,illidan,1521,shaman,restoration,124,60,64
Rocyt,sargeras,1520,shaman,restoration,66,35,31
Nagiska,ragnaros,1520,shaman,restoration,45,19,26
Ekuku,tichondrius,1519,shaman,restoration,76,42,34
Aleforj,quelthalas,1519,shaman,restoration,55,27,28
Rsdyxjh,tichondrius,1519,shaman,restoration,51,22,29
Umadilia,area-52,1517,shaman,restoration,42,27,15
Shockszz,onyxia,1517,shaman,restoration,149,72,77
Shamsom,tichondrius,1516,shaman,restoration,146,68,78
Yggiz,stormrage,1514,shaman,restoration,36,20,16
Fenrirfuryy,tichondrius,1514,shaman,restoration,54,25,29
Reuxxe,area-52,1513,shaman,restoration,224,115,109
Jbalvi,ragnaros,1512,shaman,restoration,183,98,85
Stylebenderx,frostmourne,1512,shaman,restoration,30,16,14
Freesolo,barthilas,1512,shaman,restoration,240,123,117
Todayqt,malganis,1512,shaman,restoration,36,16,20
Sellmysoul,kelthuzad,1511,shaman,restoration,105,53,52
Spongemama,tichondrius,1511,shaman,restoration,82,41,41
Bluedynamite,tichondrius,1510,shaman,restoration,66,32,34
Rukkle,alterac-mountains,1510,shaman,restoration,36,17,19
Brongar,bleeding-hollow,1510,shaman,restoration,149,68,81
Dogood,tichondrius,1510,shaman,restoration,60,27,33
Fuzbo,bleeding-hollow,1509,shaman,restoration,47,25,22
Shamansrock,tichondrius,1509,shaman,restoration,36,16,20
Joltik,area-52,1508,shaman,restoration,225,112,113
Sittinn,malganis,1508,shaman,restoration,120,59,61
Plâto,stormrage,1507,shaman,restoration,30,16,14
Benta,zuljin,1507,shaman,restoration,108,56,52
Cultsulyvahn,tichondrius,1507,shaman,restoration,73,37,36
Dîabeetus,moon-guard,1506,shaman,restoration,70,42,28
Trapghost,cenarius,1506,shaman,restoration,87,41,46
Shamankïng,proudmoore,1505,shaman,restoration,89,46,43
ßread,illidan,1505,shaman,restoration,133,62,71
Nyf,khazgoroth,1505,shaman,restoration,72,30,42
Cokehealsx,tichondrius,1503,shaman,restoration,30,16,14
Agharn,moon-guard,1503,shaman,restoration,51,26,25
Mutaishammy,barthilas,1503,shaman,restoration,96,48,48
Kaaying,tichondrius,1503,shaman,restoration,49,19,30
Ballistíc,boulderfist,1502,shaman,restoration,66,38,28
Libangbang,tichondrius,1502,shaman,restoration,30,16,14
Maakasarg,tichondrius,1502,shaman,restoration,82,40,42
Sphaerus,tichondrius,1501,shaman,restoration,54,30,24
Targhal,tichondrius,1500,shaman,restoration,318,163,155
Wuargh,area-52,1498,shaman,restoration,286,154,132
Ban,blackrock,1498,shaman,restoration,39,21,18
Boryndor,stormrage,1497,shaman,restoration,57,31,26
Sbrinz,thrall,1497,shaman,restoration,36,19,17
Choochette,illidan,1497,shaman,restoration,144,67,77
Elementàlius,quelthalas,1497,shaman,restoration,71,32,39
Alexustexas,tichondrius,1496,shaman,restoration,102,60,42
Szeav,tichondrius,1496,shaman,restoration,72,36,36
Scamgame,tichondrius,1495,shaman,restoration,30,22,8
Quakess,zuljin,1494,shaman,restoration,66,28,38
Reformeddogs,tichondrius,1492,shaman,restoration,63,36,27
Ärtful,illidan,1492,shaman,restoration,108,58,50
Powergeyser,blackhand,1492,shaman,restoration,36,17,19
Køtømine,ragnaros,1491,shaman,restoration,106,67,39
Balsonz,zuljin,1491,shaman,restoration,36,20,16
Vanklayser,ragnaros,1491,shaman,restoration,108,54,54
Thunderphury,proudmoore,1491,shaman,restoration,131,59,72
Mentyb,emerald-dream,1491,shaman,restoration,42,16,26
Zombaschamy,ragnaros,1490,shaman,restoration,30,17,13
Flamehorns,malganis,1490,shaman,restoration,83,44,39
Kwzy,stormrage,1490,shaman,restoration,63,33,30
Hwyl,frostmourne,1489,shaman,restoration,113,50,63
Mkyz,tichondrius,1488,shaman,restoration,103,54,49
Gattious,illidan,1488,shaman,restoration,90,45,45
Worldx,barthilas,1488,shaman,restoration,228,112,116
Hoboman,chogall,1488,shaman,restoration,42,17,25
Yarl,ragnaros,1487,shaman,restoration,42,24,18
Kephax,eonar,1487,shaman,restoration,156,81,75
Phrophetzee,altar-of-storms,1487,shaman,restoration,51,23,28
Jaegertotem,stormrage,1486,shaman,restoration,42,21,21
Damoclez,jubeithos,1486,shaman,restoration,57,23,34
Wuruizec,illidan,1485,shaman,restoration,77,38,39
Youarenothim,area-52,1484,shaman,restoration,24,16,8
Jizzlewizwiz,tichondrius,1484,shaman,restoration,181,89,92
Lanzero,chogall,1483,shaman,restoration,54,33,21
Zeusblaster,illidan,1482,shaman,restoration,42,18,24
Trenhance,stormrage,1481,shaman,restoration,30,23,7
Krewesham,uldaman,1481,shaman,restoration,28,17,11
Wazskood,stormrage,1481,shaman,restoration,161,81,80
Sindury,tichondrius,1480,shaman,restoration,289,160,129
Abellone,tichondrius,1480,shaman,restoration,33,17,16
Elementols,azralon,1480,shaman,restoration,48,23,25
Hachikø,frostmourne,1480,shaman,restoration,95,44,51
Vazlah,tichondrius,1479,shaman,restoration,24,16,8
Rekashaki,illidan,1479,shaman,restoration,36,19,17
Upholderxo,shadowmoon,1479,shaman,restoration,78,40,38
Shamfold,illidan,1479,shaman,restoration,36,17,19
Mlpz,black-dragonflight,1478,shaman,restoration,84,47,37
Rumkin,malganis,1478,shaman,restoration,106,58,48
Boohaha,khadgar,1478,shaman,restoration,35,16,19
Miroen,tichondrius,1477,shaman,restoration,146,70,76
Sistronok,bleeding-hollow,1476,shaman,restoration,30,16,14
Ellgric,emerald-dream,1476,shaman,restoration,48,21,27
Defac,proudmoore,1475,shaman,restoration,72,42,30
Odïn,tichondrius,1475,shaman,restoration,59,33,26
Maxchungie,azshara,1475,shaman,restoration,30,16,14
Angelabaaby,proudmoore,1475,shaman,restoration,60,28,32
Bakayarøu,tichondrius,1475,shaman,restoration,36,16,20
Vewdew,guldan,1473,shaman,restoration,78,47,31
Harbert,black-dragonflight,1473,shaman,restoration,229,123,106
Arkuldash,tichondrius,1473,shaman,restoration,66,35,31
Unchaman,ragnaros,1472,shaman,restoration,157,78,79
Milkkshake,illidan,1472,shaman,restoration,280,132,148
Brainal,sargeras,1472,shaman,restoration,60,25,35
Gluestix,bleeding-hollow,1471,shaman,restoration,43,26,17
Pissticles,bleeding-hollow,1471,shaman,restoration,150,75,75
Heebeegeebee,stormrage,1470,shaman,restoration,51,31,20
Erthshawk,wildhammer,1470,shaman,restoration,84,44,40
Tamzlol,the-forgotten-coast,1470,shaman,restoration,59,27,32
Kourage,illidan,1467,shaman,restoration,42,27,15
Sàuron,tichondrius,1467,shaman,restoration,180,100,80
Krilick,blackrock,1467,shaman,restoration,107,57,50
Bitxxnumber,tichondrius,1467,shaman,restoration,349,185,164
Keenie,shadow-council,1467,shaman,restoration,35,17,18
Gangzmmsk,tichondrius,1466,shaman,restoration,24,18,6
Philbert,boulderfist,1466,shaman,restoration,54,31,23
Whoshealing,lightninghoof,1466,shaman,restoration,114,59,55
Aceshamm,kelthuzad,1465,shaman,restoration,108,61,47
Jimmymaclroy,frostmourne,1465,shaman,restoration,120,62,58
Circuits,malganis,1464,shaman,restoration,61,33,28
Springtide,thrall,1464,shaman,restoration,83,43,40
Fujiyama,dark-iron,1462,shaman,restoration,147,73,74
Xiwg,tichondrius,1462,shaman,restoration,72,31,41
Ryùko,proudmoore,1462,shaman,restoration,90,38,52
Hirah,frostmourne,1460,shaman,restoration,23,16,7
Sarkhanvol,aggramar,1460,shaman,restoration,42,27,15
Smartakkar,emerald-dream,1460,shaman,restoration,57,36,21
Dókki,tichondrius,1460,shaman,restoration,39,24,15
Freakytiki,azshara,1460,shaman,restoration,70,43,27
Cinematticz,tichondrius,1460,shaman,restoration,119,61,58
Tundertotem,tichondrius,1459,shaman,restoration,86,50,36
Nilstorm,quelthalas,1458,shaman,restoration,72,38,34
Treasonreno,area-52,1457,shaman,restoration,143,68,75
Bighaircut,darkspear,1457,shaman,restoration,162,75,87
Kaili,illidan,1456,shaman,restoration,81,49,32
Pickledegg,tichondrius,1456,shaman,restoration,51,27,24
Teerex,tortheldrin,1456,shaman,restoration,75,38,37
Artsha,tol-barad,1456,shaman,restoration,58,29,29
Tizz,quelthalas,1456,shaman,restoration,112,54,58
Draüguss,azralon,1456,shaman,restoration,155,74,81
Furrytotems,darkspear,1455,shaman,restoration,126,56,70
Trewlolz,sargeras,1454,shaman,restoration,48,24,24
Juicypork,moon-guard,1453,shaman,restoration,44,24,20
Rinnan,malganis,1453,shaman,restoration,103,48,55
Yossarabi,bleeding-hollow,1453,shaman,restoration,84,36,48
Skelesham,zuljin,1452,shaman,restoration,48,33,15
Crittingbull,veknilash,1452,shaman,restoration,214,111,103
Foragorn,stormrage,1452,shaman,restoration,224,112,112
Carltonbanks,aggramar,1452,shaman,restoration,36,18,18
Purgenx,tichondrius,1451,shaman,restoration,52,29,23
Insertyzs,azralon,1451,shaman,restoration,78,43,35
Deosculation,tichondrius,1451,shaman,restoration,35,19,16
Jwondo,area-52,1451,shaman,restoration,62,26,36
Memorix,stonemaul,1451,shaman,restoration,42,17,25
Splonkydonky,stonemaul,1450,shaman,restoration,30,18,12
Tidalstorm,ragnaros,1450,shaman,restoration,90,52,38
Orkshammy,illidan,1450,shaman,restoration,46,26,20
Pamaj,kelthuzad,1450,shaman,restoration,99,44,55
Mäjorlazer,lightbringer,1449,shaman,restoration,38,19,19
Buffduude,shadowsong,1449,shaman,restoration,48,22,26
Aguinha,azralon,1448,shaman,restoration,78,38,40
Stylesp,area-52,1448,shaman,restoration,155,75,80
Flubydont,icecrown,1448,shaman,restoration,96,44,52
Anußis,stormrage,1447,shaman,restoration,65,25,40
Rommel,azralon,1444,shaman,restoration,57,32,25
Shazik,spirestone,1444,shaman,restoration,66,29,37
Elementorx,stormrage,1443,shaman,restoration,86,41,45
Blastoíse,area-52,1442,shaman,restoration,30,16,14
Boozi,sargeras,1442,shaman,restoration,48,24,24
Wumx,tichondrius,1441,shaman,restoration,54,22,32
Nanishock,area-52,1440,shaman,restoration,74,40,34
Kaskä,tichondrius,1439,shaman,restoration,24,15,9
Kandin,icecrown,1439,shaman,restoration,106,56,50
Praxis,tichondrius,1437,shaman,restoration,154,79,75
Jhakrï,tichondrius,1437,shaman,restoration,36,15,21
Miketheseal,bleeding-hollow,1437,shaman,restoration,36,15,21
Owtyobwol,area-52,1436,shaman,restoration,24,15,9
Creatine,area-52,1436,shaman,restoration,71,37,34
Ironcrag,moon-guard,1436,shaman,restoration,264,136,128
Yamazakì,nemesis,1436,shaman,restoration,57,23,34
Babbz,sargeras,1436,shaman,restoration,41,16,25
Fluiid,tichondrius,1435,shaman,restoration,30,15,15
Kosiee,frostmourne,1435,shaman,restoration,30,15,15
Dawny,arygos,1435,shaman,restoration,36,15,21
Wardruna,andorhal,1434,shaman,restoration,24,15,9
Chilidawg,thrall,1434,shaman,restoration,38,21,17
Ãrthor,stormrage,1434,shaman,restoration,78,42,36
Eggrollninja,illidan,1433,shaman,restoration,30,22,8
Xxchamana,ragnaros,1433,shaman,restoration,24,15,9
Èmaxx,barthilas,1432,shaman,restoration,24,15,9
Blowurbubble,tichondrius,1432,shaman,restoration,54,29,25
Ongob,kelthuzad,1432,shaman,restoration,30,15,15
Holysharmmy,tichondrius,1432,shaman,restoration,30,15,15
Thormør,tichondrius,1432,shaman,restoration,31,15,16
Shamjam,moon-guard,1431,shaman,restoration,24,15,9
Buffdestru,azralon,1431,shaman,restoration,116,66,50
Bluebones,frostmane,1431,shaman,restoration,30,17,13
Thunderborn,laughing-skull,1431,shaman,restoration,42,20,22
Totem,burning-legion,1431,shaman,restoration,36,16,20
Maheva,ragnaros,1430,shaman,restoration,24,16,8
Fatherrtime,illidan,1430,shaman,restoration,48,26,22
Pýe,bleeding-hollow,1430,shaman,restoration,65,35,30
Galeswind,sargeras,1430,shaman,restoration,72,36,36
Elecpod,frostmourne,1430,shaman,restoration,50,24,26
Joeschhmoe,tichondrius,1430,shaman,restoration,42,20,22
Totembarx,illidan,1428,shaman,restoration,42,29,13
Grimtar,burning-blade,1428,shaman,restoration,24,16,8
Santiagodx,ragnaros,1427,shaman,restoration,277,135,142
Papatreb,haomarush,1427,shaman,restoration,126,60,66
Macdab,malganis,1425,shaman,restoration,42,23,19
Supdaug,vashj,1425,shaman,restoration,86,43,43
Torric,kalecgos,1424,shaman,restoration,66,31,35
Atorinà,tichondrius,1423,shaman,restoration,30,15,15
Zinns,dalaran,1423,shaman,restoration,123,61,62
Idowhatcdont,kelthuzad,1421,shaman,restoration,24,15,9
Boonno,tichondrius,1421,shaman,restoration,36,15,21
Fatpandajim,frostmourne,1420,shaman,restoration,24,15,9
Samanl,tichondrius,1420,shaman,restoration,77,44,33
Hyonkh,tichondrius,1419,shaman,restoration,95,51,44
Slothstorm,barthilas,1419,shaman,restoration,65,34,31
Pümba,azralon,1419,shaman,restoration,30,15,15
Overcåst,barthilas,1418,shaman,restoration,84,37,47
Blaydin,elune,1416,shaman,restoration,24,15,9
Totemhype,tichondrius,1416,shaman,restoration,80,45,35
Thegil,tichondrius,1416,shaman,restoration,108,48,60
Hurú,azralon,1416,shaman,restoration,83,36,47
Pawbed,aegwynn,1415,shaman,restoration,159,82,77
Luxiaa,tichondrius,1415,shaman,restoration,77,27,50
Djshammy,barthilas,1414,shaman,restoration,80,42,38
Cethun,amanthul,1414,shaman,restoration,88,45,43
Vajoku,proudmoore,1414,shaman,restoration,48,22,26
Massif,emerald-dream,1414,shaman,restoration,37,16,21
Bearmanshrek,tichondrius,1414,shaman,restoration,72,26,46
Fíxer,tichondrius,1413,shaman,restoration,103,59,44
Sharmut,bleeding-hollow,1413,shaman,restoration,148,76,72
Spiritwler,tichondrius,1413,shaman,restoration,48,24,24
Tawahka,hyjal,1413,shaman,restoration,226,110,116
Azumaa,tichondrius,1412,shaman,restoration,243,117,126
Silhoustes,ragnaros,1411,shaman,restoration,24,15,9
Toteapole,malganis,1411,shaman,restoration,123,70,53
Xajsham,tichondrius,1411,shaman,restoration,121,66,55
Enflexi,lightbringer,1411,shaman,restoration,53,26,27
Orkwa,bleeding-hollow,1410,shaman,restoration,68,32,36
Otem,frostmourne,1410,shaman,restoration,50,23,27
Goatpornbad,sargeras,1410,shaman,restoration,108,48,60
Farö,azralon,1409,shaman,restoration,47,18,29
Xaltas,moon-guard,1407,shaman,restoration,52,33,19
Libragirl,tichondrius,1407,shaman,restoration,208,106,102
Elenix,area-52,1406,shaman,restoration,42,22,20
Uwuxdlol,tichondrius,1404,shaman,restoration,35,20,15
Zizö,barthilas,1404,shaman,restoration,42,19,23
Performix,sargeras,1404,shaman,restoration,36,15,21
Meanbetty,illidan,1403,shaman,restoration,30,17,13
Charmize,azralon,1403,shaman,restoration,129,68,61
Elex,frostmourne,1403,shaman,restoration,93,41,52
Reignz,moonrunner,1401,shaman,restoration,45,24,21
Bluetooth,stormrage,1401,shaman,restoration,95,42,53
Velesa,kiljaeden,1400,shaman,restoration,66,23,43
Cameltótém,sargeras,1399,shaman,restoration,66,35,31
Graymatterz,ysondre,1399,shaman,restoration,72,34,38
Djbs,stormrage,1399,shaman,restoration,95,43,52
Jfrzd,tichondrius,1397,shaman,restoration,31,21,10
Meshugga,scarlet-crusade,1397,shaman,restoration,72,35,37
Totemgoddess,nemesis,1397,shaman,restoration,66,30,36
Xdxs,norgannon,1397,shaman,restoration,36,16,20
Edhance,area-52,1396,shaman,restoration,171,94,77
Askortus,stormrage,1396,shaman,restoration,36,17,19
Drinkharder,stormrage,1395,shaman,restoration,34,16,18
Arginine,tichondrius,1395,shaman,restoration,42,15,27
Curador,nemesis,1394,shaman,restoration,39,24,15
Jakjohnson,stormrage,1393,shaman,restoration,33,18,15
Kakiscala,proudmoore,1393,shaman,restoration,30,16,14
Midew,proudmoore,1393,shaman,restoration,57,26,31
Siyusm,illidan,1393,shaman,restoration,72,25,47
Mikeyodinson,area-52,1392,shaman,restoration,41,20,21
Windfrenzy,thrall,1392,shaman,restoration,36,15,21
Rsham,dragonmaw,1391,shaman,restoration,30,15,15
Largeshaman,zuljin,1391,shaman,restoration,30,15,15
Rizam,malganis,1389,shaman,restoration,42,33,9
Crowingraven,queldorei,1389,shaman,restoration,24,15,9
Urb,moknathal,1388,shaman,restoration,86,40,46
Kirawindu,zuljin,1387,shaman,restoration,69,39,30
Halloweenz,area-52,1387,shaman,restoration,30,16,14
Cowtidetotem,thrall,1387,shaman,restoration,36,19,17
Soowecide,tichondrius,1387,shaman,restoration,60,23,37
Rykku,illidan,1386,shaman,restoration,30,16,14
Jodalo,ragnaros,1385,shaman,restoration,173,92,81
Fungus,firetree,1384,shaman,restoration,48,26,22
Paraplexed,blackrock,1384,shaman,restoration,50,20,30
Indesham,drenden,1382,shaman,restoration,40,20,20
Shamito,ragnaros,1382,shaman,restoration,73,36,37
Urin,emerald-dream,1382,shaman,restoration,51,24,27
Fishman,exodar,1382,shaman,restoration,101,45,56
Nyathera,barthilas,1381,shaman,restoration,102,56,46
Çruces,illidan,1381,shaman,restoration,36,17,19
Siggmaster,chogall,1381,shaman,restoration,48,19,29
Tankseven,tichondrius,1380,shaman,restoration,36,16,20
Lanuur,moon-guard,1379,shaman,restoration,54,31,23
Sheared,area-52,1379,shaman,restoration,137,69,68
Foray,barthilas,1378,shaman,restoration,84,48,36
Ottoman,eredar,1378,shaman,restoration,75,32,43
Leca,tichondrius,1378,shaman,restoration,90,38,52
Destrino,area-52,1377,shaman,restoration,48,23,25
Darado,kiljaeden,1377,shaman,restoration,45,20,25
Hannamayzing,arathor,1377,shaman,restoration,36,16,20
Ahaw,area-52,1374,shaman,restoration,78,47,31
Roxzid,area-52,1374,shaman,restoration,57,33,24
Jensenx,proudmoore,1374,shaman,restoration,82,38,44
Hateshifter,kul-tiras,1374,shaman,restoration,42,18,24
Shamicare,stormrage,1373,shaman,restoration,142,79,63
ßøvîn,thrall,1373,shaman,restoration,95,47,48
Shamkack,kelthuzad,1373,shaman,restoration,105,51,54
Psiexrcst,tichondrius,1373,shaman,restoration,105,44,61
Earthsrage,illidan,1372,shaman,restoration,42,22,20
Klimax,tichondrius,1372,shaman,restoration,48,21,27
Killercam,maiev,1370,shaman,restoration,299,143,156
Restosud,crushridge,1369,shaman,restoration,36,23,13
Blackoutsx,stormreaver,1369,shaman,restoration,28,15,13
Zugpug,emerald-dream,1368,shaman,restoration,42,18,24
Thenextcdew,illidan,1367,shaman,restoration,48,26,22
Záheer,arthas,1367,shaman,restoration,77,38,39
Onlytidez,area-52,1367,shaman,restoration,77,35,42
Aargonos,tichondrius,1365,shaman,restoration,29,23,6
Copuda,illidan,1365,shaman,restoration,137,72,65
Totemrack,tichondrius,1365,shaman,restoration,89,46,43
Goub,skullcrusher,1364,shaman,restoration,29,16,13
Shaquillius,tichondrius,1364,shaman,restoration,84,40,44
Krevsham,proudmoore,1364,shaman,restoration,62,26,36
Ralinta,tichondrius,1364,shaman,restoration,77,27,50
Kunchan,zuluhed,1362,shaman,restoration,24,16,8
Subnôize,bleeding-hollow,1362,shaman,restoration,135,72,63
Gromgrai,bleeding-hollow,1361,shaman,restoration,89,48,41
Shockburst,dalaran,1360,shaman,restoration,42,25,17
Hugebrain,proudmoore,1360,shaman,restoration,184,77,107
Wyått,emerald-dream,1359,shaman,restoration,95,43,52
Fläkky,tichondrius,1358,shaman,restoration,36,22,14
Kiojin,ragnaros,1357,shaman,restoration,186,99,87
Wagesisdeath,illidan,1357,shaman,restoration,42,20,22
Ndz,anubarak,1356,shaman,restoration,72,41,31
Genjuu,proudmoore,1356,shaman,restoration,48,25,23
Wooskier,tichondrius,1355,shaman,restoration,60,32,28
Elementgodx,skullcrusher,1354,shaman,restoration,54,27,27
Hamshamwitch,shadowmoon,1353,shaman,restoration,36,17,19
Atnaz,drakkari,1352,shaman,restoration,42,24,18
Tumble,frostmourne,1352,shaman,restoration,105,51,54
Amperage,spirestone,1352,shaman,restoration,70,33,37
Asskrap,daggerspine,1350,shaman,restoration,46,25,21
Mcshocks,area-52,1350,shaman,restoration,78,40,38
Chandye,proudmoore,1348,shaman,restoration,72,27,45
Brosidan,anvilmar,1347,shaman,restoration,110,66,44
Fallhazard,malganis,1347,shaman,restoration,52,30,22
Daddyk,gnomeregan,1347,shaman,restoration,53,30,23
Udungoofedd,the-underbog,1347,shaman,restoration,59,30,29
Greenenergy,tichondrius,1346,shaman,restoration,60,32,28
Lleonardo,tichondrius,1346,shaman,restoration,54,24,30
Imaspirit,malganis,1346,shaman,restoration,60,25,35
Lildunny,tichondrius,1346,shaman,restoration,36,15,21
Fàrrò,thrall,1345,shaman,restoration,66,39,27
Kultirio,quelthalas,1344,shaman,restoration,61,32,29
Elemen,quelthalas,1344,shaman,restoration,97,48,49
Smniss,tichondrius,1344,shaman,restoration,49,23,26
Orochishaman,stormrage,1343,shaman,restoration,24,14,10
Quequin,quelthalas,1343,shaman,restoration,42,21,21
Smearedbeard,bleeding-hollow,1343,shaman,restoration,78,36,42
Kensyz,tichondrius,1342,shaman,restoration,24,14,10
Dwârf,tichondrius,1342,shaman,restoration,24,14,10
Touchmytotmm,tichondrius,1342,shaman,restoration,24,14,10
Weathersmell,sargeras,1341,shaman,restoration,24,14,10
Crazytotems,dalaran,1341,shaman,restoration,138,71,67
Juvîa,emerald-dream,1341,shaman,restoration,91,38,53
Shockpanda,zuljin,1340,shaman,restoration,18,14,4
Mudlùst,moon-guard,1339,shaman,restoration,77,40,37
Kachupinsito,ragnaros,1339,shaman,restoration,91,45,46
Uhd,malganis,1339,shaman,restoration,44,21,23
Forcè,bleeding-hollow,1339,shaman,restoration,30,14,16
Damador,tichondrius,1339,shaman,restoration,42,16,26
Karmatide,malganis,1338,shaman,restoration,42,26,16
Rzzn,sargeras,1338,shaman,restoration,24,14,10
Misswalksha,ragnaros,1338,shaman,restoration,24,14,10
Barbosina,stormrage,1338,shaman,restoration,262,134,128
Dimitrio,azralon,1337,shaman,restoration,29,15,14
Furiousnick,stormrage,1337,shaman,restoration,31,15,16
Enemyanemone,area-52,1336,shaman,restoration,24,14,10
Çdñ,tichondrius,1336,shaman,restoration,24,14,10
Earthentotem,tichondrius,1336,shaman,restoration,24,14,10
Valst,kiljaeden,1336,shaman,restoration,93,47,46
Abcmbx,illidan,1336,shaman,restoration,107,54,53
Snowtem,moonrunner,1335,shaman,restoration,42,20,22
Tayictwo,tichondrius,1335,shaman,restoration,30,14,16
Xypress,tichondrius,1335,shaman,restoration,30,14,16
Hst,frostmourne,1334,shaman,restoration,24,14,10
Satrixss,ragnaros,1334,shaman,restoration,79,44,35
Totemist,tichondrius,1334,shaman,restoration,60,28,32
Woof,agamaggan,1334,shaman,restoration,47,16,31
Nagumi,ragnaros,1333,shaman,restoration,24,16,8
Nerfmytotemz,frostmourne,1333,shaman,restoration,30,14,16
Joyrider,sargeras,1332,shaman,restoration,54,28,26
Alátreon,azralon,1332,shaman,restoration,66,30,36
Mudtide,tichondrius,1331,shaman,restoration,72,42,30
Ixis,bleeding-hollow,1331,shaman,restoration,24,14,10
Mengemort,crushridge,1331,shaman,restoration,81,44,37
Lurue,tichondrius,1331,shaman,restoration,42,21,21
Edisto,darkspear,1331,shaman,restoration,30,14,16
Mòo,barthilas,1330,shaman,restoration,70,34,36
Skylet,azralon,1330,shaman,restoration,48,20,28
Tampíco,ragnaros,1330,shaman,restoration,36,14,22
Joriko,magtheridon,1330,shaman,restoration,36,14,22
Exussh,tichondrius,1329,shaman,restoration,18,15,3
Clutchinbuds,malganis,1329,shaman,restoration,69,32,37
Eccentrix,mannoroth,1329,shaman,restoration,36,14,22
Angron,barthilas,1328,shaman,restoration,34,21,13
Elmoss,thrall,1328,shaman,restoration,36,14,22
Huroth,proudmoore,1328,shaman,restoration,42,14,28
Tequíla,quelthalas,1327,shaman,restoration,30,16,14
Windpowa,blackrock,1327,shaman,restoration,60,25,35
Azhen,ragnaros,1326,shaman,restoration,138,69,69
Tchaishammy,tichondrius,1326,shaman,restoration,29,14,15
Noobcrits,tichondrius,1325,shaman,restoration,48,27,21
Meatballer,queldorei,1325,shaman,restoration,83,45,38
Fedinho,azralon,1325,shaman,restoration,89,48,41
Ginkuma,illidan,1325,shaman,restoration,30,14,16
Afgoox,tichondrius,1324,shaman,restoration,84,47,37
Geser,silvermoon,1324,shaman,restoration,73,37,36
Voluptuous,mannoroth,1324,shaman,restoration,623,310,313
Klausnomi,jaedenar,1324,shaman,restoration,48,21,27
Lamente,ragnaros,1324,shaman,restoration,35,14,21
Oriyani,sargeras,1323,shaman,restoration,30,14,16
Orcaninja,zuljin,1322,shaman,restoration,28,15,13
Glark,tichondrius,1322,shaman,restoration,30,14,16
Guho,tichondrius,1320,shaman,restoration,23,15,8
Ondra,frostmourne,1320,shaman,restoration,48,24,24
Bazinguinha,azralon,1320,shaman,restoration,102,48,54
Kisimi,proudmoore,1319,shaman,restoration,30,18,12
Cleanfossil,stormrage,1319,shaman,restoration,41,24,17
Rlzshaman,tichondrius,1319,shaman,restoration,24,14,10
Bearlysober,draka,1319,shaman,restoration,68,37,31
Desgarcon,zuljin,1319,shaman,restoration,137,71,66
Shimansham,aegwynn,1319,shaman,restoration,259,128,131
Boggins,dalaran,1318,shaman,restoration,52,25,27
Badião,azralon,1318,shaman,restoration,131,58,73
Bunnyele,tichondrius,1317,shaman,restoration,52,24,28
Latosos,dalaran,1317,shaman,restoration,36,15,21
Tidalchief,dalaran,1316,shaman,restoration,58,40,18
Aemi,tichondrius,1316,shaman,restoration,120,57,63
Zuljiba,illidan,1315,shaman,restoration,72,41,31
Beardcramps,tichondrius,1314,shaman,restoration,84,42,42
Schav,stormrage,1313,shaman,restoration,33,19,14
Bubbert,illidan,1313,shaman,restoration,78,31,47
Paradigm,sargeras,1312,shaman,restoration,30,15,15
Thuggliife,frostmourne,1312,shaman,restoration,41,20,21
Dmoneyswag,illidan,1312,shaman,restoration,59,27,32
Roostershama,tichondrius,1311,shaman,restoration,133,59,74
Ithappens,senjin,1310,shaman,restoration,30,16,14
Getco,tichondrius,1310,shaman,restoration,72,33,39
Shockbot,stormscale,1310,shaman,restoration,87,39,48
Orlá,moon-guard,1310,shaman,restoration,54,18,36
Kazino,stormrage,1309,shaman,restoration,28,18,10
Yeetle,gorefiend,1309,shaman,restoration,52,27,25
Jaandar,saurfang,1309,shaman,restoration,201,104,97
Prøduce,tichondrius,1309,shaman,restoration,78,40,38
Twoflower,frostmourne,1309,shaman,restoration,236,121,115
Hefestos,nemesis,1309,shaman,restoration,30,14,16
Absorblife,barthilas,1309,shaman,restoration,69,31,38
Mooshi,exodar,1309,shaman,restoration,69,27,42
Medzoe,tichondrius,1307,shaman,restoration,28,15,13
Vibration,akama,1307,shaman,restoration,159,82,77
Flamefüry,azralon,1307,shaman,restoration,36,18,18
Echoelements,tichondrius,1307,shaman,restoration,29,14,15
Sukthistotem,kelthuzad,1306,shaman,restoration,30,20,10
Fencepost,bleeding-hollow,1306,shaman,restoration,114,61,53
Cónò,tichondrius,1306,shaman,restoration,108,52,56
Torgah,tichondrius,1305,shaman,restoration,90,44,46
Shohzegky,azralon,1305,shaman,restoration,121,57,64
Solaraa,proudmoore,1304,shaman,restoration,64,31,33
Hüsky,dalaran,1303,shaman,restoration,42,14,28
Babytiramisu,stormrage,1302,shaman,restoration,46,24,22
Tumble,barthilas,1302,shaman,restoration,52,26,26
Twinkolava,nemesis,1301,shaman,restoration,49,30,19
Badgeshock,area-52,1301,shaman,restoration,108,48,60
Cæl,azralon,1300,shaman,restoration,35,20,15
Grandbunder,tichondrius,1300,shaman,restoration,36,18,18
Tedmosbe,tichondrius,1300,shaman,restoration,84,37,47
Tartar,lightbringer,1299,shaman,restoration,99,60,39
Pushaheal,tichondrius,1299,shaman,restoration,54,31,23
Teardrinker,korgath,1299,shaman,restoration,94,46,48
Haldeir,frostmourne,1298,shaman,restoration,33,17,16
Yarockheal,malganis,1298,shaman,restoration,54,27,27
Glocksitotem,malganis,1296,shaman,restoration,173,93,80
Bigtoy,frostmane,1296,shaman,restoration,42,14,28
Krishshammy,azshara,1295,shaman,restoration,171,86,85
Darrann,kiljaeden,1294,shaman,restoration,36,22,14
Moowik,emerald-dream,1294,shaman,restoration,84,45,39
Qitian,tichondrius,1294,shaman,restoration,36,14,22
Phtalid,dalaran,1293,shaman,restoration,112,56,56
Aseew,drakkari,1293,shaman,restoration,72,33,39
Dewstorm,tichondrius,1293,shaman,restoration,41,18,23
Jetstream,shadow-council,1293,shaman,restoration,42,16,26
Izarmona,bleeding-hollow,1292,shaman,restoration,24,15,9
Slaggdaddy,durotan,1292,shaman,restoration,30,14,16
Murata,tichondrius,1291,shaman,restoration,30,16,14
Lollzerz,the-forgotten-coast,1291,shaman,restoration,54,22,32
Fenny,proudmoore,1290,shaman,restoration,54,32,22
Powerpress,thunderlord,1288,shaman,restoration,42,24,18
Aviator,muradin,1288,shaman,restoration,36,19,17
Problamatic,tichondrius,1288,shaman,restoration,30,14,16
Zetli,tichondrius,1287,shaman,restoration,78,33,45
Dùffman,jubeithos,1287,shaman,restoration,41,17,24
Trúnks,magtheridon,1286,shaman,restoration,119,57,62
Mynigabob,zuljin,1285,shaman,restoration,148,83,65
Uhfishuhl,bleeding-hollow,1285,shaman,restoration,30,16,14
Shamorrhoids,frostmourne,1285,shaman,restoration,137,70,67
Nezzuk,quelthalas,1285,shaman,restoration,96,42,54
Turblix,tichondrius,1284,shaman,restoration,69,44,25
Ketaminedrip,illidan,1284,shaman,restoration,42,22,20
Feldstar,stormrage,1284,shaman,restoration,103,47,56
Sparks,ragnaros,1284,shaman,restoration,95,43,52
Strohz,undermine,1282,shaman,restoration,42,21,21
Kabasan,illidan,1282,shaman,restoration,84,33,51
Tym,sargeras,1281,shaman,restoration,42,22,20
Alraxion,ragnaros,1281,shaman,restoration,84,41,43
Jabjor,malganis,1281,shaman,restoration,66,25,41
Tákhisis,darkspear,1280,shaman,restoration,84,39,45
Ulala,azshara,1280,shaman,restoration,72,31,41
Hasselshock,area-52,1280,shaman,restoration,94,40,54
Zaxxrie,sargeras,1277,shaman,restoration,71,26,45
Mudeng,tichondrius,1276,shaman,restoration,60,30,30
Eekumbokum,bleeding-hollow,1275,shaman,restoration,80,42,38
Wunderwaffe,the-underbog,1274,shaman,restoration,102,48,54
Raikages,whisperwind,1274,shaman,restoration,66,30,36
Surgedarknes,sargeras,1273,shaman,restoration,27,15,12
Belgrom,tichondrius,1273,shaman,restoration,48,25,23
Sweatysheet,emerald-dream,1272,shaman,restoration,41,24,17
Retgarr,tichondrius,1272,shaman,restoration,30,17,13
Foodlust,sargeras,1272,shaman,restoration,108,57,51
Lengin,bleeding-hollow,1272,shaman,restoration,59,29,30
Mythshaman,tichondrius,1270,shaman,restoration,81,33,48
Sittingwolf,stormreaver,1269,shaman,restoration,29,16,13
Angelicrain,stormrage,1269,shaman,restoration,30,16,14
Derkx,thrall,1268,shaman,restoration,30,22,8
Thomastides,tichondrius,1268,shaman,restoration,82,38,44
Kalorra,whisperwind,1267,shaman,restoration,24,14,10
Rahkani,kiljaeden,1267,shaman,restoration,83,42,41
Killdeaderer,barthilas,1266,shaman,restoration,136,79,57
Kripnotik,nathrezim,1266,shaman,restoration,42,16,26
Joocer,emerald-dream,1265,shaman,restoration,102,48,54
Dodirt,laughing-skull,1263,shaman,restoration,30,17,13
Kunio,proudmoore,1261,shaman,restoration,42,22,20
Menah,moon-guard,1260,shaman,restoration,36,20,16
Karrydoskftw,ragnaros,1260,shaman,restoration,182,89,93
Tacho,bleeding-hollow,1259,shaman,restoration,120,58,62
Vsvs,tichondrius,1259,shaman,restoration,34,15,19
Hauby,zuljin,1259,shaman,restoration,48,15,33
Shiestys,tichondrius,1258,shaman,restoration,44,28,16
Ragerax,trollbane,1258,shaman,restoration,47,27,20
Chagun,illidan,1258,shaman,restoration,48,26,22
Jru,tichondrius,1257,shaman,restoration,31,14,17
Elpide,area-52,1256,shaman,restoration,24,14,10
Graveman,illidan,1256,shaman,restoration,156,83,73
Elohaen,stormrage,1256,shaman,restoration,36,18,18
Maserati,korialstrasz,1254,shaman,restoration,97,45,52
Tigrains,proudmoore,1252,shaman,restoration,29,15,14
Ironcaulk,kelthuzad,1252,shaman,restoration,54,26,28
Sploosh,norgannon,1251,shaman,restoration,38,21,17
Luto,tichondrius,1251,shaman,restoration,130,71,59
Blodbar,kiljaeden,1249,shaman,restoration,36,24,12
Stargun,korgath,1249,shaman,restoration,165,83,82
Toroph,azralon,1248,shaman,restoration,30,16,14
Stabix,tichondrius,1248,shaman,restoration,84,42,42
Bigwave,zuluhed,1248,shaman,restoration,30,15,15
Swinginwilly,barthilas,1248,shaman,restoration,36,14,22
Raïñ,stormrage,1247,shaman,restoration,24,13,11
Liquidcdew,illidan,1247,shaman,restoration,30,13,17
Censyzz,tichondrius,1247,shaman,restoration,30,13,17
Importmodule,frostmourne,1247,shaman,restoration,80,34,46
Leogi,daggerspine,1247,shaman,restoration,51,19,32
Peanutto,illidan,1246,shaman,restoration,156,87,69
Momolagbbit,tichondrius,1246,shaman,restoration,24,13,11
Graebrah,tichondrius,1246,shaman,restoration,24,13,11
Omegalmao,sargeras,1246,shaman,restoration,24,13,11
Brocules,aerie-peak,1246,shaman,restoration,30,13,17
Crakmane,kelthuzad,1245,shaman,restoration,18,13,5
Tays,tichondrius,1245,shaman,restoration,18,13,5
Fourinchsham,tichondrius,1245,shaman,restoration,24,13,11
Scape,emerald-dream,1244,shaman,restoration,18,13,5
Aelwydx,quelthalas,1244,shaman,restoration,287,145,142
Rimmington,frostmourne,1244,shaman,restoration,60,30,30
Tonka,area-52,1244,shaman,restoration,30,13,17
Shoxx,wyrmrest-accord,1243,shaman,restoration,24,13,11
Orjamba,barthilas,1243,shaman,restoration,88,42,46
Zqshaman,tichondrius,1243,shaman,restoration,30,14,16
Jsoto,ghostlands,1243,shaman,restoration,30,13,17
Stackinheals,thrall,1243,shaman,restoration,42,15,27
Drazic,area-52,1242,shaman,restoration,61,32,29
Darkn,cenarion-circle,1242,shaman,restoration,36,18,18
Yamishka,dalaran,1242,shaman,restoration,73,33,40
Delíta,quelthalas,1242,shaman,restoration,89,37,52
Lokhtar,zuljin,1241,shaman,restoration,48,26,22
Savjsh,illidan,1241,shaman,restoration,30,13,17
Chenguanxi,tichondrius,1240,shaman,restoration,18,13,5
Quady,zuljin,1240,shaman,restoration,24,13,11
Droni,emerald-dream,1240,shaman,restoration,30,16,14
Shammimane,tichondrius,1240,shaman,restoration,201,102,99
Entropey,daggerspine,1240,shaman,restoration,71,31,40
Nomediocur,moknathal,1240,shaman,restoration,61,24,37
Spekgawd,emerald-dream,1239,shaman,restoration,18,13,5
Rzul,tichondrius,1239,shaman,restoration,24,13,11
Jnzz,area-52,1239,shaman,restoration,24,13,11
Hearthx,perenolde,1239,shaman,restoration,30,13,17
Battleobobby,medivh,1239,shaman,restoration,41,13,28
Beefstocks,area-52,1238,shaman,restoration,66,32,34
Cheliz,thrall,1238,shaman,restoration,93,40,53
Lastdwarf,tichondrius,1237,shaman,restoration,18,13,5
Shamakazi,tichondrius,1237,shaman,restoration,31,14,17
Wugmuk,illidan,1236,shaman,restoration,149,73,76
Vernacks,area-52,1235,shaman,restoration,18,13,5
Êdge,quelthalas,1235,shaman,restoration,69,33,36
Zad,spinebreaker,1234,shaman,restoration,30,13,17
Krolii,tichondrius,1234,shaman,restoration,80,33,47
Saicey,zuljin,1233,shaman,restoration,104,55,49
Defnotheals,kelthuzad,1233,shaman,restoration,113,51,62
Kinjin,dragonmaw,1232,shaman,restoration,30,13,17
Watchmytrem,ragnaros,1232,shaman,restoration,92,34,58
Kommotion,proudmoore,1232,shaman,restoration,36,13,23
Fênrisulfer,area-52,1231,shaman,restoration,89,37,52
Klaital,boulderfist,1230,shaman,restoration,36,22,14
Kikkóman,malganis,1230,shaman,restoration,48,25,23
Kinshaman,lightnings-blade,1230,shaman,restoration,103,49,54
Slimshaddy,tichondrius,1230,shaman,restoration,33,15,18
Possessing,illidan,1230,shaman,restoration,30,13,17
Peppito,illidan,1229,shaman,restoration,51,29,22
Edemental,area-52,1229,shaman,restoration,129,61,68
Josiahsham,kelthuzad,1229,shaman,restoration,30,14,16
Laggythought,malganis,1229,shaman,restoration,58,19,39
Lhost,tanaris,1228,shaman,restoration,30,17,13
Thobeloza,nemesis,1228,shaman,restoration,25,14,11
Furti,daggerspine,1228,shaman,restoration,40,19,21
Terdsammich,malganis,1227,shaman,restoration,51,27,24
Shokxx,malganis,1227,shaman,restoration,90,47,43
Taò,tichondrius,1227,shaman,restoration,162,76,86
Lüca,wyrmrest-accord,1226,shaman,restoration,357,187,170
Milkmeforhp,frostmourne,1226,shaman,restoration,186,95,91
Bäsedgód,tichondrius,1225,shaman,restoration,30,13,17
Ozzai,ragnaros,1225,shaman,restoration,42,15,27
Sòlemn,burning-legion,1225,shaman,restoration,79,27,52
Mishalla,tichondrius,1224,shaman,restoration,72,27,45
Mandinga,warsong,1222,shaman,restoration,105,52,53
Woodrose,frostmourne,1221,shaman,restoration,103,49,54
Rétt,barthilas,1220,shaman,restoration,24,15,9
Hammerme,barthilas,1220,shaman,restoration,107,40,67
Villainousx,illidan,1219,shaman,restoration,39,21,18
Hoong,garrosh,1219,shaman,restoration,32,17,15
Thizzasta,blackhand,1219,shaman,restoration,40,18,22
Keiox,ragnaros,1218,shaman,restoration,24,13,11
Donmills,tichondrius,1218,shaman,restoration,54,23,31
Lavablurst,stormrage,1218,shaman,restoration,59,23,36
Exportgold,barthilas,1218,shaman,restoration,42,16,26
Booyahshaman,area-52,1216,shaman,restoration,36,19,17
Infsham,hyjal,1216,shaman,restoration,147,66,81
Spiritbear,zuljin,1215,shaman,restoration,42,27,15
Valentinê,stormrage,1215,shaman,restoration,24,13,11
Turksham,tichondrius,1213,shaman,restoration,41,22,19
Truemooin,wyrmrest-accord,1212,shaman,restoration,601,297,304
Väsain,wyrmrest-accord,1212,shaman,restoration,36,16,20
Gallikano,tichondrius,1212,shaman,restoration,48,16,32
Madvillainny,thrall,1211,shaman,restoration,50,26,24
Smashtheface,nagrand,1211,shaman,restoration,54,27,27
Llgll,tichondrius,1210,shaman,restoration,61,24,37
Dabmarinø,tichondrius,1209,shaman,restoration,30,18,12
Freyttreyn,garrosh,1209,shaman,restoration,60,31,29
Certz,dark-iron,1209,shaman,restoration,39,15,24
Dinaliia,lothar,1208,shaman,restoration,72,38,34
Voodoototems,frostmourne,1207,shaman,restoration,51,25,26
Alphamael,lightbringer,1207,shaman,restoration,50,20,30
Plausibility,moon-guard,1206,shaman,restoration,24,13,11
Solomonster,tichondrius,1205,shaman,restoration,31,15,16
Sacroshaman,frostmourne,1205,shaman,restoration,66,21,45
Patoron,proudmoore,1204,shaman,restoration,34,17,17
Beardedone,durotan,1203,shaman,restoration,42,24,18
Dxvxn,tichondrius,1203,shaman,restoration,31,14,17
Bluffin,stormrage,1201,shaman,restoration,24,17,7
Magnethor,frostmourne,1200,shaman,restoration,42,24,18
Thräll,shuhalo,1200,shaman,restoration,202,103,99
Ogtrippleog,blackwing-lair,1200,shaman,restoration,47,19,28
Phatheelz,tichondrius,1199,shaman,restoration,35,21,14
Sizbo,thrall,1199,shaman,restoration,42,20,22
Redbulls,azralon,1198,shaman,restoration,96,54,42
Paniczone,madoran,1198,shaman,restoration,48,21,27
Hicys,azralon,1197,shaman,restoration,179,88,91
Cruelface,sargeras,1196,shaman,restoration,26,14,12
Frankenstien,proudmoore,1195,shaman,restoration,61,33,28
Jaegeer,azralon,1195,shaman,restoration,30,16,14
Rokogg,thrall,1192,shaman,restoration,57,18,39
Kyma,black-dragonflight,1191,shaman,restoration,31,14,17
Synkrona,tichondrius,1191,shaman,restoration,38,16,22
Thorsén,ursin,1190,shaman,restoration,54,23,31
Nobiggy,tichondrius,1190,shaman,restoration,33,13,20
Lankae,quelthalas,1188,shaman,restoration,24,15,9
Babibolo,duskwood,1187,shaman,restoration,24,13,11
Chûnk,tichondrius,1186,shaman,restoration,32,15,17
Mochiko,frostmourne,1184,shaman,restoration,86,40,46
Getwetand,quelthalas,1182,shaman,restoration,109,54,55
Reezy,draktharon,1181,shaman,restoration,23,13,10
Orcstain,moknathal,1180,shaman,restoration,129,50,79
Lavamama,sargeras,1180,shaman,restoration,41,15,26
Shaokhang,emerald-dream,1179,shaman,restoration,82,33,49
Bethklok,daggerspine,1179,shaman,restoration,54,19,35
Rajin,sentinels,1178,shaman,restoration,36,18,18
Houhei,stormrage,1178,shaman,restoration,36,14,22
Dcãicer,quelthalas,1176,shaman,restoration,85,45,40
Sõuls,quelthalas,1176,shaman,restoration,30,14,16
Xolkrem,stormrage,1173,shaman,restoration,36,13,23
Churgarm,zuljin,1172,shaman,restoration,89,46,43
Juggerr,thunderlord,1170,shaman,restoration,50,26,24
Vanty,proudmoore,1170,shaman,restoration,29,13,16
Winry,korgath,1169,shaman,restoration,30,14,16
Hedbang,kiljaeden,1169,shaman,restoration,60,24,36
Wazöö,sargeras,1168,shaman,restoration,63,28,35
Oomshamm,area-52,1167,shaman,restoration,130,68,62
Shazikial,illidan,1167,shaman,restoration,44,21,23
Onpoint,frostmourne,1165,shaman,restoration,23,13,10
Dibatotenz,azralon,1165,shaman,restoration,73,30,43
Shämpäin,moon-guard,1165,shaman,restoration,32,13,19
Bigfatpus,illidan,1164,shaman,restoration,26,14,12
Restoramen,frostmourne,1164,shaman,restoration,43,20,23
Grakkah,thrall,1162,shaman,restoration,30,13,17
Turns,senjin,1161,shaman,restoration,36,14,22
Stahlman,blackhand,1160,shaman,restoration,48,17,31
Hoghlinn,stormrage,1158,shaman,restoration,19,17,2
Scrototëm,azralon,1157,shaman,restoration,60,33,27
Youneverknow,frostmourne,1157,shaman,restoration,161,81,80
Hatethetotem,bleeding-hollow,1156,shaman,restoration,52,27,25
Eyris,dathremar,1156,shaman,restoration,125,62,63
Drboidzerg,tichondrius,1154,shaman,restoration,32,20,12
Lulers,cenarius,1154,shaman,restoration,48,22,26
Catherìne,daggerspine,1154,shaman,restoration,42,18,24
Bekrogh,azralon,1153,shaman,restoration,23,14,9
Dahmerjr,area-52,1153,shaman,restoration,78,43,35
Jimmybutler,tichondrius,1152,shaman,restoration,18,12,6
Creativemind,arathor,1152,shaman,restoration,18,12,6
Luckalicious,proudmoore,1152,shaman,restoration,18,12,6
Hexgodx,illidan,1152,shaman,restoration,18,12,6
Electricsham,archimonde,1152,shaman,restoration,18,12,6
Steverz,daggerspine,1152,shaman,restoration,18,12,6
Bigtexas,tichondrius,1152,shaman,restoration,18,12,6
Rawdòggin,emerald-dream,1152,shaman,restoration,33,13,20
Sensibleqt,tichondrius,1151,shaman,restoration,18,12,6
Killhat,emerald-dream,1151,shaman,restoration,18,12,6
Ruupaul,kiljaeden,1151,shaman,restoration,18,12,6
Femdorfxo,frostmourne,1151,shaman,restoration,24,12,12
Gbe,tichondrius,1151,shaman,restoration,24,12,12
Iightning,frostwolf,1151,shaman,restoration,30,12,18
Hoatboiz,magtheridon,1151,shaman,restoration,54,14,40
Zieebeep,stormrage,1150,shaman,restoration,24,12,12
Ponyi,frostmourne,1150,shaman,restoration,30,12,18
Whitezzxx,tichondrius,1150,shaman,restoration,30,12,18
Oxicleanxo,sargeras,1150,shaman,restoration,30,12,18
Skrubbles,mugthol,1149,shaman,restoration,18,12,6
Shayprime,tichondrius,1149,shaman,restoration,24,12,12
Loanomi,zuljin,1148,shaman,restoration,30,16,14
Käck,tichondrius,1148,shaman,restoration,68,32,36
Jineluki,emerald-dream,1148,shaman,restoration,53,23,30
Funktotem,zuluhed,1148,shaman,restoration,36,12,24
Adventstrike,tichondrius,1148,shaman,restoration,45,14,31
Taekhala,moon-guard,1148,shaman,restoration,72,20,52
Ricn,tichondrius,1147,shaman,restoration,24,12,12
Chubbsxl,proudmoore,1147,shaman,restoration,24,12,12
Xiaoxiboy,tichondrius,1147,shaman,restoration,24,12,12
Chlknx,tichondrius,1147,shaman,restoration,30,12,18
Nosekandyz,chogall,1147,shaman,restoration,30,12,18
Branasou,emerald-dream,1147,shaman,restoration,30,12,18
Bitruff,tichondrius,1146,shaman,restoration,24,12,12
Shämwow,agamaggan,1146,shaman,restoration,880,432,448
Foghoran,quelthalas,1144,shaman,restoration,24,13,11
Aegaeonlol,tichondrius,1144,shaman,restoration,24,12,12
Boltadeez,tichondrius,1144,shaman,restoration,24,12,12
Shockalama,tichondrius,1144,shaman,restoration,84,35,49
Glizzyfeast,illidan,1143,shaman,restoration,18,12,6
Bon,ravencrest,1143,shaman,restoration,24,13,11
Juksi,the-scryers,1142,shaman,restoration,35,14,21
Vinceshamwow,lightbringer,1139,shaman,restoration,18,12,6
Laterallus,nagrand,1139,shaman,restoration,92,47,45
Twistah,firetree,1139,shaman,restoration,24,12,12
Niian,skullcrusher,1139,shaman,restoration,24,12,12
Semasham,khazgoroth,1139,shaman,restoration,36,12,24
Docshamwow,malganis,1137,shaman,restoration,18,12,6
Totemfizzle,spirestone,1137,shaman,restoration,24,12,12
Gsync,tichondrius,1136,shaman,restoration,76,45,31
Winchi,stormrage,1136,shaman,restoration,24,12,12
Jesuisbatman,zuljin,1136,shaman,restoration,24,12,12
Pissbeard,illidan,1136,shaman,restoration,42,17,25
Devipersham,frostmourne,1135,shaman,restoration,24,12,12
Vyy,perenolde,1133,shaman,restoration,24,12,12
Charr,nemesis,1133,shaman,restoration,30,14,16
Smooths,bloodscalp,1131,shaman,restoration,30,16,14
Shampane,arathor,1131,shaman,restoration,24,12,12
Mordzan,area-52,1131,shaman,restoration,26,12,14
Lezzer,ragnaros,1131,shaman,restoration,118,51,67
Ladilloso,zuljin,1131,shaman,restoration,59,24,35
Sèrb,mugthol,1131,shaman,restoration,31,12,19
Lechaman,hakkar,1131,shaman,restoration,66,22,44
Cameltotêm,frostmourne,1130,shaman,restoration,30,17,13
Grimmzhul,daggerspine,1130,shaman,restoration,182,92,90
Dragonsauce,grizzly-hills,1130,shaman,restoration,47,19,28
Slëvin,frostmourne,1128,shaman,restoration,60,25,35
Narikó,aggramar,1126,shaman,restoration,130,73,57
Sannyasin,azralon,1126,shaman,restoration,24,12,12
Paratroop,bonechewer,1126,shaman,restoration,75,30,45
Sephyros,ragnaros,1121,shaman,restoration,24,12,12
Rocksteddy,area-52,1120,shaman,restoration,24,12,12
Allegrata,sargeras,1119,shaman,restoration,30,16,14
Flametide,proudmoore,1119,shaman,restoration,58,28,30
Bloodytotems,dethecus,1118,shaman,restoration,24,12,12
Betterthanya,tichondrius,1117,shaman,restoration,22,13,9
Saxaboom,tichondrius,1115,shaman,restoration,30,12,18
Thunderfuzz,bladefist,1115,shaman,restoration,30,12,18
Etherys,frostmourne,1114,shaman,restoration,36,21,15
Phira,tichondrius,1114,shaman,restoration,78,40,38
Bikutali,kiljaeden,1114,shaman,restoration,24,12,12
Adrô,barthilas,1114,shaman,restoration,152,67,85
ßøn,altar-of-storms,1112,shaman,restoration,18,12,6
Wÿrd,illidan,1112,shaman,restoration,30,18,12
Uluwatu,bleeding-hollow,1109,shaman,restoration,48,22,26
Talroh,malganis,1108,shaman,restoration,92,33,59
Cositax,tichondrius,1106,shaman,restoration,36,22,14
Senzxlolxz,lightbringer,1106,shaman,restoration,57,33,24
Shamankofwa,tichondrius,1106,shaman,restoration,24,12,12
Mvpstorm,darkspear,1106,shaman,restoration,30,12,18
Shammyguy,stormreaver,1103,shaman,restoration,50,23,27
Tsunamic,sargeras,1102,shaman,restoration,27,12,15
Ttass,dalaran,1102,shaman,restoration,35,13,22
Knockedup,tichondrius,1100,shaman,restoration,23,12,11
Galaxiya,blackhand,1100,shaman,restoration,50,22,28
Shockur,sargeras,1099,shaman,restoration,23,12,11
Còsmos,illidan,1099,shaman,restoration,184,90,94
Eledogg,mannoroth,1099,shaman,restoration,28,13,15
Vinnydsham,tichondrius,1098,shaman,restoration,23,12,11
Drumman,skullcrusher,1098,shaman,restoration,104,44,60
Qüickeze,khazgoroth,1097,shaman,restoration,22,15,7
Shamanship,haomarush,1097,shaman,restoration,23,12,11
Kulgur,ravenholdt,1096,shaman,restoration,47,31,16
Topa,magtheridon,1095,shaman,restoration,42,18,24
Monorim,barthilas,1093,shaman,restoration,54,30,24
Kime,tichondrius,1093,shaman,restoration,84,43,41
Htsu,quelthalas,1093,shaman,restoration,28,13,15
Shocksamdi,malganis,1093,shaman,restoration,36,13,23
Stormburst,sargeras,1092,shaman,restoration,42,20,22
Tremór,frostmourne,1091,shaman,restoration,30,17,13
Baygone,tichondrius,1088,shaman,restoration,30,14,16
Taquitho,quelthalas,1088,shaman,restoration,75,32,43
Turbluscious,frostmourne,1087,shaman,restoration,79,42,37
Briagnar,drakkari,1087,shaman,restoration,29,12,17
Mikeisbadwow,tichondrius,1086,shaman,restoration,16,12,4
Kamehamekazi,blackhand,1085,shaman,restoration,24,12,12
Chungie,laughing-skull,1082,shaman,restoration,24,12,12
Belínski,azralon,1080,shaman,restoration,48,26,22
Lavatotem,stormrage,1079,shaman,restoration,53,28,25
Bettoo,ragnaros,1075,shaman,restoration,53,26,27
Delayy,destromath,1075,shaman,restoration,77,32,45
Umbrood,area-52,1073,shaman,restoration,28,13,15
Grullander,hakkar,1072,shaman,restoration,41,23,18
Racsors,ragnaros,1072,shaman,restoration,36,19,17
Elharm,ragnaros,1072,shaman,restoration,36,13,23
Hazorele,nagrand,1069,shaman,restoration,48,23,25
Zhyrouvstorm,stormrage,1068,shaman,restoration,60,27,33
Arjen,kelthuzad,1066,shaman,restoration,23,15,8
Tharapita,bleeding-hollow,1064,shaman,restoration,54,24,30
Shamanzinh,azralon,1063,shaman,restoration,35,12,23
Shammysham,zuljin,1062,shaman,restoration,37,13,24
Sekkuo,kiljaeden,1061,shaman,restoration,60,28,32
Littledream,quelthalas,1061,shaman,restoration,58,26,32
Cencyzz,tichondrius,1056,shaman,restoration,18,11,7
Biofly,thrall,1056,shaman,restoration,18,11,7
Lfgzookeeper,malganis,1056,shaman,restoration,18,11,7
Handzum,blades-edge,1056,shaman,restoration,18,11,7
Kencyi,tichondrius,1056,shaman,restoration,18,11,7
Nickwoper,emerald-dream,1056,shaman,restoration,18,11,7
Afktotems,suramar,1056,shaman,restoration,24,11,13
Jukedlawl,illidan,1056,shaman,restoration,30,11,19
Restoele,tichondrius,1055,shaman,restoration,18,11,7
Jtrxs,tichondrius,1055,shaman,restoration,24,11,13
Sweetpotatoe,malganis,1055,shaman,restoration,24,11,13
Pericazo,sargeras,1055,shaman,restoration,24,11,13
Hordeoeuvre,zuljin,1055,shaman,restoration,24,11,13
Localxhero,stormrage,1055,shaman,restoration,24,11,13
Mindgooblin,sargeras,1055,shaman,restoration,36,11,25
Cháningtotem,frostmourne,1054,shaman,restoration,18,11,7
Ballmeblazer,tichondrius,1054,shaman,restoration,18,11,7
Earthfirex,ragnaros,1054,shaman,restoration,18,11,7
Ituma,tichondrius,1054,shaman,restoration,18,11,7
Sipo,tichondrius,1054,shaman,restoration,18,11,7
Vixeen,kelthuzad,1054,shaman,restoration,24,11,13
Wragnus,tichondrius,1054,shaman,restoration,63,28,35
Elmonkeyloco,bleeding-hollow,1053,shaman,restoration,18,11,7
Kalashnikov,maiev,1053,shaman,restoration,60,32,28
Murm,burning-blade,1053,shaman,restoration,24,11,13
Alfrigg,stormrage,1051,shaman,restoration,30,11,19
Devastacion,malganis,1050,shaman,restoration,28,20,8
Kissmeslowly,zuljin,1050,shaman,restoration,18,11,7
Chebbs,bleeding-hollow,1050,shaman,restoration,18,11,7
Nehpets,kiljaeden,1050,shaman,restoration,24,11,13
Dragum,blackrock,1050,shaman,restoration,30,11,19
Millionvoltz,tichondrius,1049,shaman,restoration,24,11,13
Speedranger,stormrage,1049,shaman,restoration,48,20,28
Groundded,tichondrius,1049,shaman,restoration,35,11,24
Totemism,warsong,1048,shaman,restoration,18,11,7
Vulcanuzz,ragnaros,1048,shaman,restoration,35,12,23
Kakolicious,stormrage,1047,shaman,restoration,18,11,7
Ryuukas,illidan,1047,shaman,restoration,18,11,7
Cheesepufs,illidan,1047,shaman,restoration,25,14,11
Pohtayto,darkspear,1047,shaman,restoration,24,11,13
Kaleska,area-52,1047,shaman,restoration,32,11,21
Mcstop,tanaris,1046,shaman,restoration,36,15,21
Eleshortal,azuremyst,1046,shaman,restoration,51,21,30
Lawlsham,korgath,1045,shaman,restoration,18,11,7
Tràuma,caelestrasz,1045,shaman,restoration,45,13,32
Tsünade,anubarak,1044,shaman,restoration,12,11,1
Kronko,frostmourne,1044,shaman,restoration,24,11,13
Gl,nordrassil,1043,shaman,restoration,18,11,7
Cazlukz,demon-soul,1043,shaman,restoration,36,18,18
Kymosoloshm,sargeras,1043,shaman,restoration,24,11,13
Enzÿte,tichondrius,1043,shaman,restoration,24,11,13
Saraguthix,dalaran,1043,shaman,restoration,30,11,19
Pootergash,shadowmoon,1041,shaman,restoration,24,11,13
Volcanô,area-52,1041,shaman,restoration,30,11,19
Andiamo,deathwing,1041,shaman,restoration,48,11,37
Geoleo,stormrage,1040,shaman,restoration,42,17,25
Zugzugthug,moon-guard,1040,shaman,restoration,84,33,51
Killonsight,tichondrius,1038,shaman,restoration,24,11,13
Chablez,shattered-hand,1036,shaman,restoration,42,17,25
Atmospheric,frostmourne,1035,shaman,restoration,30,11,19
Aimiréal,nagrand,1030,shaman,restoration,30,17,13
Knowknown,tichondrius,1028,shaman,restoration,18,11,7
Zoodoo,nagrand,1027,shaman,restoration,59,21,38
Rekiem,quelthalas,1025,shaman,restoration,28,15,13
Plop,tichondrius,1024,shaman,restoration,16,12,4
Anttoekneeoh,thrall,1024,shaman,restoration,24,12,12
Vaginix,tichondrius,1023,shaman,restoration,30,11,19
Mastrionilol,stormrage,1023,shaman,restoration,34,11,23
Blooddtears,stormrage,1022,shaman,restoration,18,11,7
Dextex,azralon,1022,shaman,restoration,47,26,21
Betorc,azralon,1019,shaman,restoration,42,14,28
Robis,thrall,1017,shaman,restoration,167,84,83
Brislin,sargeras,1017,shaman,restoration,276,132,144
Zonsham,drakkari,1017,shaman,restoration,24,11,13
Frizzie,barthilas,1015,shaman,restoration,89,23,66
Rebbecablack,malganis,1008,shaman,restoration,18,12,6
Ùbbzy,illidan,1008,shaman,restoration,20,12,8
Lazi,frostmourne,1008,shaman,restoration,27,12,15
Kawixxi,ysondre,1007,shaman,restoration,65,35,30
Volsdeep,illidan,1007,shaman,restoration,21,11,10
Grêgg,area-52,1006,shaman,restoration,22,11,11
Totori,stormscale,1006,shaman,restoration,30,11,19
Illeh,illidan,1005,shaman,restoration,42,19,23
Suqmacok,barthilas,1000,shaman,restoration,15,12,3
Stitchez,illidan,1000,shaman,restoration,33,12,21
Vogelbach,ragnaros,999,shaman,restoration,30,19,11
Shamankie,tichondrius,999,shaman,restoration,40,13,27
Psilocypher,nazjatar,993,shaman,restoration,48,26,22
Mythruxx,sargeras,993,shaman,restoration,26,12,14
Gilbert,firetree,991,shaman,restoration,23,11,12
Nottrhall,azralon,990,shaman,restoration,14,11,3
Superchunk,shattered-hand,990,shaman,restoration,132,68,64
Cakinha,stormrage,985,shaman,restoration,42,24,18
Ttukilowatts,stormrage,985,shaman,restoration,120,38,82
Faegle,area-52,984,shaman,restoration,24,11,13
Doomgodx,tichondrius,983,shaman,restoration,36,16,20
Nupi,thaurissan,981,shaman,restoration,86,37,49
Banterx,emerald-dream,979,shaman,restoration,35,12,23
Andrastia,thrall,976,shaman,restoration,24,15,9
Skaehj,saurfang,972,shaman,restoration,62,33,29
Shamadran,hyjal,971,shaman,restoration,23,11,12
Ayahuassca,illidan,971,shaman,restoration,56,25,31
Njjshamm,thrall,969,shaman,restoration,36,16,20
Donkeydrill,elune,965,shaman,restoration,24,15,9
Gabbin,dalaran,960,shaman,restoration,12,10,2
Klâus,fizzcrank,960,shaman,restoration,12,10,2
Sagester,illidan,960,shaman,restoration,16,11,5
Naisayyds,tichondrius,960,shaman,restoration,18,10,8
Victusk,tichondrius,960,shaman,restoration,18,10,8
Yunotho,sargeras,960,shaman,restoration,18,10,8
Paperbot,barthilas,960,shaman,restoration,18,10,8
Burstekka,tichondrius,960,shaman,restoration,18,10,8
Hst,barthilas,960,shaman,restoration,18,10,8
Freerath,tichondrius,960,shaman,restoration,22,10,12
Nisthesham,tichondrius,960,shaman,restoration,24,10,14
Shield,lightnings-blade,960,shaman,restoration,24,10,14
Enhancex,frostwolf,960,shaman,restoration,24,10,14
Farfar,tichondrius,959,shaman,restoration,12,10,2
Køl,illidan,959,shaman,restoration,12,10,2
Awsika,lethon,959,shaman,restoration,18,10,8
Esoterikk,malganis,959,shaman,restoration,18,10,8
Lodekimm,tichondrius,959,shaman,restoration,18,10,8
Joryu,tichondrius,959,shaman,restoration,18,10,8
Zensarg,tichondrius,959,shaman,restoration,18,10,8
Service,llane,959,shaman,restoration,18,10,8
Jxx,nordrassil,959,shaman,restoration,18,10,8
Nakamora,tichondrius,959,shaman,restoration,18,10,8
Jisthexx,senjin,959,shaman,restoration,24,10,14
Valcn,moon-guard,959,shaman,restoration,24,10,14
Matzuga,bleeding-hollow,959,shaman,restoration,24,10,14
Jixxerele,malganis,959,shaman,restoration,24,10,14
Ggoong,tichondrius,959,shaman,restoration,36,10,26
Cmsix,tichondrius,958,shaman,restoration,12,10,2
Shyva,frostmourne,958,shaman,restoration,18,10,8
Felzbirt,uldum,958,shaman,restoration,30,14,16
Thundershade,deathwing,958,shaman,restoration,24,10,14
Weirdboi,area-52,958,shaman,restoration,24,10,14
Totomayo,tichondrius,957,shaman,restoration,12,10,2
Resonence,bleeding-hollow,957,shaman,restoration,18,10,8
Humpvack,tichondrius,957,shaman,restoration,18,10,8
Clytiae,arthas,957,shaman,restoration,18,10,8
Athayis,malorne,957,shaman,restoration,59,31,28
Kroggath,area-52,956,shaman,restoration,18,10,8
Smolder,magtheridon,956,shaman,restoration,62,34,28
Karaaka,ysera,956,shaman,restoration,30,10,20
Pecanwaffles,dalaran,955,shaman,restoration,18,10,8
Oohkillemm,silvermoon,955,shaman,restoration,18,10,8
Hentaistorm,kiljaeden,955,shaman,restoration,110,54,56
Rootsman,illidan,955,shaman,restoration,24,10,14
Shammystic,quelthalas,955,shaman,restoration,54,19,35
Totumstroker,thrall,954,shaman,restoration,18,10,8
Lysergicacid,proudmoore,954,shaman,restoration,42,23,19
Cheeziee,thrall,954,shaman,restoration,24,10,14
Volzuna,wyrmrest-accord,954,shaman,restoration,24,10,14
Johnnyblue,barthilas,954,shaman,restoration,30,10,20
Raininwishes,aegwynn,952,shaman,restoration,18,10,8
Santral,ragnaros,952,shaman,restoration,25,10,15
Bruhh,khadgar,951,shaman,restoration,18,10,8
Romcomx,tichondrius,951,shaman,restoration,24,10,14
Soulmiracle,tichondrius,951,shaman,restoration,24,10,14
Castte,ragnaros,950,shaman,restoration,86,38,48
Grubbyy,tichondrius,950,shaman,restoration,25,11,14
Tabby,emerald-dream,948,shaman,restoration,24,10,14
Daxetan,area-52,947,shaman,restoration,18,10,8
Urao,stormrage,947,shaman,restoration,46,13,33
Recyclicrab,skullcrusher,945,shaman,restoration,12,10,2
Vulkova,illidan,945,shaman,restoration,24,10,14
Skippe,hyjal,943,shaman,restoration,18,10,8
Mhuns,malganis,940,shaman,restoration,24,10,14
Caferino,area-52,937,shaman,restoration,58,25,33
Hurky,sargeras,937,shaman,restoration,27,11,16
Matrìx,sargeras,929,shaman,restoration,104,51,53
Boppshock,tichondrius,928,shaman,restoration,16,11,5
Thrallblade,burning-blade,926,shaman,restoration,16,11,5
Haether,madoran,926,shaman,restoration,101,50,51
Colberton,dalaran,926,shaman,restoration,23,10,13
Rastablaze,darkspear,926,shaman,restoration,70,27,43
Shoomas,tichondrius,923,shaman,restoration,23,10,13
Mikeyshockus,hydraxis,922,shaman,restoration,47,19,28
Klev,frostmourne,921,shaman,restoration,33,12,21
Grüncks,azralon,921,shaman,restoration,66,19,47
Jorko,dathremar,918,shaman,restoration,26,16,10
Brokkghul,illidan,917,shaman,restoration,28,14,14
Malløry,mugthol,917,shaman,restoration,30,12,18
Bakedpototem,magtheridon,913,shaman,restoration,24,10,14
Tineer,tichondrius,912,shaman,restoration,27,10,17
Flexexpress,stormrage,911,shaman,restoration,17,10,7
Privxd,bleeding-hollow,910,shaman,restoration,17,10,7
Booz,caelestrasz,908,shaman,restoration,89,38,51
Mainstreamx,sargeras,908,shaman,restoration,33,10,23
Bitflip,jubeithos,907,shaman,restoration,21,10,11
Jessestevens,kiljaeden,905,shaman,restoration,17,10,7
Vudu,terokkar,905,shaman,restoration,19,11,8
Tyrión,aggramar,905,shaman,restoration,27,12,15
Keybordternr,tichondrius,904,shaman,restoration,27,11,16
Alestorm,nemesis,899,shaman,restoration,28,12,16
Shamamanana,staghelm,899,shaman,restoration,30,10,20
Bigbrenx,tichondrius,895,shaman,restoration,20,10,10
Señordoge,malganis,895,shaman,restoration,26,10,16
Lyshar,laughing-skull,894,shaman,restoration,20,10,10
Beppi,zuljin,893,shaman,restoration,23,10,13
Oldhar,kirin-tor,891,shaman,restoration,24,10,14
Imperiumrum,azuremyst,887,shaman,restoration,77,41,36
Jenniferlynn,tichondrius,886,shaman,restoration,48,15,33
Swifteyy,area-52,883,shaman,restoration,22,10,12
Astàròth,malganis,880,shaman,restoration,13,10,3
Boogiefever,area-52,879,shaman,restoration,13,10,3
Thrawl,deathwing,875,shaman,restoration,24,11,13
Muur,zangarmarsh,872,shaman,restoration,25,10,15
Donix,destromath,869,shaman,restoration,36,14,22
Orouboros,area-52,869,shaman,restoration,72,25,47
Bukanra,tichondrius,868,shaman,restoration,25,10,15
Hênzo,quelthalas,867,shaman,restoration,34,19,15
Galarix,nerzhul,867,shaman,restoration,60,16,44
Washedupty,illidan,864,shaman,restoration,12,9,3
Seiunsky,area-52,864,shaman,restoration,12,9,3
ßonevoyage,malganis,864,shaman,restoration,12,9,3
Pangniu,illidan,864,shaman,restoration,12,9,3
Iadyboi,kiljaeden,864,shaman,restoration,12,9,3
Genesiis,stormrage,864,shaman,restoration,12,9,3
Bakenquake,tichondrius,864,shaman,restoration,12,9,3
Gargrax,malganis,864,shaman,restoration,18,9,9
Hexcalibur,laughing-skull,864,shaman,restoration,18,9,9
Awyiss,dreadmaul,864,shaman,restoration,18,9,9
Fiizix,malganis,864,shaman,restoration,18,9,9
Kirschblute,proudmoore,864,shaman,restoration,18,9,9
Abev,bonechewer,864,shaman,restoration,18,9,9
Medullarum,suramar,864,shaman,restoration,18,9,9
Flatt,uther,864,shaman,restoration,18,9,9
Neviahz,illidan,864,shaman,restoration,18,9,9
Biased,sargeras,864,shaman,restoration,18,9,9
Plotwave,bleeding-hollow,864,shaman,restoration,18,9,9
Wildmaster,ragnaros,864,shaman,restoration,30,9,21
Køre,tichondrius,863,shaman,restoration,12,9,3
Rockemsockem,frostmourne,863,shaman,restoration,12,9,3
Kzxs,illidan,863,shaman,restoration,12,9,3
Ajvl,tichondrius,863,shaman,restoration,12,9,3
Shamanology,echo-isles,863,shaman,restoration,15,10,5
Buffele,tichondrius,863,shaman,restoration,18,9,9
Exiledsham,area-52,863,shaman,restoration,18,9,9
Hoofpics,dalaran,863,shaman,restoration,18,9,9
Grimmick,area-52,863,shaman,restoration,18,9,9
Multran,stormscale,863,shaman,restoration,18,9,9
Potf,illidan,863,shaman,restoration,18,9,9
Snoff,burning-blade,863,shaman,restoration,18,9,9
Kassper,tichondrius,863,shaman,restoration,18,9,9
Airenne,vashj,863,shaman,restoration,18,9,9
Murica,area-52,863,shaman,restoration,18,9,9
Gornu,nemesis,863,shaman,restoration,18,9,9
Dameyo,tichondrius,863,shaman,restoration,18,9,9
Ataia,tichondrius,863,shaman,restoration,18,9,9
Thungo,thaurissan,863,shaman,restoration,18,9,9
Discofoot,wyrmrest-accord,863,shaman,restoration,24,9,15
Shockandmaul,tichondrius,863,shaman,restoration,24,9,15
Mastrionilol,dragonmaw,863,shaman,restoration,24,9,15
Yoloswage,tichondrius,863,shaman,restoration,33,10,23
Tycho,skullcrusher,862,shaman,restoration,12,9,3
Adrec,quelthalas,862,shaman,restoration,18,9,9
Drünk,hyjal,862,shaman,restoration,18,9,9
Obrahma,burning-legion,862,shaman,restoration,18,9,9
Dhalishama,thrall,862,shaman,restoration,24,9,15
Mâdy,quelthalas,861,shaman,restoration,12,9,3
Xillicit,sargeras,861,shaman,restoration,18,9,9
Soppin,bleeding-hollow,861,shaman,restoration,18,9,9
Milkstress,whisperwind,861,shaman,restoration,24,9,15
Esanim,tichondrius,860,shaman,restoration,18,9,9
Blayze,stormscale,860,shaman,restoration,23,10,13
Bacnbitz,hellscream,860,shaman,restoration,24,9,15
Xtremedwarf,frostmourne,859,shaman,restoration,18,9,9
Duza,frostmourne,859,shaman,restoration,18,9,9
Blavan,area-52,859,shaman,restoration,24,9,15
Jemes,barthilas,858,shaman,restoration,18,9,9
Ironfart,destromath,858,shaman,restoration,18,9,9
Blois,thunderlord,857,shaman,restoration,18,9,9
Stormblast,stormrage,856,shaman,restoration,42,9,33
Yakella,trollbane,854,shaman,restoration,12,9,3
Lauralai,sargeras,853,shaman,restoration,12,9,3
Mtnju,eredar,852,shaman,restoration,18,9,9
Uggbootz,amanthul,851,shaman,restoration,37,13,24
Çatastrophe,dalaran,849,shaman,restoration,18,9,9
Elementium,azshara,847,shaman,restoration,29,9,20
Fio,nerzhul,846,shaman,restoration,246,111,135
Xinz,guldan,845,shaman,restoration,20,10,10
Danil,emerald-dream,831,shaman,restoration,17,9,8
Stormcallerr,sargeras,824,shaman,restoration,17,9,8
Shubba,thrall,824,shaman,restoration,30,13,17
Insidetrader,illidan,815,shaman,restoration,15,10,5
Zitan,tichondrius,813,shaman,restoration,17,9,8
Deadlyshocks,gilneas,800,shaman,restoration,57,25,32
Canadalol,kelthuzad,799,shaman,restoration,23,9,14
Rensel,drakkari,799,shaman,restoration,23,9,14
Brahsbro,icecrown,789,shaman,restoration,96,46,50
Mikeoxxgigg,kelthuzad,787,shaman,restoration,82,39,43
Hudepohl,alexstrasza,776,shaman,restoration,23,9,14
Hexistential,tichondrius,768,shaman,restoration,12,8,4
Xbk,tichondrius,768,shaman,restoration,12,8,4
Ggdumpy,tichondrius,768,shaman,restoration,12,8,4
Shxl,zuljin,768,shaman,restoration,12,8,4
Xiaoshaman,tichondrius,768,shaman,restoration,12,8,4
Xannysnapper,zuljin,768,shaman,restoration,12,8,4
Longlivecrit,exodar,768,shaman,restoration,12,8,4
Kìttý,malganis,768,shaman,restoration,12,8,4
Plznostepmom,tichondrius,768,shaman,restoration,12,8,4
Tidesurge,tichondrius,768,shaman,restoration,12,8,4
Lavamon,illidan,768,shaman,restoration,12,8,4
Thictoxicity,tichondrius,768,shaman,restoration,12,8,4
Famikzmeypro,stormrage,768,shaman,restoration,12,8,4
Xiaoshaman,frostmourne,768,shaman,restoration,12,8,4
Floofs,kelthuzad,768,shaman,restoration,12,8,4
Rhazul,barthilas,768,shaman,restoration,18,8,10
Wolvez,tichondrius,768,shaman,restoration,18,8,10
Fyc,wyrmrest-accord,768,shaman,restoration,18,8,10
Artotem,barthilas,768,shaman,restoration,18,8,10
Sgtsosix,zuljin,768,shaman,restoration,18,8,10
Pigheadbansm,tichondrius,768,shaman,restoration,18,8,10
Legomyleg,tichondrius,768,shaman,restoration,18,8,10
Skymarshal,tichondrius,768,shaman,restoration,18,8,10
Kaddya,mannoroth,768,shaman,restoration,18,8,10
Songo,frostmane,768,shaman,restoration,18,8,10
Nohotsngravy,sargeras,768,shaman,restoration,18,8,10
Ändiroba,azralon,768,shaman,restoration,18,8,10
Toastjr,frostmourne,768,shaman,restoration,18,8,10
Zeroshears,tichondrius,768,shaman,restoration,24,8,16
Earthuncle,illidan,768,shaman,restoration,24,8,16
Shampoø,shattered-halls,767,shaman,restoration,12,8,4
Iarepotato,tichondrius,767,shaman,restoration,12,8,4
Veeve,kelthuzad,767,shaman,restoration,12,8,4
Watergirl,thaurissan,767,shaman,restoration,12,8,4
Mymojo,tichondrius,767,shaman,restoration,12,8,4
Lepoow,illidan,767,shaman,restoration,12,8,4
Gerberbaby,chogall,767,shaman,restoration,12,8,4
Elamentz,bleeding-hollow,767,shaman,restoration,12,8,4
Raspberri,kelthuzad,767,shaman,restoration,12,8,4
Squirtrussel,boulderfist,767,shaman,restoration,12,8,4
Runnybabbit,daggerspine,767,shaman,restoration,12,8,4
Tholkt,ragnaros,767,shaman,restoration,15,9,6
Regisphilman,bonechewer,767,shaman,restoration,17,10,7
Sledgehammer,auchindoun,767,shaman,restoration,15,8,7
Chrigshock,black-dragonflight,767,shaman,restoration,18,8,10
Jazziefae,arygos,767,shaman,restoration,18,8,10
Tigs,alleria,767,shaman,restoration,18,8,10
Fidelityfx,sargeras,767,shaman,restoration,18,8,10
Myrakh,zuljin,767,shaman,restoration,18,8,10
Rayfordyoung,zuljin,767,shaman,restoration,18,8,10
Brotem,barthilas,767,shaman,restoration,21,9,12
Pyroxten,area-52,767,shaman,restoration,24,8,16
Thunderfucj,tichondrius,767,shaman,restoration,24,8,16
Nienzi,wyrmrest-accord,767,shaman,restoration,24,8,16
Agrîm,tichondrius,767,shaman,restoration,24,8,16
Andrewot,aerie-peak,767,shaman,restoration,41,11,30
Shamansz,stormrage,766,shaman,restoration,12,8,4
Bigboorst,kelthuzad,766,shaman,restoration,12,8,4
Rapwnzel,tichondrius,766,shaman,restoration,18,8,10
Totemlord,lightnings-blade,766,shaman,restoration,18,8,10
Nooch,malganis,766,shaman,restoration,27,9,18
Magatotem,sargeras,766,shaman,restoration,24,8,16
Gohex,saurfang,765,shaman,restoration,12,8,4
Finaire,queldorei,765,shaman,restoration,12,8,4
Trickyjf,dalaran,765,shaman,restoration,18,8,10
Totescamel,tichondrius,765,shaman,restoration,18,8,10
Kanagawa,illidan,765,shaman,restoration,24,8,16
Zuljincj,zuljin,764,shaman,restoration,18,8,10
Tendies,ursin,764,shaman,restoration,18,8,10
Moistydank,tichondrius,764,shaman,restoration,24,8,16
Vulcanik,quelthalas,764,shaman,restoration,24,8,16
Vínnie,tichondrius,763,shaman,restoration,18,8,10
Furbiddên,area-52,763,shaman,restoration,24,8,16
Madhappycow,bleeding-hollow,762,shaman,restoration,17,9,8
Shamnnoodlez,area-52,762,shaman,restoration,18,8,10
Extenzz,area-52,761,shaman,restoration,18,8,10
Shamàc,tichondrius,761,shaman,restoration,24,8,16
Cremecheese,crushridge,760,shaman,restoration,12,8,4
Groonix,blood-furnace,759,shaman,restoration,12,8,4
Tiä,quelthalas,758,shaman,restoration,24,8,16
Turbö,hyjal,757,shaman,restoration,18,8,10
Shamanlesa,azralon,757,shaman,restoration,18,8,10
Kordir,kiljaeden,756,shaman,restoration,24,8,16
Amonamarth,tichondrius,753,shaman,restoration,18,8,10
Getpurged,thrall,751,shaman,restoration,17,8,9
Msooli,tichondrius,745,shaman,restoration,15,10,5
Siksika,bloodscalp,744,shaman,restoration,130,56,74
Ryforges,frostmourne,734,shaman,restoration,14,9,5
Unishamx,malganis,720,shaman,restoration,15,8,7
Picklefartsh,tichondrius,720,shaman,restoration,15,8,7
Treris,bleeding-hollow,719,shaman,restoration,11,8,3
Notragii,kelthuzad,719,shaman,restoration,17,8,9
Kencysz,tichondrius,714,shaman,restoration,23,9,14
Poundmaker,cairne,707,shaman,restoration,15,8,7
Purgelordx,proudmoore,703,shaman,restoration,11,8,3
Kenithwest,tichondrius,703,shaman,restoration,11,8,3
Garbagedump,burning-legion,703,shaman,restoration,14,8,6
Wasuwant,frostmourne,703,shaman,restoration,14,8,6
Rikswordfire,wyrmrest-accord,697,shaman,restoration,22,8,14
Interwebzz,tichondrius,697,shaman,restoration,72,17,55
Hueymagoo,firetree,684,shaman,restoration,25,8,17
Kikahna,stormreaver,683,shaman,restoration,22,9,13
Naturescandy,alterac-mountains,676,shaman,restoration,19,8,11
Heckinpurges,area-52,672,shaman,restoration,12,7,5
Hexmix,muradin,672,shaman,restoration,12,7,5
Meatboi,khaz-modan,672,shaman,restoration,12,7,5
Mørgénstérn,area-52,672,shaman,restoration,12,7,5
Invokeesorin,area-52,672,shaman,restoration,12,7,5
Envy,korialstrasz,672,shaman,restoration,12,7,5
Gagging,gundrak,672,shaman,restoration,12,7,5
Bloodlustxo,frostmourne,672,shaman,restoration,12,7,5
Xueticsham,tichondrius,672,shaman,restoration,12,7,5
Fatnutx,tichondrius,672,shaman,restoration,12,7,5
Toltem,bleeding-hollow,672,shaman,restoration,12,7,5
Iliillililli,tichondrius,672,shaman,restoration,12,7,5
Acdc,zuljin,672,shaman,restoration,12,7,5
Akurai,stormrage,672,shaman,restoration,12,7,5
Viprus,nerzhul,672,shaman,restoration,12,7,5
Symbox,tichondrius,672,shaman,restoration,12,7,5
Ballofduty,tichondrius,672,shaman,restoration,12,7,5
Daxotv,sargeras,672,shaman,restoration,12,7,5
Kustum,tichondrius,672,shaman,restoration,12,7,5
Dizzyswift,tichondrius,672,shaman,restoration,12,7,5
Zerwyn,senjin,672,shaman,restoration,12,7,5
Kassix,illidan,672,shaman,restoration,12,7,5
Banshaman,tichondrius,672,shaman,restoration,12,7,5
Joè,bleeding-hollow,672,shaman,restoration,12,7,5
Dopey,twisting-nether,672,shaman,restoration,12,7,5
Boltekka,tichondrius,672,shaman,restoration,12,7,5
Shöckäzulu,nazgrel,672,shaman,restoration,12,7,5
Farmër,illidan,672,shaman,restoration,12,7,5
Micgarnagul,illidan,672,shaman,restoration,12,7,5
Dektide,zuljin,672,shaman,restoration,12,7,5
Gruestorm,illidan,672,shaman,restoration,12,7,5
Zarly,bleeding-hollow,672,shaman,restoration,12,7,5
Elîas,tichondrius,672,shaman,restoration,12,7,5
Quiksilvero,khazgoroth,672,shaman,restoration,12,7,5
Paaman,proudmoore,672,shaman,restoration,12,7,5
Mastashambtw,illidan,672,shaman,restoration,12,7,5
Wreckaholic,alterac-mountains,672,shaman,restoration,12,7,5
Strykked,illidan,672,shaman,restoration,12,7,5
Yusbe,ragnaros,672,shaman,restoration,12,7,5
Mayim,sargeras,672,shaman,restoration,12,7,5
Mugiwára,ragnaros,672,shaman,restoration,12,7,5
Torgunderson,stormrage,672,shaman,restoration,12,7,5
Befree,thunderlord,672,shaman,restoration,15,8,7
Zrosurge,stormrage,672,shaman,restoration,14,7,7
Oprawindfuri,whisperwind,672,shaman,restoration,18,7,11
Pjtremblay,frostmourne,672,shaman,restoration,18,7,11
Káori,area-52,672,shaman,restoration,18,7,11
Nikeshocks,detheroc,672,shaman,restoration,18,7,11
Morphose,tichondrius,672,shaman,restoration,18,7,11
Fatherchunga,burning-legion,672,shaman,restoration,18,7,11
Ghiscar,tichondrius,672,shaman,restoration,18,7,11
Smeagles,ragnaros,672,shaman,restoration,18,7,11
Plaboii,magtheridon,672,shaman,restoration,18,7,11
Meeb,emerald-dream,672,shaman,restoration,18,7,11
Eternaltotem,darkspear,672,shaman,restoration,18,7,11
Macavell,tichondrius,672,shaman,restoration,18,7,11
Hardlyfe,frostmourne,672,shaman,restoration,18,7,11
Trippzs,barthilas,672,shaman,restoration,18,7,11
Huashiren,illidan,672,shaman,restoration,18,7,11
Lindsanx,illidan,672,shaman,restoration,18,7,11
Silverkitty,tichondrius,672,shaman,restoration,18,7,11
History,burning-blade,672,shaman,restoration,18,7,11
Lildik,tichondrius,672,shaman,restoration,18,7,11
Zanderpla,kelthuzad,672,shaman,restoration,18,7,11
Aromental,sargeras,672,shaman,restoration,18,7,11
Annpurgekins,area-52,672,shaman,restoration,18,7,11
Stumpyjoe,terokkar,672,shaman,restoration,19,7,12
Krisu,kelthuzad,672,shaman,restoration,24,7,17
Foxymama,the-forgotten-coast,672,shaman,restoration,24,7,17
Twinkyz,boulderfist,672,shaman,restoration,30,7,23
Flekzs,blackhand,671,shaman,restoration,12,7,5
Curtrex,amanthul,671,shaman,restoration,12,7,5
Drathos,azralon,671,shaman,restoration,12,7,5
Thormodin,destromath,671,shaman,restoration,12,7,5
Kustys,tichondrius,671,shaman,restoration,12,7,5
Shamiggels,sargeras,671,shaman,restoration,12,7,5
Sixzo,tichondrius,671,shaman,restoration,12,7,5
Theshamhomie,stormrage,671,shaman,restoration,12,7,5
Antysham,emerald-dream,671,shaman,restoration,12,7,5
Messiahz,illidan,671,shaman,restoration,12,7,5
Pakdis,sargeras,671,shaman,restoration,12,7,5
Arkilios,tichondrius,671,shaman,restoration,12,7,5
Rokvahn,illidan,671,shaman,restoration,12,7,5
Wishpool,stormrage,671,shaman,restoration,12,7,5
Caobuloso,azralon,671,shaman,restoration,18,7,11
Derbain,caelestrasz,671,shaman,restoration,18,7,11
Kamltoetm,proudmoore,671,shaman,restoration,18,7,11
Bintopean,boulderfist,671,shaman,restoration,18,7,11
Dochavoc,tichondrius,671,shaman,restoration,18,7,11
Lvcianrs,thrall,671,shaman,restoration,18,7,11
Cavolt,stormrage,671,shaman,restoration,18,7,11
Sheariously,sargeras,671,shaman,restoration,18,7,11
Riptiddles,nordrassil,671,shaman,restoration,30,7,23
Jaws,skullcrusher,670,shaman,restoration,12,7,5
Shamanastic,tichondrius,670,shaman,restoration,12,7,5
Crynoobs,senjin,670,shaman,restoration,12,7,5
Bethorá,suramar,670,shaman,restoration,12,7,5
Xuesu,tichondrius,670,shaman,restoration,12,7,5
Flameism,sargeras,670,shaman,restoration,12,7,5
Arrcae,tichondrius,670,shaman,restoration,12,7,5
Zevexx,tichondrius,670,shaman,restoration,12,7,5
Saulgudmon,area-52,670,shaman,restoration,18,7,11
Moonrider,nerzhul,670,shaman,restoration,18,7,11
Hopetotem,zuljin,670,shaman,restoration,18,7,11
Oprawîndfury,tichondrius,670,shaman,restoration,18,7,11
Bigmawmaw,moon-guard,670,shaman,restoration,18,7,11
Víì,tichondrius,670,shaman,restoration,24,7,17
Toedims,bonechewer,669,shaman,restoration,12,7,5
Logich,dalaran,669,shaman,restoration,18,7,11
Rrakk,proudmoore,669,shaman,restoration,18,7,11
Todem,stormrage,669,shaman,restoration,18,7,11
Thordan,lothar,669,shaman,restoration,18,7,11
Nahualtt,quelthalas,669,shaman,restoration,18,7,11
Farku,illidan,669,shaman,restoration,36,7,29
Evilraven,tichondrius,668,shaman,restoration,18,7,11
Waterspinach,tichondrius,668,shaman,restoration,18,7,11
Detropolis,illidan,668,shaman,restoration,48,7,41
Kaliøs,ragnaros,667,shaman,restoration,12,7,5
Snowship,sargeras,667,shaman,restoration,18,7,11
Youngneal,sargeras,667,shaman,restoration,18,7,11
Topazlight,thrall,667,shaman,restoration,24,7,17
Dennwoop,sargeras,666,shaman,restoration,28,8,20
Trodor,tichondrius,665,shaman,restoration,12,7,5
Ruadhri,moon-guard,665,shaman,restoration,12,7,5
Vidulfo,tichondrius,659,shaman,restoration,12,7,5
Kihlubra,frostmourne,655,shaman,restoration,25,7,18
Mâyo,thrall,654,shaman,restoration,17,7,10
Slimcube,illidan,649,shaman,restoration,24,8,16
Stormsurgë,bleeding-hollow,640,shaman,restoration,10,8,2
Healingtime,nerzhul,638,shaman,restoration,14,8,6
Flíx,stormrage,638,shaman,restoration,14,8,6
Talraviebor,stormrage,636,shaman,restoration,14,8,6
Cdewschair,tichondrius,623,shaman,restoration,17,7,10
Deacoderz,area-52,618,shaman,restoration,14,8,6
Royblue,illidan,618,shaman,restoration,14,8,6
Îvôry,bloodhoof,618,shaman,restoration,22,10,12
Vindícated,area-52,617,shaman,restoration,13,8,5
Hexoffender,thunderlord,617,shaman,restoration,21,8,13
Tolvashoc,emerald-dream,608,shaman,restoration,16,7,9
Bostar,tichondrius,607,shaman,restoration,14,7,7
Drfate,kargath,604,shaman,restoration,16,7,9
Xlash,zuljin,598,shaman,restoration,26,7,19
Grony,malganis,592,shaman,restoration,7,7,0
Vaderung,emerald-dream,592,shaman,restoration,13,7,6
Jinyara,malganis,576,shaman,restoration,6,6,0
ßlessthefall,malganis,576,shaman,restoration,6,6,0
Zontas,illidan,576,shaman,restoration,6,6,0
Jimmyapple,illidan,576,shaman,restoration,6,6,0
Duckhead,tichondrius,576,shaman,restoration,6,6,0
Limburger,zuljin,576,shaman,restoration,6,6,0
Vrangr,uther,576,shaman,restoration,6,6,0
Tommoorello,lightnings-blade,576,shaman,restoration,6,6,0
Toastsshaman,tichondrius,576,shaman,restoration,6,6,0
Jaygodx,blades-edge,576,shaman,restoration,6,6,0
Jordnöt,moon-guard,576,shaman,restoration,9,6,3
Kilrögg,illidan,576,shaman,restoration,12,6,6
Ironstars,stormrage,576,shaman,restoration,12,6,6
Betaprostate,alterac-mountains,576,shaman,restoration,12,6,6
Caprise,tichondrius,576,shaman,restoration,12,6,6
Earthside,ragnaros,576,shaman,restoration,12,6,6
Mariansaurus,ragnaros,576,shaman,restoration,12,6,6
Weqeqwqwqex,ragnaros,576,shaman,restoration,12,6,6
Triyourong,proudmoore,576,shaman,restoration,12,6,6
Akamâ,stormrage,576,shaman,restoration,12,6,6
Spiritbb,area-52,576,shaman,restoration,12,6,6
Xenvale,illidan,576,shaman,restoration,12,6,6
Fevolution,dreadmaul,576,shaman,restoration,12,6,6
Nymrose,stormrage,576,shaman,restoration,12,6,6
Iamg,kilrogg,576,shaman,restoration,12,6,6
Motatos,malganis,576,shaman,restoration,12,6,6
Oppaswag,tichondrius,576,shaman,restoration,12,6,6
Apathcat,the-forgotten-coast,576,shaman,restoration,12,6,6
Atsukaia,tichondrius,576,shaman,restoration,12,6,6
Rawdogginit,malfurion,576,shaman,restoration,12,6,6
Hhex,tichondrius,576,shaman,restoration,12,6,6
Jiangjinfu,tichondrius,576,shaman,restoration,12,6,6
Aespeon,stormrage,576,shaman,restoration,12,6,6
Chancec,garrosh,576,shaman,restoration,12,6,6
Xchainz,stormrage,576,shaman,restoration,12,6,6
Deevviouss,barthilas,576,shaman,restoration,12,6,6
Jamarcuss,tichondrius,576,shaman,restoration,12,6,6
Lindnerx,malganis,576,shaman,restoration,12,6,6
Tcurts,stormrage,576,shaman,restoration,12,6,6
Ajj,thrall,576,shaman,restoration,12,6,6
Bravezf,tichondrius,576,shaman,restoration,12,6,6
Scadouche,korgath,576,shaman,restoration,12,6,6
Mocksy,eredar,576,shaman,restoration,12,6,6
Gullirachad,stormrage,576,shaman,restoration,12,6,6
Mazekheen,barthilas,576,shaman,restoration,12,6,6
Gangdan,emerald-dream,576,shaman,restoration,12,6,6
Callabash,mugthol,576,shaman,restoration,12,6,6
Surph,zuljin,576,shaman,restoration,12,6,6
Sweatshirtz,tanaris,576,shaman,restoration,12,6,6
Unclexflex,tichondrius,576,shaman,restoration,12,6,6
Squog,sargeras,576,shaman,restoration,12,6,6
Cannoliluvr,eldrethalas,576,shaman,restoration,12,6,6
Patmar,dragonmaw,576,shaman,restoration,12,6,6
Thoraq,bleeding-hollow,576,shaman,restoration,12,6,6
Lavawurst,tichondrius,576,shaman,restoration,12,6,6
Diptide,bleeding-hollow,576,shaman,restoration,12,6,6
Pex,sargeras,576,shaman,restoration,12,6,6
Shearhands,illidan,576,shaman,restoration,12,6,6
Subhealth,tichondrius,576,shaman,restoration,12,6,6
Nickbosa,illidan,576,shaman,restoration,12,6,6
Pikapiko,tichondrius,576,shaman,restoration,12,6,6
Ccmeifbald,moon-guard,576,shaman,restoration,12,6,6
Chogramm,illidan,576,shaman,restoration,12,6,6
Fjury,dalaran,576,shaman,restoration,12,6,6
Kamusham,azralon,576,shaman,restoration,12,6,6
Kaidman,tichondrius,576,shaman,restoration,12,6,6
Goodzilla,aegwynn,576,shaman,restoration,18,6,12
Tchamí,blackrock,576,shaman,restoration,18,6,12
Rubmytiki,skywall,576,shaman,restoration,18,6,12
Shäman,anetheron,576,shaman,restoration,18,6,12
Aiyinsitan,illidan,576,shaman,restoration,18,6,12
Lyrig,lightbringer,576,shaman,restoration,18,6,12
Icehole,kelthuzad,576,shaman,restoration,18,6,12
Oscer,tichondrius,576,shaman,restoration,18,6,12
Heysteptotem,tichondrius,576,shaman,restoration,18,6,12
Sheeno,blackrock,576,shaman,restoration,18,6,12
Adodo,tichondrius,576,shaman,restoration,18,6,12
Zâppý,dalaran,576,shaman,restoration,18,6,12
Larvabust,azralon,576,shaman,restoration,18,6,12
Kÿlé,darkspear,576,shaman,restoration,18,6,12
Greensween,thrall,576,shaman,restoration,19,6,13
Shampowl,jaedenar,576,shaman,restoration,20,6,14
Dukaman,malganis,576,shaman,restoration,24,6,18
Froglok,boulderfist,575,shaman,restoration,6,6,0
Thralgor,twisting-nether,575,shaman,restoration,12,6,6
Râine,stormreaver,575,shaman,restoration,12,6,6
Twistedteas,tichondrius,575,shaman,restoration,12,6,6
Xhod,zuljin,575,shaman,restoration,12,6,6
Sarevoc,sargeras,575,shaman,restoration,12,6,6
Cùìó,barthilas,575,shaman,restoration,12,6,6
Hexegin,kelthuzad,575,shaman,restoration,12,6,6
Bootle,khazgoroth,575,shaman,restoration,12,6,6
Gushaman,area-52,575,shaman,restoration,12,6,6
Dylie,tichondrius,575,shaman,restoration,12,6,6
Donojo,zuljin,575,shaman,restoration,12,6,6
Ladash,ragnaros,575,shaman,restoration,12,6,6
Esa,andorhal,575,shaman,restoration,12,6,6
Tagliatelle,kelthuzad,575,shaman,restoration,15,7,8
Numbreseven,frostmourne,575,shaman,restoration,14,6,8
Ragnarüz,ragnaros,575,shaman,restoration,19,7,12
Deunan,ragnaros,575,shaman,restoration,18,6,12
Stormwalk,ragnaros,575,shaman,restoration,18,6,12
Fouroclock,drakthul,575,shaman,restoration,18,6,12
Loec,thrall,575,shaman,restoration,18,6,12
Millkmachine,daggerspine,575,shaman,restoration,18,6,12
Girafasuarx,korgath,575,shaman,restoration,18,6,12
Shamncheddar,bleeding-hollow,575,shaman,restoration,24,6,18
Martabakasin,frostmourne,575,shaman,restoration,24,6,18
Momoku,frostmourne,574,shaman,restoration,12,6,6
Fete,malganis,574,shaman,restoration,12,6,6
Luciuzz,tichondrius,574,shaman,restoration,12,6,6
Killerphreak,mannoroth,574,shaman,restoration,12,6,6
Shyeahmon,drenden,574,shaman,restoration,12,6,6
Kunshíí,bleeding-hollow,574,shaman,restoration,15,6,9
Camdoc,destromath,574,shaman,restoration,18,6,12
Naishi,mannoroth,573,shaman,restoration,18,6,12
Monspiett,azralon,573,shaman,restoration,18,6,12
Ctrlaltelite,burning-blade,573,shaman,restoration,18,6,12
Spookyosa,dalaran,573,shaman,restoration,36,6,30
Fogden,alleria,572,shaman,restoration,12,6,6
Jibberp,tichondrius,572,shaman,restoration,12,6,6
Bombsb,tichondrius,572,shaman,restoration,18,6,12
Killuminatti,nathrezim,572,shaman,restoration,18,6,12
Teebob,hyjal,572,shaman,restoration,18,6,12
Gimlyman,madoran,567,shaman,restoration,12,6,6
Trustfall,rexxar,566,shaman,restoration,12,6,6
Bloodmoôn,frostmourne,566,shaman,restoration,18,6,12
Kàmï,illidan,559,shaman,restoration,11,6,5
Emonez,kiljaeden,559,shaman,restoration,18,6,12
Acmilan,tichondrius,544,shaman,restoration,16,6,10
Reddleman,stormrage,544,shaman,restoration,22,6,16
Brogetic,cenarius,543,shaman,restoration,11,6,5
Earthnsky,bleeding-hollow,543,shaman,restoration,11,6,5
Saviørkai,barthilas,543,shaman,restoration,14,7,7
Heeyas,tichondrius,527,shaman,restoration,11,6,5
Thetotemtaco,tichondrius,527,shaman,restoration,11,6,5
Imlubedup,saurfang,527,shaman,restoration,11,6,5
Cornroll,tichondrius,527,shaman,restoration,11,6,5
Pazzam,arthas,526,shaman,restoration,11,6,5
Shamyshame,quelthalas,522,shaman,restoration,12,7,5
Tyealer,frostwolf,518,shaman,restoration,13,7,6
Gohral,wyrmrest-accord,512,shaman,restoration,16,6,10
Fengfeism,tichondrius,511,shaman,restoration,14,6,8
Watoos,area-52,511,shaman,restoration,20,6,14
Shamining,illidan,510,shaman,restoration,8,6,2
Reèzx,illidan,480,shaman,restoration,6,5,1
Eagaen,illidan,480,shaman,restoration,6,5,1
Mahevagodx,ragnaros,480,shaman,restoration,6,5,1
Cheddatotz,illidan,480,shaman,restoration,6,5,1
Shamamsx,illidan,480,shaman,restoration,6,5,1
Jarebears,thrall,480,shaman,restoration,6,5,1
Bluepenguin,kelthuzad,480,shaman,restoration,6,5,1
Oopy,icecrown,480,shaman,restoration,6,5,1
Plazz,sargeras,480,shaman,restoration,6,5,1
Oprawinfuryy,thrall,480,shaman,restoration,6,5,1
Dankestmemes,illidan,480,shaman,restoration,6,5,1
Fastaslight,bleeding-hollow,480,shaman,restoration,6,5,1
Binishaman,tichondrius,480,shaman,restoration,6,5,1
Praisegodx,stormrage,480,shaman,restoration,6,5,1
Zêüs,dragonmaw,480,shaman,restoration,6,5,1
Msool,tichondrius,480,shaman,restoration,6,5,1
Binestein,tichondrius,480,shaman,restoration,6,5,1
Blueclass,akama,480,shaman,restoration,6,5,1
Cantshear,zuljin,480,shaman,restoration,6,5,1
Ñätùrëðrägøñ,tichondrius,480,shaman,restoration,6,5,1
Nuggsfxce,frostmourne,480,shaman,restoration,6,5,1
Hellstabbers,lightbringer,480,shaman,restoration,6,5,1
Esterosa,tichondrius,480,shaman,restoration,6,5,1
Alasierg,stonemaul,480,shaman,restoration,6,5,1
Toath,tichondrius,480,shaman,restoration,6,5,1
Vixen,ravenholdt,480,shaman,restoration,6,5,1
Çhïcagø,aegwynn,480,shaman,restoration,6,5,1
Seukstinyne,frostmourne,480,shaman,restoration,12,5,7
Huulu,blades-edge,480,shaman,restoration,12,5,7
Doop,kiljaeden,480,shaman,restoration,12,5,7
Baltarian,emerald-dream,480,shaman,restoration,12,5,7
Sâxman,stormreaver,480,shaman,restoration,12,5,7
Shambuddy,moon-guard,480,shaman,restoration,12,5,7
Dyllbat,illidan,480,shaman,restoration,12,5,7
Soonn,ragnaros,480,shaman,restoration,12,5,7
Rykkar,kiljaeden,480,shaman,restoration,12,5,7
Trizzeh,moon-guard,480,shaman,restoration,12,5,7
Srbski,emerald-dream,480,shaman,restoration,12,5,7
Kupnicki,zuljin,480,shaman,restoration,12,5,7
Totolorraine,tichondrius,480,shaman,restoration,12,5,7
Nizzarrathur,emerald-dream,480,shaman,restoration,12,5,7
Shimta,kiljaeden,480,shaman,restoration,12,5,7
Tingletotem,tichondrius,480,shaman,restoration,12,5,7
Shockwall,stormrage,480,shaman,restoration,12,5,7
Hokuto,tichondrius,480,shaman,restoration,12,5,7
Simpinbeen,frostmourne,480,shaman,restoration,12,5,7
Sixtyninelol,thunderlord,480,shaman,restoration,12,5,7
Illmental,kelthuzad,480,shaman,restoration,12,5,7
Spiritshocks,tichondrius,480,shaman,restoration,12,5,7
Deyodin,illidan,480,shaman,restoration,12,5,7
Cluffatty,tichondrius,480,shaman,restoration,12,5,7
Goresx,tichondrius,480,shaman,restoration,12,5,7
Saw,ghostlands,480,shaman,restoration,12,5,7
Kaidis,jubeithos,480,shaman,restoration,12,5,7
Nøir,drakkari,480,shaman,restoration,12,5,7
Avelmiré,sargeras,480,shaman,restoration,12,5,7
Synkronaqt,tichondrius,480,shaman,restoration,12,5,7
Latoques,quelthalas,480,shaman,restoration,12,5,7
Aderra,garrosh,480,shaman,restoration,12,5,7
Rouzy,area-52,480,shaman,restoration,12,5,7
Masatotem,burning-blade,480,shaman,restoration,12,5,7
Juked,aegwynn,480,shaman,restoration,12,5,7
Lesnar,area-52,480,shaman,restoration,12,5,7
Folda,tichondrius,480,shaman,restoration,12,5,7
Thonty,sargeras,480,shaman,restoration,12,5,7
Teftx,area-52,480,shaman,restoration,12,5,7
Nathaan,tichondrius,480,shaman,restoration,12,5,7
Bignutters,bleeding-hollow,480,shaman,restoration,12,5,7
Needneed,tichondrius,480,shaman,restoration,12,5,7
Nøzurbo,area-52,480,shaman,restoration,12,5,7
Devastian,quelthalas,480,shaman,restoration,12,5,7
Bröxigâr,tichondrius,480,shaman,restoration,12,5,7
Teestuh,proudmoore,480,shaman,restoration,12,5,7
Kergan,fenris,480,shaman,restoration,12,5,7
Sylemm,malganis,480,shaman,restoration,12,5,7
Weebzealot,kelthuzad,480,shaman,restoration,12,5,7
Vegaslights,tichondrius,480,shaman,restoration,12,5,7
Azrlol,illidan,480,shaman,restoration,12,5,7
Astotems,tichondrius,480,shaman,restoration,12,5,7
Daintydan,illidan,480,shaman,restoration,12,5,7
Zapped,frostmane,480,shaman,restoration,12,5,7
Flaggedname,frostmane,480,shaman,restoration,12,5,7
Krupto,tichondrius,480,shaman,restoration,12,5,7
Hijodelrayo,drakkari,480,shaman,restoration,12,5,7
Nagish,alexstrasza,480,shaman,restoration,12,5,7
Jacori,malganis,480,shaman,restoration,12,5,7
Kshock,hyjal,480,shaman,restoration,12,5,7
Gomeimsoft,magtheridon,480,shaman,restoration,12,5,7
Drcopafeel,stormrage,480,shaman,restoration,12,5,7
Tmkaldärýs,tichondrius,480,shaman,restoration,12,5,7
Seiko,tichondrius,480,shaman,restoration,12,5,7
Scrumbum,tichondrius,480,shaman,restoration,16,6,10
Liltex,malganis,480,shaman,restoration,18,5,13
Noveske,arthas,480,shaman,restoration,18,5,13
Animac,bleeding-hollow,480,shaman,restoration,18,5,13
Saksa,garrosh,480,shaman,restoration,18,5,13
Stedi,moon-guard,480,shaman,restoration,18,5,13
Stoompz,kiljaeden,480,shaman,restoration,18,5,13
Zezlek,malganis,480,shaman,restoration,18,5,13
Oilburner,malganis,480,shaman,restoration,18,5,13
Decm,area-52,480,shaman,restoration,18,5,13
Tehbeast,khadgar,480,shaman,restoration,24,5,19
Danimalls,stormrage,479,shaman,restoration,6,5,1
Terrusguard,thrall,479,shaman,restoration,6,5,1
Greenberry,bonechewer,479,shaman,restoration,10,6,4
Gagonmatotem,skullcrusher,479,shaman,restoration,9,5,4
Arastour,bronzebeard,479,shaman,restoration,12,5,7
Drmundo,icecrown,479,shaman,restoration,12,5,7
Totemzlol,sargeras,479,shaman,restoration,12,5,7
Bayonett,wyrmrest-accord,479,shaman,restoration,12,5,7
Maczo,kiljaeden,479,shaman,restoration,12,5,7
Uncleg,frostmourne,479,shaman,restoration,12,5,7
Aimsely,area-52,479,shaman,restoration,12,5,7
Øliverxd,lightbringer,479,shaman,restoration,12,5,7
Blkpowerfist,malganis,479,shaman,restoration,12,5,7
Piaopiao,skywall,479,shaman,restoration,12,5,7
Yngvii,tichondrius,479,shaman,restoration,12,5,7
Sâvage,zuljin,479,shaman,restoration,12,5,7
Estheriea,moon-guard,479,shaman,restoration,12,5,7
Highmountain,tichondrius,479,shaman,restoration,12,5,7
Welled,area-52,479,shaman,restoration,12,5,7
Beardsworth,emerald-dream,479,shaman,restoration,12,5,7
Bobaflexqt,korgath,479,shaman,restoration,12,5,7
Tattoö,elune,479,shaman,restoration,12,5,7
Guronna,arthas,479,shaman,restoration,18,5,13
Beanshammy,stormrage,479,shaman,restoration,18,5,13
Nytestalker,sargeras,479,shaman,restoration,18,5,13
Haymaker,bleeding-hollow,479,shaman,restoration,24,5,19
Typo,skullcrusher,478,shaman,restoration,6,5,1
Kugelrund,proudmoore,478,shaman,restoration,12,5,7
Samac,ravencrest,478,shaman,restoration,12,5,7
Oregano,korgath,478,shaman,restoration,12,5,7
Thunderguy,icecrown,478,shaman,restoration,18,5,13
Stahlye,proudmoore,477,shaman,restoration,6,5,1
Timprecu,azralon,477,shaman,restoration,12,5,7
Furyshock,tichondrius,477,shaman,restoration,18,5,13
Vazan,arthas,476,shaman,restoration,12,5,7
Healcacatoi,zuljin,475,shaman,restoration,12,5,7
Pileef,thrall,473,shaman,restoration,13,7,6
Uderlol,tichondrius,448,shaman,restoration,10,5,5
Brocklee,farstriders,447,shaman,restoration,16,5,11
Lequandarius,sargeras,447,shaman,restoration,17,5,12
Akhae,duskwood,445,shaman,restoration,14,6,8
Shocktopus,emerald-dream,442,shaman,restoration,22,12,10
Sidnii,tichondrius,432,shaman,restoration,9,5,4
Alubedo,goldrinn,432,shaman,restoration,15,5,10
Voltzwagon,vashj,431,shaman,restoration,9,6,3
Lampstand,wildhammer,431,shaman,restoration,11,5,6
Zelzus,moon-guard,431,shaman,restoration,11,5,6
Tyfu,tichondrius,426,shaman,restoration,13,6,7
Swampy,tanaris,426,shaman,restoration,15,6,9
Littleshasha,tichondrius,426,shaman,restoration,15,6,9
Ggezlmao,bleeding-hollow,426,shaman,restoration,16,6,10
Drowsbad,tichondrius,426,shaman,restoration,22,7,15
Zio,akama,425,shaman,restoration,14,6,8
Thelôpen,tichondrius,425,shaman,restoration,23,7,16
Hannibol,tichondrius,416,shaman,restoration,10,5,5
Shockjoy,malganis,415,shaman,restoration,11,5,6
Instanoodlez,eonar,414,shaman,restoration,6,6,0
Clapton,darkspear,400,shaman,restoration,19,5,14
Thua,moon-guard,384,shaman,restoration,6,4,2
Shämblez,area-52,384,shaman,restoration,6,4,2
Tisaa,tichondrius,384,shaman,restoration,6,4,2
Smeeza,frostmourne,384,shaman,restoration,6,4,2
Enkcurable,tichondrius,384,shaman,restoration,6,4,2
Tyshaman,sargeras,384,shaman,restoration,6,4,2
Kaîowas,malganis,384,shaman,restoration,6,4,2
Drackmon,illidan,384,shaman,restoration,6,4,2
Phado,tichondrius,384,shaman,restoration,6,4,2
Castia,sargeras,384,shaman,restoration,6,4,2
Éarl,sargeras,384,shaman,restoration,6,4,2
Wecookin,frostwolf,384,shaman,restoration,6,4,2
Blazedblue,tichondrius,384,shaman,restoration,6,4,2
Satanics,drakkari,384,shaman,restoration,6,4,2
Ârtík,tichondrius,384,shaman,restoration,6,4,2
Xiaoya,tichondrius,384,shaman,restoration,6,4,2
Capriserjr,tichondrius,384,shaman,restoration,6,4,2
Dînk,stormrage,384,shaman,restoration,6,4,2
Elrik,khadgar,384,shaman,restoration,6,4,2
Gotmolk,illidan,384,shaman,restoration,6,4,2
Xraiduh,area-52,384,shaman,restoration,6,4,2
Wìnì,dalaran,384,shaman,restoration,6,4,2
Notretro,uldum,384,shaman,restoration,6,4,2
Djbluex,tichondrius,384,shaman,restoration,6,4,2
Aletcheoddox,sargeras,384,shaman,restoration,6,4,2
Intravz,tichondrius,384,shaman,restoration,6,4,2
Shiriloster,ragnaros,384,shaman,restoration,6,4,2
Rhox,azralon,384,shaman,restoration,6,4,2
Telnos,emerald-dream,384,shaman,restoration,6,4,2
Aeølus,tichondrius,384,shaman,restoration,6,4,2
Nepshock,stormrage,384,shaman,restoration,6,4,2
Baabaabare,tichondrius,384,shaman,restoration,6,4,2
Bhann,tichondrius,384,shaman,restoration,6,4,2
Unrealistic,dunemaul,384,shaman,restoration,6,4,2
Príde,ragnaros,384,shaman,restoration,6,4,2
Excaliburumb,tichondrius,384,shaman,restoration,6,4,2
Gumballin,sargeras,384,shaman,restoration,8,4,4
Spippippin,illidan,384,shaman,restoration,12,4,8
Shâmbulance,hyjal,384,shaman,restoration,12,4,8
Trölencio,quelthalas,384,shaman,restoration,12,4,8
Skumnasty,tichondrius,384,shaman,restoration,12,4,8
Dallìa,tichondrius,384,shaman,restoration,12,4,8
Naturelover,mugthol,384,shaman,restoration,12,4,8
Dablue,stormrage,384,shaman,restoration,12,4,8
Twiztedwayz,tichondrius,384,shaman,restoration,12,4,8
Inhale,sargeras,384,shaman,restoration,12,4,8
Lixir,destromath,384,shaman,restoration,12,4,8
Juraf,malganis,384,shaman,restoration,12,4,8
Dikedwarf,burning-blade,384,shaman,restoration,12,4,8
Misakism,sargeras,384,shaman,restoration,12,4,8
Toobeastly,deathwing,384,shaman,restoration,12,4,8
Boyyo,maiev,384,shaman,restoration,12,4,8
Kharnus,ravenholdt,384,shaman,restoration,12,4,8
Cgq,tichondrius,384,shaman,restoration,12,4,8
Smashyz,nerzhul,384,shaman,restoration,12,4,8
Rabajood,korgath,384,shaman,restoration,12,4,8
Bayslaps,tichondrius,384,shaman,restoration,12,4,8
Naturasol,quelthalas,384,shaman,restoration,12,4,8
Mkmprpr,tichondrius,384,shaman,restoration,12,4,8
Healswin,sargeras,384,shaman,restoration,12,4,8
Flexi,senjin,384,shaman,restoration,12,4,8
Geontha,drakkari,384,shaman,restoration,12,4,8
Belazeus,tichondrius,384,shaman,restoration,12,4,8
Stoneforged,area-52,384,shaman,restoration,12,4,8
Spokytv,azralon,384,shaman,restoration,12,4,8
Ayev,illidan,384,shaman,restoration,12,4,8
Pomelol,tichondrius,384,shaman,restoration,12,4,8
Dankprotein,tichondrius,384,shaman,restoration,12,4,8
Ngentotem,frostmourne,384,shaman,restoration,12,4,8
Celements,malganis,384,shaman,restoration,12,4,8
Porkbrains,emerald-dream,384,shaman,restoration,16,5,11
Kezzër,azralon,384,shaman,restoration,16,4,12
Malthor,terenas,384,shaman,restoration,18,4,14
Conductivity,frostmourne,384,shaman,restoration,18,4,14
Kermut,frostmourne,384,shaman,restoration,18,4,14
Djoko,tichondrius,384,shaman,restoration,18,4,14
Bøx,ragnaros,383,shaman,restoration,6,4,2
Rockyisback,illidan,383,shaman,restoration,6,4,2
Ilion,nemesis,383,shaman,restoration,6,4,2
Hexnation,frostmourne,383,shaman,restoration,6,4,2
Ozsham,burning-blade,383,shaman,restoration,8,4,4
Ânûbis,sargeras,383,shaman,restoration,12,4,8
Foogus,tichondrius,383,shaman,restoration,12,4,8
Zìfu,darkspear,383,shaman,restoration,12,4,8
Sndtome,tichondrius,383,shaman,restoration,12,4,8
Tandarin,burning-legion,383,shaman,restoration,12,4,8
Gaboola,tichondrius,383,shaman,restoration,12,4,8
Surgetankian,malorne,383,shaman,restoration,12,4,8
Sainttotem,zuljin,383,shaman,restoration,12,4,8
Herteitr,blood-furnace,383,shaman,restoration,12,4,8
Huugsnkissez,sargeras,383,shaman,restoration,12,4,8
Akharis,frostmane,383,shaman,restoration,21,5,16
Caulkshock,tichondrius,382,shaman,restoration,12,4,8
Shockshow,zuljin,382,shaman,restoration,12,4,8
Huukron,emerald-dream,382,shaman,restoration,12,4,8
Chamorro,quelthalas,382,shaman,restoration,18,4,14
Laveidem,frostmourne,382,shaman,restoration,18,4,14
Valien,kiljaeden,381,shaman,restoration,12,4,8
Bubmack,tichondrius,379,shaman,restoration,12,4,8
Xändra,ragnaros,371,shaman,restoration,23,7,16
Flavortrash,the-underbog,367,shaman,restoration,11,4,7
Pche,tichondrius,367,shaman,restoration,11,4,7
Alwinaa,kiljaeden,367,shaman,restoration,11,4,7
Aceventuura,hyjal,352,shaman,restoration,22,4,18
Shamanakin,emerald-dream,351,shaman,restoration,8,5,3
Dreadshox,wyrmrest-accord,336,shaman,restoration,9,5,4
Avidas,malganis,331,shaman,restoration,15,4,11
Hitchsláp,tichondrius,330,shaman,restoration,16,5,11
Intress,moon-guard,329,shaman,restoration,10,6,4
Cleiri,quelthalas,319,shaman,restoration,5,4,1
Záika,sargeras,318,shaman,restoration,10,4,6
Elevatezxo,stormrage,304,shaman,restoration,7,4,3
Uggerz,barthilas,297,shaman,restoration,14,5,9
Nyroh,zuljin,288,shaman,restoration,6,3,3
Megafin,tichondrius,288,shaman,restoration,6,3,3
Stymiedxs,zuljin,288,shaman,restoration,6,3,3
Owoken,illidan,288,shaman,restoration,6,3,3
Goongoon,zuljin,288,shaman,restoration,6,3,3
Cloudycloud,tichondrius,288,shaman,restoration,6,3,3
Shomminn,tichondrius,288,shaman,restoration,6,3,3
Forloren,zuljin,288,shaman,restoration,6,3,3
Snpi,kiljaeden,288,shaman,restoration,6,3,3
Beatsmaker,tichondrius,288,shaman,restoration,6,3,3
Memetide,daggerspine,288,shaman,restoration,6,3,3
Smackzs,sargeras,288,shaman,restoration,6,3,3
Sumyl,ragnaros,288,shaman,restoration,6,3,3
Wallflowerx,zuljin,288,shaman,restoration,6,3,3
Yunqboichay,kelthuzad,288,shaman,restoration,6,3,3
Nondracil,ragnaros,288,shaman,restoration,6,3,3
Snowkingx,illidan,288,shaman,restoration,6,3,3
Floods,frostmourne,288,shaman,restoration,6,3,3
Sumdumshaman,illidan,288,shaman,restoration,6,3,3
Siox,zuljin,288,shaman,restoration,6,3,3
Uthprotekta,daggerspine,288,shaman,restoration,6,3,3
Dyxlol,tichondrius,288,shaman,restoration,6,3,3
Shammich,vashj,288,shaman,restoration,6,3,3
Ñoobshaman,tichondrius,288,shaman,restoration,6,3,3
Dwarfers,emerald-dream,288,shaman,restoration,6,3,3
Drwsham,ragnaros,288,shaman,restoration,6,3,3
Yès,proudmoore,288,shaman,restoration,6,3,3
Solitarysham,moon-guard,288,shaman,restoration,6,3,3
Pôpamolly,saurfang,288,shaman,restoration,6,3,3
Shomon,khazgoroth,288,shaman,restoration,6,3,3
Jackiesham,illidan,288,shaman,restoration,6,3,3
Radbtw,icecrown,288,shaman,restoration,6,3,3
Akupapu,illidan,288,shaman,restoration,6,3,3
Russtoration,frostmourne,288,shaman,restoration,6,3,3
Sonsii,tichondrius,288,shaman,restoration,6,3,3
Vitchzestein,ragnaros,288,shaman,restoration,6,3,3
Digglr,tichondrius,288,shaman,restoration,6,3,3
Zaios,area-52,288,shaman,restoration,6,3,3
Spencêrf,illidan,288,shaman,restoration,6,3,3
Epicchodez,nerzhul,288,shaman,restoration,6,3,3
Catnïp,maelstrom,288,shaman,restoration,6,3,3
Wolfguts,thrall,288,shaman,restoration,6,3,3
Fruityrudyy,area-52,288,shaman,restoration,6,3,3
Teladoy,kelthuzad,288,shaman,restoration,6,3,3
Goullin,dalaran,288,shaman,restoration,6,3,3
Maana,dragonmaw,288,shaman,restoration,6,3,3
Ililiiïiili,tichondrius,288,shaman,restoration,6,3,3
Herpeaz,kelthuzad,288,shaman,restoration,6,3,3
Wèsleypipes,crushridge,288,shaman,restoration,6,3,3
Cloudsh,silvermoon,288,shaman,restoration,6,3,3
Schok,tichondrius,288,shaman,restoration,6,3,3
Drwaters,lightnings-blade,288,shaman,restoration,6,3,3
Solliexo,area-52,288,shaman,restoration,6,3,3
Jupider,nathrezim,288,shaman,restoration,6,3,3
Fwap,bleeding-hollow,288,shaman,restoration,6,3,3
Xxamba,tichondrius,288,shaman,restoration,6,3,3
Meerlim,malygos,288,shaman,restoration,6,3,3
Voron,kiljaeden,288,shaman,restoration,6,3,3
Soloqstayer,tichondrius,288,shaman,restoration,6,3,3
Rakkasham,blackrock,288,shaman,restoration,6,3,3
Cowboydans,malganis,288,shaman,restoration,6,3,3
Stormshadowx,proudmoore,288,shaman,restoration,6,3,3
Puntress,barthilas,288,shaman,restoration,6,3,3
Kanntok,quelthalas,288,shaman,restoration,6,3,3
Eleresto,tichondrius,288,shaman,restoration,6,3,3
Phinoi,tichondrius,288,shaman,restoration,6,3,3
Totemtots,illidan,288,shaman,restoration,6,3,3
Legendmatic,illidan,288,shaman,restoration,6,3,3
Electriqt,barthilas,288,shaman,restoration,6,3,3
Súrge,illidan,288,shaman,restoration,6,3,3
Megadabs,malganis,288,shaman,restoration,6,3,3
Cannonshot,tichondrius,288,shaman,restoration,6,3,3
Baldbozo,stormrage,288,shaman,restoration,6,3,3
Zoltide,sargeras,288,shaman,restoration,6,3,3
Chocothicc,bleeding-hollow,288,shaman,restoration,6,3,3
Rollînçoàl,malganis,288,shaman,restoration,6,3,3
Youngie,dathremar,288,shaman,restoration,6,3,3
Sreve,malganis,288,shaman,restoration,6,3,3
Shoota,tichondrius,288,shaman,restoration,6,3,3
Hungy,wyrmrest-accord,288,shaman,restoration,6,3,3
Skrubbles,bleeding-hollow,288,shaman,restoration,6,3,3
Jubie,proudmoore,288,shaman,restoration,6,3,3
Nûkes,area-52,288,shaman,restoration,6,3,3
Naughtylol,malganis,288,shaman,restoration,6,3,3
Pressyocds,darkspear,288,shaman,restoration,6,3,3
Gunx,darkspear,288,shaman,restoration,6,3,3
Taproots,ursin,288,shaman,restoration,6,3,3
Laucian,malganis,288,shaman,restoration,6,3,3
Daggonet,sargeras,288,shaman,restoration,6,3,3
Epitafor,illidan,288,shaman,restoration,6,3,3
Tonymax,malganis,288,shaman,restoration,6,3,3
Shearx,illidan,288,shaman,restoration,6,3,3
Justdeadman,tichondrius,288,shaman,restoration,6,3,3
Danyax,malganis,288,shaman,restoration,6,3,3
Bigbadpercy,frostmourne,288,shaman,restoration,6,3,3
Ryzak,dunemaul,288,shaman,restoration,6,3,3
Tekoqt,tichondrius,288,shaman,restoration,6,3,3
Gucciblunts,sargeras,288,shaman,restoration,6,3,3
Mítchconnor,tichondrius,288,shaman,restoration,6,3,3
Nüt,wyrmrest-accord,288,shaman,restoration,6,3,3
Headcrackx,sargeras,288,shaman,restoration,6,3,3
Jontrabolta,kelthuzad,288,shaman,restoration,9,4,5
Shangdide,tichondrius,288,shaman,restoration,10,4,6
Squidazzle,tichondrius,288,shaman,restoration,8,3,5
Ðrunkentotem,tichondrius,288,shaman,restoration,11,4,7
Rebelutioni,lothar,288,shaman,restoration,11,3,8
Oomme,area-52,288,shaman,restoration,12,3,9
Mochomò,ragnaros,288,shaman,restoration,12,3,9
Strawberryz,sargeras,288,shaman,restoration,12,3,9
Chaüncy,tichondrius,288,shaman,restoration,12,3,9
Emaric,sargeras,288,shaman,restoration,12,3,9
Meatyball,tichondrius,288,shaman,restoration,12,3,9
Malenhncemnt,illidan,288,shaman,restoration,12,3,9
Calliope,burning-legion,288,shaman,restoration,12,3,9
Shockathot,stormrage,288,shaman,restoration,12,3,9
Showkinho,azralon,288,shaman,restoration,12,3,9
Trysts,wyrmrest-accord,288,shaman,restoration,12,3,9
Karratquake,sargeras,288,shaman,restoration,12,3,9
Zéwel,tichondrius,288,shaman,restoration,12,3,9
Makogo,earthen-ring,288,shaman,restoration,12,3,9
Cheefgrief,shadowsong,288,shaman,restoration,12,3,9
Equinsuochha,silvermoon,288,shaman,restoration,12,3,9
Bobthashaman,tichondrius,288,shaman,restoration,12,3,9
Øten,area-52,288,shaman,restoration,12,3,9
Moresbythicc,frostmourne,288,shaman,restoration,12,3,9
Jumpc,ragnaros,288,shaman,restoration,12,3,9
Mondaymood,illidan,288,shaman,restoration,12,3,9
Thrallzballz,firetree,288,shaman,restoration,12,3,9
Stornbreiker,thrall,288,shaman,restoration,12,3,9
Scion,thaurissan,288,shaman,restoration,12,3,9
Chocobomb,burning-blade,288,shaman,restoration,12,3,9
Sliccricc,doomhammer,288,shaman,restoration,12,3,9
Sooweecide,tichondrius,288,shaman,restoration,12,3,9
Shamonalisa,altar-of-storms,288,shaman,restoration,12,3,9
Shamle,azuremyst,288,shaman,restoration,12,3,9
Babehmakr,lightnings-blade,288,shaman,restoration,12,3,9
Bovinefever,kiljaeden,288,shaman,restoration,12,3,9
Oghugin,sargeras,288,shaman,restoration,14,3,11
Adosistoxic,zuljin,288,shaman,restoration,14,3,11
Trøuble,deathwing,288,shaman,restoration,18,3,15
Boodaa,stormscale,288,shaman,restoration,18,3,15
Trovac,azralon,287,shaman,restoration,6,3,3
Altryn,shuhalo,287,shaman,restoration,6,3,3
Thean,wyrmrest-accord,287,shaman,restoration,6,3,3
Criticalthry,garrosh,287,shaman,restoration,12,3,9
Heatexchange,burning-blade,287,shaman,restoration,12,3,9
Lïet,quelthalas,287,shaman,restoration,12,3,9
Alagorn,icecrown,287,shaman,restoration,12,3,9
Grimnur,bleeding-hollow,287,shaman,restoration,12,3,9
Nottoshammy,dalaran,287,shaman,restoration,12,3,9
Kumquat,draka,287,shaman,restoration,18,3,15
Riverrun,shattered-halls,287,shaman,restoration,24,3,21
Hawpch,area-52,287,shaman,restoration,25,3,22
Garurt,daggerspine,286,shaman,restoration,12,6,6
Ranek,shuhalo,286,shaman,restoration,6,3,3
Kider,drakkari,286,shaman,restoration,6,3,3
Lupog,illidan,281,shaman,restoration,14,6,8
Tarlonygg,malganis,281,shaman,restoration,15,6,9
Eloquent,emerald-dream,273,shaman,restoration,19,6,13
Hilung,lightnings-blade,255,shaman,restoration,11,3,8
Lickerman,stormreaver,239,shaman,restoration,5,3,2
Shåmwiches,tichondrius,234,shaman,restoration,8,4,4
Båndø,tichondrius,234,shaman,restoration,9,4,5
Rohzie,illidan,234,shaman,restoration,17,6,11
Succies,emerald-dream,234,shaman,restoration,16,4,12
Bigripnow,sargeras,234,shaman,restoration,20,4,16
Tokelahoma,stormrage,234,shaman,restoration,22,4,18
Bigbone,laughing-skull,192,shaman,restoration,9,3,6
Keldara,aerie-peak,192,shaman,restoration,6,2,4
Lolcàt,tichondrius,192,shaman,restoration,6,2,4
Ebytotem,frostmourne,192,shaman,restoration,6,2,4
Healyourself,sargeras,192,shaman,restoration,6,2,4
Lewse,tichondrius,192,shaman,restoration,6,2,4
Nxboy,proudmoore,192,shaman,restoration,6,2,4
Lakeshow,tichondrius,192,shaman,restoration,6,2,4
Firesurge,sargeras,192,shaman,restoration,6,2,4
Jurafxdqt,malganis,192,shaman,restoration,6,2,4
Totemabuser,frostmourne,192,shaman,restoration,6,2,4
Snapertun,tichondrius,192,shaman,restoration,6,2,4
Plutoshaker,tichondrius,192,shaman,restoration,6,2,4
Gwenstifani,sargeras,192,shaman,restoration,6,2,4
Cawlin,stormrage,192,shaman,restoration,6,2,4
Eye,kelthuzad,192,shaman,restoration,6,2,4
Timbosteve,thrall,192,shaman,restoration,6,2,4
Toketime,thrall,192,shaman,restoration,6,2,4
Shamsky,tichondrius,192,shaman,restoration,6,2,4
Gravybakes,bleeding-hollow,192,shaman,restoration,6,2,4
Ioki,spirestone,192,shaman,restoration,6,2,4
Alexxspurge,ragnaros,192,shaman,restoration,6,2,4
Mangeegee,malganis,192,shaman,restoration,6,2,4
Busi,bleeding-hollow,192,shaman,restoration,6,2,4
Thefurrybox,tichondrius,192,shaman,restoration,6,2,4
Raymonis,kelthuzad,192,shaman,restoration,6,2,4
Nbax,tichondrius,192,shaman,restoration,6,2,4
Cvoa,bonechewer,192,shaman,restoration,6,2,4
Hughwang,kelthuzad,192,shaman,restoration,6,2,4
Konga,korialstrasz,192,shaman,restoration,6,2,4
Cpkzlol,tichondrius,192,shaman,restoration,6,2,4
Mjxholland,aegwynn,192,shaman,restoration,6,2,4
Karine,boulderfist,192,shaman,restoration,6,2,4
Halfzugzug,sargeras,192,shaman,restoration,6,2,4
Ginju,madoran,192,shaman,restoration,6,2,4
Rockøh,tichondrius,192,shaman,restoration,6,2,4
Miptide,saurfang,192,shaman,restoration,6,2,4
Gorrasha,gorgonnash,192,shaman,restoration,6,2,4
Mauiiei,sargeras,192,shaman,restoration,6,2,4
Zhangyider,illidan,192,shaman,restoration,6,2,4
Raxxom,tichondrius,192,shaman,restoration,6,2,4
Zugzugpurge,thrall,192,shaman,restoration,6,2,4
Hellfiresham,kiljaeden,192,shaman,restoration,6,2,4
Splewtsham,thrall,192,shaman,restoration,6,2,4
Nosai,tichondrius,192,shaman,restoration,6,2,4
Blackaxe,wyrmrest-accord,192,shaman,restoration,6,2,4
Thunderbleem,hyjal,192,shaman,restoration,6,2,4
Shinydiglett,area-52,192,shaman,restoration,6,2,4
Duality,shattered-halls,192,shaman,restoration,6,2,4
Yâmz,area-52,192,shaman,restoration,6,2,4
Oaken,spirestone,192,shaman,restoration,6,2,4
Chainandrain,frostmourne,192,shaman,restoration,6,2,4
Playdohz,frostmourne,192,shaman,restoration,6,2,4
Shamwoww,icecrown,192,shaman,restoration,6,2,4
Pandl,frostmourne,192,shaman,restoration,6,2,4
Fanatix,moon-guard,192,shaman,restoration,6,2,4
Notviscent,illidan,192,shaman,restoration,6,2,4
Thundertusks,norgannon,192,shaman,restoration,6,2,4
Gluestick,shadowmoon,192,shaman,restoration,6,2,4
Nazgore,jubeithos,192,shaman,restoration,6,2,4
Kumboi,frostmourne,192,shaman,restoration,6,2,4
Dylangs,frostmourne,192,shaman,restoration,6,2,4
Magwølfe,area-52,192,shaman,restoration,6,2,4
Shikane,hyjal,192,shaman,restoration,6,2,4
Twistër,illidan,192,shaman,restoration,6,2,4
Sid,frostmourne,192,shaman,restoration,6,2,4
Monkeysauce,tichondrius,192,shaman,restoration,6,2,4
Boohoo,dethecus,192,shaman,restoration,6,2,4
Relâx,icecrown,192,shaman,restoration,6,2,4
Sheems,shadowmoon,192,shaman,restoration,6,2,4
Kyrels,barthilas,192,shaman,restoration,6,2,4
Chungxs,illidan,192,shaman,restoration,6,2,4
Hottesthands,barthilas,192,shaman,restoration,6,2,4
Guabanva,wyrmrest-accord,192,shaman,restoration,6,2,4
Karnnages,cenarion-circle,192,shaman,restoration,6,2,4
Googurt,barthilas,192,shaman,restoration,6,2,4
Khidea,barthilas,192,shaman,restoration,6,2,4
Shamántics,illidan,192,shaman,restoration,6,2,4
Ghostrida,blackrock,192,shaman,restoration,6,2,4
Ezeya,area-52,192,shaman,restoration,6,2,4
Dabrat,lightnings-blade,192,shaman,restoration,6,2,4
Griph,shattered-hand,192,shaman,restoration,6,2,4
Suspend,gorgonnash,192,shaman,restoration,9,2,7
Sharish,mannoroth,192,shaman,restoration,12,2,10
Raisongreen,tichondrius,192,shaman,restoration,12,2,10
Aoiiro,dentarg,192,shaman,restoration,12,2,10
Kitanoo,kiljaeden,192,shaman,restoration,12,2,10
Birdizdawerd,shuhalo,192,shaman,restoration,12,2,10
Skingreen,nemesis,192,shaman,restoration,12,2,10
Rhaksh,sargeras,192,shaman,restoration,12,2,10
Saithô,quelthalas,192,shaman,restoration,12,2,10
Ara,zuljin,192,shaman,restoration,12,2,10
Dogchit,tichondrius,192,shaman,restoration,12,2,10
Awool,lightbringer,192,shaman,restoration,12,2,10
Soomer,frostmourne,192,shaman,restoration,12,2,10
Elva,malganis,192,shaman,restoration,12,2,10
Lomínark,stormrage,192,shaman,restoration,12,2,10
Pitaevergree,emerald-dream,192,shaman,restoration,12,2,10
Rueem,area-52,192,shaman,restoration,12,2,10
Wasiri,illidan,192,shaman,restoration,12,2,10
Paveron,stormrage,192,shaman,restoration,12,2,10
Danila,blackrock,192,shaman,restoration,12,2,10
Bizzy,black-dragonflight,192,shaman,restoration,12,2,10
Actios,stormrage,192,shaman,restoration,12,2,10
Wolpfh,area-52,192,shaman,restoration,12,2,10
Totemlyhot,frostmourne,192,shaman,restoration,12,2,10
Monchsham,illidan,192,shaman,restoration,13,2,11
Schmutz,emerald-dream,192,shaman,restoration,18,2,16
Bootsix,area-52,192,shaman,restoration,18,2,16
Kicksave,illidan,192,shaman,restoration,18,2,16
Doctermoo,daggerspine,192,shaman,restoration,28,3,25
Roogys,emerald-dream,192,shaman,restoration,22,2,20
Pwrhouse,ravenholdt,191,shaman,restoration,6,2,4
Malsturm,stormrage,191,shaman,restoration,6,2,4
Machalo,sargeras,191,shaman,restoration,6,2,4
Thudthudzap,darkspear,191,shaman,restoration,6,2,4
Fóurelements,malganis,191,shaman,restoration,6,2,4
Jammylol,frostmourne,180,shaman,restoration,21,6,15
Ambevsulfr,tichondrius,175,shaman,restoration,11,2,9
Restomilk,tichondrius,159,shaman,restoration,5,2,3
Nolij,sargeras,159,shaman,restoration,5,2,3
Beeto,sargeras,144,shaman,restoration,3,3,0
Ttvozzyxy,tichondrius,144,shaman,restoration,8,4,4
Stormsanta,emerald-dream,138,shaman,restoration,8,3,5
Bigdaddyion,thrall,138,shaman,restoration,9,3,6
Waterfaller,tichondrius,138,shaman,restoration,9,3,6
Hatemønger,medivh,138,shaman,restoration,17,3,14
Bigbøss,stormrage,138,shaman,restoration,20,3,17
Hexshamy,azralon,128,shaman,restoration,4,2,2
Lyv,stormscale,126,shaman,restoration,25,7,18
Aricer,proudmoore,112,shaman,restoration,13,2,11
Jbahr,hyjal,96,shaman,restoration,3,2,1
Downerr,malganis,96,shaman,restoration,3,2,1
Shamtoots,aerie-peak,96,shaman,restoration,9,2,7
Swartzqt,tichondrius,96,shaman,restoration,6,1,5
Restorates,tichondrius,96,shaman,restoration,6,1,5
Drgiggleheim,tichondrius,96,shaman,restoration,6,1,5
Shamoover,kelthuzad,96,shaman,restoration,6,1,5
Butteredcorn,zuljin,96,shaman,restoration,6,1,5
Daku,tichondrius,96,shaman,restoration,6,1,5
Guildhealer,darkspear,96,shaman,restoration,6,1,5
Dodey,malganis,96,shaman,restoration,6,1,5
Tofuji,barthilas,96,shaman,restoration,6,1,5
Groundfaults,bleeding-hollow,96,shaman,restoration,6,1,5
Hadèes,zuljin,96,shaman,restoration,6,1,5
Shotaro,galakrond,96,shaman,restoration,6,1,5
Blmqt,stormrage,96,shaman,restoration,6,1,5
Wannabecdeww,kelthuzad,96,shaman,restoration,6,1,5
Restoz,thrall,96,shaman,restoration,6,1,5
Ashborn,archimonde,96,shaman,restoration,6,1,5
Lennylemons,stormrage,96,shaman,restoration,6,1,5
Yaola,kiljaeden,96,shaman,restoration,6,1,5
Shambita,azralon,96,shaman,restoration,6,1,5
Statikrage,eonar,96,shaman,restoration,6,1,5
Ogeez,area-52,96,shaman,restoration,6,1,5
Frostshear,maiev,96,shaman,restoration,6,1,5
Movemaker,shattered-hand,96,shaman,restoration,6,1,5
Sharmalama,illidan,96,shaman,restoration,6,1,5
Ddolsx,tichondrius,96,shaman,restoration,6,1,5
Shamyuna,dalaran,96,shaman,restoration,6,1,5
Goblintrap,area-52,96,shaman,restoration,6,1,5
Restonomnom,the-underbog,96,shaman,restoration,6,1,5
Eleshamanz,tichondrius,96,shaman,restoration,6,1,5
Twizzhurp,bleeding-hollow,96,shaman,restoration,6,1,5
Cyberheler,quelthalas,96,shaman,restoration,6,1,5
Finnaburstt,tichondrius,96,shaman,restoration,6,1,5
Shapaman,tichondrius,96,shaman,restoration,6,1,5
Dasckisham,area-52,96,shaman,restoration,6,1,5
Thenewsherek,maelstrom,96,shaman,restoration,6,1,5
Stickshaman,sargeras,96,shaman,restoration,6,1,5
Alfrond,bleeding-hollow,96,shaman,restoration,6,1,5
Nøtørious,thrall,96,shaman,restoration,6,1,5
Drzeuss,illidan,96,shaman,restoration,6,1,5
Daiablo,barthilas,96,shaman,restoration,6,1,5
Sleepysham,anubarak,96,shaman,restoration,6,1,5
Average,bonechewer,96,shaman,restoration,6,1,5
Shamouranth,barthilas,96,shaman,restoration,6,1,5
Moetotemz,tichondrius,96,shaman,restoration,6,1,5
Erii,undermine,96,shaman,restoration,6,1,5
Teambk,illidan,96,shaman,restoration,6,1,5
Pdk,sargeras,96,shaman,restoration,6,1,5
Ocshaman,hyjal,96,shaman,restoration,6,1,5
Ashamanist,barthilas,96,shaman,restoration,6,1,5
Conflïcted,emerald-dream,96,shaman,restoration,6,1,5
Célty,moon-guard,96,shaman,restoration,6,1,5
Yggd,zuljin,96,shaman,restoration,6,1,5
Meramin,illidan,96,shaman,restoration,6,1,5
Totempixie,barthilas,96,shaman,restoration,6,1,5
Baloneyfiveo,kiljaeden,96,shaman,restoration,6,1,5
Sshhammann,tichondrius,96,shaman,restoration,6,1,5
Crassian,illidan,96,shaman,restoration,6,1,5
Teathin,ragnaros,96,shaman,restoration,6,1,5
Gadzêd,kelthuzad,96,shaman,restoration,6,1,5
Mufflër,the-venture-co,96,shaman,restoration,6,1,5
Asanako,illidan,96,shaman,restoration,6,1,5
Blazinowls,illidan,96,shaman,restoration,6,1,5
Vulpyr,ragnaros,96,shaman,restoration,6,1,5
Delzen,lightninghoof,96,shaman,restoration,6,1,5
Ampyx,tichondrius,96,shaman,restoration,6,1,5
Meattoilet,tichondrius,96,shaman,restoration,6,1,5
Zorg,area-52,96,shaman,restoration,6,1,5
Winebag,tichondrius,96,shaman,restoration,6,1,5
Kwaztotem,area-52,96,shaman,restoration,6,1,5
Milkyduds,area-52,96,shaman,restoration,6,1,5
Churdoodle,area-52,96,shaman,restoration,6,1,5
Galiffa,area-52,96,shaman,restoration,6,1,5
Toyletpaper,mugthol,96,shaman,restoration,6,1,5
Finark,tichondrius,96,shaman,restoration,7,1,6
Calicø,durotan,96,shaman,restoration,7,1,6
Jips,illidan,96,shaman,restoration,11,1,10
Slacken,kiljaeden,96,shaman,restoration,12,1,11
Njolmir,khazgoroth,96,shaman,restoration,12,1,11
Peternorse,tichondrius,96,shaman,restoration,12,1,11
Lór,onyxia,96,shaman,restoration,12,1,11
Forzeus,zuluhed,96,shaman,restoration,12,1,11
Hexpert,firetree,96,shaman,restoration,12,1,11
Tinytiddies,chogall,96,shaman,restoration,12,1,11
Meatlog,dalaran,96,shaman,restoration,12,1,11
Latishas,alleria,96,shaman,restoration,18,1,17
Okdopey,area-52,95,shaman,restoration,6,1,5
Varnol,emerald-dream,79,shaman,restoration,5,1,4
Vashidda,stormrage,79,shaman,restoration,5,1,4
Dirtyshammy,mugthol,79,shaman,restoration,11,1,10
Totèm,tichondrius,64,shaman,restoration,4,1,3
Annöying,ysera,42,shaman,restoration,6,2,4
Applicable,tichondrius,42,shaman,restoration,9,2,7
Strånge,ysera,42,shaman,restoration,10,2,8
Beatcoin,tichondrius,16,shaman,restoration,1,1,0
Kraftfullx,azralon,16,shaman,restoration,7,1,6
Bronzer,tichondrius,2346,shaman,elemental,81,57,24
Ttvozzyxy,tichondrius,2325,shaman,elemental,151,93,58
Selenna,tichondrius,2305,shaman,elemental,150,90,60
Orçhid,tichondrius,2296,shaman,elemental,132,87,45
Bøøgaa,proudmoore,2287,shaman,elemental,149,84,65
Beyoncé,lethon,2235,shaman,elemental,86,49,37
Ranjeesh,frostmourne,2220,shaman,elemental,192,109,83
Meatbeaterx,aggramar,2220,shaman,elemental,147,77,70
Glochaswon,illidan,2191,shaman,elemental,90,56,34
Khazger,area-52,2186,shaman,elemental,143,81,62
Itzgucci,illidan,2185,shaman,elemental,86,49,37
Oblessy,tichondrius,2179,shaman,elemental,78,46,32
Lardaz,darkspear,2172,shaman,elemental,66,40,26
Thegloc,illidan,2168,shaman,elemental,59,36,23
Jimmysporty,malganis,2168,shaman,elemental,90,47,43
Suqmacok,barthilas,2159,shaman,elemental,90,62,28
Mercs,frostmourne,2159,shaman,elemental,86,50,36
Bøulderfist,tichondrius,2157,shaman,elemental,72,44,28
Crøwgød,tichondrius,2156,shaman,elemental,109,65,44
Jazuul,zuljin,2139,shaman,elemental,90,46,44
Jgmbs,dalaran,2134,shaman,elemental,106,64,42
Axelsteel,illidan,2132,shaman,elemental,66,45,21
Hitzz,malganis,2127,shaman,elemental,78,49,29
Elefusion,sargeras,2127,shaman,elemental,66,40,26
Strongele,illidan,2120,shaman,elemental,75,43,32
Jeasham,malganis,2114,shaman,elemental,143,75,68
Billycool,tichondrius,2112,shaman,elemental,66,42,24
Benanderson,tichondrius,2111,shaman,elemental,110,61,49
Zoeytur,sargeras,2107,shaman,elemental,84,45,39
Shiggenbasta,tichondrius,2107,shaman,elemental,119,63,56
Hexecute,tichondrius,2106,shaman,elemental,84,42,42
Bronzers,tichondrius,2105,shaman,elemental,60,36,24
Hollowbaby,tichondrius,2101,shaman,elemental,73,48,25
Luhz,tichondrius,2084,shaman,elemental,215,105,110
Nanosec,tichondrius,2079,shaman,elemental,94,50,44
Missedkick,tichondrius,2050,shaman,elemental,175,103,72
Shockjob,frostmourne,2040,shaman,elemental,60,31,29
Tisaa,tichondrius,2025,shaman,elemental,66,32,34
Dxxlol,tichondrius,2013,shaman,elemental,102,59,43
Meatbeaterx,bleeding-hollow,2009,shaman,elemental,72,36,36
Manofsand,drenden,2006,shaman,elemental,219,114,105
Emppege,tichondrius,1998,shaman,elemental,163,81,82
Iavalash,bleeding-hollow,1995,shaman,elemental,210,103,107
Trenzix,sargeras,1989,shaman,elemental,196,100,96
Reckfulq,proudmoore,1986,shaman,elemental,137,84,53
Kimkar,bleeding-hollow,1982,shaman,elemental,90,48,42
Yejinok,tichondrius,1982,shaman,elemental,126,66,60
Zipzsham,maiev,1979,shaman,elemental,69,50,19
Orksham,tichondrius,1973,shaman,elemental,78,38,40
Blmqt,stormrage,1972,shaman,elemental,156,92,64
Mazadu,malganis,1967,shaman,elemental,47,27,20
Joedna,tichondrius,1962,shaman,elemental,118,61,57
Ãmg,tichondrius,1960,shaman,elemental,76,50,26
Chunchünmaru,area-52,1957,shaman,elemental,71,40,31
Boomsele,tichondrius,1952,shaman,elemental,61,42,19
Bakenquake,tichondrius,1947,shaman,elemental,92,48,44
Bujii,frostmourne,1928,shaman,elemental,257,128,129
Foudre,malganis,1925,shaman,elemental,42,27,15
Depression,baelgun,1921,shaman,elemental,84,51,33
Safeword,nesingwary,1919,shaman,elemental,74,42,32
Matikz,boulderfist,1919,shaman,elemental,153,85,68
Johnsju,sargeras,1918,shaman,elemental,129,66,63
Starmaker,malganis,1916,shaman,elemental,76,36,40
Planetwaves,malganis,1915,shaman,elemental,54,27,27
Kaandel,azralon,1914,shaman,elemental,233,112,121
Tenyks,tichondrius,1913,shaman,elemental,117,67,50
Geodude,executus,1909,shaman,elemental,53,33,20
Dipilga,proudmoore,1908,shaman,elemental,46,35,11
Hazzathxy,tichondrius,1908,shaman,elemental,53,30,23
Trnzx,sargeras,1905,shaman,elemental,66,41,25
Scaman,tichondrius,1903,shaman,elemental,36,23,13
Sasageyo,tichondrius,1903,shaman,elemental,99,55,44
Makazar,tichondrius,1901,shaman,elemental,42,26,16
Zzarit,tichondrius,1899,shaman,elemental,54,28,26
Ultron,deathwing,1890,shaman,elemental,143,74,69
Zò,zuljin,1890,shaman,elemental,66,32,34
Molbeato,uldum,1888,shaman,elemental,102,51,51
Hedeadxs,illidan,1882,shaman,elemental,60,30,30
Powerdown,blackrock,1878,shaman,elemental,65,32,33
Tremordrfear,lightbringer,1877,shaman,elemental,30,20,10
Sleepysham,kelthuzad,1877,shaman,elemental,132,70,62
Shockay,tichondrius,1877,shaman,elemental,80,42,38
Tyar,area-52,1876,shaman,elemental,45,31,14
Àspect,aegwynn,1875,shaman,elemental,36,20,16
Zynt,illidan,1870,shaman,elemental,36,23,13
Cùìó,barthilas,1868,shaman,elemental,54,25,29
Jalgago,tichondrius,1865,shaman,elemental,47,20,27
Molerat,illidan,1864,shaman,elemental,164,78,86
Fàlç,stormrage,1863,shaman,elemental,54,32,22
Uglytotem,tichondrius,1863,shaman,elemental,59,32,27
Illchayqt,frostmourne,1861,shaman,elemental,65,35,30
Groundme,malganis,1861,shaman,elemental,47,25,22
Gangmembr,illidan,1857,shaman,elemental,42,25,17
Jøey,nesingwary,1854,shaman,elemental,36,23,13
Apyôn,tichondrius,1853,shaman,elemental,54,30,24
Chemjenn,korgath,1850,shaman,elemental,102,46,56
Dampenedxx,bleeding-hollow,1848,shaman,elemental,151,85,66
Juicébox,tichondrius,1848,shaman,elemental,92,49,43
Sshaman,tichondrius,1846,shaman,elemental,82,40,42
Snookìe,sargeras,1846,shaman,elemental,88,41,47
Hecstacy,dalaran,1842,shaman,elemental,66,42,24
Eboy,thrall,1842,shaman,elemental,70,35,35
Utilitytotem,moon-guard,1838,shaman,elemental,154,83,71
Saphlare,tichondrius,1836,shaman,elemental,36,22,14
Rahtal,malganis,1834,shaman,elemental,48,25,23
Guybeingdude,sargeras,1832,shaman,elemental,36,24,12
Nayro,bleeding-hollow,1828,shaman,elemental,48,32,16
Gaymakaí,sargeras,1828,shaman,elemental,48,27,21
Shøckys,tichondrius,1822,shaman,elemental,138,63,75
Handzum,blades-edge,1821,shaman,elemental,78,43,35
Humorlava,tichondrius,1820,shaman,elemental,30,19,11
Magtark,frostwolf,1820,shaman,elemental,61,38,23
Carondes,proudmoore,1820,shaman,elemental,69,38,31
Shôcky,tichondrius,1819,shaman,elemental,54,33,21
Hotdogwaterx,tichondrius,1817,shaman,elemental,62,42,20
Damadar,zuljin,1817,shaman,elemental,142,75,67
Ktshammy,frostmourne,1816,shaman,elemental,44,30,14
Meatyball,tichondrius,1816,shaman,elemental,65,42,23
Baddaboom,sargeras,1816,shaman,elemental,97,54,43
Smiteums,sargeras,1813,shaman,elemental,42,24,18
Wangyinanmin,tichondrius,1812,shaman,elemental,30,19,11
Funuser,hellscream,1810,shaman,elemental,158,84,74
Whameradetu,suramar,1809,shaman,elemental,80,38,42
Dràgoon,thrall,1807,shaman,elemental,30,19,11
Coffinpls,illidan,1806,shaman,elemental,54,33,21
Lasso,shattered-hand,1806,shaman,elemental,54,30,24
Hexxás,bloodscalp,1806,shaman,elemental,92,48,44
Swigadee,tichondrius,1806,shaman,elemental,84,39,45
Bismarks,frostmourne,1805,shaman,elemental,66,38,28
Zuescannon,kelthuzad,1805,shaman,elemental,59,32,27
Drazziqt,malganis,1803,shaman,elemental,45,27,18
Skkarz,malganis,1803,shaman,elemental,170,92,78
Nonomori,frostmourne,1802,shaman,elemental,48,30,18
Torchic,drakkari,1801,shaman,elemental,60,31,29
Monkeysham,dathremar,1800,shaman,elemental,48,30,18
Elementàlius,quelthalas,1800,shaman,elemental,80,46,34
Mackq,tichondrius,1800,shaman,elemental,103,54,49
Osev,stormrage,1795,shaman,elemental,48,26,22
Cepheí,bleeding-hollow,1792,shaman,elemental,83,41,42
Triknolov,dalaran,1791,shaman,elemental,83,46,37
Ñîmåbè,tichondrius,1787,shaman,elemental,36,21,15
Ralae,zuljin,1782,shaman,elemental,29,19,10
Zapmavz,area-52,1781,shaman,elemental,113,58,55
Donkeyteeth,bleeding-hollow,1779,shaman,elemental,97,54,43
Earthclap,tichondrius,1779,shaman,elemental,79,38,41
Ieeguen,tichondrius,1778,shaman,elemental,48,22,26
Vixeen,kelthuzad,1772,shaman,elemental,48,24,24
Zqsyyds,illidan,1770,shaman,elemental,35,19,16
Deathblasts,zuljin,1770,shaman,elemental,48,22,26
Møp,spirestone,1766,shaman,elemental,66,39,27
Swiatek,ragnaros,1764,shaman,elemental,76,42,34
Nybrax,moknathal,1762,shaman,elemental,31,20,11
Bikáchu,tichondrius,1757,shaman,elemental,36,22,14
Thunderfaker,tichondrius,1755,shaman,elemental,48,24,24
Brezel,azralon,1740,shaman,elemental,42,27,15
Vkzz,sargeras,1740,shaman,elemental,91,38,53
Scrymax,area-52,1733,shaman,elemental,72,39,33
Hexistential,tichondrius,1731,shaman,elemental,34,26,8
Thündermoose,tichondrius,1731,shaman,elemental,72,38,34
Taranís,sargeras,1730,shaman,elemental,54,25,29
Caninius,sargeras,1726,shaman,elemental,60,31,29
Windfurygød,tichondrius,1724,shaman,elemental,60,44,16
Däbü,tichondrius,1724,shaman,elemental,30,18,12
Beibeihangh,tichondrius,1720,shaman,elemental,36,21,15
Emaric,sargeras,1717,shaman,elemental,48,27,21
ßævis,magtheridon,1715,shaman,elemental,60,37,23
Funnysa,tichondrius,1714,shaman,elemental,24,18,6
Liquidmagma,deathwing,1711,shaman,elemental,100,50,50
Pubechin,jubeithos,1711,shaman,elemental,42,21,21
Scherzer,frostwolf,1711,shaman,elemental,108,48,60
Ayumihamasai,tichondrius,1710,shaman,elemental,60,33,27
Ryanxo,azjolnerub,1709,shaman,elemental,35,21,14
Miroen,tichondrius,1708,shaman,elemental,36,18,18
Thaelia,azgalor,1707,shaman,elemental,46,27,19
Gravygumdrop,tichondrius,1707,shaman,elemental,110,56,54
Letronix,azralon,1707,shaman,elemental,77,39,38
Ggoong,tichondrius,1705,shaman,elemental,60,38,22
Flüke,tichondrius,1704,shaman,elemental,60,34,26
Minigible,tichondrius,1704,shaman,elemental,62,25,37
Notahappyone,area-52,1703,shaman,elemental,48,34,14
Thuntard,bleeding-hollow,1701,shaman,elemental,36,18,18
Kustys,tichondrius,1699,shaman,elemental,36,18,18
Dyxlol,tichondrius,1696,shaman,elemental,62,27,35
Trïggerr,blackrock,1695,shaman,elemental,30,18,12
Mytotemisbig,lothar,1694,shaman,elemental,59,38,21
Notbpage,burning-blade,1694,shaman,elemental,102,51,51
Hüsky,dalaran,1694,shaman,elemental,65,31,34
Tupacshocker,zuljin,1692,shaman,elemental,30,18,12
Exceedër,ragnaros,1686,shaman,elemental,36,18,18
Krumpits,barthilas,1685,shaman,elemental,45,26,19
Shockyshock,emerald-dream,1683,shaman,elemental,46,29,17
Caserguy,sargeras,1683,shaman,elemental,58,24,34
Ryukims,tichondrius,1682,shaman,elemental,76,41,35
Enkix,drakkari,1681,shaman,elemental,42,23,19
Sonire,tichondrius,1680,shaman,elemental,233,114,119
Hadèes,zuljin,1679,shaman,elemental,216,112,104
Gorjun,stormrage,1679,shaman,elemental,81,38,43
Loxshox,gnomeregan,1678,shaman,elemental,466,238,228
Ptee,tichondrius,1677,shaman,elemental,45,23,22
Zugzugdogg,destromath,1674,shaman,elemental,42,23,19
Zeroclue,area-52,1673,shaman,elemental,40,22,18
Buffele,tichondrius,1672,shaman,elemental,42,18,24
Jerkdaddy,aggramar,1668,shaman,elemental,30,19,11
Cyhren,illidan,1667,shaman,elemental,78,45,33
Deckìn,proudmoore,1663,shaman,elemental,160,85,75
Buju,bleeding-hollow,1662,shaman,elemental,152,84,68
Kigoros,bleeding-hollow,1662,shaman,elemental,101,53,48
Shockisha,sisters-of-elune,1662,shaman,elemental,70,32,38
Dewoverload,garithos,1657,shaman,elemental,33,23,10
Kawj,eonar,1652,shaman,elemental,36,21,15
Soyboyxxo,barthilas,1652,shaman,elemental,151,73,78
Walabi,tichondrius,1649,shaman,elemental,50,22,28
Zeylhe,proudmoore,1647,shaman,elemental,54,26,28
Squealer,sargeras,1644,shaman,elemental,98,50,48
Smoketide,stormrage,1644,shaman,elemental,47,21,26
Xodeus,frostmourne,1642,shaman,elemental,42,21,21
Shlmmyjimmy,tichondrius,1642,shaman,elemental,90,33,57
Streetmeat,crushridge,1640,shaman,elemental,125,64,61
Shambergler,tichondrius,1639,shaman,elemental,30,20,10
Faygodream,illidan,1638,shaman,elemental,256,138,118
Linkmyballs,tichondrius,1637,shaman,elemental,32,28,4
Hengler,emerald-dream,1637,shaman,elemental,65,33,32
Waterground,tichondrius,1636,shaman,elemental,43,24,19
Soo,kiljaeden,1636,shaman,elemental,102,49,53
Dilonsham,area-52,1635,shaman,elemental,52,32,20
Imense,sargeras,1634,shaman,elemental,77,44,33
Xxchamana,ragnaros,1633,shaman,elemental,36,23,13
Sweatshock,frostmourne,1633,shaman,elemental,224,122,102
Semasham,khazgoroth,1631,shaman,elemental,49,25,24
Pikapo,tichondrius,1630,shaman,elemental,54,34,20
Bubbert,illidan,1630,shaman,elemental,72,31,41
Óompaloompa,frostmourne,1628,shaman,elemental,52,32,20
Totemsmacker,quelthalas,1628,shaman,elemental,84,46,38
Tulol,tichondrius,1628,shaman,elemental,150,73,77
Stormsage,jubeithos,1627,shaman,elemental,54,31,23
Fiftybeers,frostmourne,1627,shaman,elemental,35,19,16
Lff,stormrage,1626,shaman,elemental,24,17,7
Hexlexic,stormrage,1625,shaman,elemental,57,34,23
Shaymîn,malganis,1624,shaman,elemental,38,21,17
Àspec,aegwynn,1623,shaman,elemental,30,17,13
Chandye,proudmoore,1620,shaman,elemental,48,22,26
Mugumbo,frostmourne,1619,shaman,elemental,73,41,32
Fruityrudyy,area-52,1618,shaman,elemental,30,22,8
Oldcregg,emerald-dream,1618,shaman,elemental,24,17,7
Eimear,kelthuzad,1618,shaman,elemental,33,20,13
Imnumberl,sargeras,1618,shaman,elemental,118,71,47
Conjury,tichondrius,1618,shaman,elemental,48,22,26
Indika,stormrage,1617,shaman,elemental,36,23,13
Popsoot,area-52,1617,shaman,elemental,36,17,19
Duality,shattered-halls,1615,shaman,elemental,59,38,21
Chajaa,ragnaros,1615,shaman,elemental,171,86,85
Meatballpie,frostmourne,1614,shaman,elemental,54,33,21
Gambezee,kelthuzad,1614,shaman,elemental,42,20,22
Catdontcare,tichondrius,1613,shaman,elemental,30,17,13
Friedmans,illidan,1613,shaman,elemental,209,110,99
Onnyx,proudmoore,1612,shaman,elemental,30,19,11
Electriik,kiljaeden,1611,shaman,elemental,72,41,31
Gangstà,stormrage,1611,shaman,elemental,66,30,36
Shamans,zuljin,1610,shaman,elemental,48,34,14
Targhal,tichondrius,1610,shaman,elemental,67,41,26
Tuntar,ragnaros,1610,shaman,elemental,192,105,87
Uglymugshock,tichondrius,1610,shaman,elemental,90,46,44
Orkuss,illidan,1609,shaman,elemental,29,19,10
Billydreams,drakkari,1609,shaman,elemental,165,78,87
Xakaeri,hyjal,1607,shaman,elemental,59,32,27
Setò,quelthalas,1607,shaman,elemental,66,35,31
Uglymuger,tichondrius,1606,shaman,elemental,146,68,78
Roxxiggom,aggramar,1605,shaman,elemental,24,19,5
Pacapinchhit,azgalor,1604,shaman,elemental,63,38,25
Jaimenohex,illidan,1603,shaman,elemental,36,19,17
Nutty,dentarg,1602,shaman,elemental,42,24,18
Everspell,lightnings-blade,1602,shaman,elemental,72,33,39
Novajersey,azralon,1601,shaman,elemental,68,36,32
Ssjgreen,illidan,1601,shaman,elemental,66,33,33
Opaltsing,tichondrius,1601,shaman,elemental,39,19,20
Tidedown,dark-iron,1600,shaman,elemental,36,25,11
Feetfungus,area-52,1600,shaman,elemental,90,41,49
Cornivore,malganis,1599,shaman,elemental,42,22,20
Mulak,frostmourne,1597,shaman,elemental,127,62,65
Datbigthing,frostmourne,1596,shaman,elemental,60,24,36
Igotu,tichondrius,1595,shaman,elemental,30,17,13
Üchihamadarâ,tichondrius,1595,shaman,elemental,151,81,70
Rahkarg,korgath,1592,shaman,elemental,42,20,22
Kymo,tichondrius,1591,shaman,elemental,30,17,13
Honeybean,tichondrius,1591,shaman,elemental,96,50,46
Lottogodx,area-52,1590,shaman,elemental,66,37,29
Darizzler,bleeding-hollow,1589,shaman,elemental,102,61,41
Hurìon,coilfang,1589,shaman,elemental,62,35,27
Tawambji,kiljaeden,1587,shaman,elemental,48,22,26
Zelthakaru,emerald-dream,1587,shaman,elemental,42,18,24
Moodizzle,tichondrius,1586,shaman,elemental,96,51,45
Jamieslays,korgath,1586,shaman,elemental,113,59,54
Zap,wyrmrest-accord,1583,shaman,elemental,84,43,41
Grimmson,emerald-dream,1578,shaman,elemental,48,20,28
Taxd,sargeras,1576,shaman,elemental,52,24,28
Talonga,moon-guard,1575,shaman,elemental,66,31,35
Motorrad,azralon,1572,shaman,elemental,58,31,27
Drogues,tichondrius,1568,shaman,elemental,71,39,32
Rodbert,sargeras,1568,shaman,elemental,41,20,21
Bycrax,ragnaros,1564,shaman,elemental,100,53,47
Muffïn,moon-guard,1561,shaman,elemental,42,24,18
Smartbunny,illidan,1559,shaman,elemental,66,29,37
Chillystotem,azjolnerub,1557,shaman,elemental,36,22,14
Snapstr,illidan,1556,shaman,elemental,71,30,41
Dwarfdude,gorefiend,1555,shaman,elemental,65,38,27
Dook,ghostlands,1555,shaman,elemental,35,17,18
Stitchis,black-dragonflight,1554,shaman,elemental,69,41,28
Shellshocka,korgath,1554,shaman,elemental,38,20,18
Simada,tichondrius,1554,shaman,elemental,36,17,19
Illbuyurmom,tichondrius,1553,shaman,elemental,104,48,56
Dtab,tichondrius,1552,shaman,elemental,36,18,18
Volcanoboxer,tichondrius,1552,shaman,elemental,90,44,46
Coldbeer,frostmourne,1551,shaman,elemental,35,18,17
Generators,area-52,1551,shaman,elemental,277,139,138
Cîmm,stormrage,1550,shaman,elemental,40,22,18
Topax,vashj,1548,shaman,elemental,41,23,18
Huskër,tichondrius,1546,shaman,elemental,106,61,45
Doodleburger,dathremar,1545,shaman,elemental,50,41,9
Illmental,kelthuzad,1543,shaman,elemental,127,61,66
Afw,darkspear,1542,shaman,elemental,100,56,44
Creativemind,ragnaros,1538,shaman,elemental,86,42,44
Busterbrounz,queldorei,1537,shaman,elemental,66,42,24
Borheals,tichondrius,1537,shaman,elemental,44,21,23
Zappynips,frostmourne,1536,shaman,elemental,51,30,21
Hexzy,moon-guard,1536,shaman,elemental,91,41,50
Ratson,ragnaros,1535,shaman,elemental,36,19,17
Robot,illidan,1534,shaman,elemental,30,16,14
Kakaaroto,nemesis,1531,shaman,elemental,93,53,40
Lovesthegear,blackrock,1529,shaman,elemental,30,16,14
Xpire,ragnaros,1528,shaman,elemental,30,16,14
Badandbooshi,stormreaver,1528,shaman,elemental,66,31,35
Harrypotqueu,zuljin,1527,shaman,elemental,30,16,14
Doxshaman,tichondrius,1525,shaman,elemental,117,65,52
Smeagles,ragnaros,1523,shaman,elemental,30,16,14
Mzzar,tichondrius,1523,shaman,elemental,30,16,14
Tunegrote,ragnaros,1523,shaman,elemental,66,35,31
Daddykooll,tichondrius,1521,shaman,elemental,78,40,38
Draghul,frostwolf,1520,shaman,elemental,43,24,19
Sheman,galakrond,1520,shaman,elemental,58,29,29
Yasmiel,zuljin,1517,shaman,elemental,60,27,33
Cacahuates,suramar,1516,shaman,elemental,96,55,41
Soulrak,tichondrius,1516,shaman,elemental,141,69,72
Clapton,darkspear,1515,shaman,elemental,47,21,26
Univearth,emerald-dream,1509,shaman,elemental,90,45,45
Gerrkiing,amanthul,1508,shaman,elemental,35,22,13
Soartotes,sargeras,1507,shaman,elemental,40,22,18
Evilraven,tichondrius,1506,shaman,elemental,183,91,92
Seventeen,blackrock,1506,shaman,elemental,36,16,20
Malosa,hyjal,1505,shaman,elemental,107,50,57
Cgq,tichondrius,1504,shaman,elemental,114,61,53
Olboy,thrall,1497,shaman,elemental,60,34,26
Mindfields,barthilas,1495,shaman,elemental,50,28,22
Pipelord,destromath,1494,shaman,elemental,30,18,12
Legthul,tichondrius,1493,shaman,elemental,36,17,19
Keldinraz,stormrage,1492,shaman,elemental,48,22,26
Sheriffbj,emerald-dream,1489,shaman,elemental,65,29,36
Georgejr,thunderlord,1488,shaman,elemental,126,70,56
Krimzs,executus,1488,shaman,elemental,93,40,53
Cowish,illidan,1487,shaman,elemental,42,23,19
Vulkuro,quelthalas,1485,shaman,elemental,48,27,21
Innvious,sargeras,1483,shaman,elemental,60,28,32
Gloi,ragnaros,1481,shaman,elemental,31,19,12
Rss,barthilas,1481,shaman,elemental,77,39,38
Bobbymooshay,area-52,1478,shaman,elemental,77,35,42
Dadadabang,frostmourne,1478,shaman,elemental,40,18,22
Tulnak,kelthuzad,1475,shaman,elemental,159,79,80
Døutrina,azralon,1472,shaman,elemental,127,58,69
Defrout,kelthuzad,1469,shaman,elemental,68,32,36
Venekk,shattered-hand,1467,shaman,elemental,35,23,12
Arukz,tichondrius,1467,shaman,elemental,36,16,20
Skyten,quelthalas,1465,shaman,elemental,36,17,19
Gahaa,tichondrius,1464,shaman,elemental,23,16,7
Morluné,tichondrius,1464,shaman,elemental,60,31,29
Washedupty,illidan,1460,shaman,elemental,118,56,62
Cavolt,stormrage,1459,shaman,elemental,47,24,23
Makocc,tichondrius,1458,shaman,elemental,97,48,49
Genericheat,tichondrius,1454,shaman,elemental,75,38,37
Rinnobunen,wyrmrest-accord,1452,shaman,elemental,100,50,50
Engara,frostmane,1451,shaman,elemental,35,17,18
Thundermatt,aegwynn,1451,shaman,elemental,87,39,48
Fwwrs,illidan,1450,shaman,elemental,26,16,10
Tørosentado,quelthalas,1450,shaman,elemental,94,47,47
Nøir,drakkari,1450,shaman,elemental,66,30,36
Rythia,elune,1446,shaman,elemental,58,30,28
Isekai,alterac-mountains,1445,shaman,elemental,280,135,145
Syile,stormrage,1445,shaman,elemental,80,37,43
Climhazard,senjin,1441,shaman,elemental,71,31,40
Hydroponicz,sargeras,1438,shaman,elemental,24,15,9
Totey,nemesis,1437,shaman,elemental,18,15,3
Giversham,bleeding-hollow,1437,shaman,elemental,24,15,9
Kumer,tichondrius,1436,shaman,elemental,34,19,15
Dodona,sargeras,1436,shaman,elemental,96,45,51
Biberom,kelthuzad,1434,shaman,elemental,57,32,25
Wfb,sargeras,1432,shaman,elemental,56,34,22
Stèpbro,sargeras,1432,shaman,elemental,36,18,18
Latoques,quelthalas,1431,shaman,elemental,24,15,9
Pipesable,ragnaros,1430,shaman,elemental,24,15,9
Bustinbooty,kiljaeden,1429,shaman,elemental,42,22,20
Ratedpvp,thrall,1427,shaman,elemental,18,15,3
Saraguthix,dalaran,1427,shaman,elemental,60,27,33
Kkangsiki,tichondrius,1427,shaman,elemental,36,16,20
Joehogan,stormrage,1426,shaman,elemental,90,51,39
Vktr,drakkari,1426,shaman,elemental,76,38,38
Drazzella,arthas,1422,shaman,elemental,47,21,26
Bramah,bonechewer,1420,shaman,elemental,36,16,20
Scryerman,area-52,1418,shaman,elemental,30,16,14
Dalianyen,bladefist,1417,shaman,elemental,30,15,15
Srbski,emerald-dream,1416,shaman,elemental,32,17,15
Pepîllo,ragnaros,1416,shaman,elemental,150,63,87
Blacklm,tichondrius,1413,shaman,elemental,24,15,9
Plotious,antonidas,1413,shaman,elemental,36,19,17
Gumballin,sargeras,1412,shaman,elemental,85,41,44
Korlog,tichondrius,1409,shaman,elemental,18,15,3
Barokoshama,area-52,1409,shaman,elemental,24,15,9
Shampainn,demon-soul,1407,shaman,elemental,72,38,34
Conductivity,frostmourne,1406,shaman,elemental,48,24,24
Hurky,sargeras,1405,shaman,elemental,164,85,79
Ectomee,tichondrius,1403,shaman,elemental,30,16,14
Bushdeedit,stormrage,1400,shaman,elemental,59,23,36
Zugzugthug,moon-guard,1395,shaman,elemental,131,69,62
Sweetbabyraé,bleeding-hollow,1391,shaman,elemental,66,42,24
Vuhdu,barthilas,1391,shaman,elemental,24,15,9
Hansolorz,tichondrius,1389,shaman,elemental,67,32,35
Liloggie,illidan,1385,shaman,elemental,23,15,8
Redlava,turalyon,1384,shaman,elemental,31,19,12
Everyst,darkspear,1383,shaman,elemental,65,34,31
Minusshaman,dalaran,1382,shaman,elemental,150,81,69
Bulljay,bleeding-hollow,1382,shaman,elemental,33,16,17
Dumpweed,stormscale,1382,shaman,elemental,58,28,30
Golozok,zuljin,1382,shaman,elemental,35,16,19
Ceedlamb,kelthuzad,1381,shaman,elemental,66,34,32
Yippeekiyay,zuluhed,1379,shaman,elemental,63,31,32
Maxchamo,ragnaros,1379,shaman,elemental,43,16,27
Synerggy,hakkar,1378,shaman,elemental,425,217,208
Richode,burning-legion,1376,shaman,elemental,30,17,13
Shuñk,frostmourne,1376,shaman,elemental,60,27,33
Tecnein,tichondrius,1374,shaman,elemental,36,15,21
Rolltìde,tichondrius,1372,shaman,elemental,153,85,68
Forgediniron,stormrage,1372,shaman,elemental,108,59,49
Luvstospooj,thaurissan,1372,shaman,elemental,73,34,39
Zechary,proudmoore,1372,shaman,elemental,48,19,29
Mittss,sargeras,1371,shaman,elemental,118,62,56
Ffaísca,azralon,1371,shaman,elemental,44,22,22
Ragnards,ragnaros,1369,shaman,elemental,91,43,48
Nuofu,illidan,1367,shaman,elemental,59,30,29
Gazamiseh,thunderhorn,1364,shaman,elemental,125,54,71
Ghorokk,azralon,1363,shaman,elemental,42,31,11
Telain,quelthalas,1360,shaman,elemental,84,42,42
Malrom,kelthuzad,1359,shaman,elemental,439,225,214
Baodan,azshara,1356,shaman,elemental,97,51,46
Frozensunn,illidan,1352,shaman,elemental,36,15,21
Chonkymilk,illidan,1351,shaman,elemental,68,29,39
Casualsham,illidan,1350,shaman,elemental,26,15,11
Stormsanta,emerald-dream,1349,shaman,elemental,35,15,20
Moartotems,kelthuzad,1347,shaman,elemental,30,18,12
Snewboii,malganis,1346,shaman,elemental,30,15,15
Zuldroth,frostmourne,1343,shaman,elemental,42,25,17
Spoonforkorc,thrall,1342,shaman,elemental,24,14,10
Jer,tichondrius,1342,shaman,elemental,24,14,10
Bagele,tichondrius,1342,shaman,elemental,30,14,16
Cptnmagma,bleeding-hollow,1341,shaman,elemental,146,75,71
Oontuk,illidan,1337,shaman,elemental,66,31,35
Laelyk,kiljaeden,1336,shaman,elemental,30,14,16
Madelements,tichondrius,1334,shaman,elemental,50,28,22
Alphamael,lightbringer,1333,shaman,elemental,65,38,27
Cocainbear,emerald-dream,1332,shaman,elemental,39,20,19
Lugak,ragnaros,1332,shaman,elemental,49,21,28
Thathurts,thrall,1331,shaman,elemental,24,14,10
Cowboy,executus,1331,shaman,elemental,30,14,16
Exoticz,barthilas,1330,shaman,elemental,53,19,34
Totem,burning-legion,1327,shaman,elemental,24,14,10
Totems,the-underbog,1327,shaman,elemental,24,14,10
Muruaic,dentarg,1327,shaman,elemental,24,14,10
Shocksrus,arthas,1326,shaman,elemental,30,14,16
Shadowowl,tanaris,1324,shaman,elemental,45,21,24
Buffaloweens,thrall,1324,shaman,elemental,30,14,16
Ekstasiel,azralon,1323,shaman,elemental,54,28,26
Hufflefluffs,kiljaeden,1323,shaman,elemental,56,29,27
Shocks,alleria,1318,shaman,elemental,30,14,16
Lenin,nathrezim,1316,shaman,elemental,62,24,38
Ôprawindfury,mugthol,1313,shaman,elemental,30,14,16
Endorovich,mannoroth,1309,shaman,elemental,30,14,16
Toho,ragnaros,1304,shaman,elemental,48,25,23
Drvoodoo,tichondrius,1303,shaman,elemental,47,22,25
Drzhong,frostmourne,1301,shaman,elemental,58,30,28
Ayahuaskah,illidan,1300,shaman,elemental,49,23,26
Pozcaster,tichondrius,1300,shaman,elemental,76,27,49
Thestromp,quelthalas,1297,shaman,elemental,23,14,9
Budgetseaan,stormrage,1296,shaman,elemental,69,40,29
Hueymagoo,firetree,1295,shaman,elemental,24,14,10
Shammany,stormrage,1295,shaman,elemental,54,28,26
Totempoke,frostmourne,1292,shaman,elemental,23,14,9
Totemtown,darkspear,1286,shaman,elemental,60,28,32
Vodord,arathor,1284,shaman,elemental,30,15,15
Porkfririe,kelthuzad,1284,shaman,elemental,58,21,37
Nírnez,ragnaros,1277,shaman,elemental,54,22,32
Øten,area-52,1275,shaman,elemental,48,31,17
Beerofdoom,proudmoore,1275,shaman,elemental,48,26,22
Seinnome,azralon,1270,shaman,elemental,43,18,25
Smithereen,area-52,1267,shaman,elemental,48,24,24
Rokogg,thrall,1267,shaman,elemental,29,14,15
Edenorion,ragnaros,1262,shaman,elemental,67,34,33
Jaapo,barthilas,1259,shaman,elemental,98,48,50
Sugirukifuja,stormrage,1258,shaman,elemental,23,16,7
Baltharzhard,saurfang,1257,shaman,elemental,36,16,20
Moacmathi,quelthalas,1253,shaman,elemental,60,27,33
Hëïmdall,stormrage,1251,shaman,elemental,35,19,16
Destroçadorx,azralon,1249,shaman,elemental,32,15,17
Okïòmó,proudmoore,1248,shaman,elemental,30,13,17
Siò,barthilas,1247,shaman,elemental,15,14,1
Ëìê,tichondrius,1247,shaman,elemental,36,13,23
Battleshammy,nagrand,1243,shaman,elemental,30,15,15
Maldini,tol-barad,1242,shaman,elemental,36,17,19
Clarix,quelthalas,1241,shaman,elemental,24,13,11
Marduul,azralon,1236,shaman,elemental,35,16,19
Boogielust,frostmourne,1234,shaman,elemental,24,13,11
Kanasya,quelthalas,1234,shaman,elemental,41,17,24
Sabtifa,proudmoore,1232,shaman,elemental,30,13,17
Akó,quelthalas,1230,shaman,elemental,48,20,28
Charabon,ragnaros,1228,shaman,elemental,24,13,11
Discokid,norgannon,1227,shaman,elemental,41,17,24
Shammpain,barthilas,1226,shaman,elemental,89,51,38
Chaposz,tichondrius,1221,shaman,elemental,30,13,17
Saulgudmon,area-52,1215,shaman,elemental,42,22,20
Bonevykin,area-52,1215,shaman,elemental,27,14,13
Rafiki,haomarush,1215,shaman,elemental,60,26,34
Mhaal,wyrmrest-accord,1213,shaman,elemental,106,42,64
Eze,tichondrius,1211,shaman,elemental,58,33,25
Yodahh,daggerspine,1211,shaman,elemental,45,24,21
Amonita,stonemaul,1210,shaman,elemental,18,13,5
Káládin,malganis,1209,shaman,elemental,36,17,19
Grezzkall,malganis,1207,shaman,elemental,39,19,20
Bazinguinha,azralon,1207,shaman,elemental,60,28,32
Premium,nagrand,1206,shaman,elemental,53,23,30
Omegaman,lightninghoof,1204,shaman,elemental,69,35,34
Shamanzinh,azralon,1204,shaman,elemental,42,20,22
Deggle,frostwolf,1201,shaman,elemental,30,14,16
Strugs,area-52,1201,shaman,elemental,59,25,34
Killeniis,tichondrius,1192,shaman,elemental,72,31,41
Araghok,ragnaros,1191,shaman,elemental,36,15,21
Duckmasick,tichondrius,1188,shaman,elemental,60,26,34
Teechainz,caelestrasz,1175,shaman,elemental,27,14,13
Lezzer,ragnaros,1167,shaman,elemental,102,45,57
Brickzilla,dalaran,1166,shaman,elemental,24,13,11
Zhokal,quelthalas,1166,shaman,elemental,125,65,60
Chanix,ragnaros,1164,shaman,elemental,29,15,14
Yasuriyamile,illidan,1164,shaman,elemental,162,74,88
Jaycobb,area-52,1159,shaman,elemental,30,13,17
Zugdabou,bonechewer,1155,shaman,elemental,66,30,36
Konndor,malganis,1155,shaman,elemental,60,24,36
Kebboz,frostmourne,1152,shaman,elemental,18,12,6
Pasto,bleeding-hollow,1152,shaman,elemental,18,12,6
Bovinebeauty,tichondrius,1152,shaman,elemental,18,12,6
Councilman,illidan,1152,shaman,elemental,24,12,12
Chenjiawei,tichondrius,1152,shaman,elemental,24,12,12
Lilbabyapy,sargeras,1152,shaman,elemental,24,12,12
Krupto,tichondrius,1151,shaman,elemental,24,12,12
Kang,terenas,1150,shaman,elemental,18,12,6
Chudeshock,ragnaros,1150,shaman,elemental,36,12,24
Arakimara,tichondrius,1149,shaman,elemental,18,12,6
Poonqtx,frostmourne,1149,shaman,elemental,18,12,6
Ndndurkadurk,malganis,1149,shaman,elemental,24,12,12
Frostshear,maiev,1149,shaman,elemental,29,14,15
Eluulne,silvermoon,1147,shaman,elemental,24,12,12
Blobberino,tichondrius,1147,shaman,elemental,30,12,18
Kilydily,destromath,1147,shaman,elemental,30,12,18
Shockerfist,thunderlord,1144,shaman,elemental,18,12,6
Enhancers,sargeras,1144,shaman,elemental,24,12,12
Beatryx,the-scryers,1140,shaman,elemental,24,12,12
Kowabounga,ragnaros,1140,shaman,elemental,24,12,12
Thunderblood,nerzhul,1138,shaman,elemental,24,12,12
Muggs,cairne,1137,shaman,elemental,18,12,6
Nuggitz,tichondrius,1136,shaman,elemental,51,30,21
Fearoshimä,drakthul,1133,shaman,elemental,24,12,12
Tribalmood,illidan,1130,shaman,elemental,36,14,22
Drmeangreen,tichondrius,1129,shaman,elemental,61,31,30
Jashar,spinebreaker,1127,shaman,elemental,24,13,11
Blacklust,tichondrius,1127,shaman,elemental,30,13,17
Shmoo,deathwing,1126,shaman,elemental,27,14,13
Luxenor,kelthuzad,1125,shaman,elemental,24,12,12
Madeleines,goldrinn,1124,shaman,elemental,24,14,10
Firecracker,warsong,1123,shaman,elemental,88,47,41
Johnwilke,area-52,1123,shaman,elemental,43,17,26
Bravederp,kelthuzad,1120,shaman,elemental,63,31,32
Cardanø,illidan,1120,shaman,elemental,47,14,33
Afgoox,tichondrius,1118,shaman,elemental,41,27,14
Meteorah,kelthuzad,1118,shaman,elemental,69,34,35
Skwiglz,tichondrius,1113,shaman,elemental,90,44,46
Phuamya,dalaran,1112,shaman,elemental,24,14,10
Karashamy,ragnaros,1107,shaman,elemental,85,40,45
Xoelement,borean-tundra,1103,shaman,elemental,54,25,29
Yunow,ragnaros,1096,shaman,elemental,48,20,28
Axelrose,ragnaros,1090,shaman,elemental,36,16,20
Nobosham,tichondrius,1090,shaman,elemental,27,12,15
Rollypolli,gnomeregan,1081,shaman,elemental,78,41,37
Catherìne,daggerspine,1077,shaman,elemental,27,15,12
Zerium,nemesis,1076,shaman,elemental,33,13,20
Coffee,mugthol,1073,shaman,elemental,48,19,29
Shamarock,stonemaul,1071,shaman,elemental,48,25,23
Shockazulu,vashj,1070,shaman,elemental,47,23,24
Sàuron,tichondrius,1066,shaman,elemental,25,12,13
Zro,ysera,1062,shaman,elemental,25,12,13
Afri,tichondrius,1056,shaman,elemental,16,12,4
Biggiechief,illidan,1056,shaman,elemental,18,11,7
Redpocket,zuluhed,1056,shaman,elemental,18,11,7
Palcyon,eonar,1056,shaman,elemental,18,11,7
Chazzwozza,area-52,1056,shaman,elemental,18,11,7
Szes,tichondrius,1056,shaman,elemental,18,11,7
Bestshamus,sargeras,1056,shaman,elemental,18,11,7
Glizzyjamon,sargeras,1056,shaman,elemental,18,11,7
Petrafk,illidan,1056,shaman,elemental,18,11,7
Highsteakss,tichondrius,1055,shaman,elemental,12,11,1
Shakron,dalaran,1055,shaman,elemental,18,11,7
Smooths,bloodscalp,1055,shaman,elemental,18,11,7
Bootietootie,bleeding-hollow,1055,shaman,elemental,18,11,7
Fanatix,moon-guard,1055,shaman,elemental,18,11,7
Shockalot,emerald-dream,1055,shaman,elemental,24,11,13
Jeffspicele,emerald-dream,1055,shaman,elemental,24,11,13
Ayetex,kelthuzad,1054,shaman,elemental,18,11,7
Lilmollet,tichondrius,1054,shaman,elemental,25,13,12
Traindablue,illidan,1054,shaman,elemental,24,11,13
Blastuh,kiljaeden,1053,shaman,elemental,18,11,7
Justballs,stormscale,1052,shaman,elemental,54,29,25
Madmartiggen,scilla,1051,shaman,elemental,21,12,9
Taeilendar,ragnaros,1050,shaman,elemental,24,11,13
Nazz,cenarion-circle,1048,shaman,elemental,18,11,7
Metlar,sargeras,1048,shaman,elemental,24,11,13
Vashidda,stormrage,1048,shaman,elemental,24,11,13
Mabite,frostmourne,1047,shaman,elemental,18,11,7
Tideborn,azralon,1046,shaman,elemental,54,25,29
Minzysm,illidan,1045,shaman,elemental,24,11,13
Enflexi,lightbringer,1044,shaman,elemental,24,11,13
Zappz,thunderlord,1041,shaman,elemental,66,36,30
Grandwolf,ragnaros,1040,shaman,elemental,24,11,13
Hodonsin,tichondrius,1039,shaman,elemental,23,11,12
Darkrock,echo-isles,1033,shaman,elemental,24,12,12
Sumnah,sargeras,1028,shaman,elemental,54,27,27
Omnath,zuluhed,1027,shaman,elemental,41,20,21
Olani,nesingwary,1022,shaman,elemental,38,12,26
Treesntotemz,darkspear,1020,shaman,elemental,18,11,7
Bigrider,nemesis,1009,shaman,elemental,48,19,29
Mîkâ,area-52,1007,shaman,elemental,24,11,13
Wälee,sargeras,1004,shaman,elemental,77,37,40
Shambix,illidan,1002,shaman,elemental,19,12,7
Bronan,laughing-skull,1002,shaman,elemental,96,42,54
Sanlu,tichondrius,991,shaman,elemental,71,34,37
Dizzytotem,dalaran,991,shaman,elemental,24,11,13
Cheweydadawg,shandris,990,shaman,elemental,23,11,12
Shàmpow,darkspear,988,shaman,elemental,23,11,12
Piloncho,ragnaros,983,shaman,elemental,60,24,36
Mistayl,bleeding-hollow,968,shaman,elemental,30,12,18
Asanako,illidan,967,shaman,elemental,88,38,50
Smrtdeath,zuljin,960,shaman,elemental,12,10,2
Graveshocks,illidan,960,shaman,elemental,12,10,2
Ðøææøð,stormrage,960,shaman,elemental,18,10,8
Folus,azjolnerub,960,shaman,elemental,18,10,8
Lividelemnts,area-52,960,shaman,elemental,18,10,8
Bigdaddyion,thrall,960,shaman,elemental,18,10,8
Withinfinity,stormrage,960,shaman,elemental,24,10,14
Hexoffend,zuljin,959,shaman,elemental,18,10,8
Tidalstorm,thrall,959,shaman,elemental,18,10,8
Zajashuna,malganis,959,shaman,elemental,18,10,8
Kodyaj,illidan,959,shaman,elemental,18,10,8
Aishel,area-52,959,shaman,elemental,18,10,8
Ehhmacros,doomhammer,959,shaman,elemental,24,10,14
Aingry,darkspear,958,shaman,elemental,18,10,8
Totemzie,illidan,958,shaman,elemental,18,10,8
Stormcop,kelthuzad,958,shaman,elemental,30,10,20
Snogger,stormrage,957,shaman,elemental,12,10,2
Beazel,moon-guard,957,shaman,elemental,30,10,20
Shockshammy,kiljaeden,956,shaman,elemental,18,10,8
Bigway,area-52,956,shaman,elemental,30,10,20
Chamuko,kelthuzad,955,shaman,elemental,18,10,8
Avni,silver-hand,954,shaman,elemental,18,10,8
Saanrixa,jubeithos,954,shaman,elemental,121,49,72
Tinkd,stormrage,953,shaman,elemental,18,10,8
Izreborn,tichondrius,953,shaman,elemental,24,10,14
Tuksha,alleria,951,shaman,elemental,30,10,20
Karvr,tichondrius,950,shaman,elemental,18,10,8
Bricx,dalaran,947,shaman,elemental,18,10,8
Elektrå,dalaran,947,shaman,elemental,24,10,14
Shamanic,dunemaul,947,shaman,elemental,89,33,56
Bröly,thunderhorn,946,shaman,elemental,30,10,20
Geladoo,gallywix,944,shaman,elemental,86,36,50
Statikrage,eonar,944,shaman,elemental,32,13,19
Galgamesh,emerald-dream,939,shaman,elemental,18,10,8
Mðna,zuluhed,935,shaman,elemental,52,24,28
Lavablaster,kelthuzad,934,shaman,elemental,32,19,13
Proignite,drakthul,934,shaman,elemental,35,17,18
Gorron,frostwolf,929,shaman,elemental,24,10,14
Dooman,area-52,927,shaman,elemental,30,10,20
Matria,tanaris,922,shaman,elemental,36,19,17
Sarahfe,wyrmrest-accord,910,shaman,elemental,17,10,7
Aragog,malygos,899,shaman,elemental,32,16,16
Notsock,zuljin,894,shaman,elemental,17,10,7
Threehandz,bleeding-hollow,886,shaman,elemental,55,20,35
Trilz,barthilas,880,shaman,elemental,19,10,9
Vitaminc,garona,864,shaman,elemental,12,9,3
Streamsnipe,sargeras,864,shaman,elemental,12,9,3
Notragii,kelthuzad,864,shaman,elemental,12,9,3
Bowlcutgodx,sargeras,864,shaman,elemental,12,9,3
Helga,hellscream,864,shaman,elemental,12,9,3
Shockbalboa,stormrage,864,shaman,elemental,12,9,3
Dîabeetus,moon-guard,864,shaman,elemental,12,9,3
Bojangz,illidan,864,shaman,elemental,12,9,3
Metallical,tichondrius,864,shaman,elemental,12,9,3
Koalatricks,shadow-council,864,shaman,elemental,12,9,3
Owtyobwol,area-52,864,shaman,elemental,18,9,9
Chainz,illidan,864,shaman,elemental,18,9,9
Doorti,area-52,864,shaman,elemental,18,9,9
Drewzie,anvilmar,864,shaman,elemental,18,9,9
Tampíco,ragnaros,864,shaman,elemental,24,9,15
Ðomzy,tichondrius,863,shaman,elemental,12,9,3
Dornmawhide,sargeras,863,shaman,elemental,12,9,3
Karagra,tichondrius,863,shaman,elemental,18,9,9
Hexellént,kiljaeden,863,shaman,elemental,18,9,9
Poseidon,kiljaeden,863,shaman,elemental,18,9,9
Blöw,tichondrius,863,shaman,elemental,18,9,9
Earthfirex,ragnaros,863,shaman,elemental,18,9,9
Darkcharles,illidan,863,shaman,elemental,18,9,9
Astrostorm,darkspear,863,shaman,elemental,18,9,9
Thaél,proudmoore,863,shaman,elemental,24,9,15
Lovebody,zuljin,863,shaman,elemental,24,9,15
Dehsaw,illidan,863,shaman,elemental,24,9,15
Dtrumpx,tichondrius,863,shaman,elemental,24,9,15
Elemastery,windrunner,862,shaman,elemental,12,9,3
Adutchcowboy,tichondrius,862,shaman,elemental,12,9,3
Tottemic,blackrock,862,shaman,elemental,18,9,9
Urb,moknathal,862,shaman,elemental,24,9,15
Cónò,tichondrius,861,shaman,elemental,18,9,9
Aleysha,dreadmaul,861,shaman,elemental,18,9,9
Phagocytosis,illidan,861,shaman,elemental,18,9,9
Jensenx,proudmoore,861,shaman,elemental,24,9,15
Kultirio,quelthalas,860,shaman,elemental,12,9,3
Grukall,galakrond,860,shaman,elemental,12,9,3
Galabanjø,malganis,860,shaman,elemental,24,9,15
Nomahuata,cenarion-circle,859,shaman,elemental,24,9,15
Bluetape,azshara,858,shaman,elemental,12,9,3
Velekar,moon-guard,858,shaman,elemental,24,9,15
Xantoor,area-52,857,shaman,elemental,18,9,9
Gorakh,illidan,856,shaman,elemental,18,9,9
Edalandd,zuljin,856,shaman,elemental,24,9,15
Dellnar,nagrand,847,shaman,elemental,18,9,9
Daiskei,nordrassil,838,shaman,elemental,18,9,9
Hbjj,illidan,816,shaman,elemental,15,9,6
Vegaslights,tichondrius,816,shaman,elemental,21,9,12
Insanelol,tichondrius,815,shaman,elemental,21,9,12
Yeoldkobb,kiljaeden,810,shaman,elemental,17,9,8
Thanwirn,ragnaros,809,shaman,elemental,24,9,15
Relâx,icecrown,779,shaman,elemental,19,9,10
Squidzy,tichondrius,768,shaman,elemental,12,8,4
Smoketide,malganis,768,shaman,elemental,12,8,4
Yurp,illidan,768,shaman,elemental,12,8,4
Bagovs,tichondrius,768,shaman,elemental,12,8,4
Xammaa,illidan,768,shaman,elemental,12,8,4
Artaiva,zuljin,768,shaman,elemental,12,8,4
Genesisz,tichondrius,768,shaman,elemental,12,8,4
Synkronaqt,tichondrius,768,shaman,elemental,12,8,4
Morabebi,tichondrius,768,shaman,elemental,12,8,4
Supbrø,zuluhed,768,shaman,elemental,12,8,4
Grandpatits,illidan,768,shaman,elemental,12,8,4
Cduck,zuljin,768,shaman,elemental,12,8,4
Meatballsx,tichondrius,768,shaman,elemental,12,8,4
Storminlorka,sargeras,768,shaman,elemental,18,8,10
Stayz,tichondrius,768,shaman,elemental,18,8,10
Groundfaults,bleeding-hollow,768,shaman,elemental,18,8,10
Caveseer,frostmourne,768,shaman,elemental,24,8,16
Blazintotems,arthas,767,shaman,elemental,12,8,4
Momothewolf,malganis,767,shaman,elemental,12,8,4
Uninfluenced,firetree,767,shaman,elemental,12,8,4
Flowerchild,proudmoore,767,shaman,elemental,12,8,4
Tierrox,tichondrius,767,shaman,elemental,12,8,4
Marcøvich,ragnaros,767,shaman,elemental,12,8,4
Thandius,arygos,767,shaman,elemental,12,8,4
Graymatterz,ysondre,767,shaman,elemental,12,8,4
Johntrabølta,zuljin,767,shaman,elemental,12,8,4
Dxycollapse,illidan,767,shaman,elemental,18,8,10
Fistwizard,sargeras,767,shaman,elemental,18,8,10
Mazdamundï,ragnaros,767,shaman,elemental,24,8,16
Volcanic,azuremyst,767,shaman,elemental,24,8,16
Fênrisulfer,area-52,766,shaman,elemental,18,8,10
Procdepartme,area-52,765,shaman,elemental,18,8,10
Cheddatotz,illidan,764,shaman,elemental,12,8,4
Pãníç,bladefist,764,shaman,elemental,18,8,10
Zappyshorty,sargeras,763,shaman,elemental,12,8,4
Neebon,jubeithos,763,shaman,elemental,12,8,4
Teekona,tichondrius,763,shaman,elemental,18,8,10
Shachone,zuljin,763,shaman,elemental,18,8,10
Stormterror,tichondrius,763,shaman,elemental,20,8,12
Shamofshame,garrosh,763,shaman,elemental,24,8,16
Brokahantas,misha,746,shaman,elemental,26,8,18
Aeromarius,ragnaros,733,shaman,elemental,13,10,3
Lowiqpleb,tichondrius,719,shaman,elemental,17,8,9
Aseew,drakkari,714,shaman,elemental,27,11,16
Downerr,malganis,712,shaman,elemental,17,10,7
Pileef,thrall,704,shaman,elemental,10,8,2
Zoumi,zuljin,704,shaman,elemental,22,8,14
Dmt,exodar,704,shaman,elemental,22,8,14
Makogo,earthen-ring,686,shaman,elemental,13,8,5
Thermopile,wildhammer,680,shaman,elemental,25,8,17
Sèèr,tichondrius,672,shaman,elemental,12,7,5
Plebshammy,bleeding-hollow,672,shaman,elemental,12,7,5
Cuban,kelthuzad,672,shaman,elemental,12,7,5
Varnol,emerald-dream,672,shaman,elemental,12,7,5
Farku,illidan,672,shaman,elemental,12,7,5
Merkal,illidan,672,shaman,elemental,12,7,5
Komana,frostmourne,672,shaman,elemental,12,7,5
Drmeatballmd,tichondrius,672,shaman,elemental,12,7,5
Smellyogre,area-52,672,shaman,elemental,12,7,5
Lagroupie,ragnaros,672,shaman,elemental,12,7,5
Willy,icecrown,672,shaman,elemental,12,7,5
Hanaruk,ragnaros,672,shaman,elemental,12,7,5
Toetum,hyjal,672,shaman,elemental,12,7,5
Thoraq,bleeding-hollow,672,shaman,elemental,12,7,5
Elemelons,stormrage,672,shaman,elemental,12,7,5
Mesdew,tichondrius,672,shaman,elemental,12,7,5
Linkzz,malganis,672,shaman,elemental,12,7,5
Tatespeech,barthilas,672,shaman,elemental,12,7,5
Pericazo,sargeras,672,shaman,elemental,12,7,5
Josiahsham,kelthuzad,672,shaman,elemental,13,7,6
Ftp,kelthuzad,672,shaman,elemental,15,8,7
Neotrad,proudmoore,672,shaman,elemental,18,7,11
Xinz,guldan,672,shaman,elemental,18,7,11
Alwaysbulkin,tichondrius,672,shaman,elemental,18,7,11
Eravas,thrall,672,shaman,elemental,18,7,11
Shamigo,tichondrius,672,shaman,elemental,18,7,11
Risker,tichondrius,672,shaman,elemental,18,7,11
Desdìnova,tortheldrin,672,shaman,elemental,18,7,11
Dansham,zuljin,672,shaman,elemental,24,7,17
Lilthrall,skullcrusher,671,shaman,elemental,12,7,5
Stormha,illidan,671,shaman,elemental,12,7,5
Trashpandaa,deathwing,671,shaman,elemental,12,7,5
Canute,bonechewer,671,shaman,elemental,12,7,5
Lenå,moon-guard,671,shaman,elemental,12,7,5
Hairyrichard,zuljin,671,shaman,elemental,12,7,5
Jacori,malganis,671,shaman,elemental,12,7,5
Oukami,area-52,671,shaman,elemental,12,7,5
Malito,ursin,671,shaman,elemental,18,7,11
Alariaa,sargeras,670,shaman,elemental,12,7,5
Parallels,blackrock,670,shaman,elemental,18,7,11
Neukims,nemesis,670,shaman,elemental,20,7,13
Beardslee,malganis,669,shaman,elemental,12,7,5
Grimlên,skullcrusher,669,shaman,elemental,18,7,11
Idiotstaff,dreadmaul,669,shaman,elemental,24,7,17
Slothycrit,emerald-dream,668,shaman,elemental,30,7,23
Saffoo,frostmourne,667,shaman,elemental,12,7,5
Dugomik,malganis,666,shaman,elemental,18,7,11
Shamadan,proudmoore,665,shaman,elemental,12,7,5
Warmak,hyjal,664,shaman,elemental,12,7,5
Dermbo,frostmourne,664,shaman,elemental,18,8,10
Jyster,area-52,664,shaman,elemental,24,7,17
Cheesewheelz,arthas,651,shaman,elemental,22,7,15
Aestheticsx,thrall,640,shaman,elemental,16,7,9
Megalithic,moon-guard,639,shaman,elemental,14,8,6
Hexytimexoqt,thrall,638,shaman,elemental,17,7,10
Koongram,area-52,623,shaman,elemental,11,7,4
Shizzänk,illidan,606,shaman,elemental,11,7,4
Oznog,bleeding-hollow,590,shaman,elemental,19,7,12
Boltadeez,tichondrius,576,shaman,elemental,6,6,0
Kasparøv,tichondrius,576,shaman,elemental,6,6,0
Zaedran,thrall,576,shaman,elemental,6,6,0
Pikapiko,tichondrius,576,shaman,elemental,6,6,0
Sxxr,moon-guard,576,shaman,elemental,6,6,0
Jimmyapple,illidan,576,shaman,elemental,10,7,3
Potf,illidan,576,shaman,elemental,12,6,6
Shaokhan,azjolnerub,576,shaman,elemental,12,6,6
Deeznuts,the-forgotten-coast,576,shaman,elemental,12,6,6
Jnzz,area-52,576,shaman,elemental,12,6,6
Smoketide,illidan,576,shaman,elemental,12,6,6
Riseon,illidan,576,shaman,elemental,12,6,6
Tairen,ragnaros,576,shaman,elemental,12,6,6
Mistysham,illidan,576,shaman,elemental,12,6,6
Spaceghost,illidan,576,shaman,elemental,12,6,6
Consolx,area-52,576,shaman,elemental,12,6,6
Getwetand,quelthalas,576,shaman,elemental,12,6,6
Jinukia,malganis,576,shaman,elemental,12,6,6
Orkshammy,illidan,576,shaman,elemental,12,6,6
Zunden,illidan,576,shaman,elemental,12,6,6
Zlateral,malganis,576,shaman,elemental,12,6,6
Deyodin,illidan,576,shaman,elemental,12,6,6
Littz,malganis,576,shaman,elemental,12,6,6
Fuseillar,illidan,576,shaman,elemental,12,6,6
Feuerbart,dalaran,576,shaman,elemental,12,6,6
Finark,tichondrius,576,shaman,elemental,12,6,6
Knowknown,tichondrius,576,shaman,elemental,12,6,6
Rubmytotêm,tichondrius,576,shaman,elemental,12,6,6
Undaunte,sargeras,576,shaman,elemental,12,6,6
Mcgraff,frostmourne,576,shaman,elemental,12,6,6
Doommjölnir,sargeras,576,shaman,elemental,12,6,6
Frosh,nazgrel,576,shaman,elemental,12,6,6
Datblueboi,dalaran,576,shaman,elemental,12,6,6
Ezevia,stormrage,576,shaman,elemental,12,6,6
Reppinsix,sargeras,576,shaman,elemental,12,6,6
Torosmile,tichondrius,576,shaman,elemental,18,6,12
Shamamas,area-52,576,shaman,elemental,18,6,12
Oxdrog,malganis,576,shaman,elemental,18,6,12
Cowtidetotem,thrall,576,shaman,elemental,18,6,12
Highvoltagex,frostmourne,576,shaman,elemental,18,6,12
Bitamin,frostmourne,576,shaman,elemental,18,6,12
Wonima,tichondrius,576,shaman,elemental,19,6,13
Hallion,frostmourne,576,shaman,elemental,24,6,18
Asuni,illidan,576,shaman,elemental,24,6,18
Skribblez,tichondrius,575,shaman,elemental,12,6,6
Thunderfuk,exodar,575,shaman,elemental,12,6,6
Fuma,nordrassil,575,shaman,elemental,12,6,6
Wrathantula,thrall,575,shaman,elemental,12,6,6
Moctezumma,area-52,575,shaman,elemental,12,6,6
Apocalypsehb,quelthalas,575,shaman,elemental,12,6,6
Shøckolate,whisperwind,575,shaman,elemental,12,6,6
Satup,ragnaros,575,shaman,elemental,12,6,6
Drewshammy,zuljin,575,shaman,elemental,12,6,6
Freesolo,barthilas,575,shaman,elemental,12,6,6
Nemei,zuljin,575,shaman,elemental,12,6,6
Grimitt,suramar,575,shaman,elemental,18,6,12
Ulamøgg,proudmoore,575,shaman,elemental,21,6,15
Chanintotem,shattered-halls,574,shaman,elemental,12,6,6
Nezzuk,quelthalas,573,shaman,elemental,12,6,6
Bcs,lightbringer,573,shaman,elemental,12,6,6
Svi,doomhammer,573,shaman,elemental,12,6,6
Thuggliife,frostmourne,573,shaman,elemental,18,6,12
Totempaul,frostmourne,570,shaman,elemental,18,6,12
Ryudark,stormrage,569,shaman,elemental,24,6,18
Asy,tichondrius,559,shaman,elemental,11,6,5
Esbet,echo-isles,555,shaman,elemental,23,6,17
Aitex,kelthuzad,543,shaman,elemental,15,7,8
Frequency,kiljaeden,542,shaman,elemental,23,6,17
Thanen,the-scryers,541,shaman,elemental,16,6,10
Devipersham,frostmourne,511,shaman,elemental,11,6,5
Shinydiglett,area-52,480,shaman,elemental,6,5,1
Unbreakable,illidan,480,shaman,elemental,6,5,1
Furiousnick,stormrage,480,shaman,elemental,6,5,1
Immashammyx,area-52,480,shaman,elemental,6,5,1
Azzula,tichondrius,480,shaman,elemental,6,5,1
Riptideafk,sargeras,480,shaman,elemental,6,5,1
Vulcansh,azralon,480,shaman,elemental,6,5,1
Shamxrob,sargeras,480,shaman,elemental,6,5,1
Love,tichondrius,480,shaman,elemental,6,5,1
Fenny,proudmoore,480,shaman,elemental,6,5,1
Axaxaxaxaxax,illidan,480,shaman,elemental,6,5,1
Kagdush,tichondrius,480,shaman,elemental,6,5,1
Sxr,moon-guard,480,shaman,elemental,6,5,1
Firedchips,tichondrius,480,shaman,elemental,17,8,9
Grêgg,area-52,480,shaman,elemental,12,5,7
Sgorr,illidan,480,shaman,elemental,12,5,7
Yssyyds,illidan,480,shaman,elemental,12,5,7
Baern,thrall,480,shaman,elemental,12,5,7
Shoxz,korgath,480,shaman,elemental,12,5,7
Flukz,nazjatar,480,shaman,elemental,12,5,7
Tipedc,sargeras,480,shaman,elemental,12,5,7
Drakhe,proudmoore,480,shaman,elemental,12,5,7
Junkygreens,proudmoore,480,shaman,elemental,12,5,7
Wobbleshock,tichondrius,480,shaman,elemental,12,5,7
Hexxercise,area-52,480,shaman,elemental,12,5,7
Kissmywalnut,frostmourne,480,shaman,elemental,12,5,7
Zeebouzy,illidan,480,shaman,elemental,12,5,7
Gjaj,tichondrius,480,shaman,elemental,12,5,7
Crooked,saurfang,480,shaman,elemental,12,5,7
Flamestrife,illidan,480,shaman,elemental,12,5,7
Oingo,destromath,480,shaman,elemental,12,5,7
Ferdi,kelthuzad,480,shaman,elemental,12,5,7
Jaedrick,chogall,480,shaman,elemental,12,5,7
Jènova,whisperwind,480,shaman,elemental,12,5,7
Chomolungma,azralon,480,shaman,elemental,12,5,7
Daerönn,azralon,480,shaman,elemental,12,5,7
Boodissy,tichondrius,480,shaman,elemental,12,5,7
Twistedteas,tichondrius,480,shaman,elemental,12,5,7
Slumpinator,tichondrius,480,shaman,elemental,12,5,7
Wempa,moon-guard,480,shaman,elemental,12,5,7
Trickytotems,stormrage,480,shaman,elemental,12,5,7
Shamberheard,kelthuzad,480,shaman,elemental,12,5,7
Scarshamxn,frostmourne,480,shaman,elemental,12,5,7
Shamyuna,dalaran,480,shaman,elemental,12,5,7
Delement,ragnaros,480,shaman,elemental,12,5,7
Athymus,dragonmaw,480,shaman,elemental,12,5,7
Fonsestrelly,emerald-dream,480,shaman,elemental,12,5,7
Mariarlee,proudmoore,480,shaman,elemental,12,5,7
Thadx,illidan,480,shaman,elemental,12,5,7
Zenan,stormreaver,480,shaman,elemental,12,5,7
Totemchucker,stormrage,480,shaman,elemental,15,6,9
Flamelink,tichondrius,480,shaman,elemental,20,6,14
Hazznokicks,bleeding-hollow,480,shaman,elemental,21,6,15
Birdizdawerd,shuhalo,480,shaman,elemental,18,5,13
Advìl,area-52,480,shaman,elemental,18,5,13
Dwârf,tichondrius,480,shaman,elemental,18,5,13
Arialial,hyjal,480,shaman,elemental,18,5,13
Lumpyshaman,tichondrius,480,shaman,elemental,18,5,13
Helapoon,area-52,480,shaman,elemental,18,5,13
Blakki,barthilas,480,shaman,elemental,18,5,13
Firesurge,sargeras,480,shaman,elemental,18,5,13
Zevelynne,wyrmrest-accord,480,shaman,elemental,24,5,19
Vjeze,frostmourne,480,shaman,elemental,24,5,19
Killdeaderer,barthilas,479,shaman,elemental,6,5,1
Shanão,nemesis,479,shaman,elemental,6,5,1
Virô,sargeras,479,shaman,elemental,6,5,1
Ðarkvolts,stormrage,479,shaman,elemental,12,5,7
Sparkyy,kelthuzad,479,shaman,elemental,12,5,7
Carrbide,malganis,479,shaman,elemental,12,5,7
Olthorson,kelthuzad,479,shaman,elemental,18,5,13
Doughboy,khadgar,478,shaman,elemental,14,6,8
Santee,frostmourne,478,shaman,elemental,12,5,7
Diokles,skywall,478,shaman,elemental,12,5,7
Talraviebor,stormrage,478,shaman,elemental,12,5,7
Tulwah,shadowmoon,447,shaman,elemental,11,6,5
Slogre,tichondrius,447,shaman,elemental,11,5,6
Bigbadbolt,malganis,431,shaman,elemental,11,5,6
Adesaa,illidan,426,shaman,elemental,22,6,16
Gunai,malganis,416,shaman,elemental,10,5,5
Kinjin,dragonmaw,415,shaman,elemental,14,5,9
Ripklanian,blood-furnace,400,shaman,elemental,13,5,8
Zelinsky,sargeras,384,shaman,elemental,6,4,2
Ryùko,proudmoore,384,shaman,elemental,6,4,2
Checkmâte,emerald-dream,384,shaman,elemental,6,4,2
Mniteshyaman,barthilas,384,shaman,elemental,6,4,2
Drcopafeel,stormrage,384,shaman,elemental,6,4,2
Seraøth,area-52,384,shaman,elemental,6,4,2
Dromus,dalvengyr,384,shaman,elemental,6,4,2
Terapatrik,area-52,384,shaman,elemental,6,4,2
Shammyqua,tichondrius,384,shaman,elemental,6,4,2
Elebro,emerald-dream,384,shaman,elemental,6,4,2
Âran,azralon,384,shaman,elemental,6,4,2
Møsh,emerald-dream,384,shaman,elemental,6,4,2
Nerfele,tichondrius,384,shaman,elemental,6,4,2
Munchies,madoran,384,shaman,elemental,6,4,2
Stormflow,dalaran,384,shaman,elemental,6,4,2
Clamson,tichondrius,384,shaman,elemental,6,4,2
Wolfgangz,illidan,384,shaman,elemental,6,4,2
Greensween,thrall,384,shaman,elemental,6,4,2
Weebdestroyr,illidan,384,shaman,elemental,6,4,2
Blueku,tichondrius,384,shaman,elemental,6,4,2
Riicc,stormrage,384,shaman,elemental,6,4,2
Boøsty,bleeding-hollow,384,shaman,elemental,6,4,2
Kranif,tichondrius,384,shaman,elemental,6,4,2
Paltalk,the-forgotten-coast,384,shaman,elemental,6,4,2
Trickyjf,dalaran,384,shaman,elemental,6,4,2
Fluupy,illidan,384,shaman,elemental,6,4,2
Sammila,tichondrius,384,shaman,elemental,6,4,2
Mistyshamy,sargeras,384,shaman,elemental,6,4,2
Zappithorus,stormrage,384,shaman,elemental,6,4,2
Simped,bleeding-hollow,384,shaman,elemental,6,4,2
Borgmash,chogall,384,shaman,elemental,6,4,2
Boogiefever,area-52,384,shaman,elemental,6,4,2
Smearedbeard,bleeding-hollow,384,shaman,elemental,6,4,2
Semnicktotem,area-52,384,shaman,elemental,6,4,2
Enil,kiljaeden,384,shaman,elemental,6,4,2
Hulan,tichondrius,384,shaman,elemental,6,4,2
Ryuubi,illidan,384,shaman,elemental,6,4,2
Mcßooger,tichondrius,384,shaman,elemental,6,4,2
Ginnagangus,mugthol,384,shaman,elemental,6,4,2
Lukora,stonemaul,384,shaman,elemental,6,4,2
Thorlottie,stormrage,384,shaman,elemental,6,4,2
Nyroh,zuljin,384,shaman,elemental,6,4,2
Dingfu,sargeras,384,shaman,elemental,6,4,2
Oscarmike,auchindoun,384,shaman,elemental,6,4,2
Synkrona,tichondrius,384,shaman,elemental,6,4,2
Ruugo,malganis,384,shaman,elemental,6,4,2
Ktom,runetotem,384,shaman,elemental,6,4,2
Malgician,proudmoore,384,shaman,elemental,6,4,2
Dragaru,illidan,384,shaman,elemental,6,4,2
Thunderbudx,malganis,384,shaman,elemental,6,4,2
Yshi,kelthuzad,384,shaman,elemental,6,4,2
Wodgodx,sargeras,384,shaman,elemental,6,4,2
Novoz,tichondrius,384,shaman,elemental,6,4,2
Zezlek,malganis,384,shaman,elemental,6,4,2
Meatballman,malganis,384,shaman,elemental,6,4,2
Dgshaman,tichondrius,384,shaman,elemental,6,4,2
Super,azshara,384,shaman,elemental,14,5,9
Gomaliquida,quelthalas,384,shaman,elemental,12,4,8
Lavasurge,area-52,384,shaman,elemental,12,4,8
Shrektar,cenarius,384,shaman,elemental,12,4,8
Nazgore,jubeithos,384,shaman,elemental,12,4,8
Benserkr,lightbringer,384,shaman,elemental,12,4,8
Sjostrom,proudmoore,384,shaman,elemental,12,4,8
Elryl,sargeras,384,shaman,elemental,12,4,8
Paltrok,tichondrius,384,shaman,elemental,12,4,8
Sharmut,bleeding-hollow,384,shaman,elemental,12,4,8
Sin,bleeding-hollow,384,shaman,elemental,12,4,8
Manitbaggins,earthen-ring,384,shaman,elemental,12,4,8
Feels,arthas,384,shaman,elemental,12,4,8
Fouroclock,drakthul,384,shaman,elemental,12,4,8
Rudoboy,ragnaros,384,shaman,elemental,12,4,8
Rosettee,stormrage,384,shaman,elemental,12,4,8
Belgrom,tichondrius,384,shaman,elemental,12,4,8
Duza,frostmourne,384,shaman,elemental,12,4,8
Jhivone,tichondrius,384,shaman,elemental,12,4,8
Kushnations,chogall,384,shaman,elemental,12,4,8
Anahvee,moon-guard,384,shaman,elemental,12,4,8
Natorr,dalaran,384,shaman,elemental,12,4,8
Zizö,barthilas,384,shaman,elemental,12,4,8
Oohkillemm,silvermoon,384,shaman,elemental,12,4,8
Fatherrtime,illidan,384,shaman,elemental,12,4,8
Aiggiggigne,sargeras,384,shaman,elemental,12,4,8
Naweiv,caelestrasz,384,shaman,elemental,12,4,8
Ayatsu,thrall,384,shaman,elemental,12,4,8
Yukishock,illidan,384,shaman,elemental,12,4,8
Cannonshot,tichondrius,384,shaman,elemental,13,4,9
Rickin,hyjal,384,shaman,elemental,18,4,14
Tdub,frostmourne,384,shaman,elemental,18,4,14
Bigstormz,fenris,384,shaman,elemental,18,4,14
Waller,duskwood,383,shaman,elemental,6,4,2
Cuallo,stormrage,383,shaman,elemental,6,4,2
Machalo,sargeras,383,shaman,elemental,12,4,8
Enroks,greymane,383,shaman,elemental,12,4,8
Stórmfuryz,tichondrius,382,shaman,elemental,12,4,8
Roxastir,shattered-halls,382,shaman,elemental,12,4,8
Potatopirate,burning-legion,381,shaman,elemental,18,4,14
Coffeeblacc,magtheridon,379,shaman,elemental,12,4,8
Babyblake,malganis,351,shaman,elemental,8,5,3
Branasou,emerald-dream,351,shaman,elemental,11,4,7
Shk,illidan,351,shaman,elemental,11,4,7
Råys,turalyon,350,shaman,elemental,11,4,7
Trashaman,garona,336,shaman,elemental,9,4,5
Stormfronts,kelthuzad,336,shaman,elemental,9,4,5
Nondracil,ragnaros,336,shaman,elemental,14,4,10
Taraneh,garrosh,325,shaman,elemental,15,5,10
Shmaybuh,malganis,320,shaman,elemental,10,4,6
Orochishaman,stormrage,319,shaman,elemental,5,4,1
Shamankie,tichondrius,319,shaman,elemental,5,4,1
Shup,chogall,319,shaman,elemental,5,4,1
Charr,nemesis,304,shaman,elemental,7,4,3
Tsunamibrew,moon-guard,302,shaman,elemental,9,4,5
Meatcannon,emerald-dream,288,shaman,elemental,6,3,3
Sylierria,frostmourne,288,shaman,elemental,6,3,3
Passion,sargeras,288,shaman,elemental,6,3,3
Groink,kiljaeden,288,shaman,elemental,6,3,3
Gankasaurrex,tichondrius,288,shaman,elemental,6,3,3
Floon,barthilas,288,shaman,elemental,6,3,3
Doop,kiljaeden,288,shaman,elemental,6,3,3
Sunkist,whisperwind,288,shaman,elemental,6,3,3
Roostershama,tichondrius,288,shaman,elemental,6,3,3
Awesomeus,barthilas,288,shaman,elemental,6,3,3
Vibration,akama,288,shaman,elemental,6,3,3
Applicable,tichondrius,288,shaman,elemental,6,3,3
Dontaey,frostmourne,288,shaman,elemental,6,3,3
Jaxlightning,nemesis,288,shaman,elemental,6,3,3
Trenhance,stormrage,288,shaman,elemental,6,3,3
Raikages,whisperwind,288,shaman,elemental,6,3,3
Iloverina,stormrage,288,shaman,elemental,6,3,3
Mozet,tichondrius,288,shaman,elemental,6,3,3
Gödöfbüdå,tichondrius,288,shaman,elemental,6,3,3
Ioki,spirestone,288,shaman,elemental,6,3,3
Jamsham,tichondrius,288,shaman,elemental,6,3,3
Ludasham,moon-guard,288,shaman,elemental,6,3,3
Wordssham,tichondrius,288,shaman,elemental,6,3,3
Axshaman,darkspear,288,shaman,elemental,6,3,3
Thelphor,nemesis,288,shaman,elemental,6,3,3
Spacemilk,stormrage,288,shaman,elemental,6,3,3
Vanëssão,stormrage,288,shaman,elemental,6,3,3
Cvoa,bonechewer,288,shaman,elemental,6,3,3
Bizle,jaedenar,288,shaman,elemental,6,3,3
Tahz,wyrmrest-accord,288,shaman,elemental,6,3,3
Curtrex,amanthul,288,shaman,elemental,6,3,3
Hedeadx,illidan,288,shaman,elemental,6,3,3
Hamrok,moon-guard,288,shaman,elemental,6,3,3
Wabiex,illidan,288,shaman,elemental,6,3,3
Woepost,tichondrius,288,shaman,elemental,6,3,3
Tokelahoma,stormrage,288,shaman,elemental,6,3,3
Frenchy,hyjal,288,shaman,elemental,6,3,3
Atokirina,drakkari,288,shaman,elemental,6,3,3
Dazu,drakkari,288,shaman,elemental,6,3,3
Shamanlordi,wyrmrest-accord,288,shaman,elemental,6,3,3
Fluffyhex,sargeras,288,shaman,elemental,6,3,3
Largerwang,sargeras,288,shaman,elemental,6,3,3
Shizamm,hyjal,288,shaman,elemental,6,3,3
Fattizer,sargeras,288,shaman,elemental,6,3,3
Corneador,ragnaros,288,shaman,elemental,6,3,3
Oxforcefairy,tichondrius,288,shaman,elemental,6,3,3
Daiablo,barthilas,288,shaman,elemental,6,3,3
Malgrave,ragnaros,288,shaman,elemental,6,3,3
Dialtone,blackrock,288,shaman,elemental,6,3,3
Garalath,bleeding-hollow,288,shaman,elemental,6,3,3
Chakkusando,barthilas,288,shaman,elemental,6,3,3
Dì,barthilas,288,shaman,elemental,6,3,3
Rampàge,ragnaros,288,shaman,elemental,6,3,3
Healingtime,nerzhul,288,shaman,elemental,6,3,3
Neesta,ragnaros,288,shaman,elemental,6,3,3
Zon,laughing-skull,288,shaman,elemental,6,3,3
Blaydin,elune,288,shaman,elemental,6,3,3
Zemleroynoyy,magtheridon,288,shaman,elemental,6,3,3
Shamtactic,thrall,288,shaman,elemental,6,3,3
Arckos,thrall,288,shaman,elemental,6,3,3
Tethai,moon-guard,288,shaman,elemental,6,3,3
Niarkx,frostmourne,288,shaman,elemental,6,3,3
Vozi,magtheridon,288,shaman,elemental,6,3,3
Autisty,sargeras,288,shaman,elemental,6,3,3
Shàman,durotan,288,shaman,elemental,6,3,3
Éarl,sargeras,288,shaman,elemental,6,3,3
Ragor,quelthalas,288,shaman,elemental,6,3,3
Earthfurÿ,quelthalas,288,shaman,elemental,6,3,3
Mønønøke,tichondrius,288,shaman,elemental,6,3,3
Fobb,area-52,288,shaman,elemental,6,3,3
Bigdumb,blackrock,288,shaman,elemental,6,3,3
Shajay,area-52,288,shaman,elemental,6,3,3
Raiden,gorgonnash,288,shaman,elemental,6,3,3
Elereeper,area-52,288,shaman,elemental,6,3,3
Häzel,nerzhul,288,shaman,elemental,6,3,3
Shadeele,cenarius,288,shaman,elemental,6,3,3
Exsh,area-52,288,shaman,elemental,6,3,3
Eztröz,kelthuzad,288,shaman,elemental,6,3,3
Aerôv,area-52,288,shaman,elemental,6,3,3
Talfur,area-52,288,shaman,elemental,6,3,3
Grwarf,korgath,288,shaman,elemental,6,3,3
Barlonso,illidan,288,shaman,elemental,6,3,3
Improvize,malganis,288,shaman,elemental,6,3,3
Altryn,shuhalo,288,shaman,elemental,6,3,3
Xhamankng,quelthalas,288,shaman,elemental,6,3,3
Jurafxdqt,malganis,288,shaman,elemental,6,3,3
Bolteon,malganis,288,shaman,elemental,6,3,3
Moosk,zuluhed,288,shaman,elemental,6,3,3
Jimmysjohn,malganis,288,shaman,elemental,6,3,3
Kurzee,kelthuzad,288,shaman,elemental,6,3,3
Bens,malganis,288,shaman,elemental,6,3,3
Headshake,malganis,288,shaman,elemental,6,3,3
Josephor,lightnings-blade,288,shaman,elemental,6,3,3
Grimnur,bleeding-hollow,288,shaman,elemental,11,3,8
Zarîks,kelthuzad,288,shaman,elemental,12,3,9
Juicemcroose,zuljin,288,shaman,elemental,12,3,9
Jessafer,undermine,288,shaman,elemental,12,3,9
Selexi,skywall,288,shaman,elemental,12,3,9
Honix,area-52,288,shaman,elemental,12,3,9
Healsquish,area-52,288,shaman,elemental,12,3,9
Bloodytotemz,emerald-dream,288,shaman,elemental,12,3,9
Emptee,area-52,288,shaman,elemental,12,3,9
Winiethepoöh,stormrage,288,shaman,elemental,12,3,9
Frakk,silvermoon,288,shaman,elemental,12,3,9
Olex,zuluhed,288,shaman,elemental,12,3,9
Coercè,tichondrius,288,shaman,elemental,12,3,9
Bitflip,jubeithos,288,shaman,elemental,12,3,9
Tawahka,hyjal,288,shaman,elemental,12,3,9
Onicharm,frostmourne,288,shaman,elemental,12,3,9
Taquitho,quelthalas,288,shaman,elemental,12,3,9
Stormklepter,fizzcrank,288,shaman,elemental,12,3,9
Sumyl,ragnaros,288,shaman,elemental,12,3,9
Rìddles,malygos,288,shaman,elemental,18,3,15
Døcholliday,zuluhed,288,shaman,elemental,18,3,15
Stîînck,azralon,288,shaman,elemental,18,3,15
Strikzjr,frostmourne,287,shaman,elemental,6,3,3
Arakye,stormrage,287,shaman,elemental,6,3,3
Juanisan,stormrage,287,shaman,elemental,6,3,3
Balrog,vashj,287,shaman,elemental,12,3,9
Slåpntickle,darkspear,287,shaman,elemental,12,3,9
Trabolta,hyjal,287,shaman,elemental,12,3,9
Awakarn,emerald-dream,287,shaman,elemental,24,4,20
Cropdustr,sargeras,286,shaman,elemental,6,3,3
Hannibol,tichondrius,255,shaman,elemental,11,3,8
Deldoduro,azralon,250,shaman,elemental,9,5,4
Oxxnabatko,amanthul,240,shaman,elemental,9,3,6
Gurdle,frostwolf,240,shaman,elemental,9,3,6
Nikeshocks,detheroc,239,shaman,elemental,5,3,2
Rîggs,wyrmrest-accord,239,shaman,elemental,5,3,2
Ppepe,boulderfist,239,shaman,elemental,5,3,2
Liamus,amanthul,239,shaman,elemental,5,3,2
Spunjie,frostmourne,239,shaman,elemental,5,3,2
Pepsy,frostmourne,192,shaman,elemental,9,3,6
Trizzeh,moon-guard,192,shaman,elemental,6,2,4
Ladash,ragnaros,192,shaman,elemental,6,2,4
Zeusblaster,illidan,192,shaman,elemental,6,2,4
Eekumbokum,bleeding-hollow,192,shaman,elemental,6,2,4
Naextramus,ragnaros,192,shaman,elemental,6,2,4
Yellowfev,thrall,192,shaman,elemental,6,2,4
Stormysteve,hyjal,192,shaman,elemental,6,2,4
Shamantimes,ragnaros,192,shaman,elemental,6,2,4
Krilick,blackrock,192,shaman,elemental,6,2,4
Drünk,hyjal,192,shaman,elemental,6,2,4
Doomberrie,thrall,192,shaman,elemental,6,2,4
Gorillox,chogall,192,shaman,elemental,6,2,4
Rinjio,zuljin,192,shaman,elemental,6,2,4
Shockt,wyrmrest-accord,192,shaman,elemental,6,2,4
Ric,malganis,192,shaman,elemental,6,2,4
Hruggol,bleeding-hollow,192,shaman,elemental,6,2,4
Deathmaker,tichondrius,192,shaman,elemental,6,2,4
Flappygooch,illidan,192,shaman,elemental,6,2,4
Zaxibow,area-52,192,shaman,elemental,6,2,4
Zugharder,illidan,192,shaman,elemental,6,2,4
Gulmuwu,zuljin,192,shaman,elemental,6,2,4
Hughwang,kelthuzad,192,shaman,elemental,6,2,4
Killtotem,illidan,192,shaman,elemental,6,2,4
Quakestorm,stormrage,192,shaman,elemental,6,2,4
Praisegodx,stormrage,192,shaman,elemental,6,2,4
Niian,skullcrusher,192,shaman,elemental,6,2,4
Stoneforged,area-52,192,shaman,elemental,6,2,4
Shablam,daggerspine,192,shaman,elemental,6,2,4
Robdaman,tichondrius,192,shaman,elemental,6,2,4
Blaiserpub,tichondrius,192,shaman,elemental,6,2,4
Artnatu,nemesis,192,shaman,elemental,6,2,4
Funeropolis,stormrage,192,shaman,elemental,6,2,4
Snoocher,kelthuzad,192,shaman,elemental,6,2,4
Drvoodoö,tichondrius,192,shaman,elemental,6,2,4
Oppaswag,tichondrius,192,shaman,elemental,6,2,4
Yagers,illidan,192,shaman,elemental,6,2,4
Goblarnit,gorefiend,192,shaman,elemental,6,2,4
Dantheman,twisting-nether,192,shaman,elemental,6,2,4
Kayzee,malganis,192,shaman,elemental,6,2,4
Plasticity,spirestone,192,shaman,elemental,6,2,4
Thormzz,tichondrius,192,shaman,elemental,6,2,4
Ahwahsahdood,stormreaver,192,shaman,elemental,6,2,4
Tartar,lightbringer,192,shaman,elemental,6,2,4
Nevershockx,kirin-tor,192,shaman,elemental,6,2,4
Fromundcheez,kelthuzad,192,shaman,elemental,6,2,4
Chadious,illidan,192,shaman,elemental,6,2,4
Britisy,stormrage,192,shaman,elemental,6,2,4
Alleys,tichondrius,192,shaman,elemental,6,2,4
Lenxd,dalaran,192,shaman,elemental,6,2,4
Ínfected,azralon,192,shaman,elemental,6,2,4
Redbulls,azralon,192,shaman,elemental,6,2,4
Tacotastic,malganis,192,shaman,elemental,6,2,4
Shåmwowz,sargeras,192,shaman,elemental,6,2,4
Heniu,tichondrius,192,shaman,elemental,6,2,4
Dirtyprocs,tichondrius,192,shaman,elemental,6,2,4
Kanbar,emerald-dream,192,shaman,elemental,6,2,4
Hehew,kelthuzad,192,shaman,elemental,6,2,4
Zeldrys,emerald-dream,192,shaman,elemental,6,2,4
Saltywap,proudmoore,192,shaman,elemental,6,2,4
Noether,sargeras,192,shaman,elemental,6,2,4
Vööbrew,illidan,192,shaman,elemental,6,2,4
Matzahmeal,skywall,192,shaman,elemental,6,2,4
Yangsangchu,tichondrius,192,shaman,elemental,6,2,4
Piffzorz,tichondrius,192,shaman,elemental,6,2,4
Wrestleman,drakthul,192,shaman,elemental,6,2,4
Shamsky,tichondrius,192,shaman,elemental,6,2,4
Elîas,tichondrius,192,shaman,elemental,6,2,4
Blastj,tichondrius,192,shaman,elemental,6,2,4
Jbahr,hyjal,192,shaman,elemental,6,2,4
Stickshaman,sargeras,192,shaman,elemental,6,2,4
Oriyani,sargeras,192,shaman,elemental,6,2,4
Rokhnar,zuljin,192,shaman,elemental,6,2,4
Maiven,frostmourne,192,shaman,elemental,6,2,4
Whitecake,frostmourne,192,shaman,elemental,6,2,4
Shockbot,stormscale,192,shaman,elemental,6,2,4
Puntress,barthilas,192,shaman,elemental,6,2,4
Grandmaster,frostmourne,192,shaman,elemental,6,2,4
Sid,frostmourne,192,shaman,elemental,6,2,4
Zuroster,kiljaeden,192,shaman,elemental,7,2,5
Martisor,barthilas,192,shaman,elemental,16,3,13
Fulingyu,moon-guard,192,shaman,elemental,12,2,10
Jazzblast,tichondrius,192,shaman,elemental,12,2,10
Fluffy,smolderthorn,192,shaman,elemental,12,2,10
Zulaantar,agamaggan,192,shaman,elemental,12,2,10
Gaboola,tichondrius,192,shaman,elemental,12,2,10
Harrìson,tichondrius,192,shaman,elemental,12,2,10
Golemagg,frostmourne,192,shaman,elemental,12,2,10
Electrïck,tichondrius,192,shaman,elemental,12,2,10
Jedley,azshara,192,shaman,elemental,12,2,10
Miane,tichondrius,192,shaman,elemental,12,2,10
Mega,azralon,192,shaman,elemental,12,2,10
Azl,guldan,192,shaman,elemental,13,2,11
Anzul,runetotem,192,shaman,elemental,18,2,16
Cyrah,azjolnerub,192,shaman,elemental,18,2,16
Telryndas,hyjal,192,shaman,elemental,18,2,16
Eleveil,emerald-dream,191,shaman,elemental,9,2,7
Hakaskry,caelestrasz,191,shaman,elemental,12,2,10
Ramonsanchez,ragnaros,160,shaman,elemental,16,2,14
Taò,tichondrius,159,shaman,elemental,5,2,3
Mentàl,baelgun,159,shaman,elemental,5,2,3
Hazzardttvz,illidan,159,shaman,elemental,5,2,3
Kidkovid,illidan,159,shaman,elemental,17,2,15
Noslol,bronzebeard,138,shaman,elemental,9,3,6
Uracemytotem,kiljaeden,138,shaman,elemental,10,3,7
Mynigabob,zuljin,128,shaman,elemental,4,2,2
Rahloo,sargeras,127,shaman,elemental,8,2,6
Kobecoopper,sargeras,96,shaman,elemental,6,1,5
Toxidizetkö,azralon,96,shaman,elemental,6,1,5
Firtog,emerald-dream,96,shaman,elemental,6,1,5
Khoden,emerald-dream,96,shaman,elemental,6,1,5
Thunderforge,azralon,96,shaman,elemental,6,1,5
Gan,silvermoon,96,shaman,elemental,6,1,5
Succies,emerald-dream,96,shaman,elemental,6,1,5
Ludacrìtz,stormrage,96,shaman,elemental,6,1,5
Staticshok,moon-guard,96,shaman,elemental,6,1,5
Oakshield,darkspear,96,shaman,elemental,6,1,5
Ravaburst,sargeras,96,shaman,elemental,6,1,5
Tatius,stormreaver,96,shaman,elemental,6,1,5
Zorgen,anvilmar,96,shaman,elemental,6,1,5
Miptide,saurfang,96,shaman,elemental,6,1,5
Crigga,dalaran,96,shaman,elemental,6,1,5
Hexondabeach,barthilas,96,shaman,elemental,6,1,5
Seanie,bleeding-hollow,96,shaman,elemental,6,1,5
Orruddon,thaurissan,96,shaman,elemental,6,1,5
Zral,emerald-dream,96,shaman,elemental,6,1,5
Buckshott,chogall,96,shaman,elemental,6,1,5
Sinsar,illidan,96,shaman,elemental,6,1,5
Youngmulakek,area-52,96,shaman,elemental,6,1,5
Dwarfdead,nemesis,96,shaman,elemental,6,1,5
Ggsggs,akama,96,shaman,elemental,6,1,5
Ognerkish,black-dragonflight,96,shaman,elemental,6,1,5
Obiwonsamdi,illidan,96,shaman,elemental,6,1,5
Girafasuarx,korgath,96,shaman,elemental,6,1,5
Snowzy,icecrown,96,shaman,elemental,6,1,5
Thorni,nagrand,96,shaman,elemental,6,1,5
Lhejyr,garona,96,shaman,elemental,6,1,5
Cathxy,kelthuzad,96,shaman,elemental,6,1,5
Mdawwg,kelthuzad,96,shaman,elemental,6,1,5
Detair,malganis,96,shaman,elemental,6,1,5
Macdab,malganis,96,shaman,elemental,6,1,5
Nerfmytotemz,frostmourne,96,shaman,elemental,6,1,5
Bullcowsby,darkspear,96,shaman,elemental,6,1,5
Bouje,frostmourne,96,shaman,elemental,6,1,5
Teathin,ragnaros,96,shaman,elemental,6,1,5
Drmn,frostmourne,96,shaman,elemental,6,1,5
Mugiwára,ragnaros,96,shaman,elemental,6,1,5
Mcshockturds,tichondrius,96,shaman,elemental,6,1,5
Firevag,hakkar,96,shaman,elemental,6,1,5
Winebag,tichondrius,96,shaman,elemental,6,1,5
Macdiesel,tichondrius,96,shaman,elemental,6,1,5
Thunderbudx,stonemaul,96,shaman,elemental,6,1,5
Oldshammy,eldrethalas,96,shaman,elemental,6,1,5
Aegaeonlol,tichondrius,96,shaman,elemental,6,1,5
Stòrmbreaker,korgath,96,shaman,elemental,12,1,11
Staticshock,darkspear,96,shaman,elemental,12,1,11
Eleshamanz,tichondrius,79,shaman,elemental,5,1,4
Docadams,chogall,79,shaman,elemental,5,1,4
Camltotem,tichondrius,79,shaman,elemental,5,1,4
Necrolords,tichondrius,79,shaman,elemental,5,1,4
Mcstop,tanaris,64,shaman,elemental,4,1,3
Hentaistorm,kiljaeden,48,shaman,elemental,3,1,2
Keyarga,ravencrest,42,shaman,elemental,11,2,9
Hothouse,malganis,31,shaman,elemental,2,1,1
Djskinflute,bleeding-hollow,16,shaman,elemental,1,1,0
Elementium,azshara,16,shaman,elemental,1,1,0
Jumoma,thrall,16,shaman,elemental,1,1,0
Aýanokoji,tichondrius,2297,shaman,enhancement,197,107,90
Hizúrú,tichondrius,2282,shaman,enhancement,132,74,58
Vanhalestorm,frostmourne,2264,shaman,enhancement,106,58,48
Mítsurí,tichondrius,2244,shaman,enhancement,210,109,101
Rauthgar,dalaran,2221,shaman,enhancement,114,66,48
Saul,tichondrius,2218,shaman,enhancement,66,42,24
Stormnala,zuljin,2211,shaman,enhancement,180,104,76
Zarktwo,azralon,2205,shaman,enhancement,153,83,70
Smxxn,tichondrius,2196,shaman,enhancement,131,68,63
Alleys,tichondrius,2185,shaman,enhancement,231,118,113
Swolé,emerald-dream,2182,shaman,enhancement,460,234,226
Musclebrains,tichondrius,2176,shaman,enhancement,84,48,36
Axegerd,quelthalas,2147,shaman,enhancement,242,132,110
Bøulderfist,tichondrius,2142,shaman,enhancement,120,76,44
Opoy,sargeras,2142,shaman,enhancement,201,112,89
Musclebrain,tichondrius,2139,shaman,enhancement,204,104,100
Crowns,tichondrius,2136,shaman,enhancement,114,59,55
Nopnopajnin,tichondrius,2135,shaman,enhancement,112,57,55
Skydre,area-52,2131,shaman,enhancement,89,54,35
Zeroq,tichondrius,2129,shaman,enhancement,114,70,44
Futeuncle,tichondrius,2123,shaman,enhancement,78,41,37
Peynful,shadowsong,2120,shaman,enhancement,93,59,34
Ftyue,area-52,2116,shaman,enhancement,112,59,53
Rawdòggin,emerald-dream,2113,shaman,enhancement,71,45,26
Musclebrainz,tichondrius,2112,shaman,enhancement,90,44,46
Shapaman,tichondrius,2110,shaman,enhancement,77,53,24
Bjorengahr,emerald-dream,2110,shaman,enhancement,83,53,30
Doomwìnds,stormrage,2108,shaman,enhancement,168,93,75
Shamsz,frostmourne,2106,shaman,enhancement,72,48,24
Lashandtrash,tichondrius,2106,shaman,enhancement,66,41,25
Tastydonut,blackrock,2094,shaman,enhancement,141,85,56
Stew,illidan,2093,shaman,enhancement,131,68,63
Wetdraenei,moon-guard,2080,shaman,enhancement,283,157,126
Swrdfsh,tichondrius,2071,shaman,enhancement,312,165,147
Baseballcap,sargeras,2070,shaman,enhancement,96,58,38
Thiccsha,moon-guard,2061,shaman,enhancement,90,48,42
Shakeys,tichondrius,2060,shaman,enhancement,77,49,28
Jazzlightnin,tichondrius,2049,shaman,enhancement,76,42,34
Realypump,area-52,2046,shaman,enhancement,215,111,104
Xiaoxiboy,tichondrius,2026,shaman,enhancement,66,41,25
Futeboy,tichondrius,2025,shaman,enhancement,69,36,33
Partypurge,malganis,2024,shaman,enhancement,95,64,31
Windfury,chogall,2024,shaman,enhancement,114,62,52
Lustingchery,area-52,2017,shaman,enhancement,123,63,60
Shylabuffkin,area-52,2015,shaman,enhancement,307,166,141
Algresh,muradin,2015,shaman,enhancement,66,33,33
Windshearbøt,tichondrius,2006,shaman,enhancement,77,47,30
Shamguards,tichondrius,2004,shaman,enhancement,42,31,11
Stronghit,tichondrius,2004,shaman,enhancement,60,32,28
Typhe,bleeding-hollow,2001,shaman,enhancement,48,30,18
Enhancex,frostwolf,2001,shaman,enhancement,68,36,32
Dalianyen,bladefist,1997,shaman,enhancement,134,71,63
Oosheratchet,illidan,1992,shaman,enhancement,70,47,23
Enhance,bleeding-hollow,1992,shaman,enhancement,77,42,35
Rozboiclique,frostmourne,1985,shaman,enhancement,156,103,53
Meataballa,the-underbog,1985,shaman,enhancement,84,54,30
Crownsx,tichondrius,1980,shaman,enhancement,91,41,50
Jyupaonaiwa,tichondrius,1977,shaman,enhancement,72,37,35
Dopeysimida,illidan,1976,shaman,enhancement,92,57,35
Pizzashaman,illidan,1970,shaman,enhancement,109,64,45
Proctopus,moon-guard,1969,shaman,enhancement,244,128,116
Napski,cenarius,1969,shaman,enhancement,161,83,78
Gatorwaves,bleeding-hollow,1965,shaman,enhancement,54,32,22
Shk,illidan,1964,shaman,enhancement,66,38,28
Zootywild,tichondrius,1963,shaman,enhancement,123,69,54
Grum,zuljin,1961,shaman,enhancement,48,27,21
Spippippin,illidan,1959,shaman,enhancement,98,50,48
Zarasvati,tichondrius,1957,shaman,enhancement,179,91,88
Imchuckbass,tichondrius,1954,shaman,enhancement,122,64,58
Artenior,stormrage,1954,shaman,enhancement,159,83,76
Hallofcost,illidan,1950,shaman,enhancement,156,93,63
Balgron,emerald-dream,1949,shaman,enhancement,52,26,26
Ohmálley,tichondrius,1944,shaman,enhancement,62,40,22
Earlainn,stormrage,1938,shaman,enhancement,114,64,50
Lividelement,area-52,1937,shaman,enhancement,60,38,22
Ogeezkush,zuljin,1935,shaman,enhancement,160,93,67
Shakeysham,tichondrius,1934,shaman,enhancement,48,29,19
Kaediea,moon-guard,1932,shaman,enhancement,36,27,9
Revtide,thrall,1928,shaman,enhancement,78,43,35
Hooluu,frostmourne,1925,shaman,enhancement,78,41,37
Xiaoxiaoxi,tichondrius,1924,shaman,enhancement,60,34,26
Fwwrs,illidan,1919,shaman,enhancement,79,51,28
Greenydapooh,nerzhul,1916,shaman,enhancement,72,45,27
Tokyofresh,malganis,1916,shaman,enhancement,234,133,101
Plsnerfret,stormrage,1913,shaman,enhancement,60,39,21
Bestshamus,sargeras,1913,shaman,enhancement,83,49,34
Kushnations,chogall,1909,shaman,enhancement,56,29,27
Ballinhance,illidan,1908,shaman,enhancement,54,31,23
Daysub,crushridge,1907,shaman,enhancement,66,38,28
Scaman,tichondrius,1904,shaman,enhancement,24,20,4
Chillpoppin,emerald-dream,1904,shaman,enhancement,42,31,11
Taowth,tichondrius,1903,shaman,enhancement,41,22,19
Interruptbøt,tichondrius,1901,shaman,enhancement,44,28,16
Keyturn,tichondrius,1899,shaman,enhancement,78,36,42
Kltz,sargeras,1892,shaman,enhancement,77,44,33
Bluntboy,zuljin,1889,shaman,enhancement,68,45,23
Watergirl,thaurissan,1889,shaman,enhancement,248,124,124
Olxsixsm,illidan,1884,shaman,enhancement,74,48,26
Legendslayar,area-52,1882,shaman,enhancement,48,32,16
Gìmli,tichondrius,1882,shaman,enhancement,65,37,28
Electricity,tichondrius,1880,shaman,enhancement,127,63,64
Clasm,tichondrius,1879,shaman,enhancement,60,39,21
Harrypotqueu,zuljin,1879,shaman,enhancement,90,49,41
Sasageyo,tichondrius,1877,shaman,enhancement,43,26,17
Stormrageman,tichondrius,1875,shaman,enhancement,81,49,32
Cowaii,illidan,1874,shaman,enhancement,72,39,33
Keyturns,tichondrius,1870,shaman,enhancement,42,28,14
Youngmulakek,area-52,1870,shaman,enhancement,125,83,42
Dano,tichondrius,1867,shaman,enhancement,124,64,60
Superchief,altar-of-storms,1865,shaman,enhancement,116,62,54
Jayhastotems,area-52,1864,shaman,enhancement,102,71,31
Zarrka,tichondrius,1864,shaman,enhancement,36,20,16
Jàro,thrall,1862,shaman,enhancement,66,30,36
Temar,sargeras,1861,shaman,enhancement,113,68,45
Ëxceeder,ragnaros,1861,shaman,enhancement,144,81,63
Lavamon,illidan,1860,shaman,enhancement,84,49,35
Deandre,illidan,1860,shaman,enhancement,60,34,26
Wonima,tichondrius,1858,shaman,enhancement,35,20,15
Zizö,barthilas,1857,shaman,enhancement,78,54,24
Shamikazi,crushridge,1857,shaman,enhancement,194,115,79
Taikø,area-52,1856,shaman,enhancement,42,25,17
Lavitris,illidan,1854,shaman,enhancement,42,29,13
Pinechanga,ragnaros,1853,shaman,enhancement,96,52,44
Freyía,illidan,1852,shaman,enhancement,36,26,10
Mcshockturds,tichondrius,1849,shaman,enhancement,143,82,61
Konfuzious,emerald-dream,1849,shaman,enhancement,165,93,72
Gïrthquake,tichondrius,1849,shaman,enhancement,84,45,39
Muisor,quelthalas,1848,shaman,enhancement,84,48,36
Kamusham,azralon,1848,shaman,enhancement,128,72,56
Undertów,area-52,1847,shaman,enhancement,48,26,22
Zeûs,lightbringer,1846,shaman,enhancement,72,41,31
Vonvulviln,emerald-dream,1845,shaman,enhancement,88,46,42
Xakaeri,hyjal,1844,shaman,enhancement,60,36,24
Xoxoxø,area-52,1843,shaman,enhancement,36,22,14
Koalakisses,shadow-council,1842,shaman,enhancement,54,32,22
Ishano,area-52,1839,shaman,enhancement,48,23,25
Bodai,magtheridon,1838,shaman,enhancement,54,36,18
Dcg,hyjal,1838,shaman,enhancement,65,33,32
Vulcänyr,quelthalas,1837,shaman,enhancement,60,34,26
Eletastic,tichondrius,1836,shaman,enhancement,78,43,35
Berxek,tichondrius,1835,shaman,enhancement,48,27,21
Thuntard,bleeding-hollow,1835,shaman,enhancement,66,33,33
Soshatsumi,tichondrius,1834,shaman,enhancement,94,54,40
Dä,tichondrius,1834,shaman,enhancement,48,26,22
Blueraccoon,tichondrius,1830,shaman,enhancement,63,38,25
Turbowolf,sargeras,1829,shaman,enhancement,104,47,57
Grommi,proudmoore,1828,shaman,enhancement,458,224,234
Eityhdz,tichondrius,1827,shaman,enhancement,425,216,209
Fujinx,medivh,1826,shaman,enhancement,45,30,15
Nomoreswap,zuljin,1825,shaman,enhancement,54,38,16
Shamanabuser,illidan,1825,shaman,enhancement,60,27,33
Loabud,tichondrius,1824,shaman,enhancement,73,43,30
Shamangpt,illidan,1823,shaman,enhancement,30,26,4
Flabby,lightbringer,1823,shaman,enhancement,54,26,28
Jokerxksx,tichondrius,1822,shaman,enhancement,72,43,29
Midwestern,emerald-dream,1822,shaman,enhancement,44,26,18
Metako,sargeras,1822,shaman,enhancement,83,47,36
Hooftoface,moon-guard,1822,shaman,enhancement,78,43,35
Struck,emerald-dream,1821,shaman,enhancement,226,136,90
Gladdorta,azralon,1821,shaman,enhancement,54,30,24
Btruez,tichondrius,1819,shaman,enhancement,63,35,28
Thunderlaw,area-52,1819,shaman,enhancement,82,44,38
Whírlwínd,area-52,1818,shaman,enhancement,30,19,11
Judgesfotm,bleeding-hollow,1818,shaman,enhancement,135,70,65
Addroi,tichondrius,1818,shaman,enhancement,60,28,32
Antek,quelthalas,1817,shaman,enhancement,171,99,72
Léxar,sargeras,1817,shaman,enhancement,72,33,39
Thromjin,ragnaros,1816,shaman,enhancement,95,57,38
Movemaker,shattered-hand,1815,shaman,enhancement,30,21,9
Cunkinator,stormrage,1815,shaman,enhancement,115,74,41
Riptiedx,barthilas,1815,shaman,enhancement,48,29,19
Sarthuul,emerald-dream,1814,shaman,enhancement,48,30,18
Thrallas,frostmourne,1814,shaman,enhancement,54,33,21
Cammeez,area-52,1814,shaman,enhancement,139,72,67
Boombigshaq,ysera,1813,shaman,enhancement,38,25,13
Àspec,aegwynn,1811,shaman,enhancement,28,21,7
Faultline,khadgar,1811,shaman,enhancement,73,47,26
Drakhe,proudmoore,1811,shaman,enhancement,232,128,104
Nygiants,tichondrius,1810,shaman,enhancement,24,19,5
Xibalba,khaz-modan,1810,shaman,enhancement,96,57,39
Sassyx,steamwheedle-cartel,1810,shaman,enhancement,48,27,21
Iamashaman,malganis,1810,shaman,enhancement,302,154,148
Bikboisteez,barthilas,1809,shaman,enhancement,110,56,54
Adalid,thrall,1808,shaman,enhancement,66,46,20
Bigsquatzy,bleeding-hollow,1808,shaman,enhancement,48,26,22
Speedrush,nagrand,1806,shaman,enhancement,146,88,58
Boboyaga,emerald-dream,1805,shaman,enhancement,54,29,25
Niuniudada,illidan,1805,shaman,enhancement,84,39,45
Stonetides,tichondrius,1804,shaman,enhancement,36,26,10
Nibrax,moknathal,1804,shaman,enhancement,78,41,37
Krûde,tichondrius,1803,shaman,enhancement,143,89,54
Blakki,barthilas,1801,shaman,enhancement,66,40,26
Dønkx,tichondrius,1801,shaman,enhancement,71,39,32
Riptideafk,sargeras,1800,shaman,enhancement,75,46,29
Landlordxx,area-52,1795,shaman,enhancement,52,32,20
Norlak,antonidas,1794,shaman,enhancement,90,44,46
Forksin,tichondrius,1793,shaman,enhancement,81,34,47
Dorta,azralon,1792,shaman,enhancement,54,30,24
Heisna,stormrage,1792,shaman,enhancement,301,160,141
Sheared,emerald-dream,1790,shaman,enhancement,138,79,59
Darkcnight,stormrage,1789,shaman,enhancement,93,53,40
Turdfergesen,destromath,1789,shaman,enhancement,94,48,46
Nonomori,frostmourne,1788,shaman,enhancement,88,50,38
Pingatronx,ragnaros,1786,shaman,enhancement,90,64,26
Wautyriex,area-52,1786,shaman,enhancement,66,32,34
Louiev,bleeding-hollow,1784,shaman,enhancement,60,33,27
Xaltas,moon-guard,1779,shaman,enhancement,102,63,39
Díesel,azralon,1777,shaman,enhancement,59,32,27
Kinzle,tichondrius,1776,shaman,enhancement,60,26,34
Doomberrie,thrall,1775,shaman,enhancement,158,84,74
Garai,emerald-dream,1775,shaman,enhancement,135,69,66
Elefornoobs,area-52,1773,shaman,enhancement,54,38,16
Krovn,stormrage,1772,shaman,enhancement,60,33,27
Mobi,tichondrius,1769,shaman,enhancement,54,31,23
Reflexsivx,malganis,1767,shaman,enhancement,66,39,27
Novedz,illidan,1767,shaman,enhancement,62,32,30
Shinian,tichondrius,1765,shaman,enhancement,63,38,25
Rukagar,barthilas,1764,shaman,enhancement,98,55,43
Anzet,ragnaros,1762,shaman,enhancement,42,26,16
Worthquake,illidan,1758,shaman,enhancement,84,48,36
Stewtwo,illidan,1758,shaman,enhancement,45,25,20
Zanderpla,kelthuzad,1758,shaman,enhancement,108,56,52
Biubiuz,tichondrius,1757,shaman,enhancement,102,63,39
Kiddfurious,kelthuzad,1757,shaman,enhancement,156,75,81
Gorgonash,magtheridon,1756,shaman,enhancement,48,27,21
Tdlz,tichondrius,1752,shaman,enhancement,110,67,43
Synivabyatch,eonar,1752,shaman,enhancement,96,55,41
Vjeze,frostmourne,1749,shaman,enhancement,44,25,19
Zappithorus,stormrage,1748,shaman,enhancement,54,35,19
Meiku,emerald-dream,1748,shaman,enhancement,42,27,15
Shocksrus,arthas,1747,shaman,enhancement,82,46,36
Kalvishdam,dalaran,1746,shaman,enhancement,36,25,11
Beañ,barthilas,1746,shaman,enhancement,418,207,211
Madonion,zuljin,1746,shaman,enhancement,66,32,34
Overpowered,korgath,1745,shaman,enhancement,40,21,19
Anadal,kargath,1743,shaman,enhancement,66,30,36
Yakora,stormrage,1741,shaman,enhancement,156,85,71
Haishoe,stormrage,1740,shaman,enhancement,68,42,26
Sin,bleeding-hollow,1740,shaman,enhancement,35,19,16
Valkriie,tichondrius,1736,shaman,enhancement,37,22,15
Nøtørious,thrall,1735,shaman,enhancement,24,22,2
Fhenh,proudmoore,1734,shaman,enhancement,161,95,66
Onlyshams,dalaran,1732,shaman,enhancement,42,25,17
Tarazhim,kelthuzad,1731,shaman,enhancement,48,30,18
Badshock,tichondrius,1730,shaman,enhancement,24,22,2
Timzero,tichondrius,1730,shaman,enhancement,187,90,97
Clappadactyl,frostmourne,1729,shaman,enhancement,266,143,123
Yucasinmojo,illidan,1726,shaman,enhancement,73,40,33
Doex,thrall,1723,shaman,enhancement,48,26,22
Shearx,illidan,1722,shaman,enhancement,75,43,32
Hellamental,malganis,1721,shaman,enhancement,72,40,32
Casinoclass,stormrage,1720,shaman,enhancement,166,94,72
Mercó,bleeding-hollow,1720,shaman,enhancement,84,44,40
Seltheran,tichondrius,1719,shaman,enhancement,48,33,15
Poizele,tichondrius,1717,shaman,enhancement,294,164,130
Olíndo,tichondrius,1716,shaman,enhancement,54,35,19
Athropos,malganis,1713,shaman,enhancement,42,20,22
Cwippin,tichondrius,1712,shaman,enhancement,134,77,57
Rngena,trollbane,1706,shaman,enhancement,30,18,12
Asumo,azralon,1705,shaman,enhancement,153,82,71
Seltherann,tichondrius,1704,shaman,enhancement,42,29,13
Taowth,area-52,1703,shaman,enhancement,47,22,25
Electrica,quelthalas,1702,shaman,enhancement,36,18,18
Akormu,tichondrius,1701,shaman,enhancement,94,58,36
Durozu,tichondrius,1701,shaman,enhancement,59,28,31
Ioiotete,tichondrius,1700,shaman,enhancement,42,24,18
Totegoat,nazjatar,1699,shaman,enhancement,90,48,42
Bbshock,stormrage,1698,shaman,enhancement,84,50,34
Wingshaman,illidan,1698,shaman,enhancement,226,120,106
Frëdstorm,kelthuzad,1698,shaman,enhancement,287,148,139
Axelsteel,illidan,1697,shaman,enhancement,48,21,27
Plzbuffme,dalaran,1696,shaman,enhancement,96,55,41
Toobeastly,deathwing,1696,shaman,enhancement,87,48,39
Bitsuey,frostmourne,1696,shaman,enhancement,84,46,38
Stonetrog,blackrock,1695,shaman,enhancement,24,19,5
Nøname,azshara,1695,shaman,enhancement,263,135,128
Tkarfuno,exodar,1694,shaman,enhancement,66,34,32
Miketideson,proudmoore,1693,shaman,enhancement,72,38,34
Çhïcagø,aegwynn,1693,shaman,enhancement,71,32,39
Megalithic,moon-guard,1690,shaman,enhancement,66,44,22
Heavy,ragnaros,1690,shaman,enhancement,47,19,28
Shamezee,stormreaver,1689,shaman,enhancement,47,22,25
Nyckysh,illidan,1688,shaman,enhancement,106,56,50
Somebozo,darkspear,1687,shaman,enhancement,157,84,73
Elryl,sargeras,1686,shaman,enhancement,116,64,52
Neuralînk,tichondrius,1685,shaman,enhancement,39,21,18
Justkitettv,stormrage,1684,shaman,enhancement,42,28,14
Geeblast,area-52,1683,shaman,enhancement,79,47,32
Convolutedx,tichondrius,1683,shaman,enhancement,36,20,16
Tuugo,mannoroth,1682,shaman,enhancement,36,24,12
Meewo,sargeras,1682,shaman,enhancement,30,18,12
Vortexfury,area-52,1682,shaman,enhancement,42,20,22
Pla,tichondrius,1681,shaman,enhancement,174,97,77
Shamungodc,tichondrius,1681,shaman,enhancement,50,25,25
Washedupty,illidan,1679,shaman,enhancement,64,38,26
Thicctotes,tichondrius,1679,shaman,enhancement,42,24,18
Zugzugenh,stormrage,1676,shaman,enhancement,76,45,31
Lagroupie,ragnaros,1675,shaman,enhancement,35,23,12
Sonofabat,spirestone,1674,shaman,enhancement,242,126,116
Melifesham,tichondrius,1672,shaman,enhancement,51,31,20
Tyven,tichondrius,1672,shaman,enhancement,100,54,46
Volkuul,zuljin,1669,shaman,enhancement,72,40,32
Gorillahazed,tichondrius,1669,shaman,enhancement,183,93,90
Shamcowhah,frostmourne,1669,shaman,enhancement,48,24,24
Sevare,area-52,1667,shaman,enhancement,45,22,23
Shamgawd,illidan,1666,shaman,enhancement,123,64,59
Aibheit,area-52,1664,shaman,enhancement,30,28,2
Egirlshmu,stormrage,1664,shaman,enhancement,60,36,24
Tyranitaur,frostmourne,1664,shaman,enhancement,94,47,47
Shockmehard,area-52,1661,shaman,enhancement,95,73,22
Kindaretro,tichondrius,1661,shaman,enhancement,60,38,22
Shámdemons,area-52,1660,shaman,enhancement,102,62,40
Brëw,tichondrius,1656,shaman,enhancement,64,44,20
Pashå,norgannon,1656,shaman,enhancement,48,30,18
Swaplord,area-52,1656,shaman,enhancement,30,18,12
Harrìson,tichondrius,1656,shaman,enhancement,41,21,20
Beaviis,frostmourne,1655,shaman,enhancement,87,43,44
Notblack,bleeding-hollow,1654,shaman,enhancement,36,28,8
Furrybâstard,wyrmrest-accord,1654,shaman,enhancement,102,59,43
Ironaddictz,kiljaeden,1654,shaman,enhancement,88,49,39
Artsha,tol-barad,1654,shaman,enhancement,56,27,29
Rêngoku,dalaran,1653,shaman,enhancement,36,26,10
Capershock,sargeras,1653,shaman,enhancement,30,19,11
Slothycrit,emerald-dream,1653,shaman,enhancement,42,22,20
Delxx,tichondrius,1651,shaman,enhancement,42,25,17
Windflex,emerald-dream,1651,shaman,enhancement,85,43,42
Shamom,silver-hand,1649,shaman,enhancement,172,95,77
Darwynz,zuljin,1649,shaman,enhancement,53,28,25
Slapnarp,wyrmrest-accord,1649,shaman,enhancement,90,43,47
Jofstrom,tichondrius,1647,shaman,enhancement,30,22,8
Ceasebelief,tichondrius,1646,shaman,enhancement,42,28,14
Dratna,sisters-of-elune,1645,shaman,enhancement,29,22,7
Vultan,winterhoof,1645,shaman,enhancement,36,25,11
Tandrian,daggerspine,1645,shaman,enhancement,60,28,32
Vøllttz,azralon,1644,shaman,enhancement,54,34,20
Täcti,tichondrius,1644,shaman,enhancement,111,59,52
Shakerina,azralon,1644,shaman,enhancement,146,70,76
Killswitch,bonechewer,1644,shaman,enhancement,54,25,29
Elemores,tichondrius,1642,shaman,enhancement,66,40,26
Daddymacktv,malganis,1642,shaman,enhancement,86,46,40
Swartzqt,tichondrius,1641,shaman,enhancement,58,28,30
Halfzugzug,sargeras,1639,shaman,enhancement,54,31,23
Murig,bladefist,1638,shaman,enhancement,57,34,23
Ràntòn,bleeding-hollow,1637,shaman,enhancement,35,24,11
Seanan,tichondrius,1637,shaman,enhancement,72,43,29
Shinydiglett,area-52,1637,shaman,enhancement,36,20,16
Hecks,malorne,1637,shaman,enhancement,102,53,49
Wortwort,tichondrius,1636,shaman,enhancement,111,59,52
Scherzer,frostwolf,1636,shaman,enhancement,50,25,25
Mixn,frostmourne,1633,shaman,enhancement,131,79,52
Onamakawash,black-dragonflight,1632,shaman,enhancement,36,22,14
Goondruka,area-52,1632,shaman,enhancement,38,20,18
Deww,sargeras,1632,shaman,enhancement,76,39,37
Orkuss,illidan,1631,shaman,enhancement,48,25,23
Thunderchad,jubeithos,1631,shaman,enhancement,50,25,25
Khormac,moon-guard,1630,shaman,enhancement,116,72,44
Tettnanger,azralon,1630,shaman,enhancement,31,19,12
Mihrion,moon-guard,1630,shaman,enhancement,71,41,30
Slashpity,stormrage,1630,shaman,enhancement,63,33,30
Olani,nesingwary,1630,shaman,enhancement,43,22,21
Mcb,barthilas,1630,shaman,enhancement,54,23,31
Sinestario,illidan,1629,shaman,enhancement,160,88,72
Tactíc,chromaggus,1628,shaman,enhancement,24,17,7
Notsamok,area-52,1628,shaman,enhancement,30,18,12
Omaguap,tichondrius,1628,shaman,enhancement,50,29,21
Kohatan,moon-guard,1627,shaman,enhancement,98,58,40
Heäven,malganis,1626,shaman,enhancement,222,120,102
Thewindman,sargeras,1626,shaman,enhancement,90,46,44
Hxzard,stormrage,1626,shaman,enhancement,36,17,19
Åvarice,shattered-halls,1626,shaman,enhancement,54,22,32
Alablast,malganis,1625,shaman,enhancement,36,21,15
Eliteshamann,tichondrius,1625,shaman,enhancement,108,58,50
Shockdome,daggerspine,1624,shaman,enhancement,33,23,10
Roysoy,stormrage,1623,shaman,enhancement,84,50,34
Zapnclap,tichondrius,1623,shaman,enhancement,42,24,18
Dankthunda,stormrage,1623,shaman,enhancement,132,74,58
Platanos,proudmoore,1622,shaman,enhancement,182,94,88
Shamakhazi,stormrage,1621,shaman,enhancement,24,17,7
Mokho,stormrage,1620,shaman,enhancement,30,19,11
Venmoo,illidan,1620,shaman,enhancement,42,20,22
Deyodin,illidan,1619,shaman,enhancement,26,18,8
Happycorgi,proudmoore,1618,shaman,enhancement,60,33,27
Unezx,tichondrius,1617,shaman,enhancement,36,26,10
Ryziax,tichondrius,1616,shaman,enhancement,41,23,18
ßurstmedaddy,bleeding-hollow,1614,shaman,enhancement,42,32,10
Udb,the-scryers,1614,shaman,enhancement,59,38,21
Stýlébéñdér,kelthuzad,1613,shaman,enhancement,24,17,7
Feroxture,frostmourne,1613,shaman,enhancement,72,41,31
Jirig,tichondrius,1612,shaman,enhancement,42,24,18
Ðr,earthen-ring,1612,shaman,enhancement,156,85,71
Ryuuraix,area-52,1610,shaman,enhancement,27,18,9
Helohk,wyrmrest-accord,1610,shaman,enhancement,39,21,18
Slapchainz,tichondrius,1609,shaman,enhancement,48,26,22
Khorgan,emerald-dream,1609,shaman,enhancement,36,19,17
Xlianah,zuljin,1609,shaman,enhancement,54,28,26
Bräindëad,hyjal,1608,shaman,enhancement,131,74,57
Robdaman,tichondrius,1607,shaman,enhancement,24,18,6
Blîzz,ragnaros,1607,shaman,enhancement,30,17,13
Hurrikaine,dalaran,1606,shaman,enhancement,164,85,79
Stormbash,ragnaros,1606,shaman,enhancement,72,30,42
Niceshoe,tichondrius,1605,shaman,enhancement,65,33,32
Scrototëm,azralon,1604,shaman,enhancement,129,70,59
Shamwik,frostmourne,1603,shaman,enhancement,95,53,42
Totemnikiel,stormrage,1602,shaman,enhancement,96,45,51
Jumoma,thrall,1601,shaman,enhancement,66,41,25
Shockszz,onyxia,1601,shaman,enhancement,42,23,19
Raxabico,nemesis,1601,shaman,enhancement,68,36,32
Shmnsm,kiljaeden,1600,shaman,enhancement,48,21,27
Juliojones,trollbane,1599,shaman,enhancement,42,20,22
Torgami,tichondrius,1598,shaman,enhancement,49,30,19
Ephraalin,frostmourne,1596,shaman,enhancement,48,26,22
Pwnôgraphy,kelthuzad,1595,shaman,enhancement,38,25,13
Eyecandi,barthilas,1595,shaman,enhancement,151,76,75
Hehew,kelthuzad,1594,shaman,enhancement,83,49,34
Døømsdáy,thrall,1594,shaman,enhancement,150,77,73
Ara,barthilas,1590,shaman,enhancement,54,33,21
Kumu,stormscale,1589,shaman,enhancement,41,20,21
Mobiediqônú,skywall,1586,shaman,enhancement,36,19,17
Stormsanta,emerald-dream,1586,shaman,enhancement,48,22,26
Gorehouse,kiljaeden,1585,shaman,enhancement,44,23,21
ßlessedx,tichondrius,1584,shaman,enhancement,95,57,38
Smash,fenris,1584,shaman,enhancement,97,49,48
Thilv,ravenholdt,1583,shaman,enhancement,58,34,24
Zaydax,altar-of-storms,1582,shaman,enhancement,30,18,12
Shabenn,proudmoore,1581,shaman,enhancement,163,82,81
Keeba,wyrmrest-accord,1580,shaman,enhancement,68,35,33
Zavar,tichondrius,1579,shaman,enhancement,77,40,37
Moistydank,tichondrius,1578,shaman,enhancement,84,54,30
Dreddfoxy,illidan,1577,shaman,enhancement,48,25,23
Shamanees,area-52,1576,shaman,enhancement,176,88,88
Jerykco,drakkari,1575,shaman,enhancement,78,40,38
Gambazzlok,terokkar,1574,shaman,enhancement,48,28,20
Zeroshocks,kelthuzad,1573,shaman,enhancement,42,25,17
Sugarpapa,bonechewer,1572,shaman,enhancement,99,60,39
Meshrek,tichondrius,1572,shaman,enhancement,47,25,22
Loadiez,frostmourne,1570,shaman,enhancement,47,31,16
Nÿh,quelthalas,1569,shaman,enhancement,48,27,21
Rtÿo,area-52,1567,shaman,enhancement,42,22,20
Aoshiferuzz,ragnaros,1566,shaman,enhancement,78,43,35
Askpuntee,sargeras,1563,shaman,enhancement,48,25,23
Lyrzsa,blackwing-lair,1562,shaman,enhancement,80,49,31
Uracemytotem,kiljaeden,1562,shaman,enhancement,84,51,33
Tumble,frostmourne,1562,shaman,enhancement,144,78,66
Thunda,black-dragonflight,1561,shaman,enhancement,36,22,14
Split,zuljin,1560,shaman,enhancement,214,115,99
Shamwows,dalaran,1559,shaman,enhancement,213,106,107
Deemmorti,stormrage,1555,shaman,enhancement,58,31,27
Obombyas,sargeras,1555,shaman,enhancement,42,21,21
Cayed,stormscale,1553,shaman,enhancement,90,47,43
Elementalïst,durotan,1549,shaman,enhancement,36,22,14
Dadadabang,frostmourne,1549,shaman,enhancement,94,52,42
Smartbunny,illidan,1546,shaman,enhancement,330,164,166
Armîn,moon-guard,1544,shaman,enhancement,54,33,21
Lavawreckage,malganis,1544,shaman,enhancement,122,66,56
Jäyp,thrall,1543,shaman,enhancement,74,43,31
Mindfields,barthilas,1542,shaman,enhancement,73,42,31
Rexoss,hyjal,1541,shaman,enhancement,146,79,67
Anime,azralon,1539,shaman,enhancement,48,29,19
Lenin,nathrezim,1538,shaman,enhancement,54,30,24
Small,alleria,1538,shaman,enhancement,60,32,28
Cowely,madoran,1536,shaman,enhancement,48,29,19
Pedaphil,frostmourne,1534,shaman,enhancement,24,16,8
Feesstt,malganis,1534,shaman,enhancement,48,27,21
Shamgødx,dalaran,1533,shaman,enhancement,18,16,2
Kushgodd,kiljaeden,1533,shaman,enhancement,96,53,43
Wishsteen,sargeras,1533,shaman,enhancement,30,16,14
Violat,area-52,1531,shaman,enhancement,18,16,2
Killavicious,area-52,1531,shaman,enhancement,84,39,45
Lohnash,area-52,1530,shaman,enhancement,24,18,6
Tootshock,illidan,1528,shaman,enhancement,60,28,32
Zmogon,quelthalas,1527,shaman,enhancement,71,33,38
Gordonramsai,sargeras,1526,shaman,enhancement,30,21,9
Argena,bonechewer,1523,shaman,enhancement,36,22,14
Soupi,illidan,1521,shaman,enhancement,162,85,77
Grx,tichondrius,1521,shaman,enhancement,56,28,28
Hephron,area-52,1521,shaman,enhancement,96,45,51
Dirtyunique,tichondrius,1519,shaman,enhancement,90,51,39
Töpg,garrosh,1519,shaman,enhancement,64,33,31
Azumaa,tichondrius,1519,shaman,enhancement,60,30,30
Vásh,quelthalas,1517,shaman,enhancement,24,16,8
Yejinok,tichondrius,1517,shaman,enhancement,31,17,14
Dilfmaster,tichondrius,1517,shaman,enhancement,77,40,37
Volsdeep,illidan,1517,shaman,enhancement,82,41,41
Boomershock,stormrage,1516,shaman,enhancement,42,20,22
Ginjij,thrall,1514,shaman,enhancement,30,18,12
Abigdude,frostmourne,1514,shaman,enhancement,179,95,84
Thegil,tichondrius,1514,shaman,enhancement,79,41,38
Balldo,stormrage,1513,shaman,enhancement,36,16,20
Torvi,saurfang,1512,shaman,enhancement,24,16,8
Chungussy,blackrock,1512,shaman,enhancement,35,21,14
Flirstatic,nemesis,1512,shaman,enhancement,135,73,62
Healmeshammy,tichondrius,1511,shaman,enhancement,24,18,6
Atthegates,illidan,1511,shaman,enhancement,240,114,126
Roidzsham,area-52,1509,shaman,enhancement,54,33,21
Daikí,ragnaros,1507,shaman,enhancement,37,21,16
Clenlift,emerald-dream,1506,shaman,enhancement,222,116,106
Slowdown,malganis,1506,shaman,enhancement,36,16,20
Terrible,illidan,1504,shaman,enhancement,78,37,41
Stormblast,stormrage,1503,shaman,enhancement,70,37,33
Elementin,kelthuzad,1503,shaman,enhancement,102,49,53
Zugzugthug,moon-guard,1502,shaman,enhancement,70,40,30
Yildiri,area-52,1501,shaman,enhancement,18,16,2
Larrylardazz,tichondrius,1501,shaman,enhancement,92,54,38
Kronkxd,malganis,1501,shaman,enhancement,30,16,14
Casualsham,illidan,1500,shaman,enhancement,52,33,19
Kandin,icecrown,1498,shaman,enhancement,72,36,36
Lavalavalava,dentarg,1495,shaman,enhancement,36,25,11
Pockethealer,emerald-dream,1494,shaman,enhancement,149,80,69
Qvibin,tichondrius,1493,shaman,enhancement,42,29,13
Earthfirex,ragnaros,1493,shaman,enhancement,48,25,23
Arlikai,arthas,1493,shaman,enhancement,159,71,88
Jummyman,area-52,1492,shaman,enhancement,65,41,24
Shockolatte,sargeras,1492,shaman,enhancement,103,45,58
Quakenbake,emerald-dream,1491,shaman,enhancement,33,20,13
Bòómz,stormrage,1489,shaman,enhancement,394,191,203
Amasaei,bleeding-hollow,1488,shaman,enhancement,72,36,36
Hungnuts,sargeras,1487,shaman,enhancement,124,67,57
Chaposz,tichondrius,1487,shaman,enhancement,103,54,49
Jamieslays,korgath,1487,shaman,enhancement,53,24,29
Volrog,magtheridon,1485,shaman,enhancement,33,17,16
Arázi,wyrmrest-accord,1485,shaman,enhancement,41,16,25
Konga,korialstrasz,1483,shaman,enhancement,38,22,16
Solka,illidan,1483,shaman,enhancement,80,44,36
Saphage,tichondrius,1482,shaman,enhancement,52,27,25
Prymalfury,illidan,1480,shaman,enhancement,126,64,62
Ragnarocck,sargeras,1479,shaman,enhancement,75,36,39
Dashmmy,dalaran,1478,shaman,enhancement,54,26,28
Iamurfather,magtheridon,1477,shaman,enhancement,149,77,72
Sigir,darrowmere,1476,shaman,enhancement,107,58,49
Armønixx,ragnaros,1476,shaman,enhancement,120,65,55
Usul,frostmane,1476,shaman,enhancement,193,102,91
Sâxman,stormreaver,1476,shaman,enhancement,66,32,34
Falasha,bloodscalp,1475,shaman,enhancement,46,27,19
Forloren,zuljin,1475,shaman,enhancement,52,28,24
Killbro,blackrock,1473,shaman,enhancement,241,124,117
Maribain,barthilas,1472,shaman,enhancement,112,65,47
Zere,cenarius,1471,shaman,enhancement,32,23,9
Spacex,velen,1470,shaman,enhancement,42,21,21
Dimitrio,azralon,1469,shaman,enhancement,130,64,66
Deshamann,illidan,1468,shaman,enhancement,126,57,69
Lakindrentv,gorefiend,1467,shaman,enhancement,30,17,13
Manthozshami,ragnaros,1467,shaman,enhancement,36,17,19
Harvesting,azralon,1466,shaman,enhancement,81,41,40
Mackandal,tichondrius,1466,shaman,enhancement,86,43,43
Skyzik,area-52,1465,shaman,enhancement,54,34,20
Makocc,tichondrius,1465,shaman,enhancement,116,55,61
Beaversniper,tichondrius,1465,shaman,enhancement,84,38,46
Woof,agamaggan,1464,shaman,enhancement,30,16,14
Earthlsflat,tichondrius,1463,shaman,enhancement,31,21,10
Daddyzap,stormrage,1462,shaman,enhancement,104,58,46
Doomfury,magtheridon,1461,shaman,enhancement,42,25,17
Lavabone,dalaran,1459,shaman,enhancement,66,28,38
Sndhlp,tichondrius,1457,shaman,enhancement,46,29,17
Stormwolf,emerald-dream,1457,shaman,enhancement,66,39,27
Shoresy,kaelthas,1455,shaman,enhancement,60,30,30
Rhez,frostmourne,1454,shaman,enhancement,54,30,24
Vapus,area-52,1454,shaman,enhancement,154,85,69
Zêus,sargeras,1454,shaman,enhancement,54,29,25
Getacho,stormrage,1454,shaman,enhancement,150,72,78
Sockittooya,bleeding-hollow,1451,shaman,enhancement,90,53,37
Xillas,moon-guard,1451,shaman,enhancement,48,28,20
Scrötotem,saurfang,1450,shaman,enhancement,89,50,39
Lamagra,nemesis,1449,shaman,enhancement,30,19,11
Goribash,wyrmrest-accord,1449,shaman,enhancement,42,26,16
Vanklayser,ragnaros,1449,shaman,enhancement,55,24,31
Zheúz,azralon,1448,shaman,enhancement,68,37,31
Surtel,tichondrius,1448,shaman,enhancement,77,36,41
Calich,kelthuzad,1447,shaman,enhancement,62,35,27
Cram,frostmourne,1447,shaman,enhancement,53,24,29
Spicyballs,coilfang,1446,shaman,enhancement,36,19,17
Odïn,tichondrius,1444,shaman,enhancement,54,33,21
Hyjixtv,stormrage,1444,shaman,enhancement,48,29,19
Beogar,moon-guard,1443,shaman,enhancement,33,19,14
Drakkaa,tichondrius,1439,shaman,enhancement,31,20,11
Cyclrin,sargeras,1439,shaman,enhancement,24,15,9
Sswf,auchindoun,1439,shaman,enhancement,24,15,9
Teeroll,frostmourne,1439,shaman,enhancement,41,25,16
Exsh,area-52,1438,shaman,enhancement,18,15,3
Exxosenh,tichondrius,1438,shaman,enhancement,18,15,3
Tamtam,gorefiend,1438,shaman,enhancement,24,15,9
Seltz,illidan,1438,shaman,enhancement,30,15,15
Nohandslost,tichondrius,1437,shaman,enhancement,43,30,13
Leschaises,skullcrusher,1437,shaman,enhancement,45,30,15
Gundar,chogall,1436,shaman,enhancement,56,31,25
Gluestick,shadowmoon,1436,shaman,enhancement,42,20,22
Tungusk,tichondrius,1435,shaman,enhancement,24,15,9
Däbü,tichondrius,1435,shaman,enhancement,30,15,15
Friednocap,kelthuzad,1435,shaman,enhancement,60,28,32
Blackenergy,stormrage,1434,shaman,enhancement,167,81,86
Wecookin,frostwolf,1433,shaman,enhancement,18,15,3
Vonnsmallpp,area-52,1433,shaman,enhancement,24,15,9
Rojhaz,stormrage,1433,shaman,enhancement,48,28,20
Shlongers,illidan,1433,shaman,enhancement,36,15,21
Djasura,blackhand,1432,shaman,enhancement,59,32,27
Meattoilet,tichondrius,1431,shaman,enhancement,23,16,7
Cuzcuz,tichondrius,1431,shaman,enhancement,24,15,9
Whydead,sargeras,1431,shaman,enhancement,72,40,32
Pahtaklol,tichondrius,1431,shaman,enhancement,30,15,15
Justincasé,sargeras,1431,shaman,enhancement,96,43,53
Froglok,boulderfist,1429,shaman,enhancement,47,25,22
Stubbywayne,area-52,1429,shaman,enhancement,232,117,115
Defiant,azgalor,1429,shaman,enhancement,30,15,15
Shalkahn,malganis,1429,shaman,enhancement,53,22,31
Roz,khaz-modan,1428,shaman,enhancement,18,15,3
Bqo,nemesis,1428,shaman,enhancement,20,16,4
Earfshock,thrall,1428,shaman,enhancement,74,41,33
Daddyzmilk,bleeding-hollow,1428,shaman,enhancement,48,20,28
Tictactotem,stormreaver,1427,shaman,enhancement,66,35,31
Texmawave,moon-guard,1425,shaman,enhancement,24,15,9
Grippysockz,dalaran,1424,shaman,enhancement,24,15,9
Piffenstien,malganis,1424,shaman,enhancement,78,42,36
Monadazs,ragnaros,1423,shaman,enhancement,62,35,27
Drumman,skullcrusher,1423,shaman,enhancement,118,66,52
Kungfuvoodoo,tichondrius,1422,shaman,enhancement,30,17,13
Raazzasham,moon-guard,1422,shaman,enhancement,65,34,31
Silyshamshyt,stormrage,1421,shaman,enhancement,24,15,9
Shamcharles,proudmoore,1421,shaman,enhancement,50,17,33
Tinysha,tichondrius,1420,shaman,enhancement,24,15,9
Tigolbittie,sargeras,1420,shaman,enhancement,66,28,38
Hagie,moon-guard,1419,shaman,enhancement,27,15,12
Joeschno,bleeding-hollow,1419,shaman,enhancement,64,28,36
Wagar,dawnbringer,1419,shaman,enhancement,42,18,24
Brulash,barthilas,1417,shaman,enhancement,78,41,37
Dwightjr,emerald-dream,1417,shaman,enhancement,48,23,25
Shamann,azshara,1416,shaman,enhancement,69,36,33
Shamrockcawk,malganis,1415,shaman,enhancement,54,35,19
Clownshòes,tichondrius,1415,shaman,enhancement,42,26,16
Grendinbal,moon-guard,1415,shaman,enhancement,39,16,23
Mudroller,moon-guard,1414,shaman,enhancement,52,24,28
Thoramgar,malganis,1413,shaman,enhancement,30,16,14
Trashfarmer,tichondrius,1413,shaman,enhancement,132,64,68
Snipyterror,shattered-hand,1410,shaman,enhancement,18,15,3
Zaxibow,area-52,1409,shaman,enhancement,46,21,25
Arque,stormrage,1406,shaman,enhancement,102,60,42
Raylord,ragnaros,1406,shaman,enhancement,131,72,59
Firevag,hakkar,1405,shaman,enhancement,135,73,62
Nankdug,tichondrius,1405,shaman,enhancement,47,25,22
Zzar,daggerspine,1404,shaman,enhancement,42,23,19
Orcshamen,tichondrius,1403,shaman,enhancement,60,35,25
Neyter,azralon,1402,shaman,enhancement,102,63,39
Goonxdz,illidan,1402,shaman,enhancement,63,26,37
Fyahchaming,drakkari,1401,shaman,enhancement,82,46,36
Talfur,area-52,1400,shaman,enhancement,42,23,19
Mairn,tichondrius,1400,shaman,enhancement,120,63,57
Nyxxus,tichondrius,1399,shaman,enhancement,30,19,11
Umbrood,area-52,1398,shaman,enhancement,98,53,45
Blasho,ragnaros,1398,shaman,enhancement,162,79,83
Globad,tichondrius,1397,shaman,enhancement,42,18,24
Chiëfslapaho,tichondrius,1395,shaman,enhancement,29,20,9
Tamzlol,the-forgotten-coast,1395,shaman,enhancement,54,30,24
Djelemental,darkspear,1394,shaman,enhancement,27,17,10
Mortzor,frostmourne,1392,shaman,enhancement,47,28,19
Zaboomafoo,emerald-dream,1392,shaman,enhancement,87,46,41
Nuofu,illidan,1392,shaman,enhancement,34,17,17
Stickysham,illidan,1391,shaman,enhancement,42,26,16
Dashinra,stormrage,1391,shaman,enhancement,38,20,18
Bigtotempole,stormreaver,1390,shaman,enhancement,66,37,29
Orcmanshamn,moon-guard,1390,shaman,enhancement,104,53,51
Groundfaults,bleeding-hollow,1389,shaman,enhancement,35,15,20
Shipmatekev,sargeras,1386,shaman,enhancement,54,29,25
Zktz,warsong,1385,shaman,enhancement,31,17,14
Lüca,wyrmrest-accord,1382,shaman,enhancement,241,123,118
Hvalleyranch,area-52,1381,shaman,enhancement,71,32,39
Rhass,ragnaros,1380,shaman,enhancement,72,34,38
Shampainn,demon-soul,1379,shaman,enhancement,50,24,26
Burrst,thrall,1378,shaman,enhancement,30,17,13
Stïtch,area-52,1378,shaman,enhancement,80,42,38
Katojune,tichondrius,1378,shaman,enhancement,34,16,18
Têach,ragnaros,1376,shaman,enhancement,24,15,9
Tyzek,illidan,1375,shaman,enhancement,42,26,16
Zute,frostmourne,1375,shaman,enhancement,91,52,39
Gettatotem,frostmourne,1373,shaman,enhancement,30,17,13
Hagarr,azralon,1372,shaman,enhancement,42,21,21
Mybadshawty,tichondrius,1370,shaman,enhancement,78,36,42
Ventus,thrall,1366,shaman,enhancement,78,35,43
Tigtotem,malganis,1365,shaman,enhancement,24,16,8
Cvoa,bonechewer,1364,shaman,enhancement,30,16,14
Nìke,nazgrel,1364,shaman,enhancement,47,21,26
Killercam,maiev,1363,shaman,enhancement,40,19,21
Psilocypher,nazjatar,1362,shaman,enhancement,42,28,14
Grohltusk,barthilas,1360,shaman,enhancement,42,24,18
Beardcramps,tichondrius,1358,shaman,enhancement,99,44,55
Johnwilke,area-52,1356,shaman,enhancement,119,59,60
Murlook,sargeras,1354,shaman,enhancement,67,44,23
Mëister,stormrage,1354,shaman,enhancement,149,76,73
Brreeaadd,tichondrius,1354,shaman,enhancement,57,25,32
Isbabani,moon-guard,1353,shaman,enhancement,30,16,14
Slaughterdog,coilfang,1348,shaman,enhancement,28,17,11
Shamwickk,tichondrius,1348,shaman,enhancement,96,54,42
Clumpen,thunderhorn,1347,shaman,enhancement,59,32,27
Bessame,sargeras,1346,shaman,enhancement,94,48,46
Tumble,barthilas,1344,shaman,enhancement,24,16,8
Borwald,dalaran,1344,shaman,enhancement,154,78,76
Tsaheylu,barthilas,1343,shaman,enhancement,54,25,29
Døømwinds,tichondrius,1342,shaman,enhancement,24,14,10
Deathjoker,icecrown,1342,shaman,enhancement,78,43,35
Singingtotem,bonechewer,1341,shaman,enhancement,29,20,9
Magmao,quelthalas,1341,shaman,enhancement,71,43,28
Thorodinsson,proudmoore,1341,shaman,enhancement,79,35,44
Corkrain,sargeras,1341,shaman,enhancement,36,15,21
Crøwgød,tichondrius,1340,shaman,enhancement,24,14,10
Trenbolone,maiev,1340,shaman,enhancement,89,51,38
Gaelfury,malganis,1339,shaman,enhancement,54,24,30
Derzwaz,draka,1338,shaman,enhancement,77,35,42
Stormgraves,moon-guard,1337,shaman,enhancement,24,14,10
Leaning,wyrmrest-accord,1335,shaman,enhancement,24,14,10
Electabuzz,arygos,1335,shaman,enhancement,30,15,15
Vlackz,quelthalas,1334,shaman,enhancement,42,22,20
Baloneyfiveo,kiljaeden,1333,shaman,enhancement,74,41,33
Kamíhameha,stormrage,1333,shaman,enhancement,128,66,62
Kulnash,auchindoun,1332,shaman,enhancement,40,24,16
Aldinatir,ragnaros,1332,shaman,enhancement,24,14,10
Dugomik,malganis,1332,shaman,enhancement,118,59,59
Tizzl,kelthuzad,1332,shaman,enhancement,78,39,39
Mumbo,malfurion,1331,shaman,enhancement,24,14,10
Chapope,quelthalas,1329,shaman,enhancement,46,30,16
Raijû,illidan,1329,shaman,enhancement,24,14,10
Niteshammy,lothar,1328,shaman,enhancement,24,14,10
Shomminn,tichondrius,1328,shaman,enhancement,36,19,17
Ieeguen,tichondrius,1328,shaman,enhancement,30,14,16
Hagass,tichondrius,1328,shaman,enhancement,61,28,33
Lazygemini,illidan,1327,shaman,enhancement,84,42,42
Zügz,illidan,1326,shaman,enhancement,61,34,27
Volcanoboxer,tichondrius,1325,shaman,enhancement,21,14,7
Doomdon,area-52,1325,shaman,enhancement,109,50,59
Winiethepoöh,stormrage,1325,shaman,enhancement,36,14,22
Doomvin,stormrage,1324,shaman,enhancement,54,29,25
Sasori,stormrage,1323,shaman,enhancement,54,35,19
Leotis,tichondrius,1323,shaman,enhancement,24,14,10
Floon,barthilas,1322,shaman,enhancement,103,52,51
Whichdoctah,proudmoore,1322,shaman,enhancement,33,16,17
Painfury,zuljin,1321,shaman,enhancement,27,15,12
Xapoxy,nemesis,1320,shaman,enhancement,26,17,9
Dontbeshockd,nagrand,1320,shaman,enhancement,26,14,12
Sleekish,moon-guard,1319,shaman,enhancement,30,14,16
Shawkedu,tichondrius,1317,shaman,enhancement,36,16,20
Canabal,eonar,1315,shaman,enhancement,24,14,10
Mustachex,kelthuzad,1315,shaman,enhancement,24,14,10
Totesmagotes,scilla,1314,shaman,enhancement,36,22,14
Montí,moon-guard,1314,shaman,enhancement,101,59,42
Argrax,sargeras,1314,shaman,enhancement,71,41,30
Rokogg,thrall,1312,shaman,enhancement,133,69,64
Naesala,thunderlord,1312,shaman,enhancement,30,14,16
Shamorrhoids,frostmourne,1311,shaman,enhancement,118,62,56
Popz,dark-iron,1309,shaman,enhancement,69,39,30
Ffaísca,azralon,1308,shaman,enhancement,36,20,16
Shøxic,perenolde,1307,shaman,enhancement,36,23,13
Vöödooranger,stormrage,1305,shaman,enhancement,24,14,10
Emelectric,quelthalas,1304,shaman,enhancement,66,31,35
Tabellarium,tichondrius,1303,shaman,enhancement,36,21,15
Atroll,moonrunner,1302,shaman,enhancement,72,32,40
Cbomberz,tichondrius,1301,shaman,enhancement,85,42,43
Pumpz,magtheridon,1301,shaman,enhancement,30,14,16
Yâmz,area-52,1301,shaman,enhancement,81,37,44
Lightnessx,stormrage,1301,shaman,enhancement,42,17,25
Microwavbakn,emerald-dream,1300,shaman,enhancement,70,38,32
Astrò,illidan,1299,shaman,enhancement,18,14,4
Iamegirl,moon-guard,1298,shaman,enhancement,54,26,28
Triní,ragnaros,1296,shaman,enhancement,69,40,29
Rongkhan,tichondrius,1296,shaman,enhancement,41,23,18
Shrektar,cenarius,1296,shaman,enhancement,48,21,27
Fireclaws,bleeding-hollow,1290,shaman,enhancement,67,34,33
Tarresh,azralon,1289,shaman,enhancement,54,26,28
Obeilius,illidan,1288,shaman,enhancement,67,34,33
Neyavv,tichondrius,1286,shaman,enhancement,354,173,181
Dàfèng,wyrmrest-accord,1286,shaman,enhancement,41,14,27
Jackofstorms,veknilash,1285,shaman,enhancement,56,25,31
Bobaflexqt,korgath,1279,shaman,enhancement,24,15,9
Prasu,spirestone,1279,shaman,enhancement,90,39,51
Holosoul,bleeding-hollow,1279,shaman,enhancement,79,34,45
Hanhze,quelthalas,1278,shaman,enhancement,109,61,48
Shamtopus,anubarak,1277,shaman,enhancement,71,30,41
Vanmaichet,azshara,1276,shaman,enhancement,29,14,15
Parallels,blackrock,1275,shaman,enhancement,112,54,58
Zerium,nemesis,1274,shaman,enhancement,42,25,17
Zechary,proudmoore,1273,shaman,enhancement,54,33,21
Goullin,dalaran,1273,shaman,enhancement,24,14,10
Flaméy,stormrage,1273,shaman,enhancement,51,21,30
Shomani,madoran,1272,shaman,enhancement,77,32,45
Kigorami,nerzhul,1271,shaman,enhancement,42,21,21
Thorlottie,stormrage,1269,shaman,enhancement,30,15,15
Majhrakova,stormrage,1266,shaman,enhancement,30,15,15
Popsmoke,gnomeregan,1265,shaman,enhancement,23,14,9
Datblueboi,dalaran,1263,shaman,enhancement,76,39,37
Dì,barthilas,1262,shaman,enhancement,30,19,11
Jonatasele,stormrage,1261,shaman,enhancement,36,14,22
Gorebog,feathermoon,1259,shaman,enhancement,42,23,19
Obrahma,burning-legion,1258,shaman,enhancement,24,16,8
Crigga,dalaran,1254,shaman,enhancement,30,14,16
Lerajje,tichondrius,1251,shaman,enhancement,42,22,20
Extraguacpls,tichondrius,1249,shaman,enhancement,23,14,9
Allmeatie,hyjal,1248,shaman,enhancement,36,21,15
Guybeingdude,sargeras,1246,shaman,enhancement,18,13,5
Hexoffnder,zuljin,1246,shaman,enhancement,18,13,5
Lizardhusk,barthilas,1246,shaman,enhancement,24,13,11
Ftp,kelthuzad,1246,shaman,enhancement,24,13,11
Care,silvermoon,1245,shaman,enhancement,18,13,5
Arckos,thrall,1245,shaman,enhancement,24,13,11
Doitclap,stormrage,1243,shaman,enhancement,18,15,3
Zêûs,moon-guard,1240,shaman,enhancement,24,13,11
Dalthragoz,tichondrius,1239,shaman,enhancement,24,13,11
Dreamers,anvilmar,1239,shaman,enhancement,24,13,11
Dylangs,frostmourne,1238,shaman,enhancement,24,13,11
Dalsun,turalyon,1237,shaman,enhancement,30,13,17
Shokaria,frostwolf,1237,shaman,enhancement,35,14,21
Evidence,thrall,1236,shaman,enhancement,24,13,11
Forgediniron,stormrage,1236,shaman,enhancement,67,32,35
Jags,baelgun,1235,shaman,enhancement,24,13,11
Eze,tichondrius,1234,shaman,enhancement,64,36,28
Stankydad,tichondrius,1234,shaman,enhancement,24,13,11
Zugxo,area-52,1233,shaman,enhancement,20,15,5
Vozs,proudmoore,1233,shaman,enhancement,60,34,26
Twansom,tichondrius,1233,shaman,enhancement,66,35,31
Thromir,blackwing-lair,1233,shaman,enhancement,48,22,26
Killamanjaro,alterac-mountains,1232,shaman,enhancement,24,13,11
Willy,icecrown,1230,shaman,enhancement,23,13,10
Pandashamnda,area-52,1230,shaman,enhancement,70,35,35
Rikswordfire,wyrmrest-accord,1230,shaman,enhancement,53,24,29
Shamikkazee,illidan,1228,shaman,enhancement,67,36,31
Aiyinsitan,illidan,1227,shaman,enhancement,30,13,17
Drahlos,tichondrius,1227,shaman,enhancement,30,13,17
Shamgoddam,illidan,1225,shaman,enhancement,58,24,34
Shawhammy,illidan,1225,shaman,enhancement,48,19,29
Uglykunt,barthilas,1224,shaman,enhancement,111,62,49
Bhaelfury,moon-guard,1224,shaman,enhancement,36,20,16
Netherfury,illidan,1224,shaman,enhancement,51,28,23
Shamantwo,windrunner,1223,shaman,enhancement,24,13,11
Vectos,bleeding-hollow,1222,shaman,enhancement,18,14,4
Súrtr,sargeras,1221,shaman,enhancement,24,13,11
Gdiafplox,thunderhorn,1220,shaman,enhancement,66,34,32
Hordeymaori,jubeithos,1219,shaman,enhancement,187,99,88
Kasukaga,shadowmoon,1219,shaman,enhancement,102,46,56
Mullten,sargeras,1219,shaman,enhancement,36,15,21
Lilpump,boulderfist,1217,shaman,enhancement,72,36,36
Hammeredd,hyjal,1212,shaman,enhancement,36,18,18
Keytürnz,frostmourne,1211,shaman,enhancement,84,39,45
Pained,arathor,1206,shaman,enhancement,24,15,9
Hroth,tanaris,1206,shaman,enhancement,30,13,17
Lutheran,dragonmaw,1200,shaman,enhancement,47,21,26
Sinsar,illidan,1200,shaman,enhancement,35,13,22
Drokán,ragnaros,1199,shaman,enhancement,80,36,44
Githealed,kelthuzad,1197,shaman,enhancement,37,17,20
Xiano,wyrmrest-accord,1188,shaman,enhancement,29,15,14
Shometrin,tichondrius,1187,shaman,enhancement,65,25,40
Lukora,stonemaul,1186,shaman,enhancement,24,14,10
Lavitris,proudmoore,1183,shaman,enhancement,17,13,4
Djshammy,barthilas,1183,shaman,enhancement,28,15,13
Oreahsham,tichondrius,1183,shaman,enhancement,36,15,21
Amärök,area-52,1181,shaman,enhancement,62,26,36
ßigðåddy,ghostlands,1179,shaman,enhancement,60,19,41
Epictotem,tichondrius,1177,shaman,enhancement,22,13,9
Spiderjohn,sargeras,1177,shaman,enhancement,42,23,19
Tirtok,laughing-skull,1177,shaman,enhancement,65,29,36
Ezpzprime,bloodscalp,1176,shaman,enhancement,20,14,6
Enhancementz,azralon,1174,shaman,enhancement,68,37,31
Slowgrath,burning-legion,1171,shaman,enhancement,57,30,27
Litchuckie,thrall,1169,shaman,enhancement,46,25,21
Beanerburst,frostwolf,1167,shaman,enhancement,60,33,27
Yelpreviewer,dalaran,1164,shaman,enhancement,29,14,15
Finnaburstt,tichondrius,1162,shaman,enhancement,54,29,25
Roguemagewar,tichondrius,1159,shaman,enhancement,35,15,20
Ashida,stormrage,1157,shaman,enhancement,49,26,23
Cydarta,ragnaros,1156,shaman,enhancement,72,41,31
Splendapapi,stormrage,1155,shaman,enhancement,38,13,25
Gangmember,shadowmoon,1152,shaman,enhancement,18,12,6
Deixw,tichondrius,1151,shaman,enhancement,18,12,6
Anasyed,emerald-dream,1151,shaman,enhancement,18,12,6
Jinxicle,illidan,1151,shaman,enhancement,18,12,6
Scrib,dawnbringer,1151,shaman,enhancement,18,12,6
Plebshammy,bleeding-hollow,1151,shaman,enhancement,18,12,6
Purgegodryuu,area-52,1151,shaman,enhancement,24,12,12
Nyknicks,tichondrius,1150,shaman,enhancement,18,12,6
Dialtone,blackrock,1150,shaman,enhancement,30,12,18
Angrymán,ragnaros,1149,shaman,enhancement,12,12,0
Durkh,ragnaros,1149,shaman,enhancement,18,12,6
Rainjig,emerald-dream,1149,shaman,enhancement,21,12,9
Taò,tichondrius,1149,shaman,enhancement,117,54,63
Shiggy,emerald-dream,1148,shaman,enhancement,24,12,12
Lassoway,illidan,1148,shaman,enhancement,36,13,23
Ahwahsahdood,stormreaver,1147,shaman,enhancement,24,12,12
Shambergler,tichondrius,1147,shaman,enhancement,24,12,12
Stoneseed,steamwheedle-cartel,1147,shaman,enhancement,30,12,18
Zèus,draka,1146,shaman,enhancement,24,12,12
Hexondabeach,barthilas,1145,shaman,enhancement,18,12,6
Tosil,tichondrius,1144,shaman,enhancement,24,12,12
Tiostroke,stormrage,1144,shaman,enhancement,24,12,12
Igarmaul,bonechewer,1143,shaman,enhancement,24,12,12
Saraguthix,dalaran,1141,shaman,enhancement,18,12,6
Fourstorms,gundrak,1141,shaman,enhancement,37,19,18
Thorre,the-scryers,1140,shaman,enhancement,42,24,18
Gonarosh,area-52,1139,shaman,enhancement,18,12,6
Vokxulsin,tichondrius,1139,shaman,enhancement,30,12,18
Sydstorm,frostmourne,1137,shaman,enhancement,18,12,6
Scams,bleeding-hollow,1136,shaman,enhancement,48,30,18
Rogorof,area-52,1126,shaman,enhancement,24,12,12
ßøn,altar-of-storms,1125,shaman,enhancement,33,16,17
Astroglyde,emerald-dream,1123,shaman,enhancement,24,12,12
Camdoc,destromath,1122,shaman,enhancement,53,24,29
Skizzymars,malganis,1120,shaman,enhancement,30,12,18
Ryb,sargeras,1119,shaman,enhancement,20,13,7
Googurt,barthilas,1118,shaman,enhancement,23,12,11
Drokron,azralon,1118,shaman,enhancement,54,26,28
Catiçero,azralon,1117,shaman,enhancement,30,12,18
Onezap,trollbane,1116,shaman,enhancement,61,23,38
Schlemiel,barthilas,1112,shaman,enhancement,82,36,46
Cseril,bonechewer,1110,shaman,enhancement,95,53,42
Golkork,quelthalas,1108,shaman,enhancement,24,13,11
Blaçktide,thrall,1104,shaman,enhancement,26,16,10
Shaminism,chromaggus,1103,shaman,enhancement,23,12,11
Wigwog,hyjal,1102,shaman,enhancement,61,35,26
Zalkran,area-52,1101,shaman,enhancement,30,20,10
Shammybreakx,malganis,1097,shaman,enhancement,80,47,33
Robis,thrall,1096,shaman,enhancement,90,39,51
Ahzar,stormrage,1093,shaman,enhancement,60,26,34
Hazak,nemesis,1088,shaman,enhancement,78,39,39
Fiercegoblin,drakkari,1082,shaman,enhancement,37,15,22
Karlpoppa,thunderhorn,1081,shaman,enhancement,36,20,16
Kalashnikov,maiev,1081,shaman,enhancement,36,14,22
Bluëwafflë,tichondrius,1080,shaman,enhancement,49,22,27
Nîghtstalker,vashj,1079,shaman,enhancement,73,30,43
Bigbólts,emerald-dream,1077,shaman,enhancement,26,14,12
Eléctro,tichondrius,1075,shaman,enhancement,52,21,31
Shayymann,exodar,1072,shaman,enhancement,66,30,36
Pùffball,anvilmar,1064,shaman,enhancement,81,43,38
Lovetides,area-52,1060,shaman,enhancement,30,18,12
Bloodytotemz,emerald-dream,1060,shaman,enhancement,30,13,17
Tekashi,muradin,1060,shaman,enhancement,31,12,19
Okïòmó,proudmoore,1056,shaman,enhancement,18,11,7
Gamergirlx,area-52,1056,shaman,enhancement,18,11,7
Jyster,area-52,1056,shaman,enhancement,71,30,41
Shambostik,thrall,1056,shaman,enhancement,36,13,23
Megaraccoon,illidan,1055,shaman,enhancement,12,11,1
Shamawolf,stormrage,1055,shaman,enhancement,12,11,1
Blöw,tichondrius,1055,shaman,enhancement,18,11,7
Zelinsky,sargeras,1055,shaman,enhancement,18,11,7
Bigboorst,tichondrius,1055,shaman,enhancement,18,11,7
Rokudo,dragonmaw,1055,shaman,enhancement,18,11,7
Jayes,zuljin,1055,shaman,enhancement,18,11,7
Shampowl,jaedenar,1055,shaman,enhancement,30,11,19
Möuthbläster,malganis,1054,shaman,enhancement,12,11,1
Syraak,elune,1054,shaman,enhancement,15,12,3
Totemclass,bleeding-hollow,1054,shaman,enhancement,18,11,7
Kyrz,ragnaros,1054,shaman,enhancement,18,11,7
Fishsham,zuljin,1054,shaman,enhancement,18,11,7
Ctrlaltelite,burning-blade,1054,shaman,enhancement,88,37,51
Ellynnu,frostmourne,1054,shaman,enhancement,36,15,21
Aceventuura,hyjal,1053,shaman,enhancement,24,11,13
Kassper,tichondrius,1053,shaman,enhancement,24,11,13
Windzorn,tichondrius,1052,shaman,enhancement,18,11,7
Xamaobomberø,azralon,1052,shaman,enhancement,18,11,7
Peepingtotem,tichondrius,1052,shaman,enhancement,24,11,13
Buffdudé,illidan,1052,shaman,enhancement,24,11,13
Kuull,thunderlord,1052,shaman,enhancement,30,11,19
Faminex,dragonmaw,1051,shaman,enhancement,12,11,1
Swapxylee,tichondrius,1051,shaman,enhancement,24,11,13
Mugiwärä,area-52,1050,shaman,enhancement,24,11,13
Dronesum,tichondrius,1050,shaman,enhancement,24,11,13
Sparkqt,sargeras,1047,shaman,enhancement,18,11,7
Grindl,stormrage,1047,shaman,enhancement,18,11,7
Emptyy,azralon,1047,shaman,enhancement,24,11,13
Johnnygeh,stormrage,1047,shaman,enhancement,30,11,19
Argues,tichondrius,1046,shaman,enhancement,18,11,7
Îvôry,bloodhoof,1046,shaman,enhancement,24,11,13
Dedlystorm,dalaran,1043,shaman,enhancement,24,15,9
Jamblee,sargeras,1043,shaman,enhancement,18,11,7
Trulos,stormrage,1041,shaman,enhancement,18,11,7
Thunderfuri,thrall,1037,shaman,enhancement,18,11,7
Hannibol,tichondrius,1036,shaman,enhancement,72,25,47
Zandya,nemesis,1029,shaman,enhancement,54,22,32
Dilldoughnut,sargeras,1024,shaman,enhancement,23,11,12
Grimlên,skullcrusher,1024,shaman,enhancement,44,16,28
Dizzytotem,dalaran,1022,shaman,enhancement,35,20,15
Zatchbell,lightnings-blade,1021,shaman,enhancement,42,21,21
Morderus,aegwynn,1021,shaman,enhancement,24,11,13
Tøtëm,tichondrius,1021,shaman,enhancement,28,12,16
Radan,kelthuzad,1020,shaman,enhancement,23,11,12
Facebooksux,sargeras,1019,shaman,enhancement,18,13,5
Rhagnar,warsong,1004,shaman,enhancement,17,11,6
PlayerJRRTZR,tichondrius,1002,shaman,enhancement,23,11,12
Stroheim,warsong,1000,shaman,enhancement,21,12,9
Poseidonxd,lightbringer,1000,shaman,enhancement,23,13,10
Korgen,area-52,999,shaman,enhancement,25,12,13
Prinkipíssa,tichondrius,995,shaman,enhancement,48,22,26
Reavs,illidan,995,shaman,enhancement,40,12,28
Felbrick,area-52,994,shaman,enhancement,42,20,22
Synshenrongt,thrall,990,shaman,enhancement,178,70,108
Zelzus,moon-guard,989,shaman,enhancement,22,11,11
Megumi,aggramar,988,shaman,enhancement,26,11,15
Deckìn,proudmoore,987,shaman,enhancement,14,11,3
Ayangat,darkspear,987,shaman,enhancement,16,11,5
Thorael,borean-tundra,985,shaman,enhancement,17,11,6
Wälee,sargeras,981,shaman,enhancement,48,25,23
Shamvandám,kiljaeden,978,shaman,enhancement,30,13,17
Svddëndëath,sargeras,978,shaman,enhancement,97,38,59
Gbankzz,ghostlands,978,shaman,enhancement,52,19,33
Stormwolf,azjolnerub,976,shaman,enhancement,60,30,30
Kyness,area-52,975,shaman,enhancement,42,23,19
Enhance,sargeras,960,shaman,enhancement,18,10,8
Goldshîre,tichondrius,960,shaman,enhancement,18,10,8
Mudpwet,borean-tundra,960,shaman,enhancement,78,41,37
Lokrath,zangarmarsh,959,shaman,enhancement,12,10,2
Pikachil,tichondrius,959,shaman,enhancement,15,11,4
Anlukla,gilneas,959,shaman,enhancement,18,10,8
Electrik,stormrage,959,shaman,enhancement,18,10,8
Kumboi,frostmourne,959,shaman,enhancement,24,10,14
Thorni,nagrand,958,shaman,enhancement,12,10,2
Meadamemnon,tichondrius,958,shaman,enhancement,12,10,2
Ambevsulfr,deathwing,958,shaman,enhancement,12,10,2
Kelce,stormrage,958,shaman,enhancement,18,10,8
Ggsggs,akama,958,shaman,enhancement,18,10,8
Gohsham,hyjal,958,shaman,enhancement,18,10,8
Marginalized,tichondrius,958,shaman,enhancement,18,10,8
Harbert,black-dragonflight,958,shaman,enhancement,18,10,8
Jimorrison,wyrmrest-accord,958,shaman,enhancement,18,10,8
Chesos,tichondrius,958,shaman,enhancement,90,33,57
Chavezlives,area-52,957,shaman,enhancement,18,10,8
Suejitsue,malganis,957,shaman,enhancement,24,10,14
Claymoore,nemesis,957,shaman,enhancement,24,10,14
Keroh,blackrock,956,shaman,enhancement,18,10,8
Azl,guldan,956,shaman,enhancement,27,11,16
Tukkutz,moon-guard,955,shaman,enhancement,48,19,29
Smokedemtree,stormrage,954,shaman,enhancement,18,10,8
Garshok,tichondrius,954,shaman,enhancement,18,10,8
Aelpian,emerald-dream,954,shaman,enhancement,18,10,8
Ryntyntyn,blood-furnace,954,shaman,enhancement,24,10,14
Lavaman,kiljaeden,954,shaman,enhancement,24,10,14
Mcgraff,frostmourne,949,shaman,enhancement,18,10,8
Zeebouzy,illidan,948,shaman,enhancement,27,11,16
Loec,thrall,947,shaman,enhancement,18,10,8
Miane,tichondrius,947,shaman,enhancement,24,10,14
Nokrosao,aegwynn,947,shaman,enhancement,24,10,14
Motylek,ragnaros,946,shaman,enhancement,24,10,14
Esko,magtheridon,943,shaman,enhancement,24,10,14
Warani,ragnaros,935,shaman,enhancement,25,10,15
Thanwirn,ragnaros,932,shaman,enhancement,42,19,23
Zorieks,wyrmrest-accord,928,shaman,enhancement,23,10,13
Orfelix,nemesis,925,shaman,enhancement,42,17,25
Charr,nemesis,924,shaman,enhancement,24,11,13
Golozok,zuljin,923,shaman,enhancement,22,12,10
Gammacide,sargeras,921,shaman,enhancement,29,10,19
Cakeclapper,nerzhul,918,shaman,enhancement,23,10,13
Karisaatara,moon-guard,914,shaman,enhancement,27,11,16
Oct,thrall,912,shaman,enhancement,36,18,18
Shockshack,illidan,911,shaman,enhancement,17,10,7
Duality,shattered-halls,909,shaman,enhancement,23,10,13
Garabashi,boulderfist,908,shaman,enhancement,24,11,13
Ongruge,hyjal,904,shaman,enhancement,97,42,55
Srgarrobo,drakkari,903,shaman,enhancement,42,22,20
Thanen,the-scryers,897,shaman,enhancement,48,21,27
Icedogg,malganis,889,shaman,enhancement,42,20,22
Lobovulpino,quelthalas,880,shaman,enhancement,41,17,24
Poagrious,bonechewer,876,shaman,enhancement,40,17,23
Vekku,ragnaros,872,shaman,enhancement,19,10,9
Elefusion,sargeras,864,shaman,enhancement,12,9,3
Conorfotm,tichondrius,864,shaman,enhancement,12,9,3
Mílkthis,tichondrius,864,shaman,enhancement,12,9,3
Zeroshears,tichondrius,864,shaman,enhancement,12,9,3
Shakazz,malganis,864,shaman,enhancement,12,9,3
Frantìk,tichondrius,864,shaman,enhancement,12,9,3
Kaandel,nemesis,864,shaman,enhancement,12,9,3
Twotapped,sargeras,864,shaman,enhancement,12,9,3
Solbis,tichondrius,864,shaman,enhancement,12,9,3
Raídyn,sargeras,864,shaman,enhancement,12,9,3
Luluzada,azralon,864,shaman,enhancement,18,9,9
Gódsgíft,tichondrius,864,shaman,enhancement,18,9,9
Sethbrogen,vashj,864,shaman,enhancement,24,9,15
Dano,frostwolf,864,shaman,enhancement,30,9,21
Crnosham,area-52,863,shaman,enhancement,12,9,3
Lickerman,stormreaver,863,shaman,enhancement,12,9,3
Swaggitto,illidan,863,shaman,enhancement,12,9,3
Cluffatty,tichondrius,863,shaman,enhancement,12,9,3
Biggem,nazjatar,863,shaman,enhancement,18,9,9
Gamba,kargath,863,shaman,enhancement,18,9,9
Sluggox,bleeding-hollow,863,shaman,enhancement,18,9,9
Flukz,nazjatar,863,shaman,enhancement,18,9,9
Rubious,cenarius,863,shaman,enhancement,19,9,10
Cannonshot,tichondrius,863,shaman,enhancement,24,9,15
Yudo,stormrage,863,shaman,enhancement,30,9,21
Okkoto,malfurion,862,shaman,enhancement,12,9,3
Arrok,bleeding-hollow,862,shaman,enhancement,12,9,3
Kakiscala,proudmoore,862,shaman,enhancement,17,9,8
Ârcanjo,azralon,862,shaman,enhancement,18,9,9
Tótemicotl,quelthalas,862,shaman,enhancement,18,9,9
Murdokr,quelthalas,862,shaman,enhancement,18,9,9
Bioshocked,korgath,862,shaman,enhancement,18,9,9
Kass,area-52,862,shaman,enhancement,18,9,9
Bjôrn,bonechewer,862,shaman,enhancement,18,9,9
Kelx,stormreaver,862,shaman,enhancement,36,9,27
Gorgrom,thunderlord,861,shaman,enhancement,12,9,3
Bargen,thunderlord,860,shaman,enhancement,12,9,3
Hoann,tichondrius,860,shaman,enhancement,18,9,9
Shocksqt,malganis,860,shaman,enhancement,24,9,15
Fevolution,dreadmaul,859,shaman,enhancement,18,9,9
Schnellhund,tichondrius,859,shaman,enhancement,18,9,9
Bôjack,stormrage,858,shaman,enhancement,12,9,3
Denki,nesingwary,858,shaman,enhancement,18,9,9
Zentius,thunderhorn,858,shaman,enhancement,26,9,17
Hazorele,nagrand,857,shaman,enhancement,18,9,9
Drewshammy,zuljin,856,shaman,enhancement,18,9,9
Hexoffénder,tichondrius,855,shaman,enhancement,15,10,5
Mydus,kiljaeden,855,shaman,enhancement,18,9,9
Bwandamian,emerald-dream,855,shaman,enhancement,24,9,15
Bilbobaggenz,sargeras,854,shaman,enhancement,18,9,9
Windfuryshm,emerald-dream,853,shaman,enhancement,18,9,9
Cdont,zuljin,853,shaman,enhancement,18,9,9
Eternalife,khazgoroth,853,shaman,enhancement,24,9,15
Halajo,thrall,849,shaman,enhancement,27,10,17
Catchclause,eonar,846,shaman,enhancement,18,10,8
Ugaboogah,thrall,845,shaman,enhancement,18,9,9
Blackshami,quelthalas,840,shaman,enhancement,42,19,23
Grosgars,burning-blade,830,shaman,enhancement,20,10,10
Trickytotems,stormrage,829,shaman,enhancement,28,9,19
Relyts,tichondrius,825,shaman,enhancement,24,11,13
Britisy,stormrage,825,shaman,enhancement,24,10,14
Sharmut,bleeding-hollow,816,shaman,enhancement,21,10,11
Elementalqti,frostmourne,815,shaman,enhancement,11,9,2
Columan,frostmourne,815,shaman,enhancement,162,80,82
Noveske,arthas,810,shaman,enhancement,21,10,11
Azzula,tichondrius,809,shaman,enhancement,25,10,15
Maicer,goldrinn,809,shaman,enhancement,35,9,26
Gesundrian,kelthuzad,800,shaman,enhancement,16,9,7
Notglads,thrall,799,shaman,enhancement,14,9,5
Tsuchekk,tichondrius,782,shaman,enhancement,23,10,13
Slumb,stormrage,781,shaman,enhancement,19,9,10
Xaryu,shuhalo,779,shaman,enhancement,20,9,11
Plznostepmom,tichondrius,768,shaman,enhancement,12,8,4
Còsmos,illidan,768,shaman,enhancement,12,8,4
Humiliated,stormrage,768,shaman,enhancement,12,8,4
Mazaar,kul-tiras,768,shaman,enhancement,12,8,4
Ennoku,khadgar,768,shaman,enhancement,12,8,4
Botu,malorne,768,shaman,enhancement,12,8,4
Jelebeans,tichondrius,768,shaman,enhancement,12,8,4
Zemz,nazjatar,768,shaman,enhancement,12,8,4
Illchayqt,frostmourne,768,shaman,enhancement,12,8,4
Cinderfury,magtheridon,768,shaman,enhancement,12,8,4
Jamz,lightbringer,768,shaman,enhancement,12,8,4
Newele,thrall,768,shaman,enhancement,18,8,10
Jungsa,tichondrius,768,shaman,enhancement,18,8,10
Neeman,malganis,768,shaman,enhancement,18,8,10
Mastrioni,dragonmaw,768,shaman,enhancement,18,8,10
Lungsha,tichondrius,768,shaman,enhancement,18,8,10
Lindsanx,illidan,768,shaman,enhancement,18,8,10
Muyg,staghelm,768,shaman,enhancement,24,8,16
Barrakum,darrowmere,767,shaman,enhancement,12,8,4
Troon,lightbringer,767,shaman,enhancement,12,8,4
Elevatezxo,stormrage,767,shaman,enhancement,12,8,4
Zunjix,tichondrius,767,shaman,enhancement,12,8,4
Nekorii,bleeding-hollow,767,shaman,enhancement,12,8,4
Indaka,kiljaeden,767,shaman,enhancement,18,8,10
Beast,mannoroth,767,shaman,enhancement,18,8,10
Shockfreak,stormrage,767,shaman,enhancement,18,8,10
Lamorandrict,icecrown,767,shaman,enhancement,18,8,10
Loliqueenfae,illidan,767,shaman,enhancement,18,8,10
Doughchino,darkspear,767,shaman,enhancement,18,8,10
Wæver,tichondrius,767,shaman,enhancement,18,8,10
Finaplex,spirestone,767,shaman,enhancement,18,8,10
Cuban,kelthuzad,767,shaman,enhancement,24,8,16
Aerôv,area-52,767,shaman,enhancement,24,8,16
Cutedraenei,destromath,767,shaman,enhancement,24,8,16
Reptimus,sargeras,767,shaman,enhancement,24,8,16
Mcumshot,ragnaros,767,shaman,enhancement,30,8,22
Pipers,frostmourne,767,shaman,enhancement,31,8,23
Chamxz,ragnaros,766,shaman,enhancement,12,8,4
Xhenra,proudmoore,766,shaman,enhancement,12,8,4
Hornyratchet,bleeding-hollow,766,shaman,enhancement,18,8,10
Adhdeeznuts,frostmourne,766,shaman,enhancement,18,8,10
Weatherboy,dalaran,765,shaman,enhancement,18,8,10
Beul,wyrmrest-accord,764,shaman,enhancement,18,8,10
Shaminja,kiljaeden,763,shaman,enhancement,12,8,4
Meatballman,malganis,763,shaman,enhancement,24,8,16
Ummyea,dreadmaul,760,shaman,enhancement,18,8,10
Böc,tichondrius,760,shaman,enhancement,18,8,10
Endme,zuljin,758,shaman,enhancement,12,8,4
Orendail,jubeithos,758,shaman,enhancement,24,8,16
Rocktor,alleria,757,shaman,enhancement,12,8,4
Shimshak,destromath,756,shaman,enhancement,18,8,10
Morgoph,bleeding-hollow,735,shaman,enhancement,14,9,5
Rakfnaruk,zuljin,735,shaman,enhancement,16,8,8
Darshidarsh,emerald-dream,735,shaman,enhancement,22,8,14
Emaric,sargeras,735,shaman,enhancement,23,8,15
Vinara,drenden,732,shaman,enhancement,18,8,10
Deeznuts,the-forgotten-coast,719,shaman,enhancement,11,8,3
Succies,emerald-dream,719,shaman,enhancement,17,8,9
Omnipresent,malganis,719,shaman,enhancement,17,8,9
Boozecruz,silvermoon,718,shaman,enhancement,23,8,15
Shockedya,destromath,714,shaman,enhancement,23,10,13
Pwnskillz,area-52,712,shaman,enhancement,17,8,9
Totojar,alexstrasza,712,shaman,enhancement,28,9,19
Hammerdog,illidan,703,shaman,enhancement,16,8,8
Beelzeburst,sargeras,703,shaman,enhancement,17,8,9
Playdohz,frostmourne,702,shaman,enhancement,17,8,9
Paulenia,quelthalas,699,shaman,enhancement,29,8,21
Õhmÿ,emerald-dream,687,shaman,enhancement,11,8,3
Grìmlock,lightbringer,687,shaman,enhancement,13,8,5
Maxsimiliano,emerald-dream,681,shaman,enhancement,24,8,16
Vlal,tichondrius,672,shaman,enhancement,12,7,5
Lavalinks,malganis,672,shaman,enhancement,12,7,5
Wojnar,zuljin,672,shaman,enhancement,12,7,5
Dwârf,tichondrius,672,shaman,enhancement,12,7,5
Zapstrike,stormrage,672,shaman,enhancement,12,7,5
Asy,tichondrius,672,shaman,enhancement,12,7,5
Rayfordyoung,zuljin,672,shaman,enhancement,12,7,5
Mattzander,kiljaeden,672,shaman,enhancement,12,7,5
Emoshamanqt,tichondrius,672,shaman,enhancement,12,7,5
Bawkbagawk,bleeding-hollow,672,shaman,enhancement,12,7,5
Remi,tichondrius,672,shaman,enhancement,12,7,5
Eimear,kelthuzad,672,shaman,enhancement,12,7,5
Ceromental,frostmane,672,shaman,enhancement,12,7,5
Sourcreamqtx,stormrage,672,shaman,enhancement,12,7,5
Ogsmolsham,zuljin,672,shaman,enhancement,12,7,5
Skybender,silvermoon,672,shaman,enhancement,12,7,5
Shòckaholic,bleeding-hollow,672,shaman,enhancement,12,7,5
Voltik,ragnaros,672,shaman,enhancement,12,7,5
Battleimp,kelthuzad,672,shaman,enhancement,12,7,5
Wóåh,stormrage,672,shaman,enhancement,12,7,5
Oneripemango,illidan,672,shaman,enhancement,12,7,5
Windführer,illidan,672,shaman,enhancement,12,7,5
Olujakal,emerald-dream,672,shaman,enhancement,12,7,5
Akwar,greymane,672,shaman,enhancement,12,7,5
Yaytotems,sargeras,672,shaman,enhancement,12,7,5
Skylîne,sargeras,672,shaman,enhancement,12,7,5
Lïnc,sargeras,672,shaman,enhancement,12,7,5
Capriserjr,tichondrius,672,shaman,enhancement,18,7,11
Jeuno,gnomeregan,672,shaman,enhancement,18,7,11
Ayahuaskah,illidan,672,shaman,enhancement,18,7,11
Kidkovid,illidan,672,shaman,enhancement,18,7,11
Yungcreampie,bleeding-hollow,672,shaman,enhancement,18,7,11
Raywhiter,tichondrius,672,shaman,enhancement,22,8,14
Jènova,whisperwind,671,shaman,enhancement,12,7,5
Crowingraven,queldorei,671,shaman,enhancement,12,7,5
Opalsm,tichondrius,671,shaman,enhancement,12,7,5
Folse,tichondrius,671,shaman,enhancement,12,7,5
Seraøth,area-52,671,shaman,enhancement,12,7,5
Setek,barthilas,671,shaman,enhancement,12,7,5
Jigawatt,doomhammer,671,shaman,enhancement,12,7,5
Checkmâte,emerald-dream,671,shaman,enhancement,12,7,5
Thiccpedro,andorhal,671,shaman,enhancement,12,7,5
Hypersomnia,icecrown,671,shaman,enhancement,12,7,5
Unbaerable,blackrock,671,shaman,enhancement,12,7,5
Ayahuaska,darkspear,671,shaman,enhancement,12,7,5
Murm,burning-blade,671,shaman,enhancement,12,7,5
Coronavirrus,hydraxis,671,shaman,enhancement,18,7,11
Jëks,azjolnerub,671,shaman,enhancement,18,7,11
Hrotah,wyrmrest-accord,671,shaman,enhancement,18,7,11
Enhancee,bonechewer,671,shaman,enhancement,18,7,11
Dennwoop,sargeras,671,shaman,enhancement,18,7,11
Wildslammer,khazgoroth,671,shaman,enhancement,18,7,11
Wickyz,moon-guard,671,shaman,enhancement,18,7,11
Nondracil,ragnaros,671,shaman,enhancement,18,7,11
Hellothere,drenden,671,shaman,enhancement,18,7,11
Gwyste,moon-guard,671,shaman,enhancement,18,7,11
Taintvapor,stormrage,671,shaman,enhancement,18,7,11
Kultirio,quelthalas,671,shaman,enhancement,18,7,11
Zald,shattered-halls,671,shaman,enhancement,18,7,11
Atlli,zuljin,671,shaman,enhancement,18,7,11
Velekar,moon-guard,671,shaman,enhancement,21,8,13
Hablarocas,ragnaros,671,shaman,enhancement,24,7,17
Radiology,garithos,670,shaman,enhancement,12,7,5
Spankì,kelthuzad,670,shaman,enhancement,12,7,5
Morehammeerr,thunderlord,670,shaman,enhancement,12,7,5
Møostrom,thrall,670,shaman,enhancement,18,7,11
Drvoodoö,tichondrius,670,shaman,enhancement,18,7,11
Orcgirth,kiljaeden,670,shaman,enhancement,21,8,13
Thunderod,destromath,669,shaman,enhancement,12,7,5
Vladd,hellscream,669,shaman,enhancement,18,7,11
Helljumper,illidan,669,shaman,enhancement,21,8,13
Mugnar,alleria,669,shaman,enhancement,24,7,17
Jacniclstorm,frostmourne,668,shaman,enhancement,12,7,5
Ipponhim,saurfang,667,shaman,enhancement,12,7,5
Gerjann,emerald-dream,667,shaman,enhancement,18,7,11
Funkyshock,dalaran,667,shaman,enhancement,18,7,11
Mfpo,thunderlord,661,shaman,enhancement,18,7,11
Shammich,vashj,655,shaman,enhancement,11,7,4
Speedmonster,hellscream,655,shaman,enhancement,19,8,11
Shablam,daggerspine,640,shaman,enhancement,28,7,21
Creamcheeser,tichondrius,639,shaman,enhancement,11,7,4
Fligmos,llane,639,shaman,enhancement,20,8,12
Heaties,tichondrius,623,shaman,enhancement,11,7,4
Nazghash,wyrmrest-accord,623,shaman,enhancement,17,7,10
Smeeza,frostmourne,617,shaman,enhancement,21,9,12
Intress,moon-guard,607,shaman,enhancement,10,7,3
Äwarz,drakkari,607,shaman,enhancement,14,7,7
Eanne,moon-guard,592,shaman,enhancement,19,7,12
Spotbeard,shadowsong,576,shaman,enhancement,6,6,0
Jimmhalpert,bronzebeard,576,shaman,enhancement,6,6,0
Clear,darkspear,576,shaman,enhancement,6,6,0
Vuduü,stormrage,576,shaman,enhancement,6,6,0
Pikoom,tichondrius,576,shaman,enhancement,6,6,0
Shockpanda,zuljin,576,shaman,enhancement,6,6,0
Dånydevito,moonrunner,576,shaman,enhancement,6,6,0
Ftierspec,frostmourne,576,shaman,enhancement,6,6,0
Chachmon,ursin,576,shaman,enhancement,6,6,0
Mèrkk,misha,576,shaman,enhancement,6,6,0
Shamane,onyxia,576,shaman,enhancement,6,6,0
Stylebenderx,frostmourne,576,shaman,enhancement,12,6,6
Failsy,darkspear,576,shaman,enhancement,12,6,6
Orkshammy,illidan,576,shaman,enhancement,12,6,6
Stormdancer,elune,576,shaman,enhancement,12,6,6
Uggoluga,dalaran,576,shaman,enhancement,12,6,6
Owtyobwol,area-52,576,shaman,enhancement,12,6,6
Xantíd,wyrmrest-accord,576,shaman,enhancement,12,6,6
Dtrumpx,tichondrius,576,shaman,enhancement,12,6,6
Scarlo,bleeding-hollow,576,shaman,enhancement,12,6,6
Onlyfanslink,darkspear,576,shaman,enhancement,12,6,6
Måståçåstå,bleeding-hollow,576,shaman,enhancement,12,6,6
Meatballbag,thrall,576,shaman,enhancement,12,6,6
Animatronixx,area-52,576,shaman,enhancement,12,6,6
Charmyn,frostmourne,576,shaman,enhancement,12,6,6
Hruggol,bleeding-hollow,576,shaman,enhancement,12,6,6
Skrankles,illidan,576,shaman,enhancement,12,6,6
Agpx,tichondrius,576,shaman,enhancement,12,6,6
Enhpower,area-52,576,shaman,enhancement,12,6,6
Kêtchpup,wyrmrest-accord,576,shaman,enhancement,12,6,6
Karagra,tichondrius,576,shaman,enhancement,12,6,6
Blazefury,stormrage,576,shaman,enhancement,12,6,6
Coraamia,nerzhul,576,shaman,enhancement,12,6,6
Thunderøus,stormrage,576,shaman,enhancement,12,6,6
Firetrucks,area-52,576,shaman,enhancement,12,6,6
Nyvka,ragnaros,576,shaman,enhancement,12,6,6
Charleschwab,proudmoore,576,shaman,enhancement,12,6,6
Bubbert,illidan,576,shaman,enhancement,12,6,6
Bussybutter,sargeras,576,shaman,enhancement,12,6,6
Kyzen,tichondrius,576,shaman,enhancement,12,6,6
Fischerman,barthilas,576,shaman,enhancement,12,6,6
Xaspen,skullcrusher,576,shaman,enhancement,12,6,6
Cptsnarf,tichondrius,576,shaman,enhancement,12,6,6
Stnky,cairne,576,shaman,enhancement,12,6,6
Cooperation,kelthuzad,576,shaman,enhancement,12,6,6
Crucybletv,korgath,576,shaman,enhancement,12,6,6
Strønklesøn,drakthul,576,shaman,enhancement,12,6,6
Trashcam,illidan,576,shaman,enhancement,12,6,6
Unrezolved,hyjal,576,shaman,enhancement,13,6,7
Groovesh,thrall,576,shaman,enhancement,14,6,8
Ikiteforlsd,zuljin,576,shaman,enhancement,14,6,8
Ferdashock,tichondrius,576,shaman,enhancement,18,6,12
Earthclap,tichondrius,576,shaman,enhancement,24,6,18
Dacota,emerald-dream,575,shaman,enhancement,12,6,6
Frèya,uldaman,575,shaman,enhancement,12,6,6
Oaktar,bleeding-hollow,575,shaman,enhancement,12,6,6
Naextramus,ragnaros,575,shaman,enhancement,12,6,6
Royvaz,guldan,575,shaman,enhancement,12,6,6
Gingeroo,stonemaul,575,shaman,enhancement,12,6,6
Somethingdop,sargeras,575,shaman,enhancement,12,6,6
Darkvx,quelthalas,575,shaman,enhancement,12,6,6
Internnet,sargeras,575,shaman,enhancement,12,6,6
Kobeshio,destromath,575,shaman,enhancement,21,7,14
Regeneration,darkspear,575,shaman,enhancement,18,6,12
Møp,spirestone,575,shaman,enhancement,18,6,12
Rockbass,sargeras,575,shaman,enhancement,18,6,12
Sartikiria,wyrmrest-accord,575,shaman,enhancement,18,6,12
Dhokki,frostmourne,574,shaman,enhancement,6,6,0
Shockalama,tichondrius,574,shaman,enhancement,24,6,18
Okdopey,area-52,574,shaman,enhancement,24,6,18
Størmbreäker,tichondrius,572,shaman,enhancement,12,6,6
Hazreti,zuljin,572,shaman,enhancement,18,6,12
Kylnadra,silvermoon,571,shaman,enhancement,12,6,6
Fadesrp,moon-guard,571,shaman,enhancement,12,6,6
Ðg,tichondrius,569,shaman,enhancement,18,6,12
Notahealz,zuljin,559,shaman,enhancement,17,6,11
Rykutu,lightbringer,544,shaman,enhancement,10,7,3
Toastsshaman,tichondrius,528,shaman,enhancement,9,6,3
Djshocks,sargeras,527,shaman,enhancement,11,6,5
Shøcker,bonechewer,527,shaman,enhancement,11,6,5
Forge,maelstrom,511,shaman,enhancement,14,6,8
Streetacus,tichondrius,510,shaman,enhancement,26,6,20
Bluepenguin,kelthuzad,480,shaman,enhancement,6,5,1
Illbuyurmom,tichondrius,480,shaman,enhancement,6,5,1
Krunggar,azralon,480,shaman,enhancement,6,5,1
Mynigabob,zuljin,480,shaman,enhancement,6,5,1
Dörnèr,malganis,480,shaman,enhancement,6,5,1
Anticyclóne,illidan,480,shaman,enhancement,6,5,1
Bofah,draktharon,480,shaman,enhancement,6,5,1
Tremordrfear,lightbringer,480,shaman,enhancement,6,5,1
Çaçeçiçoçu,azralon,480,shaman,enhancement,6,5,1
Fwap,bleeding-hollow,480,shaman,enhancement,6,5,1
Nakamora,tichondrius,480,shaman,enhancement,6,5,1
Bluekid,barthilas,480,shaman,enhancement,6,5,1
Swonsham,ravencrest,480,shaman,enhancement,6,5,1
Dangguagua,illidan,480,shaman,enhancement,6,5,1
Wugmuk,illidan,480,shaman,enhancement,6,5,1
Zappiiboii,malganis,480,shaman,enhancement,6,5,1
Iava,dalaran,480,shaman,enhancement,6,5,1
Beatmán,blades-edge,480,shaman,enhancement,6,5,1
Tekdar,kiljaeden,480,shaman,enhancement,10,6,4
Laquica,sargeras,480,shaman,enhancement,12,5,7
Shango,kalecgos,480,shaman,enhancement,12,5,7
Sèktor,dalaran,480,shaman,enhancement,12,5,7
Electrikz,moonrunner,480,shaman,enhancement,12,5,7
Jorgim,frostmourne,480,shaman,enhancement,12,5,7
Capivarãão,stormrage,480,shaman,enhancement,12,5,7
Meatlog,dalaran,480,shaman,enhancement,12,5,7
Bitxxnumber,tichondrius,480,shaman,enhancement,12,5,7
Nirmek,amanthul,480,shaman,enhancement,12,5,7
Shoktsky,moon-guard,480,shaman,enhancement,12,5,7
Spencesham,sargeras,480,shaman,enhancement,12,5,7
Rabbitlol,tichondrius,480,shaman,enhancement,12,5,7
Sleepysham,anubarak,480,shaman,enhancement,12,5,7
Scrototæm,area-52,480,shaman,enhancement,12,5,7
Keltarget,malganis,480,shaman,enhancement,12,5,7
Rockperson,illidan,480,shaman,enhancement,12,5,7
Mzzar,tichondrius,480,shaman,enhancement,12,5,7
Kamisenhance,illidan,480,shaman,enhancement,12,5,7
Waterground,tichondrius,480,shaman,enhancement,12,5,7
Choquinho,azralon,480,shaman,enhancement,12,5,7
Kwizal,stormrage,480,shaman,enhancement,12,5,7
Matzahmeal,skywall,480,shaman,enhancement,12,5,7
Osunutai,ragnaros,480,shaman,enhancement,12,5,7
Mawcus,zuljin,480,shaman,enhancement,12,5,7
Haawksin,ragnaros,480,shaman,enhancement,12,5,7
Macumbolo,nemesis,480,shaman,enhancement,12,5,7
Berasham,aerie-peak,480,shaman,enhancement,12,5,7
Nordstorm,stormrage,480,shaman,enhancement,12,5,7
Bôrghâ,sargeras,480,shaman,enhancement,12,5,7
Yeyo,tichondrius,480,shaman,enhancement,17,5,12
Fíren,area-52,480,shaman,enhancement,18,5,13
Gyokuken,stormrage,480,shaman,enhancement,18,5,13
Spiritry,tichondrius,480,shaman,enhancement,18,5,13
Gangdan,emerald-dream,480,shaman,enhancement,18,5,13
Ndndurkadurk,malganis,480,shaman,enhancement,18,5,13
Zarzlek,destromath,480,shaman,enhancement,25,5,20
Wokoe,tichondrius,479,shaman,enhancement,6,5,1
Dushkanar,barthilas,479,shaman,enhancement,12,5,7
Tugnar,ragnaros,479,shaman,enhancement,12,5,7
Youngthùg,frostmourne,479,shaman,enhancement,18,5,13
Aegaeonlol,tichondrius,479,shaman,enhancement,18,5,13
Brorogan,aerie-peak,478,shaman,enhancement,12,5,7
Unhapintadaa,azralon,478,shaman,enhancement,18,5,13
Flie,tichondrius,478,shaman,enhancement,18,5,13
Enkkiz,ragnaros,477,shaman,enhancement,12,5,7
Curtrex,amanthul,472,shaman,enhancement,19,8,11
Grogakk,moon-guard,447,shaman,enhancement,12,6,6
Jazzyy,korgath,447,shaman,enhancement,11,5,6
Shazikial,illidan,447,shaman,enhancement,11,5,6
Sleekshammy,frostmourne,426,shaman,enhancement,16,7,9
Beefdrapesz,tichondrius,426,shaman,enhancement,16,6,10
Flamestrife,illidan,426,shaman,enhancement,28,8,20
Furiousnick,stormrage,415,shaman,enhancement,8,5,3
Rykku,illidan,400,shaman,enhancement,7,5,2
Bigbb,tichondrius,400,shaman,enhancement,10,6,4
Elemastery,windrunner,384,shaman,enhancement,6,4,2
Stòrmzy,frostmourne,384,shaman,enhancement,6,4,2
Gunrose,proudmoore,384,shaman,enhancement,6,4,2
Donogal,aerie-peak,384,shaman,enhancement,6,4,2
Kisseyfaçaí,kelthuzad,384,shaman,enhancement,6,4,2
Bronzers,tichondrius,384,shaman,enhancement,6,4,2
Stormysteve,hyjal,384,shaman,enhancement,6,4,2
Wools,frostmourne,384,shaman,enhancement,6,4,2
Grimwind,tichondrius,384,shaman,enhancement,6,4,2
Thenightt,garona,384,shaman,enhancement,6,4,2
Aureal,malganis,384,shaman,enhancement,6,4,2
Shinchan,lightnings-blade,384,shaman,enhancement,6,4,2
Meramin,illidan,384,shaman,enhancement,6,4,2
Ezzroz,guldan,384,shaman,enhancement,6,4,2
Slurslinger,area-52,384,shaman,enhancement,6,4,2
Sorgal,area-52,384,shaman,enhancement,6,4,2
Bigboyjones,thrall,384,shaman,enhancement,6,4,2
Angrytotems,ragnaros,384,shaman,enhancement,6,4,2
Birkenshock,tichondrius,384,shaman,enhancement,6,4,2
Omomo,shadowmoon,384,shaman,enhancement,6,4,2
Touchovlife,dragonblight,384,shaman,enhancement,6,4,2
Miroen,tichondrius,384,shaman,enhancement,6,4,2
Skipler,stormrage,384,shaman,enhancement,6,4,2
Solomonster,tichondrius,384,shaman,enhancement,6,4,2
Dingfu,sargeras,384,shaman,enhancement,6,4,2
Protoaster,tichondrius,384,shaman,enhancement,6,4,2
Kylani,thrall,384,shaman,enhancement,6,4,2
Chakkusando,barthilas,384,shaman,enhancement,6,4,2
Mastrionilol,dragonmaw,384,shaman,enhancement,6,4,2
Tokyotimxxo,malganis,384,shaman,enhancement,6,4,2
Urao,stormrage,384,shaman,enhancement,6,4,2
Sweatshock,frostmourne,384,shaman,enhancement,6,4,2
Drmn,frostmourne,384,shaman,enhancement,6,4,2
Utilitytotem,moon-guard,384,shaman,enhancement,6,4,2
Drugdòér,tichondrius,384,shaman,enhancement,6,4,2
Wheath,tichondrius,384,shaman,enhancement,6,4,2
Orcswole,tichondrius,384,shaman,enhancement,6,4,2
Eleshortal,azuremyst,384,shaman,enhancement,9,4,5
Smackzs,sargeras,384,shaman,enhancement,12,4,8
Emppege,tichondrius,384,shaman,enhancement,12,4,8
Bloudabadee,emerald-dream,384,shaman,enhancement,12,4,8
Naturebøy,bleeding-hollow,384,shaman,enhancement,12,4,8
Enanomka,drakkari,384,shaman,enhancement,12,4,8
Piril,moon-guard,384,shaman,enhancement,12,4,8
Kinnarlan,sargeras,384,shaman,enhancement,12,4,8
Kooj,frostmourne,384,shaman,enhancement,12,4,8
Foray,barthilas,384,shaman,enhancement,12,4,8
Ironloins,kelthuzad,384,shaman,enhancement,12,4,8
Boogey,khazgoroth,384,shaman,enhancement,12,4,8
Vertrág,malganis,384,shaman,enhancement,12,4,8
Flamefüry,azralon,384,shaman,enhancement,12,4,8
Merrìtt,area-52,384,shaman,enhancement,12,4,8
Doorti,area-52,384,shaman,enhancement,12,4,8
Cariix,maelstrom,384,shaman,enhancement,12,4,8
Wabfurrie,twisting-nether,384,shaman,enhancement,12,4,8
Kaalyssia,moon-guard,384,shaman,enhancement,12,4,8
Tictactotem,lothar,384,shaman,enhancement,12,4,8
Gaurudon,zuljin,384,shaman,enhancement,12,4,8
Insanelol,tichondrius,384,shaman,enhancement,12,4,8
Odhin,mannoroth,384,shaman,enhancement,12,4,8
Bigstormz,fenris,384,shaman,enhancement,12,4,8
Nehrakgu,wyrmrest-accord,384,shaman,enhancement,12,4,8
Omaboa,azgalor,384,shaman,enhancement,12,4,8
Gorszu,proudmoore,384,shaman,enhancement,12,4,8
Raikages,whisperwind,384,shaman,enhancement,12,4,8
Styrmic,frostmourne,384,shaman,enhancement,12,4,8
Xoelement,borean-tundra,384,shaman,enhancement,18,4,14
Grimdil,quelthalas,384,shaman,enhancement,18,4,14
Illdelph,crushridge,384,shaman,enhancement,18,4,14
Stormmän,stormrage,384,shaman,enhancement,18,4,14
Çatastrophe,dalaran,384,shaman,enhancement,18,4,14
Brenqt,nemesis,384,shaman,enhancement,18,4,14
Cakinha,stormrage,383,shaman,enhancement,6,4,2
Toeto,darrowmere,383,shaman,enhancement,6,4,2
Shiestys,tichondrius,383,shaman,enhancement,6,4,2
Rhal,ragnaros,383,shaman,enhancement,6,4,2
Ghogann,bleeding-hollow,383,shaman,enhancement,6,4,2
Kurzee,kelthuzad,383,shaman,enhancement,12,4,8
Smolder,magtheridon,383,shaman,enhancement,12,4,8
Beefsham,eitrigg,383,shaman,enhancement,12,4,8
Maltral,zuljin,383,shaman,enhancement,18,4,14
Dønßlack,thunderhorn,382,shaman,enhancement,13,5,8
Ikora,crushridge,381,shaman,enhancement,12,4,8
Jonfckingear,zuljin,351,shaman,enhancement,8,5,3
Pyanir,thrall,351,shaman,enhancement,11,4,7
Engorgdshock,tichondrius,351,shaman,enhancement,14,5,9
Admetis,vashj,351,shaman,enhancement,17,4,13
Airiem,tichondrius,336,shaman,enhancement,9,5,4
Thorsén,ursin,335,shaman,enhancement,17,4,13
Jeaunoo,darkspear,330,shaman,enhancement,14,5,9
Kyrels,barthilas,330,shaman,enhancement,16,5,11
Ýup,tichondrius,320,shaman,enhancement,10,4,6
Lardaz,darkspear,319,shaman,enhancement,5,4,1
Habrith,proudmoore,319,shaman,enhancement,11,4,7
Xulangshammy,illidan,319,shaman,enhancement,11,4,7
Tempestsmash,tichondrius,304,shaman,enhancement,7,4,3
Bimbly,eitrigg,303,shaman,enhancement,13,4,9
Sabtifa,proudmoore,288,shaman,enhancement,6,3,3
Littleshammy,aggramar,288,shaman,enhancement,6,3,3
Aruçar,drakkari,288,shaman,enhancement,6,3,3
Antahanu,ragnaros,288,shaman,enhancement,6,3,3
Xzxz,sargeras,288,shaman,enhancement,6,3,3
Gulgortz,ragnaros,288,shaman,enhancement,6,3,3
Bottlez,sargeras,288,shaman,enhancement,6,3,3
Sanachan,blood-furnace,288,shaman,enhancement,6,3,3
Glexhex,tichondrius,288,shaman,enhancement,6,3,3
Gimpanzee,kiljaeden,288,shaman,enhancement,6,3,3
Bon,ravencrest,288,shaman,enhancement,6,3,3
Tideqt,tichondrius,288,shaman,enhancement,6,3,3
Wildernez,whisperwind,288,shaman,enhancement,6,3,3
Cars,jaedenar,288,shaman,enhancement,6,3,3
Getwetand,quelthalas,288,shaman,enhancement,6,3,3
Toath,tichondrius,288,shaman,enhancement,6,3,3
Shamaro,malganis,288,shaman,enhancement,6,3,3
Jumanji,zuljin,288,shaman,enhancement,6,3,3
Drgreek,barthilas,288,shaman,enhancement,6,3,3
Puffjin,zuljin,288,shaman,enhancement,6,3,3
Subbyxd,tichondrius,288,shaman,enhancement,6,3,3
Haititnahtou,kaelthas,288,shaman,enhancement,6,3,3
Hottesthands,barthilas,288,shaman,enhancement,6,3,3
Shammateur,malganis,288,shaman,enhancement,6,3,3
Gojiras,barthilas,288,shaman,enhancement,6,3,3
Mhuns,malganis,288,shaman,enhancement,6,3,3
Dogcompany,tichondrius,288,shaman,enhancement,6,3,3
Tempestarii,ragnaros,288,shaman,enhancement,6,3,3
Lillys,malganis,288,shaman,enhancement,6,3,3
Vivean,kelthuzad,288,shaman,enhancement,6,3,3
Sleepysham,kelthuzad,288,shaman,enhancement,6,3,3
Ethikas,tichondrius,288,shaman,enhancement,6,3,3
Vøødøøboy,hyjal,288,shaman,enhancement,6,3,3
Wreçkitralph,sargeras,288,shaman,enhancement,6,3,3
Thunnor,tichondrius,288,shaman,enhancement,6,3,3
Thiccwater,frostmourne,288,shaman,enhancement,6,3,3
Kubisham,warsong,288,shaman,enhancement,6,3,3
Totemtantrum,tichondrius,288,shaman,enhancement,6,3,3
Luxenor,kelthuzad,288,shaman,enhancement,6,3,3
Slowkeeper,azralon,288,shaman,enhancement,6,3,3
Harshest,stormrage,288,shaman,enhancement,6,3,3
Humper,korgath,288,shaman,enhancement,6,3,3
Redpocket,zuluhed,288,shaman,enhancement,6,3,3
Lame,korgath,288,shaman,enhancement,6,3,3
Deadryassian,malganis,288,shaman,enhancement,6,3,3
Brutalshammy,muradin,288,shaman,enhancement,6,3,3
Ban,blackrock,288,shaman,enhancement,6,3,3
Bovinefony,blackrock,288,shaman,enhancement,6,3,3
Swifteyy,area-52,288,shaman,enhancement,6,3,3
Zapmavz,area-52,288,shaman,enhancement,6,3,3
Reminisce,sargeras,288,shaman,enhancement,6,3,3
Grimmick,area-52,288,shaman,enhancement,6,3,3
Ulala,azshara,288,shaman,enhancement,6,3,3
Eekumbokum,bleeding-hollow,288,shaman,enhancement,6,3,3
Dwarfmaro,sargeras,288,shaman,enhancement,6,3,3
Helapoon,area-52,288,shaman,enhancement,6,3,3
Robot,illidan,288,shaman,enhancement,6,3,3
Popsoot,area-52,288,shaman,enhancement,6,3,3
Baelements,sargeras,288,shaman,enhancement,6,3,3
Jme,arthas,288,shaman,enhancement,6,3,3
Nkrumah,sargeras,288,shaman,enhancement,6,3,3
Mundi,madoran,288,shaman,enhancement,6,3,3
Ëvëlyn,chogall,288,shaman,enhancement,6,3,3
Lennylemons,stormrage,288,shaman,enhancement,6,3,3
Emtflakes,darkspear,288,shaman,enhancement,6,3,3
Jibbajabber,laughing-skull,288,shaman,enhancement,6,3,3
Zoma,elune,288,shaman,enhancement,6,3,3
Owiez,sargeras,288,shaman,enhancement,6,3,3
Fadeshy,illidan,288,shaman,enhancement,6,3,3
Meatcannon,emerald-dream,288,shaman,enhancement,6,3,3
Shear,bleeding-hollow,288,shaman,enhancement,6,3,3
Freshoranges,blood-furnace,288,shaman,enhancement,6,3,3
Bignveiny,darkspear,288,shaman,enhancement,6,3,3
Gumballin,sargeras,288,shaman,enhancement,6,3,3
Toyletpaper,mugthol,288,shaman,enhancement,6,3,3
Puddlecakes,lightbringer,288,shaman,enhancement,6,3,3
Hephæstus,maiev,288,shaman,enhancement,9,4,5
Jaftter,quelthalas,288,shaman,enhancement,9,4,5
Tempestion,malganis,288,shaman,enhancement,9,4,5
Putinsdad,tichondrius,288,shaman,enhancement,10,4,6
Vanella,malganis,288,shaman,enhancement,8,3,5
Faelzão,nemesis,288,shaman,enhancement,12,3,9
Thunderblood,nerzhul,288,shaman,enhancement,12,3,9
Hammaam,illidan,288,shaman,enhancement,12,3,9
Silverwolf,eredar,288,shaman,enhancement,12,3,9
Mambaz,tichondrius,288,shaman,enhancement,12,3,9
Jhivone,tichondrius,288,shaman,enhancement,12,3,9
Xrag,sargeras,288,shaman,enhancement,12,3,9
Drgiggleheim,tichondrius,288,shaman,enhancement,12,3,9
Gudac,tichondrius,288,shaman,enhancement,12,3,9
Immunize,tichondrius,288,shaman,enhancement,12,3,9
Samo,the-underbog,288,shaman,enhancement,12,3,9
Smeagðl,tichondrius,288,shaman,enhancement,12,3,9
Yaazz,frostmourne,288,shaman,enhancement,12,3,9
Lurklox,emerald-dream,288,shaman,enhancement,12,3,9
Fishmoley,zuljin,288,shaman,enhancement,12,3,9
Khazy,skullcrusher,288,shaman,enhancement,12,3,9
Jwondo,area-52,288,shaman,enhancement,12,3,9
Jireñ,area-52,288,shaman,enhancement,12,3,9
Bobbymooshay,area-52,288,shaman,enhancement,12,3,9
Drekkhal,area-52,288,shaman,enhancement,12,3,9
Jajxshammy,rivendare,288,shaman,enhancement,12,3,9
Melåån,jubeithos,288,shaman,enhancement,12,3,9
Actios,stormrage,288,shaman,enhancement,12,3,9
Fuw,zuljin,288,shaman,enhancement,12,3,9
Shocksnbonds,zuljin,288,shaman,enhancement,12,3,9
Blooddtears,stormrage,288,shaman,enhancement,12,3,9
Malsturm,stormrage,288,shaman,enhancement,12,3,9
Jackiesham,illidan,288,shaman,enhancement,12,3,9
Azão,stormrage,288,shaman,enhancement,12,3,9
Kinnix,bonechewer,288,shaman,enhancement,18,3,15
Urbullshixx,tichondrius,287,shaman,enhancement,6,3,3
Zappz,thunderlord,286,shaman,enhancement,6,3,3
Dnttazemebro,area-52,286,shaman,enhancement,6,3,3
Nargen,tichondrius,271,shaman,enhancement,11,3,8
Lagamental,frostmourne,240,shaman,enhancement,9,3,6
ßodycount,area-52,240,shaman,enhancement,9,3,6
Sølbi,tichondrius,239,shaman,enhancement,5,3,2
Caobuloso,azralon,239,shaman,enhancement,5,3,2
Kryms,chogall,234,shaman,enhancement,17,6,11
Smooths,bloodscalp,234,shaman,enhancement,19,5,14
Totemlyhot,frostmourne,192,shaman,enhancement,4,3,1
Kayadee,stormrage,192,shaman,enhancement,9,3,6
Totemzie,illidan,192,shaman,enhancement,6,2,4
Badjujubruh,thrall,192,shaman,enhancement,6,2,4
Olboy,thrall,192,shaman,enhancement,6,2,4
Twistër,illidan,192,shaman,enhancement,6,2,4
Hothandxo,illidan,192,shaman,enhancement,6,2,4
Pandancement,thrall,192,shaman,enhancement,6,2,4
Stormfronts,kelthuzad,192,shaman,enhancement,6,2,4
Skyten,quelthalas,192,shaman,enhancement,6,2,4
Vitaminc,garona,192,shaman,enhancement,6,2,4
Texaspumper,sargeras,192,shaman,enhancement,6,2,4
Jbahr,hyjal,192,shaman,enhancement,6,2,4
Ageegee,sargeras,192,shaman,enhancement,6,2,4
Zenitsue,sargeras,192,shaman,enhancement,6,2,4
Shamutari,sargeras,192,shaman,enhancement,6,2,4
Thejoshuwua,icecrown,192,shaman,enhancement,6,2,4
Stèpbro,sargeras,192,shaman,enhancement,6,2,4
Daiablo,barthilas,192,shaman,enhancement,6,2,4
Virô,sargeras,192,shaman,enhancement,6,2,4
Sicetots,sargeras,192,shaman,enhancement,6,2,4
Scarshamxn,frostmourne,192,shaman,enhancement,6,2,4
Ibreakanklez,bleeding-hollow,192,shaman,enhancement,6,2,4
Pericazo,sargeras,192,shaman,enhancement,6,2,4
Soapmactavis,sargeras,192,shaman,enhancement,6,2,4
Hèllzpyro,sargeras,192,shaman,enhancement,6,2,4
Girthquake,agamaggan,192,shaman,enhancement,6,2,4
Ôprawindfury,mugthol,192,shaman,enhancement,6,2,4
Brewstoned,kargath,192,shaman,enhancement,6,2,4
Shamanakin,emerald-dream,192,shaman,enhancement,6,2,4
Freesolo,barthilas,192,shaman,enhancement,6,2,4
Spoke,emerald-dream,192,shaman,enhancement,6,2,4
Euthiliz,emerald-dream,192,shaman,enhancement,6,2,4
Boj,magtheridon,192,shaman,enhancement,6,2,4
ßeesy,emerald-dream,192,shaman,enhancement,6,2,4
Zeldrys,emerald-dream,192,shaman,enhancement,6,2,4
Ectomee,tichondrius,192,shaman,enhancement,6,2,4
Jashiik,tichondrius,192,shaman,enhancement,6,2,4
Saltt,proudmoore,192,shaman,enhancement,6,2,4
Skyshamy,azralon,192,shaman,enhancement,6,2,4
Contraponto,azralon,192,shaman,enhancement,6,2,4
Dadajuju,azralon,192,shaman,enhancement,6,2,4
Szael,durotan,192,shaman,enhancement,6,2,4
Jamsham,tichondrius,192,shaman,enhancement,6,2,4
Sparklebunny,dark-iron,192,shaman,enhancement,6,2,4
Jasonnworb,tichondrius,192,shaman,enhancement,6,2,4
Moisttaco,azshara,192,shaman,enhancement,6,2,4
Vywolf,frostmourne,192,shaman,enhancement,6,2,4
Durogh,darkspear,192,shaman,enhancement,6,2,4
Thrallzballz,firetree,192,shaman,enhancement,6,2,4
Eraali,stormrage,192,shaman,enhancement,6,2,4
Xantorn,illidan,192,shaman,enhancement,6,2,4
Arabitol,stormrage,192,shaman,enhancement,6,2,4
Brofessor,frostwolf,192,shaman,enhancement,6,2,4
Joehogan,stormrage,192,shaman,enhancement,6,2,4
Shamflu,tichondrius,192,shaman,enhancement,6,2,4
Huiracøcha,quelthalas,192,shaman,enhancement,6,2,4
Mishalla,tichondrius,192,shaman,enhancement,6,2,4
Netflixnfeet,moonrunner,192,shaman,enhancement,6,2,4
Shockazulu,vashj,192,shaman,enhancement,6,2,4
Wìzz,zuljin,192,shaman,enhancement,6,2,4
Rinjio,zuljin,192,shaman,enhancement,6,2,4
Meatyball,tichondrius,192,shaman,enhancement,6,2,4
Fatluma,zuljin,192,shaman,enhancement,6,2,4
Kumer,tichondrius,192,shaman,enhancement,6,2,4
Bearmanshrek,tichondrius,192,shaman,enhancement,6,2,4
Totemrecalld,zuljin,192,shaman,enhancement,6,2,4
Stallos,zuljin,192,shaman,enhancement,6,2,4
Swigadee,tichondrius,192,shaman,enhancement,6,2,4
Gurdle,frostwolf,192,shaman,enhancement,6,2,4
Peternorse,tichondrius,192,shaman,enhancement,6,2,4
Pissticles,bleeding-hollow,192,shaman,enhancement,6,2,4
Picolö,bleeding-hollow,192,shaman,enhancement,6,2,4
Buttermelk,bleeding-hollow,192,shaman,enhancement,6,2,4
Furywolf,bleeding-hollow,192,shaman,enhancement,6,2,4
Crankzilla,area-52,192,shaman,enhancement,6,2,4
Slugstout,moon-guard,192,shaman,enhancement,6,2,4
Kermut,frostmourne,192,shaman,enhancement,6,2,4
Jahahahamon,arthas,192,shaman,enhancement,6,2,4
Eàrthfury,malganis,192,shaman,enhancement,6,2,4
Afri,tichondrius,192,shaman,enhancement,6,2,4
Bullcowsby,darkspear,192,shaman,enhancement,6,2,4
Galarix,nerzhul,192,shaman,enhancement,6,2,4
Dibbydogtote,tichondrius,192,shaman,enhancement,6,2,4
Víì,tichondrius,192,shaman,enhancement,6,2,4
Thünderstrük,tichondrius,192,shaman,enhancement,6,2,4
Loused,wyrmrest-accord,192,shaman,enhancement,6,2,4
Käshqt,tichondrius,192,shaman,enhancement,6,2,4
Amzurs,area-52,192,shaman,enhancement,6,2,4
Poxnhxb,tichondrius,192,shaman,enhancement,6,2,4
Quequin,quelthalas,192,shaman,enhancement,6,2,4
Jammylol,frostmourne,192,shaman,enhancement,6,2,4
Valcannos,area-52,192,shaman,enhancement,6,2,4
Whameradetu,suramar,192,shaman,enhancement,6,2,4
Khuufu,fizzcrank,192,shaman,enhancement,6,2,4
Zithdik,tichondrius,192,shaman,enhancement,6,2,4
Bootsix,area-52,192,shaman,enhancement,6,2,4
Shockalot,lightnings-blade,192,shaman,enhancement,6,2,4
Maxchiquito,ragnaros,192,shaman,enhancement,6,2,4
Uwitduhfeds,moon-guard,192,shaman,enhancement,6,2,4
Shamnick,malganis,192,shaman,enhancement,6,2,4
Raidjin,tichondrius,192,shaman,enhancement,6,2,4
Rayjamalblk,tichondrius,192,shaman,enhancement,6,2,4
Pozcaster,tichondrius,192,shaman,enhancement,6,2,4
Synyshok,tichondrius,192,shaman,enhancement,6,2,4
Ceedlamb,kelthuzad,192,shaman,enhancement,6,2,4
Friedshammy,frostmourne,192,shaman,enhancement,6,2,4
Elecpod,frostmourne,192,shaman,enhancement,6,2,4
Milkmeforhp,frostmourne,192,shaman,enhancement,6,2,4
Detair,malganis,192,shaman,enhancement,6,2,4
Nawoma,quelthalas,192,shaman,enhancement,8,2,6
Feär,ysera,192,shaman,enhancement,9,2,7
Feels,arthas,192,shaman,enhancement,16,3,13
Chontu,area-52,192,shaman,enhancement,12,2,10
Rhazer,cenarion-circle,192,shaman,enhancement,12,2,10
Tictactotum,hyjal,192,shaman,enhancement,12,2,10
Gusgusgus,laughing-skull,192,shaman,enhancement,12,2,10
Manemon,quelthalas,192,shaman,enhancement,12,2,10
Vashidda,stormrage,192,shaman,enhancement,12,2,10
Gunai,malganis,192,shaman,enhancement,12,2,10
Legendmatic,illidan,192,shaman,enhancement,12,2,10
Zuljiba,illidan,192,shaman,enhancement,12,2,10
Stylebend,area-52,192,shaman,enhancement,12,2,10
Îlikêdinos,aggramar,192,shaman,enhancement,12,2,10
Shamanhack,hellscream,192,shaman,enhancement,15,2,13
Calmconflict,daggerspine,191,shaman,enhancement,6,2,4
Ophine,illidan,191,shaman,enhancement,6,2,4
Dahmerjr,area-52,191,shaman,enhancement,6,2,4
Baktolumby,tichondrius,175,shaman,enhancement,11,2,9
Skuffedx,spirestone,159,shaman,enhancement,5,2,3
Healingtime,nerzhul,159,shaman,enhancement,5,2,3
Nuggitz,tichondrius,159,shaman,enhancement,5,2,3
Shamto,zuljin,144,shaman,enhancement,3,3,0
Khaylaa,tichondrius,138,shaman,enhancement,11,6,5
Evlle,tichondrius,128,shaman,enhancement,4,2,2
Flashyjoe,tichondrius,128,shaman,enhancement,4,2,2
Badgeshock,area-52,128,shaman,enhancement,4,2,2
Bogz,korgath,128,shaman,enhancement,4,2,2
Ludacrìtz,stormrage,112,shaman,enhancement,7,2,5
Shamcakes,kilrogg,96,shaman,enhancement,17,3,14
Shamamas,area-52,96,shaman,enhancement,6,1,5
Udÿr,drakkari,96,shaman,enhancement,6,1,5
Trynr,ragnaros,96,shaman,enhancement,6,1,5
Chudeshock,ragnaros,96,shaman,enhancement,6,1,5
Fourever,ragnaros,96,shaman,enhancement,6,1,5
Trouvaille,tichondrius,96,shaman,enhancement,6,1,5
Drgoodvibes,barthilas,96,shaman,enhancement,6,1,5
Chopmynuts,illidan,96,shaman,enhancement,6,1,5
Tetonka,tichondrius,96,shaman,enhancement,6,1,5
Cleiri,quelthalas,96,shaman,enhancement,6,1,5
Littz,malganis,96,shaman,enhancement,6,1,5
Totemtîme,frostmourne,96,shaman,enhancement,6,1,5
Dxvxn,tichondrius,96,shaman,enhancement,6,1,5
Zugnuz,sargeras,96,shaman,enhancement,6,1,5
Kàrlx,tichondrius,96,shaman,enhancement,6,1,5
Paramecium,sargeras,96,shaman,enhancement,6,1,5
Toyotatron,tichondrius,96,shaman,enhancement,6,1,5
Javinoo,tichondrius,96,shaman,enhancement,6,1,5
Zapsquidzap,illidan,96,shaman,enhancement,6,1,5
Fludge,dathremar,96,shaman,enhancement,6,1,5
Sweettooth,area-52,96,shaman,enhancement,6,1,5
Zuitianshi,tichondrius,96,shaman,enhancement,6,1,5
Pileef,thrall,96,shaman,enhancement,6,1,5
Firefíst,area-52,96,shaman,enhancement,6,1,5
Volaarn,area-52,96,shaman,enhancement,6,1,5
Feuerbart,dalaran,96,shaman,enhancement,6,1,5
Geladoo,gallywix,96,shaman,enhancement,6,1,5
Bunnyele,tichondrius,96,shaman,enhancement,6,1,5
Ohtoro,zuljin,96,shaman,enhancement,6,1,5
Youliuhua,tichondrius,96,shaman,enhancement,6,1,5
Kranif,tichondrius,96,shaman,enhancement,6,1,5
Zabatee,dalaran,96,shaman,enhancement,6,1,5
Adosistoxic,zuljin,96,shaman,enhancement,6,1,5
Ulfgarn,stormrage,96,shaman,enhancement,6,1,5
Nommymilkers,stormrage,96,shaman,enhancement,6,1,5
Trøuble,deathwing,96,shaman,enhancement,6,1,5
Zeemo,maelstrom,96,shaman,enhancement,6,1,5
Tritun,proudmoore,96,shaman,enhancement,6,1,5
Karmar,proudmoore,96,shaman,enhancement,6,1,5
Sureofname,frostmourne,96,shaman,enhancement,6,1,5
Aezst,illidan,96,shaman,enhancement,6,1,5
Hangellyca,azralon,96,shaman,enhancement,6,1,5
Juvîa,emerald-dream,96,shaman,enhancement,6,1,5
Zoeyzour,illidan,96,shaman,enhancement,6,1,5
Uttertrash,illidan,96,shaman,enhancement,6,1,5
Blackjackxx,frostmourne,96,shaman,enhancement,6,1,5
Shamofshame,garrosh,96,shaman,enhancement,6,1,5
Aiggiggigne,sargeras,96,shaman,enhancement,6,1,5
Saesenthesis,barthilas,96,shaman,enhancement,6,1,5
Sandmanatee,crushridge,96,shaman,enhancement,6,1,5
Killuminatti,nathrezim,96,shaman,enhancement,6,1,5
Shockd,icecrown,96,shaman,enhancement,6,1,5
Frostyshock,hellscream,96,shaman,enhancement,6,1,5
Spaceghost,illidan,96,shaman,enhancement,6,1,5
Kinjin,dragonmaw,96,shaman,enhancement,6,1,5
Neveroom,cenarius,96,shaman,enhancement,6,1,5
Wangbangjr,mugthol,96,shaman,enhancement,6,1,5
Beazel,moon-guard,96,shaman,enhancement,6,1,5
Alferian,moon-guard,96,shaman,enhancement,6,1,5
Baelgoth,moon-guard,96,shaman,enhancement,6,1,5
Axshaman,darkspear,96,shaman,enhancement,6,1,5
Yungmeaty,tichondrius,96,shaman,enhancement,7,1,6
Threehandz,bleeding-hollow,96,shaman,enhancement,8,1,7
Immutef,tichondrius,96,shaman,enhancement,12,1,11
Wildspark,frostmourne,96,shaman,enhancement,12,1,11
Chäningtotem,kiljaeden,96,shaman,enhancement,12,1,11
Zugpug,emerald-dream,96,shaman,enhancement,12,1,11
Thallor,stormrage,96,shaman,enhancement,12,1,11
Smokeymcpots,khazgoroth,95,shaman,enhancement,6,1,5
Sprite,wildhammer,79,shaman,enhancement,5,1,4
Oakshield,darkspear,64,shaman,enhancement,4,1,3
Stórmfuryz,tichondrius,64,shaman,enhancement,4,1,3
Byakuwugan,undermine,63,shaman,enhancement,2,2,0
Njórd,sargeras,63,shaman,enhancement,2,2,0
Bluberi,nazjatar,48,shaman,enhancement,3,1,2
Splewtsham,thrall,48,shaman,enhancement,3,1,2
Ekatonkiro,ragnaros,48,shaman,enhancement,3,1,2
Rondru,zuljin,48,shaman,enhancement,3,1,2
Pocoloco,blades-edge,48,shaman,enhancement,3,1,2
Grauldron,illidan,48,shaman,enhancement,3,1,2
Totemlord,lightnings-blade,31,shaman,enhancement,2,1,1
Liltmantwo,skywall,16,shaman,enhancement,1,1,0
Stumpyjoe,terokkar,16,shaman,enhancement,7,1,6
Cidkagenou,sargeras,2353,warlock,demonology,63,47,16
Bronzerl,tichondrius,2347,warlock,demonology,69,47,22
Wildimpx,sargeras,2330,warlock,demonology,238,129,109
Wildimp,aerie-peak,2325,warlock,demonology,114,69,45
Bahamas,bleeding-hollow,2307,warlock,demonology,96,57,39
Btsfangirl,moon-guard,2297,warlock,demonology,128,74,54
Oymmander,illidan,2278,warlock,demonology,74,50,24
Xygg,tichondrius,2264,warlock,demonology,84,51,33
Iordozzy,malganis,2245,warlock,demonology,84,56,28
Miredö,tichondrius,2223,warlock,demonology,90,51,39
Wzxx,tichondrius,2222,warlock,demonology,84,46,38
Lilballz,tichondrius,2221,warlock,demonology,65,39,26
Hrrpeuh,zuljin,2220,warlock,demonology,84,51,33
Jojofann,nemesis,2212,warlock,demonology,59,40,19
Slantsix,tichondrius,2207,warlock,demonology,83,46,37
Ediya,tichondrius,2203,warlock,demonology,178,94,84
Toiletghost,tichondrius,2201,warlock,demonology,116,74,42
Babyaga,illidan,2201,warlock,demonology,84,47,37
Beyourselff,tichondrius,2195,warlock,demonology,151,80,71
Erock,korgath,2180,warlock,demonology,72,54,18
Broccoleh,area-52,2179,warlock,demonology,71,44,27
Fatass,cairne,2179,warlock,demonology,72,42,30
Mixtape,stormrage,2178,warlock,demonology,77,47,30
Fishorz,tichondrius,2172,warlock,demonology,95,50,45
Bigfatballz,tichondrius,2171,warlock,demonology,76,48,28
Newmanz,nerzhul,2155,warlock,demonology,71,41,30
Evildeath,tichondrius,2154,warlock,demonology,78,44,34
Gentleq,tichondrius,2149,warlock,demonology,99,53,46
Gianni,chogall,2149,warlock,demonology,107,57,50
Mlx,proudmoore,2147,warlock,demonology,167,89,78
Kaossqt,azralon,2145,warlock,demonology,147,79,68
Abrocket,alleria,2143,warlock,demonology,72,45,27
Shinyballz,tichondrius,2133,warlock,demonology,71,41,30
Ziffy,emerald-dream,2133,warlock,demonology,84,42,42
Xadge,tichondrius,2128,warlock,demonology,79,43,36
Harambê,sargeras,2127,warlock,demonology,36,27,9
Lemmefear,illidan,2127,warlock,demonology,47,32,15
Chanigay,tichondrius,2127,warlock,demonology,65,39,26
Wesyane,anetheron,2127,warlock,demonology,160,84,76
Bigdaddylol,ragnaros,2120,warlock,demonology,83,45,38
Iruffcarla,cairne,2119,warlock,demonology,96,56,40
Awdam,tichondrius,2114,warlock,demonology,96,50,46
Ensebado,azralon,2111,warlock,demonology,140,78,62
Falco,azshara,2110,warlock,demonology,66,38,28
Synkz,blood-furnace,2110,warlock,demonology,72,38,34
Cosmosxx,illidan,2110,warlock,demonology,112,58,54
Ogchaos,tichondrius,2107,warlock,demonology,78,45,33
Erlandesher,tichondrius,2107,warlock,demonology,149,75,74
Tessarath,area-52,2106,warlock,demonology,59,38,21
Sslock,sargeras,2106,warlock,demonology,118,63,55
Boltqt,tichondrius,2103,warlock,demonology,60,36,24
Spicyfingers,illidan,2103,warlock,demonology,78,44,34
Nðm,tichondrius,2100,warlock,demonology,72,44,28
Sofan,dalaran,2097,warlock,demonology,70,43,27
Patoquenn,azralon,2095,warlock,demonology,72,39,33
Aoepump,tichondrius,2094,warlock,demonology,78,43,35
Zuelu,tichondrius,2092,warlock,demonology,187,99,88
Kymochaos,sargeras,2080,warlock,demonology,53,27,26
Maadhum,illidan,2079,warlock,demonology,104,55,49
Ofc,malganis,2068,warlock,demonology,60,35,25
Unhòólylck,ragnaros,2051,warlock,demonology,115,60,55
Persistencss,tichondrius,2047,warlock,demonology,48,29,19
Dreadlock,tichondrius,2046,warlock,demonology,60,36,24
Ztlivid,area-52,2045,warlock,demonology,216,113,103
Coèrce,tichondrius,2040,warlock,demonology,53,35,18
Playßøy,area-52,2032,warlock,demonology,60,33,27
Etuskaa,tichondrius,2032,warlock,demonology,167,83,84
Eazyw,stormrage,2024,warlock,demonology,95,47,48
Iselltacos,dalaran,2015,warlock,demonology,43,29,14
Cosmosxi,illidan,2008,warlock,demonology,91,50,41
Nocrackrocks,stormrage,2007,warlock,demonology,117,66,51
Atheô,ragnaros,2004,warlock,demonology,106,57,49
Awangdemon,tichondrius,1997,warlock,demonology,54,27,27
Dotman,tichondrius,1991,warlock,demonology,70,39,31
Debao,malganis,1984,warlock,demonology,119,56,63
Teivlol,mugthol,1980,warlock,demonology,96,51,45
Stopdot,lightnings-blade,1979,warlock,demonology,88,44,44
Extreme,blackwing-lair,1978,warlock,demonology,78,53,25
Procalypse,stormrage,1966,warlock,demonology,54,32,22
Precogfear,tichondrius,1964,warlock,demonology,126,64,62
Inmøtion,tichondrius,1961,warlock,demonology,66,36,30
Canobio,tichondrius,1957,warlock,demonology,65,43,22
Megamindx,tichondrius,1957,warlock,demonology,48,31,17
Voidbb,tichondrius,1957,warlock,demonology,53,30,23
Bleachkk,tichondrius,1955,warlock,demonology,113,66,47
Tarth,sargeras,1953,warlock,demonology,138,74,64
Snuufels,area-52,1950,warlock,demonology,60,37,23
Ihaveapowers,maiev,1944,warlock,demonology,120,60,60
Bwonsamdijin,tichondrius,1943,warlock,demonology,152,74,78
Naughtybolts,sargeras,1941,warlock,demonology,80,46,34
Baka,moon-guard,1938,warlock,demonology,60,32,28
Littlerod,tichondrius,1934,warlock,demonology,90,48,42
Avery,mannoroth,1934,warlock,demonology,48,25,23
Paygo,tichondrius,1930,warlock,demonology,57,32,25
Huajianmanwu,tichondrius,1929,warlock,demonology,337,175,162
Dätura,tichondrius,1928,warlock,demonology,80,50,30
Arckádia,stormrage,1923,warlock,demonology,66,31,35
Shadowmoonon,tichondrius,1921,warlock,demonology,43,21,22
Bronzel,tichondrius,1920,warlock,demonology,48,30,18
Actualjoke,frostmourne,1920,warlock,demonology,65,37,28
Invalid,frostmourne,1914,warlock,demonology,36,25,11
Ceeloftw,tichondrius,1914,warlock,demonology,113,60,53
Ministàff,ursin,1913,warlock,demonology,66,36,30
Ökïlôck,proudmoore,1912,warlock,demonology,48,27,21
Babydots,stormreaver,1911,warlock,demonology,202,104,98
Rôsé,tichondrius,1910,warlock,demonology,142,78,64
Maral,kelthuzad,1910,warlock,demonology,69,37,32
Lilgigs,stormrage,1909,warlock,demonology,60,30,30
Zjxy,tichondrius,1908,warlock,demonology,30,20,10
Devilman,darkspear,1908,warlock,demonology,186,99,87
Shadowsloc,tichondrius,1907,warlock,demonology,24,20,4
Scalpelexis,stormrage,1905,warlock,demonology,36,23,13
Dyenamik,stormrage,1904,warlock,demonology,30,24,6
Demyo,tichondrius,1903,warlock,demonology,44,24,20
Daerde,malganis,1900,warlock,demonology,47,27,20
Siphoned,darkspear,1900,warlock,demonology,53,27,26
Deadlpoo,stormscale,1899,warlock,demonology,81,41,40
Xiyangpvp,tichondrius,1898,warlock,demonology,54,31,23
Lemmepvponu,illidan,1896,warlock,demonology,48,30,18
Alisa,moon-guard,1896,warlock,demonology,60,28,32
Lowrcase,zuljin,1895,warlock,demonology,48,28,20
Drakatattwo,tichondrius,1894,warlock,demonology,48,26,22
Lrry,dalaran,1893,warlock,demonology,144,84,60
Il,nerzhul,1893,warlock,demonology,53,29,24
Gigabiga,area-52,1890,warlock,demonology,42,27,15
Buymymixtåpe,ursin,1889,warlock,demonology,63,37,26
Rakshama,chogall,1885,warlock,demonology,42,25,17
Percadu,barthilas,1885,warlock,demonology,97,50,47
Elbrujon,sargeras,1885,warlock,demonology,166,81,85
Mongobros,illidan,1881,warlock,demonology,54,33,21
Petattack,nerzhul,1878,warlock,demonology,125,60,65
Sobadhahaha,azralon,1877,warlock,demonology,78,49,29
Kimchiblast,tichondrius,1876,warlock,demonology,48,28,20
Lambe,tichondrius,1874,warlock,demonology,53,31,22
Demondisco,tichondrius,1873,warlock,demonology,95,45,50
Zydiva,sargeras,1872,warlock,demonology,118,62,56
Sàill,tichondrius,1871,warlock,demonology,35,22,13
Larixpotanin,tichondrius,1871,warlock,demonology,108,62,46
Lockiator,moon-guard,1870,warlock,demonology,71,35,36
Dowal,whisperwind,1866,warlock,demonology,60,31,29
Vexxes,malganis,1866,warlock,demonology,276,136,140
Scatach,area-52,1864,warlock,demonology,60,32,28
Thranlock,area-52,1861,warlock,demonology,162,80,82
Klol,proudmoore,1861,warlock,demonology,54,26,28
ßøßßÿßøûçhêr,tichondrius,1859,warlock,demonology,48,32,16
Ketahole,warsong,1859,warlock,demonology,135,65,70
Voidxx,tichondrius,1856,warlock,demonology,30,21,9
Mhael,lightninghoof,1856,warlock,demonology,54,32,22
Amazingamez,sargeras,1855,warlock,demonology,149,69,80
Atheø,ragnaros,1854,warlock,demonology,42,23,19
Aramith,tichondrius,1854,warlock,demonology,118,60,58
Díablo,bleeding-hollow,1848,warlock,demonology,53,36,17
Redfish,tichondrius,1847,warlock,demonology,34,20,14
Shuffler,tichondrius,1846,warlock,demonology,71,46,25
Overlard,illidan,1846,warlock,demonology,48,26,22
Xitokaiba,tichondrius,1844,warlock,demonology,67,46,21
Phóbòs,tichondrius,1843,warlock,demonology,54,40,14
Blunder,frostmourne,1843,warlock,demonology,41,26,15
Wachifurro,drakkari,1843,warlock,demonology,59,31,28
Metic,firetree,1842,warlock,demonology,48,33,15
Kerrigan,the-venture-co,1842,warlock,demonology,66,38,28
Darkzell,azralon,1841,warlock,demonology,48,30,18
Dlhmlock,tichondrius,1840,warlock,demonology,41,25,16
Spreadlove,emerald-dream,1839,warlock,demonology,252,133,119
Alndron,thrall,1837,warlock,demonology,78,38,40
Qwêrty,ursin,1836,warlock,demonology,53,36,17
Ccona,tichondrius,1835,warlock,demonology,42,23,19
Speakeasy,malygos,1835,warlock,demonology,58,29,29
Feinnx,dalaran,1835,warlock,demonology,66,31,35
Beatinu,draenor,1834,warlock,demonology,54,32,22
Domenic,sentinels,1833,warlock,demonology,58,32,26
Necronemesis,arthas,1833,warlock,demonology,162,88,74
Bbangtimo,tichondrius,1833,warlock,demonology,77,40,37
Åmön,zuljin,1832,warlock,demonology,66,32,34
Lcomi,tichondrius,1829,warlock,demonology,72,40,32
Bic,thrall,1828,warlock,demonology,66,45,21
Xoboroz,moon-guard,1827,warlock,demonology,60,29,31
Cendit,malganis,1825,warlock,demonology,54,34,20
Jerclard,proudmoore,1825,warlock,demonology,90,51,39
Castingfear,barthilas,1825,warlock,demonology,48,27,21
Tazlock,blackrock,1825,warlock,demonology,64,32,32
Greasymario,area-52,1824,warlock,demonology,60,42,18
Malatharr,quelthalas,1824,warlock,demonology,52,34,18
Xacayth,ragnaros,1824,warlock,demonology,98,57,41
Bonetangler,thrall,1824,warlock,demonology,131,61,70
Douzz,frostmourne,1821,warlock,demonology,47,28,19
Dapete,malorne,1821,warlock,demonology,59,32,27
Zehzet,area-52,1820,warlock,demonology,40,28,12
Idoovoodoo,burning-legion,1820,warlock,demonology,36,23,13
Sharaßha,moon-guard,1820,warlock,demonology,69,41,28
Haunt,mugthol,1820,warlock,demonology,54,27,27
Scarysherri,aggramar,1819,warlock,demonology,54,36,18
Eminence,stormrage,1819,warlock,demonology,72,41,31
Búmchúm,frostmourne,1818,warlock,demonology,60,38,22
Dëvïl,ragnaros,1818,warlock,demonology,92,58,34
Lockedlock,nemesis,1818,warlock,demonology,48,27,21
Villaìn,moon-guard,1818,warlock,demonology,117,55,62
Arcinian,kelthuzad,1817,warlock,demonology,66,39,27
Wls,frostmourne,1817,warlock,demonology,89,50,39
Hellbraive,queldorei,1817,warlock,demonology,54,30,24
Flocka,agamaggan,1816,warlock,demonology,66,47,19
Tít,malganis,1814,warlock,demonology,41,31,10
Wearelegionx,frostmourne,1814,warlock,demonology,84,49,35
Tinkerfell,sargeras,1814,warlock,demonology,72,36,36
Fearmebro,bleeding-hollow,1813,warlock,demonology,114,75,39
Richards,thrall,1812,warlock,demonology,42,32,10
Ltr,moon-guard,1811,warlock,demonology,30,22,8
Kronii,jubeithos,1811,warlock,demonology,35,25,10
Voidxo,tichondrius,1811,warlock,demonology,36,22,14
Krumlax,thrall,1810,warlock,demonology,60,42,18
Deboltzaru,ragnaros,1810,warlock,demonology,36,20,16
Errogant,area-52,1810,warlock,demonology,60,30,30
Nüts,blackrock,1810,warlock,demonology,50,23,27
Beckypls,zuljin,1809,warlock,demonology,36,27,9
Mcjoy,akama,1809,warlock,demonology,145,91,54
Dounutlock,area-52,1809,warlock,demonology,54,33,21
Saevitar,area-52,1809,warlock,demonology,45,24,21
Gengar,dalaran,1809,warlock,demonology,186,97,89
Zzooxxqt,area-52,1809,warlock,demonology,48,25,23
Hadoukën,hyjal,1809,warlock,demonology,108,56,52
Chilipeppa,wyrmrest-accord,1808,warlock,demonology,60,34,26
Mälwaré,tichondrius,1808,warlock,demonology,58,29,29
Chaosthekid,malganis,1807,warlock,demonology,40,25,15
Reneqtxo,jubeithos,1806,warlock,demonology,30,19,11
Demofliction,stormrage,1806,warlock,demonology,68,32,36
Evelyne,tichondrius,1805,warlock,demonology,30,19,11
Cappadonna,azralon,1804,warlock,demonology,118,69,49
Rakudemon,ragnaros,1804,warlock,demonology,147,77,70
Magë,ursin,1804,warlock,demonology,132,61,71
Darkborkain,tichondrius,1803,warlock,demonology,30,19,11
Feldren,wyrmrest-accord,1803,warlock,demonology,115,64,51
Mbhlol,illidan,1803,warlock,demonology,42,23,19
Xlilgee,kelthuzad,1802,warlock,demonology,57,31,26
ßállin,illidan,1801,warlock,demonology,47,30,17
Quetzâlcoâtl,sargeras,1801,warlock,demonology,47,28,19
Lockeslock,sargeras,1801,warlock,demonology,118,62,56
Thelockzx,azralon,1801,warlock,demonology,60,28,32
Gamecover,azralon,1798,warlock,demonology,134,75,59
Playtoy,moon-guard,1798,warlock,demonology,172,85,87
Salaszar,illidan,1797,warlock,demonology,48,31,17
Raegon,kiljaeden,1797,warlock,demonology,44,25,19
Axelrodx,tichondrius,1796,warlock,demonology,66,40,26
Tiná,tichondrius,1796,warlock,demonology,51,27,24
Overclocked,destromath,1795,warlock,demonology,30,21,9
Hugebolt,tichondrius,1793,warlock,demonology,48,28,20
Lockedinn,mannoroth,1789,warlock,demonology,109,59,50
Biubius,tichondrius,1785,warlock,demonology,42,24,18
Keylloggz,sargeras,1780,warlock,demonology,126,65,61
Juleno,quelthalas,1776,warlock,demonology,75,38,37
Hitwarlock,tichondrius,1775,warlock,demonology,78,39,39
Amgs,frostmourne,1773,warlock,demonology,54,38,16
Qp,thrall,1771,warlock,demonology,38,28,10
Lockdlhm,tichondrius,1771,warlock,demonology,43,26,17
Abomasnow,frostmourne,1768,warlock,demonology,67,32,35
Dogegg,tichondrius,1765,warlock,demonology,84,40,44
Sicksick,tichondrius,1762,warlock,demonology,45,22,23
Bugbugg,tichondrius,1761,warlock,demonology,41,25,16
Medzor,tichondrius,1761,warlock,demonology,42,23,19
Döremi,tichondrius,1760,warlock,demonology,35,21,14
Wrathh,stormscale,1753,warlock,demonology,51,24,27
Aidadeshu,tichondrius,1750,warlock,demonology,72,33,39
Graendol,tichondrius,1745,warlock,demonology,36,22,14
Lazymongoose,frostmourne,1745,warlock,demonology,203,110,93
Melisândre,kiljaeden,1744,warlock,demonology,53,26,27
Eastwitch,ragnaros,1743,warlock,demonology,120,55,65
Orgcontroler,hyjal,1742,warlock,demonology,67,29,38
Mcpickls,illidan,1740,warlock,demonology,48,26,22
Michae,tichondrius,1740,warlock,demonology,48,25,23
Arityy,tichondrius,1738,warlock,demonology,33,23,10
Missalice,nesingwary,1738,warlock,demonology,42,23,19
Zörkô,zuljin,1733,warlock,demonology,156,74,82
Kwrhitom,zuljin,1732,warlock,demonology,42,25,17
Saeph,burning-legion,1731,warlock,demonology,72,41,31
Ðëâthløck,tichondrius,1729,warlock,demonology,47,25,22
Vcain,stormrage,1728,warlock,demonology,125,63,62
Skullsoul,arthas,1725,warlock,demonology,88,49,39
Lemmewin,illidan,1724,warlock,demonology,24,18,6
Séptima,illidan,1724,warlock,demonology,36,22,14
Eriebos,area-52,1724,warlock,demonology,60,35,25
Wrathzn,azralon,1723,warlock,demonology,24,18,6
Dreadlõck,malganis,1723,warlock,demonology,112,56,56
Spicyfingerx,zangarmarsh,1720,warlock,demonology,48,29,19
Muchas,area-52,1717,warlock,demonology,30,18,12
Fadedemon,area-52,1716,warlock,demonology,42,32,10
Doomdm,zuljin,1710,warlock,demonology,30,18,12
Milkybøng,area-52,1705,warlock,demonology,99,61,38
Sasaology,frostmourne,1704,warlock,demonology,126,65,61
Shooterg,tichondrius,1704,warlock,demonology,66,32,34
Dìablo,area-52,1702,warlock,demonology,78,43,35
Zuulusi,stormrage,1702,warlock,demonology,102,54,48
Spicytaters,malganis,1701,warlock,demonology,30,24,6
Uwantpeach,tichondrius,1701,warlock,demonology,47,23,24
Nethron,the-venture-co,1700,warlock,demonology,72,35,37
Brightmoonhw,tichondrius,1700,warlock,demonology,66,32,34
Fearedu,thunderhorn,1699,warlock,demonology,155,77,78
Altairo,illidan,1696,warlock,demonology,94,49,45
Ourlegacy,tichondrius,1695,warlock,demonology,40,24,16
Ezgamejr,tichondrius,1693,warlock,demonology,24,20,4
Necroabuser,area-52,1692,warlock,demonology,40,24,16
Fksm,tichondrius,1692,warlock,demonology,36,20,16
Evilmilf,tichondrius,1692,warlock,demonology,60,32,28
Stopdottroll,zuljin,1690,warlock,demonology,30,18,12
Tazerr,sargeras,1690,warlock,demonology,57,26,31
Darknessgodd,goldrinn,1688,warlock,demonology,53,32,21
Metrow,area-52,1688,warlock,demonology,30,18,12
Leeka,tichondrius,1687,warlock,demonology,48,23,25
Gørb,wyrmrest-accord,1686,warlock,demonology,48,30,18
Notomorrow,tichondrius,1686,warlock,demonology,146,87,59
Ciprýan,azralon,1684,warlock,demonology,82,37,45
Eatsleepgame,barthilas,1684,warlock,demonology,80,34,46
Fãttyqt,sargeras,1683,warlock,demonology,70,50,20
Voltshot,tichondrius,1682,warlock,demonology,544,281,263
Paparoxy,illidan,1681,warlock,demonology,65,30,35
Almostoogood,illidan,1680,warlock,demonology,36,24,12
Scalpelx,tichondrius,1677,warlock,demonology,29,18,11
Daxxter,tichondrius,1677,warlock,demonology,54,28,26
Døtyou,area-52,1676,warlock,demonology,35,18,17
Ashlëen,ragnaros,1676,warlock,demonology,186,93,93
Juswannarock,tichondrius,1676,warlock,demonology,51,25,26
Dlchem,tichondrius,1674,warlock,demonology,88,47,41
Jaganshi,tichondrius,1674,warlock,demonology,76,37,39
Spicyfingerx,illidan,1673,warlock,demonology,36,22,14
Narmazulnn,area-52,1673,warlock,demonology,53,31,22
Doombaby,zuljin,1668,warlock,demonology,102,60,42
Gløcked,area-52,1666,warlock,demonology,48,26,22
Jyhoona,chromaggus,1666,warlock,demonology,531,268,263
Gromy,lightnings-blade,1664,warlock,demonology,113,71,42
Hoana,azralon,1663,warlock,demonology,147,84,63
Doties,bleeding-hollow,1663,warlock,demonology,42,23,19
Oluluo,andorhal,1662,warlock,demonology,53,28,25
Møbscene,bleeding-hollow,1662,warlock,demonology,43,22,21
Mcpickl,illidan,1662,warlock,demonology,54,25,29
Edzeá,frostmourne,1656,warlock,demonology,48,24,24
Aroug,aggramar,1655,warlock,demonology,125,61,64
Archibalding,area-52,1654,warlock,demonology,66,38,28
Rathul,bonechewer,1654,warlock,demonology,61,30,31
Bigdotenergi,tichondrius,1653,warlock,demonology,44,28,16
Yuengling,illidan,1653,warlock,demonology,144,73,71
Th,kiljaeden,1652,warlock,demonology,77,38,39
Gimmeprecog,tichondrius,1651,warlock,demonology,30,21,9
Fears,norgannon,1651,warlock,demonology,48,29,19
Gihaewon,tichondrius,1650,warlock,demonology,30,20,10
Pikme,bleeding-hollow,1650,warlock,demonology,48,22,26
Bosongo,boulderfist,1648,warlock,demonology,52,31,21
Exofilth,thrall,1648,warlock,demonology,92,54,38
Säbrine,zuljin,1646,warlock,demonology,97,46,51
Minichompei,frostmourne,1645,warlock,demonology,41,24,17
Phogy,bleeding-hollow,1644,warlock,demonology,71,35,36
Invisibles,barthilas,1642,warlock,demonology,35,20,15
Kreâtor,tichondrius,1642,warlock,demonology,101,56,45
Juxsr,nerzhul,1642,warlock,demonology,42,22,20
Harrydotterr,bonechewer,1639,warlock,demonology,74,38,36
Skanckqt,malganis,1638,warlock,demonology,59,31,28
Thelocker,stormrage,1637,warlock,demonology,83,48,35
Torghast,bloodhoof,1637,warlock,demonology,42,21,21
Suzüki,tichondrius,1635,warlock,demonology,36,19,17
Theseance,dalaran,1635,warlock,demonology,60,31,29
Blastyboat,terenas,1633,warlock,demonology,48,26,22
Ptwo,illidan,1632,warlock,demonology,30,18,12
Cinderwhip,moon-guard,1632,warlock,demonology,249,122,127
Venticm,tichondrius,1631,warlock,demonology,24,17,7
Rococo,emerald-dream,1631,warlock,demonology,36,22,14
Zeeref,stormrage,1629,warlock,demonology,54,27,27
Azrezzael,area-52,1628,warlock,demonology,36,22,14
Discordance,zuljin,1628,warlock,demonology,30,17,13
Kronicdotz,bleeding-hollow,1628,warlock,demonology,44,22,22
Badstepbro,sargeras,1627,warlock,demonology,30,17,13
Lamdyn,moon-guard,1626,warlock,demonology,96,55,41
Ggooudan,tichondrius,1625,warlock,demonology,29,21,8
Jokerxks,tichondrius,1624,warlock,demonology,24,17,7
Turbocleave,blackwater-raiders,1624,warlock,demonology,24,17,7
Demonicsmoke,darrowmere,1622,warlock,demonology,104,56,48
Welpxd,tichondrius,1621,warlock,demonology,24,17,7
Omertà,staghelm,1621,warlock,demonology,64,36,28
Condevil,quelthalas,1621,warlock,demonology,119,64,55
Mcpickles,illidan,1618,warlock,demonology,30,19,11
Epinetheus,stormrage,1617,warlock,demonology,54,23,31
Soreanus,illidan,1615,warlock,demonology,48,30,18
Dotzor,area-52,1615,warlock,demonology,58,35,23
Zantology,frostmourne,1615,warlock,demonology,54,31,23
Krýptizl,frostmourne,1615,warlock,demonology,81,45,36
Perfectíon,tichondrius,1614,warlock,demonology,30,19,11
Sickmade,zuljin,1612,warlock,demonology,126,72,54
Eternalsmile,tichondrius,1612,warlock,demonology,48,27,21
Garcheros,ragnaros,1612,warlock,demonology,63,33,30
Yükina,stormrage,1611,warlock,demonology,54,29,25
Xanetor,illidan,1611,warlock,demonology,58,31,27
Vawns,zuljin,1611,warlock,demonology,47,24,23
Rasildur,ragnaros,1611,warlock,demonology,61,27,34
Hulkyy,illidan,1610,warlock,demonology,131,70,61
Celestialock,tichondrius,1609,warlock,demonology,55,38,17
Hentry,sargeras,1609,warlock,demonology,53,28,25
Hers,vashj,1608,warlock,demonology,54,34,20
Gulßad,tichondrius,1607,warlock,demonology,36,24,12
Diabolock,proudmoore,1607,warlock,demonology,48,26,22
Vews,firetree,1606,warlock,demonology,36,18,18
Mamabolts,kelthuzad,1605,warlock,demonology,29,18,11
Georky,ragnaros,1605,warlock,demonology,60,36,24
Varian,quelthalas,1604,warlock,demonology,93,53,40
Cambolts,tichondrius,1604,warlock,demonology,36,20,16
Ðåntë,thrall,1604,warlock,demonology,56,29,27
Ktlock,frostmourne,1603,warlock,demonology,114,65,49
Emperator,quelthalas,1603,warlock,demonology,46,25,21
Sarcophagus,duskwood,1602,warlock,demonology,33,18,15
Innocentius,illidan,1602,warlock,demonology,82,42,40
Geauxst,tichondrius,1602,warlock,demonology,62,31,31
Zver,drakkari,1601,warlock,demonology,129,65,64
Zzh,stormrage,1600,warlock,demonology,47,25,22
Toestye,lightbringer,1600,warlock,demonology,108,56,52
Empiratore,quelthalas,1598,warlock,demonology,65,30,35
Krolczdots,tichondrius,1597,warlock,demonology,48,30,18
Valkynaris,chogall,1594,warlock,demonology,30,20,10
Warlocklmao,malganis,1594,warlock,demonology,36,19,17
Stonelocke,area-52,1594,warlock,demonology,79,40,39
Thalsiani,moon-guard,1592,warlock,demonology,51,27,24
Yanlexx,stormrage,1592,warlock,demonology,86,44,42
Funkminot,illidan,1592,warlock,demonology,343,175,168
Amour,wyrmrest-accord,1592,warlock,demonology,58,26,32
Raisa,chogall,1588,warlock,demonology,54,25,29
Silentfears,tichondrius,1585,warlock,demonology,57,35,22
Yazonics,area-52,1585,warlock,demonology,91,49,42
Creepydotman,mannoroth,1584,warlock,demonology,28,18,10
Ioroselmi,illidan,1583,warlock,demonology,68,45,23
Tsunamibaby,anvilmar,1583,warlock,demonology,138,77,61
Nyhn,bleeding-hollow,1582,warlock,demonology,44,28,16
Raidspot,bleeding-hollow,1581,warlock,demonology,72,40,32
Goorock,area-52,1581,warlock,demonology,78,40,38
Curseifier,frostmourne,1579,warlock,demonology,62,33,29
Bïcho,queldorei,1578,warlock,demonology,42,21,21
Dreamsw,frostmourne,1578,warlock,demonology,36,18,18
Agertis,frostmourne,1578,warlock,demonology,42,18,24
Nttslock,tichondrius,1575,warlock,demonology,48,24,24
Sadgellation,arthas,1574,warlock,demonology,42,27,15
Redbullsz,bleeding-hollow,1573,warlock,demonology,68,34,34
Wawrlock,stormrage,1572,warlock,demonology,38,27,11
Davekoresh,dunemaul,1571,warlock,demonology,50,27,23
Xephostwo,area-52,1567,warlock,demonology,42,20,22
Xaryl,stormrage,1564,warlock,demonology,108,52,56
Caesaros,quelthalas,1563,warlock,demonology,105,49,56
Krixaus,lightnings-blade,1562,warlock,demonology,36,19,17
Blastfinger,tichondrius,1556,warlock,demonology,78,39,39
Fullxd,quelthalas,1551,warlock,demonology,54,31,23
Bagn,tichondrius,1548,warlock,demonology,48,23,25
Spooknjuke,bleeding-hollow,1546,warlock,demonology,41,26,15
Pollodelight,deathwing,1543,warlock,demonology,54,31,23
Bauchalain,area-52,1541,warlock,demonology,36,21,15
Lamo,dawnbringer,1537,warlock,demonology,232,117,115
Maldinath,sargeras,1535,warlock,demonology,24,16,8
Cilium,illidan,1535,warlock,demonology,68,36,32
Soulrulerxc,tichondrius,1534,warlock,demonology,30,16,14
Isometrics,barthilas,1534,warlock,demonology,30,16,14
Heartpvp,tichondrius,1532,warlock,demonology,92,48,44
Forsâken,tichondrius,1531,warlock,demonology,95,42,53
Breadbug,moon-guard,1530,warlock,demonology,18,16,2
Giantgobrin,zuljin,1529,warlock,demonology,30,16,14
Miryem,illidan,1528,warlock,demonology,73,38,35
Blliizz,aegwynn,1526,warlock,demonology,24,16,8
Proletariat,moon-guard,1525,warlock,demonology,88,51,37
Wollylock,dark-iron,1520,warlock,demonology,52,25,27
Possapp,azralon,1520,warlock,demonology,91,43,48
Guisls,azralon,1518,warlock,demonology,84,42,42
Richactress,tichondrius,1517,warlock,demonology,24,16,8
Seekma,gallywix,1515,warlock,demonology,48,26,22
Zrò,bleeding-hollow,1512,warlock,demonology,30,17,13
Kandrus,moon-guard,1508,warlock,demonology,158,79,79
Comina,kelthuzad,1507,warlock,demonology,36,16,20
Spookyfurry,area-52,1506,warlock,demonology,107,60,47
Parmenides,tichondrius,1502,warlock,demonology,112,56,56
Icemanliddel,area-52,1500,warlock,demonology,35,16,19
Shigero,tichondrius,1494,warlock,demonology,30,19,11
Reczy,azralon,1494,warlock,demonology,30,16,14
Valerik,azralon,1494,warlock,demonology,73,37,36
Prägä,drakkari,1493,warlock,demonology,51,27,24
Gigagnomer,kelthuzad,1493,warlock,demonology,77,35,42
Houdneeznuts,tichondrius,1491,warlock,demonology,178,93,85
Dárklórd,dalaran,1491,warlock,demonology,262,135,127
Volanti,bleeding-hollow,1488,warlock,demonology,60,32,28
Abismoarmdr,ragnaros,1488,warlock,demonology,156,82,74
Deathcyth,crushridge,1487,warlock,demonology,215,113,102
Damerus,illidan,1487,warlock,demonology,57,24,33
Wickdways,daggerspine,1486,warlock,demonology,60,33,27
Eriand,nordrassil,1482,warlock,demonology,108,54,54
Mindfulchimp,sargeras,1480,warlock,demonology,49,27,22
Zhoull,thrall,1479,warlock,demonology,48,23,25
Grixis,zuluhed,1478,warlock,demonology,36,23,13
Musgrin,gallywix,1478,warlock,demonology,87,44,43
Thekook,illidan,1478,warlock,demonology,61,30,31
Sacrilege,zuljin,1474,warlock,demonology,30,18,12
Fabriziø,ragnaros,1472,warlock,demonology,31,21,10
Mssy,illidan,1470,warlock,demonology,29,16,13
Kyller,quelthalas,1470,warlock,demonology,30,16,14
Tubarão,azralon,1467,warlock,demonology,42,26,16
Khanaan,illidan,1466,warlock,demonology,30,16,14
Smallj,zuljin,1464,warlock,demonology,66,29,37
Blavindy,illidan,1461,warlock,demonology,54,26,28
Sugarwaffles,area-52,1460,warlock,demonology,60,33,27
Immortallock,tichondrius,1454,warlock,demonology,96,48,48
Dcpwns,arthas,1452,warlock,demonology,108,53,55
Kothoped,wyrmrest-accord,1451,warlock,demonology,41,20,21
Kìllèrgf,area-52,1451,warlock,demonology,273,132,141
Gandorf,alleria,1451,warlock,demonology,54,26,28
Malegnant,proudmoore,1442,warlock,demonology,42,20,22
Imgxyz,frostmourne,1441,warlock,demonology,54,32,22
Licmash,fizzcrank,1441,warlock,demonology,42,21,21
Darkwîngduck,illidan,1439,warlock,demonology,24,15,9
Epícburn,illidan,1439,warlock,demonology,28,16,12
Exuslock,tichondrius,1438,warlock,demonology,24,15,9
Ötì,altar-of-storms,1437,warlock,demonology,30,18,12
Sosahawk,stormrage,1437,warlock,demonology,30,15,15
Dottcha,blackrock,1436,warlock,demonology,24,15,9
Zorah,quelthalas,1436,warlock,demonology,42,22,20
Chaosboltlol,tichondrius,1436,warlock,demonology,30,15,15
Medallok,laughing-skull,1435,warlock,demonology,150,76,74
Fluj,sargeras,1434,warlock,demonology,24,15,9
Decolock,tichondrius,1433,warlock,demonology,24,15,9
Helyana,illidan,1433,warlock,demonology,53,31,22
Synisterlock,moon-guard,1433,warlock,demonology,42,21,21
Fluffylockk,bloodscalp,1432,warlock,demonology,103,54,49
Intura,burning-legion,1431,warlock,demonology,63,34,29
Aomniloltv,zuljin,1426,warlock,demonology,24,15,9
Zxyastra,hyjal,1426,warlock,demonology,30,17,13
Mothapucka,thrall,1426,warlock,demonology,47,21,26
Løcalplugxø,barthilas,1425,warlock,demonology,24,15,9
Diosban,malganis,1422,warlock,demonology,36,16,20
Hibíky,ragnaros,1422,warlock,demonology,36,15,21
Middot,area-52,1422,warlock,demonology,106,44,62
Homeschooler,darkspear,1421,warlock,demonology,30,15,15
Arlenna,sargeras,1419,warlock,demonology,128,60,68
Mixolydian,malganis,1416,warlock,demonology,30,15,15
Marowyth,ragnaros,1415,warlock,demonology,48,27,21
Bou,gorefiend,1414,warlock,demonology,36,15,21
Mysteryannie,tichondrius,1411,warlock,demonology,88,53,35
Kuyog,illidan,1411,warlock,demonology,66,33,33
Ganknãmstyle,illidan,1411,warlock,demonology,65,31,34
Laggyturbo,barthilas,1409,warlock,demonology,66,38,28
Rotsndotss,thrall,1408,warlock,demonology,48,20,28
Sayatar,ragnaros,1406,warlock,demonology,36,19,17
Ipickcotton,barthilas,1404,warlock,demonology,36,17,19
Aboode,blackrock,1404,warlock,demonology,36,16,20
Kogath,thunderlord,1403,warlock,demonology,69,32,37
Siaokuai,tichondrius,1403,warlock,demonology,36,15,21
Munick,spirestone,1402,warlock,demonology,45,29,16
Adlfcritler,emerald-dream,1402,warlock,demonology,36,19,17
Monstir,sargeras,1396,warlock,demonology,31,16,15
Sphîñx,sargeras,1394,warlock,demonology,62,29,33
Suminl,tichondrius,1392,warlock,demonology,24,15,9
Kuroyt,drakkari,1390,warlock,demonology,67,32,35
Avoidence,tanaris,1389,warlock,demonology,36,19,17
Esdreel,ragnaros,1385,warlock,demonology,123,57,66
Smartpimp,tichondrius,1384,warlock,demonology,48,26,22
Kotica,stormrage,1382,warlock,demonology,40,19,21
Bashel,sargeras,1381,warlock,demonology,36,23,13
Guldorum,kiljaeden,1375,warlock,demonology,48,28,20
Nezsarek,sargeras,1373,warlock,demonology,41,22,19
Destrokk,gorefiend,1372,warlock,demonology,42,24,18
Catarina,kaelthas,1371,warlock,demonology,28,15,13
Bojàck,stormrage,1370,warlock,demonology,30,17,13
Mocreia,azralon,1370,warlock,demonology,34,16,18
Boltsfordays,dalaran,1359,warlock,demonology,66,24,42
Felorc,wyrmrest-accord,1358,warlock,demonology,63,39,24
Narcan,arthas,1358,warlock,demonology,35,16,19
Tizzy,malganis,1356,warlock,demonology,38,25,13
Conilus,malganis,1354,warlock,demonology,48,20,28
Lintlickin,bonechewer,1353,warlock,demonology,20,15,5
Lemongillo,stormrage,1349,warlock,demonology,65,34,31
Menedemus,amanthul,1349,warlock,demonology,44,18,26
Ellynaria,nemesis,1343,warlock,demonology,18,14,4
Gnomechomski,magtheridon,1343,warlock,demonology,24,14,10
Idotû,tichondrius,1343,warlock,demonology,30,14,16
Joung,tichondrius,1342,warlock,demonology,24,14,10
Thumperrz,frostmourne,1342,warlock,demonology,24,14,10
Slothycrip,emerald-dream,1342,warlock,demonology,36,14,22
Gotfear,zuljin,1341,warlock,demonology,298,152,146
Demonalien,malganis,1339,warlock,demonology,18,14,4
Fearbarx,illidan,1339,warlock,demonology,24,14,10
Tickleskin,windrunner,1337,warlock,demonology,117,60,57
Antigotenent,sargeras,1336,warlock,demonology,24,14,10
Djvetis,blackhand,1336,warlock,demonology,24,14,10
Jamesiyah,moon-guard,1333,warlock,demonology,60,29,31
Durgamon,kirin-tor,1331,warlock,demonology,30,14,16
Praemonium,dalaran,1330,warlock,demonology,24,14,10
Smôkedsôul,area-52,1330,warlock,demonology,24,14,10
Ézman,tichondrius,1330,warlock,demonology,24,14,10
Bestwarlock,skywall,1328,warlock,demonology,30,14,16
Eldriptch,kelthuzad,1325,warlock,demonology,27,15,12
Stormrift,sargeras,1325,warlock,demonology,36,14,22
Memon,frostmane,1324,warlock,demonology,65,29,36
Es,velen,1321,warlock,demonology,144,74,70
Superjuno,sargeras,1319,warlock,demonology,18,14,4
Warlockluo,tichondrius,1319,warlock,demonology,24,14,10
Dawdrax,gallywix,1313,warlock,demonology,22,15,7
Jokerks,tichondrius,1310,warlock,demonology,23,14,9
Jæja,wyrmrest-accord,1309,warlock,demonology,29,14,15
Mechamaca,black-dragonflight,1308,warlock,demonology,96,45,51
Spicydots,arthas,1307,warlock,demonology,123,64,59
Andlerock,emerald-dream,1305,warlock,demonology,37,22,15
Brawndelock,stormrage,1304,warlock,demonology,60,26,34
Sû,stormrage,1301,warlock,demonology,84,40,44
Shadowflame,skullcrusher,1299,warlock,demonology,91,48,43
Salacia,chogall,1299,warlock,demonology,201,100,101
Yoyoling,illidan,1298,warlock,demonology,300,151,149
Critthis,illidan,1297,warlock,demonology,30,14,16
Daesire,moon-guard,1295,warlock,demonology,30,14,16
Valerilma,azralon,1284,warlock,demonology,40,18,22
Warlockdelux,thrall,1282,warlock,demonology,54,20,34
Gauul,illidan,1281,warlock,demonology,70,39,31
Heathncraig,illidan,1279,warlock,demonology,50,29,21
Screampied,sargeras,1279,warlock,demonology,53,24,29
Teron,stonemaul,1277,warlock,demonology,48,29,19
Regime,deathwing,1275,warlock,demonology,24,14,10
Grimrizz,ragnaros,1274,warlock,demonology,31,20,11
Cornboil,tichondrius,1274,warlock,demonology,57,27,30
Dôctor,tichondrius,1274,warlock,demonology,64,30,34
Voidwarlord,tichondrius,1271,warlock,demonology,107,56,51
Stargasms,blackrock,1266,warlock,demonology,64,31,33
Willsayan,ragnaros,1266,warlock,demonology,42,16,26
Bluffzlock,boulderfist,1260,warlock,demonology,23,14,9
Owwie,malganis,1258,warlock,demonology,22,14,8
Lockeem,jubeithos,1258,warlock,demonology,87,41,46
Bänno,bleeding-hollow,1256,warlock,demonology,29,14,15
Falcarr,proudmoore,1251,warlock,demonology,39,19,20
Wazog,jubeithos,1250,warlock,demonology,30,16,14
Adonege,tichondrius,1248,warlock,demonology,24,13,11
Deathboltx,zuljin,1248,warlock,demonology,24,13,11
Drakatat,tichondrius,1248,warlock,demonology,24,13,11
Pfhear,area-52,1247,warlock,demonology,24,13,11
Imbooms,blackrock,1247,warlock,demonology,24,13,11
Mukkamuk,shadowmoon,1246,warlock,demonology,18,13,5
Zoagen,ragnaros,1245,warlock,demonology,18,13,5
Evianne,skywall,1244,warlock,demonology,30,13,17
Warlockafk,darkspear,1242,warlock,demonology,24,17,7
Beerbolt,dalaran,1242,warlock,demonology,24,13,11
Sashafive,proudmoore,1241,warlock,demonology,24,13,11
Pardoned,stormrage,1241,warlock,demonology,36,13,23
Demonkiiller,kelthuzad,1237,warlock,demonology,30,13,17
Tomzombe,durotan,1233,warlock,demonology,18,13,5
Drain,proudmoore,1233,warlock,demonology,18,13,5
Devilin,drakkari,1232,warlock,demonology,30,13,17
Lpharji,tichondrius,1231,warlock,demonology,24,13,11
Alaren,korgath,1231,warlock,demonology,36,13,23
Bazeni,frostmourne,1230,warlock,demonology,42,23,19
Artmaster,nordrassil,1229,warlock,demonology,42,28,14
Welendiock,malganis,1228,warlock,demonology,43,21,22
Symplicìty,area-52,1219,warlock,demonology,24,13,11
Aniie,nemesis,1212,warlock,demonology,78,35,43
Demophile,bleeding-hollow,1204,warlock,demonology,24,18,6
Naydene,moon-guard,1190,warlock,demonology,72,33,39
Braylon,azuremyst,1185,warlock,demonology,30,15,15
Adistril,bleeding-hollow,1182,warlock,demonology,48,14,34
Syndrielle,emerald-dream,1181,warlock,demonology,54,22,32
Snuffer,detheroc,1164,warlock,demonology,30,13,17
Stankidanky,illidan,1156,warlock,demonology,30,18,12
Jezzika,azralon,1155,warlock,demonology,81,33,48
Voidxz,tichondrius,1152,warlock,demonology,18,12,6
Thefunk,tichondrius,1152,warlock,demonology,18,12,6
Kossnen,shandris,1151,warlock,demonology,18,12,6
Khaozx,ragnaros,1151,warlock,demonology,18,12,6
Soorisoori,tichondrius,1151,warlock,demonology,24,12,12
Demise,azuremyst,1151,warlock,demonology,24,12,12
Symaitiel,azralon,1151,warlock,demonology,24,12,12
Bigdaddyborr,arthas,1151,warlock,demonology,24,12,12
Demonia,dathremar,1151,warlock,demonology,30,12,18
Spectaclol,crushridge,1150,warlock,demonology,18,12,6
Lentil,zuljin,1150,warlock,demonology,18,12,6
Emurog,icecrown,1150,warlock,demonology,18,12,6
Arcaangell,sargeras,1150,warlock,demonology,93,46,47
Bellatriks,nemesis,1149,warlock,demonology,18,12,6
Chipt,kelthuzad,1149,warlock,demonology,30,12,18
Urfucct,burning-blade,1148,warlock,demonology,18,12,6
Firemarshall,stormrage,1148,warlock,demonology,22,13,9
Drkdestro,boulderfist,1148,warlock,demonology,42,12,30
Britnyfears,korgath,1143,warlock,demonology,24,12,12
Freadle,sargeras,1140,warlock,demonology,36,12,24
Päpï,tichondrius,1139,warlock,demonology,18,12,6
Moryan,malfurion,1136,warlock,demonology,33,13,20
Bizcochito,thrall,1134,warlock,demonology,24,12,12
Saltiernuts,malganis,1128,warlock,demonology,48,22,26
Xtralyfe,hyjal,1117,warlock,demonology,22,12,10
Wårloçk,tichondrius,1109,warlock,demonology,29,12,17
Löksöflöve,sargeras,1101,warlock,demonology,60,25,35
Nellon,azralon,1087,warlock,demonology,26,13,13
Elipsis,bloodhoof,1086,warlock,demonology,23,12,11
Eeso,stormrage,1084,warlock,demonology,30,13,17
Sumondeznuts,wyrmrest-accord,1080,warlock,demonology,23,12,11
Damelon,gurubashi,1075,warlock,demonology,53,19,34
Politepvperx,kelthuzad,1070,warlock,demonology,17,12,5
Maroth,elune,1070,warlock,demonology,30,12,18
Lilmollyboy,demon-soul,1068,warlock,demonology,13,12,1
Netherhigh,tichondrius,1061,warlock,demonology,66,32,34
Waii,emerald-dream,1056,warlock,demonology,12,11,1
Bøltqt,tichondrius,1056,warlock,demonology,12,11,1
Igortrikadva,zuljin,1056,warlock,demonology,12,11,1
Maxice,zuljin,1056,warlock,demonology,18,11,7
Menemies,malganis,1056,warlock,demonology,18,11,7
Itzlandox,emerald-dream,1056,warlock,demonology,18,11,7
Starta,tichondrius,1056,warlock,demonology,18,11,7
Samsara,akama,1056,warlock,demonology,18,11,7
Tiltbaseline,emerald-dream,1056,warlock,demonology,24,11,13
Haì,illidan,1055,warlock,demonology,18,11,7
Betterone,azralon,1055,warlock,demonology,18,11,7
Fotmspec,area-52,1055,warlock,demonology,18,11,7
Minervini,kiljaeden,1054,warlock,demonology,12,11,1
Nefertarie,illidan,1054,warlock,demonology,24,11,13
Jblock,zuljin,1053,warlock,demonology,21,12,9
Choas,jaedenar,1051,warlock,demonology,18,11,7
Mêdìvh,tichondrius,1050,warlock,demonology,24,11,13
Zinkro,quelthalas,1049,warlock,demonology,22,12,10
Tròll,moon-guard,1049,warlock,demonology,54,25,29
Prahvstein,shuhalo,1047,warlock,demonology,18,11,7
Tartamuda,ragnaros,1037,warlock,demonology,30,11,19
Yozzik,illidan,1036,warlock,demonology,29,11,18
Rickrock,gnomeregan,1034,warlock,demonology,18,11,7
Mementomøri,quelthalas,1034,warlock,demonology,30,11,19
Westhøf,sargeras,1023,warlock,demonology,17,11,6
Rannieck,dark-iron,1022,warlock,demonology,16,12,4
Snipsfan,hyjal,1021,warlock,demonology,30,11,19
Elyshia,illidan,1008,warlock,demonology,33,12,21
Tichondrus,ragnaros,1007,warlock,demonology,29,11,18
Lukelock,azralon,990,warlock,demonology,22,11,11
Trilleon,eldrethalas,987,warlock,demonology,20,12,8
Uzag,mugthol,975,warlock,demonology,26,11,15
Suwook,tichondrius,960,warlock,demonology,12,10,2
Hecataeus,stormrage,960,warlock,demonology,12,10,2
Vìqtìm,kelthuzad,960,warlock,demonology,12,10,2
Phyxylock,stormrage,960,warlock,demonology,12,10,2
Meltlordqt,mannoroth,960,warlock,demonology,12,10,2
Idiocy,stormrage,960,warlock,demonology,18,10,8
Spacedots,illidan,960,warlock,demonology,18,10,8
Vexice,firetree,960,warlock,demonology,18,10,8
Xyguoguo,tichondrius,960,warlock,demonology,18,10,8
Felegance,proudmoore,960,warlock,demonology,18,10,8
Ragdoll,illidan,960,warlock,demonology,22,11,11
Wdc,illidan,960,warlock,demonology,24,10,14
Millions,barthilas,960,warlock,demonology,24,10,14
Salinar,chogall,959,warlock,demonology,18,10,8
Tesil,tichondrius,959,warlock,demonology,18,10,8
Syraxi,illidan,959,warlock,demonology,18,10,8
Tydar,bleeding-hollow,959,warlock,demonology,18,10,8
Purraisa,tichondrius,959,warlock,demonology,18,10,8
Conely,barthilas,959,warlock,demonology,24,10,14
Criptix,bleeding-hollow,959,warlock,demonology,24,10,14
Lefteexd,tichondrius,959,warlock,demonology,24,10,14
Hâm,dalaran,959,warlock,demonology,36,10,26
Nêlson,area-52,958,warlock,demonology,18,10,8
Lynnha,wyrmrest-accord,958,warlock,demonology,24,10,14
Nurglea,proudmoore,957,warlock,demonology,18,10,8
Shâdowman,stormrage,957,warlock,demonology,18,10,8
Demic,thrall,957,warlock,demonology,24,10,14
Lockswagger,stormrage,956,warlock,demonology,18,10,8
Zaintv,illidan,955,warlock,demonology,18,10,8
Kaertis,emerald-dream,955,warlock,demonology,21,11,10
Fshi,frostmourne,955,warlock,demonology,24,10,14
Anjkh,skullcrusher,955,warlock,demonology,24,10,14
Leine,proudmoore,955,warlock,demonology,24,10,14
Sytrick,bleeding-hollow,955,warlock,demonology,24,10,14
Shalandalina,sargeras,954,warlock,demonology,18,10,8
Canning,shuhalo,954,warlock,demonology,24,10,14
Pestileus,bleeding-hollow,953,warlock,demonology,26,15,11
Juankkii,bonechewer,953,warlock,demonology,18,10,8
Methrocks,emerald-dream,953,warlock,demonology,24,10,14
Sørceress,bonechewer,948,warlock,demonology,18,10,8
Shadowndko,ragnaros,937,warlock,demonology,18,10,8
Velondris,illidan,929,warlock,demonology,46,18,28
Hawkinz,illidan,927,warlock,demonology,23,10,13
Pellah,malganis,926,warlock,demonology,20,11,9
Voldamorte,tichondrius,925,warlock,demonology,23,10,13
Voodootidies,proudmoore,922,warlock,demonology,27,13,14
Demonicdayer,area-52,921,warlock,demonology,19,11,8
Sheara,silver-hand,905,warlock,demonology,24,10,14
Twinklockxx,mannoroth,895,warlock,demonology,23,10,13
Apples,ravencrest,894,warlock,demonology,17,10,7
Bâppo,antonidas,873,warlock,demonology,29,13,16
Muchø,emerald-dream,864,warlock,demonology,12,9,3
Impenjoyer,tichondrius,864,warlock,demonology,12,9,3
Leleth,nordrassil,864,warlock,demonology,12,9,3
Wamage,malganis,864,warlock,demonology,12,9,3
Peterdotz,whisperwind,864,warlock,demonology,13,9,4
Luku,kiljaeden,864,warlock,demonology,18,9,9
Bewær,deathwing,864,warlock,demonology,18,9,9
Lopenx,korgath,864,warlock,demonology,18,9,9
Caduz,stormrage,864,warlock,demonology,18,9,9
Djdemolordx,bleeding-hollow,864,warlock,demonology,18,9,9
Louu,emerald-dream,864,warlock,demonology,18,9,9
Justganmore,tichondrius,864,warlock,demonology,18,9,9
Dxhusky,tichondrius,864,warlock,demonology,18,9,9
Evanylock,proudmoore,864,warlock,demonology,18,9,9
Flangy,kiljaeden,864,warlock,demonology,20,9,11
Yooseok,tichondrius,864,warlock,demonology,24,9,15
Fatals,thrall,863,warlock,demonology,12,9,3
Jorloz,ragnaros,863,warlock,demonology,12,9,3
Crujonez,sargeras,863,warlock,demonology,12,9,3
Criticalpets,stormrage,863,warlock,demonology,18,9,9
Dudebrø,zuluhed,863,warlock,demonology,18,9,9
Greenbukakky,tichondrius,863,warlock,demonology,18,9,9
Hermania,sargeras,863,warlock,demonology,18,9,9
Dotcom,eonar,863,warlock,demonology,24,9,15
Harleyjames,ravenholdt,862,warlock,demonology,12,9,3
Spooppy,thunderlord,862,warlock,demonology,12,9,3
Aînzooalgown,ragnaros,862,warlock,demonology,12,9,3
Tahroden,moon-guard,862,warlock,demonology,18,9,9
Easymac,thunderlord,860,warlock,demonology,24,9,15
Oopsíe,nagrand,860,warlock,demonology,24,9,15
Nécromonster,illidan,852,warlock,demonology,24,9,15
Belloch,frostmourne,851,warlock,demonology,18,9,9
Wakkundoe,tichondrius,846,warlock,demonology,17,9,8
Orbvoid,sargeras,845,warlock,demonology,24,9,15
Smidget,trollbane,842,warlock,demonology,18,9,9
Thoroxa,stormrage,838,warlock,demonology,23,9,14
Blaxzlock,stormscale,831,warlock,demonology,20,10,10
Abantes,area-52,818,warlock,demonology,18,11,7
Demoniclily,kiljaeden,816,warlock,demonology,21,9,12
Cleavüs,stormrage,815,warlock,demonology,11,9,2
Lockman,frostwolf,809,warlock,demonology,25,12,13
Keturáh,garrosh,794,warlock,demonology,28,12,16
Nostractus,azralon,793,warlock,demonology,21,10,11
Getavoided,azralon,778,warlock,demonology,17,10,7
Moramont,stormrage,768,warlock,demonology,12,8,4
Leekeeaynis,frostmourne,768,warlock,demonology,12,8,4
Vølt,illidan,768,warlock,demonology,12,8,4
Rizzofsparta,stormrage,768,warlock,demonology,12,8,4
Lhordeign,area-52,768,warlock,demonology,12,8,4
Bigboltkazar,tichondrius,768,warlock,demonology,12,8,4
Gigabiga,tol-barad,768,warlock,demonology,12,8,4
Famelol,tichondrius,768,warlock,demonology,12,8,4
Asmion,earthen-ring,768,warlock,demonology,12,8,4
Marshyxd,tichondrius,768,warlock,demonology,12,8,4
Westhofs,sargeras,768,warlock,demonology,12,8,4
Sakae,moon-guard,768,warlock,demonology,12,8,4
Gnumbnutz,blades-edge,768,warlock,demonology,12,8,4
Hekion,emerald-dream,768,warlock,demonology,12,8,4
Pvtpotato,tichondrius,768,warlock,demonology,12,8,4
Vasqu,stormrage,768,warlock,demonology,18,8,10
Nismo,trollbane,768,warlock,demonology,18,8,10
Joseph,draktharon,768,warlock,demonology,18,8,10
Niava,tichondrius,768,warlock,demonology,18,8,10
Radii,bladefist,768,warlock,demonology,18,8,10
Nolb,tichondrius,768,warlock,demonology,18,8,10
Dunni,area-52,768,warlock,demonology,18,8,10
Torowasabi,tichondrius,768,warlock,demonology,21,8,13
Neutrinowal,tichondrius,768,warlock,demonology,24,8,16
Puchador,sargeras,768,warlock,demonology,24,8,16
Lemdul,thrall,767,warlock,demonology,12,8,4
Buccs,barthilas,767,warlock,demonology,12,8,4
Gibberishss,tichondrius,767,warlock,demonology,12,8,4
Rosacrutian,tichondrius,767,warlock,demonology,12,8,4
Grendael,area-52,767,warlock,demonology,12,8,4
Nerfdemo,chogall,767,warlock,demonology,18,8,10
Fullmelt,azjolnerub,767,warlock,demonology,18,8,10
Ritzhul,nordrassil,766,warlock,demonology,12,8,4
Elioknight,area-52,766,warlock,demonology,18,8,10
Lustyclam,tichondrius,765,warlock,demonology,12,8,4
Xenagos,antonidas,765,warlock,demonology,18,8,10
Cvntpvntcans,kelthuzad,764,warlock,demonology,18,8,10
Pulentinskin,quelthalas,764,warlock,demonology,24,8,16
Dundreavan,area-52,763,warlock,demonology,18,8,10
Griffoz,frostwolf,763,warlock,demonology,18,8,10
Cslice,magtheridon,746,warlock,demonology,19,12,7
Idoturmum,frostmourne,739,warlock,demonology,28,11,17
Doobielock,kelthuzad,734,warlock,demonology,14,9,5
Eklypso,kelthuzad,714,warlock,demonology,20,9,11
Nurnok,ragnaros,713,warlock,demonology,18,9,9
Tikz,magtheridon,703,warlock,demonology,11,8,3
Playandlock,illidan,672,warlock,demonology,12,7,5
Bestcookies,malganis,672,warlock,demonology,12,7,5
Jweezy,malganis,672,warlock,demonology,12,7,5
Smoogzi,tichondrius,672,warlock,demonology,12,7,5
Juppup,tichondrius,672,warlock,demonology,12,7,5
Lifeinsuranc,tichondrius,672,warlock,demonology,12,7,5
Asiopdu,tichondrius,672,warlock,demonology,12,7,5
Expiredonion,bleeding-hollow,672,warlock,demonology,12,7,5
Syen,quelthalas,672,warlock,demonology,12,7,5
Lilsquirts,kelthuzad,672,warlock,demonology,12,7,5
Zanlockos,dalaran,672,warlock,demonology,12,7,5
Psykana,barthilas,672,warlock,demonology,12,7,5
Isömetrics,barthilas,672,warlock,demonology,12,7,5
Demonmal,frostmourne,672,warlock,demonology,12,7,5
Fearmore,bleeding-hollow,672,warlock,demonology,12,7,5
Agla,quelthalas,672,warlock,demonology,12,7,5
Brothadoinks,zuljin,672,warlock,demonology,12,7,5
Adramelech,thrall,672,warlock,demonology,12,7,5
Drix,wyrmrest-accord,672,warlock,demonology,12,7,5
Vigius,dalaran,672,warlock,demonology,12,7,5
Ðamndaddy,sargeras,672,warlock,demonology,12,7,5
Løckyun,tichondrius,672,warlock,demonology,12,7,5
Nockdreal,azralon,672,warlock,demonology,12,7,5
Lánathel,ragnaros,672,warlock,demonology,12,7,5
Protomán,agamaggan,672,warlock,demonology,12,7,5
Sauronne,illidan,672,warlock,demonology,12,7,5
Gearboxx,tichondrius,672,warlock,demonology,12,7,5
Laiquisha,zuljin,672,warlock,demonology,12,7,5
Deammon,tichondrius,672,warlock,demonology,12,7,5
Sorenbjerga,zuljin,672,warlock,demonology,12,7,5
Zeexi,illidan,672,warlock,demonology,12,7,5
Aruotnof,nemesis,672,warlock,demonology,12,7,5
Dadtired,tichondrius,672,warlock,demonology,12,7,5
Demodar,tol-barad,672,warlock,demonology,18,7,11
Staywrong,malganis,672,warlock,demonology,18,7,11
Drippyjones,sargeras,672,warlock,demonology,18,7,11
Urïk,stormrage,672,warlock,demonology,18,7,11
Ranil,mannoroth,672,warlock,demonology,18,7,11
Kytae,malygos,672,warlock,demonology,18,7,11
Acejerk,the-forgotten-coast,672,warlock,demonology,18,7,11
Evarona,gorefiend,672,warlock,demonology,18,7,11
Matrriixx,proudmoore,672,warlock,demonology,18,7,11
Tynks,mannoroth,672,warlock,demonology,18,7,11
Remusdark,exodar,671,warlock,demonology,12,7,5
Felynrith,khadgar,671,warlock,demonology,12,7,5
Faraday,laughing-skull,671,warlock,demonology,12,7,5
Nëcrophil,area-52,671,warlock,demonology,12,7,5
Nigthdeath,nemesis,671,warlock,demonology,12,7,5
Snoosnoo,exodar,671,warlock,demonology,12,7,5
Celindeyn,stormrage,671,warlock,demonology,12,7,5
Saldori,malganis,671,warlock,demonology,12,7,5
Glortheeb,spirestone,671,warlock,demonology,12,7,5
Damagexx,the-underbog,671,warlock,demonology,12,7,5
Lockmau,azralon,671,warlock,demonology,12,7,5
Motyl,area-52,671,warlock,demonology,18,7,11
Dotsfired,crushridge,671,warlock,demonology,18,7,11
Chelythalle,tichondrius,671,warlock,demonology,19,7,12
Sanastik,laughing-skull,670,warlock,demonology,12,7,5
Deanwarlock,sargeras,670,warlock,demonology,12,7,5
Lokiiee,azuremyst,664,warlock,demonology,12,7,5
Tsmcfker,tichondrius,654,warlock,demonology,17,7,10
Chlomakï,azralon,622,warlock,demonology,11,7,4
Heilcyon,illidan,622,warlock,demonology,11,7,4
Chaosboltex,tichondrius,618,warlock,demonology,14,8,6
Apøçàlÿpsè,firetree,618,warlock,demonology,17,9,8
Mssyy,illidan,608,warlock,demonology,10,7,3
Comply,frostmane,592,warlock,demonology,13,7,6
Vueltoachote,stormrage,592,warlock,demonology,13,7,6
Yuoalx,tichondrius,576,warlock,demonology,6,6,0
Spectro,laughing-skull,576,warlock,demonology,6,6,0
Wâg,moon-guard,576,warlock,demonology,6,6,0
Hank,azgalor,576,warlock,demonology,6,6,0
Grimløck,khadgar,576,warlock,demonology,6,6,0
Fakemagician,tichondrius,576,warlock,demonology,6,6,0
Lillpfudd,area-52,576,warlock,demonology,6,6,0
Spook,steamwheedle-cartel,576,warlock,demonology,6,6,0
Hof,bloodscalp,576,warlock,demonology,6,6,0
Toxik,zuljin,576,warlock,demonology,6,6,0
Dingis,bloodscalp,576,warlock,demonology,6,6,0
Dazevil,burning-blade,576,warlock,demonology,6,6,0
Honne,sargeras,576,warlock,demonology,10,7,3
Threedotfivu,proudmoore,576,warlock,demonology,12,6,6
Diabhlaí,tichondrius,576,warlock,demonology,12,6,6
Lafuke,tichondrius,576,warlock,demonology,12,6,6
Vexria,wyrmrest-accord,576,warlock,demonology,12,6,6
Rezw,illidan,576,warlock,demonology,12,6,6
Therru,tichondrius,576,warlock,demonology,12,6,6
Linestrazsa,daggerspine,576,warlock,demonology,12,6,6
Hoonjojjyanl,tichondrius,576,warlock,demonology,12,6,6
Bellath,azralon,576,warlock,demonology,12,6,6
Muchopower,ragnaros,576,warlock,demonology,12,6,6
Marothredd,nathrezim,576,warlock,demonology,12,6,6
Zoerina,fizzcrank,576,warlock,demonology,12,6,6
Rottenhell,kelthuzad,576,warlock,demonology,12,6,6
Oniyooshi,kelthuzad,576,warlock,demonology,12,6,6
Backseatn,tichondrius,576,warlock,demonology,12,6,6
Exxosl,tichondrius,576,warlock,demonology,12,6,6
Buboñic,area-52,576,warlock,demonology,12,6,6
Chaosblade,burning-blade,576,warlock,demonology,12,6,6
Destructio,tichondrius,576,warlock,demonology,12,6,6
Kyralena,stormrage,576,warlock,demonology,12,6,6
Projectpump,kelthuzad,576,warlock,demonology,12,6,6
Graveland,frostwolf,576,warlock,demonology,12,6,6
Dalah,illidan,576,warlock,demonology,12,6,6
Pumpkeenky,hyjal,576,warlock,demonology,12,6,6
Scarletdemon,malganis,576,warlock,demonology,12,6,6
Viejita,quelthalas,576,warlock,demonology,12,6,6
Yaldin,nemesis,576,warlock,demonology,12,6,6
Conboii,tichondrius,576,warlock,demonology,12,6,6
Sorath,blackrock,576,warlock,demonology,12,6,6
Meelady,tichondrius,576,warlock,demonology,12,6,6
Westhofz,tichondrius,576,warlock,demonology,12,6,6
Eddybigbolts,tichondrius,576,warlock,demonology,12,6,6
Babybolt,frostmourne,576,warlock,demonology,12,6,6
Davidofbowie,burning-legion,576,warlock,demonology,12,6,6
Artzul,tichondrius,576,warlock,demonology,15,7,8
Tribulatiön,moon-guard,576,warlock,demonology,18,6,12
Yungwilly,silvermoon,576,warlock,demonology,18,6,12
Dreadful,frostmourne,576,warlock,demonology,18,6,12
Shadowhax,area-52,576,warlock,demonology,18,6,12
Mucholock,azralon,576,warlock,demonology,18,6,12
Dranovis,illidan,576,warlock,demonology,18,6,12
Ragnalock,laughing-skull,576,warlock,demonology,20,6,14
Shadü,tichondrius,576,warlock,demonology,25,6,19
Lockazo,quelthalas,575,warlock,demonology,6,6,0
Szell,caelestrasz,575,warlock,demonology,12,6,6
Ronacq,norgannon,575,warlock,demonology,12,6,6
Syndel,drakkari,575,warlock,demonology,12,6,6
Sinissa,ysondre,575,warlock,demonology,12,6,6
Sylvanes,emerald-dream,575,warlock,demonology,12,6,6
Doomczar,frostmane,575,warlock,demonology,12,6,6
Voidgown,moon-guard,575,warlock,demonology,12,6,6
Lollilock,area-52,575,warlock,demonology,12,6,6
Twototheone,illidan,575,warlock,demonology,12,6,6
Sinaman,barthilas,575,warlock,demonology,17,6,11
Daliadark,sargeras,575,warlock,demonology,21,6,15
Xanlel,deathwing,574,warlock,demonology,18,6,12
Yury,scarlet-crusade,574,warlock,demonology,18,6,12
Undeadcurse,frostmourne,574,warlock,demonology,24,6,18
Algard,emerald-dream,573,warlock,demonology,12,6,6
Däemön,area-52,573,warlock,demonology,12,6,6
Tenletters,kirin-tor,558,warlock,demonology,13,7,6
ßaphomet,blackrock,543,warlock,demonology,11,6,5
Jafi,coilfang,543,warlock,demonology,17,6,11
Penzer,stormrage,528,warlock,demonology,15,6,9
Ceeloww,illidan,527,warlock,demonology,11,6,5
Constantine,exodar,527,warlock,demonology,17,6,11
Mourdera,ragnaros,522,warlock,demonology,14,7,7
Dodgebolts,khaz-modan,480,warlock,demonology,6,5,1
Valraths,arthas,480,warlock,demonology,6,5,1
Sinixx,tichondrius,480,warlock,demonology,6,5,1
Igniz,tichondrius,480,warlock,demonology,6,5,1
Floorlamp,anvilmar,480,warlock,demonology,6,5,1
Nos,bleeding-hollow,480,warlock,demonology,6,5,1
Niadmer,gnomeregan,480,warlock,demonology,6,5,1
Wybbukk,wyrmrest-accord,480,warlock,demonology,6,5,1
Viralwashbrn,illidan,480,warlock,demonology,6,5,1
Seutóóbinha,stormrage,480,warlock,demonology,6,5,1
Leyzer,stormrage,480,warlock,demonology,6,5,1
Conboi,tichondrius,480,warlock,demonology,6,5,1
Necrotko,malganis,480,warlock,demonology,6,5,1
Reneqtxo,frostmourne,480,warlock,demonology,6,5,1
Huloo,blades-edge,480,warlock,demonology,6,5,1
Druzzaj,thrall,480,warlock,demonology,6,5,1
Conboee,tichondrius,480,warlock,demonology,6,5,1
Gavvi,frostmourne,480,warlock,demonology,6,5,1
Sêrok,tichondrius,480,warlock,demonology,6,5,1
Norran,nemesis,480,warlock,demonology,6,5,1
Drainedd,blades-edge,480,warlock,demonology,6,5,1
Sapaqlia,quelthalas,480,warlock,demonology,6,5,1
Vapeboi,bleeding-hollow,480,warlock,demonology,6,5,1
Mitchosx,frostmourne,480,warlock,demonology,6,5,1
Tiatiatia,illidan,480,warlock,demonology,6,5,1
Linctowncar,sargeras,480,warlock,demonology,6,5,1
Rotkid,barthilas,480,warlock,demonology,6,5,1
Sixv,barthilas,480,warlock,demonology,6,5,1
Charlieo,barthilas,480,warlock,demonology,6,5,1
Velrose,thrall,480,warlock,demonology,6,5,1
Crilock,quelthalas,480,warlock,demonology,10,6,4
Darktias,quelthalas,480,warlock,demonology,11,6,5
Beaknasty,sargeras,480,warlock,demonology,12,5,7
Lockonthc,korgath,480,warlock,demonology,12,5,7
Demonâ,ragnaros,480,warlock,demonology,12,5,7
Zelxor,tichondrius,480,warlock,demonology,12,5,7
Rooms,sargeras,480,warlock,demonology,12,5,7
Phylox,cenarius,480,warlock,demonology,12,5,7
Perkz,moon-guard,480,warlock,demonology,12,5,7
Grandmama,tichondrius,480,warlock,demonology,12,5,7
Breeak,sargeras,480,warlock,demonology,12,5,7
Alataar,sargeras,480,warlock,demonology,12,5,7
Drugmuffin,tichondrius,480,warlock,demonology,12,5,7
Wheremyshoes,area-52,480,warlock,demonology,12,5,7
Beaknstein,sargeras,480,warlock,demonology,12,5,7
Dapperdanxy,tichondrius,480,warlock,demonology,12,5,7
Klumzey,tichondrius,480,warlock,demonology,12,5,7
Mânuel,akama,480,warlock,demonology,12,5,7
Salsong,draka,480,warlock,demonology,12,5,7
Grandpapapa,tichondrius,480,warlock,demonology,12,5,7
Sinápsís,ragnaros,480,warlock,demonology,12,5,7
Meisy,quelthalas,480,warlock,demonology,12,5,7
Bepis,emerald-dream,480,warlock,demonology,12,5,7
Grineed,emerald-dream,480,warlock,demonology,12,5,7
Dewandoritos,kelthuzad,480,warlock,demonology,12,5,7
Démoniaque,garrosh,480,warlock,demonology,12,5,7
Dkdakìng,dalaran,480,warlock,demonology,12,5,7
Zarinista,veknilash,480,warlock,demonology,12,5,7
Rumpology,illidan,480,warlock,demonology,12,5,7
Aellorie,proudmoore,480,warlock,demonology,12,5,7
Movvo,queldorei,480,warlock,demonology,12,5,7
Yanned,hakkar,480,warlock,demonology,12,5,7
Søcks,tichondrius,480,warlock,demonology,12,5,7
Aniuk,bloodhoof,480,warlock,demonology,12,5,7
Liuh,tichondrius,480,warlock,demonology,12,5,7
Gandreleda,wyrmrest-accord,480,warlock,demonology,16,6,10
Paleontology,moon-guard,480,warlock,demonology,14,5,9
Jancilianna,stormrage,480,warlock,demonology,24,5,19
Sagaema,silvermoon,479,warlock,demonology,6,5,1
Eflock,barthilas,479,warlock,demonology,12,5,7
Stinkmeaner,chogall,479,warlock,demonology,12,5,7
Deathlowkz,area-52,479,warlock,demonology,12,5,7
Omegawarlock,quelthalas,479,warlock,demonology,18,5,13
Lockybalbowa,amanthul,479,warlock,demonology,18,5,13
Iolitee,khazgoroth,477,warlock,demonology,12,5,7
Sathorastus,spirestone,448,warlock,demonology,10,6,4
Rentacletape,kelthuzad,447,warlock,demonology,9,6,3
Agaros,zuljin,426,warlock,demonology,17,6,11
Iromath,sargeras,415,warlock,demonology,8,5,3
Fokâi,sargeras,415,warlock,demonology,14,5,9
Rosalynda,azralon,398,warlock,demonology,10,5,5
Decentraland,tichondrius,384,warlock,demonology,6,4,2
Tiddliwinx,nordrassil,384,warlock,demonology,6,4,2
Lhorgainz,area-52,384,warlock,demonology,6,4,2
Hauntedhøuse,area-52,384,warlock,demonology,6,4,2
Fanzhiyi,illidan,384,warlock,demonology,6,4,2
Vesaloth,zuljin,384,warlock,demonology,6,4,2
Thanock,illidan,384,warlock,demonology,6,4,2
Xekk,wyrmrest-accord,384,warlock,demonology,6,4,2
Mazzaleen,area-52,384,warlock,demonology,6,4,2
Kamohoalii,bleeding-hollow,384,warlock,demonology,6,4,2
Zidus,tichondrius,384,warlock,demonology,6,4,2
Poppadot,korgath,384,warlock,demonology,6,4,2
Dotudead,kelthuzad,384,warlock,demonology,6,4,2
Nightblloom,illidan,384,warlock,demonology,6,4,2
Quonton,tichondrius,384,warlock,demonology,6,4,2
Frustration,darkspear,384,warlock,demonology,6,4,2
Alchan,tichondrius,384,warlock,demonology,6,4,2
Coomerdoomer,stormrage,384,warlock,demonology,6,4,2
Kernlberton,tichondrius,384,warlock,demonology,6,4,2
Lockniel,skullcrusher,384,warlock,demonology,6,4,2
Karmalock,malganis,384,warlock,demonology,6,4,2
Hordefella,malganis,384,warlock,demonology,6,4,2
Lizlock,stormrage,384,warlock,demonology,6,4,2
Viamie,illidan,384,warlock,demonology,6,4,2
Brujever,ragnaros,384,warlock,demonology,6,4,2
Curpt,the-scryers,384,warlock,demonology,6,4,2
Viejitaa,quelthalas,384,warlock,demonology,6,4,2
Ulthràn,quelthalas,384,warlock,demonology,6,4,2
Vilebrute,illidan,384,warlock,demonology,6,4,2
Narcissist,tanaris,384,warlock,demonology,6,4,2
Sakuin,bonechewer,384,warlock,demonology,6,4,2
Deathage,crushridge,384,warlock,demonology,6,4,2
Rodneyjones,emerald-dream,384,warlock,demonology,6,4,2
Famington,tichondrius,384,warlock,demonology,6,4,2
Khalamar,steamwheedle-cartel,384,warlock,demonology,6,4,2
Ahp,stormrage,384,warlock,demonology,6,4,2
Ethero,emerald-dream,384,warlock,demonology,6,4,2
Meep,madoran,384,warlock,demonology,6,4,2
Helheim,haomarush,384,warlock,demonology,6,4,2
Retaruko,illidan,384,warlock,demonology,6,4,2
Jorit,argent-dawn,384,warlock,demonology,6,4,2
Ombiez,moonrunner,384,warlock,demonology,6,4,2
Syíthe,sargeras,384,warlock,demonology,6,4,2
Drekka,bleeding-hollow,384,warlock,demonology,6,4,2
Crayonchewer,alleria,384,warlock,demonology,6,4,2
Mmfoodisgood,dalaran,384,warlock,demonology,6,4,2
Bigmancam,illidan,384,warlock,demonology,6,4,2
Conjur,barthilas,384,warlock,demonology,6,4,2
Ardam,cenarion-circle,384,warlock,demonology,6,4,2
Moräl,frostmourne,384,warlock,demonology,6,4,2
Mädzy,azralon,384,warlock,demonology,6,4,2
Nerolock,frostmourne,384,warlock,demonology,6,4,2
Mobilecherpn,frostmourne,384,warlock,demonology,6,4,2
Kyrionn,azralon,384,warlock,demonology,6,4,2
Dashaad,illidan,384,warlock,demonology,6,4,2
Hélà,sargeras,384,warlock,demonology,6,4,2
Logixo,sargeras,384,warlock,demonology,7,4,3
Warlooch,area-52,384,warlock,demonology,9,5,4
Woudini,malganis,384,warlock,demonology,10,5,5
Lockhomes,azralon,384,warlock,demonology,10,5,5
Jvilla,tichondrius,384,warlock,demonology,8,4,4
Borudo,thrall,384,warlock,demonology,12,4,8
Nazare,tichondrius,384,warlock,demonology,12,4,8
Monstermime,wildhammer,384,warlock,demonology,12,4,8
Tahmrin,quelthalas,384,warlock,demonology,12,4,8
Rylal,illidan,384,warlock,demonology,12,4,8
Uarus,tichondrius,384,warlock,demonology,12,4,8
Greenkaren,azralon,384,warlock,demonology,12,4,8
Pìnto,illidan,384,warlock,demonology,12,4,8
Soulrman,tichondrius,384,warlock,demonology,12,4,8
Diekast,tichondrius,384,warlock,demonology,12,4,8
Shadococo,tichondrius,384,warlock,demonology,12,4,8
Ddorangmoon,tichondrius,384,warlock,demonology,12,4,8
Deatt,deathwing,384,warlock,demonology,12,4,8
Warhola,tichondrius,384,warlock,demonology,12,4,8
Glizzÿ,thrall,384,warlock,demonology,12,4,8
Warlack,jubeithos,384,warlock,demonology,12,4,8
Ven,dalaran,384,warlock,demonology,12,4,8
Dogcookie,moon-guard,384,warlock,demonology,12,4,8
Srz,stormrage,384,warlock,demonology,12,4,8
Picklecatz,barthilas,384,warlock,demonology,12,4,8
Rumjugs,barthilas,384,warlock,demonology,12,4,8
Xoxoxu,frostmourne,384,warlock,demonology,12,4,8
Naz,shadowsong,384,warlock,demonology,12,4,8
Arsaurelica,blackrock,384,warlock,demonology,12,4,8
Frezy,stormrage,384,warlock,demonology,12,4,8
Dotsandpot,malfurion,384,warlock,demonology,12,4,8
Çheesestick,dalaran,384,warlock,demonology,12,4,8
Marty,stormrage,384,warlock,demonology,12,4,8
Tofulery,tichondrius,384,warlock,demonology,18,4,14
Dagadon,arathor,384,warlock,demonology,24,4,20
Greems,tichondrius,383,warlock,demonology,6,4,2
Squibley,sargeras,383,warlock,demonology,10,5,5
Xandemic,tichondrius,383,warlock,demonology,12,4,8
Meminissemus,ragnaros,383,warlock,demonology,12,4,8
Daggondai,tichondrius,383,warlock,demonology,12,4,8
Freshimps,blood-furnace,367,warlock,demonology,11,4,7
Sharee,azuremyst,363,warlock,demonology,11,4,7
Butterboyx,stormrage,351,warlock,demonology,11,4,7
Ärminvßuurën,barthilas,351,warlock,demonology,11,4,7
Manosverdes,tichondrius,336,warlock,demonology,9,4,5
Donce,tichondrius,319,warlock,demonology,5,4,1
Pizzanipple,illidan,319,warlock,demonology,5,4,1
Westhofzx,sargeras,319,warlock,demonology,5,4,1
Rycho,tichondrius,319,warlock,demonology,5,4,1
Pulpfliction,kiljaeden,304,warlock,demonology,13,4,9
Drsauce,sargeras,288,warlock,demonology,6,3,3
Chody,sargeras,288,warlock,demonology,6,3,3
Khatrat,azralon,288,warlock,demonology,6,3,3
Wiredftwx,illidan,288,warlock,demonology,6,3,3
Wiredftw,illidan,288,warlock,demonology,6,3,3
Capslock,arthas,288,warlock,demonology,6,3,3
Archleon,smolderthorn,288,warlock,demonology,6,3,3
Azland,proudmoore,288,warlock,demonology,6,3,3
Okul,frostmourne,288,warlock,demonology,6,3,3
Notprint,sargeras,288,warlock,demonology,6,3,3
Jennifear,sargeras,288,warlock,demonology,6,3,3
Khamzatt,proudmoore,288,warlock,demonology,6,3,3
Nightterrour,frostmourne,288,warlock,demonology,6,3,3
Guldylox,kiljaeden,288,warlock,demonology,6,3,3
Ðöts,frostmourne,288,warlock,demonology,6,3,3
Disgustingfk,illidan,288,warlock,demonology,6,3,3
Fatuglyegirl,sargeras,288,warlock,demonology,6,3,3
Saffuky,frostmourne,288,warlock,demonology,6,3,3
Nipz,korialstrasz,288,warlock,demonology,6,3,3
Deadlylock,gilneas,288,warlock,demonology,6,3,3
Catraca,sargeras,288,warlock,demonology,6,3,3
Widenose,agamaggan,288,warlock,demonology,6,3,3
Freyanna,moon-guard,288,warlock,demonology,6,3,3
Bral,hyjal,288,warlock,demonology,6,3,3
Hauntsin,hyjal,288,warlock,demonology,6,3,3
Neruvian,tichondrius,288,warlock,demonology,6,3,3
Shutupthug,illidan,288,warlock,demonology,6,3,3
Insanemids,tichondrius,288,warlock,demonology,6,3,3
Elementzero,malorne,288,warlock,demonology,6,3,3
Srcorvo,azralon,288,warlock,demonology,6,3,3
Ledrlpxlx,bleeding-hollow,288,warlock,demonology,6,3,3
Cyrillus,moon-guard,288,warlock,demonology,6,3,3
Ëfera,nemesis,288,warlock,demonology,6,3,3
Whydemono,tichondrius,288,warlock,demonology,6,3,3
Voldmorto,azralon,288,warlock,demonology,6,3,3
Gulvandan,dathremar,288,warlock,demonology,6,3,3
Iamfear,shuhalo,288,warlock,demonology,6,3,3
Petdaddy,lightninghoof,288,warlock,demonology,6,3,3
Drelgun,aerie-peak,288,warlock,demonology,6,3,3
Elwesthof,ragnaros,288,warlock,demonology,6,3,3
Lilthicy,sargeras,288,warlock,demonology,6,3,3
Locksoul,area-52,288,warlock,demonology,6,3,3
Daqizy,emerald-dream,288,warlock,demonology,6,3,3
Dippndotz,bleeding-hollow,288,warlock,demonology,6,3,3
Lockinha,azralon,288,warlock,demonology,6,3,3
Jèdi,drenden,288,warlock,demonology,6,3,3
Nookíe,azralon,288,warlock,demonology,6,3,3
Domwarlock,uther,288,warlock,demonology,6,3,3
Kodyconner,darkspear,288,warlock,demonology,6,3,3
Schrader,sargeras,288,warlock,demonology,6,3,3
Fancynuts,kiljaeden,288,warlock,demonology,6,3,3
Ðemented,bleeding-hollow,288,warlock,demonology,6,3,3
Feartool,stormrage,288,warlock,demonology,6,3,3
Gotty,stormrage,288,warlock,demonology,6,3,3
Malthaél,kelthuzad,288,warlock,demonology,6,3,3
Muldan,stormrage,288,warlock,demonology,6,3,3
Wasca,kelthuzad,288,warlock,demonology,6,3,3
Sweetmeat,madoran,288,warlock,demonology,6,3,3
Molguzano,ragnaros,288,warlock,demonology,6,3,3
Psyløck,bleeding-hollow,288,warlock,demonology,6,3,3
Darthael,stormrage,288,warlock,demonology,6,3,3
Pikslol,bleeding-hollow,288,warlock,demonology,6,3,3
Emeary,kelthuzad,288,warlock,demonology,6,3,3
Impbiscuit,stormrage,288,warlock,demonology,6,3,3
Devi,executus,288,warlock,demonology,6,3,3
Krystchan,bleeding-hollow,288,warlock,demonology,6,3,3
Fëlgibson,illidan,288,warlock,demonology,6,3,3
Dotomizer,moonrunner,288,warlock,demonology,6,3,3
Breeped,tichondrius,288,warlock,demonology,6,3,3
Feelthefearx,ragnaros,288,warlock,demonology,6,3,3
Dispator,tichondrius,288,warlock,demonology,6,3,3
Bertnasty,tichondrius,288,warlock,demonology,6,3,3
Keezus,area-52,288,warlock,demonology,6,3,3
Superbroly,area-52,288,warlock,demonology,6,3,3
Shìnedown,eonar,288,warlock,demonology,6,3,3
Zhul,nerzhul,288,warlock,demonology,6,3,3
Agonie,tichondrius,288,warlock,demonology,6,3,3
Chars,velen,288,warlock,demonology,6,3,3
Hgma,tichondrius,288,warlock,demonology,6,3,3
Gholra,wyrmrest-accord,288,warlock,demonology,6,3,3
Chaøsbolt,area-52,288,warlock,demonology,6,3,3
Areolaz,kelthuzad,288,warlock,demonology,6,3,3
Poggun,tichondrius,288,warlock,demonology,6,3,3
Naokishi,stormrage,288,warlock,demonology,6,3,3
Élio,quelthalas,288,warlock,demonology,6,3,3
Asmodeun,malganis,288,warlock,demonology,6,3,3
Infear,area-52,288,warlock,demonology,6,3,3
Diebydots,blackrock,288,warlock,demonology,6,3,3
Drerrday,kelthuzad,288,warlock,demonology,6,3,3
Aeonss,stormrage,288,warlock,demonology,6,3,3
Leonito,tichondrius,288,warlock,demonology,6,3,3
Sooshi,malganis,288,warlock,demonology,6,3,3
Crtyodautr,skullcrusher,288,warlock,demonology,6,3,3
Soulruler,tichondrius,288,warlock,demonology,6,3,3
Sangala,malganis,288,warlock,demonology,6,3,3
Alprazoläm,illidan,288,warlock,demonology,14,6,8
Ofcurse,stormrage,288,warlock,demonology,10,3,7
Opacusflamma,kelthuzad,288,warlock,demonology,11,3,8
Strax,shattered-hand,288,warlock,demonology,12,3,9
Pheobebuffay,frostmane,288,warlock,demonology,12,3,9
Wineburger,frostmourne,288,warlock,demonology,12,3,9
Pachips,zuljin,288,warlock,demonology,12,3,9
Iamlavon,area-52,288,warlock,demonology,12,3,9
Kajayak,nazjatar,288,warlock,demonology,12,3,9
Albbanoo,tichondrius,288,warlock,demonology,12,3,9
Tatemor,barthilas,288,warlock,demonology,12,3,9
Westhofs,tichondrius,288,warlock,demonology,12,3,9
Erc,alterac-mountains,288,warlock,demonology,12,3,9
Xephine,proudmoore,288,warlock,demonology,12,3,9
Legïõn,uldaman,288,warlock,demonology,12,3,9
Laklin,stormscale,288,warlock,demonology,12,3,9
Dàmagicman,drakthul,288,warlock,demonology,12,3,9
Jagni,stormrage,288,warlock,demonology,12,3,9
Reckluss,shattered-hand,288,warlock,demonology,12,3,9
Killvilock,kelthuzad,288,warlock,demonology,12,3,9
Crispee,azuremyst,288,warlock,demonology,12,3,9
Didntflush,blood-furnace,288,warlock,demonology,18,3,15
Shadowrift,the-forgotten-coast,287,warlock,demonology,6,3,3
Gbow,malygos,287,warlock,demonology,6,3,3
Ijustsharded,area-52,255,warlock,demonology,11,3,8
Slugworth,rivendare,239,warlock,demonology,5,3,2
Frankandbean,dawnbringer,234,warlock,demonology,7,4,3
Predictions,sargeras,234,warlock,demonology,10,5,5
Deatthmoon,stormrage,234,warlock,demonology,9,4,5
Schofen,tichondrius,234,warlock,demonology,13,4,9
Warlow,mugthol,223,warlock,demonology,14,3,11
Annubyz,quelthalas,208,warlock,demonology,7,3,4
Cocoabuttâ,stormrage,192,warlock,demonology,4,3,1
Javirr,ragnaros,192,warlock,demonology,15,5,10
Trippednfel,stormrage,192,warlock,demonology,6,2,4
Firemike,kelthuzad,192,warlock,demonology,6,2,4
Pikkon,malorne,192,warlock,demonology,6,2,4
Ggaayyooii,anubarak,192,warlock,demonology,6,2,4
Knobbynobbas,stormrage,192,warlock,demonology,6,2,4
Stuffs,wyrmrest-accord,192,warlock,demonology,6,2,4
Xblessed,stormrage,192,warlock,demonology,6,2,4
Hentailust,kiljaeden,192,warlock,demonology,6,2,4
Nanicide,kelthuzad,192,warlock,demonology,6,2,4
Sakyameil,area-52,192,warlock,demonology,6,2,4
Watchmeport,onyxia,192,warlock,demonology,6,2,4
Shipmatelock,stormrage,192,warlock,demonology,6,2,4
Sheshð,stormrage,192,warlock,demonology,6,2,4
Leônidos,ghostlands,192,warlock,demonology,6,2,4
Wreckquiem,draka,192,warlock,demonology,6,2,4
Síkaría,malganis,192,warlock,demonology,6,2,4
Caesis,illidan,192,warlock,demonology,6,2,4
Jkun,malganis,192,warlock,demonology,6,2,4
Karlangax,illidan,192,warlock,demonology,6,2,4
Aceej,nazgrel,192,warlock,demonology,6,2,4
Dwight,kargath,192,warlock,demonology,6,2,4
Hootenanny,korialstrasz,192,warlock,demonology,6,2,4
Frodosagginz,illidan,192,warlock,demonology,6,2,4
Draindeez,sargeras,192,warlock,demonology,6,2,4
Yuckytoetoe,emerald-dream,192,warlock,demonology,6,2,4
Ceelowtf,sargeras,192,warlock,demonology,6,2,4
Hellsparks,malganis,192,warlock,demonology,6,2,4
Anukh,emerald-dream,192,warlock,demonology,6,2,4
Warfeen,malganis,192,warlock,demonology,6,2,4
Reckzet,stormrage,192,warlock,demonology,6,2,4
Feardr,frostmourne,192,warlock,demonology,6,2,4
Darkboltz,area-52,192,warlock,demonology,6,2,4
Felforyouu,illidan,192,warlock,demonology,6,2,4
Zalissel,proudmoore,192,warlock,demonology,6,2,4
Ðeimøn,azralon,192,warlock,demonology,6,2,4
Boon,spirestone,192,warlock,demonology,6,2,4
Bagelandlock,tichondrius,192,warlock,demonology,6,2,4
Barbieelf,sargeras,192,warlock,demonology,6,2,4
Wtb,blackrock,192,warlock,demonology,6,2,4
Tikdotlock,silvermoon,192,warlock,demonology,6,2,4
Cursedkash,stormrage,192,warlock,demonology,6,2,4
Draino,tichondrius,192,warlock,demonology,6,2,4
Cozu,tichondrius,192,warlock,demonology,6,2,4
Réliok,quelthalas,192,warlock,demonology,6,2,4
Albright,azralon,192,warlock,demonology,6,2,4
Feldotz,illidan,192,warlock,demonology,6,2,4
Promancer,drakkari,192,warlock,demonology,6,2,4
Shadowbyte,drakkari,192,warlock,demonology,6,2,4
Evilempire,sargeras,192,warlock,demonology,6,2,4
Kaosqt,nemesis,192,warlock,demonology,6,2,4
Namig,aerie-peak,192,warlock,demonology,6,2,4
Xmogfarmer,sargeras,192,warlock,demonology,6,2,4
Destructo,illidan,192,warlock,demonology,6,2,4
Shadow,frostwolf,192,warlock,demonology,6,2,4
Zevoc,tichondrius,192,warlock,demonology,6,2,4
Fellraiser,bleeding-hollow,192,warlock,demonology,6,2,4
Isømetrics,frostmourne,192,warlock,demonology,6,2,4
Kelifan,sargeras,192,warlock,demonology,6,2,4
Incaseoffire,moon-guard,192,warlock,demonology,6,2,4
Ziroken,crushridge,192,warlock,demonology,6,2,4
Zerowarlock,stormrage,192,warlock,demonology,6,2,4
Pinkypay,ragnaros,192,warlock,demonology,6,2,4
Lilbiackguy,stormrage,192,warlock,demonology,6,2,4
Xuker,tichondrius,192,warlock,demonology,6,2,4
Greenbeanzs,tichondrius,192,warlock,demonology,6,2,4
Dedology,area-52,192,warlock,demonology,6,2,4
Infecçäo,stormrage,192,warlock,demonology,6,2,4
Brough,illidan,192,warlock,demonology,6,2,4
Rokdas,area-52,192,warlock,demonology,6,2,4
Vendareth,earthen-ring,192,warlock,demonology,6,2,4
Capïrota,nemesis,192,warlock,demonology,6,2,4
Tomathus,moon-guard,192,warlock,demonology,6,2,4
Agamendoir,frostmane,192,warlock,demonology,6,2,4
Soulbane,tol-barad,192,warlock,demonology,6,2,4
Koffay,bleeding-hollow,192,warlock,demonology,6,2,4
Zelnokt,thrall,192,warlock,demonology,6,2,4
Wesy,earthen-ring,192,warlock,demonology,6,2,4
Qic,runetotem,192,warlock,demonology,6,2,4
Irene,nagrand,192,warlock,demonology,6,2,4
Vexidus,moon-guard,192,warlock,demonology,6,2,4
Chde,ragnaros,192,warlock,demonology,6,2,4
Shadows,arygos,192,warlock,demonology,6,2,4
Doomtome,moon-guard,192,warlock,demonology,6,2,4
Felpuppet,barthilas,192,warlock,demonology,6,2,4
Raven,baelgun,192,warlock,demonology,12,2,10
Miamarin,ragnaros,192,warlock,demonology,12,2,10
Felnoxx,dragonmaw,192,warlock,demonology,12,2,10
Sinful,darkspear,192,warlock,demonology,12,2,10
Umadbruhh,tichondrius,192,warlock,demonology,12,2,10
Gàtór,kiljaeden,192,warlock,demonology,12,2,10
Vielkä,ragnaros,192,warlock,demonology,12,2,10
Starwitch,darkspear,192,warlock,demonology,12,2,10
Nameflagged,arathor,192,warlock,demonology,12,2,10
Timerad,maelstrom,192,warlock,demonology,14,2,12
Kecca,azralon,192,warlock,demonology,21,2,19
Taeden,jubeithos,175,warlock,demonology,11,3,8
Tunacanthicc,moon-guard,159,warlock,demonology,5,2,3
Ededneddy,tichondrius,159,warlock,demonology,5,2,3
Gartlarrey,daggerspine,158,warlock,demonology,14,3,11
Dotte,tichondrius,128,warlock,demonology,4,2,2
Urmami,frostwolf,127,warlock,demonology,8,2,6
Malleus,drakkari,96,warlock,demonology,3,2,1
Africanlock,sargeras,96,warlock,demonology,3,2,1
Eriss,exodar,96,warlock,demonology,6,1,5
Solöw,tichondrius,96,warlock,demonology,6,1,5
Cynnd,tichondrius,96,warlock,demonology,6,1,5
Repláced,thrall,96,warlock,demonology,6,1,5
Coheatt,hyjal,96,warlock,demonology,6,1,5
Amauder,moon-guard,96,warlock,demonology,6,1,5
Fearedit,bleeding-hollow,96,warlock,demonology,6,1,5
Borthrel,moon-guard,96,warlock,demonology,6,1,5
Malzahard,ragnaros,96,warlock,demonology,6,1,5
Xentzor,auchindoun,96,warlock,demonology,6,1,5
Hâunted,khazgoroth,96,warlock,demonology,6,1,5
Regent,nemesis,96,warlock,demonology,6,1,5
Fashon,barthilas,96,warlock,demonology,6,1,5
Xalithra,moon-guard,96,warlock,demonology,6,1,5
Isthismeta,tichondrius,96,warlock,demonology,6,1,5
Damdochael,bleeding-hollow,96,warlock,demonology,6,1,5
Sidiouss,dreadmaul,96,warlock,demonology,6,1,5
Jazzycj,bleeding-hollow,96,warlock,demonology,6,1,5
Injera,tichondrius,96,warlock,demonology,6,1,5
Somethingud,tichondrius,96,warlock,demonology,6,1,5
Thinkchair,sargeras,96,warlock,demonology,6,1,5
Felsparkz,tichondrius,96,warlock,demonology,6,1,5
Lazzarros,area-52,96,warlock,demonology,6,1,5
Yora,illidan,96,warlock,demonology,6,1,5
Bmó,stormrage,96,warlock,demonology,6,1,5
Agramonn,ragnaros,96,warlock,demonology,6,1,5
Halsonis,smolderthorn,96,warlock,demonology,6,1,5
Swapchan,sargeras,96,warlock,demonology,6,1,5
Nùts,frostmourne,96,warlock,demonology,6,1,5
Zerosix,sargeras,96,warlock,demonology,6,1,5
Erimegara,ragnaros,96,warlock,demonology,6,1,5
Skured,maiev,96,warlock,demonology,6,1,5
Thugpenus,frostmane,96,warlock,demonology,6,1,5
Osteogenesis,quelthalas,96,warlock,demonology,6,1,5
Bfaclâssic,zuljin,96,warlock,demonology,6,1,5
Tonyxx,tichondrius,96,warlock,demonology,6,1,5
Harukay,tichondrius,96,warlock,demonology,6,1,5
Varvanta,proudmoore,96,warlock,demonology,6,1,5
Hsxcx,stonemaul,96,warlock,demonology,6,1,5
Jessewheels,tichondrius,96,warlock,demonology,6,1,5
Lockz,illidan,96,warlock,demonology,6,1,5
Clarton,tichondrius,96,warlock,demonology,6,1,5
Asetiks,tichondrius,96,warlock,demonology,6,1,5
Krilkore,kiljaeden,96,warlock,demonology,6,1,5
Halloweèn,kelthuzad,96,warlock,demonology,6,1,5
Lefrancais,area-52,96,warlock,demonology,6,1,5
Bilidin,azralon,96,warlock,demonology,6,1,5
Uggaboogga,malganis,96,warlock,demonology,6,1,5
Oreo,velen,96,warlock,demonology,6,1,5
Shortbuhz,tichondrius,96,warlock,demonology,6,1,5
Ñinelyfe,frostmourne,96,warlock,demonology,6,1,5
Zíppen,proudmoore,96,warlock,demonology,6,1,5
Wakingdead,mugthol,96,warlock,demonology,6,1,5
Quinsnyder,zuljin,96,warlock,demonology,6,1,5
Allixon,feathermoon,96,warlock,demonology,6,1,5
Tormentor,malganis,96,warlock,demonology,6,1,5
Hutchyw,tichondrius,96,warlock,demonology,6,1,5
Almyfrnsrded,stormrage,96,warlock,demonology,6,1,5
Decrepticus,kargath,96,warlock,demonology,6,1,5
Demí,zuljin,96,warlock,demonology,6,1,5
Fluximilian,azralon,96,warlock,demonology,7,1,6
Vèigarr,frostmourne,96,warlock,demonology,9,1,8
Albus,skywall,96,warlock,demonology,12,1,11
Resima,stormscale,96,warlock,demonology,13,1,12
Softmain,frostmourne,64,warlock,demonology,4,1,3
Hecataeus,proudmoore,63,warlock,demonology,8,2,6
Aerindell,dalaran,48,warlock,demonology,3,1,2
Shaurial,zuljin,48,warlock,demonology,3,1,2
Eternitty,nemesis,42,warlock,demonology,11,3,8
Synysta,tichondrius,31,warlock,demonology,2,1,1
Locksyy,tichondrius,31,warlock,demonology,2,1,1
Lilspank,emerald-dream,31,warlock,demonology,2,1,1
Camila,lightnings-blade,16,warlock,demonology,1,1,0
Nosw,bleeding-hollow,2395,warlock,destruction,114,72,42
Rightwaylovê,illidan,2364,warlock,destruction,221,132,89
Drexia,tichondrius,2357,warlock,destruction,161,107,54
Slipnslide,malganis,2357,warlock,destruction,83,55,28
Hahahahahha,stormrage,2357,warlock,destruction,95,62,33
Nos,bleeding-hollow,2351,warlock,destruction,100,64,36
Voidchaos,whisperwind,2335,warlock,destruction,265,156,109
Mclovn,suramar,2293,warlock,destruction,251,135,116
Reverence,tichondrius,2288,warlock,destruction,107,68,39
Mengqil,tichondrius,2267,warlock,destruction,120,67,53
Isodjdojk,sargeras,2263,warlock,destruction,112,62,50
Solwl,shandris,2256,warlock,destruction,66,37,29
Singleaf,stormrage,2255,warlock,destruction,98,57,41
Dannyl,tichondrius,2241,warlock,destruction,78,50,28
Turiggyjr,tichondrius,2221,warlock,destruction,94,52,42
Diabolicalz,sargeras,2219,warlock,destruction,147,81,66
Ihavestds,tichondrius,2218,warlock,destruction,72,43,29
Truetime,tichondrius,2216,warlock,destruction,90,51,39
Alucarduo,emerald-dream,2216,warlock,destruction,108,61,47
Kamohoalii,bleeding-hollow,2210,warlock,destruction,102,62,40
Slantsix,tichondrius,2198,warlock,destruction,90,50,40
Playßøy,area-52,2196,warlock,destruction,90,52,38
Mcdudebro,malganis,2192,warlock,destruction,72,45,27
Heckindoggø,tichondrius,2165,warlock,destruction,87,48,39
Gimmeprecog,tichondrius,2164,warlock,destruction,80,49,31
Søülætër,bleeding-hollow,2161,warlock,destruction,66,42,24
Ribman,stormrage,2159,warlock,destruction,108,57,51
Quinsnyder,zuljin,2159,warlock,destruction,264,136,128
Sourslock,shadowsong,2158,warlock,destruction,108,70,38
Impenjoyer,tichondrius,2154,warlock,destruction,66,41,25
Sonlyc,tichondrius,2153,warlock,destruction,114,60,54
Rizzofsparta,stormrage,2148,warlock,destruction,72,45,27
Forestfruit,tichondrius,2147,warlock,destruction,54,35,19
Woahlock,thrall,2146,warlock,destruction,64,40,24
Hudwinx,illidan,2146,warlock,destruction,84,51,33
Sitomey,emerald-dream,2145,warlock,destruction,84,50,34
Deathair,tichondrius,2144,warlock,destruction,78,46,32
Ihatemyson,tichondrius,2144,warlock,destruction,59,33,26
Ellynaria,nemesis,2142,warlock,destruction,78,51,27
Colombø,gallywix,2142,warlock,destruction,181,98,83
Løckyun,tichondrius,2141,warlock,destruction,66,48,18
Etuskaa,tichondrius,2140,warlock,destruction,211,117,94
Butteredbun,stormrage,2138,warlock,destruction,216,122,94
Usainboltzz,tichondrius,2137,warlock,destruction,71,49,22
Drakedogee,illidan,2137,warlock,destruction,102,52,50
Notprint,sargeras,2136,warlock,destruction,66,42,24
Drböb,area-52,2136,warlock,destruction,76,45,31
Tomatobob,thrall,2136,warlock,destruction,84,44,40
Igortrikadva,zuljin,2135,warlock,destruction,72,43,29
Tichonkimc,tichondrius,2133,warlock,destruction,113,63,50
Yifaruhún,illidan,2132,warlock,destruction,78,58,20
Kyranu,tichondrius,2132,warlock,destruction,142,80,62
Bakko,tichondrius,2131,warlock,destruction,89,59,30
Cux,malganis,2131,warlock,destruction,89,47,42
Deideimeow,illidan,2130,warlock,destruction,65,42,23
Drâkedog,illidan,2128,warlock,destruction,66,38,28
Medzor,tichondrius,2128,warlock,destruction,93,53,40
Sockems,guldan,2125,warlock,destruction,96,54,42
Demonman,kirin-tor,2124,warlock,destruction,72,41,31
Newmanz,nerzhul,2123,warlock,destruction,60,39,21
Rizzard,lightnings-blade,2123,warlock,destruction,107,64,43
Chaosboltex,tichondrius,2123,warlock,destruction,84,47,37
Oopsprecog,tichondrius,2123,warlock,destruction,120,64,56
Horror,moon-guard,2123,warlock,destruction,93,47,46
Xiyangpvp,tichondrius,2122,warlock,destruction,96,49,47
Zyzx,malganis,2120,warlock,destruction,59,37,22
Ztlivid,area-52,2120,warlock,destruction,173,103,70
Neruvian,tichondrius,2120,warlock,destruction,66,39,27
Amez,grizzly-hills,2120,warlock,destruction,84,47,37
Insanetroll,stormrage,2119,warlock,destruction,78,54,24
Äran,azralon,2119,warlock,destruction,72,36,36
Ðlrwêcïûj,stormrage,2117,warlock,destruction,84,56,28
Venticm,tichondrius,2117,warlock,destruction,72,44,28
Bananapan,tichondrius,2116,warlock,destruction,66,44,22
Starta,tichondrius,2116,warlock,destruction,66,39,27
Dyenamik,stormrage,2116,warlock,destruction,65,36,29
Realization,illidan,2115,warlock,destruction,42,30,12
Epícburn,illidan,2115,warlock,destruction,66,40,26
Minglocked,proudmoore,2114,warlock,destruction,54,37,17
Usurpest,bleeding-hollow,2114,warlock,destruction,79,50,29
Stingzz,azralon,2113,warlock,destruction,78,46,32
Luvana,kelthuzad,2111,warlock,destruction,143,83,60
Dean,frostmourne,2111,warlock,destruction,66,33,33
Ghoul,demon-soul,2109,warlock,destruction,60,35,25
Dxxz,tichondrius,2109,warlock,destruction,115,63,52
Thumperrz,frostmourne,2108,warlock,destruction,89,47,42
Drugmuffin,tichondrius,2107,warlock,destruction,94,53,41
Mjn,tichondrius,2107,warlock,destruction,100,51,49
Vapeboi,bleeding-hollow,2106,warlock,destruction,84,47,37
Disgustingfk,illidan,2105,warlock,destruction,126,75,51
Jcm,hyjal,2104,warlock,destruction,59,41,18
Dottle,frostmourne,2104,warlock,destruction,66,39,27
Whodatman,illidan,2103,warlock,destruction,60,41,19
Dae,burning-legion,2103,warlock,destruction,59,38,21
Butterboyx,stormrage,2103,warlock,destruction,95,56,39
Bufflockmore,tichondrius,2103,warlock,destruction,112,62,50
Kaytoxic,tichondrius,2103,warlock,destruction,72,39,33
Ohmend,thrall,2102,warlock,destruction,69,45,24
Disembolt,illidan,2102,warlock,destruction,66,41,25
Breeped,tichondrius,2102,warlock,destruction,150,91,59
Rainbowdate,tichondrius,2101,warlock,destruction,36,29,7
Abrocket,alleria,2101,warlock,destruction,112,58,54
Implify,tichondrius,2101,warlock,destruction,142,73,69
Dodgeykun,khaz-modan,2100,warlock,destruction,89,55,34
Kryl,kiljaeden,2100,warlock,destruction,66,39,27
Demonicxs,area-52,2100,warlock,destruction,227,120,107
Instabilityx,tichondrius,2099,warlock,destruction,83,49,34
Loopsy,stormrage,2099,warlock,destruction,127,69,58
Warzog,wyrmrest-accord,2096,warlock,destruction,102,58,44
Cc,hellscream,2091,warlock,destruction,226,133,93
Genzy,tichondrius,2090,warlock,destruction,172,91,81
Spicywhite,tichondrius,2089,warlock,destruction,126,65,61
Jonboyy,illidan,2086,warlock,destruction,212,107,105
Marcelium,greymane,2082,warlock,destruction,59,38,21
Kruxxqt,illidan,2077,warlock,destruction,385,201,184
Heizx,area-52,2075,warlock,destruction,51,28,23
Locean,tichondrius,2074,warlock,destruction,112,60,52
Babyaga,illidan,2073,warlock,destruction,103,50,53
Hollowl,tichondrius,2072,warlock,destruction,95,64,31
Hydra,wyrmrest-accord,2072,warlock,destruction,129,70,59
Thugonomicz,demon-soul,2071,warlock,destruction,54,37,17
Darthael,stormrage,2069,warlock,destruction,200,116,84
Sinápsís,ragnaros,2067,warlock,destruction,60,38,22
Mjndewb,tichondrius,2064,warlock,destruction,78,58,20
Demofire,tichondrius,2063,warlock,destruction,63,39,24
Drackkyy,tichondrius,2061,warlock,destruction,96,54,42
Nightmanx,sargeras,2057,warlock,destruction,101,54,47
Payn,kiljaeden,2053,warlock,destruction,168,86,82
Scørrgx,azralon,2049,warlock,destruction,102,53,49
Alchandil,tichondrius,2047,warlock,destruction,60,39,21
Kaytoxics,tichondrius,2046,warlock,destruction,30,25,5
Koitis,tichondrius,2046,warlock,destruction,74,45,29
Tott,hellscream,2045,warlock,destruction,74,38,36
Foresthills,sargeras,2044,warlock,destruction,102,53,49
Sarcophagus,duskwood,2044,warlock,destruction,180,91,89
Uwantpeach,tichondrius,2043,warlock,destruction,46,34,12
Ruination,cenarius,2041,warlock,destruction,60,36,24
Brainless,tichondrius,2040,warlock,destruction,109,66,43
Marshyw,tichondrius,2039,warlock,destruction,54,31,23
Napiersdot,tichondrius,2032,warlock,destruction,102,52,50
Skynflute,tichondrius,2031,warlock,destruction,52,30,22
Salanzø,bleeding-hollow,2030,warlock,destruction,60,35,25
Mayelinvail,moon-guard,2025,warlock,destruction,190,104,86
Idotû,tichondrius,2025,warlock,destruction,221,116,105
Warlockwars,amanthul,2024,warlock,destruction,309,160,149
Destroyy,greymane,2021,warlock,destruction,60,33,27
Hrrpeuh,zuljin,2017,warlock,destruction,88,46,42
Sweatystain,tichondrius,2015,warlock,destruction,129,77,52
Revenid,tichondrius,2015,warlock,destruction,78,44,34
Duukka,malganis,2015,warlock,destruction,96,53,43
Zeari,sargeras,2014,warlock,destruction,115,59,56
Hàrrydotter,darkspear,2013,warlock,destruction,118,65,53
Truenatestes,proudmoore,2010,warlock,destruction,181,93,88
Demondisco,tichondrius,2008,warlock,destruction,102,59,43
Soulbane,jubeithos,2007,warlock,destruction,48,28,20
Kaidow,tichondrius,2006,warlock,destruction,114,67,47
Realgodlock,proudmoore,2005,warlock,destruction,200,105,95
Babybolt,frostmourne,2005,warlock,destruction,102,50,52
Lockdotsftw,illidan,2003,warlock,destruction,84,44,40
Curse,agamaggan,2002,warlock,destruction,138,84,54
Vexe,tichondrius,2001,warlock,destruction,121,74,47
Vyrecks,hyjal,2001,warlock,destruction,83,47,36
Heresucacok,frostmourne,1999,warlock,destruction,42,25,17
Maureenn,mannoroth,1999,warlock,destruction,115,61,54
Oldwing,illidan,1998,warlock,destruction,191,103,88
Darkmagicc,tichondrius,1995,warlock,destruction,96,48,48
Eav,area-52,1991,warlock,destruction,66,41,25
Xertling,sargeras,1990,warlock,destruction,67,46,21
Bronzel,tichondrius,1989,warlock,destruction,36,27,9
Qp,thrall,1989,warlock,destruction,36,27,9
Cvoaw,bonechewer,1987,warlock,destruction,108,59,49
Wzxx,tichondrius,1984,warlock,destruction,218,119,99
Il,nerzhul,1983,warlock,destruction,42,29,13
Headbolterx,tichondrius,1982,warlock,destruction,51,30,21
Dragonixs,ragnaros,1980,warlock,destruction,136,78,58
Tacobelf,magtheridon,1980,warlock,destruction,135,76,59
Zhul,nerzhul,1979,warlock,destruction,63,40,23
Biubius,tichondrius,1978,warlock,destruction,104,64,40
Felfeels,area-52,1978,warlock,destruction,132,73,59
Sereniaa,sargeras,1977,warlock,destruction,56,32,24
Fotmspec,area-52,1976,warlock,destruction,66,46,20
Narila,firetree,1976,warlock,destruction,48,29,19
Stankybootie,malganis,1970,warlock,destruction,79,53,26
Calvarr,bleeding-hollow,1970,warlock,destruction,77,45,32
Nvlnx,tichondrius,1970,warlock,destruction,155,81,74
Trengodx,area-52,1968,warlock,destruction,66,47,19
Pigii,tichondrius,1967,warlock,destruction,42,28,14
Salival,chogall,1965,warlock,destruction,51,36,15
Dazu,illidan,1965,warlock,destruction,173,90,83
Mizmagius,moon-guard,1965,warlock,destruction,65,31,34
Hellsparks,malganis,1964,warlock,destruction,54,33,21
Feetsampler,stormrage,1963,warlock,destruction,99,52,47
Wodwarlock,thrall,1961,warlock,destruction,71,44,27
Boltsnhoes,illidan,1961,warlock,destruction,78,46,32
Omegapasta,illidan,1961,warlock,destruction,120,64,56
Radicalz,ragnaros,1959,warlock,destruction,55,30,25
Blackyeonnam,tichondrius,1959,warlock,destruction,86,46,40
Pillçosby,bleeding-hollow,1957,warlock,destruction,252,122,130
Bod,bleeding-hollow,1956,warlock,destruction,65,39,26
Mazewl,illidan,1955,warlock,destruction,117,71,46
Mistrnesbitt,malganis,1954,warlock,destruction,54,31,23
Seangnong,tichondrius,1953,warlock,destruction,54,34,20
Soulbane,tol-barad,1951,warlock,destruction,33,22,11
Deadlpoo,stormscale,1951,warlock,destruction,188,97,91
Doties,bleeding-hollow,1947,warlock,destruction,48,27,21
Daddybolt,blackrock,1944,warlock,destruction,69,37,32
Jfet,sargeras,1941,warlock,destruction,65,38,27
Marware,quelthalas,1941,warlock,destruction,96,48,48
Zyltan,tichondrius,1938,warlock,destruction,36,25,11
Vileröze,zuljin,1938,warlock,destruction,114,62,52
Reallymagic,malganis,1937,warlock,destruction,185,106,79
Dimanel,moon-guard,1936,warlock,destruction,70,36,34
Zchenboom,tichondrius,1935,warlock,destruction,48,32,16
Chaosbolt,bloodhoof,1935,warlock,destruction,105,55,50
Roxmysox,darkspear,1930,warlock,destruction,102,54,48
Albbanoo,tichondrius,1930,warlock,destruction,173,89,84
Beegbeechy,nesingwary,1929,warlock,destruction,72,41,31
Bismorc,frostmourne,1928,warlock,destruction,52,31,21
Dazedl,stormrage,1928,warlock,destruction,39,23,16
Dàmagicman,drakthul,1924,warlock,destruction,92,53,39
Yuoalx,tichondrius,1922,warlock,destruction,72,38,34
Intentionz,sargeras,1921,warlock,destruction,65,39,26
Laiquisha,zuljin,1921,warlock,destruction,55,30,25
Rakshama,chogall,1920,warlock,destruction,51,28,23
Leredi,stormrage,1920,warlock,destruction,182,88,94
Eqx,illidan,1919,warlock,destruction,103,58,45
Scarified,illidan,1918,warlock,destruction,84,41,43
Balveer,tichondrius,1914,warlock,destruction,47,25,22
Slobõnmyknob,frostmourne,1913,warlock,destruction,48,31,17
Ignorai,illidan,1913,warlock,destruction,148,82,66
Dxhusky,tichondrius,1912,warlock,destruction,66,37,29
Nðm,tichondrius,1912,warlock,destruction,120,58,62
Crayonchewer,alleria,1911,warlock,destruction,72,38,34
Grandmama,tichondrius,1911,warlock,destruction,95,49,46
Audition,ragnaros,1910,warlock,destruction,114,55,59
Warcalk,stormrage,1909,warlock,destruction,72,44,28
Danaowns,spirestone,1908,warlock,destruction,36,20,16
Dreadful,frostmourne,1907,warlock,destruction,81,49,32
Mcrfan,illidan,1906,warlock,destruction,41,33,8
Reneqtxo,frostmourne,1906,warlock,destruction,92,60,32
Whatisthis,tichondrius,1906,warlock,destruction,36,20,16
Yoyoyosup,stormrage,1905,warlock,destruction,48,32,16
Famerap,tichondrius,1902,warlock,destruction,42,29,13
Almostoogood,illidan,1902,warlock,destruction,42,25,17
Kartharian,wyrmrest-accord,1901,warlock,destruction,202,104,98
Maadhum,illidan,1901,warlock,destruction,138,63,75
Freddiewill,tichondrius,1900,warlock,destruction,136,78,58
Ozmat,spirestone,1900,warlock,destruction,36,20,16
Dommön,ragnaros,1899,warlock,destruction,126,64,62
Bigjmmywiggl,illidan,1898,warlock,destruction,109,67,42
Scatz,sargeras,1897,warlock,destruction,36,33,3
Soulbane,nemesis,1897,warlock,destruction,48,28,20
Donutd,stormrage,1896,warlock,destruction,60,35,25
Boxtrolls,ragnaros,1896,warlock,destruction,54,31,23
Jaspieno,illidan,1895,warlock,destruction,54,34,20
Belandyr,stormrage,1893,warlock,destruction,36,20,16
Stilltrilly,tichondrius,1892,warlock,destruction,36,25,11
Truepain,tichondrius,1891,warlock,destruction,36,23,13
Moosejockey,stormrage,1890,warlock,destruction,30,20,10
Aryoc,ragnaros,1888,warlock,destruction,132,78,54
Drakwlya,tichondrius,1885,warlock,destruction,54,33,21
Naughtybolts,sargeras,1884,warlock,destruction,59,41,18
Toggafputuhs,illidan,1884,warlock,destruction,42,26,16
Chazzlock,area-52,1884,warlock,destruction,36,22,14
Madthelock,sargeras,1884,warlock,destruction,42,20,22
Aeaea,bleeding-hollow,1883,warlock,destruction,95,56,39
Zettian,quelthalas,1883,warlock,destruction,54,30,24
Rotfull,burning-legion,1883,warlock,destruction,57,31,26
Wampeter,azshara,1883,warlock,destruction,134,71,63
Benafflockz,kelthuzad,1882,warlock,destruction,77,46,31
Warsmock,tichondrius,1882,warlock,destruction,55,30,25
Çxb,tichondrius,1879,warlock,destruction,89,50,39
Humanwarlock,spirestone,1879,warlock,destruction,57,32,25
Neverending,malganis,1878,warlock,destruction,49,28,21
Zírds,stormrage,1878,warlock,destruction,66,37,29
Sosahawk,stormrage,1877,warlock,destruction,156,96,60
Darkjambii,tichondrius,1877,warlock,destruction,139,77,62
Thegodd,nemesis,1877,warlock,destruction,88,44,44
Drazh,area-52,1876,warlock,destruction,63,36,27
Zarinista,veknilash,1876,warlock,destruction,115,59,56
Bigulinhos,nemesis,1876,warlock,destruction,83,41,42
Tommybahama,velen,1875,warlock,destruction,76,45,31
Evilclass,tichondrius,1874,warlock,destruction,60,42,18
Pikslol,bleeding-hollow,1874,warlock,destruction,48,27,21
Shinjuro,stormrage,1873,warlock,destruction,60,37,23
Dottcha,blackrock,1873,warlock,destruction,90,48,42
Locodwarf,frostmourne,1873,warlock,destruction,274,136,138
Destructo,illidan,1872,warlock,destruction,78,41,37
Twinklockxx,mannoroth,1872,warlock,destruction,143,66,77
Millidots,bleeding-hollow,1871,warlock,destruction,60,35,25
Hommer,tichondrius,1870,warlock,destruction,57,34,23
Bigdamege,tichondrius,1870,warlock,destruction,67,39,28
Ñpç,bleeding-hollow,1870,warlock,destruction,89,48,41
Manthos,sargeras,1870,warlock,destruction,121,65,56
Espanyolo,zuljin,1868,warlock,destruction,84,58,26
Jeffreyw,tichondrius,1868,warlock,destruction,89,55,34
Slurper,frostwolf,1867,warlock,destruction,36,23,13
Amazingamez,sargeras,1867,warlock,destruction,78,42,36
Inmøtion,tichondrius,1867,warlock,destruction,48,25,23
Deammon,tichondrius,1865,warlock,destruction,72,48,24
Farathos,ragnaros,1865,warlock,destruction,166,98,68
Pheadas,deathwing,1865,warlock,destruction,42,20,22
Footyl,stormrage,1864,warlock,destruction,54,39,15
Palumorl,deathwing,1864,warlock,destruction,36,23,13
Eggós,sargeras,1864,warlock,destruction,396,199,197
Ðemented,bleeding-hollow,1863,warlock,destruction,57,36,21
Destructio,tichondrius,1863,warlock,destruction,66,37,29
Scathey,area-52,1862,warlock,destruction,168,99,69
Shutkax,sargeras,1858,warlock,destruction,42,30,12
Necrosade,tichondrius,1858,warlock,destruction,48,30,18
Corkeý,azuremyst,1857,warlock,destruction,119,64,55
Dauntx,proudmoore,1857,warlock,destruction,72,38,34
Dottx,frostmourne,1856,warlock,destruction,48,32,16
Luhgëek,tichondrius,1856,warlock,destruction,47,29,18
Zadelyn,whisperwind,1855,warlock,destruction,30,23,7
Snerp,frostmourne,1855,warlock,destruction,135,78,57
Wwlock,area-52,1855,warlock,destruction,170,88,82
Soulrulerxc,tichondrius,1854,warlock,destruction,42,27,15
Shadowhax,area-52,1854,warlock,destruction,128,64,64
Mongobros,illidan,1853,warlock,destruction,54,35,19
Coilsinfive,tichondrius,1853,warlock,destruction,48,27,21
Immolate,eitrigg,1852,warlock,destruction,48,29,19
Odjure,zuljin,1852,warlock,destruction,47,27,20
Milkdrunk,blackrock,1852,warlock,destruction,119,61,58
Dragoska,kiljaeden,1851,warlock,destruction,60,38,22
Homeboyardee,the-venture-co,1851,warlock,destruction,72,37,35
Naughtybôlts,sargeras,1850,warlock,destruction,57,39,18
Ændrew,darkspear,1850,warlock,destruction,59,37,22
Trundle,area-52,1850,warlock,destruction,107,63,44
Panna,tichondrius,1850,warlock,destruction,296,148,148
Synkz,blood-furnace,1849,warlock,destruction,42,24,18
Pernicious,bladefist,1849,warlock,destruction,221,104,117
Róckroad,lightnings-blade,1848,warlock,destruction,54,33,21
Threeinches,kelthuzad,1848,warlock,destruction,170,100,70
Mycelium,greymane,1848,warlock,destruction,34,20,14
Kaelith,kelthuzad,1848,warlock,destruction,109,53,56
Löcked,illidan,1846,warlock,destruction,42,36,6
Brazlem,blackrock,1846,warlock,destruction,49,34,15
Verbzz,tichondrius,1846,warlock,destruction,36,23,13
Krokusx,illidan,1846,warlock,destruction,156,88,68
Lemmepvponu,illidan,1846,warlock,destruction,59,28,31
Demonicsnap,bleeding-hollow,1845,warlock,destruction,130,75,55
Punstable,tichondrius,1845,warlock,destruction,139,77,62
Eskyx,tichondrius,1845,warlock,destruction,53,26,27
Eldenjohn,proudmoore,1844,warlock,destruction,30,24,6
Sithaholic,wildhammer,1843,warlock,destruction,72,39,33
Chilipeppa,wyrmrest-accord,1842,warlock,destruction,36,27,9
Jierd,tichondrius,1842,warlock,destruction,52,32,20
Illinkin,illidan,1842,warlock,destruction,150,86,64
Herpalock,illidan,1842,warlock,destruction,78,34,44
Rocketman,hydraxis,1841,warlock,destruction,48,32,16
Vialdkaseun,muradin,1841,warlock,destruction,47,28,19
Kayersoul,tichondrius,1841,warlock,destruction,36,20,16
Fearsponce,dragonmaw,1841,warlock,destruction,78,38,40
Cosmosxx,illidan,1840,warlock,destruction,54,37,17
Mindheist,stormrage,1840,warlock,destruction,48,29,19
Indelock,drenden,1840,warlock,destruction,42,24,18
Fingerslock,malganis,1840,warlock,destruction,126,62,64
Gucciflops,bleeding-hollow,1840,warlock,destruction,96,47,49
Drakedog,ragnaros,1839,warlock,destruction,43,27,16
Matafé,kelthuzad,1839,warlock,destruction,54,30,24
Isoldmysoul,stormrage,1839,warlock,destruction,132,66,66
Ctierwarlock,tichondrius,1838,warlock,destruction,28,21,7
Enter,saurfang,1838,warlock,destruction,36,24,12
Brutalsummon,frostmourne,1838,warlock,destruction,111,63,48
Zimer,moon-guard,1837,warlock,destruction,84,52,32
Philsbad,lightbringer,1837,warlock,destruction,122,70,52
Dxhusky,illidan,1837,warlock,destruction,60,32,28
Kekbolt,tichondrius,1836,warlock,destruction,53,33,20
Deathcoill,frostmourne,1836,warlock,destruction,54,32,22
Zuelu,tichondrius,1836,warlock,destruction,108,61,47
Wife,bleeding-hollow,1836,warlock,destruction,60,31,29
Sibëria,quelthalas,1835,warlock,destruction,48,35,13
Klumzey,tichondrius,1835,warlock,destruction,73,45,28
Badstep,tichondrius,1835,warlock,destruction,51,30,21
Charlieo,barthilas,1835,warlock,destruction,132,74,58
Tonyxx,tichondrius,1835,warlock,destruction,118,61,57
Goal,malganis,1835,warlock,destruction,50,25,25
Gigabiga,area-52,1834,warlock,destruction,24,20,4
Soragen,barthilas,1834,warlock,destruction,54,37,17
Nasn,black-dragonflight,1834,warlock,destruction,92,56,36
Zunexx,malganis,1834,warlock,destruction,54,31,23
Gotthmog,nerzhul,1833,warlock,destruction,48,30,18
Daylyt,sargeras,1833,warlock,destruction,39,24,15
Dustywlx,area-52,1833,warlock,destruction,79,46,33
Dotorama,sargeras,1832,warlock,destruction,53,33,20
Cumbledor,bleeding-hollow,1831,warlock,destruction,44,23,21
Barovir,tichondrius,1830,warlock,destruction,54,33,21
Buu,veknilash,1830,warlock,destruction,54,33,21
Rhelialock,stormrage,1830,warlock,destruction,36,21,15
Neghros,illidan,1830,warlock,destruction,113,59,54
Gigglywiggly,illidan,1829,warlock,destruction,48,33,15
Brillina,windrunner,1829,warlock,destruction,60,30,30
Nezlock,moon-guard,1829,warlock,destruction,92,45,47
Denotate,zuljin,1828,warlock,destruction,115,65,50
Gianni,chogall,1828,warlock,destruction,72,40,32
Koramoz,area-52,1828,warlock,destruction,176,92,84
Chaosbôlt,proudmoore,1827,warlock,destruction,120,66,54
Tenaciousd,malganis,1827,warlock,destruction,48,24,24
Vonsteevan,area-52,1826,warlock,destruction,75,46,29
Evanylock,proudmoore,1826,warlock,destruction,75,45,30
Shequita,stormrage,1825,warlock,destruction,48,37,11
Agaros,zuljin,1825,warlock,destruction,49,30,19
Necroboi,alterac-mountains,1825,warlock,destruction,52,29,23
Kissmybolts,frostmourne,1825,warlock,destruction,83,42,41
Emospec,chogall,1824,warlock,destruction,54,35,19
Dipicrowcaw,tichondrius,1822,warlock,destruction,24,19,5
Vilebeing,frostmourne,1822,warlock,destruction,66,46,20
Hakai,bleeding-hollow,1822,warlock,destruction,92,57,35
Badhombre,tichondrius,1821,warlock,destruction,48,31,17
Yungncapable,malganis,1820,warlock,destruction,69,53,16
Dadtired,tichondrius,1820,warlock,destruction,54,37,17
Chaøz,bleeding-hollow,1820,warlock,destruction,48,32,16
Evilempire,sargeras,1820,warlock,destruction,54,30,24
Nahalmaeim,tichondrius,1819,warlock,destruction,37,25,12
Azaradx,sargeras,1819,warlock,destruction,84,54,30
Yipláw,stormrage,1819,warlock,destruction,36,23,13
Puginlock,illidan,1819,warlock,destruction,60,38,22
Elfwarlock,aerie-peak,1819,warlock,destruction,43,27,16
Slurpme,stormscale,1819,warlock,destruction,48,30,18
Vamprixlz,illidan,1818,warlock,destruction,49,34,15
Lamaso,area-52,1818,warlock,destruction,90,55,35
Veklen,tichondrius,1818,warlock,destruction,64,36,28
Bumbleebolt,azralon,1817,warlock,destruction,24,19,5
Firenzy,dalaran,1817,warlock,destruction,67,39,28
Antinurse,bleeding-hollow,1817,warlock,destruction,78,45,33
Dralok,area-52,1817,warlock,destruction,66,38,28
Lockonomicz,tichondrius,1817,warlock,destruction,42,24,18
Brujoalfa,ragnaros,1817,warlock,destruction,175,98,77
Feinnx,dalaran,1817,warlock,destruction,70,38,32
Zehoc,thrall,1817,warlock,destruction,102,55,47
Derok,bleeding-hollow,1817,warlock,destruction,277,144,133
Dampenedx,bleeding-hollow,1817,warlock,destruction,58,30,28
Wraithlord,chogall,1816,warlock,destruction,51,32,19
Screampies,tichondrius,1816,warlock,destruction,52,30,22
Doclove,destromath,1816,warlock,destruction,149,83,66
Noxfear,azralon,1815,warlock,destruction,72,51,21
Sairic,azralon,1815,warlock,destruction,120,76,44
Dunnin,dalaran,1815,warlock,destruction,36,22,14
Savlonicsego,stormrage,1815,warlock,destruction,78,45,33
Frappucino,wyrmrest-accord,1814,warlock,destruction,30,23,7
Nozyroh,emerald-dream,1814,warlock,destruction,41,25,16
Loadybigbolt,dalaran,1814,warlock,destruction,119,69,50
Slpxoxo,sargeras,1814,warlock,destruction,54,30,24
Mythdot,ragnaros,1814,warlock,destruction,245,133,112
Starwitch,darkspear,1814,warlock,destruction,131,62,69
Archimondee,rivendare,1814,warlock,destruction,114,53,61
Wiredftw,illidan,1813,warlock,destruction,30,19,11
Sacalawia,drakkari,1813,warlock,destruction,45,27,18
Korash,kilrogg,1813,warlock,destruction,42,25,17
Monika,anetheron,1813,warlock,destruction,58,32,26
Razlock,moon-guard,1813,warlock,destruction,236,128,108
Lokintots,darkspear,1812,warlock,destruction,36,29,7
Bodhisage,kelthuzad,1812,warlock,destruction,24,19,5
Zauber,magtheridon,1812,warlock,destruction,44,29,15
Galfear,malganis,1812,warlock,destruction,207,116,91
Rèdrùm,tichondrius,1812,warlock,destruction,51,26,25
Naroy,malygos,1811,warlock,destruction,38,21,17
Fenriakshog,zuljin,1810,warlock,destruction,36,23,13
Tìdals,zuljin,1810,warlock,destruction,44,28,16
Alchan,tichondrius,1810,warlock,destruction,65,38,27
Fartymårty,tichondrius,1810,warlock,destruction,36,21,15
Embrz,area-52,1810,warlock,destruction,54,31,23
Omnireaper,tichondrius,1810,warlock,destruction,54,29,25
Berkz,stormrage,1810,warlock,destruction,66,33,33
Oof,dalaran,1809,warlock,destruction,30,22,8
Ashlet,kelthuzad,1809,warlock,destruction,48,30,18
Emeraldflame,turalyon,1808,warlock,destruction,60,44,16
Fanzhiyi,illidan,1808,warlock,destruction,43,27,16
Daimonic,bronzebeard,1808,warlock,destruction,90,55,35
Blackchinese,zuljin,1808,warlock,destruction,138,73,65
Niava,tichondrius,1808,warlock,destruction,54,28,26
Zjxy,tichondrius,1807,warlock,destruction,30,22,8
Drthiccbolts,malganis,1807,warlock,destruction,47,29,18
Drdoom,sargeras,1807,warlock,destruction,36,22,14
Cheqmate,moon-guard,1807,warlock,destruction,61,36,25
Xivra,thrall,1807,warlock,destruction,59,34,25
Aidadeshu,tichondrius,1807,warlock,destruction,60,32,28
Zakhim,zuljin,1806,warlock,destruction,124,74,50
Åbyssal,stormrage,1806,warlock,destruction,159,94,65
Belenas,tichondrius,1806,warlock,destruction,48,28,20
Amgs,frostmourne,1806,warlock,destruction,167,88,79
Nigthdeath,nemesis,1806,warlock,destruction,179,94,85
Döremi,tichondrius,1805,warlock,destruction,48,28,20
Veleza,kiljaeden,1805,warlock,destruction,82,47,35
Cenich,darkspear,1804,warlock,destruction,67,43,24
Trixtah,illidan,1804,warlock,destruction,36,23,13
Meatmanxtrem,sargeras,1804,warlock,destruction,60,33,27
Teesolinia,stormrage,1803,warlock,destruction,117,74,43
Expiredfood,stormreaver,1803,warlock,destruction,42,26,16
Pillçosby,tichondrius,1803,warlock,destruction,36,22,14
Xhrine,frostmourne,1803,warlock,destruction,65,37,28
Revérence,sargeras,1803,warlock,destruction,53,28,25
Mursay,tichondrius,1802,warlock,destruction,48,33,15
Scârecrow,stormrage,1802,warlock,destruction,72,46,26
Vexidus,moon-guard,1802,warlock,destruction,102,60,42
Mamosa,stormrage,1801,warlock,destruction,72,52,20
Romdi,tichondrius,1801,warlock,destruction,52,32,20
Geekmonster,tichondrius,1801,warlock,destruction,54,33,21
Ghettobeluga,area-52,1801,warlock,destruction,53,30,23
Rettek,bleeding-hollow,1801,warlock,destruction,48,27,21
Karimbenzema,tichondrius,1801,warlock,destruction,54,30,24
Frightbright,sargeras,1801,warlock,destruction,45,25,20
Enkryption,dalaran,1801,warlock,destruction,42,23,19
Suaveaye,tichondrius,1801,warlock,destruction,66,36,30
Seltzi,illidan,1801,warlock,destruction,47,25,22
Necrochemist,frostmane,1800,warlock,destruction,24,19,5
Podda,shuhalo,1800,warlock,destruction,59,38,21
Xervas,frostmourne,1800,warlock,destruction,54,33,21
Warmstreak,blackrock,1800,warlock,destruction,48,28,20
Lapidate,malganis,1800,warlock,destruction,59,33,26
Leruss,zangarmarsh,1800,warlock,destruction,55,30,25
Cowboydann,malganis,1799,warlock,destruction,30,19,11
Ensanaty,dalaran,1799,warlock,destruction,62,33,29
Glôck,lightbringer,1799,warlock,destruction,121,60,61
Missinhim,shattered-halls,1798,warlock,destruction,24,19,5
Doughnut,mugthol,1798,warlock,destruction,90,50,40
Tribulatiön,moon-guard,1798,warlock,destruction,446,237,209
Sherlóck,duskwood,1798,warlock,destruction,54,28,26
Cróhns,bleeding-hollow,1797,warlock,destruction,139,86,53
Basicwitch,malganis,1796,warlock,destruction,41,26,15
Exilegd,proudmoore,1796,warlock,destruction,101,62,39
Kogath,thunderlord,1796,warlock,destruction,116,66,50
Puchador,sargeras,1795,warlock,destruction,144,74,70
Gløcked,area-52,1793,warlock,destruction,36,21,15
Krikxy,tichondrius,1793,warlock,destruction,56,31,25
Darksummoner,kaelthas,1793,warlock,destruction,90,47,43
Vickerzz,barthilas,1792,warlock,destruction,65,32,33
Feardotjpg,stormrage,1791,warlock,destruction,42,29,13
Shadøwy,nemesis,1791,warlock,destruction,184,102,82
Chaosjedi,stormrage,1791,warlock,destruction,135,65,70
Kyleslock,illidan,1790,warlock,destruction,29,21,8
Vulcke,kelthuzad,1790,warlock,destruction,117,57,60
Swapsfour,area-52,1789,warlock,destruction,48,30,18
Barbieelf,sargeras,1789,warlock,destruction,238,124,114
Babyhzz,tichondrius,1788,warlock,destruction,48,33,15
Løcalplugxø,barthilas,1786,warlock,destruction,137,86,51
Whitexzz,tichondrius,1786,warlock,destruction,42,24,18
Lopenx,korgath,1786,warlock,destruction,218,106,112
Benafflockzz,kelthuzad,1785,warlock,destruction,72,45,27
Dmacxl,tichondrius,1785,warlock,destruction,48,27,21
Birez,kelthuzad,1785,warlock,destruction,104,58,46
Deathhawkz,ravencrest,1784,warlock,destruction,36,24,12
Wreyz,mannoroth,1783,warlock,destruction,72,39,33
Oblivious,firetree,1783,warlock,destruction,237,124,113
Nevermindxd,barthilas,1783,warlock,destruction,66,32,34
Finalboss,tichondrius,1782,warlock,destruction,48,33,15
Positivity,thunderhorn,1782,warlock,destruction,48,30,18
Øutbreak,thrall,1782,warlock,destruction,62,36,26
Tonnon,stormrage,1782,warlock,destruction,84,47,37
Latchlock,malganis,1781,warlock,destruction,209,112,97
Michae,tichondrius,1780,warlock,destruction,30,21,9
Duckboji,tichondrius,1780,warlock,destruction,56,33,23
Dupapad,stormrage,1780,warlock,destruction,65,31,34
Wineburger,frostmourne,1779,warlock,destruction,72,46,26
Nahz,tichondrius,1779,warlock,destruction,42,24,18
Jakjub,kelthuzad,1778,warlock,destruction,54,31,23
Soukinomicz,sargeras,1777,warlock,destruction,48,31,17
Bellaswans,hyjal,1777,warlock,destruction,78,43,35
Eggpower,tichondrius,1776,warlock,destruction,52,27,25
Darkwidow,sargeras,1776,warlock,destruction,218,108,110
Ralerhard,kelthuzad,1775,warlock,destruction,64,40,24
Grq,stormrage,1775,warlock,destruction,69,43,26
Hellparks,malganis,1774,warlock,destruction,42,27,15
Loksoflove,tichondrius,1773,warlock,destruction,30,21,9
Screwed,tichondrius,1773,warlock,destruction,96,49,47
Nt,burning-legion,1772,warlock,destruction,50,41,9
Alùcärd,tichondrius,1772,warlock,destruction,54,25,29
Azlloa,tichondrius,1771,warlock,destruction,42,27,15
Plasticware,korgath,1771,warlock,destruction,48,29,19
Andelaylas,tichondrius,1771,warlock,destruction,95,57,38
Twilson,moon-guard,1771,warlock,destruction,54,29,25
Anujy,moon-guard,1769,warlock,destruction,78,53,25
Nùts,frostmourne,1769,warlock,destruction,42,27,15
Urukái,dalaran,1769,warlock,destruction,117,65,52
Gladyr,frostmourne,1768,warlock,destruction,54,28,26
Lifeinsuranc,tichondrius,1767,warlock,destruction,30,19,11
Maldivà,tichondrius,1767,warlock,destruction,35,22,13
Yaresly,kelthuzad,1763,warlock,destruction,44,31,13
Tm,dalaran,1763,warlock,destruction,59,35,24
Freejakejone,tichondrius,1763,warlock,destruction,72,41,31
Guldåniel,tichondrius,1763,warlock,destruction,60,34,26
Exgenshinpro,proudmoore,1763,warlock,destruction,42,23,19
Guldansbicep,illidan,1763,warlock,destruction,99,52,47
Vallàx,area-52,1762,warlock,destruction,174,91,83
Kakistocracy,kelthuzad,1761,warlock,destruction,30,23,7
Haì,illidan,1761,warlock,destruction,78,44,34
Bolsheivik,dentarg,1759,warlock,destruction,104,58,46
Marshyxd,tichondrius,1759,warlock,destruction,48,23,25
Pk,azralon,1758,warlock,destruction,36,23,13
Gottawiz,illidan,1758,warlock,destruction,60,32,28
Gavlock,tichondrius,1758,warlock,destruction,60,28,32
Nick,llane,1757,warlock,destruction,36,23,13
Chêrrypopper,proudmoore,1755,warlock,destruction,67,41,26
Thirsts,tichondrius,1755,warlock,destruction,70,41,29
Squishyboy,tichondrius,1755,warlock,destruction,57,30,27
Ravëncläw,quelthalas,1755,warlock,destruction,67,35,32
Flattsl,tichondrius,1755,warlock,destruction,84,39,45
Obliceress,crushridge,1754,warlock,destruction,42,26,16
Zoagen,ragnaros,1754,warlock,destruction,70,39,31
Rotshtëin,tichondrius,1754,warlock,destruction,191,98,93
Ibrroski,proudmoore,1753,warlock,destruction,24,20,4
Debigbolt,area-52,1752,warlock,destruction,42,28,14
Terrorbytes,frostmourne,1752,warlock,destruction,126,70,56
Killabeesack,tichondrius,1751,warlock,destruction,85,50,35
Symaitiel,azralon,1751,warlock,destruction,96,51,45
Plaintive,moon-guard,1750,warlock,destruction,54,28,26
Éx,jubeithos,1748,warlock,destruction,47,30,17
Lockfaceguy,agamaggan,1747,warlock,destruction,75,39,36
Qualio,thrall,1746,warlock,destruction,129,62,67
Devi,executus,1745,warlock,destruction,30,19,11
Thinktank,tichondrius,1743,warlock,destruction,42,25,17
Mokushiroku,trollbane,1743,warlock,destruction,83,42,41
Raxxis,moon-guard,1742,warlock,destruction,29,19,10
Dewandoritos,kelthuzad,1742,warlock,destruction,36,22,14
Paparoxy,illidan,1742,warlock,destruction,64,31,33
Flake,kelthuzad,1741,warlock,destruction,62,37,25
Yeepzbytre,bleeding-hollow,1741,warlock,destruction,113,66,47
Halloweèn,kelthuzad,1741,warlock,destruction,131,74,57
Pkzy,azralon,1741,warlock,destruction,36,19,17
Bouldrlickr,dragonmaw,1740,warlock,destruction,48,30,18
Zaef,kelthuzad,1740,warlock,destruction,106,51,55
Quinzel,tichondrius,1739,warlock,destruction,24,22,2
Boodizz,frostmourne,1738,warlock,destruction,48,25,23
Zrok,bleeding-hollow,1738,warlock,destruction,60,29,31
Shequita,thrall,1737,warlock,destruction,42,25,17
Rollup,turalyon,1737,warlock,destruction,36,20,16
Theredwoman,emerald-dream,1736,warlock,destruction,36,20,16
Darkmagician,kelthuzad,1735,warlock,destruction,30,22,8
Boltster,destromath,1735,warlock,destruction,110,74,36
Radalyn,icecrown,1735,warlock,destruction,37,22,15
Chaoticchaos,kelthuzad,1735,warlock,destruction,35,20,15
Hädes,frostwolf,1734,warlock,destruction,45,31,14
Mânuel,akama,1731,warlock,destruction,30,22,8
Rianna,lightninghoof,1730,warlock,destruction,27,20,7
Spooked,khadgar,1730,warlock,destruction,60,35,25
Richactress,tichondrius,1730,warlock,destruction,35,19,16
Keniiwood,quelthalas,1730,warlock,destruction,42,21,21
Fabiusbilex,tichondrius,1729,warlock,destruction,45,28,17
Sdiaz,illidan,1729,warlock,destruction,42,26,16
Leeroydots,area-52,1729,warlock,destruction,72,43,29
Adelrinn,frostmourne,1729,warlock,destruction,240,134,106
Harmfuul,illidan,1728,warlock,destruction,45,28,17
Sakyameil,area-52,1727,warlock,destruction,48,28,20
Merji,area-52,1726,warlock,destruction,35,22,13
Kymamd,sargeras,1726,warlock,destruction,44,24,20
Teefgap,sargeras,1726,warlock,destruction,48,24,24
Uarus,tichondrius,1725,warlock,destruction,42,26,16
Nino,barthilas,1725,warlock,destruction,33,20,13
Popdotdropit,frostwolf,1725,warlock,destruction,84,48,36
Elcidoo,tichondrius,1724,warlock,destruction,30,18,12
Sundrín,mugthol,1724,warlock,destruction,71,32,39
Perfidious,altar-of-storms,1723,warlock,destruction,40,30,10
Fearlord,shattered-hand,1723,warlock,destruction,66,37,29
Meraz,zuljin,1721,warlock,destruction,40,24,16
Glad,fenris,1721,warlock,destruction,109,60,49
Destructing,hyjal,1721,warlock,destruction,48,25,23
Janeciap,tichondrius,1720,warlock,destruction,30,18,12
Covidmaster,frostmourne,1720,warlock,destruction,124,66,58
Kyrmax,malganis,1720,warlock,destruction,150,71,79
Drwongmd,sargeras,1719,warlock,destruction,30,21,9
Verminosa,nemesis,1718,warlock,destruction,30,19,11
Agni,gurubashi,1718,warlock,destruction,126,66,60
Crucyblettv,korgath,1717,warlock,destruction,24,18,6
Jenda,blackrock,1717,warlock,destruction,128,67,61
Naiyuan,tichondrius,1716,warlock,destruction,36,18,18
Lockfoxyy,tichondrius,1714,warlock,destruction,30,21,9
Carcøsa,malganis,1714,warlock,destruction,72,40,32
Azaradx,azralon,1714,warlock,destruction,85,39,46
Gëngar,malganis,1713,warlock,destruction,37,26,11
Sixv,barthilas,1713,warlock,destruction,48,32,16
Richãrdjr,area-52,1713,warlock,destruction,36,22,14
Kairiesmirk,illidan,1713,warlock,destruction,129,67,62
Lotussama,anetheron,1712,warlock,destruction,24,18,6
Evatar,malganis,1712,warlock,destruction,36,21,15
Keylloggz,sargeras,1712,warlock,destruction,102,56,46
Sidgnosis,stormrage,1712,warlock,destruction,266,136,130
Hehimx,bleeding-hollow,1711,warlock,destruction,24,18,6
Mchawi,tichondrius,1711,warlock,destruction,59,35,24
Crimpy,dathremar,1711,warlock,destruction,59,34,25
Aggrodesiac,wyrmrest-accord,1711,warlock,destruction,108,58,50
Mastasnipah,illidan,1711,warlock,destruction,42,22,20
Struggles,emerald-dream,1711,warlock,destruction,187,97,90
Serveq,tichondrius,1710,warlock,destruction,103,58,45
Richãrd,area-52,1709,warlock,destruction,49,26,23
Ercaz,frostmourne,1709,warlock,destruction,48,20,28
Shulol,tichondrius,1708,warlock,destruction,30,18,12
Pigmahz,malganis,1708,warlock,destruction,72,39,33
Dbf,sargeras,1708,warlock,destruction,115,57,58
Wårløck,stormrage,1707,warlock,destruction,24,18,6
Cokeparty,tichondrius,1707,warlock,destruction,53,29,24
Resuah,tichondrius,1707,warlock,destruction,184,99,85
Tacticalderp,bleeding-hollow,1706,warlock,destruction,36,18,18
Juicestarr,barthilas,1704,warlock,destruction,105,51,54
Gasgrassnass,sargeras,1702,warlock,destruction,89,50,39
Wolfstein,tichondrius,1699,warlock,destruction,24,18,6
Conradlenoir,illidan,1699,warlock,destruction,36,23,13
Jennifear,sargeras,1699,warlock,destruction,96,54,42
Giantgobrin,zuljin,1699,warlock,destruction,60,31,29
Daartaru,quelthalas,1698,warlock,destruction,90,48,42
Ägnar,nemesis,1698,warlock,destruction,40,21,19
Azazil,malganis,1697,warlock,destruction,36,22,14
Fredwinsta,laughing-skull,1697,warlock,destruction,54,29,25
Harukay,tichondrius,1696,warlock,destruction,29,20,9
Dedrikz,illidan,1696,warlock,destruction,36,24,12
Hiddentech,saurfang,1696,warlock,destruction,36,20,16
Teivlol,mugthol,1696,warlock,destruction,36,18,18
Døomsday,hyjal,1696,warlock,destruction,92,42,50
Chrysippus,illidan,1696,warlock,destruction,42,18,24
Pãni,area-52,1695,warlock,destruction,60,32,28
Dotandforget,tichondrius,1691,warlock,destruction,36,24,12
Chrönic,azralon,1691,warlock,destruction,45,26,19
Alktrz,azralon,1691,warlock,destruction,37,19,18
Cbx,kelthuzad,1690,warlock,destruction,36,28,8
Aluaris,earthen-ring,1690,warlock,destruction,30,23,7
Chaosbeard,korgath,1690,warlock,destruction,62,36,26
Taneverah,wyrmrest-accord,1689,warlock,destruction,47,30,17
Missmonday,tichondrius,1689,warlock,destruction,83,44,39
Hauntsin,hyjal,1689,warlock,destruction,42,21,21
Kâyn,area-52,1687,warlock,destruction,95,49,46
Lønewølf,sargeras,1687,warlock,destruction,90,45,45
Wafflezcb,frostmourne,1687,warlock,destruction,43,21,22
Dautenit,illidan,1687,warlock,destruction,66,32,34
Bfadestro,tichondrius,1686,warlock,destruction,36,24,12
Drain,proudmoore,1686,warlock,destruction,60,38,22
Bobbyshmurdå,frostmourne,1686,warlock,destruction,48,29,19
Nocrackrocks,stormrage,1686,warlock,destruction,40,23,17
Veerdz,area-52,1686,warlock,destruction,60,27,33
Contagion,dragonmaw,1685,warlock,destruction,36,20,16
Viralwashbrn,illidan,1685,warlock,destruction,84,43,41
Melôck,area-52,1684,warlock,destruction,42,28,14
Urukaix,sargeras,1683,warlock,destruction,36,23,13
Maggotworm,sargeras,1683,warlock,destruction,189,104,85
Parishiltoon,frostmourne,1681,warlock,destruction,64,26,38
Droptopp,malganis,1680,warlock,destruction,42,27,15
Warwand,tichondrius,1679,warlock,destruction,36,25,11
Stølo,deathwing,1679,warlock,destruction,130,84,46
Gavrhin,area-52,1679,warlock,destruction,47,29,18
Lïttle,stormrage,1678,warlock,destruction,81,48,33
Sauceaura,frostmourne,1678,warlock,destruction,57,29,28
Catodo,ragnaros,1678,warlock,destruction,42,18,24
Chaotixbolt,sargeras,1677,warlock,destruction,30,20,10
Getoffmedawg,illidan,1677,warlock,destruction,66,38,28
Breeak,sargeras,1676,warlock,destruction,48,31,17
Gekku,ragnaros,1676,warlock,destruction,36,22,14
Kbolt,barthilas,1676,warlock,destruction,95,55,40
Dipixd,tichondrius,1675,warlock,destruction,24,22,2
Revenus,tichondrius,1675,warlock,destruction,195,97,98
Zandõx,jubeithos,1674,warlock,destruction,65,40,25
Knockknock,llane,1673,warlock,destruction,42,22,20
Razzakka,stormrage,1673,warlock,destruction,171,87,84
Booßiemiles,area-52,1672,warlock,destruction,157,92,65
Bytezlk,area-52,1672,warlock,destruction,36,21,15
Pyatpree,bleeding-hollow,1671,warlock,destruction,30,19,11
Cloudynightz,tichondrius,1671,warlock,destruction,167,89,78
Mlxd,tichondrius,1670,warlock,destruction,24,19,5
Critthis,illidan,1670,warlock,destruction,47,32,15
Sauzith,area-52,1670,warlock,destruction,55,33,22
Ðòm,tichondrius,1670,warlock,destruction,42,24,18
Imadotyasan,shandris,1669,warlock,destruction,52,35,17
Ðiêsel,malganis,1668,warlock,destruction,57,32,25
Painful,mannoroth,1668,warlock,destruction,246,126,120
Levantine,barthilas,1667,warlock,destruction,45,24,21
Drksøul,barthilas,1666,warlock,destruction,77,52,25
Stankbigly,thrall,1666,warlock,destruction,68,41,27
Ifearjoo,vashj,1666,warlock,destruction,48,25,23
Iskiplegday,illidan,1666,warlock,destruction,107,45,62
Restolock,destromath,1665,warlock,destruction,78,45,33
Scxut,zuljin,1665,warlock,destruction,94,53,41
Degred,tichondrius,1664,warlock,destruction,45,34,11
Kurifodo,illidan,1664,warlock,destruction,88,50,38
Skrublockz,area-52,1664,warlock,destruction,47,24,23
Nocchi,amanthul,1664,warlock,destruction,40,19,21
Olgee,tortheldrin,1663,warlock,destruction,53,30,23
Chnos,mugthol,1663,warlock,destruction,41,23,18
Katrisse,aegwynn,1663,warlock,destruction,78,42,36
Rxjr,sargeras,1663,warlock,destruction,90,46,44
Làsko,area-52,1663,warlock,destruction,120,60,60
Khølek,ragnaros,1662,warlock,destruction,59,39,20
Evilmilf,tichondrius,1662,warlock,destruction,109,60,49
Lockz,illidan,1662,warlock,destruction,54,27,27
Manapouli,area-52,1660,warlock,destruction,44,26,18
Silone,tichondrius,1659,warlock,destruction,30,24,6
Xdta,frostmourne,1659,warlock,destruction,78,43,35
Yisuschríst,quelthalas,1659,warlock,destruction,52,26,26
Flûké,tichondrius,1658,warlock,destruction,36,19,17
Domwarlock,uther,1658,warlock,destruction,51,25,26
Hynnis,nemesis,1657,warlock,destruction,66,41,25
Sendnudez,nemesis,1657,warlock,destruction,53,30,23
Sîthfu,tichondrius,1657,warlock,destruction,195,105,90
Cbolt,tichondrius,1656,warlock,destruction,90,52,38
Pikme,bleeding-hollow,1656,warlock,destruction,42,23,19
Mephizar,moon-guard,1656,warlock,destruction,56,30,26
Deangood,tichondrius,1656,warlock,destruction,152,77,75
Aureboros,sargeras,1655,warlock,destruction,30,20,10
Steebi,tichondrius,1655,warlock,destruction,36,23,13
Favorite,malfurion,1655,warlock,destruction,36,21,15
Nooko,frostmourne,1655,warlock,destruction,48,25,23
Demonkiiller,kelthuzad,1655,warlock,destruction,54,24,30
Zhvim,stormrage,1654,warlock,destruction,41,23,18
Sagatt,illidan,1654,warlock,destruction,83,45,38
Hellwish,tichondrius,1654,warlock,destruction,108,53,55
Chachanoobx,sargeras,1653,warlock,destruction,168,102,66
Egirlgamer,sargeras,1653,warlock,destruction,72,43,29
Magiaoscurax,quelthalas,1653,warlock,destruction,165,93,72
Nickie,azralon,1653,warlock,destruction,60,33,27
Dobbythelock,zuljin,1653,warlock,destruction,42,23,19
Fece,area-52,1652,warlock,destruction,38,24,14
Warmandei,dalaran,1652,warlock,destruction,72,42,30
Tulu,muradin,1651,warlock,destruction,65,46,19
Contägion,bleeding-hollow,1651,warlock,destruction,42,20,22
Lemonfire,area-52,1650,warlock,destruction,49,26,23
Lockniel,skullcrusher,1649,warlock,destruction,60,37,23
Absoluté,nemesis,1649,warlock,destruction,36,19,17
Cptsaveahoe,skullcrusher,1649,warlock,destruction,42,22,20
Royalmace,dethecus,1648,warlock,destruction,46,25,21
Jaythuzad,stormrage,1648,warlock,destruction,146,79,67
Uranusa,proudmoore,1648,warlock,destruction,108,50,58
Trewlocke,sargeras,1647,warlock,destruction,42,25,17
Muffîn,moon-guard,1647,warlock,destruction,109,64,45
Reppedlock,illidan,1647,warlock,destruction,94,55,39
Dolut,azralon,1647,warlock,destruction,60,35,25
Feardadots,tichondrius,1646,warlock,destruction,75,48,27
Harambê,sargeras,1646,warlock,destruction,40,22,18
Javirr,ragnaros,1645,warlock,destruction,65,39,26
Neverportx,kirin-tor,1645,warlock,destruction,36,21,15
Jussmollett,arygos,1645,warlock,destruction,125,66,59
Dëstró,tichondrius,1645,warlock,destruction,65,34,31
Jpepps,perenolde,1644,warlock,destruction,89,53,36
Misolock,sargeras,1644,warlock,destruction,105,56,49
Rotsndotss,thrall,1644,warlock,destruction,57,28,29
Jerclard,proudmoore,1643,warlock,destruction,66,35,31
Balepyre,moon-guard,1643,warlock,destruction,106,56,50
Fiddlesticks,draka,1642,warlock,destruction,54,36,18
Tahmrin,quelthalas,1642,warlock,destruction,58,30,28
Saltiez,sargeras,1641,warlock,destruction,30,22,8
Imports,tichondrius,1641,warlock,destruction,34,21,13
Chaosage,sargeras,1640,warlock,destruction,42,28,14
Liuh,tichondrius,1640,warlock,destruction,30,18,12
Luckehlock,firetree,1640,warlock,destruction,65,34,31
Cairo,emerald-dream,1640,warlock,destruction,249,130,119
Mindrekt,azralon,1639,warlock,destruction,72,47,25
Fearmebro,bleeding-hollow,1639,warlock,destruction,139,72,67
Kerrigan,the-venture-co,1638,warlock,destruction,29,21,8
Belford,tichondrius,1638,warlock,destruction,67,35,32
Grandpa,daggerspine,1638,warlock,destruction,115,59,56
Demonclock,sargeras,1637,warlock,destruction,39,24,15
Ardentia,malganis,1637,warlock,destruction,54,30,24
Ðòt,nagrand,1637,warlock,destruction,52,25,27
Reficul,frostmourne,1637,warlock,destruction,50,23,27
Gingerspise,nathrezim,1637,warlock,destruction,48,21,27
Arenis,stormrage,1636,warlock,destruction,36,25,11
Xylâ,emerald-dream,1636,warlock,destruction,39,22,17
Kvxkxvxvk,bleeding-hollow,1636,warlock,destruction,49,23,26
Eyoeyo,tichondrius,1636,warlock,destruction,42,18,24
Cursedstales,stormrage,1635,warlock,destruction,42,30,12
Fenexia,hyjal,1635,warlock,destruction,89,58,31
Flággedname,area-52,1635,warlock,destruction,36,21,15
Sëcond,azralon,1635,warlock,destruction,36,19,17
Kylaria,emerald-dream,1635,warlock,destruction,48,24,24
Hugechungusw,frostmourne,1634,warlock,destruction,50,31,19
Bénâfflock,area-52,1634,warlock,destruction,54,32,22
Identiti,tichondrius,1634,warlock,destruction,49,27,22
Iconicxo,thrall,1634,warlock,destruction,84,43,41
Dartthvader,azralon,1634,warlock,destruction,110,53,57
Dìpndots,wyrmrest-accord,1633,warlock,destruction,54,32,22
Zhaphrax,frostmourne,1633,warlock,destruction,85,43,42
Evapilot,tichondrius,1632,warlock,destruction,54,31,23
Yidhra,aerie-peak,1632,warlock,destruction,111,58,53
Siellisele,illidan,1632,warlock,destruction,60,29,31
Guldoom,tichondrius,1631,warlock,destruction,18,17,1
Demonista,illidan,1631,warlock,destruction,31,22,9
Oxylock,magtheridon,1631,warlock,destruction,42,24,18
Lóckdówn,frostmourne,1631,warlock,destruction,60,32,28
Shendù,stormrage,1631,warlock,destruction,48,23,25
Ddorangmoon,tichondrius,1630,warlock,destruction,42,25,17
Dipixyz,tichondrius,1630,warlock,destruction,30,17,13
Infecçäo,stormrage,1630,warlock,destruction,131,73,58
Kjazz,tichondrius,1630,warlock,destruction,42,23,19
Holunging,illidan,1630,warlock,destruction,36,19,17
Tjdrizzle,tichondrius,1630,warlock,destruction,48,18,30
Léarníng,nemesis,1629,warlock,destruction,36,26,10
Daenon,kiljaeden,1629,warlock,destruction,54,29,25
Tanskeeh,sargeras,1629,warlock,destruction,82,44,38
Stormrift,sargeras,1629,warlock,destruction,74,39,35
Ltoplaylock,area-52,1628,warlock,destruction,24,17,7
Soranpotter,tichondrius,1628,warlock,destruction,24,17,7
Tuugadark,echo-isles,1628,warlock,destruction,85,51,34
Cöpeñhagen,illidan,1627,warlock,destruction,48,26,22
Undeadzx,tichondrius,1627,warlock,destruction,36,19,17
Synmari,tichondrius,1627,warlock,destruction,54,26,28
Shadowlifts,kelthuzad,1626,warlock,destruction,48,29,19
Meep,madoran,1626,warlock,destruction,59,35,24
Katastrophïk,area-52,1626,warlock,destruction,36,20,16
Byndedlock,dragonmaw,1625,warlock,destruction,33,20,13
Vvivienx,tichondrius,1625,warlock,destruction,30,17,13
Babydots,stormreaver,1625,warlock,destruction,80,44,36
Avelmi,daggerspine,1625,warlock,destruction,139,74,65
Dovahkini,stormrage,1625,warlock,destruction,47,23,24
Shadowsloc,tichondrius,1625,warlock,destruction,48,22,26
Ruknài,barthilas,1624,warlock,destruction,36,21,15
Coomerius,zuljin,1624,warlock,destruction,54,29,25
Xephine,proudmoore,1623,warlock,destruction,46,30,16
Deathboltx,zuljin,1623,warlock,destruction,33,21,12
Excusey,tichondrius,1623,warlock,destruction,36,20,16
Alizondemdik,azralon,1623,warlock,destruction,67,37,30
Thotblood,stormrage,1622,warlock,destruction,24,18,6
Friendd,frostmourne,1622,warlock,destruction,41,30,11
Doomswitch,sargeras,1622,warlock,destruction,48,33,15
Permaslowed,kiljaeden,1622,warlock,destruction,40,22,18
Sslock,sargeras,1622,warlock,destruction,52,27,25
Golock,tichondrius,1621,warlock,destruction,24,17,7
Sauromann,sargeras,1621,warlock,destruction,114,66,48
Deathmask,alleria,1621,warlock,destruction,52,30,22
Magnetix,arthas,1621,warlock,destruction,212,108,104
Ticklebolts,tichondrius,1621,warlock,destruction,52,21,31
Elmobolt,thrall,1620,warlock,destruction,37,27,10
Annereyn,stormrage,1620,warlock,destruction,119,62,57
Webrar,frostmourne,1619,warlock,destruction,48,28,20
Yikës,stormrage,1619,warlock,destruction,36,20,16
Tít,malganis,1619,warlock,destruction,90,46,44
Rainymood,frostmourne,1618,warlock,destruction,97,59,38
Penzer,stormrage,1618,warlock,destruction,36,20,16
Wickedry,antonidas,1617,warlock,destruction,48,23,25
Raykun,quelthalas,1616,warlock,destruction,90,47,43
Sidious,jubeithos,1615,warlock,destruction,70,43,27
Ðarkñess,burning-legion,1615,warlock,destruction,66,38,28
Malagas,tichondrius,1615,warlock,destruction,81,46,35
Dotgonewrong,malganis,1615,warlock,destruction,71,32,39
Notspeedy,tichondrius,1615,warlock,destruction,91,41,50
Brockdot,tichondrius,1614,warlock,destruction,44,31,13
Ãids,khadgar,1614,warlock,destruction,54,36,18
Shïrõ,tichondrius,1613,warlock,destruction,30,22,8
Dettocs,emerald-dream,1613,warlock,destruction,61,29,32
Vasqu,stormrage,1612,warlock,destruction,24,17,7
Mitryc,illidan,1612,warlock,destruction,30,17,13
Ko,nordrassil,1612,warlock,destruction,72,37,35
Hypnotikal,illidan,1611,warlock,destruction,30,22,8
Draenil,eredar,1611,warlock,destruction,24,17,7
Dipz,zuljin,1611,warlock,destruction,30,21,9
Corruptblxck,tichondrius,1611,warlock,destruction,45,28,17
Chrishasnen,moon-guard,1611,warlock,destruction,54,27,27
Idrannell,illidan,1610,warlock,destruction,98,56,42
Omleaf,malganis,1610,warlock,destruction,36,18,18
Gigabiga,tol-barad,1609,warlock,destruction,24,17,7
Funnysoxx,caelestrasz,1609,warlock,destruction,58,33,25
Momshutup,sargeras,1609,warlock,destruction,41,20,21
Isarac,zuljin,1608,warlock,destruction,78,50,28
Zuyumin,ragnaros,1608,warlock,destruction,89,57,32
Ayrr,zuljin,1608,warlock,destruction,30,17,13
Liritasu,illidan,1608,warlock,destruction,36,20,16
Gnomlette,smolderthorn,1608,warlock,destruction,98,53,45
Kály,azralon,1608,warlock,destruction,69,37,32
Saruon,proudmoore,1607,warlock,destruction,24,17,7
Valrena,rivendare,1607,warlock,destruction,30,20,10
Darknessgodd,goldrinn,1607,warlock,destruction,133,76,57
Pugnatwo,kelthuzad,1607,warlock,destruction,42,18,24
Skrunkz,illidan,1606,warlock,destruction,28,20,8
Lilbiackguy,stormrage,1606,warlock,destruction,78,50,28
Tougetsu,tichondrius,1606,warlock,destruction,46,27,19
Soloart,tichondrius,1606,warlock,destruction,60,33,27
Necrotic,mannoroth,1606,warlock,destruction,113,52,61
Macdeezylock,sargeras,1605,warlock,destruction,36,23,13
Vugaddi,illidan,1605,warlock,destruction,30,19,11
Lôrdslug,bleeding-hollow,1605,warlock,destruction,48,29,19
Brdsflynhigh,garrosh,1604,warlock,destruction,33,23,10
Poxnhub,tichondrius,1604,warlock,destruction,29,19,10
Darkÿoda,malganis,1604,warlock,destruction,86,47,39
Hordeadlock,illidan,1604,warlock,destruction,60,31,29
Powertrîp,sargeras,1604,warlock,destruction,36,18,18
Honchoe,illidan,1603,warlock,destruction,42,29,13
Nosferatu,arthas,1602,warlock,destruction,26,20,6
Bourrasq,illidan,1602,warlock,destruction,24,17,7
Kliera,stormscale,1602,warlock,destruction,54,29,25
Espyn,silvermoon,1602,warlock,destruction,105,51,54
Vafa,kelthuzad,1601,warlock,destruction,32,21,11
Lyonesse,frostmourne,1601,warlock,destruction,34,21,13
Reportmenerd,tichondrius,1601,warlock,destruction,126,71,55
Lafourche,tichondrius,1601,warlock,destruction,60,31,29
Mattypatty,the-forgotten-coast,1601,warlock,destruction,60,30,30
Spliffxl,stormrage,1601,warlock,destruction,42,21,21
Pauldiesel,ragnaros,1601,warlock,destruction,42,21,21
Hâm,dalaran,1601,warlock,destruction,96,46,50
Dapete,malorne,1600,warlock,destruction,36,26,10
Watchmegate,darkspear,1600,warlock,destruction,72,45,27
Asiloas,shattered-hand,1600,warlock,destruction,30,17,13
Locknug,tichondrius,1600,warlock,destruction,132,74,58
Dapperdanxy,tichondrius,1600,warlock,destruction,38,21,17
Adouken,ragnaros,1600,warlock,destruction,36,19,17
Johnnybegood,frostmourne,1598,warlock,destruction,54,32,22
Boltsnhoez,tichondrius,1598,warlock,destruction,34,20,14
Wayce,burning-blade,1598,warlock,destruction,208,107,101
Xoxoxu,frostmourne,1597,warlock,destruction,44,25,19
Predictions,sargeras,1597,warlock,destruction,77,40,37
Closetslut,moon-guard,1596,warlock,destruction,24,20,4
Maddotts,malganis,1596,warlock,destruction,42,28,14
Matilla,tichondrius,1596,warlock,destruction,36,20,16
Burnzul,bleeding-hollow,1596,warlock,destruction,54,29,25
Cheylock,stormrage,1595,warlock,destruction,30,18,12
Midoolock,proudmoore,1595,warlock,destruction,82,46,36
Dotcoin,tichondrius,1594,warlock,destruction,30,17,13
Sasaology,frostmourne,1594,warlock,destruction,30,17,13
Lockforyou,frostmourne,1594,warlock,destruction,66,37,29
Dôkgo,tichondrius,1594,warlock,destruction,36,17,19
Jnxzlock,sargeras,1593,warlock,destruction,67,37,30
Wheremyshoes,area-52,1593,warlock,destruction,141,68,73
Jerearderedo,thrall,1592,warlock,destruction,54,30,24
Kernlberton,tichondrius,1592,warlock,destruction,48,25,23
Larryfisher,drenden,1591,warlock,destruction,30,19,11
Akolite,tichondrius,1591,warlock,destruction,62,31,31
Noggét,frostmourne,1590,warlock,destruction,126,71,55
Romminus,zuljin,1589,warlock,destruction,43,30,13
Mokulock,tichondrius,1589,warlock,destruction,93,50,43
Lockdogg,mannoroth,1588,warlock,destruction,36,22,14
Sladez,tichondrius,1588,warlock,destruction,47,20,27
Caustikk,malganis,1587,warlock,destruction,44,25,19
Buffwarlocks,senjin,1587,warlock,destruction,48,26,22
Doobielock,kelthuzad,1586,warlock,destruction,57,33,24
Tothegrave,sargeras,1585,warlock,destruction,35,22,13
Rottenhell,kelthuzad,1585,warlock,destruction,108,61,47
Calidaze,tichondrius,1584,warlock,destruction,134,70,64
Kuroyt,drakkari,1583,warlock,destruction,42,26,16
Belzebud,area-52,1583,warlock,destruction,111,64,47
Ciprýan,azralon,1583,warlock,destruction,52,27,25
Devilman,darkspear,1583,warlock,destruction,169,85,84
Caseau,frostmourne,1581,warlock,destruction,30,19,11
Lockblock,veknilash,1580,warlock,destruction,41,25,16
Doombaby,zuljin,1580,warlock,destruction,144,79,65
Pyralock,malfurion,1580,warlock,destruction,66,32,34
Gerthclas,aggramar,1579,warlock,destruction,35,24,11
Bbclover,thrall,1579,warlock,destruction,29,19,10
Grindwald,echo-isles,1579,warlock,destruction,85,44,41
Lhandus,drakkari,1579,warlock,destruction,98,47,51
Wediditjoe,kelthuzad,1578,warlock,destruction,42,24,18
Lostanubis,tichondrius,1578,warlock,destruction,51,29,22
Woezz,tichondrius,1578,warlock,destruction,105,55,50
Gluestik,shadowmoon,1578,warlock,destruction,84,42,42
Dferreira,azralon,1577,warlock,destruction,123,66,57
Thirdsol,stormrage,1577,warlock,destruction,59,31,28
Charnoob,kelthuzad,1577,warlock,destruction,54,26,28
Soreanus,illidan,1576,warlock,destruction,34,23,11
Horloc,moon-guard,1575,warlock,destruction,98,52,46
Grenswood,arathor,1575,warlock,destruction,39,19,20
Leônidos,ghostlands,1574,warlock,destruction,120,61,59
Borthrel,moon-guard,1573,warlock,destruction,132,75,57
Jezwazerox,area-52,1573,warlock,destruction,117,66,51
Xiáoyan,tichondrius,1571,warlock,destruction,60,37,23
Bunnyhugs,gorefiend,1571,warlock,destruction,36,22,14
Youkeyoh,illidan,1571,warlock,destruction,48,28,20
Khurze,area-52,1571,warlock,destruction,109,56,53
Carmelasin,moon-guard,1570,warlock,destruction,60,39,21
Serplock,kelthuzad,1570,warlock,destruction,33,19,14
Austeeny,wyrmrest-accord,1569,warlock,destruction,37,26,11
Lifelock,auchindoun,1567,warlock,destruction,46,28,18
Stocktonslap,saurfang,1567,warlock,destruction,188,100,88
Nutgobblerxo,sargeras,1565,warlock,destruction,30,19,11
Khrom,illidan,1565,warlock,destruction,64,32,32
Hellfires,ragnaros,1565,warlock,destruction,36,17,19
Riiselock,shadow-council,1564,warlock,destruction,48,26,22
Whathurts,tichondrius,1564,warlock,destruction,86,42,44
Uow,stormrage,1564,warlock,destruction,42,20,22
Rentacletape,kelthuzad,1563,warlock,destruction,40,22,18
Plutö,thrall,1563,warlock,destruction,36,18,18
Drakedox,tichondrius,1562,warlock,destruction,50,28,22
Yaldin,nemesis,1562,warlock,destruction,227,124,103
Versariki,frostmourne,1562,warlock,destruction,96,51,45
Felnightz,area-52,1562,warlock,destruction,48,23,25
Alfaflux,tol-barad,1562,warlock,destruction,65,30,35
Juswannarock,tichondrius,1561,warlock,destruction,45,26,19
Canobio,tichondrius,1559,warlock,destruction,36,18,18
Vasago,jubeithos,1558,warlock,destruction,71,36,35
Ìzanamí,area-52,1558,warlock,destruction,36,18,18
Deathteller,tichondrius,1558,warlock,destruction,35,17,18
Tharki,darkspear,1557,warlock,destruction,311,159,152
Jarasseck,malganis,1557,warlock,destruction,109,54,55
Mothmayhem,moon-guard,1556,warlock,destruction,54,29,25
Trastham,malganis,1556,warlock,destruction,108,53,55
Dëception,ragnaros,1555,warlock,destruction,30,18,12
Dewars,aggramar,1554,warlock,destruction,132,71,61
Niked,sargeras,1553,warlock,destruction,114,67,47
Tunacangirth,mannoroth,1551,warlock,destruction,24,17,7
Wiildgoose,area-52,1551,warlock,destruction,42,27,15
Loçk,zuljin,1551,warlock,destruction,169,87,82
Dots,haomarush,1551,warlock,destruction,107,53,54
Naba,malorne,1550,warlock,destruction,42,27,15
Mispickle,kelthuzad,1550,warlock,destruction,60,32,28
Cioxius,stormrage,1550,warlock,destruction,57,28,29
Kossnen,shandris,1550,warlock,destruction,76,35,41
Yükina,stormrage,1549,warlock,destruction,211,109,102
Neph,malganis,1549,warlock,destruction,38,19,19
Nightshan,draenor,1548,warlock,destruction,78,36,42
Kascade,drakkari,1547,warlock,destruction,56,31,25
Darksolace,dalaran,1547,warlock,destruction,42,21,21
Glortheeb,spirestone,1547,warlock,destruction,42,21,21
Medusaqn,tichondrius,1547,warlock,destruction,36,18,18
Ðeãdman,bleeding-hollow,1546,warlock,destruction,36,25,11
Beelzibub,firetree,1546,warlock,destruction,65,41,24
Bayfayth,zuljin,1546,warlock,destruction,92,52,40
Buboñic,area-52,1545,warlock,destruction,83,39,44
Freggen,shadowsong,1544,warlock,destruction,66,39,27
Plexwl,sargeras,1544,warlock,destruction,75,37,38
Gorontar,kelthuzad,1544,warlock,destruction,62,30,32
Brickedx,malfurion,1544,warlock,destruction,113,54,59
Nöxïöüs,sargeras,1543,warlock,destruction,29,17,12
Sickgurl,stormrage,1542,warlock,destruction,77,46,31
Strykerliath,bleeding-hollow,1541,warlock,destruction,55,29,26
Remua,tichondrius,1540,warlock,destruction,29,18,11
Warlockmf,sargeras,1540,warlock,destruction,121,66,55
Nattydots,sargeras,1540,warlock,destruction,83,43,40
Kkokko,tichondrius,1539,warlock,destruction,114,60,54
Psyløck,bleeding-hollow,1539,warlock,destruction,78,41,37
Nybeth,malganis,1539,warlock,destruction,80,39,41
Thralord,blackrock,1538,warlock,destruction,48,30,18
Cryptos,kalecgos,1538,warlock,destruction,38,22,16
Lessance,dalaran,1538,warlock,destruction,54,31,23
Beranflakes,darkspear,1538,warlock,destruction,36,19,17
Flxmin,area-52,1538,warlock,destruction,64,32,32
Guula,alexstrasza,1538,warlock,destruction,48,23,25
Kazinox,area-52,1538,warlock,destruction,42,20,22
Rerolledfotm,sargeras,1537,warlock,destruction,60,36,24
Hadouh,stormrage,1537,warlock,destruction,29,17,12
Barathron,tichondrius,1537,warlock,destruction,90,45,45
Dunbu,illidan,1536,warlock,destruction,152,84,68
Warlockgomes,azralon,1536,warlock,destruction,264,135,129
Celistia,wyrmrest-accord,1535,warlock,destruction,24,17,7
Nvmb,frostmourne,1535,warlock,destruction,30,21,9
Chadica,malganis,1534,warlock,destruction,18,16,2
Threk,quelthalas,1534,warlock,destruction,30,16,14
Littledúck,azralon,1533,warlock,destruction,18,16,2
Zver,drakkari,1533,warlock,destruction,41,23,18
Scarletdemon,malganis,1532,warlock,destruction,65,35,30
Shatteroidz,darkspear,1531,warlock,destruction,24,16,8
Fearem,tichondrius,1530,warlock,destruction,27,17,10
Zogs,stonemaul,1530,warlock,destruction,42,17,25
Beetlejoos,stormreaver,1529,warlock,destruction,30,16,14
Shadowmoonon,tichondrius,1529,warlock,destruction,30,16,14
Catdog,bleeding-hollow,1529,warlock,destruction,54,27,27
Soulicit,kelthuzad,1529,warlock,destruction,70,34,36
Brucelock,proudmoore,1528,warlock,destruction,24,16,8
Greedy,garrosh,1528,warlock,destruction,30,18,12
Gharlock,tichondrius,1528,warlock,destruction,62,36,26
Bcxz,illidan,1528,warlock,destruction,82,40,42
Zalord,mannoroth,1528,warlock,destruction,124,54,70
Lustyclam,tichondrius,1527,warlock,destruction,95,55,40
Yanned,hakkar,1527,warlock,destruction,243,127,116
Asetiks,tichondrius,1526,warlock,destruction,30,16,14
Promethian,proudmoore,1526,warlock,destruction,75,33,42
Repláced,thrall,1525,warlock,destruction,101,58,43
Josaith,moon-guard,1525,warlock,destruction,107,57,50
Alexmeister,jubeithos,1525,warlock,destruction,42,16,26
Prelick,illidan,1524,warlock,destruction,47,19,28
Warluckie,zuljin,1523,warlock,destruction,24,18,6
Sharkweek,zuljin,1523,warlock,destruction,30,18,12
Hadit,malganis,1523,warlock,destruction,55,30,25
Zetsu,zuljin,1523,warlock,destruction,263,135,128
Obscurity,tichondrius,1523,warlock,destruction,72,36,36
Trobgol,bleeding-hollow,1522,warlock,destruction,35,22,13
Cesily,frostmourne,1522,warlock,destruction,30,16,14
Tunacanthicc,moon-guard,1522,warlock,destruction,136,70,66
Ggooudan,tichondrius,1521,warlock,destruction,24,16,8
Mateekabr,malganis,1521,warlock,destruction,30,18,12
Voltshot,tichondrius,1521,warlock,destruction,153,82,71
Escapefromtw,tichondrius,1521,warlock,destruction,71,35,36
Killvilock,kelthuzad,1521,warlock,destruction,79,37,42
Baldandugly,illidan,1520,warlock,destruction,30,18,12
Kajayak,nazjatar,1520,warlock,destruction,84,46,38
Numerical,frostmourne,1519,warlock,destruction,24,16,8
Azracore,illidan,1519,warlock,destruction,51,31,20
Domson,area-52,1519,warlock,destruction,140,81,59
Hellbòund,mugthol,1519,warlock,destruction,42,24,18
Forsâken,tichondrius,1519,warlock,destruction,79,40,39
Blorgaflob,thaurissan,1518,warlock,destruction,19,16,3
Impfused,azshara,1518,warlock,destruction,54,31,23
Thravis,tichondrius,1518,warlock,destruction,36,20,16
Aliciayd,andorhal,1517,warlock,destruction,30,19,11
Hyoozy,illidan,1517,warlock,destruction,30,16,14
Grammapatty,tichondrius,1517,warlock,destruction,30,16,14
Agonie,tichondrius,1517,warlock,destruction,285,146,139
Marcedlc,ragnaros,1516,warlock,destruction,84,48,36
Iockgodtkoz,tichondrius,1516,warlock,destruction,54,27,27
Sylrath,illidan,1516,warlock,destruction,69,30,39
Mixolydian,malganis,1515,warlock,destruction,42,23,19
Pestilocks,area-52,1514,warlock,destruction,73,44,29
Politex,malganis,1513,warlock,destruction,64,40,24
Squatchamp,sargeras,1512,warlock,destruction,54,31,23
Kongal,tichondrius,1512,warlock,destruction,30,16,14
Árkadiano,drakkari,1511,warlock,destruction,30,16,14
Hootenanny,korialstrasz,1511,warlock,destruction,72,34,38
Grimby,malganis,1511,warlock,destruction,42,18,24
Hawklock,ragnaros,1510,warlock,destruction,24,17,7
Stonnerz,ragnaros,1509,warlock,destruction,81,46,35
Joseph,draktharon,1509,warlock,destruction,66,35,31
Lockybalboah,turalyon,1509,warlock,destruction,120,63,57
Fearsntears,stormrage,1509,warlock,destruction,42,16,26
Chaosmorty,tichondrius,1508,warlock,destruction,51,32,19
Honne,sargeras,1507,warlock,destruction,32,19,13
Korose,tichondrius,1507,warlock,destruction,207,102,105
Conspiration,sargeras,1505,warlock,destruction,36,24,12
Hazbussy,kelthuzad,1505,warlock,destruction,30,17,13
Widdleywahh,area-52,1505,warlock,destruction,145,76,69
Wizlox,illidan,1505,warlock,destruction,220,109,111
Shaneyxd,bleeding-hollow,1504,warlock,destruction,24,16,8
Johndazombie,zuljin,1504,warlock,destruction,24,16,8
Aashes,doomhammer,1504,warlock,destruction,48,21,27
Dinglerdots,tichondrius,1502,warlock,destruction,27,21,6
Jugaa,arthas,1502,warlock,destruction,41,29,12
Sìddy,frostmourne,1501,warlock,destruction,34,20,14
Bosongo,boulderfist,1501,warlock,destruction,65,37,28
Deboltzaru,ragnaros,1501,warlock,destruction,91,45,46
Blklavender,darkspear,1501,warlock,destruction,43,21,22
Mordranan,thrall,1500,warlock,destruction,48,29,19
Greasymario,area-52,1500,warlock,destruction,46,25,21
Kyoarnez,quelthalas,1500,warlock,destruction,62,31,31
Pøwertrîp,sargeras,1500,warlock,destruction,72,32,40
Strawberryz,boulderfist,1499,warlock,destruction,32,19,13
Krokodiil,tichondrius,1498,warlock,destruction,74,46,28
Odiums,area-52,1498,warlock,destruction,77,44,33
Deathage,crushridge,1498,warlock,destruction,90,51,39
Badmagic,area-52,1498,warlock,destruction,87,46,41
Kudoslck,tichondrius,1497,warlock,destruction,42,22,20
Dippidydot,illidan,1497,warlock,destruction,84,39,45
Sñeed,sargeras,1496,warlock,destruction,61,35,26
Destruição,zuljin,1496,warlock,destruction,35,20,15
Firewõrks,moon-guard,1496,warlock,destruction,30,17,13
Brettmackson,area-52,1496,warlock,destruction,105,54,51
Daremyth,azralon,1494,warlock,destruction,36,24,12
Mongdot,frostmourne,1494,warlock,destruction,51,30,21
Dotsfired,crushridge,1493,warlock,destruction,105,61,44
Døtbomb,stormrage,1493,warlock,destruction,35,16,19
Memnøch,emerald-dream,1492,warlock,destruction,41,24,17
Arthyr,twisting-nether,1492,warlock,destruction,53,24,29
Deebeel,sargeras,1492,warlock,destruction,36,16,20
Cozu,tichondrius,1489,warlock,destruction,41,27,14
Goomgoom,doomhammer,1489,warlock,destruction,114,50,64
Titusvorenus,runetotem,1488,warlock,destruction,50,30,20
Terrival,illidan,1487,warlock,destruction,41,22,19
Ovosound,tichondrius,1486,warlock,destruction,23,16,7
Dotte,tichondrius,1486,warlock,destruction,59,31,28
Asmodheus,ragnaros,1486,warlock,destruction,36,18,18
Morcegø,azralon,1486,warlock,destruction,75,37,38
Gentleq,tichondrius,1486,warlock,destruction,33,16,17
Vigius,dalaran,1486,warlock,destruction,53,24,29
Nytefels,skullcrusher,1485,warlock,destruction,30,20,10
Daddybolt,stormrage,1485,warlock,destruction,30,17,13
Chéztér,proudmoore,1485,warlock,destruction,136,70,66
Hornetbee,tichondrius,1483,warlock,destruction,24,16,8
Kalellock,azralon,1483,warlock,destruction,120,63,57
Dynamó,tichondrius,1483,warlock,destruction,74,37,37
Crypticwl,proudmoore,1483,warlock,destruction,66,32,34
Ellneggro,zuljin,1482,warlock,destruction,36,25,11
Fshi,frostmourne,1482,warlock,destruction,102,58,44
Cutewarlock,draktharon,1481,warlock,destruction,50,30,20
Gingery,the-underbog,1481,warlock,destruction,155,76,79
Fatals,thrall,1480,warlock,destruction,36,17,19
Beyourselff,tichondrius,1479,warlock,destruction,35,16,19
Yahihlock,silver-hand,1478,warlock,destruction,36,23,13
Dloq,azgalor,1478,warlock,destruction,117,70,47
Musgrin,gallywix,1478,warlock,destruction,66,35,31
Millyvanilly,tichondrius,1478,warlock,destruction,71,36,35
Flor,khadgar,1478,warlock,destruction,261,131,130
Drcameron,zuljin,1477,warlock,destruction,36,24,12
Nazzlock,bleeding-hollow,1477,warlock,destruction,35,19,16
Chàõs,tichondrius,1477,warlock,destruction,54,27,27
Boltybarnes,area-52,1476,warlock,destruction,54,37,17
Avae,frostmourne,1476,warlock,destruction,108,61,47
Daracon,thrall,1476,warlock,destruction,42,22,20
Drdotngo,tichondrius,1476,warlock,destruction,62,24,38
Pyresworn,wyrmrest-accord,1475,warlock,destruction,60,36,24
Nefandous,malganis,1475,warlock,destruction,179,95,84
Ioroselmi,illidan,1475,warlock,destruction,131,64,67
Tofulery,tichondrius,1475,warlock,destruction,50,23,27
Hargol,azralon,1475,warlock,destruction,42,19,23
Doublebolt,illidan,1473,warlock,destruction,123,72,51
Somethingud,tichondrius,1473,warlock,destruction,85,34,51
Priiscilá,drakkari,1472,warlock,destruction,72,35,37
Raizël,ragnaros,1471,warlock,destruction,56,34,22
Privin,sargeras,1471,warlock,destruction,36,18,18
Cilium,illidan,1470,warlock,destruction,42,18,24
Demondots,sargeras,1469,warlock,destruction,54,31,23
Medeia,tichondrius,1469,warlock,destruction,29,16,13
Celash,barthilas,1469,warlock,destruction,60,32,28
Taìnted,lightbringer,1469,warlock,destruction,34,16,18
Laylowl,tichondrius,1468,warlock,destruction,36,22,14
Shadowxlock,misha,1468,warlock,destruction,95,51,44
Slipfallx,tichondrius,1468,warlock,destruction,64,33,31
Magy,deathwing,1467,warlock,destruction,48,30,18
Wawfw,bleeding-hollow,1466,warlock,destruction,33,21,12
Impdad,destromath,1466,warlock,destruction,130,76,54
Nebulox,stormrage,1466,warlock,destruction,48,28,20
Addonic,hyjal,1466,warlock,destruction,48,26,22
Esså,jaedenar,1466,warlock,destruction,47,20,27
Darthðotspam,mugthol,1465,warlock,destruction,108,61,47
Pwz,azralon,1465,warlock,destruction,108,60,48
Noxdolor,stormreaver,1465,warlock,destruction,36,20,16
Soultrain,sargeras,1465,warlock,destruction,32,17,15
Zemphius,illidan,1463,warlock,destruction,55,27,28
Løvesick,zuljin,1463,warlock,destruction,70,33,37
Vindicated,azgalor,1462,warlock,destruction,49,33,16
Eldriptch,kelthuzad,1462,warlock,destruction,65,33,32
Shipmatelock,stormrage,1461,warlock,destruction,54,36,18
Mickylock,tichondrius,1461,warlock,destruction,233,127,106
Jakeyboii,frostmourne,1459,warlock,destruction,51,33,18
Falcorr,area-52,1459,warlock,destruction,34,19,15
Captrollol,tichondrius,1459,warlock,destruction,100,47,53
Filthypumper,proudmoore,1455,warlock,destruction,43,28,15
Bugha,ravencrest,1455,warlock,destruction,36,22,14
Ledrlpxlx,bleeding-hollow,1455,warlock,destruction,77,38,39
Vacuole,uther,1451,warlock,destruction,36,19,17
Muldan,stormrage,1450,warlock,destruction,47,30,17
Ptheven,area-52,1450,warlock,destruction,86,52,34
Monkeylock,dathremar,1449,warlock,destruction,33,22,11
Pvping,illidan,1449,warlock,destruction,48,30,18
Perfectylock,azralon,1447,warlock,destruction,34,17,17
Gatewayoncd,frostmourne,1447,warlock,destruction,102,48,54
Eriess,burning-blade,1447,warlock,destruction,54,24,30
Dasati,frostmourne,1446,warlock,destruction,42,29,13
Pescador,tichondrius,1446,warlock,destruction,43,24,19
Sickmade,zuljin,1445,warlock,destruction,24,16,8
Bustednut,nerzhul,1445,warlock,destruction,98,58,40
Mcjoy,akama,1445,warlock,destruction,254,129,125
Demonicus,thunderlord,1445,warlock,destruction,54,25,29
Maleficmango,tichondrius,1444,warlock,destruction,36,23,13
Meleemetabtw,emerald-dream,1442,warlock,destruction,28,16,12
Bmó,stormrage,1442,warlock,destruction,48,27,21
Trìplock,area-52,1442,warlock,destruction,54,29,25
Atrofourth,tichondrius,1442,warlock,destruction,54,26,28
Xbqss,illidan,1442,warlock,destruction,36,16,20
Newty,zuljin,1441,warlock,destruction,24,19,5
Jaboltz,tichondrius,1441,warlock,destruction,25,16,9
Yorchziel,ragnaros,1441,warlock,destruction,100,54,46
Mantis,proudmoore,1441,warlock,destruction,43,23,20
Nttslock,tichondrius,1441,warlock,destruction,42,22,20
Badufin,azralon,1440,warlock,destruction,30,18,12
Zezkin,alexstrasza,1440,warlock,destruction,39,21,18
Snéed,sargeras,1440,warlock,destruction,41,21,20
Kevin,moon-guard,1440,warlock,destruction,133,67,66
Çèrègäpîrät,illidan,1439,warlock,destruction,18,15,3
Hdys,tichondrius,1439,warlock,destruction,24,15,9
Printwo,sargeras,1439,warlock,destruction,24,15,9
Discordant,trollbane,1439,warlock,destruction,48,29,19
Twototheone,illidan,1439,warlock,destruction,131,67,64
Manã,wyrmrest-accord,1439,warlock,destruction,36,18,18
Beastsuper,tichondrius,1439,warlock,destruction,30,15,15
Spectro,laughing-skull,1438,warlock,destruction,18,15,3
Selwitch,dalaran,1438,warlock,destruction,18,15,3
Sâlâñzø,bleeding-hollow,1438,warlock,destruction,18,15,3
Dvorakk,frostmourne,1438,warlock,destruction,38,23,15
Mykiel,sargeras,1438,warlock,destruction,42,21,21
Köënïgsëgg,blackwater-raiders,1437,warlock,destruction,18,15,3
Lostlock,sargeras,1437,warlock,destruction,18,15,3
Deathmásk,ragnaros,1437,warlock,destruction,18,15,3
Goofycupcake,drakthul,1437,warlock,destruction,18,15,3
Wildimp,aerie-peak,1437,warlock,destruction,24,15,9
Phreekish,bleeding-hollow,1437,warlock,destruction,24,15,9
Amoranlenus,sargeras,1437,warlock,destruction,36,21,15
Imbooms,blackrock,1437,warlock,destruction,30,15,15
Rzlrot,tichondrius,1436,warlock,destruction,30,18,12
Destruction,frostmourne,1436,warlock,destruction,51,29,22
Jämeson,tichondrius,1436,warlock,destruction,30,15,15
Artzul,tichondrius,1436,warlock,destruction,60,25,35
Zerfall,area-52,1435,warlock,destruction,24,15,9
Sonnagalook,sargeras,1435,warlock,destruction,48,27,21
Mikaelbolton,tichondrius,1435,warlock,destruction,52,24,28
Stizzy,eredar,1434,warlock,destruction,24,15,9
Lotusx,tichondrius,1434,warlock,destruction,60,35,25
Plagueîs,area-52,1434,warlock,destruction,33,18,15
Év,azralon,1434,warlock,destruction,53,27,26
Munar,quelthalas,1434,warlock,destruction,111,56,55
Kuoma,boulderfist,1434,warlock,destruction,121,57,64
Staudt,mugthol,1433,warlock,destruction,30,22,8
Loçky,area-52,1433,warlock,destruction,24,15,9
Felacid,tichondrius,1433,warlock,destruction,48,28,20
Picklepuller,arthas,1433,warlock,destruction,60,34,26
Mldxd,undermine,1432,warlock,destruction,34,17,17
Swaelee,area-52,1432,warlock,destruction,107,51,56
Dance,sargeras,1431,warlock,destruction,18,15,3
Jokerzz,tichondrius,1431,warlock,destruction,24,16,8
Xêlsnåp,steamwheedle-cartel,1431,warlock,destruction,110,60,50
Masefield,moon-guard,1431,warlock,destruction,68,33,35
Spaceghóst,bleeding-hollow,1430,warlock,destruction,291,142,149
Dotsyu,frostmourne,1429,warlock,destruction,50,28,22
Conorloco,tichondrius,1429,warlock,destruction,36,15,21
Naome,cenarius,1428,warlock,destruction,36,16,20
Paindge,senjin,1427,warlock,destruction,24,15,9
Foxfoxfel,thrall,1426,warlock,destruction,36,24,12
Cúrsified,sargeras,1426,warlock,destruction,34,17,17
Ironsightsl,dalaran,1426,warlock,destruction,48,21,27
Aomniloltv,zuljin,1425,warlock,destruction,112,60,52
Dedremus,korialstrasz,1425,warlock,destruction,30,15,15
Shadowfork,illidan,1424,warlock,destruction,24,15,9
Dercair,korgath,1424,warlock,destruction,48,25,23
Saddestboi,proudmoore,1423,warlock,destruction,66,40,26
Gvvo,tichondrius,1423,warlock,destruction,30,15,15
Çrayoneater,tichondrius,1423,warlock,destruction,52,22,30
Soiedentaire,illidan,1422,warlock,destruction,36,30,6
Steav,quelthalas,1422,warlock,destruction,34,19,15
Jhivtwo,tichondrius,1422,warlock,destruction,36,18,18
Enmama,malganis,1422,warlock,destruction,30,15,15
Srcorvo,azralon,1422,warlock,destruction,53,24,29
Rickyspanish,malygos,1422,warlock,destruction,47,21,26
Yarrz,kelthuzad,1421,warlock,destruction,42,28,14
Hellcon,area-52,1421,warlock,destruction,100,58,42
Nergoul,stormrage,1421,warlock,destruction,30,16,14
Yuh,moon-guard,1420,warlock,destruction,18,15,3
Toonbolt,sargeras,1420,warlock,destruction,48,28,20
Fearloom,tichondrius,1420,warlock,destruction,151,78,73
Decrepticus,kargath,1419,warlock,destruction,44,26,18
Vandammed,silvermoon,1419,warlock,destruction,30,15,15
Gretlock,emerald-dream,1418,warlock,destruction,24,16,8
Razdarin,proudmoore,1418,warlock,destruction,30,19,11
Wdc,illidan,1418,warlock,destruction,114,55,59
Tsalagi,sargeras,1417,warlock,destruction,54,30,24
Nmelock,malganis,1417,warlock,destruction,36,17,19
Xlilgee,kelthuzad,1416,warlock,destruction,24,15,9
Desconjuro,nemesis,1416,warlock,destruction,50,29,21
Apøçàlÿpsè,firetree,1416,warlock,destruction,75,37,38
Deatthmoon,stormrage,1415,warlock,destruction,24,15,9
Evillyñ,tichondrius,1415,warlock,destruction,72,38,34
Locker,lightnings-blade,1414,warlock,destruction,30,18,12
Lockssy,tichondrius,1414,warlock,destruction,147,82,65
Exofilth,thrall,1414,warlock,destruction,58,25,33
Budgetkroozz,illidan,1413,warlock,destruction,30,15,15
Bilidin,azralon,1413,warlock,destruction,93,41,52
Overlock,ragnaros,1412,warlock,destruction,74,43,31
Darksdot,barthilas,1412,warlock,destruction,35,17,18
Spite,thrall,1411,warlock,destruction,24,18,6
Exupery,emerald-dream,1411,warlock,destruction,123,64,59
Thicclöcc,tichondrius,1410,warlock,destruction,30,15,15
Caplock,barthilas,1410,warlock,destruction,67,31,36
Balfast,quelthalas,1410,warlock,destruction,117,54,63
Parmenides,tichondrius,1410,warlock,destruction,42,19,23
Graced,dalaran,1409,warlock,destruction,48,24,24
Becà,stormrage,1408,warlock,destruction,30,19,11
Geauxst,tichondrius,1408,warlock,destruction,24,15,9
Nazgal,tichondrius,1408,warlock,destruction,35,21,14
Ezdagor,quelthalas,1408,warlock,destruction,161,86,75
Tergale,illidan,1408,warlock,destruction,111,52,59
Dialalock,frostmourne,1407,warlock,destruction,63,33,30
Altazor,thunderlord,1407,warlock,destruction,36,16,20
Bobbygoulant,tichondrius,1406,warlock,destruction,265,130,135
Blackguldan,illidan,1405,warlock,destruction,24,15,9
Meatybolts,nagrand,1405,warlock,destruction,84,46,38
Digylock,kelthuzad,1405,warlock,destruction,47,16,31
Lightname,arthas,1404,warlock,destruction,24,17,7
Kyle,shandris,1404,warlock,destruction,69,38,31
Daliron,moon-guard,1404,warlock,destruction,30,15,15
Valvravé,malganis,1404,warlock,destruction,71,33,38
Bellanomikus,stormrage,1404,warlock,destruction,60,25,35
Sepültüra,quelthalas,1402,warlock,destruction,121,59,62
Adderall,altar-of-storms,1402,warlock,destruction,42,20,22
Bauchalain,area-52,1402,warlock,destruction,44,19,25
Batär,area-52,1401,warlock,destruction,42,30,12
Rickthelock,tichondrius,1401,warlock,destruction,30,18,12
Awfeelya,sargeras,1401,warlock,destruction,59,35,24
Killafornia,runetotem,1401,warlock,destruction,48,28,20
Chuwhee,sargeras,1401,warlock,destruction,54,18,36
Antistar,barthilas,1400,warlock,destruction,43,27,16
Lockerdoo,aegwynn,1400,warlock,destruction,102,52,50
Perples,dalaran,1399,warlock,destruction,60,30,30
Shadow,frostwolf,1399,warlock,destruction,44,17,27
Azöd,tichondrius,1398,warlock,destruction,117,69,48
Jaydow,illidan,1398,warlock,destruction,29,15,14
Drudotzz,hyjal,1398,warlock,destruction,36,18,18
Kurudios,ragnaros,1397,warlock,destruction,30,18,12
Georky,ragnaros,1397,warlock,destruction,67,32,35
Straightlock,sargeras,1397,warlock,destruction,65,27,38
Jackscar,windrunner,1396,warlock,destruction,53,33,20
Theporkchunk,nordrassil,1395,warlock,destruction,106,66,40
Iongestpp,bleeding-hollow,1395,warlock,destruction,42,22,20
Hamadan,azralon,1394,warlock,destruction,67,38,29
Crashcrash,area-52,1394,warlock,destruction,30,15,15
Shadococo,tichondrius,1393,warlock,destruction,36,16,20
Mariscoveloz,stormrage,1392,warlock,destruction,108,58,50
Kecca,azralon,1392,warlock,destruction,220,113,107
Adhauto,illidan,1390,warlock,destruction,113,62,51
Esteedees,moon-guard,1389,warlock,destruction,48,20,28
Chamansy,darkspear,1388,warlock,destruction,72,39,33
Wadoom,tichondrius,1388,warlock,destruction,62,33,29
Gnomerky,stormrage,1388,warlock,destruction,42,19,23
Fiftydkps,azralon,1387,warlock,destruction,93,53,40
Garbagefarts,aegwynn,1387,warlock,destruction,100,48,52
Dotsnrots,frostmourne,1386,warlock,destruction,70,32,38
Blayzen,elune,1386,warlock,destruction,35,16,19
Rangmar,ragnaros,1385,warlock,destruction,39,18,21
Gorelami,tichondrius,1384,warlock,destruction,42,23,19
Iceameri,tichondrius,1384,warlock,destruction,68,36,32
Notchinese,kiljaeden,1383,warlock,destruction,76,37,39
Spreadnhiv,thrall,1383,warlock,destruction,66,31,35
Deseo,moon-guard,1382,warlock,destruction,100,60,40
Gauul,illidan,1382,warlock,destruction,70,39,31
Javaspooky,nemesis,1382,warlock,destruction,85,38,47
Mèrlin,aerie-peak,1381,warlock,destruction,48,29,19
Stunresistin,tichondrius,1381,warlock,destruction,156,79,77
Neodron,thrall,1380,warlock,destruction,69,45,24
Kyrionn,azralon,1380,warlock,destruction,34,18,16
Sugmabone,zuluhed,1379,warlock,destruction,54,33,21
Necrotic,antonidas,1379,warlock,destruction,66,33,33
Davnport,frostmourne,1379,warlock,destruction,80,37,43
Warlo,moonrunner,1378,warlock,destruction,30,20,10
Jhop,sargeras,1378,warlock,destruction,100,55,45
Coreleron,proudmoore,1378,warlock,destruction,61,29,32
Siccwidit,area-52,1378,warlock,destruction,74,34,40
Aksness,stormrage,1377,warlock,destruction,48,21,27
Jeramie,darkspear,1376,warlock,destruction,44,21,23
Blankdots,sargeras,1375,warlock,destruction,42,27,15
Sunkuna,aerie-peak,1375,warlock,destruction,176,89,87
Lockonthc,korgath,1375,warlock,destruction,32,16,16
Wasrenai,tichondrius,1375,warlock,destruction,47,21,26
Dealcloud,tichondrius,1374,warlock,destruction,83,44,39
Hobblefoòt,proudmoore,1374,warlock,destruction,46,23,23
Demontos,darkspear,1374,warlock,destruction,66,31,35
Zinkro,quelthalas,1374,warlock,destruction,77,32,45
Naparima,stormreaver,1373,warlock,destruction,59,32,27
Vorelock,wyrmrest-accord,1373,warlock,destruction,36,19,17
Lynnilock,area-52,1371,warlock,destruction,26,16,10
Connect,borean-tundra,1371,warlock,destruction,35,18,17
Adramelech,thrall,1371,warlock,destruction,30,15,15
Delarae,frostmourne,1371,warlock,destruction,35,17,18
Dessoft,ragnaros,1371,warlock,destruction,36,17,19
Humanreapers,malganis,1369,warlock,destruction,49,27,22
Avatar,uldum,1369,warlock,destruction,41,18,23
Ravikk,dalaran,1369,warlock,destruction,48,21,27
Methandmmkay,illidan,1368,warlock,destruction,33,21,12
Valerilma,azralon,1368,warlock,destruction,52,28,24
Ppoonlock,tichondrius,1367,warlock,destruction,35,15,20
Himselfflol,tichondrius,1366,warlock,destruction,34,17,17
Critneyfearz,stormscale,1366,warlock,destruction,65,31,34
Dipindottz,tichondrius,1365,warlock,destruction,48,32,16
Kanekiskid,mannoroth,1365,warlock,destruction,48,30,18
Ebølarot,tichondrius,1365,warlock,destruction,24,15,9
Ilvvll,proudmoore,1365,warlock,destruction,65,30,35
Blindingsun,kiljaeden,1365,warlock,destruction,72,27,45
Gilgameshs,stormrage,1364,warlock,destruction,41,20,21
Glenfarclas,tichondrius,1364,warlock,destruction,91,39,52
Luxenna,malganis,1363,warlock,destruction,84,40,44
Sauronne,illidan,1363,warlock,destruction,84,38,46
Bagn,tichondrius,1362,warlock,destruction,20,16,4
Eurygnomous,thrall,1362,warlock,destruction,36,18,18
Gridwild,drakkari,1362,warlock,destruction,30,15,15
Wackykid,azralon,1360,warlock,destruction,86,39,47
Cynwise,arathor,1359,warlock,destruction,42,24,18
Buildsuccess,tichondrius,1359,warlock,destruction,41,16,25
Lafuke,tichondrius,1358,warlock,destruction,25,15,10
Fireballingx,illidan,1358,warlock,destruction,26,15,11
Locksyy,tichondrius,1357,warlock,destruction,59,24,35
Kelifan,sargeras,1356,warlock,destruction,96,52,44
Patagucci,bleeding-hollow,1354,warlock,destruction,64,33,31
Sylestrio,feathermoon,1354,warlock,destruction,60,30,30
Katsby,moon-guard,1354,warlock,destruction,46,23,23
Microd,tichondrius,1353,warlock,destruction,30,15,15
Laklin,stormscale,1353,warlock,destruction,122,58,64
Finnickk,blackrock,1353,warlock,destruction,36,16,20
Skazza,bleeding-hollow,1352,warlock,destruction,29,16,13
Gingerlocky,barthilas,1352,warlock,destruction,110,53,57
Sumonníng,tichondrius,1351,warlock,destruction,48,27,21
Ørfna,zuljin,1351,warlock,destruction,66,33,33
Zénth,kiljaeden,1349,warlock,destruction,58,31,27
Nøvah,tichondrius,1348,warlock,destruction,25,15,10
Shelocks,sargeras,1348,warlock,destruction,48,22,26
Lagcursed,frostmourne,1347,warlock,destruction,30,20,10
Morganith,ravenholdt,1347,warlock,destruction,54,20,34
Memon,frostmane,1346,warlock,destruction,108,55,53
Pruevolf,tichondrius,1346,warlock,destruction,116,57,59
Jannus,wyrmrest-accord,1346,warlock,destruction,62,30,32
Razizzles,malganis,1345,warlock,destruction,72,42,30
Stallrooks,moon-guard,1345,warlock,destruction,29,16,13
Retwarr,tichondrius,1344,warlock,destruction,18,14,4
Shortstacki,tichondrius,1344,warlock,destruction,24,17,7
Thinkchair,sargeras,1344,warlock,destruction,24,14,10
Soulruler,tichondrius,1344,warlock,destruction,24,14,10
Cælohin,tichondrius,1344,warlock,destruction,42,21,21
Blockk,moknathal,1344,warlock,destruction,166,78,88
Súpersonic,tichondrius,1343,warlock,destruction,24,14,10
Sktfäker,sargeras,1343,warlock,destruction,24,14,10
Austen,tichondrius,1343,warlock,destruction,55,24,31
Celestiah,aggramar,1341,warlock,destruction,134,73,61
Miniime,azgalor,1341,warlock,destruction,50,23,27
Spenwarlocka,illidan,1340,warlock,destruction,24,14,10
Kortinanga,tichondrius,1340,warlock,destruction,90,51,39
Buttkins,tichondrius,1340,warlock,destruction,48,25,23
Justganmore,tichondrius,1339,warlock,destruction,30,14,16
Haxlock,azralon,1339,warlock,destruction,64,26,38
Aemma,proudmoore,1338,warlock,destruction,18,14,4
Extinção,azralon,1338,warlock,destruction,64,39,25
Pantypeeler,barthilas,1338,warlock,destruction,60,35,25
Sofan,dalaran,1338,warlock,destruction,24,14,10
Chaoticman,tichondrius,1338,warlock,destruction,87,50,37
Punishment,jubeithos,1337,warlock,destruction,23,15,8
Sketchytat,stormrage,1337,warlock,destruction,24,14,10
Devastation,senjin,1336,warlock,destruction,21,15,6
Scãryz,jubeithos,1336,warlock,destruction,62,35,27
Downbad,ysera,1336,warlock,destruction,43,20,23
Dkdakìng,dalaran,1335,warlock,destruction,18,14,4
Pabloescobr,tichondrius,1335,warlock,destruction,24,14,10
Nueleth,frostmourne,1335,warlock,destruction,75,35,40
Warpstar,area-52,1335,warlock,destruction,35,16,19
Condevil,quelthalas,1334,warlock,destruction,119,64,55
Lòthloria,mannoroth,1334,warlock,destruction,149,74,75
Liability,zuljin,1334,warlock,destruction,30,14,16
Majinbuû,malganis,1334,warlock,destruction,30,14,16
Atrabiliario,quelthalas,1334,warlock,destruction,42,17,25
Fazzlock,nagrand,1333,warlock,destruction,52,28,24
Aroris,silver-hand,1333,warlock,destruction,30,15,15
Prototyp,azralon,1332,warlock,destruction,24,17,7
Fearedit,bleeding-hollow,1332,warlock,destruction,24,14,10
Mailerdaemön,proudmoore,1332,warlock,destruction,30,14,16
Brenda,bleeding-hollow,1331,warlock,destruction,48,29,19
Yibbel,area-52,1331,warlock,destruction,24,14,10
Spongebobjrj,tichondrius,1331,warlock,destruction,36,20,16
Ahp,stormrage,1331,warlock,destruction,27,15,12
Avadakedavra,warsong,1330,warlock,destruction,30,18,12
Lefteexd,tichondrius,1330,warlock,destruction,24,14,10
Grandpapapa,tichondrius,1330,warlock,destruction,60,25,35
Hávìk,malganis,1329,warlock,destruction,30,14,16
Thotsanddots,area-52,1328,warlock,destruction,24,16,8
Freestyle,blackwater-raiders,1328,warlock,destruction,60,37,23
Sixonenine,boulderfist,1328,warlock,destruction,30,14,16
Oony,quelthalas,1328,warlock,destruction,66,27,39
Celeden,emerald-dream,1327,warlock,destruction,30,18,12
Harleyjames,ravenholdt,1327,warlock,destruction,30,16,14
Monson,warsong,1327,warlock,destruction,30,14,16
Cursedoll,ragnaros,1327,warlock,destruction,36,15,21
Salties,magtheridon,1326,warlock,destruction,24,14,10
Plagueis,zuluhed,1326,warlock,destruction,31,15,16
Nezsarek,sargeras,1324,warlock,destruction,223,99,124
Draxxus,barthilas,1323,warlock,destruction,36,15,21
Lockednloade,tichondrius,1322,warlock,destruction,63,36,27
Zephee,queldorei,1322,warlock,destruction,60,34,26
Wizdom,turalyon,1322,warlock,destruction,33,17,16
Jill,thunderhorn,1322,warlock,destruction,36,17,19
Rytaint,emerald-dream,1321,warlock,destruction,24,14,10
Gòtti,frostmourne,1320,warlock,destruction,24,14,10
Jugerdotz,sargeras,1320,warlock,destruction,30,14,16
Sweetmeat,madoran,1319,warlock,destruction,37,14,23
Provilock,moon-guard,1318,warlock,destruction,31,17,14
Dragonlordy,proudmoore,1317,warlock,destruction,24,14,10
Munick,spirestone,1317,warlock,destruction,30,15,15
Zyhq,stormrage,1317,warlock,destruction,48,18,30
Castngcouch,tichondrius,1316,warlock,destruction,69,35,34
Dogetrash,tichondrius,1315,warlock,destruction,56,35,21
Scrumlock,fenris,1314,warlock,destruction,29,17,12
Undies,demon-soul,1314,warlock,destruction,72,39,33
Lessthanjake,zuljin,1314,warlock,destruction,30,14,16
Semyaza,zuluhed,1313,warlock,destruction,41,25,16
Abracadavers,ragnaros,1313,warlock,destruction,45,23,22
Ganknãmstyle,illidan,1313,warlock,destruction,89,42,47
Veditä,goldrinn,1312,warlock,destruction,24,15,9
Felpsychosis,illidan,1312,warlock,destruction,140,73,67
Jecklez,tichondrius,1312,warlock,destruction,135,70,65
Shedara,ragnaros,1311,warlock,destruction,23,14,9
Kabroom,boulderfist,1311,warlock,destruction,24,14,10
Covírus,azralon,1310,warlock,destruction,29,18,11
Epicgaymer,zuljin,1310,warlock,destruction,32,15,17
Melodyh,laughing-skull,1310,warlock,destruction,42,16,26
Unstablê,ragnaros,1309,warlock,destruction,37,19,18
Striga,staghelm,1309,warlock,destruction,65,28,37
Pipeo,quelthalas,1308,warlock,destruction,53,31,22
Dotyoazz,tichondrius,1308,warlock,destruction,38,22,16
Lladyyheartt,nesingwary,1308,warlock,destruction,72,36,36
Sayatar,ragnaros,1308,warlock,destruction,30,14,16
Muchoprecogo,tichondrius,1306,warlock,destruction,24,14,10
Sû,stormrage,1306,warlock,destruction,72,31,41
Karadelice,stormrage,1305,warlock,destruction,66,33,33
Zaeloc,ragnaros,1304,warlock,destruction,50,18,32
Gscar,area-52,1303,warlock,destruction,48,28,20
Felqueenn,windrunner,1303,warlock,destruction,66,37,29
Krýstál,ragnaros,1303,warlock,destruction,73,40,33
Llu,tichondrius,1302,warlock,destruction,59,35,24
Soulwipe,dethecus,1301,warlock,destruction,30,14,16
Voidchaos,korgath,1300,warlock,destruction,18,14,4
Valthorion,dathremar,1299,warlock,destruction,34,17,17
Getpissed,emerald-dream,1299,warlock,destruction,74,34,40
Tsmcfker,tichondrius,1298,warlock,destruction,24,14,10
Matdamon,barthilas,1298,warlock,destruction,66,34,32
Nylíx,stormrage,1297,warlock,destruction,30,15,15
Shadowy,dragonblight,1296,warlock,destruction,36,17,19
Juwi,frostmourne,1295,warlock,destruction,48,24,24
Cyrus,akama,1294,warlock,destruction,30,20,10
Shivalx,tichondrius,1292,warlock,destruction,30,15,15
Rauwërrs,azralon,1292,warlock,destruction,55,26,29
Kombat,amanthul,1292,warlock,destruction,71,32,39
Bigdoinks,nagrand,1290,warlock,destruction,34,19,15
Consumed,area-52,1289,warlock,destruction,33,19,14
Boltsfordays,dalaran,1289,warlock,destruction,104,55,49
Cvntpvntcans,kelthuzad,1289,warlock,destruction,36,16,20
Lolimalock,bleeding-hollow,1286,warlock,destruction,35,19,16
Sevokk,stormrage,1285,warlock,destruction,36,17,19
Darkboltz,area-52,1283,warlock,destruction,45,26,19
Vexedconvex,area-52,1283,warlock,destruction,420,203,217
Insanemids,tichondrius,1283,warlock,destruction,32,15,17
Malchiev,area-52,1282,warlock,destruction,36,17,19
Omegawarlock,quelthalas,1281,warlock,destruction,32,19,13
Zuldar,tichondrius,1281,warlock,destruction,36,21,15
Covenslave,nemesis,1281,warlock,destruction,341,168,173
Zoluraan,proudmoore,1280,warlock,destruction,51,33,18
Sumondeznuts,wyrmrest-accord,1279,warlock,destruction,39,15,24
Imprecátion,tichondrius,1279,warlock,destruction,65,24,41
Darthzugzug,gorefiend,1277,warlock,destruction,54,32,22
Heathncraig,illidan,1277,warlock,destruction,241,116,125
Ozgwad,thunderhorn,1277,warlock,destruction,42,19,23
Ahrimus,area-52,1275,warlock,destruction,28,14,14
Gukky,misha,1274,warlock,destruction,143,80,63
Thizzmaa,area-52,1273,warlock,destruction,125,63,62
Grendaldots,tichondrius,1273,warlock,destruction,28,14,14
Potatostew,dalaran,1273,warlock,destruction,36,14,22
Telvanni,sargeras,1270,warlock,destruction,43,24,19
Mocreia,azralon,1270,warlock,destruction,182,90,92
Derfflinger,tichondrius,1270,warlock,destruction,118,49,69
Felryssa,kiljaeden,1269,warlock,destruction,60,29,31
Tartamuda,ragnaros,1269,warlock,destruction,42,16,26
Tiqs,stormrage,1268,warlock,destruction,23,14,9
Gyxx,exodar,1267,warlock,destruction,27,14,13
Diabhlaí,tichondrius,1266,warlock,destruction,108,57,51
Necrodeath,malygos,1265,warlock,destruction,48,26,22
Griget,runetotem,1265,warlock,destruction,59,28,31
Lockmycawk,stormrage,1264,warlock,destruction,29,14,15
Klapincheeks,malganis,1262,warlock,destruction,87,31,56
Zehr,malganis,1261,warlock,destruction,58,32,26
Moredots,zuljin,1261,warlock,destruction,42,15,27
Stinkychef,hyjal,1259,warlock,destruction,30,19,11
Gattsonn,kiljaeden,1259,warlock,destruction,42,15,27
Pikkon,malorne,1258,warlock,destruction,30,15,15
Dotdoctor,thrall,1257,warlock,destruction,69,34,35
Soulfurr,dathremar,1257,warlock,destruction,42,19,23
Umdur,zuljin,1257,warlock,destruction,87,37,50
Regent,nemesis,1256,warlock,destruction,110,52,58
Esmaldo,tichondrius,1255,warlock,destruction,37,19,18
Mordekhay,tichondrius,1255,warlock,destruction,80,39,41
Felancholy,illidan,1254,warlock,destruction,32,22,10
Ticktóck,ghostlands,1253,warlock,destruction,19,14,5
Ogawalation,stormrage,1253,warlock,destruction,24,14,10
Siliconsnipe,tichondrius,1252,warlock,destruction,24,17,7
Mordror,azralon,1251,warlock,destruction,68,36,32
Drwolfman,bonechewer,1249,warlock,destruction,84,41,43
Xtwistedteas,tichondrius,1249,warlock,destruction,31,14,17
Dottzie,malganis,1247,warlock,destruction,18,13,5
Voqo,shandris,1247,warlock,destruction,18,13,5
Pressurë,tichondrius,1247,warlock,destruction,18,13,5
Whaad,tichondrius,1247,warlock,destruction,18,13,5
Drainerx,kelthuzad,1247,warlock,destruction,18,13,5
Kimsoul,zuljin,1247,warlock,destruction,24,13,11
Moonsoaps,moon-guard,1247,warlock,destruction,24,13,11
Jandorace,anetheron,1247,warlock,destruction,24,13,11
Oymmander,illidan,1247,warlock,destruction,24,13,11
Thragèqt,sargeras,1247,warlock,destruction,24,13,11
Suwook,tichondrius,1246,warlock,destruction,18,13,5
Djdemolordx,bleeding-hollow,1246,warlock,destruction,18,13,5
Alyarn,greymane,1246,warlock,destruction,36,20,16
Inaane,thrall,1246,warlock,destruction,24,13,11
Skanckqt,malganis,1246,warlock,destruction,24,13,11
Lockedinn,mannoroth,1246,warlock,destruction,30,13,17
Stainn,gallywix,1245,warlock,destruction,27,17,10
Toastwl,tichondrius,1244,warlock,destruction,18,13,5
Riptyler,illidan,1244,warlock,destruction,24,13,11
Dreadxbolts,stormrage,1244,warlock,destruction,24,13,11
Kemchaos,illidan,1244,warlock,destruction,94,46,48
Vuittøn,barthilas,1243,warlock,destruction,18,13,5
Luciffer,windrunner,1242,warlock,destruction,22,16,6
Nigsy,nagrand,1242,warlock,destruction,24,13,11
Spòngwò,tichondrius,1242,warlock,destruction,24,13,11
Shokran,frostmourne,1242,warlock,destruction,24,13,11
Tirzah,frostmourne,1241,warlock,destruction,18,13,5
Cyio,zuljin,1241,warlock,destruction,24,13,11
Zelophobiaz,crushridge,1241,warlock,destruction,24,13,11
Badmir,area-52,1241,warlock,destruction,24,13,11
Smokiilock,proudmoore,1241,warlock,destruction,24,13,11
Shadü,tichondrius,1241,warlock,destruction,36,14,22
Kboydots,sargeras,1240,warlock,destruction,18,13,5
Jnzi,area-52,1239,warlock,destruction,18,13,5
Bowltz,chogall,1239,warlock,destruction,24,13,11
Adøràßøltz,tichondrius,1239,warlock,destruction,24,13,11
Peeberson,tichondrius,1239,warlock,destruction,24,13,11
Teahourse,tichondrius,1239,warlock,destruction,31,14,17
Granlordmilu,azralon,1238,warlock,destruction,24,14,10
Fearndot,draenor,1236,warlock,destruction,63,29,34
Gwarlocassh,quelthalas,1236,warlock,destruction,51,20,31
Pandemik,turalyon,1234,warlock,destruction,23,15,8
Azrezzael,area-52,1233,warlock,destruction,24,13,11
Blastyboat,terenas,1233,warlock,destruction,39,15,24
Dalruk,wyrmrest-accord,1232,warlock,destruction,18,13,5
Klatuu,stonemaul,1232,warlock,destruction,24,15,9
Keraj,quelthalas,1232,warlock,destruction,30,14,16
Sylvine,korgath,1232,warlock,destruction,30,13,17
Kärên,proudmoore,1231,warlock,destruction,31,23,8
Luulloo,proudmoore,1231,warlock,destruction,66,36,30
Jelluz,ghostlands,1230,warlock,destruction,33,16,17
Chermonalbur,draka,1229,warlock,destruction,24,15,9
Mcscrotie,tichondrius,1229,warlock,destruction,28,14,14
Dmox,darkspear,1229,warlock,destruction,30,13,17
Radamantîs,ragnaros,1229,warlock,destruction,36,13,23
Verybaked,sargeras,1228,warlock,destruction,39,25,14
Bénn,moon-guard,1228,warlock,destruction,77,49,28
Jjesie,tichondrius,1228,warlock,destruction,30,13,17
Impieties,emerald-dream,1228,warlock,destruction,36,14,22
Faldoras,kalecgos,1227,warlock,destruction,18,13,5
Shaggster,stormrage,1226,warlock,destruction,72,39,33
Xdyourd,tichondrius,1225,warlock,destruction,18,13,5
Imbadatpvp,tichondrius,1225,warlock,destruction,30,13,17
Sathorastus,spirestone,1225,warlock,destruction,30,13,17
Dirtybóy,tichondrius,1224,warlock,destruction,24,13,11
Candykrush,tichondrius,1224,warlock,destruction,26,13,13
Raebolts,area-52,1222,warlock,destruction,24,13,11
Bohnd,elune,1222,warlock,destruction,27,14,13
Pocserlock,drakkari,1221,warlock,destruction,21,13,8
Vikkter,tichondrius,1221,warlock,destruction,30,14,16
Nhen,daggerspine,1220,warlock,destruction,155,85,70
Rustý,illidan,1220,warlock,destruction,77,42,35
Thotorina,tichondrius,1220,warlock,destruction,34,16,18
Florryn,barthilas,1220,warlock,destruction,30,14,16
Enaria,queldorei,1218,warlock,destruction,24,13,11
Kuhui,lightbringer,1218,warlock,destruction,39,14,25
Hurriicane,stormrage,1217,warlock,destruction,104,52,52
Ktlock,frostmourne,1217,warlock,destruction,42,20,22
Gambel,duskwood,1217,warlock,destruction,36,16,20
Cursedtool,quelthalas,1216,warlock,destruction,21,14,7
Schmok,terenas,1216,warlock,destruction,64,33,31
Totti,tol-barad,1214,warlock,destruction,30,17,13
Erevas,area-52,1213,warlock,destruction,24,14,10
Tatemor,barthilas,1213,warlock,destruction,36,13,23
Xicó,tichondrius,1212,warlock,destruction,82,39,43
Soulsurvivor,tichondrius,1212,warlock,destruction,36,13,23
Lazarùs,zuljin,1211,warlock,destruction,18,13,5
Prinzheinric,quelthalas,1209,warlock,destruction,39,22,17
Felinå,hyjal,1206,warlock,destruction,39,24,15
Superbroly,area-52,1204,warlock,destruction,30,16,14
Ehcsrop,doomhammer,1204,warlock,destruction,104,49,55
Gouldon,sargeras,1202,warlock,destruction,40,20,20
Dotess,illidan,1202,warlock,destruction,35,16,19
Blew,bleeding-hollow,1200,warlock,destruction,15,14,1
Mysophobia,frostmourne,1200,warlock,destruction,131,67,64
Cascades,icecrown,1199,warlock,destruction,150,71,79
Burnedout,proudmoore,1196,warlock,destruction,26,17,9
Sitra,ragnaros,1196,warlock,destruction,24,15,9
Dokue,kaelthas,1195,warlock,destruction,15,14,1
Westy,drenden,1195,warlock,destruction,30,20,10
Rentblod,azralon,1195,warlock,destruction,23,13,10
Zydaria,stormrage,1195,warlock,destruction,36,20,16
Sutra,tichondrius,1194,warlock,destruction,43,24,19
Daeykras,crushridge,1193,warlock,destruction,57,31,26
Pancakestack,stormrage,1192,warlock,destruction,125,64,61
Spookyfurry,area-52,1192,warlock,destruction,30,13,17
Aboode,blackrock,1190,warlock,destruction,59,26,33
Cørruption,emerald-dream,1188,warlock,destruction,47,22,25
Arredivh,blackhand,1183,warlock,destruction,17,13,4
Rodimus,hyjal,1183,warlock,destruction,227,121,106
Chodetamer,lethon,1180,warlock,destruction,41,23,18
Maldíta,quelthalas,1180,warlock,destruction,117,52,65
Kidsoul,illidan,1178,warlock,destruction,97,46,51
Nanodingo,tichondrius,1176,warlock,destruction,59,30,29
Alyndraxia,malganis,1175,warlock,destruction,22,15,7
Iiferna,sargeras,1174,warlock,destruction,209,99,110
Notäçultist,nagrand,1173,warlock,destruction,110,57,53
Prinsessdie,proudmoore,1173,warlock,destruction,36,15,21
Kadavara,thrall,1170,warlock,destruction,36,15,21
Phreaky,area-52,1169,warlock,destruction,75,40,35
Ilovedemons,aegwynn,1168,warlock,destruction,42,26,16
Vamperro,thrall,1168,warlock,destruction,22,13,9
Yury,scarlet-crusade,1165,warlock,destruction,30,13,17
Goldieloc,sargeras,1164,warlock,destruction,48,28,20
Juniorsalanu,quelthalas,1164,warlock,destruction,48,27,21
Fearlok,malorne,1164,warlock,destruction,28,13,15
Prägä,drakkari,1163,warlock,destruction,20,13,7
Aerozyn,wyrmrest-accord,1161,warlock,destruction,30,16,14
Clizarisa,moon-guard,1158,warlock,destruction,37,23,14
Scaryðreams,malganis,1155,warlock,destruction,86,34,52
Dudda,sargeras,1152,warlock,destruction,12,12,0
Sphoo,tichondrius,1152,warlock,destruction,18,12,6
Livinpink,zuljin,1152,warlock,destruction,18,12,6
Falsaqt,area-52,1152,warlock,destruction,18,12,6
Osmatz,area-52,1152,warlock,destruction,18,12,6
Blodrain,tichondrius,1152,warlock,destruction,18,12,6
Ztc,dalaran,1152,warlock,destruction,18,12,6
Kazam,quelthalas,1152,warlock,destruction,36,20,16
Noteko,korgath,1152,warlock,destruction,24,13,11
Koei,tichondrius,1152,warlock,destruction,24,12,12
Saraphina,maiev,1152,warlock,destruction,461,225,236
Jishtructo,frostmourne,1151,warlock,destruction,18,12,6
Magik,balnazzar,1151,warlock,destruction,18,12,6
Wargllock,tichondrius,1151,warlock,destruction,18,12,6
Blastamastah,tichondrius,1151,warlock,destruction,18,12,6
Soulfinder,tichondrius,1151,warlock,destruction,18,12,6
Shutupthug,illidan,1151,warlock,destruction,18,12,6
Angrydestro,tichondrius,1151,warlock,destruction,18,12,6
Oceangrownx,emerald-dream,1151,warlock,destruction,24,12,12
Klol,proudmoore,1151,warlock,destruction,24,12,12
Asmit,firetree,1151,warlock,destruction,28,13,15
Zaiocian,tichondrius,1151,warlock,destruction,26,12,14
Pndasrntlegt,burning-blade,1150,warlock,destruction,12,12,0
Rumplefust,thrall,1150,warlock,destruction,18,12,6
Pratticus,stormrage,1150,warlock,destruction,18,12,6
Nynx,stormrage,1150,warlock,destruction,18,12,6
Ñigorshedøn,area-52,1150,warlock,destruction,18,12,6
Biggbolts,tichondrius,1150,warlock,destruction,24,12,12
Sonovabeech,winterhoof,1150,warlock,destruction,24,12,12
Soulripped,area-52,1150,warlock,destruction,24,12,12
Khalynd,azralon,1150,warlock,destruction,47,22,25
Lockedyaup,skullcrusher,1150,warlock,destruction,42,19,23
Greenbolts,area-52,1149,warlock,destruction,24,12,12
Iggyiggy,sargeras,1149,warlock,destruction,24,12,12
Ole,area-52,1149,warlock,destruction,27,13,14
Beldiinlock,khazgoroth,1149,warlock,destruction,75,36,39
Pardoned,stormrage,1149,warlock,destruction,30,12,18
Shredlock,tichondrius,1148,warlock,destruction,18,12,6
Poock,goldrinn,1148,warlock,destruction,18,12,6
Skillful,illidan,1148,warlock,destruction,30,12,18
Omarlil,kelthuzad,1147,warlock,destruction,18,12,6
Toastyybone,hellscream,1147,warlock,destruction,24,12,12
Hawkstalker,thaurissan,1147,warlock,destruction,94,45,49
Goarage,tichondrius,1147,warlock,destruction,28,13,15
Nadirius,shadowmoon,1146,warlock,destruction,18,12,6
Joromojo,zuljin,1146,warlock,destruction,18,12,6
Thânàtös,malganis,1144,warlock,destruction,30,12,18
Carcine,frostwolf,1143,warlock,destruction,24,12,12
Wakøzi,mugthol,1143,warlock,destruction,24,12,12
Yëët,wildhammer,1142,warlock,destruction,18,12,6
Handler,earthen-ring,1142,warlock,destruction,48,31,17
Escro,azgalor,1142,warlock,destruction,80,47,33
Dista,bleeding-hollow,1141,warlock,destruction,67,27,40
Nadek,tichondrius,1140,warlock,destruction,24,12,12
Tarnish,medivh,1140,warlock,destruction,120,52,68
Cogitoergo,stormrage,1136,warlock,destruction,18,12,6
Klaríon,ragnaros,1136,warlock,destruction,21,13,8
Taylôr,proudmoore,1136,warlock,destruction,30,12,18
Haardmode,area-52,1135,warlock,destruction,24,12,12
Pepzz,emerald-dream,1135,warlock,destruction,24,12,12
Sankestones,burning-legion,1134,warlock,destruction,30,12,18
Souwantwar,kiljaeden,1133,warlock,destruction,24,12,12
Skullsoul,arthas,1132,warlock,destruction,24,12,12
Ilfucyobit,kelthuzad,1132,warlock,destruction,89,32,57
Dlchem,tichondrius,1126,warlock,destruction,18,12,6
Myshadow,gorefiend,1126,warlock,destruction,48,23,25
Huskir,tichondrius,1125,warlock,destruction,30,12,18
Rageraff,trollbane,1121,warlock,destruction,30,18,12
Sylorelol,stormreaver,1121,warlock,destruction,42,15,27
Viejitaa,quelthalas,1118,warlock,destruction,22,13,9
Zêphyr,gilneas,1117,warlock,destruction,18,12,6
Cöökïe,tichondrius,1117,warlock,destruction,23,12,11
Trïnîty,tichondrius,1117,warlock,destruction,71,31,40
Hookslinger,barthilas,1116,warlock,destruction,24,12,12
Thugpenus,frostmane,1115,warlock,destruction,30,15,15
Lilibe,tichondrius,1115,warlock,destruction,77,34,43
Josemb,ragnaros,1114,warlock,destruction,26,14,12
Marvolö,darkspear,1112,warlock,destruction,24,15,9
Thulium,dawnbringer,1111,warlock,destruction,18,12,6
Feladrae,wyrmrest-accord,1111,warlock,destruction,74,27,47
Shadowndko,ragnaros,1110,warlock,destruction,23,12,11
Bawldimort,stormrage,1110,warlock,destruction,95,47,48
Mshyde,gurubashi,1107,warlock,destruction,30,17,13
Esomy,sargeras,1107,warlock,destruction,33,17,16
Darthlockz,illidan,1107,warlock,destruction,30,15,15
Anstik,area-52,1103,warlock,destruction,15,13,2
Infortunium,sargeras,1103,warlock,destruction,18,12,6
Hulion,kiljaeden,1100,warlock,destruction,54,21,33
Xenagos,antonidas,1100,warlock,destruction,35,12,23
Gwar,khazgoroth,1099,warlock,destruction,177,81,96
Tempestzone,barthilas,1096,warlock,destruction,29,16,13
Wárbaby,area-52,1096,warlock,destruction,24,13,11
Dreadlock,shadowsong,1095,warlock,destruction,28,13,15
Madgettike,stormrage,1094,warlock,destruction,36,22,14
Cãsh,aegwynn,1094,warlock,destruction,41,14,27
Cassetes,tichondrius,1093,warlock,destruction,17,12,5
Varuuss,ragnaros,1092,warlock,destruction,21,12,9
Mindfulchimp,sargeras,1092,warlock,destruction,23,12,11
Timmerstar,tichondrius,1091,warlock,destruction,54,25,29
Lerooux,hyjal,1090,warlock,destruction,66,28,38
Necrotiá,tichondrius,1085,warlock,destruction,17,12,5
Dualipy,ragnaros,1084,warlock,destruction,20,12,8
Spicý,sargeras,1084,warlock,destruction,63,31,32
Liltoastii,illidan,1084,warlock,destruction,27,13,14
Elchileno,drakkari,1081,warlock,destruction,24,12,12
Creambun,barthilas,1078,warlock,destruction,22,12,10
Kracky,tichondrius,1077,warlock,destruction,222,114,108
Nathalyâ,drakkari,1077,warlock,destruction,72,36,36
Glifosáto,quelthalas,1075,warlock,destruction,22,14,8
Valval,moon-guard,1074,warlock,destruction,72,22,50
Wolfib,tichondrius,1072,warlock,destruction,19,12,7
Caramelgodx,stormrage,1072,warlock,destruction,34,12,22
Wìckedelf,area-52,1071,warlock,destruction,121,61,60
Toby,azralon,1066,warlock,destruction,25,12,13
Luke,lightnings-blade,1062,warlock,destruction,18,12,6
Mogran,twisting-nether,1059,warlock,destruction,30,15,15
Agramonn,ragnaros,1058,warlock,destruction,41,14,27
Caesaros,quelthalas,1057,warlock,destruction,25,12,13
Vronos,stormrage,1056,warlock,destruction,12,11,1
Bumbleebolts,azralon,1056,warlock,destruction,12,11,1
Redsolojdc,tichondrius,1056,warlock,destruction,12,11,1
Søulswap,tichondrius,1056,warlock,destruction,18,11,7
Pandasrlegit,burning-blade,1056,warlock,destruction,18,11,7
Xidothewitch,stormrage,1056,warlock,destruction,18,11,7
Lockâsf,tichondrius,1056,warlock,destruction,18,11,7
Rubybestlol,tichondrius,1056,warlock,destruction,18,11,7
Drsmegmaz,dreadmaul,1056,warlock,destruction,24,11,13
Bbangtimo,tichondrius,1056,warlock,destruction,24,11,13
Edeklock,frostmourne,1055,warlock,destruction,12,11,1
Valyona,moon-guard,1055,warlock,destruction,18,12,6
Shadowflux,winterhoof,1055,warlock,destruction,18,11,7
Fatass,cairne,1055,warlock,destruction,18,11,7
Feardotzrun,illidan,1055,warlock,destruction,18,11,7
Sahdude,illidan,1055,warlock,destruction,18,11,7
Pedestal,bleeding-hollow,1055,warlock,destruction,18,11,7
Tuzadin,tichondrius,1055,warlock,destruction,18,11,7
Itstista,proudmoore,1055,warlock,destruction,24,11,13
Lowkei,stonemaul,1055,warlock,destruction,72,30,42
Evalovia,hyjal,1055,warlock,destruction,30,11,19
Virûs,vashj,1054,warlock,destruction,12,11,1
Yze,sargeras,1054,warlock,destruction,18,11,7
Friggus,azralon,1054,warlock,destruction,18,11,7
Locksolo,tichondrius,1054,warlock,destruction,18,11,7
Dunkindots,dalaran,1054,warlock,destruction,18,11,7
Spudzies,bleeding-hollow,1054,warlock,destruction,24,11,13
Neurotoxiina,azralon,1054,warlock,destruction,90,32,58
Brough,illidan,1054,warlock,destruction,36,11,25
Faënn,zuljin,1053,warlock,destruction,18,11,7
Buffwarlockz,stormrage,1053,warlock,destruction,18,11,7
Arremon,thrall,1053,warlock,destruction,24,11,13
Dëvïl,ragnaros,1053,warlock,destruction,24,11,13
Nibala,aegwynn,1053,warlock,destruction,30,11,19
Ranil,mannoroth,1052,warlock,destruction,18,11,7
Vocarion,stormrage,1052,warlock,destruction,18,11,7
Galtur,azralon,1052,warlock,destruction,24,11,13
Virt,anubarak,1052,warlock,destruction,24,11,13
Bêlthazor,kelthuzad,1052,warlock,destruction,24,11,13
Blanklee,tichondrius,1051,warlock,destruction,12,11,1
Domenic,sentinels,1051,warlock,destruction,16,12,4
Flemball,aegwynn,1051,warlock,destruction,21,12,9
Windwolff,dalvengyr,1051,warlock,destruction,24,11,13
Cheiff,tichondrius,1051,warlock,destruction,69,28,41
Kurmenos,uldum,1050,warlock,destruction,50,31,19
Toxec,barthilas,1050,warlock,destruction,18,11,7
Actiow,stormrage,1050,warlock,destruction,18,11,7
Unprønuncea,azralon,1050,warlock,destruction,25,11,14
Dotsandchill,dalaran,1049,warlock,destruction,24,11,13
Nobuyori,tichondrius,1049,warlock,destruction,36,13,23
Aswrislock,tichondrius,1048,warlock,destruction,12,11,1
Lindrasta,proudmoore,1048,warlock,destruction,12,11,1
Tirp,illidan,1048,warlock,destruction,24,11,13
Ionithvia,tichondrius,1048,warlock,destruction,30,11,19
Mäléficø,nemesis,1048,warlock,destruction,39,12,27
Irunaways,stormrage,1047,warlock,destruction,18,11,7
Pokemebutt,hydraxis,1046,warlock,destruction,18,11,7
Dex,jubeithos,1046,warlock,destruction,159,60,99
Ltr,moon-guard,1045,warlock,destruction,18,11,7
Haloren,moon-guard,1044,warlock,destruction,18,11,7
Reluxify,dalaran,1042,warlock,destruction,30,11,19
Funnelcakies,area-52,1040,warlock,destruction,24,11,13
Seeword,sargeras,1039,warlock,destruction,18,11,7
Crankshaft,nordrassil,1035,warlock,destruction,24,11,13
Gorskij,frostwolf,1035,warlock,destruction,25,11,14
Zíppen,proudmoore,1034,warlock,destruction,66,32,34
Warkoc,stormreaver,1031,warlock,destruction,33,12,21
Baiss,tichondrius,1030,warlock,destruction,18,11,7
Danoinfelizz,nemesis,1029,warlock,destruction,15,12,3
Kimis,azralon,1029,warlock,destruction,36,22,14
Thediaz,quelthalas,1029,warlock,destruction,30,16,14
Fidobiu,stormrage,1028,warlock,destruction,48,23,25
Yvonnee,tichondrius,1027,warlock,destruction,36,11,25
Noriaeradra,illidan,1025,warlock,destruction,24,13,11
Albus,skywall,1025,warlock,destruction,30,12,18
Valintine,khadgar,1024,warlock,destruction,21,12,9
Superbvious,lothar,1024,warlock,destruction,107,48,59
Getsmoked,moknathal,1023,warlock,destruction,23,11,12
Plaugewolf,azgalor,1021,warlock,destruction,24,13,11
Scentient,jubeithos,1019,warlock,destruction,18,11,7
Sylersa,malganis,1018,warlock,destruction,30,11,19
Nessro,stormrage,1016,warlock,destruction,24,16,8
Rnicu,bonechewer,1016,warlock,destruction,99,49,50
Solrad,illidan,1016,warlock,destruction,102,50,52
Bobthedoc,sargeras,1011,warlock,destruction,23,11,12
Jonuts,korgath,1010,warlock,destruction,79,39,40
Kklock,frostmourne,1007,warlock,destruction,45,26,19
Faliceu,sargeras,1006,warlock,destruction,26,11,15
Plagué,barthilas,1004,warlock,destruction,21,11,10
Docwildest,area-52,1003,warlock,destruction,17,11,6
Zhujiu,illidan,1002,warlock,destruction,23,12,11
Panyc,tichondrius,1002,warlock,destruction,23,11,12
Locksoul,area-52,999,warlock,destruction,72,33,39
Shardgodx,barthilas,997,warlock,destruction,23,11,12
Huskee,sargeras,992,warlock,destruction,22,11,11
Cs,icecrown,991,warlock,destruction,15,12,3
Celestîne,sargeras,988,warlock,destruction,22,11,11
Wingzerø,tichondrius,988,warlock,destruction,23,11,12
Ozric,quelthalas,987,warlock,destruction,20,12,8
Nevermorde,area-52,986,warlock,destruction,23,11,12
Dysxliea,dalaran,986,warlock,destruction,26,11,15
Zazyi,azralon,983,warlock,destruction,25,16,9
Mystikcloak,lightbringer,980,warlock,destruction,19,13,6
Hanoaa,tichondrius,975,warlock,destruction,11,11,0
Xmochahollic,tichondrius,963,warlock,destruction,208,89,119
Fxckyuo,tichondrius,960,warlock,destruction,12,10,2
Mesw,tichondrius,960,warlock,destruction,12,10,2
Adonegege,tichondrius,960,warlock,destruction,12,10,2
Jaboy,dragonmaw,960,warlock,destruction,12,10,2
Letmecastpls,tichondrius,960,warlock,destruction,12,10,2
Goldielocks,eredar,960,warlock,destruction,12,10,2
Wanglock,blackrock,960,warlock,destruction,12,10,2
Glanis,drakkari,960,warlock,destruction,12,10,2
Lockbtw,altar-of-storms,960,warlock,destruction,12,10,2
Defukd,proudmoore,960,warlock,destruction,12,10,2
Wolfibi,tichondrius,960,warlock,destruction,12,10,2
Afrikenx,tichondrius,960,warlock,destruction,12,10,2
Kammuany,sargeras,960,warlock,destruction,12,10,2
Lilshedon,kelthuzad,960,warlock,destruction,12,10,2
Icecokepeach,black-dragonflight,960,warlock,destruction,12,10,2
Renatis,malganis,960,warlock,destruction,15,11,4
Spicyfingerx,illidan,960,warlock,destruction,18,10,8
Asamsbinladn,illidan,960,warlock,destruction,18,10,8
Busterbob,tichondrius,960,warlock,destruction,18,10,8
Yuvirayz,illidan,960,warlock,destruction,18,10,8
Baka,moon-guard,960,warlock,destruction,18,10,8
Areufearious,sargeras,960,warlock,destruction,18,10,8
Phøbøs,hyjal,960,warlock,destruction,18,10,8
Veryezgame,tichondrius,960,warlock,destruction,18,10,8
Krypt,scilla,960,warlock,destruction,18,10,8
Extreme,blackwing-lair,960,warlock,destruction,18,10,8
Hydroponics,bloodscalp,960,warlock,destruction,18,10,8
Tjdotter,stormrage,960,warlock,destruction,21,11,10
Reflexlock,malganis,960,warlock,destruction,24,10,14
Ruellia,tichondrius,960,warlock,destruction,24,10,14
Gneçro,area-52,960,warlock,destruction,24,10,14
Percaddict,illidan,959,warlock,destruction,12,10,2
Evierine,zuljin,959,warlock,destruction,12,10,2
Daisyridley,frostmourne,959,warlock,destruction,12,10,2
Candylock,blackrock,959,warlock,destruction,12,10,2
Hexxorcism,bleeding-hollow,959,warlock,destruction,12,10,2
Foxar,stormrage,959,warlock,destruction,12,10,2
Gregfearnrun,area-52,959,warlock,destruction,16,11,5
Teppss,sargeras,959,warlock,destruction,18,10,8
Cursé,area-52,959,warlock,destruction,18,10,8
Roblockz,illidan,959,warlock,destruction,18,10,8
Juiçédaddy,aggramar,959,warlock,destruction,18,10,8
Years,moon-guard,959,warlock,destruction,18,10,8
Maral,kelthuzad,959,warlock,destruction,18,10,8
Neccross,azralon,959,warlock,destruction,18,10,8
Kxäs,ragnaros,959,warlock,destruction,18,10,8
Dotnrunn,kelthuzad,959,warlock,destruction,18,10,8
Notatryhard,emerald-dream,959,warlock,destruction,18,10,8
Jxstinl,tichondrius,959,warlock,destruction,18,10,8
Zipanadblcup,thrall,959,warlock,destruction,18,10,8
Maquedonia,quelthalas,959,warlock,destruction,18,10,8
Bktheruler,tichondrius,959,warlock,destruction,18,10,8
Tevonsonte,tichondrius,959,warlock,destruction,18,10,8
Pykorrg,ragnaros,959,warlock,destruction,24,10,14
Helraz,darkspear,958,warlock,destruction,12,10,2
Metafin,quelthalas,958,warlock,destruction,18,10,8
Taye,barthilas,958,warlock,destruction,18,10,8
Friendsalt,frostmourne,958,warlock,destruction,18,10,8
Mørgoth,thrall,958,warlock,destruction,18,10,8
Wondon,tichondrius,958,warlock,destruction,18,10,8
Gibkii,tichondrius,958,warlock,destruction,21,11,10
Sourmilkz,zuljin,958,warlock,destruction,24,10,14
Kåos,kelthuzad,957,warlock,destruction,18,10,8
Diabolous,malganis,957,warlock,destruction,18,10,8
Dercrow,quelthalas,957,warlock,destruction,18,10,8
Daesire,moon-guard,957,warlock,destruction,18,10,8
Hellwalker,illidan,957,warlock,destruction,18,10,8
Xerozus,tichondrius,957,warlock,destruction,18,10,8
Viash,thrall,957,warlock,destruction,18,10,8
Sieghert,frostmourne,957,warlock,destruction,24,10,14
Tromeo,sargeras,957,warlock,destruction,24,10,14
Gilfhunter,hellscream,957,warlock,destruction,24,10,14
Sacrifices,sargeras,956,warlock,destruction,12,10,2
Dårkfyre,kiljaeden,956,warlock,destruction,18,10,8
Wømanizer,azralon,956,warlock,destruction,18,10,8
Ragnalock,laughing-skull,956,warlock,destruction,18,10,8
Raidspot,bleeding-hollow,956,warlock,destruction,24,10,14
Zaintv,illidan,955,warlock,destruction,18,10,8
Chaoticstorm,area-52,955,warlock,destruction,18,10,8
Hellslayer,frostmourne,955,warlock,destruction,24,10,14
Pachips,zuljin,955,warlock,destruction,24,10,14
Redbro,darkspear,955,warlock,destruction,24,10,14
Babydolls,tichondrius,954,warlock,destruction,12,10,2
Soulinite,fizzcrank,954,warlock,destruction,24,10,14
Mybadyo,dalaran,953,warlock,destruction,16,11,5
Punjj,jubeithos,952,warlock,destruction,18,10,8
Jezzabell,amanthul,952,warlock,destruction,24,10,14
Huuchie,moon-guard,951,warlock,destruction,18,10,8
Opëth,thrall,951,warlock,destruction,18,10,8
Puscifear,azralon,951,warlock,destruction,30,10,20
Sojupain,kaelthas,950,warlock,destruction,12,10,2
Acribal,quelthalas,948,warlock,destruction,30,10,20
Moreedotss,malganis,947,warlock,destruction,30,10,20
Cursé,stormrage,944,warlock,destruction,18,10,8
Darkhadouken,sargeras,944,warlock,destruction,24,10,14
Zudre,tanaris,942,warlock,destruction,16,11,5
Mìrä,kelthuzad,934,warlock,destruction,23,10,13
Imsupercool,bleeding-hollow,927,warlock,destruction,17,10,7
Aliceðupree,darkspear,927,warlock,destruction,75,32,43
Astarõth,zuljin,926,warlock,destruction,26,11,15
Sasseypeach,frostmourne,923,warlock,destruction,18,10,8
Twohandedkil,stormrage,920,warlock,destruction,26,11,15
Keleiron,velen,916,warlock,destruction,18,10,8
Alvatio,tichondrius,914,warlock,destruction,30,11,19
Gritzixx,frostmourne,910,warlock,destruction,23,10,13
Xekk,wyrmrest-accord,910,warlock,destruction,23,10,13
Lockyy,khaz-modan,904,warlock,destruction,26,11,15
Sakeer,quelthalas,902,warlock,destruction,17,10,7
Earllock,sargeras,895,warlock,destruction,14,10,4
Fiennx,dalaran,894,warlock,destruction,17,10,7
Rakudemon,ragnaros,894,warlock,destruction,20,10,10
Zzat,area-52,892,warlock,destruction,14,10,4
Edielyth,proudmoore,891,warlock,destruction,17,10,7
Marlett,destromath,890,warlock,destruction,169,87,82
Ilovedabs,aerie-peak,890,warlock,destruction,22,10,12
Savagetheron,korgath,887,warlock,destruction,18,10,8
Pyria,boulderfist,877,warlock,destruction,13,10,3
Nikôlas,stormrage,871,warlock,destruction,66,26,40
Drezx,frostmourne,864,warlock,destruction,12,9,3
Frustration,darkspear,864,warlock,destruction,12,9,3
Rice,lothar,864,warlock,destruction,12,9,3
Animarex,tichondrius,864,warlock,destruction,12,9,3
Ziffy,emerald-dream,864,warlock,destruction,12,9,3
Alphaeus,hydraxis,864,warlock,destruction,12,9,3
Tstlsl,area-52,864,warlock,destruction,12,9,3
Pengliyuaner,illidan,864,warlock,destruction,12,9,3
Matthewx,stormrage,864,warlock,destruction,12,9,3
Voidsoda,whisperwind,864,warlock,destruction,12,9,3
Lokiy,ragnaros,864,warlock,destruction,12,9,3
Cirï,hellscream,864,warlock,destruction,12,9,3
Baddummy,tichondrius,864,warlock,destruction,12,9,3
Quickzmaster,blackrock,864,warlock,destruction,12,9,3
Bonita,garona,864,warlock,destruction,12,9,3
Lysitheä,moon-guard,864,warlock,destruction,12,9,3
Dabú,tichondrius,864,warlock,destruction,12,9,3
Crnowarlock,area-52,864,warlock,destruction,12,9,3
Khaozx,ragnaros,864,warlock,destruction,12,9,3
Demoabuser,lightnings-blade,864,warlock,destruction,12,9,3
Wtfcowisownz,illidan,864,warlock,destruction,12,9,3
Moóndust,bleeding-hollow,864,warlock,destruction,12,9,3
Particles,proudmoore,864,warlock,destruction,16,10,6
Deatthwish,ragnaros,864,warlock,destruction,21,11,10
Rorvask,area-52,864,warlock,destruction,18,9,9
Miroir,illidan,864,warlock,destruction,18,9,9
Voidxo,tichondrius,864,warlock,destruction,18,9,9
Eazyw,stormrage,864,warlock,destruction,18,9,9
Bigolehogger,area-52,864,warlock,destruction,18,9,9
Blair,wildhammer,864,warlock,destruction,18,9,9
Rezial,illidan,864,warlock,destruction,18,9,9
Woopie,malfurion,864,warlock,destruction,18,9,9
Stuffs,wyrmrest-accord,864,warlock,destruction,18,9,9
Drossx,illidan,864,warlock,destruction,18,9,9
Ezgamejr,tichondrius,864,warlock,destruction,24,9,15
Tharax,moon-guard,864,warlock,destruction,24,9,15
Mithlock,azralon,863,warlock,destruction,12,9,3
Shooff,area-52,863,warlock,destruction,12,9,3
Gent,stormrage,863,warlock,destruction,12,9,3
Ahrimaan,illidan,863,warlock,destruction,12,9,3
Pacopico,illidan,863,warlock,destruction,12,9,3
Pleaseno,tichondrius,863,warlock,destruction,12,9,3
Zycas,tichondrius,863,warlock,destruction,12,9,3
Slicktrik,stormrage,863,warlock,destruction,12,9,3
Dottemup,dalvengyr,863,warlock,destruction,12,9,3
Covidcorp,emerald-dream,863,warlock,destruction,12,9,3
Kathriss,frostmane,863,warlock,destruction,12,9,3
Stambye,ragnaros,863,warlock,destruction,12,9,3
Glergarby,stormscale,863,warlock,destruction,15,10,5
Jankity,kelthuzad,863,warlock,destruction,18,9,9
Kyraleth,frostmourne,863,warlock,destruction,18,9,9
Manethail,aegwynn,863,warlock,destruction,18,9,9
Kmüz,drakkari,863,warlock,destruction,18,9,9
Maxdamage,blackwater-raiders,863,warlock,destruction,18,9,9
Getlockdlol,stormrage,863,warlock,destruction,18,9,9
Firemike,kelthuzad,863,warlock,destruction,18,9,9
Nethron,the-venture-co,863,warlock,destruction,18,9,9
Christophear,stormrage,863,warlock,destruction,18,9,9
Minzyw,illidan,863,warlock,destruction,18,9,9
Rhabdo,ravenholdt,863,warlock,destruction,18,9,9
Notdiesel,thrall,863,warlock,destruction,18,9,9
Nicsb,caelestrasz,863,warlock,destruction,18,9,9
Rothmar,bleeding-hollow,863,warlock,destruction,18,9,9
Ðarkbat,ragnaros,863,warlock,destruction,18,9,9
Durgamon,kirin-tor,863,warlock,destruction,18,9,9
Kunshii,bleeding-hollow,863,warlock,destruction,18,9,9
Rokdas,area-52,863,warlock,destruction,24,9,15
Cigárillo,thrall,863,warlock,destruction,24,9,15
Namig,aerie-peak,862,warlock,destruction,12,9,3
Mourinhoftw,illidan,862,warlock,destruction,12,9,3
Bootyybandit,tichondrius,862,warlock,destruction,12,9,3
Locklockdead,earthen-ring,862,warlock,destruction,12,9,3
Çhåos,destromath,862,warlock,destruction,12,9,3
Sanzofunke,area-52,862,warlock,destruction,18,9,9
Artheás,azralon,862,warlock,destruction,18,9,9
Galamarius,korgath,862,warlock,destruction,18,9,9
Duhdotsbruh,trollbane,862,warlock,destruction,18,9,9
Thewkama,tichondrius,862,warlock,destruction,18,9,9
Dìabolos,frostmourne,862,warlock,destruction,18,9,9
Rainali,tichondrius,862,warlock,destruction,18,9,9
Breaad,tichondrius,862,warlock,destruction,24,9,15
Tanathoz,thrall,862,warlock,destruction,28,10,18
Aveeda,malganis,861,warlock,destruction,12,9,3
Chaosvoid,frostmourne,861,warlock,destruction,12,9,3
Frdchickiana,tichondrius,861,warlock,destruction,18,9,9
Blackwlk,tichondrius,861,warlock,destruction,18,9,9
Aikus,quelthalas,861,warlock,destruction,18,9,9
Aruotnof,nemesis,861,warlock,destruction,18,9,9
Porsimorgis,firetree,861,warlock,destruction,21,10,11
Snapp,kelthuzad,861,warlock,destruction,24,9,15
Kritza,proudmoore,860,warlock,destruction,18,9,9
Damdochael,bleeding-hollow,860,warlock,destruction,24,9,15
Botoslap,dragonmaw,860,warlock,destruction,24,9,15
Yelabanxtown,thaurissan,859,warlock,destruction,12,9,3
Githany,hyjal,859,warlock,destruction,18,9,9
Demonchurch,area-52,859,warlock,destruction,18,9,9
Damerus,illidan,859,warlock,destruction,24,9,15
Wybbukk,wyrmrest-accord,858,warlock,destruction,12,9,3
Lestant,moon-guard,858,warlock,destruction,18,9,9
Anubrikhan,wyrmrest-accord,858,warlock,destruction,18,9,9
Shlecht,ragnaros,858,warlock,destruction,24,9,15
Corezach,proudmoore,858,warlock,destruction,30,9,21
Rudeuss,kiljaeden,857,warlock,destruction,18,9,9
Sarkahn,sargeras,856,warlock,destruction,12,9,3
Sykosenpai,zuljin,856,warlock,destruction,12,9,3
Shickeri,thunderlord,855,warlock,destruction,12,9,3
Shadohz,lightnings-blade,855,warlock,destruction,12,9,3
Chewpawcabra,tichondrius,855,warlock,destruction,23,11,12
Alagau,sargeras,853,warlock,destruction,12,9,3
Klummzy,tichondrius,850,warlock,destruction,18,9,9
Juan,borean-tundra,850,warlock,destruction,24,9,15
Vampir,hellscream,850,warlock,destruction,24,9,15
Doomtome,moon-guard,850,warlock,destruction,38,9,29
Xîon,nagrand,843,warlock,destruction,12,9,3
Deathwishiz,tichondrius,840,warlock,destruction,24,9,15
Elyzier,gallywix,839,warlock,destruction,48,20,28
Lockyßalboa,the-venture-co,835,warlock,destruction,18,9,9
Freakdoa,blades-edge,834,warlock,destruction,53,20,33
Hayhatchie,nagrand,831,warlock,destruction,17,9,8
Chaospump,frostmourne,815,warlock,destruction,17,9,8
Cheêsyx,tichondrius,815,warlock,destruction,17,9,8
Üziel,nemesis,814,warlock,destruction,15,9,6
Brútek,moon-guard,811,warlock,destruction,23,9,14
Metamòrph,malganis,810,warlock,destruction,16,10,6
Lüçian,ragnaros,810,warlock,destruction,21,10,11
Middot,area-52,799,warlock,destruction,16,9,7
Dixynormis,zuljin,795,warlock,destruction,17,9,8
Rôver,crushridge,781,warlock,destruction,21,10,11
Conboii,tichondrius,768,warlock,destruction,10,9,1
Elcidz,tichondrius,768,warlock,destruction,12,8,4
Flackory,tichondrius,768,warlock,destruction,12,8,4
Warcoc,bleeding-hollow,768,warlock,destruction,12,8,4
Ronaspreader,tichondrius,768,warlock,destruction,12,8,4
Aexsion,moon-guard,768,warlock,destruction,12,8,4
Nicorot,malganis,768,warlock,destruction,12,8,4
Bopplock,tichondrius,768,warlock,destruction,12,8,4
Munje,bleeding-hollow,768,warlock,destruction,12,8,4
Bhalthazar,staghelm,768,warlock,destruction,12,8,4
Idoovoodoo,burning-legion,768,warlock,destruction,12,8,4
Esolock,malganis,768,warlock,destruction,12,8,4
Shinagae,tichondrius,768,warlock,destruction,12,8,4
Elprup,tichondrius,768,warlock,destruction,12,8,4
Felegance,proudmoore,768,warlock,destruction,12,8,4
Ceeloftw,tichondrius,768,warlock,destruction,12,8,4
Mcsquee,lightbringer,768,warlock,destruction,12,8,4
Dumbfknclass,malganis,768,warlock,destruction,12,8,4
Aptukk,archimonde,768,warlock,destruction,12,8,4
Soliaa,stormrage,768,warlock,destruction,12,8,4
Rebolting,tichondrius,768,warlock,destruction,12,8,4
Flavakid,malganis,768,warlock,destruction,12,8,4
Wickiedalice,vashj,768,warlock,destruction,12,8,4
Rhelialock,icecrown,768,warlock,destruction,12,8,4
Postitnotes,tichondrius,768,warlock,destruction,12,8,4
Kápz,darkspear,768,warlock,destruction,12,8,4
Stíngz,nemesis,768,warlock,destruction,12,8,4
Wizxin,emerald-dream,768,warlock,destruction,12,8,4
Elldiablo,darkspear,768,warlock,destruction,12,8,4
Tylennidar,black-dragonflight,768,warlock,destruction,12,8,4
Diznei,nemesis,768,warlock,destruction,12,8,4
Warlocknroll,frostmourne,768,warlock,destruction,12,8,4
Annantu,area-52,768,warlock,destruction,12,8,4
Fischh,hyjal,768,warlock,destruction,12,8,4
Gamecover,azralon,768,warlock,destruction,12,8,4
Smeezles,frostmourne,768,warlock,destruction,12,8,4
Searinox,scilla,768,warlock,destruction,12,8,4
Levee,spirestone,768,warlock,destruction,12,8,4
Ohthemisery,sargeras,768,warlock,destruction,12,8,4
Necroferal,whisperwind,768,warlock,destruction,12,8,4
Skylinel,tichondrius,768,warlock,destruction,12,8,4
Ayedss,dalaran,768,warlock,destruction,12,8,4
Koalafluffy,shadow-council,768,warlock,destruction,12,8,4
Paddywacker,azgalor,768,warlock,destruction,12,8,4
Hipnus,drakkari,768,warlock,destruction,12,8,4
Slackjaww,kiljaeden,768,warlock,destruction,12,8,4
Clorvenna,zuljin,768,warlock,destruction,12,8,4
Discordance,zuljin,768,warlock,destruction,12,8,4
Famington,tichondrius,768,warlock,destruction,12,8,4
Xevari,zuljin,768,warlock,destruction,12,8,4
Narzhul,drakkari,768,warlock,destruction,12,8,4
Beckypls,zuljin,768,warlock,destruction,12,8,4
Chaoscoach,sargeras,768,warlock,destruction,12,8,4
Nyhn,bleeding-hollow,768,warlock,destruction,13,8,5
Westtung,tichondrius,768,warlock,destruction,13,8,5
Metic,firetree,768,warlock,destruction,16,9,7
Rashiko,bleeding-hollow,768,warlock,destruction,18,8,10
Westhofxx,sargeras,768,warlock,destruction,18,8,10
Tarth,sargeras,768,warlock,destruction,18,8,10
Demfearslol,terokkar,768,warlock,destruction,18,8,10
Kallym,azralon,768,warlock,destruction,18,8,10
Iniboltquity,tichondrius,768,warlock,destruction,18,8,10
Joung,tichondrius,768,warlock,destruction,18,8,10
Dethknell,stormrage,768,warlock,destruction,18,8,10
Warcrimes,silvermoon,768,warlock,destruction,18,8,10
Oppaijuggler,tichondrius,768,warlock,destruction,18,8,10
Vexxes,malganis,768,warlock,destruction,18,8,10
Impbisqit,stormrage,767,warlock,destruction,12,8,4
Bâppo,antonidas,767,warlock,destruction,12,8,4
Feldune,sargeras,767,warlock,destruction,12,8,4
Darthtequila,stormrage,767,warlock,destruction,12,8,4
Char,jubeithos,767,warlock,destruction,12,8,4
Matrriixx,proudmoore,767,warlock,destruction,12,8,4
Coil,kiljaeden,767,warlock,destruction,12,8,4
Wartoyy,uldum,767,warlock,destruction,12,8,4
Alastoorx,ragnaros,767,warlock,destruction,12,8,4
Kruder,tichondrius,767,warlock,destruction,12,8,4
Yonz,area-52,767,warlock,destruction,12,8,4
Accentuate,tichondrius,767,warlock,destruction,12,8,4
Xaviier,sargeras,767,warlock,destruction,12,8,4
Doman,thorium-brotherhood,767,warlock,destruction,12,8,4
Says,gorefiend,767,warlock,destruction,18,8,10
Síkaría,malganis,767,warlock,destruction,18,8,10
Babubabub,azralon,767,warlock,destruction,18,8,10
Misscháos,malganis,767,warlock,destruction,18,8,10
Skirnir,tichondrius,767,warlock,destruction,18,8,10
Lokkup,dalaran,767,warlock,destruction,18,8,10
Abramerlin,tichondrius,767,warlock,destruction,18,8,10
Slysdexia,sargeras,767,warlock,destruction,18,8,10
Lockabeesha,chogall,767,warlock,destruction,18,8,10
Felpuppet,barthilas,767,warlock,destruction,18,8,10
Katsurägi,tichondrius,767,warlock,destruction,18,8,10
Mxd,ragnaros,767,warlock,destruction,18,8,10
Mangdaemon,silvermoon,767,warlock,destruction,18,8,10
Aldaill,moon-guard,767,warlock,destruction,18,8,10
Mêdìvh,tichondrius,767,warlock,destruction,18,8,10
Shikyo,lightnings-blade,767,warlock,destruction,18,8,10
Veleseth,stormrage,767,warlock,destruction,24,8,16
Spicytaters,malganis,767,warlock,destruction,24,8,16
Itsmeagain,area-52,767,warlock,destruction,24,8,16
Feoona,hyjal,767,warlock,destruction,24,8,16
Necrófear,tichondrius,767,warlock,destruction,24,8,16
Vlk,barthilas,767,warlock,destruction,26,8,18
Dinkydeen,area-52,766,warlock,destruction,12,8,4
Raglans,amanthul,766,warlock,destruction,12,8,4
Enur,malganis,766,warlock,destruction,12,8,4
Doomers,frostmourne,766,warlock,destruction,12,8,4
Devdolittle,tichondrius,766,warlock,destruction,12,8,4
Dmgcrit,destromath,766,warlock,destruction,12,8,4
Assaulttron,wyrmrest-accord,766,warlock,destruction,12,8,4
Uncann,bleeding-hollow,766,warlock,destruction,18,8,10
Mandley,nazgrel,766,warlock,destruction,18,8,10
Seniorshneef,emerald-dream,766,warlock,destruction,18,8,10
Vansa,caelestrasz,766,warlock,destruction,18,8,10
Abyssamcdoom,sargeras,766,warlock,destruction,18,8,10
Wrathfull,malganis,765,warlock,destruction,12,8,4
Spiritofodin,grizzly-hills,765,warlock,destruction,12,8,4
Rurnt,bloodhoof,765,warlock,destruction,12,8,4
Lizzosize,tichondrius,765,warlock,destruction,12,8,4
Wyrmsteez,tichondrius,765,warlock,destruction,18,8,10
Rottgodqt,area-52,765,warlock,destruction,24,8,16
Døtcom,frostmourne,764,warlock,destruction,16,9,7
Lilitht,drakkari,764,warlock,destruction,18,8,10
Guinegobbler,hyjal,764,warlock,destruction,20,8,12
Esoo,kul-tiras,763,warlock,destruction,12,8,4
Iamfear,shuhalo,763,warlock,destruction,18,8,10
Caryn,dalaran,763,warlock,destruction,18,8,10
Disrespex,kelthuzad,762,warlock,destruction,18,8,10
Terminall,quelthalas,762,warlock,destruction,18,8,10
Nightblloom,illidan,762,warlock,destruction,18,8,10
Djfear,tichondrius,762,warlock,destruction,18,8,10
Degynlock,wyrmrest-accord,762,warlock,destruction,24,8,16
Shooterg,tichondrius,761,warlock,destruction,18,8,10
Soderbergh,area-52,760,warlock,destruction,24,8,16
Schwaan,bladefist,757,warlock,destruction,12,8,4
Fëâr,trollbane,755,warlock,destruction,18,8,10
Voidsoul,garithos,754,warlock,destruction,18,8,10
Shendotigans,illidan,735,warlock,destruction,23,8,15
Fellraiser,bleeding-hollow,720,warlock,destruction,15,8,7
Notoriusmma,illidan,720,warlock,destruction,19,10,9
Sotera,bleeding-hollow,719,warlock,destruction,11,8,3
Thuglovex,sargeras,719,warlock,destruction,11,8,3
Zhoull,thrall,719,warlock,destruction,15,8,7
Silverfire,ragnaros,718,warlock,destruction,17,8,9
Lökdown,dalaran,714,warlock,destruction,15,11,4
Júbeka,drakkari,714,warlock,destruction,20,9,11
Lilsquirts,kelthuzad,704,warlock,destruction,16,8,8
Disclamer,tichondrius,704,warlock,destruction,16,8,8
Ihaveapowers,maiev,703,warlock,destruction,11,8,3
Cubanlock,aegwynn,703,warlock,destruction,11,8,3
Tinyjo,sargeras,703,warlock,destruction,11,8,3
Bäbz,barthilas,703,warlock,destruction,11,8,3
Demotional,wyrmrest-accord,703,warlock,destruction,14,8,6
Liljamie,stormrage,703,warlock,destruction,17,8,9
Valkynaris,chogall,703,warlock,destruction,20,8,12
Nozixx,thrall,703,warlock,destruction,22,8,14
Darchrow,frostmourne,703,warlock,destruction,23,8,15
Screampied,sargeras,699,warlock,destruction,20,8,12
Surleshilla,malganis,688,warlock,destruction,19,8,11
Clamdischarg,frostmourne,687,warlock,destruction,13,8,5
Dihva,malganis,687,warlock,destruction,17,9,8
Boltondahoes,sargeras,686,warlock,destruction,13,8,5
Zunlock,tichondrius,681,warlock,destruction,26,11,15
Zlippery,barthilas,672,warlock,destruction,10,8,2
Getfeared,emerald-dream,672,warlock,destruction,10,8,2
Dealindoug,bonechewer,672,warlock,destruction,12,7,5
Demí,zuljin,672,warlock,destruction,12,7,5
Revdog,sargeras,672,warlock,destruction,12,7,5
Aegywn,gorgonnash,672,warlock,destruction,12,7,5
Flicks,arthas,672,warlock,destruction,12,7,5
Monkeyasslol,sargeras,672,warlock,destruction,12,7,5
Brujoroba,drakkari,672,warlock,destruction,12,7,5
Karmalock,malganis,672,warlock,destruction,12,7,5
Sylvarri,stormrage,672,warlock,destruction,12,7,5
Synisterlock,moon-guard,672,warlock,destruction,12,7,5
Khartric,kelthuzad,672,warlock,destruction,12,7,5
Lorenzojrr,sargeras,672,warlock,destruction,12,7,5
Westhofz,sargeras,672,warlock,destruction,12,7,5
Pillock,bleeding-hollow,672,warlock,destruction,12,7,5
Insànity,bleeding-hollow,672,warlock,destruction,12,7,5
Lockoutz,illidan,672,warlock,destruction,12,7,5
Luciusvrenus,tichondrius,672,warlock,destruction,12,7,5
Ouijafaps,sargeras,672,warlock,destruction,12,7,5
Charognart,lightninghoof,672,warlock,destruction,12,7,5
Tatordotzz,tichondrius,672,warlock,destruction,12,7,5
Drakatat,tichondrius,672,warlock,destruction,12,7,5
Morganach,moon-guard,672,warlock,destruction,12,7,5
Snikpan,silver-hand,672,warlock,destruction,12,7,5
Kuaa,illidan,672,warlock,destruction,12,7,5
Suminl,tichondrius,672,warlock,destruction,12,7,5
Tamzin,kelthuzad,672,warlock,destruction,12,7,5
Dplexs,jubeithos,672,warlock,destruction,12,7,5
Mfcalamity,uldum,672,warlock,destruction,12,7,5
Deidax,sargeras,672,warlock,destruction,12,7,5
Clingrita,tichondrius,672,warlock,destruction,12,7,5
Felforyouu,illidan,672,warlock,destruction,12,7,5
Milkybøng,area-52,672,warlock,destruction,12,7,5
Buypork,tichondrius,672,warlock,destruction,12,7,5
Pinkless,frostmourne,672,warlock,destruction,12,7,5
Cancer,bloodscalp,672,warlock,destruction,12,7,5
Frùgle,sargeras,672,warlock,destruction,12,7,5
Glizzÿ,thrall,672,warlock,destruction,12,7,5
Yeeaahhbuddy,frostmourne,672,warlock,destruction,12,7,5
Afflackxl,sargeras,672,warlock,destruction,12,7,5
Phishdots,tichondrius,672,warlock,destruction,12,7,5
Bigjersey,illidan,672,warlock,destruction,12,7,5
Furryfears,gurubashi,672,warlock,destruction,12,7,5
Kountdrakula,tichondrius,672,warlock,destruction,12,7,5
Schlutty,malganis,672,warlock,destruction,12,7,5
Alìen,barthilas,672,warlock,destruction,12,7,5
Rothslock,tichondrius,672,warlock,destruction,12,7,5
Dotcòm,illidan,672,warlock,destruction,12,7,5
Necrotko,malganis,672,warlock,destruction,12,7,5
Dipgodx,bleeding-hollow,672,warlock,destruction,12,7,5
Iboltudie,tichondrius,672,warlock,destruction,12,7,5
Siddara,garrosh,672,warlock,destruction,12,7,5
Fsx,malganis,672,warlock,destruction,12,7,5
Alterity,kelthuzad,672,warlock,destruction,12,7,5
Stîgz,stormrage,672,warlock,destruction,12,7,5
Dätura,tichondrius,672,warlock,destruction,12,7,5
Tomathus,moon-guard,672,warlock,destruction,12,7,5
Rockalock,burning-blade,672,warlock,destruction,12,7,5
Theovohn,thrall,672,warlock,destruction,12,7,5
Dötkill,illidan,672,warlock,destruction,12,7,5
Uggaboogga,malganis,672,warlock,destruction,12,7,5
Locker,darkspear,672,warlock,destruction,12,7,5
Yellowfevr,thrall,672,warlock,destruction,12,7,5
Walleyemike,kelthuzad,672,warlock,destruction,12,7,5
Dotlockndrop,stormreaver,672,warlock,destruction,12,7,5
Nbayoungbolt,altar-of-storms,672,warlock,destruction,12,7,5
Callofzevoid,tichondrius,672,warlock,destruction,12,7,5
Javinou,tichondrius,672,warlock,destruction,12,7,5
Méphisto,emerald-dream,672,warlock,destruction,12,7,5
Mokfernal,tichondrius,672,warlock,destruction,12,7,5
Fantumz,illidan,672,warlock,destruction,12,7,5
Qayin,azralon,672,warlock,destruction,12,7,5
Puvvo,tichondrius,672,warlock,destruction,12,7,5
Kimchiblast,tichondrius,672,warlock,destruction,12,7,5
Elanfel,thrall,672,warlock,destruction,12,7,5
Inmøtíøn,tichondrius,672,warlock,destruction,12,7,5
Bosswarlock,tichondrius,672,warlock,destruction,13,7,6
Axetoss,stormrage,672,warlock,destruction,17,9,8
Myidas,quelthalas,672,warlock,destruction,18,7,11
Marshyl,tichondrius,672,warlock,destruction,18,7,11
Zantology,frostmourne,672,warlock,destruction,18,7,11
Lilintrovert,illidan,672,warlock,destruction,18,7,11
Ivanux,quelthalas,672,warlock,destruction,18,7,11
Butterbolts,aerie-peak,672,warlock,destruction,18,7,11
Spacedots,illidan,672,warlock,destruction,18,7,11
Anasúi,quelthalas,672,warlock,destruction,18,7,11
Sibome,stormrage,672,warlock,destruction,18,7,11
Vihxy,moon-guard,672,warlock,destruction,18,7,11
Modot,tichondrius,672,warlock,destruction,18,7,11
Gabagøøl,illidan,672,warlock,destruction,18,7,11
Zareke,silvermoon,672,warlock,destruction,18,7,11
Dilonlock,area-52,672,warlock,destruction,18,7,11
Kroshuto,ragnaros,671,warlock,destruction,12,7,5
Grimzo,mugthol,671,warlock,destruction,12,7,5
Pendïng,area-52,671,warlock,destruction,12,7,5
Zms,ragnaros,671,warlock,destruction,12,7,5
Bradella,proudmoore,671,warlock,destruction,12,7,5
Azâziel,ragnaros,671,warlock,destruction,12,7,5
Mérli,quelthalas,671,warlock,destruction,12,7,5
Bhupzy,barthilas,671,warlock,destruction,12,7,5
Demosthenes,nazjatar,671,warlock,destruction,12,7,5
Zhing,frostmourne,671,warlock,destruction,12,7,5
Shadowpainn,the-underbog,671,warlock,destruction,12,7,5
Choas,jaedenar,671,warlock,destruction,12,7,5
Sorenbjerga,zuljin,671,warlock,destruction,12,7,5
Cytosine,medivh,671,warlock,destruction,12,7,5
Hudsonse,eitrigg,671,warlock,destruction,12,7,5
Krillz,quelthalas,671,warlock,destruction,12,7,5
Leroybrown,alterac-mountains,671,warlock,destruction,12,7,5
Drskeeters,malganis,671,warlock,destruction,12,7,5
Zyraxx,moon-guard,671,warlock,destruction,12,7,5
Darthgoku,area-52,671,warlock,destruction,12,7,5
Espanol,magtheridon,671,warlock,destruction,12,7,5
Briside,malganis,671,warlock,destruction,12,7,5
Crenth,ravencrest,671,warlock,destruction,12,7,5
Fapchat,silvermoon,671,warlock,destruction,12,7,5
Saicinxd,darkspear,671,warlock,destruction,12,7,5
Lübelock,illidan,671,warlock,destruction,18,7,11
Arkangel,dalvengyr,671,warlock,destruction,18,7,11
Taoloni,stormrage,671,warlock,destruction,18,7,11
Wollylock,dark-iron,671,warlock,destruction,18,7,11
Vetislock,thrall,671,warlock,destruction,18,7,11
Deadlockz,stormrage,671,warlock,destruction,18,7,11
Kachauwoo,kiljaeden,671,warlock,destruction,18,7,11
Begelock,illidan,671,warlock,destruction,18,7,11
Yungwilly,silvermoon,671,warlock,destruction,18,7,11
Jvilla,tichondrius,671,warlock,destruction,18,7,11
Vorituuray,moon-guard,671,warlock,destruction,18,7,11
Fulc,area-52,671,warlock,destruction,18,7,11
Purplehatred,area-52,671,warlock,destruction,18,7,11
Familjia,nagrand,671,warlock,destruction,24,7,17
Tørturë,tichondrius,670,warlock,destruction,12,7,5
Damienn,wyrmrest-accord,670,warlock,destruction,12,7,5
Amilkman,area-52,670,warlock,destruction,12,7,5
Dipndøtz,illidan,670,warlock,destruction,12,7,5
Pinksh,sargeras,670,warlock,destruction,12,7,5
Cazadorius,jubeithos,670,warlock,destruction,13,7,6
Cynissel,sargeras,670,warlock,destruction,13,7,6
Siphos,proudmoore,670,warlock,destruction,18,7,11
Kurtcodrain,blackhand,670,warlock,destruction,18,7,11
Heartpvp,tichondrius,670,warlock,destruction,18,7,11
Graced,stormrage,670,warlock,destruction,18,7,11
Archibalding,area-52,670,warlock,destruction,21,7,14
Otus,echo-isles,669,warlock,destruction,12,7,5
Revenancer,smolderthorn,669,warlock,destruction,12,7,5
Kristenßell,senjin,669,warlock,destruction,12,7,5
Ailliforlune,illidan,669,warlock,destruction,22,8,14
Sneakywarlok,dalaran,668,warlock,destruction,19,7,12
Deathjerky,thrall,667,warlock,destruction,12,7,5
Anahaldever,fenris,667,warlock,destruction,12,7,5
Xargeras,emerald-dream,667,warlock,destruction,18,7,11
Nicestrike,barthilas,666,warlock,destruction,12,7,5
Markov,goldrinn,666,warlock,destruction,30,7,23
Giiada,korgath,665,warlock,destruction,15,8,7
Fartonomus,illidan,658,warlock,destruction,18,7,11
Truffleseed,tichondrius,640,warlock,destruction,16,7,9
Saltboi,azjolnerub,640,warlock,destruction,16,7,9
Felse,stormrage,640,warlock,destruction,22,7,15
Voidxx,tichondrius,639,warlock,destruction,11,7,4
Greenwarlock,bleeding-hollow,639,warlock,destruction,14,8,6
Demondan,magtheridon,638,warlock,destruction,23,7,16
Hateslocks,bladefist,637,warlock,destruction,22,7,15
Pandemone,proudmoore,624,warlock,destruction,15,7,8
Conboee,tichondrius,623,warlock,destruction,11,7,4
Seregå,skywall,623,warlock,destruction,11,7,4
Helpimdýing,sargeras,622,warlock,destruction,21,7,14
Ashdan,area-52,621,warlock,destruction,17,7,10
Ganondolph,sargeras,618,warlock,destruction,15,8,7
Marty,stormrage,618,warlock,destruction,21,8,13
Lazzarros,area-52,618,warlock,destruction,22,8,14
Pontoontim,mugthol,617,warlock,destruction,20,8,12
Fancynuts,kiljaeden,607,warlock,destruction,11,7,4
Perfsx,bleeding-hollow,607,warlock,destruction,14,7,7
Playdizzle,frostmourne,607,warlock,destruction,14,7,7
Furrlokc,tichondrius,607,warlock,destruction,16,7,9
Prahvstein,shuhalo,602,warlock,destruction,14,7,7
Studathlete,tichondrius,592,warlock,destruction,13,7,6
Freyanna,moon-guard,588,warlock,destruction,19,7,12
Bivvix,malganis,576,warlock,destruction,6,6,0
Notstingz,azralon,576,warlock,destruction,6,6,0
Menggoth,tichondrius,576,warlock,destruction,6,6,0
Winipuhmalo,quelthalas,576,warlock,destruction,6,6,0
Dancedark,tichondrius,576,warlock,destruction,6,6,0
Mitchosx,frostmourne,576,warlock,destruction,6,6,0
Zyntowin,bleeding-hollow,576,warlock,destruction,6,6,0
Kòngal,tichondrius,576,warlock,destruction,6,6,0
Lockhippo,illidan,576,warlock,destruction,6,6,0
Baconmuffin,tichondrius,576,warlock,destruction,6,6,0
Malevolent,velen,576,warlock,destruction,6,6,0
Paratex,thrall,576,warlock,destruction,6,6,0
Damn,stormreaver,576,warlock,destruction,6,6,0
Raghnor,illidan,576,warlock,destruction,6,6,0
Jblock,zuljin,576,warlock,destruction,6,6,0
Schrader,sargeras,576,warlock,destruction,6,6,0
Usainboltzz,kelthuzad,576,warlock,destruction,6,6,0
Gabbagoul,sargeras,576,warlock,destruction,6,6,0
Hypexis,area-52,576,warlock,destruction,6,6,0
Yzqer,stormrage,576,warlock,destruction,6,6,0
Alexiosy,area-52,576,warlock,destruction,6,6,0
Fears,norgannon,576,warlock,destruction,6,6,0
Guitarpick,kelthuzad,576,warlock,destruction,6,6,0
Baiw,tichondrius,576,warlock,destruction,6,6,0
Deliverances,kelthuzad,576,warlock,destruction,9,7,2
Crewee,tichondrius,576,warlock,destruction,9,6,3
Broovid,tichondrius,576,warlock,destruction,13,7,6
Pavél,ragnaros,576,warlock,destruction,12,6,6
Kreemy,ysera,576,warlock,destruction,12,6,6
Tomato,azjolnerub,576,warlock,destruction,12,6,6
Tlock,azjolnerub,576,warlock,destruction,12,6,6
Limeriax,emerald-dream,576,warlock,destruction,12,6,6
Hiro,steamwheedle-cartel,576,warlock,destruction,12,6,6
Bhris,wildhammer,576,warlock,destruction,12,6,6
Viejita,quelthalas,576,warlock,destruction,12,6,6
Coffeezx,malganis,576,warlock,destruction,12,6,6
Geegas,malganis,576,warlock,destruction,12,6,6
Bolèyn,moon-guard,576,warlock,destruction,12,6,6
Claus,warsong,576,warlock,destruction,12,6,6
Smashfacelck,tichondrius,576,warlock,destruction,12,6,6
Lockmeupuwu,malganis,576,warlock,destruction,12,6,6
Chaosboltss,tichondrius,576,warlock,destruction,12,6,6
Imortalchaos,dentarg,576,warlock,destruction,12,6,6
Zoboo,zuljin,576,warlock,destruction,12,6,6
Innerforce,tichondrius,576,warlock,destruction,12,6,6
Lucíela,ragnaros,576,warlock,destruction,12,6,6
Gengar,dalaran,576,warlock,destruction,12,6,6
Souldrain,malganis,576,warlock,destruction,12,6,6
Sadist,area-52,576,warlock,destruction,12,6,6
Kulgar,aerie-peak,576,warlock,destruction,12,6,6
Jessewheels,tichondrius,576,warlock,destruction,12,6,6
Warlooch,area-52,576,warlock,destruction,12,6,6
Manalis,zuljin,576,warlock,destruction,12,6,6
Athronak,malganis,576,warlock,destruction,12,6,6
Andrewpg,zuljin,576,warlock,destruction,12,6,6
Lockboss,malganis,576,warlock,destruction,12,6,6
Doomhauzer,kiljaeden,576,warlock,destruction,12,6,6
Charmandfarm,nerzhul,576,warlock,destruction,12,6,6
Pepperbolt,emerald-dream,576,warlock,destruction,12,6,6
Flu,darkspear,576,warlock,destruction,12,6,6
Wrongname,hakkar,576,warlock,destruction,12,6,6
Sumrule,dreadmaul,576,warlock,destruction,12,6,6
Zephidel,thrall,576,warlock,destruction,12,6,6
Tonifortnite,emerald-dream,576,warlock,destruction,12,6,6
Impabuser,tichondrius,576,warlock,destruction,12,6,6
Baconmarty,emerald-dream,576,warlock,destruction,12,6,6
Tinked,stormrage,576,warlock,destruction,12,6,6
Maèlstrom,area-52,576,warlock,destruction,12,6,6
Crimsonela,emerald-dream,576,warlock,destruction,12,6,6
Ðáyshéll,kelthuzad,576,warlock,destruction,12,6,6
Chabolt,tichondrius,576,warlock,destruction,12,6,6
Kerës,sargeras,576,warlock,destruction,12,6,6
Quadrillion,stormrage,576,warlock,destruction,12,6,6
Lambe,tichondrius,576,warlock,destruction,12,6,6
Cunalia,sargeras,576,warlock,destruction,12,6,6
Riskydemon,azralon,576,warlock,destruction,12,6,6
Vravras,kelthuzad,576,warlock,destruction,12,6,6
Beamin,dentarg,576,warlock,destruction,12,6,6
Chipt,kelthuzad,576,warlock,destruction,12,6,6
Velvalla,chogall,576,warlock,destruction,12,6,6
Jingzw,illidan,576,warlock,destruction,12,6,6
Beerbolt,dalaran,576,warlock,destruction,12,6,6
Vietoutlaw,bronzebeard,576,warlock,destruction,12,6,6
Ronnietherat,tichondrius,576,warlock,destruction,12,6,6
Zeromech,sargeras,576,warlock,destruction,12,6,6
Karpawarlock,ragnaros,576,warlock,destruction,12,6,6
Graingrippin,malganis,576,warlock,destruction,12,6,6
Kentus,moonrunner,576,warlock,destruction,12,6,6
Salentsia,malganis,576,warlock,destruction,12,6,6
Ïmpdance,tichondrius,576,warlock,destruction,12,6,6
Sn,dalaran,576,warlock,destruction,12,6,6
Massivebolts,area-52,576,warlock,destruction,12,6,6
Drßöb,area-52,576,warlock,destruction,12,6,6
Ryzhen,area-52,576,warlock,destruction,12,6,6
Zedonius,dragonmaw,576,warlock,destruction,12,6,6
Betrili,tichondrius,576,warlock,destruction,12,6,6
Lri,frostmourne,576,warlock,destruction,12,6,6
Shigero,tichondrius,576,warlock,destruction,12,6,6
Ritua,dragonmaw,576,warlock,destruction,12,6,6
Huajianmanwu,tichondrius,576,warlock,destruction,12,6,6
Legallydan,tichondrius,576,warlock,destruction,12,6,6
Justignoreme,tichondrius,576,warlock,destruction,12,6,6
Iemonv,vashj,576,warlock,destruction,12,6,6
Eboknight,area-52,576,warlock,destruction,12,6,6
Girthlock,tichondrius,576,warlock,destruction,12,6,6
Gagitha,black-dragonflight,576,warlock,destruction,12,6,6
Cosmosxi,illidan,576,warlock,destruction,12,6,6
Gagh,tichondrius,576,warlock,destruction,12,6,6
Äbolished,illidan,576,warlock,destruction,12,6,6
Medusablood,area-52,576,warlock,destruction,12,6,6
Bléssédx,tichondrius,576,warlock,destruction,12,6,6
Ellipsispain,bleeding-hollow,576,warlock,destruction,13,6,7
Marinw,azralon,576,warlock,destruction,16,7,9
Indrah,tichondrius,576,warlock,destruction,14,6,8
Emptysoul,illidan,576,warlock,destruction,18,6,12
Coviddotsrot,sargeras,576,warlock,destruction,18,6,12
Møs,proudmoore,576,warlock,destruction,18,6,12
Lamdyn,moon-guard,576,warlock,destruction,18,6,12
Moxilli,malganis,576,warlock,destruction,18,6,12
Wzrdtrx,deathwing,576,warlock,destruction,18,6,12
Curaven,emerald-dream,576,warlock,destruction,18,6,12
Tenletters,kirin-tor,576,warlock,destruction,18,6,12
Plutheros,stormrage,576,warlock,destruction,18,6,12
Evianne,skywall,576,warlock,destruction,18,6,12
Esoteríc,sargeras,576,warlock,destruction,18,6,12
Klisman,azralon,576,warlock,destruction,18,6,12
Decentraland,tichondrius,576,warlock,destruction,18,6,12
Jinxdacat,shandris,576,warlock,destruction,18,6,12
Lenestus,stormrage,576,warlock,destruction,18,6,12
Berszerk,quelthalas,576,warlock,destruction,18,6,12
Lõck,tichondrius,576,warlock,destruction,18,6,12
Kkuldan,tichondrius,576,warlock,destruction,24,6,18
Rosebolt,nemesis,575,warlock,destruction,6,6,0
Drlocktastic,vashj,575,warlock,destruction,6,6,0
Spamfearftw,sargeras,575,warlock,destruction,6,6,0
Williwallace,stormrage,575,warlock,destruction,12,6,6
Exedrin,wyrmrest-accord,575,warlock,destruction,12,6,6
Mium,bronzebeard,575,warlock,destruction,12,6,6
Tidepodd,bonechewer,575,warlock,destruction,12,6,6
Feldubya,illidan,575,warlock,destruction,12,6,6
Cheekzz,illidan,575,warlock,destruction,12,6,6
Pegorn,illidan,575,warlock,destruction,12,6,6
Ifeludead,sargeras,575,warlock,destruction,12,6,6
Baphomët,tichondrius,575,warlock,destruction,12,6,6
Daimon,kaelthas,575,warlock,destruction,12,6,6
Noslock,aegwynn,575,warlock,destruction,12,6,6
Rathianna,sargeras,575,warlock,destruction,12,6,6
Lockswagger,stormrage,575,warlock,destruction,12,6,6
Pactman,sargeras,575,warlock,destruction,12,6,6
Kdoggydogg,azshara,575,warlock,destruction,12,6,6
Méhoe,bleeding-hollow,575,warlock,destruction,12,6,6
Mastroguise,illidan,575,warlock,destruction,15,6,9
Benbuttons,sargeras,575,warlock,destruction,21,7,14
Selitose,illidan,575,warlock,destruction,18,6,12
Yetiaids,tichondrius,575,warlock,destruction,18,6,12
Balasar,cenarion-circle,575,warlock,destruction,18,6,12
Oluluo,andorhal,575,warlock,destruction,18,6,12
Leno,twisting-nether,575,warlock,destruction,18,6,12
Dotsamoray,frostmourne,575,warlock,destruction,24,6,18
Ëliphas,tichondrius,575,warlock,destruction,24,6,18
Gulliftonan,zuljin,575,warlock,destruction,24,6,18
Trayga,illidan,574,warlock,destruction,6,6,0
Ggumx,tichondrius,574,warlock,destruction,12,6,6
Tesdeez,tichondrius,574,warlock,destruction,12,6,6
Persephoné,blackrock,574,warlock,destruction,12,6,6
Hungovermate,barthilas,574,warlock,destruction,12,6,6
Silkxy,frostwolf,574,warlock,destruction,12,6,6
Kronman,zuluhed,574,warlock,destruction,18,6,12
Träzyn,kiljaeden,574,warlock,destruction,18,6,12
Teedub,thrall,574,warlock,destruction,18,6,12
Anúbis,farstriders,574,warlock,destruction,18,6,12
Zahba,stormrage,572,warlock,destruction,12,6,6
Supercracker,bleeding-hollow,572,warlock,destruction,18,6,12
Mageline,thrall,567,warlock,destruction,24,6,18
Expiredonion,bleeding-hollow,559,warlock,destruction,11,6,5
Friend,frostmourne,559,warlock,destruction,17,6,11
Märshall,quelthalas,543,warlock,destruction,10,7,3
Aoepump,tichondrius,543,warlock,destruction,12,6,6
Malékíth,ragnaros,528,warlock,destruction,9,6,3
Promancer,drakkari,528,warlock,destruction,9,6,3
Sixxlol,malganis,527,warlock,destruction,11,6,5
Loch,destromath,527,warlock,destruction,11,6,5
Watchdatfear,dragonmaw,527,warlock,destruction,11,6,5
Exillis,barthilas,527,warlock,destruction,17,6,11
Ebo,bloodscalp,527,warlock,destruction,21,6,15
Tangslock,skullcrusher,526,warlock,destruction,17,6,11
Catraca,sargeras,524,warlock,destruction,15,7,8
Tesowenn,tichondrius,522,warlock,destruction,15,7,8
Dotznfearz,zuljin,521,warlock,destruction,16,8,8
Redmil,quelthalas,520,warlock,destruction,35,7,28
Locdup,sargeras,512,warlock,destruction,22,6,16
Lunazz,tichondrius,511,warlock,destruction,11,7,4
Wompastompah,tanaris,511,warlock,destruction,20,6,14
Ràistlin,madoran,494,warlock,destruction,11,6,5
Patoquenz,azralon,480,warlock,destruction,6,5,1
Ikite,zuljin,480,warlock,destruction,6,5,1
Zoljinn,frostwolf,480,warlock,destruction,6,5,1
Omnimetus,bleeding-hollow,480,warlock,destruction,6,5,1
Poonanifotm,gundrak,480,warlock,destruction,6,5,1
Cannaboltzz,icecrown,480,warlock,destruction,6,5,1
Kargos,bonechewer,480,warlock,destruction,6,5,1
Bendejo,thrall,480,warlock,destruction,6,5,1
Donutx,illidan,480,warlock,destruction,6,5,1
Stachybotrys,burning-blade,480,warlock,destruction,6,5,1
Salaszar,illidan,480,warlock,destruction,6,5,1
Frylockx,mugthol,480,warlock,destruction,6,5,1
Púp,bleeding-hollow,480,warlock,destruction,6,5,1
Nerflocks,azralon,480,warlock,destruction,6,5,1
Evilforce,area-52,480,warlock,destruction,6,5,1
Efuc,tichondrius,480,warlock,destruction,6,5,1
Phyxylock,stormrage,480,warlock,destruction,6,5,1
Onidium,area-52,480,warlock,destruction,6,5,1
Mathindis,ragnaros,480,warlock,destruction,6,5,1
Cuteasianpov,kiljaeden,480,warlock,destruction,6,5,1
Kopium,tichondrius,480,warlock,destruction,6,5,1
Shortnproud,tichondrius,480,warlock,destruction,6,5,1
Akudama,dalaran,480,warlock,destruction,6,5,1
Lucro,emerald-dream,480,warlock,destruction,6,5,1
Jalean,illidan,480,warlock,destruction,6,5,1
Matdemonn,barthilas,480,warlock,destruction,6,5,1
Novah,balnazzar,480,warlock,destruction,6,5,1
Foxbolt,tichondrius,480,warlock,destruction,6,5,1
Djae,frostmourne,480,warlock,destruction,6,5,1
Panndadots,tichondrius,480,warlock,destruction,6,5,1
Zerocastspec,tichondrius,480,warlock,destruction,6,5,1
Morsecode,illidan,480,warlock,destruction,6,5,1
Pickles,kaelthas,480,warlock,destruction,6,5,1
Awdam,tichondrius,480,warlock,destruction,6,5,1
Zerefel,stormrage,480,warlock,destruction,6,5,1
Dippindotz,scilla,480,warlock,destruction,6,5,1
Meddsurgx,emerald-dream,480,warlock,destruction,6,5,1
Cloperry,area-52,480,warlock,destruction,6,5,1
Oreganow,icecrown,480,warlock,destruction,6,5,1
Cheesëbolt,illidan,480,warlock,destruction,6,5,1
Chewybolt,illidan,480,warlock,destruction,6,5,1
Nutted,dentarg,480,warlock,destruction,6,5,1
Ricemachinex,grizzly-hills,480,warlock,destruction,6,5,1
Halftism,sargeras,480,warlock,destruction,6,5,1
Popnloc,tichondrius,480,warlock,destruction,6,5,1
Leîa,tichondrius,480,warlock,destruction,6,5,1
Dingis,bloodscalp,480,warlock,destruction,6,5,1
Geeßoogie,laughing-skull,480,warlock,destruction,6,5,1
Yuckytoetoe,emerald-dream,480,warlock,destruction,6,5,1
Humblegodd,illidan,480,warlock,destruction,6,5,1
Mørøs,tichondrius,480,warlock,destruction,6,5,1
Arnan,korgath,480,warlock,destruction,6,5,1
Balencinaga,frostmourne,480,warlock,destruction,6,5,1
Babyvet,stormreaver,480,warlock,destruction,6,5,1
Chaosbud,tichondrius,480,warlock,destruction,6,5,1
Kss,quelthalas,480,warlock,destruction,6,5,1
Pantubølt,stormrage,480,warlock,destruction,6,5,1
Yateshall,illidan,480,warlock,destruction,6,5,1
Unicornspit,tichondrius,480,warlock,destruction,6,5,1
Sully,korgath,480,warlock,destruction,6,5,1
Frogdance,stormrage,480,warlock,destruction,6,5,1
Darknuker,wyrmrest-accord,480,warlock,destruction,6,5,1
Destructium,stormrage,480,warlock,destruction,6,5,1
Tiddliwinx,nordrassil,480,warlock,destruction,7,5,2
Elementzero,malorne,480,warlock,destruction,11,5,6
Daemonixx,vashj,480,warlock,destruction,12,5,7
Lildottythot,malganis,480,warlock,destruction,12,5,7
Flayaz,bleeding-hollow,480,warlock,destruction,12,5,7
Scalaakka,proudmoore,480,warlock,destruction,12,5,7
Darezs,frostmourne,480,warlock,destruction,12,5,7
Yurick,frostmourne,480,warlock,destruction,12,5,7
Hyjixy,stormrage,480,warlock,destruction,12,5,7
Ilxxllxxll,area-52,480,warlock,destruction,12,5,7
Ascendant,amanthul,480,warlock,destruction,12,5,7
Kubera,mannoroth,480,warlock,destruction,12,5,7
Souljäboy,bleeding-hollow,480,warlock,destruction,12,5,7
Gruldan,drakkari,480,warlock,destruction,12,5,7
Pabloqlx,ragnaros,480,warlock,destruction,12,5,7
Aurdra,thunderhorn,480,warlock,destruction,12,5,7
Dignifie,area-52,480,warlock,destruction,12,5,7
Pveisboring,tichondrius,480,warlock,destruction,12,5,7
Jenová,uldaman,480,warlock,destruction,12,5,7
Toxishk,tichondrius,480,warlock,destruction,12,5,7
Pikvas,darkspear,480,warlock,destruction,12,5,7
Soulswap,deathwing,480,warlock,destruction,12,5,7
Lockwell,tichondrius,480,warlock,destruction,12,5,7
Qfear,tichondrius,480,warlock,destruction,12,5,7
Icemanliddel,area-52,480,warlock,destruction,12,5,7
Jaydero,lightbringer,480,warlock,destruction,12,5,7
Hoonjojjyanl,tichondrius,480,warlock,destruction,12,5,7
Imhereforrbg,moon-guard,480,warlock,destruction,12,5,7
Lockandload,malfurion,480,warlock,destruction,12,5,7
Seraphserius,laughing-skull,480,warlock,destruction,12,5,7
Gundrillas,area-52,480,warlock,destruction,12,5,7
Ededneddy,tichondrius,480,warlock,destruction,12,5,7
Lilthicy,sargeras,480,warlock,destruction,12,5,7
Geists,emerald-dream,480,warlock,destruction,12,5,7
Balden,fenris,480,warlock,destruction,12,5,7
Bludlock,illidan,480,warlock,destruction,12,5,7
Gallynna,moon-guard,480,warlock,destruction,12,5,7
Macnab,malganis,480,warlock,destruction,12,5,7
Jakd,frostmourne,480,warlock,destruction,12,5,7
Gameface,garrosh,480,warlock,destruction,12,5,7
Buccs,barthilas,480,warlock,destruction,12,5,7
Exitiumm,malygos,480,warlock,destruction,12,5,7
Gouzenko,emerald-dream,480,warlock,destruction,12,5,7
Eneraxg,proudmoore,480,warlock,destruction,12,5,7
Shadowflame,skullcrusher,480,warlock,destruction,12,5,7
Cycaeria,moon-guard,480,warlock,destruction,12,5,7
Psionyde,barthilas,480,warlock,destruction,12,5,7
Bellgrande,shadowmoon,480,warlock,destruction,12,5,7
Richards,thrall,480,warlock,destruction,12,5,7
Marothredd,nathrezim,480,warlock,destruction,12,5,7
Dalanllan,wyrmrest-accord,480,warlock,destruction,12,5,7
Chaoz,aggramar,480,warlock,destruction,12,5,7
Murphyslawl,skullcrusher,480,warlock,destruction,12,5,7
Wombogombo,malganis,480,warlock,destruction,12,5,7
Zugzor,shadowmoon,480,warlock,destruction,12,5,7
Hellweaver,amanthul,480,warlock,destruction,12,5,7
Zalurk,emerald-dream,480,warlock,destruction,12,5,7
Errogant,area-52,480,warlock,destruction,12,5,7
Firulock,azralon,480,warlock,destruction,12,5,7
Galeirria,stormrage,480,warlock,destruction,12,5,7
Archleon,smolderthorn,480,warlock,destruction,12,5,7
Avoidahoe,sargeras,480,warlock,destruction,12,5,7
Topboypepito,tichondrius,480,warlock,destruction,12,5,7
Totsdots,blackrock,480,warlock,destruction,12,5,7
Nelamona,moon-guard,480,warlock,destruction,12,5,7
Respecter,kelthuzad,480,warlock,destruction,12,5,7
Gnimms,sargeras,480,warlock,destruction,12,5,7
Cadejo,emerald-dream,480,warlock,destruction,12,5,7
Locknes,kiljaeden,480,warlock,destruction,12,5,7
Enforcer,hellscream,480,warlock,destruction,12,5,7
Halfmade,tichondrius,480,warlock,destruction,12,5,7
Speakeasy,malygos,480,warlock,destruction,12,5,7
Marbuldan,frostmourne,480,warlock,destruction,12,5,7
Sukmalock,proudmoore,480,warlock,destruction,15,6,9
Maarzil,malygos,480,warlock,destruction,16,6,10
Malevictus,deathwing,480,warlock,destruction,18,5,13
Teajools,area-52,480,warlock,destruction,18,5,13
Luntrazz,arthas,480,warlock,destruction,18,5,13
Vicnutz,tichondrius,480,warlock,destruction,18,5,13
Skrillhex,dragonmaw,479,warlock,destruction,6,5,1
Lockystar,malganis,479,warlock,destruction,6,5,1
Grix,uldaman,479,warlock,destruction,12,5,7
Vordz,amanthul,479,warlock,destruction,12,5,7
Loccdawg,laughing-skull,479,warlock,destruction,12,5,7
Apothokary,stormrage,479,warlock,destruction,12,5,7
Ragnorök,medivh,479,warlock,destruction,12,5,7
Deecon,stormscale,479,warlock,destruction,12,5,7
Aluridan,azralon,479,warlock,destruction,12,5,7
Kiami,destromath,479,warlock,destruction,12,5,7
Kelici,borean-tundra,479,warlock,destruction,12,5,7
Osteogenesis,quelthalas,479,warlock,destruction,12,5,7
Karkloc,stormrage,479,warlock,destruction,18,5,13
Clias,galakrond,479,warlock,destruction,18,5,13
Daemonddred,hakkar,479,warlock,destruction,18,5,13
Moorrt,dragonblight,478,warlock,destruction,12,5,7
Giled,runetotem,478,warlock,destruction,12,5,7
Saintvil,drakkari,477,warlock,destruction,6,5,1
Warrogoblin,ragnaros,476,warlock,destruction,9,6,3
Blázê,illidan,476,warlock,destruction,12,5,7
Mystickittie,aerie-peak,475,warlock,destruction,12,5,7
Raven,baelgun,463,warlock,destruction,11,5,6
Anubís,vashj,462,warlock,destruction,11,5,6
Bitblack,tichondrius,453,warlock,destruction,13,7,6
Magniwl,zuljin,447,warlock,destruction,11,5,6
ßolts,frostmourne,447,warlock,destruction,11,5,6
Theshattered,kiljaeden,447,warlock,destruction,11,5,6
Britnyfears,korgath,447,warlock,destruction,16,5,11
Djvetis,blackhand,442,warlock,destruction,15,7,8
Fengfeiss,tichondrius,432,warlock,destruction,15,6,9
Twinkies,tichondrius,431,warlock,destruction,11,5,6
Berathelok,aerie-peak,426,warlock,destruction,17,6,11
Empowerdlock,garrosh,416,warlock,destruction,10,5,5
Erazero,illidan,416,warlock,destruction,16,5,11
Krozu,bleeding-hollow,415,warlock,destruction,14,5,9
Velsona,moon-guard,415,warlock,destruction,14,5,9
Lockdlhm,tichondrius,400,warlock,destruction,13,5,8
Drainerade,stormreaver,399,warlock,destruction,5,5,0
ßenafflock,wyrmrest-accord,399,warlock,destruction,14,5,9
Apocoly,tichondrius,384,warlock,destruction,9,6,3
Ozidus,tichondrius,384,warlock,destruction,6,4,2
Biger,nemesis,384,warlock,destruction,6,4,2
Dötsonurpp,stormrage,384,warlock,destruction,6,4,2
Doubledigit,tichondrius,384,warlock,destruction,6,4,2
Dçíöçk,tichondrius,384,warlock,destruction,6,4,2
Drgiggles,tichondrius,384,warlock,destruction,6,4,2
Korguji,tichondrius,384,warlock,destruction,6,4,2
Underchicken,blackrock,384,warlock,destruction,6,4,2
Rendori,the-scryers,384,warlock,destruction,6,4,2
Bigbadbolt,thaurissan,384,warlock,destruction,6,4,2
Tichondrus,ragnaros,384,warlock,destruction,6,4,2
Methrocks,emerald-dream,384,warlock,destruction,6,4,2
Dematic,illidan,384,warlock,destruction,6,4,2
Cursebolt,tichondrius,384,warlock,destruction,6,4,2
Anthaxel,dalaran,384,warlock,destruction,6,4,2
Fearann,ragnaros,384,warlock,destruction,6,4,2
Ñever,winterhoof,384,warlock,destruction,6,4,2
Slappndemons,mugthol,384,warlock,destruction,6,4,2
Ardamelech,quelthalas,384,warlock,destruction,6,4,2
Décalisse,eonar,384,warlock,destruction,6,4,2
Solöw,tichondrius,384,warlock,destruction,6,4,2
Eliquis,frostmane,384,warlock,destruction,6,4,2
Saitibolty,dalaran,384,warlock,destruction,6,4,2
Locktardoe,thrall,384,warlock,destruction,6,4,2
Asiopdu,tichondrius,384,warlock,destruction,6,4,2
Oldgodkiller,kelthuzad,384,warlock,destruction,6,4,2
Houseofpain,emerald-dream,384,warlock,destruction,6,4,2
Asukakira,tichondrius,384,warlock,destruction,6,4,2
Pokendot,illidan,384,warlock,destruction,6,4,2
Agla,quelthalas,384,warlock,destruction,6,4,2
Hawtchili,illidan,384,warlock,destruction,6,4,2
Smnslock,emerald-dream,384,warlock,destruction,6,4,2
Erock,korgath,384,warlock,destruction,6,4,2
Syraxi,illidan,384,warlock,destruction,6,4,2
Dastruct,tichondrius,384,warlock,destruction,6,4,2
Roota,dalaran,384,warlock,destruction,6,4,2
Thelynx,chogall,384,warlock,destruction,6,4,2
Bertnasty,tichondrius,384,warlock,destruction,6,4,2
Anorex,area-52,384,warlock,destruction,6,4,2
Tumßle,stormreaver,384,warlock,destruction,6,4,2
Rodneyjones,emerald-dream,384,warlock,destruction,6,4,2
Norastrum,area-52,384,warlock,destruction,6,4,2
Arckádia,stormrage,384,warlock,destruction,6,4,2
Fearoshimá,thrall,384,warlock,destruction,6,4,2
Khaos,norgannon,384,warlock,destruction,6,4,2
Kractdlk,tichondrius,384,warlock,destruction,6,4,2
Dottcom,laughing-skull,384,warlock,destruction,6,4,2
Gordoxin,area-52,384,warlock,destruction,6,4,2
Toomanymind,stormrage,384,warlock,destruction,6,4,2
Siltharious,senjin,384,warlock,destruction,6,4,2
Døzër,area-52,384,warlock,destruction,6,4,2
Bedtimes,tichondrius,384,warlock,destruction,6,4,2
Bigdd,frostmane,384,warlock,destruction,6,4,2
Laytome,stormreaver,384,warlock,destruction,6,4,2
Zuroghar,azralon,384,warlock,destruction,6,4,2
Instababe,stormrage,384,warlock,destruction,6,4,2
Fatherbolt,tichondrius,384,warlock,destruction,6,4,2
Magvezx,kelthuzad,384,warlock,destruction,6,4,2
Lîlý,bleeding-hollow,384,warlock,destruction,6,4,2
Aussiesauce,frostmourne,384,warlock,destruction,6,4,2
Tizzy,malganis,384,warlock,destruction,6,4,2
Brokenaf,stormrage,384,warlock,destruction,6,4,2
Zevoc,tichondrius,384,warlock,destruction,6,4,2
Elkane,area-52,384,warlock,destruction,6,4,2
Zërlina,area-52,384,warlock,destruction,6,4,2
Frem,eonar,384,warlock,destruction,6,4,2
Antagony,bleeding-hollow,384,warlock,destruction,6,4,2
Carielict,sargeras,384,warlock,destruction,6,4,2
Asalaviik,illidan,384,warlock,destruction,6,4,2
Xijp,illidan,384,warlock,destruction,6,4,2
Æzi,tichondrius,384,warlock,destruction,6,4,2
Moistpoodle,the-underbog,384,warlock,destruction,6,4,2
Vaynnei,kiljaeden,384,warlock,destruction,6,4,2
Slakiejr,darkspear,384,warlock,destruction,6,4,2
Dranyam,ragnaros,384,warlock,destruction,6,4,2
Leyzer,stormrage,384,warlock,destruction,6,4,2
Gamenine,tichondrius,384,warlock,destruction,6,4,2
Deathtones,moon-guard,384,warlock,destruction,6,4,2
Menedemus,amanthul,384,warlock,destruction,6,4,2
Sheetzlock,azgalor,384,warlock,destruction,6,4,2
Woofbolt,malganis,384,warlock,destruction,6,4,2
Ðöts,frostmourne,384,warlock,destruction,6,4,2
Tazerr,sargeras,384,warlock,destruction,6,4,2
Bugbugg,tichondrius,384,warlock,destruction,6,4,2
Quetzâlcoâtl,sargeras,384,warlock,destruction,6,4,2
Naginikill,zuljin,384,warlock,destruction,6,4,2
Donttouchme,azralon,384,warlock,destruction,6,4,2
Bigherobolts,tichondrius,384,warlock,destruction,6,4,2
Calcadius,zuljin,384,warlock,destruction,6,4,2
Gobvoca,bleeding-hollow,384,warlock,destruction,6,4,2
Eatmybeef,ravencrest,384,warlock,destruction,6,4,2
Smallj,zuljin,384,warlock,destruction,6,4,2
Leekeeaynis,frostmourne,384,warlock,destruction,6,4,2
Mmrceo,azgalor,384,warlock,destruction,6,4,2
Darkguile,kiljaeden,384,warlock,destruction,6,4,2
Sprenn,bleeding-hollow,384,warlock,destruction,6,4,2
Alwysoom,aegwynn,384,warlock,destruction,6,4,2
Ceeloww,illidan,384,warlock,destruction,6,4,2
Lockiana,zuljin,384,warlock,destruction,6,4,2
Warlocksz,kelthuzad,384,warlock,destruction,6,4,2
Moramont,stormrage,384,warlock,destruction,6,4,2
Litemeatlary,kelthuzad,384,warlock,destruction,6,4,2
Gidelend,daggerspine,384,warlock,destruction,6,4,2
Sylvahh,sargeras,384,warlock,destruction,6,4,2
Crackhammer,sargeras,384,warlock,destruction,6,4,2
Wonderlocks,sargeras,384,warlock,destruction,6,4,2
Mattybolts,tichondrius,384,warlock,destruction,6,4,2
Chumbing,sargeras,384,warlock,destruction,6,4,2
Iplaywarlock,deathwing,384,warlock,destruction,6,4,2
Wiredftwx,illidan,384,warlock,destruction,6,4,2
Marrowsipper,tichondrius,384,warlock,destruction,6,4,2
Warfeen,malganis,384,warlock,destruction,6,4,2
Incantation,moon-guard,384,warlock,destruction,6,4,2
Wallzz,gnomeregan,384,warlock,destruction,6,4,2
Vilebrute,illidan,384,warlock,destruction,6,4,2
Apoklock,area-52,384,warlock,destruction,6,4,2
Fyahwalka,aggramar,384,warlock,destruction,6,4,2
Hoana,azralon,384,warlock,destruction,6,4,2
Barhathion,ragnaros,384,warlock,destruction,6,4,2
Jerothia,lethon,384,warlock,destruction,6,4,2
Cønsfèáracy,sargeras,384,warlock,destruction,6,4,2
Darkfæ,kaelthas,384,warlock,destruction,6,4,2
Fatuglyegirl,sargeras,384,warlock,destruction,6,4,2
Wreckquiem,burning-blade,384,warlock,destruction,6,4,2
Zonss,tichondrius,384,warlock,destruction,6,4,2
Meathat,gorefiend,384,warlock,destruction,9,5,4
Soulfired,kiljaeden,384,warlock,destruction,11,5,6
Rhaègar,kiljaeden,384,warlock,destruction,15,5,10
Awangdemon,tichondrius,384,warlock,destruction,12,4,8
Kelthutard,area-52,384,warlock,destruction,12,4,8
Lila,kaelthas,384,warlock,destruction,12,4,8
Pitou,akama,384,warlock,destruction,12,4,8
Famouslos,anetheron,384,warlock,destruction,12,4,8
Letsfckingo,tichondrius,384,warlock,destruction,12,4,8
Oxtheog,sargeras,384,warlock,destruction,12,4,8
Maleficist,bleeding-hollow,384,warlock,destruction,12,4,8
Perfidien,tichondrius,384,warlock,destruction,12,4,8
Darksòúl,stormrage,384,warlock,destruction,12,4,8
Lockeando,ragnaros,384,warlock,destruction,12,4,8
Praemonium,dalaran,384,warlock,destruction,12,4,8
Bjarke,malganis,384,warlock,destruction,12,4,8
Snailbite,tichondrius,384,warlock,destruction,12,4,8
Catastrophk,malganis,384,warlock,destruction,12,4,8
Sailuhh,frostwolf,384,warlock,destruction,12,4,8
Overlard,illidan,384,warlock,destruction,12,4,8
Puddulz,thrall,384,warlock,destruction,12,4,8
Nazrakin,malganis,384,warlock,destruction,12,4,8
Capïrota,nemesis,384,warlock,destruction,12,4,8
Demowolock,area-52,384,warlock,destruction,12,4,8
Daedayus,frostwolf,384,warlock,destruction,12,4,8
Offendor,stormrage,384,warlock,destruction,12,4,8
Malavik,moon-guard,384,warlock,destruction,12,4,8
Trumpthicc,tichondrius,384,warlock,destruction,12,4,8
Niétzsché,emerald-dream,384,warlock,destruction,12,4,8
Aededa,proudmoore,384,warlock,destruction,12,4,8
Jáws,zuljin,384,warlock,destruction,12,4,8
Medraut,wyrmrest-accord,384,warlock,destruction,12,4,8
Giggideez,bleeding-hollow,384,warlock,destruction,12,4,8
Blumercricet,stormrage,384,warlock,destruction,12,4,8
Veyra,malganis,384,warlock,destruction,12,4,8
Syileria,frostmourne,384,warlock,destruction,12,4,8
Dotington,frostmourne,384,warlock,destruction,12,4,8
Stonelocke,area-52,384,warlock,destruction,12,4,8
Antigotenent,sargeras,384,warlock,destruction,12,4,8
Speedlock,daggerspine,384,warlock,destruction,12,4,8
Dpz,darkspear,384,warlock,destruction,12,4,8
Rumpology,illidan,384,warlock,destruction,12,4,8
Mostlyundead,darkspear,384,warlock,destruction,12,4,8
Kaísta,proudmoore,384,warlock,destruction,12,4,8
Panicmode,darkspear,384,warlock,destruction,12,4,8
Outkãst,illidan,384,warlock,destruction,12,4,8
Fullmelt,azjolnerub,384,warlock,destruction,12,4,8
Freezâ,stormrage,384,warlock,destruction,12,4,8
Madamenapalm,wyrmrest-accord,384,warlock,destruction,12,4,8
Crafterism,barthilas,384,warlock,destruction,12,4,8
Hollows,burning-blade,384,warlock,destruction,12,4,8
Flocka,agamaggan,384,warlock,destruction,12,4,8
Lockandestro,tichondrius,384,warlock,destruction,12,4,8
Evarona,gorefiend,384,warlock,destruction,12,4,8
Æonas,bladefist,384,warlock,destruction,12,4,8
Theboss,arygos,384,warlock,destruction,12,4,8
Nintendøt,malganis,384,warlock,destruction,12,4,8
Poisondeepnu,malganis,384,warlock,destruction,12,4,8
Fowll,frostwolf,384,warlock,destruction,12,4,8
Stepmommie,moon-guard,384,warlock,destruction,12,4,8
Capslockfury,frostmourne,384,warlock,destruction,12,4,8
Twospliff,sargeras,384,warlock,destruction,16,5,11
Mozbet,kiljaeden,384,warlock,destruction,13,4,9
Fex,hyjal,384,warlock,destruction,14,4,10
Kholdstarev,thunderlord,384,warlock,destruction,18,4,14
Pvman,onyxia,384,warlock,destruction,18,4,14
Persianloc,tichondrius,384,warlock,destruction,18,4,14
Destroyaz,stormreaver,383,warlock,destruction,6,4,2
Halkroz,nathrezim,383,warlock,destruction,6,4,2
Pointproven,tichondrius,383,warlock,destruction,6,4,2
Gorski,frostwolf,383,warlock,destruction,6,4,2
Stonelocker,stormrage,383,warlock,destruction,6,4,2
Arthürr,thrall,383,warlock,destruction,12,4,8
Wodinskol,sargeras,383,warlock,destruction,12,4,8
Trilleon,eldrethalas,383,warlock,destruction,12,4,8
Sinissa,ysondre,383,warlock,destruction,12,4,8
Locnload,bonechewer,383,warlock,destruction,12,4,8
Covidbussin,cenarius,383,warlock,destruction,12,4,8
Fearanddots,moon-guard,383,warlock,destruction,12,4,8
Coheatt,hyjal,383,warlock,destruction,12,4,8
Loçkshow,hyjal,383,warlock,destruction,12,4,8
Albuuss,daggerspine,383,warlock,destruction,12,4,8
Downing,drakkari,383,warlock,destruction,12,4,8
Eliphas,bronzebeard,383,warlock,destruction,12,4,8
Asheräh,stormrage,383,warlock,destruction,12,4,8
Gängrëna,azralon,383,warlock,destruction,12,4,8
Yesmistress,thrall,383,warlock,destruction,14,4,10
Necromaniac,nerzhul,383,warlock,destruction,18,4,14
Sargrath,ragnaros,381,warlock,destruction,12,4,8
Ðêcimatê,frostmourne,361,warlock,destruction,12,6,6
Plaguelnc,illidan,352,warlock,destruction,10,5,5
Maxfx,tichondrius,351,warlock,destruction,8,5,3
Startx,tichondrius,351,warlock,destruction,11,4,7
Voodoowan,bleeding-hollow,351,warlock,destruction,11,4,7
Vetic,area-52,351,warlock,destruction,11,4,7
Cronobolts,stormrage,351,warlock,destruction,11,4,7
Vanvídd,ragnaros,351,warlock,destruction,11,4,7
Cyrillus,moon-guard,351,warlock,destruction,11,4,7
Auntzhang,tichondrius,351,warlock,destruction,23,4,19
Shidded,lightbringer,349,warlock,destruction,10,5,5
Gobbledeez,moknathal,349,warlock,destruction,19,5,14
Kidneystone,emerald-dream,346,warlock,destruction,17,8,9
Amaroth,spinebreaker,335,warlock,destruction,11,4,7
Voltrakk,gilneas,330,warlock,destruction,11,7,4
Sooshi,malganis,330,warlock,destruction,11,6,5
Lockazo,quelthalas,330,warlock,destruction,11,6,5
Actualjoke,frostmourne,330,warlock,destruction,15,6,9
Casusita,area-52,322,warlock,destruction,16,6,10
Rosacrutian,tichondrius,320,warlock,destruction,10,4,6
Sojulord,sargeras,320,warlock,destruction,10,4,6
Saintläurent,bleeding-hollow,319,warlock,destruction,5,4,1
Nokturnal,norgannon,303,warlock,destruction,13,4,9
Nortx,kiljaeden,288,warlock,destruction,6,3,3
Mamabolts,kelthuzad,288,warlock,destruction,6,3,3
Bunami,kiljaeden,288,warlock,destruction,6,3,3
Purraisa,tichondrius,288,warlock,destruction,6,3,3
Drelgun,aerie-peak,288,warlock,destruction,6,3,3
Unquit,frostmourne,288,warlock,destruction,6,3,3
Bothered,bleeding-hollow,288,warlock,destruction,6,3,3
Fakecastxøxø,drakkari,288,warlock,destruction,6,3,3
Meltingface,bleeding-hollow,288,warlock,destruction,6,3,3
Demtros,tichondrius,288,warlock,destruction,6,3,3
Creedmore,sargeras,288,warlock,destruction,6,3,3
Wickdways,daggerspine,288,warlock,destruction,6,3,3
Graveland,frostwolf,288,warlock,destruction,6,3,3
Oleg,bleeding-hollow,288,warlock,destruction,6,3,3
Nòpê,tichondrius,288,warlock,destruction,6,3,3
Poggyjones,tichondrius,288,warlock,destruction,6,3,3
Ÿoucantwin,kiljaeden,288,warlock,destruction,6,3,3
Larsiezwei,spirestone,288,warlock,destruction,6,3,3
Sweetgreen,area-52,288,warlock,destruction,6,3,3
Hamdulla,tichondrius,288,warlock,destruction,6,3,3
Fungiforest,kelthuzad,288,warlock,destruction,6,3,3
Voldamorte,tichondrius,288,warlock,destruction,6,3,3
Blaxzlock,stormscale,288,warlock,destruction,6,3,3
Tamzlock,the-forgotten-coast,288,warlock,destruction,6,3,3
Spacemonkey,malganis,288,warlock,destruction,6,3,3
Nihilus,anvilmar,288,warlock,destruction,6,3,3
Ratedtorgast,illidan,288,warlock,destruction,6,3,3
Dotbot,blades-edge,288,warlock,destruction,6,3,3
Thisisturtle,area-52,288,warlock,destruction,6,3,3
Kebobz,frostmourne,288,warlock,destruction,6,3,3
Ketahole,warsong,288,warlock,destruction,6,3,3
Røckdeäth,sargeras,288,warlock,destruction,6,3,3
Maledictivus,stormrage,288,warlock,destruction,6,3,3
Slothdots,tichondrius,288,warlock,destruction,6,3,3
Xoroth,crushridge,288,warlock,destruction,6,3,3
Orelauk,rexxar,288,warlock,destruction,6,3,3
Dirtrox,tichondrius,288,warlock,destruction,6,3,3
Warlockluo,tichondrius,288,warlock,destruction,6,3,3
Xocxusegeic,illidan,288,warlock,destruction,6,3,3
Weaselherder,illidan,288,warlock,destruction,6,3,3
Geofar,bleeding-hollow,288,warlock,destruction,6,3,3
Skýnët,tichondrius,288,warlock,destruction,6,3,3
Tiptonb,tichondrius,288,warlock,destruction,6,3,3
Jaazmin,ragnaros,288,warlock,destruction,6,3,3
Shädowflame,bleeding-hollow,288,warlock,destruction,6,3,3
Vetadul,proudmoore,288,warlock,destruction,6,3,3
Nismo,trollbane,288,warlock,destruction,6,3,3
Worstname,hakkar,288,warlock,destruction,6,3,3
Sàill,tichondrius,288,warlock,destruction,6,3,3
Toxicatedz,azralon,288,warlock,destruction,6,3,3
Velzillia,zuljin,288,warlock,destruction,6,3,3
Miratrix,moon-guard,288,warlock,destruction,6,3,3
Rickylakess,ragnaros,288,warlock,destruction,6,3,3
Cleptomain,tichondrius,288,warlock,destruction,6,3,3
Ökïlôck,proudmoore,288,warlock,destruction,6,3,3
Trainwreck,sargeras,288,warlock,destruction,6,3,3
Felsgoodman,illidan,288,warlock,destruction,6,3,3
Picklecatz,barthilas,288,warlock,destruction,6,3,3
Papablasty,nagrand,288,warlock,destruction,6,3,3
Coret,moonrunner,288,warlock,destruction,6,3,3
Astarothe,proudmoore,288,warlock,destruction,6,3,3
Xbendover,proudmoore,288,warlock,destruction,6,3,3
Atheô,ragnaros,288,warlock,destruction,6,3,3
Lockhomes,azralon,288,warlock,destruction,6,3,3
Rexington,hyjal,288,warlock,destruction,6,3,3
Ärminvßuurën,barthilas,288,warlock,destruction,6,3,3
Päinoth,wyrmrest-accord,288,warlock,destruction,6,3,3
Shifulock,azralon,288,warlock,destruction,6,3,3
Feeltheviibe,zuljin,288,warlock,destruction,6,3,3
Pheríe,sargeras,288,warlock,destruction,6,3,3
Vìqtìm,kelthuzad,288,warlock,destruction,6,3,3
Háydn,azuremyst,288,warlock,destruction,6,3,3
Jangbii,tichondrius,288,warlock,destruction,6,3,3
Uwubolt,moon-guard,288,warlock,destruction,6,3,3
Ashtak,coilfang,288,warlock,destruction,6,3,3
Strax,shattered-hand,288,warlock,destruction,6,3,3
Xblessed,stormrage,288,warlock,destruction,6,3,3
Eiram,ragnaros,288,warlock,destruction,6,3,3
Bonermarrow,tichondrius,288,warlock,destruction,6,3,3
Bushmelded,tichondrius,288,warlock,destruction,6,3,3
Lcomi,tichondrius,288,warlock,destruction,6,3,3
Gümbÿ,illidan,288,warlock,destruction,6,3,3
Washeeba,tichondrius,288,warlock,destruction,6,3,3
Voldormort,uldaman,288,warlock,destruction,6,3,3
Vampydark,quelthalas,288,warlock,destruction,6,3,3
Mylock,andorhal,288,warlock,destruction,6,3,3
Anastadora,proudmoore,288,warlock,destruction,6,3,3
Neversoft,bleeding-hollow,288,warlock,destruction,6,3,3
Saffuky,frostmourne,288,warlock,destruction,6,3,3
Souldotz,proudmoore,288,warlock,destruction,6,3,3
Odelgabiana,area-52,288,warlock,destruction,6,3,3
Bellwulf,goldrinn,288,warlock,destruction,6,3,3
Shâdowman,stormrage,288,warlock,destruction,6,3,3
Babylung,bleeding-hollow,288,warlock,destruction,6,3,3
Blastindotz,frostmane,288,warlock,destruction,6,3,3
Sweetjezuz,barthilas,288,warlock,destruction,6,3,3
Lillpfudd,area-52,288,warlock,destruction,6,3,3
Keemy,tichondrius,288,warlock,destruction,6,3,3
Embraces,tichondrius,288,warlock,destruction,6,3,3
Krazyjay,bleeding-hollow,288,warlock,destruction,6,3,3
Nhudi,frostmourne,288,warlock,destruction,6,3,3
Youngblood,maelstrom,288,warlock,destruction,6,3,3
Ovoíd,area-52,288,warlock,destruction,6,3,3
Cocoabuttâ,stormrage,288,warlock,destruction,6,3,3
Muchopower,ragnaros,288,warlock,destruction,6,3,3
Stretchmark,stormrage,288,warlock,destruction,6,3,3
Mileyswift,kelthuzad,288,warlock,destruction,6,3,3
Signalnine,thrall,288,warlock,destruction,6,3,3
Tacolock,azshara,288,warlock,destruction,6,3,3
Devi,destromath,288,warlock,destruction,6,3,3
Feardr,frostmourne,288,warlock,destruction,6,3,3
Carpedemon,malganis,288,warlock,destruction,6,3,3
Reyaena,moon-guard,288,warlock,destruction,6,3,3
Dohmie,argent-dawn,288,warlock,destruction,6,3,3
Massta,tichondrius,288,warlock,destruction,6,3,3
Æsidius,tichondrius,288,warlock,destruction,6,3,3
Dolcex,sargeras,288,warlock,destruction,6,3,3
Gingerlock,stonemaul,288,warlock,destruction,6,3,3
Lockaloga,azralon,288,warlock,destruction,6,3,3
Pennÿ,quelthalas,288,warlock,destruction,6,3,3
Jagni,stormrage,288,warlock,destruction,6,3,3
Vxms,barthilas,288,warlock,destruction,6,3,3
Thelock,tichondrius,288,warlock,destruction,6,3,3
Conboi,tichondrius,288,warlock,destruction,6,3,3
Homeschooler,darkspear,288,warlock,destruction,6,3,3
Hauntgød,tichondrius,288,warlock,destruction,6,3,3
Chesterfear,quelthalas,288,warlock,destruction,6,3,3
Dluttysots,emerald-dream,288,warlock,destruction,6,3,3
Attackbird,area-52,288,warlock,destruction,6,3,3
Vogez,boulderfist,288,warlock,destruction,6,3,3
Bazeni,frostmourne,288,warlock,destruction,6,3,3
Ijustsharded,area-52,288,warlock,destruction,6,3,3
Râsh,tichondrius,288,warlock,destruction,6,3,3
Itsawarlock,thunderlord,288,warlock,destruction,6,3,3
Chaosßolts,illidan,288,warlock,destruction,6,3,3
Dogcookie,moon-guard,288,warlock,destruction,6,3,3
Amuros,illidan,288,warlock,destruction,6,3,3
Turbocleave,blackwater-raiders,288,warlock,destruction,6,3,3
Dashaad,illidan,288,warlock,destruction,6,3,3
Watsfear,illidan,288,warlock,destruction,6,3,3
Lochek,stonemaul,288,warlock,destruction,6,3,3
Ñevaeh,emerald-dream,288,warlock,destruction,6,3,3
Eh,laughing-skull,288,warlock,destruction,6,3,3
Peterdotz,whisperwind,288,warlock,destruction,6,3,3
Amauder,moon-guard,288,warlock,destruction,6,3,3
Gotfear,zuljin,288,warlock,destruction,6,3,3
Hëctic,nerzhul,288,warlock,destruction,6,3,3
Nutzosaurus,darkspear,288,warlock,destruction,6,3,3
Sinsanìty,tichondrius,288,warlock,destruction,6,3,3
Famelol,tichondrius,288,warlock,destruction,6,3,3
Gurlock,illidan,288,warlock,destruction,6,3,3
Deejaye,frostmourne,288,warlock,destruction,6,3,3
Karter,anetheron,288,warlock,destruction,6,3,3
Reallygud,tichondrius,288,warlock,destruction,6,3,3
Ðëâthløck,tichondrius,288,warlock,destruction,6,3,3
Shawzyy,tichondrius,288,warlock,destruction,6,3,3
Dejagu,tichondrius,288,warlock,destruction,6,3,3
Minos,tichondrius,288,warlock,destruction,6,3,3
Metaphors,stormrage,288,warlock,destruction,6,3,3
Merlinsbeard,zuluhed,288,warlock,destruction,6,3,3
Phénom,tichondrius,288,warlock,destruction,6,3,3
Feartool,stormrage,288,warlock,destruction,6,3,3
Hairydottr,malganis,288,warlock,destruction,6,3,3
Mystrix,illidan,288,warlock,destruction,6,3,3
Crucifieds,tichondrius,288,warlock,destruction,6,3,3
Shadøwcrits,quelthalas,288,warlock,destruction,6,3,3
Siphoned,darkspear,288,warlock,destruction,6,3,3
Héllboy,akama,288,warlock,destruction,6,3,3
Sorath,blackrock,288,warlock,destruction,6,3,3
Xephostwo,area-52,288,warlock,destruction,6,3,3
Ladaa,tichondrius,288,warlock,destruction,6,3,3
Lockmetsu,area-52,288,warlock,destruction,6,3,3
Borudo,thrall,288,warlock,destruction,6,3,3
Sapaqlia,quelthalas,288,warlock,destruction,6,3,3
Lycanthropi,illidan,288,warlock,destruction,9,4,5
Ministàff,ursin,288,warlock,destruction,9,4,5
Taldaroth,moon-guard,288,warlock,destruction,7,3,4
Cult,smolderthorn,288,warlock,destruction,7,3,4
Juanigtstand,bleeding-hollow,288,warlock,destruction,10,4,6
Fluximilian,azralon,288,warlock,destruction,10,4,6
Amidone,bleeding-hollow,288,warlock,destruction,10,4,6
Verminperson,illidan,288,warlock,destruction,8,3,5
Malleus,drakkari,288,warlock,destruction,8,3,5
Wickedt,ragnaros,288,warlock,destruction,12,3,9
Gdpx,malganis,288,warlock,destruction,12,3,9
Mageus,blood-furnace,288,warlock,destruction,12,3,9
Demondays,sargeras,288,warlock,destruction,12,3,9
Pennydrop,barthilas,288,warlock,destruction,12,3,9
Dopamine,antonidas,288,warlock,destruction,12,3,9
Belfomént,ragnaros,288,warlock,destruction,12,3,9
Gotty,stormrage,288,warlock,destruction,12,3,9
Zeeref,stormrage,288,warlock,destruction,12,3,9
Trotndot,dragonmaw,288,warlock,destruction,12,3,9
Hachiui,galakrond,288,warlock,destruction,12,3,9
Fearfactory,lethon,288,warlock,destruction,12,3,9
Shaddaj,illidan,288,warlock,destruction,12,3,9
Demonâ,ragnaros,288,warlock,destruction,12,3,9
Gorgaron,zuljin,288,warlock,destruction,12,3,9
Voidmãngõ,stormrage,288,warlock,destruction,12,3,9
Sambodeemon,proudmoore,288,warlock,destruction,12,3,9
Wyrelock,hyjal,288,warlock,destruction,12,3,9
Héstia,area-52,288,warlock,destruction,12,3,9
Rabiesdot,tichondrius,288,warlock,destruction,12,3,9
Zeshlo,firetree,288,warlock,destruction,12,3,9
Mireffect,auchindoun,288,warlock,destruction,12,3,9
Amour,wyrmrest-accord,288,warlock,destruction,12,3,9
Dotvador,dalaran,288,warlock,destruction,12,3,9
Methology,wyrmrest-accord,288,warlock,destruction,12,3,9
Sulívan,azralon,288,warlock,destruction,12,3,9
Cexdragon,tichondrius,288,warlock,destruction,14,3,11
Cati,moon-guard,288,warlock,destruction,18,3,15
Báál,bleeding-hollow,288,warlock,destruction,18,3,15
Brenmen,tichondrius,287,warlock,destruction,6,3,3
Sykolock,lethon,287,warlock,destruction,6,3,3
Izmadara,frostmane,287,warlock,destruction,6,3,3
Trrolling,jubeithos,287,warlock,destruction,12,5,7
Liftthatbox,undermine,287,warlock,destruction,12,3,9
Evilbacon,stormrage,287,warlock,destruction,12,3,9
Drunklockdot,tichondrius,271,warlock,destruction,11,3,8
Ainzeal,nagrand,256,warlock,destruction,10,4,6
Sophia,wildhammer,255,warlock,destruction,8,4,4
Mikejones,dawnbringer,255,warlock,destruction,14,4,10
Draisien,moon-guard,250,warlock,destruction,7,5,2
Warakaso,ragnaros,240,warlock,destruction,9,3,6
Infectionl,ragnaros,239,warlock,destruction,5,3,2
Nawtychannel,aegwynn,239,warlock,destruction,5,3,2
Blightbeast,area-52,239,warlock,destruction,5,3,2
Alliciia,area-52,234,warlock,destruction,11,5,6
Evolda,tichondrius,234,warlock,destruction,9,4,5
Sakuin,bonechewer,234,warlock,destruction,17,5,12
Wàtchmebolt,dalvengyr,223,warlock,destruction,8,3,5
Amaia,nathrezim,207,warlock,destruction,7,3,4
Ëxotic,thrall,192,warlock,destruction,4,3,1
Pheobebuffay,frostmane,192,warlock,destruction,4,3,1
Portalgun,tichondrius,192,warlock,destruction,4,3,1
Demiloy,stormrage,192,warlock,destruction,9,3,6
Draindeez,sargeras,192,warlock,destruction,9,3,6
Vlaz,stormrage,192,warlock,destruction,6,2,4
Qbl,wyrmrest-accord,192,warlock,destruction,6,2,4
Dotsin,wyrmrest-accord,192,warlock,destruction,6,2,4
Guisls,azralon,192,warlock,destruction,6,2,4
Ourlegacy,tichondrius,192,warlock,destruction,6,2,4
Wakkundoe,tichondrius,192,warlock,destruction,6,2,4
Lemdul,thrall,192,warlock,destruction,6,2,4
Tirisfel,tichondrius,192,warlock,destruction,6,2,4
Dôctor,tichondrius,192,warlock,destruction,6,2,4
Amazeus,tichondrius,192,warlock,destruction,6,2,4
Cholock,anubarak,192,warlock,destruction,6,2,4
Ramone,turalyon,192,warlock,destruction,6,2,4
Alïka,quelthalas,192,warlock,destruction,6,2,4
Mothapucka,thrall,192,warlock,destruction,6,2,4
Herewegoagai,zuljin,192,warlock,destruction,6,2,4
Darkbaron,khadgar,192,warlock,destruction,6,2,4
Itzlandox,emerald-dream,192,warlock,destruction,6,2,4
Adalaya,emerald-dream,192,warlock,destruction,6,2,4
Solflames,stormrage,192,warlock,destruction,6,2,4
Outlanderr,tichondrius,192,warlock,destruction,6,2,4
Reckzet,stormrage,192,warlock,destruction,6,2,4
Sinsky,darkspear,192,warlock,destruction,6,2,4
Sugarfire,nemesis,192,warlock,destruction,6,2,4
Lexist,darkspear,192,warlock,destruction,6,2,4
Afflicmindz,azralon,192,warlock,destruction,6,2,4
Nüts,blackrock,192,warlock,destruction,6,2,4
Toxik,zuljin,192,warlock,destruction,6,2,4
Rickystuart,tichondrius,192,warlock,destruction,6,2,4
Nianas,ysondre,192,warlock,destruction,6,2,4
Shanelle,korgath,192,warlock,destruction,6,2,4
Gradek,dalaran,192,warlock,destruction,6,2,4
Srz,stormrage,192,warlock,destruction,6,2,4
Gihaewon,tichondrius,192,warlock,destruction,6,2,4
Mutexlock,whisperwind,192,warlock,destruction,6,2,4
Înfèçtìön,emerald-dream,192,warlock,destruction,6,2,4
Dramylock,sargeras,192,warlock,destruction,6,2,4
Zivira,stormrage,192,warlock,destruction,6,2,4
Valydri,stormrage,192,warlock,destruction,6,2,4
Nolb,tichondrius,192,warlock,destruction,6,2,4
Rococo,emerald-dream,192,warlock,destruction,6,2,4
Deiformis,malganis,192,warlock,destruction,6,2,4
Erimegara,ragnaros,192,warlock,destruction,6,2,4
Deanwarlock,sargeras,192,warlock,destruction,6,2,4
Disapoin,stormrage,192,warlock,destruction,6,2,4
Seizuresauce,stormrage,192,warlock,destruction,6,2,4
Gschism,ragnaros,192,warlock,destruction,6,2,4
Encanis,dalaran,192,warlock,destruction,6,2,4
Plzdont,blades-edge,192,warlock,destruction,6,2,4
Nonamehero,tichondrius,192,warlock,destruction,6,2,4
Cityswimmer,malganis,192,warlock,destruction,6,2,4
Gaijin,stormrage,192,warlock,destruction,6,2,4
Lazzie,thrall,192,warlock,destruction,6,2,4
Poltergiiest,korgath,192,warlock,destruction,6,2,4
Gemnî,tichondrius,192,warlock,destruction,6,2,4
Lynnha,wyrmrest-accord,192,warlock,destruction,6,2,4
Ðamndaddy,sargeras,192,warlock,destruction,6,2,4
Fluffylockk,bloodscalp,192,warlock,destruction,6,2,4
Ðuckworth,azralon,192,warlock,destruction,6,2,4
Msdotfire,nazjatar,192,warlock,destruction,6,2,4
Infant,agamaggan,192,warlock,destruction,6,2,4
Maxice,zuljin,192,warlock,destruction,6,2,4
Theredwolf,zuljin,192,warlock,destruction,6,2,4
Drkdestro,boulderfist,192,warlock,destruction,6,2,4
Spicyfingers,illidan,192,warlock,destruction,6,2,4
Zzamji,tichondrius,192,warlock,destruction,6,2,4
Åchse,ragnaros,192,warlock,destruction,6,2,4
Bleachkk,tichondrius,192,warlock,destruction,6,2,4
Cauldron,tichondrius,192,warlock,destruction,6,2,4
Pinguswalrus,stormrage,192,warlock,destruction,6,2,4
Puddlepiimp,illidan,192,warlock,destruction,6,2,4
Dedrae,silvermoon,192,warlock,destruction,6,2,4
Gvz,tichondrius,192,warlock,destruction,6,2,4
Mythh,hyjal,192,warlock,destruction,6,2,4
Flixon,tichondrius,192,warlock,destruction,6,2,4
Snipsfan,hyjal,192,warlock,destruction,6,2,4
Mortallicus,proudmoore,192,warlock,destruction,6,2,4
Amgamgamg,hyjal,192,warlock,destruction,6,2,4
Njunx,queldorei,192,warlock,destruction,6,2,4
Montaine,malganis,192,warlock,destruction,6,2,4
Asaveyous,wyrmrest-accord,192,warlock,destruction,6,2,4
Savemykoalas,tichondrius,192,warlock,destruction,6,2,4
Arcaangell,sargeras,192,warlock,destruction,6,2,4
Nazug,dark-iron,192,warlock,destruction,6,2,4
Brawndelock,stormrage,192,warlock,destruction,6,2,4
Xalcezar,sargeras,192,warlock,destruction,6,2,4
Dchichi,tichondrius,192,warlock,destruction,6,2,4
Konarik,nagrand,192,warlock,destruction,6,2,4
Biznam,tichondrius,192,warlock,destruction,6,2,4
Tokc,sargeras,192,warlock,destruction,6,2,4
Diablox,silvermoon,192,warlock,destruction,6,2,4
Checkit,zuljin,192,warlock,destruction,6,2,4
Leine,proudmoore,192,warlock,destruction,6,2,4
Moistdank,tichondrius,192,warlock,destruction,6,2,4
Oopsíe,nagrand,192,warlock,destruction,6,2,4
Fstndantilus,moonrunner,192,warlock,destruction,6,2,4
Ganggu,tichondrius,192,warlock,destruction,6,2,4
Zárco,ragnaros,192,warlock,destruction,6,2,4
Blliizz,aegwynn,192,warlock,destruction,6,2,4
Bigballslock,ragnaros,192,warlock,destruction,6,2,4
Ibanez,bleeding-hollow,192,warlock,destruction,6,2,4
Amz,grizzly-hills,192,warlock,destruction,6,2,4
Mlx,proudmoore,192,warlock,destruction,6,2,4
Yêrfdog,proudmoore,192,warlock,destruction,6,2,4
Diabolock,proudmoore,192,warlock,destruction,6,2,4
Hadeys,amanthul,192,warlock,destruction,6,2,4
Ozie,proudmoore,192,warlock,destruction,6,2,4
Raisa,chogall,192,warlock,destruction,6,2,4
Maniacal,shattered-halls,192,warlock,destruction,6,2,4
Ricklock,aggramar,192,warlock,destruction,6,2,4
Demonia,dathremar,192,warlock,destruction,6,2,4
Dach,moon-guard,192,warlock,destruction,6,2,4
Nameflagged,arathor,192,warlock,destruction,6,2,4
Nuradzec,illidan,192,warlock,destruction,6,2,4
Cynnd,tichondrius,192,warlock,destruction,6,2,4
Petez,sargeras,192,warlock,destruction,6,2,4
Nefertarie,illidan,192,warlock,destruction,6,2,4
Ballpain,sargeras,192,warlock,destruction,6,2,4
Vorkaz,moon-guard,192,warlock,destruction,6,2,4
Hawkinz,illidan,192,warlock,destruction,6,2,4
Constantine,exodar,192,warlock,destruction,6,2,4
Sinnâcle,illidan,192,warlock,destruction,6,2,4
Fjklock,nemesis,192,warlock,destruction,6,2,4
Percadu,barthilas,192,warlock,destruction,6,2,4
Fbgmel,emerald-dream,192,warlock,destruction,6,2,4
Diabloisekai,ragnaros,192,warlock,destruction,6,2,4
Baalock,frostmourne,192,warlock,destruction,6,2,4
Apokálipse,frostmourne,192,warlock,destruction,6,2,4
Idoturmum,frostmourne,192,warlock,destruction,6,2,4
Ðemõn,area-52,192,warlock,destruction,6,2,4
Búmchúm,frostmourne,192,warlock,destruction,6,2,4
Eliraa,frostmourne,192,warlock,destruction,6,2,4
Muffinlol,frostmourne,192,warlock,destruction,6,2,4
Xaraki,skullcrusher,192,warlock,destruction,6,2,4
Imindanger,frostmourne,192,warlock,destruction,6,2,4
Lolokayhaha,vashj,192,warlock,destruction,6,2,4
Camila,lightnings-blade,192,warlock,destruction,6,2,4
Locksama,area-52,192,warlock,destruction,6,2,4
Lhorgainz,area-52,192,warlock,destruction,6,2,4
Schmashed,eonar,192,warlock,destruction,6,2,4
Aksanaa,area-52,192,warlock,destruction,6,2,4
Cthuga,frostmourne,192,warlock,destruction,6,2,4
Zephiy,kelthuzad,192,warlock,destruction,6,2,4
Gadalann,area-52,192,warlock,destruction,6,2,4
Wasca,kelthuzad,192,warlock,destruction,6,2,4
Corruptious,frostmourne,192,warlock,destruction,6,2,4
Raghog,kelthuzad,192,warlock,destruction,6,2,4
Lostlove,moon-guard,192,warlock,destruction,6,2,4
Oprahofbolts,area-52,192,warlock,destruction,6,2,4
Yordich,kelthuzad,192,warlock,destruction,6,2,4
Theyfearbuda,kelthuzad,192,warlock,destruction,6,2,4
Dotzlol,jubeithos,192,warlock,destruction,6,2,4
Nightterrour,frostmourne,192,warlock,destruction,6,2,4
Iadminl,moon-guard,192,warlock,destruction,6,2,4
Abbyshapiro,kelthuzad,192,warlock,destruction,6,2,4
Lîch,thunderlord,192,warlock,destruction,8,2,6
Altairo,illidan,192,warlock,destruction,8,2,6
Tsunamibaby,anvilmar,192,warlock,destruction,9,2,7
Cbq,stormrage,192,warlock,destruction,9,2,7
Savubaloo,blackrock,192,warlock,destruction,15,3,12
Whydemono,tichondrius,192,warlock,destruction,10,2,8
Kandrus,moon-guard,192,warlock,destruction,12,2,10
Asumi,nemesis,192,warlock,destruction,12,2,10
Moknuhg,emerald-dream,192,warlock,destruction,12,2,10
Burnphase,sargeras,192,warlock,destruction,12,2,10
Hadés,aerie-peak,192,warlock,destruction,12,2,10
Scorrgx,azralon,192,warlock,destruction,12,2,10
Bladebank,kirin-tor,192,warlock,destruction,12,2,10
Wizie,arthas,192,warlock,destruction,12,2,10
Daggondai,tichondrius,192,warlock,destruction,12,2,10
Zlocks,scilla,192,warlock,destruction,12,2,10
Dorath,archimonde,192,warlock,destruction,12,2,10
Beamac,cenarius,192,warlock,destruction,14,2,12
Pangppi,tichondrius,192,warlock,destruction,24,2,22
Eldrien,spirestone,191,warlock,destruction,12,2,10
Erindevil,demon-soul,191,warlock,destruction,12,2,10
Prds,illidan,159,warlock,destruction,5,2,3
Fearfeaster,tichondrius,159,warlock,destruction,5,2,3
Dotyoazz,stormrage,159,warlock,destruction,5,2,3
Lockycharms,sargeras,159,warlock,destruction,5,2,3
Zarson,illidan,159,warlock,destruction,5,2,3
Lowvalue,illidan,159,warlock,destruction,5,2,3
Eatmyboltz,hyjal,159,warlock,destruction,5,2,3
Katarameni,tortheldrin,138,warlock,destruction,7,4,3
Blakedogx,tichondrius,138,warlock,destruction,8,3,5
Gildedknight,arthas,138,warlock,destruction,10,3,7
Afróex,azralon,138,warlock,destruction,19,4,15
Hentailust,kiljaeden,128,warlock,destruction,4,2,2
Conilus,malganis,128,warlock,destruction,4,2,2
Miggazzizle,senjin,128,warlock,destruction,4,2,2
Thegoatmen,stormrage,128,warlock,destruction,4,2,2
Catarina,kaelthas,128,warlock,destruction,4,2,2
Demonhart,moon-guard,128,warlock,destruction,4,2,2
Oreo,velen,112,warlock,destruction,7,2,5
Walljumper,thrall,105,warlock,destruction,13,4,9
Lukgar,azralon,96,warlock,destruction,3,2,1
Willsayan,ragnaros,96,warlock,destruction,3,2,1
Crankak,zuljin,96,warlock,destruction,3,2,1
Goodforyou,stormscale,96,warlock,destruction,3,2,1
Vahlgor,thunderlord,96,warlock,destruction,6,1,5
Nabuco,barthilas,96,warlock,destruction,6,1,5
Kuasta,shadowmoon,96,warlock,destruction,6,1,5
Basticor,moon-guard,96,warlock,destruction,6,1,5
Elaïla,area-52,96,warlock,destruction,6,1,5
Xaryus,barthilas,96,warlock,destruction,6,1,5
Seutóóbinha,stormrage,96,warlock,destruction,6,1,5
Dotomizer,moonrunner,96,warlock,destruction,6,1,5
Mônkêy,kelthuzad,96,warlock,destruction,6,1,5
Chilevael,sargeras,96,warlock,destruction,6,1,5
Lánathel,ragnaros,96,warlock,destruction,6,1,5
Tubarão,azralon,96,warlock,destruction,6,1,5
Pashe,hyjal,96,warlock,destruction,6,1,5
Nächtxîüs,terenas,96,warlock,destruction,6,1,5
Vexria,wyrmrest-accord,96,warlock,destruction,6,1,5
Talti,nathrezim,96,warlock,destruction,6,1,5
Pwnasaurus,barthilas,96,warlock,destruction,6,1,5
Killulock,area-52,96,warlock,destruction,6,1,5
Kraguenöth,drakkari,96,warlock,destruction,6,1,5
Rennik,haomarush,96,warlock,destruction,6,1,5
Vendareth,earthen-ring,96,warlock,destruction,6,1,5
Clairovibes,tichondrius,96,warlock,destruction,6,1,5
Brah,tichondrius,96,warlock,destruction,6,1,5
Ursuxus,moon-guard,96,warlock,destruction,6,1,5
Kothoped,wyrmrest-accord,96,warlock,destruction,6,1,5
Monstir,sargeras,96,warlock,destruction,6,1,5
Toryboltz,sargeras,96,warlock,destruction,6,1,5
Rëappér,ragnaros,96,warlock,destruction,6,1,5
Gamecobra,greymane,96,warlock,destruction,6,1,5
Sheara,silver-hand,96,warlock,destruction,6,1,5
Radii,bladefist,96,warlock,destruction,6,1,5
Cursenkill,sargeras,96,warlock,destruction,6,1,5
Sèphìrøth,burning-legion,96,warlock,destruction,6,1,5
Lilcarmy,emerald-dream,96,warlock,destruction,6,1,5
Spellbøund,malorne,96,warlock,destruction,6,1,5
Biigdaddyy,kelthuzad,96,warlock,destruction,6,1,5
Pspot,kiljaeden,96,warlock,destruction,6,1,5
Mílkduds,zuljin,96,warlock,destruction,6,1,5
Fearfaze,tichondrius,96,warlock,destruction,6,1,5
Bfaclâssic,zuljin,96,warlock,destruction,6,1,5
Proletariat,moon-guard,96,warlock,destruction,6,1,5
Siaokuai,tichondrius,96,warlock,destruction,6,1,5
Taddedlock,kelthuzad,96,warlock,destruction,6,1,5
Brothadoinks,zuljin,96,warlock,destruction,6,1,5
Robertloblah,sargeras,96,warlock,destruction,6,1,5
Lawkdown,dark-iron,96,warlock,destruction,6,1,5
Evvell,bleeding-hollow,96,warlock,destruction,6,1,5
Jitza,bleeding-hollow,96,warlock,destruction,6,1,5
Demonellea,frostmourne,96,warlock,destruction,6,1,5
Adlfcritler,emerald-dream,96,warlock,destruction,6,1,5
Koillock,bleeding-hollow,96,warlock,destruction,6,1,5
Gsr,bleeding-hollow,96,warlock,destruction,6,1,5
Lokiiee,azuremyst,96,warlock,destruction,6,1,5
Heffyboi,frostmourne,96,warlock,destruction,6,1,5
Réliok,quelthalas,96,warlock,destruction,6,1,5
Skeemer,azuremyst,96,warlock,destruction,6,1,5
Lizlock,stormrage,96,warlock,destruction,6,1,5
Kaossqt,azralon,96,warlock,destruction,6,1,5
Medivhz,tichondrius,96,warlock,destruction,6,1,5
Däemön,area-52,96,warlock,destruction,6,1,5
Xanlel,deathwing,96,warlock,destruction,6,1,5
Jiwonpark,goldrinn,96,warlock,destruction,6,1,5
Rhoobi,proudmoore,96,warlock,destruction,6,1,5
Alcorick,moon-guard,96,warlock,destruction,6,1,5
Mazip,vashj,96,warlock,destruction,6,1,5
Cewkimonster,proudmoore,96,warlock,destruction,6,1,5
Charlîe,vashj,96,warlock,destruction,6,1,5
Eldïablo,stormrage,96,warlock,destruction,6,1,5
Aflictiyon,azralon,96,warlock,destruction,6,1,5
Resima,stormscale,96,warlock,destruction,6,1,5
Meinhundin,stormrage,96,warlock,destruction,6,1,5
Hinatasu,greymane,96,warlock,destruction,6,1,5
Winstonblack,moon-guard,96,warlock,destruction,6,1,5
Plaguedoctor,stormrage,96,warlock,destruction,6,1,5
Lazymongoose,frostmourne,96,warlock,destruction,6,1,5
Fearxd,maiev,96,warlock,destruction,6,1,5
Meanda,boulderfist,96,warlock,destruction,6,1,5
Demonist,moon-guard,96,warlock,destruction,6,1,5
Crushbucket,stormreaver,96,warlock,destruction,6,1,5
Scatach,area-52,96,warlock,destruction,6,1,5
Voky,whisperwind,96,warlock,destruction,6,1,5
Thehempress,magtheridon,96,warlock,destruction,6,1,5
Bosshoglock,whisperwind,96,warlock,destruction,6,1,5
Wesyane,anetheron,96,warlock,destruction,6,1,5
Projecto,tichondrius,96,warlock,destruction,6,1,5
Xyrantha,moon-guard,96,warlock,destruction,6,1,5
Darkmatter,frostmourne,96,warlock,destruction,6,1,5
Niubeelol,tichondrius,96,warlock,destruction,6,1,5
Onfîre,area-52,96,warlock,destruction,6,1,5
Lokinzz,tichondrius,96,warlock,destruction,6,1,5
Druzzaj,thrall,96,warlock,destruction,6,1,5
Wickedicky,alleria,96,warlock,destruction,6,1,5
Daycrazee,gorefiend,96,warlock,destruction,6,1,5
Cornboil,tichondrius,96,warlock,destruction,6,1,5
Infear,area-52,96,warlock,destruction,6,1,5
Darkarts,uldum,96,warlock,destruction,6,1,5
Mcpickl,illidan,96,warlock,destruction,6,1,5
Mmfoodisgood,dalaran,96,warlock,destruction,6,1,5
Darkestholy,illidan,96,warlock,destruction,6,1,5
Saytiri,tichondrius,96,warlock,destruction,6,1,5
Kaotiq,area-52,96,warlock,destruction,6,1,5
Siinistuh,tichondrius,96,warlock,destruction,6,1,5
Zanlockos,dalaran,96,warlock,destruction,6,1,5
Gulgrin,eldrethalas,96,warlock,destruction,6,1,5
Alfizzle,illidan,96,warlock,destruction,6,1,5
Varix,frostmourne,96,warlock,destruction,6,1,5
Toelickerx,illidan,96,warlock,destruction,6,1,5
Alyxandros,illidan,96,warlock,destruction,6,1,5
Wetweenies,illidan,96,warlock,destruction,6,1,5
Yallsdead,frostmourne,96,warlock,destruction,6,1,5
Yuengling,illidan,96,warlock,destruction,6,1,5
Delaye,tichondrius,96,warlock,destruction,6,1,5
Bitrot,jubeithos,96,warlock,destruction,6,1,5
Zohhan,tichondrius,96,warlock,destruction,6,1,5
Lucifuhrerr,tichondrius,96,warlock,destruction,6,1,5
Wherelock,area-52,96,warlock,destruction,7,1,6
Nekranis,thrall,96,warlock,destruction,12,1,11
Diddy,arygos,96,warlock,destruction,12,1,11
Warhola,tichondrius,96,warlock,destruction,12,1,11
Neverknownwl,proudmoore,96,warlock,destruction,12,1,11
Kreâtor,tichondrius,96,warlock,destruction,12,1,11
Ashlëen,ragnaros,96,warlock,destruction,12,1,11
Mythsubpar,tichondrius,96,warlock,destruction,12,1,11
Balian,stormreaver,95,warlock,destruction,4,2,2
Moz,sargeras,79,warlock,destruction,5,1,4
Ledmann,tichondrius,73,warlock,destruction,21,3,18
Júnmú,tichondrius,64,warlock,destruction,10,1,9
Thiccdoinkz,tichondrius,63,warlock,destruction,2,2,0
Cokelime,sargeras,63,warlock,destruction,2,2,0
Clevingert,frostmourne,48,warlock,destruction,3,1,2
Aoneandatwo,proudmoore,48,warlock,destruction,3,1,2
Kosugi,kelthuzad,42,warlock,destruction,8,2,6
Kandlia,tichondrius,31,warlock,destruction,2,1,1
Amarexd,stormrage,31,warlock,destruction,2,1,1
Morêdots,malganis,31,warlock,destruction,2,1,1
Jusmessin,tichondrius,31,warlock,destruction,2,1,1
Moräl,frostmourne,31,warlock,destruction,2,1,1
Emurog,icecrown,30,warlock,destruction,12,6,6
Amonthuzad,blackrock,16,warlock,destruction,1,1,0
Lazygnom,azshara,16,warlock,destruction,1,1,0
Goofhu,sargeras,2270,warlock,affliction,102,62,40
Exgenshinpro,proudmoore,2232,warlock,affliction,166,91,75
Tcchiu,tichondrius,2174,warlock,affliction,59,34,25
Dewandoritos,kelthuzad,2138,warlock,affliction,159,79,80
Yandhi,bronzebeard,2129,warlock,affliction,46,30,16
Dotdzdotdoze,tichondrius,2106,warlock,affliction,245,131,114
Conradlenoir,illidan,2023,warlock,affliction,71,35,36
Idotû,tichondrius,2005,warlock,affliction,88,48,40
Sphoo,tichondrius,2001,warlock,affliction,112,58,54
Shanyanghuxu,tichondrius,1997,warlock,affliction,48,30,18
Rangz,tichondrius,1983,warlock,affliction,84,45,39
Arityy,tichondrius,1980,warlock,affliction,120,64,56
Baxmoney,malganis,1973,warlock,affliction,84,37,47
Kålêïðøsçøpê,sargeras,1965,warlock,affliction,42,24,18
Goofgg,sargeras,1957,warlock,affliction,371,179,192
Octopus,nerzhul,1954,warlock,affliction,88,43,45
Diminish,sargeras,1953,warlock,affliction,138,70,68
Pardoned,stormrage,1945,warlock,affliction,65,31,34
Wardyn,dragonmaw,1937,warlock,affliction,96,43,53
Jukethisxo,tichondrius,1925,warlock,affliction,117,70,47
Gekku,ragnaros,1917,warlock,affliction,83,49,34
Dyenamik,stormrage,1891,warlock,affliction,60,33,27
Boyahancook,tichondrius,1888,warlock,affliction,169,89,80
Exódia,tichondrius,1888,warlock,affliction,225,112,113
Hiro,steamwheedle-cartel,1887,warlock,affliction,129,73,56
Cumbledora,kelthuzad,1878,warlock,affliction,48,30,18
Beetlejoos,stormreaver,1875,warlock,affliction,128,72,56
Rangrang,tichondrius,1873,warlock,affliction,108,51,57
Yellowfevr,thrall,1870,warlock,affliction,48,27,21
Steven,firetree,1868,warlock,affliction,48,27,21
Fallenis,proudmoore,1854,warlock,affliction,60,35,25
Burtreynolds,shattered-hand,1854,warlock,affliction,84,44,40
Oymmander,illidan,1850,warlock,affliction,36,25,11
Prnhbgødx,sargeras,1850,warlock,affliction,48,26,22
Widenose,agamaggan,1847,warlock,affliction,77,43,34
Hyoozy,illidan,1830,warlock,affliction,111,60,51
Fatherbolt,tichondrius,1819,warlock,affliction,30,20,10
Forestfruit,tichondrius,1819,warlock,affliction,58,31,27
Lostlock,sargeras,1818,warlock,affliction,132,73,59
Lockhippo,illidan,1818,warlock,affliction,58,30,28
Matrielan,azshara,1815,warlock,affliction,138,85,53
Bugbugg,tichondrius,1814,warlock,affliction,51,38,13
Woopie,malfurion,1809,warlock,affliction,53,29,24
Knothy,proudmoore,1807,warlock,affliction,78,36,42
Warlocknroll,frostmourne,1803,warlock,affliction,47,21,26
Dröwzy,sargeras,1801,warlock,affliction,48,25,23
Phlares,stormrage,1798,warlock,affliction,71,30,41
Slendyman,stormrage,1794,warlock,affliction,42,25,17
Bigg,duskwood,1791,warlock,affliction,36,24,12
Renosa,illidan,1788,warlock,affliction,63,34,29
Limeriax,emerald-dream,1782,warlock,affliction,120,65,55
Lockprocz,kirin-tor,1779,warlock,affliction,48,24,24
Lucyloux,sargeras,1775,warlock,affliction,40,23,17
Voidrob,tichondrius,1774,warlock,affliction,36,24,12
Leach,draktharon,1769,warlock,affliction,90,49,41
Gry,malganis,1767,warlock,affliction,34,19,15
Purp,vashj,1767,warlock,affliction,44,23,21
Portalgun,tichondrius,1764,warlock,affliction,54,30,24
Duukka,malganis,1763,warlock,affliction,47,28,19
Salival,chogall,1757,warlock,affliction,78,41,37
Fancynuts,kiljaeden,1754,warlock,affliction,54,27,27
Fatals,thrall,1749,warlock,affliction,84,45,39
Amazeus,tichondrius,1747,warlock,affliction,64,36,28
Goofgoof,sargeras,1744,warlock,affliction,42,19,23
Ezgamejr,tichondrius,1740,warlock,affliction,52,30,22
Mornnah,dalaran,1738,warlock,affliction,234,111,123
Jimmyvagene,area-52,1736,warlock,affliction,59,26,33
Phøbøs,hyjal,1725,warlock,affliction,36,23,13
Àfflìction,tichondrius,1719,warlock,affliction,149,79,70
Albright,azralon,1710,warlock,affliction,47,22,25
Sventka,ragnaros,1708,warlock,affliction,405,209,196
Înfy,sargeras,1703,warlock,affliction,30,18,12
Imadotyasan,shandris,1702,warlock,affliction,60,31,29
Swath,firetree,1700,warlock,affliction,60,30,30
Locklist,frostmourne,1695,warlock,affliction,78,41,37
Cslice,magtheridon,1686,warlock,affliction,36,20,16
Strudelfears,tichondrius,1685,warlock,affliction,119,75,44
Calculator,tichondrius,1684,warlock,affliction,42,21,21
Beamin,dentarg,1683,warlock,affliction,42,27,15
Eh,laughing-skull,1669,warlock,affliction,148,71,77
Liarz,tichondrius,1667,warlock,affliction,72,36,36
Thecat,shattered-hand,1657,warlock,affliction,30,24,6
Sâltylôck,tichondrius,1654,warlock,affliction,47,24,23
Buccs,barthilas,1652,warlock,affliction,29,20,9
Felegance,proudmoore,1652,warlock,affliction,49,22,27
Kopium,tichondrius,1645,warlock,affliction,36,24,12
Dpz,spirestone,1645,warlock,affliction,30,18,12
Dottcha,blackrock,1643,warlock,affliction,66,40,26
Ticktickdoom,sargeras,1641,warlock,affliction,80,38,42
Jordhan,barthilas,1639,warlock,affliction,36,18,18
Wojii,kelthuzad,1636,warlock,affliction,44,24,20
Hauntx,bonechewer,1632,warlock,affliction,45,22,23
Arcziz,tichondrius,1628,warlock,affliction,54,32,22
Blackchinese,zuljin,1627,warlock,affliction,119,69,50
Vardros,moon-guard,1626,warlock,affliction,60,33,27
Venticm,tichondrius,1623,warlock,affliction,24,17,7
Mørøs,tichondrius,1623,warlock,affliction,108,70,38
Grimdreams,malganis,1622,warlock,affliction,37,21,16
Eraticlock,illidan,1621,warlock,affliction,37,22,15
Hilzin,area-52,1617,warlock,affliction,102,51,51
Bigdammich,bleeding-hollow,1617,warlock,affliction,66,33,33
Dotplaystyle,blackrock,1617,warlock,affliction,101,46,55
Cokeparty,tichondrius,1611,warlock,affliction,108,52,56
Urwjoa,tichondrius,1609,warlock,affliction,74,39,35
Jkun,malganis,1608,warlock,affliction,126,70,56
Catarina,kaelthas,1605,warlock,affliction,33,18,15
Muffîn,moon-guard,1604,warlock,affliction,55,31,24
Fasteddywow,arygos,1603,warlock,affliction,71,41,30
Slothycrip,emerald-dream,1602,warlock,affliction,71,39,32
Dlarenn,kelthuzad,1602,warlock,affliction,36,17,19
Autotheism,whisperwind,1601,warlock,affliction,48,24,24
Tjdotter,stormrage,1600,warlock,affliction,30,19,11
Pykorrg,ragnaros,1600,warlock,affliction,47,23,24
Chilipeppa,wyrmrest-accord,1598,warlock,affliction,94,47,47
Demonkiiller,kelthuzad,1597,warlock,affliction,49,25,24
Uggaboogga,malganis,1597,warlock,affliction,36,17,19
Evarona,gorefiend,1596,warlock,affliction,84,41,43
Sinápsís,ragnaros,1593,warlock,affliction,30,18,12
Dotymania,aegwynn,1593,warlock,affliction,30,18,12
Unsee,sargeras,1589,warlock,affliction,113,61,52
Elend,elune,1588,warlock,affliction,48,33,15
Waifucandy,tichondrius,1588,warlock,affliction,60,29,31
Mechnite,sargeras,1586,warlock,affliction,67,31,36
Xentzor,auchindoun,1585,warlock,affliction,96,48,48
Cuteboy,tichondrius,1584,warlock,affliction,90,59,31
Parmenides,tichondrius,1584,warlock,affliction,210,110,100
Damage,khadgar,1584,warlock,affliction,66,33,33
Laurela,aegwynn,1583,warlock,affliction,114,58,56
Zeraedify,bleeding-hollow,1580,warlock,affliction,48,21,27
Babydots,stormreaver,1579,warlock,affliction,29,18,11
Nightkiss,sargeras,1578,warlock,affliction,48,22,26
Forcedbeejay,sargeras,1575,warlock,affliction,60,33,27
Sìnister,nazgrel,1569,warlock,affliction,77,49,28
Glifosáto,quelthalas,1569,warlock,affliction,54,32,22
Stalezz,barthilas,1559,warlock,affliction,62,33,29
Hauntgød,tichondrius,1558,warlock,affliction,66,38,28
Freddiewill,tichondrius,1557,warlock,affliction,41,26,15
Adeadsaint,boulderfist,1557,warlock,affliction,47,28,19
Lessthanjake,zuljin,1553,warlock,affliction,60,35,25
Mattypatty,the-forgotten-coast,1550,warlock,affliction,80,43,37
Mitryc,illidan,1540,warlock,affliction,55,26,29
Disneytoon,moon-guard,1536,warlock,affliction,36,18,18
Bigdamege,tichondrius,1535,warlock,affliction,24,17,7
Ðåntë,thrall,1532,warlock,affliction,62,32,30
Methrocks,emerald-dream,1529,warlock,affliction,70,42,28
Zod,burning-legion,1525,warlock,affliction,36,17,19
Dirtydotting,nerzhul,1524,warlock,affliction,30,17,13
Deangood,tichondrius,1523,warlock,affliction,54,31,23
Stopdot,lightnings-blade,1522,warlock,affliction,77,41,36
Erolidra,blackrock,1519,warlock,affliction,30,16,14
Vialdkaseun,muradin,1516,warlock,affliction,150,67,83
Dotte,tichondrius,1514,warlock,affliction,42,27,15
Soulripped,area-52,1514,warlock,affliction,76,42,34
Yanned,hakkar,1514,warlock,affliction,99,51,48
Benafflock,kaelthas,1514,warlock,affliction,48,24,24
Xoxoxoxoxo,lightnings-blade,1513,warlock,affliction,70,33,37
Aroug,aggramar,1512,warlock,affliction,122,66,56
Crazikrix,area-52,1511,warlock,affliction,103,55,48
Tyicuslok,tichondrius,1510,warlock,affliction,60,31,29
Sheboy,moon-guard,1509,warlock,affliction,96,52,44
Buckéthéad,arathor,1504,warlock,affliction,108,54,54
Aomniloltv,zuljin,1500,warlock,affliction,152,78,74
Loodle,moon-guard,1494,warlock,affliction,47,23,24
Spreadlove,emerald-dream,1494,warlock,affliction,54,23,31
Razlock,moon-guard,1490,warlock,affliction,102,54,48
Dautenit,illidan,1490,warlock,affliction,71,34,37
Squirtwee,frostmourne,1489,warlock,affliction,145,68,77
Belaflore,moon-guard,1488,warlock,affliction,36,18,18
Wizxin,emerald-dream,1488,warlock,affliction,78,38,40
Dghuldahn,bleeding-hollow,1486,warlock,affliction,66,40,26
Tsalagi,sargeras,1478,warlock,affliction,145,78,67
Locker,lightnings-blade,1471,warlock,affliction,36,23,13
Moräl,frostmourne,1470,warlock,affliction,51,25,26
Fowll,frostwolf,1469,warlock,affliction,121,74,47
Catdrugs,kelthuzad,1461,warlock,affliction,34,16,18
Flangy,kiljaeden,1460,warlock,affliction,126,66,60
Juleno,quelthalas,1458,warlock,affliction,30,17,13
Infecçäo,stormrage,1455,warlock,affliction,46,23,23
Yisuschríst,quelthalas,1453,warlock,affliction,39,23,16
Sillyrabbut,kelthuzad,1450,warlock,affliction,216,108,108
Tribulatiön,moon-guard,1449,warlock,affliction,59,25,34
Benaffllock,turalyon,1439,warlock,affliction,30,18,12
Beitrice,barthilas,1439,warlock,affliction,42,17,25
Dotsarehot,dreadmaul,1436,warlock,affliction,54,26,28
Xicó,tichondrius,1435,warlock,affliction,64,31,33
Fearfaze,tichondrius,1433,warlock,affliction,60,27,33
Snuffe,vashj,1432,warlock,affliction,103,60,43
Torowasabi,tichondrius,1432,warlock,affliction,65,29,36
Percadu,barthilas,1431,warlock,affliction,36,16,20
Ouijafaps,sargeras,1430,warlock,affliction,48,25,23
Livingdead,dreadmaul,1429,warlock,affliction,35,18,17
Maxcorrupted,sargeras,1428,warlock,affliction,41,23,18
Shadowhax,area-52,1427,warlock,affliction,38,16,22
Daëmön,stormrage,1421,warlock,affliction,30,15,15
Kimis,proudmoore,1421,warlock,affliction,42,20,22
Varvanta,proudmoore,1420,warlock,affliction,48,18,30
Droppindots,frostmane,1419,warlock,affliction,42,23,19
Garthbrookz,bleeding-hollow,1418,warlock,affliction,63,29,34
Soulcore,area-52,1416,warlock,affliction,24,15,9
Justganmore,tichondrius,1416,warlock,affliction,71,37,34
Snuzzock,darkspear,1416,warlock,affliction,47,21,26
Nutzosaurus,darkspear,1414,warlock,affliction,42,23,19
Hottyscotty,tichondrius,1414,warlock,affliction,91,43,48
Chadre,feathermoon,1413,warlock,affliction,46,23,23
Vaalac,tichondrius,1412,warlock,affliction,492,237,255
Sweetjuly,area-52,1410,warlock,affliction,69,42,27
Skoobler,tichondrius,1409,warlock,affliction,99,54,45
Sîthfu,tichondrius,1409,warlock,affliction,71,34,37
Marà,ragnaros,1409,warlock,affliction,45,18,27
Dårkfyre,kiljaeden,1406,warlock,affliction,24,15,9
Elliarquet,akama,1404,warlock,affliction,106,52,54
Yuckytoetoe,emerald-dream,1400,warlock,affliction,42,24,18
Nookíe,azralon,1399,warlock,affliction,66,34,32
Cantibor,illidan,1398,warlock,affliction,112,60,52
Frylock,frostmourne,1398,warlock,affliction,170,83,87
Jumlock,illidan,1395,warlock,affliction,52,29,23
Karpawarlock,ragnaros,1394,warlock,affliction,84,47,37
Sinesta,bleeding-hollow,1393,warlock,affliction,42,24,18
Diosban,malganis,1391,warlock,affliction,48,20,28
Äffie,aerie-peak,1390,warlock,affliction,144,70,74
Morgil,suramar,1389,warlock,affliction,39,20,19
Chachanoobx,sargeras,1387,warlock,affliction,48,23,25
Munch,khadgar,1386,warlock,affliction,36,17,19
Captrollol,tichondrius,1385,warlock,affliction,44,27,17
Tuerie,illidan,1385,warlock,affliction,60,34,26
Soloart,tichondrius,1385,warlock,affliction,36,15,21
Winipuhmalo,quelthalas,1384,warlock,affliction,59,33,26
Awp,malganis,1383,warlock,affliction,42,22,20
Aerumna,barthilas,1378,warlock,affliction,30,15,15
Gordaroth,barthilas,1376,warlock,affliction,41,24,17
Boreo,ragnaros,1376,warlock,affliction,48,23,25
Koiboii,tichondrius,1374,warlock,affliction,36,20,16
Lockneo,stormrage,1370,warlock,affliction,138,77,61
Nicodareus,hellscream,1369,warlock,affliction,45,25,20
Søül,tichondrius,1368,warlock,affliction,42,21,21
Onmyioji,dalaran,1367,warlock,affliction,24,16,8
Hairydotter,doomhammer,1365,warlock,affliction,42,24,18
Dankdôtz,stormrage,1365,warlock,affliction,42,18,24
Bbangtimo,tichondrius,1363,warlock,affliction,26,15,11
Acceptdeath,stormrage,1362,warlock,affliction,30,17,13
Dippindots,boulderfist,1355,warlock,affliction,110,53,57
Feoona,hyjal,1354,warlock,affliction,72,41,31
Zinkro,quelthalas,1353,warlock,affliction,129,74,55
Eilethen,cenarion-circle,1350,warlock,affliction,34,15,19
Mysoultotake,sargeras,1344,warlock,affliction,36,19,17
Cvoaw,bonechewer,1342,warlock,affliction,19,15,4
Nutted,dentarg,1342,warlock,affliction,24,14,10
Dotpocket,runetotem,1342,warlock,affliction,36,14,22
Ialfizzle,dethecus,1340,warlock,affliction,72,33,39
Kickg,tichondrius,1335,warlock,affliction,24,14,10
Nazrakin,malganis,1333,warlock,affliction,54,26,28
Ragnalock,laughing-skull,1331,warlock,affliction,30,16,14
Fatuglyegirl,sargeras,1331,warlock,affliction,63,30,33
Mèsut,malganis,1327,warlock,affliction,36,24,12
Warakaso,ragnaros,1327,warlock,affliction,60,37,23
Pepzz,emerald-dream,1327,warlock,affliction,48,23,25
Aights,zuljin,1325,warlock,affliction,92,38,54
Yeepzbytre,bleeding-hollow,1320,warlock,affliction,30,14,16
Zeviaem,quelthalas,1319,warlock,affliction,30,14,16
Yyoyo,tichondrius,1318,warlock,affliction,36,24,12
Munick,spirestone,1318,warlock,affliction,54,27,27
Spi,chogall,1317,warlock,affliction,164,81,83
Thoxy,barthilas,1316,warlock,affliction,66,32,34
Mïer,tichondrius,1315,warlock,affliction,89,47,42
Dercrow,quelthalas,1314,warlock,affliction,38,21,17
Arillus,thrall,1314,warlock,affliction,77,39,38
Aikonor,stormrage,1313,warlock,affliction,99,49,50
Gnock,garona,1312,warlock,affliction,59,27,32
Lemdul,thrall,1310,warlock,affliction,48,22,26
Phelly,frostmourne,1309,warlock,affliction,98,56,42
Valtimorh,ragnaros,1309,warlock,affliction,36,19,17
Psx,frostmourne,1308,warlock,affliction,30,14,16
Hemmlock,moknathal,1306,warlock,affliction,57,26,31
Atraedes,moon-guard,1305,warlock,affliction,86,46,40
Côp,tichondrius,1303,warlock,affliction,71,31,40
Violentx,tichondrius,1301,warlock,affliction,45,20,25
Castngcouch,tichondrius,1296,warlock,affliction,117,62,55
Fluffylockk,bloodscalp,1295,warlock,affliction,52,26,26
Merlinguini,cenarion-circle,1294,warlock,affliction,29,14,15
Punished,arthas,1293,warlock,affliction,56,30,26
Whathurts,tichondrius,1289,warlock,affliction,62,38,24
Pipeo,quelthalas,1288,warlock,affliction,126,72,54
Symplicìty,area-52,1286,warlock,affliction,54,35,19
Eyedot,stormscale,1285,warlock,affliction,24,18,6
Ysnou,nemesis,1283,warlock,affliction,42,24,18
Avatar,uldum,1283,warlock,affliction,60,26,34
Irene,nagrand,1281,warlock,affliction,43,24,19
Beelzismurph,emerald-dream,1281,warlock,affliction,63,31,32
Tizl,tichondrius,1277,warlock,affliction,228,108,120
Novichok,amanthul,1276,warlock,affliction,36,15,21
Aalkaid,dathremar,1273,warlock,affliction,54,31,23
Zamorakk,nemesis,1272,warlock,affliction,58,33,25
Volsace,moon-guard,1267,warlock,affliction,30,14,16
Baiano,nagrand,1265,warlock,affliction,46,19,27
Lisaleda,stormrage,1263,warlock,affliction,30,16,14
Wallow,thunderhorn,1258,warlock,affliction,65,34,31
Rickrock,gnomeregan,1257,warlock,affliction,46,22,24
Fshi,frostmourne,1252,warlock,affliction,98,54,44
Gregg,laughing-skull,1248,warlock,affliction,156,82,74
Barovir,tichondrius,1247,warlock,affliction,18,13,5
Killernix,drakkari,1247,warlock,affliction,60,33,27
Gianni,chogall,1247,warlock,affliction,24,13,11
Gurlock,illidan,1246,warlock,affliction,42,26,16
Mindfulchimp,sargeras,1246,warlock,affliction,50,21,29
Quitxmanlm,tichondrius,1245,warlock,affliction,24,13,11
Drowzy,undermine,1245,warlock,affliction,30,13,17
Kreatur,ragnaros,1244,warlock,affliction,60,28,32
Balveer,tichondrius,1243,warlock,affliction,28,14,14
Stonelocke,area-52,1242,warlock,affliction,30,14,16
Curaven,emerald-dream,1242,warlock,affliction,35,14,21
Obertito,kelthuzad,1239,warlock,affliction,31,17,14
Ruegger,stormscale,1238,warlock,affliction,48,21,27
Lotdon,blackrock,1237,warlock,affliction,113,50,63
Wtb,blackrock,1235,warlock,affliction,24,13,11
Garbocan,area-52,1235,warlock,affliction,24,13,11
Asetiks,tichondrius,1235,warlock,affliction,30,13,17
Reckzet,stormrage,1234,warlock,affliction,24,13,11
Squasum,sargeras,1232,warlock,affliction,156,81,75
Mymmic,ragnaros,1232,warlock,affliction,100,46,54
Lilliara,korgath,1232,warlock,affliction,41,16,25
Cascades,icecrown,1228,warlock,affliction,37,19,18
Moxz,garona,1227,warlock,affliction,91,37,54
Caustikk,malganis,1225,warlock,affliction,24,13,11
Saltyfries,wildhammer,1224,warlock,affliction,54,22,32
Aeonss,stormrage,1222,warlock,affliction,54,25,29
Coolwipp,demon-soul,1221,warlock,affliction,198,97,101
Iainmbanks,barthilas,1220,warlock,affliction,250,119,131
Juniorsalanu,quelthalas,1219,warlock,affliction,97,43,54
Ciprýan,azralon,1218,warlock,affliction,24,14,10
Kyugin,goldrinn,1217,warlock,affliction,32,13,19
Mothapucka,thrall,1216,warlock,affliction,42,14,28
Kogath,thunderlord,1209,warlock,affliction,53,29,24
Tohkisaeki,dalaran,1209,warlock,affliction,72,37,35
Cynic,uther,1209,warlock,affliction,29,13,16
Yoyoling,illidan,1200,warlock,affliction,82,43,39
Bashel,sargeras,1199,warlock,affliction,83,47,36
Yosuljaengi,stormrage,1192,warlock,affliction,140,70,70
Sammythebull,frostwolf,1186,warlock,affliction,44,24,20
Finnek,moon-guard,1184,warlock,affliction,36,21,15
Azâziel,ragnaros,1184,warlock,affliction,45,24,21
Slakiejr,darkspear,1180,warlock,affliction,22,13,9
Eightyfall,barthilas,1180,warlock,affliction,40,17,23
Critthis,illidan,1175,warlock,affliction,42,21,21
Candykrush,tichondrius,1173,warlock,affliction,30,18,12
Batär,area-52,1171,warlock,affliction,62,26,36
Poltergiiest,korgath,1164,warlock,affliction,24,13,11
Khatrat,azralon,1164,warlock,affliction,106,43,63
Zaliki,hellscream,1161,warlock,affliction,36,22,14
Lilpewpeww,bleeding-hollow,1154,warlock,affliction,123,60,63
Lomeron,sargeras,1153,warlock,affliction,30,14,16
Promann,drakkari,1151,warlock,affliction,12,12,0
Háydn,azuremyst,1151,warlock,affliction,18,12,6
Guldåniel,tichondrius,1150,warlock,affliction,18,12,6
Kruxxqt,illidan,1150,warlock,affliction,24,12,12
Nestpas,tichondrius,1150,warlock,affliction,33,14,19
Tìdals,zuljin,1149,warlock,affliction,18,12,6
Rakshama,chogall,1148,warlock,affliction,24,12,12
Necroñomicon,malganis,1145,warlock,affliction,18,12,6
Deusita,kelthuzad,1144,warlock,affliction,54,21,33
Fyahwalka,aggramar,1143,warlock,affliction,48,19,29
Millyvanilly,tichondrius,1140,warlock,affliction,24,12,12
Studious,sargeras,1139,warlock,affliction,26,15,11
Buucocky,proudmoore,1136,warlock,affliction,30,16,14
Sugarwaffles,area-52,1135,warlock,affliction,18,12,6
Ikis,cenarion-circle,1134,warlock,affliction,24,15,9
Krïttzïe,proudmoore,1124,warlock,affliction,78,41,37
Doombaby,zuljin,1124,warlock,affliction,24,12,12
Päinoth,wyrmrest-accord,1122,warlock,affliction,42,26,16
Lockinha,azralon,1122,warlock,affliction,36,13,23
Nedrien,moon-guard,1120,warlock,affliction,54,28,26
Drskeeters,malganis,1116,warlock,affliction,26,13,13
Zrx,proudmoore,1115,warlock,affliction,69,27,42
Beetlegiese,doomhammer,1114,warlock,affliction,40,19,21
Fearocity,argent-dawn,1111,warlock,affliction,74,33,41
Sylencia,demon-soul,1107,warlock,affliction,36,13,23
Zipstream,dark-iron,1104,warlock,affliction,36,13,23
Auntzhang,tichondrius,1101,warlock,affliction,29,12,17
Dipdip,illidan,1097,warlock,affliction,63,25,38
Kokoto,azralon,1092,warlock,affliction,75,44,31
Littlepain,goldrinn,1071,warlock,affliction,30,14,16
Lockaloga,azralon,1068,warlock,affliction,20,12,8
Elander,azuremyst,1067,warlock,affliction,30,17,13
Felmort,bleeding-hollow,1059,warlock,affliction,48,19,29
Swinefrommud,zuljin,1056,warlock,affliction,24,11,13
Aanx,dark-iron,1055,warlock,affliction,24,11,13
Dragoska,kiljaeden,1053,warlock,affliction,16,12,4
Wreyz,mannoroth,1053,warlock,affliction,18,11,7
Gateor,zuljin,1051,warlock,affliction,24,11,13
Ellneggro,zuljin,1050,warlock,affliction,21,12,9
Lockfold,illidan,1050,warlock,affliction,24,11,13
Naburn,tichondrius,1049,warlock,affliction,24,11,13
Eastwitch,ragnaros,1048,warlock,affliction,24,11,13
Pauldiesel,ragnaros,1048,warlock,affliction,26,11,15
Losecontrol,illidan,1046,warlock,affliction,18,11,7
Guacamolock,drakkari,1045,warlock,affliction,24,11,13
Cozu,tichondrius,1045,warlock,affliction,30,11,19
Amaroth,spinebreaker,1043,warlock,affliction,38,12,26
Mangku,frostmourne,1042,warlock,affliction,46,19,27
Teaset,hellscream,1039,warlock,affliction,66,33,33
Rorrlex,muradin,1037,warlock,affliction,42,20,22
Berszerk,quelthalas,1037,warlock,affliction,30,11,19
Hungovermate,barthilas,1036,warlock,affliction,18,13,5
Donnellus,frostmane,1028,warlock,affliction,24,14,10
Basticor,moon-guard,1024,warlock,affliction,42,18,24
Halzarn,agamaggan,1021,warlock,affliction,42,23,19
Medallok,laughing-skull,1021,warlock,affliction,54,28,26
Aerozyn,wyrmrest-accord,1012,warlock,affliction,42,23,19
Dirtydeikan,stormrage,1010,warlock,affliction,65,29,36
Duuka,malganis,1008,warlock,affliction,15,12,3
Darkestholy,illidan,1006,warlock,affliction,23,11,12
Shadöwdancer,uldum,1005,warlock,affliction,24,16,8
Jyxxy,arthas,1005,warlock,affliction,50,25,25
Arzenexx,malganis,1002,warlock,affliction,42,24,18
Corvos,garrosh,1001,warlock,affliction,32,12,20
Wizlox,illidan,996,warlock,affliction,33,11,22
Malleus,drakkari,992,warlock,affliction,50,22,28
Miredö,tichondrius,991,warlock,affliction,23,11,12
Testicoils,sargeras,988,warlock,affliction,20,11,9
Whydemono,tichondrius,982,warlock,affliction,26,11,15
Dreadloxx,whisperwind,979,warlock,affliction,48,23,25
Skrufenjoyer,sargeras,972,warlock,affliction,92,42,50
Medran,azralon,968,warlock,affliction,68,36,32
Maelganis,thrall,966,warlock,affliction,29,11,18
Avelmi,daggerspine,964,warlock,affliction,31,11,20
Wardocc,sargeras,962,warlock,affliction,66,31,35
Velanthra,skullcrusher,960,warlock,affliction,24,10,14
Tailsy,proudmoore,959,warlock,affliction,18,10,8
Lapandemica,gorefiend,959,warlock,affliction,24,10,14
Niubeelol,tichondrius,959,warlock,affliction,24,10,14
Bobbyross,garrosh,958,warlock,affliction,16,11,5
Malagas,tichondrius,958,warlock,affliction,18,10,8
Makumbeiro,sargeras,958,warlock,affliction,18,10,8
Cilium,illidan,958,warlock,affliction,18,10,8
Mxd,ragnaros,958,warlock,affliction,18,10,8
Downing,drakkari,958,warlock,affliction,71,26,45
Xdq,malganis,957,warlock,affliction,27,12,15
Ttub,stormrage,957,warlock,affliction,24,10,14
Qualio,thrall,957,warlock,affliction,24,10,14
Jìbril,stormrage,956,warlock,affliction,24,10,14
Buboñic,area-52,956,warlock,affliction,24,10,14
Jennifear,sargeras,952,warlock,affliction,18,10,8
Victani,gallywix,946,warlock,affliction,18,10,8
Oreo,velen,942,warlock,affliction,30,10,20
Avadakedávra,darkspear,941,warlock,affliction,18,10,8
Mpm,dragonmaw,906,warlock,affliction,30,15,15
Popdotdropit,frostwolf,895,warlock,affliction,17,10,7
Britainwl,azshara,892,warlock,affliction,30,13,17
Persianloc,tichondrius,888,warlock,affliction,29,10,19
Halciyon,dalvengyr,874,warlock,affliction,25,10,15
Ioroselmi,illidan,871,warlock,affliction,25,10,15
Nöxïöüs,sargeras,864,warlock,affliction,12,9,3
Quitxman,tichondrius,864,warlock,affliction,12,9,3
Conboee,tichondrius,864,warlock,affliction,12,9,3
Ruphilin,fizzcrank,864,warlock,affliction,12,9,3
Crayonchewer,alleria,864,warlock,affliction,18,9,9
Minglocked,proudmoore,864,warlock,affliction,18,9,9
Jfet,sargeras,864,warlock,affliction,18,9,9
Oldwing,illidan,864,warlock,affliction,18,9,9
Tvfazedorito,kelthuzad,864,warlock,affliction,18,9,9
Dejagu,tichondrius,864,warlock,affliction,24,9,15
Halloweèn,kelthuzad,863,warlock,affliction,12,9,3
Bjarke,malganis,863,warlock,affliction,12,9,3
Demonycc,archimonde,863,warlock,affliction,12,9,3
Devdolittle,tichondrius,863,warlock,affliction,18,9,9
Sslock,sargeras,863,warlock,affliction,18,9,9
Wanglock,blackrock,863,warlock,affliction,18,9,9
Búmchúm,frostmourne,863,warlock,affliction,18,9,9
Twilson,moon-guard,863,warlock,affliction,18,9,9
Kryllua,tichondrius,863,warlock,affliction,27,10,17
Nerd,fizzcrank,862,warlock,affliction,12,9,3
Sesyid,tichondrius,862,warlock,affliction,18,9,9
Astralrunner,moon-guard,862,warlock,affliction,18,9,9
Scarysherri,aggramar,862,warlock,affliction,24,9,15
Sarkahn,sargeras,862,warlock,affliction,24,9,15
Conkeldurr,tichondrius,861,warlock,affliction,12,9,3
Thisist,kiljaeden,861,warlock,affliction,12,9,3
Bignoselock,illidan,861,warlock,affliction,18,9,9
Vyntras,kelthuzad,861,warlock,affliction,18,9,9
Abyssisle,malygos,860,warlock,affliction,20,10,10
Holloch,bonechewer,860,warlock,affliction,18,9,9
Smockalock,proudmoore,857,warlock,affliction,18,9,9
Tinydotz,hydraxis,856,warlock,affliction,18,10,8
Mörgana,quelthalas,856,warlock,affliction,19,10,9
Yratiprocs,ysera,853,warlock,affliction,18,9,9
Lachs,jubeithos,844,warlock,affliction,18,9,9
Thetopg,bronzebeard,834,warlock,affliction,37,17,20
Mustacheguy,tichondrius,805,warlock,affliction,29,9,20
Handlevil,stormrage,787,warlock,affliction,16,9,7
Hexxüs,area-52,784,warlock,affliction,19,9,10
Demfearslol,terokkar,776,warlock,affliction,27,11,16
Púp,bleeding-hollow,768,warlock,affliction,12,8,4
Kåléïðøsçøpè,sargeras,768,warlock,affliction,12,8,4
Hutchyw,tichondrius,768,warlock,affliction,12,8,4
Dethklokx,tichondrius,768,warlock,affliction,12,8,4
Slothdots,tichondrius,768,warlock,affliction,12,8,4
Richãrdjr,area-52,768,warlock,affliction,12,8,4
Dötsonurpp,stormrage,768,warlock,affliction,12,8,4
Sadoldman,malganis,768,warlock,affliction,12,8,4
Frylockk,mugthol,768,warlock,affliction,18,8,10
Yogurtslingr,tichondrius,768,warlock,affliction,18,8,10
Herladytha,aegwynn,767,warlock,affliction,12,8,4
Pillçosby,bleeding-hollow,767,warlock,affliction,12,8,4
Brujoalfa,ragnaros,767,warlock,affliction,12,8,4
Wreckquiem,draka,767,warlock,affliction,12,8,4
Warlockmf,sargeras,767,warlock,affliction,12,8,4
Antigotenent,sargeras,767,warlock,affliction,12,8,4
Pokendot,illidan,767,warlock,affliction,18,8,10
Oblivious,firetree,767,warlock,affliction,18,8,10
Fearharder,stormrage,767,warlock,affliction,24,8,16
Arkterris,doomhammer,766,warlock,affliction,18,8,10
Divoc,zangarmarsh,766,warlock,affliction,18,8,10
Flixon,tichondrius,765,warlock,affliction,12,8,4
Çheesestick,dalaran,765,warlock,affliction,18,8,10
Bëëlzebub,crushridge,765,warlock,affliction,18,8,10
Aksness,stormrage,765,warlock,affliction,24,8,16
Dowglips,area-52,763,warlock,affliction,18,8,10
Cássandra,ragnaros,761,warlock,affliction,12,8,4
Radamantîs,ragnaros,761,warlock,affliction,18,8,10
Jakedbtw,crushridge,759,warlock,affliction,12,8,4
Covidkillerr,tichondrius,759,warlock,affliction,13,8,5
Rotfull,burning-legion,751,warlock,affliction,17,8,9
Seecurse,kelthuzad,735,warlock,affliction,17,8,9
Hiddentech,saurfang,719,warlock,affliction,11,8,3
Apéx,frostmourne,716,warlock,affliction,17,8,9
Amgs,frostmourne,714,warlock,affliction,23,11,12
Nuckz,whisperwind,687,warlock,affliction,14,9,5
Modot,tichondrius,685,warlock,affliction,23,9,14
Charïs,ragnaros,679,warlock,affliction,13,8,5
Dotfearspam,alterac-mountains,679,warlock,affliction,21,8,13
Casslight,tichondrius,672,warlock,affliction,12,7,5
Miratrix,moon-guard,672,warlock,affliction,12,7,5
Geofar,bleeding-hollow,672,warlock,affliction,12,7,5
Bakko,tichondrius,672,warlock,affliction,12,7,5
Kuhio,korgath,672,warlock,affliction,12,7,5
Halethadro,emerald-dream,672,warlock,affliction,12,7,5
Darkgaia,skullcrusher,672,warlock,affliction,12,7,5
Delaye,tichondrius,672,warlock,affliction,12,7,5
Oogren,korgath,672,warlock,affliction,18,7,11
Glortheeb,spirestone,672,warlock,affliction,18,7,11
Necromâncer,stormreaver,672,warlock,affliction,18,7,11
Icemanliddel,area-52,672,warlock,affliction,18,7,11
Aruotnof,nemesis,671,warlock,affliction,12,7,5
Ãids,khadgar,671,warlock,affliction,12,7,5
Killhorde,thunderlord,671,warlock,affliction,12,7,5
Tekkiez,barthilas,671,warlock,affliction,12,7,5
Zurp,wyrmrest-accord,671,warlock,affliction,12,7,5
Foxyloxy,hakkar,671,warlock,affliction,14,7,7
Djminuterice,bleeding-hollow,671,warlock,affliction,18,7,11
Afflicktion,frostmourne,671,warlock,affliction,18,7,11
Sapaqlia,quelthalas,671,warlock,affliction,18,7,11
Korguji,tichondrius,671,warlock,affliction,22,7,15
Kuoma,boulderfist,670,warlock,affliction,12,7,5
Skyvre,tichondrius,670,warlock,affliction,12,7,5
Afflicmindz,azralon,670,warlock,affliction,12,7,5
Miermortal,tichondrius,670,warlock,affliction,18,7,11
Magicbones,tichondrius,669,warlock,affliction,15,8,7
Deatthmoon,stormrage,669,warlock,affliction,15,8,7
Tsmcfker,tichondrius,669,warlock,affliction,22,9,13
Mefound,nerzhul,668,warlock,affliction,12,7,5
Imien,moknathal,668,warlock,affliction,27,7,20
Larlock,black-dragonflight,667,warlock,affliction,12,7,5
Balmir,tichondrius,658,warlock,affliction,18,7,11
Gummylock,frostmourne,623,warlock,affliction,11,7,4
Paparoxy,illidan,623,warlock,affliction,15,8,7
Puddlepiimp,illidan,622,warlock,affliction,17,7,10
Bludshadow,duskwood,620,warlock,affliction,21,7,14
Radiscul,dragonmaw,619,warlock,affliction,17,7,10
Yury,scarlet-crusade,617,warlock,affliction,17,7,10
Cezarz,tichondrius,592,warlock,affliction,13,7,6
Mfcalamity,uldum,591,warlock,affliction,11,7,4
Sluglishphsh,stormrage,576,warlock,affliction,12,6,6
Biubius,tichondrius,576,warlock,affliction,12,6,6
Dogfiend,spirestone,576,warlock,affliction,12,6,6
Fearophobic,illidan,576,warlock,affliction,12,6,6
Darkuul,malganis,576,warlock,affliction,12,6,6
Nihilus,anvilmar,576,warlock,affliction,12,6,6
Sikmagic,kelthuzad,576,warlock,affliction,12,6,6
Toelickerx,illidan,576,warlock,affliction,12,6,6
Datazdotcom,illidan,576,warlock,affliction,12,6,6
Aellorie,proudmoore,576,warlock,affliction,12,6,6
Astarõth,zuljin,576,warlock,affliction,12,6,6
Nadablast,tichondrius,576,warlock,affliction,12,6,6
Xtremegirth,zuljin,576,warlock,affliction,12,6,6
Abrocket,alleria,576,warlock,affliction,12,6,6
Løcalplugxø,barthilas,576,warlock,affliction,12,6,6
Shadøwy,nemesis,576,warlock,affliction,12,6,6
Kamohoalii,bleeding-hollow,576,warlock,affliction,12,6,6
Chrishasnen,moon-guard,576,warlock,affliction,12,6,6
Neevius,barthilas,576,warlock,affliction,12,6,6
Brunemon,proudmoore,576,warlock,affliction,12,6,6
Lilcarmy,emerald-dream,576,warlock,affliction,12,6,6
Lokkup,dalaran,576,warlock,affliction,12,6,6
Caenzen,bleeding-hollow,576,warlock,affliction,12,6,6
Khil,darkspear,576,warlock,affliction,12,6,6
Haross,darkspear,576,warlock,affliction,18,6,12
Demiloy,stormrage,576,warlock,affliction,18,6,12
Parishiltoon,frostmourne,576,warlock,affliction,18,6,12
Muchø,emerald-dream,576,warlock,affliction,24,6,18
Drivercurses,terenas,575,warlock,affliction,12,6,6
Gødmôde,tichondrius,575,warlock,affliction,12,6,6
Jhop,sargeras,575,warlock,affliction,12,6,6
Leroybrown,alterac-mountains,575,warlock,affliction,12,6,6
Kunozonbi,malganis,575,warlock,affliction,12,6,6
Shadowbo,aggramar,575,warlock,affliction,12,6,6
Valvravé,malganis,575,warlock,affliction,12,6,6
Infortunium,sargeras,575,warlock,affliction,12,6,6
Halesatan,tichondrius,575,warlock,affliction,20,7,13
Blacadder,azgalor,575,warlock,affliction,18,6,12
Zuldar,tichondrius,575,warlock,affliction,18,6,12
Holdmybeard,senjin,575,warlock,affliction,18,6,12
Saraden,illidan,575,warlock,affliction,18,6,12
Bloodybooger,area-52,574,warlock,affliction,12,6,6
Conrii,burning-blade,574,warlock,affliction,18,6,12
Sind,garona,573,warlock,affliction,12,6,6
Lockë,thunderlord,572,warlock,affliction,12,6,6
Hâunted,khazgoroth,571,warlock,affliction,12,6,6
Kflexxpt,hydraxis,569,warlock,affliction,12,6,6
Justero,kelthuzad,569,warlock,affliction,12,6,6
Socketriver,bleeding-hollow,568,warlock,affliction,18,6,12
Bigheadjr,gorgonnash,543,warlock,affliction,17,6,11
Raff,detheroc,527,warlock,affliction,11,6,5
Louuis,barthilas,521,warlock,affliction,13,7,6
Vrajitor,ragnaros,511,warlock,affliction,11,6,5
Markuss,boulderfist,511,warlock,affliction,14,6,8
Dotdoctor,thrall,511,warlock,affliction,16,6,10
Oluluo,andorhal,510,warlock,affliction,8,6,2
Beexy,sargeras,510,warlock,affliction,14,6,8
Bobthedragqn,proudmoore,480,warlock,affliction,6,5,1
Lucro,emerald-dream,480,warlock,affliction,6,5,1
Varix,frostmourne,480,warlock,affliction,6,5,1
Satunir,shadowsong,480,warlock,affliction,6,5,1
Gaza,malganis,480,warlock,affliction,6,5,1
Flòwstate,tichondrius,480,warlock,affliction,6,5,1
Fruityß,kaelthas,480,warlock,affliction,6,5,1
Swapchan,sargeras,480,warlock,affliction,6,5,1
Faschom,tichondrius,480,warlock,affliction,6,5,1
Misolock,sargeras,480,warlock,affliction,6,5,1
Lunazz,tichondrius,480,warlock,affliction,6,5,1
Ribman,stormrage,480,warlock,affliction,6,5,1
Mhael,lightninghoof,480,warlock,affliction,12,5,7
Itsmedirt,malganis,480,warlock,affliction,12,5,7
Kerokafe,azralon,480,warlock,affliction,12,5,7
Rexuss,velen,480,warlock,affliction,12,5,7
Mattclipword,azralon,480,warlock,affliction,12,5,7
Bwup,tichondrius,480,warlock,affliction,12,5,7
Sairic,azralon,480,warlock,affliction,12,5,7
Goldface,frostmourne,480,warlock,affliction,12,5,7
Eflock,barthilas,480,warlock,affliction,12,5,7
Poogâ,tichondrius,480,warlock,affliction,12,5,7
Prarkmur,illidan,480,warlock,affliction,12,5,7
Andrewpg,zuljin,480,warlock,affliction,12,5,7
Lübelock,illidan,480,warlock,affliction,12,5,7
Chaoz,aggramar,480,warlock,affliction,12,5,7
Artzul,tichondrius,480,warlock,affliction,12,5,7
Perfectwar,tichondrius,480,warlock,affliction,12,5,7
Jaybro,thaurissan,480,warlock,affliction,12,5,7
Cryolock,nagrand,480,warlock,affliction,12,5,7
Necrosith,ragnaros,480,warlock,affliction,15,6,9
Lockboxx,stormscale,480,warlock,affliction,18,5,13
Daesire,moon-guard,480,warlock,affliction,18,5,13
Sosomaa,kelthuzad,480,warlock,affliction,18,5,13
Lockring,zuljin,480,warlock,affliction,18,5,13
Morepetss,saurfang,479,warlock,affliction,12,5,7
Pruevolf,tichondrius,479,warlock,affliction,12,5,7
Tatemor,barthilas,479,warlock,affliction,12,5,7
Hélà,sargeras,479,warlock,affliction,18,5,13
Whitchpoison,nagrand,479,warlock,affliction,30,5,25
Cityswimmer,malganis,478,warlock,affliction,12,5,7
Dravin,alleria,478,warlock,affliction,12,5,7
Redbro,darkspear,478,warlock,affliction,12,5,7
Fearfactory,lethon,478,warlock,affliction,12,5,7
Skellisama,moon-guard,478,warlock,affliction,18,5,13
Suzüki,tichondrius,463,warlock,affliction,11,5,6
Verrøkel,sargeras,426,warlock,affliction,11,7,4
Rainmakers,moon-guard,426,warlock,affliction,14,6,8
Fublizz,black-dragonflight,416,warlock,affliction,10,5,5
Khaozx,ragnaros,416,warlock,affliction,10,5,5
Onlytoez,tichondrius,416,warlock,affliction,16,5,11
Kuroyt,drakkari,415,warlock,affliction,12,6,6
Tonickush,area-52,384,warlock,affliction,6,4,2
Åbyssal,stormrage,384,warlock,affliction,6,4,2
Blliizz,aegwynn,384,warlock,affliction,6,4,2
Breeped,tichondrius,384,warlock,affliction,6,4,2
Celin,rivendare,384,warlock,affliction,6,4,2
Hellbraive,queldorei,384,warlock,affliction,6,4,2
Drugia,stormrage,384,warlock,affliction,6,4,2
Shaddows,nathrezim,384,warlock,affliction,6,4,2
Redmist,arthas,384,warlock,affliction,6,4,2
Gümbÿ,illidan,384,warlock,affliction,6,4,2
Torchie,moon-guard,384,warlock,affliction,6,4,2
Eupheriia,thaurissan,384,warlock,affliction,6,4,2
Zekjojo,turalyon,384,warlock,affliction,6,4,2
Gasgrassnass,sargeras,384,warlock,affliction,6,4,2
Purplelambox,illidan,384,warlock,affliction,6,4,2
Jotkbe,ragnaros,384,warlock,affliction,6,4,2
Flippinfear,illidan,384,warlock,affliction,6,4,2
Silkxy,frostwolf,384,warlock,affliction,6,4,2
Omegapasta,illidan,384,warlock,affliction,6,4,2
Richãrd,area-52,384,warlock,affliction,6,4,2
Walterrør,nemesis,384,warlock,affliction,6,4,2
Methrocks,tichondrius,384,warlock,affliction,6,4,2
Hypnotikal,illidan,384,warlock,affliction,6,4,2
Siller,azralon,384,warlock,affliction,6,4,2
Calvärr,bleeding-hollow,384,warlock,affliction,6,4,2
Superbroly,area-52,384,warlock,affliction,6,4,2
Demoiceman,bleeding-hollow,384,warlock,affliction,6,4,2
Plsdontcrit,tichondrius,384,warlock,affliction,6,4,2
Omleaf,malganis,384,warlock,affliction,6,4,2
Vamperro,thrall,384,warlock,affliction,6,4,2
Bänno,bleeding-hollow,384,warlock,affliction,6,4,2
Discordance,zuljin,384,warlock,affliction,6,4,2
Rbnz,kiljaeden,384,warlock,affliction,6,4,2
Cowboydann,malganis,384,warlock,affliction,6,4,2
Locker,darkspear,384,warlock,affliction,6,4,2
Bliztivision,proudmoore,384,warlock,affliction,6,4,2
Soulrman,tichondrius,384,warlock,affliction,6,4,2
Jessndistres,stormrage,384,warlock,affliction,6,4,2
Necroraise,boulderfist,384,warlock,affliction,9,5,4
Yagumi,crushridge,384,warlock,affliction,12,4,8
Bharim,quelthalas,384,warlock,affliction,12,4,8
Tylandér,nordrassil,384,warlock,affliction,12,4,8
Duckboji,tichondrius,384,warlock,affliction,12,4,8
Tichonkimc,tichondrius,384,warlock,affliction,12,4,8
Promancer,drakkari,384,warlock,affliction,12,4,8
Punstable,tichondrius,384,warlock,affliction,12,4,8
Demonug,area-52,384,warlock,affliction,12,4,8
Emptyx,tichondrius,384,warlock,affliction,12,4,8
Fksm,tichondrius,384,warlock,affliction,12,4,8
Bïcho,queldorei,384,warlock,affliction,12,4,8
Emptysoul,illidan,384,warlock,affliction,12,4,8
Dotsfìred,tichondrius,384,warlock,affliction,12,4,8
Bmó,stormrage,384,warlock,affliction,12,4,8
Fearedit,bleeding-hollow,384,warlock,affliction,12,4,8
Nethron,the-venture-co,384,warlock,affliction,12,4,8
Lockie,skywall,384,warlock,affliction,12,4,8
Necromaniac,nerzhul,384,warlock,affliction,18,4,14
Lockazo,quelthalas,383,warlock,affliction,6,4,2
Lefrancais,area-52,383,warlock,affliction,6,4,2
Coofy,ragnaros,383,warlock,affliction,6,4,2
Wirthless,area-52,383,warlock,affliction,12,4,8
Luciffer,windrunner,383,warlock,affliction,12,4,8
Slord,bonechewer,382,warlock,affliction,6,4,2
Darkdestine,emerald-dream,382,warlock,affliction,12,4,8
Damint,sargeras,351,warlock,affliction,11,4,7
Xaemog,tichondrius,351,warlock,affliction,17,4,13
Gattsonn,kiljaeden,350,warlock,affliction,12,5,7
Debs,sargeras,319,warlock,affliction,5,4,1
Jancilianna,stormrage,318,warlock,affliction,8,4,4
Heavyøfmetal,tol-barad,316,warlock,affliction,14,4,10
Brujildå,area-52,304,warlock,affliction,13,4,9
Marinw,azralon,304,warlock,affliction,13,4,9
Chåndler,nemesis,288,warlock,affliction,6,3,3
Arnan,korgath,288,warlock,affliction,6,3,3
Liliasintera,dentarg,288,warlock,affliction,6,3,3
Feldubya,illidan,288,warlock,affliction,6,3,3
Yanlexx,stormrage,288,warlock,affliction,6,3,3
Capïrota,nemesis,288,warlock,affliction,6,3,3
Harleyjames,ravenholdt,288,warlock,affliction,6,3,3
Chaôtic,daggerspine,288,warlock,affliction,6,3,3
Berathelok,aerie-peak,288,warlock,affliction,6,3,3
Kossnen,shandris,288,warlock,affliction,6,3,3
Hauntu,stormreaver,288,warlock,affliction,6,3,3
Blockk,moknathal,288,warlock,affliction,6,3,3
Dodgebolts,khaz-modan,288,warlock,affliction,6,3,3
Phishdots,tichondrius,288,warlock,affliction,6,3,3
Æonas,bladefist,288,warlock,affliction,6,3,3
Schofen,tichondrius,288,warlock,affliction,6,3,3
Hachiui,galakrond,288,warlock,affliction,6,3,3
Kokushu,burning-legion,288,warlock,affliction,6,3,3
Stepzxo,sargeras,288,warlock,affliction,6,3,3
Vickerzz,barthilas,288,warlock,affliction,6,3,3
Sinaman,barthilas,288,warlock,affliction,6,3,3
Bajheerafan,illidan,288,warlock,affliction,6,3,3
Saltycracka,stormrage,288,warlock,affliction,6,3,3
Nozyroh,emerald-dream,288,warlock,affliction,6,3,3
Vintagepoop,sargeras,288,warlock,affliction,6,3,3
Stormrift,sargeras,288,warlock,affliction,6,3,3
Shadows,arygos,288,warlock,affliction,6,3,3
Drdoom,sargeras,288,warlock,affliction,6,3,3
Alarauca,nerzhul,288,warlock,affliction,6,3,3
Malicandra,lightbringer,288,warlock,affliction,6,3,3
Voltshot,tichondrius,288,warlock,affliction,6,3,3
Tazerr,sargeras,288,warlock,affliction,6,3,3
Manapouli,area-52,288,warlock,affliction,6,3,3
Emurog,icecrown,288,warlock,affliction,6,3,3
Impbiscuit,stormrage,288,warlock,affliction,6,3,3
Frylockx,mugthol,288,warlock,affliction,6,3,3
Diablox,silvermoon,288,warlock,affliction,6,3,3
Knäbue,tichondrius,288,warlock,affliction,6,3,3
Warfeen,malganis,288,warlock,affliction,6,3,3
Wizie,arthas,288,warlock,affliction,6,3,3
Róckroad,lightnings-blade,288,warlock,affliction,6,3,3
Crucifieds,tichondrius,288,warlock,affliction,6,3,3
Naag,tichondrius,288,warlock,affliction,6,3,3
Conboii,tichondrius,288,warlock,affliction,6,3,3
Drugmuffin,tichondrius,288,warlock,affliction,6,3,3
Boltqt,tichondrius,288,warlock,affliction,6,3,3
Sidiouss,dreadmaul,288,warlock,affliction,6,3,3
Xerozus,tichondrius,288,warlock,affliction,6,3,3
Drböb,area-52,288,warlock,affliction,6,3,3
Redsolojdc,tichondrius,288,warlock,affliction,6,3,3
Kamai,frostwolf,288,warlock,affliction,6,3,3
Freseate,quelthalas,288,warlock,affliction,6,3,3
Leônidos,ghostlands,288,warlock,affliction,6,3,3
Chermonalbur,draka,288,warlock,affliction,9,3,6
Grendaldots,tichondrius,288,warlock,affliction,12,3,9
Aluridan,azralon,288,warlock,affliction,12,3,9
Ÿoucantwin,kiljaeden,288,warlock,affliction,12,3,9
Drdemons,kelthuzad,288,warlock,affliction,12,3,9
Denji,galakrond,288,warlock,affliction,12,3,9
Lithani,ragnaros,288,warlock,affliction,12,3,9
Avii,drakthul,288,warlock,affliction,12,3,9
Ezzako,area-52,288,warlock,affliction,12,3,9
Davnport,frostmourne,288,warlock,affliction,12,3,9
Culture,arthas,288,warlock,affliction,12,3,9
Tromeo,sargeras,288,warlock,affliction,12,3,9
Feelthefearx,ragnaros,288,warlock,affliction,12,3,9
Orelauk,rexxar,288,warlock,affliction,12,3,9
Provilock,moon-guard,288,warlock,affliction,12,3,9
Llkoreall,tichondrius,288,warlock,affliction,12,3,9
Mynerve,velen,288,warlock,affliction,12,3,9
Atticassasin,stormrage,288,warlock,affliction,12,3,9
Felno,emerald-dream,288,warlock,affliction,12,3,9
Camila,lightnings-blade,288,warlock,affliction,12,3,9
Condevil,quelthalas,288,warlock,affliction,18,3,15
Angel,sargeras,288,warlock,affliction,18,3,15
Castshadow,nordrassil,288,warlock,affliction,18,3,15
Jjesie,tichondrius,288,warlock,affliction,18,3,15
Nhen,daggerspine,287,warlock,affliction,6,3,3
Vizkopnik,bleeding-hollow,287,warlock,affliction,6,3,3
Kashog,earthen-ring,287,warlock,affliction,15,4,11
Nessima,jubeithos,287,warlock,affliction,12,3,9
Lowkei,stonemaul,286,warlock,affliction,6,3,3
Lilthicy,sargeras,271,warlock,affliction,14,3,11
Kentus,moonrunner,255,warlock,affliction,14,4,10
Niava,tichondrius,239,warlock,affliction,5,3,2
Matzoball,zuljin,234,warlock,affliction,14,4,10
Hoana,azralon,233,warlock,affliction,8,4,4
Siltharious,dalaran,232,warlock,affliction,15,5,10
Pillçosby,tichondrius,224,warlock,affliction,10,3,7
Lifelock,auchindoun,223,warlock,affliction,8,3,5
Spookytrev,stormrage,223,warlock,affliction,14,3,11
Payn,kiljaeden,192,warlock,affliction,6,2,4
Screwed,tichondrius,192,warlock,affliction,6,2,4
Leruss,zangarmarsh,192,warlock,affliction,6,2,4
Trillas,illidan,192,warlock,affliction,6,2,4
Ørfna,zuljin,192,warlock,affliction,6,2,4
Vessires,darkspear,192,warlock,affliction,6,2,4
Lilitht,drakkari,192,warlock,affliction,6,2,4
Zörkô,zuljin,192,warlock,affliction,6,2,4
Døtyou,area-52,192,warlock,affliction,6,2,4
Dotdottgoose,kiljaeden,192,warlock,affliction,6,2,4
Jacorian,illidan,192,warlock,affliction,6,2,4
Yahihlock,silver-hand,192,warlock,affliction,6,2,4
Ðeãdman,bleeding-hollow,192,warlock,affliction,6,2,4
Grixis,zuluhed,192,warlock,affliction,6,2,4
Carcine,frostwolf,192,warlock,affliction,6,2,4
Cheesëbolt,illidan,192,warlock,affliction,6,2,4
Es,velen,192,warlock,affliction,6,2,4
Lysergica,bleeding-hollow,192,warlock,affliction,6,2,4
Matilla,tichondrius,192,warlock,affliction,6,2,4
Ministàff,ursin,192,warlock,affliction,6,2,4
Bktheruler,tichondrius,192,warlock,affliction,6,2,4
Destructo,illidan,192,warlock,affliction,6,2,4
Yolandahadid,gilneas,192,warlock,affliction,6,2,4
Sylorelol,stormreaver,192,warlock,affliction,6,2,4
Damerus,illidan,192,warlock,affliction,6,2,4
Willogan,gurubashi,192,warlock,affliction,6,2,4
Deanwarlock,sargeras,192,warlock,affliction,6,2,4
Fearsntears,stormrage,192,warlock,affliction,6,2,4
Soularonomy,tichondrius,192,warlock,affliction,6,2,4
Khurze,area-52,192,warlock,affliction,6,2,4
Anastadora,proudmoore,192,warlock,affliction,6,2,4
Sebss,proudmoore,192,warlock,affliction,6,2,4
Rerollx,firetree,192,warlock,affliction,6,2,4
Lockboss,malganis,192,warlock,affliction,6,2,4
Fondlemydot,stormscale,192,warlock,affliction,6,2,4
Lcomi,tichondrius,192,warlock,affliction,6,2,4
Fearanddots,moon-guard,192,warlock,affliction,6,2,4
Charmandfarm,nerzhul,192,warlock,affliction,6,2,4
Jèdi,drenden,192,warlock,affliction,6,2,4
Karmalock,malganis,192,warlock,affliction,6,2,4
Lockednloade,tichondrius,192,warlock,affliction,6,2,4
Meelady,tichondrius,192,warlock,affliction,6,2,4
Raínstilted,area-52,192,warlock,affliction,6,2,4
Hellfires,ragnaros,192,warlock,affliction,6,2,4
Scepti,area-52,192,warlock,affliction,6,2,4
Bóózér,tichondrius,192,warlock,affliction,6,2,4
Thralord,blackrock,192,warlock,affliction,6,2,4
Deadlockseeu,area-52,192,warlock,affliction,6,2,4
Plaguedoctor,stormrage,192,warlock,affliction,6,2,4
Veerdz,area-52,192,warlock,affliction,6,2,4
Narsdemons,tichondrius,192,warlock,affliction,6,2,4
Pk,azralon,192,warlock,affliction,6,2,4
Asmodeun,malganis,192,warlock,affliction,6,2,4
Apøçàlÿpsè,firetree,192,warlock,affliction,6,2,4
Dawaatisme,zuljin,192,warlock,affliction,6,2,4
Nècrósìs,area-52,192,warlock,affliction,6,2,4
Vorlos,bonechewer,192,warlock,affliction,6,2,4
Apolodys,garona,192,warlock,affliction,6,2,4
Xoxoxu,frostmourne,192,warlock,affliction,6,2,4
Nerolock,frostmourne,192,warlock,affliction,6,2,4
Yurick,frostmourne,192,warlock,affliction,6,2,4
Nightterrour,frostmourne,192,warlock,affliction,6,2,4
Thumperrz,frostmourne,192,warlock,affliction,6,2,4
Noggét,frostmourne,192,warlock,affliction,6,2,4
Abomasnow,frostmourne,192,warlock,affliction,6,2,4
Omagg,malorne,192,warlock,affliction,12,2,10
Tormentedcat,nazjatar,192,warlock,affliction,12,2,10
Dloq,azgalor,192,warlock,affliction,12,2,10
Refîk,sargeras,192,warlock,affliction,12,2,10
Sürfacing,malganis,192,warlock,affliction,12,2,10
Leviathen,shattered-hand,192,warlock,affliction,12,2,10
Rurnt,bloodhoof,192,warlock,affliction,13,2,11
Dotlockndrop,stormreaver,159,warlock,affliction,5,2,3
Ceranius,emerald-dream,159,warlock,affliction,5,2,3
Ramone,turalyon,159,warlock,affliction,5,2,3
Ferich,azralon,159,warlock,affliction,5,2,3
Zaiocian,tichondrius,159,warlock,affliction,5,2,3
Gutterxfox,malganis,159,warlock,affliction,11,2,9
Wartoyy,uldum,128,warlock,affliction,4,2,2
Pwnasaurus,barthilas,128,warlock,affliction,10,2,8
Drainedd,blades-edge,96,warlock,affliction,6,1,5
Xylõck,sargeras,96,warlock,affliction,6,1,5
Feár,emerald-dream,96,warlock,affliction,6,1,5
Rxjr,sargeras,96,warlock,affliction,6,1,5
Houseofpain,emerald-dream,96,warlock,affliction,6,1,5
Efg,illidan,96,warlock,affliction,6,1,5
Kammuany,sargeras,96,warlock,affliction,6,1,5
Volturnus,wildhammer,96,warlock,affliction,6,1,5
Conspiration,sargeras,96,warlock,affliction,6,1,5
Sylvahh,sargeras,96,warlock,affliction,6,1,5
Ehcsrop,doomhammer,96,warlock,affliction,6,1,5
Menedemus,amanthul,96,warlock,affliction,6,1,5
Shalandalina,sargeras,96,warlock,affliction,6,1,5
Malchiev,area-52,96,warlock,affliction,6,1,5
Chaøsbolt,area-52,96,warlock,affliction,6,1,5
Smôkedsôul,area-52,96,warlock,affliction,6,1,5
Frem,eonar,96,warlock,affliction,6,1,5
Haedn,stormrage,96,warlock,affliction,6,1,5
Ailliforlune,illidan,96,warlock,affliction,6,1,5
Alfemale,dalaran,96,warlock,affliction,6,1,5
Ørthox,malganis,96,warlock,affliction,6,1,5
Shennaniganz,bleeding-hollow,96,warlock,affliction,6,1,5
Locktimes,ragnaros,96,warlock,affliction,6,1,5
Pinkypay,ragnaros,96,warlock,affliction,6,1,5
Gamecobra,greymane,96,warlock,affliction,6,1,5
Sunkuna,aerie-peak,96,warlock,affliction,6,1,5
Superbvious,lothar,96,warlock,affliction,6,1,5
Apocryphh,stormrage,96,warlock,affliction,6,1,5
Mobilecherpn,frostmourne,96,warlock,affliction,6,1,5
Krozu,bleeding-hollow,96,warlock,affliction,6,1,5
Aedarine,uldum,96,warlock,affliction,6,1,5
Cornboil,tichondrius,96,warlock,affliction,6,1,5
Mickylock,tichondrius,96,warlock,affliction,6,1,5
Frdchickiana,tichondrius,96,warlock,affliction,6,1,5
Carabelois,aegwynn,96,warlock,affliction,6,1,5
Tuhdah,frostwolf,96,warlock,affliction,6,1,5
Olgreg,daggerspine,96,warlock,affliction,6,1,5
Fabiusbilex,tichondrius,96,warlock,affliction,6,1,5
Nêcro,moon-guard,96,warlock,affliction,6,1,5
Malignant,tichondrius,96,warlock,affliction,6,1,5
Bluffzlock,boulderfist,96,warlock,affliction,6,1,5
Joseph,draktharon,96,warlock,affliction,6,1,5
Imhereforrbg,moon-guard,96,warlock,affliction,6,1,5
Pikvas,darkspear,96,warlock,affliction,6,1,5
Newmanz,nerzhul,96,warlock,affliction,6,1,5
Guinegobbler,hyjal,96,warlock,affliction,6,1,5
Fenrinozil,tichondrius,96,warlock,affliction,12,1,11
Shendù,stormrage,79,warlock,affliction,5,1,4
Demí,zuljin,79,warlock,affliction,5,1,4
Zuelu,tichondrius,64,warlock,affliction,4,1,3
Handler,earthen-ring,63,warlock,affliction,4,1,3
Mìrä,kelthuzad,48,warlock,affliction,3,1,2
Amaia,nathrezim,48,warlock,affliction,3,1,2
Voldmorto,azralon,42,warlock,affliction,8,2,6
Delete,greymane,16,warlock,affliction,1,1,0
Halix,emerald-dream,16,warlock,affliction,1,1,0
Ttvdjrio,area-52,2202,warrior,fury,102,63,39
Orclog,illidan,2168,warrior,fury,149,82,67
Yadiig,illidan,2150,warrior,fury,78,50,28
Thrator,wyrmrest-accord,2132,warrior,fury,114,59,55
Grimgrip,frostmane,2131,warrior,fury,92,53,39
Joshiman,area-52,2131,warrior,fury,87,43,44
Notwarried,sargeras,2126,warrior,fury,137,69,68
Cabelastwo,tichondrius,2124,warrior,fury,87,46,41
Americanbull,moon-guard,2119,warrior,fury,253,134,119
Takeda,sargeras,2117,warrior,fury,107,61,46
Cabelas,tichondrius,2112,warrior,fury,89,45,44
Braxxínn,tichondrius,2107,warrior,fury,54,39,15
Coldlòve,akama,2076,warrior,fury,106,61,45
Sandronb,illidan,2059,warrior,fury,107,57,50
Riproarin,stormrage,2051,warrior,fury,110,60,50
Biaa,tichondrius,2030,warrior,fury,84,40,44
Taras,blackhand,2025,warrior,fury,171,83,88
Wienertoes,tichondrius,2020,warrior,fury,120,68,52
Sworda,sargeras,2018,warrior,fury,89,54,35
Furrytakeda,kelthuzad,2018,warrior,fury,158,86,72
Warqt,kelthuzad,2011,warrior,fury,105,58,47
Eazyc,tichondrius,2009,warrior,fury,227,122,105
Gazzef,thrall,1990,warrior,fury,132,71,61
Chillawigs,kelthuzad,1983,warrior,fury,84,47,37
Rôxi,malganis,1983,warrior,fury,300,157,143
Hìm,tichondrius,1968,warrior,fury,96,51,45
Shadax,bleeding-hollow,1966,warrior,fury,311,169,142
Ðêed,area-52,1966,warrior,fury,78,41,37
Ragwreck,bleeding-hollow,1959,warrior,fury,68,35,33
Nailah,illidan,1948,warrior,fury,181,100,81
Dowser,goldrinn,1938,warrior,fury,167,90,77
Eno,ragnaros,1937,warrior,fury,69,46,23
Gromkhor,tichondrius,1935,warrior,fury,48,29,19
Cannabiddies,illidan,1932,warrior,fury,60,31,29
Lahired,drakkari,1930,warrior,fury,250,122,128
Alabamá,sargeras,1925,warrior,fury,36,21,15
Turboboy,tichondrius,1911,warrior,fury,36,24,12
Ásúrá,quelthalas,1909,warrior,fury,54,33,21
Veevz,proudmoore,1908,warrior,fury,132,62,70
Druzhinik,moon-guard,1902,warrior,fury,179,102,77
Mphx,tichondrius,1901,warrior,fury,54,32,22
Killbørn,azralon,1898,warrior,fury,54,30,24
Szauren,stormrage,1898,warrior,fury,75,37,38
Tøpg,sargeras,1897,warrior,fury,67,39,28
Blgjb,tichondrius,1894,warrior,fury,90,41,49
Chopemupp,area-52,1885,warrior,fury,101,60,41
Rekatron,area-52,1885,warrior,fury,61,30,31
Okme,tichondrius,1882,warrior,fury,66,36,30
Onîkudakì,sargeras,1878,warrior,fury,126,79,47
Badvelic,tichondrius,1874,warrior,fury,46,28,18
Darkduke,tichondrius,1870,warrior,fury,39,26,13
Zanzaa,sargeras,1870,warrior,fury,85,47,38
Hlt,tichondrius,1869,warrior,fury,66,38,28
Shîzu,moon-guard,1868,warrior,fury,102,67,35
Vèév,proudmoore,1866,warrior,fury,68,43,25
Unbreakkable,tichondrius,1866,warrior,fury,100,56,44
Negleçt,stormrage,1861,warrior,fury,36,23,13
ßdm,illidan,1860,warrior,fury,54,26,28
Damonadrann,proudmoore,1859,warrior,fury,66,34,32
Zak,feathermoon,1852,warrior,fury,41,30,11
Mchamstring,stormrage,1846,warrior,fury,51,30,21
Jimjinjin,tichondrius,1844,warrior,fury,96,50,46
Âragorn,tichondrius,1837,warrior,fury,121,66,55
Esilox,area-52,1836,warrior,fury,42,28,14
Ethyrie,ragnaros,1836,warrior,fury,61,34,27
Lokityr,tichondrius,1834,warrior,fury,36,26,10
Jenjang,proudmoore,1834,warrior,fury,83,52,31
Zankets,area-52,1833,warrior,fury,48,29,19
Burger,the-underbog,1830,warrior,fury,30,21,9
Brainhaze,tichondrius,1829,warrior,fury,36,21,15
Ggull,tichondrius,1827,warrior,fury,47,28,19
Nilah,tichondrius,1827,warrior,fury,118,68,50
Kennäy,azralon,1827,warrior,fury,52,29,23
Ragwreckz,bleeding-hollow,1826,warrior,fury,52,32,20
Zugyu,tichondrius,1825,warrior,fury,30,25,5
Soymong,frostmourne,1825,warrior,fury,116,74,42
Saîyanroyce,barthilas,1825,warrior,fury,131,74,57
Mty,tichondrius,1824,warrior,fury,54,35,19
Cleavxy,sargeras,1823,warrior,fury,54,37,17
Lingho,illidan,1822,warrior,fury,36,20,16
Gorehardt,illidan,1822,warrior,fury,60,28,32
Apocalyptist,stormrage,1821,warrior,fury,99,58,41
Thadamaja,kiljaeden,1821,warrior,fury,48,26,22
Bosswin,tichondrius,1820,warrior,fury,53,28,25
Illmindofpoo,kelthuzad,1818,warrior,fury,42,28,14
Sayjaki,stormrage,1818,warrior,fury,102,62,40
Isahri,moon-guard,1818,warrior,fury,110,64,46
Orchilles,illidan,1817,warrior,fury,60,35,25
Damiansuv,moon-guard,1817,warrior,fury,154,89,65
Openhardest,stormrage,1816,warrior,fury,41,27,14
Jírky,ragnaros,1816,warrior,fury,240,134,106
Zujuzo,moon-guard,1815,warrior,fury,111,64,47
Neôn,frostmourne,1815,warrior,fury,66,37,29
Onionsauce,frostmourne,1815,warrior,fury,161,90,71
Flexo,moon-guard,1815,warrior,fury,54,29,25
Gushee,medivh,1815,warrior,fury,71,38,33
Escånor,moon-guard,1814,warrior,fury,31,24,7
Dodgestrikes,khaz-modan,1814,warrior,fury,36,24,12
Slughorn,moon-guard,1814,warrior,fury,102,53,49
Kazora,zuljin,1813,warrior,fury,48,33,15
Gentlehugs,illidan,1813,warrior,fury,35,20,15
Donutwar,proudmoore,1813,warrior,fury,54,30,24
Crankyhorn,stormrage,1813,warrior,fury,60,31,29
Ramseyx,dalaran,1812,warrior,fury,34,20,14
Duxor,sargeras,1811,warrior,fury,70,41,29
Clumhaku,dalaran,1811,warrior,fury,88,48,40
Barafang,wyrmrest-accord,1811,warrior,fury,234,125,109
Ragemane,illidan,1811,warrior,fury,90,47,43
Psychogenic,barthilas,1810,warrior,fury,102,60,42
Smarthulk,tichondrius,1808,warrior,fury,90,55,35
Zyzz,scarlet-crusade,1807,warrior,fury,72,41,31
Killuall,sargeras,1807,warrior,fury,42,23,19
Crøm,tichondrius,1807,warrior,fury,114,61,53
Wagù,moon-guard,1805,warrior,fury,48,32,16
Starshattr,bleeding-hollow,1805,warrior,fury,108,64,44
Seoní,wyrmrest-accord,1805,warrior,fury,76,43,33
Maximad,moon-guard,1805,warrior,fury,108,58,50
Girioo,thrall,1802,warrior,fury,24,19,5
Franticlol,tichondrius,1802,warrior,fury,90,59,31
Kevy,arygos,1802,warrior,fury,72,40,32
Cubie,malganis,1802,warrior,fury,89,47,42
Brøly,sargeras,1800,warrior,fury,48,27,21
Holuntung,illidan,1796,warrior,fury,85,45,40
Volgarr,zuljin,1794,warrior,fury,57,34,23
Ágsgøðx,bleeding-hollow,1792,warrior,fury,150,81,69
Smexxin,tichondrius,1790,warrior,fury,36,21,15
Melifehorde,tichondrius,1790,warrior,fury,222,111,111
Pepétí,azralon,1788,warrior,fury,108,65,43
Furíous,thunderhorn,1788,warrior,fury,102,56,46
Dripgodx,malganis,1786,warrior,fury,66,37,29
Trackstarz,llane,1786,warrior,fury,114,63,51
Yawdamper,illidan,1782,warrior,fury,57,34,23
Rynkae,moon-guard,1782,warrior,fury,42,21,21
Sixtydolla,kelthuzad,1781,warrior,fury,67,38,29
Bbcapitalist,blackrock,1777,warrior,fury,65,35,30
Traumaj,bleeding-hollow,1776,warrior,fury,42,27,15
Sàndman,malganis,1775,warrior,fury,39,23,16
Giannï,chogall,1775,warrior,fury,72,41,31
Márcellus,illidan,1766,warrior,fury,113,65,48
Zoldian,tichondrius,1764,warrior,fury,95,51,44
Brodestar,sargeras,1759,warrior,fury,60,33,27
Skyja,quelthalas,1759,warrior,fury,54,25,29
Dahakawar,malganis,1757,warrior,fury,53,32,21
Veyrin,stormrage,1757,warrior,fury,156,88,68
Splasch,kelthuzad,1753,warrior,fury,83,39,44
Basedaf,frostmourne,1751,warrior,fury,183,98,85
Chopped,wyrmrest-accord,1750,warrior,fury,93,43,50
Cheiftain,dalaran,1747,warrior,fury,48,26,22
Lootacris,illidan,1746,warrior,fury,42,20,22
Alarìon,malganis,1745,warrior,fury,45,31,14
Sonyanalogue,frostmourne,1745,warrior,fury,54,29,25
Raveve,area-52,1744,warrior,fury,68,42,26
Ciege,illidan,1740,warrior,fury,66,38,28
Zoomgar,barthilas,1738,warrior,fury,50,34,16
Gooberbear,frostmourne,1736,warrior,fury,175,94,81
Choppiechop,area-52,1735,warrior,fury,60,34,26
Brimstoné,wyrmrest-accord,1732,warrior,fury,158,86,72
Bulgrim,moon-guard,1732,warrior,fury,121,62,59
Invinciblé,tichondrius,1730,warrior,fury,36,22,14
Beanstrom,tichondrius,1729,warrior,fury,77,39,38
Akaínu,area-52,1728,warrior,fury,48,27,21
Varrian,rivendare,1727,warrior,fury,126,73,53
Daedrion,dalaran,1726,warrior,fury,90,49,41
Budgetclap,nordrassil,1723,warrior,fury,72,36,36
Moelolita,illidan,1723,warrior,fury,41,19,22
Bigdude,frostwolf,1721,warrior,fury,48,24,24
Gomachi,moon-guard,1720,warrior,fury,84,39,45
Slamurai,moon-guard,1719,warrior,fury,24,18,6
Duochuanjun,illidan,1719,warrior,fury,48,26,22
Noramed,moon-guard,1718,warrior,fury,142,77,65
Warroiser,quelthalas,1718,warrior,fury,170,91,79
Tastý,moon-guard,1716,warrior,fury,36,23,13
Käggai,khadgar,1716,warrior,fury,91,50,41
Smache,tichondrius,1714,warrior,fury,29,19,10
Mulish,frostmourne,1712,warrior,fury,79,47,32
Wång,bonechewer,1710,warrior,fury,30,19,11
Ediann,elune,1709,warrior,fury,113,66,47
Hammerock,ragnaros,1709,warrior,fury,48,27,21
Bigfatork,area-52,1709,warrior,fury,112,55,57
Riggs,stonemaul,1706,warrior,fury,59,32,27
Oddyseey,moon-guard,1706,warrior,fury,54,27,27
Elkojack,nemesis,1705,warrior,fury,41,22,19
Keltanas,quelthalas,1704,warrior,fury,125,66,59
Dawx,thrall,1704,warrior,fury,42,22,20
Modì,sargeras,1703,warrior,fury,125,69,56
Faytful,thrall,1703,warrior,fury,60,27,33
Kinseb,doomhammer,1702,warrior,fury,84,49,35
Nazraill,aggramar,1699,warrior,fury,45,27,18
Flarkin,area-52,1699,warrior,fury,30,18,12
Blazingfury,area-52,1699,warrior,fury,115,59,56
Humanlog,illidan,1698,warrior,fury,36,21,15
Festergrin,area-52,1696,warrior,fury,84,45,39
Mochigome,moon-guard,1696,warrior,fury,97,49,48
Scolpi,stormrage,1695,warrior,fury,76,42,34
Bwandøn,moon-guard,1691,warrior,fury,72,43,29
Executed,blackhand,1691,warrior,fury,36,21,15
Vapyr,moon-guard,1691,warrior,fury,59,29,30
Vuraxx,area-52,1690,warrior,fury,36,25,11
Philsbbqnow,dark-iron,1690,warrior,fury,54,27,27
Nordama,stormrage,1686,warrior,fury,89,53,36
Berawar,tichondrius,1683,warrior,fury,90,47,43
Kintarra,malygos,1682,warrior,fury,53,30,23
Ðowser,area-52,1680,warrior,fury,24,18,6
Scrotedog,area-52,1680,warrior,fury,55,24,31
Tyroe,thunderhorn,1679,warrior,fury,36,22,14
Rikki,frostmourne,1678,warrior,fury,66,36,30
Torbajhorn,moon-guard,1676,warrior,fury,66,34,32
Garobber,stormrage,1676,warrior,fury,48,23,25
Thugdorr,sargeras,1675,warrior,fury,102,53,49
Morfoggore,ragnaros,1674,warrior,fury,73,34,39
Grantlol,illidan,1673,warrior,fury,30,20,10
Tenger,velen,1672,warrior,fury,125,72,53
Råmpågë,tichondrius,1671,warrior,fury,48,31,17
Nikon,bleeding-hollow,1671,warrior,fury,48,28,20
Tigas,icecrown,1671,warrior,fury,56,30,26
Zuggrok,zuljin,1671,warrior,fury,243,121,122
Lethu,tichondrius,1670,warrior,fury,54,32,22
Koei,illidan,1670,warrior,fury,48,28,20
Colorx,sargeras,1668,warrior,fury,82,46,36
Snugglebuggs,stormrage,1668,warrior,fury,143,74,69
Bopwar,malganis,1665,warrior,fury,48,29,19
Påpi,sargeras,1663,warrior,fury,90,54,36
Vinvivenna,emerald-dream,1663,warrior,fury,40,23,17
Moistt,nesingwary,1662,warrior,fury,44,28,16
Zugzugtime,tichondrius,1662,warrior,fury,70,41,29
Gaazhel,quelthalas,1662,warrior,fury,157,81,76
Drashi,nazjatar,1661,warrior,fury,78,46,32
Ianprime,the-scryers,1661,warrior,fury,66,37,29
Fanglerondz,area-52,1660,warrior,fury,30,20,10
Ystk,tichondrius,1659,warrior,fury,83,52,31
Sálieri,ragnaros,1659,warrior,fury,120,70,50
Larosfan,tichondrius,1659,warrior,fury,60,33,27
Râvik,illidan,1659,warrior,fury,105,53,52
Vulnscan,tichondrius,1659,warrior,fury,46,22,24
Alteryx,sargeras,1658,warrior,fury,244,132,112
Gladheateher,bonechewer,1658,warrior,fury,60,28,32
Onionlord,wyrmrest-accord,1657,warrior,fury,41,26,15
Freefighter,frostwolf,1656,warrior,fury,36,24,12
Orphasmic,moon-guard,1656,warrior,fury,52,30,22
Calder,malganis,1656,warrior,fury,72,36,36
Statistic,skullcrusher,1656,warrior,fury,70,32,38
Mezw,tichondrius,1655,warrior,fury,108,56,52
Dwarlan,stormrage,1654,warrior,fury,83,53,30
Firmware,illidan,1653,warrior,fury,39,19,20
Aotha,moon-guard,1652,warrior,fury,38,23,15
Conflíct,illidan,1652,warrior,fury,88,52,36
Zartren,khazgoroth,1651,warrior,fury,60,35,25
Malatov,moon-guard,1651,warrior,fury,78,42,36
Graverot,burning-legion,1651,warrior,fury,64,31,33
Klieterious,bleeding-hollow,1650,warrior,fury,114,60,54
Coalpit,emerald-dream,1650,warrior,fury,66,31,35
Rarefxck,tichondrius,1649,warrior,fury,27,19,8
Jarheadz,bleeding-hollow,1649,warrior,fury,48,32,16
Oiledman,emerald-dream,1649,warrior,fury,46,24,22
Joog,kalecgos,1649,warrior,fury,58,27,31
Axesage,tichondrius,1648,warrior,fury,72,41,31
Ashwalker,malganis,1648,warrior,fury,56,30,26
Tanorai,area-52,1647,warrior,fury,60,38,22
Eggdoubles,sargeras,1647,warrior,fury,33,19,14
Eregor,sargeras,1647,warrior,fury,54,27,27
Andorane,bleeding-hollow,1646,warrior,fury,72,39,33
Eggroll,emerald-dream,1646,warrior,fury,189,101,88
Kolosaltwo,tichondrius,1645,warrior,fury,111,58,53
Tinyexcute,tichondrius,1644,warrior,fury,48,25,23
Gorrtog,stormrage,1644,warrior,fury,284,145,139
Ballinx,illidan,1644,warrior,fury,48,21,27
Agragar,zuljin,1643,warrior,fury,30,18,12
Ssamba,shattered-hand,1643,warrior,fury,36,20,16
Faren,agamaggan,1643,warrior,fury,167,91,76
Traka,stormrage,1642,warrior,fury,36,19,17
Mandragorn,kelthuzad,1642,warrior,fury,71,37,34
Lowz,hyjal,1641,warrior,fury,32,23,9
Evilkorean,tichondrius,1641,warrior,fury,158,85,73
Wangjianguo,illidan,1641,warrior,fury,53,28,25
Jhalma,stormrage,1640,warrior,fury,42,20,22
Nogèt,frostmourne,1638,warrior,fury,47,28,19
Youaredafeds,moon-guard,1638,warrior,fury,137,77,60
Cupper,tichondrius,1638,warrior,fury,47,25,22
Sperow,malygos,1636,warrior,fury,73,42,31
Oxitowocina,quelthalas,1636,warrior,fury,54,30,24
Rücküs,tichondrius,1635,warrior,fury,122,75,47
Dardash,ragnaros,1634,warrior,fury,30,21,9
Udmwarrior,zuljin,1633,warrior,fury,54,24,30
Tithousand,tichondrius,1631,warrior,fury,77,46,31
Fearlessxq,tichondrius,1631,warrior,fury,148,85,63
Albinosword,azralon,1631,warrior,fury,92,51,41
Tádakatsu,sargeras,1631,warrior,fury,159,84,75
Gnomageddon,anetheron,1631,warrior,fury,88,41,47
Bloodfist,tichondrius,1630,warrior,fury,36,23,13
Moistmoocow,thrall,1629,warrior,fury,90,47,43
Thiccyb,area-52,1628,warrior,fury,24,17,7
Skollyd,tichondrius,1628,warrior,fury,32,20,12
Mers,garrosh,1628,warrior,fury,78,44,34
Naelynh,quelthalas,1628,warrior,fury,54,26,28
Kellyboitv,frostmourne,1628,warrior,fury,42,20,22
Dcashmoney,moon-guard,1627,warrior,fury,102,59,43
Zastrow,dalaran,1627,warrior,fury,42,23,19
Darkbunny,thaurissan,1627,warrior,fury,114,59,55
Illaedan,quelthalas,1627,warrior,fury,113,52,61
Dann,ragnaros,1626,warrior,fury,77,47,30
Arágorn,sargeras,1626,warrior,fury,66,39,27
Choppin,sargeras,1625,warrior,fury,36,22,14
Ugriker,skullcrusher,1623,warrior,fury,42,26,16
Scrümp,illidan,1622,warrior,fury,71,44,27
Quinntis,anvilmar,1622,warrior,fury,42,23,19
Rinima,tichondrius,1621,warrior,fury,136,70,66
Goaco,drakkari,1621,warrior,fury,45,22,23
Emv,area-52,1620,warrior,fury,36,20,16
Ðåddý,stormrage,1620,warrior,fury,149,73,76
Colössal,moon-guard,1616,warrior,fury,36,25,11
Sleazedog,kelthuzad,1616,warrior,fury,48,30,18
Nornogin,tichondrius,1616,warrior,fury,72,42,30
Swiftslaýer,vashj,1616,warrior,fury,141,72,69
Timbermack,moon-guard,1615,warrior,fury,30,18,12
Hârambe,kiljaeden,1614,warrior,fury,41,25,16
Hairygrundel,area-52,1614,warrior,fury,113,61,52
Zangetsy,sargeras,1612,warrior,fury,111,59,52
Cornmaster,darkspear,1612,warrior,fury,122,62,60
Damburga,tichondrius,1609,warrior,fury,48,30,18
Cokespoon,frostmourne,1609,warrior,fury,84,51,33
Khrull,khazgoroth,1609,warrior,fury,74,40,34
Celere,azralon,1609,warrior,fury,78,40,38
Kholusia,kul-tiras,1609,warrior,fury,148,70,78
Misakizs,sargeras,1609,warrior,fury,38,17,21
Guerreraa,ragnaros,1609,warrior,fury,83,37,46
Wrniss,tichondrius,1608,warrior,fury,48,31,17
Ohdang,dark-iron,1608,warrior,fury,221,119,102
Fluffyarm,sargeras,1607,warrior,fury,133,72,61
Georgedubya,illidan,1607,warrior,fury,48,20,28
Leviqt,moon-guard,1606,warrior,fury,36,21,15
Angryexe,zuljin,1605,warrior,fury,36,17,19
Vids,aegwynn,1604,warrior,fury,42,21,21
Swordmasters,icecrown,1603,warrior,fury,52,28,24
Trôca,ragnaros,1603,warrior,fury,54,29,25
Fearless,moon-guard,1603,warrior,fury,132,68,64
Velarrine,illidan,1603,warrior,fury,127,65,62
Orsex,ragnaros,1603,warrior,fury,47,23,24
Lilgucci,stonemaul,1602,warrior,fury,36,20,16
Coldshots,stormreaver,1602,warrior,fury,108,57,51
Gpro,tichondrius,1602,warrior,fury,42,21,21
Islik,stormrage,1601,warrior,fury,30,17,13
Fearlessly,moon-guard,1601,warrior,fury,215,115,100
Genesisblade,illidan,1601,warrior,fury,58,25,33
Krovikân,area-52,1600,warrior,fury,30,19,11
Soulfang,stormscale,1600,warrior,fury,36,20,16
Brutality,kirin-tor,1598,warrior,fury,107,57,50
Jimseung,tichondrius,1598,warrior,fury,60,29,31
Warrmachine,mannoroth,1597,warrior,fury,214,119,95
Flexid,tichondrius,1597,warrior,fury,80,41,39
Koffray,malfurion,1596,warrior,fury,59,30,29
Feetmann,illidan,1595,warrior,fury,90,55,35
Ngu,eldrethalas,1595,warrior,fury,35,18,17
Filamon,dentarg,1595,warrior,fury,71,30,41
Neurötic,ragnaros,1594,warrior,fury,30,20,10
Gurukakko,ragnaros,1594,warrior,fury,54,33,21
Gigatroll,tichondrius,1592,warrior,fury,59,30,29
Bártho,area-52,1591,warrior,fury,42,23,19
Wampzug,azshara,1591,warrior,fury,78,37,41
Easons,tichondrius,1591,warrior,fury,71,33,38
Larrybiscuit,moon-guard,1589,warrior,fury,190,108,82
Korthiasucks,area-52,1588,warrior,fury,30,19,11
Akkar,gilneas,1588,warrior,fury,55,27,28
Verigan,barthilas,1587,warrior,fury,36,21,15
Jadeemerald,kelthuzad,1585,warrior,fury,66,34,32
Hoodlark,lightbringer,1584,warrior,fury,81,47,34
Shapur,tichondrius,1583,warrior,fury,41,22,19
Torv,frostmourne,1581,warrior,fury,68,38,30
Shaøkahn,azralon,1580,warrior,fury,74,43,31
Kroozy,thrall,1580,warrior,fury,42,24,18
Zitfrlt,wildhammer,1579,warrior,fury,111,53,58
Grômm,tichondrius,1577,warrior,fury,75,42,33
Ezeji,area-52,1577,warrior,fury,42,23,19
Brøsk,azralon,1574,warrior,fury,108,58,50
Warriorbrain,wyrmrest-accord,1574,warrior,fury,36,17,19
Wolfcultist,moon-guard,1572,warrior,fury,117,54,63
Holddapoop,area-52,1571,warrior,fury,45,23,22
Antei,thunderlord,1569,warrior,fury,81,46,35
Strëngth,aggramar,1569,warrior,fury,94,50,44
Kombatwombat,kaelthas,1567,warrior,fury,53,30,23
Morguez,tichondrius,1566,warrior,fury,96,53,43
Gûard,stormrage,1566,warrior,fury,121,62,59
Ooze,darkspear,1564,warrior,fury,93,50,43
Impalle,nazjatar,1563,warrior,fury,60,37,23
Rekill,emerald-dream,1562,warrior,fury,36,19,17
Benchpress,bleeding-hollow,1560,warrior,fury,138,71,67
Jimmfro,zuljin,1559,warrior,fury,64,33,31
Nvzah,area-52,1556,warrior,fury,78,34,44
Igoboom,bleeding-hollow,1555,warrior,fury,52,27,25
Khargrok,ragnaros,1554,warrior,fury,147,80,67
Oppos,lightnings-blade,1553,warrior,fury,36,19,17
Rafurk,area-52,1552,warrior,fury,72,42,30
Bigßiceps,tichondrius,1552,warrior,fury,42,23,19
Hazknar,azralon,1549,warrior,fury,66,34,32
Stavsie,tichondrius,1548,warrior,fury,35,18,17
Chainsa,stormrage,1548,warrior,fury,36,18,18
Tempusbane,proudmoore,1548,warrior,fury,56,24,32
Sithlõrd,moon-guard,1547,warrior,fury,90,44,46
Rendwarchief,garrosh,1546,warrior,fury,161,82,79
Sugmad,area-52,1545,warrior,fury,48,22,26
Pitchman,tichondrius,1544,warrior,fury,59,32,27
Sìon,tichondrius,1543,warrior,fury,30,20,10
Xtargaryen,stormrage,1543,warrior,fury,32,20,12
Raggnarsøøn,ragnaros,1543,warrior,fury,101,47,54
Vongrave,moonrunner,1542,warrior,fury,30,19,11
Mereleona,quelthalas,1542,warrior,fury,48,26,22
Bigbungus,frostmourne,1542,warrior,fury,50,27,23
Lujzika,stormreaver,1539,warrior,fury,119,67,52
Zibby,malganis,1539,warrior,fury,36,18,18
Thraig,moon-guard,1538,warrior,fury,36,17,19
Pootyspootz,warsong,1536,warrior,fury,53,31,22
Jingson,moon-guard,1535,warrior,fury,39,21,18
Iceice,dalaran,1535,warrior,fury,82,41,41
Thren,tichondrius,1533,warrior,fury,36,19,17
Warborn,agamaggan,1533,warrior,fury,66,32,34
Arkey,queldorei,1532,warrior,fury,42,23,19
Romus,spirestone,1531,warrior,fury,72,40,32
Zombad,azralon,1530,warrior,fury,68,37,31
Baeowar,area-52,1529,warrior,fury,96,44,52
Linker,ragnaros,1528,warrior,fury,60,34,26
Grommrosh,azralon,1528,warrior,fury,42,19,23
Sïxsnacks,stormrage,1526,warrior,fury,32,19,13
Ðow,burning-blade,1526,warrior,fury,47,25,22
Hellamoist,tichondrius,1526,warrior,fury,66,30,36
Womanbeaterx,stormrage,1525,warrior,fury,38,24,14
Gryl,stormrage,1525,warrior,fury,65,29,36
Tctc,emerald-dream,1524,warrior,fury,41,22,19
Cohëëd,kelthuzad,1523,warrior,fury,119,64,55
Getthechoppa,aegwynn,1523,warrior,fury,69,37,32
Nukemdown,darkspear,1522,warrior,fury,36,16,20
Canduin,queldorei,1517,warrior,fury,32,19,13
Abomlnatlon,tichondrius,1516,warrior,fury,78,43,35
Huacai,tichondrius,1516,warrior,fury,48,24,24
Magnis,stormrage,1514,warrior,fury,78,39,39
Shibaraku,tichondrius,1514,warrior,fury,458,224,234
Playbox,area-52,1514,warrior,fury,83,37,46
Rikbielo,dragonmaw,1513,warrior,fury,73,39,34
Vhalden,quelthalas,1512,warrior,fury,24,16,8
Fkt,frostmourne,1512,warrior,fury,31,17,14
Zarxc,quelthalas,1512,warrior,fury,107,52,55
Mytharion,sargeras,1511,warrior,fury,30,18,12
Blxckbeard,hyjal,1510,warrior,fury,30,16,14
Thegoodson,zuljin,1509,warrior,fury,36,18,18
Grumok,tichondrius,1509,warrior,fury,44,20,24
Bòne,frostmourne,1508,warrior,fury,42,21,21
Wouili,zuljin,1506,warrior,fury,56,27,29
Mayonnaise,ragnaros,1506,warrior,fury,48,23,25
Zerkxi,kelthuzad,1504,warrior,fury,45,25,20
Nebgleb,bleeding-hollow,1503,warrior,fury,48,32,16
Anandamide,frostwolf,1503,warrior,fury,51,27,24
Apeal,skullcrusher,1502,warrior,fury,120,66,54
Machomanran,zuljin,1502,warrior,fury,107,56,51
Harkeigh,wyrmrest-accord,1501,warrior,fury,72,38,34
Rodahn,emerald-dream,1500,warrior,fury,54,31,23
Ragnararagor,ragnaros,1499,warrior,fury,293,146,147
Benieswar,frostmourne,1498,warrior,fury,42,21,21
Sensho,azralon,1497,warrior,fury,88,48,40
Wíldcat,illidan,1497,warrior,fury,30,16,14
Iskandr,amanthul,1496,warrior,fury,123,63,60
Koppo,kelthuzad,1496,warrior,fury,42,18,24
Venirith,moon-guard,1495,warrior,fury,82,43,39
Panterra,azralon,1494,warrior,fury,82,43,39
Stoopkid,uldum,1494,warrior,fury,58,29,29
Wardeád,quelthalas,1493,warrior,fury,36,21,15
Varith,sargeras,1493,warrior,fury,54,26,28
Mäjka,dalaran,1493,warrior,fury,48,23,25
Warbringerr,hydraxis,1490,warrior,fury,36,23,13
Eor,greymane,1490,warrior,fury,48,24,24
Eatmyblade,wyrmrest-accord,1489,warrior,fury,319,156,163
Goon,frostmourne,1488,warrior,fury,54,30,24
Horvv,frostmourne,1488,warrior,fury,60,33,27
Wöûlöû,trollbane,1488,warrior,fury,103,52,51
Thunderfurry,drakkari,1488,warrior,fury,135,66,69
Impaling,moon-guard,1487,warrior,fury,89,52,37
Crushanater,tichondrius,1487,warrior,fury,39,20,19
Statistical,area-52,1486,warrior,fury,42,27,15
Wolurog,emerald-dream,1485,warrior,fury,30,21,9
Bdm,mugthol,1485,warrior,fury,46,23,23
Viagraliker,tichondrius,1484,warrior,fury,93,52,41
Carnemølida,thrall,1484,warrior,fury,58,28,30
Mcluffin,proudmoore,1483,warrior,fury,24,16,8
Hjomura,quelthalas,1482,warrior,fury,48,24,24
Ronok,ghostlands,1481,warrior,fury,42,26,16
Know,anetheron,1480,warrior,fury,39,25,14
Xakp,tichondrius,1480,warrior,fury,39,19,20
Daelganis,blood-furnace,1480,warrior,fury,83,40,43
Sigiswald,cenarion-circle,1480,warrior,fury,72,32,40
Shádo,darkspear,1479,warrior,fury,48,29,19
Genrÿuusai,azralon,1478,warrior,fury,35,19,16
Himiko,kaelthas,1478,warrior,fury,75,38,37
Invdeath,azralon,1478,warrior,fury,52,25,27
Lavablood,moon-guard,1478,warrior,fury,48,22,26
Machâ,illidan,1477,warrior,fury,41,19,22
Tigo,khaz-modan,1476,warrior,fury,36,17,19
Monreale,area-52,1473,warrior,fury,30,19,11
Karusuke,stormrage,1472,warrior,fury,36,21,15
Ruktar,akama,1472,warrior,fury,113,57,56
Zuggyboi,moon-guard,1472,warrior,fury,54,25,29
Brutalloli,thrall,1471,warrior,fury,66,37,29
Johnnysnowx,sargeras,1471,warrior,fury,137,73,64
Potan,thrall,1471,warrior,fury,36,18,18
Badoosh,kaelthas,1466,warrior,fury,40,26,14
Xannypatrol,tichondrius,1466,warrior,fury,125,68,57
Hôdû,tichondrius,1466,warrior,fury,132,70,62
Crohdey,madoran,1466,warrior,fury,167,87,80
Jubeithos,draktharon,1466,warrior,fury,60,28,32
Mezmer,sargeras,1465,warrior,fury,42,25,17
Noten,thunderlord,1465,warrior,fury,82,47,35
Xenogears,boulderfist,1465,warrior,fury,66,27,39
Cliveswife,frostmourne,1462,warrior,fury,23,16,7
Teyroporah,azralon,1462,warrior,fury,63,34,29
Violençe,malganis,1462,warrior,fury,42,19,23
Hughmungús,frostmourne,1461,warrior,fury,56,30,26
Azázyel,quelthalas,1461,warrior,fury,66,29,37
Mág,burning-legion,1460,warrior,fury,33,20,13
Commandó,proudmoore,1460,warrior,fury,71,42,29
Mòrgo,agamaggan,1458,warrior,fury,30,20,10
Nimna,moon-guard,1458,warrior,fury,67,32,35
Mandremin,moon-guard,1456,warrior,fury,24,17,7
Jarvîs,moon-guard,1456,warrior,fury,73,37,36
Outrage,the-forgotten-coast,1456,warrior,fury,92,44,48
Cogsbixby,aerie-peak,1455,warrior,fury,30,21,9
Rhann,kelthuzad,1454,warrior,fury,44,23,21
Corbray,frostmourne,1454,warrior,fury,42,20,22
Bruttallis,frostmane,1452,warrior,fury,38,20,18
Berthibar,dalaran,1452,warrior,fury,117,54,63
Jorked,drakkari,1451,warrior,fury,98,48,50
Calzonez,bloodscalp,1449,warrior,fury,53,31,22
Kortera,malganis,1449,warrior,fury,59,33,26
Fendimonster,tichondrius,1448,warrior,fury,285,152,133
Connero,stormrage,1448,warrior,fury,54,25,29
Bestgrunt,tichondrius,1446,warrior,fury,102,46,56
Líl,gorgonnash,1446,warrior,fury,54,21,33
Asstastic,bonechewer,1445,warrior,fury,35,16,19
Cenanuandra,gnomeregan,1442,warrior,fury,82,46,36
Biggbudzz,sargeras,1441,warrior,fury,47,23,24
Sarovek,thrall,1437,warrior,fury,48,27,21
Nikomasked,kelthuzad,1436,warrior,fury,24,15,9
Sertul,tichondrius,1436,warrior,fury,36,18,18
Vheraxes,sargeras,1435,warrior,fury,24,15,9
Elken,haomarush,1435,warrior,fury,60,32,28
Howlofang,bleeding-hollow,1434,warrior,fury,66,30,36
Kenpachì,kelthuzad,1433,warrior,fury,25,16,9
Trco,quelthalas,1433,warrior,fury,48,28,20
Lemondrake,sargeras,1432,warrior,fury,24,15,9
Døppiø,area-52,1432,warrior,fury,28,16,12
Mankus,tichondrius,1432,warrior,fury,90,45,45
Calmebigfeet,tichondrius,1432,warrior,fury,30,15,15
Braxtön,moon-guard,1432,warrior,fury,78,37,41
Deseroth,illidan,1432,warrior,fury,36,15,21
Tacomeat,malorne,1430,warrior,fury,58,29,29
Chlord,proudmoore,1430,warrior,fury,30,15,15
Æwarrìor,tichondrius,1429,warrior,fury,58,25,33
Progesterone,bleeding-hollow,1429,warrior,fury,36,15,21
Décapitator,area-52,1428,warrior,fury,36,15,21
Toberino,illidan,1427,warrior,fury,24,15,9
Vnw,illidan,1427,warrior,fury,24,15,9
Siegfriéd,bleeding-hollow,1427,warrior,fury,58,33,25
Kaladbolg,tichondrius,1427,warrior,fury,84,47,37
Thyssara,moon-guard,1427,warrior,fury,99,51,48
Fury,frostmourne,1427,warrior,fury,30,15,15
Dieselsauce,stormscale,1426,warrior,fury,59,28,31
Limpninny,dalaran,1426,warrior,fury,39,17,22
Ikoré,saurfang,1425,warrior,fury,87,45,42
Extremerogu,tichondrius,1423,warrior,fury,47,25,22
Kross,illidan,1423,warrior,fury,86,44,42
Maciste,exodar,1422,warrior,fury,30,15,15
Exsolacyst,sargeras,1421,warrior,fury,24,15,9
Hydrolisk,area-52,1421,warrior,fury,30,16,14
Attractive,silvermoon,1420,warrior,fury,103,57,46
Asuna,burning-blade,1420,warrior,fury,46,24,22
Heenguer,azralon,1420,warrior,fury,60,31,29
Nixe,caelestrasz,1420,warrior,fury,150,72,78
Mervyn,aegwynn,1419,warrior,fury,40,24,16
Äléx,frostmourne,1418,warrior,fury,36,22,14
Gromarth,wyrmrest-accord,1418,warrior,fury,70,38,32
Akenox,area-52,1418,warrior,fury,30,15,15
Selathiel,burning-blade,1417,warrior,fury,113,60,53
Aarmii,ragnaros,1417,warrior,fury,89,44,45
Lechonk,suramar,1415,warrior,fury,30,16,14
Bhutjolokia,ragnaros,1415,warrior,fury,48,23,25
Gokkuu,dragonblight,1414,warrior,fury,78,42,36
Zareshi,sargeras,1412,warrior,fury,140,71,69
Youserg,khazgoroth,1411,warrior,fury,165,84,81
Perserve,thunderlord,1411,warrior,fury,120,54,66
Moriax,azralon,1410,warrior,fury,142,73,69
Wazy,ragnaros,1410,warrior,fury,78,36,42
Warsongwolf,tichondrius,1409,warrior,fury,78,36,42
Galigiggs,emerald-dream,1407,warrior,fury,24,15,9
Burtiera,wyrmrest-accord,1407,warrior,fury,66,39,27
Noppô,tichondrius,1406,warrior,fury,47,30,17
Errejota,illidan,1406,warrior,fury,54,26,28
Cannonballz,sargeras,1405,warrior,fury,24,15,9
Wolfdurotan,azralon,1405,warrior,fury,24,15,9
Icrìtmypants,dragonmaw,1404,warrior,fury,24,15,9
Orson,lothar,1404,warrior,fury,26,15,11
Enzothebaker,thrall,1404,warrior,fury,30,16,14
Bloodhârdt,area-52,1404,warrior,fury,70,35,35
Exëqt,area-52,1404,warrior,fury,60,25,35
Alecsten,tichondrius,1403,warrior,fury,30,15,15
Aladrynne,dalaran,1402,warrior,fury,207,101,106
Sindarin,eitrigg,1400,warrior,fury,54,32,22
Kolgrim,hyjal,1400,warrior,fury,27,16,11
Chippurrz,illidan,1400,warrior,fury,99,58,41
Xurug,zuljin,1400,warrior,fury,30,15,15
Broksampson,stormrage,1399,warrior,fury,30,15,15
Leónard,moon-guard,1398,warrior,fury,40,22,18
Sinkale,moon-guard,1398,warrior,fury,54,28,26
Panicbutton,proudmoore,1396,warrior,fury,84,44,40
Furyann,frostmourne,1396,warrior,fury,42,19,23
Fluffytaco,illidan,1395,warrior,fury,60,32,28
Kevinhårt,sargeras,1395,warrior,fury,48,22,26
Rageorade,area-52,1394,warrior,fury,89,50,39
Lyonele,moon-guard,1394,warrior,fury,50,28,22
Murderwalk,shadowmoon,1394,warrior,fury,57,27,30
Rahj,caelestrasz,1392,warrior,fury,31,17,14
Zekken,blades-edge,1392,warrior,fury,83,42,41
Destructör,nagrand,1392,warrior,fury,72,34,38
Majindoom,illidan,1388,warrior,fury,59,32,27
Gromtalin,sargeras,1386,warrior,fury,30,17,13
Tinyterror,sargeras,1386,warrior,fury,48,22,26
Zerríck,moon-guard,1385,warrior,fury,78,38,40
Spaceburied,illidan,1385,warrior,fury,129,59,70
Quuavo,tichondrius,1384,warrior,fury,48,25,23
Ayrifik,tichondrius,1383,warrior,fury,21,15,6
Modzilla,aerie-peak,1383,warrior,fury,72,34,38
Rageinc,jubeithos,1383,warrior,fury,62,28,34
Vedrikk,ragnaros,1382,warrior,fury,30,16,14
Kârzâ,dawnbringer,1382,warrior,fury,161,81,80
Kratøz,tichondrius,1382,warrior,fury,36,18,18
Eamonvalda,dalaran,1380,warrior,fury,51,27,24
Thywub,proudmoore,1380,warrior,fury,36,17,19
Dtrumpo,moon-guard,1380,warrior,fury,67,28,39
Weesten,aerie-peak,1378,warrior,fury,178,99,79
Tranos,zuljin,1378,warrior,fury,42,16,26
Rerollrogue,thrall,1377,warrior,fury,111,51,60
Swiffy,stormrage,1375,warrior,fury,46,29,17
Brugo,area-52,1374,warrior,fury,91,56,35
Wishayzka,drakkari,1373,warrior,fury,48,21,27
Originalkhan,stormrage,1373,warrior,fury,54,23,31
Casmier,tichondrius,1370,warrior,fury,36,19,17
Dhaemom,azralon,1370,warrior,fury,162,83,79
Zootonius,bloodscalp,1368,warrior,fury,36,20,16
Chounshiryu,drakkari,1367,warrior,fury,283,142,141
Ruuthless,sargeras,1367,warrior,fury,139,66,73
Lovehandlez,proudmoore,1366,warrior,fury,87,46,41
Áres,spinebreaker,1366,warrior,fury,48,24,24
Dözer,icecrown,1366,warrior,fury,42,21,21
Assaulttank,drenden,1366,warrior,fury,60,28,32
Hêllseeker,ragnaros,1365,warrior,fury,52,24,28
Ísrafel,ragnaros,1363,warrior,fury,36,21,15
Rageraz,trollbane,1362,warrior,fury,30,19,11
Valkwar,tichondrius,1362,warrior,fury,54,28,26
Redblade,bleeding-hollow,1361,warrior,fury,36,16,20
Reesse,eonar,1360,warrior,fury,30,17,13
Emotionaldps,malygos,1360,warrior,fury,141,74,67
Ourhero,malganis,1359,warrior,fury,33,18,15
Barntley,illidan,1358,warrior,fury,44,24,20
Screwz,blackrock,1357,warrior,fury,146,78,68
Rhohan,ysera,1356,warrior,fury,90,46,44
Surge,eredar,1355,warrior,fury,39,19,20
Matthegreat,area-52,1354,warrior,fury,51,25,26
Mikejustice,kelthuzad,1351,warrior,fury,160,77,83
Saabre,tichondrius,1351,warrior,fury,84,39,45
Arbeon,emerald-dream,1348,warrior,fury,19,15,4
Eatafrank,tichondrius,1348,warrior,fury,54,30,24
Slaggdad,illidan,1348,warrior,fury,138,64,74
Wuushang,area-52,1345,warrior,fury,80,42,38
Ghostwalker,akama,1344,warrior,fury,56,27,29
Contradict,thrall,1343,warrior,fury,42,20,22
Rawheadrex,sargeras,1342,warrior,fury,24,14,10
Varlekt,frostmourne,1342,warrior,fury,65,34,31
Wurrukattezz,tichondrius,1342,warrior,fury,68,32,36
Evanx,sargeras,1341,warrior,fury,24,14,10
Slughörn,moon-guard,1341,warrior,fury,30,14,16
Chilledflex,stormrage,1341,warrior,fury,36,15,21
Setseno,stormrage,1340,warrior,fury,32,16,16
Noteko,tichondrius,1340,warrior,fury,30,15,15
Dodiru,azralon,1339,warrior,fury,33,18,15
Teresabelle,proudmoore,1339,warrior,fury,46,23,23
Beifong,barthilas,1338,warrior,fury,24,14,10
Xiaoyujin,proudmoore,1337,warrior,fury,24,14,10
Brummbär,thrall,1337,warrior,fury,36,14,22
Michaela,moon-guard,1336,warrior,fury,24,14,10
Elfdestroyer,wyrmrest-accord,1335,warrior,fury,24,14,10
Cevadix,azralon,1335,warrior,fury,76,37,39
Torthak,area-52,1334,warrior,fury,24,17,7
Ciellë,proudmoore,1334,warrior,fury,27,17,10
Thorfjin,stormrage,1333,warrior,fury,48,25,23
Ivanzaytsev,ragnaros,1333,warrior,fury,84,42,42
Shino,garona,1332,warrior,fury,22,15,7
Breaker,undermine,1331,warrior,fury,30,14,16
Madwolf,tichondrius,1330,warrior,fury,24,14,10
Sulze,tichondrius,1330,warrior,fury,27,15,12
Alysson,moon-guard,1329,warrior,fury,24,14,10
Whitetaure,arthas,1328,warrior,fury,78,31,47
Timer,nagrand,1325,warrior,fury,30,18,12
Rakshata,destromath,1325,warrior,fury,36,19,17
Ironpanzer,thrall,1325,warrior,fury,120,60,60
Bondeye,stormrage,1325,warrior,fury,83,38,45
Arfzz,zangarmarsh,1325,warrior,fury,42,17,25
Boryndin,caelestrasz,1324,warrior,fury,18,14,4
Headsour,thunderhorn,1322,warrior,fury,94,43,51
Hewman,aerie-peak,1321,warrior,fury,30,17,13
Raulwar,ragnaros,1321,warrior,fury,36,20,16
Andreas,quelthalas,1321,warrior,fury,30,16,14
Uggtrick,zuljin,1321,warrior,fury,86,41,45
Alrekur,moon-guard,1320,warrior,fury,18,14,4
Pelikanesis,arthas,1320,warrior,fury,30,14,16
Lilcha,stormrage,1320,warrior,fury,42,19,23
Cptnchocmilk,thrall,1319,warrior,fury,24,14,10
Galaxarr,bonechewer,1319,warrior,fury,65,32,33
Vornicar,moon-guard,1319,warrior,fury,56,27,29
Chumbinhu,stormrage,1319,warrior,fury,36,16,20
Râgê,moon-guard,1318,warrior,fury,24,14,10
Hellframe,ysondre,1318,warrior,fury,60,26,34
Venóm,moon-guard,1317,warrior,fury,24,14,10
Raahj,sargeras,1317,warrior,fury,26,14,12
Hup,dethecus,1317,warrior,fury,42,15,27
Bigjier,proudmoore,1316,warrior,fury,115,59,56
Jichelei,tichondrius,1316,warrior,fury,30,14,16
Maarilayne,wyrmrest-accord,1315,warrior,fury,36,20,16
Chash,frostmourne,1315,warrior,fury,54,29,25
Zenrrei,ragnaros,1315,warrior,fury,31,15,16
Kahuwuna,tichondrius,1314,warrior,fury,30,14,16
Grommasth,jubeithos,1312,warrior,fury,36,21,15
Dissx,illidan,1308,warrior,fury,54,23,31
Belena,barthilas,1308,warrior,fury,36,14,22
Crixsullus,sargeras,1307,warrior,fury,36,20,16
Heater,stormrage,1306,warrior,fury,22,14,8
Tüssèll,khazgoroth,1306,warrior,fury,97,48,49
Makcumba,ragnaros,1305,warrior,fury,41,19,22
Sansãocore,nemesis,1304,warrior,fury,76,33,43
Nikey,tichondrius,1301,warrior,fury,41,23,18
Osannd,tichondrius,1301,warrior,fury,66,31,35
Soypingu,the-scryers,1301,warrior,fury,39,17,22
Kujø,wyrmrest-accord,1301,warrior,fury,66,28,38
Lighttaker,proudmoore,1300,warrior,fury,109,57,52
Balbyo,shattered-hand,1300,warrior,fury,54,22,32
Goleus,emerald-dream,1299,warrior,fury,42,17,25
Maytrix,bleeding-hollow,1298,warrior,fury,66,33,33
Xeto,ragnaros,1296,warrior,fury,34,20,14
Leviathanl,bleeding-hollow,1296,warrior,fury,54,30,24
Fabian,kelthuzad,1296,warrior,fury,76,40,36
Zovudo,area-52,1296,warrior,fury,57,29,28
Jrodrick,nemesis,1295,warrior,fury,42,21,21
Aitadon,sargeras,1295,warrior,fury,36,16,20
Joxer,nordrassil,1293,warrior,fury,60,31,29
Elbetoques,ragnaros,1292,warrior,fury,114,61,53
Farklesnarf,tichondrius,1292,warrior,fury,30,14,16
Ganzar,nesingwary,1292,warrior,fury,35,14,21
Spicywagyu,tichondrius,1291,warrior,fury,36,22,14
Iblith,sargeras,1291,warrior,fury,42,23,19
Ludicrous,dreadmaul,1291,warrior,fury,101,52,49
Cougaloo,sargeras,1289,warrior,fury,72,33,39
Syaon,moon-guard,1288,warrior,fury,36,21,15
Shneakywar,frostmourne,1288,warrior,fury,42,24,18
Hescobarrier,dalaran,1286,warrior,fury,30,16,14
Rusteazy,bleeding-hollow,1286,warrior,fury,48,19,29
Heavymetalyo,sargeras,1285,warrior,fury,36,20,16
Raskmeth,zuljin,1285,warrior,fury,36,20,16
Ryukendo,stormrage,1285,warrior,fury,159,81,78
Atruis,area-52,1285,warrior,fury,31,14,17
Funk,illidan,1285,warrior,fury,42,14,28
Zweihänder,nemesis,1284,warrior,fury,23,14,9
Slumdawgg,andorhal,1282,warrior,fury,36,18,18
Dabier,bleeding-hollow,1282,warrior,fury,86,38,48
Metalstorms,firetree,1281,warrior,fury,79,38,41
Sheerwill,wyrmrest-accord,1281,warrior,fury,42,18,24
Zikeno,dalaran,1280,warrior,fury,30,15,15
Jankalmojo,proudmoore,1277,warrior,fury,44,21,23
Smasher,garona,1277,warrior,fury,36,16,20
Kitto,malganis,1277,warrior,fury,56,22,34
Blackpro,sargeras,1275,warrior,fury,48,30,18
Slashen,sargeras,1274,warrior,fury,23,14,9
Kelandrin,illidan,1273,warrior,fury,54,28,26
Warföx,stormrage,1273,warrior,fury,54,23,31
Spaceguybro,whisperwind,1272,warrior,fury,47,20,27
Samuwrigh,tichondrius,1269,warrior,fury,42,21,21
Tryndamere,nagrand,1269,warrior,fury,65,27,38
Arrad,sargeras,1267,warrior,fury,80,40,40
Ivoryana,kelthuzad,1266,warrior,fury,48,25,23
Paí,nemesis,1265,warrior,fury,24,15,9
Tayne,ragnaros,1265,warrior,fury,42,20,22
Xfootman,quelthalas,1264,warrior,fury,67,43,24
Ghazzghkull,illidan,1263,warrior,fury,53,27,26
Leturen,area-52,1259,warrior,fury,41,19,22
Tiqokz,sargeras,1257,warrior,fury,24,14,10
Swággýc,tichondrius,1257,warrior,fury,46,25,21
Bingin,stormrage,1257,warrior,fury,60,26,34
Savikk,earthen-ring,1256,warrior,fury,42,23,19
Garce,aerie-peak,1253,warrior,fury,31,16,15
Splints,nesingwary,1252,warrior,fury,44,25,19
Kurishjadar,tichondrius,1252,warrior,fury,72,34,38
Vandrad,stormrage,1252,warrior,fury,123,56,67
Renseven,frostmourne,1251,warrior,fury,42,23,19
Wiimaann,quelthalas,1250,warrior,fury,31,14,17
Ensïs,moon-guard,1249,warrior,fury,84,34,50
Cryposlice,malganis,1247,warrior,fury,30,13,17
Smorc,stormrage,1246,warrior,fury,18,13,5
Carnemontana,shadowsong,1246,warrior,fury,24,17,7
Jutank,sargeras,1245,warrior,fury,18,13,5
Collosalx,stormrage,1245,warrior,fury,24,13,11
Fayttful,area-52,1245,warrior,fury,24,13,11
Washim,area-52,1245,warrior,fury,61,31,30
Draxxarlol,zuljin,1244,warrior,fury,24,13,11
Durist,tichondrius,1244,warrior,fury,24,13,11
Taiine,moon-guard,1243,warrior,fury,24,13,11
Torkscreww,bleeding-hollow,1243,warrior,fury,24,13,11
Coltyn,illidan,1243,warrior,fury,30,13,17
Virillius,wyrmrest-accord,1242,warrior,fury,18,13,5
Ironsavage,frostmourne,1242,warrior,fury,24,13,11
Liltom,sargeras,1242,warrior,fury,24,13,11
Buckleboot,illidan,1242,warrior,fury,24,13,11
Rendard,sargeras,1242,warrior,fury,24,13,11
Mammo,khazgoroth,1241,warrior,fury,24,13,11
Controlololx,hyjal,1241,warrior,fury,24,13,11
Sako,amanthul,1241,warrior,fury,26,14,12
Warhand,frostmourne,1241,warrior,fury,30,13,17
Tripichin,sargeras,1240,warrior,fury,22,16,6
Cidrick,stormrage,1240,warrior,fury,18,13,5
Copinhodagua,azralon,1240,warrior,fury,25,15,10
Smeshyou,kelthuzad,1240,warrior,fury,24,13,11
Warriorlee,jubeithos,1240,warrior,fury,33,16,17
Robocöp,quelthalas,1239,warrior,fury,24,13,11
Derr,tichondrius,1239,warrior,fury,30,13,17
Skipowawa,area-52,1237,warrior,fury,30,16,14
Phandrosa,ragnaros,1237,warrior,fury,31,14,17
Lucicicia,bronzebeard,1236,warrior,fury,18,13,5
Atracasöl,ragnaros,1236,warrior,fury,24,13,11
Agonistes,emerald-dream,1236,warrior,fury,42,16,26
Maydie,illidan,1235,warrior,fury,24,13,11
Varkiren,moon-guard,1234,warrior,fury,24,13,11
Kaíroz,quelthalas,1233,warrior,fury,54,31,23
Gtrain,barthilas,1233,warrior,fury,24,13,11
Therealflex,zuljin,1233,warrior,fury,24,13,11
Zephyron,moonrunner,1231,warrior,fury,38,18,20
Mcburger,barthilas,1231,warrior,fury,51,23,28
Murotamaka,malganis,1231,warrior,fury,30,13,17
Greenugly,tichondrius,1229,warrior,fury,54,24,30
Cjay,bleeding-hollow,1229,warrior,fury,30,13,17
Kyle,kargath,1227,warrior,fury,34,21,13
Nezzarek,sargeras,1227,warrior,fury,133,57,76
Groggam,illidan,1226,warrior,fury,24,13,11
Furiousangel,area-52,1226,warrior,fury,50,27,23
Tupacsback,stormrage,1224,warrior,fury,54,29,25
Tdaddy,lightbringer,1224,warrior,fury,168,84,84
Lawyer,quelthalas,1224,warrior,fury,66,32,34
Elonownesme,zuljin,1224,warrior,fury,62,28,34
Markodarko,gilneas,1222,warrior,fury,41,22,19
Mnoga,azralon,1222,warrior,fury,58,27,31
Beryrn,farstriders,1220,warrior,fury,47,28,19
Warbane,barthilas,1220,warrior,fury,36,19,17
Rsage,lightbringer,1219,warrior,fury,122,60,62
Wakkawar,stormrage,1218,warrior,fury,60,29,31
Elpezeta,tichondrius,1215,warrior,fury,29,13,16
Grosjambes,turalyon,1214,warrior,fury,30,18,12
Swingretzky,zuljin,1214,warrior,fury,24,13,11
Tenebrocity,stormrage,1213,warrior,fury,42,19,23
Breinan,ragnaros,1205,warrior,fury,51,26,25
Hadowar,thrall,1201,warrior,fury,24,13,11
Coffeebottom,wyrmrest-accord,1199,warrior,fury,29,16,13
Rendus,hyjal,1198,warrior,fury,54,21,33
Tlâloque,quelthalas,1197,warrior,fury,54,26,28
Natedógg,tichondrius,1196,warrior,fury,30,13,17
Bigglyjoobs,tichondrius,1195,warrior,fury,23,13,10
Goyqqw,illidan,1194,warrior,fury,23,13,10
Wraithvlad,moon-guard,1194,warrior,fury,97,43,54
Lidia,windrunner,1194,warrior,fury,38,14,24
Bestseason,kelthuzad,1193,warrior,fury,23,13,10
Xanåtos,moon-guard,1193,warrior,fury,67,35,32
Tinycutty,frostmourne,1189,warrior,fury,23,13,10
Koraciá,illidan,1188,warrior,fury,42,19,23
Akusenshi,dragonblight,1184,warrior,fury,114,54,60
Nemesioh,tichondrius,1184,warrior,fury,59,25,34
Honduranhary,sargeras,1183,warrior,fury,34,17,17
Ghostss,tichondrius,1183,warrior,fury,28,14,14
Doublezuglol,tichondrius,1182,warrior,fury,22,13,9
Serviettski,zuljin,1181,warrior,fury,36,19,17
Buffygramp,kelthuzad,1181,warrior,fury,39,17,22
Furyknight,velen,1180,warrior,fury,79,41,38
Freakin,ragnaros,1180,warrior,fury,58,27,31
Ventréss,bleeding-hollow,1179,warrior,fury,29,14,15
Nutwax,korgath,1177,warrior,fury,42,16,26
Wariorphilip,moon-guard,1175,warrior,fury,39,19,20
Meatyslaps,area-52,1172,warrior,fury,44,19,25
Rayson,saurfang,1169,warrior,fury,39,20,19
Dawrzel,tichondrius,1168,warrior,fury,72,29,43
Roxon,hellscream,1166,warrior,fury,119,62,57
Akarì,emerald-dream,1166,warrior,fury,36,17,19
Brolgo,quelthalas,1166,warrior,fury,68,31,37
Droun,rexxar,1165,warrior,fury,81,42,39
Zorhn,skywall,1161,warrior,fury,24,18,6
Lucymay,kelthuzad,1159,warrior,fury,48,28,20
Darthwarr,bleeding-hollow,1156,warrior,fury,35,23,12
Rocketcayton,veknilash,1156,warrior,fury,60,35,25
Liljon,windrunner,1155,warrior,fury,43,20,23
Croxxs,aegwynn,1153,warrior,fury,30,18,12
Chaiwar,ghostlands,1153,warrior,fury,24,13,11
Yepkorean,tichondrius,1151,warrior,fury,18,12,6
Dangerousd,kiljaeden,1151,warrior,fury,18,12,6
Notfaytful,thrall,1151,warrior,fury,21,13,8
Líliúm,ragnaros,1151,warrior,fury,31,19,12
Iwillcrushyo,darkspear,1151,warrior,fury,30,12,18
Skrognoth,malganis,1150,warrior,fury,18,12,6
Notcoverage,tichondrius,1150,warrior,fury,24,12,12
Ganzi,tichondrius,1150,warrior,fury,24,12,12
Ganzism,tichondrius,1150,warrior,fury,24,12,12
Notacop,malygos,1148,warrior,fury,18,12,6
Flaapjack,malganis,1147,warrior,fury,18,12,6
Justicwar,area-52,1147,warrior,fury,24,12,12
Synalia,sargeras,1147,warrior,fury,24,12,12
Stånnis,moon-guard,1146,warrior,fury,18,12,6
Lòrdnasher,tichondrius,1146,warrior,fury,21,13,8
Krispykreme,uldum,1146,warrior,fury,24,12,12
Bigshett,sargeras,1145,warrior,fury,24,12,12
Faywarsong,area-52,1145,warrior,fury,24,12,12
Notzyeal,area-52,1145,warrior,fury,30,12,18
Midweststuna,kul-tiras,1144,warrior,fury,18,12,6
Okkin,cairne,1143,warrior,fury,18,12,6
Reäl,dalaran,1143,warrior,fury,24,12,12
Kanekhy,ragnaros,1143,warrior,fury,28,13,15
Orrof,antonidas,1143,warrior,fury,143,66,77
Lox,blades-edge,1141,warrior,fury,24,12,12
Sixtyboost,tichondrius,1139,warrior,fury,24,12,12
Shééylias,moon-guard,1137,warrior,fury,30,12,18
Kaladïn,ragnaros,1135,warrior,fury,18,12,6
Talismantate,quelthalas,1135,warrior,fury,18,12,6
Madaroy,stormrage,1135,warrior,fury,38,19,19
Curvinito,emerald-dream,1135,warrior,fury,24,12,12
Zerkules,frostmane,1131,warrior,fury,51,19,32
Kreyonz,hyjal,1129,warrior,fury,24,12,12
Stinkyfuq,area-52,1128,warrior,fury,18,12,6
Icon,tichondrius,1128,warrior,fury,30,12,18
Valdemär,stormrage,1128,warrior,fury,30,12,18
Lykon,echo-isles,1127,warrior,fury,30,17,13
Chahta,shadowsong,1125,warrior,fury,18,12,6
Nondracio,ragnaros,1125,warrior,fury,36,12,24
Captnwrink,ysera,1121,warrior,fury,36,19,17
Ragemarley,dalaran,1119,warrior,fury,53,23,30
Trendxx,stormrage,1118,warrior,fury,42,14,28
Rekitralph,tichondrius,1116,warrior,fury,30,13,17
Wyrmscream,moon-guard,1115,warrior,fury,174,88,86
Evergardens,saurfang,1115,warrior,fury,30,15,15
Irontarkus,garrosh,1112,warrior,fury,18,12,6
Welgo,moon-guard,1112,warrior,fury,24,13,11
Starplatinum,aerie-peak,1112,warrior,fury,60,26,34
Legionário,sargeras,1111,warrior,fury,29,15,14
Sphílly,thrall,1107,warrior,fury,36,19,17
Garmeg,nemesis,1105,warrior,fury,78,36,42
Tyraelius,kiljaeden,1103,warrior,fury,39,24,15
Aggravation,bleeding-hollow,1103,warrior,fury,29,12,17
Danastus,icecrown,1102,warrior,fury,63,27,36
Jellyjamz,zuljin,1100,warrior,fury,36,19,17
Hæmomancy,moon-guard,1095,warrior,fury,24,12,12
Hyperdevil,ragnaros,1094,warrior,fury,30,14,16
Uhtred,moonrunner,1093,warrior,fury,36,18,18
Goinberserk,tichondrius,1093,warrior,fury,34,16,18
Pigonhae,zuljin,1093,warrior,fury,31,14,17
Studsrus,aegwynn,1092,warrior,fury,105,55,50
Naekochee,moon-guard,1092,warrior,fury,31,13,18
Warkinit,proudmoore,1091,warrior,fury,80,35,45
Brodîn,tichondrius,1083,warrior,fury,66,36,30
Awell,azralon,1082,warrior,fury,54,26,28
Jonÿ,sargeras,1081,warrior,fury,143,77,66
Elsee,drakkari,1080,warrior,fury,26,12,14
Undmyaxe,shattered-halls,1078,warrior,fury,24,13,11
Fatguy,tichondrius,1077,warrior,fury,109,54,55
Assmut,stormrage,1074,warrior,fury,35,15,20
Elmosmash,thrall,1068,warrior,fury,31,12,19
Youjumpijump,frostmourne,1066,warrior,fury,32,12,20
Creedz,dreadmaul,1064,warrior,fury,48,21,27
Monstersynde,nemesis,1063,warrior,fury,25,13,12
Shoteiotoshi,ragnaros,1057,warrior,fury,53,29,24
Damage,malganis,1056,warrior,fury,12,11,1
Xcuses,area-52,1055,warrior,fury,18,11,7
Nertharul,zuljin,1055,warrior,fury,18,11,7
Ragingboner,aggramar,1055,warrior,fury,18,11,7
Recksus,tichondrius,1055,warrior,fury,18,11,7
Nicfury,alterac-mountains,1055,warrior,fury,18,11,7
Baultenaz,draenor,1055,warrior,fury,18,11,7
Yermalx,tichondrius,1055,warrior,fury,18,11,7
Xgraves,sargeras,1055,warrior,fury,18,11,7
Flaco,tichondrius,1055,warrior,fury,21,12,9
Gorbagglúk,azralon,1055,warrior,fury,30,15,15
Bornclueless,illidan,1055,warrior,fury,24,11,13
Bobu,area-52,1055,warrior,fury,24,11,13
Aeros,winterhoof,1054,warrior,fury,18,11,7
Chop,khadgar,1054,warrior,fury,18,11,7
Bearlornan,frostmourne,1054,warrior,fury,18,11,7
Claymation,tichondrius,1054,warrior,fury,18,11,7
Riechst,quelthalas,1053,warrior,fury,18,11,7
Mogghul,azralon,1053,warrior,fury,18,11,7
Mightypikel,illidan,1051,warrior,fury,16,12,4
Varenkä,drakkari,1051,warrior,fury,18,11,7
Xochicotzin,mugthol,1051,warrior,fury,24,11,13
Radisa,sargeras,1051,warrior,fury,30,11,19
Yagluth,illidan,1050,warrior,fury,18,11,7
Shrekshomie,zuljin,1049,warrior,fury,18,11,7
Villäïness,daggerspine,1049,warrior,fury,22,13,9
Ráionshin,quelthalas,1049,warrior,fury,24,11,13
Assamith,nemesis,1049,warrior,fury,30,11,19
Bigmagron,azralon,1048,warrior,fury,24,11,13
Racknon,ragnaros,1048,warrior,fury,36,12,24
Marcuss,bonechewer,1043,warrior,fury,18,11,7
Cåfe,tichondrius,1043,warrior,fury,18,11,7
Mercurial,mugthol,1042,warrior,fury,18,12,6
Droggo,cenarius,1042,warrior,fury,18,11,7
Djfredsd,tichondrius,1041,warrior,fury,24,11,13
Brutalpløx,illidan,1039,warrior,fury,36,11,25
Nabangle,barthilas,1033,warrior,fury,59,26,33
Owwycowwy,area-52,1032,warrior,fury,36,15,21
Stoneddragon,spinebreaker,1031,warrior,fury,18,11,7
Nelissa,runetotem,1030,warrior,fury,24,12,12
Butterbutt,area-52,1030,warrior,fury,24,11,13
Sworne,nordrassil,1028,warrior,fury,18,11,7
Learila,moon-guard,1027,warrior,fury,30,14,16
Bonebreakr,tichondrius,1026,warrior,fury,78,35,43
Munanio,stormrage,1024,warrior,fury,24,11,13
Naughtytwat,tichondrius,1021,warrior,fury,20,12,8
Axekill,bleeding-hollow,1019,warrior,fury,30,11,19
Zokrásh,quelthalas,1019,warrior,fury,60,19,41
Beardedretz,durotan,1016,warrior,fury,22,11,11
Lodog,proudmoore,1012,warrior,fury,28,12,16
Bothar,sargeras,1012,warrior,fury,30,11,19
Liavana,jubeithos,1012,warrior,fury,36,13,23
Shiddoshi,ragnaros,1008,warrior,fury,30,17,13
Éeu,anubarak,1008,warrior,fury,112,58,54
Meatdrps,frostmane,1007,warrior,fury,21,11,10
Maligaro,draka,1004,warrior,fury,20,12,8
Altharos,drakkari,1002,warrior,fury,26,12,14
Crazysharpz,thaurissan,1001,warrior,fury,29,12,17
Rumka,draktharon,1000,warrior,fury,137,62,75
Xauce,queldorei,999,warrior,fury,42,12,30
Smallestwar,zuljin,997,warrior,fury,101,42,59
Warchine,malganis,994,warrior,fury,27,12,15
Splurger,thrall,991,warrior,fury,17,11,6
Yêawen,tichondrius,990,warrior,fury,20,11,9
Tyranatusk,malganis,989,warrior,fury,18,12,6
Muufasa,nerzhul,988,warrior,fury,24,13,11
Curacao,dark-iron,987,warrior,fury,26,11,15
Bèèfcake,shattered-hand,984,warrior,fury,20,11,9
Lessandro,quelthalas,977,warrior,fury,28,12,16
Pulp,sargeras,976,warrior,fury,19,11,8
Grimfàng,moon-guard,976,warrior,fury,50,21,29
Judessi,kiljaeden,971,warrior,fury,20,11,9
Painfulangel,nesingwary,966,warrior,fury,50,29,21
Offthecharts,mannoroth,965,warrior,fury,56,25,31
Eadsmasher,jubeithos,961,warrior,fury,24,13,11
Wargoph,burning-legion,960,warrior,fury,12,10,2
Rickharrison,illidan,960,warrior,fury,12,10,2
Chadwarr,tichondrius,960,warrior,fury,12,10,2
Gavrien,wyrmrest-accord,960,warrior,fury,12,10,2
Youngmoneyd,illidan,960,warrior,fury,12,10,2
Milkmebby,bleeding-hollow,960,warrior,fury,18,10,8
Suzushi,tichondrius,960,warrior,fury,18,10,8
Warreeper,area-52,959,warrior,fury,12,10,2
Dontlookup,tichondrius,959,warrior,fury,15,11,4
Irontink,sargeras,959,warrior,fury,18,10,8
Funsyze,garona,959,warrior,fury,18,10,8
Gulgosh,stormscale,959,warrior,fury,18,10,8
Snowflakee,jaedenar,959,warrior,fury,18,10,8
Jonhy,illidan,959,warrior,fury,18,10,8
Vaider,bleeding-hollow,959,warrior,fury,18,10,8
Orrkky,jubeithos,959,warrior,fury,18,10,8
Hasbullaa,proudmoore,959,warrior,fury,18,10,8
Woomas,tichondrius,959,warrior,fury,18,10,8
Cjz,tichondrius,959,warrior,fury,18,10,8
Ymìr,moon-guard,959,warrior,fury,24,10,14
Prestico,ragnaros,959,warrior,fury,24,10,14
Gahenk,chogall,958,warrior,fury,12,10,2
Zertok,ravencrest,958,warrior,fury,18,10,8
Tnknspnk,magtheridon,958,warrior,fury,18,10,8
Worclin,illidan,958,warrior,fury,18,10,8
Rampagejin,tichondrius,958,warrior,fury,24,10,14
Kiladrew,korgath,958,warrior,fury,24,10,14
Squishmello,hyjal,957,warrior,fury,12,10,2
Semiru,zuljin,957,warrior,fury,12,10,2
Dragvovar,thrall,957,warrior,fury,19,10,9
Qicha,tichondrius,957,warrior,fury,24,10,14
Gorcker,hellscream,955,warrior,fury,18,10,8
Harlow,spirestone,955,warrior,fury,24,10,14
Alerish,quelthalas,954,warrior,fury,18,10,8
Luckychaos,bleeding-hollow,954,warrior,fury,18,10,8
Jcßot,exodar,954,warrior,fury,24,10,14
Lurtras,exodar,954,warrior,fury,24,10,14
Nordrages,stormrage,953,warrior,fury,18,10,8
Zépileque,azralon,953,warrior,fury,30,10,20
Ironbark,elune,952,warrior,fury,18,10,8
Mfgodofwar,kelthuzad,951,warrior,fury,24,10,14
Maytrixx,stormrage,950,warrior,fury,12,10,2
Jellybomb,sargeras,950,warrior,fury,24,10,14
Cannan,the-underbog,948,warrior,fury,81,28,53
Zèldris,gallywix,941,warrior,fury,138,72,66
Serovok,zangarmarsh,937,warrior,fury,18,10,8
Alexthar,drakkari,934,warrior,fury,98,42,56
Darkarus,drakkari,925,warrior,fury,36,14,22
Hùlksmâsh,zuljin,924,warrior,fury,23,13,10
Afelhia,moon-guard,924,warrior,fury,25,11,14
Faladoris,thrall,923,warrior,fury,58,30,28
Ghostlyedge,turalyon,918,warrior,fury,78,28,50
Qfiend,stormrage,911,warrior,fury,17,10,7
Sedition,borean-tundra,910,warrior,fury,17,10,7
Obiwun,azgalor,910,warrior,fury,17,10,7
Nïckböï,misha,909,warrior,fury,41,21,20
Dolsorae,malganis,905,warrior,fury,28,11,17
Lokiullr,tichondrius,900,warrior,fury,27,11,16
Samdarkblade,kilrogg,898,warrior,fury,33,10,23
Shyliar,thrall,896,warrior,fury,20,10,10
Grievouz,nemesis,894,warrior,fury,17,10,7
Alanoria,skywall,891,warrior,fury,26,11,15
Cüba,nemesis,884,warrior,fury,54,24,30
Zadrak,whisperwind,880,warrior,fury,19,10,9
Dionran,nemesis,880,warrior,fury,28,13,15
Zambonibob,eonar,876,warrior,fury,60,29,31
Sanduin,drakkari,874,warrior,fury,13,10,3
Urnitemare,hyjal,872,warrior,fury,66,22,44
Shadowstingg,tichondrius,864,warrior,fury,12,9,3
Furydudz,tichondrius,864,warrior,fury,12,9,3
Iløveaysla,azralon,864,warrior,fury,12,9,3
Tutuh,quelthalas,864,warrior,fury,12,9,3
Pkgdtko,tichondrius,864,warrior,fury,12,9,3
Missrend,hyjal,864,warrior,fury,12,9,3
Jerryk,zuljin,864,warrior,fury,12,9,3
Genderfluuid,trollbane,864,warrior,fury,12,9,3
Gbrz,stormrage,864,warrior,fury,12,9,3
Riftgar,hyjal,864,warrior,fury,18,9,9
Astrëa,quelthalas,864,warrior,fury,18,9,9
Lindsanv,illidan,864,warrior,fury,18,9,9
Baylîfe,illidan,864,warrior,fury,18,9,9
Shimizuken,tichondrius,864,warrior,fury,24,9,15
Flanrych,illidan,863,warrior,fury,12,9,3
Likelygood,tichondrius,863,warrior,fury,12,9,3
Verrynasty,area-52,863,warrior,fury,12,9,3
Seulrene,sargeras,863,warrior,fury,12,9,3
Devaya,ragnaros,863,warrior,fury,12,9,3
Ishtalar,sargeras,863,warrior,fury,12,9,3
Squonks,kelthuzad,863,warrior,fury,12,9,3
Peeb,tichondrius,863,warrior,fury,18,9,9
Tyrannus,chogall,863,warrior,fury,18,9,9
Mywarr,andorhal,863,warrior,fury,18,9,9
Cubanßûrst,stormrage,863,warrior,fury,18,9,9
Captinkitty,thrall,863,warrior,fury,18,9,9
Pressd,frostmourne,863,warrior,fury,24,9,15
Gzilla,queldorei,863,warrior,fury,24,9,15
Yahnjee,stormrage,863,warrior,fury,24,9,15
Xclusive,area-52,863,warrior,fury,24,9,15
Iskandër,quelthalas,862,warrior,fury,12,9,3
Tylerdurdenx,dalaran,862,warrior,fury,12,9,3
Janoski,chogall,862,warrior,fury,12,9,3
Kåyotix,proudmoore,862,warrior,fury,18,9,9
Kiaonlinn,ragnaros,862,warrior,fury,18,9,9
Oledcktwist,garrosh,862,warrior,fury,18,9,9
Nowarriororc,thrall,862,warrior,fury,18,9,9
Kreigër,area-52,862,warrior,fury,18,9,9
Archibaldo,darkspear,862,warrior,fury,18,9,9
Crammed,tichondrius,862,warrior,fury,24,9,15
Dotlom,wyrmrest-accord,862,warrior,fury,30,9,21
Virrainy,stormrage,861,warrior,fury,18,9,9
Irongiant,blades-edge,861,warrior,fury,20,9,11
Neak,kelthuzad,861,warrior,fury,24,9,15
Painquin,boulderfist,861,warrior,fury,24,9,15
Hamandaxe,amanthul,861,warrior,fury,24,9,15
Nerjinzul,bloodscalp,860,warrior,fury,15,10,5
Betametazone,ragnaros,860,warrior,fury,19,11,8
Jarmog,tichondrius,860,warrior,fury,18,9,9
Maddzspin,tichondrius,860,warrior,fury,18,9,9
Rodorn,frostmourne,860,warrior,fury,22,10,12
Neorage,elune,860,warrior,fury,24,9,15
Awfulzone,malganis,860,warrior,fury,36,10,26
Lámuérté,frostmourne,859,warrior,fury,17,10,7
Groguu,windrunner,859,warrior,fury,18,9,9
Fartden,tichondrius,859,warrior,fury,18,9,9
Stunninchaos,shattered-hand,859,warrior,fury,24,9,15
Figurefour,tichondrius,858,warrior,fury,12,9,3
Smugorc,medivh,858,warrior,fury,12,9,3
Papasmurff,zuljin,858,warrior,fury,18,9,9
Elleaux,bloodscalp,857,warrior,fury,18,9,9
Dáïñ,sargeras,857,warrior,fury,24,9,15
Melankoma,sargeras,856,warrior,fury,18,9,9
Jendal,ragnaros,856,warrior,fury,24,11,13
Kræzee,kelthuzad,856,warrior,fury,24,9,15
Buckets,chogall,855,warrior,fury,18,9,9
Cowmilk,llane,855,warrior,fury,32,10,22
Nukee,tichondrius,853,warrior,fury,24,9,15
Boitoróh,azralon,850,warrior,fury,24,9,15
Trufsoturi,bleeding-hollow,845,warrior,fury,23,9,14
Xiing,azshara,842,warrior,fury,24,9,15
Halobender,emerald-dream,838,warrior,fury,22,11,11
Flywar,nesingwary,838,warrior,fury,60,25,35
Kajing,boulderfist,836,warrior,fury,19,10,9
Haelerostus,moon-guard,832,warrior,fury,66,28,38
Cønan,stormrage,830,warrior,fury,14,10,4
Ghonad,windrunner,821,warrior,fury,23,9,14
Kessahh,moon-guard,820,warrior,fury,18,9,9
Beccabutcher,tichondrius,817,warrior,fury,18,9,9
Likeachimpx,sargeras,816,warrior,fury,15,10,5
Avatarl,ragnaros,816,warrior,fury,21,9,12
Magdar,daggerspine,813,warrior,fury,28,9,19
Franklinmvrd,stormrage,810,warrior,fury,18,10,8
Futtmebuck,emerald-dream,810,warrior,fury,18,10,8
Ankhxiety,sargeras,809,warrior,fury,22,11,11
Lourdadmiwal,aegwynn,807,warrior,fury,41,14,27
Rediger,aggramar,805,warrior,fury,40,16,24
Mataviejitos,ragnaros,804,warrior,fury,22,12,10
Bargorengar,skullcrusher,797,warrior,fury,108,48,60
Ragetide,illidan,796,warrior,fury,20,9,11
Riguini,tol-barad,794,warrior,fury,20,9,11
Liquidbagel,frostmourne,794,warrior,fury,22,9,13
Stompgnomes,malganis,791,warrior,fury,20,9,11
Huangatang,wyrmrest-accord,784,warrior,fury,13,9,4
Doominustwo,tichondrius,784,warrior,fury,19,9,10
Tankieone,aggramar,784,warrior,fury,102,35,67
Verallyn,area-52,783,warrior,fury,19,9,10
Klim,grizzly-hills,781,warrior,fury,25,9,16
Ryse,aegwynn,768,warrior,fury,12,8,4
Punteerage,sargeras,768,warrior,fury,12,8,4
Falconheart,wyrmrest-accord,768,warrior,fury,12,8,4
Idranel,nordrassil,768,warrior,fury,12,8,4
Dex,saurfang,768,warrior,fury,12,8,4
Bamag,dethecus,768,warrior,fury,12,8,4
Xwarz,drakkari,768,warrior,fury,12,8,4
Swìll,illidan,768,warrior,fury,12,8,4
Akiyo,azralon,768,warrior,fury,12,8,4
Beerstorm,stormrage,768,warrior,fury,12,8,4
Colonclogger,proudmoore,768,warrior,fury,12,8,4
Thelma,archimonde,768,warrior,fury,12,8,4
Stimm,blood-furnace,768,warrior,fury,12,8,4
Noblêsix,dalaran,768,warrior,fury,12,8,4
Narwhål,tichondrius,768,warrior,fury,12,8,4
Tehsuperhero,norgannon,768,warrior,fury,12,8,4
Brendan,llane,768,warrior,fury,12,8,4
Kruma,stormscale,768,warrior,fury,12,8,4
Rimshotts,sargeras,768,warrior,fury,12,8,4
Victoria,malganis,768,warrior,fury,12,8,4
Beforever,kiljaeden,768,warrior,fury,12,8,4
Jethrix,kelthuzad,768,warrior,fury,18,8,10
Doczz,malganis,768,warrior,fury,18,8,10
Bozwar,tichondrius,768,warrior,fury,18,8,10
Oohsht,tichondrius,768,warrior,fury,18,8,10
Icebringer,frostmourne,768,warrior,fury,24,8,16
Seanpaiuwu,zuljin,768,warrior,fury,24,8,16
Kyres,moon-guard,767,warrior,fury,12,8,4
Moggos,firetree,767,warrior,fury,12,8,4
Dagrone,drakkari,767,warrior,fury,12,8,4
Trickyshield,durotan,767,warrior,fury,12,8,4
Mittyroar,khazgoroth,767,warrior,fury,12,8,4
Drunkwarriôr,malygos,767,warrior,fury,12,8,4
Mlau,tichondrius,767,warrior,fury,12,8,4
Iromrogar,area-52,767,warrior,fury,12,8,4
Zhangetsu,emerald-dream,767,warrior,fury,12,8,4
Narelah,proudmoore,767,warrior,fury,12,8,4
Spraten,bonechewer,767,warrior,fury,12,8,4
Gorethrax,tichondrius,767,warrior,fury,18,8,10
Chillimus,tichondrius,767,warrior,fury,18,8,10
Smashr,tichondrius,767,warrior,fury,18,8,10
Ungabunga,frostwolf,767,warrior,fury,18,8,10
Osselan,moon-guard,767,warrior,fury,18,8,10
Weightyox,barthilas,767,warrior,fury,18,8,10
Gízzmo,tichondrius,767,warrior,fury,18,8,10
Warriorox,illidan,767,warrior,fury,18,8,10
Stoneball,kiljaeden,767,warrior,fury,18,8,10
Olifin,durotan,767,warrior,fury,18,8,10
Zêtt,drakkari,767,warrior,fury,18,8,10
Zaràki,area-52,767,warrior,fury,18,8,10
Maintarget,malganis,767,warrior,fury,18,8,10
Irallianaa,daggerspine,767,warrior,fury,18,8,10
Erdres,kelthuzad,767,warrior,fury,22,9,13
Forks,malganis,767,warrior,fury,24,8,16
Drumann,hyjal,766,warrior,fury,12,8,4
Ogundados,kelthuzad,766,warrior,fury,12,8,4
Darkirondadi,frostmourne,766,warrior,fury,12,8,4
Ugrak,frostmourne,766,warrior,fury,12,8,4
Jeffarian,illidan,766,warrior,fury,12,8,4
Theßull,frostmourne,766,warrior,fury,12,8,4
Menelaau,nemesis,766,warrior,fury,12,8,4
Genjis,quelthalas,766,warrior,fury,18,8,10
Warpaint,azuremyst,766,warrior,fury,18,8,10
Arågòrn,stormrage,766,warrior,fury,18,8,10
Åsc,area-52,766,warrior,fury,18,8,10
Ayn,llane,766,warrior,fury,18,8,10
Elix,stormscale,766,warrior,fury,18,8,10
Xanthchaser,stormrage,765,warrior,fury,18,8,10
Kaikah,aegwynn,765,warrior,fury,24,8,16
Hellsinga,stormrage,764,warrior,fury,18,8,10
Wölf,azralon,764,warrior,fury,18,8,10
Zeerohkool,tichondrius,764,warrior,fury,24,8,16
Hishika,quelthalas,763,warrior,fury,15,9,6
Huri,nemesis,763,warrior,fury,30,8,22
Frettyhooman,blood-furnace,762,warrior,fury,12,8,4
Çampbêll,area-52,762,warrior,fury,24,8,16
Alandris,icecrown,760,warrior,fury,18,10,8
Vicegripp,misha,759,warrior,fury,18,8,10
Kilp,thrall,751,warrior,fury,17,8,9
Leotonywar,tichondrius,750,warrior,fury,18,8,10
Toonchick,sargeras,749,warrior,fury,24,8,16
Riddickx,dragonblight,747,warrior,fury,35,12,23
Marleau,bleeding-hollow,742,warrior,fury,21,9,12
Slughórn,moon-guard,735,warrior,fury,14,9,5
Arngrimm,area-52,735,warrior,fury,14,9,5
Azmael,sargeras,735,warrior,fury,17,8,9
Alaricck,quelthalas,735,warrior,fury,26,9,17
Vlark,eredar,725,warrior,fury,18,8,10
Grandorth,moon-guard,712,warrior,fury,18,9,9
Husurnanny,dalaran,712,warrior,fury,23,10,13
Eleronogoth,draka,704,warrior,fury,16,8,8
Zaraki,moon-guard,704,warrior,fury,16,8,8
Akêwñon,stormrage,703,warrior,fury,16,8,8
Butterflakes,thunderlord,697,warrior,fury,11,8,3
Argorothiis,jubeithos,693,warrior,fury,14,8,6
Dagaraha,quelthalas,693,warrior,fury,22,8,14
Krunas,quelthalas,672,warrior,fury,12,7,5
Liltotey,frostmourne,672,warrior,fury,12,7,5
Linara,shandris,672,warrior,fury,12,7,5
Tonios,stormrage,672,warrior,fury,12,7,5
Iinnocence,frostmourne,672,warrior,fury,12,7,5
Yormunt,quelthalas,672,warrior,fury,12,7,5
Blaiize,ragnaros,672,warrior,fury,12,7,5
Dós,emerald-dream,672,warrior,fury,12,7,5
Souserkill,ragnaros,672,warrior,fury,12,7,5
Ruckw,stormrage,672,warrior,fury,12,7,5
Sypii,malganis,672,warrior,fury,12,7,5
Kowboy,stormrage,672,warrior,fury,12,7,5
Chopmeat,ysera,672,warrior,fury,12,7,5
Xårren,stormrage,672,warrior,fury,12,7,5
Daymiian,blackrock,672,warrior,fury,12,7,5
Zerrekarr,wyrmrest-accord,672,warrior,fury,12,7,5
Vvarcry,sargeras,672,warrior,fury,12,7,5
Eino,llane,672,warrior,fury,12,7,5
Xjpig,frostmourne,672,warrior,fury,12,7,5
Nylissia,blood-furnace,672,warrior,fury,12,7,5
Moistslam,proudmoore,672,warrior,fury,12,7,5
Maar,lightbringer,672,warrior,fury,12,7,5
Stonksi,shadowmoon,672,warrior,fury,12,7,5
Showtimè,thrall,672,warrior,fury,12,7,5
Dustywx,area-52,672,warrior,fury,12,7,5
Executefreak,illidan,672,warrior,fury,12,7,5
Decimateme,tichondrius,672,warrior,fury,12,7,5
Heyzulnut,whisperwind,672,warrior,fury,12,7,5
Gazah,skullcrusher,672,warrior,fury,12,7,5
Oggrend,dalaran,672,warrior,fury,12,7,5
Zenetsu,kelthuzad,672,warrior,fury,12,7,5
Orgrön,nemesis,672,warrior,fury,12,7,5
Psrsistenczs,tichondrius,672,warrior,fury,12,7,5
Ðrëäd,area-52,672,warrior,fury,12,7,5
Ladderx,area-52,672,warrior,fury,12,7,5
Kryptonite,illidan,672,warrior,fury,12,7,5
Ðìbs,moon-guard,672,warrior,fury,18,7,11
Rustylugnut,area-52,672,warrior,fury,18,7,11
Radnod,tichondrius,672,warrior,fury,18,7,11
Mardrex,korgath,672,warrior,fury,18,7,11
Ëdwärd,moon-guard,672,warrior,fury,18,7,11
Alëwar,quelthalas,672,warrior,fury,18,7,11
Zultråk,quelthalas,672,warrior,fury,18,7,11
Okgotchax,kelthuzad,672,warrior,fury,18,7,11
Endlesskilla,destromath,672,warrior,fury,18,7,11
Iorak,queldorei,671,warrior,fury,12,7,5
Cellyndia,area-52,671,warrior,fury,12,7,5
Phaellii,sargeras,671,warrior,fury,12,7,5
Quintonious,dark-iron,671,warrior,fury,12,7,5
Demobox,malganis,671,warrior,fury,12,7,5
Ahmorok,moon-guard,671,warrior,fury,12,7,5
Carfal,spirestone,671,warrior,fury,12,7,5
Müffîn,moon-guard,671,warrior,fury,12,7,5
Methodicaly,aerie-peak,671,warrior,fury,12,7,5
Avorable,shattered-hand,671,warrior,fury,12,7,5
Idestroy,exodar,671,warrior,fury,12,7,5
Gigantx,tichondrius,671,warrior,fury,12,7,5
Greenmachine,twisting-nether,671,warrior,fury,12,7,5
Lísterfiend,illidan,671,warrior,fury,12,7,5
Kwelve,proudmoore,671,warrior,fury,12,7,5
Potjiekos,lightninghoof,671,warrior,fury,12,7,5
Nokak,borean-tundra,671,warrior,fury,12,7,5
Constintine,spinebreaker,671,warrior,fury,12,7,5
Seksyme,darkspear,671,warrior,fury,12,7,5
Bjarkyy,azralon,671,warrior,fury,12,7,5
Mullf,stormrage,671,warrior,fury,12,7,5
Pancárcho,quelthalas,671,warrior,fury,12,7,5
Cthumoo,moonrunner,671,warrior,fury,18,7,11
Rockadoodle,tichondrius,671,warrior,fury,18,7,11
Teqniq,kelthuzad,671,warrior,fury,18,7,11
Chacca,suramar,671,warrior,fury,18,7,11
Chieef,illidan,671,warrior,fury,18,7,11
Hurtless,area-52,671,warrior,fury,18,7,11
Ragnir,kelthuzad,671,warrior,fury,18,7,11
Ghurrk,hyjal,671,warrior,fury,18,7,11
Fooko,lethon,671,warrior,fury,18,7,11
Barsol,ragnaros,671,warrior,fury,18,7,11
Smokiiwar,proudmoore,671,warrior,fury,18,7,11
Remudan,tichondrius,671,warrior,fury,18,7,11
Angrier,area-52,671,warrior,fury,18,7,11
Wårrior,kelthuzad,671,warrior,fury,18,7,11
Thradek,proudmoore,671,warrior,fury,24,7,17
Xiosè,ragnaros,671,warrior,fury,24,7,17
Ganon,garrosh,670,warrior,fury,12,7,5
Dragnol,quelthalas,670,warrior,fury,12,7,5
Trackhawk,moon-guard,670,warrior,fury,18,7,11
Gerplé,moon-guard,670,warrior,fury,18,7,11
Dragonrage,tanaris,670,warrior,fury,24,7,17
Zulex,dathremar,670,warrior,fury,24,7,17
Lyzan,stormrage,669,warrior,fury,12,7,5
Boneskull,zuljin,669,warrior,fury,12,7,5
Rafaeldantas,azralon,669,warrior,fury,12,7,5
Sealee,area-52,669,warrior,fury,12,7,5
Cýnz,frostmourne,669,warrior,fury,18,7,11
Khorvesh,burning-legion,669,warrior,fury,18,7,11
Gamoosh,illidan,669,warrior,fury,20,7,13
Deáthwing,steamwheedle-cartel,669,warrior,fury,24,7,17
Awezc,chogall,669,warrior,fury,24,7,17
Shadowtitanx,korgath,669,warrior,fury,30,7,23
Saltyareolas,destromath,668,warrior,fury,24,7,17
Genesis,zangarmarsh,667,warrior,fury,12,7,5
Misgnomer,farstriders,667,warrior,fury,12,7,5
Dalînar,quelthalas,666,warrior,fury,12,7,5
Siiss,stormrage,665,warrior,fury,21,9,12
Keateane,frostmourne,662,warrior,fury,12,7,5
Shhiraq,zuljin,661,warrior,fury,30,7,23
Nighttoker,lightnings-blade,659,warrior,fury,12,7,5
Crashacorn,stormrage,659,warrior,fury,18,7,11
Trailsend,dalaran,658,warrior,fury,12,7,5
Damnge,zuljin,656,warrior,fury,24,10,14
Shrexecute,tichondrius,655,warrior,fury,17,7,10
Ayvha,wyrmrest-accord,654,warrior,fury,18,7,11
Wintz,dreadmaul,638,warrior,fury,14,8,6
Donjuan,skullcrusher,637,warrior,fury,20,8,12
Nanor,zuljin,635,warrior,fury,14,8,6
Starcade,executus,623,warrior,fury,11,7,4
Fenmok,khazgoroth,623,warrior,fury,11,7,4
Greenwell,area-52,623,warrior,fury,15,7,8
Iozhua,wyrmrest-accord,617,warrior,fury,22,9,13
Benimalish,illidan,608,warrior,fury,10,7,3
Furryhorv,frostmourne,608,warrior,fury,22,7,15
Rohkvan,illidan,607,warrior,fury,14,7,7
Vorthax,korgath,607,warrior,fury,14,7,7
Lilreese,tichondrius,592,warrior,fury,13,7,6
Noktyn,haomarush,591,warrior,fury,11,7,4
Grimfate,boulderfist,576,warrior,fury,6,6,0
Grïnk,stormrage,576,warrior,fury,6,6,0
Contented,illidan,576,warrior,fury,9,7,2
Zuzi,korgath,576,warrior,fury,9,7,2
Jiszle,sargeras,576,warrior,fury,12,6,6
Lilkrome,illidan,576,warrior,fury,12,6,6
Marfas,hyjal,576,warrior,fury,12,6,6
Rigil,the-forgotten-coast,576,warrior,fury,12,6,6
Säbeër,ragnaros,576,warrior,fury,12,6,6
Whateverzhan,tichondrius,576,warrior,fury,12,6,6
Flynnstone,tichondrius,576,warrior,fury,12,6,6
Ggludan,area-52,576,warrior,fury,12,6,6
Kforti,kiljaeden,576,warrior,fury,12,6,6
Raeyth,twisting-nether,576,warrior,fury,12,6,6
Disarmed,proudmoore,576,warrior,fury,12,6,6
Matrias,tichondrius,576,warrior,fury,12,6,6
Endurefen,sargeras,576,warrior,fury,12,6,6
Ezcharger,kelthuzad,576,warrior,fury,12,6,6
Serzull,area-52,576,warrior,fury,12,6,6
Kasheeka,spirestone,576,warrior,fury,12,6,6
Erogorn,dawnbringer,576,warrior,fury,12,6,6
Shieldchain,dalaran,576,warrior,fury,12,6,6
Zatarra,azralon,576,warrior,fury,12,6,6
Whittyxc,tichondrius,576,warrior,fury,12,6,6
Youngmop,eitrigg,576,warrior,fury,12,6,6
New,sargeras,576,warrior,fury,12,6,6
Mordoo,zuljin,576,warrior,fury,12,6,6
Madblackcat,illidan,576,warrior,fury,12,6,6
Skoll,illidan,576,warrior,fury,12,6,6
Bonafidesimp,stormrage,576,warrior,fury,12,6,6
Durrandal,stormrage,576,warrior,fury,12,6,6
Shaolin,duskwood,576,warrior,fury,12,6,6
Tortag,malganis,576,warrior,fury,12,6,6
Freÿdis,zuljin,576,warrior,fury,12,6,6
Ciz,emerald-dream,576,warrior,fury,12,6,6
Lolylops,kiljaeden,576,warrior,fury,12,6,6
Xragnar,area-52,576,warrior,fury,12,6,6
Tacrolimus,thrall,576,warrior,fury,12,6,6
Gamelagged,area-52,576,warrior,fury,12,6,6
Feedzz,area-52,576,warrior,fury,12,6,6
Kennie,malganis,576,warrior,fury,12,6,6
Dunkmate,malganis,576,warrior,fury,12,6,6
Strongerjaw,tichondrius,576,warrior,fury,12,6,6
Kaivax,tichondrius,576,warrior,fury,12,6,6
Rezhan,area-52,576,warrior,fury,12,6,6
Aisqt,frostmourne,576,warrior,fury,12,6,6
Yükana,quelthalas,576,warrior,fury,12,6,6
Ðrënch,tichondrius,576,warrior,fury,12,6,6
Darrowshire,moon-guard,576,warrior,fury,12,6,6
Dëåth,azgalor,576,warrior,fury,12,6,6
Unclemusclez,azgalor,576,warrior,fury,12,6,6
Iluvhugz,tichondrius,576,warrior,fury,12,6,6
Majaya,area-52,576,warrior,fury,12,6,6
Sunamys,illidan,576,warrior,fury,12,6,6
Goywarr,illidan,576,warrior,fury,12,6,6
Borahgis,area-52,576,warrior,fury,12,6,6
Grukosh,illidan,576,warrior,fury,12,6,6
Tinfinitee,frostwolf,576,warrior,fury,18,6,12
Kritsg,azgalor,576,warrior,fury,18,6,12
Himer,tichondrius,576,warrior,fury,18,6,12
Jpiece,tichondrius,576,warrior,fury,18,6,12
Digitaldj,frostmourne,576,warrior,fury,18,6,12
Hoarahløux,trollbane,575,warrior,fury,12,6,6
Kratthos,azralon,575,warrior,fury,12,6,6
Burninated,tichondrius,575,warrior,fury,12,6,6
Bigs,exodar,575,warrior,fury,12,6,6
Båldur,quelthalas,575,warrior,fury,12,6,6
Xenyn,malganis,575,warrior,fury,12,6,6
Plidan,shuhalo,575,warrior,fury,12,6,6
Seymourbot,illidan,575,warrior,fury,12,6,6
Lorelie,malganis,575,warrior,fury,12,6,6
Berario,garrosh,575,warrior,fury,12,6,6
Ludakritz,moon-guard,575,warrior,fury,12,6,6
Isitorganic,nesingwary,575,warrior,fury,12,6,6
Mordelona,ragnaros,575,warrior,fury,12,6,6
Vlaren,stormrage,575,warrior,fury,18,6,12
Docmoriarty,malygos,575,warrior,fury,18,6,12
Buck,tichondrius,575,warrior,fury,18,6,12
Honorloxo,bleeding-hollow,575,warrior,fury,24,6,18
Risingson,argent-dawn,574,warrior,fury,12,6,6
Waterboylol,malganis,574,warrior,fury,12,6,6
Rageroni,tichondrius,574,warrior,fury,12,6,6
Badairplane,gilneas,574,warrior,fury,12,6,6
Ruffless,skullcrusher,574,warrior,fury,12,6,6
Cômmander,ragnaros,574,warrior,fury,18,6,12
Gros,exodar,574,warrior,fury,18,6,12
Oralo,tichondrius,574,warrior,fury,18,6,12
Clavan,moon-guard,574,warrior,fury,24,6,18
Worc,aggramar,572,warrior,fury,12,6,6
Vethronis,dalaran,572,warrior,fury,12,6,6
Beligarde,moon-guard,571,warrior,fury,22,6,16
Olokrash,dalaran,570,warrior,fury,12,6,6
Deltong,bonechewer,569,warrior,fury,12,6,6
Boothtowolf,the-forgotten-coast,566,warrior,fury,12,6,6
Finnin,nathrezim,559,warrior,fury,11,6,5
Agram,alleria,559,warrior,fury,17,6,11
Shoresy,korgath,558,warrior,fury,17,6,11
Akj,sargeras,551,warrior,fury,26,9,17
Tochixchaos,illidan,543,warrior,fury,14,7,7
Loosypoosy,magtheridon,542,warrior,fury,11,6,5
Sheluh,illidan,542,warrior,fury,17,6,11
Thorkéll,proudmoore,541,warrior,fury,23,6,17
Millerlite,illidan,527,warrior,fury,11,6,5
Tatërs,zuljin,527,warrior,fury,11,6,5
Sinbãd,whisperwind,527,warrior,fury,11,6,5
Agarto,illidan,526,warrior,fury,11,6,5
Dhefinator,moknathal,512,warrior,fury,10,6,4
Ángron,ragnaros,511,warrior,fury,11,6,5
Monkeydwood,proudmoore,510,warrior,fury,20,6,14
Cassetto,icecrown,496,warrior,fury,13,6,7
Tryhardr,sargeras,480,warrior,fury,6,5,1
Kiritarokila,area-52,480,warrior,fury,6,5,1
Kaitlanzhan,malganis,480,warrior,fury,6,5,1
Didinosaur,azralon,480,warrior,fury,6,5,1
Çhloee,the-underbog,480,warrior,fury,6,5,1
Bromgarr,crushridge,480,warrior,fury,6,5,1
Tmacwar,area-52,480,warrior,fury,6,5,1
Robostergler,tichondrius,480,warrior,fury,6,5,1
Trigon,chromaggus,480,warrior,fury,6,5,1
Edmuula,tichondrius,480,warrior,fury,6,5,1
Theseuse,tichondrius,480,warrior,fury,6,5,1
Thornhardt,frostmourne,480,warrior,fury,6,5,1
Orkussw,illidan,480,warrior,fury,6,5,1
Vennoe,proudmoore,480,warrior,fury,6,5,1
Soggynapkin,proudmoore,480,warrior,fury,6,5,1
Magnusz,zuljin,480,warrior,fury,6,5,1
Sinjino,proudmoore,480,warrior,fury,6,5,1
Goyards,tichondrius,480,warrior,fury,6,5,1
Serrokie,tichondrius,480,warrior,fury,6,5,1
Korsarro,frostmourne,480,warrior,fury,6,5,1
Onyx,auchindoun,480,warrior,fury,6,5,1
Àxcx,moon-guard,480,warrior,fury,6,5,1
Nickfurÿ,stormrage,480,warrior,fury,6,5,1
Wrathena,khadgar,480,warrior,fury,6,5,1
Tazmanianfur,akama,480,warrior,fury,6,5,1
Thorado,nemesis,480,warrior,fury,6,5,1
Beleña,dalaran,480,warrior,fury,6,5,1
Ckoaw,dalaran,480,warrior,fury,6,5,1
Balrog,firetree,480,warrior,fury,6,5,1
Sbplaywar,akama,480,warrior,fury,9,6,3
Ramranch,dawnbringer,480,warrior,fury,8,5,3
Victoriaöus,emerald-dream,480,warrior,fury,9,5,4
Momlover,area-52,480,warrior,fury,12,5,7
Tappyz,area-52,480,warrior,fury,12,5,7
Crímewave,zuljin,480,warrior,fury,12,5,7
Hexmaul,zuljin,480,warrior,fury,12,5,7
Rowdyanders,area-52,480,warrior,fury,12,5,7
Pápý,ragnaros,480,warrior,fury,12,5,7
Arthurston,tichondrius,480,warrior,fury,12,5,7
Grimlòck,area-52,480,warrior,fury,12,5,7
Trekk,azralon,480,warrior,fury,12,5,7
Dalinare,area-52,480,warrior,fury,12,5,7
Slamuëladams,bleeding-hollow,480,warrior,fury,12,5,7
Dtherockj,kiljaeden,480,warrior,fury,12,5,7
Weildboy,undermine,480,warrior,fury,12,5,7
Shadalloo,azralon,480,warrior,fury,12,5,7
Resize,wyrmrest-accord,480,warrior,fury,12,5,7
Faiken,quelthalas,480,warrior,fury,12,5,7
Río,area-52,480,warrior,fury,12,5,7
Gale,kelthuzad,480,warrior,fury,12,5,7
Smashkuntz,lightnings-blade,480,warrior,fury,12,5,7
Kamigoroshi,crushridge,480,warrior,fury,12,5,7
Aladarith,moon-guard,480,warrior,fury,12,5,7
Lunitics,darkspear,480,warrior,fury,12,5,7
Jywarr,area-52,480,warrior,fury,12,5,7
Bgwinnier,shuhalo,480,warrior,fury,12,5,7
Pisini,illidan,480,warrior,fury,12,5,7
Clansy,moon-guard,480,warrior,fury,12,5,7
Vvârriôr,barthilas,480,warrior,fury,12,5,7
Maltrate,hyjal,480,warrior,fury,12,5,7
Vallkÿria,goldrinn,480,warrior,fury,12,5,7
Kiingkratoz,ragnaros,480,warrior,fury,12,5,7
Sabers,mannoroth,480,warrior,fury,12,5,7
Angrystepdad,moon-guard,480,warrior,fury,12,5,7
Izhansheni,illidan,480,warrior,fury,12,5,7
Iittlewiener,tichondrius,480,warrior,fury,12,5,7
Genesisxp,barthilas,480,warrior,fury,12,5,7
Warkaiser,ragnaros,480,warrior,fury,12,5,7
Carnith,arthas,480,warrior,fury,12,5,7
Moostorm,darkspear,480,warrior,fury,12,5,7
Swollenbicep,tichondrius,480,warrior,fury,12,5,7
Buhurt,sargeras,480,warrior,fury,12,5,7
Taurenosaur,illidan,480,warrior,fury,12,5,7
Loktarmabras,dreadmaul,480,warrior,fury,12,5,7
Axesomebody,tichondrius,480,warrior,fury,12,5,7
Pingolona,nemesis,480,warrior,fury,12,5,7
Marimadelene,aegwynn,480,warrior,fury,12,5,7
Testees,senjin,480,warrior,fury,12,5,7
Lilsweet,moon-guard,480,warrior,fury,12,5,7
Outo,stormrage,480,warrior,fury,12,5,7
Ÿûkímès,tichondrius,480,warrior,fury,12,5,7
Oprampage,illidan,480,warrior,fury,12,5,7
Zelglory,dalaran,480,warrior,fury,12,5,7
Còlòssal,moknathal,480,warrior,fury,12,5,7
Pneumasmash,tichondrius,480,warrior,fury,12,5,7
Orcveinz,tichondrius,480,warrior,fury,17,7,10
Caststeel,nordrassil,480,warrior,fury,15,6,9
Zoowarr,illidan,480,warrior,fury,15,6,9
Karukaj,azshara,480,warrior,fury,13,5,8
Àndrewceo,illidan,480,warrior,fury,16,6,10
Gadlfuerte,ragnaros,480,warrior,fury,14,5,9
Spinspin,borean-tundra,480,warrior,fury,18,5,13
Thiccsauce,wyrmrest-accord,480,warrior,fury,18,5,13
Feetpicsx,tichondrius,480,warrior,fury,18,5,13
Rwagorn,scilla,480,warrior,fury,18,5,13
Klen,kelthuzad,480,warrior,fury,18,5,13
Saltyniples,aegwynn,480,warrior,fury,18,5,13
Laloman,ragnaros,480,warrior,fury,18,5,13
Raazzawar,moon-guard,479,warrior,fury,6,5,1
Zirtag,proudmoore,479,warrior,fury,6,5,1
Vonkinky,sargeras,479,warrior,fury,6,5,1
Morshaz,drakkari,479,warrior,fury,6,5,1
Guantid,sargeras,479,warrior,fury,12,5,7
Morasar,area-52,479,warrior,fury,12,5,7
Amroth,barthilas,479,warrior,fury,12,5,7
Ksubîî,frostmourne,479,warrior,fury,12,5,7
Olegg,laughing-skull,479,warrior,fury,12,5,7
Yasser,ragnaros,479,warrior,fury,12,5,7
Warsero,tichondrius,479,warrior,fury,12,5,7
Reishera,stormrage,479,warrior,fury,12,5,7
Vengxdor,stormrage,479,warrior,fury,12,5,7
Gàdgét,moon-guard,479,warrior,fury,12,5,7
Dorathorn,azralon,479,warrior,fury,18,5,13
Supersquish,moon-guard,479,warrior,fury,18,5,13
Màgs,moon-guard,479,warrior,fury,18,5,13
Ozyozyozy,khazgoroth,478,warrior,fury,6,5,1
Døøm,malganis,478,warrior,fury,12,5,7
Daiin,kelthuzad,478,warrior,fury,18,5,13
Dragmös,nemesis,478,warrior,fury,18,5,13
Beilian,quelthalas,478,warrior,fury,24,5,19
Drovik,malygos,477,warrior,fury,18,5,13
Fabszord,nemesis,476,warrior,fury,12,5,7
Dathrand,aerie-peak,476,warrior,fury,12,5,7
Áryon,stormrage,474,warrior,fury,12,5,7
Veganwarrior,quelthalas,469,warrior,fury,18,5,13
Joebo,thrall,463,warrior,fury,11,5,6
Blazeowlglad,area-52,463,warrior,fury,17,5,12
Bpdpacient,illidan,447,warrior,fury,8,6,2
Erdnase,ragnaros,447,warrior,fury,11,5,6
Igoon,dentarg,432,warrior,fury,9,5,4
Ataullah,barthilas,432,warrior,fury,9,5,4
Rageverd,malganis,432,warrior,fury,9,5,4
Chiffonade,kelthuzad,432,warrior,fury,11,6,5
Kitiará,area-52,432,warrior,fury,15,6,9
Thalloom,thaurissan,432,warrior,fury,15,5,10
Daydayfight,illidan,431,warrior,fury,11,5,6
Glaros,blood-furnace,431,warrior,fury,11,5,6
Hugz,thrall,431,warrior,fury,11,5,6
Sukstofuk,frostmourne,431,warrior,fury,11,5,6
Stealheads,dalaran,431,warrior,fury,15,6,9
Morgrein,area-52,416,warrior,fury,10,5,5
Forerunner,tichondrius,416,warrior,fury,10,5,5
Israelelel,azralon,416,warrior,fury,10,5,5
Inocencius,ragnaros,415,warrior,fury,8,5,3
Digitalblade,illidan,415,warrior,fury,14,5,9
Husyuzhi,tichondrius,400,warrior,fury,7,5,2
Smokes,sargeras,384,warrior,fury,6,4,2
Skarkla,thrall,384,warrior,fury,6,4,2
Tmvalchoir,tichondrius,384,warrior,fury,6,4,2
Ymirock,area-52,384,warrior,fury,6,4,2
Joshiguy,area-52,384,warrior,fury,6,4,2
Cujø,tichondrius,384,warrior,fury,6,4,2
Nunu,firetree,384,warrior,fury,6,4,2
Bobandi,tichondrius,384,warrior,fury,6,4,2
Pz,ravencrest,384,warrior,fury,6,4,2
Hêroìnê,tichondrius,384,warrior,fury,6,4,2
Walterwhîte,tichondrius,384,warrior,fury,6,4,2
Tobaccocat,stormreaver,384,warrior,fury,6,4,2
Youdumbaut,tichondrius,384,warrior,fury,6,4,2
Biganimegirl,frostmourne,384,warrior,fury,6,4,2
Atuey,area-52,384,warrior,fury,6,4,2
Trashman,frostwolf,384,warrior,fury,6,4,2
Sarachnis,area-52,384,warrior,fury,6,4,2
Glowstick,tichondrius,384,warrior,fury,6,4,2
Theisius,tichondrius,384,warrior,fury,6,4,2
Gorgoz,area-52,384,warrior,fury,6,4,2
Tomatogodx,sargeras,384,warrior,fury,6,4,2
Superbest,tichondrius,384,warrior,fury,6,4,2
Psyrush,area-52,384,warrior,fury,6,4,2
Kamidaren,tichondrius,384,warrior,fury,6,4,2
Olaqwarraso,sargeras,384,warrior,fury,6,4,2
Daboogeyman,thunderhorn,384,warrior,fury,6,4,2
Junaid,frostmourne,384,warrior,fury,6,4,2
Biggwall,sargeras,384,warrior,fury,6,4,2
Vilgaxx,area-52,384,warrior,fury,6,4,2
Meatbone,emerald-dream,384,warrior,fury,6,4,2
Speakeassy,dalaran,384,warrior,fury,6,4,2
Darkoil,illidan,384,warrior,fury,6,4,2
Mortalstrike,chogall,384,warrior,fury,6,4,2
Bakadoom,illidan,384,warrior,fury,6,4,2
Hasbullá,ragnaros,384,warrior,fury,6,4,2
Tazgar,draka,384,warrior,fury,6,4,2
Ricksanches,shadowmoon,384,warrior,fury,6,4,2
Wooney,emerald-dream,384,warrior,fury,6,4,2
Sickwidit,kiljaeden,384,warrior,fury,6,4,2
Brogdar,moon-guard,384,warrior,fury,6,4,2
Xirexa,bleeding-hollow,384,warrior,fury,6,4,2
Rahj,saurfang,384,warrior,fury,6,4,2
Iwooglybool,icecrown,384,warrior,fury,6,4,2
Tjuanalpha,illidan,384,warrior,fury,6,4,2
Unpaused,kelthuzad,384,warrior,fury,6,4,2
Painedd,stormrage,384,warrior,fury,6,4,2
Bloodscream,magtheridon,384,warrior,fury,6,4,2
Myrä,kelthuzad,384,warrior,fury,6,4,2
Vaughan,azuremyst,384,warrior,fury,6,4,2
Laferrari,illidan,384,warrior,fury,6,4,2
Hamcan,dalaran,384,warrior,fury,6,4,2
Willcharge,tichondrius,384,warrior,fury,6,4,2
Murghol,malganis,384,warrior,fury,6,4,2
Leønidasll,ragnaros,384,warrior,fury,6,4,2
Amphyctionis,zuljin,384,warrior,fury,6,4,2
Antecubital,burning-blade,384,warrior,fury,6,4,2
Tyranitar,proudmoore,384,warrior,fury,6,4,2
Greeplol,arthas,384,warrior,fury,6,4,2
Scripper,stormrage,384,warrior,fury,6,4,2
Mcfatstuffs,boulderfist,384,warrior,fury,6,4,2
Axazel,drakkari,384,warrior,fury,6,4,2
Iripuanewone,illidan,384,warrior,fury,6,4,2
Braxxinn,tichondrius,384,warrior,fury,6,4,2
Fornido,quelthalas,384,warrior,fury,6,4,2
Techanina,aerie-peak,384,warrior,fury,6,4,2
Samuluo,tichondrius,384,warrior,fury,6,4,2
Dualslong,malygos,384,warrior,fury,6,4,2
Moneywarr,illidan,384,warrior,fury,6,4,2
Thistou,quelthalas,384,warrior,fury,6,4,2
Blackbaba,illidan,384,warrior,fury,6,4,2
Jàmiè,wyrmrest-accord,384,warrior,fury,6,4,2
Hanyball,stormrage,384,warrior,fury,6,4,2
Machutron,quelthalas,384,warrior,fury,6,4,2
Vosnir,dalaran,384,warrior,fury,6,4,2
Mommystrasza,kelthuzad,384,warrior,fury,6,4,2
Daemòn,dalaran,384,warrior,fury,6,4,2
Breké,moon-guard,384,warrior,fury,6,4,2
Qram,illidan,384,warrior,fury,6,4,2
Affeine,malganis,384,warrior,fury,6,4,2
Bornne,doomhammer,384,warrior,fury,9,4,5
Negrus,sargeras,384,warrior,fury,11,4,7
Danield,illidan,384,warrior,fury,11,4,7
Kanosukai,emerald-dream,384,warrior,fury,12,4,8
Pigblind,azralon,384,warrior,fury,12,4,8
Bobitolio,dalaran,384,warrior,fury,12,4,8
Beetcoyne,azuremyst,384,warrior,fury,12,4,8
Cronrow,thunderlord,384,warrior,fury,12,4,8
Metalhaed,thrall,384,warrior,fury,12,4,8
Worgasum,black-dragonflight,384,warrior,fury,12,4,8
Truegit,illidan,384,warrior,fury,12,4,8
Empriux,quelthalas,384,warrior,fury,12,4,8
Syntra,area-52,384,warrior,fury,12,4,8
Corazondleón,ragnaros,384,warrior,fury,12,4,8
Luosifen,tichondrius,384,warrior,fury,12,4,8
Bs,kiljaeden,384,warrior,fury,12,4,8
Muradinpica,stormrage,384,warrior,fury,12,4,8
Gorm,greymane,384,warrior,fury,12,4,8
Sakutarou,lightbringer,384,warrior,fury,12,4,8
Hukzula,illidan,384,warrior,fury,12,4,8
Krodah,quelthalas,384,warrior,fury,12,4,8
Jaimey,malganis,384,warrior,fury,12,4,8
Drengarusk,area-52,384,warrior,fury,12,4,8
Jhalakni,quelthalas,384,warrior,fury,12,4,8
Wariorwang,tichondrius,384,warrior,fury,12,4,8
Appleleon,ragnaros,384,warrior,fury,12,4,8
Shinshido,tichondrius,384,warrior,fury,12,4,8
Gallowes,elune,384,warrior,fury,12,4,8
Aislistraee,moon-guard,384,warrior,fury,12,4,8
Tháne,emerald-dream,384,warrior,fury,12,4,8
Sîn,sargeras,384,warrior,fury,12,4,8
Wanderlie,zangarmarsh,384,warrior,fury,12,4,8
Rägnarök,stormrage,384,warrior,fury,12,4,8
Bighamm,tichondrius,384,warrior,fury,12,4,8
Sveenn,area-52,384,warrior,fury,12,4,8
Goremack,hellscream,384,warrior,fury,12,4,8
Apollos,alleria,384,warrior,fury,12,4,8
Goatmanee,tichondrius,384,warrior,fury,12,4,8
Nasrôth,korialstrasz,384,warrior,fury,12,4,8
Avoraçado,nemesis,384,warrior,fury,12,4,8
Kevinersaa,frostmourne,384,warrior,fury,12,4,8
Skrot,stormrage,384,warrior,fury,12,4,8
Rezzett,wyrmrest-accord,384,warrior,fury,12,4,8
Bladetko,tichondrius,384,warrior,fury,12,4,8
Nobowar,tichondrius,384,warrior,fury,12,4,8
Gravo,ragnaros,384,warrior,fury,12,4,8
Agamere,stormrage,384,warrior,fury,12,4,8
Lsays,tichondrius,384,warrior,fury,18,4,14
Seppukush,quelthalas,384,warrior,fury,18,4,14
Kuragdem,trollbane,384,warrior,fury,18,4,14
Galvar,frostmourne,383,warrior,fury,6,4,2
Blackknïght,arthas,383,warrior,fury,6,4,2
Equityr,azralon,383,warrior,fury,6,4,2
Greggor,frostmourne,383,warrior,fury,12,4,8
Galadon,amanthul,383,warrior,fury,12,4,8
Rahmholz,bonechewer,383,warrior,fury,12,4,8
Norru,moon-guard,383,warrior,fury,21,5,16
Anger,zuljin,383,warrior,fury,24,4,20
Ünö,proudmoore,382,warrior,fury,6,4,2
Buakaaw,gallywix,382,warrior,fury,6,4,2
Fangerbiter,destromath,382,warrior,fury,6,4,2
Solveighelga,drakkari,381,warrior,fury,12,4,8
Glennyballs,dalaran,379,warrior,fury,12,4,8
Baxel,arthas,367,warrior,fury,11,4,7
Warseed,ragnaros,367,warrior,fury,17,4,13
Pappin,malganis,351,warrior,fury,11,4,7
Snowwsaint,sargeras,351,warrior,fury,11,4,7
Gotrekson,azralon,351,warrior,fury,11,4,7
Koaltank,illidan,351,warrior,fury,14,5,9
Illicitiri,sargeras,336,warrior,fury,9,5,4
Weepingdeath,burning-legion,336,warrior,fury,15,4,11
Darkrevel,dalvengyr,335,warrior,fury,11,4,7
Boonn,frostmourne,330,warrior,fury,13,7,6
Kíngkaisér,azralon,330,warrior,fury,15,6,9
Huleo,tichondrius,330,warrior,fury,14,5,9
Rohde,nemesis,319,warrior,fury,8,4,4
Fancyboo,malganis,319,warrior,fury,8,4,4
Wallzar,sargeras,304,warrior,fury,13,4,9
Lightswords,stormrage,288,warrior,fury,6,3,3
Wolfsbanne,khadgar,288,warrior,fury,6,3,3
Scran,sargeras,288,warrior,fury,6,3,3
Caynos,stormrage,288,warrior,fury,6,3,3
Swiftÿ,gurubashi,288,warrior,fury,6,3,3
Shyea,gurubashi,288,warrior,fury,6,3,3
Satedqq,illidan,288,warrior,fury,6,3,3
Instakill,garrosh,288,warrior,fury,6,3,3
Verydanger,emerald-dream,288,warrior,fury,6,3,3
Deepsplitter,illidan,288,warrior,fury,6,3,3
Swíshersweét,kelthuzad,288,warrior,fury,6,3,3
Ðivebomb,sargeras,288,warrior,fury,6,3,3
Durres,tichondrius,288,warrior,fury,6,3,3
Pongk,tichondrius,288,warrior,fury,6,3,3
Bruzerk,ragnaros,288,warrior,fury,6,3,3
Malystik,ragnaros,288,warrior,fury,6,3,3
Twilightrain,tichondrius,288,warrior,fury,6,3,3
Lechee,silvermoon,288,warrior,fury,6,3,3
Akrian,hellscream,288,warrior,fury,6,3,3
Kreamyumyums,tichondrius,288,warrior,fury,6,3,3
Harthan,stormscale,288,warrior,fury,6,3,3
Vurk,area-52,288,warrior,fury,6,3,3
Uncritable,dalaran,288,warrior,fury,6,3,3
Daddyd,sargeras,288,warrior,fury,6,3,3
Exequet,tichondrius,288,warrior,fury,6,3,3
Smxrf,hyjal,288,warrior,fury,6,3,3
Mubun,tichondrius,288,warrior,fury,6,3,3
Razzik,emerald-dream,288,warrior,fury,6,3,3
Furìous,stormrage,288,warrior,fury,6,3,3
Sejunz,ragnaros,288,warrior,fury,6,3,3
Carborr,frostmourne,288,warrior,fury,6,3,3
Stellabear,aggramar,288,warrior,fury,6,3,3
Brôm,emerald-dream,288,warrior,fury,6,3,3
Heavydoody,moon-guard,288,warrior,fury,6,3,3
Dilfshakes,illidan,288,warrior,fury,6,3,3
Unng,emerald-dream,288,warrior,fury,6,3,3
Taywar,sargeras,288,warrior,fury,6,3,3
Krishwar,azshara,288,warrior,fury,6,3,3
Glexecute,sargeras,288,warrior,fury,6,3,3
Terazova,tichondrius,288,warrior,fury,6,3,3
Mildsauce,illidan,288,warrior,fury,6,3,3
Morelz,stormrage,288,warrior,fury,6,3,3
Chops,arygos,288,warrior,fury,6,3,3
Chapublin,ragnaros,288,warrior,fury,6,3,3
Wescer,frostmourne,288,warrior,fury,6,3,3
Zangre,stormrage,288,warrior,fury,6,3,3
Lylyna,moon-guard,288,warrior,fury,6,3,3
Raygé,malygos,288,warrior,fury,6,3,3
Ävdol,emerald-dream,288,warrior,fury,6,3,3
Nginx,queldorei,288,warrior,fury,6,3,3
Slãmpiece,stormrage,288,warrior,fury,6,3,3
Corevp,barthilas,288,warrior,fury,6,3,3
Makeranbing,barthilas,288,warrior,fury,6,3,3
Gläedr,dalaran,288,warrior,fury,6,3,3
Priapus,stormrage,288,warrior,fury,6,3,3
Mehji,boulderfist,288,warrior,fury,6,3,3
Korland,aerie-peak,288,warrior,fury,6,3,3
Uded,icecrown,288,warrior,fury,6,3,3
Bloodcivil,thrall,288,warrior,fury,6,3,3
Griimhoof,malganis,288,warrior,fury,6,3,3
Herkja,barthilas,288,warrior,fury,6,3,3
Egoist,malganis,288,warrior,fury,6,3,3
Executie,duskwood,288,warrior,fury,6,3,3
Gongos,doomhammer,288,warrior,fury,6,3,3
Wwesheamus,frostmourne,288,warrior,fury,6,3,3
Hijjiup,ysera,288,warrior,fury,6,3,3
Nukeworker,durotan,288,warrior,fury,6,3,3
Beârz,the-underbog,288,warrior,fury,6,3,3
Peterheater,emerald-dream,288,warrior,fury,6,3,3
Kénblock,tichondrius,288,warrior,fury,6,3,3
Chubw,tichondrius,288,warrior,fury,6,3,3
Bigdickgomez,frostmourne,288,warrior,fury,6,3,3
Tasswar,hyjal,288,warrior,fury,6,3,3
Thaann,illidan,288,warrior,fury,6,3,3
Govosh,thrall,288,warrior,fury,6,3,3
Protstitute,hyjal,288,warrior,fury,6,3,3
Benw,dawnbringer,288,warrior,fury,6,3,3
Chzze,tichondrius,288,warrior,fury,6,3,3
Soloqandy,moon-guard,288,warrior,fury,6,3,3
Kurowar,drakkari,288,warrior,fury,6,3,3
Wisslogia,ragnaros,288,warrior,fury,6,3,3
Kazek,sargeras,288,warrior,fury,6,3,3
Strongboii,tichondrius,288,warrior,fury,6,3,3
Kahn,andorhal,288,warrior,fury,6,3,3
Aùstin,moon-guard,288,warrior,fury,6,3,3
Pezy,frostmourne,288,warrior,fury,6,3,3
Bloodthornx,quelthalas,288,warrior,fury,6,3,3
Tâlos,ysondre,288,warrior,fury,6,3,3
Tâlos,magtheridon,288,warrior,fury,6,3,3
Joarmyman,proudmoore,288,warrior,fury,6,3,3
Mcdowëll,moon-guard,288,warrior,fury,6,3,3
Painfulsin,tichondrius,288,warrior,fury,6,3,3
Rí,moon-guard,288,warrior,fury,6,3,3
Demøletiøn,stormrage,288,warrior,fury,6,3,3
Daytime,scilla,288,warrior,fury,6,3,3
Sánsón,illidan,288,warrior,fury,6,3,3
Crowsfall,aggramar,288,warrior,fury,6,3,3
Zugsok,thrall,288,warrior,fury,6,3,3
Dirtypin,shadowmoon,288,warrior,fury,6,3,3
Devolved,amanthul,288,warrior,fury,6,3,3
Çhocothunder,area-52,288,warrior,fury,6,3,3
Miyamashi,stormrage,288,warrior,fury,6,3,3
Vodak,daggerspine,288,warrior,fury,6,3,3
Martrek,amanthul,288,warrior,fury,6,3,3
Jodoro,malfurion,288,warrior,fury,6,3,3
Perrin,burning-blade,288,warrior,fury,6,3,3
Orcly,kilrogg,288,warrior,fury,6,3,3
Lazs,wyrmrest-accord,288,warrior,fury,6,3,3
Santhvel,jubeithos,288,warrior,fury,6,3,3
Tenfury,proudmoore,288,warrior,fury,6,3,3
Cocó,sargeras,288,warrior,fury,6,3,3
Oven,tichondrius,288,warrior,fury,6,3,3
Kriloth,frostmourne,288,warrior,fury,6,3,3
Rogorof,azralon,288,warrior,fury,6,3,3
Zemi,sargeras,288,warrior,fury,6,3,3
Immòrtal,zuljin,288,warrior,fury,6,3,3
Aruia,proudmoore,288,warrior,fury,6,3,3
Guillotinè,area-52,288,warrior,fury,6,3,3
Hithen,quelthalas,288,warrior,fury,6,3,3
Júmmy,area-52,288,warrior,fury,6,3,3
Skynitez,area-52,288,warrior,fury,6,3,3
Tobyrendrson,area-52,288,warrior,fury,6,3,3
Warmaghar,azralon,288,warrior,fury,6,3,3
Corvesio,wyrmrest-accord,288,warrior,fury,6,3,3
Kimed,nordrassil,288,warrior,fury,6,3,3
Eightballerz,barthilas,288,warrior,fury,6,3,3
Scylall,area-52,288,warrior,fury,6,3,3
Anticiðe,zuljin,288,warrior,fury,6,3,3
Galachad,jubeithos,288,warrior,fury,6,3,3
Barbarìan,bleeding-hollow,288,warrior,fury,6,3,3
Wargasms,alterac-mountains,288,warrior,fury,6,3,3
Corgii,khaz-modan,288,warrior,fury,6,3,3
Abuse,nordrassil,288,warrior,fury,6,3,3
Kàli,kiljaeden,288,warrior,fury,6,3,3
Slitt,azralon,288,warrior,fury,6,3,3
Tsathoggua,kiljaeden,288,warrior,fury,6,3,3
Brindlè,kelthuzad,288,warrior,fury,7,3,4
Bled,quelthalas,288,warrior,fury,10,4,6
Duudoo,stormrage,288,warrior,fury,8,3,5
Loadmaster,dragonmaw,288,warrior,fury,8,3,5
Cøpperpøt,bleeding-hollow,288,warrior,fury,9,3,6
Urion,illidan,288,warrior,fury,11,3,8
Slimeto,area-52,288,warrior,fury,12,3,9
Bladeweaver,illidan,288,warrior,fury,12,3,9
Tríxman,moon-guard,288,warrior,fury,12,3,9
Gristly,sargeras,288,warrior,fury,12,3,9
Blackscale,grizzly-hills,288,warrior,fury,12,3,9
Lynn,zangarmarsh,288,warrior,fury,12,3,9
Leonz,undermine,288,warrior,fury,12,3,9
Ratface,frostmourne,288,warrior,fury,12,3,9
Zelekron,emerald-dream,288,warrior,fury,12,3,9
Rólex,tichondrius,288,warrior,fury,12,3,9
Powerhard,area-52,288,warrior,fury,12,3,9
Bebob,tichondrius,288,warrior,fury,12,3,9
Krimmjðw,sargeras,288,warrior,fury,12,3,9
Shínkicker,area-52,288,warrior,fury,12,3,9
Davien,tichondrius,288,warrior,fury,12,3,9
Flexìn,tichondrius,288,warrior,fury,12,3,9
Pastorpeen,thrall,288,warrior,fury,12,3,9
Kimuraa,hyjal,288,warrior,fury,12,3,9
Monkeybrain,azralon,288,warrior,fury,12,3,9
Apolio,magtheridon,288,warrior,fury,12,3,9
Stromkiller,stormrage,288,warrior,fury,12,3,9
Serrabella,illidan,288,warrior,fury,12,3,9
Kromgrall,tichondrius,288,warrior,fury,12,3,9
Rageroidz,area-52,288,warrior,fury,12,3,9
Krilles,tichondrius,288,warrior,fury,12,3,9
Banggo,frostmourne,288,warrior,fury,12,3,9
Hokanii,moon-guard,288,warrior,fury,12,3,9
Andro,arthas,288,warrior,fury,12,3,9
Barcëlð,frostmourne,288,warrior,fury,12,3,9
Queterompo,ragnaros,288,warrior,fury,18,3,15
Jujuassgeter,darkspear,288,warrior,fury,18,3,15
Anamich,quelthalas,287,warrior,fury,6,3,3
Disclone,tichondrius,287,warrior,fury,6,3,3
Monsterpepe,tichondrius,287,warrior,fury,12,3,9
Furyworgen,kiljaeden,287,warrior,fury,18,3,15
Daymancometh,proudmoore,271,warrior,fury,11,3,8
Bigdaddyzees,bleeding-hollow,255,warrior,fury,11,3,8
Zolpidem,nemesis,255,warrior,fury,11,3,8
Aserus,quelthalas,240,warrior,fury,21,3,18
Gwod,stormrage,239,warrior,fury,5,3,2
Chupelo,tichondrius,239,warrior,fury,5,3,2
Ramaraparoo,proudmoore,239,warrior,fury,5,3,2
Ramisés,stormrage,239,warrior,fury,5,3,2
Asteríon,sargeras,239,warrior,fury,5,3,2
Reagzy,stormrage,234,warrior,fury,10,4,6
Lubri,azralon,223,warrior,fury,8,3,5
Schlosh,laughing-skull,223,warrior,fury,8,3,5
Heirel,kelthuzad,208,warrior,fury,7,3,4
Datneck,tichondrius,192,warrior,fury,4,3,1
Çórý,area-52,192,warrior,fury,4,3,1
Gavtini,drakthul,192,warrior,fury,4,3,1
Amaragos,tichondrius,192,warrior,fury,6,4,2
Kushal,sargeras,192,warrior,fury,8,3,5
Drefnor,thunderhorn,192,warrior,fury,9,3,6
Zarkró,quelthalas,192,warrior,fury,6,2,4
Gladicus,zuljin,192,warrior,fury,6,2,4
Xîonorc,ragnaros,192,warrior,fury,6,2,4
Tarkvs,ragnaros,192,warrior,fury,6,2,4
Jowesley,azralon,192,warrior,fury,6,2,4
Casteleiro,azralon,192,warrior,fury,6,2,4
Släughter,zuljin,192,warrior,fury,6,2,4
Shablamm,korgath,192,warrior,fury,6,2,4
Containerbox,korgath,192,warrior,fury,6,2,4
Drugdilla,zuljin,192,warrior,fury,6,2,4
Franc,kiljaeden,192,warrior,fury,6,2,4
Rundai,zuljin,192,warrior,fury,6,2,4
Boombop,zuljin,192,warrior,fury,6,2,4
Peekyblinder,kiljaeden,192,warrior,fury,6,2,4
Trágus,azralon,192,warrior,fury,6,2,4
Ðöminátè,kiljaeden,192,warrior,fury,6,2,4
Unterg,ragnaros,192,warrior,fury,6,2,4
Gotcrit,blood-furnace,192,warrior,fury,6,2,4
Clönazepam,azralon,192,warrior,fury,6,2,4
Iapologiz,illidan,192,warrior,fury,6,2,4
Linios,tichondrius,192,warrior,fury,6,2,4
Zareos,azralon,192,warrior,fury,6,2,4
ßoris,grizzly-hills,192,warrior,fury,6,2,4
Uju,lothar,192,warrior,fury,6,2,4
Elyoy,aerie-peak,192,warrior,fury,6,2,4
Arakod,moon-guard,192,warrior,fury,6,2,4
Blackpinkx,tichondrius,192,warrior,fury,6,2,4
Märkdî,quelthalas,192,warrior,fury,6,2,4
Xorjak,tichondrius,192,warrior,fury,6,2,4
Vaclein,quelthalas,192,warrior,fury,6,2,4
Thrawb,bleeding-hollow,192,warrior,fury,6,2,4
Skalmöld,area-52,192,warrior,fury,6,2,4
Krannos,area-52,192,warrior,fury,6,2,4
Valko,ragnaros,192,warrior,fury,6,2,4
Aisinbro,illidan,192,warrior,fury,6,2,4
Zeroy,bleeding-hollow,192,warrior,fury,6,2,4
Lopotron,sargeras,192,warrior,fury,6,2,4
Blademaw,stormreaver,192,warrior,fury,6,2,4
Brosèph,sargeras,192,warrior,fury,6,2,4
Jéshka,wyrmrest-accord,192,warrior,fury,6,2,4
Jägernaught,stormrage,192,warrior,fury,6,2,4
Pippysmallz,tichondrius,192,warrior,fury,6,2,4
Veyronn,stormrage,192,warrior,fury,6,2,4
Tepaste,ragnaros,192,warrior,fury,6,2,4
Azrailz,stormrage,192,warrior,fury,6,2,4
Kalabawph,area-52,192,warrior,fury,6,2,4
Deizhul,stormscale,192,warrior,fury,6,2,4
Zdokk,sargeras,192,warrior,fury,6,2,4
Zooboo,laughing-skull,192,warrior,fury,6,2,4
Bobisyourmom,tichondrius,192,warrior,fury,6,2,4
Backtrack,whisperwind,192,warrior,fury,6,2,4
Elchacál,ragnaros,192,warrior,fury,6,2,4
Nebraskapete,wyrmrest-accord,192,warrior,fury,6,2,4
Twoironfist,azralon,192,warrior,fury,6,2,4
Jeyvil,stormrage,192,warrior,fury,6,2,4
Prodgio,nemesis,192,warrior,fury,6,2,4
Larath,quelthalas,192,warrior,fury,6,2,4
Telynne,frostmourne,192,warrior,fury,6,2,4
Browngusher,sargeras,192,warrior,fury,6,2,4
Kraven,haomarush,192,warrior,fury,6,2,4
Tÿ,haomarush,192,warrior,fury,6,2,4
Weewarrior,wyrmrest-accord,192,warrior,fury,6,2,4
Disheartened,wyrmrest-accord,192,warrior,fury,6,2,4
Chloee,the-underbog,192,warrior,fury,6,2,4
Gladcal,stormscale,192,warrior,fury,6,2,4
Collapsekim,tichondrius,192,warrior,fury,6,2,4
Aboveaverage,arthas,192,warrior,fury,6,2,4
Warney,tichondrius,192,warrior,fury,6,2,4
Lokgur,gallywix,192,warrior,fury,6,2,4
Warpork,sargeras,192,warrior,fury,6,2,4
Kachigas,sargeras,192,warrior,fury,6,2,4
Matahorda,darkspear,192,warrior,fury,6,2,4
Hatedßyßlízz,area-52,192,warrior,fury,6,2,4
Catdestroyer,kelthuzad,192,warrior,fury,6,2,4
Mussashí,stormrage,192,warrior,fury,6,2,4
Ëxecute,darkspear,192,warrior,fury,6,2,4
Amberlym,ragnaros,192,warrior,fury,6,2,4
Torimzor,nemesis,192,warrior,fury,6,2,4
Bigbadaxe,sargeras,192,warrior,fury,6,2,4
Taurwaz,draka,192,warrior,fury,6,2,4
Sickwar,emerald-dream,192,warrior,fury,6,2,4
Lepzed,area-52,192,warrior,fury,6,2,4
Gorkar,frostwolf,192,warrior,fury,6,2,4
Jayynorthyy,malganis,192,warrior,fury,6,2,4
Kørønus,bonechewer,192,warrior,fury,6,2,4
Svera,dalaran,192,warrior,fury,6,2,4
Drayco,tichondrius,192,warrior,fury,6,2,4
Wooters,tichondrius,192,warrior,fury,6,2,4
Thevan,dunemaul,192,warrior,fury,6,2,4
Erikx,ragnaros,192,warrior,fury,6,2,4
Youdeadx,aegwynn,192,warrior,fury,6,2,4
Fofefa,ragnaros,192,warrior,fury,6,2,4
Threg,malganis,192,warrior,fury,6,2,4
Moosoka,malorne,192,warrior,fury,6,2,4
Bersérk,area-52,192,warrior,fury,6,2,4
Cdjr,malganis,192,warrior,fury,6,2,4
Estrasystole,sargeras,192,warrior,fury,6,2,4
Swinkyzug,tichondrius,192,warrior,fury,6,2,4
Grekk,kelthuzad,192,warrior,fury,6,2,4
Bachyr,stormrage,192,warrior,fury,6,2,4
Jäëgër,moon-guard,192,warrior,fury,6,2,4
Bernardes,stormrage,192,warrior,fury,6,2,4
Gistid,frostmourne,192,warrior,fury,6,2,4
Ultraa,lightbringer,192,warrior,fury,6,2,4
Kaniks,dalaran,192,warrior,fury,6,2,4
Garagedays,area-52,192,warrior,fury,6,2,4
Clerond,tichondrius,192,warrior,fury,6,2,4
Mimiu,ragnaros,192,warrior,fury,6,2,4
Kokixz,tichondrius,192,warrior,fury,6,2,4
Brewstrike,dalaran,192,warrior,fury,6,2,4
Beatmeat,frostmourne,192,warrior,fury,6,2,4
Birddogs,scarlet-crusade,192,warrior,fury,6,2,4
Aoste,tichondrius,192,warrior,fury,6,2,4
Uglymanxd,area-52,192,warrior,fury,6,2,4
Lôwkeyfix,illidan,192,warrior,fury,6,2,4
Slambiggly,tichondrius,192,warrior,fury,6,2,4
Rexxunos,ragnaros,192,warrior,fury,6,2,4
Hazew,kelthuzad,192,warrior,fury,6,2,4
Iïl,area-52,192,warrior,fury,6,2,4
Yeèzy,stormrage,192,warrior,fury,6,2,4
Estrozo,sargeras,192,warrior,fury,6,2,4
Cartmain,illidan,192,warrior,fury,6,2,4
Stugwar,moon-guard,192,warrior,fury,6,2,4
Creepedz,tichondrius,192,warrior,fury,6,2,4
Wqnmlgbd,tichondrius,192,warrior,fury,6,2,4
Horahloux,ragnaros,192,warrior,fury,6,2,4
Nsanesavage,kelthuzad,192,warrior,fury,6,2,4
Tickletickle,illidan,192,warrior,fury,6,2,4
Ludøciel,moon-guard,192,warrior,fury,6,2,4
Tentacruels,area-52,192,warrior,fury,6,2,4
Areiana,stormrage,192,warrior,fury,6,2,4
Awlawdemrang,tichondrius,192,warrior,fury,6,2,4
Eîghtysîx,sargeras,192,warrior,fury,6,2,4
Ballbusting,moon-guard,192,warrior,fury,6,2,4
Deafwarrior,sargeras,192,warrior,fury,6,2,4
Drenzywar,scilla,192,warrior,fury,6,2,4
Slamspam,the-underbog,192,warrior,fury,6,2,4
Ghostkin,ragnaros,192,warrior,fury,6,2,4
Smokedaperc,illidan,192,warrior,fury,6,2,4
Tigershárk,tichondrius,192,warrior,fury,6,2,4
Gakatarc,thrall,192,warrior,fury,6,2,4
Sustantus,emerald-dream,192,warrior,fury,6,2,4
Katfight,frostmourne,192,warrior,fury,6,2,4
Bariotyr,the-underbog,192,warrior,fury,6,2,4
Aqee,illidan,192,warrior,fury,6,2,4
Gangelx,illidan,192,warrior,fury,6,2,4
Halò,thrall,192,warrior,fury,6,2,4
Wendër,area-52,192,warrior,fury,6,2,4
Záshá,ragnaros,192,warrior,fury,6,2,4
Dagorine,eredar,192,warrior,fury,6,2,4
Andrexion,moon-guard,192,warrior,fury,6,2,4
Borealiss,ragnaros,192,warrior,fury,6,2,4
Autopsys,moon-guard,192,warrior,fury,6,2,4
Mafe,tichondrius,192,warrior,fury,6,2,4
Neifle,tichondrius,192,warrior,fury,6,2,4
Jkasdfglkg,tichondrius,192,warrior,fury,6,2,4
Onlyslams,sargeras,192,warrior,fury,6,2,4
Arx,frostwolf,192,warrior,fury,6,2,4
Mekkanic,moon-guard,192,warrior,fury,6,2,4
Twilightzza,sargeras,192,warrior,fury,6,2,4
Gnasty,hyjal,192,warrior,fury,6,2,4
Noor,tichondrius,192,warrior,fury,6,2,4
Fetalalcohol,illidan,192,warrior,fury,6,2,4
Itzyourmom,nazjatar,192,warrior,fury,6,2,4
Verigislena,moon-guard,192,warrior,fury,6,2,4
Good,garona,192,warrior,fury,6,2,4
Hackbbadda,tichondrius,192,warrior,fury,6,2,4
Redrunebar,illidan,192,warrior,fury,6,2,4
Helder,destromath,192,warrior,fury,6,2,4
Oohdang,tichondrius,192,warrior,fury,6,2,4
Druckerz,lightnings-blade,192,warrior,fury,6,2,4
Killaen,thrall,192,warrior,fury,6,2,4
Lêvïåthån,moon-guard,192,warrior,fury,6,2,4
Youdiankua,illidan,192,warrior,fury,6,2,4
Melithiae,barthilas,192,warrior,fury,6,2,4
Yermalt,tichondrius,192,warrior,fury,6,2,4
Warkahoz,drakkari,192,warrior,fury,6,2,4
Koast,aerie-peak,192,warrior,fury,6,2,4
Dysazter,ravencrest,192,warrior,fury,6,2,4
Mortaldznuts,tichondrius,192,warrior,fury,6,2,4
Rahu,thrall,192,warrior,fury,6,2,4
Painstake,illidan,192,warrior,fury,6,2,4
Persiancoco,tichondrius,192,warrior,fury,6,2,4
Supersteak,tichondrius,192,warrior,fury,6,2,4
Bobbylee,ravencrest,192,warrior,fury,6,2,4
Mahievs,area-52,192,warrior,fury,10,3,7
Bonesheild,ursin,192,warrior,fury,11,2,9
Ragëqt,windrunner,192,warrior,fury,12,2,10
Typenine,proudmoore,192,warrior,fury,12,2,10
Wêlfoment,ragnaros,192,warrior,fury,12,2,10
Zoldyak,ragnaros,192,warrior,fury,12,2,10
Mickyplate,tichondrius,192,warrior,fury,12,2,10
Alchremo,dalaran,192,warrior,fury,12,2,10
Zugmeov,barthilas,192,warrior,fury,12,2,10
Destrogore,darkspear,192,warrior,fury,12,2,10
Doappy,darkspear,192,warrior,fury,12,2,10
Shandrar,frostmourne,192,warrior,fury,12,2,10
Warmul,bleeding-hollow,192,warrior,fury,12,2,10
Thecolor,tichondrius,192,warrior,fury,12,2,10
Kames,garrosh,192,warrior,fury,12,2,10
Gymnopolar,barthilas,192,warrior,fury,12,2,10
Naabii,moon-guard,191,warrior,fury,6,2,4
Nirvyn,quelthalas,191,warrior,fury,6,2,4
Werrewolf,kul-tiras,191,warrior,fury,6,2,4
Wayne,kargath,160,warrior,fury,16,2,14
Warriormikey,tichondrius,159,warrior,fury,5,2,3
Mariò,area-52,159,warrior,fury,5,2,3
Orangerzze,hyjal,145,warrior,fury,32,9,23
Finana,illidan,138,warrior,fury,10,4,6
Dräxxär,sargeras,138,warrior,fury,10,3,7
Eldarad,stormrage,128,warrior,fury,4,2,2
Chadrich,kilrogg,128,warrior,fury,4,2,2
Fatbarstard,jubeithos,128,warrior,fury,4,2,2
Andrewceo,tichondrius,128,warrior,fury,4,2,2
Bootskrapp,azgalor,112,warrior,fury,7,2,5
Bradockqt,azralon,96,warrior,fury,3,2,1
Nëcrophagist,wyrmrest-accord,96,warrior,fury,3,2,1
Trén,hydraxis,96,warrior,fury,6,1,5
Diudiu,tichondrius,96,warrior,fury,6,1,5
Shwizzyy,tichondrius,96,warrior,fury,6,1,5
Beray,skullcrusher,96,warrior,fury,6,1,5
Flabergaster,skullcrusher,96,warrior,fury,6,1,5
Neverwinta,moon-guard,96,warrior,fury,6,1,5
Quasi,tichondrius,96,warrior,fury,6,1,5
Deydradrene,illidan,96,warrior,fury,6,1,5
Vvengencezz,the-underbog,96,warrior,fury,6,1,5
Fûry,barthilas,96,warrior,fury,6,1,5
Wapistun,thrall,96,warrior,fury,6,1,5
Augutra,moon-guard,96,warrior,fury,6,1,5
Xiaohuzi,tichondrius,96,warrior,fury,6,1,5
Xehm,tichondrius,96,warrior,fury,6,1,5
Ustadbaba,area-52,96,warrior,fury,6,1,5
Zingerboss,barthilas,96,warrior,fury,6,1,5
Lanlorash,barthilas,96,warrior,fury,6,1,5
Alitalia,thunderlord,96,warrior,fury,6,1,5
Nazuke,wyrmrest-accord,96,warrior,fury,6,1,5
Warrdawg,tichondrius,96,warrior,fury,6,1,5
Harattawi,thrall,96,warrior,fury,6,1,5
Bigk,korgath,96,warrior,fury,6,1,5
Soulmerc,turalyon,96,warrior,fury,6,1,5
Nerdturd,mannoroth,96,warrior,fury,6,1,5
Dokoba,bleeding-hollow,96,warrior,fury,6,1,5
Largegayman,sargeras,96,warrior,fury,6,1,5
Savager,spinebreaker,96,warrior,fury,6,1,5
Lifaen,zangarmarsh,96,warrior,fury,6,1,5
Radianteyes,quelthalas,96,warrior,fury,6,1,5
Aiforix,gorefiend,96,warrior,fury,6,1,5
Slayabunny,icecrown,96,warrior,fury,6,1,5
Loveføx,stormrage,96,warrior,fury,6,1,5
Bbyè,tichondrius,96,warrior,fury,6,1,5
Broxar,area-52,96,warrior,fury,6,1,5
Rexxous,hyjal,96,warrior,fury,6,1,5
Bumrushed,tichondrius,96,warrior,fury,6,1,5
Lambsy,zuljin,96,warrior,fury,6,1,5
Tarviss,exodar,96,warrior,fury,6,1,5
Xut,moon-guard,96,warrior,fury,6,1,5
Nipnipz,kelthuzad,96,warrior,fury,6,1,5
Arkayla,moon-guard,96,warrior,fury,6,1,5
Lawlstørm,stormrage,96,warrior,fury,6,1,5
Tamagoshi,kiljaeden,96,warrior,fury,6,1,5
Rongor,drakkari,96,warrior,fury,6,1,5
Horabad,terenas,96,warrior,fury,6,1,5
ßallinjr,illidan,96,warrior,fury,6,1,5
Pcprincipal,khadgar,96,warrior,fury,6,1,5
Keirina,bonechewer,96,warrior,fury,6,1,5
Magarrior,shadowsong,96,warrior,fury,6,1,5
Bigcracka,illidan,96,warrior,fury,6,1,5
Polox,ragnaros,96,warrior,fury,6,1,5
Spartacam,frostmourne,96,warrior,fury,6,1,5
Chóps,quelthalas,96,warrior,fury,6,1,5
Kraevok,feathermoon,96,warrior,fury,6,1,5
Aftershóck,daggerspine,96,warrior,fury,6,1,5
Jazzkiler,azralon,96,warrior,fury,6,1,5
Thegalant,dalaran,96,warrior,fury,6,1,5
Srze,azralon,96,warrior,fury,6,1,5
Awex,kelthuzad,96,warrior,fury,6,1,5
Ravenxdawnx,tichondrius,96,warrior,fury,6,1,5
Grândmâ,zuljin,96,warrior,fury,6,1,5
Schwicker,stormrage,96,warrior,fury,6,1,5
Nillor,emerald-dream,96,warrior,fury,6,1,5
Pornawar,area-52,96,warrior,fury,6,1,5
Sweetred,windrunner,96,warrior,fury,6,1,5
Mafia,dalaran,96,warrior,fury,6,1,5
Bigwarrior,stonemaul,96,warrior,fury,6,1,5
Handain,malganis,96,warrior,fury,6,1,5
Warrbull,spirestone,96,warrior,fury,6,1,5
Stonnies,bleeding-hollow,96,warrior,fury,6,1,5
Girthyslaps,frostmourne,96,warrior,fury,6,1,5
Dabdaddyy,dawnbringer,96,warrior,fury,6,1,5
Murrdock,nesingwary,96,warrior,fury,6,1,5
Play,dark-iron,96,warrior,fury,6,1,5
Woponese,veknilash,96,warrior,fury,6,1,5
Beserkqt,azralon,96,warrior,fury,6,1,5
Igmif,stormrage,96,warrior,fury,6,1,5
Warritha,ragnaros,96,warrior,fury,6,1,5
Béntley,kiljaeden,96,warrior,fury,6,1,5
Freanor,azralon,96,warrior,fury,6,1,5
Warriortimes,ragnaros,96,warrior,fury,6,1,5
Ragnarsmash,stormrage,96,warrior,fury,6,1,5
Hypëriøn,bleeding-hollow,96,warrior,fury,6,1,5
ßlåde,lethon,96,warrior,fury,6,1,5
Neotico,quelthalas,96,warrior,fury,6,1,5
Omnislash,proudmoore,96,warrior,fury,6,1,5
Lungwar,tichondrius,96,warrior,fury,6,1,5
Trollchopo,kiljaeden,96,warrior,fury,6,1,5
Figork,tichondrius,96,warrior,fury,6,1,5
Fatdiabetic,tichondrius,96,warrior,fury,6,1,5
Draann,kirin-tor,96,warrior,fury,6,1,5
Carnagè,area-52,96,warrior,fury,6,1,5
Ridemepapi,tichondrius,96,warrior,fury,6,1,5
Ezsmash,firetree,96,warrior,fury,6,1,5
Laylowk,tichondrius,96,warrior,fury,6,1,5
Annihilataur,blackhand,96,warrior,fury,6,1,5
Freesubs,sargeras,96,warrior,fury,6,1,5
Bvngk,tichondrius,96,warrior,fury,6,1,5
Jotar,goldrinn,96,warrior,fury,6,1,5
Rades,sargeras,96,warrior,fury,6,1,5
Gregur,sargeras,96,warrior,fury,6,1,5
Bigboyorior,caelestrasz,96,warrior,fury,6,1,5
Jackhsu,tichondrius,96,warrior,fury,6,1,5
Katsarola,cenarion-circle,96,warrior,fury,6,1,5
Fletçhér,sargeras,96,warrior,fury,7,1,6
Ballzindeep,tichondrius,96,warrior,fury,9,1,8
Furyofbeans,area-52,96,warrior,fury,12,1,11
Mawdryn,destromath,96,warrior,fury,12,1,11
Facerollyou,blackrock,96,warrior,fury,12,1,11
Zaxari,gurubashi,96,warrior,fury,12,1,11
Philbert,alexstrasza,96,warrior,fury,12,1,11
Maaxdry,area-52,96,warrior,fury,12,1,11
Mamalonic,ragnaros,96,warrior,fury,12,1,11
Syegfried,dethecus,79,warrior,fury,5,1,4
Yirko,quelthalas,79,warrior,fury,5,1,4
Boouuaakk,tichondrius,79,warrior,fury,5,1,4
Gigglamesh,muradin,64,warrior,fury,4,1,3
Guroku,tichondrius,64,warrior,fury,4,1,3
Cremosö,azralon,64,warrior,fury,4,1,3
Adonis,burning-blade,64,warrior,fury,10,1,9
Xidaego,tichondrius,63,warrior,fury,2,2,0
Coverage,frostmourne,63,warrior,fury,2,2,0
Allenwrite,frostmourne,63,warrior,fury,2,2,0
Sìkarío,illidan,48,warrior,fury,3,1,2
Warmain,haomarush,48,warrior,fury,3,1,2
Kirikash,illidan,42,warrior,fury,6,2,4
Ztg,tichondrius,42,warrior,fury,11,2,9
Vioar,hyjal,31,warrior,fury,2,1,1
Edrelang,bronzebeard,31,warrior,fury,2,1,1
Khàzix,kelthuzad,31,warrior,fury,2,1,1
Spartaacus,windrunner,31,warrior,fury,2,1,1
Freakdps,stormrage,16,warrior,fury,1,1,0
Lehzera,frostmourne,16,warrior,fury,1,1,0
Hapigirl,tichondrius,2283,warrior,arms,66,48,18
Exzistance,area-52,2242,warrior,arms,127,70,57
Río,area-52,2207,warrior,arms,171,89,82
Récksus,tichondrius,2182,warrior,arms,98,58,40
Thiccbiscuit,area-52,2168,warrior,arms,133,67,66
Zhanwudix,tichondrius,2162,warrior,arms,111,62,49
Killbørn,azralon,2156,warrior,arms,90,47,43
Marsshine,tichondrius,2142,warrior,arms,119,63,56
Turtleboy,feathermoon,2141,warrior,arms,79,45,34
Todory,moon-guard,2137,warrior,arms,155,78,77
Ikkyuo,proudmoore,2136,warrior,arms,174,93,81
Ðêed,area-52,2134,warrior,arms,87,49,38
Dpoy,tichondrius,2130,warrior,arms,114,57,57
Schonkopf,moon-guard,2128,warrior,arms,96,50,46
Kraftyx,bleeding-hollow,2125,warrior,arms,72,44,28
Ssamök,ragnaros,2125,warrior,arms,329,168,161
Toutie,tichondrius,2122,warrior,arms,120,67,53
Buckwar,zuljin,2121,warrior,arms,78,41,37
Huzha,tichondrius,2114,warrior,arms,117,64,53
Warried,sargeras,2113,warrior,arms,66,37,29
Tyranitar,proudmoore,2113,warrior,arms,90,50,40
Strife,sargeras,2112,warrior,arms,56,32,24
Abswar,tichondrius,2110,warrior,arms,171,100,71
Menethíl,tichondrius,2110,warrior,arms,156,82,74
Warrgodlol,illidan,2109,warrior,arms,81,41,40
Nitron,dawnbringer,2108,warrior,arms,89,45,44
Vituu,sargeras,2107,warrior,arms,110,57,53
Edgarllama,sargeras,2103,warrior,arms,87,48,39
ßallinjr,illidan,2103,warrior,arms,90,46,44
Recksus,tichondrius,2102,warrior,arms,119,74,45
Huuzha,tichondrius,2102,warrior,arms,95,55,40
Nikomasked,kelthuzad,2100,warrior,arms,66,37,29
Forakenna,dragonmaw,2096,warrior,arms,75,48,27
Foraken,dragonmaw,2090,warrior,arms,77,44,33
Anti,nerzhul,2055,warrior,arms,87,45,42
Cloudxxy,kiljaeden,2052,warrior,arms,75,43,32
Belàrià,tichondrius,2049,warrior,arms,85,48,37
Leans,sargeras,2048,warrior,arms,143,78,65
Salgadoryan,stormrage,2047,warrior,arms,232,118,114
Exespamtwo,area-52,2045,warrior,arms,206,112,94
Killborn,tichondrius,2044,warrior,arms,151,74,77
Vø,agamaggan,2042,warrior,arms,219,111,108
Bighamm,tichondrius,2037,warrior,arms,77,46,31
Orclog,illidan,2033,warrior,arms,72,37,35
Islonely,tichondrius,2026,warrior,arms,168,81,87
Leoneceo,azralon,2025,warrior,arms,132,82,50
Foxxfighter,thrall,2025,warrior,arms,104,55,49
Iløveaysla,azralon,2021,warrior,arms,96,47,49
Bajheera,sargeras,2016,warrior,arms,59,34,25
Gyracide,area-52,2016,warrior,arms,101,49,52
Tryhardr,sargeras,2006,warrior,arms,266,143,123
Shadowstingg,tichondrius,2002,warrior,arms,83,41,42
Blackpînk,tichondrius,1992,warrior,arms,78,43,35
Huugg,skullcrusher,1990,warrior,arms,183,98,85
Icarryrats,tichondrius,1988,warrior,arms,105,52,53
Nuqipq,tichondrius,1986,warrior,arms,94,48,46
Wutainx,tichondrius,1984,warrior,arms,60,33,27
Bhaldur,sargeras,1984,warrior,arms,194,106,88
Arthurjlol,tichondrius,1982,warrior,arms,72,33,39
Og,shattered-hand,1979,warrior,arms,53,31,22
Ironbad,sargeras,1977,warrior,arms,110,58,52
Hoobaz,area-52,1977,warrior,arms,69,35,34
Boblennon,tichondrius,1977,warrior,arms,72,33,39
Sick,azralon,1973,warrior,arms,94,46,48
Lyrics,tichondrius,1969,warrior,arms,62,32,30
Pdbq,tichondrius,1968,warrior,arms,114,59,55
Chakø,tichondrius,1966,warrior,arms,114,66,48
Szw,tichondrius,1966,warrior,arms,293,164,129
Azaks,drakkari,1965,warrior,arms,58,32,26
Bigjbs,tichondrius,1963,warrior,arms,48,29,19
Massacretko,area-52,1962,warrior,arms,88,50,38
Grantlol,illidan,1961,warrior,arms,102,55,47
Dissector,ragnaros,1953,warrior,arms,72,38,34
Ddaÿ,tichondrius,1952,warrior,arms,177,85,92
Belàriá,tichondrius,1948,warrior,arms,66,36,30
Bùbbájr,emerald-dream,1947,warrior,arms,72,35,37
Yermalx,tichondrius,1941,warrior,arms,54,30,24
Ricorecklezz,korgath,1941,warrior,arms,72,33,39
Magicalol,tichondrius,1937,warrior,arms,66,39,27
Bigladmike,sargeras,1937,warrior,arms,90,40,50
Ðìbs,moon-guard,1936,warrior,arms,77,39,38
Moxxyy,tichondrius,1935,warrior,arms,48,30,18
Bacchanal,illidan,1935,warrior,arms,215,107,108
Ignid,tichondrius,1934,warrior,arms,144,69,75
Fanglerondz,area-52,1932,warrior,arms,53,28,25
Icanfixher,moon-guard,1932,warrior,arms,835,418,417
Perfs,bleeding-hollow,1931,warrior,arms,108,53,55
Kalpok,tichondrius,1929,warrior,arms,64,33,31
Yermalt,tichondrius,1928,warrior,arms,92,48,44
Kiggs,tichondrius,1925,warrior,arms,66,34,32
Marfas,hyjal,1924,warrior,arms,157,86,71
Hookahboss,area-52,1923,warrior,arms,70,36,34
Ushouldnome,tichondrius,1921,warrior,arms,72,40,32
Bigbait,hyjal,1921,warrior,arms,78,38,40
Cutgirl,quelthalas,1919,warrior,arms,115,57,58
Gormag,sargeras,1917,warrior,arms,60,35,25
Smorc,stormrage,1917,warrior,arms,60,31,29
Überwältigen,thrall,1917,warrior,arms,59,29,30
Indominate,tichondrius,1916,warrior,arms,222,116,106
Paoxiaolol,tichondrius,1915,warrior,arms,85,54,31
Coldlòve,akama,1911,warrior,arms,54,30,24
Yamatoflash,tichondrius,1911,warrior,arms,81,40,41
Cosmicsteel,tichondrius,1908,warrior,arms,88,51,37
Thugdorr,sargeras,1908,warrior,arms,82,40,42
Solastro,malganis,1906,warrior,arms,74,35,39
Painqt,area-52,1903,warrior,arms,24,20,4
Madblackcat,illidan,1902,warrior,arms,58,34,24
Isnlonely,tichondrius,1901,warrior,arms,42,26,16
Kimchikick,tichondrius,1901,warrior,arms,209,109,100
Vascoes,alleria,1898,warrior,arms,191,107,84
Rageroidz,area-52,1897,warrior,arms,96,52,44
Invalidoath,tichondrius,1897,warrior,arms,72,36,36
Goonassassin,tichondrius,1896,warrior,arms,70,38,32
Kfcvivofifty,tichondrius,1894,warrior,arms,137,73,64
Lícketysplít,ysondre,1893,warrior,arms,52,29,23
Hoboedd,area-52,1893,warrior,arms,94,45,49
Zuckexe,illidan,1892,warrior,arms,76,43,33
Kydrav,khadgar,1891,warrior,arms,52,28,24
Jgillz,sargeras,1891,warrior,arms,78,41,37
Yeawen,tichondrius,1890,warrior,arms,54,27,27
Tigima,tichondrius,1889,warrior,arms,78,38,40
Joshiguy,area-52,1889,warrior,arms,78,36,42
Etchiasoko,gurubashi,1888,warrior,arms,48,33,15
Darrowshire,moon-guard,1888,warrior,arms,47,28,19
Mítos,quelthalas,1888,warrior,arms,215,109,106
Tankypandazd,stormrage,1886,warrior,arms,323,159,164
Bpdpacient,illidan,1885,warrior,arms,36,28,8
Betterthanu,azralon,1885,warrior,arms,174,91,83
Wtssap,ragnaros,1884,warrior,arms,42,27,15
Exëqt,nemesis,1884,warrior,arms,156,79,77
Ruinenlust,zuljin,1884,warrior,arms,138,66,72
Drdalidou,zuljin,1884,warrior,arms,54,25,29
Ttvdjrio,area-52,1883,warrior,arms,36,22,14
Arivok,hyjal,1883,warrior,arms,161,81,80
Everfury,tichondrius,1883,warrior,arms,162,81,81
Baitson,hyjal,1882,warrior,arms,60,30,30
Raime,sargeras,1880,warrior,arms,48,25,23
Ochinching,tichondrius,1880,warrior,arms,84,39,45
Ggtk,tichondrius,1880,warrior,arms,72,33,39
Yamadaflash,tichondrius,1879,warrior,arms,61,35,26
Evach,kelthuzad,1879,warrior,arms,70,40,30
Paoxiaoevs,tichondrius,1879,warrior,arms,53,29,24
Samuluo,tichondrius,1879,warrior,arms,72,34,38
Franticlol,tichondrius,1876,warrior,arms,97,47,50
Destrey,emerald-dream,1874,warrior,arms,84,46,38
Matesan,jubeithos,1873,warrior,arms,60,34,26
Blackpinkx,tichondrius,1873,warrior,arms,48,23,25
Kamoo,bonechewer,1871,warrior,arms,54,30,24
Falindrah,moon-guard,1869,warrior,arms,72,33,39
Míasma,ragnaros,1868,warrior,arms,126,55,71
Sziw,tichondrius,1867,warrior,arms,276,141,135
Eqztw,tichondrius,1864,warrior,arms,149,90,59
Tyránny,stormrage,1864,warrior,arms,71,35,36
Chupelo,tichondrius,1863,warrior,arms,54,46,8
Gorek,illidan,1863,warrior,arms,48,24,24
Dawx,thrall,1862,warrior,arms,65,32,33
Natating,terenas,1860,warrior,arms,54,32,22
Venturexone,azralon,1860,warrior,arms,54,31,23
Fleegugeegu,malganis,1859,warrior,arms,108,55,53
Trezturbo,tichondrius,1858,warrior,arms,198,102,96
Wutains,tichondrius,1858,warrior,arms,71,36,35
Pezy,frostmourne,1858,warrior,arms,120,59,61
Sunamys,illidan,1857,warrior,arms,48,23,25
Bigdaddyxo,whisperwind,1857,warrior,arms,65,30,35
Wartrué,tichondrius,1857,warrior,arms,137,61,76
Grayview,sargeras,1856,warrior,arms,83,45,38
Sponsored,argent-dawn,1856,warrior,arms,71,33,38
Pooshshi,illidan,1855,warrior,arms,60,29,31
Kylewalker,tichondrius,1855,warrior,arms,77,33,44
Archosaurs,illidan,1854,warrior,arms,48,23,25
Evnine,illidan,1853,warrior,arms,39,29,10
Bakadoom,illidan,1853,warrior,arms,90,53,37
Rafheeki,tichondrius,1853,warrior,arms,90,49,41
Comehnrfce,illidan,1853,warrior,arms,140,66,74
Mynameyaff,tichondrius,1852,warrior,arms,199,115,84
Brahmo,kelthuzad,1852,warrior,arms,66,38,28
Barrbarossa,stormrage,1852,warrior,arms,217,109,108
Ruzoc,frostmourne,1851,warrior,arms,112,50,62
Demetor,skywall,1850,warrior,arms,53,27,26
Goodlikeplay,ragnaros,1849,warrior,arms,60,34,26
Wartruë,tichondrius,1848,warrior,arms,316,170,146
Kigame,tichondrius,1847,warrior,arms,119,64,55
Jikith,proudmoore,1847,warrior,arms,48,23,25
Bigbadbaka,thaurissan,1847,warrior,arms,78,36,42
Icon,tichondrius,1846,warrior,arms,46,35,11
Bigdad,whisperwind,1846,warrior,arms,60,34,26
Blozar,illidan,1846,warrior,arms,60,30,30
Randydanger,illidan,1845,warrior,arms,66,32,34
Elsamok,ragnaros,1844,warrior,arms,46,25,21
Wheyprotein,illidan,1844,warrior,arms,42,22,20
Battousai,kiljaeden,1844,warrior,arms,54,27,27
ßloodshed,frostmourne,1843,warrior,arms,67,44,23
Bladebuster,stormrage,1843,warrior,arms,66,36,30
Veilsidewar,kelthuzad,1843,warrior,arms,453,235,218
Dabaojiàn,illidan,1843,warrior,arms,45,23,22
Dishonorkill,dentarg,1842,warrior,arms,43,27,16
Støne,draktharon,1842,warrior,arms,98,56,42
Sukonamí,draka,1842,warrior,arms,60,33,27
Executeqt,azralon,1842,warrior,arms,161,87,74
Madwolf,tichondrius,1842,warrior,arms,103,51,52
Hoboeddtwo,area-52,1841,warrior,arms,48,30,18
Gryffith,bleeding-hollow,1841,warrior,arms,87,40,47
Krunnknator,azralon,1840,warrior,arms,41,26,15
Ramzeé,kelthuzad,1840,warrior,arms,130,81,49
Hildemir,tichondrius,1840,warrior,arms,142,79,63
Mixx,bleeding-hollow,1840,warrior,arms,48,26,22
Narwhål,tichondrius,1840,warrior,arms,90,44,46
Paddyj,illidan,1838,warrior,arms,116,72,44
Uzza,stormrage,1838,warrior,arms,60,34,26
Draus,nemesis,1838,warrior,arms,119,67,52
Thlam,muradin,1838,warrior,arms,186,99,87
Ânticide,darkspear,1838,warrior,arms,84,43,41
Møcat,illidan,1837,warrior,arms,96,56,40
Nïcowo,ragnaros,1837,warrior,arms,164,84,80
Xiaoyujin,proudmoore,1837,warrior,arms,192,98,94
Adaana,kargath,1836,warrior,arms,119,70,49
Mantrà,skullcrusher,1836,warrior,arms,42,24,18
Vatix,sargeras,1836,warrior,arms,50,28,22
Imuti,illidan,1836,warrior,arms,102,54,48
Tuggernaut,khadgar,1835,warrior,arms,54,28,26
Cammerz,area-52,1835,warrior,arms,198,97,101
Croc,frostmourne,1834,warrior,arms,32,21,11
Peinx,ragnaros,1834,warrior,arms,71,38,33
Yossarrion,frostwolf,1833,warrior,arms,48,25,23
Musclehead,moon-guard,1832,warrior,arms,141,83,58
Brilliance,suramar,1832,warrior,arms,60,30,30
Zindawg,frostmourne,1832,warrior,arms,337,166,171
Frëdsmite,kelthuzad,1831,warrior,arms,144,77,67
Zira,thrall,1831,warrior,arms,133,69,64
Rólex,tichondrius,1831,warrior,arms,63,30,33
Mercystaling,tichondrius,1829,warrior,arms,42,21,21
Nativê,sargeras,1829,warrior,arms,72,35,37
Damage,malganis,1829,warrior,arms,48,23,25
Razw,frostmourne,1828,warrior,arms,48,28,20
Elpappa,tichondrius,1827,warrior,arms,48,42,6
Sanquelme,ragnaros,1827,warrior,arms,63,32,31
Jonathann,suramar,1827,warrior,arms,132,65,67
Blaíze,ragnaros,1826,warrior,arms,44,24,20
Urdem,moon-guard,1826,warrior,arms,168,91,77
Rflexxo,tichondrius,1826,warrior,arms,60,32,28
Seblleddo,drakkari,1826,warrior,arms,66,34,32
Rebied,ragnaros,1826,warrior,arms,96,43,53
Ciz,emerald-dream,1825,warrior,arms,70,38,32
Warriorbloo,sargeras,1825,warrior,arms,72,39,33
Sandycrack,blackrock,1825,warrior,arms,60,30,30
Salthouse,sargeras,1824,warrior,arms,42,25,17
Threg,malganis,1824,warrior,arms,42,21,21
Këther,tichondrius,1824,warrior,arms,90,43,47
Calthi,moon-guard,1823,warrior,arms,125,75,50
Coby,wildhammer,1823,warrior,arms,65,36,29
Jokerkxs,tichondrius,1823,warrior,arms,53,29,24
Gbar,azralon,1823,warrior,arms,79,42,37
Jdubz,frostmourne,1823,warrior,arms,90,45,45
Cyster,proudmoore,1822,warrior,arms,42,24,18
Soultarius,area-52,1822,warrior,arms,69,36,33
Kurï,duskwood,1822,warrior,arms,51,24,27
Laddèrx,area-52,1821,warrior,arms,71,36,35
Anautumnday,tichondrius,1820,warrior,arms,48,24,24
Aggnilia,proudmoore,1820,warrior,arms,102,50,52
Honock,ragnaros,1820,warrior,arms,72,34,38
Abbastanza,tichondrius,1820,warrior,arms,89,42,47
Boomergodx,stormrage,1819,warrior,arms,96,56,40
Badboyjan,tichondrius,1818,warrior,arms,30,19,11
Nilah,tichondrius,1818,warrior,arms,46,26,20
Iwillcrushyo,darkspear,1818,warrior,arms,90,46,44
Nozmok,proudmoore,1818,warrior,arms,65,33,32
Zankets,area-52,1818,warrior,arms,171,82,89
Blakeb,area-52,1817,warrior,arms,60,36,24
Okita,bleeding-hollow,1817,warrior,arms,124,65,59
Smashxx,area-52,1816,warrior,arms,95,55,40
Deadhate,sargeras,1816,warrior,arms,54,28,26
Missrend,hyjal,1816,warrior,arms,114,57,57
Berzek,area-52,1816,warrior,arms,59,23,36
Picarus,thunderhorn,1815,warrior,arms,72,40,32
Warney,tichondrius,1815,warrior,arms,65,35,30
Destram,kelthuzad,1815,warrior,arms,107,57,50
Skolltonxoxo,tichondrius,1815,warrior,arms,54,28,26
Mezdrì,quelthalas,1814,warrior,arms,72,46,26
Ashtonx,sargeras,1814,warrior,arms,60,32,28
Boxxyy,tichondrius,1814,warrior,arms,36,19,17
Strongbaby,tichondrius,1814,warrior,arms,72,36,36
Zapatín,quelthalas,1814,warrior,arms,67,32,35
Mäddôx,tichondrius,1814,warrior,arms,126,60,66
Sezariùs,darkspear,1813,warrior,arms,61,42,19
Elimination,tichondrius,1813,warrior,arms,41,27,14
Doominus,tichondrius,1813,warrior,arms,48,23,25
Vicioustalol,proudmoore,1812,warrior,arms,57,34,23
Onebraincell,stormrage,1811,warrior,arms,48,34,14
Gohrgroc,quelthalas,1811,warrior,arms,48,30,18
Glocç,sargeras,1811,warrior,arms,112,59,53
Knuklez,tichondrius,1811,warrior,arms,64,33,31
Dangerousd,kiljaeden,1811,warrior,arms,60,30,30
Vergerak,tichondrius,1811,warrior,arms,58,29,29
Dabdaddyy,dawnbringer,1811,warrior,arms,135,66,69
Kaimedran,moon-guard,1810,warrior,arms,48,30,18
Kriloth,frostmourne,1810,warrior,arms,50,30,20
Ppdub,zuljin,1810,warrior,arms,44,26,18
Bussupshut,kelthuzad,1810,warrior,arms,64,32,32
Ürürææae,sargeras,1810,warrior,arms,189,94,95
Darkduet,tichondrius,1810,warrior,arms,70,33,37
Mecc,tichondrius,1809,warrior,arms,107,53,54
Kazynn,tichondrius,1808,warrior,arms,45,30,15
Aavyrre,moon-guard,1808,warrior,arms,60,34,26
Crowsfall,aggramar,1808,warrior,arms,274,144,130
Smokes,sargeras,1808,warrior,arms,144,73,71
Spartus,kelthuzad,1808,warrior,arms,78,32,46
Zarrdune,darkspear,1807,warrior,arms,45,32,13
Crøm,tichondrius,1807,warrior,arms,48,29,19
Robodad,illidan,1807,warrior,arms,63,36,27
Bbyè,tichondrius,1806,warrior,arms,318,168,150
Helrise,sargeras,1806,warrior,arms,54,27,27
Grômm,tichondrius,1806,warrior,arms,89,42,47
Bradockqt,azralon,1806,warrior,arms,54,25,29
Kâdé,malganis,1805,warrior,arms,42,26,16
Sickwidit,kiljaeden,1805,warrior,arms,49,28,21
Rookìe,illidan,1805,warrior,arms,131,73,58
Chaytin,bleeding-hollow,1805,warrior,arms,74,41,33
Dackøzzt,quelthalas,1805,warrior,arms,36,19,17
Noblewinter,sargeras,1805,warrior,arms,36,19,17
Tenskj,proudmoore,1805,warrior,arms,57,30,27
Wootzu,zuljin,1805,warrior,arms,54,27,27
Mildlol,tichondrius,1804,warrior,arms,42,25,17
Americanbull,moon-guard,1804,warrior,arms,78,38,40
Bahlahkay,proudmoore,1804,warrior,arms,60,28,32
Asstastic,bonechewer,1803,warrior,arms,160,77,83
Masumura,kaelthas,1803,warrior,arms,86,40,46
Storminshock,malganis,1802,warrior,arms,81,46,35
Ollena,wyrmrest-accord,1802,warrior,arms,90,46,44
Illing,tichondrius,1801,warrior,arms,336,178,158
Hìm,tichondrius,1801,warrior,arms,54,28,26
Yagura,emerald-dream,1801,warrior,arms,76,37,39
Longzhan,tichondrius,1800,warrior,arms,138,65,73
Lebanesemvp,tichondrius,1799,warrior,arms,141,72,69
Kustybuckets,korgath,1798,warrior,arms,46,27,19
Ksharer,tichondrius,1794,warrior,arms,89,41,48
Tokugawaieya,nemesis,1793,warrior,arms,119,56,63
Meccsecute,tichondrius,1792,warrior,arms,114,59,55
Kruma,stormscale,1791,warrior,arms,37,22,15
Beanbags,zangarmarsh,1790,warrior,arms,72,36,36
Ælilblessedñ,azralon,1789,warrior,arms,184,90,94
Debbie,bleeding-hollow,1789,warrior,arms,90,44,46
Melifehorde,tichondrius,1787,warrior,arms,48,25,23
Bigglyjoobs,tichondrius,1787,warrior,arms,78,38,40
Yonkerss,garrosh,1785,warrior,arms,101,55,46
Ígnatius,malganis,1781,warrior,arms,48,31,17
Nänchobo,tichondrius,1781,warrior,arms,62,28,34
Samwolok,tichondrius,1780,warrior,arms,36,19,17
Pipedoctor,kelthuzad,1780,warrior,arms,54,28,26
Slaten,barthilas,1780,warrior,arms,149,77,72
Dawxw,thrall,1779,warrior,arms,47,25,22
Bloodbath,kiljaeden,1779,warrior,arms,53,28,25
Crushedlol,bleeding-hollow,1779,warrior,arms,48,25,23
Daddyßigßeef,malganis,1778,warrior,arms,67,40,27
Cgelangdula,tichondrius,1778,warrior,arms,60,30,30
Nanchobo,tichondrius,1778,warrior,arms,66,28,38
Hbrandy,tichondrius,1773,warrior,arms,83,42,41
Undefied,moon-guard,1772,warrior,arms,51,29,22
Sharer,tichondrius,1772,warrior,arms,36,19,17
Franziskaner,frostmourne,1772,warrior,arms,162,81,81
Danceylol,barthilas,1768,warrior,arms,108,53,55
Warginger,malygos,1767,warrior,arms,65,36,29
Dalan,korgath,1766,warrior,arms,48,30,18
Tùngrâu,frostmourne,1766,warrior,arms,202,104,98
Hanzmat,illidan,1766,warrior,arms,119,56,63
Wulouzhan,tichondrius,1765,warrior,arms,179,96,83
Stáclin,ragnaros,1765,warrior,arms,595,317,278
Zanjaro,thrall,1765,warrior,arms,59,29,30
Chimbrila,azralon,1765,warrior,arms,126,59,67
Jimjinjin,tichondrius,1763,warrior,arms,78,41,37
Tehfury,area-52,1763,warrior,arms,57,26,31
Kaÿip,tichondrius,1762,warrior,arms,163,84,79
Pkkcrisis,archimonde,1762,warrior,arms,96,43,53
Rexqq,zuljin,1761,warrior,arms,36,20,16
Nuvola,tichondrius,1761,warrior,arms,72,38,34
Endstorm,proudmoore,1761,warrior,arms,74,37,37
Cokeroom,tichondrius,1760,warrior,arms,103,60,43
Dokgö,tichondrius,1759,warrior,arms,100,53,47
Exorbit,sargeras,1758,warrior,arms,81,47,34
Nuccî,azralon,1758,warrior,arms,98,49,49
Scoopdog,stormrage,1757,warrior,arms,48,24,24
Marchdream,tichondrius,1756,warrior,arms,60,32,28
Bainian,tichondrius,1754,warrior,arms,142,81,61
Zhangye,tichondrius,1754,warrior,arms,60,28,32
Jadeemerald,kelthuzad,1753,warrior,arms,118,58,60
Xîonorc,ragnaros,1750,warrior,arms,261,133,128
Spìke,thrall,1750,warrior,arms,203,98,105
Tutifrutiø,azralon,1750,warrior,arms,108,49,59
Rageroidz,sargeras,1749,warrior,arms,36,19,17
Warfuse,illidan,1749,warrior,arms,126,63,63
Nànchobo,tichondrius,1749,warrior,arms,72,31,41
Bigdude,frostwolf,1748,warrior,arms,66,38,28
Kames,garrosh,1748,warrior,arms,196,96,100
Noodlezz,moon-guard,1748,warrior,arms,147,71,76
Yueren,tichondrius,1748,warrior,arms,102,42,60
Polydopam,tichondrius,1747,warrior,arms,130,66,64
Marvachi,moon-guard,1745,warrior,arms,278,143,135
Soníco,area-52,1745,warrior,arms,62,25,37
Sharpen,tichondrius,1744,warrior,arms,48,22,26
Kurodia,quelthalas,1744,warrior,arms,84,35,49
Karín,tichondrius,1743,warrior,arms,90,53,37
Ogrelurd,malygos,1743,warrior,arms,42,22,20
Brendanshwab,bleeding-hollow,1743,warrior,arms,89,44,45
Utxpia,azralon,1743,warrior,arms,59,26,33
Krokü,area-52,1742,warrior,arms,54,30,24
Rynrak,tichondrius,1742,warrior,arms,102,52,50
Purplepiper,ragnaros,1740,warrior,arms,55,30,25
Krbigcow,tichondrius,1740,warrior,arms,144,73,71
Dogmar,staghelm,1739,warrior,arms,110,54,56
Garrmash,hyjal,1737,warrior,arms,265,138,127
Xwoyer,malganis,1736,warrior,arms,136,72,64
Partyx,tichondrius,1736,warrior,arms,300,154,146
Irascible,stormrage,1736,warrior,arms,60,26,34
Unhòólyshy,ragnaros,1733,warrior,arms,90,50,40
Nightheller,stormrage,1733,warrior,arms,78,33,45
Andorane,bleeding-hollow,1732,warrior,arms,50,27,23
Odiseo,ragnaros,1731,warrior,arms,109,58,51
Mantistabogn,zuluhed,1726,warrior,arms,82,43,39
Roughknuckle,kelthuzad,1726,warrior,arms,41,19,22
Swifty,anvilmar,1725,warrior,arms,30,18,12
Jubeithos,draktharon,1725,warrior,arms,95,50,45
Crysis,malorne,1725,warrior,arms,54,25,29
Magnuszx,zuljin,1724,warrior,arms,30,18,12
Facefïster,malganis,1723,warrior,arms,89,43,46
Relerocker,area-52,1722,warrior,arms,101,53,48
Swìll,illidan,1722,warrior,arms,36,18,18
Warbeshar,area-52,1722,warrior,arms,66,32,34
Nyloras,illidan,1722,warrior,arms,75,32,43
Itsfall,tichondrius,1721,warrior,arms,42,21,21
Crownzz,tichondrius,1721,warrior,arms,36,18,18
Vadio,area-52,1721,warrior,arms,76,35,41
Ciskokido,illidan,1720,warrior,arms,130,69,61
Gannïcûs,drakkari,1720,warrior,arms,107,52,55
Swordborne,moon-guard,1720,warrior,arms,100,46,54
Cåfe,tichondrius,1719,warrior,arms,149,81,68
Zacharyx,tichondrius,1718,warrior,arms,302,144,158
Soloqandy,moon-guard,1718,warrior,arms,78,33,45
Rocta,tichondrius,1717,warrior,arms,98,54,44
Afrikunt,tichondrius,1717,warrior,arms,72,38,34
Heylol,blackhand,1717,warrior,arms,64,28,36
Killimanjaro,aggramar,1716,warrior,arms,106,49,57
Arixos,frostmourne,1715,warrior,arms,54,31,23
Maddawgg,mugthol,1715,warrior,arms,70,36,34
Lvlthreemage,fizzcrank,1715,warrior,arms,180,87,93
Meowdaa,proudmoore,1715,warrior,arms,78,26,52
Milough,nesingwary,1714,warrior,arms,124,71,53
Basedaf,frostmourne,1713,warrior,arms,84,45,39
Potero,ragnaros,1709,warrior,arms,71,37,34
Hateuu,tichondrius,1709,warrior,arms,60,26,34
Joebo,thrall,1708,warrior,arms,36,26,10
Anukhar,emerald-dream,1708,warrior,arms,95,55,40
Smashies,kelthuzad,1708,warrior,arms,53,27,26
Tatërs,zuljin,1708,warrior,arms,72,36,36
Gromkhor,tichondrius,1708,warrior,arms,72,30,42
Doublezuglol,tichondrius,1707,warrior,arms,282,142,140
Tankomode,area-52,1707,warrior,arms,36,18,18
Musclecrowe,illidan,1707,warrior,arms,48,22,26
Infernae,emerald-dream,1706,warrior,arms,96,56,40
Ðíablø,tichondrius,1705,warrior,arms,146,78,68
Furyslam,tichondrius,1705,warrior,arms,77,30,47
Sherrywalken,azralon,1704,warrior,arms,139,73,66
Niubzs,tichondrius,1704,warrior,arms,53,27,26
Jdubzr,frostmourne,1704,warrior,arms,66,33,33
Zugprime,dragonmaw,1703,warrior,arms,48,26,22
Hiness,tichondrius,1702,warrior,arms,54,23,31
Misakizs,illidan,1701,warrior,arms,61,26,35
Thrator,wyrmrest-accord,1699,warrior,arms,42,23,19
Golem,frostmourne,1699,warrior,arms,99,51,48
Battlestance,shadowsong,1699,warrior,arms,95,42,53
Shrikewing,moon-guard,1698,warrior,arms,124,75,49
Unkultom,stormrage,1697,warrior,arms,105,62,43
Ramparts,moon-guard,1697,warrior,arms,48,23,25
Ammeh,draka,1696,warrior,arms,48,28,20
Zenrrei,ragnaros,1696,warrior,arms,187,101,86
Lanlorash,barthilas,1696,warrior,arms,36,18,18
Warkingx,tichondrius,1696,warrior,arms,36,18,18
Akrono,sargeras,1696,warrior,arms,54,19,35
Baultenaz,draenor,1695,warrior,arms,35,23,12
Pacow,illidan,1695,warrior,arms,36,22,14
Genghiz,azralon,1694,warrior,arms,66,36,30
Tastý,moon-guard,1694,warrior,arms,54,22,32
Lexxsteele,mugthol,1693,warrior,arms,48,29,19
Delphont,stormrage,1693,warrior,arms,107,59,48
Wolfcultist,moon-guard,1693,warrior,arms,78,35,43
Zaÿne,moon-guard,1692,warrior,arms,87,41,46
Xtrachrome,stormrage,1691,warrior,arms,42,24,18
Blaiize,ragnaros,1691,warrior,arms,60,25,35
Littlevarian,ragnaros,1690,warrior,arms,54,30,24
Bozzy,illidan,1690,warrior,arms,77,34,43
Rogôsh,tichondrius,1689,warrior,arms,60,24,36
Kilgorath,area-52,1688,warrior,arms,90,42,48
Raph,barthilas,1686,warrior,arms,42,25,17
Sindevelor,tichondrius,1684,warrior,arms,89,50,39
Tyrannus,chogall,1683,warrior,arms,113,58,55
Kolosal,tichondrius,1683,warrior,arms,51,24,27
Omnismash,stormrage,1683,warrior,arms,44,20,24
Zalakan,malganis,1682,warrior,arms,54,34,20
Shinigamix,steamwheedle-cartel,1682,warrior,arms,48,29,19
Bmo,chogall,1682,warrior,arms,135,68,67
Janjannodie,tichondrius,1682,warrior,arms,41,20,21
Cathillex,eonar,1680,warrior,arms,78,47,31
Groundpound,sargeras,1680,warrior,arms,164,85,79
Purrava,tichondrius,1680,warrior,arms,50,25,25
Stonesoup,kelthuzad,1680,warrior,arms,83,33,50
Gravewurm,twisting-nether,1679,warrior,arms,42,24,18
Ådderall,thrall,1679,warrior,arms,102,54,48
Bøek,area-52,1679,warrior,arms,104,49,55
Kroni,ragnaros,1678,warrior,arms,42,21,21
Warsongwolf,tichondrius,1678,warrior,arms,80,35,45
Swagramarr,area-52,1677,warrior,arms,93,51,42
Johnburns,tichondrius,1677,warrior,arms,53,27,26
Fartazz,zuljin,1677,warrior,arms,156,77,79
Huacai,tichondrius,1676,warrior,arms,54,26,28
Alëwar,quelthalas,1676,warrior,arms,83,38,45
Zastrow,dalaran,1676,warrior,arms,96,39,57
Coisini,tichondrius,1675,warrior,arms,130,75,55
Ichirisw,tichondrius,1675,warrior,arms,59,32,27
Heater,stormrage,1675,warrior,arms,95,46,49
Hofukumizuki,tichondrius,1675,warrior,arms,60,25,35
Shneakywar,frostmourne,1674,warrior,arms,96,54,42
Mitigated,bleeding-hollow,1673,warrior,arms,48,26,22
Necroticism,bleeding-hollow,1673,warrior,arms,42,20,22
Gomachi,moon-guard,1673,warrior,arms,88,39,49
Lunartime,sargeras,1672,warrior,arms,126,65,61
Kirown,quelthalas,1672,warrior,arms,139,67,72
Staystrong,tichondrius,1671,warrior,arms,54,37,17
Kromgrall,tichondrius,1671,warrior,arms,167,79,88
Pusspeepers,kelthuzad,1671,warrior,arms,39,18,21
Andeadw,tichondrius,1670,warrior,arms,33,21,12
Winota,frostmourne,1669,warrior,arms,30,22,8
Dodgestrikes,khaz-modan,1669,warrior,arms,48,28,20
Sinsinatra,azralon,1669,warrior,arms,275,143,132
Zenchi,nerzhul,1669,warrior,arms,76,36,40
Brøly,sargeras,1669,warrior,arms,84,38,46
Amlahj,stormrage,1668,warrior,arms,53,30,23
Armamortal,kelthuzad,1668,warrior,arms,422,219,203
Metal,ragnaros,1667,warrior,arms,37,22,15
Sparts,area-52,1667,warrior,arms,53,30,23
Woth,deathwing,1667,warrior,arms,41,21,20
Gangdamn,frostmourne,1667,warrior,arms,83,31,52
Patwong,frostmourne,1666,warrior,arms,113,62,51
Kamoo,gurubashi,1665,warrior,arms,60,46,14
Bilboswagins,agamaggan,1665,warrior,arms,47,25,22
Hickorie,sargeras,1665,warrior,arms,117,60,57
Marcellùs,proudmoore,1664,warrior,arms,52,29,23
Bigbadaxe,sargeras,1664,warrior,arms,42,21,21
Trapbois,tichondrius,1663,warrior,arms,48,29,19
Legoyoda,zuljin,1663,warrior,arms,54,29,25
Edgárllama,sargeras,1663,warrior,arms,38,20,18
Colössal,moon-guard,1663,warrior,arms,94,48,46
Mightyduck,area-52,1663,warrior,arms,64,29,35
Ystkk,tichondrius,1662,warrior,arms,42,25,17
Ironboar,proudmoore,1662,warrior,arms,72,32,40
Iwillcrushu,tichondrius,1661,warrior,arms,113,59,54
Killbórn,azralon,1660,warrior,arms,30,19,11
Bddg,tichondrius,1660,warrior,arms,88,45,43
Anticiðe,zuljin,1659,warrior,arms,42,22,20
Fumzxy,frostmourne,1659,warrior,arms,122,62,60
Hoodrch,azralon,1659,warrior,arms,131,64,67
Babyogre,thunderlord,1657,warrior,arms,77,42,35
Wurua,tichondrius,1657,warrior,arms,58,30,28
Sheyshey,quelthalas,1656,warrior,arms,42,25,17
Xunxie,tichondrius,1656,warrior,arms,142,76,66
Bûm,sargeras,1656,warrior,arms,146,73,73
Murderbell,tichondrius,1656,warrior,arms,114,55,59
Orçaos,ragnaros,1655,warrior,arms,168,88,80
Cushman,tichondrius,1655,warrior,arms,174,90,84
Møønnlight,quelthalas,1655,warrior,arms,111,53,58
Twoone,illidan,1655,warrior,arms,61,29,32
Paletona,emerald-dream,1655,warrior,arms,41,19,22
Sineatér,frostmourne,1654,warrior,arms,61,30,31
Flexìn,tichondrius,1654,warrior,arms,48,23,25
Maktarax,zuljin,1654,warrior,arms,40,18,22
Baciless,illidan,1654,warrior,arms,78,35,43
Thuykieu,barthilas,1653,warrior,arms,36,18,18
Aumni,illidan,1653,warrior,arms,116,57,59
Jehocc,tichondrius,1653,warrior,arms,44,21,23
Tÿ,haomarush,1652,warrior,arms,83,47,36
Wartrue,tichondrius,1651,warrior,arms,174,82,92
Spartiguss,emerald-dream,1650,warrior,arms,59,32,27
Creøn,silvermoon,1650,warrior,arms,68,35,33
Arx,frostwolf,1650,warrior,arms,261,134,127
Hèphæstús,sargeras,1650,warrior,arms,162,82,80
Tepaste,ragnaros,1650,warrior,arms,101,50,51
Tiredkev,tichondrius,1649,warrior,arms,107,53,54
Raahjz,sargeras,1649,warrior,arms,102,48,54
Executing,emerald-dream,1649,warrior,arms,54,25,29
Chillimus,tichondrius,1648,warrior,arms,81,44,37
Phabian,frostmourne,1648,warrior,arms,41,22,19
Tatsuujin,sargeras,1648,warrior,arms,152,77,75
Slamedi,frostmourne,1647,warrior,arms,138,68,70
Omnïslash,tichondrius,1647,warrior,arms,54,25,29
Broxigore,nerzhul,1647,warrior,arms,84,32,52
Droguernaut,tichondrius,1646,warrior,arms,59,30,29
Kralo,moon-guard,1646,warrior,arms,69,34,35
Fidel,blackrock,1645,warrior,arms,59,19,40
Lokityr,tichondrius,1644,warrior,arms,132,84,48
Gtr,illidan,1644,warrior,arms,80,48,32
Sayîon,zuljin,1644,warrior,arms,138,67,71
Hariban,sargeras,1644,warrior,arms,113,53,60
Kekbyemmr,illidan,1644,warrior,arms,48,22,26
Príde,kiljaeden,1643,warrior,arms,66,34,32
Theokos,dalaran,1643,warrior,arms,130,66,64
Darkirondork,bleeding-hollow,1643,warrior,arms,78,35,43
Ariést,bleeding-hollow,1643,warrior,arms,90,37,53
Onecho,tichondrius,1642,warrior,arms,59,29,30
Rhynehardt,scilla,1642,warrior,arms,108,51,57
Alator,gorgonnash,1641,warrior,arms,66,38,28
Trágus,azralon,1641,warrior,arms,107,61,46
Stattic,illidan,1641,warrior,arms,54,25,29
Nipnipz,kelthuzad,1641,warrior,arms,121,56,65
Galehna,ragnaros,1641,warrior,arms,53,24,29
Ashbringera,proudmoore,1640,warrior,arms,267,140,127
Dramalas,lightbringer,1640,warrior,arms,311,156,155
Wqnmlgbd,tichondrius,1640,warrior,arms,54,27,27
Tigris,nesingwary,1640,warrior,arms,42,21,21
Aventajadu,ragnaros,1640,warrior,arms,48,22,26
Sonjeba,malganis,1640,warrior,arms,70,32,38
Rarefxck,tichondrius,1640,warrior,arms,90,39,51
Tarók,tichondrius,1639,warrior,arms,50,32,18
Austerö,nemesis,1639,warrior,arms,33,20,13
Fulaixiong,illidan,1639,warrior,arms,87,52,35
Mindgoblin,smolderthorn,1639,warrior,arms,106,54,52
Wilric,ragnaros,1638,warrior,arms,60,27,33
Oxandrolona,ragnaros,1638,warrior,arms,86,34,52
Izugyou,thrall,1637,warrior,arms,87,45,42
Wargasmx,tichondrius,1637,warrior,arms,70,31,39
Koniq,azralon,1636,warrior,arms,35,20,15
Wolfsbanne,khadgar,1636,warrior,arms,168,89,79
Ngu,eldrethalas,1636,warrior,arms,53,26,27
Donivan,illidan,1636,warrior,arms,60,29,31
Slaught,kelthuzad,1636,warrior,arms,169,80,89
Sambojüjü,stormrage,1635,warrior,arms,30,18,12
Shaõkahn,nemesis,1635,warrior,arms,52,26,26
Brianucky,thrall,1635,warrior,arms,71,33,38
Mavrus,malganis,1634,warrior,arms,36,19,17
Grimjouw,sargeras,1633,warrior,arms,42,23,19
Twilightrain,tichondrius,1633,warrior,arms,424,221,203
Iigotu,tichondrius,1632,warrior,arms,262,136,126
Ragster,kelthuzad,1632,warrior,arms,99,51,48
Bigbrick,stormrage,1632,warrior,arms,96,45,51
Lexíbelle,korgath,1631,warrior,arms,36,21,15
Túrin,quelthalas,1631,warrior,arms,132,71,61
Raveve,area-52,1631,warrior,arms,71,36,35
Ragemane,illidan,1631,warrior,arms,51,24,27
Spinspin,borean-tundra,1630,warrior,arms,70,37,33
Shazbøt,tichondrius,1630,warrior,arms,45,19,26
Icrìtmypants,dragonmaw,1629,warrior,arms,48,27,21
Crusherr,earthen-ring,1629,warrior,arms,102,54,48
Furykets,proudmoore,1629,warrior,arms,38,19,19
Okanos,tichondrius,1629,warrior,arms,48,21,27
Rhorix,korialstrasz,1629,warrior,arms,48,19,29
Khørnë,ragnaros,1628,warrior,arms,78,41,37
Bigdumborc,tichondrius,1628,warrior,arms,42,22,20
Alteryx,sargeras,1628,warrior,arms,75,36,39
Hõdõnsin,tichondrius,1628,warrior,arms,57,26,31
Vices,sargeras,1627,warrior,arms,24,17,7
Ikaikasan,illidan,1627,warrior,arms,32,22,10
Wârtorn,darkspear,1627,warrior,arms,42,22,20
Çrusha,thrall,1627,warrior,arms,48,20,28
Coollelex,proudmoore,1626,warrior,arms,56,29,27
Wewladdie,malganis,1626,warrior,arms,36,18,18
Kazecap,proudmoore,1626,warrior,arms,66,29,37
Orgnosh,tichondrius,1625,warrior,arms,96,52,44
Gutting,moon-guard,1625,warrior,arms,36,18,18
Unitsven,barthilas,1625,warrior,arms,54,26,28
Duxor,sargeras,1625,warrior,arms,54,24,30
Brutallicus,kelthuzad,1625,warrior,arms,50,21,29
Elyll,tichondrius,1624,warrior,arms,47,28,19
Soupwar,moon-guard,1624,warrior,arms,177,90,87
Deathsteelw,zuljin,1624,warrior,arms,48,24,24
Faelash,stormrage,1624,warrior,arms,67,32,35
Mirado,tichondrius,1624,warrior,arms,94,44,50
Coltronitis,kelthuzad,1624,warrior,arms,54,23,31
Ryängosling,azralon,1623,warrior,arms,168,92,76
Downblow,tichondrius,1623,warrior,arms,36,19,17
Flexid,tichondrius,1623,warrior,arms,78,40,38
Littlemieoo,sargeras,1623,warrior,arms,36,17,19
Lindsanv,illidan,1622,warrior,arms,110,59,51
Swólepetrol,tichondrius,1622,warrior,arms,36,19,17
Larrylurker,proudmoore,1622,warrior,arms,119,62,57
Orahard,illidan,1622,warrior,arms,200,100,100
Brainhaze,tichondrius,1622,warrior,arms,64,29,35
Scotteh,eredar,1622,warrior,arms,54,21,33
Chadwarr,tichondrius,1621,warrior,arms,31,17,14
Stooklol,tichondrius,1621,warrior,arms,54,22,32
Nerdstompêr,illidan,1620,warrior,arms,90,43,47
Thezboy,tichondrius,1619,warrior,arms,100,56,44
Amberlym,ragnaros,1619,warrior,arms,58,28,30
Feiler,ragnaros,1619,warrior,arms,48,21,27
Lacorte,ragnaros,1618,warrior,arms,51,23,28
Szeo,tichondrius,1617,warrior,arms,24,17,7
Achilex,sargeras,1617,warrior,arms,127,66,61
Thebigmala,azralon,1616,warrior,arms,55,32,23
Slamuëladams,bleeding-hollow,1616,warrior,arms,48,20,28
Malathire,illidan,1615,warrior,arms,70,41,29
Delakos,frostmourne,1615,warrior,arms,95,51,44
Ghostmourne,ragnaros,1615,warrior,arms,316,164,152
Lehzera,frostmourne,1615,warrior,arms,120,62,58
Zekkenx,azjolnerub,1615,warrior,arms,54,23,31
Axellent,gilneas,1614,warrior,arms,70,44,26
Rittylord,frostmourne,1614,warrior,arms,68,37,31
Metalchileno,ragnaros,1614,warrior,arms,48,20,28
Willcharge,tichondrius,1614,warrior,arms,49,17,32
Myndon,area-52,1613,warrior,arms,37,27,10
Gáren,quelthalas,1613,warrior,arms,42,22,20
Arkkaine,sargeras,1613,warrior,arms,117,58,59
Automator,proudmoore,1613,warrior,arms,78,35,43
Wingaling,malganis,1613,warrior,arms,66,29,37
Ÿüñí,tichondrius,1613,warrior,arms,66,27,39
Parren,bleeding-hollow,1612,warrior,arms,43,22,21
Fluffyarm,sargeras,1612,warrior,arms,198,98,100
Thètrùth,duskwood,1612,warrior,arms,54,23,31
Sgtquad,illidan,1611,warrior,arms,39,19,20
Dankdad,garrosh,1611,warrior,arms,36,17,19
Hugeflopper,malganis,1610,warrior,arms,32,19,13
Matrias,tichondrius,1610,warrior,arms,177,96,81
Gwlade,sargeras,1610,warrior,arms,210,113,97
Thulsan,emerald-dream,1610,warrior,arms,48,25,23
Malerick,illidan,1610,warrior,arms,69,31,38
Enzoh,zuljin,1610,warrior,arms,86,30,56
Nitechaos,thrall,1609,warrior,arms,37,23,14
Thebigsmash,tichondrius,1609,warrior,arms,42,23,19
Aloregorey,malganis,1609,warrior,arms,138,69,69
Morfoggore,ragnaros,1609,warrior,arms,98,49,49
Painsoul,illidan,1609,warrior,arms,65,32,33
Lionbuster,ragnaros,1608,warrior,arms,48,31,17
Theseuse,tichondrius,1608,warrior,arms,40,24,16
Tommygunns,area-52,1608,warrior,arms,30,17,13
Methwitch,moon-guard,1608,warrior,arms,42,22,20
Rongor,drakkari,1608,warrior,arms,66,33,33
Tommytimbo,destromath,1608,warrior,arms,49,23,26
Liltop,moon-guard,1607,warrior,arms,75,41,34
Furydudz,tichondrius,1607,warrior,arms,42,21,21
Dicedup,stormrage,1607,warrior,arms,48,20,28
Madeus,quelthalas,1607,warrior,arms,60,23,37
Ottø,area-52,1606,warrior,arms,72,40,32
Hanadaddy,frostmourne,1606,warrior,arms,318,161,157
Azeryan,azralon,1606,warrior,arms,119,56,63
Auzery,emerald-dream,1606,warrior,arms,66,31,35
Soez,tichondrius,1605,warrior,arms,39,27,12
Palauu,tichondrius,1605,warrior,arms,30,18,12
Maraudertko,area-52,1605,warrior,arms,30,17,13
Myxz,barthilas,1605,warrior,arms,120,59,61
Ethuil,azshara,1605,warrior,arms,65,29,36
Boiled,sargeras,1604,warrior,arms,30,21,9
Morboo,illidan,1604,warrior,arms,48,27,21
Blodreìna,hyjal,1604,warrior,arms,109,53,56
Lôwkeyfix,illidan,1604,warrior,arms,126,58,68
Sayyaf,moon-guard,1604,warrior,arms,57,20,37
Killaen,thrall,1603,warrior,arms,48,29,19
Bleedx,bleeding-hollow,1603,warrior,arms,51,30,21
Däwggy,tichondrius,1603,warrior,arms,54,30,24
Saleem,tichondrius,1603,warrior,arms,273,142,131
Zaràki,area-52,1603,warrior,arms,186,95,91
Powerbucks,tichondrius,1603,warrior,arms,44,22,22
Mahoogler,hakkar,1603,warrior,arms,66,31,35
Xradull,dawnbringer,1602,warrior,arms,146,85,61
Athalen,nemesis,1602,warrior,arms,88,39,49
Vodkalol,bleeding-hollow,1601,warrior,arms,42,27,15
Reave,wyrmrest-accord,1601,warrior,arms,78,42,36
Wowtightight,barthilas,1601,warrior,arms,54,29,25
Icarrus,frostmourne,1601,warrior,arms,83,42,41
Pigzig,nagrand,1601,warrior,arms,42,21,21
Yarock,malganis,1601,warrior,arms,96,45,51
Valdius,bleeding-hollow,1601,warrior,arms,48,22,26
Sheriff,eldrethalas,1600,warrior,arms,54,31,23
Dulapamore,tichondrius,1600,warrior,arms,48,22,26
Xwarz,drakkari,1600,warrior,arms,72,29,43
Draenøk,tichondrius,1600,warrior,arms,54,21,33
Draugus,azralon,1599,warrior,arms,58,31,27
Easylel,stormrage,1599,warrior,arms,36,19,17
Koberos,queldorei,1599,warrior,arms,66,26,40
Memorylane,proudmoore,1598,warrior,arms,42,20,22
Tríxman,moon-guard,1597,warrior,arms,124,73,51
Bromro,tichondrius,1597,warrior,arms,172,82,90
Shain,thrall,1596,warrior,arms,48,22,26
Kolossus,korgath,1596,warrior,arms,64,25,39
Vauquelin,tichondrius,1594,warrior,arms,78,41,37
Qingmei,illidan,1594,warrior,arms,110,48,62
Wingedknight,malganis,1593,warrior,arms,133,66,67
Benjiprice,sargeras,1591,warrior,arms,52,27,25
Vanexx,tichondrius,1590,warrior,arms,43,24,19
Mistrpower,bleeding-hollow,1589,warrior,arms,78,44,34
Mcluffin,proudmoore,1588,warrior,arms,63,37,26
Mimiovo,tichondrius,1588,warrior,arms,48,26,22
Bobu,area-52,1588,warrior,arms,63,33,30
Impactw,aerie-peak,1588,warrior,arms,88,45,43
Lootacris,illidan,1588,warrior,arms,67,34,33
Dre,anubarak,1587,warrior,arms,65,32,33
Husyuzhi,tichondrius,1587,warrior,arms,60,29,31
Noelglz,quelthalas,1587,warrior,arms,59,26,33
Homebody,uldaman,1585,warrior,arms,38,25,13
Hyperdevil,ragnaros,1585,warrior,arms,35,19,16
Línfert,stormrage,1585,warrior,arms,223,115,108
Brokthard,ragnaros,1585,warrior,arms,36,18,18
Sheetss,tichondrius,1585,warrior,arms,54,26,28
Lostsummer,frostmourne,1585,warrior,arms,76,36,40
Dukà,hyjal,1584,warrior,arms,54,30,24
Destructör,nagrand,1584,warrior,arms,93,49,44
Retrospex,black-dragonflight,1584,warrior,arms,42,20,22
Warriorbod,area-52,1583,warrior,arms,53,33,20
Lyliumn,frostmourne,1583,warrior,arms,66,34,32
Sakutarou,lightbringer,1583,warrior,arms,295,143,152
Hugewarrior,area-52,1583,warrior,arms,43,20,23
Kàli,kiljaeden,1583,warrior,arms,60,26,34
Yueqingshu,tichondrius,1582,warrior,arms,38,24,14
Ginthril,magtheridon,1582,warrior,arms,154,75,79
Thombelina,malganis,1582,warrior,arms,59,25,34
Gosariw,tichondrius,1581,warrior,arms,69,31,38
Wydstepwar,malganis,1580,warrior,arms,60,38,22
Mortawar,tichondrius,1580,warrior,arms,104,60,44
Aranacn,tichondrius,1580,warrior,arms,72,40,32
Grimus,bleeding-hollow,1580,warrior,arms,197,109,88
Ohanaglad,illidan,1580,warrior,arms,189,99,90
Wóko,tichondrius,1580,warrior,arms,59,26,33
Uneasyw,tichondrius,1580,warrior,arms,47,20,27
Allyer,darkspear,1579,warrior,arms,90,45,45
Erradic,sargeras,1579,warrior,arms,54,26,28
Malice,frostmourne,1579,warrior,arms,80,29,51
Dukagã,tichondrius,1578,warrior,arms,30,18,12
Stick,tichondrius,1578,warrior,arms,125,64,61
Drjuicce,tichondrius,1577,warrior,arms,24,17,7
Arctures,stormrage,1577,warrior,arms,96,58,38
Bestseason,kelthuzad,1577,warrior,arms,87,48,39
Orsex,ragnaros,1577,warrior,arms,56,29,27
Ragetodef,illidan,1577,warrior,arms,97,48,49
Riled,barthilas,1577,warrior,arms,48,20,28
Därkzh,stormrage,1576,warrior,arms,30,20,10
Dáinsleif,frostmourne,1576,warrior,arms,54,28,26
Oxia,quelthalas,1576,warrior,arms,94,42,52
Pangus,uldum,1576,warrior,arms,48,20,28
Garrygarry,zuljin,1575,warrior,arms,38,25,13
Juuz,frostmourne,1575,warrior,arms,114,56,58
Ferozan,azralon,1575,warrior,arms,42,20,22
Durres,tichondrius,1575,warrior,arms,42,19,23
Illaedan,quelthalas,1575,warrior,arms,48,19,29
Blowhoof,azralon,1573,warrior,arms,72,41,31
Darthbleezy,malygos,1573,warrior,arms,42,22,20
Radox,tichondrius,1573,warrior,arms,78,40,38
Hydrolisk,area-52,1573,warrior,arms,144,71,73
Sinbãd,whisperwind,1573,warrior,arms,65,29,36
Yabahdabah,stormrage,1572,warrior,arms,93,49,44
Tzumugi,ragnaros,1572,warrior,arms,455,229,226
Brayitann,illidan,1571,warrior,arms,61,35,26
Ashantia,stormrage,1571,warrior,arms,90,48,42
Nyle,zuljin,1571,warrior,arms,112,59,53
Thistleberry,aegwynn,1571,warrior,arms,41,19,22
Onefourfifty,tichondrius,1570,warrior,arms,30,17,13
Byung,terenas,1570,warrior,arms,227,115,112
Traumaj,bleeding-hollow,1569,warrior,arms,158,84,74
Juicylumpia,moon-guard,1568,warrior,arms,48,31,17
Fixafflock,bleeding-hollow,1568,warrior,arms,60,33,27
Ángron,ragnaros,1568,warrior,arms,134,73,61
Chadblade,tichondrius,1568,warrior,arms,66,34,32
Tatsuu,tichondrius,1568,warrior,arms,282,137,145
Pachacutecxx,ragnaros,1568,warrior,arms,105,50,55
Zuzi,korgath,1567,warrior,arms,55,35,20
Jaybers,malganis,1567,warrior,arms,59,31,28
Fracked,sargeras,1567,warrior,arms,45,22,23
Devildriver,malganis,1566,warrior,arms,120,64,56
Riggragg,tichondrius,1565,warrior,arms,48,28,20
Rapcherawr,illidan,1565,warrior,arms,51,28,23
Radagøn,drakkari,1565,warrior,arms,48,24,24
Montibello,moon-guard,1565,warrior,arms,243,119,124
Flexo,moon-guard,1564,warrior,arms,72,39,33
Scrümp,illidan,1564,warrior,arms,85,45,40
Zeroskill,cenarius,1564,warrior,arms,106,49,57
Ralphy,lightnings-blade,1563,warrior,arms,94,53,41
Vvarríør,tichondrius,1563,warrior,arms,100,53,47
Naejwar,ragnaros,1563,warrior,arms,186,97,89
Punknicanor,quelthalas,1563,warrior,arms,102,53,49
Darkmagno,ragnaros,1563,warrior,arms,42,20,22
Tkazo,tichondrius,1563,warrior,arms,103,47,56
Chogar,proudmoore,1562,warrior,arms,64,34,30
Chañ,tichondrius,1562,warrior,arms,36,19,17
Dewbae,whisperwind,1562,warrior,arms,119,60,59
Executie,duskwood,1562,warrior,arms,73,36,37
Bigdadde,tichondrius,1561,warrior,arms,30,19,11
Stormlørd,frostmourne,1560,warrior,arms,100,51,49
Jenkin,korgath,1560,warrior,arms,40,19,21
Vargoth,frostmourne,1560,warrior,arms,83,37,46
Shewar,ragnaros,1560,warrior,arms,39,17,22
Raahjv,sargeras,1559,warrior,arms,60,36,24
Yolo,dunemaul,1558,warrior,arms,84,47,37
Hônor,ragnaros,1558,warrior,arms,54,24,30
Claymation,tichondrius,1558,warrior,arms,48,18,30
Michaelrossx,bloodhoof,1557,warrior,arms,285,143,142
Cronguin,bleeding-hollow,1557,warrior,arms,64,32,32
Timbermack,moon-guard,1556,warrior,arms,138,71,67
Arot,bloodhoof,1556,warrior,arms,225,113,112
Amputate,akama,1556,warrior,arms,77,33,44
Firesx,tichondrius,1555,warrior,arms,36,20,16
Skronkar,illidan,1555,warrior,arms,174,88,86
Mardrex,korgath,1555,warrior,arms,48,21,27
Azindar,gilneas,1554,warrior,arms,42,21,21
Flavor,aegwynn,1554,warrior,arms,60,27,33
Áustin,sargeras,1553,warrior,arms,36,21,15
Rushour,quelthalas,1553,warrior,arms,38,17,21
Martyferrari,black-dragonflight,1552,warrior,arms,114,63,51
Sosimi,tichondrius,1552,warrior,arms,97,51,46
Achillescool,tichondrius,1552,warrior,arms,178,90,88
Doves,tichondrius,1552,warrior,arms,57,28,29
Nagaboner,frostmourne,1551,warrior,arms,146,81,65
Slyith,shadow-council,1551,warrior,arms,120,64,56
Kastenz,frostmourne,1551,warrior,arms,73,36,37
Blíding,ragnaros,1551,warrior,arms,75,28,47
Ghóstx,alleria,1550,warrior,arms,53,37,16
Weildboy,undermine,1550,warrior,arms,155,81,74
Kahuwuna,tichondrius,1550,warrior,arms,36,18,18
Rèckit,thrall,1550,warrior,arms,48,21,27
Gorgan,ragnaros,1549,warrior,arms,96,48,48
Kilgrah,emerald-dream,1549,warrior,arms,64,31,33
Hannibalkng,zangarmarsh,1549,warrior,arms,64,27,37
Azziiqt,stormrage,1548,warrior,arms,24,18,6
Dreadedbeef,area-52,1548,warrior,arms,54,28,26
Drob,malganis,1548,warrior,arms,60,30,30
Narkduke,onyxia,1548,warrior,arms,42,20,22
Bebob,tichondrius,1548,warrior,arms,100,47,53
Dashballer,sargeras,1547,warrior,arms,62,31,31
Itskel,stormreaver,1546,warrior,arms,44,23,21
Muskratz,tichondrius,1546,warrior,arms,194,99,95
Banhaezzi,tichondrius,1546,warrior,arms,181,91,90
Andrès,sargeras,1546,warrior,arms,239,116,123
Rainingblooð,blackrock,1546,warrior,arms,120,58,62
Bjjorm,malganis,1546,warrior,arms,74,33,41
Kénjar,tichondrius,1545,warrior,arms,54,32,22
Rathty,shadowsong,1545,warrior,arms,54,30,24
Ðrex,nagrand,1545,warrior,arms,128,66,62
Spartaur,tichondrius,1545,warrior,arms,42,21,21
Pachacutec,area-52,1545,warrior,arms,92,42,50
Brostormftw,shattered-halls,1544,warrior,arms,72,43,29
Zyppz,sargeras,1543,warrior,arms,38,26,12
Grumtak,azralon,1543,warrior,arms,59,30,29
Boypartz,onyxia,1543,warrior,arms,66,26,40
Lykemore,moon-guard,1542,warrior,arms,74,41,33
Tkavalan,proudmoore,1542,warrior,arms,71,33,38
Know,anetheron,1542,warrior,arms,98,45,53
Warrbull,spirestone,1542,warrior,arms,42,19,23
Danield,illidan,1542,warrior,arms,60,23,37
Reckonting,moon-guard,1541,warrior,arms,36,24,12
Aqee,illidan,1541,warrior,arms,91,60,31
Blightscream,bleeding-hollow,1541,warrior,arms,299,150,149
Aragorn,mannoroth,1541,warrior,arms,42,21,21
Eronara,emerald-dream,1541,warrior,arms,76,37,39
Gorez,ragnaros,1541,warrior,arms,60,28,32
Athin,azralon,1540,warrior,arms,114,61,53
Nazraill,aggramar,1540,warrior,arms,99,49,50
Millywhopz,thrall,1539,warrior,arms,48,25,23
Uhttercow,tichondrius,1539,warrior,arms,66,33,33
Piimpmaster,malganis,1539,warrior,arms,42,19,23
Slitt,azralon,1538,warrior,arms,78,42,36
Xkickaxes,tichondrius,1538,warrior,arms,101,48,53
Bwandøn,moon-guard,1538,warrior,arms,88,41,47
Cowtipin,illidan,1538,warrior,arms,110,50,60
Mõgorrin,area-52,1538,warrior,arms,42,18,24
Tansozzi,tichondrius,1537,warrior,arms,48,27,21
Guerra,goldrinn,1537,warrior,arms,66,31,35
Rokgral,tichondrius,1536,warrior,arms,92,48,44
Dudupápá,tichondrius,1536,warrior,arms,40,19,21
Gavfields,tichondrius,1536,warrior,arms,36,17,19
Kenshín,ragnaros,1536,warrior,arms,197,93,104
Mailløche,bleeding-hollow,1535,warrior,arms,72,41,31
Rezzett,wyrmrest-accord,1535,warrior,arms,73,38,35
Kpc,tichondrius,1535,warrior,arms,116,46,70
Mortyy,stormrage,1534,warrior,arms,43,23,20
Themudcrab,frostmourne,1534,warrior,arms,339,166,173
Sulze,tichondrius,1534,warrior,arms,373,181,192
Twshizgd,proudmoore,1534,warrior,arms,193,91,102
Burstmacro,garrosh,1534,warrior,arms,60,26,34
Áres,malganis,1533,warrior,arms,292,156,136
Ogeezus,crushridge,1533,warrior,arms,72,36,36
Fraccx,area-52,1533,warrior,arms,76,34,42
Hydranoid,ragnaros,1532,warrior,arms,157,73,84
Warthok,turalyon,1531,warrior,arms,86,41,45
Anukhos,emerald-dream,1530,warrior,arms,30,16,14
Maddorlon,thrall,1530,warrior,arms,59,27,32
Rohta,kiljaeden,1529,warrior,arms,113,55,58
Axazel,drakkari,1529,warrior,arms,204,97,107
Marzse,sargeras,1529,warrior,arms,54,23,31
Ratfang,zuljin,1528,warrior,arms,28,17,11
Stinkyw,tichondrius,1528,warrior,arms,49,27,22
Meatbone,emerald-dream,1528,warrior,arms,113,61,52
Hotdadparty,frostmourne,1528,warrior,arms,145,73,72
Marsoc,burning-legion,1528,warrior,arms,69,33,36
Noyel,tichondrius,1528,warrior,arms,70,32,38
Wargasms,alterac-mountains,1528,warrior,arms,66,29,37
Termana,azjolnerub,1527,warrior,arms,30,16,14
Imyourdaddy,chogall,1527,warrior,arms,40,21,19
Volstraya,frostmourne,1527,warrior,arms,43,22,21
Seukkang,tichondrius,1527,warrior,arms,54,24,30
Jwz,tichondrius,1527,warrior,arms,36,16,20
Barbatenaz,ragnaros,1527,warrior,arms,64,28,36
Yiplaw,stormrage,1526,warrior,arms,30,16,14
Slamspam,the-underbog,1526,warrior,arms,31,16,15
Zaddybear,aerie-peak,1526,warrior,arms,45,23,22
Bìgpoppapump,tichondrius,1526,warrior,arms,195,95,100
Malvadin,stormrage,1526,warrior,arms,66,30,36
Saelaa,azralon,1525,warrior,arms,36,16,20
Flynnstone,tichondrius,1524,warrior,arms,30,19,11
Bottlecaps,shadowmoon,1524,warrior,arms,63,32,31
Bowlingball,darkspear,1524,warrior,arms,48,24,24
Chinamonk,tichondrius,1524,warrior,arms,101,49,52
Dtitanzz,quelthalas,1524,warrior,arms,57,27,30
Executty,stormrage,1524,warrior,arms,36,17,19
Doubleturbo,illidan,1524,warrior,arms,85,40,45
Ôxluck,ragnaros,1524,warrior,arms,126,54,72
Urion,illidan,1523,warrior,arms,30,17,13
Morioso,boulderfist,1523,warrior,arms,126,56,70
Varenkä,drakkari,1523,warrior,arms,36,16,20
Gwàr,kiljaeden,1522,warrior,arms,42,22,20
Dotlom,wyrmrest-accord,1522,warrior,arms,173,84,89
Genøcide,terenas,1522,warrior,arms,54,23,31
Nayuta,area-52,1521,warrior,arms,66,33,33
Himurinha,nemesis,1520,warrior,arms,36,20,16
Kimed,nordrassil,1520,warrior,arms,30,16,14
Spartacam,frostmourne,1520,warrior,arms,166,83,83
Dâvo,area-52,1520,warrior,arms,78,38,40
Raves,quelthalas,1520,warrior,arms,153,73,80
Renger,garona,1520,warrior,arms,42,20,22
Dropopen,tichondrius,1520,warrior,arms,86,36,50
Randysnapper,zuljin,1519,warrior,arms,24,16,8
Ichigö,gundrak,1519,warrior,arms,57,28,29
Venecus,stormrage,1519,warrior,arms,42,20,22
Rukittenme,area-52,1519,warrior,arms,72,29,43
Ártorius,sargeras,1518,warrior,arms,138,72,66
Malakaimapk,korgath,1517,warrior,arms,30,16,14
Lòrdnasher,tichondrius,1516,warrior,arms,119,64,55
Bobandi,tichondrius,1516,warrior,arms,67,34,33
Ghianna,quelthalas,1516,warrior,arms,95,47,48
Damiansuv,moon-guard,1516,warrior,arms,153,73,80
Evoltoad,illidan,1516,warrior,arms,77,28,49
Dajva,ragnaros,1515,warrior,arms,78,36,42
Bryk,korgath,1514,warrior,arms,36,21,15
Bugsberserk,tichondrius,1514,warrior,arms,140,68,72
Môrôdin,area-52,1514,warrior,arms,120,55,65
Gruula,frostmourne,1513,warrior,arms,45,27,18
Nyuk,tichondrius,1513,warrior,arms,51,29,22
Bvrst,area-52,1513,warrior,arms,30,16,14
Dtrumpo,moon-guard,1513,warrior,arms,52,27,25
Monstersynde,nemesis,1513,warrior,arms,143,71,72
Shiv,illidan,1513,warrior,arms,128,63,65
Elevate,whisperwind,1513,warrior,arms,36,16,20
Hawkior,moon-guard,1512,warrior,arms,47,26,21
Bullmastic,deathwing,1512,warrior,arms,52,26,26
Slamthony,sargeras,1511,warrior,arms,81,41,40
Raala,cenarius,1510,warrior,arms,51,34,17
Hdkwanwoo,tichondrius,1509,warrior,arms,78,45,33
Underbite,area-52,1509,warrior,arms,72,41,31
Draganovich,aerie-peak,1509,warrior,arms,54,30,24
Broodthorne,tichondrius,1509,warrior,arms,42,21,21
Darkdargon,tichondrius,1509,warrior,arms,48,22,26
Karrosh,agamaggan,1509,warrior,arms,42,18,24
Himer,tichondrius,1509,warrior,arms,48,20,28
Kratosxx,quelthalas,1508,warrior,arms,79,38,41
Ryank,bonechewer,1508,warrior,arms,54,25,29
Kissmyaxê,tichondrius,1508,warrior,arms,63,28,35
Notoxzy,tichondrius,1508,warrior,arms,36,16,20
Zeroaxx,ragnaros,1507,warrior,arms,115,68,47
Macray,proudmoore,1507,warrior,arms,30,17,13
Machete,nemesis,1507,warrior,arms,76,40,36
Nornogin,tichondrius,1507,warrior,arms,81,38,43
Hashwar,area-52,1507,warrior,arms,36,16,20
Geñeralguap,tichondrius,1506,warrior,arms,208,110,98
Jäÿ,proudmoore,1506,warrior,arms,87,44,43
Asäel,ragnaros,1506,warrior,arms,83,40,43
Etothed,stormrage,1506,warrior,arms,48,19,29
Zolotrollo,area-52,1505,warrior,arms,24,16,8
Zewl,barthilas,1505,warrior,arms,42,22,20
Testflight,tichondrius,1505,warrior,arms,84,41,43
Moonär,emerald-dream,1505,warrior,arms,113,55,58
Titanor,illidan,1505,warrior,arms,75,35,40
Warrgawd,illidan,1504,warrior,arms,107,52,55
Kwelve,proudmoore,1504,warrior,arms,60,27,33
Pocserwar,drakkari,1504,warrior,arms,36,16,20
Wouili,zuljin,1503,warrior,arms,97,59,38
Atróx,quelthalas,1503,warrior,arms,84,40,44
Mokron,moon-guard,1503,warrior,arms,103,44,59
Ikitee,zuljin,1501,warrior,arms,30,16,14
Slvrback,stormrage,1501,warrior,arms,30,16,14
Cagrekk,wyrmrest-accord,1501,warrior,arms,71,37,34
Vecira,moon-guard,1501,warrior,arms,47,24,23
Cúdi,darkspear,1501,warrior,arms,54,26,28
Rallyingcry,illidan,1500,warrior,arms,30,18,12
Khargrok,ragnaros,1500,warrior,arms,72,36,36
Azkaosa,tichondrius,1500,warrior,arms,59,27,32
Yawdamper,illidan,1499,warrior,arms,42,26,16
Yunnkel,ragnaros,1499,warrior,arms,128,64,64
Radamäntthys,nemesis,1499,warrior,arms,123,56,67
Deadlypsycho,moonrunner,1498,warrior,arms,66,29,37
Zzchocolate,illidan,1498,warrior,arms,114,49,65
Akkar,gilneas,1497,warrior,arms,99,53,46
Stickybladez,frostmourne,1497,warrior,arms,160,80,80
Konraad,amanthul,1497,warrior,arms,66,33,33
Lilreese,tichondrius,1497,warrior,arms,74,36,38
Tcchmm,akama,1497,warrior,arms,64,28,36
Habakkos,firetree,1496,warrior,arms,72,39,33
Crustyfella,stormrage,1496,warrior,arms,52,28,24
Jrod,boulderfist,1496,warrior,arms,257,130,127
Titanzz,quelthalas,1496,warrior,arms,83,39,44
Nomequemee,quelthalas,1496,warrior,arms,36,16,20
Katre,malorne,1496,warrior,arms,91,39,52
Tharsìs,emerald-dream,1496,warrior,arms,51,18,33
Wo,alleria,1495,warrior,arms,42,19,23
Crowncrumpah,illidan,1494,warrior,arms,60,28,32
Gale,kelthuzad,1493,warrior,arms,42,24,18
Frosto,nemesis,1493,warrior,arms,30,16,14
Datneck,tichondrius,1493,warrior,arms,30,16,14
Metalwarr,illidan,1493,warrior,arms,71,35,36
Horsekok,tichondrius,1492,warrior,arms,30,19,11
Asc,barthilas,1492,warrior,arms,270,143,127
Aggorak,illidan,1492,warrior,arms,36,16,20
Bigster,malganis,1491,warrior,arms,60,33,27
Kakamallo,black-dragonflight,1491,warrior,arms,219,114,105
Sáítámá,tichondrius,1491,warrior,arms,58,30,28
Handkerchief,bleeding-hollow,1491,warrior,arms,43,19,24
Balroge,illidan,1490,warrior,arms,60,30,30
Roidraging,thunderlord,1490,warrior,arms,149,66,83
Theisius,tichondrius,1490,warrior,arms,75,33,42
Zhânshen,tichondrius,1489,warrior,arms,66,35,31
Velarael,stormscale,1489,warrior,arms,58,29,29
Medusaann,proudmoore,1489,warrior,arms,69,34,35
Rockstedy,area-52,1489,warrior,arms,68,31,37
Taywar,sargeras,1488,warrior,arms,60,29,31
Legnar,malganis,1488,warrior,arms,72,30,42
Casablancas,azralon,1488,warrior,arms,42,16,26
Dragvovar,thrall,1488,warrior,arms,42,16,26
Mewpaw,azralon,1487,warrior,arms,24,16,8
Gahju,area-52,1487,warrior,arms,36,20,16
Aldérmach,zuljin,1487,warrior,arms,130,68,62
Zänn,dalaran,1486,warrior,arms,60,38,22
Linga,bleeding-hollow,1486,warrior,arms,36,19,17
Cosmosz,illidan,1486,warrior,arms,143,75,68
Sìkarío,illidan,1486,warrior,arms,60,31,29
Bigdingus,frostwolf,1486,warrior,arms,66,32,34
Pelonna,drakkari,1486,warrior,arms,190,92,98
Zxlor,tichondrius,1486,warrior,arms,60,26,34
Brotu,nemesis,1485,warrior,arms,169,95,74
Ävdol,emerald-dream,1485,warrior,arms,133,62,71
Karnakk,thrall,1485,warrior,arms,41,16,25
Cjz,tichondrius,1484,warrior,arms,63,38,25
Iskandr,amanthul,1484,warrior,arms,33,17,16
Oppressor,darkspear,1484,warrior,arms,112,54,58
Wmf,frostmourne,1484,warrior,arms,96,44,52
Danzohh,dalaran,1484,warrior,arms,45,18,27
Twobyfuor,sargeras,1483,warrior,arms,77,43,34
Braxin,dalaran,1483,warrior,arms,77,42,35
Vayper,illidan,1483,warrior,arms,95,50,45
Märkdî,quelthalas,1483,warrior,arms,156,81,75
Gulgosh,stormscale,1483,warrior,arms,107,51,56
Earlsiriuz,tichondrius,1483,warrior,arms,51,23,28
Amaragos,tichondrius,1482,warrior,arms,74,44,30
Slimmjim,malganis,1482,warrior,arms,211,116,95
Tamagoshi,kiljaeden,1482,warrior,arms,185,100,85
Islik,stormrage,1482,warrior,arms,73,35,38
Bâlthor,quelthalas,1481,warrior,arms,126,61,65
Drèádnought,tichondrius,1481,warrior,arms,50,24,26
Velarrine,illidan,1480,warrior,arms,101,47,54
Magnis,stormrage,1480,warrior,arms,72,33,39
Mikero,terenas,1480,warrior,arms,36,16,20
Leapgodx,drenden,1479,warrior,arms,48,26,22
Dysensor,illidan,1479,warrior,arms,156,82,74
Volkz,ragnaros,1479,warrior,arms,107,51,56
Endurefen,sargeras,1478,warrior,arms,42,23,19
Lsays,tichondrius,1478,warrior,arms,168,84,84
Aparentlynot,shattered-hand,1478,warrior,arms,36,17,19
Elchacál,ragnaros,1478,warrior,arms,72,29,43
Bêelzebub,aerie-peak,1478,warrior,arms,54,20,34
Armsprotfury,tichondrius,1477,warrior,arms,54,33,21
Luosifen,tichondrius,1477,warrior,arms,282,143,139
Rainzy,stormrage,1476,warrior,arms,36,16,20
Slammshady,tichondrius,1475,warrior,arms,33,18,15
Ewenki,tichondrius,1475,warrior,arms,298,151,147
Dæthtønes,tichondrius,1475,warrior,arms,144,72,72
Crystaríum,stormrage,1475,warrior,arms,92,43,49
Weedow,proudmoore,1474,warrior,arms,29,16,13
Auxthas,tichondrius,1474,warrior,arms,54,29,25
Rimz,sargeras,1474,warrior,arms,40,21,19
Gerztok,aggramar,1474,warrior,arms,58,28,30
Johnnysmizle,kelthuzad,1474,warrior,arms,96,41,55
Flintish,moon-guard,1473,warrior,arms,77,45,32
Saîyanroyce,barthilas,1473,warrior,arms,137,69,68
Peacemake,tichondrius,1473,warrior,arms,52,26,26
Ironhide,malorne,1472,warrior,arms,48,24,24
Eihn,quelthalas,1472,warrior,arms,59,28,31
Belldor,barthilas,1472,warrior,arms,108,47,61
Ryen,malganis,1472,warrior,arms,93,39,54
Dazfotm,tichondrius,1472,warrior,arms,41,16,25
Holddapoop,area-52,1471,warrior,arms,78,43,35
Neotico,quelthalas,1471,warrior,arms,62,27,35
Soltrain,stormrage,1470,warrior,arms,80,38,42
Potalot,draenor,1469,warrior,arms,30,16,14
Baul,area-52,1469,warrior,arms,59,31,28
Smokedaperc,illidan,1468,warrior,arms,84,44,40
Jichelei,tichondrius,1468,warrior,arms,78,39,39
Jeffo,amanthul,1468,warrior,arms,38,18,20
Gnizzmo,sargeras,1468,warrior,arms,65,30,35
Thurman,spirestone,1467,warrior,arms,44,26,18
Lilmerman,laughing-skull,1467,warrior,arms,83,41,42
Klouddraft,tichondrius,1466,warrior,arms,45,26,19
Jurojin,tichondrius,1466,warrior,arms,29,16,13
Riderless,ragnaros,1466,warrior,arms,47,23,24
Sharpen,terokkar,1465,warrior,arms,30,17,13
Bestid,tichondrius,1465,warrior,arms,60,33,27
Warrimon,nemesis,1465,warrior,arms,78,35,43
Báhamut,area-52,1465,warrior,arms,83,37,46
Thedin,gorefiend,1465,warrior,arms,84,36,48
Eggroll,emerald-dream,1465,warrior,arms,47,17,30
Najarath,barthilas,1464,warrior,arms,65,37,28
Torimzor,nemesis,1464,warrior,arms,138,74,64
Bricksquad,mannoroth,1464,warrior,arms,57,25,32
Joesbàr,tichondrius,1464,warrior,arms,78,34,44
Ikrad,quelthalas,1463,warrior,arms,123,64,59
Rampage,azralon,1463,warrior,arms,178,90,88
Babybears,tichondrius,1463,warrior,arms,62,23,39
Tekaiatsu,tichondrius,1462,warrior,arms,107,61,46
Vyndronor,illidan,1462,warrior,arms,96,52,44
Dou,barthilas,1462,warrior,arms,41,22,19
Duroxzee,area-52,1462,warrior,arms,187,100,87
Carnith,arthas,1462,warrior,arms,66,30,36
Perrin,burning-blade,1462,warrior,arms,73,33,40
Skollyd,tichondrius,1462,warrior,arms,38,17,21
Sertss,proudmoore,1462,warrior,arms,71,30,41
Garadiels,tichondrius,1462,warrior,arms,79,33,46
Supremegalek,tichondrius,1461,warrior,arms,98,54,44
Golkän,goldrinn,1461,warrior,arms,66,34,32
Ihadnochoice,barthilas,1461,warrior,arms,256,126,130
Noitrak,azralon,1461,warrior,arms,45,18,27
Xforcewar,zuljin,1460,warrior,arms,54,27,27
Nabiouscx,malganis,1460,warrior,arms,107,50,57
Akaius,ragnaros,1460,warrior,arms,78,36,42
Darkfang,icecrown,1459,warrior,arms,72,39,33
Aloloco,ragnaros,1459,warrior,arms,78,38,40
Ôn,tichondrius,1459,warrior,arms,301,145,156
Riskydevil,azralon,1458,warrior,arms,58,32,26
Warlow,korgath,1458,warrior,arms,70,32,38
Mommysharky,illidan,1457,warrior,arms,36,26,10
Dathalidus,area-52,1457,warrior,arms,50,32,18
Creepi,sargeras,1457,warrior,arms,56,30,26
Rads,stormscale,1457,warrior,arms,75,40,35
Lisande,sargeras,1457,warrior,arms,171,91,80
Bozwar,tichondrius,1457,warrior,arms,72,36,36
Brocky,malorne,1456,warrior,arms,659,324,335
Kröh,quelthalas,1456,warrior,arms,54,25,29
Urscrewed,frostmane,1456,warrior,arms,59,24,35
Pongk,tichondrius,1456,warrior,arms,57,17,40
Cheeriozz,thrall,1455,warrior,arms,53,30,23
Renegón,ragnaros,1455,warrior,arms,54,28,26
Jotto,zuljin,1455,warrior,arms,36,18,18
Ginormous,rivendare,1455,warrior,arms,81,38,43
Xaka,tichondrius,1455,warrior,arms,42,19,23
Bigdickgomez,frostmourne,1454,warrior,arms,30,16,14
Lionssong,bleeding-hollow,1454,warrior,arms,71,31,40
Suprslayer,spirestone,1453,warrior,arms,40,20,20
Rayks,tichondrius,1452,warrior,arms,108,61,47
Aesom,wyrmrest-accord,1452,warrior,arms,145,80,65
Xenogears,boulderfist,1452,warrior,arms,96,51,45
Ayath,hyjal,1452,warrior,arms,66,31,35
Visenyä,mannoroth,1452,warrior,arms,58,23,35
Furyass,bleeding-hollow,1451,warrior,arms,126,67,59
Bellonar,stormrage,1450,warrior,arms,44,27,17
Tapijuju,stormrage,1450,warrior,arms,65,36,29
Elíte,kelthuzad,1450,warrior,arms,39,21,18
Zizwe,proudmoore,1450,warrior,arms,83,44,39
Biznizwar,sargeras,1450,warrior,arms,124,61,63
Isarat,illidan,1450,warrior,arms,48,23,25
Qetimporta,quelthalas,1449,warrior,arms,108,60,48
Thokk,argent-dawn,1449,warrior,arms,33,16,17
Shortgoofy,sargeras,1449,warrior,arms,141,66,75
Erple,eldrethalas,1449,warrior,arms,116,54,62
Wellowarr,moon-guard,1448,warrior,arms,78,34,44
Dcashmoney,moon-guard,1448,warrior,arms,66,28,38
Angelsantos,sargeras,1447,warrior,arms,42,24,18
Wapistun,thrall,1447,warrior,arms,48,26,22
Supersquish,moon-guard,1447,warrior,arms,129,66,63
Torzzen,azralon,1447,warrior,arms,129,63,66
Dånkers,sargeras,1447,warrior,arms,44,16,28
Gtatewarr,azjolnerub,1446,warrior,arms,26,16,10
Overswing,tichondrius,1446,warrior,arms,78,32,46
Shawnemd,proudmoore,1445,warrior,arms,54,29,25
Skorgebt,thrall,1445,warrior,arms,65,31,34
Slashcry,frostmourne,1445,warrior,arms,82,36,46
Elegorn,nemesis,1444,warrior,arms,79,36,43
Byefelipe,dalaran,1444,warrior,arms,36,16,20
Trackstarz,llane,1443,warrior,arms,250,124,126
Bonesaaw,caelestrasz,1443,warrior,arms,72,31,41
Suicider,stormrage,1443,warrior,arms,41,16,25
Bazironbeard,ravencrest,1442,warrior,arms,29,18,11
Kréix,sargeras,1442,warrior,arms,59,27,32
Destoryhamer,illidan,1441,warrior,arms,96,51,45
Dann,ragnaros,1441,warrior,arms,132,62,70
Asgér,quelthalas,1441,warrior,arms,129,55,74
Luckyw,draktharon,1440,warrior,arms,79,44,35
Blokz,arthas,1440,warrior,arms,114,63,51
Ðêad,area-52,1439,warrior,arms,24,15,9
Joran,dathremar,1439,warrior,arms,44,23,21
Kror,garona,1439,warrior,arms,75,38,37
Smoket,tichondrius,1439,warrior,arms,54,27,27
Sowavey,korgath,1439,warrior,arms,30,15,15
Rekatron,area-52,1439,warrior,arms,30,15,15
Raviax,sargeras,1439,warrior,arms,66,32,34
Beefytheorc,tichondrius,1439,warrior,arms,36,17,19
Emaree,thrall,1438,warrior,arms,98,55,43
Enilaw,proudmoore,1438,warrior,arms,74,40,34
Himxp,tichondrius,1438,warrior,arms,70,35,35
Beatmeat,frostmourne,1438,warrior,arms,55,25,30
Loosz,stormrage,1438,warrior,arms,36,15,21
Themessiah,stormrage,1437,warrior,arms,59,33,26
Graelus,terenas,1437,warrior,arms,47,26,21
Drekzul,azralon,1437,warrior,arms,71,39,32
Kurdtx,tichondrius,1437,warrior,arms,30,15,15
Frashes,darkspear,1437,warrior,arms,67,31,36
Handain,malganis,1437,warrior,arms,48,19,29
Raxek,stormrage,1437,warrior,arms,54,19,35
Benkenobi,khaz-modan,1436,warrior,arms,24,15,9
Stufit,emerald-dream,1436,warrior,arms,34,20,14
Sako,amanthul,1436,warrior,arms,42,22,20
Gorenay,nemesis,1436,warrior,arms,48,21,27
Cleaveson,malganis,1436,warrior,arms,36,15,21
Swamphell,barthilas,1436,warrior,arms,68,25,43
Lotsay,tichondrius,1435,warrior,arms,109,56,53
Ssamok,ragnaros,1435,warrior,arms,30,15,15
Nikon,bleeding-hollow,1435,warrior,arms,42,16,26
Valder,akama,1434,warrior,arms,42,23,19
Herey,moon-guard,1434,warrior,arms,30,15,15
Vainamóinen,kelthuzad,1433,warrior,arms,24,15,9
Fòntaine,shandris,1433,warrior,arms,49,28,21
Monowarx,frostmourne,1433,warrior,arms,46,22,24
Ybo,illidan,1432,warrior,arms,87,56,31
Zonkis,kelthuzad,1432,warrior,arms,30,15,15
Brewstrike,dalaran,1432,warrior,arms,54,25,29
Tonesman,tichondrius,1432,warrior,arms,48,22,26
Druckerz,lightnings-blade,1432,warrior,arms,102,43,59
Asgaurdius,thunderlord,1431,warrior,arms,76,38,38
Beaerboy,darkspear,1431,warrior,arms,148,68,80
Painfulsin,tichondrius,1431,warrior,arms,60,26,34
Badguys,illidan,1431,warrior,arms,36,15,21
Recktko,sargeras,1431,warrior,arms,45,16,29
Josephcrazy,tichondrius,1430,warrior,arms,36,19,17
Cowstik,illidan,1430,warrior,arms,30,15,15
Naughtytwat,tichondrius,1430,warrior,arms,261,128,133
Unstàble,frostmourne,1430,warrior,arms,120,58,62
Jeffyd,bleeding-hollow,1430,warrior,arms,66,28,38
Chiêfatriox,tichondrius,1430,warrior,arms,54,21,33
Camloops,tichondrius,1429,warrior,arms,22,16,6
Einnarr,tichondrius,1429,warrior,arms,25,15,10
Zeldawolfpac,moon-guard,1429,warrior,arms,42,23,19
Deáthknight,shuhalo,1429,warrior,arms,48,22,26
Jeffe,khadgar,1429,warrior,arms,86,39,47
Kushhy,illidan,1429,warrior,arms,45,19,26
Destroid,zuljin,1428,warrior,arms,24,15,9
Liinx,tichondrius,1428,warrior,arms,30,17,13
Laintimee,tichondrius,1428,warrior,arms,56,30,26
Maleap,moon-guard,1428,warrior,arms,62,28,34
Shiiftybuga,frostmourne,1427,warrior,arms,50,27,23
Streetdog,stormrage,1427,warrior,arms,72,35,37
Kadira,stormrage,1427,warrior,arms,90,37,53
Calmebigfeet,tichondrius,1426,warrior,arms,30,15,15
Tuvia,malganis,1426,warrior,arms,225,110,115
Hulkbuster,ragnaros,1426,warrior,arms,77,36,41
Rokó,illidan,1425,warrior,arms,88,44,44
Empyrius,exodar,1425,warrior,arms,38,17,21
Santiágo,wyrmrest-accord,1425,warrior,arms,42,15,27
Nervoxztwo,ragnaros,1424,warrior,arms,126,66,60
Kannzox,quelthalas,1424,warrior,arms,103,53,50
Cptstarship,sargeras,1424,warrior,arms,42,21,21
Flexeçute,moon-guard,1424,warrior,arms,87,42,45
Maintarget,malganis,1424,warrior,arms,59,21,38
Tergll,illidan,1423,warrior,arms,51,23,28
Thalfor,emerald-dream,1423,warrior,arms,89,36,53
Bütton,sargeras,1422,warrior,arms,24,15,9
Ooze,darkspear,1422,warrior,arms,138,75,63
Gladìus,area-52,1422,warrior,arms,30,15,15
Justfair,barthilas,1422,warrior,arms,63,31,32
Guguito,drakkari,1422,warrior,arms,42,17,25
Groxxigore,chogall,1421,warrior,arms,147,82,65
Filthyrandy,proudmoore,1421,warrior,arms,42,21,21
Lørdvingador,azralon,1421,warrior,arms,30,15,15
Blàdê,illidan,1421,warrior,arms,30,15,15
Gritrog,thrall,1420,warrior,arms,56,42,14
Banggo,frostmourne,1420,warrior,arms,72,41,31
Themonsterr,stormrage,1420,warrior,arms,40,18,22
Sleazedog,kelthuzad,1420,warrior,arms,48,21,27
Farquahd,illidan,1420,warrior,arms,84,34,50
Waraze,tichondrius,1420,warrior,arms,42,17,25
Nipparcs,tichondrius,1420,warrior,arms,42,15,27
Varyanguard,quelthalas,1419,warrior,arms,47,25,22
Orctiddy,emerald-dream,1419,warrior,arms,32,16,16
Mopwarrior,sargeras,1419,warrior,arms,30,15,15
Fûry,barthilas,1419,warrior,arms,48,22,26
Yazia,stormrage,1419,warrior,arms,54,23,31
Peepeeboi,blackrock,1418,warrior,arms,48,27,21
Elyoy,aerie-peak,1418,warrior,arms,48,26,22
Juggerboo,frostmourne,1418,warrior,arms,145,73,72
Legbreaker,tichondrius,1418,warrior,arms,100,49,51
Hundredplus,frostmourne,1418,warrior,arms,36,17,19
Pepétí,azralon,1418,warrior,arms,160,72,88
Mortalgodtko,ragnaros,1418,warrior,arms,39,17,22
Fraannky,windrunner,1417,warrior,arms,164,82,82
Hopar,illidan,1416,warrior,arms,95,53,42
Tasesino,quelthalas,1416,warrior,arms,82,45,37
Aaryn,caelestrasz,1415,warrior,arms,104,56,48
Rekitralph,tichondrius,1415,warrior,arms,45,23,22
Kiranoma,moon-guard,1415,warrior,arms,45,23,22
Ughh,bleeding-hollow,1415,warrior,arms,54,27,27
Bâtar,area-52,1415,warrior,arms,47,17,30
Drygen,tichondrius,1414,warrior,arms,60,36,24
Tdestroy,ragnaros,1414,warrior,arms,51,28,23
Sludgthwaps,stormrage,1414,warrior,arms,65,33,32
Fatnfurious,dunemaul,1414,warrior,arms,100,50,50
Dizgraceful,malganis,1413,warrior,arms,30,21,9
Korboc,malganis,1413,warrior,arms,60,29,31
Slickpapi,area-52,1413,warrior,arms,93,44,49
Sercastic,illidan,1413,warrior,arms,41,18,23
Muertededios,quelthalas,1412,warrior,arms,141,70,71
Rikuduo,quelthalas,1412,warrior,arms,138,66,72
Magnusson,kelthuzad,1412,warrior,arms,42,20,22
Ëssex,tichondrius,1412,warrior,arms,83,38,45
Gageoddord,kiljaeden,1411,warrior,arms,30,17,13
Shadderaz,sargeras,1411,warrior,arms,66,30,36
Elessarr,moon-guard,1411,warrior,arms,36,15,21
Shockkwave,tichondrius,1410,warrior,arms,30,15,15
Kanamechan,area-52,1410,warrior,arms,71,28,43
Slamix,area-52,1409,warrior,arms,81,41,40
Toughguts,saurfang,1409,warrior,arms,78,36,42
Kilrok,thunderlord,1409,warrior,arms,48,17,31
Utgarde,stormrage,1408,warrior,arms,200,101,99
Haxzors,sargeras,1408,warrior,arms,60,26,34
Moozz,dreadmaul,1408,warrior,arms,56,22,34
Warthorns,malganis,1408,warrior,arms,49,17,32
Iwooglybool,icecrown,1407,warrior,arms,24,15,9
Jøq,ragnaros,1407,warrior,arms,30,17,13
Karrok,zuluhed,1407,warrior,arms,282,135,147
Novastormer,barthilas,1407,warrior,arms,90,41,49
Rägar,quelthalas,1406,warrior,arms,73,37,36
Solano,illidan,1405,warrior,arms,48,30,18
Outo,stormrage,1405,warrior,arms,29,15,14
Warb,aggramar,1405,warrior,arms,93,48,45
Bruttallis,frostmane,1405,warrior,arms,51,25,26
Hoodlark,lightbringer,1405,warrior,arms,78,30,48
Baix,frostmourne,1404,warrior,arms,63,35,28
Tithousand,tichondrius,1404,warrior,arms,45,24,21
Janlei,quelthalas,1404,warrior,arms,88,42,46
Jottman,tichondrius,1404,warrior,arms,171,73,98
Yummysushi,gorgonnash,1404,warrior,arms,76,31,45
Erynus,malganis,1403,warrior,arms,56,29,27
Mortalstrike,chogall,1403,warrior,arms,52,25,27
Zareos,azralon,1403,warrior,arms,40,17,23
Bløødy,lethon,1402,warrior,arms,26,17,9
Gusbus,malganis,1402,warrior,arms,121,65,56
Chacca,suramar,1401,warrior,arms,36,25,11
Gorrock,dreadmaul,1401,warrior,arms,84,43,41
Kolacut,tichondrius,1401,warrior,arms,30,15,15
Sigfir,ragnaros,1401,warrior,arms,76,36,40
Ðirtyboy,tichondrius,1401,warrior,arms,60,22,38
Aión,nemesis,1400,warrior,arms,24,17,7
Thaisyta,tichondrius,1400,warrior,arms,30,19,11
Wreckz,blood-furnace,1400,warrior,arms,108,60,48
Zaexx,stormrage,1400,warrior,arms,71,36,35
Golinn,aerie-peak,1399,warrior,arms,108,56,52
Peeb,tichondrius,1399,warrior,arms,30,15,15
Hêllseeker,ragnaros,1399,warrior,arms,78,37,41
Xvett,drakkari,1398,warrior,arms,126,71,55
Tern,emerald-dream,1398,warrior,arms,82,42,40
Grimreáper,bleeding-hollow,1398,warrior,arms,108,44,64
Tenebrous,nemesis,1397,warrior,arms,48,20,28
Badbrain,barthilas,1397,warrior,arms,53,22,31
Dubstoob,illidan,1396,warrior,arms,184,95,89
Naxxiki,wyrmrest-accord,1396,warrior,arms,210,107,103
Wanabea,tichondrius,1396,warrior,arms,42,17,25
Sokõ,tichondrius,1394,warrior,arms,48,28,20
Varith,sargeras,1394,warrior,arms,36,20,16
Ponchetas,quelthalas,1394,warrior,arms,96,46,50
Rageorade,area-52,1394,warrior,arms,35,16,19
Krimgar,quelthalas,1394,warrior,arms,100,41,59
Topmeoff,bleeding-hollow,1394,warrior,arms,54,21,33
Fenømenoide,ragnaros,1392,warrior,arms,66,43,23
Cläpped,thrall,1392,warrior,arms,24,15,9
Fatty,mugthol,1392,warrior,arms,54,30,24
Vanglorio,azralon,1392,warrior,arms,81,44,37
Zaurka,sargeras,1391,warrior,arms,30,18,12
Nicegirl,sargeras,1391,warrior,arms,69,36,33
Ayuko,greymane,1391,warrior,arms,47,23,24
Coolade,thunderhorn,1391,warrior,arms,106,51,55
Zeerohkool,tichondrius,1391,warrior,arms,102,46,56
Sevala,spinebreaker,1390,warrior,arms,64,36,28
Natedógg,tichondrius,1390,warrior,arms,53,24,29
Apallô,tichondrius,1388,warrior,arms,89,40,49
Odrak,ragnaros,1388,warrior,arms,81,35,46
Rekcd,sargeras,1387,warrior,arms,36,23,13
Nãrax,area-52,1387,warrior,arms,40,20,20
Demonsláyer,illidan,1387,warrior,arms,30,15,15
Gilgaméshh,tichondrius,1387,warrior,arms,54,23,31
Stoneshield,senjin,1386,warrior,arms,29,15,14
Cecchino,zuluhed,1386,warrior,arms,60,31,29
Arthwarf,proudmoore,1386,warrior,arms,78,40,38
Aoste,tichondrius,1386,warrior,arms,73,37,36
Momojojo,daggerspine,1385,warrior,arms,26,18,8
Morhgath,bonechewer,1385,warrior,arms,49,26,23
Retros,kelthuzad,1385,warrior,arms,96,49,47
Roitty,proudmoore,1385,warrior,arms,73,36,37
Caupølican,ragnaros,1385,warrior,arms,82,40,42
Kanekhy,ragnaros,1385,warrior,arms,42,20,22
Steelfist,grizzly-hills,1385,warrior,arms,60,27,33
Yirko,quelthalas,1385,warrior,arms,74,31,43
Nightshauyia,kelthuzad,1384,warrior,arms,69,37,32
Tenchuu,azralon,1384,warrior,arms,162,75,87
Raygé,malygos,1383,warrior,arms,45,21,24
Disarmiea,cairne,1383,warrior,arms,87,40,47
Abidis,tichondrius,1383,warrior,arms,47,15,32
Greywo,tichondrius,1382,warrior,arms,73,43,30
Zuggarnaught,tichondrius,1382,warrior,arms,100,56,44
Fazeo,madoran,1382,warrior,arms,27,15,12
Rongkhunxyz,tichondrius,1382,warrior,arms,54,28,26
Fuknazum,gundrak,1382,warrior,arms,232,114,118
Ghostss,tichondrius,1382,warrior,arms,67,29,38
Eîghtysîx,sargeras,1382,warrior,arms,100,43,57
Rivenz,moon-guard,1382,warrior,arms,57,20,37
Ukris,area-52,1381,warrior,arms,119,62,57
Kantorowicz,goldrinn,1381,warrior,arms,108,55,53
Verain,thrall,1381,warrior,arms,36,17,19
Säbeër,ragnaros,1381,warrior,arms,73,32,41
Bagur,ragnaros,1380,warrior,arms,120,64,56
Durtmcsmash,stormrage,1380,warrior,arms,30,16,14
Tusktrollmon,illidan,1380,warrior,arms,158,78,80
Typhön,tichondrius,1380,warrior,arms,77,31,46
Gooshin,sargeras,1379,warrior,arms,127,65,62
Dinogc,barthilas,1379,warrior,arms,44,21,23
Silvers,blades-edge,1379,warrior,arms,36,15,21
Soniixz,ragnaros,1378,warrior,arms,79,38,41
Edwiddin,frostmourne,1378,warrior,arms,72,32,40
Killtarget,tichondrius,1377,warrior,arms,82,45,37
Gwendolynl,hyjal,1377,warrior,arms,73,35,38
Chrosis,norgannon,1377,warrior,arms,89,40,49
Kolossux,ragnaros,1376,warrior,arms,114,55,59
Mafe,tichondrius,1375,warrior,arms,58,28,30
Umogarmac,draktharon,1375,warrior,arms,42,19,23
Danzael,quelthalas,1375,warrior,arms,45,20,25
Yoruba,burning-blade,1375,warrior,arms,67,29,38
Beowúlf,burning-blade,1375,warrior,arms,41,16,25
Dolkal,tichondrius,1375,warrior,arms,57,21,36
Buntpunt,mannoroth,1374,warrior,arms,133,64,69
Týrodar,moon-guard,1374,warrior,arms,54,24,30
Allgas,barthilas,1373,warrior,arms,124,67,57
Rhohan,ysera,1373,warrior,arms,83,40,43
Kowboy,stormrage,1372,warrior,arms,130,66,64
Ragepocket,proudmoore,1371,warrior,arms,66,32,34
Udô,proudmoore,1371,warrior,arms,66,28,38
Azog,bleeding-hollow,1370,warrior,arms,60,32,28
Ðarkstar,zuljin,1370,warrior,arms,140,62,78
Budzie,frostwolf,1368,warrior,arms,40,21,19
Girthquake,stormreaver,1368,warrior,arms,29,15,14
Ermeji,ragnaros,1368,warrior,arms,71,31,40
Tasërface,hakkar,1368,warrior,arms,80,34,46
Frankoiz,quelthalas,1368,warrior,arms,54,20,34
Gizzmo,bonechewer,1368,warrior,arms,42,15,27
Monkedurant,tichondrius,1367,warrior,arms,30,18,12
Magnar,zuljin,1367,warrior,arms,119,63,56
Dhakhota,azralon,1367,warrior,arms,42,22,20
Amaus,queldorei,1367,warrior,arms,39,20,19
Bingchilly,aegwynn,1366,warrior,arms,27,16,11
Dhaemom,azralon,1366,warrior,arms,133,69,64
Scrapx,malganis,1366,warrior,arms,203,101,102
Evilkorean,tichondrius,1366,warrior,arms,59,29,30
Zaulgoodman,sargeras,1366,warrior,arms,48,21,27
Noppô,tichondrius,1366,warrior,arms,42,15,27
Doomreaper,hellscream,1365,warrior,arms,113,57,56
Tyzana,illidan,1365,warrior,arms,66,33,33
Zugnut,tichondrius,1365,warrior,arms,70,34,36
Xenowar,alleria,1365,warrior,arms,108,48,60
Durko,whisperwind,1365,warrior,arms,36,16,20
Ragnarwar,azralon,1364,warrior,arms,69,39,30
Juicey,burning-blade,1364,warrior,arms,55,28,27
Kleavage,korgath,1364,warrior,arms,97,47,50
Tÿÿr,azralon,1364,warrior,arms,60,26,34
Xampuu,ragnaros,1363,warrior,arms,34,20,14
Theragar,kilrogg,1363,warrior,arms,36,20,16
Tooto,kelthuzad,1363,warrior,arms,36,17,19
Tryndåmere,firetree,1363,warrior,arms,42,17,25
Ooktanx,emerald-dream,1363,warrior,arms,38,15,23
Bwhaha,frostwolf,1362,warrior,arms,42,30,12
Mjorn,sargeras,1362,warrior,arms,64,30,34
Yummybumbum,barthilas,1362,warrior,arms,60,26,34
Tyir,ragnaros,1362,warrior,arms,44,18,26
Swordmasters,icecrown,1361,warrior,arms,83,39,44
Kinzi,quelthalas,1361,warrior,arms,189,86,103
Arashikage,malganis,1361,warrior,arms,40,18,22
Hammertoez,thunderhorn,1361,warrior,arms,44,18,26
Mervyn,aegwynn,1360,warrior,arms,48,29,19
Èox,barthilas,1360,warrior,arms,45,26,19
Tikkò,tichondrius,1360,warrior,arms,62,33,29
Azrielsc,vashj,1360,warrior,arms,81,43,38
Devil,illidan,1360,warrior,arms,33,17,16
Warsaínt,area-52,1360,warrior,arms,65,31,34
Krakitus,azralon,1360,warrior,arms,99,43,56
Klingensturm,thrall,1359,warrior,arms,25,15,10
Lègèndáry,dark-iron,1359,warrior,arms,48,21,27
Tigo,khaz-modan,1358,warrior,arms,87,47,40
Franc,kiljaeden,1358,warrior,arms,41,22,19
Kilrosao,nordrassil,1358,warrior,arms,89,45,44
Rárict,moon-guard,1358,warrior,arms,70,35,35
Davidorco,drakkari,1358,warrior,arms,41,19,22
Ightdoex,zuljin,1357,warrior,arms,32,22,10
Estivador,kelthuzad,1357,warrior,arms,62,27,35
Raekor,tichondrius,1356,warrior,arms,54,33,21
Swàgnáros,area-52,1356,warrior,arms,30,18,12
Chanchoswar,ragnaros,1356,warrior,arms,138,62,76
Sllvrbck,tichondrius,1355,warrior,arms,64,37,27
Pangpou,tichondrius,1355,warrior,arms,156,83,73
Kourny,frostmourne,1355,warrior,arms,93,46,47
Xufoxpikmin,gurubashi,1354,warrior,arms,124,57,67
Lowlow,lightbringer,1354,warrior,arms,36,16,20
Kittybang,quelthalas,1354,warrior,arms,71,29,42
Seariphim,lothar,1353,warrior,arms,45,24,21
Jhave,ragnaros,1353,warrior,arms,44,22,22
Silverkiller,drakkari,1352,warrior,arms,57,29,28
Rapralph,barthilas,1352,warrior,arms,54,26,28
Biloni,ragnaros,1352,warrior,arms,42,18,24
Browneyed,area-52,1352,warrior,arms,36,15,21
Zroz,ragnaros,1351,warrior,arms,63,34,29
Toagrim,azralon,1351,warrior,arms,66,31,35
Mahkrash,quelthalas,1351,warrior,arms,89,41,48
Morbaras,tichondrius,1351,warrior,arms,59,26,33
Pírlo,ragnaros,1351,warrior,arms,42,18,24
Ninefingers,madoran,1350,warrior,arms,96,45,51
Hiddensquidd,stormrage,1349,warrior,arms,57,35,22
Mightypower,gurubashi,1349,warrior,arms,30,17,13
Hippy,kiljaeden,1349,warrior,arms,34,19,15
Dreadwarr,stormrage,1349,warrior,arms,62,33,29
Tinydingo,sargeras,1349,warrior,arms,36,19,17
Jsolucky,thrall,1348,warrior,arms,36,15,21
Cevadix,azralon,1348,warrior,arms,41,16,25
Datsongz,proudmoore,1347,warrior,arms,132,66,66
Odrath,tichondrius,1347,warrior,arms,96,46,50
Mogtash,blackrock,1347,warrior,arms,53,23,30
Dimus,area-52,1347,warrior,arms,36,15,21
Loothar,goldrinn,1346,warrior,arms,161,81,80
Rasgriz,moon-guard,1346,warrior,arms,43,20,23
Sonezwar,thrall,1345,warrior,arms,72,36,36
Taürok,azralon,1345,warrior,arms,48,23,25
Ðuratestön,azralon,1345,warrior,arms,36,16,20
Juff,hakkar,1344,warrior,arms,70,36,34
ßaldbornë,stormrage,1344,warrior,arms,94,47,47
Okayge,proudmoore,1343,warrior,arms,24,14,10
Cabelas,tichondrius,1343,warrior,arms,24,14,10
Warraaxx,stonemaul,1343,warrior,arms,48,25,23
Notmagnusz,zuljin,1343,warrior,arms,30,14,16
Dreamonn,illidan,1343,warrior,arms,30,14,16
Lagzistance,area-52,1343,warrior,arms,30,14,16
Legday,stormrage,1343,warrior,arms,36,14,22
Orangesoda,tichondrius,1342,warrior,arms,24,14,10
Celt,uldum,1342,warrior,arms,55,30,25
Bloodface,azralon,1342,warrior,arms,31,15,16
Punnisher,nerzhul,1342,warrior,arms,59,27,32
Zuljikan,illidan,1342,warrior,arms,59,21,38
Kurdt,tichondrius,1341,warrior,arms,24,14,10
Mcflury,skullcrusher,1341,warrior,arms,24,14,10
Rage,uther,1341,warrior,arms,30,14,16
Aliminar,zuluhed,1341,warrior,arms,30,14,16
Horcules,kiljaeden,1341,warrior,arms,47,19,28
Nithix,sargeras,1340,warrior,arms,28,15,13
Gentlehugs,illidan,1340,warrior,arms,36,14,22
Cuantascopas,ragnaros,1338,warrior,arms,24,14,10
Nerdstorm,tichondrius,1338,warrior,arms,24,14,10
Garysmalls,kelthuzad,1338,warrior,arms,24,14,10
Eskobar,magtheridon,1338,warrior,arms,29,15,14
Warrmoose,tichondrius,1338,warrior,arms,30,14,16
Sonicboom,whisperwind,1338,warrior,arms,30,14,16
Sloppyglucks,moon-guard,1338,warrior,arms,36,16,20
Småckin,frostmourne,1337,warrior,arms,73,41,32
Kiritos,draktharon,1337,warrior,arms,177,86,91
Rockadoodle,tichondrius,1337,warrior,arms,78,37,41
Suntore,malganis,1336,warrior,arms,24,14,10
Laygoh,zuljin,1336,warrior,arms,24,14,10
Govosh,thrall,1336,warrior,arms,24,14,10
Ketaqt,illidan,1336,warrior,arms,26,15,11
Elix,stormscale,1336,warrior,arms,42,22,20
Kelidar,kaelthas,1336,warrior,arms,60,31,29
Irix,tichondrius,1336,warrior,arms,147,74,73
Arm,stormscale,1336,warrior,arms,68,33,35
Viagraliker,tichondrius,1336,warrior,arms,44,19,25
Wesih,ragnaros,1336,warrior,arms,60,22,38
Unbeatablezs,tichondrius,1335,warrior,arms,96,51,45
Necco,lothar,1335,warrior,arms,42,19,23
Xenoblade,wildhammer,1335,warrior,arms,48,21,27
Zerosends,kelthuzad,1335,warrior,arms,36,14,22
Prodigál,dalaran,1334,warrior,arms,36,15,21
Wolfsrage,frostmourne,1334,warrior,arms,36,14,22
Guille,skullcrusher,1333,warrior,arms,30,22,8
Thegoochgoon,malorne,1333,warrior,arms,73,39,34
Diegoreo,drakkari,1333,warrior,arms,47,23,24
Vlix,korgath,1332,warrior,arms,36,19,17
Jijiyeya,tichondrius,1332,warrior,arms,36,17,19
Blackwulff,korgath,1332,warrior,arms,66,29,37
Waabi,emerald-dream,1331,warrior,arms,42,24,18
Heltic,uldum,1331,warrior,arms,30,15,15
Powerhard,area-52,1331,warrior,arms,63,28,35
Cainne,proudmoore,1330,warrior,arms,30,19,11
Carken,kiljaeden,1330,warrior,arms,36,20,16
Doomreaprr,hellscream,1330,warrior,arms,50,27,23
Tenserr,kiljaeden,1330,warrior,arms,45,22,23
Neozsmash,thrall,1330,warrior,arms,70,34,36
Jösellä,rivendare,1330,warrior,arms,30,14,16
Illicitkillz,destromath,1329,warrior,arms,30,14,16
Kilroywar,tichondrius,1329,warrior,arms,30,14,16
Nfx,tichondrius,1328,warrior,arms,24,14,10
Hadesz,nazjatar,1328,warrior,arms,83,45,38
Nuclearfury,khadgar,1328,warrior,arms,60,31,29
Xowarr,borean-tundra,1328,warrior,arms,35,16,19
Polox,ragnaros,1328,warrior,arms,37,16,21
Chilicezo,durotan,1327,warrior,arms,65,37,28
Cyllå,frostmourne,1327,warrior,arms,33,18,15
Kalnor,dark-iron,1327,warrior,arms,50,26,24
Flèx,stormrage,1327,warrior,arms,30,14,16
Llewellenar,stormrage,1327,warrior,arms,41,19,22
Kamboocha,tichondrius,1327,warrior,arms,34,15,19
Ketasshi,kelthuzad,1327,warrior,arms,36,14,22
Twistwarr,area-52,1326,warrior,arms,24,14,10
Iyamii,hyjal,1326,warrior,arms,35,19,16
Barricade,velen,1326,warrior,arms,175,85,90
Babamama,tichondrius,1326,warrior,arms,56,27,29
Papaming,tichondrius,1326,warrior,arms,78,36,42
Dragonupup,tichondrius,1325,warrior,arms,24,14,10
Boocawkeyy,illidan,1325,warrior,arms,60,23,37
Colosal,drakkari,1324,warrior,arms,33,20,13
Tasilia,tichondrius,1324,warrior,arms,30,14,16
Ygucheng,emerald-dream,1324,warrior,arms,85,38,47
Mitered,tichondrius,1323,warrior,arms,39,19,20
Overfury,azralon,1322,warrior,arms,36,18,18
Stewwar,wyrmrest-accord,1321,warrior,arms,44,25,19
Nviv,proudmoore,1321,warrior,arms,96,42,54
Vamtoro,illidan,1320,warrior,arms,56,33,23
Lelànd,kelthuzad,1320,warrior,arms,30,14,16
Reckfül,proudmoore,1320,warrior,arms,30,14,16
Warriordanim,tichondrius,1320,warrior,arms,319,145,174
Macsen,zuljin,1319,warrior,arms,36,18,18
Semyus,ragnaros,1319,warrior,arms,65,32,33
Linçpin,tichondrius,1319,warrior,arms,60,29,31
Thrawb,bleeding-hollow,1319,warrior,arms,33,15,18
Gï,fizzcrank,1318,warrior,arms,24,14,10
Arkayko,quelthalas,1318,warrior,arms,28,15,13
Xiosè,ragnaros,1318,warrior,arms,107,50,57
Lujzika,stormreaver,1318,warrior,arms,39,17,22
Calmaah,frostmourne,1317,warrior,arms,63,33,30
Zhyper,frostmourne,1316,warrior,arms,30,16,14
Kappis,illidan,1315,warrior,arms,59,29,30
Mackjackson,sargeras,1315,warrior,arms,54,26,28
Vikkz,frostmourne,1315,warrior,arms,47,22,25
Dennlss,quelthalas,1315,warrior,arms,114,49,65
Vondrack,ragnaros,1315,warrior,arms,83,34,49
Fuller,kelthuzad,1314,warrior,arms,36,18,18
Maxalyss,stormrage,1314,warrior,arms,30,15,15
Ragehir,thrall,1314,warrior,arms,31,15,16
Thorado,nemesis,1313,warrior,arms,178,86,92
Orcaine,ursin,1312,warrior,arms,71,42,29
Theregulator,area-52,1312,warrior,arms,94,53,41
Niudazhuang,tichondrius,1312,warrior,arms,112,60,52
Logi,alexstrasza,1312,warrior,arms,42,17,25
Blacksmiff,malganis,1311,warrior,arms,126,69,57
Carodataverm,saurfang,1310,warrior,arms,30,16,14
Qtcrow,frostmourne,1310,warrior,arms,78,39,39
Sseobeon,tichondrius,1310,warrior,arms,28,14,14
Tunasurprize,stormrage,1310,warrior,arms,33,16,17
Doomtree,zuljin,1309,warrior,arms,18,14,4
Makcumba,ragnaros,1309,warrior,arms,54,29,25
Verigislena,moon-guard,1309,warrior,arms,56,28,28
Jalaskâ,azralon,1309,warrior,arms,82,39,43
Kipqt,frostmourne,1309,warrior,arms,30,14,16
Bloodwish,stormrage,1308,warrior,arms,70,40,30
Deadhawk,wyrmrest-accord,1308,warrior,arms,108,49,59
Vâìn,tichondrius,1308,warrior,arms,40,18,22
Zeerohkool,malganis,1308,warrior,arms,140,62,78
Daymiian,blackrock,1308,warrior,arms,42,17,25
Notsi,ragnaros,1307,warrior,arms,66,28,38
Syllana,sargeras,1306,warrior,arms,30,15,15
Daniín,azralon,1306,warrior,arms,36,15,21
Teedubbs,antonidas,1306,warrior,arms,54,21,33
Exxic,zuljin,1305,warrior,arms,42,21,21
Vemue,tichondrius,1305,warrior,arms,172,84,88
Korsarro,frostmourne,1305,warrior,arms,110,52,58
Timbajimba,silvermoon,1305,warrior,arms,64,30,34
Rhagnael,malganis,1305,warrior,arms,72,30,42
Dreweth,altar-of-storms,1304,warrior,arms,30,16,14
Hoshigaki,frostmourne,1304,warrior,arms,77,40,37
Pum,bleeding-hollow,1304,warrior,arms,30,14,16
Marraneitor,quelthalas,1303,warrior,arms,60,29,31
Akj,sargeras,1302,warrior,arms,54,23,31
Ludicrous,dreadmaul,1302,warrior,arms,85,36,49
Kayaburn,tichondrius,1301,warrior,arms,24,19,5
Donhoolio,illidan,1301,warrior,arms,24,14,10
Ratherfull,ragnaros,1301,warrior,arms,28,14,14
Legolant,uther,1301,warrior,arms,30,14,16
Machineofwar,zuluhed,1301,warrior,arms,168,78,90
Beserkqt,azralon,1301,warrior,arms,54,23,31
Erdres,kelthuzad,1301,warrior,arms,75,27,48
Warnick,illidan,1300,warrior,arms,72,35,37
Pvpheart,tichondrius,1299,warrior,arms,47,27,20
Bluthammer,wyrmrest-accord,1299,warrior,arms,35,16,19
Tsmtsmtsm,tichondrius,1298,warrior,arms,30,17,13
Warrdawg,tichondrius,1298,warrior,arms,36,20,16
Ccmeharder,kiljaeden,1298,warrior,arms,30,14,16
Aresmt,illidan,1298,warrior,arms,30,14,16
Badmanego,illidan,1298,warrior,arms,121,56,65
Rekem,malganis,1298,warrior,arms,78,35,43
Bustybucky,tichondrius,1298,warrior,arms,54,17,37
Zeiyah,quelthalas,1297,warrior,arms,28,15,13
Cowsgomerr,tichondrius,1297,warrior,arms,40,16,24
Kitonic,proudmoore,1296,warrior,arms,29,18,11
Toragorr,illidan,1296,warrior,arms,42,21,21
Iromrogar,area-52,1296,warrior,arms,30,14,16
Guitter,nazjatar,1296,warrior,arms,48,20,28
Brontok,darkspear,1295,warrior,arms,70,35,35
Superpot,bleeding-hollow,1295,warrior,arms,55,26,29
Beeny,tichondrius,1295,warrior,arms,33,14,19
Rasazghal,darrowmere,1295,warrior,arms,129,52,77
Darthbjorn,lethon,1294,warrior,arms,48,28,20
Devilsbane,khaz-modan,1294,warrior,arms,90,45,45
Pootyspootz,warsong,1293,warrior,arms,22,15,7
Friends,azjolnerub,1293,warrior,arms,35,19,16
Crú,stormrage,1293,warrior,arms,30,14,16
Angertooth,tichondrius,1293,warrior,arms,30,14,16
Spitfired,kiljaeden,1292,warrior,arms,42,23,19
Weepingdeath,burning-legion,1292,warrior,arms,72,33,39
Noobslayr,wyrmrest-accord,1290,warrior,arms,30,18,12
Ønì,tichondrius,1289,warrior,arms,48,35,13
Chargeback,zuljin,1289,warrior,arms,74,39,35
Odinsglory,mugthol,1289,warrior,arms,194,94,100
Grumok,tichondrius,1289,warrior,arms,57,24,33
Ðigger,rivendare,1288,warrior,arms,48,22,26
Bùlk,barthilas,1288,warrior,arms,130,57,73
Antoníuz,drakkari,1288,warrior,arms,48,20,28
Balakay,drenden,1287,warrior,arms,24,15,9
Bigolpeen,sargeras,1287,warrior,arms,54,32,22
Hikikomori,goldrinn,1287,warrior,arms,65,35,30
Walterwhîte,tichondrius,1287,warrior,arms,30,14,16
Jaens,quelthalas,1287,warrior,arms,50,23,27
Carralee,azralon,1286,warrior,arms,78,46,32
Utheroellin,stormrage,1286,warrior,arms,30,15,15
Saltyundies,tichondrius,1286,warrior,arms,135,59,76
Egargiss,malygos,1285,warrior,arms,24,14,10
Âmânthul,alexstrasza,1285,warrior,arms,252,134,118
Swám,quelthalas,1285,warrior,arms,42,19,23
Hatedßyßlízz,area-52,1285,warrior,arms,54,24,30
Skornnd,malganis,1285,warrior,arms,82,35,47
Ðåddý,stormrage,1285,warrior,arms,41,14,27
Repsey,zuljin,1284,warrior,arms,23,15,8
Valde,stormrage,1284,warrior,arms,27,14,13
Skrot,stormrage,1284,warrior,arms,76,38,38
Lögän,azralon,1284,warrior,arms,36,14,22
Ashrah,emerald-dream,1283,warrior,arms,54,29,25
Dualip,tichondrius,1283,warrior,arms,75,38,37
Excaliburz,frostmourne,1283,warrior,arms,101,48,53
Tsurik,malfurion,1283,warrior,arms,54,23,31
Evencane,stormrage,1283,warrior,arms,35,14,21
Rnkman,quelthalas,1282,warrior,arms,25,16,9
Raserei,moonrunner,1282,warrior,arms,162,86,76
Tobiwan,ragnaros,1282,warrior,arms,53,28,25
Northhill,tichondrius,1282,warrior,arms,132,67,65
Your,emerald-dream,1282,warrior,arms,60,30,30
Swamis,stormreaver,1282,warrior,arms,66,32,34
Kagerou,ragnaros,1282,warrior,arms,62,28,34
Heals,zuljin,1282,warrior,arms,36,15,21
Ibba,khazgoroth,1281,warrior,arms,39,18,21
Ahore,illidan,1281,warrior,arms,57,24,33
Shishokun,quelthalas,1281,warrior,arms,88,35,53
Mussashí,stormrage,1280,warrior,arms,70,41,29
Biggieswords,madoran,1280,warrior,arms,29,16,13
Eudora,stormrage,1280,warrior,arms,84,45,39
Homicideted,frostmourne,1280,warrior,arms,78,40,38
Mickyplate,tichondrius,1279,warrior,arms,84,41,43
Ålbedo,malganis,1279,warrior,arms,35,17,18
Kujø,wyrmrest-accord,1279,warrior,arms,36,17,19
Maywarro,ragnaros,1279,warrior,arms,77,35,42
Thanitose,bleeding-hollow,1279,warrior,arms,33,15,18
Rhâêgâr,tichondrius,1278,warrior,arms,48,26,22
Knghtofseven,nemesis,1278,warrior,arms,78,41,37
Looffy,saurfang,1278,warrior,arms,132,65,67
Onionion,stormrage,1278,warrior,arms,30,14,16
Bfrenzy,dalaran,1278,warrior,arms,42,18,24
Ñors,spinebreaker,1278,warrior,arms,42,16,26
Aintou,aegwynn,1276,warrior,arms,42,20,22
Swiftui,nemesis,1276,warrior,arms,93,41,52
Córnpop,tichondrius,1275,warrior,arms,23,14,9
Putong,tichondrius,1274,warrior,arms,77,41,36
Squeekzz,frostmane,1273,warrior,arms,62,31,31
Titanika,wyrmrest-accord,1273,warrior,arms,88,37,51
Tappia,quelthalas,1273,warrior,arms,42,14,28
Krazyguerra,bleeding-hollow,1272,warrior,arms,48,26,22
Arox,ghostlands,1272,warrior,arms,60,30,30
Dëkm,quelthalas,1272,warrior,arms,41,18,23
Qookymonster,zuljin,1271,warrior,arms,118,60,58
Chawp,emerald-dream,1271,warrior,arms,53,26,27
Broxhar,ragnaros,1270,warrior,arms,59,30,29
Victorhugo,ragnaros,1269,warrior,arms,50,23,27
Hunnam,illidan,1269,warrior,arms,42,16,26
Arthknight,ragnaros,1268,warrior,arms,36,19,17
Ogundados,kelthuzad,1268,warrior,arms,42,18,24
Loucha,nagrand,1268,warrior,arms,75,32,43
Hoboken,quelthalas,1267,warrior,arms,30,17,13
Mfmuggz,thunderlord,1267,warrior,arms,65,32,33
Torkus,ragnaros,1267,warrior,arms,82,39,43
Deadee,aerie-peak,1267,warrior,arms,105,49,56
Hudë,stormrage,1266,warrior,arms,54,28,26
Bdubz,moknathal,1266,warrior,arms,29,14,15
Hoodlord,tichondrius,1266,warrior,arms,66,31,35
Junsus,moon-guard,1266,warrior,arms,95,44,51
Catastrophie,mugthol,1266,warrior,arms,87,39,48
Seshømaru,quelthalas,1264,warrior,arms,26,15,11
Scumrat,frostmourne,1264,warrior,arms,68,33,35
Arrozkonlech,proudmoore,1264,warrior,arms,49,23,26
Timotheapple,stormrage,1264,warrior,arms,32,14,18
Elane,moon-guard,1264,warrior,arms,72,28,44
Ready,laughing-skull,1263,warrior,arms,54,30,24
Daddymoist,moon-guard,1263,warrior,arms,77,39,38
Sherway,quelthalas,1263,warrior,arms,289,146,143
Thelgrath,quelthalas,1263,warrior,arms,136,66,70
Deomer,quelthalas,1263,warrior,arms,42,20,22
Lobsterrj,emerald-dream,1263,warrior,arms,54,21,33
Krimmjðw,sargeras,1263,warrior,arms,36,14,22
Sabini,nemesis,1263,warrior,arms,48,14,34
Aiforix,gorefiend,1262,warrior,arms,75,44,31
Babyguns,tichondrius,1262,warrior,arms,66,29,37
Hazorl,zuljin,1261,warrior,arms,36,20,16
Korlòth,proudmoore,1261,warrior,arms,30,14,16
Viladoht,aegwynn,1261,warrior,arms,30,14,16
Knewty,stormrage,1261,warrior,arms,32,14,18
Laynarri,hyjal,1260,warrior,arms,60,28,32
Irongummy,frostmourne,1260,warrior,arms,72,33,39
Golîath,mannoroth,1260,warrior,arms,91,40,51
Valkyrië,garrosh,1259,warrior,arms,30,16,14
Tribbally,silver-hand,1259,warrior,arms,61,30,31
Vãnzir,wyrmrest-accord,1259,warrior,arms,36,17,19
Monardaid,uldum,1259,warrior,arms,42,17,25
Walmir,shadow-council,1258,warrior,arms,24,15,9
Tämuros,thrall,1258,warrior,arms,64,32,32
Wrathena,khadgar,1258,warrior,arms,55,26,29
Thörir,proudmoore,1258,warrior,arms,64,30,34
Selathiel,burning-blade,1256,warrior,arms,40,16,24
Luckybrother,tichondrius,1255,warrior,arms,116,57,59
Cbum,quelthalas,1255,warrior,arms,72,34,38
Aleniá,tichondrius,1255,warrior,arms,79,37,42
Dúmßlòwn,tichondrius,1255,warrior,arms,171,79,92
Spartaner,shadowsong,1255,warrior,arms,53,19,34
Aelrog,malganis,1254,warrior,arms,224,115,109
Laint,wyrmrest-accord,1254,warrior,arms,146,73,73
Warrshield,ragnaros,1254,warrior,arms,120,58,62
Lilboytroy,korgath,1253,warrior,arms,36,15,21
Croxxs,aegwynn,1253,warrior,arms,50,17,33
Jrodrick,nemesis,1253,warrior,arms,58,19,39
Huri,nemesis,1252,warrior,arms,80,45,35
Tyrantwolf,ragnaros,1252,warrior,arms,69,35,34
Alexitwo,ragnaros,1252,warrior,arms,114,54,60
Jellybomb,sargeras,1251,warrior,arms,234,110,124
Magmaheart,lightbringer,1251,warrior,arms,30,14,16
Cauldrin,bleeding-hollow,1251,warrior,arms,144,67,77
Maimif,korgath,1251,warrior,arms,35,16,19
Hblock,barthilas,1251,warrior,arms,45,16,29
Rodhin,proudmoore,1249,warrior,arms,47,22,25
Çleåvage,stormrage,1249,warrior,arms,60,25,35
Invinciblé,tichondrius,1248,warrior,arms,24,13,11
Stolz,dragonmaw,1248,warrior,arms,42,19,23
Raizzw,ragnaros,1247,warrior,arms,18,13,5
Areaves,moon-guard,1247,warrior,arms,24,13,11
Codyjones,illidan,1247,warrior,arms,24,13,11
Sabotender,suramar,1247,warrior,arms,30,13,17
Marrago,moon-guard,1246,warrior,arms,24,13,11
Callad,tichondrius,1246,warrior,arms,47,22,25
Lilfookur,dalaran,1246,warrior,arms,82,37,45
Schizogeist,malganis,1246,warrior,arms,40,18,22
Sejac,moon-guard,1246,warrior,arms,30,13,17
Spearmisser,stormrage,1246,warrior,arms,30,13,17
Warhji,malganis,1246,warrior,arms,30,13,17
Betterwar,zuljin,1246,warrior,arms,30,13,17
Sleepypie,tichondrius,1245,warrior,arms,18,13,5
Catwar,tichondrius,1245,warrior,arms,18,13,5
Gunjay,sargeras,1245,warrior,arms,27,14,13
Rarelinew,malganis,1244,warrior,arms,18,13,5
Reichbeast,area-52,1244,warrior,arms,18,13,5
Rollz,amanthul,1244,warrior,arms,52,22,30
Dutchyy,frostmourne,1243,warrior,arms,24,13,11
Mokrog,bleeding-hollow,1243,warrior,arms,24,13,11
Malvicious,proudmoore,1243,warrior,arms,24,13,11
Kreyonz,hyjal,1243,warrior,arms,45,23,22
Demðnslayer,kelthuzad,1243,warrior,arms,85,43,42
Nexgenwar,destromath,1243,warrior,arms,30,13,17
Flexinbooty,kelthuzad,1243,warrior,arms,36,13,23
Swoonmixy,frostmourne,1243,warrior,arms,36,13,23
Ystk,tichondrius,1242,warrior,arms,24,13,11
Thunderclapz,stormscale,1242,warrior,arms,30,16,14
Sneeze,kul-tiras,1242,warrior,arms,58,27,31
Skunkz,kelthuzad,1242,warrior,arms,30,13,17
Metalbiff,bleeding-hollow,1242,warrior,arms,30,13,17
Gíal,ragnaros,1242,warrior,arms,64,26,38
Gaydin,eldrethalas,1242,warrior,arms,39,15,24
Queterompo,ragnaros,1241,warrior,arms,98,52,46
Ragedump,shadowsong,1241,warrior,arms,26,13,13
Titanrage,tichondrius,1241,warrior,arms,32,14,18
Boouuaakk,tichondrius,1241,warrior,arms,30,13,17
Qtxd,malganis,1240,warrior,arms,24,13,11
Uglycubano,quelthalas,1240,warrior,arms,36,19,17
Deamonkiller,kelthuzad,1240,warrior,arms,103,45,58
Rahj,caelestrasz,1240,warrior,arms,30,13,17
Jaminos,frostmourne,1240,warrior,arms,51,22,29
Ðhrâgøn,ragnaros,1239,warrior,arms,18,15,3
Airhood,frostmourne,1239,warrior,arms,18,13,5
Psychosicko,tichondrius,1239,warrior,arms,28,15,13
Krostyx,ragnaros,1239,warrior,arms,84,44,40
Mezi,tichondrius,1239,warrior,arms,62,32,30
Mitigation,hyjal,1239,warrior,arms,34,15,19
Retrostorm,illidan,1238,warrior,arms,24,13,11
Ivanovh,quelthalas,1238,warrior,arms,195,98,97
Depthsii,lightbringer,1238,warrior,arms,30,14,16
Superdah,kiljaeden,1238,warrior,arms,84,37,47
Ragelol,icecrown,1237,warrior,arms,24,13,11
Lokiilloo,drakkari,1237,warrior,arms,97,48,49
Deathengine,area-52,1237,warrior,arms,29,14,15
Märx,barthilas,1237,warrior,arms,74,35,39
Wxwxwxwxwxw,illidan,1236,warrior,arms,24,13,11
Jire,shadowmoon,1236,warrior,arms,28,14,14
Nerròk,wyrmrest-accord,1236,warrior,arms,30,13,17
Tallix,smolderthorn,1235,warrior,arms,24,13,11
Rahgnarson,kelthuzad,1235,warrior,arms,42,13,29
Nickfurie,emerald-dream,1234,warrior,arms,24,13,11
Rockedanger,stormrage,1233,warrior,arms,38,22,16
Dieselsauce,stormscale,1233,warrior,arms,42,24,18
Ådolf,sargeras,1233,warrior,arms,38,19,19
Nosfuratuzod,frostmourne,1233,warrior,arms,49,22,27
Standsonkegs,illidan,1233,warrior,arms,30,13,17
Allenwrite,frostmourne,1233,warrior,arms,89,38,51
Grizzlefish,feathermoon,1233,warrior,arms,72,30,42
Lundyswung,silver-hand,1233,warrior,arms,36,13,23
Bananae,stormrage,1232,warrior,arms,21,14,7
Pandaniela,area-52,1232,warrior,arms,30,18,12
Sayuri,frostmourne,1232,warrior,arms,24,13,11
Goldbêrg,malganis,1232,warrior,arms,24,13,11
Heojae,tichondrius,1232,warrior,arms,24,13,11
Vobiscum,drakkari,1232,warrior,arms,30,14,16
Damadar,malganis,1232,warrior,arms,30,13,17
Deesad,azralon,1231,warrior,arms,28,14,14
Hôdû,tichondrius,1231,warrior,arms,87,40,47
Wankcelot,kiljaeden,1231,warrior,arms,48,21,27
Moonsworn,moon-guard,1231,warrior,arms,30,13,17
Siegfriéd,bleeding-hollow,1231,warrior,arms,47,16,31
Shapur,tichondrius,1230,warrior,arms,24,13,11
Broxii,frostmourne,1230,warrior,arms,24,13,11
Savagetko,illidan,1230,warrior,arms,29,13,16
Eternalwill,rexxar,1229,warrior,arms,24,13,11
Ximzhao,quelthalas,1229,warrior,arms,97,45,52
Terók,stormrage,1229,warrior,arms,54,21,33
Thunderbash,thrall,1229,warrior,arms,36,13,23
Awkagar,hyjal,1228,warrior,arms,23,13,10
Asarg,emerald-dream,1227,warrior,arms,36,23,13
Weesten,aerie-peak,1227,warrior,arms,54,29,25
Babyweenis,sargeras,1226,warrior,arms,18,13,5
Pallus,korgath,1226,warrior,arms,24,13,11
Lükë,zuluhed,1226,warrior,arms,24,13,11
Aisinbro,illidan,1226,warrior,arms,30,13,17
Malystik,ragnaros,1225,warrior,arms,93,49,44
Rhydonero,azralon,1224,warrior,arms,89,47,42
Tunchi,runetotem,1224,warrior,arms,90,47,43
Armorlancer,stormrage,1223,warrior,arms,24,13,11
Warrage,kiljaeden,1223,warrior,arms,103,55,48
Philbert,alexstrasza,1223,warrior,arms,123,65,58
Khåyman,illidan,1223,warrior,arms,47,18,29
Iwishiknew,kargath,1222,warrior,arms,36,16,20
Rebelzudo,azralon,1221,warrior,arms,78,44,34
Avesielli,dalaran,1221,warrior,arms,24,13,11
Joed,quelthalas,1221,warrior,arms,120,60,60
Dorianfrost,ravenholdt,1221,warrior,arms,131,49,82
Kuchikilla,borean-tundra,1219,warrior,arms,100,48,52
Sugarpanties,moon-guard,1219,warrior,arms,93,42,51
Bladereaver,sargeras,1218,warrior,arms,24,13,11
Varekai,frostmourne,1218,warrior,arms,74,34,40
Ðwârf,tichondrius,1218,warrior,arms,46,17,29
Royye,blood-furnace,1217,warrior,arms,30,16,14
Jinsol,illidan,1217,warrior,arms,92,43,49
Amrap,dentarg,1217,warrior,arms,43,17,26
Zeldrissx,quelthalas,1217,warrior,arms,50,19,31
Baghatur,tichondrius,1216,warrior,arms,30,15,15
Dungs,emerald-dream,1216,warrior,arms,46,22,24
Pangean,sargeras,1216,warrior,arms,42,18,24
Magarrior,shadowsong,1215,warrior,arms,34,18,16
Akunaswar,dalaran,1215,warrior,arms,89,41,48
Dsz,nemesis,1215,warrior,arms,53,24,29
Rageoverdose,burning-legion,1214,warrior,arms,159,77,82
Tuf,malygos,1214,warrior,arms,66,31,35
Dippindabz,area-52,1213,warrior,arms,47,26,21
Rockystyle,tichondrius,1213,warrior,arms,96,49,47
Loaksz,tichondrius,1213,warrior,arms,30,14,16
Colapse,zuljin,1213,warrior,arms,30,13,17
Truongx,kiljaeden,1212,warrior,arms,24,14,10
Ediict,illidan,1212,warrior,arms,29,13,16
Ashanthaa,kelthuzad,1211,warrior,arms,42,20,22
Thorablade,barthilas,1211,warrior,arms,102,45,57
Brianya,moon-guard,1210,warrior,arms,30,13,17
Winjerrywin,frostwolf,1209,warrior,arms,46,26,20
Gunnaoffxans,sargeras,1209,warrior,arms,30,14,16
Brozown,wildhammer,1209,warrior,arms,32,14,18
Rageloading,amanthul,1208,warrior,arms,36,18,18
Baadomishram,ragnaros,1208,warrior,arms,30,14,16
Kiillwar,smolderthorn,1208,warrior,arms,30,14,16
Soulcalibur,zuljin,1208,warrior,arms,29,13,16
Storkos,moon-guard,1207,warrior,arms,116,60,56
Killgløry,aerie-peak,1207,warrior,arms,63,32,31
Yiffathon,wyrmrest-accord,1207,warrior,arms,87,37,50
Mogruk,stonemaul,1205,warrior,arms,90,44,46
Deadhofe,azuremyst,1205,warrior,arms,33,16,17
Hintofmint,tichondrius,1204,warrior,arms,56,30,26
Menestz,dreadmaul,1204,warrior,arms,100,48,52
Xzqtz,tichondrius,1204,warrior,arms,50,24,26
Skumwarr,moon-guard,1204,warrior,arms,76,32,44
Rawlur,zuljin,1204,warrior,arms,47,17,30
Hkbdynamus,black-dragonflight,1203,warrior,arms,48,21,27
Toky,malganis,1202,warrior,arms,24,13,11
Colnar,stormrage,1202,warrior,arms,30,13,17
Mangler,tichondrius,1202,warrior,arms,72,30,42
Vapòr,frostmourne,1201,warrior,arms,24,14,10
Tolette,quelthalas,1201,warrior,arms,24,13,11
Beiron,ragnaros,1201,warrior,arms,36,18,18
Newtommi,barthilas,1200,warrior,arms,54,27,27
Kapalua,darkspear,1200,warrior,arms,45,21,24
Aspxt,saurfang,1200,warrior,arms,66,30,36
Faiken,quelthalas,1199,warrior,arms,30,19,11
Bloodfx,darkspear,1199,warrior,arms,156,76,80
Friendnoodle,frostmourne,1199,warrior,arms,59,28,31
Aggor,trollbane,1198,warrior,arms,36,13,23
Aclipse,nagrand,1197,warrior,arms,65,34,31
Buliwyff,wyrmrest-accord,1197,warrior,arms,57,28,29
Gorash,gundrak,1197,warrior,arms,117,56,61
Bigcerts,darkspear,1197,warrior,arms,30,13,17
Hàru,illidan,1196,warrior,arms,21,13,8
Koteketzu,ragnaros,1196,warrior,arms,47,29,18
Flexakute,malganis,1196,warrior,arms,24,14,10
Darkhorv,frostmourne,1196,warrior,arms,23,13,10
Shotgunzx,tichondrius,1195,warrior,arms,27,13,14
Bootstraps,hyjal,1195,warrior,arms,90,41,49
Rargou,illidan,1194,warrior,arms,23,13,10
Spincity,stormrage,1194,warrior,arms,42,21,21
Olgran,drakkari,1194,warrior,arms,82,37,45
Iridikron,dalaran,1194,warrior,arms,30,13,17
Degentradorz,area-52,1193,warrior,arms,171,83,88
Saero,ragnaros,1193,warrior,arms,30,13,17
Bersorcker,ragnaros,1193,warrior,arms,86,33,53
Hellus,tichondrius,1193,warrior,arms,42,16,26
Xl,quelthalas,1192,warrior,arms,126,56,70
Slivers,stormrage,1191,warrior,arms,36,18,18
Calynn,frostmourne,1191,warrior,arms,288,137,151
Kiayla,quelthalas,1191,warrior,arms,207,95,112
Ontull,emerald-dream,1191,warrior,arms,42,13,29
Annaliyah,wyrmrest-accord,1190,warrior,arms,66,36,30
Baroque,darkspear,1190,warrior,arms,24,13,11
Diamict,wyrmrest-accord,1190,warrior,arms,127,62,65
Aistine,alterac-mountains,1189,warrior,arms,36,18,18
Kannerhus,quelthalas,1189,warrior,arms,133,64,69
Exist,kaelthas,1187,warrior,arms,36,14,22
Gohawn,hyjal,1186,warrior,arms,37,20,17
Axharafuji,dalvengyr,1186,warrior,arms,78,35,43
Baloraj,barthilas,1185,warrior,arms,36,15,21
Jamajuicedx,thrall,1183,warrior,arms,29,13,16
Thebruce,nemesis,1182,warrior,arms,176,87,89
Rios,jubeithos,1182,warrior,arms,36,14,22
Toxxel,wyrmrest-accord,1182,warrior,arms,83,29,54
Rickyxp,aggramar,1181,warrior,arms,84,38,46
Avoraçado,nemesis,1181,warrior,arms,133,54,79
Flycosmos,tichondrius,1180,warrior,arms,151,75,76
Ogpapabear,stormscale,1179,warrior,arms,81,30,51
Bifilar,frostmourne,1178,warrior,arms,54,23,31
Archonian,stormscale,1177,warrior,arms,40,24,16
Brynjah,azralon,1177,warrior,arms,102,43,59
Orcbreaker,quelthalas,1176,warrior,arms,38,18,20
Aràthor,stormrage,1176,warrior,arms,119,54,65
Ibizà,tichondrius,1176,warrior,arms,48,18,30
Fkndog,tichondrius,1175,warrior,arms,78,36,42
Zarrock,emerald-dream,1174,warrior,arms,26,14,12
Secsecute,moon-guard,1174,warrior,arms,30,13,17
Süspicious,malfurion,1174,warrior,arms,35,14,21
Rrawrr,bleeding-hollow,1172,warrior,arms,48,25,23
Droogust,tichondrius,1172,warrior,arms,30,15,15
Southmariner,malganis,1172,warrior,arms,78,38,40
Anlerrick,frostwolf,1171,warrior,arms,18,13,5
Rauh,emerald-dream,1171,warrior,arms,22,13,9
Haowar,tichondrius,1169,warrior,arms,41,13,28
Rockley,mugthol,1168,warrior,arms,48,19,29
Khâi,tichondrius,1168,warrior,arms,33,13,20
Robotríp,illidan,1167,warrior,arms,88,41,47
Drdrip,shuhalo,1167,warrior,arms,81,36,45
Dissx,illidan,1167,warrior,arms,61,26,35
Seniorsherk,dalaran,1167,warrior,arms,63,26,37
Mnoga,azralon,1167,warrior,arms,61,22,39
Adunken,ragnaros,1165,warrior,arms,30,17,13
Grömäash,ragnaros,1165,warrior,arms,32,13,19
Tsmcsuckmyd,tichondrius,1163,warrior,arms,41,25,16
Puertorc,ragnaros,1163,warrior,arms,36,17,19
Areiden,sargeras,1162,warrior,arms,54,18,36
Condog,stormrage,1161,warrior,arms,30,19,11
Thedargz,trollbane,1161,warrior,arms,140,73,67
Gongos,doomhammer,1161,warrior,arms,207,107,100
Malok,deathwing,1161,warrior,arms,93,41,52
Ãleister,stormrage,1160,warrior,arms,63,25,38
Enthria,illidan,1159,warrior,arms,96,49,47
Dji,tichondrius,1158,warrior,arms,355,172,183
Raokao,senjin,1157,warrior,arms,42,15,27
Angryskeever,garona,1156,warrior,arms,48,25,23
Tomatogodx,sargeras,1156,warrior,arms,31,15,16
Nosetackle,area-52,1156,warrior,arms,67,32,35
Aquannas,bloodscalp,1155,warrior,arms,31,20,11
Cowbøycrytoo,azralon,1155,warrior,arms,124,62,62
Wako,hyjal,1155,warrior,arms,44,22,22
Elpish,ragnaros,1154,warrior,arms,72,34,38
Dollfacelol,bleeding-hollow,1152,warrior,arms,18,12,6
Golodiso,mugthol,1152,warrior,arms,30,12,18
Pathelsonsus,stormrage,1152,warrior,arms,30,12,18
Atomiclol,area-52,1151,warrior,arms,18,12,6
Drashka,ragnaros,1151,warrior,arms,18,12,6
Dpsmachinex,tichondrius,1151,warrior,arms,18,12,6
Scaredwarr,stormrage,1151,warrior,arms,46,25,21
Renaissancex,tichondrius,1151,warrior,arms,24,12,12
Varrior,wyrmrest-accord,1151,warrior,arms,24,12,12
Turecw,illidan,1151,warrior,arms,24,12,12
Njjszn,thrall,1151,warrior,arms,226,110,116
Soultarius,sargeras,1151,warrior,arms,33,13,20
Pkgdtko,tichondrius,1150,warrior,arms,18,12,6
Vezixx,dragonmaw,1150,warrior,arms,30,17,13
Gathzyx,tichondrius,1150,warrior,arms,24,12,12
Intricacy,tichondrius,1150,warrior,arms,24,12,12
Jarheadz,bleeding-hollow,1150,warrior,arms,35,12,23
Jaytoo,illidan,1149,warrior,arms,18,12,6
Gordofofo,azralon,1149,warrior,arms,18,12,6
Adversary,tichondrius,1149,warrior,arms,18,12,6
Iblowloads,illidan,1149,warrior,arms,24,14,10
Doucherocket,kelthuzad,1149,warrior,arms,24,12,12
Chestbrook,icecrown,1148,warrior,arms,18,12,6
Shino,garona,1148,warrior,arms,24,12,12
Fulreck,tichondrius,1148,warrior,arms,24,12,12
Kamuwarr,azralon,1148,warrior,arms,24,12,12
Pezek,thrall,1148,warrior,arms,26,12,14
Genesisblade,illidan,1148,warrior,arms,30,12,18
Vodkagoblin,sargeras,1147,warrior,arms,24,12,12
Misclickëd,dalaran,1147,warrior,arms,24,12,12
Virillius,wyrmrest-accord,1147,warrior,arms,28,13,15
Jianhung,tichondrius,1147,warrior,arms,30,12,18
Elsee,drakkari,1147,warrior,arms,48,12,36
Hektar,tichondrius,1146,warrior,arms,18,12,6
Stompyocouch,mugthol,1146,warrior,arms,21,13,8
Tramplehaste,barthilas,1146,warrior,arms,30,18,12
Nebraskapete,wyrmrest-accord,1146,warrior,arms,24,12,12
Laylowk,tichondrius,1146,warrior,arms,24,12,12
Furryhorv,frostmourne,1146,warrior,arms,24,12,12
Alejandrica,ragnaros,1146,warrior,arms,30,12,18
Løuriet,ragnaros,1146,warrior,arms,30,12,18
Plssaveme,ysera,1146,warrior,arms,68,27,41
Ragnarloðbró,tichondrius,1146,warrior,arms,36,12,24
Itskinggrizz,thrall,1145,warrior,arms,22,13,9
Struka,drakkari,1145,warrior,arms,24,12,12
Phojjangz,tichondrius,1145,warrior,arms,28,13,15
Davlar,ragnaros,1145,warrior,arms,33,14,19
Ðred,blackhand,1145,warrior,arms,30,12,18
Skizoid,kiljaeden,1144,warrior,arms,18,12,6
Skittlesxo,bleeding-hollow,1144,warrior,arms,24,12,12
Notakîd,stormrage,1144,warrior,arms,30,13,17
Funderr,eonar,1144,warrior,arms,45,19,26
Awm,wyrmrest-accord,1144,warrior,arms,30,12,18
Sartin,boulderfist,1144,warrior,arms,42,14,28
Héro,stormrage,1144,warrior,arms,36,12,24
Invared,stormrage,1143,warrior,arms,18,12,6
Bladeblade,burning-blade,1143,warrior,arms,27,12,15
Icestormray,illidan,1143,warrior,arms,30,12,18
Matutekz,ragnaros,1143,warrior,arms,36,12,24
Nibbzy,sargeras,1142,warrior,arms,18,12,6
Lucidx,malfurion,1142,warrior,arms,18,12,6
Realthiccbbw,tichondrius,1142,warrior,arms,24,12,12
Haldeer,shadow-council,1142,warrior,arms,24,12,12
Dracossack,ragnaros,1142,warrior,arms,47,17,30
Stoul,illidan,1141,warrior,arms,36,24,12
Crnogorac,hakkar,1141,warrior,arms,18,12,6
Yisunshin,azralon,1141,warrior,arms,24,12,12
Elmosmash,thrall,1141,warrior,arms,24,12,12
Avalisk,balnazzar,1141,warrior,arms,27,13,14
Strongtall,tichondrius,1141,warrior,arms,36,15,21
Munchiesxqc,exodar,1141,warrior,arms,74,26,48
Saskouach,stormrage,1140,warrior,arms,26,12,14
Brocc,tichondrius,1139,warrior,arms,24,12,12
Empriux,quelthalas,1139,warrior,arms,30,12,18
Gristly,sargeras,1138,warrior,arms,18,12,6
Uzipipe,malfurion,1138,warrior,arms,30,18,12
Baloz,tichondrius,1138,warrior,arms,30,13,17
Bigsquiggle,blackrock,1138,warrior,arms,30,12,18
Thecolor,tichondrius,1138,warrior,arms,36,12,24
Plugz,sargeras,1137,warrior,arms,28,14,14
Aztecvil,drakkari,1137,warrior,arms,30,12,18
Soggynapkin,proudmoore,1136,warrior,arms,30,17,13
Nabii,tichondrius,1136,warrior,arms,30,12,18
Zulgadark,ragnaros,1136,warrior,arms,39,15,24
Bib,malganis,1135,warrior,arms,30,12,18
Drahconian,aggramar,1134,warrior,arms,24,12,12
Shattering,fizzcrank,1134,warrior,arms,24,12,12
Dhano,drakkari,1134,warrior,arms,60,25,35
Alphablade,frostmourne,1134,warrior,arms,30,12,18
Areuz,azralon,1133,warrior,arms,22,13,9
Cocainiouz,dalaran,1133,warrior,arms,54,24,30
Bekilled,frostmourne,1133,warrior,arms,48,20,28
Yamato,skywall,1133,warrior,arms,30,12,18
Tragictonka,stormrage,1133,warrior,arms,30,12,18
Loktarrogar,illidan,1133,warrior,arms,30,12,18
Tripleblack,mugthol,1132,warrior,arms,18,12,6
Diãbel,azralon,1132,warrior,arms,18,12,6
Isildur,nerzhul,1132,warrior,arms,36,20,16
Otheralex,kiljaeden,1132,warrior,arms,24,12,12
Sudavis,alleria,1131,warrior,arms,61,36,25
Édton,area-52,1131,warrior,arms,72,36,36
Spritez,malganis,1131,warrior,arms,70,27,43
Orz,sargeras,1130,warrior,arms,42,15,27
Fugufish,nemesis,1130,warrior,arms,47,16,31
Xyazhiro,ragnaros,1129,warrior,arms,102,47,55
Inunotaysho,quelthalas,1129,warrior,arms,54,22,32
Genesisxp,barthilas,1129,warrior,arms,30,12,18
Irishhammer,malfurion,1129,warrior,arms,41,15,26
Lunks,kelthuzad,1128,warrior,arms,18,12,6
Bulletfodder,tichondrius,1127,warrior,arms,24,12,12
Turkin,proudmoore,1127,warrior,arms,36,13,23
Lilsweet,moon-guard,1126,warrior,arms,51,28,23
Angitu,quelthalas,1124,warrior,arms,24,14,10
Úmarth,azralon,1124,warrior,arms,60,29,31
Raharon,chogall,1124,warrior,arms,61,26,35
Warsins,bonechewer,1124,warrior,arms,39,13,26
Preschool,sargeras,1123,warrior,arms,18,13,5
Croton,moon-guard,1122,warrior,arms,24,12,12
Demetrïus,moon-guard,1122,warrior,arms,30,12,18
Jaimey,malganis,1121,warrior,arms,29,12,17
Ragebladë,tichondrius,1120,warrior,arms,131,72,59
Carrito,perenolde,1120,warrior,arms,53,29,24
Hunchless,detheroc,1120,warrior,arms,82,42,40
Ambiss,azjolnerub,1120,warrior,arms,47,21,26
Slumdawgg,andorhal,1119,warrior,arms,59,32,27
Sarget,ragnaros,1119,warrior,arms,48,24,24
Vaclein,quelthalas,1119,warrior,arms,54,24,30
Grândmâ,zuljin,1119,warrior,arms,36,14,22
Swiftynifty,area-52,1118,warrior,arms,48,29,19
Clovê,ragnaros,1118,warrior,arms,48,27,21
Kì,moon-guard,1118,warrior,arms,160,80,80
Aersasi,tichondrius,1117,warrior,arms,24,13,11
Fabszord,nemesis,1116,warrior,arms,46,25,21
Rahtahtas,area-52,1116,warrior,arms,24,12,12
Buffalobob,bronzebeard,1115,warrior,arms,24,12,12
Bigjanglès,frostmourne,1114,warrior,arms,42,22,20
Hemone,frostmourne,1114,warrior,arms,30,15,15
Ereborh,ragnaros,1114,warrior,arms,24,12,12
Containerbox,korgath,1112,warrior,arms,42,18,24
Casteleiro,azralon,1112,warrior,arms,32,13,19
Alejandros,azgalor,1111,warrior,arms,23,12,11
Éllenor,azralon,1111,warrior,arms,24,12,12
Marcolatus,ragnaros,1111,warrior,arms,143,71,72
Warriorlee,jubeithos,1111,warrior,arms,44,19,25
Starplatinum,aerie-peak,1111,warrior,arms,56,22,34
Brysontiller,frostmourne,1110,warrior,arms,23,12,11
Tyférious,tichondrius,1110,warrior,arms,68,27,41
Wastenott,area-52,1109,warrior,arms,30,19,11
Thedoofy,blackrock,1109,warrior,arms,39,20,19
Spredforbred,area-52,1109,warrior,arms,30,12,18
Locotto,ragnaros,1109,warrior,arms,48,16,32
Marvél,quelthalas,1108,warrior,arms,218,104,114
Rineer,tichondrius,1108,warrior,arms,30,12,18
Youtank,kiljaeden,1105,warrior,arms,78,36,42
Dvhwec,tichondrius,1105,warrior,arms,28,12,16
Digitalpsyko,hyjal,1104,warrior,arms,24,13,11
Stiffysword,tanaris,1104,warrior,arms,41,21,20
Hazew,kelthuzad,1104,warrior,arms,29,12,17
Kenroc,illidan,1102,warrior,arms,24,12,12
Tipincider,perenolde,1100,warrior,arms,21,12,9
Bigsvit,trollbane,1100,warrior,arms,90,43,47
Anotee,kelthuzad,1098,warrior,arms,135,68,67
Lazyclap,nagrand,1098,warrior,arms,71,33,38
Märiä,ragnaros,1097,warrior,arms,64,36,28
Wtbfriends,malganis,1097,warrior,arms,29,15,14
Riga,tichondrius,1097,warrior,arms,51,25,26
Kreeper,farstriders,1097,warrior,arms,28,13,15
Garìk,moon-guard,1097,warrior,arms,99,41,58
Panzerian,area-52,1097,warrior,arms,37,14,23
Forevercute,proudmoore,1096,warrior,arms,23,14,9
Theøcritus,korgath,1096,warrior,arms,42,25,17
Eiendira,proudmoore,1096,warrior,arms,32,13,19
Jägernaught,stormrage,1095,warrior,arms,29,12,17
Rageinice,tichondrius,1094,warrior,arms,53,23,30
Melankoma,sargeras,1094,warrior,arms,30,12,18
Arrogated,emerald-dream,1093,warrior,arms,90,44,46
Helandas,moknathal,1093,warrior,arms,223,109,114
Burgdur,sargeras,1092,warrior,arms,84,36,48
Lunusx,stormrage,1092,warrior,arms,31,12,19
Schwicker,stormrage,1091,warrior,arms,28,12,16
Hagud,tichondrius,1090,warrior,arms,70,28,42
Nanaru,tichondrius,1090,warrior,arms,41,16,25
Charcharbinx,zuljin,1090,warrior,arms,54,21,33
Zolpidem,nemesis,1089,warrior,arms,30,13,17
Racky,dragonmaw,1089,warrior,arms,28,12,16
Padalouh,kelthuzad,1089,warrior,arms,48,19,29
Ujumpijump,andorhal,1089,warrior,arms,84,32,52
Bloren,thrall,1085,warrior,arms,30,14,16
Jiszle,sargeras,1085,warrior,arms,34,12,22
Agresvnapkin,dalaran,1084,warrior,arms,20,12,8
Marconisabio,azralon,1084,warrior,arms,30,12,18
Kempachii,ragnaros,1083,warrior,arms,82,40,42
Bailo,dathremar,1082,warrior,arms,24,12,12
Pingorosho,quelthalas,1082,warrior,arms,48,22,26
Orcopata,ragnaros,1081,warrior,arms,26,12,14
Riuk,goldrinn,1080,warrior,arms,29,16,13
Gorfin,spirestone,1077,warrior,arms,42,12,30
Chisum,gnomeregan,1076,warrior,arms,64,35,29
Mortilant,perenolde,1075,warrior,arms,99,43,56
Xandrak,barthilas,1074,warrior,arms,65,33,32
Several,whisperwind,1073,warrior,arms,39,23,16
Beansgohard,deathwing,1073,warrior,arms,27,12,15
Plsmilkme,zuljin,1072,warrior,arms,24,16,8
Kriegert,illidan,1071,warrior,arms,24,16,8
Ødïñ,sargeras,1071,warrior,arms,75,37,38
Alderr,frostmourne,1071,warrior,arms,30,13,17
Wasabiz,tichondrius,1069,warrior,arms,78,34,44
Armada,sargeras,1068,warrior,arms,25,12,13
Geoorg,ragnaros,1067,warrior,arms,71,28,43
Karroww,thrall,1066,warrior,arms,30,18,12
Kiddoe,rivendare,1066,warrior,arms,107,46,61
Neekka,tichondrius,1065,warrior,arms,38,17,21
Axedeity,caelestrasz,1063,warrior,arms,99,54,45
Krömm,kilrogg,1062,warrior,arms,54,28,26
Thebeastwar,area-52,1062,warrior,arms,66,33,33
Knocks,blackrock,1061,warrior,arms,50,25,25
Ugrundan,zuljin,1061,warrior,arms,48,21,27
Outterspace,illidan,1056,warrior,arms,18,11,7
Midorikwa,area-52,1056,warrior,arms,18,11,7
Kahn,andorhal,1056,warrior,arms,18,11,7
Soyu,tichondrius,1056,warrior,arms,22,12,10
Wizcleavuh,area-52,1056,warrior,arms,24,11,13
Evanx,sargeras,1056,warrior,arms,24,11,13
Kufflinks,kelthuzad,1056,warrior,arms,30,11,19
Hotshótz,kelthuzad,1055,warrior,arms,12,11,1
Pkgd,tichondrius,1055,warrior,arms,12,11,1
Thuggyfresh,malganis,1055,warrior,arms,18,11,7
Gladiator,azshara,1055,warrior,arms,18,11,7
Turtlestorm,tichondrius,1055,warrior,arms,18,11,7
Jeffesptein,tichondrius,1055,warrior,arms,18,11,7
Sonwar,azralon,1055,warrior,arms,18,11,7
Warronin,kaelthas,1055,warrior,arms,18,11,7
Kracha,thrall,1055,warrior,arms,30,15,15
Breyns,garrosh,1055,warrior,arms,25,12,13
Carriney,illidan,1055,warrior,arms,77,36,41
Feedzz,area-52,1055,warrior,arms,24,11,13
Faronstompz,sargeras,1055,warrior,arms,24,11,13
Abomlnatlon,tichondrius,1055,warrior,arms,24,11,13
Duckyuwu,tichondrius,1055,warrior,arms,24,11,13
Imcute,senjin,1055,warrior,arms,78,30,48
Dirkdallas,tichondrius,1055,warrior,arms,30,11,19
Aromar,kiljaeden,1055,warrior,arms,42,15,27
Fallenguardx,sargeras,1054,warrior,arms,18,11,7
Chonbi,tichondrius,1054,warrior,arms,18,11,7
Relaxnerdlol,antonidas,1054,warrior,arms,18,11,7
Vooné,tichondrius,1054,warrior,arms,18,11,7
Executiepie,hyjal,1054,warrior,arms,18,11,7
Chopped,wyrmrest-accord,1054,warrior,arms,18,11,7
Hitmypronoun,illidan,1054,warrior,arms,21,12,9
Eniaan,khaz-modan,1054,warrior,arms,27,13,14
Vexwar,bleeding-hollow,1054,warrior,arms,24,11,13
Tháne,emerald-dream,1054,warrior,arms,24,11,13
Shöthetank,area-52,1054,warrior,arms,30,11,19
Ttl,dalaran,1053,warrior,arms,18,11,7
Anabolics,bleeding-hollow,1053,warrior,arms,18,11,7
Sawsyy,kelthuzad,1053,warrior,arms,27,11,16
Fortchin,area-52,1053,warrior,arms,30,11,19
Adryina,zuljin,1052,warrior,arms,18,11,7
Blornecus,area-52,1052,warrior,arms,18,11,7
Elbelgon,ragnaros,1052,warrior,arms,18,11,7
Roadglide,korgath,1052,warrior,arms,18,11,7
Astrowarrior,tichondrius,1052,warrior,arms,24,11,13
Carrange,moon-guard,1052,warrior,arms,24,11,13
Execute,kirin-tor,1052,warrior,arms,24,11,13
Kaìju,dragonmaw,1052,warrior,arms,24,11,13
Tâte,sargeras,1052,warrior,arms,24,11,13
Hellizzy,sargeras,1052,warrior,arms,30,11,19
Geubsal,tichondrius,1052,warrior,arms,36,11,25
Joaododrøp,azralon,1051,warrior,arms,18,11,7
Kàkarot,illidan,1051,warrior,arms,18,11,7
Envision,frostmourne,1051,warrior,arms,24,11,13
Essofeit,frostmourne,1051,warrior,arms,30,11,19
Drillbit,wyrmrest-accord,1051,warrior,arms,30,11,19
Humminity,quelthalas,1051,warrior,arms,32,11,21
Slasherman,illidan,1051,warrior,arms,36,11,25
Georgedubya,illidan,1051,warrior,arms,36,11,25
Spacepants,azjolnerub,1050,warrior,arms,16,12,4
Angrybulky,illidan,1050,warrior,arms,18,11,7
Rexquando,barthilas,1050,warrior,arms,24,11,13
Crul,gurubashi,1050,warrior,arms,31,11,20
Myceliumlog,frostmourne,1049,warrior,arms,18,11,7
Halis,illidan,1049,warrior,arms,27,16,11
Lololosda,quelthalas,1049,warrior,arms,88,47,41
Arroezze,earthen-ring,1049,warrior,arms,25,12,13
Strongtongue,malganis,1049,warrior,arms,24,11,13
Plagueis,dark-iron,1049,warrior,arms,24,11,13
Purefury,whisperwind,1049,warrior,arms,111,49,62
Gadderhammer,azgalor,1049,warrior,arms,42,17,25
Clortho,korialstrasz,1049,warrior,arms,40,16,24
Wixer,illidan,1048,warrior,arms,18,11,7
Ferdaliance,tichondrius,1048,warrior,arms,18,11,7
Sneakyhand,draktharon,1048,warrior,arms,18,11,7
Snewdawg,malganis,1048,warrior,arms,22,12,10
Jamil,illidan,1048,warrior,arms,156,75,81
Pneumasmash,tichondrius,1048,warrior,arms,24,11,13
Noktyn,haomarush,1048,warrior,arms,24,11,13
Castedien,quelthalas,1048,warrior,arms,36,11,25
Zugmeov,barthilas,1048,warrior,arms,42,11,31
Bøgz,kelthuzad,1047,warrior,arms,18,11,7
Bouk,bloodscalp,1047,warrior,arms,18,11,7
Dwarfanage,tichondrius,1047,warrior,arms,28,12,16
Rankjuan,area-52,1047,warrior,arms,30,11,19
Bjërgsen,azralon,1046,warrior,arms,21,12,9
Prunebery,area-52,1046,warrior,arms,30,16,14
Blaxst,gorgonnash,1046,warrior,arms,30,16,14
Nirax,burning-legion,1046,warrior,arms,26,11,15
Rottlingberg,kelthuzad,1046,warrior,arms,30,11,19
Jfordnever,area-52,1045,warrior,arms,18,11,7
Warrpool,shadowmoon,1045,warrior,arms,18,11,7
Jodoro,malfurion,1045,warrior,arms,24,11,13
Hugz,thrall,1045,warrior,arms,30,11,19
Ggodmyles,lightbringer,1045,warrior,arms,30,11,19
Milkshake,stormrage,1045,warrior,arms,36,11,25
Orphasmic,moon-guard,1044,warrior,arms,36,11,25
Eqz,area-52,1043,warrior,arms,18,11,7
Huggesmash,thaurissan,1043,warrior,arms,24,11,13
Nachobeef,illidan,1043,warrior,arms,24,11,13
Mâmba,thrall,1043,warrior,arms,37,16,21
Svênd,ragnaros,1042,warrior,arms,30,12,18
Alondir,quelthalas,1042,warrior,arms,30,11,19
Creator,dalaran,1041,warrior,arms,24,11,13
Greenmachine,twisting-nether,1040,warrior,arms,30,11,19
Krunchal,terenas,1039,warrior,arms,42,17,25
Tomcruisé,ragnaros,1038,warrior,arms,23,15,8
Dylaiin,kelthuzad,1038,warrior,arms,30,11,19
Prota,gorgonnash,1038,warrior,arms,36,11,25
Wrekkshop,tichondrius,1037,warrior,arms,27,13,14
Wrrx,frostmourne,1037,warrior,arms,24,11,13
Yoknitron,bonechewer,1037,warrior,arms,30,11,19
Ligerii,quelthalas,1036,warrior,arms,24,11,13
Flabergaster,skullcrusher,1036,warrior,arms,30,11,19
Doglegz,saurfang,1035,warrior,arms,30,18,12
Beardoff,sargeras,1034,warrior,arms,40,20,20
Regthar,illidan,1034,warrior,arms,23,11,12
Indoondabeat,azgalor,1034,warrior,arms,32,15,17
Portersz,korgath,1034,warrior,arms,24,11,13
Layoon,azralon,1033,warrior,arms,25,12,13
Nashallo,zuljin,1033,warrior,arms,36,14,22
Mentalape,bleeding-hollow,1033,warrior,arms,30,11,19
Nobowar,tichondrius,1032,warrior,arms,24,11,13
Radeox,ragnaros,1032,warrior,arms,25,11,14
Pegaso,the-underbog,1032,warrior,arms,29,12,17
Kaimana,zuljin,1031,warrior,arms,24,11,13
Stalecrouton,doomhammer,1030,warrior,arms,18,11,7
Potan,thrall,1030,warrior,arms,60,25,35
Bradshaw,sargeras,1029,warrior,arms,42,18,24
Kâyous,tichondrius,1029,warrior,arms,41,13,28
Thråsh,area-52,1028,warrior,arms,66,33,33
Cronie,steamwheedle-cartel,1027,warrior,arms,36,16,20
Yerajmiel,proudmoore,1026,warrior,arms,18,11,7
Blockcheese,illidan,1026,warrior,arms,36,13,23
Dinocrusher,illidan,1024,warrior,arms,18,11,7
Xiaogigi,barthilas,1021,warrior,arms,23,11,12
Unterg,ragnaros,1021,warrior,arms,36,17,19
Nøzerker,kelthuzad,1020,warrior,arms,26,12,14
Macdollibee,barthilas,1017,warrior,arms,42,22,20
Guanyúu,tichondrius,1017,warrior,arms,23,11,12
Rágnárr,ragnaros,1017,warrior,arms,36,15,21
Orcimonde,arthas,1017,warrior,arms,28,11,17
Stygïàn,draenor,1016,warrior,arms,80,45,35
Galuf,malygos,1014,warrior,arms,18,11,7
Gargameld,stormrage,1012,warrior,arms,53,29,24
Coffetea,area-52,1011,warrior,arms,41,25,16
Deathsmirk,illidan,1010,warrior,arms,72,37,35
Psýchótic,tichondrius,1009,warrior,arms,23,11,12
Hexenbæne,tichondrius,1006,warrior,arms,23,11,12
Tsebaoth,quelthalas,1004,warrior,arms,78,38,40
Brutallypwnd,tichondrius,1002,warrior,arms,53,29,24
Gorepig,sargeras,1002,warrior,arms,29,11,18
Imgunnacrum,malganis,1001,warrior,arms,28,14,14
Tandiko,wyrmrest-accord,999,warrior,arms,23,11,12
Borgee,tichondrius,999,warrior,arms,30,12,18
Lieutemajor,nemesis,998,warrior,arms,55,27,28
Yuccaleaptus,area-52,998,warrior,arms,83,31,52
Goofyahwok,doomhammer,998,warrior,arms,33,12,21
Fûry,tichondrius,997,warrior,arms,136,63,73
Altruiel,sargeras,995,warrior,arms,40,20,20
Kyritto,azralon,994,warrior,arms,35,18,17
Vicor,ragnaros,993,warrior,arms,42,22,20
Orkuduro,azralon,993,warrior,arms,77,37,40
Ankhxiety,sargeras,993,warrior,arms,26,12,14
Kiggzs,tichondrius,991,warrior,arms,14,11,3
Tmhinfen,tichondrius,991,warrior,arms,16,11,5
Szee,tichondrius,991,warrior,arms,17,11,6
Billy,area-52,990,warrior,arms,14,11,3
Aggripa,kelthuzad,990,warrior,arms,20,11,9
Kalaxe,quelthalas,990,warrior,arms,36,11,25
Brownman,saurfang,989,warrior,arms,30,12,18
Ulnaz,stormrage,988,warrior,arms,18,12,6
Wardeád,quelthalas,988,warrior,arms,27,11,16
Midge,proudmoore,987,warrior,arms,83,40,43
Warrihoe,stormrage,986,warrior,arms,29,11,18
Brrzrrkrr,twisting-nether,983,warrior,arms,36,18,18
Darkthok,drakkari,982,warrior,arms,34,15,19
Sneaknyoface,sargeras,982,warrior,arms,26,11,15
Reliquia,quelthalas,980,warrior,arms,30,12,18
Josiah,frostmourne,979,warrior,arms,27,13,14
Lokiullr,tichondrius,978,warrior,arms,81,35,46
Jragonmaster,borean-tundra,978,warrior,arms,42,15,27
Tucô,skullcrusher,976,warrior,arms,49,22,27
Onso,ragnaros,976,warrior,arms,28,11,17
Happywarrior,tichondrius,976,warrior,arms,30,11,19
Sudokubrain,tichondrius,974,warrior,arms,19,11,8
Inuyasha,korgath,974,warrior,arms,70,38,32
Bussundas,azralon,974,warrior,arms,96,41,55
Blackstamp,tichondrius,973,warrior,arms,47,23,24
Djfredsd,tichondrius,972,warrior,arms,13,11,2
Swampsmash,barthilas,972,warrior,arms,32,12,20
Ghainemarko,hakkar,970,warrior,arms,30,11,19
Elfmonger,proudmoore,966,warrior,arms,19,11,8
Târtàrûs,tichondrius,966,warrior,arms,60,28,32
Tankdatt,frostmourne,966,warrior,arms,30,12,18
Wondaimon,drakkari,963,warrior,arms,27,12,15
Pvppaul,sargeras,960,warrior,arms,12,10,2
Battousäi,kiljaeden,960,warrior,arms,18,10,8
Escanòr,malganis,960,warrior,arms,18,10,8
Szew,tichondrius,960,warrior,arms,18,10,8
Adios,tichondrius,960,warrior,arms,18,10,8
Nuqupq,tichondrius,960,warrior,arms,18,10,8
Åthos,illidan,960,warrior,arms,18,10,8
Benw,dawnbringer,960,warrior,arms,24,10,14
ßdm,illidan,960,warrior,arms,24,10,14
Wargázm,thrall,960,warrior,arms,24,10,14
Jethrix,kelthuzad,960,warrior,arms,24,10,14
Choppin,sargeras,960,warrior,arms,24,10,14
Fatalian,proudmoore,960,warrior,arms,30,10,20
Lukatim,proudmoore,959,warrior,arms,12,10,2
Xyranica,moon-guard,959,warrior,arms,12,10,2
Bamxz,sargeras,959,warrior,arms,18,10,8
Alkír,zuljin,959,warrior,arms,18,10,8
Warbasher,area-52,959,warrior,arms,18,10,8
Zszszszszs,tichondrius,959,warrior,arms,18,10,8
Tantei,moon-guard,959,warrior,arms,18,10,8
Angrymadman,mannoroth,959,warrior,arms,18,10,8
Velicah,stormrage,959,warrior,arms,18,10,8
Tmjakeful,area-52,959,warrior,arms,18,10,8
Beozerker,thrall,959,warrior,arms,18,10,8
Jelurd,stormrage,959,warrior,arms,18,10,8
Lgnasty,area-52,959,warrior,arms,18,10,8
Imakeupuddin,turalyon,959,warrior,arms,18,10,8
Violence,icecrown,959,warrior,arms,18,10,8
Akenox,area-52,959,warrior,arms,18,10,8
Hellfirearms,tichondrius,959,warrior,arms,18,10,8
Drdelicious,tichondrius,959,warrior,arms,24,10,14
Mikeoxgreen,zuljin,959,warrior,arms,24,10,14
Organge,zuljin,959,warrior,arms,24,10,14
Ggrone,ragnaros,959,warrior,arms,24,10,14
Warfeno,malganis,959,warrior,arms,24,10,14
Dreadworld,bleeding-hollow,959,warrior,arms,24,10,14
Chardz,ragnaros,959,warrior,arms,30,10,20
Zugface,tichondrius,959,warrior,arms,36,10,26
Est,illidan,958,warrior,arms,12,10,2
Arrtorias,quelthalas,958,warrior,arms,12,10,2
Hauce,illidan,958,warrior,arms,18,10,8
Kanchy,sargeras,958,warrior,arms,18,10,8
Twôfour,tichondrius,958,warrior,arms,18,10,8
Cannibalizm,hyjal,958,warrior,arms,18,10,8
Glacierrsz,sargeras,958,warrior,arms,18,10,8
Akylis,tichondrius,958,warrior,arms,18,10,8
Papazugs,kelthuzad,958,warrior,arms,18,10,8
Beatstickz,malganis,958,warrior,arms,24,10,14
Bigdickfever,sargeras,958,warrior,arms,24,10,14
Grimspin,tichondrius,958,warrior,arms,24,10,14
Unwarmas,ragnaros,958,warrior,arms,24,10,14
Kelmor,thunderhorn,958,warrior,arms,30,10,20
Calto,tichondrius,958,warrior,arms,30,10,20
Ghostblood,stormscale,957,warrior,arms,12,10,2
Razakamx,tichondrius,957,warrior,arms,12,10,2
Fugmaface,sargeras,957,warrior,arms,18,10,8
Leapsalp,proudmoore,957,warrior,arms,18,10,8
Whórm,kelthuzad,957,warrior,arms,18,10,8
Tasyn,blackrock,957,warrior,arms,18,10,8
Atuey,area-52,957,warrior,arms,18,10,8
Dypnos,ragnaros,957,warrior,arms,24,10,14
Silywarr,frostmourne,957,warrior,arms,24,10,14
Targos,frostwolf,957,warrior,arms,24,10,14
Rendron,frostmourne,957,warrior,arms,24,10,14
Pootybeef,daggerspine,957,warrior,arms,24,10,14
Dysteriah,frostmourne,957,warrior,arms,30,10,20
Aberwarr,illidan,956,warrior,arms,18,10,8
Topbel,sargeras,956,warrior,arms,18,10,8
Keffdog,laughing-skull,956,warrior,arms,18,10,8
Lòvex,alterac-mountains,956,warrior,arms,60,32,28
Numb,moon-guard,956,warrior,arms,26,11,15
Torbajhorn,moon-guard,956,warrior,arms,24,10,14
Kriegsheer,bleeding-hollow,956,warrior,arms,24,10,14
Smash,frostmane,956,warrior,arms,24,10,14
Warzôg,emerald-dream,956,warrior,arms,24,10,14
Barøneza,stormrage,956,warrior,arms,24,10,14
Kushe,moon-guard,956,warrior,arms,24,10,14
Xdorkie,area-52,956,warrior,arms,30,10,20
Stromkiller,stormrage,955,warrior,arms,18,10,8
Qtrpndwcheez,area-52,955,warrior,arms,18,10,8
Baldain,garrosh,955,warrior,arms,18,10,8
Moffett,illidan,955,warrior,arms,24,10,14
Nanor,zuljin,955,warrior,arms,24,10,14
Theestallion,kiljaeden,954,warrior,arms,18,10,8
Agoro,tichondrius,954,warrior,arms,20,10,10
Chieef,illidan,954,warrior,arms,24,10,14
Roccoz,quelthalas,954,warrior,arms,24,10,14
Antêro,sargeras,954,warrior,arms,42,17,25
Starshattr,bleeding-hollow,954,warrior,arms,30,10,20
Zomars,ragnaros,953,warrior,arms,18,10,8
Coffeebottom,wyrmrest-accord,953,warrior,arms,18,10,8
Pharan,malganis,953,warrior,arms,24,10,14
Honanilana,burning-legion,953,warrior,arms,24,10,14
Zohjira,barthilas,953,warrior,arms,24,10,14
Iamfine,area-52,953,warrior,arms,30,10,20
Thiccsmith,blackrock,952,warrior,arms,18,10,8
Mauler,medivh,952,warrior,arms,24,10,14
Turlesoup,proudmoore,952,warrior,arms,24,10,14
Shadalloo,azralon,952,warrior,arms,24,10,14
Originalpimp,bleeding-hollow,952,warrior,arms,24,10,14
Aziz,kiljaeden,952,warrior,arms,25,10,15
Aaltara,barthilas,951,warrior,arms,18,10,8
Astellios,stormrage,951,warrior,arms,18,10,8
Vvârriôr,barthilas,951,warrior,arms,24,10,14
Ajulacho,ragnaros,951,warrior,arms,24,10,14
Helaume,arathor,950,warrior,arms,18,10,8
Darroma,bleeding-hollow,950,warrior,arms,18,10,8
Discopogo,nemesis,950,warrior,arms,24,10,14
Oppos,lightnings-blade,950,warrior,arms,31,12,19
Rainiki,stormrage,950,warrior,arms,30,11,19
Babybiif,azralon,950,warrior,arms,30,10,20
Tanatos,the-venture-co,949,warrior,arms,42,16,26
Dizzygal,hyjal,947,warrior,arms,24,10,14
Uhredb,aegwynn,946,warrior,arms,42,22,20
Bionikus,nemesis,944,warrior,arms,120,54,66
Gfree,kiljaeden,944,warrior,arms,27,11,16
Lükke,ragnaros,943,warrior,arms,24,10,14
Xarlon,stormrage,942,warrior,arms,27,11,16
Meatdrps,frostmane,941,warrior,arms,26,11,15
Thing,gorgonnash,941,warrior,arms,24,10,14
Bigbouba,jubeithos,941,warrior,arms,36,10,26
Feared,hakkar,940,warrior,arms,23,10,13
Dragmös,nemesis,937,warrior,arms,12,10,2
Stöñè,blackwater-raiders,937,warrior,arms,24,10,14
Cizzik,emerald-dream,936,warrior,arms,18,10,8
Hulkspazz,darkspear,936,warrior,arms,39,18,21
Mariò,area-52,934,warrior,arms,18,10,8
Tyrantt,malganis,934,warrior,arms,54,22,32
Vlanko,tichondrius,933,warrior,arms,24,10,14
Danielss,ragnaros,930,warrior,arms,29,12,17
Pocketaxe,blackwater-raiders,927,warrior,arms,83,40,43
Phoveros,sargeras,927,warrior,arms,23,10,13
Bruze,hellscream,926,warrior,arms,19,11,8
Ragesimp,stormrage,926,warrior,arms,23,10,13
Kalusha,ragnaros,926,warrior,arms,72,29,43
Taigola,aggramar,923,warrior,arms,22,11,11
Lobo,sargeras,918,warrior,arms,88,32,56
Velliena,tichondrius,916,warrior,arms,32,11,21
Whiteclouds,blood-furnace,913,warrior,arms,60,28,32
Rocketbom,tichondrius,911,warrior,arms,23,10,13
Beanstrom,tichondrius,911,warrior,arms,23,10,13
Skarkla,thrall,911,warrior,arms,29,10,19
Beyblade,jubeithos,910,warrior,arms,17,10,7
Loudpee,tichondrius,910,warrior,arms,20,11,9
Nexie,moon-guard,910,warrior,arms,21,10,11
Kzw,illidan,910,warrior,arms,23,10,13
Deathhit,barthilas,907,warrior,arms,18,10,8
Lishajr,malganis,907,warrior,arms,38,19,19
Warbreaker,stormrage,905,warrior,arms,17,10,7
Spitts,frostmourne,904,warrior,arms,21,10,11
Placerqt,ragnaros,903,warrior,arms,26,11,15
Kazatdum,zuljin,902,warrior,arms,24,11,13
Atrocithy,ragnaros,896,warrior,arms,16,10,6
Girioo,thrall,895,warrior,arms,14,10,4
Demonsterz,ravenholdt,895,warrior,arms,22,10,12
Ohjim,stormrage,892,warrior,arms,26,10,16
Pumpuup,bleeding-hollow,890,warrior,arms,48,19,29
Smokezee,barthilas,890,warrior,arms,26,10,16
Machatlan,stormrage,889,warrior,arms,38,18,20
Wallzar,sargeras,887,warrior,arms,20,10,10
Hruum,moknathal,886,warrior,arms,18,10,8
Tankadin,dragonmaw,885,warrior,arms,24,10,14
Faen,anvilmar,883,warrior,arms,22,10,12
Murrdock,nesingwary,882,warrior,arms,20,10,10
Mortalchop,tichondrius,880,warrior,arms,19,10,9
Krokgoldmane,drakkari,878,warrior,arms,60,28,32
Poornub,emerald-dream,875,warrior,arms,19,11,8
Psyrush,area-52,874,warrior,arms,25,10,15
Moosebeef,garrosh,873,warrior,arms,67,32,35
Tôpanga,lightninghoof,873,warrior,arms,31,10,21
Sígmar,dreadmaul,869,warrior,arms,18,10,8
Wreckerr,area-52,869,warrior,arms,26,12,14
Moonyxx,frostmourne,864,warrior,arms,12,9,3
Joker,andorhal,864,warrior,arms,12,9,3
Microraccoon,tichondrius,864,warrior,arms,12,9,3
Tobella,illidan,864,warrior,arms,12,9,3
Iracor,stormrage,864,warrior,arms,12,9,3
Dripgodx,malganis,864,warrior,arms,12,9,3
Dedgamesucks,darkspear,864,warrior,arms,12,9,3
Youngmoneyd,illidan,864,warrior,arms,12,9,3
Skynitez,area-52,864,warrior,arms,12,9,3
Stÿgian,blood-furnace,864,warrior,arms,18,9,9
Warwagon,the-underbog,864,warrior,arms,18,9,9
Solocon,tichondrius,864,warrior,arms,18,9,9
Bbg,bleeding-hollow,864,warrior,arms,18,9,9
Undeadbones,firetree,864,warrior,arms,18,9,9
Alchera,fizzcrank,864,warrior,arms,18,9,9
Böô,tichondrius,864,warrior,arms,18,9,9
Grimfate,boulderfist,864,warrior,arms,18,9,9
Miniraccoon,tichondrius,864,warrior,arms,18,9,9
Óðinnodin,tichondrius,864,warrior,arms,18,9,9
Vanlur,khaz-modan,864,warrior,arms,18,9,9
Gläedr,dalaran,864,warrior,arms,18,9,9
Anklebiter,aerie-peak,864,warrior,arms,18,9,9
Mlau,tichondrius,864,warrior,arms,18,9,9
Oafnir,moon-guard,864,warrior,arms,18,9,9
Dreadtøøth,tichondrius,864,warrior,arms,24,9,15
Pretending,dalaran,864,warrior,arms,24,9,15
Softtofu,illidan,864,warrior,arms,24,9,15
Baye,kargath,864,warrior,arms,24,9,15
Eensy,sargeras,864,warrior,arms,24,9,15
Dustywx,area-52,864,warrior,arms,24,9,15
Boardslide,proudmoore,864,warrior,arms,30,9,21
Durist,tichondrius,864,warrior,arms,36,9,27
Eggheadorc,area-52,863,warrior,arms,12,9,3
Grehk,sargeras,863,warrior,arms,12,9,3
Tinymooie,frostmourne,863,warrior,arms,12,9,3
Stickystorm,proudmoore,863,warrior,arms,16,10,6
Hasbullaa,proudmoore,863,warrior,arms,18,9,9
Balthamel,dunemaul,863,warrior,arms,18,9,9
Primedstrike,wyrmrest-accord,863,warrior,arms,18,9,9
Trén,hydraxis,863,warrior,arms,18,9,9
Zaynafein,emerald-dream,863,warrior,arms,18,9,9
Averagewar,frostwolf,863,warrior,arms,18,9,9
Chrom,illidan,863,warrior,arms,18,9,9
Terneitor,ragnaros,863,warrior,arms,18,9,9
Nosoraki,thrall,863,warrior,arms,18,9,9
Erdnase,ragnaros,863,warrior,arms,18,9,9
Kid,daggerspine,863,warrior,arms,18,9,9
Spartagux,dalaran,863,warrior,arms,18,9,9
Mechagodzila,kiljaeden,863,warrior,arms,18,9,9
Healthpoints,area-52,863,warrior,arms,18,9,9
Spxnk,illidan,863,warrior,arms,18,9,9
Greven,malganis,863,warrior,arms,18,9,9
Demolishier,quelthalas,863,warrior,arms,18,9,9
Mortalstrike,azralon,863,warrior,arms,18,9,9
Coveiro,nemesis,863,warrior,arms,19,9,10
Spincycle,khadgar,863,warrior,arms,21,9,12
Actio,stormrage,863,warrior,arms,24,9,15
Spiritz,illidan,863,warrior,arms,24,9,15
Laochra,aggramar,863,warrior,arms,24,9,15
Dynamiite,bleeding-hollow,863,warrior,arms,24,9,15
Kamigoroshi,crushridge,863,warrior,arms,24,9,15
Geontage,drakkari,863,warrior,arms,24,9,15
Touhen,illidan,863,warrior,arms,24,9,15
Wrecktang,tichondrius,863,warrior,arms,24,9,15
Vrinith,ragnaros,863,warrior,arms,25,9,16
Warwslayer,tichondrius,863,warrior,arms,30,9,21
Xumæ,akama,863,warrior,arms,30,9,21
Qnl,sargeras,862,warrior,arms,16,10,6
Izârâk,frostmourne,862,warrior,arms,18,9,9
Humansmash,thrall,862,warrior,arms,18,9,9
Xargosh,magtheridon,862,warrior,arms,18,9,9
Wargorin,bleeding-hollow,862,warrior,arms,18,9,9
Um,moon-guard,862,warrior,arms,18,9,9
Fatalsfury,tichondrius,862,warrior,arms,18,9,9
Cogsbixby,aerie-peak,862,warrior,arms,18,9,9
Ichigami,kelthuzad,862,warrior,arms,24,9,15
Xurc,gnomeregan,862,warrior,arms,24,9,15
Yamzprime,stormrage,862,warrior,arms,24,9,15
Wárriór,tichondrius,862,warrior,arms,24,9,15
Tbagg,area-52,862,warrior,arms,24,9,15
Shniewind,ragnaros,862,warrior,arms,30,9,21
Arên,ragnaros,861,warrior,arms,18,9,9
Bruxigar,ragnaros,861,warrior,arms,18,9,9
Swolthelas,tichondrius,861,warrior,arms,18,9,9
Gobx,tichondrius,861,warrior,arms,24,9,15
Shínkicker,area-52,861,warrior,arms,24,9,15
Vãryan,frostmourne,861,warrior,arms,24,9,15
Kurgos,quelthalas,860,warrior,arms,18,9,9
Zanicus,bleeding-hollow,860,warrior,arms,18,9,9
Josesilver,quelthalas,860,warrior,arms,18,9,9
Grandtank,veknilash,860,warrior,arms,21,10,11
Stormit,illidan,860,warrior,arms,19,9,10
Jindyn,boulderfist,860,warrior,arms,64,29,35
Layllassa,moon-guard,860,warrior,arms,24,9,15
Lungwar,tichondrius,860,warrior,arms,24,9,15
Marnan,quelthalas,860,warrior,arms,24,9,15
Ultradma,area-52,860,warrior,arms,24,9,15
Kråtøs,nordrassil,860,warrior,arms,24,9,15
Nishtana,quelthalas,859,warrior,arms,18,9,9
Vio,mannoroth,859,warrior,arms,18,9,9
Kiyokó,sargeras,859,warrior,arms,18,9,9
Czartacus,dalaran,858,warrior,arms,20,11,9
Geyaráh,azralon,858,warrior,arms,18,9,9
Féril,ragnaros,858,warrior,arms,18,9,9
Åres,wyrmrest-accord,858,warrior,arms,18,9,9
Corthíus,stormrage,858,warrior,arms,22,10,12
Bachyr,stormrage,858,warrior,arms,24,9,15
Deathstrøke,illidan,858,warrior,arms,30,9,21
Boltmor,stormrage,857,warrior,arms,12,9,3
Tinyguysmall,eredar,857,warrior,arms,22,11,11
Gahii,barthilas,857,warrior,arms,18,9,9
Joshums,warsong,857,warrior,arms,26,10,16
Karusuke,stormrage,857,warrior,arms,24,9,15
Tomcruizes,tichondrius,856,warrior,arms,18,9,9
Sparkye,gallywix,856,warrior,arms,18,9,9
Elliyuh,darkspear,856,warrior,arms,24,10,14
Irøns,arthas,856,warrior,arms,24,9,15
Kvoth,bleeding-hollow,856,warrior,arms,24,9,15
Eorik,stormrage,856,warrior,arms,36,9,27
Daytime,scilla,855,warrior,arms,18,9,9
Théoh,area-52,855,warrior,arms,18,9,9
Coldsnaps,azjolnerub,855,warrior,arms,18,9,9
Bärdock,ragnaros,855,warrior,arms,22,10,12
Tarviss,exodar,855,warrior,arms,32,9,23
Stonnies,bleeding-hollow,854,warrior,arms,18,9,9
Wândêrer,wyrmrest-accord,854,warrior,arms,18,9,9
Garusok,thrall,853,warrior,arms,12,9,3
Kkaell,azralon,852,warrior,arms,18,9,9
Chargekillu,proudmoore,852,warrior,arms,18,9,9
Asiyurekhans,borean-tundra,851,warrior,arms,12,9,3
Trigon,chromaggus,851,warrior,arms,18,9,9
Zetraytus,moon-guard,851,warrior,arms,24,9,15
Ashtien,moon-guard,850,warrior,arms,24,9,15
Marszx,frostmourne,846,warrior,arms,29,9,20
Karadell,emerald-dream,843,warrior,arms,22,10,12
Rafaelwar,drakkari,843,warrior,arms,24,9,15
Lamaril,silvermoon,837,warrior,arms,12,9,3
Saigø,stormrage,833,warrior,arms,24,11,13
Molloywr,kelthuzad,831,warrior,arms,23,9,14
Karrison,azshara,829,warrior,arms,85,41,44
Eskama,hyjal,823,warrior,arms,29,9,20
Hjoz,illidan,822,warrior,arms,16,9,7
Beepboop,malganis,817,warrior,arms,18,9,9
Rexxous,hyjal,815,warrior,arms,27,9,18
Dupaminichav,stormrage,814,warrior,arms,15,9,6
Bargorengar,skullcrusher,814,warrior,arms,78,34,44
Chickntender,stormreaver,813,warrior,arms,11,9,2
Kambrial,zuljin,810,warrior,arms,15,12,3
Scran,sargeras,809,warrior,arms,21,10,11
Paí,nemesis,808,warrior,arms,17,9,8
Gigazug,stormrage,799,warrior,arms,20,9,11
Rahj,saurfang,799,warrior,arms,20,9,11
Fatmân,tichondrius,798,warrior,arms,22,9,13
Alzuga,quelthalas,796,warrior,arms,26,9,17
Dierdris,gnomeregan,795,warrior,arms,19,9,10
Xcal,malganis,795,warrior,arms,20,9,11
Zemdur,azralon,795,warrior,arms,20,9,11
Thagunshow,tichondrius,794,warrior,arms,20,9,11
Ripstorm,emerald-dream,794,warrior,arms,20,9,11
Ruick,wyrmrest-accord,793,warrior,arms,18,9,9
Rizmal,area-52,791,warrior,arms,20,9,11
Vandalizer,sargeras,788,warrior,arms,20,10,10
Joecules,kelthuzad,783,warrior,arms,17,9,8
Koraciá,illidan,780,warrior,arms,19,9,10
Gushyguts,tichondrius,771,warrior,arms,25,9,16
Slaughterx,malganis,768,warrior,arms,12,8,4
Majinnox,wyrmrest-accord,768,warrior,arms,12,8,4
Huangatang,wyrmrest-accord,768,warrior,arms,12,8,4
Wreckfúll,sargeras,768,warrior,arms,12,8,4
Fløkî,azralon,768,warrior,arms,12,8,4
Gabv,shadowmoon,768,warrior,arms,12,8,4
Laggytwodope,kelthuzad,768,warrior,arms,12,8,4
Armsupx,tichondrius,768,warrior,arms,12,8,4
Halibut,kelthuzad,768,warrior,arms,12,8,4
Cjay,bleeding-hollow,768,warrior,arms,12,8,4
Sweeped,darkspear,768,warrior,arms,12,8,4
Perfz,bleeding-hollow,768,warrior,arms,12,8,4
Msallsunday,nerzhul,768,warrior,arms,12,8,4
Clown,andorhal,768,warrior,arms,12,8,4
Optym,onyxia,768,warrior,arms,12,8,4
Mayhém,tichondrius,768,warrior,arms,12,8,4
Patékphilípe,area-52,768,warrior,arms,12,8,4
Cazora,ragnaros,768,warrior,arms,12,8,4
Smallbrainx,tichondrius,768,warrior,arms,12,8,4
Saucebussin,emerald-dream,768,warrior,arms,12,8,4
Zleam,area-52,768,warrior,arms,12,8,4
Iced,tichondrius,768,warrior,arms,12,8,4
Traglos,ragnaros,768,warrior,arms,12,8,4
Gorva,emerald-dream,768,warrior,arms,12,8,4
Zdokk,sargeras,768,warrior,arms,12,8,4
Xaenne,zuljin,768,warrior,arms,12,8,4
Willieruth,stormrage,768,warrior,arms,12,8,4
Sleifx,quelthalas,768,warrior,arms,12,8,4
Thornhardt,frostmourne,768,warrior,arms,12,8,4
Dadslapper,illidan,768,warrior,arms,12,8,4
Grüumsh,drenden,768,warrior,arms,12,8,4
Hoodslam,moon-guard,768,warrior,arms,12,8,4
Staffed,area-52,768,warrior,arms,13,8,5
Wingnut,zuluhed,768,warrior,arms,18,8,10
Ogre,magtheridon,768,warrior,arms,18,8,10
Locorion,zuljin,768,warrior,arms,18,8,10
Tádakatsu,sargeras,768,warrior,arms,18,8,10
Monkeystrike,barthilas,768,warrior,arms,18,8,10
Sabers,mannoroth,768,warrior,arms,18,8,10
Martrios,alexstrasza,768,warrior,arms,18,8,10
Leunitas,shadow-council,768,warrior,arms,18,8,10
Baaltica,ragnaros,768,warrior,arms,18,8,10
Cuddlechamp,barthilas,768,warrior,arms,18,8,10
Soladelor,moon-guard,768,warrior,arms,18,8,10
Espadotas,ragnaros,768,warrior,arms,18,8,10
Stoneball,kiljaeden,768,warrior,arms,18,8,10
Tamajkaz,the-forgotten-coast,768,warrior,arms,18,8,10
Dazuu,illidan,768,warrior,arms,18,8,10
Elkz,tichondrius,768,warrior,arms,18,8,10
Elky,area-52,768,warrior,arms,18,8,10
Gízzmo,tichondrius,768,warrior,arms,18,8,10
Linjunfeng,tichondrius,768,warrior,arms,18,8,10
Chronek,sargeras,768,warrior,arms,18,8,10
Ricksanches,shadowmoon,768,warrior,arms,18,8,10
Cugij,frostmourne,768,warrior,arms,18,8,10
Püsspeepers,kelthuzad,768,warrior,arms,18,8,10
Supermieo,illidan,768,warrior,arms,18,8,10
Elitistx,bleeding-hollow,768,warrior,arms,18,8,10
Finndal,bleeding-hollow,768,warrior,arms,21,9,12
Maldrik,exodar,768,warrior,arms,24,8,16
Majaya,area-52,768,warrior,arms,24,8,16
Smallraccoon,tichondrius,768,warrior,arms,24,8,16
Bornne,doomhammer,768,warrior,arms,30,8,22
Rushee,argent-dawn,767,warrior,arms,12,8,4
Alucardio,turalyon,767,warrior,arms,12,8,4
Mikeyforever,quelthalas,767,warrior,arms,12,8,4
Wantor,lightnings-blade,767,warrior,arms,12,8,4
Letsgosmokes,stormrage,767,warrior,arms,12,8,4
Kixxel,sargeras,767,warrior,arms,12,8,4
Pigblind,azralon,767,warrior,arms,12,8,4
Gränd,frostmourne,767,warrior,arms,12,8,4
Tharez,stormrage,767,warrior,arms,12,8,4
Dukar,crushridge,767,warrior,arms,12,8,4
Daemous,wyrmrest-accord,767,warrior,arms,12,8,4
Blazingguard,stormrage,767,warrior,arms,12,8,4
Warwagon,malganis,767,warrior,arms,12,8,4
Husc,kiljaeden,767,warrior,arms,12,8,4
Papazug,kelthuzad,767,warrior,arms,12,8,4
Silac,drenden,767,warrior,arms,12,8,4
Mongosyco,proudmoore,767,warrior,arms,12,8,4
Domminux,darkspear,767,warrior,arms,12,8,4
Executefreak,illidan,767,warrior,arms,12,8,4
Rúz,illidan,767,warrior,arms,12,8,4
Zédelívery,azralon,767,warrior,arms,16,9,7
Nogèt,frostmourne,767,warrior,arms,18,8,10
Reapr,moonrunner,767,warrior,arms,18,8,10
Dalinare,area-52,767,warrior,arms,18,8,10
Drusillaa,deathwing,767,warrior,arms,18,8,10
Viizer,tichondrius,767,warrior,arms,18,8,10
Batchat,frostmourne,767,warrior,arms,18,8,10
Jódiarias,bleeding-hollow,767,warrior,arms,18,8,10
Fraxxure,proudmoore,767,warrior,arms,18,8,10
Ihazlolstorm,area-52,767,warrior,arms,18,8,10
Jorked,drakkari,767,warrior,arms,18,8,10
Wakaflaka,kiljaeden,767,warrior,arms,18,8,10
Moarbrainz,mannoroth,767,warrior,arms,18,8,10
Æwarrìor,tichondrius,767,warrior,arms,18,8,10
Bean,ragnaros,767,warrior,arms,18,8,10
Houdinix,stormrage,767,warrior,arms,18,8,10
Loxcrow,sargeras,767,warrior,arms,18,8,10
Womanbeaterx,stormrage,767,warrior,arms,18,8,10
Broxar,area-52,767,warrior,arms,18,8,10
Geubsalx,tichondrius,767,warrior,arms,18,8,10
Speedyfarm,sargeras,767,warrior,arms,18,8,10
Slashup,sargeras,767,warrior,arms,18,8,10
Pípe,nemesis,767,warrior,arms,18,8,10
Prontera,illidan,767,warrior,arms,18,8,10
Orgreshin,area-52,767,warrior,arms,21,9,12
Gurtheng,sargeras,767,warrior,arms,19,8,11
Ivory,emerald-dream,767,warrior,arms,24,8,16
Techanina,aerie-peak,767,warrior,arms,24,8,16
Cajual,area-52,767,warrior,arms,24,8,16
Mondëgo,stormrage,767,warrior,arms,24,8,16
Rraw,demon-soul,767,warrior,arms,24,8,16
Brawnforce,shadowsong,767,warrior,arms,24,8,16
Nhojj,veknilash,767,warrior,arms,25,8,17
Headsour,thunderhorn,767,warrior,arms,30,8,22
Bigcracka,illidan,767,warrior,arms,30,8,22
Thesmackboi,sargeras,766,warrior,arms,12,8,4
Horvv,frostmourne,766,warrior,arms,12,8,4
Khrull,khazgoroth,766,warrior,arms,12,8,4
Brodin,maelstrom,766,warrior,arms,12,8,4
Warriorc,laughing-skull,766,warrior,arms,12,8,4
Houk,frostmourne,766,warrior,arms,12,8,4
Jackhanma,kelthuzad,766,warrior,arms,12,8,4
Zhasi,bonechewer,766,warrior,arms,12,8,4
Ragarok,jubeithos,766,warrior,arms,12,8,4
Dáin,azralon,766,warrior,arms,18,8,10
Truecarnage,emerald-dream,766,warrior,arms,18,8,10
Camphump,bleeding-hollow,766,warrior,arms,18,8,10
Sixxqt,malganis,766,warrior,arms,18,8,10
Edalthor,quelthalas,766,warrior,arms,18,8,10
Orthopedic,tichondrius,766,warrior,arms,18,8,10
Javabaenss,tichondrius,766,warrior,arms,18,8,10
Chj,kelthuzad,766,warrior,arms,18,8,10
Hemmyroidz,tichondrius,766,warrior,arms,18,8,10
Sálieri,ragnaros,766,warrior,arms,18,8,10
Sriara,ragnaros,766,warrior,arms,18,8,10
Donnacha,garona,766,warrior,arms,18,8,10
Bigboy,icecrown,766,warrior,arms,18,8,10
Izhansheni,illidan,766,warrior,arms,18,8,10
Zrads,zuljin,766,warrior,arms,19,8,11
Calledon,emerald-dream,766,warrior,arms,24,8,16
Violençe,malganis,766,warrior,arms,24,8,16
Biggieth,sargeras,766,warrior,arms,33,9,24
Modzilla,aerie-peak,766,warrior,arms,30,8,22
Sinergui,nemesis,765,warrior,arms,12,8,4
Léva,ragnaros,765,warrior,arms,12,8,4
Rambð,illidan,765,warrior,arms,12,8,4
Kurgrok,kiljaeden,765,warrior,arms,12,8,4
Percthirty,blackrock,765,warrior,arms,18,8,10
Desertor,illidan,765,warrior,arms,18,8,10
Belladeom,azralon,765,warrior,arms,18,8,10
Ulfioff,whisperwind,765,warrior,arms,18,8,10
Uragiri,shadowsong,765,warrior,arms,18,8,10
Vassild,firetree,765,warrior,arms,18,8,10
Ästen,kargath,765,warrior,arms,18,8,10
Xeto,ragnaros,765,warrior,arms,18,8,10
Maltrate,hyjal,765,warrior,arms,21,9,12
Franklenn,mannoroth,765,warrior,arms,24,8,16
Lui,the-forgotten-coast,765,warrior,arms,24,8,16
Bogrock,frostmourne,764,warrior,arms,12,8,4
Maxprotein,area-52,764,warrior,arms,14,8,6
Kurixu,ragnaros,764,warrior,arms,18,8,10
Alexarchos,chogall,764,warrior,arms,18,8,10
Harattawi,thrall,764,warrior,arms,18,8,10
Nosferagc,frostmourne,764,warrior,arms,21,9,12
Renziass,tichondrius,764,warrior,arms,24,8,16
Theodere,moon-guard,763,warrior,arms,18,8,10
Chamfer,illidan,763,warrior,arms,18,8,10
Luneblade,tichondrius,763,warrior,arms,18,8,10
Sygw,area-52,763,warrior,arms,24,8,16
Goodrik,quelthalas,763,warrior,arms,24,8,16
Shìromìzù,eredar,762,warrior,arms,12,8,4
Tarmer,moon-guard,762,warrior,arms,18,8,10
Sweetdeé,zuljin,762,warrior,arms,18,8,10
Zépileque,azralon,762,warrior,arms,24,8,16
Arktoast,tichondrius,762,warrior,arms,24,8,16
Revenn,greymane,761,warrior,arms,12,8,4
Jårko,dathremar,761,warrior,arms,18,8,10
Trohgdor,sargeras,761,warrior,arms,18,8,10
Lumilis,draenor,760,warrior,arms,18,8,10
Vynfull,area-52,760,warrior,arms,18,8,10
Tekkamanaxe,tichondrius,758,warrior,arms,30,8,22
Badazzdad,thunderhorn,757,warrior,arms,18,8,10
Liiberator,thrall,757,warrior,arms,24,8,16
Trapwar,malganis,755,warrior,arms,12,8,4
Bilmuuri,illidan,754,warrior,arms,27,9,18
Fleshtuxedo,stormrage,752,warrior,arms,12,8,4
Renzokuken,demon-soul,752,warrior,arms,12,8,4
Bratomil,amanthul,751,warrior,arms,18,8,10
Xomis,thrall,750,warrior,arms,17,8,9
Tgnomeless,gilneas,750,warrior,arms,25,8,17
Gladiattor,tol-barad,749,warrior,arms,18,8,10
Kasheeka,spirestone,749,warrior,arms,23,8,15
Dadookibooty,area-52,740,warrior,arms,24,11,13
Ironwarr,hyjal,740,warrior,arms,23,8,15
Vetinari,nazjatar,735,warrior,arms,11,8,3
Casmier,tichondrius,734,warrior,arms,17,8,9
Tánktop,sargeras,733,warrior,arms,14,9,5
Gorakis,barthilas,733,warrior,arms,20,9,11
Turtleofhope,barthilas,720,warrior,arms,15,8,7
Señor,barthilas,719,warrior,arms,15,8,7
Mêlo,area-52,719,warrior,arms,17,8,9
Randywar,tichondrius,719,warrior,arms,21,8,13
Khirr,barthilas,719,warrior,arms,23,8,15
Wreckthis,area-52,718,warrior,arms,17,8,9
Ârmstrong,quelthalas,714,warrior,arms,23,10,13
Alemão,bleeding-hollow,713,warrior,arms,23,9,14
Kimuraa,hyjal,708,warrior,arms,29,10,19
Creamcorn,bleeding-hollow,704,warrior,arms,16,8,8
Insylum,feathermoon,704,warrior,arms,22,8,14
Cptdrako,alterac-mountains,703,warrior,arms,14,8,6
Kforti,kiljaeden,703,warrior,arms,20,8,12
Tabadigbick,bleeding-hollow,698,warrior,arms,17,8,9
Hordrek,moon-guard,688,warrior,arms,13,8,5
Valuxia,sargeras,687,warrior,arms,19,8,11
Earfquake,boulderfist,686,warrior,arms,13,8,5
Greenbrain,dunemaul,685,warrior,arms,19,8,11
Ðeerblack,ragnaros,672,warrior,arms,12,7,5
Bloodshêdz,stormrage,672,warrior,arms,12,7,5
Necrøbutchër,ragnaros,672,warrior,arms,12,7,5
Chøde,barthilas,672,warrior,arms,12,7,5
Ryalaeth,moon-guard,672,warrior,arms,12,7,5
Furìous,stormrage,672,warrior,arms,12,7,5
Magnusz,zuljin,672,warrior,arms,12,7,5
Havocsmash,tichondrius,672,warrior,arms,12,7,5
Fernzie,malganis,672,warrior,arms,12,7,5
Jaysmom,tichondrius,672,warrior,arms,12,7,5
Yrz,malganis,672,warrior,arms,12,7,5
Raeging,area-52,672,warrior,arms,12,7,5
Ischyrós,stormrage,672,warrior,arms,12,7,5
Toungy,kelthuzad,672,warrior,arms,12,7,5
Cuzmyslam,sargeras,672,warrior,arms,12,7,5
Giv,frostmourne,672,warrior,arms,12,7,5
Tunnelvision,garrosh,672,warrior,arms,12,7,5
Hopefulki,duskwood,672,warrior,arms,12,7,5
Chulain,tichondrius,672,warrior,arms,12,7,5
Bullwar,barthilas,672,warrior,arms,12,7,5
Madmartiggan,tichondrius,672,warrior,arms,12,7,5
Doogthunk,mannoroth,672,warrior,arms,12,7,5
Korbles,moon-guard,672,warrior,arms,12,7,5
Madamemarie,stormrage,672,warrior,arms,12,7,5
Slaughtér,tichondrius,672,warrior,arms,12,7,5
Petuniä,zuljin,672,warrior,arms,12,7,5
Gbrz,stormrage,672,warrior,arms,12,7,5
Dehumanized,greymane,672,warrior,arms,12,7,5
Kevy,arygos,672,warrior,arms,12,7,5
Benbtw,malganis,672,warrior,arms,12,7,5
Jahrakál,thunderlord,672,warrior,arms,12,7,5
Mouncha,tichondrius,672,warrior,arms,12,7,5
Sphatic,tichondrius,672,warrior,arms,12,7,5
Arsis,whisperwind,672,warrior,arms,12,7,5
Iammi,skywall,672,warrior,arms,12,7,5
Xdoombringer,area-52,672,warrior,arms,12,7,5
Jypster,stormrage,672,warrior,arms,12,7,5
Executor,mugthol,672,warrior,arms,12,7,5
Deseroth,sargeras,672,warrior,arms,12,7,5
Deathammer,stormrage,672,warrior,arms,12,7,5
Ousetadoidao,nemesis,672,warrior,arms,12,7,5
Edmuula,tichondrius,672,warrior,arms,12,7,5
Jesbar,ragnaros,672,warrior,arms,12,7,5
Nekopara,caelestrasz,672,warrior,arms,12,7,5
Yqoos,tichondrius,672,warrior,arms,12,7,5
Niulaoye,tichondrius,672,warrior,arms,12,7,5
Roiboy,stormrage,672,warrior,arms,12,7,5
Grounyl,azralon,672,warrior,arms,12,7,5
Hinsionzillu,proudmoore,672,warrior,arms,12,7,5
Studdythejet,zuljin,672,warrior,arms,12,7,5
Qutuz,illidan,672,warrior,arms,12,7,5
Spaceslam,tichondrius,672,warrior,arms,12,7,5
Vxjohnson,proudmoore,672,warrior,arms,15,8,7
Kappiz,wyrmrest-accord,672,warrior,arms,14,7,7
Nooniezpw,tichondrius,672,warrior,arms,18,7,11
Aalrua,moon-guard,672,warrior,arms,18,7,11
Infâmous,proudmoore,672,warrior,arms,18,7,11
Goyqqw,illidan,672,warrior,arms,18,7,11
Fatdouglass,sargeras,672,warrior,arms,18,7,11
Sayjaki,stormrage,672,warrior,arms,18,7,11
Kraft,azralon,672,warrior,arms,18,7,11
Orczug,tichondrius,672,warrior,arms,18,7,11
Hårrison,tichondrius,672,warrior,arms,18,7,11
Pressd,frostmourne,672,warrior,arms,18,7,11
Lorewow,quelthalas,672,warrior,arms,18,7,11
Ulamøg,proudmoore,672,warrior,arms,18,7,11
Arquiem,ragnaros,672,warrior,arms,18,7,11
Käggai,khadgar,672,warrior,arms,18,7,11
Stipdip,tichondrius,672,warrior,arms,18,7,11
Jackmonkey,the-forgotten-coast,672,warrior,arms,18,7,11
Ignorebrain,tichondrius,672,warrior,arms,18,7,11
Ryänlord,mugthol,672,warrior,arms,18,7,11
Extremist,nagrand,672,warrior,arms,18,7,11
Hazelbean,tichondrius,672,warrior,arms,18,7,11
July,arthas,672,warrior,arms,18,7,11
Kerrena,kelthuzad,672,warrior,arms,18,7,11
Zuans,azralon,672,warrior,arms,18,7,11
Udmwarrior,zuljin,672,warrior,arms,18,7,11
Doully,proudmoore,672,warrior,arms,18,7,11
Uglyfuq,bleeding-hollow,672,warrior,arms,18,7,11
Rudakoff,ragnaros,672,warrior,arms,18,7,11
Buddypalmer,bleeding-hollow,672,warrior,arms,18,7,11
Achui,cairne,672,warrior,arms,21,8,13
Augutra,moon-guard,672,warrior,arms,24,7,17
Omlas,azralon,672,warrior,arms,24,7,17
Festerclaws,wyrmrest-accord,672,warrior,arms,24,7,17
Pokeyobutt,hydraxis,672,warrior,arms,24,7,17
Paralyzed,malganis,672,warrior,arms,24,7,17
Ggéz,stormrage,672,warrior,arms,24,7,17
Natalieftm,tichondrius,672,warrior,arms,24,7,17
Beifong,barthilas,672,warrior,arms,24,7,17
Corevp,barthilas,672,warrior,arms,24,7,17
Pipeman,blackhand,671,warrior,arms,12,7,5
Exceldoc,frostwolf,671,warrior,arms,12,7,5
Riffralph,quelthalas,671,warrior,arms,12,7,5
Capo,windrunner,671,warrior,arms,12,7,5
Glizzarms,dalaran,671,warrior,arms,12,7,5
Vijit,stormrage,671,warrior,arms,12,7,5
Jedeva,stormrage,671,warrior,arms,12,7,5
Dêsêcratê,frostmourne,671,warrior,arms,12,7,5
Nyokenshi,quelthalas,671,warrior,arms,12,7,5
Furiousangel,area-52,671,warrior,arms,12,7,5
Sosoma,kelthuzad,671,warrior,arms,12,7,5
Ramborco,kelthuzad,671,warrior,arms,12,7,5
Girthstick,eredar,671,warrior,arms,12,7,5
Rhuktar,azralon,671,warrior,arms,12,7,5
Gunnëy,malganis,671,warrior,arms,12,7,5
Blazie,barthilas,671,warrior,arms,12,7,5
Coffeephd,moon-guard,671,warrior,arms,12,7,5
Bingoslam,frostmourne,671,warrior,arms,12,7,5
Maddzspin,tichondrius,671,warrior,arms,12,7,5
Balela,sargeras,671,warrior,arms,12,7,5
Kevinlanders,sargeras,671,warrior,arms,12,7,5
Muugrexe,ragnaros,671,warrior,arms,12,7,5
Dunkindots,tichondrius,671,warrior,arms,12,7,5
Iradri,wyrmrest-accord,671,warrior,arms,12,7,5
Hungdiesel,area-52,671,warrior,arms,12,7,5
Kryssanta,kilrogg,671,warrior,arms,13,7,6
Metaphoric,stormrage,671,warrior,arms,15,8,7
Battosaì,bonechewer,671,warrior,arms,19,9,10
Grazellor,khaz-modan,671,warrior,arms,18,7,11
Nehpets,akama,671,warrior,arms,18,7,11
Andrexion,moon-guard,671,warrior,arms,18,7,11
Dsquarius,emerald-dream,671,warrior,arms,18,7,11
Rembrand,blackhand,671,warrior,arms,18,7,11
Analítico,ragnaros,671,warrior,arms,18,7,11
Chumbinhu,stormrage,671,warrior,arms,18,7,11
Paratech,thrall,671,warrior,arms,18,7,11
Slöppyjoe,blackrock,671,warrior,arms,18,7,11
Conviction,draka,671,warrior,arms,18,7,11
Cj,proudmoore,671,warrior,arms,18,7,11
Bulldozar,zuljin,671,warrior,arms,18,7,11
Aùstin,moon-guard,671,warrior,arms,18,7,11
Dedbeet,barthilas,671,warrior,arms,18,7,11
Iden,vashj,671,warrior,arms,18,7,11
Warriorkofwa,tichondrius,671,warrior,arms,18,7,11
Jeason,ragnaros,671,warrior,arms,18,7,11
Stepzugger,illidan,671,warrior,arms,18,7,11
Mustachelove,bleeding-hollow,671,warrior,arms,18,7,11
Brøxigár,quelthalas,671,warrior,arms,18,7,11
Earnhardt,tichondrius,671,warrior,arms,18,7,11
Mirandakerrx,frostmourne,671,warrior,arms,18,7,11
Bröstörm,bonechewer,671,warrior,arms,18,7,11
Omnifortis,bleeding-hollow,671,warrior,arms,18,7,11
Layøut,azralon,671,warrior,arms,18,7,11
Xeniwar,tichondrius,671,warrior,arms,20,7,13
Antiab,ragnaros,671,warrior,arms,24,7,17
Vandammage,cenarion-circle,671,warrior,arms,24,7,17
Winso,blood-furnace,671,warrior,arms,24,7,17
Powerjaw,stormrage,671,warrior,arms,24,7,17
Zerevik,stormrage,671,warrior,arms,24,7,17
Babyreap,frostmourne,670,warrior,arms,12,7,5
Nraged,illidan,670,warrior,arms,12,7,5
Svantevit,tichondrius,670,warrior,arms,12,7,5
Draggo,tortheldrin,670,warrior,arms,12,7,5
Murrderrface,azgalor,670,warrior,arms,12,7,5
Bryanw,zuljin,670,warrior,arms,12,7,5
Nemezzao,azralon,670,warrior,arms,12,7,5
Eirikdahulk,area-52,670,warrior,arms,12,7,5
Promewar,ragnaros,670,warrior,arms,12,7,5
Deathlokz,proudmoore,670,warrior,arms,12,7,5
Oglethorrpe,dragonmaw,670,warrior,arms,12,7,5
Darquan,trollbane,670,warrior,arms,12,7,5
Mefhes,ragnaros,670,warrior,arms,12,7,5
Pummels,area-52,670,warrior,arms,18,7,11
Kaimera,echo-isles,670,warrior,arms,18,7,11
Aquaknight,tortheldrin,670,warrior,arms,18,7,11
Gìraffe,illidan,670,warrior,arms,18,7,11
Daleo,ragnaros,670,warrior,arms,18,7,11
Powerlift,area-52,670,warrior,arms,24,7,17
Reidahn,zuljin,670,warrior,arms,24,7,17
Torage,wyrmrest-accord,669,warrior,arms,12,7,5
Astrokreep,emerald-dream,669,warrior,arms,12,7,5
Getoffmee,queldorei,669,warrior,arms,18,7,11
Harnor,garrosh,669,warrior,arms,18,7,11
Teyliemond,amanthul,668,warrior,arms,12,7,5
Grokash,azralon,668,warrior,arms,18,7,11
Nepheliloux,amanthul,668,warrior,arms,18,7,11
Pandamoanman,moon-guard,668,warrior,arms,18,7,11
Azaeil,tanaris,668,warrior,arms,18,7,11
Yanïka,barthilas,667,warrior,arms,13,7,6
Raÿnok,ragnaros,667,warrior,arms,16,8,8
Rogkhan,tichondrius,667,warrior,arms,18,7,11
Sienge,tortheldrin,667,warrior,arms,18,7,11
Moøster,aggramar,667,warrior,arms,18,7,11
Kevasaurr,sargeras,667,warrior,arms,24,7,17
Zammuro,sargeras,666,warrior,arms,12,7,5
Fruth,nagrand,666,warrior,arms,30,7,23
Mattrick,hyjal,665,warrior,arms,12,7,5
Terribletom,stormrage,665,warrior,arms,18,7,11
Wnunes,nemesis,665,warrior,arms,18,7,11
Nepharia,kirin-tor,664,warrior,arms,18,7,11
Othon,nemesis,663,warrior,arms,12,7,5
Jötunn,dalaran,663,warrior,arms,12,7,5
Lilwarrior,blackrock,661,warrior,arms,12,7,5
Konstanttine,darkspear,660,warrior,arms,13,7,6
Dragothian,laughing-skull,655,warrior,arms,17,7,10
Skalvi,moon-guard,655,warrior,arms,17,7,10
Blok,malorne,655,warrior,arms,17,7,10
Slaughterist,illidan,652,warrior,arms,24,7,17
Altever,illidan,640,warrior,arms,16,8,8
Pippysmallz,tichondrius,640,warrior,arms,16,7,9
Parmizan,hydraxis,639,warrior,arms,16,7,9
Agnesis,quelthalas,639,warrior,arms,16,7,9
Moostorm,darkspear,639,warrior,arms,17,7,10
Notoriousmmà,illidan,639,warrior,arms,17,7,10
Fewfingers,sargeras,638,warrior,arms,16,7,9
Jamska,quelthalas,638,warrior,arms,17,7,10
Twinxin,thrall,637,warrior,arms,17,7,10
Rametep,illidan,624,warrior,arms,15,7,8
Oohyu,tichondrius,623,warrior,arms,11,7,4
Tildzy,sargeras,623,warrior,arms,11,7,4
Allenwalker,dreadmaul,623,warrior,arms,13,7,6
Haveya,ghostlands,623,warrior,arms,15,7,8
Frntdblbicep,tichondrius,623,warrior,arms,17,7,10
Upro,tichondrius,623,warrior,arms,23,7,16
Bigboycandy,malganis,621,warrior,arms,11,7,4
Bullkathoss,bleeding-hollow,620,warrior,arms,23,8,15
Xunaco,quelthalas,620,warrior,arms,26,7,19
Shabus,moon-guard,617,warrior,arms,21,8,13
Spartanor,darkspear,607,warrior,arms,20,7,13
Pkrage,hellscream,606,warrior,arms,11,7,4
Zeshgarr,jubeithos,606,warrior,arms,22,8,14
Porkasolta,goldrinn,604,warrior,arms,14,7,7
Azyxia,emerald-dream,587,warrior,arms,16,8,8
Suhwoosh,bleeding-hollow,584,warrior,arms,28,10,18
Elpresador,dragonmaw,576,warrior,arms,6,6,0
Dóminus,malfurion,576,warrior,arms,6,6,0
Khalwar,ragnaros,576,warrior,arms,6,6,0
Nada,eredar,576,warrior,arms,6,6,0
Darkoil,illidan,576,warrior,arms,6,6,0
Baltusrol,hydraxis,576,warrior,arms,6,6,0
Chura,kiljaeden,576,warrior,arms,12,6,6
Luminiere,sargeras,576,warrior,arms,12,6,6
Gpro,tichondrius,576,warrior,arms,12,6,6
Blitzø,malganis,576,warrior,arms,12,6,6
Latorre,kelthuzad,576,warrior,arms,12,6,6
Hololeave,tichondrius,576,warrior,arms,12,6,6
Larrythelob,kelthuzad,576,warrior,arms,12,6,6
Raahj,sargeras,576,warrior,arms,12,6,6
Hipower,lethon,576,warrior,arms,12,6,6
Bamlin,sargeras,576,warrior,arms,12,6,6
Stÿgían,kelthuzad,576,warrior,arms,12,6,6
Ogchiken,frostmourne,576,warrior,arms,12,6,6
Aladarith,moon-guard,576,warrior,arms,12,6,6
Aypok,malganis,576,warrior,arms,12,6,6
Hülkamanïa,sargeras,576,warrior,arms,12,6,6
Lathian,sargeras,576,warrior,arms,12,6,6
Armsofury,kelthuzad,576,warrior,arms,12,6,6
Catêyês,kelthuzad,576,warrior,arms,12,6,6
Areiana,stormrage,576,warrior,arms,12,6,6
Murdokkwml,ragnaros,576,warrior,arms,12,6,6
Bonclay,nerzhul,576,warrior,arms,12,6,6
Luckychaos,bleeding-hollow,576,warrior,arms,12,6,6
Desgardius,tichondrius,576,warrior,arms,12,6,6
Pyrælara,shattered-halls,576,warrior,arms,12,6,6
Bedman,tichondrius,576,warrior,arms,12,6,6
Warnazx,azralon,576,warrior,arms,12,6,6
Hitwkey,tichondrius,576,warrior,arms,12,6,6
Toegap,illidan,576,warrior,arms,12,6,6
Screwz,blackrock,576,warrior,arms,12,6,6
Gílly,borean-tundra,576,warrior,arms,12,6,6
Kazabare,tichondrius,576,warrior,arms,12,6,6
Griftustle,moon-guard,576,warrior,arms,12,6,6
Dreamwarr,tichondrius,576,warrior,arms,12,6,6
Illmindofboo,tichondrius,576,warrior,arms,12,6,6
Baynn,frostmourne,576,warrior,arms,12,6,6
Targramu,emerald-dream,576,warrior,arms,12,6,6
Tmgagexx,tichondrius,576,warrior,arms,12,6,6
Breaker,undermine,576,warrior,arms,12,6,6
Dysazter,ravencrest,576,warrior,arms,12,6,6
Señortryhard,area-52,576,warrior,arms,12,6,6
Devastata,jaedenar,576,warrior,arms,12,6,6
Brookiecooki,frostmourne,576,warrior,arms,12,6,6
Madrak,greymane,576,warrior,arms,12,6,6
Linios,tichondrius,576,warrior,arms,12,6,6
Blazight,dunemaul,576,warrior,arms,12,6,6
Trexxen,stormrage,576,warrior,arms,12,6,6
Rattw,area-52,576,warrior,arms,12,6,6
Swiftystorm,thrall,576,warrior,arms,12,6,6
Rikthor,sargeras,576,warrior,arms,12,6,6
Kovarro,stormrage,576,warrior,arms,12,6,6
Sodarzok,thaurissan,576,warrior,arms,12,6,6
Inkurushio,suramar,576,warrior,arms,12,6,6
Brrazze,moon-guard,576,warrior,arms,12,6,6
Reflective,zuljin,576,warrior,arms,12,6,6
Sadomize,kiljaeden,576,warrior,arms,12,6,6
Amortens,area-52,576,warrior,arms,12,6,6
Marîn,stormrage,576,warrior,arms,12,6,6
Ibyessa,emerald-dream,576,warrior,arms,12,6,6
Yenør,stormrage,576,warrior,arms,12,6,6
Jabakas,tichondrius,576,warrior,arms,12,6,6
Szar,stormrage,576,warrior,arms,12,6,6
Clutchclutz,spirestone,576,warrior,arms,12,6,6
Deicide,quelthalas,576,warrior,arms,12,6,6
Ayaseharuqt,quelthalas,576,warrior,arms,12,6,6
Cavence,dalaran,576,warrior,arms,12,6,6
Exeqt,terokkar,576,warrior,arms,12,6,6
Homogenized,area-52,576,warrior,arms,12,6,6
Zingywar,tichondrius,576,warrior,arms,12,6,6
Warsongworg,tichondrius,576,warrior,arms,12,6,6
Flidumpling,tichondrius,576,warrior,arms,12,6,6
Chrig,tichondrius,576,warrior,arms,12,6,6
Stromdart,quelthalas,576,warrior,arms,12,6,6
Rorralyn,moon-guard,576,warrior,arms,12,6,6
Vibrates,stormreaver,576,warrior,arms,12,6,6
Grughak,kiljaeden,576,warrior,arms,12,6,6
Jakslasfa,aegwynn,576,warrior,arms,12,6,6
Gonthoriàn,stormrage,576,warrior,arms,12,6,6
Tàlent,thrall,576,warrior,arms,12,6,6
Dgumby,illidan,576,warrior,arms,12,6,6
Zzode,tichondrius,576,warrior,arms,12,6,6
Spikedudley,wildhammer,576,warrior,arms,12,6,6
Cassetto,icecrown,576,warrior,arms,12,6,6
Glourfindel,quelthalas,576,warrior,arms,12,6,6
Bagginses,quelthalas,576,warrior,arms,12,6,6
Calembo,illidan,576,warrior,arms,12,6,6
Flanrych,illidan,576,warrior,arms,12,6,6
Cleaving,moon-guard,576,warrior,arms,12,6,6
Arozay,illidan,576,warrior,arms,12,6,6
Bailu,ragnaros,576,warrior,arms,12,6,6
Psychescape,cenarius,576,warrior,arms,12,6,6
Rokknark,stormrage,576,warrior,arms,12,6,6
Êraser,tichondrius,576,warrior,arms,12,6,6
Rulz,tichondrius,576,warrior,arms,12,6,6
Orkussw,illidan,576,warrior,arms,12,6,6
Ctc,gilneas,576,warrior,arms,12,6,6
Sigrik,moon-guard,576,warrior,arms,12,6,6
Notskulm,emerald-dream,576,warrior,arms,12,6,6
Mebraindead,tichondrius,576,warrior,arms,12,6,6
Mufasaprime,ursin,576,warrior,arms,12,6,6
Feedmetren,tichondrius,576,warrior,arms,12,6,6
Prìscìlla,stormrage,576,warrior,arms,12,6,6
Sorr,bonechewer,576,warrior,arms,12,6,6
Jerebeloz,proudmoore,576,warrior,arms,12,6,6
Biorhn,area-52,576,warrior,arms,12,6,6
Martiallawl,skullcrusher,576,warrior,arms,12,6,6
Caperage,tichondrius,576,warrior,arms,12,6,6
Assamith,nemesis,576,warrior,arms,12,6,6
Kronathas,stormrage,576,warrior,arms,12,6,6
Róngor,ragnaros,576,warrior,arms,12,6,6
Kushmeister,illidan,576,warrior,arms,12,6,6
Oxxelfer,tichondrius,576,warrior,arms,12,6,6
Undesmadre,ragnaros,576,warrior,arms,12,6,6
Gladdz,moon-guard,576,warrior,arms,12,6,6
Gnomërcy,tichondrius,576,warrior,arms,12,6,6
Dustiezi,stormrage,576,warrior,arms,12,6,6
Xilents,frostmourne,576,warrior,arms,12,6,6
Kuraiaki,crushridge,576,warrior,arms,12,6,6
Zugsok,thrall,576,warrior,arms,12,6,6
Chapux,ragnaros,576,warrior,arms,12,6,6
Sunderstruck,boulderfist,576,warrior,arms,12,6,6
Fatpoos,barthilas,576,warrior,arms,12,6,6
Roflcombo,illidan,576,warrior,arms,12,6,6
Azrailz,stormrage,576,warrior,arms,12,6,6
Feralcut,tichondrius,576,warrior,arms,12,6,6
Guerramacina,tichondrius,576,warrior,arms,13,6,7
Ganzism,tichondrius,576,warrior,arms,13,6,7
Olala,kiljaeden,576,warrior,arms,13,6,7
Cleavxy,sargeras,576,warrior,arms,18,6,12
Erhue,sargeras,576,warrior,arms,18,6,12
Cowboybeast,tanaris,576,warrior,arms,18,6,12
Zingerboss,barthilas,576,warrior,arms,18,6,12
Failnat,area-52,576,warrior,arms,18,6,12
Nightwing,bleeding-hollow,576,warrior,arms,18,6,12
Drakunai,shattered-halls,576,warrior,arms,18,6,12
Nillor,emerald-dream,576,warrior,arms,18,6,12
Fayttful,area-52,576,warrior,arms,18,6,12
Dondà,illidan,576,warrior,arms,18,6,12
Vurk,area-52,576,warrior,arms,18,6,12
Májorrobot,area-52,576,warrior,arms,18,6,12
Robar,trollbane,576,warrior,arms,18,6,12
Rhinð,sargeras,576,warrior,arms,18,6,12
Boozy,barthilas,576,warrior,arms,18,6,12
Sõnics,tichondrius,576,warrior,arms,18,6,12
Egoist,malganis,576,warrior,arms,18,6,12
Kaggorax,tichondrius,576,warrior,arms,18,6,12
Eabywarrs,tichondrius,576,warrior,arms,18,6,12
Aldhard,moon-guard,576,warrior,arms,18,6,12
Ronak,vashj,576,warrior,arms,18,6,12
Xgraves,sargeras,576,warrior,arms,18,6,12
Kennäy,azralon,576,warrior,arms,18,6,12
Irondefense,thrall,576,warrior,arms,18,6,12
Uzy,proudmoore,576,warrior,arms,18,6,12
Mahoneslice,thrall,576,warrior,arms,18,6,12
Ahkimih,ragnaros,576,warrior,arms,18,6,12
Pushh,thrall,576,warrior,arms,18,6,12
Longcutie,tichondrius,576,warrior,arms,18,6,12
Syrupsippin,zuljin,576,warrior,arms,18,6,12
Aidenwr,area-52,576,warrior,arms,18,6,12
Zaxxry,malganis,576,warrior,arms,18,6,12
Psilly,sargeras,576,warrior,arms,18,6,12
Abrakàrn,zuluhed,576,warrior,arms,18,6,12
Stormwald,sargeras,576,warrior,arms,18,6,12
Lieofa,tichondrius,576,warrior,arms,19,6,13
Ezgamelol,azralon,576,warrior,arms,20,6,14
Contentious,moon-guard,576,warrior,arms,24,6,18
Madgrim,tichondrius,576,warrior,arms,24,6,18
Shîzu,moon-guard,576,warrior,arms,24,6,18
Ckranzz,azralon,575,warrior,arms,9,7,2
Matasimio,drakkari,575,warrior,arms,14,7,7
Thornakh,stormrage,575,warrior,arms,12,6,6
Orryn,proudmoore,575,warrior,arms,12,6,6
Tyrall,stormrage,575,warrior,arms,12,6,6
Amérus,moon-guard,575,warrior,arms,12,6,6
Desul,tichondrius,575,warrior,arms,12,6,6
Obstruktíon,tichondrius,575,warrior,arms,12,6,6
Hildibrawn,stormrage,575,warrior,arms,12,6,6
Pandatrue,azralon,575,warrior,arms,12,6,6
Gilisraw,tichondrius,575,warrior,arms,12,6,6
Balthazãr,quelthalas,575,warrior,arms,12,6,6
Tinywx,perenolde,575,warrior,arms,12,6,6
Leturen,area-52,575,warrior,arms,12,6,6
Mekkanic,moon-guard,575,warrior,arms,12,6,6
Cryptikk,tichondrius,575,warrior,arms,12,6,6
Aiöria,ragnaros,575,warrior,arms,12,6,6
Mekaknight,destromath,575,warrior,arms,12,6,6
Weewarrior,wyrmrest-accord,575,warrior,arms,12,6,6
Penryn,illidan,575,warrior,arms,12,6,6
Atømic,illidan,575,warrior,arms,12,6,6
Awöl,jubeithos,575,warrior,arms,12,6,6
Bolx,archimonde,575,warrior,arms,12,6,6
Volnas,earthen-ring,575,warrior,arms,12,6,6
Edgeegee,sargeras,575,warrior,arms,12,6,6
Teyrn,stormrage,575,warrior,arms,12,6,6
Aguìi,quelthalas,575,warrior,arms,12,6,6
Lowag,illidan,575,warrior,arms,12,6,6
Ragefested,tichondrius,575,warrior,arms,12,6,6
Bkdorbandit,illidan,575,warrior,arms,12,6,6
Nospace,tichondrius,575,warrior,arms,12,6,6
Jujuassgeter,darkspear,575,warrior,arms,12,6,6
Redneckk,emerald-dream,575,warrior,arms,12,6,6
Trenbalogna,area-52,575,warrior,arms,12,6,6
Ryukendo,stormrage,575,warrior,arms,12,6,6
Abuse,nordrassil,575,warrior,arms,12,6,6
Vioar,hyjal,575,warrior,arms,12,6,6
Thunderess,illidan,575,warrior,arms,12,6,6
Gimmiefood,emerald-dream,575,warrior,arms,12,6,6
Onisusu,frostmourne,575,warrior,arms,12,6,6
Burntwaffle,ysera,575,warrior,arms,12,6,6
Èxecutè,area-52,575,warrior,arms,15,7,8
Claugoss,azralon,575,warrior,arms,14,6,8
Diesel,duskwood,575,warrior,arms,14,6,8
Chadler,dragonmaw,575,warrior,arms,18,6,12
Slamchowdy,tichondrius,575,warrior,arms,18,6,12
Gotcrit,blood-furnace,575,warrior,arms,18,6,12
Agamere,stormrage,575,warrior,arms,18,6,12
Opalert,tichondrius,575,warrior,arms,18,6,12
Dede,darkspear,575,warrior,arms,18,6,12
PlayerNTCVKN,moonrunner,575,warrior,arms,18,6,12
Orckims,tichondrius,575,warrior,arms,18,6,12
Axemurdera,frostmourne,575,warrior,arms,18,6,12
Nukee,tichondrius,575,warrior,arms,18,6,12
Bersk,sargeras,575,warrior,arms,24,6,18
Darkshrek,quelthalas,574,warrior,arms,12,6,6
Percanator,aggramar,574,warrior,arms,12,6,6
Mubun,tichondrius,574,warrior,arms,12,6,6
Liltoastyy,illidan,574,warrior,arms,12,6,6
Masami,moon-guard,574,warrior,arms,18,6,12
Warmaghar,azralon,574,warrior,arms,18,6,12
Antonios,drakthul,574,warrior,arms,30,6,24
Irgon,quelthalas,573,warrior,arms,12,6,6
Unbeaten,malganis,573,warrior,arms,12,6,6
Logohn,wyrmrest-accord,573,warrior,arms,12,6,6
Chrysion,moon-guard,573,warrior,arms,12,6,6
Dúmp,stormrage,573,warrior,arms,12,6,6
Môgwai,kelthuzad,573,warrior,arms,12,6,6
Brosèph,sargeras,573,warrior,arms,18,6,12
Girei,ghostlands,573,warrior,arms,18,6,12
Cartou,stormscale,573,warrior,arms,24,6,18
Johnsnake,sargeras,572,warrior,arms,12,6,6
Alrage,stormrage,572,warrior,arms,12,6,6
Faóra,moon-guard,572,warrior,arms,12,6,6
Reginato,ravenholdt,572,warrior,arms,18,6,12
Bitiatus,scilla,572,warrior,arms,18,6,12
Tatsher,turalyon,571,warrior,arms,12,6,6
Rudiblade,dalaran,571,warrior,arms,12,6,6
Fexis,queldorei,571,warrior,arms,30,6,24
Acanof,azjolnerub,565,warrior,arms,15,7,8
Ciran,azralon,564,warrior,arms,18,6,12
Conchalover,illidan,559,warrior,arms,17,6,11
Stormfuhrer,stormrage,559,warrior,arms,21,7,14
Lïnkzq,frostmourne,558,warrior,arms,10,7,3
Berserko,gurubashi,558,warrior,arms,21,8,13
Hrothtyr,kelthuzad,552,warrior,arms,24,9,15
Ecopolis,azshara,544,warrior,arms,16,6,10
Ballzindeep,tichondrius,543,warrior,arms,8,7,1
Tastyskeet,illidan,543,warrior,arms,11,6,5
Trevvel,proudmoore,543,warrior,arms,11,6,5
Tâlos,ysondre,543,warrior,arms,11,6,5
Tecnowar,quelthalas,543,warrior,arms,17,6,11
Ragerok,bleeding-hollow,542,warrior,arms,22,7,15
Ðean,quelthalas,528,warrior,arms,15,6,9
Jÿp,tichondrius,527,warrior,arms,11,6,5
Ledezma,proudmoore,527,warrior,arms,17,6,11
Bimbor,azralon,527,warrior,arms,17,6,11
Warwik,stormscale,527,warrior,arms,17,6,11
Lazric,area-52,524,warrior,arms,15,6,9
Meadsweats,tichondrius,522,warrior,arms,17,10,7
Bersérk,area-52,522,warrior,arms,14,8,6
Vids,aegwynn,522,warrior,arms,15,7,8
Tomcruz,bloodscalp,522,warrior,arms,16,7,9
Hrókr,kiljaeden,522,warrior,arms,19,8,11
Shaydeen,black-dragonflight,521,warrior,arms,15,7,8
Swafty,daggerspine,519,warrior,arms,17,9,8
Rhok,elune,515,warrior,arms,16,9,7
Mindfreaklol,nemesis,514,warrior,arms,23,8,15
Protologist,chogall,512,warrior,arms,16,6,10
Duumgai,ghostlands,512,warrior,arms,22,6,16
Illicitiri,sargeras,511,warrior,arms,10,6,4
Zandara,kelthuzad,511,warrior,arms,10,6,4
Kvobash,area-52,511,warrior,arms,11,6,5
Samoksk,ragnaros,511,warrior,arms,11,6,5
Jackjaeger,area-52,511,warrior,arms,16,6,10
Berzerc,stormrage,511,warrior,arms,18,6,12
Ruiend,bonechewer,510,warrior,arms,14,6,8
Tyraelius,kiljaeden,510,warrior,arms,17,6,11
Zachw,stormrage,495,warrior,arms,13,6,7
Warlapse,emerald-dream,494,warrior,arms,13,6,7
Bootypound,sargeras,480,warrior,arms,6,5,1
Byvo,stormrage,480,warrior,arms,6,5,1
Kushian,tichondrius,480,warrior,arms,6,5,1
Ghostemane,whisperwind,480,warrior,arms,6,5,1
Zügnificent,area-52,480,warrior,arms,6,5,1
Pavv,malganis,480,warrior,arms,6,5,1
Ryü,khaz-modan,480,warrior,arms,6,5,1
Tinymo,archimonde,480,warrior,arms,6,5,1
Jackox,sargeras,480,warrior,arms,6,5,1
Isoln,tichondrius,480,warrior,arms,6,5,1
Theentity,mannoroth,480,warrior,arms,6,5,1
Noor,tichondrius,480,warrior,arms,6,5,1
Trojanx,malganis,480,warrior,arms,6,5,1
Damore,sargeras,480,warrior,arms,6,5,1
Saladin,gnomeregan,480,warrior,arms,6,5,1
Meatsweatx,stormrage,480,warrior,arms,6,5,1
Rickywarx,illidan,480,warrior,arms,6,5,1
Zerøhøùr,kul-tiras,480,warrior,arms,6,5,1
Noreaga,tichondrius,480,warrior,arms,6,5,1
Jarlaix,dragonmaw,480,warrior,arms,6,5,1
Biggesttoees,tichondrius,480,warrior,arms,6,5,1
Geàrbreaker,tichondrius,480,warrior,arms,6,5,1
Flexecute,area-52,480,warrior,arms,6,5,1
Warmgun,quelthalas,480,warrior,arms,6,5,1
Crookedface,area-52,480,warrior,arms,6,5,1
Ångelman,tichondrius,480,warrior,arms,6,5,1
Billythunda,tichondrius,480,warrior,arms,6,5,1
Xruntz,kelthuzad,480,warrior,arms,6,5,1
Tehnklo,malorne,480,warrior,arms,6,5,1
Olbus,tichondrius,480,warrior,arms,6,5,1
Demetryuz,azralon,480,warrior,arms,6,5,1
Moè,frostmourne,480,warrior,arms,10,6,4
Warpenguin,kelthuzad,480,warrior,arms,10,6,4
Skaaxx,barthilas,480,warrior,arms,10,6,4
Whittyxc,tichondrius,480,warrior,arms,9,5,4
Toddlovesu,kelthuzad,480,warrior,arms,12,5,7
Cabi,frostmourne,480,warrior,arms,12,5,7
Thaedes,kelthuzad,480,warrior,arms,12,5,7
Arcâdio,cairne,480,warrior,arms,12,5,7
Kð,zuljin,480,warrior,arms,12,5,7
Drudw,moon-guard,480,warrior,arms,12,5,7
Jäëgër,moon-guard,480,warrior,arms,12,5,7
Téry,dalaran,480,warrior,arms,12,5,7
Trevmo,bloodscalp,480,warrior,arms,12,5,7
Flëët,tichondrius,480,warrior,arms,12,5,7
Buffwar,tichondrius,480,warrior,arms,12,5,7
Kiladrew,korgath,480,warrior,arms,12,5,7
Excalibruh,frostmourne,480,warrior,arms,12,5,7
Nedstarc,laughing-skull,480,warrior,arms,12,5,7
Críxus,sargeras,480,warrior,arms,12,5,7
Kluster,kelthuzad,480,warrior,arms,12,5,7
Mimiu,ragnaros,480,warrior,arms,12,5,7
Emraldfury,darkspear,480,warrior,arms,12,5,7
Juggernäut,malganis,480,warrior,arms,12,5,7
Kaikah,aegwynn,480,warrior,arms,12,5,7
Shadowsea,dragonblight,480,warrior,arms,12,5,7
Agoge,stormrage,480,warrior,arms,12,5,7
Bloodxfrenzy,silvermoon,480,warrior,arms,12,5,7
Kethsel,ragnaros,480,warrior,arms,12,5,7
Karik,proudmoore,480,warrior,arms,12,5,7
Robertolini,moon-guard,480,warrior,arms,12,5,7
Nazgrull,wildhammer,480,warrior,arms,12,5,7
Astrálís,nemesis,480,warrior,arms,12,5,7
Schoolbuhs,tichondrius,480,warrior,arms,12,5,7
Paulhëyman,sargeras,480,warrior,arms,12,5,7
Biggiesmash,bleeding-hollow,480,warrior,arms,12,5,7
Phyriix,stormrage,480,warrior,arms,12,5,7
Cpudemon,undermine,480,warrior,arms,12,5,7
Corazondleón,ragnaros,480,warrior,arms,12,5,7
Philipjoo,illidan,480,warrior,arms,12,5,7
Spirìt,illidan,480,warrior,arms,12,5,7
Madhouse,tanaris,480,warrior,arms,12,5,7
Gävilar,sargeras,480,warrior,arms,12,5,7
Lru,whisperwind,480,warrior,arms,12,5,7
Crushingnews,sargeras,480,warrior,arms,12,5,7
Sigismundd,bonechewer,480,warrior,arms,12,5,7
Stinkktoe,tichondrius,480,warrior,arms,12,5,7
Whytea,cairne,480,warrior,arms,12,5,7
Sosaalmigh,tichondrius,480,warrior,arms,12,5,7
Slamoholic,turalyon,480,warrior,arms,12,5,7
Shádo,darkspear,480,warrior,arms,12,5,7
Peters,malfurion,480,warrior,arms,12,5,7
Igoon,dentarg,480,warrior,arms,12,5,7
Beleña,dalaran,480,warrior,arms,12,5,7
Matumbo,skullcrusher,480,warrior,arms,12,5,7
Flexxinpapi,exodar,480,warrior,arms,12,5,7
Tâlos,magtheridon,480,warrior,arms,12,5,7
Lanco,kiljaeden,480,warrior,arms,12,5,7
Bariotyr,the-underbog,480,warrior,arms,12,5,7
Soneoak,frostmourne,480,warrior,arms,12,5,7
Sylvanos,arthas,480,warrior,arms,12,5,7
Ponygon,quelthalas,480,warrior,arms,12,5,7
Daedrion,dalaran,480,warrior,arms,12,5,7
Waroes,emerald-dream,480,warrior,arms,12,5,7
Zuiken,kiljaeden,480,warrior,arms,12,5,7
Thedeejoner,caelestrasz,480,warrior,arms,12,5,7
Executeprocz,frostmourne,480,warrior,arms,12,5,7
Huleo,tichondrius,480,warrior,arms,12,5,7
Neth,arthas,480,warrior,arms,12,5,7
Karlsabad,medivh,480,warrior,arms,12,5,7
Qwort,moon-guard,480,warrior,arms,12,5,7
Ramisés,stormrage,480,warrior,arms,12,5,7
Dillý,area-52,480,warrior,arms,12,5,7
Secondbro,tichondrius,480,warrior,arms,12,5,7
Biggrizz,area-52,480,warrior,arms,12,5,7
Loveføx,stormrage,480,warrior,arms,12,5,7
Shyghy,stormrage,480,warrior,arms,12,5,7
Vmill,tichondrius,480,warrior,arms,12,5,7
Shrëkslovaki,tichondrius,480,warrior,arms,12,5,7
Glenn,tichondrius,480,warrior,arms,12,5,7
Vãnth,kelthuzad,480,warrior,arms,12,5,7
Crogosh,quelthalas,480,warrior,arms,12,5,7
Crammed,tichondrius,480,warrior,arms,12,5,7
Potatocannon,kelthuzad,480,warrior,arms,12,5,7
Hìtchslap,tichondrius,480,warrior,arms,12,5,7
Ericthegreat,azuremyst,480,warrior,arms,12,5,7
Brickhouse,tichondrius,480,warrior,arms,12,5,7
Jkasdfglkg,tichondrius,480,warrior,arms,12,5,7
Bootysmelly,mannoroth,480,warrior,arms,12,5,7
Wën,stormrage,480,warrior,arms,12,5,7
Gonzwold,drenden,480,warrior,arms,12,5,7
Sideon,frostmourne,480,warrior,arms,12,5,7
Beerstorm,stormrage,480,warrior,arms,12,5,7
Stillgrinnin,galakrond,480,warrior,arms,12,5,7
Holmgang,frostmourne,480,warrior,arms,12,5,7
Metalhog,sargeras,480,warrior,arms,12,5,7
Huricas,arthas,480,warrior,arms,12,5,7
Manbok,tichondrius,480,warrior,arms,12,5,7
Takenotez,sargeras,480,warrior,arms,12,5,7
Pandaxes,proudmoore,480,warrior,arms,12,5,7
Meatspinner,sargeras,480,warrior,arms,12,5,7
Maniel,greymane,480,warrior,arms,12,5,7
Scozziee,barthilas,480,warrior,arms,12,5,7
Wonbin,moon-guard,480,warrior,arms,12,5,7
Wcb,sargeras,480,warrior,arms,12,5,7
Smashbashdie,stormrage,480,warrior,arms,12,5,7
Martydom,proudmoore,480,warrior,arms,12,5,7
Consolidate,hyjal,480,warrior,arms,12,5,7
Shwip,tichondrius,480,warrior,arms,12,5,7
Andrismash,barthilas,480,warrior,arms,12,5,7
Thehóund,area-52,480,warrior,arms,12,5,7
Quinntis,anvilmar,480,warrior,arms,12,5,7
Gromlette,trollbane,480,warrior,arms,12,5,7
Claponomics,area-52,480,warrior,arms,12,5,7
Thiccowman,area-52,480,warrior,arms,12,5,7
Hemkcus,zuluhed,480,warrior,arms,12,5,7
Loudnoise,frostwolf,480,warrior,arms,12,5,7
Powerrager,amanthul,480,warrior,arms,12,5,7
Justicwar,area-52,480,warrior,arms,12,5,7
Miniwarkingx,tichondrius,480,warrior,arms,12,5,7
Lüxord,quelthalas,480,warrior,arms,12,5,7
Lokgur,gallywix,480,warrior,arms,12,5,7
Mayshowgunmo,tichondrius,480,warrior,arms,12,5,7
Pregnannie,barthilas,480,warrior,arms,12,5,7
Milbën,tichondrius,480,warrior,arms,12,5,7
Orcbum,kiljaeden,480,warrior,arms,12,5,7
Ffrog,tichondrius,480,warrior,arms,12,5,7
Zuggernaut,shadowsong,480,warrior,arms,12,5,7
Clamjammed,thrall,480,warrior,arms,12,5,7
Tyragyz,azralon,480,warrior,arms,12,5,7
Tiitlefight,bleeding-hollow,480,warrior,arms,12,5,7
Greyknights,kiljaeden,480,warrior,arms,12,5,7
Elkinss,tichondrius,480,warrior,arms,12,5,7
Dwenlocklv,barthilas,480,warrior,arms,12,5,7
Momano,frostmourne,480,warrior,arms,12,5,7
Felorelea,moon-guard,480,warrior,arms,12,5,7
Oledcktwist,garrosh,480,warrior,arms,13,5,8
Mág,burning-legion,480,warrior,arms,13,5,8
Zibby,malganis,480,warrior,arms,14,5,9
Tigershárk,tichondrius,480,warrior,arms,16,5,11
Goaco,drakkari,480,warrior,arms,18,5,13
Cyllyzie,emerald-dream,480,warrior,arms,18,5,13
Tsathoggua,kiljaeden,480,warrior,arms,18,5,13
Øvrpwrd,frostmourne,480,warrior,arms,18,5,13
Smackify,stormrage,480,warrior,arms,18,5,13
Ravager,ragnaros,480,warrior,arms,18,5,13
Skyanidas,korgath,480,warrior,arms,18,5,13
Seppukush,quelthalas,480,warrior,arms,18,5,13
Crimsóñ,kelthuzad,480,warrior,arms,18,5,13
Oofta,kelthuzad,480,warrior,arms,18,5,13
Reifrayton,ragnaros,480,warrior,arms,18,5,13
Eightydeuce,bonechewer,480,warrior,arms,18,5,13
Imprw,stormrage,480,warrior,arms,18,5,13
Osannd,tichondrius,480,warrior,arms,18,5,13
Shaynaynay,tichondrius,480,warrior,arms,18,5,13
Aldathion,argent-dawn,480,warrior,arms,18,5,13
Kkuzo,bleeding-hollow,480,warrior,arms,18,5,13
Bigwarrior,stonemaul,480,warrior,arms,19,5,14
Bornclueless,illidan,480,warrior,arms,21,5,16
Creannew,drakkari,480,warrior,arms,24,5,19
Lorinzer,zuljin,480,warrior,arms,24,5,19
Asidieslowly,tichondrius,479,warrior,arms,6,5,1
Sarkhan,zuluhed,479,warrior,arms,6,5,1
Tanger,korgath,479,warrior,arms,6,5,1
Rinngo,proudmoore,479,warrior,arms,6,5,1
Trufsoturi,bleeding-hollow,479,warrior,arms,12,5,7
Razgorkul,illidan,479,warrior,arms,12,5,7
Têzeret,shadowmoon,479,warrior,arms,12,5,7
Fwengli,illidan,479,warrior,arms,12,5,7
Dirtyrandy,zuluhed,479,warrior,arms,12,5,7
Bovisrex,shadow-council,479,warrior,arms,12,5,7
Luckstang,zuljin,479,warrior,arms,12,5,7
Maudlewis,bladefist,479,warrior,arms,12,5,7
Qqmachine,tichondrius,479,warrior,arms,12,5,7
Stretchytime,emerald-dream,479,warrior,arms,12,5,7
Synestira,frostmourne,479,warrior,arms,12,5,7
Pythons,skullcrusher,479,warrior,arms,12,5,7
Warstik,malganis,479,warrior,arms,12,5,7
Skragg,chogall,479,warrior,arms,12,5,7
Cueromodel,ragnaros,479,warrior,arms,12,5,7
Rücküs,tichondrius,479,warrior,arms,12,5,7
Spliff,ghostlands,479,warrior,arms,12,5,7
Reishera,stormrage,479,warrior,arms,12,5,7
Spàcetìme,stormrage,479,warrior,arms,12,5,7
Unphased,area-52,479,warrior,arms,12,5,7
Helscreem,hyjal,479,warrior,arms,18,5,13
Tentacruels,area-52,479,warrior,arms,18,5,13
ßlindãø,azralon,479,warrior,arms,18,5,13
Kanicky,draka,479,warrior,arms,18,5,13
Flexecute,senjin,479,warrior,arms,18,5,13
Gorrthrax,area-52,479,warrior,arms,24,5,19
Arooy,azralon,478,warrior,arms,6,5,1
Dirtywarrior,lightnings-blade,478,warrior,arms,12,5,7
Otyek,proudmoore,478,warrior,arms,12,5,7
Bennybrock,crushridge,478,warrior,arms,12,5,7
Tmible,ragnaros,477,warrior,arms,6,5,1
Larale,emerald-dream,477,warrior,arms,12,5,7
Therom,ragnaros,477,warrior,arms,21,6,15
Spitbeard,kargath,477,warrior,arms,18,5,13
Rhawl,ragnaros,477,warrior,arms,28,7,21
Marleta,aegwynn,475,warrior,arms,12,5,7
Brutekush,barthilas,475,warrior,arms,18,5,13
Lechonkk,proudmoore,472,warrior,arms,12,5,7
Raktrazbirt,dalaran,472,warrior,arms,12,5,7
Felsen,blackwing-lair,463,warrior,arms,11,5,6
Bøøtymuncher,illidan,462,warrior,arms,11,7,4
Naindejardin,sargeras,462,warrior,arms,11,5,6
Danalle,area-52,448,warrior,arms,10,6,4
Turboboy,tichondrius,448,warrior,arms,10,5,5
Mverstappen,azralon,448,warrior,arms,10,5,5
Tenderturtle,tichondrius,447,warrior,arms,11,5,6
Notcoverage,tichondrius,447,warrior,arms,11,5,6
Enelsita,sargeras,447,warrior,arms,14,6,8
Dontkiteme,frostmourne,447,warrior,arms,17,5,12
Boorabill,stormrage,446,warrior,arms,14,6,8
Hvwk,sargeras,445,warrior,arms,11,5,6
Dpsdone,blackrock,432,warrior,arms,9,6,3
Esko,tichondrius,431,warrior,arms,11,5,6
Gurgak,illidan,431,warrior,arms,11,5,6
Jackedaniels,stormrage,431,warrior,arms,12,5,7
Bloodbottle,darkspear,426,warrior,arms,14,7,7
Reignwolf,azralon,426,warrior,arms,13,6,7
Boombasta,shuhalo,426,warrior,arms,15,6,9
Ragëqt,windrunner,426,warrior,arms,15,6,9
Aybssin,skullcrusher,425,warrior,arms,19,7,12
Crushaholic,azgalor,424,warrior,arms,18,7,11
Yarocktoo,kelthuzad,415,warrior,arms,8,5,3
Raselix,quelthalas,415,warrior,arms,8,5,3
Machutron,quelthalas,415,warrior,arms,8,5,3
Crackersmack,stormrage,415,warrior,arms,11,6,5
Nrico,frostmourne,415,warrior,arms,10,5,5
Thano,kiljaeden,415,warrior,arms,10,5,5
Meanface,malganis,415,warrior,arms,14,5,9
Superbest,tichondrius,415,warrior,arms,14,5,9
Argorøk,azralon,415,warrior,arms,32,5,27
Smashsmash,barthilas,400,warrior,arms,7,5,2
Calcùlus,kelthuzad,400,warrior,arms,13,5,8
Romus,spirestone,399,warrior,arms,7,5,2
Farmtruckqt,proudmoore,384,warrior,arms,6,4,2
Diâbetes,area-52,384,warrior,arms,6,4,2
Aægekaz,proudmoore,384,warrior,arms,6,4,2
Halfman,turalyon,384,warrior,arms,6,4,2
Sygurd,drakkari,384,warrior,arms,6,4,2
Frakt,illidan,384,warrior,arms,6,4,2
Alèx,tichondrius,384,warrior,arms,6,4,2
Orangew,dalaran,384,warrior,arms,6,4,2
Ragingboner,aggramar,384,warrior,arms,6,4,2
Bigmens,illidan,384,warrior,arms,6,4,2
Gozugurself,barthilas,384,warrior,arms,6,4,2
Slapywar,illidan,384,warrior,arms,6,4,2
Dementordark,ragnaros,384,warrior,arms,6,4,2
Swordfighter,moon-guard,384,warrior,arms,6,4,2
Yagarel,dalaran,384,warrior,arms,6,4,2
Ckoaw,dalaran,384,warrior,arms,6,4,2
Datogkush,frostmourne,384,warrior,arms,6,4,2
Borahgis,area-52,384,warrior,arms,6,4,2
Crayen,moon-guard,384,warrior,arms,6,4,2
Gamörä,illidan,384,warrior,arms,6,4,2
Deosgladius,ragnaros,384,warrior,arms,6,4,2
Wardread,frostmourne,384,warrior,arms,6,4,2
Rungoar,frostmourne,384,warrior,arms,6,4,2
Shartstaín,tichondrius,384,warrior,arms,6,4,2
Kaghogar,area-52,384,warrior,arms,6,4,2
Ordinaryname,illidan,384,warrior,arms,6,4,2
Afelhia,moon-guard,384,warrior,arms,6,4,2
Bruisebanner,area-52,384,warrior,arms,6,4,2
Steelsong,area-52,384,warrior,arms,6,4,2
Fròthy,emerald-dream,384,warrior,arms,6,4,2
Sakiimoe,ragnaros,384,warrior,arms,6,4,2
Gnasty,hyjal,384,warrior,arms,6,4,2
Oddyseey,moon-guard,384,warrior,arms,6,4,2
Iloveremi,sargeras,384,warrior,arms,6,4,2
Picpay,area-52,384,warrior,arms,6,4,2
Tankdawg,draktharon,384,warrior,arms,6,4,2
Callosus,stormrage,384,warrior,arms,6,4,2
Sanqq,tichondrius,384,warrior,arms,6,4,2
Copinhodagua,azralon,384,warrior,arms,6,4,2
Wariorwang,tichondrius,384,warrior,arms,6,4,2
Swillzz,illidan,384,warrior,arms,6,4,2
Pilgrimslays,tichondrius,384,warrior,arms,6,4,2
Bütch,stormrage,384,warrior,arms,6,4,2
Lanthelon,wyrmrest-accord,384,warrior,arms,6,4,2
Appolyonn,hyjal,384,warrior,arms,6,4,2
Ummso,nerzhul,384,warrior,arms,6,4,2
Tickej,dragonmaw,384,warrior,arms,6,4,2
Caberg,ragnaros,384,warrior,arms,6,4,2
Slipter,ragnaros,384,warrior,arms,6,4,2
Mòrgo,agamaggan,384,warrior,arms,6,4,2
Iroh,thunderhorn,384,warrior,arms,6,4,2
Boomtacular,moon-guard,384,warrior,arms,6,4,2
Styiex,ragnaros,384,warrior,arms,6,4,2
Dazfury,barthilas,384,warrior,arms,6,4,2
Bigfatork,area-52,384,warrior,arms,6,4,2
Pozan,tichondrius,384,warrior,arms,6,4,2
Dracoñ,quelthalas,384,warrior,arms,6,4,2
Ziggeraut,cenarion-circle,384,warrior,arms,6,4,2
Veedrin,ysera,384,warrior,arms,6,4,2
Takitó,ragnaros,384,warrior,arms,6,4,2
Hamur,azralon,384,warrior,arms,6,4,2
Gangdan,sargeras,384,warrior,arms,6,4,2
Tsutsana,lightninghoof,384,warrior,arms,6,4,2
Bajheeraz,sargeras,384,warrior,arms,6,4,2
Míaguiulfo,ragnaros,384,warrior,arms,6,4,2
Rinima,tichondrius,384,warrior,arms,6,4,2
Mfgodofwar,kelthuzad,384,warrior,arms,6,4,2
Evergardens,saurfang,384,warrior,arms,6,4,2
Bajheeraz,tichondrius,384,warrior,arms,6,4,2
Thiccyb,area-52,384,warrior,arms,6,4,2
Yêawen,tichondrius,384,warrior,arms,6,4,2
Pineapplezz,kelthuzad,384,warrior,arms,6,4,2
Optimalwar,arthas,384,warrior,arms,6,4,2
Mommystrasza,kelthuzad,384,warrior,arms,6,4,2
Còlòssal,moknathal,384,warrior,arms,6,4,2
Gurneyhalec,proudmoore,384,warrior,arms,6,4,2
Fingaz,azralon,384,warrior,arms,6,4,2
Crunchytacos,zuljin,384,warrior,arms,6,4,2
Malgoth,illidan,384,warrior,arms,6,4,2
Zoldyak,ragnaros,384,warrior,arms,6,4,2
Neon,wildhammer,384,warrior,arms,6,4,2
Terminatorr,quelthalas,384,warrior,arms,6,4,2
Odalp,tichondrius,384,warrior,arms,6,4,2
Burzerk,malganis,384,warrior,arms,6,4,2
Ygìr,mannoroth,384,warrior,arms,6,4,2
Megadracoman,altar-of-storms,384,warrior,arms,6,4,2
Farlywarrior,tichondrius,384,warrior,arms,6,4,2
Conormacleod,stormrage,384,warrior,arms,6,4,2
Braxxìnn,tichondrius,384,warrior,arms,6,4,2
Mortalhandx,tichondrius,384,warrior,arms,6,4,2
Nextquestion,sargeras,384,warrior,arms,6,4,2
Daddydomtop,moon-guard,384,warrior,arms,6,4,2
Fancysin,malganis,384,warrior,arms,6,4,2
Mikrotik,alleria,384,warrior,arms,6,4,2
Titanmax,kelthuzad,384,warrior,arms,6,4,2
Lxstcxntury,sargeras,384,warrior,arms,6,4,2
Misticstorm,barthilas,384,warrior,arms,6,4,2
Extrinsic,tichondrius,384,warrior,arms,6,4,2
Prodigi,ragnaros,384,warrior,arms,6,4,2
Mystïctank,sargeras,384,warrior,arms,6,4,2
Littlegengar,tichondrius,384,warrior,arms,6,4,2
Restoy,tichondrius,384,warrior,arms,6,4,2
Aleforth,quelthalas,384,warrior,arms,6,4,2
Swaystko,sargeras,384,warrior,arms,6,4,2
Stormleap,tichondrius,384,warrior,arms,6,4,2
Mcwanga,barthilas,384,warrior,arms,6,4,2
Rõcky,frostmourne,384,warrior,arms,6,4,2
Helder,destromath,384,warrior,arms,6,4,2
Kimbö,quelthalas,384,warrior,arms,6,4,2
Hamburgezo,quelthalas,384,warrior,arms,6,4,2
Size,azralon,384,warrior,arms,6,4,2
Kruçify,dark-iron,384,warrior,arms,6,4,2
Claymorer,tichondrius,384,warrior,arms,6,4,2
Thottprot,blackhand,384,warrior,arms,6,4,2
Cheshe,area-52,384,warrior,arms,6,4,2
Zarttorius,quelthalas,384,warrior,arms,6,4,2
Swingyslammy,area-52,384,warrior,arms,6,4,2
Ssamba,shattered-hand,384,warrior,arms,6,4,2
Warcheif,dentarg,384,warrior,arms,6,4,2
Jersucristö,quelthalas,384,warrior,arms,6,4,2
Ghoghánz,quelthalas,384,warrior,arms,6,4,2
Sonoflaw,skullcrusher,384,warrior,arms,6,4,2
Blucollardad,bleeding-hollow,384,warrior,arms,6,4,2
Kraggo,zuljin,384,warrior,arms,6,4,2
Sakuraya,tichondrius,384,warrior,arms,6,4,2
Yivicus,sargeras,384,warrior,arms,6,4,2
Ráwrxd,bleeding-hollow,384,warrior,arms,6,4,2
Koalabear,shadow-council,384,warrior,arms,6,4,2
Galaxius,frostmane,384,warrior,arms,7,4,3
Greenishfox,illidan,384,warrior,arms,9,5,4
Siouxfall,area-52,384,warrior,arms,9,5,4
Kalisandra,undermine,384,warrior,arms,10,5,5
Ragnarlbrok,goldrinn,384,warrior,arms,10,5,5
Ailes,hakkar,384,warrior,arms,11,4,7
Drewpqawk,tichondrius,384,warrior,arms,12,4,8
Notfaytful,thrall,384,warrior,arms,12,4,8
Tappyc,tichondrius,384,warrior,arms,12,4,8
Sheerina,area-52,384,warrior,arms,12,4,8
Durango,duskwood,384,warrior,arms,12,4,8
Khaellanax,azralon,384,warrior,arms,12,4,8
Gaouis,stormreaver,384,warrior,arms,12,4,8
Velanos,bleeding-hollow,384,warrior,arms,12,4,8
Majitz,azralon,384,warrior,arms,12,4,8
Snack,stormreaver,384,warrior,arms,12,4,8
Akoro,bleeding-hollow,384,warrior,arms,12,4,8
Narduk,emerald-dream,384,warrior,arms,12,4,8
Laokan,illidan,384,warrior,arms,12,4,8
Dessindir,quelthalas,384,warrior,arms,12,4,8
Smokr,azralon,384,warrior,arms,12,4,8
Filth,tichondrius,384,warrior,arms,12,4,8
Metalhit,tichondrius,384,warrior,arms,12,4,8
Sandrine,fizzcrank,384,warrior,arms,12,4,8
Redrumman,demon-soul,384,warrior,arms,12,4,8
Naelynh,quelthalas,384,warrior,arms,12,4,8
Draiken,dalaran,384,warrior,arms,12,4,8
Palumorw,deathwing,384,warrior,arms,12,4,8
Fetalalcohol,illidan,384,warrior,arms,12,4,8
Zebel,tichondrius,384,warrior,arms,12,4,8
Bigshett,sargeras,384,warrior,arms,12,4,8
Swingú,illidan,384,warrior,arms,12,4,8
Rexmar,tichondrius,384,warrior,arms,12,4,8
Stangomongo,tichondrius,384,warrior,arms,12,4,8
Wyborn,emerald-dream,384,warrior,arms,12,4,8
Fatherkelso,tichondrius,384,warrior,arms,12,4,8
Jaredfrmsbwy,kelthuzad,384,warrior,arms,12,4,8
Brendan,llane,384,warrior,arms,12,4,8
Mikejustice,kelthuzad,384,warrior,arms,12,4,8
Brazenox,illidan,384,warrior,arms,12,4,8
Pilsenerog,ragnaros,384,warrior,arms,12,4,8
Ediann,elune,384,warrior,arms,12,4,8
Koei,illidan,384,warrior,arms,12,4,8
Drakgøre,ragnaros,384,warrior,arms,12,4,8
Tanksbad,lightnings-blade,384,warrior,arms,12,4,8
Emmartillos,ragnaros,384,warrior,arms,12,4,8
Rheizen,dark-iron,384,warrior,arms,12,4,8
Sorty,emerald-dream,384,warrior,arms,12,4,8
Shibanda,tichondrius,384,warrior,arms,12,4,8
Mindgoblin,bleeding-hollow,384,warrior,arms,12,4,8
Furyofrage,dalaran,384,warrior,arms,12,4,8
Obama,chogall,384,warrior,arms,12,4,8
Bigpharma,elune,384,warrior,arms,12,4,8
Dosey,kelthuzad,384,warrior,arms,12,4,8
Indfo,altar-of-storms,384,warrior,arms,12,4,8
Nibones,malganis,384,warrior,arms,12,4,8
Cupper,tichondrius,384,warrior,arms,12,4,8
Lørdvingådør,azralon,384,warrior,arms,12,4,8
Gazah,skullcrusher,384,warrior,arms,12,4,8
Slapscar,tichondrius,384,warrior,arms,12,4,8
Ferilya,thunderhorn,384,warrior,arms,12,4,8
Heliza,ragnaros,384,warrior,arms,12,4,8
Aldaøm,ragnaros,384,warrior,arms,12,4,8
Jaclksparrow,azralon,384,warrior,arms,12,4,8
Malahorda,illidan,384,warrior,arms,12,4,8
Claphub,malganis,384,warrior,arms,12,4,8
Murotamaka,malganis,384,warrior,arms,12,4,8
Chongos,malganis,384,warrior,arms,12,4,8
Warriormikey,tichondrius,384,warrior,arms,12,4,8
Darkirondolo,tichondrius,384,warrior,arms,12,4,8
Hamslamm,area-52,384,warrior,arms,12,4,8
Ladderx,area-52,384,warrior,arms,12,4,8
Hameey,sargeras,384,warrior,arms,12,4,8
Bewbeebangz,kelthuzad,384,warrior,arms,12,4,8
Runningatyou,area-52,384,warrior,arms,12,4,8
Insondável,thrall,384,warrior,arms,12,4,8
Zebron,sargeras,384,warrior,arms,12,4,8
Grullhamer,ragnaros,384,warrior,arms,12,4,8
Flexyx,arthas,384,warrior,arms,12,4,8
Redbeanw,tichondrius,384,warrior,arms,12,4,8
Regax,thrall,384,warrior,arms,12,4,8
Estrasystole,sargeras,384,warrior,arms,12,4,8
Zantetsukenn,sargeras,384,warrior,arms,12,4,8
Vampiranha,azralon,384,warrior,arms,12,4,8
Wendër,area-52,384,warrior,arms,12,4,8
Jasonsdady,illidan,384,warrior,arms,12,4,8
Zamera,tichondrius,384,warrior,arms,12,4,8
Verrynasty,area-52,384,warrior,arms,12,4,8
Itsshowtime,tichondrius,384,warrior,arms,12,4,8
Dámöuse,stormrage,384,warrior,arms,12,4,8
Twoshoutz,stormrage,384,warrior,arms,12,4,8
Nginx,queldorei,384,warrior,arms,12,4,8
Sinkale,moon-guard,384,warrior,arms,12,4,8
Nerolanast,wyrmrest-accord,384,warrior,arms,12,4,8
Guyllol,barthilas,384,warrior,arms,12,4,8
Iargestpp,bleeding-hollow,384,warrior,arms,12,4,8
Varrian,rivendare,384,warrior,arms,12,4,8
Vurks,frostmourne,384,warrior,arms,12,4,8
Lebs,frostmourne,384,warrior,arms,12,4,8
Toothpick,frostmourne,384,warrior,arms,12,4,8
Xårren,stormrage,384,warrior,arms,12,4,8
Barrocops,kiljaeden,384,warrior,arms,12,4,8
Allonsas,moon-guard,384,warrior,arms,12,4,8
Trogwaagh,zuljin,384,warrior,arms,12,4,8
Joekenshield,stonemaul,384,warrior,arms,12,4,8
Kenedy,moon-guard,384,warrior,arms,12,4,8
Warmachined,grizzly-hills,384,warrior,arms,12,4,8
Warspartan,stormrage,384,warrior,arms,12,4,8
Nxmabala,proudmoore,384,warrior,arms,12,4,8
Melithiae,barthilas,384,warrior,arms,12,4,8
Còsmico,trollbane,384,warrior,arms,12,4,8
Gangaa,barthilas,384,warrior,arms,12,4,8
Angrybrog,malfurion,384,warrior,arms,12,4,8
Porchorc,hyjal,384,warrior,arms,12,4,8
Gorethak,kiljaeden,384,warrior,arms,12,4,8
Totenhammer,nathrezim,384,warrior,arms,12,4,8
Ballsy,fenris,384,warrior,arms,12,4,8
Freedum,shandris,384,warrior,arms,12,4,8
Chàrr,crushridge,384,warrior,arms,12,4,8
Galaxywar,stormrage,384,warrior,arms,12,4,8
Moseshrute,zuljin,384,warrior,arms,12,4,8
Jathellum,stormrage,384,warrior,arms,12,4,8
Zulataza,zuljin,384,warrior,arms,12,4,8
Thelsarian,nerzhul,384,warrior,arms,12,4,8
Varbû,hakkar,384,warrior,arms,12,4,8
Daduké,stormrage,384,warrior,arms,12,4,8
Pop,stormrage,384,warrior,arms,12,4,8
Renclave,wyrmrest-accord,384,warrior,arms,12,4,8
Mefus,wyrmrest-accord,384,warrior,arms,12,4,8
Licona,wyrmrest-accord,384,warrior,arms,12,4,8
Hambster,frostmane,384,warrior,arms,12,4,8
Bs,kiljaeden,384,warrior,arms,12,4,8
Hârambe,kiljaeden,384,warrior,arms,12,4,8
Facekilla,nordrassil,384,warrior,arms,12,4,8
Handikap,stormrage,384,warrior,arms,12,4,8
Spacegoatze,thunderlord,384,warrior,arms,12,4,8
Orcly,kilrogg,384,warrior,arms,12,4,8
Varkery,sargeras,384,warrior,arms,13,4,9
Bondadoso,stormrage,384,warrior,arms,13,4,9
Kyres,moon-guard,384,warrior,arms,16,4,12
Jazzkiler,azralon,384,warrior,arms,17,4,13
Retiarius,tichondrius,384,warrior,arms,18,4,14
Draxxarlol,zuljin,384,warrior,arms,18,4,14
Moctezuma,bronzebeard,384,warrior,arms,18,4,14
Gladicus,zuljin,384,warrior,arms,18,4,14
Raggnar,zuluhed,384,warrior,arms,18,4,14
Paauly,ragnaros,384,warrior,arms,18,4,14
Asphyxiating,illidan,384,warrior,arms,18,4,14
Zugyu,tichondrius,384,warrior,arms,18,4,14
Âlecos,ragnaros,384,warrior,arms,18,4,14
Lóthnalár,ragnaros,384,warrior,arms,18,4,14
Thedozer,kargath,383,warrior,arms,6,4,2
Orcrist,stormreaver,383,warrior,arms,6,4,2
Randumxx,nerzhul,383,warrior,arms,6,4,2
Yeit,tichondrius,383,warrior,arms,6,4,2
Sethh,ragnaros,383,warrior,arms,6,4,2
Ezaxe,tichondrius,383,warrior,arms,6,4,2
Rathlann,crushridge,383,warrior,arms,6,4,2
Tookbeki,tichondrius,383,warrior,arms,6,4,2
Narkki,tichondrius,383,warrior,arms,6,4,2
Orangerzze,hyjal,383,warrior,arms,12,4,8
Grosjambes,turalyon,383,warrior,arms,12,4,8
Ralf,emerald-dream,383,warrior,arms,12,4,8
Ajamu,aegwynn,383,warrior,arms,12,4,8
Duvir,frostwolf,383,warrior,arms,12,4,8
Drovik,malygos,383,warrior,arms,12,4,8
Aazokk,emerald-dream,383,warrior,arms,12,4,8
Bläckraven,quelthalas,383,warrior,arms,12,4,8
Dayafter,queldorei,383,warrior,arms,12,4,8
Brujas,blackrock,383,warrior,arms,18,4,14
Christellà,dalaran,383,warrior,arms,18,4,14
Bahlsac,cenarion-circle,382,warrior,arms,12,4,8
Bunedau,azgalor,380,warrior,arms,18,4,14
Handdok,runetotem,379,warrior,arms,12,4,8
Dingoe,wyrmrest-accord,379,warrior,arms,12,4,8
Såmmÿ,moon-guard,379,warrior,arms,12,4,8
Lightstrikes,sargeras,379,warrior,arms,12,4,8
Drakôn,quelthalas,367,warrior,arms,11,4,7
Shagalaca,tichondrius,367,warrior,arms,11,4,7
Twohandkilla,scilla,367,warrior,arms,11,4,7
Loomine,illidan,367,warrior,arms,11,4,7
Xaxxar,bleeding-hollow,367,warrior,arms,11,4,7
Gâbríel,maiev,351,warrior,arms,11,4,7
Förkz,ragnaros,351,warrior,arms,11,4,7
Thøros,moon-guard,351,warrior,arms,11,4,7
Vaetren,area-52,351,warrior,arms,11,4,7
Twinktop,tichondrius,351,warrior,arms,11,4,7
Cönan,thunderhorn,351,warrior,arms,16,4,12
Bronkyaf,hyjal,351,warrior,arms,23,4,19
Boyarde,tichondrius,336,warrior,arms,9,4,5
Justentacle,zuljin,336,warrior,arms,15,4,11
Sinweaver,bleeding-hollow,335,warrior,arms,9,5,4
Caynos,stormrage,335,warrior,arms,11,4,7
Chargingboto,dragonmaw,335,warrior,arms,11,4,7
Jimpepega,quelthalas,335,warrior,arms,11,4,7
Toir,bladefist,335,warrior,arms,11,4,7
Krongarr,area-52,330,warrior,arms,14,5,9
Rubbers,thrall,330,warrior,arms,17,6,11
Macray,zuljin,330,warrior,arms,18,5,13
Scottie,cairne,325,warrior,arms,13,5,8
Lildumptruck,emerald-dream,320,warrior,arms,10,4,6
Painstake,illidan,320,warrior,arms,19,5,14
Vaider,bleeding-hollow,319,warrior,arms,5,4,1
Zyken,tichondrius,319,warrior,arms,5,4,1
Skollton,tichondrius,319,warrior,arms,5,4,1
Toetoeto,darrowmere,319,warrior,arms,5,4,1
Rauwers,azralon,319,warrior,arms,8,4,4
Kricken,frostmourne,319,warrior,arms,8,4,4
Aerriz,area-52,319,warrior,arms,11,4,7
Nayaqt,tichondrius,319,warrior,arms,14,4,10
Edmaghar,ragnaros,319,warrior,arms,14,4,10
Atruis,area-52,304,warrior,arms,7,4,3
Rezhan,area-52,304,warrior,arms,13,4,9
Swiftless,gnomeregan,304,warrior,arms,13,4,9
Syradar,ragnaros,304,warrior,arms,13,4,9
Nicolasrage,trollbane,303,warrior,arms,11,5,6
Hotboxer,kelthuzad,295,warrior,arms,12,5,7
Chikenekihc,frostmourne,288,warrior,arms,6,3,3
Kajind,boulderfist,288,warrior,arms,6,3,3
Miarisa,moon-guard,288,warrior,arms,6,3,3
Unhealbedam,area-52,288,warrior,arms,6,3,3
Flarkin,area-52,288,warrior,arms,6,3,3
Zåzriel,tichondrius,288,warrior,arms,6,3,3
Magthor,warsong,288,warrior,arms,6,3,3
Tulnaak,durotan,288,warrior,arms,6,3,3
Preceptron,azralon,288,warrior,arms,6,3,3
Krïtzkreig,the-forgotten-coast,288,warrior,arms,6,3,3
Exequet,tichondrius,288,warrior,arms,6,3,3
Robio,tichondrius,288,warrior,arms,6,3,3
Hytonmi,moon-guard,288,warrior,arms,6,3,3
Swizzly,tichondrius,288,warrior,arms,6,3,3
Muguiying,frostmourne,288,warrior,arms,6,3,3
Jaqques,moon-guard,288,warrior,arms,6,3,3
Shaydoom,frostmourne,288,warrior,arms,6,3,3
Sweetmojito,vashj,288,warrior,arms,6,3,3
Temperament,area-52,288,warrior,arms,6,3,3
Kénblock,tichondrius,288,warrior,arms,6,3,3
Exiledwarz,area-52,288,warrior,arms,6,3,3
Boitoróh,azralon,288,warrior,arms,6,3,3
Bullblader,azralon,288,warrior,arms,6,3,3
Leeth,azralon,288,warrior,arms,6,3,3
Cryptex,illidan,288,warrior,arms,6,3,3
Miroz,tichondrius,288,warrior,arms,6,3,3
Tenfury,proudmoore,288,warrior,arms,6,3,3
Diddlin,tichondrius,288,warrior,arms,6,3,3
Sinjino,proudmoore,288,warrior,arms,6,3,3
Faelzerá,azralon,288,warrior,arms,6,3,3
Valför,ysera,288,warrior,arms,6,3,3
Wöûlöû,trollbane,288,warrior,arms,6,3,3
Akhinoz,area-52,288,warrior,arms,6,3,3
Tinylimbs,frostmourne,288,warrior,arms,6,3,3
Nefrith,lightbringer,288,warrior,arms,6,3,3
Zenmore,illidan,288,warrior,arms,6,3,3
Warreeper,area-52,288,warrior,arms,6,3,3
Telynne,frostmourne,288,warrior,arms,6,3,3
Fregory,moon-guard,288,warrior,arms,6,3,3
Vuraxx,area-52,288,warrior,arms,6,3,3
Huffzo,tichondrius,288,warrior,arms,6,3,3
Poonoxo,gundrak,288,warrior,arms,6,3,3
Humanlog,illidan,288,warrior,arms,6,3,3
Gorkrog,frostmourne,288,warrior,arms,6,3,3
Topee,area-52,288,warrior,arms,6,3,3
Readytoflee,moon-guard,288,warrior,arms,6,3,3
Nazakeen,tichondrius,288,warrior,arms,6,3,3
Roidråge,area-52,288,warrior,arms,6,3,3
Orkwar,tichondrius,288,warrior,arms,6,3,3
Cheekclapps,tichondrius,288,warrior,arms,6,3,3
Idarkshakra,illidan,288,warrior,arms,6,3,3
Scanlan,dalvengyr,288,warrior,arms,6,3,3
Tehnklo,tichondrius,288,warrior,arms,6,3,3
Vistacleave,maiev,288,warrior,arms,6,3,3
Phaknah,emerald-dream,288,warrior,arms,6,3,3
Cokedope,tichondrius,288,warrior,arms,6,3,3
Sauceslinga,frostmourne,288,warrior,arms,6,3,3
Runtasticx,tichondrius,288,warrior,arms,6,3,3
Ymìr,moon-guard,288,warrior,arms,6,3,3
Haginn,malorne,288,warrior,arms,6,3,3
Schlosh,laughing-skull,288,warrior,arms,6,3,3
Exdilla,zuljin,288,warrior,arms,6,3,3
Fivewarrior,tichondrius,288,warrior,arms,6,3,3
Allmotor,zuljin,288,warrior,arms,6,3,3
Letyoupain,illidan,288,warrior,arms,6,3,3
Axeslaps,illidan,288,warrior,arms,6,3,3
Fjswpp,tichondrius,288,warrior,arms,6,3,3
Messe,khazgoroth,288,warrior,arms,6,3,3
Brôm,emerald-dream,288,warrior,arms,6,3,3
Blazingfury,area-52,288,warrior,arms,6,3,3
Akilosh,illidan,288,warrior,arms,6,3,3
Mcrîb,stormscale,288,warrior,arms,6,3,3
Gungo,kiljaeden,288,warrior,arms,6,3,3
Riidim,area-52,288,warrior,arms,6,3,3
Drugdilla,zuljin,288,warrior,arms,6,3,3
Chronicdank,tichondrius,288,warrior,arms,6,3,3
Sunhands,emerald-dream,288,warrior,arms,6,3,3
Stungrunn,tichondrius,288,warrior,arms,6,3,3
Trackhawk,moon-guard,288,warrior,arms,6,3,3
Éten,drakkari,288,warrior,arms,6,3,3
Mittyroar,khazgoroth,288,warrior,arms,6,3,3
Warriortimes,ragnaros,288,warrior,arms,6,3,3
Solembuumm,illidan,288,warrior,arms,6,3,3
Davien,tichondrius,288,warrior,arms,6,3,3
Jeyvil,stormrage,288,warrior,arms,6,3,3
Gypsypsycho,stormrage,288,warrior,arms,6,3,3
Brayven,area-52,288,warrior,arms,6,3,3
Osselan,moon-guard,288,warrior,arms,6,3,3
Badvelic,tichondrius,288,warrior,arms,6,3,3
Wrèckingball,tichondrius,288,warrior,arms,6,3,3
Ambevsgunnar,tichondrius,288,warrior,arms,6,3,3
Kryptïç,moon-guard,288,warrior,arms,6,3,3
Rehnd,illidan,288,warrior,arms,6,3,3
Retrô,uldum,288,warrior,arms,6,3,3
Tnytank,burning-legion,288,warrior,arms,6,3,3
Meepxd,stormrage,288,warrior,arms,6,3,3
Warbringerr,hydraxis,288,warrior,arms,6,3,3
Andrewceo,tichondrius,288,warrior,arms,6,3,3
Leonidas,barthilas,288,warrior,arms,6,3,3
Richenbach,kelthuzad,288,warrior,arms,6,3,3
Seymourbot,illidan,288,warrior,arms,6,3,3
Rockybâlboa,illidan,288,warrior,arms,6,3,3
Faywarsong,area-52,288,warrior,arms,6,3,3
Kokurawr,burning-legion,288,warrior,arms,6,3,3
Shloope,barthilas,288,warrior,arms,6,3,3
Jackanape,sargeras,288,warrior,arms,6,3,3
Vinetic,kiljaeden,288,warrior,arms,6,3,3
Edokthong,frostmourne,288,warrior,arms,6,3,3
Renseven,frostmourne,288,warrior,arms,6,3,3
Aeximu,skywall,288,warrior,arms,6,3,3
Forthejeers,sargeras,288,warrior,arms,6,3,3
Robostergler,tichondrius,288,warrior,arms,6,3,3
Dropthemic,tichondrius,288,warrior,arms,6,3,3
Finnagnome,sargeras,288,warrior,arms,6,3,3
Drakr,ragnaros,288,warrior,arms,6,3,3
Hanginaround,zuluhed,288,warrior,arms,6,3,3
Decimus,medivh,288,warrior,arms,6,3,3
Pureone,barthilas,288,warrior,arms,6,3,3
Funkyjosh,spirestone,288,warrior,arms,6,3,3
Carborr,frostmourne,288,warrior,arms,6,3,3
Dolph,sargeras,288,warrior,arms,6,3,3
Nukehazard,bleeding-hollow,288,warrior,arms,6,3,3
Pussman,malganis,288,warrior,arms,6,3,3
Dematic,skullcrusher,288,warrior,arms,6,3,3
Garroshrimp,tichondrius,288,warrior,arms,6,3,3
Camaeel,stormrage,288,warrior,arms,6,3,3
Benieswar,frostmourne,288,warrior,arms,6,3,3
Ellx,sargeras,288,warrior,arms,6,3,3
Wulfgarn,frostwolf,288,warrior,arms,6,3,3
Springbreak,bleeding-hollow,288,warrior,arms,6,3,3
Vnw,illidan,288,warrior,arms,6,3,3
Gulharot,stormrage,288,warrior,arms,6,3,3
Bëowulf,malganis,288,warrior,arms,6,3,3
Warnuk,lightnings-blade,288,warrior,arms,6,3,3
Altron,icecrown,288,warrior,arms,6,3,3
Ragemelon,icecrown,288,warrior,arms,6,3,3
Scottpilgrim,illidan,288,warrior,arms,6,3,3
Bghero,wyrmrest-accord,288,warrior,arms,6,3,3
Imperiial,stormrage,288,warrior,arms,6,3,3
Cwar,tichondrius,288,warrior,arms,6,3,3
Smashndspin,sargeras,288,warrior,arms,6,3,3
Assmut,stormrage,288,warrior,arms,6,3,3
Jutank,sargeras,288,warrior,arms,6,3,3
Fyle,stormrage,288,warrior,arms,6,3,3
Glowstick,tichondrius,288,warrior,arms,6,3,3
Renning,malganis,288,warrior,arms,6,3,3
Hukzula,illidan,288,warrior,arms,6,3,3
Mandofl,ragnaros,288,warrior,arms,6,3,3
Toughness,kelthuzad,288,warrior,arms,6,3,3
Robothands,tichondrius,288,warrior,arms,6,3,3
Elegance,llane,288,warrior,arms,6,3,3
Az,malorne,288,warrior,arms,6,3,3
Zemi,sargeras,288,warrior,arms,6,3,3
Dublinn,llane,288,warrior,arms,6,3,3
Serindel,quelthalas,288,warrior,arms,6,3,3
Zombeebe,sargeras,288,warrior,arms,6,3,3
Ei,darrowmere,288,warrior,arms,6,3,3
Wilwineve,barthilas,288,warrior,arms,6,3,3
Flavorw,cairne,288,warrior,arms,6,3,3
Seblledo,drakkari,288,warrior,arms,6,3,3
Corrum,shuhalo,288,warrior,arms,6,3,3
Småckêd,sargeras,288,warrior,arms,6,3,3
Duglug,malganis,288,warrior,arms,6,3,3
Dunsker,stormrage,288,warrior,arms,6,3,3
Jug,khazgoroth,288,warrior,arms,6,3,3
Miltlan,drakkari,288,warrior,arms,6,3,3
Shiromiya,tichondrius,288,warrior,arms,6,3,3
Trashman,frostwolf,288,warrior,arms,6,3,3
Tread,mugthol,288,warrior,arms,6,3,3
Liltotey,frostmourne,288,warrior,arms,6,3,3
Skullsplittr,illidan,288,warrior,arms,6,3,3
Evôlutiôn,kelthuzad,288,warrior,arms,6,3,3
Yasser,ragnaros,288,warrior,arms,6,3,3
Rezorc,stormrage,288,warrior,arms,6,3,3
Rockhardt,tichondrius,288,warrior,arms,6,3,3
Jerveen,quelthalas,288,warrior,arms,6,3,3
Hotwings,kelthuzad,288,warrior,arms,6,3,3
Srkong,stormrage,288,warrior,arms,6,3,3
Meatpouch,kelthuzad,288,warrior,arms,6,3,3
Larosfan,tichondrius,288,warrior,arms,6,3,3
Allmurr,ragnaros,288,warrior,arms,6,3,3
Dronarmus,ragnaros,288,warrior,arms,6,3,3
Vólkar,quelthalas,288,warrior,arms,6,3,3
Billpoonover,blackwing-lair,288,warrior,arms,6,3,3
Fakktwo,blackhand,288,warrior,arms,6,3,3
Tothepain,thrall,288,warrior,arms,6,3,3
Hotaha,tichondrius,288,warrior,arms,6,3,3
Notawar,stormrage,288,warrior,arms,6,3,3
Limby,wyrmrest-accord,288,warrior,arms,6,3,3
Ayenel,stormrage,288,warrior,arms,6,3,3
Mcbanner,ragnaros,288,warrior,arms,6,3,3
Valperion,frostmourne,288,warrior,arms,6,3,3
Spartanfury,tichondrius,288,warrior,arms,6,3,3
Stárscreám,malganis,288,warrior,arms,6,3,3
Ghomory,quelthalas,288,warrior,arms,6,3,3
Hellscrom,galakrond,288,warrior,arms,6,3,3
Grapegush,bleeding-hollow,288,warrior,arms,6,3,3
Ðuffman,jubeithos,288,warrior,arms,6,3,3
Noteko,tichondrius,288,warrior,arms,6,3,3
Skrognoth,malganis,288,warrior,arms,6,3,3
Zemms,mannoroth,288,warrior,arms,6,3,3
Salveknight,ragnaros,288,warrior,arms,6,3,3
Poppacd,stormrage,288,warrior,arms,6,3,3
Clerond,tichondrius,288,warrior,arms,6,3,3
Pressonce,bleeding-hollow,288,warrior,arms,6,3,3
Caalypso,stormrage,288,warrior,arms,6,3,3
Cevene,sargeras,288,warrior,arms,6,3,3
Dämnjoe,thrall,288,warrior,arms,6,3,3
Wrekzor,zuljin,288,warrior,arms,6,3,3
Mortaryon,malganis,288,warrior,arms,6,3,3
Rhonusturune,blackrock,288,warrior,arms,6,3,3
Hesch,thunderlord,288,warrior,arms,6,3,3
Kuntahkintah,tichondrius,288,warrior,arms,6,3,3
Lemondrake,sargeras,288,warrior,arms,6,3,3
Senzhi,sargeras,288,warrior,arms,6,3,3
Largegayman,sargeras,288,warrior,arms,6,3,3
Maldre,stormrage,288,warrior,arms,9,4,5
Rageslayer,area-52,288,warrior,arms,9,4,5
Grognäk,malganis,288,warrior,arms,7,3,4
Terukan,drakkari,288,warrior,arms,7,3,4
Lildam,sargeras,288,warrior,arms,13,5,8
Ohdang,dark-iron,288,warrior,arms,8,3,5
Ennia,azralon,288,warrior,arms,9,3,6
Medval,quelthalas,288,warrior,arms,11,3,8
Akil,ragnaros,288,warrior,arms,15,4,11
Hoovie,thrall,288,warrior,arms,12,3,9
Relay,mugthol,288,warrior,arms,12,3,9
Wxxz,tichondrius,288,warrior,arms,12,3,9
Enzothebaker,thrall,288,warrior,arms,12,3,9
Kintownhero,aegwynn,288,warrior,arms,12,3,9
Porori,proudmoore,288,warrior,arms,12,3,9
Dainbramage,dalaran,288,warrior,arms,12,3,9
Mesw,illidan,288,warrior,arms,12,3,9
Lowdopamine,tichondrius,288,warrior,arms,12,3,9
Mothor,thrall,288,warrior,arms,12,3,9
Kierto,undermine,288,warrior,arms,12,3,9
Staticego,dalaran,288,warrior,arms,12,3,9
Doomr,tichondrius,288,warrior,arms,12,3,9
Hellamoist,tichondrius,288,warrior,arms,12,3,9
Émerald,kilrogg,288,warrior,arms,12,3,9
Soughloe,illidan,288,warrior,arms,12,3,9
Nektar,aerie-peak,288,warrior,arms,12,3,9
Mansin,tichondrius,288,warrior,arms,12,3,9
Calebrium,tichondrius,288,warrior,arms,12,3,9
Kirikash,illidan,288,warrior,arms,12,3,9
Enulimen,daggerspine,288,warrior,arms,12,3,9
Hrl,tichondrius,288,warrior,arms,12,3,9
Clayguns,argent-dawn,288,warrior,arms,12,3,9
Paxyisbad,tichondrius,288,warrior,arms,12,3,9
Melancalli,thorium-brotherhood,288,warrior,arms,12,3,9
Zsl,tichondrius,288,warrior,arms,12,3,9
Beenbag,aerie-peak,288,warrior,arms,12,3,9
Dablao,tichondrius,288,warrior,arms,12,3,9
Luchonamøm,ragnaros,288,warrior,arms,12,3,9
Urbzog,chogall,288,warrior,arms,12,3,9
Awezc,chogall,288,warrior,arms,12,3,9
Guerreraa,ragnaros,288,warrior,arms,12,3,9
Phargo,korgath,288,warrior,arms,12,3,9
Zaeyr,tichondrius,288,warrior,arms,12,3,9
Alppha,emerald-dream,288,warrior,arms,12,3,9
Forarrior,malganis,288,warrior,arms,12,3,9
Aralla,area-52,288,warrior,arms,12,3,9
Sescor,moon-guard,288,warrior,arms,12,3,9
Aræn,sargeras,288,warrior,arms,12,3,9
Glamen,moon-guard,288,warrior,arms,12,3,9
Valestrike,moon-guard,288,warrior,arms,12,3,9
Naughtynilla,sargeras,288,warrior,arms,12,3,9
Kero,malganis,288,warrior,arms,12,3,9
Tangö,barthilas,288,warrior,arms,12,3,9
Kigo,azralon,288,warrior,arms,12,3,9
Grouwarriar,azralon,288,warrior,arms,12,3,9
Ichil,azshara,288,warrior,arms,12,3,9
Basingsei,area-52,288,warrior,arms,12,3,9
Brütalize,wyrmrest-accord,288,warrior,arms,12,3,9
Battleboxes,area-52,288,warrior,arms,12,3,9
Fupatwo,moon-guard,288,warrior,arms,12,3,9
Kregnar,gundrak,288,warrior,arms,12,3,9
Ntwandamaela,moon-guard,288,warrior,arms,12,3,9
Exenknight,frostmourne,288,warrior,arms,12,3,9
Grimthad,emerald-dream,288,warrior,arms,12,3,9
Darthfaith,azgalor,288,warrior,arms,12,3,9
Minnysota,area-52,288,warrior,arms,12,3,9
Neltar,nagrand,288,warrior,arms,12,3,9
Djshinobi,whisperwind,288,warrior,arms,12,3,9
Smashyu,fenris,288,warrior,arms,12,3,9
Kinigit,azjolnerub,288,warrior,arms,12,3,9
Morgithia,suramar,288,warrior,arms,12,3,9
Orcboic,area-52,288,warrior,arms,12,3,9
Hozer,tichondrius,288,warrior,arms,12,3,9
Xdragonfirex,terenas,288,warrior,arms,12,3,9
Roadpig,zuljin,288,warrior,arms,12,3,9
Eightballerz,barthilas,288,warrior,arms,12,3,9
Mavromantus,lightninghoof,288,warrior,arms,12,3,9
Alliancerulz,darrowmere,288,warrior,arms,12,3,9
Snippy,garona,288,warrior,arms,12,3,9
Erzawälkër,quelthalas,288,warrior,arms,12,3,9
Disturbed,velen,288,warrior,arms,12,3,9
Scrubzwarr,barthilas,288,warrior,arms,12,3,9
Gnomas,destromath,288,warrior,arms,12,3,9
Äisemberg,quelthalas,288,warrior,arms,17,3,14
Integrâl,tichondrius,288,warrior,arms,18,3,15
Giant,lothar,288,warrior,arms,18,3,15
Khallell,illidan,288,warrior,arms,18,3,15
Beefybovine,zuljin,288,warrior,arms,18,3,15
Mathilan,moon-guard,288,warrior,arms,18,3,15
Dorathorn,azralon,288,warrior,arms,18,3,15
Macbride,blackrock,288,warrior,arms,24,3,21
Magtharas,dunemaul,287,warrior,arms,6,3,3
Smashthings,area-52,287,warrior,arms,6,3,3
Saintgeorge,thorium-brotherhood,287,warrior,arms,6,3,3
Yomaaln,blackrock,287,warrior,arms,6,3,3
Silverludê,sargeras,287,warrior,arms,6,3,3
Breinan,ragnaros,287,warrior,arms,6,3,3
Noktarr,tichondrius,287,warrior,arms,9,4,5
Leosax,drakthul,287,warrior,arms,12,3,9
Dekromm,tol-barad,287,warrior,arms,12,3,9
Clayske,gurubashi,287,warrior,arms,12,3,9
Borgosa,wyrmrest-accord,287,warrior,arms,18,3,15
Tyronê,moon-guard,287,warrior,arms,18,3,15
Kalys,ravencrest,284,warrior,arms,12,3,9
Morphexo,quelthalas,276,warrior,arms,20,6,14
Dazanor,moon-guard,271,warrior,arms,11,3,8
Vith,bleeding-hollow,271,warrior,arms,11,3,8
Zugbrained,zuljin,271,warrior,arms,11,3,8
Nooy,blackrock,271,warrior,arms,17,3,14
Thorsën,sargeras,256,warrior,arms,8,4,4
Nècroxious,hellscream,255,warrior,arms,11,3,8
Spicywagyu,tichondrius,255,warrior,arms,11,3,8
Blksquadron,sargeras,253,warrior,arms,12,3,9
Belakorr,frostmourne,240,warrior,arms,9,3,6
Faduuba,quelthalas,240,warrior,arms,9,3,6
Busyguyw,kiljaeden,239,warrior,arms,5,3,2
ßlitzxkreig,tichondrius,239,warrior,arms,5,3,2
Hakén,tichondrius,239,warrior,arms,5,3,2
Likearock,thrall,239,warrior,arms,5,3,2
Kalphok,tichondrius,239,warrior,arms,5,3,2
Omicripto,tichondrius,239,warrior,arms,5,3,2
Kholusia,kul-tiras,239,warrior,arms,5,3,2
Builtdif,zuljin,239,warrior,arms,5,3,2
Dragonrage,tanaris,223,warrior,arms,8,3,5
Snikkles,frostmourne,223,warrior,arms,8,3,5
Benchpress,bleeding-hollow,223,warrior,arms,8,3,5
Nicked,azralon,223,warrior,arms,14,3,11
Condemnd,area-52,207,warrior,arms,8,3,5
Grawñ,frostmourne,192,warrior,arms,4,3,1
Wonderjack,akama,192,warrior,arms,4,3,1
Porotitto,drakkari,192,warrior,arms,11,4,7
Berru,bleeding-hollow,192,warrior,arms,9,3,6
Arianarkw,sargeras,192,warrior,arms,9,3,6
Cugino,tichondrius,192,warrior,arms,9,3,6
Uldrath,hyjal,192,warrior,arms,6,2,4
Controlololx,hyjal,192,warrior,arms,6,2,4
Hookiee,zuljin,192,warrior,arms,6,2,4
Brenrainn,thrall,192,warrior,arms,6,2,4
Kratøz,tichondrius,192,warrior,arms,6,2,4
Ereshom,wyrmrest-accord,192,warrior,arms,6,2,4
Titanwarr,malganis,192,warrior,arms,6,2,4
Jéshka,wyrmrest-accord,192,warrior,arms,6,2,4
Trouz,ragnaros,192,warrior,arms,6,2,4
Bestexecutes,stormrage,192,warrior,arms,6,2,4
Wardaddÿ,zuljin,192,warrior,arms,6,2,4
Mansaniwis,tichondrius,192,warrior,arms,6,2,4
Hbbaboy,nagrand,192,warrior,arms,6,2,4
Exec,mannoroth,192,warrior,arms,6,2,4
Comic,malganis,192,warrior,arms,6,2,4
Pép,malganis,192,warrior,arms,6,2,4
Gigglamesh,muradin,192,warrior,arms,6,2,4
Befòx,tichondrius,192,warrior,arms,6,2,4
Moruken,malganis,192,warrior,arms,6,2,4
Immadropyou,malganis,192,warrior,arms,6,2,4
Warkaiser,ragnaros,192,warrior,arms,6,2,4
Danskmand,tichondrius,192,warrior,arms,6,2,4
Disheartened,wyrmrest-accord,192,warrior,arms,6,2,4
Borealiss,ragnaros,192,warrior,arms,6,2,4
Deepsplitter,illidan,192,warrior,arms,6,2,4
Flakesskillz,darkspear,192,warrior,arms,6,2,4
Æxe,tichondrius,192,warrior,arms,6,2,4
Stellabear,aggramar,192,warrior,arms,6,2,4
Dragonbossy,sargeras,192,warrior,arms,6,2,4
Tearadis,thunderlord,192,warrior,arms,6,2,4
Verwischen,zuljin,192,warrior,arms,6,2,4
Digitalfear,malganis,192,warrior,arms,6,2,4
Soulmerc,turalyon,192,warrior,arms,6,2,4
Einerjar,kelthuzad,192,warrior,arms,6,2,4
Grekk,kelthuzad,192,warrior,arms,6,2,4
Checkeett,sargeras,192,warrior,arms,6,2,4
Zulex,dathremar,192,warrior,arms,6,2,4
Donni,kelthuzad,192,warrior,arms,6,2,4
Wreckan,darkspear,192,warrior,arms,6,2,4
Whymike,aerie-peak,192,warrior,arms,6,2,4
Ruinhorn,thrall,192,warrior,arms,6,2,4
Yeetzbytre,sargeras,192,warrior,arms,6,2,4
Revinth,sargeras,192,warrior,arms,6,2,4
Eleenoor,drakkari,192,warrior,arms,6,2,4
Kreits,drakkari,192,warrior,arms,6,2,4
Linkedd,sargeras,192,warrior,arms,6,2,4
Suzushi,tichondrius,192,warrior,arms,6,2,4
Kuthero,bonechewer,192,warrior,arms,6,2,4
Smeshyou,kelthuzad,192,warrior,arms,6,2,4
Squonks,kelthuzad,192,warrior,arms,6,2,4
Bbyzugga,kelthuzad,192,warrior,arms,6,2,4
Frankal,aegwynn,192,warrior,arms,6,2,4
Ronipastrami,kelthuzad,192,warrior,arms,6,2,4
Josmawar,drakkari,192,warrior,arms,6,2,4
Passionjar,bleeding-hollow,192,warrior,arms,6,2,4
Lopotron,sargeras,192,warrior,arms,6,2,4
Shiestyzug,tichondrius,192,warrior,arms,6,2,4
Spaceshuttle,bleeding-hollow,192,warrior,arms,6,2,4
Ulkharek,wyrmrest-accord,192,warrior,arms,6,2,4
Yeèzy,stormrage,192,warrior,arms,6,2,4
Draimän,ragnaros,192,warrior,arms,6,2,4
Trashish,tichondrius,192,warrior,arms,6,2,4
Berserkchow,sargeras,192,warrior,arms,6,2,4
Rendus,hyjal,192,warrior,arms,6,2,4
Armsracê,zuljin,192,warrior,arms,6,2,4
Stinkdog,khazgoroth,192,warrior,arms,6,2,4
Endlesskilla,destromath,192,warrior,arms,6,2,4
Berario,garrosh,192,warrior,arms,6,2,4
Vamsx,barthilas,192,warrior,arms,6,2,4
Liabilities,icecrown,192,warrior,arms,6,2,4
Dahakawar,malganis,192,warrior,arms,6,2,4
Doomtheog,tichondrius,192,warrior,arms,6,2,4
Rekshor,wyrmrest-accord,192,warrior,arms,6,2,4
Eurthx,lightbringer,192,warrior,arms,6,2,4
Raldoron,thrall,192,warrior,arms,6,2,4
Stebe,thunderlord,192,warrior,arms,6,2,4
Adonis,burning-blade,192,warrior,arms,6,2,4
Bamxz,stormrage,192,warrior,arms,6,2,4
Kénny,stormrage,192,warrior,arms,6,2,4
Zabutay,quelthalas,192,warrior,arms,6,2,4
Berserkur,daggerspine,192,warrior,arms,6,2,4
Negrus,sargeras,192,warrior,arms,6,2,4
Tarkvs,ragnaros,192,warrior,arms,6,2,4
Wl,ragnaros,192,warrior,arms,6,2,4
Crno,stormrage,192,warrior,arms,6,2,4
Hawaiianko,guldan,192,warrior,arms,6,2,4
Xtrego,quelthalas,192,warrior,arms,6,2,4
Bubbleho,thrall,192,warrior,arms,6,2,4
Rassius,sargeras,192,warrior,arms,6,2,4
Xkrieger,tichondrius,192,warrior,arms,6,2,4
Dunklad,thrall,192,warrior,arms,6,2,4
Scrubwarrior,black-dragonflight,192,warrior,arms,6,2,4
Annihilataur,blackhand,192,warrior,arms,6,2,4
Tüssèll,khazgoroth,192,warrior,arms,6,2,4
Jírky,ragnaros,192,warrior,arms,6,2,4
Sypii,malganis,192,warrior,arms,6,2,4
Wildawar,tichondrius,192,warrior,arms,6,2,4
Donpepe,sargeras,192,warrior,arms,6,2,4
Fùzzy,zuluhed,192,warrior,arms,6,2,4
Minionz,tichondrius,192,warrior,arms,6,2,4
Bradic,bladefist,192,warrior,arms,6,2,4
Helminth,kirin-tor,192,warrior,arms,6,2,4
Pornawar,area-52,192,warrior,arms,6,2,4
Bloodthristy,dunemaul,192,warrior,arms,6,2,4
Oow,barthilas,192,warrior,arms,6,2,4
Avansys,tichondrius,192,warrior,arms,6,2,4
Burstful,bleeding-hollow,192,warrior,arms,6,2,4
Slamzftw,stormreaver,192,warrior,arms,6,2,4
Flyaf,illidan,192,warrior,arms,6,2,4
Pandemonio,burning-legion,192,warrior,arms,6,2,4
Beârz,the-underbog,192,warrior,arms,6,2,4
Hitokïri,stormrage,192,warrior,arms,6,2,4
Tergg,silvermoon,192,warrior,arms,6,2,4
Diddlystix,illidan,192,warrior,arms,6,2,4
Roidragez,illidan,192,warrior,arms,6,2,4
Alitalia,thunderlord,192,warrior,arms,6,2,4
Dalmor,stormrage,192,warrior,arms,6,2,4
Zekken,blades-edge,192,warrior,arms,6,2,4
Kostikk,tichondrius,192,warrior,arms,6,2,4
Padregordo,stormrage,192,warrior,arms,6,2,4
Hellabandz,bleeding-hollow,192,warrior,arms,6,2,4
Ragepumper,stormrage,192,warrior,arms,6,2,4
Nabangle,barthilas,192,warrior,arms,6,2,4
Wakkawar,stormrage,192,warrior,arms,6,2,4
Tokushima,illidan,192,warrior,arms,6,2,4
Chapa,tichondrius,192,warrior,arms,6,2,4
Åmowarr,illidan,192,warrior,arms,6,2,4
Lazarenthus,stormrage,192,warrior,arms,6,2,4
Sweatyvols,illidan,192,warrior,arms,6,2,4
Düde,whisperwind,192,warrior,arms,6,2,4
Joelyyonerr,barthilas,192,warrior,arms,6,2,4
Stormbadge,tichondrius,192,warrior,arms,6,2,4
Dagorine,eredar,192,warrior,arms,6,2,4
Derr,tichondrius,192,warrior,arms,6,2,4
Lhariza,stormrage,192,warrior,arms,6,2,4
Mongofiera,quelthalas,192,warrior,arms,6,2,4
Arbitraiter,whisperwind,192,warrior,arms,6,2,4
Trenbopanda,tichondrius,192,warrior,arms,6,2,4
Fealix,moon-guard,192,warrior,arms,6,2,4
Pookythebear,tichondrius,192,warrior,arms,6,2,4
Saltycrakerz,area-52,192,warrior,arms,6,2,4
Guroku,tichondrius,192,warrior,arms,6,2,4
Focalabbys,illidan,192,warrior,arms,6,2,4
Saabre,tichondrius,192,warrior,arms,6,2,4
Surge,eredar,192,warrior,arms,6,2,4
Hookahmasta,area-52,192,warrior,arms,6,2,4
Dylberta,tichondrius,192,warrior,arms,6,2,4
Wooglinx,stormrage,192,warrior,arms,6,2,4
Uprisèn,illidan,192,warrior,arms,6,2,4
Oðín,emerald-dream,192,warrior,arms,6,2,4
Kvnñ,frostmourne,192,warrior,arms,6,2,4
Ggcthulu,area-52,192,warrior,arms,6,2,4
Richbear,kiljaeden,192,warrior,arms,6,2,4
Denival,proudmoore,192,warrior,arms,6,2,4
Oneeyewille,sargeras,192,warrior,arms,6,2,4
Sylvannlee,tichondrius,192,warrior,arms,6,2,4
Papichoppyme,bleeding-hollow,192,warrior,arms,6,2,4
Negrolas,nemesis,192,warrior,arms,6,2,4
Smokinaces,emerald-dream,192,warrior,arms,6,2,4
Toscö,quelthalas,192,warrior,arms,6,2,4
Guanabacoa,area-52,192,warrior,arms,6,2,4
Akaínu,area-52,192,warrior,arms,6,2,4
Kraff,tichondrius,192,warrior,arms,6,2,4
Iapologiz,illidan,192,warrior,arms,6,2,4
Àyo,frostmourne,192,warrior,arms,6,2,4
Jessicajinn,illidan,192,warrior,arms,6,2,4
Chuck,zangarmarsh,192,warrior,arms,6,2,4
Mututu,frostmourne,192,warrior,arms,6,2,4
Chrizo,area-52,192,warrior,arms,6,2,4
Ychazz,stormrage,192,warrior,arms,6,2,4
Playdohxt,frostmourne,192,warrior,arms,6,2,4
Okcomputer,bleeding-hollow,192,warrior,arms,6,2,4
Deloum,tichondrius,192,warrior,arms,6,2,4
Thresdan,emerald-dream,192,warrior,arms,6,2,4
Harlo,nerzhul,192,warrior,arms,6,2,4
Tonytonychop,chogall,192,warrior,arms,6,2,4
Xurug,zuljin,192,warrior,arms,6,2,4
Airolol,tichondrius,192,warrior,arms,6,2,4
Hagger,quelthalas,192,warrior,arms,6,2,4
Beilian,quelthalas,192,warrior,arms,6,2,4
Saltos,frostmourne,192,warrior,arms,6,2,4
Maleficous,tol-barad,192,warrior,arms,6,2,4
Ningz,tichondrius,192,warrior,arms,6,2,4
Jakelope,proudmoore,192,warrior,arms,6,2,4
Gátzú,ragnaros,192,warrior,arms,6,2,4
Bogii,area-52,192,warrior,arms,6,2,4
Urukaw,azralon,192,warrior,arms,6,2,4
Stavsie,tichondrius,192,warrior,arms,6,2,4
Troyana,azralon,192,warrior,arms,6,2,4
Deldramor,proudmoore,192,warrior,arms,6,2,4
Annubiis,tichondrius,192,warrior,arms,6,2,4
Tankum,dunemaul,192,warrior,arms,6,2,4
Warcryof,illidan,192,warrior,arms,6,2,4
Riggs,stonemaul,192,warrior,arms,6,2,4
Raazzawar,moon-guard,192,warrior,arms,6,2,4
Drtbag,tichondrius,192,warrior,arms,6,2,4
Variants,azralon,192,warrior,arms,6,2,4
Soldiër,proudmoore,192,warrior,arms,6,2,4
Overlordz,azralon,192,warrior,arms,6,2,4
Risr,illidan,192,warrior,arms,6,2,4
Orphenkaos,bleeding-hollow,192,warrior,arms,6,2,4
Tatro,tichondrius,192,warrior,arms,6,2,4
Pisagnòmos,quelthalas,192,warrior,arms,6,2,4
Orson,lothar,192,warrior,arms,6,2,4
Tnknspnk,stormrage,192,warrior,arms,6,2,4
Yeicomoon,ragnaros,192,warrior,arms,6,2,4
Warhova,area-52,192,warrior,arms,6,2,4
Fäey,dalaran,192,warrior,arms,6,2,4
Clumhaku,dalaran,192,warrior,arms,6,2,4
Kalabawph,area-52,192,warrior,arms,6,2,4
Icebringer,frostmourne,192,warrior,arms,6,2,4
Bloodscream,magtheridon,192,warrior,arms,6,2,4
Hurricán,tichondrius,192,warrior,arms,6,2,4
Tnknspnk,magtheridon,192,warrior,arms,6,2,4
Noblêsix,dalaran,192,warrior,arms,6,2,4
Tinykong,zuljin,192,warrior,arms,6,2,4
Creedmor,moon-guard,192,warrior,arms,6,2,4
Darkstrikee,tichondrius,192,warrior,arms,6,2,4
Nordrages,stormrage,192,warrior,arms,6,2,4
Pendrake,proudmoore,192,warrior,arms,6,2,4
Mahknut,moon-guard,192,warrior,arms,6,2,4
Dëckhand,proudmoore,192,warrior,arms,6,2,4
Depressedman,tichondrius,192,warrior,arms,6,2,4
Treeinchkokk,area-52,192,warrior,arms,6,2,4
Steelbane,moon-guard,192,warrior,arms,6,2,4
Çampbêll,area-52,192,warrior,arms,6,2,4
Bubjones,anvilmar,192,warrior,arms,6,2,4
Dodiru,azralon,192,warrior,arms,6,2,4
Playbox,area-52,192,warrior,arms,6,2,4
Zerríck,moon-guard,192,warrior,arms,6,2,4
Lavablood,moon-guard,192,warrior,arms,6,2,4
Vosnir,dalaran,192,warrior,arms,6,2,4
Smokingops,frostmourne,192,warrior,arms,6,2,4
Nerffrogues,stormrage,192,warrior,arms,6,2,4
Rawcancer,malganis,192,warrior,arms,6,2,4
Rí,moon-guard,192,warrior,arms,6,2,4
Mochigome,moon-guard,192,warrior,arms,6,2,4
Gio,duskwood,192,warrior,arms,6,2,4
Chopmeat,ysera,192,warrior,arms,6,2,4
Dracufeuer,bleeding-hollow,192,warrior,arms,6,2,4
Xaviorn,illidan,192,warrior,arms,6,2,4
Ällfather,proudmoore,192,warrior,arms,6,2,4
Bonetotem,azralon,192,warrior,arms,6,2,4
Beirdo,aegwynn,192,warrior,arms,6,2,4
Suavay,executus,192,warrior,arms,6,2,4
Kinaed,durotan,192,warrior,arms,6,2,4
Golmash,draenor,192,warrior,arms,6,2,4
Primørdíal,tichondrius,192,warrior,arms,6,2,4
Anabolicjim,frostmourne,192,warrior,arms,6,2,4
Bronzeblood,arthas,192,warrior,arms,6,2,4
Gtrain,barthilas,192,warrior,arms,6,2,4
Nezy,frostmourne,192,warrior,arms,6,2,4
Danksoms,arthas,192,warrior,arms,6,2,4
Vegr,queldorei,192,warrior,arms,6,2,4
Valky,sargeras,192,warrior,arms,6,2,4
Blackzone,lethon,192,warrior,arms,6,2,4
Shrexecute,tichondrius,192,warrior,arms,6,2,4
Freezyraw,zuljin,192,warrior,arms,6,2,4
Arkey,queldorei,192,warrior,arms,6,2,4
ßabybeef,azralon,192,warrior,arms,6,2,4
Braxxinn,tichondrius,192,warrior,arms,6,2,4
Admission,dalaran,192,warrior,arms,6,2,4
Lvcifer,akama,192,warrior,arms,6,2,4
Tormite,spirestone,192,warrior,arms,6,2,4
Bearlornan,frostmourne,192,warrior,arms,6,2,4
Frantic,korialstrasz,192,warrior,arms,6,2,4
Bigbungus,frostmourne,192,warrior,arms,6,2,4
Bjorgsen,frostmourne,192,warrior,arms,6,2,4
Pollere,firetree,192,warrior,arms,6,2,4
Moosoka,malorne,192,warrior,arms,6,2,4
Plata,akama,192,warrior,arms,6,2,4
Hawö,quelthalas,192,warrior,arms,6,2,4
Thiccthôt,frostmourne,192,warrior,arms,6,2,4
Daechoochoo,frostwolf,192,warrior,arms,6,2,4
Bizherp,ragnaros,192,warrior,arms,6,2,4
Amicus,frostmourne,192,warrior,arms,7,2,5
Sinenrs,tichondrius,192,warrior,arms,8,2,6
Zugzùgly,illidan,192,warrior,arms,8,2,6
Xavíerus,tichondrius,192,warrior,arms,9,2,7
Rexsi,korgath,192,warrior,arms,9,2,7
Redrunebar,illidan,192,warrior,arms,10,2,8
Duraffe,moon-guard,192,warrior,arms,10,2,8
Øverpowwer,azralon,192,warrior,arms,11,2,9
Hiddensquids,laughing-skull,192,warrior,arms,11,2,9
Falcmore,stormrage,192,warrior,arms,12,2,10
Grègore,stormrage,192,warrior,arms,12,2,10
Yoshiua,stormrage,192,warrior,arms,12,2,10
Lawlstørm,stormrage,192,warrior,arms,12,2,10
Item,nerzhul,192,warrior,arms,12,2,10
Mokthar,barthilas,192,warrior,arms,12,2,10
Kurzix,crushridge,192,warrior,arms,12,2,10
Cleaver,draka,192,warrior,arms,12,2,10
Avondwella,undermine,192,warrior,arms,12,2,10
Gouzizhang,proudmoore,192,warrior,arms,12,2,10
Hellswine,barthilas,192,warrior,arms,12,2,10
Haruq,tichondrius,192,warrior,arms,12,2,10
Arthurston,tichondrius,192,warrior,arms,12,2,10
Loktaromoose,frostmourne,192,warrior,arms,12,2,10
Connero,stormrage,192,warrior,arms,12,2,10
Hugezs,tichondrius,192,warrior,arms,12,2,10
Shaffer,bleeding-hollow,192,warrior,arms,12,2,10
Aymadommy,illidan,192,warrior,arms,12,2,10
Strongboii,tichondrius,192,warrior,arms,12,2,10
Gambii,moon-guard,192,warrior,arms,12,2,10
Ragekilla,silvermoon,192,warrior,arms,12,2,10
Pennyonebutt,barthilas,192,warrior,arms,12,2,10
Loveliuna,illidan,192,warrior,arms,12,2,10
Árades,tichondrius,192,warrior,arms,12,2,10
Killtrain,illidan,192,warrior,arms,12,2,10
Braygar,barthilas,192,warrior,arms,12,2,10
Spårtacus,illidan,192,warrior,arms,12,2,10
Léonwow,tichondrius,192,warrior,arms,12,2,10
Goretooth,moon-guard,192,warrior,arms,12,2,10
Artá,uldum,192,warrior,arms,12,2,10
Trollchopo,kiljaeden,192,warrior,arms,12,2,10
Arkenon,drakkari,192,warrior,arms,12,2,10
Erwin,kiljaeden,192,warrior,arms,12,2,10
Annyan,ragnaros,192,warrior,arms,12,2,10
Ohhgeekush,proudmoore,192,warrior,arms,12,2,10
Brutaltruth,dragonmaw,192,warrior,arms,12,2,10
Jsl,tichondrius,192,warrior,arms,12,2,10
Eravor,quelthalas,192,warrior,arms,12,2,10
Alvitr,kelthuzad,192,warrior,arms,12,2,10
Zulm,emerald-dream,192,warrior,arms,12,2,10
Jhalakni,quelthalas,192,warrior,arms,12,2,10
Daedrá,blackhand,192,warrior,arms,12,2,10
Lawyer,quelthalas,192,warrior,arms,12,2,10
Warhoofz,malganis,192,warrior,arms,12,2,10
Jiva,emerald-dream,192,warrior,arms,12,2,10
Gornal,sargeras,192,warrior,arms,12,2,10
Råging,area-52,192,warrior,arms,12,2,10
Bearyfresh,area-52,192,warrior,arms,12,2,10
Twoironfist,azralon,192,warrior,arms,12,2,10
Warmachîne,area-52,192,warrior,arms,12,2,10
Senia,coilfang,192,warrior,arms,13,2,11
Fallensoul,nazjatar,192,warrior,arms,14,2,12
Schecterguy,stormrage,192,warrior,arms,14,2,12
Escuamata,quelthalas,192,warrior,arms,18,2,16
Kebechett,emerald-dream,192,warrior,arms,18,2,16
Hazell,gundrak,191,warrior,arms,6,2,4
Chóps,quelthalas,191,warrior,arms,6,2,4
Blackkcow,zuljin,191,warrior,arms,6,2,4
Rezsicknéss,eonar,191,warrior,arms,6,2,4
Edrelang,bronzebeard,191,warrior,arms,6,2,4
Krátös,farstriders,191,warrior,arms,6,2,4
Americanbull,moon-guard,1399,warrior,protection,80,41,39
Graventhal,tichondrius,1192,warrior,protection,53,25,28
Percaderp,barthilas,1158,warrior,protection,63,30,33
Thororan,whisperwind,845,warrior,protection,27,10,17
Appolyonn,hyjal,836,warrior,protection,43,17,26
Nansitao,kelthuzad,758,warrior,protection,30,8,22
Rhuk,drakkari,739,warrior,protection,36,8,28
Logan,twisting-nether,705,warrior,protection,44,12,32
Smelldrglove,frostmourne,692,warrior,protection,32,12,20
Toothnnailz,destromath,628,warrior,protection,24,7,17
Lagurtz,ragnaros,576,warrior,protection,18,6,12
Ghostoffury,thrall,574,warrior,protection,12,6,6
Meadier,windrunner,566,warrior,protection,12,6,6
Stophitingme,bloodscalp,525,warrior,protection,40,10,30
Archaòn,frostmourne,473,warrior,protection,12,5,7
Ksubîî,frostmourne,448,warrior,protection,16,5,11
Dabdaddyy,dawnbringer,384,warrior,protection,6,4,2
Kidkolby,moon-guard,384,warrior,protection,12,4,8
Manthraxx,sargeras,288,warrior,protection,6,3,3
Metalhog,sargeras,288,warrior,protection,6,3,3
Chàrr,crushridge,288,warrior,protection,15,4,11
Zatu,moknathal,285,warrior,protection,12,3,9
Tåra,area-52,256,warrior,protection,22,3,19
Executespam,madoran,192,warrior,protection,6,2,4
Awfulzone,malganis,192,warrior,protection,12,2,10
Strongtongue,malganis,192,warrior,protection,12,2,10
Bulldozer,terokkar,192,warrior,protection,12,2,10
Loonycity,arygos,192,warrior,protection,12,2,10
Fearless,moon-guard,96,warrior,protection,6,1,5
Lunusx,stormrage,96,warrior,protection,6,1,5
Joralion,frostmourne,96,warrior,protection,6,1,5
Shadowyfreak,blackrock,96,warrior,protection,12,1,11
Varith,sargeras,96,warrior,protection,18,1,17
Mannorth,aerie-peak,95,warrior,protection,6,1,5
Piojowar,quelthalas,95,warrior,protection,6,1,5
Jindyn,boulderfist,95,warrior,protection,6,1,5
Stowdace,bladefist,89,warrior,protection,10,5,5
Axiyum,tichondrius,79,warrior,protection,5,1,4
Juicey,burning-blade,31,warrior,protection,2,1,1
Malvinö,azralon,16,warrior,protection,1,1,0
