,name,realm,rating,cls,spec,play,win,lose
0,Phearbunny,bleeding-hollow,1469,deathknight,blood,66,32,34
1,Pagumon,moon-guard,1421,deathknight,blood,126,65,61
2,Bloodbukkaky,bleeding-hollow,1201,deathknight,blood,42,13,29
3,Tiumau,goldrinn,1088,deathknight,blood,54,23,31
4,Tragül,sargeras,1012,deathknight,blood,36,16,20
5,Valind,eredar,854,deathknight,blood,18,9,9
6,Kult,azralon,841,deathknight,blood,12,9,3
7,Insonne,dalaran,837,deathknight,blood,18,9,9
8,Réndwarchièf,garrosh,749,deathknight,blood,15,9,6
9,Blasphemus,malganis,575,deathknight,blood,12,6,6
10,Kaîne,dalaran,480,deathknight,blood,12,5,7
11,Belfknightt,area-52,479,deathknight,blood,15,5,10
12,Tristam,area-52,384,deathknight,blood,6,4,2
13,Pride,ragnaros,384,deathknight,blood,12,4,8
14,He,echo-isles,383,deathknight,blood,6,4,2
15,ßläzë,baelgun,288,deathknight,blood,15,4,11
16,Kimbøslîce,area-52,288,deathknight,blood,12,3,9
17,Neroxzdvm,area-52,192,deathknight,blood,6,2,4
18,Cerbeefquake,wyrmrest-accord,192,deathknight,blood,12,2,10
19,Eteson,tichondrius,191,deathknight,blood,6,2,4
20,Unhølydøøm,misha,191,deathknight,blood,12,2,10
21,Lunatick,darkspear,96,deathknight,blood,6,1,5
22,Gnargnarr,firetree,96,deathknight,blood,6,1,5
23,Wowattorney,tichondrius,96,deathknight,blood,6,1,5
24,Cozzasad,barthilas,96,deathknight,blood,6,1,5
25,Nbayoungboy,kiljaeden,96,deathknight,blood,6,1,5
26,Determinate,deathwing,96,deathknight,blood,6,1,5
27,Hulmorr,bleeding-hollow,64,deathknight,blood,4,1,3
28,Zerhistran,proudmoore,64,deathknight,blood,4,1,3
29,Graphics,moon-guard,2125,deathknight,unholy,382,194,188
30,Pwaff,illidan,2125,deathknight,unholy,89,45,44
31,Neroxz,area-52,2105,deathknight,unholy,83,43,40
32,Qipara,zuljin,2104,deathknight,unholy,163,87,76
33,Partywaffles,illidan,2079,deathknight,unholy,259,133,126
34,Spaidzz,malganis,2076,deathknight,unholy,199,100,99
35,Níngjìng,tichondrius,2074,deathknight,unholy,84,43,41
36,Flarkness,area-52,2010,deathknight,unholy,78,37,41
37,Búddy,zuljin,1992,deathknight,unholy,94,45,49
38,Achílles,sargeras,1979,deathknight,unholy,175,85,90
39,Scriptløl,sargeras,1975,deathknight,unholy,138,66,72
40,Roidboy,illidan,1954,deathknight,unholy,115,57,58
41,Vineyard,area-52,1942,deathknight,unholy,287,143,144
42,Toxicwaste,malganis,1942,deathknight,unholy,82,39,43
43,Juelzjerk,tichondrius,1918,deathknight,unholy,101,54,47
44,Mårlbørø,tichondrius,1915,deathknight,unholy,41,21,20
45,Darkdj,kelthuzad,1914,deathknight,unholy,73,34,39
46,Éternalnight,tichondrius,1913,deathknight,unholy,76,32,44
47,Zynyzter,malganis,1912,deathknight,unholy,72,41,31
48,Veilsidé,kelthuzad,1910,deathknight,unholy,250,125,125
49,Killinois,tichondrius,1910,deathknight,unholy,47,21,26
50,Brutos,thrall,1905,deathknight,unholy,98,55,43
51,Geomdae,tichondrius,1901,deathknight,unholy,71,31,40
52,Barelyviable,tichondrius,1898,deathknight,unholy,72,32,40
53,Pradas,area-52,1897,deathknight,unholy,100,51,49
54,Dkya,tichondrius,1891,deathknight,unholy,224,113,111
55,Malhandir,bleeding-hollow,1880,deathknight,unholy,41,23,18
56,Cardii,area-52,1877,deathknight,unholy,124,63,61
57,Kilohotel,stormrage,1873,deathknight,unholy,42,25,17
58,Ilceses,area-52,1870,deathknight,unholy,66,29,37
59,Catarïa,tichondrius,1869,deathknight,unholy,90,44,46
60,Iato,sargeras,1868,deathknight,unholy,60,39,21
61,Drauguss,azralon,1860,deathknight,unholy,106,53,53
62,Cavaliers,ragnaros,1860,deathknight,unholy,66,32,34
63,Lattè,area-52,1859,deathknight,unholy,55,30,25
64,Bloodbruh,blackrock,1854,deathknight,unholy,60,34,26
65,Tduggylolz,tichondrius,1851,deathknight,unholy,60,26,34
66,Bedstains,thunderlord,1850,deathknight,unholy,113,64,49
67,Morbiddesire,stormrage,1849,deathknight,unholy,87,49,38
68,Ceomdae,tichondrius,1849,deathknight,unholy,60,29,31
69,Didri,quelthalas,1846,deathknight,unholy,72,34,38
70,Nixonxx,tichondrius,1843,deathknight,unholy,94,58,36
71,Tokyotimxx,malganis,1842,deathknight,unholy,48,30,18
72,Azhid,tichondrius,1841,deathknight,unholy,130,70,60
73,Cloüd,wyrmrest-accord,1841,deathknight,unholy,64,31,33
74,Bicepsüal,zuljin,1840,deathknight,unholy,36,28,8
75,Bruceleedk,tichondrius,1839,deathknight,unholy,100,51,49
76,Milleh,bleeding-hollow,1838,deathknight,unholy,78,35,43
77,Riddles,maiev,1837,deathknight,unholy,119,64,55
78,Blackfyré,sargeras,1837,deathknight,unholy,62,32,30
79,Haldevarik,doomhammer,1834,deathknight,unholy,78,43,35
80,Orphanmakerx,area-52,1832,deathknight,unholy,123,60,63
81,Zerhistran,proudmoore,1831,deathknight,unholy,254,136,118
82,Goonà,tichondrius,1831,deathknight,unholy,63,29,34
83,Aurious,lightnings-blade,1830,deathknight,unholy,84,47,37
84,Kortingert,nagrand,1830,deathknight,unholy,59,33,26
85,Wøund,black-dragonflight,1830,deathknight,unholy,220,112,108
86,Anatøly,ragnaros,1827,deathknight,unholy,42,21,21
87,Soulhand,tichondrius,1826,deathknight,unholy,104,57,47
88,Arthez,frostmourne,1824,deathknight,unholy,72,38,34
89,Sadboy,grizzly-hills,1822,deathknight,unholy,65,27,38
90,Zerøimperial,quelthalas,1821,deathknight,unholy,209,111,98
91,Altareon,ragnaros,1820,deathknight,unholy,150,79,71
92,Serwestley,stormrage,1820,deathknight,unholy,59,31,28
93,Kciktep,tichondrius,1819,deathknight,unholy,36,19,17
94,Aerd,sargeras,1819,deathknight,unholy,251,126,125
95,Hrsb,tichondrius,1817,deathknight,unholy,124,68,56
96,Poesoul,tichondrius,1817,deathknight,unholy,261,131,130
97,Skideroth,kelthuzad,1817,deathknight,unholy,60,28,32
98,Hwml,barthilas,1816,deathknight,unholy,93,54,39
99,Flizzycash,malganis,1816,deathknight,unholy,56,27,29
100,Õdin,area-52,1815,deathknight,unholy,203,103,100
101,Wowattorney,tichondrius,1815,deathknight,unholy,82,33,49
102,Xebane,frostmourne,1812,deathknight,unholy,348,182,166
103,Ravindrannor,saurfang,1812,deathknight,unholy,65,32,33
104,Dahnga,frostmourne,1811,deathknight,unholy,54,32,22
105,Plagueflavor,tichondrius,1811,deathknight,unholy,306,152,154
106,Fatzilla,tichondrius,1811,deathknight,unholy,66,26,40
107,Keomdae,tichondrius,1809,deathknight,unholy,59,30,29
108,Warrcc,steamwheedle-cartel,1809,deathknight,unholy,48,24,24
109,Evilduck,ragnaros,1808,deathknight,unholy,66,37,29
110,Infectik,tichondrius,1807,deathknight,unholy,59,35,24
111,Anhedonía,illidan,1807,deathknight,unholy,162,86,76
112,Chillbaynê,the-scryers,1807,deathknight,unholy,119,62,57
113,Jakeboyswag,shandris,1807,deathknight,unholy,143,73,70
114,Ddibb,tichondrius,1807,deathknight,unholy,57,28,29
115,Brocigar,tichondrius,1806,deathknight,unholy,84,43,41
116,Sagadk,hyjal,1806,deathknight,unholy,70,33,37
117,Necrôtic,area-52,1806,deathknight,unholy,76,35,41
118,Twindleroot,aggramar,1804,deathknight,unholy,77,45,32
119,Mûs,tichondrius,1804,deathknight,unholy,66,36,30
120,Kaeligh,ragnaros,1803,deathknight,unholy,66,29,37
121,Ziskon,illidan,1802,deathknight,unholy,100,53,47
122,Zìlêán,tichondrius,1800,deathknight,unholy,70,39,31
123,Harókz,azralon,1800,deathknight,unholy,65,31,34
124,Azre,tichondrius,1800,deathknight,unholy,160,74,86
125,Starshopping,proudmoore,1799,deathknight,unholy,85,41,44
126,Avengering,tichondrius,1794,deathknight,unholy,75,40,35
127,Brandonsdk,tichondrius,1794,deathknight,unholy,143,71,72
128,Muspellheim,azralon,1791,deathknight,unholy,54,29,25
129,Attack,grizzly-hills,1787,deathknight,unholy,60,28,32
130,Boneyards,bleeding-hollow,1787,deathknight,unholy,96,43,53
131,Daoniancc,tichondrius,1784,deathknight,unholy,322,168,154
132,Nabbiby,tichondrius,1784,deathknight,unholy,72,33,39
133,Áethros,malganis,1778,deathknight,unholy,96,44,52
134,Thorediks,stormrage,1777,deathknight,unholy,54,27,27
135,Skippee,tichondrius,1775,deathknight,unholy,54,24,30
136,Grimiz,tichondrius,1774,deathknight,unholy,145,71,74
137,Demonboyjr,tichondrius,1766,deathknight,unholy,75,31,44
138,Asukka,tichondrius,1763,deathknight,unholy,72,29,43
139,Apøçálýpsé,firetree,1761,deathknight,unholy,67,35,32
140,Goonaa,tichondrius,1760,deathknight,unholy,54,27,27
141,Sinell,kargath,1753,deathknight,unholy,139,75,64
142,Xiaodabaolol,tichondrius,1751,deathknight,unholy,48,26,22
143,Stankybreath,bleeding-hollow,1750,deathknight,unholy,58,27,31
144,Cesaroo,aegwynn,1747,deathknight,unholy,100,49,51
145,Muspel,sargeras,1746,deathknight,unholy,59,28,31
146,Standalizer,gilneas,1745,deathknight,unholy,72,40,32
147,Ermanotruta,azralon,1744,deathknight,unholy,77,37,40
148,Carryme,quelthalas,1742,deathknight,unholy,92,45,47
149,Xibbas,illidan,1741,deathknight,unholy,48,27,21
150,Nh,malganis,1737,deathknight,unholy,54,28,26
151,Teksurugi,korgath,1734,deathknight,unholy,60,32,28
152,Zìlêáns,tichondrius,1730,deathknight,unholy,84,50,34
153,Exaar,tichondrius,1730,deathknight,unholy,63,27,36
154,Nevermore,hyjal,1727,deathknight,unholy,113,57,56
155,Arroyo,borean-tundra,1724,deathknight,unholy,54,29,25
156,Hatrèd,quelthalas,1724,deathknight,unholy,71,36,35
157,Doombeast,area-52,1722,deathknight,unholy,72,32,40
158,Ålastor,stormrage,1721,deathknight,unholy,58,32,26
159,Sussybakadk,sargeras,1718,deathknight,unholy,58,27,31
160,Nalz,drakkari,1716,deathknight,unholy,135,71,64
161,Lazarise,area-52,1713,deathknight,unholy,71,34,37
162,Tkyo,tichondrius,1712,deathknight,unholy,47,22,25
163,Huuzzha,tichondrius,1706,deathknight,unholy,124,69,55
164,Komplex,kelthuzad,1705,deathknight,unholy,64,36,28
165,Volyant,frostmourne,1704,deathknight,unholy,48,22,26
166,Dâki,blades-edge,1702,deathknight,unholy,108,61,47
167,Koda,thrall,1701,deathknight,unholy,77,36,41
168,Justafkdk,gorefiend,1700,deathknight,unholy,84,43,41
169,Kinkysgnome,tichondrius,1696,deathknight,unholy,131,61,70
170,Krätos,zuljin,1694,deathknight,unholy,36,23,13
171,Ðomìnus,moon-guard,1693,deathknight,unholy,96,57,39
172,Barakhenaku,illidan,1692,deathknight,unholy,36,20,16
173,Mephostophel,sargeras,1688,deathknight,unholy,168,88,80
174,Onefire,illidan,1680,deathknight,unholy,59,29,30
175,Fakiez,kelthuzad,1679,deathknight,unholy,68,30,38
176,Nevmic,emerald-dream,1677,deathknight,unholy,155,74,81
177,Falkorn,korgath,1675,deathknight,unholy,69,33,36
178,Wittlewanka,zuljin,1675,deathknight,unholy,40,18,22
179,Blacklabel,andorhal,1675,deathknight,unholy,72,31,41
180,Dunduner,tichondrius,1672,deathknight,unholy,90,44,46
181,Noik,azralon,1671,deathknight,unholy,87,41,46
182,Cantmove,area-52,1669,deathknight,unholy,50,22,28
183,Malhandir,azgalor,1668,deathknight,unholy,54,20,34
184,Spacealien,malganis,1667,deathknight,unholy,60,32,28
185,Howdoulose,illidan,1667,deathknight,unholy,48,22,26
186,Darktone,tichondrius,1665,deathknight,unholy,35,18,17
187,Slty,tichondrius,1664,deathknight,unholy,42,18,24
188,Lichtborne,illidan,1662,deathknight,unholy,73,33,40
189,Azynks,azralon,1660,deathknight,unholy,102,47,55
190,Ståtìc,tichondrius,1659,deathknight,unholy,78,40,38
191,Imadkloldie,frostmourne,1659,deathknight,unholy,90,46,44
192,Bellum,moon-guard,1658,deathknight,unholy,99,56,43
193,Properterps,bonechewer,1658,deathknight,unholy,122,67,55
194,Xhoul,sargeras,1658,deathknight,unholy,195,106,89
195,Bopalop,malganis,1657,deathknight,unholy,69,28,41
196,Kjarnda,malganis,1653,deathknight,unholy,48,21,27
197,Yubell,barthilas,1652,deathknight,unholy,275,138,137
198,Pooseunpoose,velen,1652,deathknight,unholy,84,40,44
199,Ullísés,ragnaros,1651,deathknight,unholy,45,24,21
200,Trumps,stormrage,1649,deathknight,unholy,48,27,21
201,Ludgan,stormrage,1649,deathknight,unholy,180,86,94
202,Floreon,tichondrius,1648,deathknight,unholy,41,23,18
203,Lighostx,tichondrius,1647,deathknight,unholy,52,22,30
204,Merados,quelthalas,1646,deathknight,unholy,79,30,49
205,Tråuma,uther,1645,deathknight,unholy,42,22,20
206,Vexxan,thrall,1644,deathknight,unholy,41,23,18
207,Galarick,area-52,1643,deathknight,unholy,41,22,19
208,Ligmagooch,tichondrius,1642,deathknight,unholy,87,45,42
209,Lichanis,bonechewer,1641,deathknight,unholy,60,30,30
210,Tailm,ragnaros,1639,deathknight,unholy,36,20,16
211,Billieeilish,sargeras,1638,deathknight,unholy,36,21,15
212,Dkdanim,tichondrius,1637,deathknight,unholy,130,71,59
213,Vynox,frostmourne,1637,deathknight,unholy,56,27,29
214,Khaíne,wyrmrest-accord,1634,deathknight,unholy,175,90,85
215,Grimmdreamer,stormrage,1634,deathknight,unholy,76,37,39
216,Søad,quelthalas,1633,deathknight,unholy,94,52,42
217,Raps,frostmourne,1632,deathknight,unholy,56,23,33
218,Lùcius,garrosh,1631,deathknight,unholy,154,82,72
219,Kakarotó,azralon,1629,deathknight,unholy,53,30,23
220,Fasterjake,sargeras,1629,deathknight,unholy,110,59,51
221,Zerochillz,sargeras,1628,deathknight,unholy,30,17,13
222,Kenishii,kiljaeden,1627,deathknight,unholy,48,30,18
223,Landez,ragnaros,1627,deathknight,unholy,66,37,29
224,Krargosh,quelthalas,1627,deathknight,unholy,173,89,84
225,Wastethis,sargeras,1626,deathknight,unholy,71,40,31
226,Hhasaki,area-52,1626,deathknight,unholy,152,78,74
227,Paratekdk,thrall,1625,deathknight,unholy,71,39,32
228,Megatroun,stormreaver,1625,deathknight,unholy,42,23,19
229,Bladê,tichondrius,1624,deathknight,unholy,61,26,35
230,Jeremiahe,hyjal,1622,deathknight,unholy,84,45,39
231,Kwolve,proudmoore,1621,deathknight,unholy,237,118,119
232,Xraduky,dawnbringer,1620,deathknight,unholy,38,26,12
233,Gripyourhoe,tichondrius,1619,deathknight,unholy,42,26,16
234,Elogy,velen,1619,deathknight,unholy,60,34,26
235,Wheatasil,garona,1618,deathknight,unholy,64,33,31
236,Ayooplaguez,guldan,1617,deathknight,unholy,42,19,23
237,Supblood,tichondrius,1614,deathknight,unholy,36,20,16
238,Drpepp,bleeding-hollow,1614,deathknight,unholy,137,75,62
239,Kurnoth,barthilas,1614,deathknight,unholy,104,49,55
240,Boofcigars,sargeras,1612,deathknight,unholy,42,21,21
241,Rezøk,ragnaros,1612,deathknight,unholy,54,20,34
242,Ðogmá,vashj,1610,deathknight,unholy,35,22,13
243,Mikoaa,bladefist,1610,deathknight,unholy,30,17,13
244,Lagmasterx,sargeras,1609,deathknight,unholy,42,20,22
245,Ousted,daggerspine,1608,deathknight,unholy,36,20,16
246,Ilikelydead,tichondrius,1608,deathknight,unholy,66,32,34
247,Deuter,quelthalas,1606,deathknight,unholy,204,105,99
248,Takeurcheeks,tichondrius,1605,deathknight,unholy,101,49,52
249,Ãstaroth,stormrage,1605,deathknight,unholy,48,22,26
250,Notorious,garrosh,1605,deathknight,unholy,42,18,24
251,Thotiannaqt,area-52,1605,deathknight,unholy,42,17,25
252,Boofcigars,kelthuzad,1604,deathknight,unholy,77,41,36
253,Unholykevin,sargeras,1604,deathknight,unholy,42,21,21
254,Dominos,tichondrius,1604,deathknight,unholy,42,20,22
255,Idodamn,tichondrius,1603,deathknight,unholy,84,45,39
256,Wednesdæ,moon-guard,1603,deathknight,unholy,54,28,26
257,Voncleaver,tichondrius,1603,deathknight,unholy,64,20,44
258,Gargoylepowa,nemesis,1602,deathknight,unholy,42,20,22
259,Nofoamlattes,thrall,1602,deathknight,unholy,42,19,23
260,Puppykisses,perenolde,1602,deathknight,unholy,89,38,51
261,Originalcimm,stormrage,1601,deathknight,unholy,60,25,35
262,Promotheseis,sargeras,1600,deathknight,unholy,66,41,25
263,Lickblood,sargeras,1600,deathknight,unholy,30,17,13
264,Burbash,moon-guard,1600,deathknight,unholy,79,41,38
265,Giznator,malganis,1598,deathknight,unholy,108,50,58
266,Bukum,zuljin,1598,deathknight,unholy,53,20,33
267,Aldebamuu,ragnaros,1592,deathknight,unholy,90,46,44
268,Shadow,ragnaros,1591,deathknight,unholy,55,30,25
269,Ulísés,ragnaros,1591,deathknight,unholy,58,20,38
270,Arcticc,area-52,1589,deathknight,unholy,48,21,27
271,Kellydean,moon-guard,1588,deathknight,unholy,78,41,37
272,Libitina,tichondrius,1587,deathknight,unholy,30,19,11
273,Telrenaur,proudmoore,1587,deathknight,unholy,42,22,20
274,Aidsbenedict,malganis,1586,deathknight,unholy,54,20,34
275,Papalich,stormrage,1582,deathknight,unholy,132,65,67
276,Daethiel,demon-soul,1580,deathknight,unholy,59,27,32
277,Morrticia,malganis,1579,deathknight,unholy,31,22,9
278,Nøsfferatus,azralon,1579,deathknight,unholy,65,34,31
279,Frostbite,the-venture-co,1577,deathknight,unholy,84,48,36
280,Auniel,gorefiend,1577,deathknight,unholy,48,19,29
281,Orkky,jubeithos,1573,deathknight,unholy,104,50,54
282,Kaaizer,azralon,1572,deathknight,unholy,120,68,52
283,Loongdk,kiljaeden,1572,deathknight,unholy,121,57,64
284,Fydedk,stormrage,1571,deathknight,unholy,60,29,31
285,Brß,tichondrius,1570,deathknight,unholy,36,19,17
286,Läskö,area-52,1569,deathknight,unholy,55,34,21
287,Onlyfunss,moon-guard,1568,deathknight,unholy,108,52,56
288,Evilbot,tichondrius,1564,deathknight,unholy,60,40,20
289,Lichkong,dalaran,1561,deathknight,unholy,59,33,26
290,Zzdk,thrall,1561,deathknight,unholy,48,23,25
291,Demonnation,illidan,1556,deathknight,unholy,114,49,65
292,Emopalli,tichondrius,1554,deathknight,unholy,128,65,63
293,Døømhøund,tichondrius,1554,deathknight,unholy,92,43,49
294,Siphilusxo,dalaran,1551,deathknight,unholy,36,20,16
295,Toophus,sargeras,1551,deathknight,unholy,74,35,39
296,Arc,maiev,1551,deathknight,unholy,87,36,51
297,Alistra,frostmourne,1550,deathknight,unholy,36,17,19
298,Tuicca,frostmane,1550,deathknight,unholy,79,34,45
299,Kuwarerubana,proudmoore,1549,deathknight,unholy,74,41,33
300,Catena,blood-furnace,1548,deathknight,unholy,71,32,39
301,Kalgor,illidan,1544,deathknight,unholy,114,58,56
302,Drfauci,boulderfist,1544,deathknight,unholy,36,18,18
303,Takeoverr,ragnaros,1543,deathknight,unholy,78,48,30
304,Deathwavez,cenarius,1537,deathknight,unholy,42,21,21
305,Garht,azralon,1533,deathknight,unholy,40,22,18
306,Chachio,kiljaeden,1532,deathknight,unholy,30,16,14
307,Nymppho,kelthuzad,1532,deathknight,unholy,193,85,108
308,Arktoz,tichondrius,1531,deathknight,unholy,30,16,14
309,Clearlol,bleeding-hollow,1531,deathknight,unholy,36,16,20
310,Dialysis,emerald-dream,1530,deathknight,unholy,137,68,69
311,Kindaholy,malganis,1528,deathknight,unholy,23,17,6
312,Nokenoke,illidan,1528,deathknight,unholy,190,97,93
313,Biefeile,tichondrius,1526,deathknight,unholy,40,18,22
314,Risottonero,kelthuzad,1524,deathknight,unholy,165,87,78
315,Deathbloss,illidan,1523,deathknight,unholy,32,17,15
316,Gottajuice,moonrunner,1522,deathknight,unholy,57,32,25
317,Tigs,proudmoore,1522,deathknight,unholy,126,65,61
318,Rixin,agamaggan,1520,deathknight,unholy,54,22,32
319,Zaxrree,malganis,1519,deathknight,unholy,60,37,23
320,Raíndrop,tichondrius,1519,deathknight,unholy,102,54,48
321,Azibar,moon-guard,1519,deathknight,unholy,35,17,18
322,Wisdôm,frostmourne,1518,deathknight,unholy,47,21,26
323,Hooterzqt,tichondrius,1518,deathknight,unholy,106,47,59
324,Dóm,proudmoore,1516,deathknight,unholy,66,29,37
325,Zedsdead,mannoroth,1514,deathknight,unholy,24,16,8
326,Deathzpeckt,tichondrius,1513,deathknight,unholy,36,17,19
327,Devillele,proudmoore,1509,deathknight,unholy,78,36,42
328,Elyxoxo,tichondrius,1507,deathknight,unholy,54,25,29
329,Fadedlight,zuljin,1506,deathknight,unholy,96,47,49
330,Dexarax,norgannon,1505,deathknight,unholy,87,49,38
331,Urieen,gorefiend,1505,deathknight,unholy,77,43,34
332,Coldsleeps,saurfang,1503,deathknight,unholy,30,16,14
333,Unfórgíven,arthas,1501,deathknight,unholy,48,17,31
334,Cammy,frostmourne,1500,deathknight,unholy,29,16,13
335,Obedient,firetree,1499,deathknight,unholy,114,65,49
336,Axeldrion,tichondrius,1499,deathknight,unholy,35,17,18
337,Abroham,arthas,1498,deathknight,unholy,59,30,29
338,Câpîrota,nemesis,1498,deathknight,unholy,46,23,23
339,Stoicïsm,tichondrius,1496,deathknight,unholy,102,57,45
340,Asheravon,moon-guard,1495,deathknight,unholy,271,129,142
341,Naxn,tichondrius,1495,deathknight,unholy,54,25,29
342,Apocxo,lightnings-blade,1491,deathknight,unholy,119,58,61
343,Ams,moon-guard,1490,deathknight,unholy,48,27,21
344,Ghoulslasher,bleeding-hollow,1490,deathknight,unholy,62,28,34
345,Kcorides,tichondrius,1488,deathknight,unholy,49,28,21
346,Laxatives,tichondrius,1488,deathknight,unholy,45,19,26
347,Thenin,crushridge,1487,deathknight,unholy,54,32,22
348,Blackary,emerald-dream,1486,deathknight,unholy,47,30,17
349,Jaxxftw,azralon,1485,deathknight,unholy,46,27,19
350,Deezwaz,draka,1485,deathknight,unholy,40,21,19
351,Fanggrief,proudmoore,1485,deathknight,unholy,54,26,28
352,Typhøn,illidan,1484,deathknight,unholy,157,78,79
353,Coolk,tichondrius,1482,deathknight,unholy,48,31,17
354,Saighast,illidan,1482,deathknight,unholy,72,39,33
355,Unholyfish,malganis,1482,deathknight,unholy,103,52,51
356,Zaluster,malganis,1479,deathknight,unholy,143,72,71
357,Allianknight,windrunner,1479,deathknight,unholy,36,17,19
358,Brounlyii,drakkari,1478,deathknight,unholy,54,35,19
359,Tiansama,ragnaros,1478,deathknight,unholy,30,18,12
360,Alexeous,wyrmrest-accord,1477,deathknight,unholy,160,85,75
361,Nialich,kelthuzad,1476,deathknight,unholy,41,16,25
362,Eldavò,quelthalas,1473,deathknight,unholy,54,25,29
363,Beeftip,area-52,1471,deathknight,unholy,155,76,79
364,Aradorn,azralon,1470,deathknight,unholy,160,77,83
365,Gankstagrip,anvilmar,1469,deathknight,unholy,85,43,42
366,Grayfoxx,twisting-nether,1469,deathknight,unholy,41,18,23
367,Brisblade,shattered-hand,1468,deathknight,unholy,48,26,22
368,Mortarîon,icecrown,1467,deathknight,unholy,138,66,72
369,Xlive,tichondrius,1466,deathknight,unholy,42,17,25
370,Buttrfingrz,cenarius,1465,deathknight,unholy,54,22,32
371,Tronnie,kelthuzad,1463,deathknight,unholy,72,37,35
372,Grimnuts,thrall,1463,deathknight,unholy,60,29,31
373,Regiknight,stormrage,1462,deathknight,unholy,176,97,79
374,Rhaeisxalnym,sargeras,1460,deathknight,unholy,106,52,54
375,Släke,azralon,1460,deathknight,unholy,160,78,82
376,Rk,blackhand,1457,deathknight,unholy,97,58,39
377,Banjingquan,tichondrius,1457,deathknight,unholy,59,33,26
378,Wryu,malganis,1451,deathknight,unholy,35,21,14
379,Fallen,nazjatar,1450,deathknight,unholy,30,19,11
380,Allhejluya,illidan,1449,deathknight,unholy,199,101,98
381,Genjírou,frostwolf,1449,deathknight,unholy,224,110,114
382,Balboskina,shattered-hand,1448,deathknight,unholy,76,39,37
383,Paulpatine,tichondrius,1448,deathknight,unholy,54,21,33
384,Pmpfrmdwntwn,stormrage,1447,deathknight,unholy,61,26,35
385,Tracyminaj,tichondrius,1445,deathknight,unholy,60,27,33
386,Starms,ragnaros,1445,deathknight,unholy,65,29,36
387,Knownkilla,hyjal,1444,deathknight,unholy,77,45,32
388,Garù,ragnaros,1444,deathknight,unholy,56,29,27
389,Nightskull,malganis,1444,deathknight,unholy,36,18,18
390,Gerometal,ragnaros,1440,deathknight,unholy,42,18,24
391,Breadtruck,area-52,1440,deathknight,unholy,75,31,44
392,Dreadfang,the-venture-co,1438,deathknight,unholy,24,15,9
393,Corrpsse,tichondrius,1438,deathknight,unholy,157,81,76
394,Pettyk,tichondrius,1438,deathknight,unholy,36,15,21
395,Redbr,tichondrius,1437,deathknight,unholy,78,37,41
396,Flavorchops,kelthuzad,1437,deathknight,unholy,48,16,32
397,Steamerboy,stormrage,1436,deathknight,unholy,30,15,15
398,Yadaddy,hydraxis,1434,deathknight,unholy,36,21,15
399,Ningjinglol,tichondrius,1434,deathknight,unholy,30,15,15
400,Greenduck,malganis,1433,deathknight,unholy,30,15,15
401,Unknowndk,kul-tiras,1433,deathknight,unholy,36,17,19
402,Exin,cenarion-circle,1432,deathknight,unholy,24,15,9
403,Moonjae,illidan,1432,deathknight,unholy,24,15,9
404,Halvôr,moon-guard,1431,deathknight,unholy,132,70,62
405,Coffeebagel,bleeding-hollow,1426,deathknight,unholy,149,65,84
406,Anexdk,korgath,1423,deathknight,unholy,24,15,9
407,Jarah,destromath,1422,deathknight,unholy,54,25,29
408,Sannistus,ysera,1420,deathknight,unholy,97,43,54
409,Sgtdead,thrall,1418,deathknight,unholy,63,35,28
410,Hornpipe,borean-tundra,1418,deathknight,unholy,126,61,65
411,Rycerzfrost,ragnaros,1418,deathknight,unholy,54,21,33
412,Fellenn,stormrage,1417,deathknight,unholy,144,78,66
413,Deathofchaos,smolderthorn,1417,deathknight,unholy,65,25,40
414,Seranta,wyrmrest-accord,1417,deathknight,unholy,54,19,35
415,Sniperlord,uldaman,1415,deathknight,unholy,90,51,39
416,Fuzzknight,ravenholdt,1414,deathknight,unholy,30,15,15
417,Subparatbest,chogall,1414,deathknight,unholy,30,15,15
418,Dûsk,thunderlord,1413,deathknight,unholy,52,21,31
419,Ganancïa,nemesis,1412,deathknight,unholy,39,22,17
420,Reinhartlol,sargeras,1411,deathknight,unholy,81,38,43
421,Deathpool,shadowmoon,1409,deathknight,unholy,54,19,35
422,Seiyokú,ragnaros,1408,deathknight,unholy,74,38,36
423,Desen,arthas,1408,deathknight,unholy,39,15,24
424,Fugs,ghostlands,1406,deathknight,unholy,56,30,26
425,Hatreon,sargeras,1401,deathknight,unholy,30,20,10
426,Sílthree,barthilas,1401,deathknight,unholy,42,17,25
427,Wndypefrcorn,sargeras,1397,deathknight,unholy,37,24,13
428,Vazarus,darrowmere,1397,deathknight,unholy,66,30,36
429,Fzero,frostmourne,1392,deathknight,unholy,66,23,43
430,Sammåel,malganis,1387,deathknight,unholy,36,18,18
431,Paíín,illidan,1387,deathknight,unholy,48,21,27
432,Degrease,bonechewer,1385,deathknight,unholy,36,15,21
433,Unrealzrotz,tichondrius,1383,deathknight,unholy,60,39,21
434,Tenóry,nemesis,1383,deathknight,unholy,72,31,41
435,Egirlgripper,area-52,1382,deathknight,unholy,30,15,15
436,Plagueghoul,wyrmrest-accord,1381,deathknight,unholy,92,47,45
437,Silanvia,wyrmrest-accord,1377,deathknight,unholy,48,21,27
438,Mèrc,ragnaros,1376,deathknight,unholy,89,38,51
439,Sparklekitty,illidan,1374,deathknight,unholy,24,16,8
440,Greeasy,bleeding-hollow,1374,deathknight,unholy,41,23,18
441,Volcolm,kelthuzad,1373,deathknight,unholy,54,26,28
442,Zuly,moon-guard,1369,deathknight,unholy,113,54,59
443,Putrefactive,frostmourne,1368,deathknight,unholy,174,85,89
444,Darkunral,stormrage,1365,deathknight,unholy,80,33,47
445,Warstompgød,tichondrius,1364,deathknight,unholy,36,16,20
446,Any,the-venture-co,1364,deathknight,unholy,54,21,33
447,Waremoto,ragnaros,1361,deathknight,unholy,81,47,34
448,Bloodramen,dalaran,1360,deathknight,unholy,327,166,161
449,Dkzote,quelthalas,1360,deathknight,unholy,48,20,28
450,Deathsatan,barthilas,1359,deathknight,unholy,36,20,16
451,Awzy,azralon,1358,deathknight,unholy,36,20,16
452,Hydree,bleeding-hollow,1358,deathknight,unholy,42,17,25
453,Luckyson,tichondrius,1357,deathknight,unholy,40,19,21
454,Belegos,quelthalas,1356,deathknight,unholy,81,38,43
455,Shélly,ragnaros,1354,deathknight,unholy,83,41,42
456,Darknessice,tichondrius,1350,deathknight,unholy,66,35,31
457,Bumbleton,blackrock,1349,deathknight,unholy,45,24,21
458,Unhøøly,nemesis,1346,deathknight,unholy,53,30,23
459,Dethcro,shandris,1343,deathknight,unholy,93,47,46
460,Deliriioh,ragnaros,1340,deathknight,unholy,156,82,74
461,Koltíra,azralon,1339,deathknight,unholy,50,26,24
462,Tötenkaiser,quelthalas,1337,deathknight,unholy,30,14,16
463,Ântipaladin,arthas,1335,deathknight,unholy,46,19,27
464,Zeban,area-52,1334,deathknight,unholy,78,36,42
465,Bannedforevr,dalaran,1334,deathknight,unholy,36,14,22
466,Fiddleop,thrall,1333,deathknight,unholy,24,14,10
467,Negril,tichondrius,1332,deathknight,unholy,78,38,40
468,Darthsydius,azralon,1330,deathknight,unholy,24,14,10
469,Zxy,hyjal,1327,deathknight,unholy,23,17,6
470,Madmaxxy,barthilas,1326,deathknight,unholy,121,59,62
471,Rekbari,sargeras,1325,deathknight,unholy,24,15,9
472,Vynkys,shadow-council,1325,deathknight,unholy,58,32,26
473,Ellipsoro,onyxia,1325,deathknight,unholy,36,14,22
474,Unholychillz,ghostlands,1324,deathknight,unholy,44,20,24
475,Stangz,bonechewer,1322,deathknight,unholy,36,14,22
476,Earador,dalaran,1321,deathknight,unholy,30,15,15
477,Mords,area-52,1321,deathknight,unholy,30,14,16
478,Asylïthcc,sargeras,1317,deathknight,unholy,48,28,20
479,Gilden,malfurion,1317,deathknight,unholy,80,34,46
480,Midway,drakkari,1316,deathknight,unholy,30,16,14
481,Afterdeath,frostmourne,1313,deathknight,unholy,36,16,20
482,Maligned,uldum,1312,deathknight,unholy,49,18,31
483,Wrothgarr,stormreaver,1311,deathknight,unholy,36,18,18
484,Frðst,executus,1310,deathknight,unholy,24,14,10
485,Ñovacaine,moon-guard,1309,deathknight,unholy,77,36,41
486,Gwiffhm,tichondrius,1304,deathknight,unholy,40,14,26
487,Grizzdk,blackrock,1303,deathknight,unholy,30,14,16
488,Anonymousix,kelthuzad,1301,deathknight,unholy,29,15,14
489,Darkàn,lightnings-blade,1301,deathknight,unholy,42,20,22
490,Killerundead,area-52,1299,deathknight,unholy,39,17,22
491,Kallgìn,emerald-dream,1299,deathknight,unholy,36,15,21
492,Unholycube,zuljin,1290,deathknight,unholy,35,14,21
493,Mëgazørd,nemesis,1289,deathknight,unholy,42,22,20
494,Cripticknigt,spinebreaker,1289,deathknight,unholy,48,22,26
495,Shargan,tichondrius,1284,deathknight,unholy,84,44,40
496,Demona,ragnaros,1275,deathknight,unholy,52,18,34
497,Harlthas,ragnaros,1274,deathknight,unholy,30,17,13
498,Ometecuhtli,kelthuzad,1273,deathknight,unholy,60,35,25
499,Kromgarath,stormrage,1271,deathknight,unholy,60,28,32
500,Twodkitty,kelthuzad,1269,deathknight,unholy,21,14,7
501,Flo,ghostlands,1266,deathknight,unholy,34,17,17
502,Unleud,tichondrius,1260,deathknight,unholy,36,21,15
503,Nukydoe,azralon,1260,deathknight,unholy,42,19,23
504,Enjal,stormrage,1255,deathknight,unholy,53,23,30
505,Aretos,dreadmaul,1254,deathknight,unholy,32,16,16
506,Abruptdk,bonechewer,1254,deathknight,unholy,61,29,32
507,Ownaron,moon-guard,1249,deathknight,unholy,45,24,21
508,Resumen,steamwheedle-cartel,1249,deathknight,unholy,32,15,17
509,Clowngodx,illidan,1247,deathknight,unholy,24,13,11
510,Darktonelol,tichondrius,1247,deathknight,unholy,30,13,17
511,Buldrokastee,tichondrius,1247,deathknight,unholy,36,13,23
512,Bloodyloco,malganis,1246,deathknight,unholy,64,32,32
513,Earthican,bleeding-hollow,1245,deathknight,unholy,18,13,5
514,Daixks,proudmoore,1245,deathknight,unholy,42,22,20
515,Magipierrot,ragnaros,1245,deathknight,unholy,62,31,31
516,Lovedaddy,frostmourne,1242,deathknight,unholy,30,13,17
517,Lemuriön,nemesis,1242,deathknight,unholy,30,13,17
518,Bubblesdk,whisperwind,1242,deathknight,unholy,66,27,39
519,Youngmoneyyd,illidan,1241,deathknight,unholy,18,13,5
520,Shezoe,drakkari,1238,deathknight,unholy,24,13,11
521,Lebrônjames,tichondrius,1236,deathknight,unholy,24,13,11
522,Althamon,tanaris,1235,deathknight,unholy,36,13,23
523,Neipum,stormrage,1234,deathknight,unholy,18,13,5
524,Rarum,bleeding-hollow,1233,deathknight,unholy,24,13,11
525,Muffinstomp,eredar,1231,deathknight,unholy,53,29,24
526,Hellzkknight,tichondrius,1231,deathknight,unholy,34,16,18
527,Treikorh,quelthalas,1230,deathknight,unholy,148,66,82
528,Yamanji,wyrmrest-accord,1229,deathknight,unholy,24,13,11
529,Soulhuntress,doomhammer,1227,deathknight,unholy,114,58,56
530,Unhølydøøm,misha,1226,deathknight,unholy,78,39,39
531,Lorð,malganis,1225,deathknight,unholy,42,22,20
532,Sokthr,proudmoore,1224,deathknight,unholy,38,17,21
533,Déká,tichondrius,1222,deathknight,unholy,24,13,11
534,Necrósy,azralon,1222,deathknight,unholy,30,13,17
535,Potatobob,dalaran,1222,deathknight,unholy,30,13,17
536,Ahrímán,illidan,1219,deathknight,unholy,30,13,17
537,Malsedius,kelthuzad,1216,deathknight,unholy,39,16,23
538,Mazey,moon-guard,1209,deathknight,unholy,199,98,101
539,Nevarro,lightbringer,1209,deathknight,unholy,234,114,120
540,Darktrinnity,nemesis,1201,deathknight,unholy,47,27,20
541,Golurun,tichondrius,1197,deathknight,unholy,25,15,10
542,Zeeroo,moon-guard,1191,deathknight,unholy,34,17,17
543,Möchi,ragnaros,1190,deathknight,unholy,75,36,39
544,Leviiathan,tichondrius,1185,deathknight,unholy,30,14,16
545,Gatrars,sargeras,1185,deathknight,unholy,72,32,40
546,Lieyanyanwan,tichondrius,1181,deathknight,unholy,42,15,27
547,Sne,dragonmaw,1180,deathknight,unholy,30,17,13
548,Coffïnfeeder,dalaran,1178,deathknight,unholy,78,31,47
549,Drowhd,nemesis,1177,deathknight,unholy,60,27,33
550,Deadwait,rivendare,1175,deathknight,unholy,22,13,9
551,Hanmayuziro,tichondrius,1171,deathknight,unholy,23,13,10
552,Mmrhostage,kelthuzad,1165,deathknight,unholy,30,14,16
553,Lazenca,malganis,1158,deathknight,unholy,20,13,7
554,Oql,tichondrius,1152,deathknight,unholy,24,12,12
555,Diviniumx,bleeding-hollow,1152,deathknight,unholy,27,13,14
556,Gutterboy,malganis,1152,deathknight,unholy,30,12,18
557,Divinium,bleeding-hollow,1152,deathknight,unholy,30,12,18
558,Xtador,quelthalas,1150,deathknight,unholy,23,13,10
559,Kryptikkyt,blackrock,1150,deathknight,unholy,30,12,18
560,Böffa,dalaran,1149,deathknight,unholy,30,12,18
561,Vesel,tichondrius,1149,deathknight,unholy,36,12,24
562,Azgaroth,dathremar,1148,deathknight,unholy,38,20,18
563,Orcsexual,azralon,1148,deathknight,unholy,24,12,12
564,Zebastion,amanthul,1147,deathknight,unholy,36,15,21
565,Oldskul,sargeras,1146,deathknight,unholy,34,17,17
566,Chalamander,tichondrius,1146,deathknight,unholy,24,12,12
567,Blightrish,icecrown,1146,deathknight,unholy,42,19,23
568,Iamthedanger,aerie-peak,1145,deathknight,unholy,24,12,12
569,Kehin,azralon,1144,deathknight,unholy,70,29,41
570,Zukcho,tichondrius,1144,deathknight,unholy,36,12,24
571,Dravix,azshara,1143,deathknight,unholy,18,12,6
572,Skeleton,lightnings-blade,1141,deathknight,unholy,33,13,20
573,Rognarash,emerald-dream,1139,deathknight,unholy,24,12,12
574,Balakk,tichondrius,1137,deathknight,unholy,32,13,19
575,Skellig,wyrmrest-accord,1137,deathknight,unholy,60,24,36
576,Deathwardenn,ghostlands,1136,deathknight,unholy,24,12,12
577,Araris,stormrage,1135,deathknight,unholy,36,12,24
578,Ventuss,bleeding-hollow,1134,deathknight,unholy,24,12,12
579,Shinici,kelthuzad,1132,deathknight,unholy,24,12,12
580,Kel,stormreaver,1132,deathknight,unholy,35,12,23
581,Heärt,bleeding-hollow,1127,deathknight,unholy,68,28,40
582,Edhral,ragnaros,1123,deathknight,unholy,30,13,17
583,Vampirecarti,tichondrius,1122,deathknight,unholy,38,18,20
584,Darthblade,darkspear,1121,deathknight,unholy,36,26,10
585,Toroandmoi,area-52,1121,deathknight,unholy,24,12,12
586,Carecaa,azralon,1119,deathknight,unholy,44,19,25
587,Sabotdk,tichondrius,1117,deathknight,unholy,24,12,12
588,Mordekaiseer,azralon,1116,deathknight,unholy,142,73,69
589,Mercysparx,thrall,1116,deathknight,unholy,72,34,38
590,Frostcleave,emerald-dream,1115,deathknight,unholy,24,16,8
591,Joeyxdk,tichondrius,1114,deathknight,unholy,23,12,11
592,Druncker,blackrock,1114,deathknight,unholy,53,20,33
593,Mordeo,bleeding-hollow,1114,deathknight,unholy,34,12,22
594,Pántera,darkspear,1113,deathknight,unholy,24,12,12
595,Exequias,zuljin,1111,deathknight,unholy,30,17,13
596,Mandrágor,quelthalas,1111,deathknight,unholy,52,20,32
597,Fuzzyrump,eitrigg,1108,deathknight,unholy,30,19,11
598,Alphabro,zuluhed,1108,deathknight,unholy,42,22,20
599,Vaseline,zangarmarsh,1105,deathknight,unholy,53,27,26
600,Virulous,zuljin,1100,deathknight,unholy,21,13,8
601,Jukpark,tichondrius,1100,deathknight,unholy,42,25,17
602,Morghulas,moon-guard,1098,deathknight,unholy,30,12,18
603,Omegaseven,gorgonnash,1094,deathknight,unholy,166,84,82
604,Polydeuces,queldorei,1091,deathknight,unholy,66,26,40
605,Rhaenyrà,tichondrius,1089,deathknight,unholy,27,15,12
606,Beanboyx,tichondrius,1085,deathknight,unholy,22,12,10
607,Kanthrix,illidan,1084,deathknight,unholy,32,12,20
608,Trüppen,area-52,1078,deathknight,unholy,49,24,25
609,Volardan,trollbane,1071,deathknight,unholy,21,13,8
610,Zaelize,sargeras,1065,deathknight,unholy,48,21,27
611,Ragsec,bleeding-hollow,1056,deathknight,unholy,18,11,7
612,Vleryan,ragnaros,1055,deathknight,unholy,18,11,7
613,Asastac,tichondrius,1054,deathknight,unholy,18,11,7
614,Bhyrnam,ragnaros,1054,deathknight,unholy,36,11,25
615,Rongkhun,proudmoore,1054,deathknight,unholy,36,11,25
616,Sommeliergg,stormrage,1053,deathknight,unholy,18,11,7
617,Xaldalas,kelthuzad,1053,deathknight,unholy,24,11,13
618,Deathboost,stormrage,1053,deathknight,unholy,36,11,25
619,Plaguebreak,darrowmere,1052,deathknight,unholy,60,35,25
620,Boofcigars,stormrage,1052,deathknight,unholy,21,12,9
621,Happynaru,tichondrius,1052,deathknight,unholy,24,11,13
622,Polpop,zuljin,1051,deathknight,unholy,18,11,7
623,Acidirin,tichondrius,1049,deathknight,unholy,18,11,7
624,Draenor,shadowmoon,1049,deathknight,unholy,18,11,7
625,Runicblade,jaedenar,1048,deathknight,unholy,18,11,7
626,Salahzar,stormrage,1048,deathknight,unholy,24,11,13
627,Agohnim,moon-guard,1046,deathknight,unholy,30,11,19
628,Bazzingaxd,hyjal,1044,deathknight,unholy,36,21,15
629,Lazta,azralon,1044,deathknight,unholy,40,17,23
630,Cswildwind,aerie-peak,1041,deathknight,unholy,30,11,19
631,Alayka,stormrage,1040,deathknight,unholy,24,11,13
632,Deathcometh,tichondrius,1027,deathknight,unholy,30,11,19
633,Kayzark,tichondrius,1026,deathknight,unholy,36,20,16
634,Deathnorris,zuljin,1026,deathknight,unholy,80,38,42
635,Annerito,area-52,1023,deathknight,unholy,29,11,18
636,Dredrikbane,moon-guard,1022,deathknight,unholy,23,12,11
637,Deathsmog,quelthalas,1016,deathknight,unholy,19,11,8
638,Puppykiss,perenolde,1007,deathknight,unholy,27,11,16
639,Gêralt,darkspear,996,deathknight,unholy,24,12,12
640,Honustustere,emerald-dream,986,deathknight,unholy,23,11,12
641,Hansmclroy,trollbane,970,deathknight,unholy,24,14,10
642,Fendos,turalyon,963,deathknight,unholy,24,14,10
643,Vaske,azjolnerub,963,deathknight,unholy,55,20,35
644,Wölf,durotan,960,deathknight,unholy,12,10,2
645,Vaizard,malganis,960,deathknight,unholy,18,10,8
646,Giveretms,azralon,960,deathknight,unholy,24,10,14
647,Ragrek,bleeding-hollow,960,deathknight,unholy,24,10,14
648,Einherjiar,tichondrius,960,deathknight,unholy,24,10,14
649,Rängi,caelestrasz,960,deathknight,unholy,78,26,52
650,Immadkx,area-52,960,deathknight,unholy,30,10,20
651,Rxzo,frostmourne,960,deathknight,unholy,30,10,20
652,Pookr,area-52,960,deathknight,unholy,30,10,20
653,Hotdk,thrall,960,deathknight,unholy,30,10,20
654,Sithdog,blackrock,960,deathknight,unholy,30,10,20
655,Awshuks,illidan,959,deathknight,unholy,18,10,8
656,Mainxx,stormrage,959,deathknight,unholy,18,10,8
657,Tragdore,thrall,959,deathknight,unholy,18,10,8
658,Emarose,illidan,959,deathknight,unholy,24,10,14
659,Distorted,emerald-dream,959,deathknight,unholy,24,10,14
660,Galaxyboom,tichondrius,958,deathknight,unholy,12,10,2
661,Reapsouls,stormrage,958,deathknight,unholy,13,10,3
662,Pacedd,silvermoon,958,deathknight,unholy,18,10,8
663,Iðûnn,barthilas,957,deathknight,unholy,18,10,8
664,Aldoraenna,illidan,957,deathknight,unholy,24,10,14
665,Cimitiere,stormrage,956,deathknight,unholy,24,10,14
666,Arthyius,kiljaeden,956,deathknight,unholy,30,10,20
667,Mëlødy,quelthalas,955,deathknight,unholy,18,10,8
668,Gobaiakun,proudmoore,955,deathknight,unholy,18,10,8
669,Vërmilliøn,ragnaros,951,deathknight,unholy,18,10,8
670,Deathafter,tichondrius,948,deathknight,unholy,24,10,14
671,Thaylenaar,eredar,947,deathknight,unholy,18,10,8
672,Niennahh,sargeras,946,deathknight,unholy,24,10,14
673,Ghorzul,thrall,945,deathknight,unholy,24,10,14
674,Morhtzen,moon-guard,944,deathknight,unholy,13,10,3
675,Hentaideath,kiljaeden,934,deathknight,unholy,24,10,14
676,Bahtman,hakkar,925,deathknight,unholy,18,10,8
677,Jaydkx,tichondrius,906,deathknight,unholy,28,11,17
678,Jhiv,tichondrius,903,deathknight,unholy,22,11,11
679,Rottenwiener,sargeras,900,deathknight,unholy,17,10,7
680,Cishei,quelthalas,897,deathknight,unholy,21,12,9
681,Càsshêrn,lightbringer,893,deathknight,unholy,14,10,4
682,Dragoroth,zuluhed,893,deathknight,unholy,31,15,16
683,Zareon,zuluhed,876,deathknight,unholy,24,12,12
684,Dandandor,muradin,876,deathknight,unholy,38,17,21
685,Deathstrikex,tichondrius,864,deathknight,unholy,12,9,3
686,Nerfdklul,illidan,864,deathknight,unholy,12,9,3
687,Linyive,malganis,864,deathknight,unholy,18,9,9
688,Skullash,stormrage,864,deathknight,unholy,18,9,9
689,Utthrity,ysera,864,deathknight,unholy,18,9,9
690,Methyldk,frostmourne,864,deathknight,unholy,21,10,11
691,Shadowsdk,tichondrius,864,deathknight,unholy,24,9,15
692,Dill,madoran,864,deathknight,unholy,24,9,15
693,Datnai,barthilas,864,deathknight,unholy,24,9,15
694,Shinukishin,stormrage,864,deathknight,unholy,24,9,15
695,Fortissax,area-52,864,deathknight,unholy,30,9,21
696,Howlex,barthilas,863,deathknight,unholy,18,9,9
697,Kranaz,frostmourne,863,deathknight,unholy,24,9,15
698,Sbplaysdk,akama,863,deathknight,unholy,30,9,21
699,Tharegorn,azralon,862,deathknight,unholy,18,9,9
700,Umbranox,arthas,862,deathknight,unholy,18,9,9
701,Vynlerran,skullcrusher,862,deathknight,unholy,18,9,9
702,Runeswanson,area-52,861,deathknight,unholy,18,9,9
703,Isaarid,proudmoore,860,deathknight,unholy,12,9,3
704,Cosanostrá,malganis,860,deathknight,unholy,12,9,3
705,Rinthosaka,ragnaros,860,deathknight,unholy,18,9,9
706,Orphnoch,illidan,860,deathknight,unholy,24,9,15
707,Velyssiah,stormrage,860,deathknight,unholy,24,9,15
708,Feorlar,dalaran,860,deathknight,unholy,24,9,15
709,Ðerion,stormrage,859,deathknight,unholy,18,9,9
710,Sidbane,kalecgos,859,deathknight,unholy,19,9,10
711,Krixia,ragnaros,859,deathknight,unholy,24,9,15
712,Tugs,nathrezim,858,deathknight,unholy,18,9,9
713,Kaórii,stormrage,858,deathknight,unholy,30,9,21
714,Yosemithe,quelthalas,857,deathknight,unholy,18,9,9
715,Bloopdabloop,sargeras,856,deathknight,unholy,18,10,8
716,Tinytanx,aerie-peak,856,deathknight,unholy,30,9,21
717,Nicrack,malganis,853,deathknight,unholy,18,9,9
718,Zathog,lightbringer,853,deathknight,unholy,30,9,21
719,Ulerin,illidan,850,deathknight,unholy,18,9,9
720,Plaza,thorium-brotherhood,844,deathknight,unholy,18,9,9
721,Grimmtidings,dentarg,839,deathknight,unholy,42,17,25
722,Destruktion,uldaman,838,deathknight,unholy,12,9,3
723,Deadspellz,bleeding-hollow,832,deathknight,unholy,34,9,25
724,Handler,nemesis,830,deathknight,unholy,20,10,10
725,Ulyssess,jubeithos,827,deathknight,unholy,58,26,32
726,Alderma,zuljin,814,deathknight,unholy,29,10,19
727,Littlekims,emerald-dream,799,deathknight,unholy,16,9,7
728,Hobdk,malganis,798,deathknight,unholy,21,9,12
729,Festers,burning-legion,794,deathknight,unholy,26,9,17
730,Mesx,illidan,768,deathknight,unholy,12,8,4
731,Vitad,tichondrius,768,deathknight,unholy,12,8,4
732,Liqùid,moon-guard,768,deathknight,unholy,12,8,4
733,Deadsamurai,illidan,768,deathknight,unholy,12,8,4
734,Gromhal,azralon,768,deathknight,unholy,12,8,4
735,Poderrosodk,azralon,768,deathknight,unholy,12,8,4
736,Dicromick,illidan,768,deathknight,unholy,15,9,6
737,Asterend,proudmoore,768,deathknight,unholy,16,9,7
738,Aisö,bleeding-hollow,768,deathknight,unholy,18,8,10
739,Clapt,kelthuzad,768,deathknight,unholy,18,8,10
740,Icytoast,tichondrius,768,deathknight,unholy,18,8,10
741,Piratehookah,sargeras,768,deathknight,unholy,18,8,10
742,Loomoros,sargeras,768,deathknight,unholy,24,8,16
743,Novädk,ragnaros,768,deathknight,unholy,24,8,16
744,Bigdollars,eredar,767,deathknight,unholy,12,8,4
745,Deathsloot,sargeras,767,deathknight,unholy,12,8,4
746,Ørcrist,area-52,767,deathknight,unholy,12,8,4
747,Akrylo,ragnaros,767,deathknight,unholy,12,8,4
748,Ðaz,zuljin,767,deathknight,unholy,12,8,4
749,Hædës,area-52,767,deathknight,unholy,18,8,10
750,Traitre,onyxia,767,deathknight,unholy,18,8,10
751,Rulord,wyrmrest-accord,767,deathknight,unholy,18,8,10
752,Fluffymoo,frostmourne,767,deathknight,unholy,18,8,10
753,Gorillagrip,sargeras,767,deathknight,unholy,18,8,10
754,Bloodygrip,bleeding-hollow,767,deathknight,unholy,18,8,10
755,Mordumi,stormrage,767,deathknight,unholy,24,8,16
756,Deephideblue,proudmoore,767,deathknight,unholy,25,8,17
757,Redcancer,tichondrius,766,deathknight,unholy,12,8,4
758,Olblueyes,hyjal,766,deathknight,unholy,18,8,10
759,Riparonii,illidan,766,deathknight,unholy,21,8,13
760,Shadowghast,saurfang,765,deathknight,unholy,12,8,4
761,Hildolfr,shattered-hand,765,deathknight,unholy,18,8,10
762,Bloodydebt,malganis,765,deathknight,unholy,18,8,10
763,Dalrin,emerald-dream,765,deathknight,unholy,24,8,16
764,Abadena,illidan,765,deathknight,unholy,27,8,19
765,Leiry,darkspear,762,deathknight,unholy,12,8,4
766,Primoverdino,azralon,762,deathknight,unholy,18,8,10
767,Kowell,drakkari,762,deathknight,unholy,18,8,10
768,Dankbro,tichondrius,761,deathknight,unholy,24,10,14
769,Iamlrr,maelstrom,761,deathknight,unholy,24,8,16
770,Croaker,gurubashi,760,deathknight,unholy,12,8,4
771,Kaciann,dalaran,758,deathknight,unholy,12,8,4
772,Lepanda,skywall,758,deathknight,unholy,18,8,10
773,Moxtexd,drakkari,752,deathknight,unholy,12,8,4
774,Soulfarm,tichondrius,751,deathknight,unholy,12,8,4
775,Frozenkappa,hyjal,735,deathknight,unholy,17,8,9
776,Poonen,area-52,735,deathknight,unholy,17,8,9
777,Starset,burning-legion,728,deathknight,unholy,24,9,15
778,Tonylin,tichondrius,703,deathknight,unholy,14,8,6
779,Somethingdum,sargeras,703,deathknight,unholy,16,8,8
780,Froznorbs,tichondrius,700,deathknight,unholy,14,8,6
781,Cgg,tichondrius,672,deathknight,unholy,12,7,5
782,Liverkick,zuljin,672,deathknight,unholy,12,7,5
783,Khørne,area-52,672,deathknight,unholy,12,7,5
784,Jbert,sargeras,672,deathknight,unholy,12,7,5
785,Raizzhít,ragnaros,672,deathknight,unholy,12,7,5
786,Apoz,tichondrius,672,deathknight,unholy,12,7,5
787,Plag,bleeding-hollow,672,deathknight,unholy,12,7,5
788,Mcdeathturds,tichondrius,672,deathknight,unholy,12,7,5
789,Bigdekay,illidan,672,deathknight,unholy,12,7,5
790,Dezmond,quelthalas,672,deathknight,unholy,12,7,5
791,Karthayne,area-52,672,deathknight,unholy,12,7,5
792,Donrhythmic,ysera,672,deathknight,unholy,12,7,5
793,Gurnok,barthilas,672,deathknight,unholy,12,7,5
794,Inemia,wyrmrest-accord,672,deathknight,unholy,16,7,9
795,Mightyfails,frostmourne,672,deathknight,unholy,18,7,11
796,Bryku,tichondrius,672,deathknight,unholy,18,7,11
797,Kûri,runetotem,672,deathknight,unholy,18,7,11
798,Bellybuster,malganis,672,deathknight,unholy,18,7,11
799,Vigarst,azralon,672,deathknight,unholy,18,7,11
800,Ebolaxd,area-52,672,deathknight,unholy,18,7,11
801,Umbramane,tichondrius,672,deathknight,unholy,18,7,11
802,Mmaximus,darkspear,672,deathknight,unholy,18,7,11
803,Darione,twisting-nether,672,deathknight,unholy,24,7,17
804,Xenocrates,illidan,672,deathknight,unholy,24,7,17
805,Cptsäveähöe,tichondrius,672,deathknight,unholy,24,7,17
806,Ceedog,crushridge,672,deathknight,unholy,30,7,23
807,Deatheey,area-52,671,deathknight,unholy,12,7,5
808,Sevexi,moon-guard,671,deathknight,unholy,12,7,5
809,Tiller,mannoroth,671,deathknight,unholy,12,7,5
810,Woahwtf,area-52,671,deathknight,unholy,12,7,5
811,Dreadcowpie,dalaran,671,deathknight,unholy,12,7,5
812,Fligdeath,llane,671,deathknight,unholy,12,7,5
813,Gâbriel,cairne,671,deathknight,unholy,12,7,5
814,Biukanon,ragnaros,671,deathknight,unholy,18,7,11
815,Kidek,proudmoore,671,deathknight,unholy,18,7,11
816,Shhnitzle,stormrage,671,deathknight,unholy,18,7,11
817,Mfknight,archimonde,671,deathknight,unholy,18,7,11
818,Dravoc,kelthuzad,671,deathknight,unholy,24,7,17
819,Demonstalker,boulderfist,671,deathknight,unholy,24,7,17
820,Coldrhelx,quelthalas,671,deathknight,unholy,30,7,23
821,Emberwarden,stormrage,670,deathknight,unholy,18,7,11
822,Irokthefrost,frostmourne,669,deathknight,unholy,12,7,5
823,Boneguard,stormrage,668,deathknight,unholy,18,7,11
824,Terracundo,quelthalas,667,deathknight,unholy,18,9,9
825,Grtmisdirect,illidan,666,deathknight,unholy,21,8,13
826,Zëb,sargeras,665,deathknight,unholy,12,7,5
827,Zàkgor,moon-guard,665,deathknight,unholy,12,7,5
828,Argar,crushridge,664,deathknight,unholy,12,7,5
829,Heldwynd,bonechewer,664,deathknight,unholy,24,7,17
830,Garshna,ragnaros,658,deathknight,unholy,12,7,5
831,Hadianton,stormrage,654,deathknight,unholy,15,8,7
832,Dbg,frostmane,639,deathknight,unholy,11,7,4
833,Arthureon,kelthuzad,635,deathknight,unholy,20,7,13
834,Bonalumë,azralon,620,deathknight,unholy,17,7,10
835,Soulkiti,blackwater-raiders,608,deathknight,unholy,16,7,9
836,Nekrosys,eitrigg,608,deathknight,unholy,22,7,15
837,Aundethell,moon-guard,608,deathknight,unholy,33,7,26
838,Bingoez,frostmourne,607,deathknight,unholy,11,7,4
839,Xènia,exodar,592,deathknight,unholy,13,7,6
840,Bernaldino,illidan,576,deathknight,unholy,6,6,0
841,Arcänn,drenden,576,deathknight,unholy,6,6,0
842,Feej,malganis,576,deathknight,unholy,6,6,0
843,Delwrath,proudmoore,576,deathknight,unholy,12,6,6
844,Chainsawmàn,tichondrius,576,deathknight,unholy,12,6,6
845,Justtaki,zuljin,576,deathknight,unholy,12,6,6
846,Bøoth,area-52,576,deathknight,unholy,12,6,6
847,Raaizz,ragnaros,576,deathknight,unholy,12,6,6
848,Svlla,doomhammer,576,deathknight,unholy,12,6,6
849,Ridesatenspd,caelestrasz,576,deathknight,unholy,12,6,6
850,Zifandel,bleeding-hollow,576,deathknight,unholy,12,6,6
851,Lilwayne,archimonde,576,deathknight,unholy,12,6,6
852,Cali,bladefist,576,deathknight,unholy,12,6,6
853,Bossdk,tichondrius,576,deathknight,unholy,12,6,6
854,Migwel,emerald-dream,576,deathknight,unholy,12,6,6
855,Meisterdeath,stormrage,576,deathknight,unholy,12,6,6
856,Remõrse,moon-guard,576,deathknight,unholy,12,6,6
857,Surkk,tichondrius,576,deathknight,unholy,12,6,6
858,Demonicrunes,windrunner,576,deathknight,unholy,12,6,6
859,Zakka,korgath,576,deathknight,unholy,12,6,6
860,Hickish,tichondrius,576,deathknight,unholy,12,6,6
861,Lagérthâ,ragnaros,576,deathknight,unholy,12,6,6
862,Bébøp,malganis,576,deathknight,unholy,12,6,6
863,Ghouldruis,barthilas,576,deathknight,unholy,12,6,6
864,Maiatsu,illidan,576,deathknight,unholy,12,6,6
865,Friezen,illidan,576,deathknight,unholy,12,6,6
866,Jonahdk,sargeras,576,deathknight,unholy,12,6,6
867,Witdk,illidan,576,deathknight,unholy,15,6,9
868,Lainmortal,ragnaros,576,deathknight,unholy,18,6,12
869,Maripaula,ragnaros,576,deathknight,unholy,18,6,12
870,Cirillan,bleeding-hollow,576,deathknight,unholy,18,6,12
871,Kterrorblade,sargeras,576,deathknight,unholy,18,6,12
872,Joystickwrld,silvermoon,576,deathknight,unholy,18,6,12
873,Conquest,drenden,576,deathknight,unholy,24,6,18
874,Baldlord,tichondrius,576,deathknight,unholy,24,6,18
875,Zevrynn,barthilas,575,deathknight,unholy,12,6,6
876,Agamoth,ragnaros,575,deathknight,unholy,12,6,6
877,Åkatsukii,uther,575,deathknight,unholy,12,6,6
878,Zebirock,stormrage,575,deathknight,unholy,12,6,6
879,Ksoldier,illidan,575,deathknight,unholy,12,6,6
880,Christophe,skullcrusher,575,deathknight,unholy,12,6,6
881,Corpsepetal,muradin,575,deathknight,unholy,18,6,12
882,Hordbadia,garrosh,574,deathknight,unholy,12,6,6
883,Vicentão,tichondrius,574,deathknight,unholy,12,6,6
884,Liltinktink,stormreaver,574,deathknight,unholy,12,6,6
885,Masochrist,baelgun,574,deathknight,unholy,18,6,12
886,Vapelounge,darkspear,574,deathknight,unholy,18,6,12
887,Fraänrisco,ragnaros,574,deathknight,unholy,18,6,12
888,Scaista,tichondrius,573,deathknight,unholy,12,6,6
889,Juggérnaút,bonechewer,572,deathknight,unholy,12,6,6
890,Tormentsoul,ragnaros,572,deathknight,unholy,12,6,6
891,Lowan,stormrage,566,deathknight,unholy,12,6,6
892,Waterboy,malganis,566,deathknight,unholy,12,6,6
893,Syzurp,barthilas,558,deathknight,unholy,13,7,6
894,Zillachilla,azshara,527,deathknight,unholy,9,7,2
895,Herstôry,kelthuzad,527,deathknight,unholy,11,6,5
896,Gkdm,tichondrius,522,deathknight,unholy,21,8,13
897,Chës,tichondrius,522,deathknight,unholy,22,7,15
898,Abømination,zuljin,510,deathknight,unholy,20,6,14
899,Kalëndar,drakkari,503,deathknight,unholy,25,12,13
900,Bawlsauce,area-52,496,deathknight,unholy,13,6,7
901,Monstrosìty,bleeding-hollow,480,deathknight,unholy,6,5,1
902,Andariel,ragnaros,480,deathknight,unholy,6,5,1
903,Depthknight,barthilas,480,deathknight,unholy,6,5,1
904,Wâggies,moon-guard,480,deathknight,unholy,6,5,1
905,Solø,proudmoore,480,deathknight,unholy,6,5,1
906,Jongro,tichondrius,480,deathknight,unholy,6,5,1
907,Bànished,moon-guard,480,deathknight,unholy,7,5,2
908,Nwnqt,frostmourne,480,deathknight,unholy,9,6,3
909,Serathai,tichondrius,480,deathknight,unholy,12,5,7
910,Laboön,stormrage,480,deathknight,unholy,12,5,7
911,Granknight,azralon,480,deathknight,unholy,12,5,7
912,Defaultz,turalyon,480,deathknight,unholy,12,5,7
913,Darkwraith,illidan,480,deathknight,unholy,12,5,7
914,Swänsz,stormrage,480,deathknight,unholy,12,5,7
915,Dkbunny,thaurissan,480,deathknight,unholy,12,5,7
916,Gneanderthal,bloodscalp,480,deathknight,unholy,12,5,7
917,Lîch,azralon,480,deathknight,unholy,12,5,7
918,Noitrox,azralon,480,deathknight,unholy,12,5,7
919,Hardtoplaydk,chogall,480,deathknight,unholy,12,5,7
920,Andem,elune,480,deathknight,unholy,12,5,7
921,Römney,stormrage,480,deathknight,unholy,12,5,7
922,Schreit,zuljin,480,deathknight,unholy,12,5,7
923,Yeahgood,frostmourne,480,deathknight,unholy,12,5,7
924,Akmy,illidan,480,deathknight,unholy,12,5,7
925,Frostyclaws,blackrock,480,deathknight,unholy,12,5,7
926,Smerknight,proudmoore,480,deathknight,unholy,12,5,7
927,Aoshië,area-52,480,deathknight,unholy,12,5,7
928,Katakuri,azralon,480,deathknight,unholy,12,5,7
929,Erodin,moon-guard,480,deathknight,unholy,12,5,7
930,Irreversible,zuljin,480,deathknight,unholy,12,5,7
931,Cammykickbot,frostmourne,480,deathknight,unholy,12,5,7
932,Cosmicrune,turalyon,480,deathknight,unholy,12,5,7
933,Pathæs,bleeding-hollow,480,deathknight,unholy,12,5,7
934,Nordiin,stormrage,480,deathknight,unholy,12,5,7
935,Maggotmulch,zuljin,480,deathknight,unholy,12,5,7
936,Xariuz,quelthalas,480,deathknight,unholy,12,5,7
937,Deathpair,bleeding-hollow,480,deathknight,unholy,12,5,7
938,Darkfög,sargeras,480,deathknight,unholy,12,5,7
939,Raull,ragnaros,480,deathknight,unholy,12,5,7
940,Skotch,lightninghoof,480,deathknight,unholy,12,5,7
941,Akilol,tichondrius,480,deathknight,unholy,12,5,7
942,Vläad,ragnaros,480,deathknight,unholy,12,5,7
943,Initiative,moon-guard,480,deathknight,unholy,12,5,7
944,Ghrat,bleeding-hollow,480,deathknight,unholy,12,5,7
945,Kasteny,frostmourne,480,deathknight,unholy,12,5,7
946,Zaratose,area-52,480,deathknight,unholy,12,5,7
947,Defekaite,kiljaeden,480,deathknight,unholy,12,5,7
948,Renaming,area-52,480,deathknight,unholy,15,6,9
949,Skulm,emerald-dream,480,deathknight,unholy,14,5,9
950,Sylèss,tichondrius,480,deathknight,unholy,18,5,13
951,Sevendeadly,frostmourne,480,deathknight,unholy,18,5,13
952,Arkhän,ragnaros,480,deathknight,unholy,18,5,13
953,Maskofwintrs,zuljin,480,deathknight,unholy,18,5,13
954,Rytex,moon-guard,480,deathknight,unholy,18,5,13
955,Nappão,azralon,480,deathknight,unholy,19,5,14
956,Dementrius,zuljin,480,deathknight,unholy,25,5,20
957,Extremepvp,aegwynn,479,deathknight,unholy,6,5,1
958,Ahwooh,kelthuzad,479,deathknight,unholy,6,5,1
959,Mefistô,quelthalas,479,deathknight,unholy,10,6,4
960,Caqw,akama,479,deathknight,unholy,12,5,7
961,Azombie,burning-blade,479,deathknight,unholy,12,5,7
962,Nekrofeelyak,kelthuzad,479,deathknight,unholy,12,5,7
963,Borgin,emerald-dream,479,deathknight,unholy,12,5,7
964,Amaethyst,kelthuzad,479,deathknight,unholy,12,5,7
965,Jessefur,undermine,479,deathknight,unholy,12,5,7
966,Jojomcdeath,senjin,479,deathknight,unholy,12,5,7
967,Deathfearsme,kiljaeden,479,deathknight,unholy,12,5,7
968,Itired,tichondrius,479,deathknight,unholy,12,5,7
969,Kramy,barthilas,479,deathknight,unholy,12,5,7
970,Aborter,arthas,478,deathknight,unholy,12,5,7
971,Dàndàn,lightbringer,477,deathknight,unholy,12,5,7
972,Tandarilada,shadowmoon,476,deathknight,unholy,12,5,7
973,Delamuerte,ragnaros,476,deathknight,unholy,12,5,7
974,Draxsos,quelthalas,475,deathknight,unholy,18,5,13
975,Dreekon,bleeding-hollow,468,deathknight,unholy,19,9,10
976,Megatrôn,malganis,463,deathknight,unholy,17,5,12
977,Faelmo,malganis,447,deathknight,unholy,11,5,6
978,Fearfull,hyjal,447,deathknight,unholy,11,5,6
979,Iloveenzley,tichondrius,447,deathknight,unholy,11,5,6
980,Sorry,ysera,432,deathknight,unholy,9,6,3
981,Spôôn,aggramar,430,deathknight,unholy,11,5,6
982,Dtrayn,tichondrius,416,deathknight,unholy,10,5,5
983,Reighart,kiljaeden,415,deathknight,unholy,8,5,3
984,Testifier,illidan,415,deathknight,unholy,8,5,3
985,Unholyreap,arthas,415,deathknight,unholy,10,5,5
986,Shiminy,chogall,415,deathknight,unholy,10,5,5
987,Wuhán,proudmoore,414,deathknight,unholy,26,5,21
988,Noahmelo,nemesis,400,deathknight,unholy,7,5,2
989,Frostology,echo-isles,399,deathknight,unholy,5,5,0
990,Claudio,tichondrius,384,deathknight,unholy,6,4,2
991,Mistmoorex,stormscale,384,deathknight,unholy,6,4,2
992,Hiki,ragnaros,384,deathknight,unholy,6,4,2
993,Atrahazis,quelthalas,384,deathknight,unholy,6,4,2
994,Raynorr,dawnbringer,384,deathknight,unholy,6,4,2
995,Richiex,tichondrius,384,deathknight,unholy,6,4,2
996,Horîzon,sargeras,384,deathknight,unholy,6,4,2
997,Futruth,khaz-modan,384,deathknight,unholy,6,4,2
998,Lxsol,illidan,384,deathknight,unholy,6,4,2
999,Higeki,area-52,384,deathknight,unholy,6,4,2
1000,Nøzawkolypse,area-52,384,deathknight,unholy,6,4,2
1001,Darkswar,barthilas,384,deathknight,unholy,6,4,2
1002,Vampygeizt,zuljin,384,deathknight,unholy,6,4,2
1003,Koreandk,tichondrius,384,deathknight,unholy,6,4,2
1004,Chooksknight,tichondrius,384,deathknight,unholy,6,4,2
1005,Tragül,sargeras,384,deathknight,unholy,6,4,2
1006,Penguinlolx,sargeras,384,deathknight,unholy,6,4,2
1007,Whaleofwales,ysondre,384,deathknight,unholy,6,4,2
1008,Zeathial,moon-guard,384,deathknight,unholy,6,4,2
1009,Logann,azralon,384,deathknight,unholy,6,4,2
1010,Keator,tichondrius,384,deathknight,unholy,6,4,2
1011,Metinchaff,shadowmoon,384,deathknight,unholy,6,4,2
1012,Murphu,stormrage,384,deathknight,unholy,6,4,2
1013,Sleezyfbaby,sargeras,384,deathknight,unholy,6,4,2
1014,Sephirott,boulderfist,384,deathknight,unholy,6,4,2
1015,Chillbruh,garrosh,384,deathknight,unholy,6,4,2
1016,Tibocourtois,tichondrius,384,deathknight,unholy,6,4,2
1017,Xhamstr,frostmourne,384,deathknight,unholy,6,4,2
1018,Zyzz,frostmourne,384,deathknight,unholy,6,4,2
1019,Pleasecakes,blood-furnace,384,deathknight,unholy,9,5,4
1020,Bjorstad,moon-guard,384,deathknight,unholy,12,4,8
1021,Furcht,gundrak,384,deathknight,unholy,12,4,8
1022,Kárd,tichondrius,384,deathknight,unholy,12,4,8
1023,Bøngripx,tichondrius,384,deathknight,unholy,12,4,8
1024,Dalka,laughing-skull,384,deathknight,unholy,12,4,8
1025,Bealzabub,sargeras,384,deathknight,unholy,12,4,8
1026,Cäin,dreadmaul,384,deathknight,unholy,12,4,8
1027,Oomak,bonechewer,384,deathknight,unholy,12,4,8
1028,Hounura,dathremar,384,deathknight,unholy,12,4,8
1029,Asana,illidan,384,deathknight,unholy,12,4,8
1030,Valandiel,jubeithos,384,deathknight,unholy,12,4,8
1031,Boltman,malganis,384,deathknight,unholy,12,4,8
1032,Tyrien,frostmane,384,deathknight,unholy,12,4,8
1033,Threehunned,frostmourne,384,deathknight,unholy,12,4,8
1034,Sonoftwodads,thrall,384,deathknight,unholy,12,4,8
1035,Dkekk,illidan,384,deathknight,unholy,12,4,8
1036,Dkinaboxx,hyjal,384,deathknight,unholy,12,4,8
1037,Çorn,sargeras,384,deathknight,unholy,12,4,8
1038,Tinylich,arthas,384,deathknight,unholy,12,4,8
1039,Libramontes,ragnaros,384,deathknight,unholy,12,4,8
1040,Àrchøn,kelthuzad,384,deathknight,unholy,12,4,8
1041,Mardrank,stormrage,384,deathknight,unholy,12,4,8
1042,Coronä,malfurion,384,deathknight,unholy,12,4,8
1043,Grýmm,bonechewer,384,deathknight,unholy,12,4,8
1044,Ambagrips,frostmourne,384,deathknight,unholy,12,4,8
1045,Pharoahx,gurubashi,384,deathknight,unholy,12,4,8
1046,Raakaa,ghostlands,384,deathknight,unholy,12,4,8
1047,Cokedrip,bleeding-hollow,384,deathknight,unholy,12,4,8
1048,Darkcata,tichondrius,384,deathknight,unholy,12,4,8
1049,Noiksnow,azralon,384,deathknight,unholy,12,4,8
1050,Yeetmaster,area-52,384,deathknight,unholy,12,4,8
1051,Nolderosdk,nemesis,384,deathknight,unholy,12,4,8
1052,Mournehowl,stormrage,384,deathknight,unholy,12,4,8
1053,Wúhan,moon-guard,384,deathknight,unholy,12,4,8
1054,Sandooñ,tichondrius,384,deathknight,unholy,12,4,8
1055,Zoomoth,illidan,384,deathknight,unholy,12,4,8
1056,Maalevolent,thunderlord,384,deathknight,unholy,12,4,8
1057,Eightamdk,tichondrius,384,deathknight,unholy,12,4,8
1058,Annuvyz,darkspear,384,deathknight,unholy,12,4,8
1059,Daellius,ragnaros,384,deathknight,unholy,12,4,8
1060,Testamentxx,thunderlord,384,deathknight,unholy,12,4,8
1061,Avengis,bleeding-hollow,384,deathknight,unholy,18,4,14
1062,Dkjs,anetheron,384,deathknight,unholy,18,4,14
1063,Drzièglér,tichondrius,384,deathknight,unholy,18,4,14
1064,Sahaile,moon-guard,384,deathknight,unholy,18,4,14
1065,Keralius,stormrage,384,deathknight,unholy,18,4,14
1066,Lho,caelestrasz,384,deathknight,unholy,18,4,14
1067,Artous,stormrage,384,deathknight,unholy,24,4,20
1068,Flazzul,kiljaeden,383,deathknight,unholy,6,4,2
1069,Turbotoxic,illidan,383,deathknight,unholy,6,4,2
1070,Hitsüyi,quelthalas,383,deathknight,unholy,11,6,5
1071,Demher,ragnaros,383,deathknight,unholy,12,4,8
1072,Plaguedoctor,moon-guard,383,deathknight,unholy,12,4,8
1073,Mëllowhypë,sargeras,383,deathknight,unholy,12,4,8
1074,Runíc,demon-soul,383,deathknight,unholy,12,4,8
1075,Optics,bleeding-hollow,383,deathknight,unholy,12,4,8
1076,Jinxtar,wyrmrest-accord,382,deathknight,unholy,6,4,2
1077,Rinngar,quelthalas,382,deathknight,unholy,6,4,2
1078,Hobyrt,bleeding-hollow,382,deathknight,unholy,6,4,2
1079,Gankhiss,emerald-dream,351,deathknight,unholy,11,4,7
1080,Azupo,aerie-peak,351,deathknight,unholy,14,5,9
1081,Zuum,kelthuzad,351,deathknight,unholy,17,4,13
1082,Ghostdeath,blackhand,336,deathknight,unholy,9,4,5
1083,Zygon,thrall,336,deathknight,unholy,9,4,5
1084,Ahirek,quelthalas,320,deathknight,unholy,10,4,6
1085,Ekaj,azuremyst,319,deathknight,unholy,5,4,1
1086,Icefrost,ghostlands,288,deathknight,unholy,6,3,3
1087,Birnolan,proudmoore,288,deathknight,unholy,6,3,3
1088,Drippedout,illidan,288,deathknight,unholy,6,3,3
1089,Frostdest,kiljaeden,288,deathknight,unholy,6,3,3
1090,Jerkin,area-52,288,deathknight,unholy,6,3,3
1091,Adavynn,darkspear,288,deathknight,unholy,6,3,3
1092,Xijiñpiñg,hyjal,288,deathknight,unholy,6,3,3
1093,Greizul,area-52,288,deathknight,unholy,6,3,3
1094,Deathlyvoid,sargeras,288,deathknight,unholy,6,3,3
1095,Nethaar,tichondrius,288,deathknight,unholy,6,3,3
1096,Trant,tichondrius,288,deathknight,unholy,6,3,3
1097,Nifftybear,tichondrius,288,deathknight,unholy,6,3,3
1098,Ödens,dalaran,288,deathknight,unholy,6,3,3
1099,Laeroth,zuluhed,288,deathknight,unholy,6,3,3
1100,Andeadx,tichondrius,288,deathknight,unholy,6,3,3
1101,Darthkeefers,zuljin,288,deathknight,unholy,6,3,3
1102,Alivaron,lothar,288,deathknight,unholy,6,3,3
1103,Petkick,tichondrius,288,deathknight,unholy,6,3,3
1104,Holsey,moon-guard,288,deathknight,unholy,6,3,3
1105,Necrotictko,tichondrius,288,deathknight,unholy,6,3,3
1106,Xhín,bleeding-hollow,288,deathknight,unholy,6,3,3
1107,Rhors,nemesis,288,deathknight,unholy,6,3,3
1108,Jacklinn,ysondre,288,deathknight,unholy,6,3,3
1109,Mýrrh,wyrmrest-accord,288,deathknight,unholy,6,3,3
1110,Redrox,tichondrius,288,deathknight,unholy,6,3,3
1111,Jorich,ragnaros,288,deathknight,unholy,6,3,3
1112,Smokeyjoe,aegwynn,288,deathknight,unholy,6,3,3
1113,Rizzchimp,tichondrius,288,deathknight,unholy,6,3,3
1114,Legendåryx,sargeras,288,deathknight,unholy,6,3,3
1115,Válak,stormrage,288,deathknight,unholy,6,3,3
1116,Monglord,arthas,288,deathknight,unholy,6,3,3
1117,Viscerus,stormrage,288,deathknight,unholy,6,3,3
1118,Plaguewar,thrall,288,deathknight,unholy,6,3,3
1119,Vinaroth,kiljaeden,288,deathknight,unholy,6,3,3
1120,Shookdnation,suramar,288,deathknight,unholy,6,3,3
1121,Chrønnøz,nemesis,288,deathknight,unholy,6,3,3
1122,Disritmia,stormrage,288,deathknight,unholy,6,3,3
1123,Anderius,tichondrius,288,deathknight,unholy,6,3,3
1124,Siêgfriëd,ragnaros,288,deathknight,unholy,6,3,3
1125,Malairia,area-52,288,deathknight,unholy,6,3,3
1126,Qberks,elune,288,deathknight,unholy,6,3,3
1127,Mawvac,quelthalas,288,deathknight,unholy,6,3,3
1128,Mendoh,tichondrius,288,deathknight,unholy,6,3,3
1129,Chibalaloca,quelthalas,288,deathknight,unholy,6,3,3
1130,Kossero,thunderlord,288,deathknight,unholy,6,3,3
1131,Bosleigor,elune,288,deathknight,unholy,6,3,3
1132,Pepecoomer,frostmourne,288,deathknight,unholy,6,3,3
1133,Marash,moon-guard,288,deathknight,unholy,6,3,3
1134,Icycrazy,azralon,288,deathknight,unholy,6,3,3
1135,Blitzcreig,sargeras,288,deathknight,unholy,6,3,3
1136,Ariacy,sargeras,288,deathknight,unholy,6,3,3
1137,Indraz,jubeithos,288,deathknight,unholy,6,3,3
1138,Vexmaw,twisting-nether,288,deathknight,unholy,6,3,3
1139,Sindragosa,dragonmaw,288,deathknight,unholy,6,3,3
1140,Frenzza,frostmourne,288,deathknight,unholy,6,3,3
1141,Sherank,akama,288,deathknight,unholy,6,3,3
1142,Lafourche,sargeras,288,deathknight,unholy,6,3,3
1143,Micteca,moonrunner,288,deathknight,unholy,7,3,4
1144,Oroborus,korgath,288,deathknight,unholy,8,3,5
1145,Boomxic,shuhalo,288,deathknight,unholy,11,4,7
1146,Garonse,wyrmrest-accord,288,deathknight,unholy,12,3,9
1147,Rottenqunt,tichondrius,288,deathknight,unholy,12,3,9
1148,Chosenrune,stormrage,288,deathknight,unholy,12,3,9
1149,Mongomongo,malganis,288,deathknight,unholy,12,3,9
1150,Gigabone,tichondrius,288,deathknight,unholy,12,3,9
1151,Lolgriped,tichondrius,288,deathknight,unholy,12,3,9
1152,Techneeq,tichondrius,288,deathknight,unholy,12,3,9
1153,Fokit,barthilas,288,deathknight,unholy,12,3,9
1154,Chosenhero,stormrage,288,deathknight,unholy,12,3,9
1155,Angerforge,illidan,288,deathknight,unholy,12,3,9
1156,Emotionaldam,area-52,288,deathknight,unholy,12,3,9
1157,Zerky,stormrage,288,deathknight,unholy,12,3,9
1158,Sübzerö,quelthalas,288,deathknight,unholy,12,3,9
1159,Danlorinis,moon-guard,288,deathknight,unholy,12,3,9
1160,Coldmilk,wyrmrest-accord,288,deathknight,unholy,12,3,9
1161,Kaspbrak,destromath,288,deathknight,unholy,12,3,9
1162,Supermane,jubeithos,288,deathknight,unholy,12,3,9
1163,Carmii,wyrmrest-accord,288,deathknight,unholy,12,3,9
1164,Torsophuk,stormrage,288,deathknight,unholy,12,3,9
1165,Coffeemilk,kiljaeden,288,deathknight,unholy,13,3,10
1166,Deathsent,malganis,288,deathknight,unholy,18,3,15
1167,Kreachuer,lightbringer,287,deathknight,unholy,6,3,3
1168,Thepanzer,elune,287,deathknight,unholy,6,3,3
1169,Malovv,nemesis,287,deathknight,unholy,6,3,3
1170,Jman,kaelthas,287,deathknight,unholy,6,3,3
1171,Chanskey,stormrage,287,deathknight,unholy,9,3,6
1172,Zedknight,emerald-dream,287,deathknight,unholy,15,4,11
1173,Morthul,tol-barad,287,deathknight,unholy,12,3,9
1174,Papparoach,ysera,286,deathknight,unholy,6,3,3
1175,Orthason,moon-guard,286,deathknight,unholy,6,3,3
1176,Copy,suramar,271,deathknight,unholy,11,3,8
1177,Lockstocked,dathremar,256,deathknight,unholy,4,4,0
1178,Milkdrugs,daggerspine,256,deathknight,unholy,10,3,7
1179,Baskel,frostmane,255,deathknight,unholy,11,3,8
1180,Deathrowe,blackhand,240,deathknight,unholy,9,3,6
1181,Dairboi,sargeras,239,deathknight,unholy,5,3,2
1182,Originalsin,tichondrius,239,deathknight,unholy,11,3,8
1183,Rompeimën,ragnaros,234,deathknight,unholy,11,6,5
1184,Charabone,ragnaros,192,deathknight,unholy,4,3,1
1185,Moonkhink,stormrage,192,deathknight,unholy,6,2,4
1186,Junepí,stormrage,192,deathknight,unholy,6,2,4
1187,Geth,sargeras,192,deathknight,unholy,6,2,4
1188,Eastcoast,azuremyst,192,deathknight,unholy,6,2,4
1189,Sieg,goldrinn,192,deathknight,unholy,6,2,4
1190,Deathgimbo,hellscream,192,deathknight,unholy,6,2,4
1191,Spaxz,illidan,192,deathknight,unholy,6,2,4
1192,Bloodemperor,malfurion,192,deathknight,unholy,6,2,4
1193,Dkb,drakthul,192,deathknight,unholy,6,2,4
1194,Deathhimself,moonrunner,192,deathknight,unholy,6,2,4
1195,Teedk,drakthul,192,deathknight,unholy,6,2,4
1196,Ralphpootawn,illidan,192,deathknight,unholy,6,2,4
1197,Grimreminder,zuljin,192,deathknight,unholy,6,2,4
1198,Afkftwok,illidan,192,deathknight,unholy,6,2,4
1199,Uncoachablex,illidan,192,deathknight,unholy,6,2,4
1200,Mythandour,shandris,192,deathknight,unholy,6,2,4
1201,Corscadden,zuljin,192,deathknight,unholy,6,2,4
1202,Fizzease,illidan,192,deathknight,unholy,6,2,4
1203,Blooddisease,frostmourne,192,deathknight,unholy,6,2,4
1204,Menalise,moon-guard,192,deathknight,unholy,6,2,4
1205,Dkgrrick,bleeding-hollow,192,deathknight,unholy,6,2,4
1206,Kranaz,barthilas,192,deathknight,unholy,6,2,4
1207,Tristam,area-52,192,deathknight,unholy,6,2,4
1208,Twocolors,gilneas,192,deathknight,unholy,6,2,4
1209,Dustknight,sargeras,192,deathknight,unholy,6,2,4
1210,Nightdaddyy,laughing-skull,192,deathknight,unholy,6,2,4
1211,Bogoraptor,emerald-dream,192,deathknight,unholy,6,2,4
1212,Orbo,elune,192,deathknight,unholy,6,2,4
1213,Questíonable,arthas,192,deathknight,unholy,6,2,4
1214,Ahmisu,tichondrius,192,deathknight,unholy,6,2,4
1215,Disturbedtwo,azralon,192,deathknight,unholy,6,2,4
1216,Janoh,the-scryers,192,deathknight,unholy,6,2,4
1217,Dxssxe,tichondrius,192,deathknight,unholy,6,2,4
1218,Dhaarok,malganis,192,deathknight,unholy,6,2,4
1219,Nurglet,proudmoore,192,deathknight,unholy,6,2,4
1220,Reizu,ragnaros,192,deathknight,unholy,6,2,4
1221,Otr,wyrmrest-accord,192,deathknight,unholy,6,2,4
1222,Jinus,earthen-ring,192,deathknight,unholy,6,2,4
1223,Atheion,the-underbog,192,deathknight,unholy,6,2,4
1224,Onsslaught,sargeras,192,deathknight,unholy,6,2,4
1225,Patchi,area-52,192,deathknight,unholy,6,2,4
1226,Sinnan,turalyon,192,deathknight,unholy,6,2,4
1227,Orcazmic,area-52,192,deathknight,unholy,6,2,4
1228,Kmardk,area-52,192,deathknight,unholy,6,2,4
1229,Mesx,tichondrius,192,deathknight,unholy,6,2,4
1230,Supfam,tichondrius,192,deathknight,unholy,6,2,4
1231,Lunatick,darkspear,192,deathknight,unholy,6,2,4
1232,Rockadeath,sargeras,192,deathknight,unholy,6,2,4
1233,Havasu,proudmoore,192,deathknight,unholy,6,2,4
1234,Lìlith,dreadmaul,192,deathknight,unholy,6,2,4
1235,Saraphdk,area-52,192,deathknight,unholy,6,2,4
1236,Weedseagull,dragonmaw,192,deathknight,unholy,6,2,4
1237,Hastë,proudmoore,192,deathknight,unholy,6,2,4
1238,Gusabio,drakkari,192,deathknight,unholy,6,2,4
1239,Kniightdkk,kelthuzad,192,deathknight,unholy,6,2,4
1240,Vlladimir,kelthuzad,192,deathknight,unholy,6,2,4
1241,Zerodk,kelthuzad,192,deathknight,unholy,6,2,4
1242,Bealzabubb,sargeras,192,deathknight,unholy,6,2,4
1243,Hanung,tichondrius,192,deathknight,unholy,6,2,4
1244,Chandsformer,tichondrius,192,deathknight,unholy,6,2,4
1245,Gatitos,ragnaros,192,deathknight,unholy,6,2,4
1246,Dkdkdkdkdk,chromaggus,192,deathknight,unholy,6,2,4
1247,Semisoftbody,malganis,192,deathknight,unholy,6,2,4
1248,Tbop,ragnaros,192,deathknight,unholy,6,2,4
1249,Poubelle,malganis,192,deathknight,unholy,6,2,4
1250,Zilli,blackrock,192,deathknight,unholy,6,2,4
1251,Kookx,tichondrius,192,deathknight,unholy,6,2,4
1252,Bagul,azralon,192,deathknight,unholy,6,2,4
1253,Raahjx,sargeras,192,deathknight,unholy,6,2,4
1254,Válhállá,ragnaros,192,deathknight,unholy,6,2,4
1255,Gooré,ragnaros,192,deathknight,unholy,6,2,4
1256,Spotsdk,hyjal,192,deathknight,unholy,6,2,4
1257,Mako,garithos,192,deathknight,unholy,6,2,4
1258,Mistake,ragnaros,192,deathknight,unholy,6,2,4
1259,Chachea,kiljaeden,192,deathknight,unholy,12,2,10
1260,Rykard,hyjal,192,deathknight,unholy,12,2,10
1261,Longlnus,malganis,192,deathknight,unholy,12,2,10
1262,Stteve,proudmoore,192,deathknight,unholy,12,2,10
1263,Tacofoxlol,tichondrius,192,deathknight,unholy,12,2,10
1264,Maliceborn,stormrage,192,deathknight,unholy,12,2,10
1265,Scythê,barthilas,192,deathknight,unholy,12,2,10
1266,Mystery,wyrmrest-accord,192,deathknight,unholy,12,2,10
1267,Cow,sargeras,192,deathknight,unholy,12,2,10
1268,Giraldus,stormrage,192,deathknight,unholy,12,2,10
1269,Ðìvíne,illidan,192,deathknight,unholy,12,2,10
1270,Ovulating,malganis,192,deathknight,unholy,12,2,10
1271,Lunaxx,ragnaros,192,deathknight,unholy,12,2,10
1272,Vynjonc,drenden,191,deathknight,unholy,6,2,4
1273,Larrisey,illidan,191,deathknight,unholy,6,2,4
1274,Drdeathz,sargeras,191,deathknight,unholy,6,2,4
1275,Fishtouching,illidan,175,deathknight,unholy,11,2,9
1276,Guffles,tichondrius,160,deathknight,unholy,10,2,8
1277,Hooker,dragonmaw,138,deathknight,unholy,8,4,4
1278,Glacíuss,ragnaros,138,deathknight,unholy,9,4,5
1279,Plutonyus,stonemaul,128,deathknight,unholy,4,2,2
1280,Ðëthbringër,jubeithos,127,deathknight,unholy,8,2,6
1281,Tìtø,ragnaros,96,deathknight,unholy,6,1,5
1282,Moldremover,frostmourne,96,deathknight,unholy,6,1,5
1283,Testitickler,gurubashi,96,deathknight,unholy,6,1,5
1284,Lazynome,azshara,96,deathknight,unholy,6,1,5
1285,Bulltille,azralon,96,deathknight,unholy,6,1,5
1286,Hushima,lightbringer,96,deathknight,unholy,6,1,5
1287,Drip,whisperwind,96,deathknight,unholy,6,1,5
1288,Andivh,hydraxis,96,deathknight,unholy,6,1,5
1289,Bealzabbub,sargeras,96,deathknight,unholy,6,1,5
1290,Amö,emerald-dream,96,deathknight,unholy,6,1,5
1291,Stormsick,ragnaros,96,deathknight,unholy,6,1,5
1292,Hunwild,emerald-dream,96,deathknight,unholy,6,1,5
1293,Apeirøn,quelthalas,96,deathknight,unholy,6,1,5
1294,Istery,thrall,96,deathknight,unholy,6,1,5
1295,Gnargnarr,firetree,96,deathknight,unholy,6,1,5
1296,Alexanderz,quelthalas,96,deathknight,unholy,6,1,5
1297,Krw,stormrage,96,deathknight,unholy,6,1,5
1298,Deathscyythe,illidan,96,deathknight,unholy,6,1,5
1299,Terrethess,illidan,96,deathknight,unholy,6,1,5
1300,Abake,illidan,96,deathknight,unholy,6,1,5
1301,Iluvbooty,blackrock,96,deathknight,unholy,6,1,5
1302,Gröxxigor,azralon,96,deathknight,unholy,6,1,5
1303,Bein,frostmourne,96,deathknight,unholy,6,1,5
1304,Lichhbanne,doomhammer,96,deathknight,unholy,6,1,5
1305,Wacktony,illidan,96,deathknight,unholy,6,1,5
1306,Rgn,deathwing,96,deathknight,unholy,6,1,5
1307,Dknightor,dalaran,96,deathknight,unholy,6,1,5
1308,Sever,demon-soul,96,deathknight,unholy,6,1,5
1309,Kìrìtó,malygos,96,deathknight,unholy,6,1,5
1310,Artyboy,icecrown,96,deathknight,unholy,6,1,5
1311,Apocalypsis,uldum,96,deathknight,unholy,6,1,5
1312,Ishamaael,tichondrius,96,deathknight,unholy,6,1,5
1313,Heavic,skywall,96,deathknight,unholy,6,1,5
1314,Skynyght,area-52,96,deathknight,unholy,6,1,5
1315,Alayssia,darkspear,96,deathknight,unholy,6,1,5
1316,Argy,zuljin,96,deathknight,unholy,6,1,5
1317,Requísition,barthilas,96,deathknight,unholy,6,1,5
1318,Tarone,zuljin,96,deathknight,unholy,6,1,5
1319,Sandolorian,area-52,96,deathknight,unholy,6,1,5
1320,Dontbanmepls,zuljin,96,deathknight,unholy,6,1,5
1321,Zetarexia,area-52,96,deathknight,unholy,6,1,5
1322,Dethklòk,area-52,96,deathknight,unholy,6,1,5
1323,Almostdead,proudmoore,96,deathknight,unholy,6,1,5
1324,Grimorra,bleeding-hollow,96,deathknight,unholy,6,1,5
1325,Dreâmer,tichondrius,96,deathknight,unholy,6,1,5
1326,Vicedro,arthas,96,deathknight,unholy,6,1,5
1327,Percy,thaurissan,96,deathknight,unholy,6,1,5
1328,Vicesquad,tichondrius,96,deathknight,unholy,6,1,5
1329,Zenin,emerald-dream,96,deathknight,unholy,6,1,5
1330,Report,dathremar,96,deathknight,unholy,6,1,5
1331,Nachohands,laughing-skull,96,deathknight,unholy,6,1,5
1332,Azryull,perenolde,96,deathknight,unholy,6,1,5
1333,Vorlakesh,boulderfist,96,deathknight,unholy,6,1,5
1334,Otarin,tichondrius,96,deathknight,unholy,6,1,5
1335,Worgenracist,tichondrius,96,deathknight,unholy,6,1,5
1336,Rotfang,elune,96,deathknight,unholy,6,1,5
1337,Diviniums,bleeding-hollow,96,deathknight,unholy,6,1,5
1338,Perculës,sargeras,96,deathknight,unholy,7,1,6
1339,Aqs,sargeras,96,deathknight,unholy,9,1,8
1340,Níce,tichondrius,96,deathknight,unholy,12,1,11
1341,Dípero,azralon,96,deathknight,unholy,12,1,11
1342,Wkxx,tichondrius,96,deathknight,unholy,12,1,11
1343,Klàssy,stormrage,96,deathknight,unholy,12,1,11
1344,Skadattle,emerald-dream,96,deathknight,unholy,12,1,11
1345,Darnkiller,kelthuzad,96,deathknight,unholy,18,1,17
1346,Droko,thunderlord,95,deathknight,unholy,9,2,7
1347,Funerall,azralon,95,deathknight,unholy,12,1,11
1348,Frostbytez,barthilas,79,deathknight,unholy,5,1,4
1349,Explorer,kelthuzad,64,deathknight,unholy,4,1,3
1350,Deanz,stormrage,63,deathknight,unholy,2,2,0
1351,Asfaq,frostmourne,63,deathknight,unholy,2,2,0
1352,Weebfiend,moon-guard,63,deathknight,unholy,2,2,0
1353,Spleem,stormrage,48,deathknight,unholy,3,1,2
1354,Lördd,moon-guard,42,deathknight,unholy,11,3,8
1355,Harrypottr,darrowmere,42,deathknight,unholy,8,2,6
1356,Pookr,area-52,2214,deathknight,frost,355,180,175
1357,Yoinkzz,illidan,2167,deathknight,frost,113,58,55
1358,Thânätos,nemesis,1980,deathknight,frost,84,44,40
1359,Sylèss,tichondrius,1979,deathknight,frost,84,47,37
1360,Runtasticxz,tichondrius,1906,deathknight,frost,60,29,31
1361,Raiekko,dalaran,1888,deathknight,frost,68,33,35
1362,Duranteh,illidan,1881,deathknight,frost,60,32,28
1363,Venvicta,tichondrius,1850,deathknight,frost,44,31,13
1364,Saco,malganis,1845,deathknight,frost,110,62,48
1365,Scareth,proudmoore,1823,deathknight,frost,46,27,19
1366,Deaddubya,illidan,1815,deathknight,frost,63,40,23
1367,Mikeycal,stormrage,1805,deathknight,frost,66,34,32
1368,Gladiaturd,hellscream,1782,deathknight,frost,76,38,38
1369,Dkyeico,ragnaros,1762,deathknight,frost,90,44,46
1370,Chillbaynê,the-scryers,1754,deathknight,frost,36,22,14
1371,Ksmc,tichondrius,1740,deathknight,frost,54,27,27
1372,Fastapi,tichondrius,1737,deathknight,frost,90,41,49
1373,Iccyhottie,stormrage,1722,deathknight,frost,196,103,93
1374,Sober,destromath,1712,deathknight,frost,95,48,47
1375,Axiomqt,tichondrius,1710,deathknight,frost,48,25,23
1376,Devcoil,sargeras,1706,deathknight,frost,54,22,32
1377,Mikepinkdk,illidan,1700,deathknight,frost,75,40,35
1378,Remanent,tichondrius,1680,deathknight,frost,48,27,21
1379,Crink,sargeras,1658,deathknight,frost,47,24,23
1380,Menalise,moon-guard,1650,deathknight,frost,42,22,20
1381,Deathboost,stormrage,1647,deathknight,frost,75,33,42
1382,Børeas,quelthalas,1645,deathknight,frost,96,43,53
1383,Gkdm,tichondrius,1643,deathknight,frost,42,21,21
1384,Jykupajr,proudmoore,1629,deathknight,frost,42,22,20
1385,Xelonith,sargeras,1627,deathknight,frost,30,17,13
1386,Tzepesci,hyjal,1626,deathknight,frost,58,26,32
1387,Sinizster,kelthuzad,1615,deathknight,frost,31,18,13
1388,Ebolaxd,area-52,1614,deathknight,frost,42,21,21
1389,Rekktless,aerie-peak,1613,deathknight,frost,66,34,32
1390,Grippygarý,illidan,1600,deathknight,frost,42,19,23
1391,Worgenracist,tichondrius,1598,deathknight,frost,53,22,31
1392,Frosthana,illidan,1596,deathknight,frost,78,34,44
1393,Fußuky,quelthalas,1594,deathknight,frost,76,39,37
1394,Zemzil,tichondrius,1559,deathknight,frost,56,25,31
1395,Skullash,stormrage,1538,deathknight,frost,36,19,17
1396,Grakth,quelthalas,1527,deathknight,frost,66,37,29
1397,Darkwraith,illidan,1525,deathknight,frost,42,21,21
1398,Uzgard,zuljin,1517,deathknight,frost,65,38,27
1399,Jimmyjohnson,illidan,1500,deathknight,frost,77,44,33
1400,Report,dathremar,1494,deathknight,frost,75,38,37
1401,Trødz,tichondrius,1468,deathknight,frost,87,42,45
1402,Rembrandtdk,gorefiend,1467,deathknight,frost,54,29,25
1403,Lho,caelestrasz,1465,deathknight,frost,107,54,53
1404,Vust,malganis,1454,deathknight,frost,42,23,19
1405,Dekanok,korgath,1452,deathknight,frost,30,16,14
1406,Jazh,tichondrius,1441,deathknight,frost,59,23,36
1407,Umbramane,tichondrius,1438,deathknight,frost,39,19,20
1408,Iskandàr,ragnaros,1435,deathknight,frost,32,16,16
1409,Vãl,sargeras,1434,deathknight,frost,155,72,83
1410,Abrahams,tichondrius,1427,deathknight,frost,100,48,52
1411,Percy,thaurissan,1427,deathknight,frost,181,80,101
1412,Emanuels,quelthalas,1425,deathknight,frost,56,28,28
1413,Deadspellz,bleeding-hollow,1423,deathknight,frost,30,15,15
1414,Vuldy,blackhand,1396,deathknight,frost,30,17,13
1415,Eldavò,quelthalas,1393,deathknight,frost,60,25,35
1416,Corrpsse,tichondrius,1390,deathknight,frost,30,16,14
1417,Algeross,dalaran,1379,deathknight,frost,42,15,27
1418,Khalid,azgalor,1376,deathknight,frost,54,23,31
1419,Clongeus,tichondrius,1374,deathknight,frost,54,25,29
1420,Tangarang,dalaran,1372,deathknight,frost,68,30,38
1421,Imfrozone,stormrage,1371,deathknight,frost,35,15,20
1422,Sinyay,tichondrius,1370,deathknight,frost,82,48,34
1423,Ellipsoro,onyxia,1362,deathknight,frost,78,35,43
1424,Sandooñ,tichondrius,1359,deathknight,frost,138,67,71
1425,Nevermor,malganis,1358,deathknight,frost,98,50,48
1426,Theronguard,area-52,1358,deathknight,frost,48,22,26
1427,Rylas,destromath,1356,deathknight,frost,75,38,37
1428,Gwab,stormrage,1354,deathknight,frost,48,20,28
1429,Eloton,daggerspine,1350,deathknight,frost,35,18,17
1430,Thetalis,moon-guard,1346,deathknight,frost,78,38,40
1431,Kryptikkyt,blackrock,1341,deathknight,frost,18,14,4
1432,Ðerion,stormrage,1339,deathknight,frost,116,52,64
1433,Clapdat,malganis,1335,deathknight,frost,114,56,58
1434,Onsslaught,sargeras,1334,deathknight,frost,42,14,28
1435,Kruspy,area-52,1324,deathknight,frost,53,27,26
1436,Dontbanmepls,zuljin,1318,deathknight,frost,30,14,16
1437,Tekc,nemesis,1317,deathknight,frost,132,64,68
1438,Jordankg,tanaris,1312,deathknight,frost,36,15,21
1439,Bridenbrad,quelthalas,1299,deathknight,frost,27,17,10
1440,Iceice,emerald-dream,1296,deathknight,frost,102,47,55
1441,Flins,nemesis,1288,deathknight,frost,384,195,189
1442,Estali,kelthuzad,1272,deathknight,frost,110,51,59
1443,Abake,illidan,1267,deathknight,frost,62,30,32
1444,Lichborn,azralon,1265,deathknight,frost,65,26,39
1445,Alexanderz,quelthalas,1264,deathknight,frost,36,15,21
1446,Alexeous,wyrmrest-accord,1261,deathknight,frost,103,43,60
1447,Friggintough,tichondrius,1255,deathknight,frost,30,14,16
1448,Barrodir,tichondrius,1243,deathknight,frost,69,36,33
1449,Darkdeviliv,darkspear,1238,deathknight,frost,41,21,20
1450,Bâttalion,illidan,1237,deathknight,frost,30,13,17
1451,Rayden,frostmourne,1235,deathknight,frost,24,13,11
1452,Yödä,barthilas,1235,deathknight,frost,36,14,22
1453,Darketvam,illidan,1230,deathknight,frost,38,23,15
1454,Bossk,emerald-dream,1229,deathknight,frost,30,13,17
1455,Spoon,sargeras,1223,deathknight,frost,70,33,37
1456,Sécret,tichondrius,1212,deathknight,frost,24,13,11
1457,Rohdey,madoran,1210,deathknight,frost,42,15,27
1458,Jackofblades,veknilash,1204,deathknight,frost,66,32,34
1459,Darkreígn,tichondrius,1202,deathknight,frost,59,28,31
1460,Seeyoudiebr,gallywix,1190,deathknight,frost,42,17,25
1461,Zefdk,illidan,1186,deathknight,frost,48,27,21
1462,Dkptador,azralon,1182,deathknight,frost,130,64,66
1463,Darfik,sargeras,1177,deathknight,frost,120,65,55
1464,Lîch,azralon,1157,deathknight,frost,63,24,39
1465,Tìtø,ragnaros,1151,deathknight,frost,24,12,12
1466,Lxsol,illidan,1149,deathknight,frost,18,12,6
1467,Tambaknight,nemesis,1146,deathknight,frost,44,15,29
1468,Soulfang,nemesis,1145,deathknight,frost,54,25,29
1469,Laumuelden,ragnaros,1143,deathknight,frost,48,17,31
1470,Janco,runetotem,1141,deathknight,frost,24,12,12
1471,Frostunholy,tichondrius,1140,deathknight,frost,24,12,12
1472,Hiki,ragnaros,1134,deathknight,frost,30,12,18
1473,Verhangnis,azjolnerub,1123,deathknight,frost,20,12,8
1474,Achilleo,quelthalas,1115,deathknight,frost,24,12,12
1475,Pembadk,tichondrius,1110,deathknight,frost,33,14,19
1476,Janoh,the-scryers,1095,deathknight,frost,32,16,16
1477,Ârtas,uldum,1090,deathknight,frost,39,16,23
1478,Moonnwater,frostmourne,1087,deathknight,frost,84,43,41
1479,Sephirott,boulderfist,1086,deathknight,frost,35,19,16
1480,Garryxz,quelthalas,1077,deathknight,frost,22,12,10
1481,Darkdevilvii,tichondrius,1069,deathknight,frost,66,33,33
1482,Mawvac,quelthalas,1069,deathknight,frost,72,33,39
1483,Zephyx,lightbringer,1056,deathknight,frost,18,11,7
1484,Toxismall,zuljin,1056,deathknight,frost,24,11,13
1485,Puppykisses,perenolde,1055,deathknight,frost,24,11,13
1486,Icewalløw,darkspear,1052,deathknight,frost,18,11,7
1487,Jhonnsnow,frostmourne,1051,deathknight,frost,24,11,13
1488,Dregdar,emerald-dream,1049,deathknight,frost,18,11,7
1489,Griswold,windrunner,1049,deathknight,frost,30,15,15
1490,Malovv,nemesis,1042,deathknight,frost,18,12,6
1491,Dromidon,darkspear,1036,deathknight,frost,23,11,12
1492,Vanyor,wyrmrest-accord,1025,deathknight,frost,44,14,30
1493,Zarathraz,ragnaros,1004,deathknight,frost,23,11,12
1494,Roarbane,muradin,999,deathknight,frost,42,22,20
1495,Icedmilk,zuluhed,982,deathknight,frost,25,14,11
1496,Tarone,zuljin,981,deathknight,frost,27,14,13
1497,Vorlakesh,boulderfist,979,deathknight,frost,22,11,11
1498,Skittsdk,thrall,966,deathknight,frost,24,12,12
1499,Xhín,bleeding-hollow,959,deathknight,frost,18,10,8
1500,Tokyotimxx,malganis,958,deathknight,frost,18,10,8
1501,Thetissuebox,emerald-dream,958,deathknight,frost,18,10,8
1502,Toothstick,stormrage,957,deathknight,frost,18,10,8
1503,Necrósy,azralon,955,deathknight,frost,18,10,8
1504,Axylus,kelthuzad,953,deathknight,frost,18,10,8
1505,Raegywn,blood-furnace,952,deathknight,frost,24,10,14
1506,Eliagianluca,caelestrasz,949,deathknight,frost,60,25,35
1507,Loverianed,aerie-peak,946,deathknight,frost,106,46,60
1508,Úndead,barthilas,943,deathknight,frost,18,10,8
1509,Larrisey,illidan,940,deathknight,frost,33,18,15
1510,Kraige,tichondrius,933,deathknight,frost,30,10,20
1511,Ciputra,blood-furnace,929,deathknight,frost,47,23,24
1512,ßlazedkush,kelthuzad,928,deathknight,frost,18,10,8
1513,Blooddisease,frostmourne,926,deathknight,frost,23,10,13
1514,Kallugrax,kelthuzad,919,deathknight,frost,30,12,18
1515,Fokit,barthilas,897,deathknight,frost,58,28,30
1516,Sandolorian,area-52,892,deathknight,frost,24,10,14
1517,Lokitabeso,ragnaros,864,deathknight,frost,12,9,3
1518,Legendåryx,sargeras,863,deathknight,frost,12,9,3
1519,Lazenca,malganis,863,deathknight,frost,18,9,9
1520,Zarakas,sargeras,863,deathknight,frost,24,9,15
1521,Deathzpeckt,tichondrius,863,deathknight,frost,24,9,15
1522,Kekkijutsu,bleeding-hollow,862,deathknight,frost,12,9,3
1523,Zivz,borean-tundra,862,deathknight,frost,12,9,3
1524,Thesseo,quelthalas,862,deathknight,frost,18,9,9
1525,Surcäfauces,ragnaros,862,deathknight,frost,21,10,11
1526,Dkbunny,thaurissan,862,deathknight,frost,30,9,21
1527,Chicnchsteak,tichondrius,862,deathknight,frost,30,9,21
1528,Jasmíne,vashj,861,deathknight,frost,12,9,3
1529,Dreekon,bleeding-hollow,861,deathknight,frost,12,9,3
1530,Urieen,gorefiend,861,deathknight,frost,18,9,9
1531,Ântipaladin,arthas,859,deathknight,frost,18,9,9
1532,Sporkdk,illidan,859,deathknight,frost,29,9,20
1533,Janzano,deathwing,858,deathknight,frost,20,9,11
1534,Sllice,aegwynn,858,deathknight,frost,24,9,15
1535,Metaphysicsx,amanthul,839,deathknight,frost,20,9,11
1536,Madorderog,stormrage,834,deathknight,frost,34,15,19
1537,Sakaarr,bleeding-hollow,830,deathknight,frost,24,9,15
1538,Dèadpool,blackhand,828,deathknight,frost,18,9,9
1539,Uncfester,onyxia,823,deathknight,frost,18,9,9
1540,Neofrank,drakkari,800,deathknight,frost,54,13,41
1541,Plaw,kiljaeden,799,deathknight,frost,17,9,8
1542,Lokítabesos,ragnaros,768,deathknight,frost,12,8,4
1543,Havince,drenden,768,deathknight,frost,12,8,4
1544,Vigasick,azralon,768,deathknight,frost,18,8,10
1545,Incanis,moon-guard,767,deathknight,frost,18,8,10
1546,Gypo,scilla,766,deathknight,frost,12,8,4
1547,Artourias,wyrmrest-accord,766,deathknight,frost,12,8,4
1548,Kerigann,moon-guard,766,deathknight,frost,12,8,4
1549,Freemoney,wyrmrest-accord,766,deathknight,frost,12,8,4
1550,Dhrogar,moon-guard,762,deathknight,frost,12,8,4
1551,Dyingwolf,ragnaros,761,deathknight,frost,18,8,10
1552,Jyantdeck,area-52,760,deathknight,frost,13,8,5
1553,Zarolden,tichondrius,759,deathknight,frost,24,8,16
1554,Nagaizao,nemesis,757,deathknight,frost,18,8,10
1555,Hansmclroy,trollbane,738,deathknight,frost,24,8,16
1556,Fexon,queldorei,735,deathknight,frost,27,9,18
1557,Monglord,arthas,733,deathknight,frost,27,9,18
1558,Unhappyvelic,tichondrius,720,deathknight,frost,21,8,13
1559,Russkivolk,frostmourne,688,deathknight,frost,19,8,11
1560,Insanity,boulderfist,672,deathknight,frost,12,7,5
1561,Dumbledore,deathwing,672,deathknight,frost,12,7,5
1562,Anexdk,korgath,672,deathknight,frost,18,7,11
1563,Chillpills,stormrage,672,deathknight,frost,18,7,11
1564,Iriwa,tichondrius,672,deathknight,frost,24,7,17
1565,Unholycube,zuljin,671,deathknight,frost,30,7,23
1566,Carecaa,azralon,670,deathknight,frost,18,7,11
1567,Elwoodblooz,stormrage,669,deathknight,frost,15,8,7
1568,Cryptgore,moon-guard,665,deathknight,frost,18,7,11
1569,Ixiefin,sargeras,663,deathknight,frost,12,7,5
1570,Dantte,stormscale,659,deathknight,frost,18,7,11
1571,Iiedown,stormrage,623,deathknight,frost,11,7,4
1572,Wap,bloodhoof,576,deathknight,frost,12,6,6
1573,Soulbone,wyrmrest-accord,576,deathknight,frost,12,6,6
1574,Dementrius,zuljin,576,deathknight,frost,12,6,6
1575,Rotfang,proudmoore,576,deathknight,frost,12,6,6
1576,Dreadlight,moon-guard,576,deathknight,frost,12,6,6
1577,Sparklekitty,illidan,576,deathknight,frost,12,6,6
1578,Cozzasad,barthilas,576,deathknight,frost,12,6,6
1579,Riglros,tichondrius,576,deathknight,frost,12,6,6
1580,Aldrey,bonechewer,576,deathknight,frost,12,6,6
1581,Otarin,tichondrius,576,deathknight,frost,12,6,6
1582,Rennoc,emerald-dream,576,deathknight,frost,12,6,6
1583,Darkxavros,stormrage,576,deathknight,frost,12,6,6
1584,Beliath,crushridge,576,deathknight,frost,17,6,11
1585,Dairboi,sargeras,576,deathknight,frost,18,6,12
1586,Ariacy,sargeras,576,deathknight,frost,18,6,12
1587,Flûffÿ,thrall,575,deathknight,frost,12,6,6
1588,Mexe,ragnaros,575,deathknight,frost,12,6,6
1589,Davenn,stormrage,575,deathknight,frost,12,6,6
1590,Tooe,darrowmere,575,deathknight,frost,12,6,6
1591,Winterstone,moon-guard,575,deathknight,frost,12,6,6
1592,Nezareth,sargeras,574,deathknight,frost,12,6,6
1593,Bloodbanne,darkspear,573,deathknight,frost,12,6,6
1594,Krowl,nagrand,570,deathknight,frost,12,6,6
1595,Ikaris,wildhammer,569,deathknight,frost,12,6,6
1596,Parksy,kelthuzad,559,deathknight,frost,11,6,5
1597,Werebuddy,lightnings-blade,528,deathknight,frost,15,6,9
1598,Bellum,moon-guard,511,deathknight,frost,20,6,14
1599,Kookx,tichondrius,489,deathknight,frost,13,6,7
1600,Wahpow,frostwolf,480,deathknight,frost,6,5,1
1601,Lokitaßeso,ragnaros,480,deathknight,frost,6,5,1
1602,Vett,antonidas,480,deathknight,frost,6,5,1
1603,Sathanazz,ragnaros,480,deathknight,frost,6,5,1
1604,Busynas,thrall,480,deathknight,frost,6,5,1
1605,Subparatbest,chogall,480,deathknight,frost,12,5,7
1606,Martinnash,emerald-dream,480,deathknight,frost,12,5,7
1607,Himanshu,emerald-dream,480,deathknight,frost,12,5,7
1608,Sinistarz,area-52,480,deathknight,frost,12,5,7
1609,Neaz,moon-guard,480,deathknight,frost,12,5,7
1610,Deadbeards,zuluhed,480,deathknight,frost,12,5,7
1611,Denale,darkspear,480,deathknight,frost,12,5,7
1612,Kodokuna,bleeding-hollow,480,deathknight,frost,12,5,7
1613,Flashofdark,proudmoore,480,deathknight,frost,12,5,7
1614,Rumblepuppy,hyjal,480,deathknight,frost,12,5,7
1615,Frozenhawk,lothar,480,deathknight,frost,12,5,7
1616,Unintended,barthilas,480,deathknight,frost,18,5,13
1617,Saighast,illidan,480,deathknight,frost,18,5,13
1618,Moovement,illidan,479,deathknight,frost,6,5,1
1619,Bëlzëbü,stormrage,479,deathknight,frost,6,5,1
1620,Bulltille,azralon,479,deathknight,frost,6,5,1
1621,Twicecursed,kelthuzad,479,deathknight,frost,12,5,7
1622,Caravante,azralon,479,deathknight,frost,12,5,7
1623,Bigdkk,thaurissan,477,deathknight,frost,12,5,7
1624,Adjudicated,darkspear,477,deathknight,frost,12,5,7
1625,Ðecimate,muradin,476,deathknight,frost,12,5,7
1626,Killa,maiev,475,deathknight,frost,12,5,7
1627,Ergoth,darkspear,475,deathknight,frost,24,5,19
1628,Neowolf,azgalor,473,deathknight,frost,30,5,25
1629,Frostyclaws,blackrock,447,deathknight,frost,17,5,12
1630,Greeasy,bleeding-hollow,446,deathknight,frost,17,5,12
1631,Dìs,frostmourne,399,deathknight,frost,5,5,0
1632,Anatøly,ragnaros,384,deathknight,frost,6,4,2
1633,Aldebamuu,ragnaros,384,deathknight,frost,6,4,2
1634,Bigdooks,area-52,384,deathknight,frost,6,4,2
1635,Nabreus,ragnaros,384,deathknight,frost,6,4,2
1636,Tanjus,kelthuzad,384,deathknight,frost,6,4,2
1637,Tontan,cairne,384,deathknight,frost,6,4,2
1638,Lókhä,thrall,384,deathknight,frost,6,4,2
1639,Orbo,elune,384,deathknight,frost,6,4,2
1640,Laxatives,tichondrius,384,deathknight,frost,6,4,2
1641,Hunrune,emerald-dream,384,deathknight,frost,6,4,2
1642,Lichhbanne,doomhammer,384,deathknight,frost,12,4,8
1643,Silanvia,wyrmrest-accord,384,deathknight,frost,12,4,8
1644,Exiledknight,area-52,384,deathknight,frost,12,4,8
1645,Aradorn,azralon,384,deathknight,frost,12,4,8
1646,Shmacmiller,stormrage,384,deathknight,frost,12,4,8
1647,Zenin,emerald-dream,384,deathknight,frost,12,4,8
1648,Almostdead,proudmoore,384,deathknight,frost,12,4,8
1649,Hooterzqt,tichondrius,384,deathknight,frost,12,4,8
1650,Thikness,tichondrius,384,deathknight,frost,12,4,8
1651,Deathrowe,blackhand,384,deathknight,frost,12,4,8
1652,Whytedk,illidan,384,deathknight,frost,12,4,8
1653,Xhoul,sargeras,384,deathknight,frost,12,4,8
1654,Nefarion,nathrezim,384,deathknight,frost,15,4,11
1655,Ðaz,zuljin,384,deathknight,frost,18,4,14
1656,Wãrson,bleeding-hollow,383,deathknight,frost,6,4,2
1657,Shinici,kelthuzad,383,deathknight,frost,9,5,4
1658,Grimmr,tichondrius,383,deathknight,frost,12,4,8
1659,Amauqsun,bleeding-hollow,383,deathknight,frost,12,4,8
1660,Vithael,stormrage,383,deathknight,frost,12,4,8
1661,Getmad,anvilmar,383,deathknight,frost,12,4,8
1662,Bullbanger,runetotem,382,deathknight,frost,6,4,2
1663,Cailras,argent-dawn,382,deathknight,frost,6,4,2
1664,Sindragos,stormrage,382,deathknight,frost,12,4,8
1665,Deathvortex,nemesis,379,deathknight,frost,12,4,8
1666,Khaíne,wyrmrest-accord,352,deathknight,frost,13,4,9
1667,Lokitakisses,ragnaros,351,deathknight,frost,11,4,7
1668,Bunghoolio,nerzhul,315,deathknight,frost,16,4,12
1669,Yungdooks,area-52,288,deathknight,frost,6,3,3
1670,Arnagal,drakkari,288,deathknight,frost,6,3,3
1671,Trant,tichondrius,288,deathknight,frost,6,3,3
1672,Störmrünner,kelthuzad,288,deathknight,frost,6,3,3
1673,Amarlana,mannoroth,288,deathknight,frost,6,3,3
1674,Frostybones,guldan,288,deathknight,frost,6,3,3
1675,Egirlgripper,area-52,288,deathknight,frost,6,3,3
1676,Saraphdk,area-52,288,deathknight,frost,6,3,3
1677,Gorsz,tichondrius,288,deathknight,frost,6,3,3
1678,Fåîrÿdûst,skullcrusher,288,deathknight,frost,6,3,3
1679,Clizforden,kelthuzad,288,deathknight,frost,6,3,3
1680,Nalec,tichondrius,288,deathknight,frost,6,3,3
1681,Zügzug,chogall,288,deathknight,frost,6,3,3
1682,Laboön,stormrage,288,deathknight,frost,6,3,3
1683,Brumaks,quelthalas,288,deathknight,frost,6,3,3
1684,Démise,malganis,288,deathknight,frost,6,3,3
1685,Bootyclapztv,tichondrius,288,deathknight,frost,6,3,3
1686,Víní,azralon,288,deathknight,frost,6,3,3
1687,Pyradine,amanthul,288,deathknight,frost,6,3,3
1688,Billclintonn,sargeras,288,deathknight,frost,6,3,3
1689,Zygon,thrall,288,deathknight,frost,6,3,3
1690,Yamanji,wyrmrest-accord,288,deathknight,frost,6,3,3
1691,Jughéad,thrall,288,deathknight,frost,6,3,3
1692,Ruggair,proudmoore,288,deathknight,frost,6,3,3
1693,Tofurious,barthilas,288,deathknight,frost,6,3,3
1694,Ghouldruis,barthilas,288,deathknight,frost,6,3,3
1695,Jessaminne,nordrassil,288,deathknight,frost,6,3,3
1696,Astanddra,wyrmrest-accord,288,deathknight,frost,6,3,3
1697,Kalevesicant,nesingwary,288,deathknight,frost,6,3,3
1698,Doomdk,azralon,288,deathknight,frost,6,3,3
1699,Plaugedone,lightbringer,288,deathknight,frost,6,3,3
1700,Fearfull,hyjal,288,deathknight,frost,10,4,6
1701,Janus,illidan,288,deathknight,frost,12,3,9
1702,Freyjani,moon-guard,288,deathknight,frost,12,3,9
1703,Nenó,illidan,288,deathknight,frost,12,3,9
1704,Dkpeter,quelthalas,288,deathknight,frost,12,3,9
1705,Paíín,illidan,288,deathknight,frost,12,3,9
1706,Toxicant,zuljin,288,deathknight,frost,12,3,9
1707,Bloodmourne,barthilas,288,deathknight,frost,12,3,9
1708,Flarkness,area-52,288,deathknight,frost,12,3,9
1709,Drzièglér,tichondrius,288,deathknight,frost,12,3,9
1710,Moyjô,aggramar,288,deathknight,frost,15,3,12
1711,Sinfulvoid,darkspear,287,deathknight,frost,6,3,3
1712,Válhállá,ragnaros,287,deathknight,frost,12,3,9
1713,Páthøgen,ravencrest,287,deathknight,frost,12,3,9
1714,Varrine,hyjal,286,deathknight,frost,6,3,3
1715,Xslaught,maiev,286,deathknight,frost,6,3,3
1716,Dragoroth,zuluhed,286,deathknight,frost,6,3,3
1717,Gnomey,area-52,255,deathknight,frost,8,4,4
1718,Crukashongal,zuljin,240,deathknight,frost,9,4,5
1719,Frrost,earthen-ring,240,deathknight,frost,9,3,6
1720,Unwantedgrab,sargeras,239,deathknight,frost,5,3,2
1721,Hamze,stormrage,239,deathknight,frost,5,3,2
1722,Bbcobliterat,proudmoore,234,deathknight,frost,22,4,18
1723,Lindrayëda,moon-guard,206,deathknight,frost,7,3,4
1724,Chilivibes,boulderfist,192,deathknight,frost,6,2,4
1725,Alderollar,stormrage,192,deathknight,frost,6,2,4
1726,Azhid,tichondrius,192,deathknight,frost,6,2,4
1727,Hadeon,boulderfist,192,deathknight,frost,6,2,4
1728,Lichkong,dalaran,192,deathknight,frost,6,2,4
1729,Demise,stormrage,192,deathknight,frost,6,2,4
1730,Chrønnøz,nemesis,192,deathknight,frost,6,2,4
1731,Lospollos,tichondrius,192,deathknight,frost,6,2,4
1732,Superlast,blackrock,192,deathknight,frost,6,2,4
1733,Dego,tichondrius,192,deathknight,frost,6,2,4
1734,Yourunigrip,tichondrius,192,deathknight,frost,6,2,4
1735,Sayâ,frostmane,192,deathknight,frost,6,2,4
1736,Crakdos,illidan,192,deathknight,frost,6,2,4
1737,Edek,frostmourne,192,deathknight,frost,6,2,4
1738,Nebuchadnezz,darkspear,192,deathknight,frost,6,2,4
1739,Maelk,stormrage,192,deathknight,frost,6,2,4
1740,Frozenjuice,sargeras,192,deathknight,frost,6,2,4
1741,Pofokut,bleeding-hollow,192,deathknight,frost,6,2,4
1742,Zëb,sargeras,192,deathknight,frost,6,2,4
1743,Rulord,wyrmrest-accord,192,deathknight,frost,6,2,4
1744,Oldskul,sargeras,192,deathknight,frost,6,2,4
1745,Hunwild,emerald-dream,192,deathknight,frost,6,2,4
1746,Dahaaka,malganis,192,deathknight,frost,6,2,4
1747,Oreodeath,sargeras,192,deathknight,frost,6,2,4
1748,Khørne,area-52,192,deathknight,frost,6,2,4
1749,Fraýja,tichondrius,192,deathknight,frost,6,2,4
1750,Xangrim,emerald-dream,192,deathknight,frost,6,2,4
1751,Soutennizase,azralon,192,deathknight,frost,6,2,4
1752,Noik,azralon,192,deathknight,frost,6,2,4
1753,Bonusman,sargeras,192,deathknight,frost,6,2,4
1754,Kreyun,bleeding-hollow,192,deathknight,frost,6,2,4
1755,Rotfang,elune,192,deathknight,frost,6,2,4
1756,Deathrey,kargath,192,deathknight,frost,6,2,4
1757,Envisage,kelthuzad,192,deathknight,frost,6,2,4
1758,Ryugetzu,drakkari,192,deathknight,frost,6,2,4
1759,Piratehookah,sargeras,192,deathknight,frost,6,2,4
1760,Tarknok,moon-guard,192,deathknight,frost,6,2,4
1761,Evangelina,antonidas,192,deathknight,frost,12,2,10
1762,Záiiko,quelthalas,192,deathknight,frost,12,2,10
1763,Lillylilly,bleeding-hollow,192,deathknight,frost,12,2,10
1764,Melyrc,quelthalas,192,deathknight,frost,12,2,10
1765,Shadar,muradin,192,deathknight,frost,12,2,10
1766,Appledog,ragnaros,192,deathknight,frost,12,2,10
1767,Edhral,ragnaros,191,deathknight,frost,6,2,4
1768,Sübzerö,quelthalas,191,deathknight,frost,6,2,4
1769,Rogoroth,stormrage,191,deathknight,frost,6,2,4
1770,Ulyssess,jubeithos,191,deathknight,frost,6,2,4
1771,Deathmike,bonechewer,191,deathknight,frost,6,2,4
1772,Akmy,illidan,175,deathknight,frost,11,2,9
1773,Nickolas,dalvengyr,159,deathknight,frost,5,2,3
1774,Oilasslover,illidan,128,deathknight,frost,4,2,2
1775,Xaldeth,moon-guard,127,deathknight,frost,8,2,6
1776,Telrenaur,proudmoore,96,deathknight,frost,3,2,1
1777,Teksurugi,korgath,96,deathknight,frost,6,1,5
1778,Skadattle,emerald-dream,96,deathknight,frost,6,1,5
1779,Dotted,tichondrius,96,deathknight,frost,6,1,5
1780,Kakaih,azralon,96,deathknight,frost,6,1,5
1781,Gooré,ragnaros,96,deathknight,frost,6,1,5
1782,Davyjonescx,moon-guard,96,deathknight,frost,6,1,5
1783,Bubblesdk,whisperwind,96,deathknight,frost,6,1,5
1784,Ricedisease,emerald-dream,96,deathknight,frost,6,1,5
1785,Einherjiar,tichondrius,96,deathknight,frost,6,1,5
1786,Grayfoxx,twisting-nether,96,deathknight,frost,6,1,5
1787,Xakri,kelthuzad,96,deathknight,frost,6,1,5
1788,Kireek,stormrage,96,deathknight,frost,6,1,5
1789,Vrolock,quelthalas,96,deathknight,frost,6,1,5
1790,Selasia,malygos,96,deathknight,frost,6,1,5
1791,Krargosh,quelthalas,96,deathknight,frost,6,1,5
1792,Thwap,sargeras,96,deathknight,frost,6,1,5
1793,Grimorra,bleeding-hollow,96,deathknight,frost,6,1,5
1794,Siphilusxo,dalaran,96,deathknight,frost,6,1,5
1795,Koltíra,azralon,96,deathknight,frost,6,1,5
1796,Denkot,stormrage,96,deathknight,frost,6,1,5
1797,Frostpanda,dalaran,96,deathknight,frost,6,1,5
1798,Cellebrok,bleeding-hollow,96,deathknight,frost,6,1,5
1799,Bingoez,frostmourne,96,deathknight,frost,6,1,5
1800,Guffles,tichondrius,96,deathknight,frost,6,1,5
1801,Hadianton,stormrage,96,deathknight,frost,6,1,5
1802,Mordekeiser,wyrmrest-accord,96,deathknight,frost,6,1,5
1803,Mephostophel,sargeras,96,deathknight,frost,6,1,5
1804,Mako,garithos,96,deathknight,frost,6,1,5
1805,Sindragosa,dragonmaw,96,deathknight,frost,6,1,5
1806,Xninjakiller,korgath,95,deathknight,frost,12,1,11
1807,Magipierrot,ragnaros,64,deathknight,frost,4,1,3
1808,Agasuko,ghostlands,48,deathknight,frost,3,1,2
1809,Villåin,hyjal,42,deathknight,frost,9,2,7
1810,Twindleroot,aggramar,31,deathknight,frost,2,1,1
1811,Sharnathos,stormrage,16,deathknight,frost,1,1,0
1812,Jerric,skullcrusher,16,deathknight,frost,7,1,6
1813,Demoncouch,malganis,2137,demonhunter,havoc,90,46,44
1814,Seorae,tichondrius,2126,demonhunter,havoc,84,45,39
1815,Mvqdh,illidan,2114,demonhunter,havoc,65,40,25
1816,Ehtend,sargeras,2106,demonhunter,havoc,78,42,36
1817,Xiaosu,tichondrius,2105,demonhunter,havoc,527,260,267
1818,Insomniaq,sargeras,2102,demonhunter,havoc,115,62,53
1819,Zetara,malganis,2074,demonhunter,havoc,82,49,33
1820,Dhcn,tichondrius,2073,demonhunter,havoc,64,35,29
1821,Taegos,tichondrius,2072,demonhunter,havoc,351,173,178
1822,Ehtend,malganis,2069,demonhunter,havoc,209,103,106
1823,Calpoot,stormscale,2065,demonhunter,havoc,65,38,27
1824,Nasadh,tichondrius,2065,demonhunter,havoc,90,52,38
1825,Fellhamer,malganis,2054,demonhunter,havoc,123,69,54
1826,Sadgirlx,area-52,2054,demonhunter,havoc,90,44,46
1827,Nézuko,eldrethalas,2018,demonhunter,havoc,123,64,59
1828,Ordorll,area-52,1998,demonhunter,havoc,114,59,55
1829,Lademon,tichondrius,1997,demonhunter,havoc,84,46,38
1830,Badhábits,sargeras,1979,demonhunter,havoc,66,37,29
1831,Reps,hydraxis,1979,demonhunter,havoc,114,63,51
1832,Bløødyrøse,illidan,1978,demonhunter,havoc,66,40,26
1833,Terrorsong,tichondrius,1970,demonhunter,havoc,71,45,26
1834,Medrathis,wyrmrest-accord,1970,demonhunter,havoc,48,30,18
1835,Felz,illidan,1964,demonhunter,havoc,95,48,47
1836,Lifting,illidan,1960,demonhunter,havoc,84,40,44
1837,Tømåtøgøðx,sargeras,1953,demonhunter,havoc,180,95,85
1838,Glaivezx,stormreaver,1948,demonhunter,havoc,66,33,33
1839,Lighost,tichondrius,1944,demonhunter,havoc,288,140,148
1840,Xtickles,frostmourne,1937,demonhunter,havoc,148,74,74
1841,Mvpdh,area-52,1936,demonhunter,havoc,200,104,96
1842,Boonchu,frostmourne,1935,demonhunter,havoc,86,45,41
1843,Sypï,malganis,1931,demonhunter,havoc,66,37,29
1844,Jøsem,ragnaros,1930,demonhunter,havoc,94,48,46
1845,Kohî,sargeras,1924,demonhunter,havoc,53,27,26
1846,ßöb,aggramar,1920,demonhunter,havoc,66,34,32
1847,Càrnagex,tichondrius,1916,demonhunter,havoc,255,129,126
1848,Ystkz,tichondrius,1908,demonhunter,havoc,117,64,53
1849,Blasphemus,illidan,1908,demonhunter,havoc,63,34,29
1850,Cromega,malganis,1906,demonhunter,havoc,108,50,58
1851,Oddblindguy,area-52,1903,demonhunter,havoc,42,30,12
1852,Lemilion,wyrmrest-accord,1903,demonhunter,havoc,53,27,26
1853,Winsforgold,area-52,1902,demonhunter,havoc,66,36,30
1854,Solit,illidan,1901,demonhunter,havoc,66,33,33
1855,Cyrøcryphä,quelthalas,1901,demonhunter,havoc,144,68,76
1856,Ouru,area-52,1896,demonhunter,havoc,96,48,48
1857,Ìke,quelthalas,1894,demonhunter,havoc,109,55,54
1858,Tendiës,tichondrius,1891,demonhunter,havoc,62,32,30
1859,Askvivian,sargeras,1890,demonhunter,havoc,91,58,33
1860,Boos,moon-guard,1889,demonhunter,havoc,160,78,82
1861,Frostchaos,ragnaros,1888,demonhunter,havoc,30,20,10
1862,Stellitas,ragnaros,1881,demonhunter,havoc,72,38,34
1863,Xch,aegwynn,1881,demonhunter,havoc,166,87,79
1864,Dayvenie,area-52,1879,demonhunter,havoc,125,70,55
1865,Sleepyjoeb,illidan,1875,demonhunter,havoc,66,35,31
1866,Junma,tichondrius,1874,demonhunter,havoc,84,47,37
1867,Busting,tichondrius,1872,demonhunter,havoc,48,24,24
1868,Mvqqdh,tichondrius,1872,demonhunter,havoc,42,20,22
1869,Leothero,area-52,1863,demonhunter,havoc,54,28,26
1870,Anihilum,zuljin,1858,demonhunter,havoc,90,59,31
1871,Rlycoolclass,zuljin,1858,demonhunter,havoc,65,30,35
1872,Azrethec,wyrmrest-accord,1855,demonhunter,havoc,108,62,46
1873,Potspoon,tichondrius,1855,demonhunter,havoc,138,72,66
1874,Loadingdh,tichondrius,1854,demonhunter,havoc,47,20,27
1875,Nb,silvermoon,1853,demonhunter,havoc,59,32,27
1876,Andthrx,area-52,1853,demonhunter,havoc,198,101,97
1877,Bippy,durotan,1853,demonhunter,havoc,90,44,46
1878,Promitto,tichondrius,1852,demonhunter,havoc,53,29,24
1879,Mizaru,moon-guard,1849,demonhunter,havoc,35,24,11
1880,Rosinanta,malygos,1849,demonhunter,havoc,104,56,48
1881,Joshallen,malganis,1846,demonhunter,havoc,141,73,68
1882,Wowcoldcold,barthilas,1845,demonhunter,havoc,59,30,29
1883,Lamorty,tichondrius,1842,demonhunter,havoc,84,40,44
1884,Airmax,tichondrius,1839,demonhunter,havoc,60,32,28
1885,Doejah,stormrage,1838,demonhunter,havoc,50,28,22
1886,Bigbadmad,stormrage,1838,demonhunter,havoc,155,79,76
1887,Smqkepvrpp,zuljin,1835,demonhunter,havoc,58,39,19
1888,Juiced,thunderhorn,1835,demonhunter,havoc,89,48,41
1889,Asdazanis,nemesis,1835,demonhunter,havoc,80,40,40
1890,Ökìtycoón,proudmoore,1833,demonhunter,havoc,78,45,33
1891,Raiinier,sargeras,1830,demonhunter,havoc,72,45,27
1892,Hasbeen,tichondrius,1830,demonhunter,havoc,39,23,16
1893,Divide,tichondrius,1830,demonhunter,havoc,106,58,48
1894,Maverzz,area-52,1828,demonhunter,havoc,35,20,15
1895,Takagi,kirin-tor,1828,demonhunter,havoc,221,120,101
1896,Devotio,emerald-dream,1825,demonhunter,havoc,96,57,39
1897,Migey,thrall,1825,demonhunter,havoc,112,65,47
1898,Vanarion,area-52,1825,demonhunter,havoc,84,36,48
1899,Beerdash,area-52,1825,demonhunter,havoc,66,28,38
1900,Ninetalesx,sargeras,1823,demonhunter,havoc,81,48,33
1901,Darkrai,area-52,1823,demonhunter,havoc,132,73,59
1902,Nolabb,tichondrius,1822,demonhunter,havoc,128,72,56
1903,Írís,blackrock,1820,demonhunter,havoc,124,75,49
1904,Karonisam,dalaran,1820,demonhunter,havoc,61,32,29
1905,Dannyolo,hyjal,1820,demonhunter,havoc,78,32,46
1906,Daía,ragnaros,1818,demonhunter,havoc,47,24,23
1907,Thânatøs,nemesis,1818,demonhunter,havoc,114,56,58
1908,Cromosh,quelthalas,1818,demonhunter,havoc,78,35,43
1909,Mamazboy,area-52,1817,demonhunter,havoc,34,20,14
1910,Failtimeboat,terenas,1817,demonhunter,havoc,60,34,26
1911,Yaboiswift,stormrage,1817,demonhunter,havoc,36,19,17
1912,Garbage,illidan,1816,demonhunter,havoc,84,44,40
1913,Helenquinn,kelthuzad,1815,demonhunter,havoc,72,46,26
1914,Brotherz,tichondrius,1815,demonhunter,havoc,113,56,57
1915,Brbpetmycat,zuljin,1815,demonhunter,havoc,63,30,33
1916,Skyez,moon-guard,1814,demonhunter,havoc,115,54,61
1917,Kázeshini,frostmourne,1813,demonhunter,havoc,143,71,72
1918,Rufio,nesingwary,1813,demonhunter,havoc,54,25,29
1919,Syrio,frostmourne,1812,demonhunter,havoc,206,114,92
1920,Eldiablaso,malganis,1812,demonhunter,havoc,36,19,17
1921,Zoenin,illidan,1812,demonhunter,havoc,96,46,50
1922,Lucifèr,uther,1812,demonhunter,havoc,59,28,31
1923,Vowz,sargeras,1811,demonhunter,havoc,66,34,32
1924,Tyskeram,bleeding-hollow,1810,demonhunter,havoc,81,47,34
1925,Hatréd,quelthalas,1810,demonhunter,havoc,48,26,22
1926,Bbteaa,frostmourne,1810,demonhunter,havoc,134,72,62
1927,Blode,tichondrius,1810,demonhunter,havoc,153,80,73
1928,Griphunt,tichondrius,1809,demonhunter,havoc,198,102,96
1929,Feldarath,sargeras,1807,demonhunter,havoc,133,76,57
1930,Fenomeno,tichondrius,1807,demonhunter,havoc,58,32,26
1931,Xcf,area-52,1807,demonhunter,havoc,48,22,26
1932,Bitcoingodx,tichondrius,1806,demonhunter,havoc,90,53,37
1933,Raenorion,kelthuzad,1805,demonhunter,havoc,54,33,21
1934,Dangerspud,frostmourne,1805,demonhunter,havoc,66,28,38
1935,Dwilk,sargeras,1804,demonhunter,havoc,136,62,74
1936,Purplekuush,bleeding-hollow,1803,demonhunter,havoc,54,31,23
1937,Fruitbatx,tichondrius,1803,demonhunter,havoc,114,56,58
1938,Dhkyun,tichondrius,1801,demonhunter,havoc,54,29,25
1939,Wompo,wyrmrest-accord,1801,demonhunter,havoc,36,19,17
1940,Dewk,ghostlands,1801,demonhunter,havoc,57,29,28
1941,Icecokelime,black-dragonflight,1800,demonhunter,havoc,38,20,18
1942,Deathbladezx,tichondrius,1800,demonhunter,havoc,47,23,24
1943,Donaldjr,area-52,1798,demonhunter,havoc,69,42,27
1944,Flykzuwu,azralon,1793,demonhunter,havoc,83,48,35
1945,Dyllen,tichondrius,1793,demonhunter,havoc,152,86,66
1946,Zatharas,stormrage,1792,demonhunter,havoc,116,59,57
1947,Nuktukdh,moon-guard,1791,demonhunter,havoc,68,30,38
1948,Dewkee,ghostlands,1789,demonhunter,havoc,36,23,13
1949,Ubetterun,azralon,1781,demonhunter,havoc,141,75,66
1950,Ferano,frostmourne,1781,demonhunter,havoc,187,96,91
1951,Thundiir,area-52,1780,demonhunter,havoc,96,50,46
1952,Aryapudding,tichondrius,1779,demonhunter,havoc,58,28,30
1953,Demonsob,illidan,1772,demonhunter,havoc,59,22,37
1954,Mevadow,bleeding-hollow,1768,demonhunter,havoc,126,57,69
1955,Crittic,thrall,1764,demonhunter,havoc,54,25,29
1956,Mèw,bleeding-hollow,1762,demonhunter,havoc,42,25,17
1957,Drachyn,darkspear,1762,demonhunter,havoc,65,29,36
1958,Sikarnix,stormrage,1761,demonhunter,havoc,66,31,35
1959,Xanthalos,wyrmrest-accord,1759,demonhunter,havoc,144,73,71
1960,Ahsref,stormrage,1757,demonhunter,havoc,60,30,30
1961,Saaldh,zuljin,1753,demonhunter,havoc,65,27,38
1962,Gubydal,frostmourne,1750,demonhunter,havoc,53,29,24
1963,Felswamp,zuljin,1748,demonhunter,havoc,90,45,45
1964,Immortalsinz,dalaran,1747,demonhunter,havoc,112,48,64
1965,Bllackclover,zuljin,1746,demonhunter,havoc,47,25,22
1966,Noobstaa,area-52,1745,demonhunter,havoc,48,34,14
1967,Ðavid,firetree,1745,demonhunter,havoc,96,48,48
1968,Plumkin,kiljaeden,1743,demonhunter,havoc,48,27,21
1969,Lazydeamon,frostmourne,1740,demonhunter,havoc,60,26,34
1970,Obsidians,korgath,1737,demonhunter,havoc,83,49,34
1971,Monfel,dalaran,1737,demonhunter,havoc,108,63,45
1972,Furious,tichondrius,1737,demonhunter,havoc,48,23,25
1973,Nadlli,bleeding-hollow,1736,demonhunter,havoc,152,77,75
1974,Tichóndrius,tichondrius,1735,demonhunter,havoc,173,95,78
1975,Hoochee,lightnings-blade,1735,demonhunter,havoc,73,39,34
1976,Baka,grizzly-hills,1735,demonhunter,havoc,48,22,26
1977,Firstsol,stormrage,1734,demonhunter,havoc,54,33,21
1978,Theprodigy,malganis,1734,demonhunter,havoc,72,36,36
1979,Harríson,tichondrius,1734,demonhunter,havoc,96,47,49
1980,Wherwelandin,zuljin,1734,demonhunter,havoc,51,24,27
1981,Axalark,nemesis,1733,demonhunter,havoc,54,26,28
1982,Lilise,kiljaeden,1731,demonhunter,havoc,72,35,37
1983,Stellartv,tichondrius,1730,demonhunter,havoc,103,49,54
1984,Hogmandh,illidan,1729,demonhunter,havoc,48,23,25
1985,Sacredtree,tichondrius,1724,demonhunter,havoc,80,43,37
1986,Beyondjerky,malganis,1721,demonhunter,havoc,34,20,14
1987,Croches,tichondrius,1721,demonhunter,havoc,36,18,18
1988,Cococat,tichondrius,1721,demonhunter,havoc,50,20,30
1989,Larandaa,sargeras,1720,demonhunter,havoc,60,33,27
1990,Madepp,tichondrius,1720,demonhunter,havoc,48,23,25
1991,Fardyhole,illidan,1719,demonhunter,havoc,36,18,18
1992,Tendies,tichondrius,1716,demonhunter,havoc,48,24,24
1993,Nåxah,bleeding-hollow,1716,demonhunter,havoc,54,26,28
1994,Ibdl,tichondrius,1714,demonhunter,havoc,30,18,12
1995,Irisand,ragnaros,1714,demonhunter,havoc,83,40,43
1996,Doeja,illidan,1713,demonhunter,havoc,30,18,12
1997,Thehonor,tichondrius,1713,demonhunter,havoc,65,36,29
1998,Ruffolina,azralon,1713,demonhunter,havoc,163,89,74
1999,Aetheris,bleeding-hollow,1709,demonhunter,havoc,78,34,44
2000,Demabrak,azralon,1707,demonhunter,havoc,47,23,24
2001,Dãnishroll,illidan,1707,demonhunter,havoc,60,26,34
2002,Soyboycuck,emerald-dream,1705,demonhunter,havoc,36,18,18
2003,Rôsè,tichondrius,1704,demonhunter,havoc,88,49,39
2004,Xeylin,sargeras,1703,demonhunter,havoc,54,34,20
2005,Gamernation,area-52,1703,demonhunter,havoc,57,29,28
2006,Wildh,stormrage,1702,demonhunter,havoc,66,35,31
2007,Xøtourlife,malganis,1701,demonhunter,havoc,52,25,27
2008,Nopohunter,burning-blade,1699,demonhunter,havoc,47,31,16
2009,Junmà,tichondrius,1699,demonhunter,havoc,60,38,22
2010,Vendeem,moonrunner,1697,demonhunter,havoc,104,56,48
2011,Raahjxz,sargeras,1696,demonhunter,havoc,54,33,21
2012,Johnconnor,tichondrius,1696,demonhunter,havoc,53,20,33
2013,Chiesa,sargeras,1695,demonhunter,havoc,34,27,7
2014,Remh,bleeding-hollow,1694,demonhunter,havoc,254,129,125
2015,Kenmu,ragnaros,1693,demonhunter,havoc,50,24,26
2016,Ravana,khaz-modan,1692,demonhunter,havoc,82,46,36
2017,Munyanyô,moon-guard,1691,demonhunter,havoc,41,26,15
2018,Tubaki,tichondrius,1691,demonhunter,havoc,35,19,16
2019,Speedh,area-52,1691,demonhunter,havoc,36,18,18
2020,Deaforalive,malganis,1690,demonhunter,havoc,96,54,42
2021,Cöcainë,stormrage,1689,demonhunter,havoc,36,24,12
2022,Nephxz,tichondrius,1689,demonhunter,havoc,42,21,21
2023,Flyudzhin,azgalor,1689,demonhunter,havoc,116,56,60
2024,Kìed,kiljaeden,1687,demonhunter,havoc,48,24,24
2025,Wickbeams,barthilas,1684,demonhunter,havoc,59,28,31
2026,Dawgzo,thunderhorn,1682,demonhunter,havoc,60,34,26
2027,Nips,lightnings-blade,1675,demonhunter,havoc,54,33,21
2028,Buddyyguy,illidan,1675,demonhunter,havoc,102,45,57
2029,Dragonÿx,ragnaros,1674,demonhunter,havoc,97,53,44
2030,Folkmagic,proudmoore,1673,demonhunter,havoc,30,18,12
2031,Dingowango,illidan,1672,demonhunter,havoc,48,24,24
2032,Biognosis,ragnaros,1672,demonhunter,havoc,84,38,46
2033,Balancedtoon,tichondrius,1670,demonhunter,havoc,54,30,24
2034,Coa,nazjatar,1670,demonhunter,havoc,70,34,36
2035,Glaivediggar,barthilas,1670,demonhunter,havoc,106,49,57
2036,Bloodhunter,exodar,1668,demonhunter,havoc,92,53,39
2037,Imaginedmg,illidan,1668,demonhunter,havoc,60,28,32
2038,Jaauk,ragnaros,1668,demonhunter,havoc,52,23,29
2039,Jcosta,tichondrius,1667,demonhunter,havoc,61,27,34
2040,Hisso,nordrassil,1666,demonhunter,havoc,48,28,20
2041,Oshinoko,area-52,1664,demonhunter,havoc,57,30,27
2042,Dhwhat,stormrage,1661,demonhunter,havoc,89,49,40
2043,Boagz,area-52,1660,demonhunter,havoc,84,48,36
2044,Hundredeye,malganis,1660,demonhunter,havoc,34,18,16
2045,Kioka,khaz-modan,1659,demonhunter,havoc,34,20,14
2046,Fellenkellar,stormrage,1659,demonhunter,havoc,72,38,34
2047,Çhan,tichondrius,1658,demonhunter,havoc,213,108,105
2048,Ilìdarì,zuljin,1657,demonhunter,havoc,33,20,13
2049,Scylus,tichondrius,1657,demonhunter,havoc,66,39,27
2050,Antamoris,sargeras,1656,demonhunter,havoc,52,25,27
2051,Ethhunter,proudmoore,1656,demonhunter,havoc,66,31,35
2052,Poogzzig,tichondrius,1655,demonhunter,havoc,84,43,41
2053,Getpoodon,sargeras,1655,demonhunter,havoc,36,18,18
2054,Sáìto,arthas,1654,demonhunter,havoc,30,19,11
2055,Azexion,malganis,1653,demonhunter,havoc,70,34,36
2056,Baikudyn,darkspear,1651,demonhunter,havoc,30,19,11
2057,Ðaredevil,azralon,1650,demonhunter,havoc,36,22,14
2058,Chîsäki,quelthalas,1649,demonhunter,havoc,75,40,35
2059,Pragma,thrall,1648,demonhunter,havoc,157,89,68
2060,Gesture,malganis,1648,demonhunter,havoc,160,89,71
2061,Vapegodxqt,aegwynn,1647,demonhunter,havoc,50,25,25
2062,Asheng,cairne,1646,demonhunter,havoc,45,22,23
2063,Ironsightsdh,dalaran,1645,demonhunter,havoc,89,47,42
2064,Sarynrae,malganis,1644,demonhunter,havoc,52,24,28
2065,Valerrias,area-52,1643,demonhunter,havoc,42,21,21
2066,Warlasher,zuljin,1640,demonhunter,havoc,150,79,71
2067,Vândel,kelthuzad,1639,demonhunter,havoc,47,22,25
2068,Gôôseberry,malganis,1639,demonhunter,havoc,81,37,44
2069,Dealer,frostmourne,1638,demonhunter,havoc,66,31,35
2070,Randomdh,zuljin,1636,demonhunter,havoc,43,23,20
2071,Khaõs,tichondrius,1636,demonhunter,havoc,78,34,44
2072,Pythongodx,azralon,1635,demonhunter,havoc,42,23,19
2073,Mewmewkitty,tichondrius,1635,demonhunter,havoc,34,18,16
2074,Synthwäve,area-52,1634,demonhunter,havoc,36,23,13
2075,Joric,dalaran,1634,demonhunter,havoc,48,30,18
2076,Azinoht,ragnaros,1634,demonhunter,havoc,146,69,77
2077,Killuaqt,frostmourne,1633,demonhunter,havoc,36,20,16
2078,Demoncastx,tichondrius,1632,demonhunter,havoc,89,50,39
2079,Accidcleaves,sargeras,1632,demonhunter,havoc,48,26,22
2080,Seraphïel,khaz-modan,1631,demonhunter,havoc,36,23,13
2081,Nocturnale,ragnaros,1629,demonhunter,havoc,53,28,25
2082,Cezkia,hyjal,1629,demonhunter,havoc,72,36,36
2083,Xenore,emerald-dream,1628,demonhunter,havoc,47,21,26
2084,Chulakels,tichondrius,1627,demonhunter,havoc,30,18,12
2085,Trilidan,proudmoore,1627,demonhunter,havoc,37,21,16
2086,Stefdh,tichondrius,1627,demonhunter,havoc,51,23,28
2087,Thelor,frostmourne,1626,demonhunter,havoc,48,28,20
2088,Xday,tichondrius,1626,demonhunter,havoc,258,132,126
2089,Sicknizzle,area-52,1626,demonhunter,havoc,126,63,63
2090,Rekttx,area-52,1625,demonhunter,havoc,64,34,30
2091,Cuper,tichondrius,1623,demonhunter,havoc,72,41,31
2092,Perspirant,malganis,1623,demonhunter,havoc,41,23,18
2093,Ídunno,kiljaeden,1623,demonhunter,havoc,42,19,23
2094,Sivà,tichondrius,1622,demonhunter,havoc,69,35,34
2095,Zeroheaven,stormrage,1621,demonhunter,havoc,48,19,29
2096,Hehehaha,wyrmrest-accord,1620,demonhunter,havoc,30,20,10
2097,Skyfly,stormscale,1619,demonhunter,havoc,48,21,27
2098,Ohanadh,ragnaros,1618,demonhunter,havoc,48,19,29
2099,Zachfortnite,emerald-dream,1616,demonhunter,havoc,30,19,11
2100,Taszyn,blackrock,1613,demonhunter,havoc,92,51,41
2101,Karmakula,tichondrius,1613,demonhunter,havoc,77,39,38
2102,Anathørn,ragnaros,1612,demonhunter,havoc,42,23,19
2103,Surå,tichondrius,1612,demonhunter,havoc,76,37,39
2104,Jpdh,frostmourne,1611,demonhunter,havoc,74,39,35
2105,Scriptyscrip,dark-iron,1611,demonhunter,havoc,138,63,75
2106,Bitskii,kelthuzad,1610,demonhunter,havoc,47,21,26
2107,Jk,dreadmaul,1609,demonhunter,havoc,70,40,30
2108,Nistrin,area-52,1609,demonhunter,havoc,72,40,32
2109,Crixxus,zuljin,1609,demonhunter,havoc,48,20,28
2110,Niuzimeile,illidan,1609,demonhunter,havoc,48,17,31
2111,Yiptaw,area-52,1608,demonhunter,havoc,55,29,26
2112,Feníxx,ragnaros,1608,demonhunter,havoc,88,45,43
2113,Beastbringer,proudmoore,1607,demonhunter,havoc,147,86,61
2114,Landorus,barthilas,1607,demonhunter,havoc,100,49,51
2115,Abigëil,quelthalas,1605,demonhunter,havoc,56,31,25
2116,Mavrush,malganis,1604,demonhunter,havoc,54,31,23
2117,Vynthar,wyrmrest-accord,1604,demonhunter,havoc,148,72,76
2118,Dèmonhuntèr,tichondrius,1603,demonhunter,havoc,90,48,42
2119,Tychondrius,earthen-ring,1603,demonhunter,havoc,202,107,95
2120,Kaedri,burning-blade,1603,demonhunter,havoc,141,68,73
2121,Sìlençe,illidan,1602,demonhunter,havoc,29,19,10
2122,Shale,gilneas,1602,demonhunter,havoc,70,35,35
2123,Phaintx,tichondrius,1602,demonhunter,havoc,42,21,21
2124,Ariodh,area-52,1602,demonhunter,havoc,36,17,19
2125,Felnipz,tichondrius,1601,demonhunter,havoc,31,18,13
2126,Deathlex,sargeras,1600,demonhunter,havoc,72,35,37
2127,Gjoat,tichondrius,1600,demonhunter,havoc,42,19,23
2128,Tenthslayer,frostmourne,1598,demonhunter,havoc,30,17,13
2129,Pubelice,draenor,1596,demonhunter,havoc,62,36,26
2130,Ptsdh,bloodhoof,1595,demonhunter,havoc,66,36,30
2131,Netherbane,azgalor,1592,demonhunter,havoc,96,44,52
2132,Dhyzz,proudmoore,1590,demonhunter,havoc,43,25,18
2133,Eugenyackle,bleeding-hollow,1589,demonhunter,havoc,48,35,13
2134,Reito,ragnaros,1589,demonhunter,havoc,53,29,24
2135,Nándÿ,tichondrius,1589,demonhunter,havoc,61,33,28
2136,Darkrasta,ragnaros,1589,demonhunter,havoc,90,41,49
2137,Shyisback,area-52,1588,demonhunter,havoc,96,54,42
2138,Wsickformula,gilneas,1588,demonhunter,havoc,119,66,53
2139,Churchpls,stormrage,1588,demonhunter,havoc,52,19,33
2140,Progenji,azralon,1585,demonhunter,havoc,36,21,15
2141,Alast,emerald-dream,1584,demonhunter,havoc,48,23,25
2142,Sucio,khaz-modan,1581,demonhunter,havoc,36,18,18
2143,Supadupä,stormrage,1580,demonhunter,havoc,30,17,13
2144,Kaelclaira,dalvengyr,1580,demonhunter,havoc,60,29,31
2145,Jaybeezy,balnazzar,1580,demonhunter,havoc,42,18,24
2146,Chungîe,frostmourne,1579,demonhunter,havoc,30,20,10
2147,Ossivil,ragnaros,1579,demonhunter,havoc,90,41,49
2148,Yuppx,tichondrius,1578,demonhunter,havoc,48,29,19
2149,Mcspicyy,tichondrius,1578,demonhunter,havoc,42,22,20
2150,Corngodx,sargeras,1578,demonhunter,havoc,96,47,49
2151,Hoonjojjyana,tichondrius,1578,demonhunter,havoc,46,20,26
2152,Dammitbôbby,tichondrius,1577,demonhunter,havoc,121,66,55
2153,Needlepoint,illidan,1576,demonhunter,havoc,59,32,27
2154,Baalböski,tichondrius,1574,demonhunter,havoc,88,41,47
2155,Billmcawsom,proudmoore,1573,demonhunter,havoc,42,19,23
2156,Demonfarter,tichondrius,1570,demonhunter,havoc,120,61,59
2157,Enfirok,duskwood,1566,demonhunter,havoc,234,122,112
2158,Kssmee,korgath,1565,demonhunter,havoc,42,23,19
2159,Sheepone,tichondrius,1564,demonhunter,havoc,24,19,5
2160,Daymanhunter,bleeding-hollow,1563,demonhunter,havoc,83,41,42
2161,Gymnast,thaurissan,1561,demonhunter,havoc,48,19,29
2162,Nomfries,malganis,1560,demonhunter,havoc,52,27,25
2163,Wikkidd,thrall,1560,demonhunter,havoc,47,22,25
2164,Doomtower,tichondrius,1557,demonhunter,havoc,45,22,23
2165,Ylydary,ragnaros,1554,demonhunter,havoc,66,39,27
2166,Gorillidan,kelthuzad,1553,demonhunter,havoc,30,18,12
2167,Kaelthys,nordrassil,1552,demonhunter,havoc,33,21,12
2168,Yqpro,tichondrius,1549,demonhunter,havoc,119,62,57
2169,Blurblurblur,frostmourne,1549,demonhunter,havoc,42,17,25
2170,Kuramou,area-52,1547,demonhunter,havoc,36,22,14
2171,Bogdan,azjolnerub,1545,demonhunter,havoc,60,33,27
2172,Xionas,moon-guard,1543,demonhunter,havoc,81,42,39
2173,Blackmvp,tichondrius,1537,demonhunter,havoc,24,17,7
2174,Cäldo,tichondrius,1537,demonhunter,havoc,36,21,15
2175,Imwhack,frostmane,1535,demonhunter,havoc,49,27,22
2176,Scoplyn,malfurion,1535,demonhunter,havoc,60,30,30
2177,Doxdevil,tichondrius,1533,demonhunter,havoc,57,19,38
2178,Thêdràïñgáñg,jubeithos,1530,demonhunter,havoc,30,16,14
2179,Mileze,area-52,1530,demonhunter,havoc,60,21,39
2180,Papaelf,thunderlord,1528,demonhunter,havoc,48,33,15
2181,Knuckifubuck,frostwolf,1527,demonhunter,havoc,106,57,49
2182,Knshy,azralon,1527,demonhunter,havoc,44,21,23
2183,Crayoz,tichondrius,1525,demonhunter,havoc,131,73,58
2184,Emopidgeon,dalaran,1525,demonhunter,havoc,30,16,14
2185,Broneill,blood-furnace,1525,demonhunter,havoc,42,21,21
2186,Mattdizzle,illidan,1524,demonhunter,havoc,24,17,7
2187,Brútalgore,area-52,1521,demonhunter,havoc,141,73,68
2188,Sineex,illidan,1520,demonhunter,havoc,30,18,12
2189,Hròðvitnir,quelthalas,1519,demonhunter,havoc,50,30,20
2190,Creãtuss,area-52,1519,demonhunter,havoc,54,29,25
2191,Mazakein,tichondrius,1517,demonhunter,havoc,42,21,21
2192,Allyrian,sargeras,1513,demonhunter,havoc,59,39,20
2193,Dadoftheyear,destromath,1513,demonhunter,havoc,36,20,16
2194,Deadpixellz,illidan,1511,demonhunter,havoc,76,39,37
2195,Yåkuza,daggerspine,1509,demonhunter,havoc,140,70,70
2196,Gittgudd,area-52,1507,demonhunter,havoc,69,36,33
2197,Icrazedcruxl,gnomeregan,1504,demonhunter,havoc,36,16,20
2198,Dirtbag,tichondrius,1503,demonhunter,havoc,30,16,14
2199,Ilydos,emerald-dream,1503,demonhunter,havoc,102,52,50
2200,Darknezzl,ragnaros,1500,demonhunter,havoc,84,39,45
2201,Demodorn,frostmane,1499,demonhunter,havoc,30,19,11
2202,Macacøbrr,azralon,1498,demonhunter,havoc,76,37,39
2203,Littlewolfie,illidan,1496,demonhunter,havoc,30,16,14
2204,Alli,bleeding-hollow,1494,demonhunter,havoc,69,39,30
2205,Ralløszek,illidan,1494,demonhunter,havoc,48,26,22
2206,Ralløs81A363,illidan,1494,demonhunter,havoc,48,26,22
2207,Karmadh,malganis,1494,demonhunter,havoc,30,16,14
2208,Træt,emerald-dream,1494,demonhunter,havoc,83,42,41
2209,Nuredmyy,illidan,1488,demonhunter,havoc,30,17,13
2210,Hellmetal,quelthalas,1488,demonhunter,havoc,36,17,19
2211,Dashxo,tichondrius,1487,demonhunter,havoc,36,17,19
2212,Apõz,tichondrius,1486,demonhunter,havoc,30,16,14
2213,Orgasmia,tichondrius,1486,demonhunter,havoc,106,32,74
2214,Emeress,illidan,1485,demonhunter,havoc,47,20,27
2215,Demontrue,tichondrius,1483,demonhunter,havoc,62,32,30
2216,Kimjonguun,tichondrius,1481,demonhunter,havoc,32,22,10
2217,Häruun,quelthalas,1480,demonhunter,havoc,41,23,18
2218,Wormli,moon-guard,1477,demonhunter,havoc,40,24,16
2219,Nooksuh,bleeding-hollow,1473,demonhunter,havoc,29,16,13
2220,Kegu,stormrage,1469,demonhunter,havoc,54,20,34
2221,Gomesdhunter,azralon,1466,demonhunter,havoc,88,47,41
2222,Henry,tichondrius,1465,demonhunter,havoc,69,41,28
2223,Bjj,bonechewer,1465,demonhunter,havoc,100,58,42
2224,Zackfair,burning-legion,1465,demonhunter,havoc,117,59,58
2225,Papazaraki,tichondrius,1465,demonhunter,havoc,36,18,18
2226,Eery,tichondrius,1461,demonhunter,havoc,71,35,36
2227,Mamif,korgath,1460,demonhunter,havoc,68,31,37
2228,Gaìjîn,barthilas,1459,demonhunter,havoc,132,70,62
2229,Hellnkeller,tichondrius,1459,demonhunter,havoc,36,16,20
2230,Somethingstu,sargeras,1458,demonhunter,havoc,28,18,10
2231,Furiel,quelthalas,1458,demonhunter,havoc,38,22,16
2232,Croisoi,ragnaros,1458,demonhunter,havoc,66,31,35
2233,Bofxo,sargeras,1458,demonhunter,havoc,47,22,25
2234,Gohamx,illidan,1457,demonhunter,havoc,110,54,56
2235,Felseal,frostmourne,1456,demonhunter,havoc,53,34,19
2236,Demonhunter,kirin-tor,1456,demonhunter,havoc,66,28,38
2237,Coohiyan,tichondrius,1455,demonhunter,havoc,30,18,12
2238,Nekrosdaeva,zuljin,1455,demonhunter,havoc,73,40,33
2239,Telmordrin,azralon,1454,demonhunter,havoc,38,21,17
2240,Aiapaec,wyrmrest-accord,1454,demonhunter,havoc,101,50,51
2241,Sciatic,area-52,1454,demonhunter,havoc,68,33,35
2242,Eyecandyxo,grizzly-hills,1452,demonhunter,havoc,37,20,17
2243,Sloôtybag,tichondrius,1452,demonhunter,havoc,36,19,17
2244,Órph,sargeras,1452,demonhunter,havoc,42,22,20
2245,Wangasaurus,emerald-dream,1452,demonhunter,havoc,54,26,28
2246,Xillidan,area-52,1450,demonhunter,havoc,112,70,42
2247,Sëlene,antonidas,1449,demonhunter,havoc,77,37,40
2248,Bucx,barthilas,1445,demonhunter,havoc,60,36,24
2249,Nicodine,tichondrius,1445,demonhunter,havoc,63,34,29
2250,Jaysavage,eitrigg,1443,demonhunter,havoc,63,31,32
2251,Vlääd,ragnaros,1442,demonhunter,havoc,114,54,60
2252,Faphunter,illidan,1441,demonhunter,havoc,87,50,37
2253,Mavèrick,thrall,1441,demonhunter,havoc,45,21,24
2254,Mamadorx,azralon,1438,demonhunter,havoc,24,15,9
2255,Huntoneshot,bleeding-hollow,1438,demonhunter,havoc,43,23,20
2256,Velravyn,moon-guard,1438,demonhunter,havoc,35,17,18
2257,Molchamp,kelthuzad,1438,demonhunter,havoc,60,27,33
2258,Feelmybush,barthilas,1438,demonhunter,havoc,72,29,43
2259,Haades,proudmoore,1437,demonhunter,havoc,48,25,23
2260,Grizzop,sargeras,1437,demonhunter,havoc,96,48,48
2261,Lravanal,quelthalas,1435,demonhunter,havoc,24,17,7
2262,Fametrap,tichondrius,1435,demonhunter,havoc,24,15,9
2263,Backtolumby,bleeding-hollow,1435,demonhunter,havoc,53,30,23
2264,ßlurr,moon-guard,1435,demonhunter,havoc,114,63,51
2265,Sheldoncoop,emerald-dream,1435,demonhunter,havoc,30,15,15
2266,Brackmagik,barthilas,1434,demonhunter,havoc,18,15,3
2267,Illusiondh,tichondrius,1433,demonhunter,havoc,75,47,28
2268,Raith,khazgoroth,1432,demonhunter,havoc,49,27,22
2269,Nepzz,stormrage,1430,demonhunter,havoc,66,37,29
2270,Remuko,tichondrius,1430,demonhunter,havoc,30,15,15
2271,Dridri,quelthalas,1430,demonhunter,havoc,44,21,23
2272,Unjusthunt,magtheridon,1429,demonhunter,havoc,30,15,15
2273,Mybus,tichondrius,1429,demonhunter,havoc,72,32,40
2274,Exequion,ragnaros,1428,demonhunter,havoc,93,53,40
2275,Noxon,stormrage,1428,demonhunter,havoc,92,48,44
2276,Iim,tichondrius,1428,demonhunter,havoc,87,35,52
2277,Absinith,jubeithos,1427,demonhunter,havoc,28,20,8
2278,Demonicfish,malganis,1427,demonhunter,havoc,54,32,22
2279,Superlative,area-52,1423,demonhunter,havoc,24,15,9
2280,Anatema,illidan,1423,demonhunter,havoc,59,30,29
2281,Flirtyscythe,illidan,1422,demonhunter,havoc,30,15,15
2282,Moylecrumbs,stormrage,1420,demonhunter,havoc,72,35,37
2283,Mirriana,thunderlord,1420,demonhunter,havoc,36,15,21
2284,Creamboi,stormrage,1419,demonhunter,havoc,34,19,15
2285,Redkin,moon-guard,1419,demonhunter,havoc,42,21,21
2286,Nuggetx,lightnings-blade,1418,demonhunter,havoc,24,15,9
2287,Viismoke,thaurissan,1418,demonhunter,havoc,42,25,17
2288,Talyethsam,shadowsong,1418,demonhunter,havoc,32,16,16
2289,Valka,emerald-dream,1416,demonhunter,havoc,100,53,47
2290,Ikilldemonz,thrall,1415,demonhunter,havoc,42,19,23
2291,Bremdh,thrall,1413,demonhunter,havoc,30,15,15
2292,Varthalos,thrall,1412,demonhunter,havoc,96,54,42
2293,Oxyoxy,illidan,1410,demonhunter,havoc,37,23,14
2294,Genruis,area-52,1410,demonhunter,havoc,61,30,31
2295,Cybertrax,tichondrius,1408,demonhunter,havoc,24,15,9
2296,Narchis,malganis,1403,demonhunter,havoc,30,17,13
2297,Derperhunter,kiljaeden,1403,demonhunter,havoc,54,26,28
2298,Loreney,quelthalas,1402,demonhunter,havoc,120,55,65
2299,Yodiegang,nazgrel,1400,demonhunter,havoc,24,15,9
2300,Ehrapist,kelthuzad,1399,demonhunter,havoc,30,16,14
2301,Majnun,moon-guard,1399,demonhunter,havoc,30,16,14
2302,Radamanthysi,azralon,1398,demonhunter,havoc,72,43,29
2303,Skace,jubeithos,1397,demonhunter,havoc,102,56,46
2304,Tøwers,aegwynn,1397,demonhunter,havoc,36,18,18
2305,Torments,area-52,1397,demonhunter,havoc,30,15,15
2306,Alganoth,malfurion,1394,demonhunter,havoc,67,36,31
2307,Softkyll,area-52,1394,demonhunter,havoc,369,191,178
2308,Methany,saurfang,1393,demonhunter,havoc,81,37,44
2309,Kellytgt,perenolde,1392,demonhunter,havoc,36,21,15
2310,Falachio,tichondrius,1391,demonhunter,havoc,75,37,38
2311,Tylersdh,illidan,1390,demonhunter,havoc,22,15,7
2312,Swarlee,kiljaeden,1389,demonhunter,havoc,83,46,37
2313,Siksix,bleeding-hollow,1389,demonhunter,havoc,42,21,21
2314,Tharzadan,quelthalas,1387,demonhunter,havoc,51,26,25
2315,Dejay,thunderhorn,1386,demonhunter,havoc,42,27,15
2316,Kúrama,tichondrius,1385,demonhunter,havoc,78,46,32
2317,Snaped,tichondrius,1384,demonhunter,havoc,42,28,14
2318,Jackk,nordrassil,1384,demonhunter,havoc,41,21,20
2319,Ranir,doomhammer,1384,demonhunter,havoc,54,23,31
2320,Lostsoulzz,tichondrius,1383,demonhunter,havoc,45,28,17
2321,Vegan,magtheridon,1382,demonhunter,havoc,48,29,19
2322,Tyredris,kelthuzad,1379,demonhunter,havoc,36,17,19
2323,Duhan,tichondrius,1377,demonhunter,havoc,190,100,90
2324,Yukisyn,proudmoore,1376,demonhunter,havoc,90,48,42
2325,Violegrace,area-52,1376,demonhunter,havoc,106,51,55
2326,Villumninati,tichondrius,1375,demonhunter,havoc,48,27,21
2327,Omgshesocute,hyjal,1375,demonhunter,havoc,36,18,18
2328,Pupupoo,tichondrius,1373,demonhunter,havoc,48,28,20
2329,Lonelydusk,zangarmarsh,1372,demonhunter,havoc,30,15,15
2330,Kellox,ragnaros,1372,demonhunter,havoc,36,15,21
2331,Petty,moon-guard,1371,demonhunter,havoc,48,28,20
2332,Soupwoup,moon-guard,1368,demonhunter,havoc,51,25,26
2333,Colinn,illidan,1367,demonhunter,havoc,30,18,12
2334,Kazdh,sargeras,1367,demonhunter,havoc,48,25,23
2335,Thêpunisher,ragnaros,1367,demonhunter,havoc,118,60,58
2336,Chaz,blood-furnace,1366,demonhunter,havoc,36,16,20
2337,Jellous,rivendare,1366,demonhunter,havoc,42,17,25
2338,Metabeam,tichondrius,1365,demonhunter,havoc,30,19,11
2339,Loadedtruck,frostmourne,1362,demonhunter,havoc,24,16,8
2340,Kakster,tichondrius,1362,demonhunter,havoc,66,35,31
2341,Ronkasprince,thunderlord,1361,demonhunter,havoc,92,41,51
2342,Layli,azralon,1360,demonhunter,havoc,42,25,17
2343,Nupx,frostmourne,1358,demonhunter,havoc,33,17,16
2344,Felbreak,stormrage,1358,demonhunter,havoc,72,35,37
2345,Celestiel,cenarion-circle,1357,demonhunter,havoc,30,17,13
2346,Artemisleto,tichondrius,1356,demonhunter,havoc,36,18,18
2347,Wíkkihx,emerald-dream,1356,demonhunter,havoc,49,24,25
2348,Hornedelf,frostmourne,1355,demonhunter,havoc,41,22,19
2349,Gwendanzig,zangarmarsh,1355,demonhunter,havoc,60,28,32
2350,Metagoblin,tichondrius,1352,demonhunter,havoc,30,15,15
2351,Kitnix,proudmoore,1349,demonhunter,havoc,31,16,15
2352,Krizo,frostmourne,1348,demonhunter,havoc,37,19,18
2353,Rânkle,darkspear,1345,demonhunter,havoc,46,25,21
2354,Exzyo,area-52,1344,demonhunter,havoc,18,14,4
2355,Rem,stormrage,1344,demonhunter,havoc,69,37,32
2356,Onewhoknox,mannoroth,1344,demonhunter,havoc,126,64,62
2357,Ergzydh,frostmourne,1344,demonhunter,havoc,72,30,42
2358,Taylordem,tichondrius,1342,demonhunter,havoc,24,14,10
2359,Riskerdog,tichondrius,1342,demonhunter,havoc,30,14,16
2360,Theflurry,tichondrius,1342,demonhunter,havoc,36,14,22
2361,Catastrophis,tichondrius,1341,demonhunter,havoc,36,18,18
2362,Deviljane,illidan,1340,demonhunter,havoc,24,14,10
2363,Egirlhunter,echo-isles,1339,demonhunter,havoc,24,14,10
2364,Demondubya,illidan,1339,demonhunter,havoc,28,15,13
2365,Malviciouss,tichondrius,1339,demonhunter,havoc,42,19,23
2366,Røllnautløw,aegwynn,1338,demonhunter,havoc,26,16,10
2367,Sillyslayadk,moon-guard,1336,demonhunter,havoc,118,67,51
2368,Devirador,ragnaros,1335,demonhunter,havoc,33,15,18
2369,Danloesh,silver-hand,1334,demonhunter,havoc,24,14,10
2370,Telrindyl,moon-guard,1330,demonhunter,havoc,99,57,42
2371,Xein,khazgoroth,1327,demonhunter,havoc,66,30,36
2372,Kalmor,barthilas,1327,demonhunter,havoc,45,20,25
2373,Elevateztko,stormrage,1326,demonhunter,havoc,36,16,20
2374,Kêrbydh,frostmourne,1325,demonhunter,havoc,36,22,14
2375,Rizzaarrdd,tichondrius,1325,demonhunter,havoc,122,63,59
2376,Refractx,illidan,1322,demonhunter,havoc,42,22,20
2377,Zévron,area-52,1322,demonhunter,havoc,54,26,28
2378,Tickelfist,zuljin,1320,demonhunter,havoc,48,22,26
2379,Xiaochicken,tichondrius,1320,demonhunter,havoc,38,17,21
2380,Báléríón,area-52,1319,demonhunter,havoc,35,21,14
2381,Inkubuz,sargeras,1319,demonhunter,havoc,139,70,69
2382,Gigavlad,area-52,1317,demonhunter,havoc,30,14,16
2383,Valdiran,duskwood,1317,demonhunter,havoc,30,14,16
2384,Chromatïc,jubeithos,1317,demonhunter,havoc,72,30,42
2385,Kaelidan,kelthuzad,1316,demonhunter,havoc,111,58,53
2386,Ovèrrated,area-52,1316,demonhunter,havoc,86,40,46
2387,Demonkratoz,ragnaros,1316,demonhunter,havoc,43,19,24
2388,Litzilla,thrall,1315,demonhunter,havoc,42,20,22
2389,Nolights,area-52,1315,demonhunter,havoc,90,37,53
2390,Mördredd,quelthalas,1315,demonhunter,havoc,37,15,22
2391,Sicklyslick,frostmourne,1313,demonhunter,havoc,25,15,10
2392,Rytesx,moon-guard,1310,demonhunter,havoc,28,21,7
2393,Nurzal,malganis,1310,demonhunter,havoc,30,14,16
2394,Stochastic,ragnaros,1310,demonhunter,havoc,37,15,22
2395,Jibaiye,tichondrius,1309,demonhunter,havoc,30,14,16
2396,Yønkou,stormrage,1308,demonhunter,havoc,114,57,57
2397,Aeonys,stormrage,1304,demonhunter,havoc,36,21,15
2398,Tekkamanevil,tichondrius,1304,demonhunter,havoc,210,104,106
2399,Powertaco,tichondrius,1304,demonhunter,havoc,67,31,36
2400,Silvs,illidan,1299,demonhunter,havoc,184,102,82
2401,Belial,haomarush,1299,demonhunter,havoc,54,28,26
2402,Halftruth,stormrage,1298,demonhunter,havoc,46,22,24
2403,Nrpx,stormrage,1298,demonhunter,havoc,34,14,20
2404,Thechaz,bleeding-hollow,1297,demonhunter,havoc,54,34,20
2405,Revvup,tichondrius,1294,demonhunter,havoc,71,33,38
2406,Alaron,wildhammer,1293,demonhunter,havoc,99,53,46
2407,Naelaksa,tichondrius,1293,demonhunter,havoc,36,14,22
2408,Swoffordsr,tichondrius,1291,demonhunter,havoc,48,23,25
2409,Mursiless,drenden,1290,demonhunter,havoc,24,15,9
2410,Mustardtigër,bleeding-hollow,1290,demonhunter,havoc,23,14,9
2411,Chungg,laughing-skull,1287,demonhunter,havoc,30,15,15
2412,Draenkz,ragnaros,1287,demonhunter,havoc,46,15,31
2413,Cherlas,blood-furnace,1286,demonhunter,havoc,51,24,27
2414,Soulsteall,tichondrius,1285,demonhunter,havoc,30,20,10
2415,Hawkowicz,tichondrius,1284,demonhunter,havoc,181,90,91
2416,Vwap,tichondrius,1284,demonhunter,havoc,29,14,15
2417,Cots,stormrage,1284,demonhunter,havoc,32,15,17
2418,Vaxs,moon-guard,1282,demonhunter,havoc,56,33,23
2419,Roughins,chogall,1278,demonhunter,havoc,51,28,23
2420,Malthazaan,stormrage,1276,demonhunter,havoc,20,14,6
2421,Fiziokratdh,ghostlands,1276,demonhunter,havoc,49,21,28
2422,Turecdh,illidan,1274,demonhunter,havoc,38,14,24
2423,Sylenah,hyjal,1273,demonhunter,havoc,30,14,16
2424,Foxdie,bonechewer,1271,demonhunter,havoc,36,15,21
2425,Greent,stormrage,1270,demonhunter,havoc,30,17,13
2426,Salomesalvi,proudmoore,1268,demonhunter,havoc,24,14,10
2427,Neecro,frostmourne,1268,demonhunter,havoc,60,29,31
2428,Whataboutbob,korgath,1268,demonhunter,havoc,36,14,22
2429,Mortiria,dalaran,1267,demonhunter,havoc,67,30,37
2430,Kereses,bonechewer,1266,demonhunter,havoc,45,25,20
2431,Vizionz,emerald-dream,1266,demonhunter,havoc,41,21,20
2432,Tattedandfab,stormrage,1265,demonhunter,havoc,102,44,58
2433,Diversityabc,bleeding-hollow,1263,demonhunter,havoc,72,30,42
2434,Skilla,frostmourne,1262,demonhunter,havoc,85,42,43
2435,Amdusias,darkspear,1259,demonhunter,havoc,49,22,27
2436,Eullz,skullcrusher,1257,demonhunter,havoc,31,14,17
2437,Twodxoxo,kelthuzad,1256,demonhunter,havoc,24,14,10
2438,Xà,sargeras,1256,demonhunter,havoc,36,14,22
2439,Durello,stormrage,1255,demonhunter,havoc,54,25,29
2440,Onlypain,korgath,1251,demonhunter,havoc,38,16,22
2441,Blinddh,bleeding-hollow,1249,demonhunter,havoc,32,14,18
2442,Mårth,caelestrasz,1248,demonhunter,havoc,48,25,23
2443,Aleira,frostwolf,1247,demonhunter,havoc,33,18,15
2444,Cerebro,stormrage,1247,demonhunter,havoc,24,13,11
2445,Ilovenina,sargeras,1247,demonhunter,havoc,24,13,11
2446,Giselah,malganis,1247,demonhunter,havoc,30,13,17
2447,Gènji,tichondrius,1246,demonhunter,havoc,24,13,11
2448,Achemedåche,dalaran,1245,demonhunter,havoc,18,13,5
2449,Blúr,tichondrius,1245,demonhunter,havoc,18,13,5
2450,Christensen,illidan,1245,demonhunter,havoc,54,30,24
2451,Kalikanzar,sargeras,1245,demonhunter,havoc,24,13,11
2452,Kushidari,tichondrius,1245,demonhunter,havoc,48,24,24
2453,Diablitaa,sargeras,1245,demonhunter,havoc,30,13,17
2454,Fingersdh,malganis,1245,demonhunter,havoc,30,13,17
2455,Rykidh,tichondrius,1245,demonhunter,havoc,30,13,17
2456,Trillidan,mugthol,1245,demonhunter,havoc,30,13,17
2457,Äòégämîñg,stormrage,1245,demonhunter,havoc,36,13,23
2458,Alizqt,ragnaros,1244,demonhunter,havoc,24,13,11
2459,Deathsweep,tichondrius,1244,demonhunter,havoc,24,13,11
2460,Hoguriders,tichondrius,1244,demonhunter,havoc,30,13,17
2461,Baejuhyun,kiljaeden,1243,demonhunter,havoc,24,16,8
2462,Smilingbomb,tichondrius,1243,demonhunter,havoc,24,13,11
2463,Nichousha,tichondrius,1243,demonhunter,havoc,24,13,11
2464,Intensìve,illidan,1242,demonhunter,havoc,48,14,34
2465,Ashtyr,emerald-dream,1241,demonhunter,havoc,22,14,8
2466,Decoi,tichondrius,1241,demonhunter,havoc,24,13,11
2467,Tydriedian,dalaran,1239,demonhunter,havoc,18,13,5
2468,Missjotab,tichondrius,1239,demonhunter,havoc,24,13,11
2469,Harû,tichondrius,1239,demonhunter,havoc,30,13,17
2470,Narandra,malganis,1239,demonhunter,havoc,36,13,23
2471,Zématador,azralon,1238,demonhunter,havoc,100,53,47
2472,Zétta,area-52,1236,demonhunter,havoc,24,13,11
2473,Demonbane,moon-guard,1236,demonhunter,havoc,54,27,27
2474,Maddummy,tichondrius,1234,demonhunter,havoc,30,13,17
2475,Véñom,area-52,1233,demonhunter,havoc,42,13,29
2476,Zunfooki,stormrage,1231,demonhunter,havoc,24,13,11
2477,Sorrybadgas,illidan,1231,demonhunter,havoc,36,13,23
2478,Sikäria,malganis,1229,demonhunter,havoc,24,13,11
2479,Superbug,quelthalas,1229,demonhunter,havoc,42,20,22
2480,Revean,darkspear,1226,demonhunter,havoc,66,36,30
2481,Darthmah,illidan,1222,demonhunter,havoc,18,13,5
2482,Tezrian,earthen-ring,1221,demonhunter,havoc,24,13,11
2483,Lixthing,ragnaros,1220,demonhunter,havoc,55,36,19
2484,Lachesix,tichondrius,1217,demonhunter,havoc,30,13,17
2485,Ralrdh,ragnaros,1216,demonhunter,havoc,24,13,11
2486,Devwillhuntu,barthilas,1216,demonhunter,havoc,80,42,38
2487,Pilyn,ragnaros,1216,demonhunter,havoc,80,39,41
2488,Keelin,ragnaros,1212,demonhunter,havoc,28,13,15
2489,Eraticdh,illidan,1211,demonhunter,havoc,30,13,17
2490,Bzrp,stormrage,1210,demonhunter,havoc,40,23,17
2491,Asmoday,warsong,1209,demonhunter,havoc,102,59,43
2492,Spicywings,arthas,1209,demonhunter,havoc,42,18,24
2493,Dömönic,illidan,1208,demonhunter,havoc,24,13,11
2494,Cursesoul,area-52,1206,demonhunter,havoc,60,31,29
2495,Hoein,eldrethalas,1204,demonhunter,havoc,24,14,10
2496,Raradane,illidan,1203,demonhunter,havoc,18,13,5
2497,Adryr,eredar,1203,demonhunter,havoc,36,19,17
2498,Hellspawnn,malganis,1200,demonhunter,havoc,44,24,20
2499,Miltonpickle,tichondrius,1199,demonhunter,havoc,30,13,17
2500,Etherëäl,stormrage,1194,demonhunter,havoc,53,32,21
2501,Fellight,bonechewer,1193,demonhunter,havoc,42,27,15
2502,Medusarri,frostmourne,1193,demonhunter,havoc,36,19,17
2503,Aroncruel,area-52,1192,demonhunter,havoc,48,27,21
2504,Ixix,proudmoore,1192,demonhunter,havoc,62,30,32
2505,Illidice,tichondrius,1189,demonhunter,havoc,30,13,17
2506,Hiddenblade,coilfang,1188,demonhunter,havoc,55,24,31
2507,Erazuz,stormrage,1188,demonhunter,havoc,30,13,17
2508,Scarshine,frostmourne,1186,demonhunter,havoc,66,25,41
2509,Brunoqt,azralon,1185,demonhunter,havoc,29,13,16
2510,Cyberpsycho,illidan,1184,demonhunter,havoc,30,14,16
2511,Sleepyjobe,sargeras,1183,demonhunter,havoc,16,13,3
2512,Spamsamich,stormscale,1180,demonhunter,havoc,59,35,24
2513,Tyrelara,durotan,1179,demonhunter,havoc,23,13,10
2514,Glayve,emerald-dream,1178,demonhunter,havoc,85,41,44
2515,Saelila,emerald-dream,1172,demonhunter,havoc,30,13,17
2516,Dyingslow,stormrage,1172,demonhunter,havoc,66,24,42
2517,Buzzmezaddy,bleeding-hollow,1170,demonhunter,havoc,63,28,35
2518,Ënky,ragnaros,1170,demonhunter,havoc,54,23,31
2519,Gouge,hakkar,1167,demonhunter,havoc,55,30,25
2520,Daiks,proudmoore,1166,demonhunter,havoc,48,22,26
2521,Blazed,thrall,1164,demonhunter,havoc,94,46,48
2522,Zoruv,quelthalas,1160,demonhunter,havoc,27,14,13
2523,Thedaz,frostmourne,1158,demonhunter,havoc,143,66,77
2524,Larayedia,illidan,1156,demonhunter,havoc,24,17,7
2525,Sucubus,eredar,1155,demonhunter,havoc,30,17,13
2526,Ragiidh,tichondrius,1152,demonhunter,havoc,24,12,12
2527,Xragii,kelthuzad,1152,demonhunter,havoc,24,12,12
2528,Postodesaúde,azralon,1151,demonhunter,havoc,24,12,12
2529,Gtåte,azjolnerub,1151,demonhunter,havoc,42,12,30
2530,Ðrogö,emerald-dream,1150,demonhunter,havoc,18,12,6
2531,Insomdh,sargeras,1150,demonhunter,havoc,18,12,6
2532,Fasnk,tichondrius,1150,demonhunter,havoc,24,12,12
2533,Qixoni,emerald-dream,1150,demonhunter,havoc,30,12,18
2534,Xylëm,tichondrius,1149,demonhunter,havoc,36,12,24
2535,Openhard,stormrage,1148,demonhunter,havoc,24,12,12
2536,Viio,proudmoore,1146,demonhunter,havoc,24,12,12
2537,Chaosfienddh,bleeding-hollow,1146,demonhunter,havoc,30,12,18
2538,Luana,stormscale,1145,demonhunter,havoc,24,12,12
2539,Omygaud,tichondrius,1143,demonhunter,havoc,18,12,6
2540,Namaga,illidan,1143,demonhunter,havoc,18,12,6
2541,Skinnrd,malganis,1142,demonhunter,havoc,24,12,12
2542,Vandeste,tichondrius,1142,demonhunter,havoc,30,12,18
2543,Kagraxxis,stormrage,1141,demonhunter,havoc,21,13,8
2544,Torophz,azralon,1139,demonhunter,havoc,30,12,18
2545,Elidani,area-52,1138,demonhunter,havoc,30,12,18
2546,Vivas,tichondrius,1136,demonhunter,havoc,24,12,12
2547,Endyr,area-52,1136,demonhunter,havoc,25,12,13
2548,Tayel,emerald-dream,1133,demonhunter,havoc,34,19,15
2549,Dakro,blackrock,1130,demonhunter,havoc,22,13,9
2550,Dandreb,draenor,1130,demonhunter,havoc,29,15,14
2551,Ozark,barthilas,1129,demonhunter,havoc,42,25,17
2552,Siicknote,frostmourne,1127,demonhunter,havoc,23,12,11
2553,Jennesis,tichondrius,1126,demonhunter,havoc,78,36,42
2554,Momysimpypoo,tichondrius,1125,demonhunter,havoc,18,12,6
2555,Itachiix,sargeras,1125,demonhunter,havoc,18,12,6
2556,Ibeatrix,malorne,1124,demonhunter,havoc,24,18,6
2557,Howller,azralon,1121,demonhunter,havoc,27,13,14
2558,Syrena,mugthol,1119,demonhunter,havoc,24,12,12
2559,Attritionx,sargeras,1118,demonhunter,havoc,23,13,10
2560,Painkiiller,kelthuzad,1115,demonhunter,havoc,24,15,9
2561,Onií,bleeding-hollow,1110,demonhunter,havoc,29,12,17
2562,Lory,eldrethalas,1108,demonhunter,havoc,67,33,34
2563,Thelada,illidan,1106,demonhunter,havoc,27,13,14
2564,Thèflurry,tichondrius,1102,demonhunter,havoc,23,12,11
2565,Miroir,silvermoon,1094,demonhunter,havoc,119,54,65
2566,Imjustbad,malganis,1091,demonhunter,havoc,48,27,21
2567,Sätän,malganis,1089,demonhunter,havoc,24,13,11
2568,Elenamarth,kiljaeden,1089,demonhunter,havoc,30,12,18
2569,Lilliåna,kiljaeden,1085,demonhunter,havoc,56,24,32
2570,Ghostzface,sargeras,1084,demonhunter,havoc,48,26,22
2571,Kelmar,stormreaver,1084,demonhunter,havoc,32,12,20
2572,Moxí,ragnaros,1082,demonhunter,havoc,36,19,17
2573,Bhuppz,frostmourne,1076,demonhunter,havoc,22,12,10
2574,Misfortune,bloodscalp,1076,demonhunter,havoc,36,15,21
2575,Nixsa,area-52,1073,demonhunter,havoc,84,37,47
2576,Dirtyvitus,gorefiend,1072,demonhunter,havoc,36,24,12
2577,Esomet,stormrage,1070,demonhunter,havoc,27,15,12
2578,Faalleen,quelthalas,1059,demonhunter,havoc,18,12,6
2579,Syrine,veknilash,1059,demonhunter,havoc,72,41,31
2580,Illadra,fizzcrank,1058,demonhunter,havoc,23,12,11
2581,Cavell,tichondrius,1056,demonhunter,havoc,18,11,7
2582,Thegoph,bleeding-hollow,1056,demonhunter,havoc,24,11,13
2583,Zztzz,illidan,1055,demonhunter,havoc,18,11,7
2584,Fëlla,tanaris,1055,demonhunter,havoc,18,11,7
2585,Çópê,sargeras,1055,demonhunter,havoc,18,11,7
2586,Gogungho,tichondrius,1055,demonhunter,havoc,24,11,13
2587,Dennfear,skullcrusher,1054,demonhunter,havoc,18,12,6
2588,Ariaxy,sargeras,1054,demonhunter,havoc,18,11,7
2589,Thumôss,malganis,1054,demonhunter,havoc,18,11,7
2590,Diiecrux,bleeding-hollow,1054,demonhunter,havoc,18,11,7
2591,Ravack,stormrage,1054,demonhunter,havoc,18,11,7
2592,Koverage,frostmourne,1054,demonhunter,havoc,18,11,7
2593,Behemod,thrall,1054,demonhunter,havoc,24,11,13
2594,Spicyblades,stormrage,1054,demonhunter,havoc,47,21,26
2595,Mudßutt,malganis,1054,demonhunter,havoc,30,11,19
2596,Xavid,bleeding-hollow,1053,demonhunter,havoc,24,11,13
2597,Messenoire,area-52,1051,demonhunter,havoc,26,11,15
2598,Mood,stonemaul,1050,demonhunter,havoc,18,11,7
2599,Ønsen,tichondrius,1049,demonhunter,havoc,29,11,18
2600,Trituone,ragnaros,1049,demonhunter,havoc,32,12,20
2601,Shandras,dathremar,1048,demonhunter,havoc,18,11,7
2602,Vuse,moon-guard,1048,demonhunter,havoc,24,11,13
2603,Covoth,bleeding-hollow,1048,demonhunter,havoc,27,12,15
2604,Faster,tichondrius,1048,demonhunter,havoc,30,11,19
2605,Winlegend,gallywix,1048,demonhunter,havoc,32,11,21
2606,Creamin,thrall,1047,demonhunter,havoc,18,11,7
2607,Legäult,bleeding-hollow,1047,demonhunter,havoc,33,17,16
2608,Callux,black-dragonflight,1047,demonhunter,havoc,30,11,19
2609,Rewyle,magtheridon,1047,demonhunter,havoc,30,11,19
2610,Midewdh,proudmoore,1046,demonhunter,havoc,24,11,13
2611,Thunderray,ragnaros,1044,demonhunter,havoc,18,11,7
2612,Throniren,stormrage,1044,demonhunter,havoc,24,11,13
2613,Demonslaier,dragonblight,1043,demonhunter,havoc,20,12,8
2614,Xanthee,drakkari,1043,demonhunter,havoc,81,41,40
2615,Rickinmorty,lightnings-blade,1041,demonhunter,havoc,19,11,8
2616,Aedice,gurubashi,1038,demonhunter,havoc,24,11,13
2617,Rhaast,executus,1035,demonhunter,havoc,79,35,44
2618,Narene,mannoroth,1034,demonhunter,havoc,27,11,16
2619,Aliniron,illidan,1025,demonhunter,havoc,24,12,12
2620,Chronicsmoke,blood-furnace,1024,demonhunter,havoc,30,14,16
2621,Hentaidemon,kiljaeden,1023,demonhunter,havoc,36,18,18
2622,Chinadh,tichondrius,1022,demonhunter,havoc,23,11,12
2623,Darkweast,dalaran,1021,demonhunter,havoc,24,11,13
2624,Dameon,wildhammer,1019,demonhunter,havoc,66,32,34
2625,Jënesis,illidan,1019,demonhunter,havoc,80,35,45
2626,Swansong,norgannon,1016,demonhunter,havoc,24,13,11
2627,Fugabag,thrall,1015,demonhunter,havoc,23,11,12
2628,Eikichi,bleeding-hollow,1009,demonhunter,havoc,54,26,28
2629,Catfood,icecrown,1008,demonhunter,havoc,27,11,16
2630,Chirõn,moonrunner,1007,demonhunter,havoc,23,11,12
2631,Seamenhunter,garrosh,1004,demonhunter,havoc,24,12,12
2632,Shawnchad,blood-furnace,999,demonhunter,havoc,139,71,68
2633,Ethelric,frostmourne,993,demonhunter,havoc,41,12,29
2634,Xxann,tichondrius,991,demonhunter,havoc,26,11,15
2635,Lüky,malganis,986,demonhunter,havoc,22,11,11
2636,Suhui,sargeras,983,demonhunter,havoc,29,11,18
2637,Doomhead,burning-legion,981,demonhunter,havoc,24,15,9
2638,Andarïel,bleeding-hollow,977,demonhunter,havoc,25,12,13
2639,Cuint,barthilas,976,demonhunter,havoc,36,18,18
2640,Hypetraindh,kelthuzad,960,demonhunter,havoc,12,10,2
2641,Kokushiibo,frostwolf,960,demonhunter,havoc,18,10,8
2642,Chainsawz,zuljin,960,demonhunter,havoc,18,10,8
2643,Lancee,zuljin,960,demonhunter,havoc,24,10,14
2644,Ntts,tichondrius,960,demonhunter,havoc,24,10,14
2645,Beerbreak,area-52,960,demonhunter,havoc,30,10,20
2646,Noztak,area-52,960,demonhunter,havoc,30,10,20
2647,Demonleap,proudmoore,959,demonhunter,havoc,18,10,8
2648,Sourapple,barthilas,959,demonhunter,havoc,18,10,8
2649,Iluvboóty,blackrock,959,demonhunter,havoc,24,10,14
2650,Hueylucifer,ravencrest,959,demonhunter,havoc,30,10,20
2651,Cyånan,bleeding-hollow,958,demonhunter,havoc,23,14,9
2652,Yaety,tichondrius,958,demonhunter,havoc,18,10,8
2653,Planeinsky,malganis,958,demonhunter,havoc,18,10,8
2654,Skógarmaðr,garrosh,958,demonhunter,havoc,23,11,12
2655,Alwaysin,zuljin,957,demonhunter,havoc,18,10,8
2656,Krelious,barthilas,957,demonhunter,havoc,18,10,8
2657,Randôm,kelthuzad,957,demonhunter,havoc,21,11,10
2658,Gilberte,stormrage,957,demonhunter,havoc,24,10,14
2659,Tangoh,burning-legion,955,demonhunter,havoc,18,10,8
2660,Derelikte,shadowmoon,955,demonhunter,havoc,18,10,8
2661,Rorac,ragnaros,955,demonhunter,havoc,24,10,14
2662,Jagidan,area-52,955,demonhunter,havoc,24,10,14
2663,Clorhídrico,quelthalas,954,demonhunter,havoc,72,35,37
2664,Xibir,amanthul,953,demonhunter,havoc,24,10,14
2665,Larnol,moon-guard,952,demonhunter,havoc,18,10,8
2666,Allenqt,azralon,952,demonhunter,havoc,24,10,14
2667,Nerco,bleeding-hollow,952,demonhunter,havoc,24,10,14
2668,Akurawrath,area-52,951,demonhunter,havoc,12,10,2
2669,Mázoku,shuhalo,951,demonhunter,havoc,20,11,9
2670,Ghótam,quelthalas,950,demonhunter,havoc,24,10,14
2671,Vladdtepes,cairne,949,demonhunter,havoc,83,44,39
2672,Airaxx,moon-guard,949,demonhunter,havoc,21,11,10
2673,Letzgobrandn,silvermoon,948,demonhunter,havoc,18,10,8
2674,Kwoop,tichondrius,946,demonhunter,havoc,24,10,14
2675,Annabow,moon-guard,944,demonhunter,havoc,66,34,32
2676,Demonizhe,thrall,944,demonhunter,havoc,43,22,21
2677,Elurandre,moon-guard,944,demonhunter,havoc,23,10,13
2678,Weedeaterr,arthas,943,demonhunter,havoc,36,10,26
2679,Evros,tichondrius,933,demonhunter,havoc,21,11,10
2680,Deegsdh,sargeras,932,demonhunter,havoc,27,10,17
2681,Andyhunter,emerald-dream,930,demonhunter,havoc,62,32,30
2682,Gozer,korialstrasz,929,demonhunter,havoc,36,12,24
2683,Lillidum,azralon,927,demonhunter,havoc,45,21,24
2684,Keeblerself,tichondrius,925,demonhunter,havoc,24,11,13
2685,Vilal,dalaran,923,demonhunter,havoc,14,11,3
2686,Gravelot,quelthalas,915,demonhunter,havoc,30,10,20
2687,Bukwheat,thunderhorn,913,demonhunter,havoc,66,31,35
2688,Troigh,thunderlord,912,demonhunter,havoc,60,29,31
2689,Kslicedevil,dalaran,909,demonhunter,havoc,66,28,38
2690,Rissélys,thrall,894,demonhunter,havoc,30,15,15
2691,Falaszun,aegwynn,889,demonhunter,havoc,20,10,10
2692,Ripchimmii,illidan,880,demonhunter,havoc,25,10,15
2693,Mikiller,thrall,879,demonhunter,havoc,109,53,56
2694,Blacktocki,barthilas,878,demonhunter,havoc,22,10,12
2695,Blops,emerald-dream,877,demonhunter,havoc,24,11,13
2696,Riicardo,ragnaros,870,demonhunter,havoc,28,12,16
2697,Faarkyou,barthilas,868,demonhunter,havoc,26,10,16
2698,Myname,aggramar,866,demonhunter,havoc,56,14,42
2699,Souliz,tichondrius,864,demonhunter,havoc,12,9,3
2700,Ragiixoxo,tichondrius,864,demonhunter,havoc,12,9,3
2701,Ravevê,area-52,864,demonhunter,havoc,12,9,3
2702,Pennyx,barthilas,864,demonhunter,havoc,12,9,3
2703,Bammski,tichondrius,864,demonhunter,havoc,18,9,9
2704,Tarro,whisperwind,864,demonhunter,havoc,18,9,9
2705,Mcgurty,illidan,864,demonhunter,havoc,24,9,15
2706,Noobender,malganis,864,demonhunter,havoc,30,9,21
2707,Ripidan,stormrage,864,demonhunter,havoc,30,9,21
2708,Agsakim,tichondrius,863,demonhunter,havoc,12,9,3
2709,Subieshift,sargeras,863,demonhunter,havoc,15,10,5
2710,Rothdh,tichondrius,863,demonhunter,havoc,15,10,5
2711,Sävage,zuljin,863,demonhunter,havoc,18,9,9
2712,Dogcleave,area-52,863,demonhunter,havoc,18,9,9
2713,Orosz,bleeding-hollow,863,demonhunter,havoc,18,9,9
2714,Worldahmelee,illidan,863,demonhunter,havoc,18,9,9
2715,Lördvïngadør,azralon,863,demonhunter,havoc,18,9,9
2716,Dmonslayer,daggerspine,863,demonhunter,havoc,24,9,15
2717,Amanthx,tichondrius,863,demonhunter,havoc,24,9,15
2718,Checkmate,bleeding-hollow,863,demonhunter,havoc,24,9,15
2719,Khaito,illidan,863,demonhunter,havoc,24,9,15
2720,Dragynfíst,malganis,863,demonhunter,havoc,30,9,21
2721,Rizzle,malganis,862,demonhunter,havoc,18,9,9
2722,Vida,winterhoof,862,demonhunter,havoc,18,9,9
2723,Nicosdh,agamaggan,862,demonhunter,havoc,18,9,9
2724,Hugehogger,boulderfist,862,demonhunter,havoc,18,9,9
2725,Moranah,tichondrius,862,demonhunter,havoc,18,9,9
2726,Lucipur,thrall,862,demonhunter,havoc,18,9,9
2727,Phoébé,drakkari,861,demonhunter,havoc,18,9,9
2728,Facerollfel,tichondrius,861,demonhunter,havoc,18,9,9
2729,Felhunt,ragnaros,861,demonhunter,havoc,24,9,15
2730,Rosamune,kelthuzad,861,demonhunter,havoc,24,9,15
2731,Hellboss,dalaran,860,demonhunter,havoc,12,9,3
2732,Zirrey,stormrage,860,demonhunter,havoc,18,9,9
2733,Rèlentless,moon-guard,860,demonhunter,havoc,18,9,9
2734,Bodemön,stormrage,860,demonhunter,havoc,18,9,9
2735,Alphmega,malganis,859,demonhunter,havoc,18,9,9
2736,Smokahontas,eredar,859,demonhunter,havoc,18,9,9
2737,Cleår,kelthuzad,859,demonhunter,havoc,18,9,9
2738,Allukya,azralon,856,demonhunter,havoc,12,9,3
2739,Flyingsky,tichondrius,855,demonhunter,havoc,12,9,3
2740,Aflex,zuljin,855,demonhunter,havoc,18,9,9
2741,Dartanyn,tichondrius,853,demonhunter,havoc,24,9,15
2742,Drackista,stormrage,852,demonhunter,havoc,18,9,9
2743,Jakodh,sargeras,848,demonhunter,havoc,18,9,9
2744,Aussiepleb,nagrand,846,demonhunter,havoc,87,37,50
2745,Dalmandra,arthas,841,demonhunter,havoc,17,9,8
2746,Wut,nemesis,839,demonhunter,havoc,70,34,36
2747,Syldaeya,silvermoon,838,demonhunter,havoc,22,11,11
2748,Fckyouscott,illidan,830,demonhunter,havoc,14,10,4
2749,Necrødh,tichondrius,828,demonhunter,havoc,16,9,7
2750,Aleymar,tichondrius,822,demonhunter,havoc,18,9,9
2751,Szei,tichondrius,815,demonhunter,havoc,11,9,2
2752,Wokeaf,malganis,814,demonhunter,havoc,17,9,8
2753,Coaa,dalaran,814,demonhunter,havoc,23,9,14
2754,Pariah,saurfang,813,demonhunter,havoc,17,9,8
2755,Antistar,emerald-dream,799,demonhunter,havoc,26,9,17
2756,Felraven,scarlet-crusade,797,demonhunter,havoc,16,9,7
2757,Demonci,stormrage,795,demonhunter,havoc,20,11,9
2758,Jellehx,frostmourne,784,demonhunter,havoc,13,9,4
2759,Deuzz,arthas,768,demonhunter,havoc,12,8,4
2760,Lxg,kelthuzad,768,demonhunter,havoc,12,8,4
2761,Dzdh,stormrage,768,demonhunter,havoc,12,8,4
2762,Humanitydh,sargeras,768,demonhunter,havoc,12,8,4
2763,Thickgary,illidan,768,demonhunter,havoc,12,8,4
2764,Dulcibella,tichondrius,768,demonhunter,havoc,12,8,4
2765,Surkkdh,tichondrius,768,demonhunter,havoc,12,8,4
2766,Doomanone,sargeras,768,demonhunter,havoc,12,8,4
2767,Squaller,tichondrius,768,demonhunter,havoc,12,8,4
2768,Mesidan,illidan,768,demonhunter,havoc,12,8,4
2769,Helltaker,blood-furnace,768,demonhunter,havoc,12,8,4
2770,Cegocruel,sargeras,768,demonhunter,havoc,13,8,5
2771,Devssimpspec,sargeras,768,demonhunter,havoc,18,8,10
2772,Raylêy,tichondrius,768,demonhunter,havoc,18,8,10
2773,Felontis,sargeras,768,demonhunter,havoc,18,8,10
2774,Neverblurx,kirin-tor,768,demonhunter,havoc,18,8,10
2775,Zuppashi,area-52,768,demonhunter,havoc,18,8,10
2776,Fingól,ragnaros,768,demonhunter,havoc,18,8,10
2777,Felgobbler,zuljin,768,demonhunter,havoc,18,8,10
2778,Veilmaya,arthas,768,demonhunter,havoc,18,8,10
2779,Tomhenk,blackrock,768,demonhunter,havoc,18,8,10
2780,Doomantwo,sargeras,768,demonhunter,havoc,24,8,16
2781,Bdwxxnmm,tichondrius,768,demonhunter,havoc,24,8,16
2782,Hellrazer,area-52,767,demonhunter,havoc,12,8,4
2783,Aethrys,amanthul,767,demonhunter,havoc,12,8,4
2784,Badwurd,sargeras,767,demonhunter,havoc,12,8,4
2785,Cocomeld,tichondrius,767,demonhunter,havoc,12,8,4
2786,Myspyhu,malganis,767,demonhunter,havoc,12,8,4
2787,Prazethesun,emerald-dream,767,demonhunter,havoc,12,8,4
2788,Netherbird,malganis,767,demonhunter,havoc,12,8,4
2789,Ziyàl,vashj,767,demonhunter,havoc,12,8,4
2790,Xonu,sargeras,767,demonhunter,havoc,12,8,4
2791,Lethalblows,darkspear,767,demonhunter,havoc,15,9,6
2792,Linedori,destromath,767,demonhunter,havoc,16,9,7
2793,ßonècrushèr,tichondrius,767,demonhunter,havoc,18,8,10
2794,Demonqt,blackrock,767,demonhunter,havoc,18,8,10
2795,Hellrazer,azgalor,767,demonhunter,havoc,18,8,10
2796,Madatya,black-dragonflight,767,demonhunter,havoc,18,8,10
2797,Oddlysimple,korgath,767,demonhunter,havoc,18,8,10
2798,Feldumper,illidan,767,demonhunter,havoc,18,8,10
2799,Wólff,azralon,766,demonhunter,havoc,12,8,4
2800,Andein,dalaran,766,demonhunter,havoc,12,8,4
2801,Felshiv,azralon,766,demonhunter,havoc,18,8,10
2802,Rolecheck,tichondrius,766,demonhunter,havoc,18,8,10
2803,Darkglaive,ragnaros,766,demonhunter,havoc,18,8,10
2804,Accipiter,ragnaros,766,demonhunter,havoc,24,8,16
2805,Yedeme,tichondrius,766,demonhunter,havoc,25,8,17
2806,Bholez,illidan,765,demonhunter,havoc,18,8,10
2807,Këÿz,earthen-ring,765,demonhunter,havoc,18,8,10
2808,Lû,arthas,765,demonhunter,havoc,24,8,16
2809,Diddlemethis,nagrand,764,demonhunter,havoc,12,8,4
2810,Margerie,bleeding-hollow,764,demonhunter,havoc,18,8,10
2811,Felbòy,korgath,763,demonhunter,havoc,18,8,10
2812,Llrebelionll,stormrage,762,demonhunter,havoc,12,8,4
2813,Sodiaksd,quelthalas,762,demonhunter,havoc,18,8,10
2814,Lingnafoxy,tichondrius,762,demonhunter,havoc,21,9,12
2815,Illhuntya,bonechewer,758,demonhunter,havoc,18,8,10
2816,Suyu,ragnaros,758,demonhunter,havoc,21,8,13
2817,Maydemon,ragnaros,757,demonhunter,havoc,24,8,16
2818,Covidneitor,drakkari,752,demonhunter,havoc,24,8,16
2819,Menadori,madoran,748,demonhunter,havoc,18,8,10
2820,Abusedchild,dalaran,735,demonhunter,havoc,18,8,10
2821,Grolschen,proudmoore,735,demonhunter,havoc,24,9,15
2822,Wuya,thrall,734,demonhunter,havoc,22,8,14
2823,Kellndore,emerald-dream,730,demonhunter,havoc,18,8,10
2824,Hiresol,emerald-dream,719,demonhunter,havoc,11,8,3
2825,Rôrônôâzôrô,stormrage,719,demonhunter,havoc,17,8,9
2826,Malefisentt,firetree,719,demonhunter,havoc,21,9,12
2827,Lrianna,senjin,706,demonhunter,havoc,17,8,9
2828,Diequickly,tichondrius,704,demonhunter,havoc,22,8,14
2829,Nécô,tichondrius,703,demonhunter,havoc,14,8,6
2830,Dakkemon,zuljin,702,demonhunter,havoc,20,8,12
2831,Rivent,dethecus,702,demonhunter,havoc,26,8,18
2832,Memoryleaky,proudmoore,696,demonhunter,havoc,11,8,3
2833,Neshaan,stormreaver,688,demonhunter,havoc,38,20,18
2834,Dæl,quelthalas,672,demonhunter,havoc,12,7,5
2835,Stalaias,madoran,672,demonhunter,havoc,12,7,5
2836,Reddh,bleeding-hollow,672,demonhunter,havoc,12,7,5
2837,Icantseelol,sargeras,672,demonhunter,havoc,12,7,5
2838,Darthwhorë,frostmane,672,demonhunter,havoc,12,7,5
2839,Levail,wyrmrest-accord,672,demonhunter,havoc,12,7,5
2840,Endofdaysx,tichondrius,672,demonhunter,havoc,12,7,5
2841,Verå,tichondrius,672,demonhunter,havoc,12,7,5
2842,Dabsfordayz,zuluhed,672,demonhunter,havoc,12,7,5
2843,Evelynee,illidan,672,demonhunter,havoc,12,7,5
2844,Warassassin,stormrage,672,demonhunter,havoc,12,7,5
2845,Idontfaced,area-52,672,demonhunter,havoc,12,7,5
2846,Demonthorne,illidan,672,demonhunter,havoc,12,7,5
2847,Fiveiq,malganis,672,demonhunter,havoc,12,7,5
2848,Solbiz,tichondrius,672,demonhunter,havoc,12,7,5
2849,Isev,illidan,672,demonhunter,havoc,12,7,5
2850,Slaarky,malganis,672,demonhunter,havoc,12,7,5
2851,Nichidah,illidan,672,demonhunter,havoc,12,7,5
2852,Flamehunter,durotan,672,demonhunter,havoc,13,7,6
2853,Igotdc,tichondrius,672,demonhunter,havoc,13,7,6
2854,Elchapotko,tichondrius,672,demonhunter,havoc,18,7,11
2855,Faceurdemons,frostmourne,672,demonhunter,havoc,18,7,11
2856,Moistybreeze,frostmourne,672,demonhunter,havoc,18,7,11
2857,Dumbledor,stonemaul,672,demonhunter,havoc,18,7,11
2858,Babahorns,dalaran,672,demonhunter,havoc,18,7,11
2859,Yasuo,moon-guard,672,demonhunter,havoc,18,7,11
2860,Demonaco,tichondrius,672,demonhunter,havoc,24,7,17
2861,Sadpepe,bleeding-hollow,672,demonhunter,havoc,24,7,17
2862,Stormville,illidan,671,demonhunter,havoc,12,7,5
2863,Cresslina,tichondrius,671,demonhunter,havoc,12,7,5
2864,Wìtchblades,tichondrius,671,demonhunter,havoc,12,7,5
2865,Alycina,wyrmrest-accord,671,demonhunter,havoc,12,7,5
2866,Ogmon,tichondrius,671,demonhunter,havoc,12,7,5
2867,Ivalerà,thrall,671,demonhunter,havoc,12,7,5
2868,Fiebzz,queldorei,671,demonhunter,havoc,12,7,5
2869,Jolty,stormrage,671,demonhunter,havoc,12,7,5
2870,Unóhana,drakkari,671,demonhunter,havoc,12,7,5
2871,Rhadê,ragnaros,671,demonhunter,havoc,12,7,5
2872,Taters,gorefiend,671,demonhunter,havoc,12,7,5
2873,Seabisciut,silvermoon,671,demonhunter,havoc,12,7,5
2874,Cascadingeye,emerald-dream,671,demonhunter,havoc,12,7,5
2875,Zarroe,stormrage,671,demonhunter,havoc,12,7,5
2876,Nicòrobin,dalaran,671,demonhunter,havoc,18,7,11
2877,Sektõr,dalaran,671,demonhunter,havoc,18,7,11
2878,Veryaverage,kelthuzad,671,demonhunter,havoc,18,7,11
2879,Haax,azralon,671,demonhunter,havoc,18,7,11
2880,Hyphonìc,area-52,671,demonhunter,havoc,18,7,11
2881,Ðarkone,ragnaros,671,demonhunter,havoc,24,7,17
2882,Keigna,tichondrius,670,demonhunter,havoc,12,7,5
2883,Yaakee,tichondrius,670,demonhunter,havoc,12,7,5
2884,Renshear,cenarius,670,demonhunter,havoc,12,7,5
2885,Bijix,area-52,670,demonhunter,havoc,12,7,5
2886,Ãstoreth,quelthalas,670,demonhunter,havoc,12,7,5
2887,Zanaiahs,sargeras,670,demonhunter,havoc,21,7,14
2888,Stepbroseph,kiljaeden,669,demonhunter,havoc,15,8,7
2889,Halfprepared,kelthuzad,669,demonhunter,havoc,24,7,17
2890,Denjii,malganis,669,demonhunter,havoc,24,7,17
2891,Falsewave,sargeras,668,demonhunter,havoc,12,7,5
2892,Demonbanter,emerald-dream,668,demonhunter,havoc,15,8,7
2893,Xxsozin,skullcrusher,668,demonhunter,havoc,18,7,11
2894,Irìs,blood-furnace,668,demonhunter,havoc,24,7,17
2895,Snòòp,uldaman,667,demonhunter,havoc,12,7,5
2896,Gretadumberg,area-52,666,demonhunter,havoc,12,7,5
2897,Rahgoul,garrosh,666,demonhunter,havoc,18,7,11
2898,Endoshiva,icecrown,666,demonhunter,havoc,18,7,11
2899,Genifer,norgannon,665,demonhunter,havoc,12,7,5
2900,Turbochadbro,spirestone,663,demonhunter,havoc,15,8,7
2901,Rhydonx,korgath,662,demonhunter,havoc,12,7,5
2902,Eckerstrom,tichondrius,659,demonhunter,havoc,12,7,5
2903,Luzev,thrall,657,demonhunter,havoc,12,7,5
2904,Ripperxx,zuljin,653,demonhunter,havoc,18,7,11
2905,Purpsquirter,stormscale,653,demonhunter,havoc,21,8,13
2906,Lëif,stormrage,652,demonhunter,havoc,18,7,11
2907,Gwîlym,area-52,644,demonhunter,havoc,14,9,5
2908,Leg,scilla,640,demonhunter,havoc,16,7,9
2909,Pegásus,kiljaeden,639,demonhunter,havoc,10,7,3
2910,Çummins,malganis,637,demonhunter,havoc,14,8,6
2911,Bliqué,emerald-dream,633,demonhunter,havoc,17,7,10
2912,Bigtitiemilk,tichondrius,623,demonhunter,havoc,11,7,4
2913,Gebblemon,aerie-peak,623,demonhunter,havoc,17,7,10
2914,Hidan,velen,621,demonhunter,havoc,14,8,6
2915,Mqvdh,area-52,618,demonhunter,havoc,39,8,31
2916,Galaxezz,bonechewer,612,demonhunter,havoc,15,8,7
2917,Joegamer,illidan,607,demonhunter,havoc,14,8,6
2918,Wualicho,ragnaros,603,demonhunter,havoc,24,8,16
2919,Runecaster,anvilmar,587,demonhunter,havoc,11,7,4
2920,Bossdh,zuljin,576,demonhunter,havoc,12,6,6
2921,Manmilker,bleeding-hollow,576,demonhunter,havoc,12,6,6
2922,Pabloh,trollbane,576,demonhunter,havoc,12,6,6
2923,Metakigai,ghostlands,576,demonhunter,havoc,12,6,6
2924,Whatdagoof,tichondrius,576,demonhunter,havoc,12,6,6
2925,Basdminority,bleeding-hollow,576,demonhunter,havoc,12,6,6
2926,Carlosjr,stormrage,576,demonhunter,havoc,12,6,6
2927,Felraiser,stormrage,576,demonhunter,havoc,12,6,6
2928,Merzinator,korgath,576,demonhunter,havoc,12,6,6
2929,Everdh,barthilas,576,demonhunter,havoc,12,6,6
2930,Qualitycaulk,tichondrius,576,demonhunter,havoc,12,6,6
2931,Fanc,sargeras,576,demonhunter,havoc,12,6,6
2932,Yikari,stormrage,576,demonhunter,havoc,12,6,6
2933,Lettüceprey,sargeras,576,demonhunter,havoc,12,6,6
2934,Irezumi,icecrown,576,demonhunter,havoc,12,6,6
2935,Niteclawla,illidan,576,demonhunter,havoc,12,6,6
2936,Kolthis,tichondrius,576,demonhunter,havoc,12,6,6
2937,Audara,sargeras,576,demonhunter,havoc,12,6,6
2938,Minhzie,moon-guard,576,demonhunter,havoc,12,6,6
2939,Vishì,thrall,576,demonhunter,havoc,12,6,6
2940,Deathschosen,malganis,576,demonhunter,havoc,12,6,6
2941,Kyuno,eitrigg,576,demonhunter,havoc,12,6,6
2942,Thunderlor,malganis,576,demonhunter,havoc,12,6,6
2943,Beniesdh,frostmourne,576,demonhunter,havoc,12,6,6
2944,Shadöw,emerald-dream,576,demonhunter,havoc,12,6,6
2945,Cðnstantine,barthilas,576,demonhunter,havoc,12,6,6
2946,Abadina,illidan,576,demonhunter,havoc,12,6,6
2947,Trenbolognie,illidan,576,demonhunter,havoc,12,6,6
2948,Stalkdemon,azralon,576,demonhunter,havoc,12,6,6
2949,Crankbaz,malganis,576,demonhunter,havoc,12,6,6
2950,Seya,tichondrius,576,demonhunter,havoc,12,6,6
2951,Blanky,shadowmoon,576,demonhunter,havoc,12,6,6
2952,Valeriya,frostmourne,576,demonhunter,havoc,12,6,6
2953,Zyer,mannoroth,576,demonhunter,havoc,12,6,6
2954,Gommademon,illidan,576,demonhunter,havoc,12,6,6
2955,Dgj,kelthuzad,576,demonhunter,havoc,12,6,6
2956,Evelynvc,illidan,576,demonhunter,havoc,12,6,6
2957,Slapxy,illidan,576,demonhunter,havoc,12,6,6
2958,Solriel,malganis,576,demonhunter,havoc,12,6,6
2959,Jotalejandro,quelthalas,576,demonhunter,havoc,12,6,6
2960,Trampstampz,darkspear,576,demonhunter,havoc,12,6,6
2961,Weskerz,illidan,576,demonhunter,havoc,12,6,6
2962,Ahsoka,arygos,576,demonhunter,havoc,15,7,8
2963,Zümanity,zangarmarsh,576,demonhunter,havoc,18,6,12
2964,Kelan,borean-tundra,576,demonhunter,havoc,18,6,12
2965,Thrania,lothar,576,demonhunter,havoc,18,6,12
2966,Demonfused,illidan,576,demonhunter,havoc,18,6,12
2967,Gayrio,sargeras,576,demonhunter,havoc,18,6,12
2968,Tresbotones,kelthuzad,576,demonhunter,havoc,18,6,12
2969,Busta,dethecus,576,demonhunter,havoc,18,6,12
2970,Xyntel,tichondrius,576,demonhunter,havoc,18,6,12
2971,Abscarnage,ragnaros,576,demonhunter,havoc,18,6,12
2972,Zergedh,kiljaeden,576,demonhunter,havoc,18,6,12
2973,Vyrai,lightbringer,576,demonhunter,havoc,18,6,12
2974,Chabashira,tichondrius,576,demonhunter,havoc,19,6,13
2975,Eazyrat,stormrage,575,demonhunter,havoc,6,6,0
2976,Hootyeahbou,shattered-hand,575,demonhunter,havoc,12,6,6
2977,Diizy,illidan,575,demonhunter,havoc,12,6,6
2978,Lovekills,tichondrius,575,demonhunter,havoc,12,6,6
2979,Lysol,darrowmere,575,demonhunter,havoc,12,6,6
2980,Cholula,korgath,575,demonhunter,havoc,12,6,6
2981,Veladoria,malorne,575,demonhunter,havoc,12,6,6
2982,Tyindorin,gurubashi,575,demonhunter,havoc,12,6,6
2983,Liquidblaze,elune,575,demonhunter,havoc,12,6,6
2984,Sekiro,illidan,575,demonhunter,havoc,12,6,6
2985,Eyesyk,bonechewer,575,demonhunter,havoc,12,6,6
2986,Gurthbrookz,tichondrius,575,demonhunter,havoc,12,6,6
2987,Smoothtaco,azshara,575,demonhunter,havoc,12,6,6
2988,ßatmañ,barthilas,575,demonhunter,havoc,18,6,12
2989,Jalet,azralon,575,demonhunter,havoc,18,6,12
2990,Salveya,stormrage,575,demonhunter,havoc,20,6,14
2991,Casualdemon,emerald-dream,574,demonhunter,havoc,12,6,6
2992,Ðruh,kelthuzad,574,demonhunter,havoc,18,6,12
2993,Firesworn,zuljin,573,demonhunter,havoc,12,6,6
2994,Slaytan,darkspear,573,demonhunter,havoc,18,6,12
2995,Adayinthelif,proudmoore,573,demonhunter,havoc,18,6,12
2996,Lanistus,bloodhoof,570,demonhunter,havoc,18,6,12
2997,Rampyr,terokkar,569,demonhunter,havoc,12,6,6
2998,Kreel,ghostlands,568,demonhunter,havoc,12,6,6
2999,Thjoannys,illidan,567,demonhunter,havoc,12,6,6
3000,Kêydën,ragnaros,541,demonhunter,havoc,10,7,3
3001,Xlash,malganis,528,demonhunter,havoc,15,6,9
3002,Shizune,boulderfist,525,demonhunter,havoc,11,6,5
3003,Wickedlurker,sargeras,519,demonhunter,havoc,17,9,8
3004,Soure,azralon,511,demonhunter,havoc,14,6,8
3005,Äshês,blackhand,510,demonhunter,havoc,8,6,2
3006,Isedelica,area-52,510,demonhunter,havoc,11,6,5
3007,Vessarin,madoran,510,demonhunter,havoc,20,6,14
3008,Ceried,moon-guard,491,demonhunter,havoc,13,6,7
3009,Kyndris,ghostlands,480,demonhunter,havoc,6,5,1
3010,Ottie,kelthuzad,480,demonhunter,havoc,6,5,1
3011,Khaodemus,kaelthas,480,demonhunter,havoc,6,5,1
3012,Lumh,quelthalas,480,demonhunter,havoc,6,5,1
3013,Ljevilin,gilneas,480,demonhunter,havoc,6,5,1
3014,Cynthadra,frostmourne,480,demonhunter,havoc,6,5,1
3015,Tîtø,quelthalas,480,demonhunter,havoc,6,5,1
3016,Ryntx,moon-guard,480,demonhunter,havoc,6,5,1
3017,Damador,malganis,480,demonhunter,havoc,6,5,1
3018,Isabellaluna,illidan,480,demonhunter,havoc,6,5,1
3019,Med,wyrmrest-accord,480,demonhunter,havoc,6,5,1
3020,Milfhuñter,sargeras,480,demonhunter,havoc,6,5,1
3021,Keairà,bleeding-hollow,480,demonhunter,havoc,8,5,3
3022,Hyptonique,queldorei,480,demonhunter,havoc,12,5,7
3023,Delaían,drakkari,480,demonhunter,havoc,12,5,7
3024,Bátmañ,stormrage,480,demonhunter,havoc,12,5,7
3025,Onbloodfam,kelthuzad,480,demonhunter,havoc,12,5,7
3026,Nightwisty,azralon,480,demonhunter,havoc,12,5,7
3027,Dheria,barthilas,480,demonhunter,havoc,12,5,7
3028,Anthvedroth,area-52,480,demonhunter,havoc,12,5,7
3029,Tyrele,drakkari,480,demonhunter,havoc,12,5,7
3030,Wwdh,stormrage,480,demonhunter,havoc,12,5,7
3031,Muffjuice,emerald-dream,480,demonhunter,havoc,12,5,7
3032,Obîtox,illidan,480,demonhunter,havoc,12,5,7
3033,Roughcut,blackrock,480,demonhunter,havoc,12,5,7
3034,Emodan,moon-guard,480,demonhunter,havoc,12,5,7
3035,Billmurray,skullcrusher,480,demonhunter,havoc,12,5,7
3036,Goodrink,tichondrius,480,demonhunter,havoc,12,5,7
3037,Highpower,area-52,480,demonhunter,havoc,12,5,7
3038,Paypaldh,malganis,480,demonhunter,havoc,12,5,7
3039,Bümb,moon-guard,480,demonhunter,havoc,12,5,7
3040,Feliodas,tichondrius,480,demonhunter,havoc,12,5,7
3041,Cabedh,tichondrius,480,demonhunter,havoc,12,5,7
3042,Harahmbae,moon-guard,480,demonhunter,havoc,12,5,7
3043,Hippygamer,frostmourne,480,demonhunter,havoc,12,5,7
3044,Lìttlê,runetotem,480,demonhunter,havoc,12,5,7
3045,Køugami,azralon,480,demonhunter,havoc,12,5,7
3046,Domeemommy,moon-guard,480,demonhunter,havoc,12,5,7
3047,Sailtheskies,tichondrius,480,demonhunter,havoc,12,5,7
3048,Khelt,dalaran,480,demonhunter,havoc,12,5,7
3049,Dontplanahea,tichondrius,480,demonhunter,havoc,12,5,7
3050,Theownz,stormrage,480,demonhunter,havoc,12,5,7
3051,Ahurock,ragnaros,480,demonhunter,havoc,12,5,7
3052,Bellysniffer,illidan,480,demonhunter,havoc,12,5,7
3053,Finagel,destromath,480,demonhunter,havoc,12,5,7
3054,Zlr,bleeding-hollow,480,demonhunter,havoc,12,5,7
3055,Cupernacus,tichondrius,480,demonhunter,havoc,12,5,7
3056,Demondurk,illidan,480,demonhunter,havoc,12,5,7
3057,Drathothian,moon-guard,480,demonhunter,havoc,12,5,7
3058,Xiaodudh,tichondrius,480,demonhunter,havoc,12,5,7
3059,Besoween,tichondrius,480,demonhunter,havoc,12,5,7
3060,Dbljump,kiljaeden,480,demonhunter,havoc,12,5,7
3061,Dhworm,azralon,480,demonhunter,havoc,12,5,7
3062,Chandrian,gorefiend,480,demonhunter,havoc,12,5,7
3063,Jiawen,barthilas,480,demonhunter,havoc,12,5,7
3064,Untouchèd,bleeding-hollow,480,demonhunter,havoc,12,5,7
3065,Uneasydh,tichondrius,480,demonhunter,havoc,12,5,7
3066,Mjin,tichondrius,480,demonhunter,havoc,12,5,7
3067,Chupillidan,tichondrius,480,demonhunter,havoc,12,5,7
3068,Dàrk,zuljin,480,demonhunter,havoc,23,7,16
3069,Soulrending,stormrage,480,demonhunter,havoc,18,5,13
3070,Thedh,ragnaros,480,demonhunter,havoc,18,5,13
3071,Dracxus,sargeras,480,demonhunter,havoc,18,5,13
3072,Barael,tichondrius,480,demonhunter,havoc,18,5,13
3073,Eyebeamtowin,stormrage,480,demonhunter,havoc,18,5,13
3074,Roozi,tichondrius,480,demonhunter,havoc,24,5,19
3075,Pwnagextreme,area-52,479,demonhunter,havoc,6,5,1
3076,Breezoo,tichondrius,479,demonhunter,havoc,6,5,1
3077,Jizzidan,blackhand,479,demonhunter,havoc,6,5,1
3078,Pocahotnes,stormrage,479,demonhunter,havoc,12,5,7
3079,Cantreborn,destromath,479,demonhunter,havoc,12,5,7
3080,ßoobiemiles,area-52,479,demonhunter,havoc,12,5,7
3081,Felmilk,demon-soul,479,demonhunter,havoc,12,5,7
3082,Fliar,black-dragonflight,479,demonhunter,havoc,12,5,7
3083,Denathrion,moon-guard,479,demonhunter,havoc,12,5,7
3084,Epicfront,darkspear,479,demonhunter,havoc,12,5,7
3085,Felvanora,amanthul,479,demonhunter,havoc,12,5,7
3086,Horndawgg,zuljin,479,demonhunter,havoc,12,5,7
3087,Kattsparrow,stormrage,479,demonhunter,havoc,18,5,13
3088,Bonebtwo,area-52,479,demonhunter,havoc,18,5,13
3089,Hàuntress,saurfang,479,demonhunter,havoc,18,5,13
3090,Tdmturbo,zuluhed,478,demonhunter,havoc,12,5,7
3091,Kritik,goldrinn,478,demonhunter,havoc,12,5,7
3092,Midnightlord,tichondrius,477,demonhunter,havoc,6,5,1
3093,Devc,stormrage,477,demonhunter,havoc,12,5,7
3094,Mentoes,tichondrius,473,demonhunter,havoc,12,5,7
3095,Raum,elune,443,demonhunter,havoc,8,6,2
3096,Bogged,emerald-dream,432,demonhunter,havoc,9,5,4
3097,Bituhvic,stormrage,431,demonhunter,havoc,11,5,6
3098,Roosterhead,azjolnerub,430,demonhunter,havoc,11,5,6
3099,Annxyìng,tichondrius,426,demonhunter,havoc,14,6,8
3100,Funky,draenor,420,demonhunter,havoc,22,8,14
3101,Tygerion,emerald-dream,416,demonhunter,havoc,10,5,5
3102,Wheredyougo,proudmoore,416,demonhunter,havoc,10,5,5
3103,Blinddude,sargeras,415,demonhunter,havoc,14,5,9
3104,Ryemortis,malganis,415,demonhunter,havoc,14,5,9
3105,Bladezues,tichondrius,415,demonhunter,havoc,14,5,9
3106,Teenis,malygos,412,demonhunter,havoc,14,5,9
3107,Akiirus,azralon,400,demonhunter,havoc,7,5,2
3108,Italoo,ragnaros,384,demonhunter,havoc,6,4,2
3109,Bopersdh,drakkari,384,demonhunter,havoc,6,4,2
3110,Verasu,kiljaeden,384,demonhunter,havoc,6,4,2
3111,Ktsoulhunter,azralon,384,demonhunter,havoc,6,4,2
3112,Doras,kelthuzad,384,demonhunter,havoc,6,4,2
3113,Tyindron,exodar,384,demonhunter,havoc,6,4,2
3114,Parabolicc,illidan,384,demonhunter,havoc,6,4,2
3115,Blackblades,blackhand,384,demonhunter,havoc,6,4,2
3116,Jinsha,emerald-dream,384,demonhunter,havoc,6,4,2
3117,Felluser,sargeras,384,demonhunter,havoc,6,4,2
3118,Touchmeweird,area-52,384,demonhunter,havoc,6,4,2
3119,Fov,crushridge,384,demonhunter,havoc,6,4,2
3120,Hordesback,illidan,384,demonhunter,havoc,6,4,2
3121,Abakkio,kelthuzad,384,demonhunter,havoc,6,4,2
3122,Intrusive,kelthuzad,384,demonhunter,havoc,6,4,2
3123,Heygriffin,proudmoore,384,demonhunter,havoc,6,4,2
3124,Uncleruckus,bloodscalp,384,demonhunter,havoc,6,4,2
3125,Spasmodiic,illidan,384,demonhunter,havoc,6,4,2
3126,Kasseater,stormrage,384,demonhunter,havoc,6,4,2
3127,Ultear,the-venture-co,384,demonhunter,havoc,6,4,2
3128,Servilletas,spirestone,384,demonhunter,havoc,6,4,2
3129,Whudaz,tichondrius,384,demonhunter,havoc,6,4,2
3130,Florks,area-52,384,demonhunter,havoc,6,4,2
3131,Illidam,arthas,384,demonhunter,havoc,6,4,2
3132,Extínctíon,moon-guard,384,demonhunter,havoc,6,4,2
3133,Tragedydh,sargeras,384,demonhunter,havoc,6,4,2
3134,Nihilist,kaelthas,384,demonhunter,havoc,6,4,2
3135,Ineptbb,frostmourne,384,demonhunter,havoc,6,4,2
3136,Khaosx,ragnaros,384,demonhunter,havoc,6,4,2
3137,Dareassassin,tichondrius,384,demonhunter,havoc,6,4,2
3138,Déörwine,quelthalas,384,demonhunter,havoc,6,4,2
3139,Cwrld,area-52,384,demonhunter,havoc,6,4,2
3140,Darkrëaper,azralon,384,demonhunter,havoc,6,4,2
3141,Mysteryastor,tichondrius,384,demonhunter,havoc,6,4,2
3142,Boonchux,frostmourne,384,demonhunter,havoc,6,4,2
3143,Vyndrestan,dalaran,384,demonhunter,havoc,6,4,2
3144,Darkah,icecrown,384,demonhunter,havoc,6,4,2
3145,Deezhuntz,anvilmar,384,demonhunter,havoc,6,4,2
3146,Jeeprcreeprs,sargeras,384,demonhunter,havoc,6,4,2
3147,Wogarg,sargeras,384,demonhunter,havoc,6,4,2
3148,Bigdingding,area-52,384,demonhunter,havoc,6,4,2
3149,Slyblitz,bleeding-hollow,384,demonhunter,havoc,6,4,2
3150,Tristanzx,sargeras,384,demonhunter,havoc,6,4,2
3151,Yågåmist,dalaran,384,demonhunter,havoc,6,4,2
3152,Cloudzzy,illidan,384,demonhunter,havoc,6,4,2
3153,Diëgo,gallywix,384,demonhunter,havoc,6,4,2
3154,Misriah,sargeras,384,demonhunter,havoc,12,4,8
3155,Separate,stormrage,384,demonhunter,havoc,12,4,8
3156,Pupariuh,illidan,384,demonhunter,havoc,12,4,8
3157,Heallscrean,drakkari,384,demonhunter,havoc,12,4,8
3158,Drîp,moon-guard,384,demonhunter,havoc,12,4,8
3159,Contactfront,whisperwind,384,demonhunter,havoc,12,4,8
3160,Allidox,tichondrius,384,demonhunter,havoc,12,4,8
3161,Sinhful,darkspear,384,demonhunter,havoc,12,4,8
3162,Ahernn,tichondrius,384,demonhunter,havoc,12,4,8
3163,Devilspawnss,barthilas,384,demonhunter,havoc,12,4,8
3164,Butterfinger,greymane,384,demonhunter,havoc,12,4,8
3165,Zoomie,durotan,384,demonhunter,havoc,12,4,8
3166,Reapersauce,illidan,384,demonhunter,havoc,12,4,8
3167,Dhsoop,tichondrius,384,demonhunter,havoc,12,4,8
3168,Vorlimornd,illidan,384,demonhunter,havoc,12,4,8
3169,Maisus,illidan,384,demonhunter,havoc,12,4,8
3170,Vallar,bleeding-hollow,384,demonhunter,havoc,12,4,8
3171,Angelawhite,illidan,384,demonhunter,havoc,12,4,8
3172,Mommafingers,illidan,384,demonhunter,havoc,12,4,8
3173,Zzatmikaze,area-52,384,demonhunter,havoc,12,4,8
3174,Dkdakìng,thrall,384,demonhunter,havoc,12,4,8
3175,Gulios,azralon,384,demonhunter,havoc,12,4,8
3176,Mikemyoffice,illidan,384,demonhunter,havoc,12,4,8
3177,Namthar,quelthalas,384,demonhunter,havoc,12,4,8
3178,Blackclóver,drakkari,384,demonhunter,havoc,12,4,8
3179,Temporarý,bleeding-hollow,384,demonhunter,havoc,12,4,8
3180,Soliit,illidan,384,demonhunter,havoc,12,4,8
3181,Fraxxured,proudmoore,384,demonhunter,havoc,12,4,8
3182,Noliaclap,sargeras,384,demonhunter,havoc,12,4,8
3183,Portgaes,ragnaros,384,demonhunter,havoc,12,4,8
3184,Bazul,tichondrius,384,demonhunter,havoc,12,4,8
3185,Fenthras,thrall,384,demonhunter,havoc,12,4,8
3186,Dystopik,area-52,384,demonhunter,havoc,12,4,8
3187,Anomander,khazgoroth,384,demonhunter,havoc,12,4,8
3188,Uchulu,quelthalas,384,demonhunter,havoc,12,4,8
3189,Dhibjorf,destromath,384,demonhunter,havoc,12,4,8
3190,Zradda,zuljin,384,demonhunter,havoc,12,4,8
3191,Sathsong,tichondrius,384,demonhunter,havoc,12,4,8
3192,Bättousai,kiljaeden,384,demonhunter,havoc,12,4,8
3193,Orsova,area-52,384,demonhunter,havoc,12,4,8
3194,Dhtimes,ragnaros,384,demonhunter,havoc,12,4,8
3195,Kruptikos,tichondrius,384,demonhunter,havoc,12,4,8
3196,Yukimes,frostmourne,384,demonhunter,havoc,12,4,8
3197,Älönë,thrall,384,demonhunter,havoc,12,4,8
3198,Àku,area-52,384,demonhunter,havoc,12,4,8
3199,Dankhuntér,zuljin,384,demonhunter,havoc,12,4,8
3200,Sailtheskys,tichondrius,384,demonhunter,havoc,12,4,8
3201,Alphatoo,area-52,384,demonhunter,havoc,15,4,11
3202,Fuujiin,tol-barad,384,demonhunter,havoc,18,4,14
3203,Roodblurz,zuljin,384,demonhunter,havoc,18,4,14
3204,Severon,stormrage,383,demonhunter,havoc,6,4,2
3205,Demondrëad,lightbringer,383,demonhunter,havoc,9,5,4
3206,Draktyl,bronzebeard,383,demonhunter,havoc,12,4,8
3207,Deathslice,azgalor,383,demonhunter,havoc,12,4,8
3208,Rarespawnjon,tichondrius,383,demonhunter,havoc,12,4,8
3209,Vellinaris,zuljin,383,demonhunter,havoc,12,4,8
3210,Sanllish,illidan,383,demonhunter,havoc,12,4,8
3211,Døffy,area-52,383,demonhunter,havoc,12,4,8
3212,Themurderer,area-52,383,demonhunter,havoc,12,4,8
3213,Sitarok,drakkari,383,demonhunter,havoc,13,4,9
3214,Rouzk,ragnaros,382,demonhunter,havoc,6,4,2
3215,Çherrii,moon-guard,382,demonhunter,havoc,6,4,2
3216,Apaantuh,sargeras,382,demonhunter,havoc,12,4,8
3217,Xiin,cenarion-circle,382,demonhunter,havoc,12,4,8
3218,Saladuoduo,illidan,382,demonhunter,havoc,12,4,8
3219,Anguloke,wyrmrest-accord,381,demonhunter,havoc,10,5,5
3220,Bckzy,sargeras,381,demonhunter,havoc,12,4,8
3221,Killercooter,area-52,381,demonhunter,havoc,12,4,8
3222,Agramun,ragnaros,381,demonhunter,havoc,12,4,8
3223,Polunochnaya,area-52,352,demonhunter,havoc,16,4,12
3224,Findoratoqc,darrowmere,351,demonhunter,havoc,11,4,7
3225,Cassiedemonh,tichondrius,336,demonhunter,havoc,9,5,4
3226,Xiruu,area-52,336,demonhunter,havoc,15,5,10
3227,Unjust,darkspear,336,demonhunter,havoc,15,4,11
3228,Deadlysin,dragonmaw,336,demonhunter,havoc,15,4,11
3229,Cherrycrüsh,sargeras,335,demonhunter,havoc,11,4,7
3230,Fingerjamsx,area-52,335,demonhunter,havoc,11,4,7
3231,Dearborn,frostmourne,330,demonhunter,havoc,16,5,11
3232,Criyn,kelthuzad,330,demonhunter,havoc,17,5,12
3233,Gibbz,wyrmrest-accord,304,demonhunter,havoc,11,5,6
3234,Msbadass,demon-soul,304,demonhunter,havoc,13,4,9
3235,Singueta,stormrage,288,demonhunter,havoc,6,3,3
3236,Fracxures,area-52,288,demonhunter,havoc,6,3,3
3237,Imissher,dalaran,288,demonhunter,havoc,6,3,3
3238,Asukaxox,illidan,288,demonhunter,havoc,6,3,3
3239,Teufelhundn,tichondrius,288,demonhunter,havoc,6,3,3
3240,Thunderrbolt,illidan,288,demonhunter,havoc,6,3,3
3241,Celestez,kelthuzad,288,demonhunter,havoc,6,3,3
3242,Rákdos,illidan,288,demonhunter,havoc,6,3,3
3243,Darkstein,nathrezim,288,demonhunter,havoc,6,3,3
3244,Zurg,wyrmrest-accord,288,demonhunter,havoc,6,3,3
3245,Onedigitiq,thrall,288,demonhunter,havoc,6,3,3
3246,Litan,ragnaros,288,demonhunter,havoc,6,3,3
3247,Gentlesoap,blackrock,288,demonhunter,havoc,6,3,3
3248,Zïlly,blackrock,288,demonhunter,havoc,6,3,3
3249,Kunitsuna,thunderlord,288,demonhunter,havoc,6,3,3
3250,Çreme,tichondrius,288,demonhunter,havoc,6,3,3
3251,Smokepurppx,zuljin,288,demonhunter,havoc,6,3,3
3252,Kylíejennêr,gilneas,288,demonhunter,havoc,6,3,3
3253,Bkeight,dalaran,288,demonhunter,havoc,6,3,3
3254,Relaxnerdss,bleeding-hollow,288,demonhunter,havoc,6,3,3
3255,Vichopan,tichondrius,288,demonhunter,havoc,6,3,3
3256,Shacco,bleeding-hollow,288,demonhunter,havoc,6,3,3
3257,Walk,kul-tiras,288,demonhunter,havoc,6,3,3
3258,Demønical,dalaran,288,demonhunter,havoc,6,3,3
3259,Foodtruck,hellscream,288,demonhunter,havoc,6,3,3
3260,Lyrndrial,wildhammer,288,demonhunter,havoc,6,3,3
3261,Blingtrön,malganis,288,demonhunter,havoc,6,3,3
3262,Businessmaam,malganis,288,demonhunter,havoc,6,3,3
3263,Zeppelìn,stormrage,288,demonhunter,havoc,6,3,3
3264,Cassadega,sargeras,288,demonhunter,havoc,6,3,3
3265,Doomanthree,sargeras,288,demonhunter,havoc,6,3,3
3266,Treyydh,illidan,288,demonhunter,havoc,6,3,3
3267,Felform,area-52,288,demonhunter,havoc,6,3,3
3268,Tink,kilrogg,288,demonhunter,havoc,6,3,3
3269,Mavrii,executus,288,demonhunter,havoc,6,3,3
3270,Âsmodeus,laughing-skull,288,demonhunter,havoc,6,3,3
3271,Walluped,malganis,288,demonhunter,havoc,6,3,3
3272,Pokemibut,frostmourne,288,demonhunter,havoc,6,3,3
3273,Aslowbust,tichondrius,288,demonhunter,havoc,6,3,3
3274,Rhynóe,illidan,288,demonhunter,havoc,6,3,3
3275,Inva,stormrage,288,demonhunter,havoc,6,3,3
3276,Danthedh,illidan,288,demonhunter,havoc,6,3,3
3277,Talsaris,drakthul,288,demonhunter,havoc,6,3,3
3278,Ziyutomioka,moon-guard,288,demonhunter,havoc,6,3,3
3279,Wingsofhavoc,darkspear,288,demonhunter,havoc,6,3,3
3280,Krendron,malganis,288,demonhunter,havoc,6,3,3
3281,Arlequhin,ragnaros,288,demonhunter,havoc,6,3,3
3282,Adycatt,illidan,288,demonhunter,havoc,6,3,3
3283,Ocão,azralon,288,demonhunter,havoc,6,3,3
3284,Riodh,area-52,288,demonhunter,havoc,6,3,3
3285,Cedicdh,illidan,288,demonhunter,havoc,6,3,3
3286,Mèrlyn,sargeras,288,demonhunter,havoc,6,3,3
3287,Gnatman,skywall,288,demonhunter,havoc,6,3,3
3288,Kamakhasi,bleeding-hollow,288,demonhunter,havoc,6,3,3
3289,Illipo,illidan,288,demonhunter,havoc,6,3,3
3290,Llivid,area-52,288,demonhunter,havoc,6,3,3
3291,Gilarian,stormrage,288,demonhunter,havoc,6,3,3
3292,Slodeath,zuljin,288,demonhunter,havoc,6,3,3
3293,Namiisann,terenas,288,demonhunter,havoc,6,3,3
3294,Sourlime,stormrage,288,demonhunter,havoc,6,3,3
3295,Smallsuper,azralon,288,demonhunter,havoc,6,3,3
3296,Yogo,tichondrius,288,demonhunter,havoc,6,3,3
3297,Elgreezy,sargeras,288,demonhunter,havoc,6,3,3
3298,Feltini,whisperwind,288,demonhunter,havoc,6,3,3
3299,Sofedon,kargath,288,demonhunter,havoc,6,3,3
3300,Velerolas,area-52,288,demonhunter,havoc,6,3,3
3301,Sxzure,frostmourne,288,demonhunter,havoc,6,3,3
3302,Songtwo,frostmourne,288,demonhunter,havoc,6,3,3
3303,Touched,guldan,288,demonhunter,havoc,6,3,3
3304,Zalenn,whisperwind,288,demonhunter,havoc,6,3,3
3305,Pub,the-scryers,288,demonhunter,havoc,6,3,3
3306,Rauwèrs,azralon,288,demonhunter,havoc,6,3,3
3307,Kawaiiakitty,tichondrius,288,demonhunter,havoc,6,3,3
3308,Claudija,frostmourne,288,demonhunter,havoc,6,3,3
3309,Dettlaff,sentinels,288,demonhunter,havoc,6,3,3
3310,Noóve,area-52,288,demonhunter,havoc,6,3,3
3311,Blurnomnom,bleeding-hollow,288,demonhunter,havoc,6,3,3
3312,Totheglaive,sargeras,288,demonhunter,havoc,6,3,3
3313,Dhameer,tichondrius,288,demonhunter,havoc,6,3,3
3314,Darkterrôr,sargeras,288,demonhunter,havoc,9,4,5
3315,Asamir,ragnaros,288,demonhunter,havoc,7,3,4
3316,Dhuck,nemesis,288,demonhunter,havoc,15,4,11
3317,Icanmove,area-52,288,demonhunter,havoc,12,3,9
3318,Denadiirx,area-52,288,demonhunter,havoc,12,3,9
3319,Dmfeetpics,dalaran,288,demonhunter,havoc,12,3,9
3320,Dirtyd,dragonmaw,288,demonhunter,havoc,12,3,9
3321,Azziria,aerie-peak,288,demonhunter,havoc,12,3,9
3322,Abrams,tichondrius,288,demonhunter,havoc,12,3,9
3323,Demonichoov,thrall,288,demonhunter,havoc,12,3,9
3324,Gumeasy,tichondrius,288,demonhunter,havoc,12,3,9
3325,Felsa,wyrmrest-accord,288,demonhunter,havoc,12,3,9
3326,Mirante,illidan,288,demonhunter,havoc,12,3,9
3327,Atriax,kelthuzad,288,demonhunter,havoc,12,3,9
3328,Kraky,nemesis,288,demonhunter,havoc,12,3,9
3329,Lawimmortal,tichondrius,288,demonhunter,havoc,12,3,9
3330,Elflerri,area-52,288,demonhunter,havoc,12,3,9
3331,Zudo,amanthul,288,demonhunter,havoc,12,3,9
3332,Çløûdïx,tichondrius,288,demonhunter,havoc,12,3,9
3333,Fleetop,tichondrius,288,demonhunter,havoc,12,3,9
3334,Hemmerdainz,kelthuzad,288,demonhunter,havoc,12,3,9
3335,Skrimpi,dalaran,288,demonhunter,havoc,12,3,9
3336,Ðemonix,tichondrius,288,demonhunter,havoc,12,3,9
3337,Wotlkdh,area-52,288,demonhunter,havoc,12,3,9
3338,Trekt,blades-edge,288,demonhunter,havoc,12,3,9
3339,Rasgon,azralon,288,demonhunter,havoc,12,3,9
3340,Occula,moon-guard,288,demonhunter,havoc,12,3,9
3341,Sammblorqt,illidan,288,demonhunter,havoc,18,3,15
3342,Vellassa,stormscale,288,demonhunter,havoc,18,3,15
3343,Lavantora,tichondrius,288,demonhunter,havoc,23,3,20
3344,Pimm,kelthuzad,287,demonhunter,havoc,6,3,3
3345,Eggandpotato,saurfang,287,demonhunter,havoc,6,3,3
3346,Haydet,stormrage,287,demonhunter,havoc,6,3,3
3347,Holescrewer,tichondrius,287,demonhunter,havoc,6,3,3
3348,Devilina,khadgar,287,demonhunter,havoc,6,3,3
3349,Amneshia,ragnaros,287,demonhunter,havoc,6,3,3
3350,Magoroth,ragnaros,287,demonhunter,havoc,6,3,3
3351,Slixxk,sargeras,287,demonhunter,havoc,9,4,5
3352,Cheriste,malganis,287,demonhunter,havoc,14,4,10
3353,Villoria,kul-tiras,287,demonhunter,havoc,12,3,9
3354,Mindburn,shadowmoon,286,demonhunter,havoc,6,3,3
3355,Lsnusnul,illidan,286,demonhunter,havoc,6,3,3
3356,Psythe,undermine,286,demonhunter,havoc,12,3,9
3357,Dannaris,maelstrom,285,demonhunter,havoc,12,3,9
3358,Pekkora,illidan,284,demonhunter,havoc,12,3,9
3359,Nikator,emerald-dream,255,demonhunter,havoc,11,3,8
3360,Elrr,drakkari,255,demonhunter,havoc,11,3,8
3361,Juantty,area-52,240,demonhunter,havoc,15,3,12
3362,Vickyvette,illidan,239,demonhunter,havoc,5,3,2
3363,Kryzthed,drakkari,233,demonhunter,havoc,13,4,9
3364,Bushwacker,azralon,223,demonhunter,havoc,8,3,5
3365,Onihunter,zangarmarsh,208,demonhunter,havoc,7,3,4
3366,Cobra,quelthalas,208,demonhunter,havoc,7,3,4
3367,Critxclutch,tichondrius,192,demonhunter,havoc,4,3,1
3368,Syrendris,moon-guard,192,demonhunter,havoc,8,3,5
3369,Thedhdream,frostmourne,192,demonhunter,havoc,9,3,6
3370,Rykko,borean-tundra,192,demonhunter,havoc,6,2,4
3371,Shadynãsty,drakthul,192,demonhunter,havoc,6,2,4
3372,Ýizl,ragnaros,192,demonhunter,havoc,6,2,4
3373,Dirtydone,area-52,192,demonhunter,havoc,6,2,4
3374,Ausä,ragnaros,192,demonhunter,havoc,6,2,4
3375,Lilyanie,stormrage,192,demonhunter,havoc,6,2,4
3376,Renoshan,wyrmrest-accord,192,demonhunter,havoc,6,2,4
3377,Ratcnt,barthilas,192,demonhunter,havoc,6,2,4
3378,String,tanaris,192,demonhunter,havoc,6,2,4
3379,Mitsûri,quelthalas,192,demonhunter,havoc,6,2,4
3380,Berquondh,tichondrius,192,demonhunter,havoc,6,2,4
3381,Freddiedread,bladefist,192,demonhunter,havoc,6,2,4
3382,Wartornx,tichondrius,192,demonhunter,havoc,6,2,4
3383,Swagidan,khaz-modan,192,demonhunter,havoc,6,2,4
3384,Renatha,ragnaros,192,demonhunter,havoc,6,2,4
3385,Azshada,shadowmoon,192,demonhunter,havoc,6,2,4
3386,Heptabase,tichondrius,192,demonhunter,havoc,6,2,4
3387,Causinghavoc,dalaran,192,demonhunter,havoc,6,2,4
3388,Cocopapa,tichondrius,192,demonhunter,havoc,6,2,4
3389,Arkynth,dalaran,192,demonhunter,havoc,6,2,4
3390,Sparklepunch,stormrage,192,demonhunter,havoc,6,2,4
3391,Krador,wyrmrest-accord,192,demonhunter,havoc,6,2,4
3392,Muerdun,tichondrius,192,demonhunter,havoc,6,2,4
3393,Atomicsorrow,tichondrius,192,demonhunter,havoc,6,2,4
3394,Trystenn,nagrand,192,demonhunter,havoc,6,2,4
3395,Ivexia,blackrock,192,demonhunter,havoc,6,2,4
3396,Nhoxell,ragnaros,192,demonhunter,havoc,6,2,4
3397,Subsfordubs,illidan,192,demonhunter,havoc,6,2,4
3398,Illimare,tichondrius,192,demonhunter,havoc,6,2,4
3399,Zusi,frostmane,192,demonhunter,havoc,6,2,4
3400,Zarraessa,trollbane,192,demonhunter,havoc,6,2,4
3401,Annmílls,quelthalas,192,demonhunter,havoc,6,2,4
3402,Falan,drakthul,192,demonhunter,havoc,6,2,4
3403,Demonslayyer,saurfang,192,demonhunter,havoc,6,2,4
3404,Cirillas,illidan,192,demonhunter,havoc,6,2,4
3405,Gopump,area-52,192,demonhunter,havoc,6,2,4
3406,Lookatdishoe,tichondrius,192,demonhunter,havoc,6,2,4
3407,Mäläk,zuluhed,192,demonhunter,havoc,6,2,4
3408,Atsudadh,illidan,192,demonhunter,havoc,6,2,4
3409,Metha,kiljaeden,192,demonhunter,havoc,6,2,4
3410,Xannaa,illidan,192,demonhunter,havoc,6,2,4
3411,Kezzaku,frostmourne,192,demonhunter,havoc,6,2,4
3412,Jadyne,frostmourne,192,demonhunter,havoc,6,2,4
3413,Demonwaffle,draka,192,demonhunter,havoc,6,2,4
3414,Demonchild,azralon,192,demonhunter,havoc,6,2,4
3415,Frøppy,illidan,192,demonhunter,havoc,6,2,4
3416,Bleaster,malganis,192,demonhunter,havoc,6,2,4
3417,Sero,malganis,192,demonhunter,havoc,6,2,4
3418,Kayanson,azralon,192,demonhunter,havoc,6,2,4
3419,Cordianx,area-52,192,demonhunter,havoc,6,2,4
3420,Carlibeth,illidan,192,demonhunter,havoc,6,2,4
3421,Showaitie,thrall,192,demonhunter,havoc,6,2,4
3422,Øxxy,azralon,192,demonhunter,havoc,6,2,4
3423,Ossariss,moon-guard,192,demonhunter,havoc,6,2,4
3424,Lovedem,area-52,192,demonhunter,havoc,6,2,4
3425,Reflexin,tichondrius,192,demonhunter,havoc,6,2,4
3426,Daabsdh,thrall,192,demonhunter,havoc,6,2,4
3427,Lilvetis,thrall,192,demonhunter,havoc,6,2,4
3428,Illdaira,windrunner,192,demonhunter,havoc,6,2,4
3429,Kraazi,thrall,192,demonhunter,havoc,6,2,4
3430,Sarithos,frostmourne,192,demonhunter,havoc,6,2,4
3431,Sephmilli,azralon,192,demonhunter,havoc,6,2,4
3432,Xanthrodril,illidan,192,demonhunter,havoc,6,2,4
3433,Wowomg,tichondrius,192,demonhunter,havoc,6,2,4
3434,Spikehed,area-52,192,demonhunter,havoc,6,2,4
3435,Sodí,moon-guard,192,demonhunter,havoc,6,2,4
3436,Illidanmello,proudmoore,192,demonhunter,havoc,6,2,4
3437,Devilweef,whisperwind,192,demonhunter,havoc,6,2,4
3438,Daso,the-forgotten-coast,192,demonhunter,havoc,6,2,4
3439,Ambitiòn,moon-guard,192,demonhunter,havoc,6,2,4
3440,Frino,steamwheedle-cartel,192,demonhunter,havoc,6,2,4
3441,Moxy,kaelthas,192,demonhunter,havoc,6,2,4
3442,Discos,frostmourne,192,demonhunter,havoc,6,2,4
3443,Lillidanss,the-forgotten-coast,192,demonhunter,havoc,6,2,4
3444,Gyutaro,frostmourne,192,demonhunter,havoc,6,2,4
3445,Rkakda,thunderlord,192,demonhunter,havoc,6,2,4
3446,Blynx,destromath,192,demonhunter,havoc,6,2,4
3447,Azuki,lightbringer,192,demonhunter,havoc,6,2,4
3448,Hellishunter,illidan,192,demonhunter,havoc,6,2,4
3449,Yhell,darkspear,192,demonhunter,havoc,6,2,4
3450,Slaymore,sargeras,192,demonhunter,havoc,6,2,4
3451,Imagoon,sargeras,192,demonhunter,havoc,6,2,4
3452,Trackamp,emerald-dream,192,demonhunter,havoc,6,2,4
3453,Elaurenne,sargeras,192,demonhunter,havoc,6,2,4
3454,Arandë,earthen-ring,192,demonhunter,havoc,6,2,4
3455,Bastaghor,stormrage,192,demonhunter,havoc,6,2,4
3456,Cryolite,sargeras,192,demonhunter,havoc,6,2,4
3457,Thesituatíon,sargeras,192,demonhunter,havoc,6,2,4
3458,Logixdh,tichondrius,192,demonhunter,havoc,6,2,4
3459,Zethh,drakkari,192,demonhunter,havoc,6,2,4
3460,Badservice,frostwolf,192,demonhunter,havoc,6,2,4
3461,Aleta,firetree,192,demonhunter,havoc,6,2,4
3462,Skol,andorhal,192,demonhunter,havoc,6,2,4
3463,Daracu,aerie-peak,192,demonhunter,havoc,6,2,4
3464,Jozeez,emerald-dream,192,demonhunter,havoc,6,2,4
3465,Ragath,bonechewer,192,demonhunter,havoc,6,2,4
3466,Buhnana,stormscale,192,demonhunter,havoc,6,2,4
3467,Wreckforce,blades-edge,192,demonhunter,havoc,6,2,4
3468,Texts,norgannon,192,demonhunter,havoc,6,2,4
3469,Rrochy,tichondrius,192,demonhunter,havoc,6,2,4
3470,Hoagiedevil,moon-guard,192,demonhunter,havoc,6,2,4
3471,Vellestia,argent-dawn,192,demonhunter,havoc,6,2,4
3472,Morgoph,burning-legion,192,demonhunter,havoc,6,2,4
3473,Onigirix,area-52,192,demonhunter,havoc,6,2,4
3474,Zeldris,duskwood,192,demonhunter,havoc,6,2,4
3475,Qlmm,stormrage,192,demonhunter,havoc,7,2,5
3476,Hávok,sargeras,192,demonhunter,havoc,7,2,5
3477,Tiristra,cenarion-circle,192,demonhunter,havoc,8,2,6
3478,Daeth,skullcrusher,192,demonhunter,havoc,12,2,10
3479,Denel,laughing-skull,192,demonhunter,havoc,12,2,10
3480,Gyop,azralon,192,demonhunter,havoc,12,2,10
3481,Pokoloko,twisting-nether,192,demonhunter,havoc,12,2,10
3482,Catastroz,ragnaros,192,demonhunter,havoc,12,2,10
3483,Beastforlife,sargeras,192,demonhunter,havoc,12,2,10
3484,Âduka,illidan,192,demonhunter,havoc,12,2,10
3485,Kyska,tichondrius,192,demonhunter,havoc,12,2,10
3486,Melantharia,wyrmrest-accord,192,demonhunter,havoc,12,2,10
3487,Halaena,moon-guard,192,demonhunter,havoc,12,2,10
3488,Kushz,dalaran,192,demonhunter,havoc,12,2,10
3489,Hollownight,area-52,192,demonhunter,havoc,12,2,10
3490,Illidunk,tichondrius,192,demonhunter,havoc,12,2,10
3491,Boofdh,illidan,192,demonhunter,havoc,12,2,10
3492,Proserpinâ,bleeding-hollow,192,demonhunter,havoc,12,2,10
3493,Spacéphoenix,stormrage,192,demonhunter,havoc,12,2,10
3494,Asharian,wyrmrest-accord,192,demonhunter,havoc,12,2,10
3495,Funspunk,nagrand,192,demonhunter,havoc,18,2,16
3496,Teethdaggers,wyrmrest-accord,191,demonhunter,havoc,6,2,4
3497,Tarasam,burning-blade,191,demonhunter,havoc,12,2,10
3498,Feilixx,moon-guard,190,demonhunter,havoc,12,2,10
3499,Ryoga,malganis,159,demonhunter,havoc,5,2,3
3500,Theweektwo,drakkari,159,demonhunter,havoc,11,2,9
3501,Refused,nesingwary,138,demonhunter,havoc,11,4,7
3502,Criolex,stormrage,138,demonhunter,havoc,9,3,6
3503,Shanjara,sargeras,138,demonhunter,havoc,15,3,12
3504,Xeil,zuljin,128,demonhunter,havoc,4,2,2
3505,Zanecksbinge,skullcrusher,128,demonhunter,havoc,4,2,2
3506,Kümï,quelthalas,96,demonhunter,havoc,3,2,1
3507,Tättø,area-52,96,demonhunter,havoc,3,2,1
3508,Litball,stormrage,96,demonhunter,havoc,3,2,1
3509,Giantryhard,tichondrius,96,demonhunter,havoc,6,1,5
3510,Eibizoudh,sargeras,96,demonhunter,havoc,6,1,5
3511,Constantwood,sargeras,96,demonhunter,havoc,6,1,5
3512,Mythundorn,burning-blade,96,demonhunter,havoc,6,1,5
3513,Musewine,tichondrius,96,demonhunter,havoc,6,1,5
3514,Vëngêåncé,tichondrius,96,demonhunter,havoc,6,1,5
3515,Chirøn,darkspear,96,demonhunter,havoc,6,1,5
3516,Negraxo,ragnaros,96,demonhunter,havoc,6,1,5
3517,Jerry,emerald-dream,96,demonhunter,havoc,6,1,5
3518,Theysuffer,scilla,96,demonhunter,havoc,6,1,5
3519,Wubloadz,bleeding-hollow,96,demonhunter,havoc,6,1,5
3520,Hausecat,aegwynn,96,demonhunter,havoc,6,1,5
3521,Elillidan,emerald-dream,96,demonhunter,havoc,6,1,5
3522,Terpenese,chogall,96,demonhunter,havoc,6,1,5
3523,Marxefel,ragnaros,96,demonhunter,havoc,6,1,5
3524,Frenchtoast,bonechewer,96,demonhunter,havoc,6,1,5
3525,Mazïkeen,uther,96,demonhunter,havoc,6,1,5
3526,Ðemonhunterx,frostmourne,96,demonhunter,havoc,6,1,5
3527,Glaivee,dalaran,96,demonhunter,havoc,6,1,5
3528,Painqtxo,area-52,96,demonhunter,havoc,6,1,5
3529,Jekyldh,tichondrius,96,demonhunter,havoc,6,1,5
3530,Devî,ragnaros,96,demonhunter,havoc,6,1,5
3531,Chris,nordrassil,96,demonhunter,havoc,6,1,5
3532,Scarolol,malganis,96,demonhunter,havoc,6,1,5
3533,Demonleàf,area-52,96,demonhunter,havoc,6,1,5
3534,Lauriale,moon-guard,96,demonhunter,havoc,6,1,5
3535,Gil,moonrunner,96,demonhunter,havoc,6,1,5
3536,Boatsnhoze,tichondrius,96,demonhunter,havoc,6,1,5
3537,Chakan,burning-legion,96,demonhunter,havoc,6,1,5
3538,Itsplague,tichondrius,96,demonhunter,havoc,6,1,5
3539,Chad,anvilmar,96,demonhunter,havoc,6,1,5
3540,Nightsatan,stormrage,96,demonhunter,havoc,6,1,5
3541,Félmoose,moon-guard,96,demonhunter,havoc,6,1,5
3542,Treblig,nerzhul,96,demonhunter,havoc,6,1,5
3543,Izruul,tichondrius,96,demonhunter,havoc,6,1,5
3544,Sado,proudmoore,96,demonhunter,havoc,6,1,5
3545,Esøteric,area-52,96,demonhunter,havoc,6,1,5
3546,Slycerr,illidan,96,demonhunter,havoc,6,1,5
3547,Thêworld,azralon,96,demonhunter,havoc,6,1,5
3548,Snazzyy,kelthuzad,96,demonhunter,havoc,6,1,5
3549,Misakidh,sargeras,96,demonhunter,havoc,6,1,5
3550,Siegfridemon,ragnaros,96,demonhunter,havoc,6,1,5
3551,Sternhunt,khadgar,96,demonhunter,havoc,6,1,5
3552,Safikins,tichondrius,96,demonhunter,havoc,6,1,5
3553,Vaestl,zuljin,96,demonhunter,havoc,6,1,5
3554,Memslaw,tichondrius,96,demonhunter,havoc,6,1,5
3555,Varanidae,kelthuzad,96,demonhunter,havoc,6,1,5
3556,Skylinetime,sargeras,96,demonhunter,havoc,6,1,5
3557,Carrîôn,tichondrius,96,demonhunter,havoc,6,1,5
3558,Reezi,sargeras,96,demonhunter,havoc,6,1,5
3559,Anabolicbro,tichondrius,96,demonhunter,havoc,6,1,5
3560,Akammy,proudmoore,96,demonhunter,havoc,6,1,5
3561,Jhinskui,drakkari,96,demonhunter,havoc,6,1,5
3562,Kazadin,azralon,96,demonhunter,havoc,6,1,5
3563,Finnanutt,tichondrius,96,demonhunter,havoc,6,1,5
3564,Majindemon,dragonmaw,96,demonhunter,havoc,6,1,5
3565,Cidolem,area-52,96,demonhunter,havoc,6,1,5
3566,Ellguindh,malganis,96,demonhunter,havoc,6,1,5
3567,Roat,malganis,96,demonhunter,havoc,6,1,5
3568,Demønvil,onyxia,96,demonhunter,havoc,6,1,5
3569,Dhrongor,drakkari,96,demonhunter,havoc,6,1,5
3570,Gosrend,durotan,96,demonhunter,havoc,7,1,6
3571,Lantherin,sargeras,96,demonhunter,havoc,11,1,10
3572,Moonsocks,proudmoore,96,demonhunter,havoc,12,1,11
3573,Gnocchis,thrall,96,demonhunter,havoc,12,1,11
3574,Ichigoo,arthas,96,demonhunter,havoc,12,1,11
3575,Aríes,dreadmaul,94,demonhunter,havoc,4,3,1
3576,Vespherie,moon-guard,84,demonhunter,havoc,8,5,3
3577,Byzzel,barthilas,79,demonhunter,havoc,5,1,4
3578,Miskiiv,malganis,79,demonhunter,havoc,5,1,4
3579,Fellchapo,illidan,79,demonhunter,havoc,5,1,4
3580,Zetsuwaffles,area-52,79,demonhunter,havoc,5,1,4
3581,Demonbluntzz,tichondrius,79,demonhunter,havoc,11,1,10
3582,Shadevon,wyrmrest-accord,64,demonhunter,havoc,4,1,3
3583,Mcthiccyy,moon-guard,64,demonhunter,havoc,4,1,3
3584,Elena,the-underbog,64,demonhunter,havoc,4,1,3
3585,Quinny,runetotem,48,demonhunter,havoc,3,1,2
3586,Quoates,dalaran,48,demonhunter,havoc,3,1,2
3587,Aryía,stormrage,48,demonhunter,havoc,3,1,2
3588,Lifefery,quelthalas,48,demonhunter,havoc,3,1,2
3589,Raptorjèsus,azjolnerub,48,demonhunter,havoc,3,1,2
3590,Jizzidari,frostmourne,48,demonhunter,havoc,3,1,2
3591,Healinfubar,stormrage,47,demonhunter,havoc,3,2,1
3592,Xaryic,stormrage,42,demonhunter,havoc,16,5,11
3593,Worcraf,ragnaros,42,demonhunter,havoc,8,2,6
3594,Pooterjuice,shadowmoon,31,demonhunter,havoc,2,1,1
3595,Lathazar,darkspear,16,demonhunter,havoc,1,1,0
3596,Iwasright,stonemaul,1488,demonhunter,vengeance,72,35,37
3597,Slippedinfel,tichondrius,1335,demonhunter,vengeance,47,22,25
3598,Jersey,proudmoore,1091,demonhunter,vengeance,29,17,12
3599,Nights,greymane,566,demonhunter,vengeance,12,6,6
3600,Agricornia,tichondrius,475,demonhunter,vengeance,12,5,7
3601,Irisand,ragnaros,288,demonhunter,vengeance,6,3,3
3602,Ferano,frostmourne,288,demonhunter,vengeance,6,3,3
3603,Çherrii,moon-guard,286,demonhunter,vengeance,6,3,3
3604,Tilltheend,illidan,239,demonhunter,vengeance,5,3,2
3605,Asderel,zuljin,192,demonhunter,vengeance,6,2,4
3606,Meliødaz,ragnaros,192,demonhunter,vengeance,12,2,10
3607,Shiningvenus,stormrage,192,demonhunter,vengeance,12,2,10
3608,Daymanhunter,bleeding-hollow,96,demonhunter,vengeance,6,1,5
3609,Aleymar,tichondrius,96,demonhunter,vengeance,6,1,5
3610,Foodtruck,hellscream,96,demonhunter,vengeance,6,1,5
3611,Grovetenderx,tichondrius,2238,druid,restoration,86,53,33
3612,Flóp,dalaran,2238,druid,restoration,90,53,37
3613,Renner,zuljin,2192,druid,restoration,109,57,52
3614,Kobaishome,tichondrius,2148,druid,restoration,119,70,49
3615,Linful,tichondrius,2141,druid,restoration,179,92,87
3616,Omkin,tichondrius,2137,druid,restoration,120,62,58
3617,Angrygochux,tichondrius,2132,druid,restoration,148,79,69
3618,Liangpibro,illidan,2123,druid,restoration,85,54,31
3619,Bestrun,tichondrius,2116,druid,restoration,108,58,50
3620,Szwlol,tichondrius,2105,druid,restoration,315,170,145
3621,Andrwceo,stormrage,2104,druid,restoration,60,37,23
3622,Couragé,ragnaros,2098,druid,restoration,147,73,74
3623,Davidqx,zuljin,2060,druid,restoration,72,47,25
3624,Gotheelsx,illidan,2056,druid,restoration,137,67,70
3625,Commercii,tichondrius,2043,druid,restoration,72,42,30
3626,Vers,dathremar,2037,druid,restoration,90,43,47
3627,Shaylyne,moonrunner,2026,druid,restoration,69,41,28
3628,Dannycarry,tichondrius,2025,druid,restoration,59,32,27
3629,Racialmotive,illidan,2017,druid,restoration,134,76,58
3630,Rorae,tichondrius,2000,druid,restoration,167,85,82
3631,Hchls,tichondrius,1996,druid,restoration,152,77,75
3632,Taiwanzz,tichondrius,1994,druid,restoration,79,40,39
3633,Taaienberg,sargeras,1991,druid,restoration,66,34,32
3634,Sanlunainiu,tichondrius,1976,druid,restoration,178,82,96
3635,Brenden,area-52,1958,druid,restoration,150,76,74
3636,Rbavny,tichondrius,1954,druid,restoration,42,25,17
3637,Pornkkimi,tichondrius,1952,druid,restoration,48,29,19
3638,Plorenz,zuljin,1952,druid,restoration,89,51,38
3639,Mengniulol,tichondrius,1947,druid,restoration,179,100,79
3640,Flowen,spinebreaker,1940,druid,restoration,78,39,39
3641,Tizzyy,eredar,1921,druid,restoration,78,43,35
3642,Gotheels,illidan,1910,druid,restoration,41,29,12
3643,Guqingshuang,tichondrius,1905,druid,restoration,85,43,42
3644,Shiftýx,tichondrius,1905,druid,restoration,77,38,39
3645,Sanitizer,tichondrius,1902,druid,restoration,66,38,28
3646,Dancesdru,area-52,1888,druid,restoration,36,20,16
3647,Treenleaves,stormrage,1888,druid,restoration,493,260,233
3648,Saxhouse,illidan,1881,druid,restoration,60,34,26
3649,Nikdruidne,tichondrius,1881,druid,restoration,60,29,31
3650,Darkenëd,dalaran,1880,druid,restoration,68,41,27
3651,Aryawilliams,area-52,1880,druid,restoration,65,36,29
3652,Lenya,bleeding-hollow,1877,druid,restoration,69,38,31
3653,Eddí,illidan,1872,druid,restoration,64,32,32
3654,Bashthecat,tichondrius,1871,druid,restoration,59,39,20
3655,Xijinfing,tichondrius,1870,druid,restoration,42,25,17
3656,Rindy,rexxar,1869,druid,restoration,72,37,35
3657,Ksz,stormrage,1867,druid,restoration,42,25,17
3658,Holydruid,tichondrius,1867,druid,restoration,83,43,40
3659,Represent,tichondrius,1864,druid,restoration,48,26,22
3660,Lotiononmyd,illidan,1860,druid,restoration,153,85,68
3661,Héisénbérg,sargeras,1857,druid,restoration,117,65,52
3662,Corbind,arthas,1853,druid,restoration,250,132,118
3663,Oinkme,kiljaeden,1853,druid,restoration,78,38,40
3664,Druuná,kiljaeden,1852,druid,restoration,81,37,44
3665,Bexdru,area-52,1850,druid,restoration,284,151,133
3666,Psam,emerald-dream,1848,druid,restoration,53,29,24
3667,Lvse,tichondrius,1847,druid,restoration,54,34,20
3668,Rèmix,bleeding-hollow,1847,druid,restoration,42,23,19
3669,Qdeb,akama,1844,druid,restoration,48,27,21
3670,Vesoween,tichondrius,1843,druid,restoration,55,37,18
3671,Creamcow,tichondrius,1843,druid,restoration,52,28,24
3672,Esque,stormrage,1842,druid,restoration,48,24,24
3673,Tokesh,malganis,1840,druid,restoration,72,33,39
3674,Washedgodx,mugthol,1839,druid,restoration,59,34,25
3675,Mimidelol,tichondrius,1839,druid,restoration,66,36,30
3676,Clameo,barthilas,1839,druid,restoration,102,48,54
3677,Gluesmoka,icecrown,1836,druid,restoration,54,31,23
3678,Reehz,stormrage,1834,druid,restoration,53,25,28
3679,Leafowl,tichondrius,1830,druid,restoration,42,25,17
3680,Bodytwisting,tichondrius,1828,druid,restoration,48,29,19
3681,Pvpgold,illidan,1827,druid,restoration,71,39,32
3682,Rerolldr,firetree,1826,druid,restoration,42,24,18
3683,Germlol,sargeras,1825,druid,restoration,51,30,21
3684,Heymeow,tichondrius,1825,druid,restoration,60,24,36
3685,Brendenjr,area-52,1819,druid,restoration,45,32,13
3686,Jegara,auchindoun,1818,druid,restoration,149,81,68
3687,Badtree,tichondrius,1816,druid,restoration,104,63,41
3688,Currants,lightbringer,1815,druid,restoration,138,64,74
3689,Jbdontplay,sargeras,1812,druid,restoration,59,37,22
3690,Tunnaris,ragnaros,1811,druid,restoration,71,33,38
3691,Kenái,nemesis,1810,druid,restoration,30,19,11
3692,Hlchs,tichondrius,1810,druid,restoration,36,22,14
3693,Corcovado,bleeding-hollow,1809,druid,restoration,66,31,35
3694,Udoyu,barthilas,1807,druid,restoration,66,28,38
3695,Aljalladtv,bleeding-hollow,1805,druid,restoration,30,19,11
3696,Yggdrasil,ravencrest,1805,druid,restoration,65,31,34
3697,Kayorva,gurubashi,1804,druid,restoration,47,24,23
3698,Playstyle,stormrage,1801,druid,restoration,49,25,24
3699,Nayko,sargeras,1801,druid,restoration,72,30,42
3700,Ivý,shadowsong,1800,druid,restoration,41,28,13
3701,Mengyu,tichondrius,1800,druid,restoration,64,41,23
3702,Kobrah,twisting-nether,1800,druid,restoration,36,20,16
3703,Blueclàssxx,akama,1796,druid,restoration,52,41,11
3704,Reizzy,sargeras,1793,druid,restoration,72,35,37
3705,Loudswords,barthilas,1784,druid,restoration,54,29,25
3706,Softpawz,kelthuzad,1782,druid,restoration,35,19,16
3707,Ekr,tichondrius,1779,druid,restoration,54,29,25
3708,Jdown,dalaran,1772,druid,restoration,76,43,33
3709,Maen,kelthuzad,1771,druid,restoration,70,32,38
3710,Geddoff,stormrage,1770,druid,restoration,111,51,60
3711,Kruisberg,sargeras,1769,druid,restoration,29,19,10
3712,Sùlyvahn,tichondrius,1761,druid,restoration,57,30,27
3713,Tweeguy,malganis,1761,druid,restoration,78,33,45
3714,Dsheeps,tichondrius,1760,druid,restoration,48,27,21
3715,Gsex,nemesis,1760,druid,restoration,40,22,18
3716,Moldragon,crushridge,1758,druid,restoration,48,24,24
3717,Gloomster,tichondrius,1756,druid,restoration,64,37,27
3718,Facegotrake,stormrage,1748,druid,restoration,78,47,31
3719,Naturae,spirestone,1742,druid,restoration,188,103,85
3720,Caipirinha,tichondrius,1742,druid,restoration,35,19,16
3721,Surefacts,dathremar,1738,druid,restoration,40,21,19
3722,Branchmanagr,dark-iron,1736,druid,restoration,54,23,31
3723,Janzak,thrall,1735,druid,restoration,36,20,16
3724,Airmeodaddy,barthilas,1730,druid,restoration,44,24,20
3725,Fattdiabetic,tichondrius,1726,druid,restoration,42,24,18
3726,Xgodhands,sargeras,1724,druid,restoration,24,18,6
3727,Anaps,frostmourne,1724,druid,restoration,60,35,25
3728,Spiritot,tichondrius,1724,druid,restoration,42,22,20
3729,Thasta,blackrock,1723,druid,restoration,116,62,54
3730,Thundercast,quelthalas,1720,druid,restoration,128,66,62
3731,Zrobloom,stormrage,1720,druid,restoration,69,29,40
3732,Dirtdog,uther,1719,druid,restoration,53,25,28
3733,Bigtimers,illidan,1717,druid,restoration,36,18,18
3734,Ymy,tichondrius,1716,druid,restoration,36,21,15
3735,Soreze,kelthuzad,1714,druid,restoration,44,28,16
3736,Kwd,stormrage,1712,druid,restoration,65,43,22
3737,Fruitberry,malganis,1710,druid,restoration,42,18,24
3738,Drjelly,tichondrius,1707,druid,restoration,76,32,44
3739,Huaxià,tichondrius,1705,druid,restoration,209,114,95
3740,Yungdoinkski,icecrown,1704,druid,restoration,28,19,9
3741,Hideurkidz,tichondrius,1699,druid,restoration,39,23,16
3742,Pizzatimex,zuluhed,1698,druid,restoration,72,38,34
3743,Flowdruid,tichondrius,1698,druid,restoration,45,22,23
3744,Dmxx,kiljaeden,1696,druid,restoration,33,19,14
3745,Remus,hydraxis,1696,druid,restoration,48,23,25
3746,Gankstanerdz,tichondrius,1694,druid,restoration,148,68,80
3747,Socialyst,area-52,1688,druid,restoration,35,21,14
3748,Lifeboomer,ragnaros,1684,druid,restoration,61,41,20
3749,Polyester,frostmourne,1679,druid,restoration,54,25,29
3750,Dabloleu,illidan,1675,druid,restoration,24,19,5
3751,Roen,tichondrius,1672,druid,restoration,40,21,19
3752,Boonsogan,tichondrius,1672,druid,restoration,36,18,18
3753,Afkhottedyou,suramar,1667,druid,restoration,46,24,22
3754,Ellystarry,stormrage,1666,druid,restoration,48,24,24
3755,Bobd,proudmoore,1664,druid,restoration,36,19,17
3756,Legitonedge,zuljin,1662,druid,restoration,55,30,25
3757,Addiedru,zuljin,1659,druid,restoration,63,30,33
3758,Bramii,illidan,1657,druid,restoration,51,28,23
3759,Zoteqt,kelthuzad,1657,druid,restoration,48,25,23
3760,Cienza,proudmoore,1651,druid,restoration,192,98,94
3761,Druidstin,tichondrius,1649,druid,restoration,162,84,78
3762,Defteras,illidan,1647,druid,restoration,42,21,21
3763,Sooey,wyrmrest-accord,1646,druid,restoration,79,46,33
3764,Animalge,sargeras,1643,druid,restoration,60,25,35
3765,Woshiyigede,frostmourne,1642,druid,restoration,66,29,37
3766,Dendrix,area-52,1641,druid,restoration,90,46,44
3767,Gsëx,nemesis,1640,druid,restoration,47,22,25
3768,Images,kilrogg,1638,druid,restoration,54,37,17
3769,Birdfromtree,dalaran,1636,druid,restoration,48,26,22
3770,Pootyleaf,daggerspine,1636,druid,restoration,60,28,32
3771,Zblmystic,tichondrius,1635,druid,restoration,60,33,27
3772,Légz,area-52,1634,druid,restoration,94,49,45
3773,Luckyslot,frostmourne,1631,druid,restoration,36,21,15
3774,Widescreen,burning-blade,1630,druid,restoration,318,168,150
3775,Dexlol,area-52,1629,druid,restoration,18,17,1
3776,Pawsbutton,stormrage,1629,druid,restoration,30,20,10
3777,Viscentdd,illidan,1626,druid,restoration,36,17,19
3778,Acdru,tichondrius,1624,druid,restoration,54,26,28
3779,Sarrati,emerald-dream,1623,druid,restoration,182,98,84
3780,Wolfis,malganis,1622,druid,restoration,36,20,16
3781,Notpodruida,tichondrius,1621,druid,restoration,36,21,15
3782,Cybeé,sargeras,1621,druid,restoration,48,19,29
3783,Chevy,onyxia,1619,druid,restoration,66,23,43
3784,Lobsterdruid,area-52,1617,druid,restoration,36,21,15
3785,Kaperij,sargeras,1617,druid,restoration,30,17,13
3786,Asmitar,illidan,1616,druid,restoration,36,22,14
3787,Muhu,frostmourne,1615,druid,restoration,60,35,25
3788,Shinjis,tichondrius,1615,druid,restoration,36,18,18
3789,Gødriç,tichondrius,1614,druid,restoration,221,112,109
3790,Gulperberg,sargeras,1612,druid,restoration,30,25,5
3791,Hxm,tichondrius,1611,druid,restoration,35,17,18
3792,Hideurchickn,tichondrius,1609,druid,restoration,36,23,13
3793,Douwantoplay,tichondrius,1607,druid,restoration,60,32,28
3794,Fhiziod,kelthuzad,1606,druid,restoration,74,44,30
3795,Wìms,malganis,1606,druid,restoration,36,20,16
3796,Tayriel,area-52,1606,druid,restoration,42,19,23
3797,Jathy,area-52,1606,druid,restoration,51,21,30
3798,Kurrious,frostmourne,1605,druid,restoration,40,18,22
3799,Yavannita,quelthalas,1600,druid,restoration,57,36,21
3800,Hehaw,kelthuzad,1600,druid,restoration,152,87,65
3801,Manycyclones,zuluhed,1598,druid,restoration,60,32,28
3802,Relbedo,sargeras,1598,druid,restoration,138,73,65
3803,Gonimydear,proudmoore,1598,druid,restoration,138,70,68
3804,Erral,malganis,1597,druid,restoration,57,26,31
3805,Kaleaky,thrall,1595,druid,restoration,99,53,46
3806,Tondrai,malganis,1593,druid,restoration,30,17,13
3807,Sixthsex,tichondrius,1593,druid,restoration,83,43,40
3808,Errane,eonar,1587,druid,restoration,193,107,86
3809,Cheddy,tichondrius,1585,druid,restoration,71,38,33
3810,Dbk,suramar,1584,druid,restoration,146,88,58
3811,Poscow,tichondrius,1583,druid,restoration,45,25,20
3812,Durintor,nemesis,1582,druid,restoration,129,67,62
3813,Silentbeer,frostmourne,1581,druid,restoration,168,86,82
3814,Druinin,archimonde,1581,druid,restoration,74,32,42
3815,Aberdare,tichondrius,1574,druid,restoration,123,71,52
3816,Boomtastik,frostmourne,1574,druid,restoration,108,46,62
3817,Methyld,frostmourne,1574,druid,restoration,90,36,54
3818,Møøncry,ragnaros,1571,druid,restoration,154,73,81
3819,Bitsandbobs,tichondrius,1570,druid,restoration,47,19,28
3820,Nerfthedruid,blackrock,1569,druid,restoration,36,25,11
3821,Rizzit,wyrmrest-accord,1568,druid,restoration,173,97,76
3822,Duragx,bleeding-hollow,1567,druid,restoration,100,62,38
3823,Arwëna,tichondrius,1566,druid,restoration,60,34,26
3824,Sanninx,barthilas,1566,druid,restoration,36,18,18
3825,Frydaze,tichondrius,1564,druid,restoration,42,21,21
3826,Breaksilence,tichondrius,1563,druid,restoration,29,18,11
3827,Èmax,barthilas,1560,druid,restoration,31,19,12
3828,Classydruid,spinebreaker,1560,druid,restoration,205,109,96
3829,Riiccflaiir,stormrage,1559,druid,restoration,56,32,24
3830,Zyzzema,frostmourne,1559,druid,restoration,174,82,92
3831,Druxe,zuljin,1555,druid,restoration,85,38,47
3832,Poscod,tichondrius,1552,druid,restoration,48,22,26
3833,Hayase,tichondrius,1551,druid,restoration,42,25,17
3834,Maplêleaf,moon-guard,1551,druid,restoration,163,89,74
3835,Gunnymad,tichondrius,1549,druid,restoration,36,21,15
3836,Psyqobloom,dalaran,1548,druid,restoration,82,45,37
3837,Zyhsul,emerald-dream,1546,druid,restoration,137,65,72
3838,Bedlam,zuljin,1544,druid,restoration,60,25,35
3839,Meruemoo,tichondrius,1543,druid,restoration,362,183,179
3840,Moonyy,emerald-dream,1542,druid,restoration,42,20,22
3841,Hdruid,tichondrius,1540,druid,restoration,77,40,37
3842,Soheezy,illidan,1539,druid,restoration,102,60,42
3843,Lubbeck,stormrage,1538,druid,restoration,98,53,45
3844,Drudma,shadowmoon,1538,druid,restoration,48,23,25
3845,Evokade,dalaran,1534,druid,restoration,42,28,14
3846,Zhn,sargeras,1534,druid,restoration,29,19,10
3847,Hravan,dentarg,1534,druid,restoration,49,26,23
3848,Bigmoran,tichondrius,1534,druid,restoration,36,16,20
3849,Nikotser,dreadmaul,1531,druid,restoration,39,18,21
3850,Qidzerker,arathor,1530,druid,restoration,89,44,45
3851,Shapedance,sargeras,1530,druid,restoration,60,27,33
3852,Creamjr,tichondrius,1528,druid,restoration,30,16,14
3853,Unis,tichondrius,1528,druid,restoration,37,19,18
3854,Rougaroux,andorhal,1527,druid,restoration,54,24,30
3855,Spurzky,emerald-dream,1526,druid,restoration,46,26,20
3856,Pilcosbie,stormrage,1526,druid,restoration,42,21,21
3857,Terkpla,ragnaros,1525,druid,restoration,71,37,34
3858,Mortqt,tichondrius,1524,druid,restoration,96,44,52
3859,Lilbigcow,gnomeregan,1515,druid,restoration,176,77,99
3860,Manzar,illidan,1514,druid,restoration,30,17,13
3861,Ursiiday,sargeras,1507,druid,restoration,60,22,38
3862,Meniscus,arthas,1506,druid,restoration,53,19,34
3863,Seamandeman,sargeras,1504,druid,restoration,90,49,41
3864,Baduret,dalaran,1503,druid,restoration,43,27,16
3865,Kimnim,tichondrius,1500,druid,restoration,106,57,49
3866,Redpigo,tichondrius,1497,druid,restoration,36,18,18
3867,Pëndulum,illidan,1497,druid,restoration,66,29,37
3868,Redo,zuluhed,1496,druid,restoration,30,16,14
3869,Gìtgoodtrash,frostmourne,1494,druid,restoration,76,39,37
3870,Morphiq,tichondrius,1493,druid,restoration,123,63,60
3871,Akeven,illidan,1491,druid,restoration,68,31,37
3872,Poliage,moon-guard,1489,druid,restoration,99,44,55
3873,Rowlex,moon-guard,1483,druid,restoration,22,17,5
3874,Knottywood,muradin,1481,druid,restoration,53,28,25
3875,Stonemonkey,sargeras,1480,druid,restoration,85,38,47
3876,Gizho,dark-iron,1476,druid,restoration,33,19,14
3877,Selling,moon-guard,1476,druid,restoration,60,27,33
3878,Growl,jubeithos,1476,druid,restoration,48,19,29
3879,Rlzdruid,tichondrius,1474,druid,restoration,70,31,39
3880,Lutein,tichondrius,1474,druid,restoration,77,31,46
3881,Dkfm,thrall,1467,druid,restoration,404,207,197
3882,Cndistance,tichondrius,1467,druid,restoration,71,34,37
3883,Bobx,kelthuzad,1467,druid,restoration,66,26,40
3884,Spuncone,frostmourne,1463,druid,restoration,42,24,18
3885,Unpeelable,stormrage,1460,druid,restoration,24,16,8
3886,Volktots,bleeding-hollow,1459,druid,restoration,60,34,26
3887,Elliar,akama,1459,druid,restoration,72,35,37
3888,Staraborn,stormrage,1458,druid,restoration,249,135,114
3889,Rasgabuxoh,azralon,1458,druid,restoration,30,16,14
3890,Utterhots,bleeding-hollow,1457,druid,restoration,146,81,65
3891,Xhoz,tichondrius,1457,druid,restoration,201,109,92
3892,Faramar,sargeras,1456,druid,restoration,35,16,19
3893,Berzz,frostmourne,1455,druid,restoration,217,105,112
3894,Cutely,tichondrius,1452,druid,restoration,153,77,76
3895,Verkara,stormrage,1452,druid,restoration,76,35,41
3896,Meepø,mugthol,1451,druid,restoration,103,56,47
3897,Busanmilk,tichondrius,1445,druid,restoration,60,29,31
3898,Rikishi,executus,1441,druid,restoration,52,27,25
3899,Clubroot,sargeras,1437,druid,restoration,42,17,25
3900,Drøgbä,tichondrius,1436,druid,restoration,24,15,9
3901,Aiyouyou,tichondrius,1436,druid,restoration,159,85,74
3902,Lusam,korialstrasz,1435,druid,restoration,40,23,17
3903,Jonnygg,illidan,1433,druid,restoration,36,15,21
3904,Vuru,azralon,1432,druid,restoration,72,33,39
3905,Eviltwín,frostmourne,1431,druid,restoration,36,20,16
3906,Swiftydel,frostmourne,1431,druid,restoration,52,27,25
3907,Sakpase,area-52,1428,druid,restoration,30,15,15
3908,Grimo,illidan,1427,druid,restoration,38,23,15
3909,Thornblade,stormrage,1427,druid,restoration,30,15,15
3910,Strokingmyd,illidan,1427,druid,restoration,63,31,32
3911,Greylyth,moon-guard,1426,druid,restoration,54,25,29
3912,Hyne,emerald-dream,1425,druid,restoration,114,62,52
3913,Bruujz,moon-guard,1424,druid,restoration,54,33,21
3914,Shirô,bleeding-hollow,1421,druid,restoration,115,59,56
3915,Skêet,tichondrius,1420,druid,restoration,37,24,13
3916,Prevail,nazgrel,1420,druid,restoration,127,66,61
3917,Lauramavra,azralon,1419,druid,restoration,273,143,130
3918,Lucked,tichondrius,1415,druid,restoration,24,15,9
3919,Komaner,frostmourne,1414,druid,restoration,48,21,27
3920,Kaerrort,sargeras,1412,druid,restoration,26,15,11
3921,Approx,tichondrius,1409,druid,restoration,145,68,77
3922,Ozanji,wyrmrest-accord,1406,druid,restoration,30,17,13
3923,Gôdôfwow,tichondrius,1402,druid,restoration,77,31,46
3924,Biggucci,stonemaul,1399,druid,restoration,30,18,12
3925,Darimmx,mannoroth,1397,druid,restoration,84,44,40
3926,Maviç,hyjal,1397,druid,restoration,96,50,46
3927,Cyclone,mugthol,1396,druid,restoration,24,19,5
3928,Leleoceo,azralon,1396,druid,restoration,24,15,9
3929,Haymade,sargeras,1396,druid,restoration,78,36,42
3930,Seizuressld,stormrage,1395,druid,restoration,81,46,35
3931,Arkenix,velen,1395,druid,restoration,36,17,19
3932,Murkeÿ,frostmourne,1391,druid,restoration,24,15,9
3933,Lorern,eldrethalas,1390,druid,restoration,60,30,30
3934,Lexut,ragnaros,1388,druid,restoration,36,16,20
3935,Oobuck,kilrogg,1386,druid,restoration,87,47,40
3936,Diglit,malganis,1386,druid,restoration,40,18,22
3937,Nanniel,tichondrius,1383,druid,restoration,54,24,30
3938,Icastsmells,tichondrius,1381,druid,restoration,57,36,21
3939,Okiesmokied,proudmoore,1378,druid,restoration,30,17,13
3940,Nestaballo,illidan,1375,druid,restoration,117,63,54
3941,Lostnsauce,tichondrius,1375,druid,restoration,72,30,42
3942,Maaui,sargeras,1374,druid,restoration,48,24,24
3943,Venomgtz,laughing-skull,1372,druid,restoration,117,60,57
3944,Kronik,jubeithos,1370,druid,restoration,49,15,34
3945,Azshunara,moon-guard,1369,druid,restoration,84,43,41
3946,Deamondruidz,kaelthas,1367,druid,restoration,78,31,47
3947,Vakimumu,anubarak,1366,druid,restoration,72,31,41
3948,Farmageddon,thunderhorn,1365,druid,restoration,58,33,25
3949,Aramá,drakkari,1365,druid,restoration,38,21,17
3950,Edraen,zuljin,1362,druid,restoration,137,67,70
3951,Daku,moknathal,1362,druid,restoration,64,31,33
3952,Vondutch,tichondrius,1362,druid,restoration,60,24,36
3953,Kuwä,proudmoore,1360,druid,restoration,130,65,65
3954,Santiagowski,ragnaros,1359,druid,restoration,46,23,23
3955,Shifftycent,trollbane,1359,druid,restoration,54,26,28
3956,Amandi,magtheridon,1358,druid,restoration,42,23,19
3957,Kergai,emerald-dream,1355,druid,restoration,102,53,49
3958,Horymory,darkspear,1353,druid,restoration,132,66,66
3959,Onblue,tichondrius,1347,druid,restoration,38,22,16
3960,Hotemz,dragonmaw,1347,druid,restoration,30,16,14
3961,Jimjab,stormreaver,1346,druid,restoration,60,35,25
3962,Fryy,balnazzar,1346,druid,restoration,30,15,15
3963,Treelomilo,stormrage,1345,druid,restoration,61,34,27
3964,Bobobear,proudmoore,1345,druid,restoration,60,23,37
3965,Delody,tichondrius,1343,druid,restoration,38,23,15
3966,Puzzlebox,illidan,1343,druid,restoration,24,14,10
3967,Bemelerberg,sargeras,1343,druid,restoration,24,14,10
3968,Cantmeldthis,zuljin,1340,druid,restoration,30,14,16
3969,Muatigorn,blackrock,1339,druid,restoration,38,19,19
3970,Rwi,tichondrius,1339,druid,restoration,105,49,56
3971,Groschats,area-52,1339,druid,restoration,42,14,28
3972,Ripberg,chogall,1338,druid,restoration,30,14,16
3973,Cznfik,area-52,1338,druid,restoration,78,32,46
3974,Eraticdruid,illidan,1338,druid,restoration,42,16,26
3975,Doglightning,illidan,1336,druid,restoration,25,15,10
3976,Klamediya,illidan,1336,druid,restoration,36,14,22
3977,Vecuronium,tichondrius,1335,druid,restoration,30,14,16
3978,Calmd,sargeras,1334,druid,restoration,18,14,4
3979,Binionsolboy,illidan,1333,druid,restoration,30,14,16
3980,Anchunlol,tichondrius,1332,druid,restoration,36,18,18
3981,Mudpi,illidan,1332,druid,restoration,71,34,37
3982,Izzabelle,deathwing,1330,druid,restoration,25,16,9
3983,Girthture,tichondrius,1330,druid,restoration,130,63,67
3984,Gladelf,sargeras,1327,druid,restoration,230,116,114
3985,Anotherstar,frostmourne,1327,druid,restoration,60,28,32
3986,Hynz,barthilas,1327,druid,restoration,36,15,21
3987,Dokasaurus,lightbringer,1325,druid,restoration,36,17,19
3988,Aristeus,kelthuzad,1322,druid,restoration,144,77,67
3989,Joopsy,tichondrius,1321,druid,restoration,130,71,59
3990,Puntcounder,sargeras,1320,druid,restoration,40,21,19
3991,Nxghtfall,tichondrius,1319,druid,restoration,122,65,57
3992,Youngteezy,barthilas,1319,druid,restoration,142,53,89
3993,Bruitzya,barthilas,1318,druid,restoration,21,15,6
3994,Branu,hyjal,1318,druid,restoration,30,14,16
3995,Petmydeadcow,illidan,1317,druid,restoration,115,56,59
3996,Zelyvia,moon-guard,1313,druid,restoration,24,14,10
3997,Freehealjob,lightnings-blade,1313,druid,restoration,30,14,16
3998,Kzinti,zuluhed,1312,druid,restoration,30,14,16
3999,Donnà,tichondrius,1310,druid,restoration,43,21,22
4000,Kevarcen,dalaran,1310,druid,restoration,66,32,34
4001,Bovindickus,tichondrius,1309,druid,restoration,36,16,20
4002,Ÿozsh,azralon,1306,druid,restoration,22,15,7
4003,Ghirox,stormrage,1306,druid,restoration,54,26,28
4004,Skotty,hyjal,1306,druid,restoration,48,23,25
4005,Dypx,tichondrius,1304,druid,restoration,95,38,57
4006,Gaawdx,illidan,1303,druid,restoration,54,25,29
4007,Madsewerslvt,stormrage,1300,druid,restoration,149,75,74
4008,Yoshí,emerald-dream,1299,druid,restoration,51,22,29
4009,Purpleleaves,stormrage,1299,druid,restoration,119,51,68
4010,Airmíd,illidan,1299,druid,restoration,48,16,32
4011,Aaughh,sargeras,1297,druid,restoration,70,33,37
4012,Rooroo,ragnaros,1296,druid,restoration,28,15,13
4013,Minokawa,kargath,1296,druid,restoration,29,15,14
4014,Zoeyx,tichondrius,1295,druid,restoration,37,21,16
4015,Melbian,tichondrius,1295,druid,restoration,124,70,54
4016,Entydruid,khazgoroth,1295,druid,restoration,34,19,15
4017,Badferal,blackhand,1295,druid,restoration,51,25,26
4018,Plagiarist,stormrage,1295,druid,restoration,44,20,24
4019,Ohhshiift,tichondrius,1295,druid,restoration,33,14,19
4020,Dunedaddy,silvermoon,1294,druid,restoration,42,23,19
4021,Caustìk,malganis,1291,druid,restoration,70,38,32
4022,Haneulso,tichondrius,1290,druid,restoration,55,30,25
4023,Standee,sargeras,1290,druid,restoration,48,18,30
4024,Kybecruz,stormrage,1289,druid,restoration,66,29,37
4025,Magicrock,moon-guard,1285,druid,restoration,42,23,19
4026,Apoxi,arygos,1284,druid,restoration,42,24,18
4027,Ananan,burning-blade,1282,druid,restoration,101,49,52
4028,Rawbacon,blackrock,1281,druid,restoration,40,15,25
4029,Beleraine,moon-guard,1280,druid,restoration,34,17,17
4030,Nogàrd,arygos,1279,druid,restoration,23,14,9
4031,Naseebo,frostmourne,1279,druid,restoration,67,25,42
4032,Zambyr,azralon,1278,druid,restoration,66,28,38
4033,Afonso,frostmourne,1276,druid,restoration,50,26,24
4034,Morphios,barthilas,1274,druid,restoration,54,25,29
4035,Silit,tichondrius,1273,druid,restoration,39,18,21
4036,Thericebags,illidan,1272,druid,restoration,161,86,75
4037,Tenhoteta,goldrinn,1272,druid,restoration,48,22,26
4038,Drazibaz,thrall,1271,druid,restoration,42,24,18
4039,Sxlanderx,malganis,1271,druid,restoration,118,58,60
4040,Haohomie,tichondrius,1270,druid,restoration,41,21,20
4041,Odcerberus,azralon,1267,druid,restoration,36,18,18
4042,Clawriander,barthilas,1266,druid,restoration,90,47,43
4043,Tallenzz,lightninghoof,1265,druid,restoration,96,53,43
4044,Slév,frostmourne,1263,druid,restoration,35,17,18
4045,Beefyhealz,emerald-dream,1260,druid,restoration,48,31,17
4046,Ourse,frostmourne,1260,druid,restoration,23,14,9
4047,Nanate,sargeras,1259,druid,restoration,47,24,23
4048,Greenvibes,drakkari,1257,druid,restoration,77,42,35
4049,Lindi,kelthuzad,1257,druid,restoration,78,42,36
4050,Kerrzo,frostmourne,1256,druid,restoration,36,17,19
4051,Junglefists,frostmourne,1255,druid,restoration,133,68,65
4052,Rockmeifucan,greymane,1253,druid,restoration,78,33,45
4053,Katherine,moon-guard,1251,druid,restoration,132,62,70
4054,Yakuho,proudmoore,1250,druid,restoration,32,20,12
4055,Carlosd,tichondrius,1250,druid,restoration,58,33,25
4056,Romcom,demon-soul,1250,druid,restoration,48,27,21
4057,Jacknit,illidan,1250,druid,restoration,28,15,13
4058,Phåtkid,darkspear,1250,druid,restoration,36,15,21
4059,Druidnim,tichondrius,1249,druid,restoration,48,15,33
4060,Skymund,tichondrius,1247,druid,restoration,50,26,24
4061,Pouncing,sargeras,1247,druid,restoration,32,14,18
4062,Ninzor,tichondrius,1247,druid,restoration,30,13,17
4063,Rapttors,zuljin,1247,druid,restoration,30,13,17
4064,Ziegey,tichondrius,1246,druid,restoration,24,13,11
4065,Jonculler,korgath,1246,druid,restoration,54,26,28
4066,Dolanaar,stormrage,1245,druid,restoration,149,78,71
4067,Shallowcat,tichondrius,1245,druid,restoration,41,15,26
4068,Icehulk,kelthuzad,1244,druid,restoration,24,13,11
4069,Toslick,kelthuzad,1244,druid,restoration,117,59,58
4070,Torofarmeon,quelthalas,1243,druid,restoration,51,30,21
4071,Dankcentral,frostwolf,1242,druid,restoration,88,50,38
4072,Goosebümps,stormrage,1242,druid,restoration,24,13,11
4073,Krevy,nazgrel,1241,druid,restoration,36,13,23
4074,Sarojna,malganis,1239,druid,restoration,18,13,5
4075,Healingcute,tichondrius,1239,druid,restoration,131,70,61
4076,Feldstarx,stormrage,1238,druid,restoration,24,13,11
4077,Larc,frostwolf,1238,druid,restoration,76,39,37
4078,Shanê,proudmoore,1238,druid,restoration,55,27,28
4079,Kyndel,kiljaeden,1237,druid,restoration,44,22,22
4080,Amatxu,ragnaros,1237,druid,restoration,123,61,62
4081,Travys,sargeras,1235,druid,restoration,36,16,20
4082,Veganz,moon-guard,1233,druid,restoration,145,71,74
4083,Svarne,kiljaeden,1232,druid,restoration,59,29,30
4084,Adaralia,tichondrius,1232,druid,restoration,30,13,17
4085,Groõt,barthilas,1232,druid,restoration,99,42,57
4086,Shekelsnätch,area-52,1231,druid,restoration,42,21,21
4087,Smilax,eonar,1231,druid,restoration,71,29,42
4088,Slev,frostmourne,1229,druid,restoration,24,13,11
4089,Lünaä,quelthalas,1228,druid,restoration,42,29,13
4090,Imakitty,aerie-peak,1226,druid,restoration,121,62,59
4091,Carneluna,area-52,1226,druid,restoration,66,31,35
4092,Suye,tichondrius,1226,druid,restoration,66,30,36
4093,Wildwhisper,moon-guard,1225,druid,restoration,96,50,46
4094,Yellowstone,drakthul,1222,druid,restoration,42,23,19
4095,Speaks,moon-guard,1222,druid,restoration,71,29,42
4096,Anothersalad,stormrage,1221,druid,restoration,66,32,34
4097,Beladrexx,stormrage,1221,druid,restoration,54,21,33
4098,Whispurrz,tichondrius,1219,druid,restoration,297,152,145
4099,Druidkingdk,stormrage,1218,druid,restoration,29,18,11
4100,Brandonxerox,tichondrius,1217,druid,restoration,30,13,17
4101,Ännä,moon-guard,1217,druid,restoration,30,13,17
4102,Greemer,sargeras,1213,druid,restoration,39,18,21
4103,Bunnyes,tichondrius,1212,druid,restoration,59,29,30
4104,Malfurionis,tichondrius,1212,druid,restoration,36,13,23
4105,Gryel,area-52,1211,druid,restoration,235,122,113
4106,Bäñgarang,tichondrius,1210,druid,restoration,72,40,32
4107,Ulfaren,frostmourne,1209,druid,restoration,24,15,9
4108,Layala,sargeras,1209,druid,restoration,84,41,43
4109,Pyrogenics,whisperwind,1209,druid,restoration,42,20,22
4110,Lewïs,stormrage,1208,druid,restoration,87,53,34
4111,Barecow,tichondrius,1207,druid,restoration,30,13,17
4112,Tìssuebox,malganis,1207,druid,restoration,75,32,43
4113,Lunkz,tichondrius,1205,druid,restoration,96,46,50
4114,Tuskdaddie,sargeras,1204,druid,restoration,30,17,13
4115,Meôwmix,stormrage,1202,druid,restoration,24,13,11
4116,Kasannaommi,sargeras,1202,druid,restoration,66,32,34
4117,Cuddles,moon-guard,1201,druid,restoration,137,67,70
4118,Driftwood,bonechewer,1201,druid,restoration,64,27,37
4119,Bikacat,kelthuzad,1200,druid,restoration,24,13,11
4120,Darksteak,tichondrius,1200,druid,restoration,168,85,83
4121,Rhatir,stormrage,1200,druid,restoration,104,48,56
4122,Dimzim,lightbringer,1198,druid,restoration,66,31,35
4123,Gokki,zuljin,1197,druid,restoration,22,14,8
4124,Nugren,thrall,1195,druid,restoration,50,22,28
4125,Sweetcorn,malganis,1192,druid,restoration,40,16,24
4126,Gossìpgoat,frostmourne,1191,druid,restoration,80,38,42
4127,Höneyfang,moon-guard,1189,druid,restoration,59,37,22
4128,Cheddastov,illidan,1189,druid,restoration,27,14,13
4129,Knowgo,tichondrius,1188,druid,restoration,54,28,26
4130,Longisland,quelthalas,1188,druid,restoration,84,38,46
4131,Juuru,stormreaver,1185,druid,restoration,24,17,7
4132,Adarindre,aerie-peak,1185,druid,restoration,93,46,47
4133,Pawpurrazzi,moon-guard,1183,druid,restoration,17,13,4
4134,Alphalemon,ragnaros,1182,druid,restoration,63,32,31
4135,Valeñtine,dalaran,1179,druid,restoration,78,39,39
4136,Aterra,ragnaros,1179,druid,restoration,29,13,16
4137,Tworax,frostmourne,1179,druid,restoration,30,13,17
4138,Alastras,tichondrius,1176,druid,restoration,30,16,14
4139,Pollished,kelthuzad,1176,druid,restoration,35,17,18
4140,Ephemere,emerald-dream,1176,druid,restoration,28,13,15
4141,Lizzelune,drakkari,1176,druid,restoration,42,18,24
4142,Hruke,illidan,1173,druid,restoration,42,17,25
4143,Schlotzsky,skullcrusher,1171,druid,restoration,69,37,32
4144,Mf,stormscale,1171,druid,restoration,30,14,16
4145,Iambeefy,hyjal,1170,druid,restoration,165,79,86
4146,Vantorsydmel,proudmoore,1167,druid,restoration,46,24,22
4147,Chixao,tichondrius,1166,druid,restoration,23,13,10
4148,Matpd,norgannon,1165,druid,restoration,124,61,63
4149,Saelyle,illidan,1164,druid,restoration,40,19,21
4150,Frames,area-52,1164,druid,restoration,109,51,58
4151,Kamisamalee,tichondrius,1163,druid,restoration,17,13,4
4152,Sarangzzang,tichondrius,1159,druid,restoration,37,22,15
4153,Pachacamac,dragonmaw,1159,druid,restoration,36,21,15
4154,Lenori,vashj,1159,druid,restoration,48,24,24
4155,Smhyle,frostmourne,1158,druid,restoration,41,21,20
4156,Naturemagic,malganis,1157,druid,restoration,45,26,19
4157,Garbagedruid,scilla,1152,druid,restoration,24,12,12
4158,Doah,kelthuzad,1152,druid,restoration,24,12,12
4159,Rekelberg,sargeras,1151,druid,restoration,18,12,6
4160,Ayalia,saurfang,1151,druid,restoration,18,12,6
4161,Beecammy,frostmourne,1151,druid,restoration,54,31,23
4162,Floofi,kelthuzad,1151,druid,restoration,24,12,12
4163,Concordya,tichondrius,1149,druid,restoration,59,29,30
4164,Enrÿu,nemesis,1149,druid,restoration,30,12,18
4165,Mommymilkers,jubeithos,1149,druid,restoration,54,14,40
4166,Æpex,lightnings-blade,1148,druid,restoration,30,16,14
4167,Idoldeoz,quelthalas,1147,druid,restoration,36,18,18
4168,Dchizzle,tichondrius,1147,druid,restoration,45,20,25
4169,Gorillagloo,area-52,1146,druid,restoration,79,36,43
4170,Fatshift,chogall,1145,druid,restoration,122,62,60
4171,Skibbidy,boulderfist,1145,druid,restoration,33,14,19
4172,Weedmunchies,kelthuzad,1143,druid,restoration,24,12,12
4173,Tyrs,aggramar,1140,druid,restoration,35,15,20
4174,Elylaylalar,moon-guard,1139,druid,restoration,48,21,27
4175,Jijunss,tichondrius,1137,druid,restoration,23,13,10
4176,Sinseir,stormscale,1137,druid,restoration,99,42,57
4177,Miyeonly,dalaran,1137,druid,restoration,36,12,24
4178,Joya,stormrage,1136,druid,restoration,18,12,6
4179,Glenkair,lightnings-blade,1134,druid,restoration,36,17,19
4180,Pumma,darkspear,1134,druid,restoration,28,13,15
4181,Bigherbo,zuljin,1130,druid,restoration,126,61,65
4182,Catlypso,tichondrius,1129,druid,restoration,66,40,26
4183,Foxbear,garona,1127,druid,restoration,51,33,18
4184,Duxz,tichondrius,1127,druid,restoration,23,13,10
4185,Würzel,nemesis,1127,druid,restoration,84,41,43
4186,Sloptoucher,barthilas,1126,druid,restoration,24,12,12
4187,Iheartpvp,tichondrius,1121,druid,restoration,48,21,27
4188,Hotkage,tichondrius,1120,druid,restoration,18,12,6
4189,Hðthead,area-52,1118,druid,restoration,54,26,28
4190,Feralgodx,sargeras,1114,druid,restoration,23,12,11
4191,Stupidranga,barthilas,1114,druid,restoration,48,17,31
4192,Fermata,aegwynn,1113,druid,restoration,28,15,13
4193,Jruids,stormrage,1111,druid,restoration,36,12,24
4194,Dainehoof,area-52,1110,druid,restoration,39,14,25
4195,Kuaite,azralon,1110,druid,restoration,72,25,47
4196,Katdog,warsong,1109,druid,restoration,33,22,11
4197,Löthnälar,ragnaros,1109,druid,restoration,48,24,24
4198,Chowyunfats,proudmoore,1106,druid,restoration,301,155,146
4199,Müfasä,azralon,1106,druid,restoration,54,25,29
4200,Maddoxi,stormrage,1106,druid,restoration,30,12,18
4201,Sharinna,andorhal,1106,druid,restoration,38,14,24
4202,Sodury,tichondrius,1104,druid,restoration,90,50,40
4203,Furfu,illidan,1104,druid,restoration,74,33,41
4204,Moomooheal,moon-guard,1102,druid,restoration,21,13,8
4205,Sneakysoren,kelthuzad,1102,druid,restoration,36,13,23
4206,Carekoala,wyrmrest-accord,1098,druid,restoration,59,30,29
4207,Shroomkin,area-52,1097,druid,restoration,36,19,17
4208,Tensuen,boulderfist,1095,druid,restoration,45,17,28
4209,Kymopexy,sargeras,1095,druid,restoration,41,14,27
4210,Jabina,detheroc,1093,druid,restoration,54,16,38
4211,Mcriblet,illidan,1091,druid,restoration,24,12,12
4212,Barugaf,drakkari,1090,druid,restoration,49,28,21
4213,Kittne,hellscream,1089,druid,restoration,48,24,24
4214,Vollzar,sargeras,1089,druid,restoration,68,23,45
4215,Wp,proudmoore,1088,druid,restoration,32,14,18
4216,Cear,proudmoore,1087,druid,restoration,30,12,18
4217,Ayadel,moon-guard,1086,druid,restoration,118,54,64
4218,Tarzzan,drakkari,1085,druid,restoration,17,13,4
4219,Bubbashift,garona,1080,druid,restoration,30,12,18
4220,Volgoro,thrall,1078,druid,restoration,60,25,35
4221,Mydira,stormrage,1071,druid,restoration,54,30,24
4222,Samerax,vashj,1070,druid,restoration,107,45,62
4223,Slleep,tichondrius,1069,druid,restoration,54,28,26
4224,Gimborion,stormrage,1066,druid,restoration,48,23,25
4225,Nöches,quelthalas,1065,druid,restoration,32,12,20
4226,Quaileggs,illidan,1064,druid,restoration,36,12,24
4227,Aarandiel,borean-tundra,1063,druid,restoration,30,17,13
4228,Lutzenberger,nemesis,1063,druid,restoration,53,23,30
4229,Buffalobillz,lethon,1062,druid,restoration,40,25,15
4230,Soxyeon,tichondrius,1062,druid,restoration,29,12,17
4231,Rëroll,zuljin,1059,druid,restoration,17,12,5
4232,Chinadruids,tichondrius,1056,druid,restoration,18,11,7
4233,Whhm,burning-blade,1056,druid,restoration,24,11,13
4234,Slurpi,barthilas,1056,druid,restoration,30,11,19
4235,Buffdisc,darkspear,1055,druid,restoration,12,11,1
4236,Hoeba,tichondrius,1055,druid,restoration,18,11,7
4237,Gromdruid,azralon,1055,druid,restoration,66,33,33
4238,Momorabbitd,tichondrius,1055,druid,restoration,30,11,19
4239,Qkskill,nemesis,1055,druid,restoration,42,11,31
4240,Goodhealer,akama,1054,druid,restoration,42,26,16
4241,Krobz,bleeding-hollow,1054,druid,restoration,18,11,7
4242,Moonpaws,frostmourne,1053,druid,restoration,18,11,7
4243,Careless,destromath,1053,druid,restoration,66,27,39
4244,Kitnip,proudmoore,1052,druid,restoration,24,16,8
4245,Côunsyl,silvermoon,1052,druid,restoration,18,11,7
4246,Áçxpërt,jubeithos,1052,druid,restoration,18,11,7
4247,Israh,malygos,1052,druid,restoration,26,15,11
4248,Lawlz,aegwynn,1052,druid,restoration,72,39,33
4249,Yorch,stormrage,1052,druid,restoration,60,28,32
4250,Madowl,tichondrius,1052,druid,restoration,24,11,13
4251,Undaunted,bloodhoof,1051,druid,restoration,24,11,13
4252,Solisuu,frostmane,1051,druid,restoration,30,11,19
4253,Cres,moon-guard,1051,druid,restoration,42,11,31
4254,Phxburn,illidan,1050,druid,restoration,30,11,19
4255,Eredorn,darkspear,1049,druid,restoration,24,18,6
4256,Wythrim,quelthalas,1049,druid,restoration,18,11,7
4257,Quarantinia,arathor,1049,druid,restoration,36,20,16
4258,Hallowbranch,moon-guard,1048,druid,restoration,38,15,23
4259,Dinglebops,stormrage,1047,druid,restoration,28,15,13
4260,Xzerhos,area-52,1047,druid,restoration,151,70,81
4261,Cratose,runetotem,1047,druid,restoration,47,20,27
4262,Yimii,stormrage,1046,druid,restoration,18,11,7
4263,Sorrinn,tichondrius,1046,druid,restoration,24,11,13
4264,Thõrr,tichondrius,1046,druid,restoration,24,11,13
4265,Dorzaku,ragnaros,1045,druid,restoration,47,27,20
4266,Zadayos,aerie-peak,1044,druid,restoration,30,16,14
4267,Deximus,wyrmrest-accord,1043,druid,restoration,18,11,7
4268,Druilicious,ghostlands,1043,druid,restoration,55,27,28
4269,Gairen,the-venture-co,1042,druid,restoration,20,12,8
4270,Feaveldin,moon-guard,1041,druid,restoration,18,11,7
4271,Azyx,stormrage,1041,druid,restoration,42,16,26
4272,Ahrilee,area-52,1040,druid,restoration,75,33,42
4273,Jimmycooks,tichondrius,1039,druid,restoration,18,11,7
4274,Chopleaf,khadgar,1039,druid,restoration,180,92,88
4275,Erû,ragnaros,1037,druid,restoration,18,11,7
4276,Beefcurtâins,aggramar,1032,druid,restoration,18,11,7
4277,Fionnbharr,ragnaros,1031,druid,restoration,76,35,41
4278,Delicioso,wyrmrest-accord,1030,druid,restoration,33,21,12
4279,Javoh,drakkari,1030,druid,restoration,25,13,12
4280,Boofndergz,area-52,1027,druid,restoration,24,15,9
4281,Janaki,malygos,1024,druid,restoration,30,13,17
4282,Panacaea,windrunner,1023,druid,restoration,18,11,7
4283,Burdup,tichondrius,1020,druid,restoration,18,11,7
4284,Imcop,tichondrius,1020,druid,restoration,18,11,7
4285,Troply,ragnaros,1020,druid,restoration,20,12,8
4286,Funnydruid,frostmourne,1020,druid,restoration,42,20,22
4287,Xarressian,moon-guard,1019,druid,restoration,24,11,13
4288,Sonrius,proudmoore,1017,druid,restoration,52,25,27
4289,Feanah,tichondrius,1017,druid,restoration,26,12,14
4290,Nachopuppet,kelthuzad,1017,druid,restoration,45,20,25
4291,Skaidi,quelthalas,1015,druid,restoration,24,13,11
4292,Milkmoneymeo,illidan,1011,druid,restoration,29,11,18
4293,Sunneater,azuremyst,1009,druid,restoration,37,18,19
4294,Agranock,nazgrel,1008,druid,restoration,58,27,31
4295,Ojdidnt,bleeding-hollow,1007,druid,restoration,21,12,9
4296,Cannabull,echo-isles,1007,druid,restoration,27,13,14
4297,Rivetrix,azralon,1007,druid,restoration,103,49,54
4298,Agnala,drakkari,1007,druid,restoration,93,32,61
4299,Duducows,tichondrius,1007,druid,restoration,35,12,23
4300,Keladria,bleeding-hollow,1002,druid,restoration,102,55,47
4301,Guron,aegwynn,1001,druid,restoration,57,30,27
4302,Pmsprone,tichondrius,1001,druid,restoration,66,30,36
4303,Yeahhots,frostmourne,1000,druid,restoration,15,12,3
4304,Mainera,sargeras,1000,druid,restoration,26,12,14
4305,Kastro,frostwolf,997,druid,restoration,24,11,13
4306,Alfurr,tichondrius,994,druid,restoration,85,43,42
4307,Krossus,drakkari,993,druid,restoration,38,13,25
4308,Hewozuoai,area-52,990,druid,restoration,35,11,24
4309,Astharon,drakkari,989,druid,restoration,56,31,25
4310,Marrana,altar-of-storms,989,druid,restoration,24,13,11
4311,Ahylen,quelthalas,989,druid,restoration,53,22,31
4312,Canche,arthas,986,druid,restoration,34,19,15
4313,Feralgød,tichondrius,985,druid,restoration,30,11,19
4314,Treewik,emerald-dream,981,druid,restoration,85,48,37
4315,Nerfmesoon,sargeras,978,druid,restoration,22,11,11
4316,Santicow,ragnaros,975,druid,restoration,20,11,9
4317,Sharkhotzlol,frostmourne,974,druid,restoration,30,11,19
4318,Jethelium,illidan,971,druid,restoration,136,73,63
4319,Seceru,proudmoore,968,druid,restoration,58,31,27
4320,Boomshorts,blackrock,968,druid,restoration,29,14,15
4321,Macdonah,tichondrius,967,druid,restoration,54,26,28
4322,Sunyatsen,quelthalas,967,druid,restoration,58,25,33
4323,Tiufill,nemesis,965,druid,restoration,30,16,14
4324,Mielo,illidan,964,druid,restoration,130,62,68
4325,Wiggle,stormscale,962,druid,restoration,44,21,23
4326,Baruc,illidan,960,druid,restoration,12,10,2
4327,Salzadruid,aggramar,960,druid,restoration,12,10,2
4328,Larissaelar,tichondrius,960,druid,restoration,12,10,2
4329,Pekingcuckoo,illidan,960,druid,restoration,18,10,8
4330,Kurohîme,illidan,960,druid,restoration,18,10,8
4331,Jiywa,lightbringer,960,druid,restoration,18,10,8
4332,Aphroditezs,tichondrius,960,druid,restoration,18,10,8
4333,Nhin,ghostlands,960,druid,restoration,24,10,14
4334,Smeekq,tichondrius,960,druid,restoration,24,10,14
4335,Xiaoyi,tichondrius,959,druid,restoration,12,10,2
4336,Overthink,daggerspine,959,druid,restoration,12,10,2
4337,Dolwizz,tichondrius,959,druid,restoration,18,10,8
4338,Hoonjojjyanx,tichondrius,959,druid,restoration,18,10,8
4339,Elyl,tichondrius,959,druid,restoration,18,10,8
4340,Ddi,frostmourne,959,druid,restoration,18,10,8
4341,Slambeezy,emerald-dream,959,druid,restoration,18,10,8
4342,Garbagebutt,burning-legion,959,druid,restoration,18,10,8
4343,Oblackbetty,illidan,959,druid,restoration,39,18,21
4344,Chutney,windrunner,959,druid,restoration,24,10,14
4345,Treesh,kelthuzad,959,druid,restoration,26,10,16
4346,Lissette,thrall,958,druid,restoration,18,10,8
4347,Uggadruid,malganis,958,druid,restoration,18,10,8
4348,Tlanquility,tichondrius,958,druid,restoration,18,10,8
4349,Lolomas,proudmoore,958,druid,restoration,24,10,14
4350,Magzally,stormrage,958,druid,restoration,24,10,14
4351,Simina,kargath,957,druid,restoration,18,10,8
4352,Dreamgaze,zuljin,957,druid,restoration,18,10,8
4353,Chenxguang,tichondrius,957,druid,restoration,42,22,20
4354,Iheartmushu,mannoroth,957,druid,restoration,91,47,44
4355,Lovenug,shadowsong,957,druid,restoration,24,10,14
4356,Ñoobdruid,tichondrius,956,druid,restoration,18,10,8
4357,Cranbérry,sargeras,956,druid,restoration,18,10,8
4358,Vêzpêr,kelthuzad,956,druid,restoration,24,10,14
4359,Lorca,stormrage,955,druid,restoration,12,10,2
4360,Kataless,sargeras,954,druid,restoration,77,40,37
4361,Dobidas,tichondrius,953,druid,restoration,82,40,42
4362,Pronewb,frostmourne,952,druid,restoration,12,10,2
4363,Trolbearpig,malganis,952,druid,restoration,18,10,8
4364,Joink,sargeras,952,druid,restoration,18,10,8
4365,Wildartform,malganis,952,druid,restoration,23,12,11
4366,Dietmilk,sargeras,952,druid,restoration,24,11,13
4367,Däll,tichondrius,952,druid,restoration,24,10,14
4368,Fortnitburgr,tichondrius,951,druid,restoration,18,10,8
4369,Erisya,moon-guard,951,druid,restoration,18,10,8
4370,Wintarz,sargeras,951,druid,restoration,30,10,20
4371,Feckzd,blackhand,950,druid,restoration,18,10,8
4372,Honeymead,wyrmrest-accord,950,druid,restoration,65,36,29
4373,Judar,barthilas,950,druid,restoration,24,10,14
4374,Immabot,tichondrius,949,druid,restoration,36,10,26
4375,Krözjk,quelthalas,948,druid,restoration,27,10,17
4376,Hpcorrection,bleeding-hollow,946,druid,restoration,18,10,8
4377,Yourka,uther,946,druid,restoration,29,15,14
4378,Fatjoints,tichondrius,943,druid,restoration,60,21,39
4379,Maxobviously,stormrage,942,druid,restoration,18,10,8
4380,Devilsparda,frostmane,942,druid,restoration,24,10,14
4381,Kg,cenarion-circle,941,druid,restoration,28,13,15
4382,Dwalk,moknathal,941,druid,restoration,79,36,43
4383,Tyrantha,emerald-dream,941,druid,restoration,24,10,14
4384,Shiftaholic,azgalor,940,druid,restoration,33,17,16
4385,Drucaicer,quelthalas,939,druid,restoration,71,38,33
4386,Bindudream,frostmane,938,druid,restoration,66,30,36
4387,Nattog,area-52,937,druid,restoration,47,12,35
4388,Saltyzz,tichondrius,935,druid,restoration,24,10,14
4389,Blackdawgg,frostmourne,931,druid,restoration,60,21,39
4390,Katochi,area-52,929,druid,restoration,54,24,30
4391,Blooddude,saurfang,927,druid,restoration,30,11,19
4392,Killari,malganis,926,druid,restoration,30,15,15
4393,Movom,tichondrius,925,druid,restoration,23,10,13
4394,Dhannar,proudmoore,924,druid,restoration,12,10,2
4395,Cloudbreaker,duskwood,923,druid,restoration,18,10,8
4396,Chocoo,thaurissan,923,druid,restoration,20,11,9
4397,Bankinbäbe,illidan,923,druid,restoration,50,23,27
4398,Cowtox,moon-guard,920,druid,restoration,60,25,35
4399,Moolan,bleeding-hollow,919,druid,restoration,32,15,17
4400,Fovoss,dalaran,914,druid,restoration,36,18,18
4401,Lazypandas,silvermoon,914,druid,restoration,41,17,24
4402,Worgbearpig,destromath,908,druid,restoration,20,11,9
4403,Aquesadilla,tichondrius,907,druid,restoration,108,36,72
4404,Guerrillera,khadgar,903,druid,restoration,118,54,64
4405,Diaks,proudmoore,900,druid,restoration,24,12,12
4406,Bethemarble,sargeras,900,druid,restoration,47,20,27
4407,Merawr,area-52,896,druid,restoration,22,10,12
4408,Hentaiboom,kiljaeden,893,druid,restoration,36,16,20
4409,Vengaul,amanthul,892,druid,restoration,24,10,14
4410,Lâvazza,tichondrius,890,druid,restoration,28,10,18
4411,Sliickrick,frostmourne,889,druid,restoration,30,10,20
4412,Anasia,barthilas,886,druid,restoration,14,11,3
4413,Theboyz,zuljin,881,druid,restoration,30,11,19
4414,Midníght,drakkari,880,druid,restoration,34,18,16
4415,Bunrÿl,thorium-brotherhood,874,druid,restoration,54,24,30
4416,Augus,hyjal,870,druid,restoration,33,11,22
4417,Theboy,dalaran,869,druid,restoration,48,15,33
4418,Bopplejr,tichondrius,864,druid,restoration,12,9,3
4419,Aiteezy,illidan,864,druid,restoration,12,9,3
4420,Restokinaja,dreadmaul,864,druid,restoration,12,9,3
4421,Duo,demon-soul,864,druid,restoration,12,9,3
4422,Spikeleaf,tichondrius,864,druid,restoration,12,9,3
4423,Justforgame,sargeras,864,druid,restoration,12,9,3
4424,Ppbtw,illidan,864,druid,restoration,18,9,9
4425,Ppbdru,tichondrius,864,druid,restoration,18,9,9
4426,Mmrborrower,icecrown,864,druid,restoration,18,9,9
4427,Hellshifterr,tichondrius,864,druid,restoration,18,9,9
4428,Ppb,illidan,864,druid,restoration,18,9,9
4429,Bridgerén,tichondrius,864,druid,restoration,18,9,9
4430,Lindsanr,illidan,864,druid,restoration,24,9,15
4431,Convokíng,kelthuzad,864,druid,restoration,30,9,21
4432,Ilovejuli,illidan,863,druid,restoration,12,9,3
4433,Naturenugget,tichondrius,863,druid,restoration,12,9,3
4434,Rejuvenation,kaelthas,863,druid,restoration,12,9,3
4435,Ooh,stormreaver,863,druid,restoration,12,9,3
4436,Vernaar,laughing-skull,863,druid,restoration,18,9,9
4437,Asaphelps,stormrage,863,druid,restoration,18,9,9
4438,Canek,ghostlands,863,druid,restoration,18,9,9
4439,Canitöuchit,tichondrius,863,druid,restoration,24,9,15
4440,Opim,sargeras,863,druid,restoration,24,9,15
4441,Guss,mannoroth,863,druid,restoration,24,9,15
4442,Tugginudders,illidan,863,druid,restoration,30,9,21
4443,Shuffleqlol,stormrage,862,druid,restoration,12,9,3
4444,Jentzull,tichondrius,862,druid,restoration,12,9,3
4445,Pawsh,tichondrius,862,druid,restoration,12,9,3
4446,Phylex,frostmourne,862,druid,restoration,18,9,9
4447,Cenarius,frostmourne,862,druid,restoration,18,9,9
4448,Bigrich,malorne,862,druid,restoration,18,9,9
4449,Dummedruid,illidan,862,druid,restoration,24,9,15
4450,Monkeyxo,kelthuzad,861,druid,restoration,18,9,9
4451,Alindrä,moon-guard,861,druid,restoration,18,9,9
4452,Alsei,quelthalas,861,druid,restoration,40,18,22
4453,Goodspeed,thrall,861,druid,restoration,42,11,31
4454,Dankmids,hyjal,860,druid,restoration,12,9,3
4455,Stetile,azralon,859,druid,restoration,18,9,9
4456,Sorio,area-52,858,druid,restoration,28,10,18
4457,Poutyface,sargeras,858,druid,restoration,51,10,41
4458,Feutrine,zuljin,857,druid,restoration,18,9,9
4459,Crackheads,tichondrius,856,druid,restoration,24,9,15
4460,Treeoleo,stormrage,855,druid,restoration,30,13,17
4461,Malice,undermine,854,druid,restoration,24,9,15
4462,Faroo,azralon,854,druid,restoration,24,9,15
4463,Kvacco,kiljaeden,848,druid,restoration,24,9,15
4464,Encosan,azralon,848,druid,restoration,30,9,21
4465,Drexldrood,cenarius,847,druid,restoration,12,9,3
4466,Kanadae,thrall,846,druid,restoration,24,9,15
4467,Uwupollo,ragnaros,846,druid,restoration,42,13,29
4468,Érois,azralon,844,druid,restoration,18,9,9
4469,Stamynn,kelthuzad,843,druid,restoration,133,44,89
4470,Draycø,tichondrius,841,druid,restoration,18,9,9
4471,Fronkysilva,illidan,838,druid,restoration,48,19,29
4472,Kellykapore,area-52,827,druid,restoration,66,15,51
4473,Jennafix,dathremar,825,druid,restoration,18,9,9
4474,Kittyz,wyrmrest-accord,817,druid,restoration,18,9,9
4475,Kawanishi,stormrage,810,druid,restoration,18,9,9
4476,Elauria,stormreaver,804,druid,restoration,42,17,25
4477,Atim,moon-guard,804,druid,restoration,96,28,68
4478,Xxuan,tichondrius,803,druid,restoration,62,16,46
4479,Gypsysoul,barthilas,798,druid,restoration,17,9,8
4480,Mcy,nerzhul,798,druid,restoration,20,9,11
4481,Lazza,blackhand,796,druid,restoration,16,9,7
4482,Cenariun,stormrage,790,druid,restoration,30,9,21
4483,Shturman,blackrock,783,druid,restoration,11,9,2
4484,Judwen,grizzly-hills,779,druid,restoration,70,26,44
4485,Redharp,proudmoore,776,druid,restoration,43,17,26
4486,Hoebaz,tichondrius,768,druid,restoration,12,8,4
4487,Chinadruides,tichondrius,768,druid,restoration,12,8,4
4488,Quss,tichondrius,768,druid,restoration,12,8,4
4489,Cakeinalake,bleeding-hollow,768,druid,restoration,12,8,4
4490,Albafic,illidan,768,druid,restoration,12,8,4
4491,Kustumsdog,tichondrius,768,druid,restoration,12,8,4
4492,Bobxd,kelthuzad,768,druid,restoration,12,8,4
4493,Leafynymph,tichondrius,768,druid,restoration,12,8,4
4494,Xiaootong,tichondrius,768,druid,restoration,12,8,4
4495,Ppm,illidan,768,druid,restoration,12,8,4
4496,Leilani,eredar,768,druid,restoration,12,8,4
4497,Tiggor,ghostlands,768,druid,restoration,12,8,4
4498,Taledra,stormrage,768,druid,restoration,18,8,10
4499,Restobaby,tichondrius,768,druid,restoration,18,8,10
4500,Pekazay,illidan,768,druid,restoration,18,8,10
4501,Înfamous,thrall,767,druid,restoration,12,8,4
4502,Maeo,drenden,767,druid,restoration,12,8,4
4503,Kismet,andorhal,767,druid,restoration,12,8,4
4504,Alend,alexstrasza,767,druid,restoration,12,8,4
4505,Mxlasthope,stormrage,767,druid,restoration,12,8,4
4506,Bringo,executus,767,druid,restoration,21,10,11
4507,Acerolita,azralon,767,druid,restoration,18,8,10
4508,Lifebloomlol,area-52,767,druid,restoration,18,8,10
4509,Waxedchest,emerald-dream,767,druid,restoration,18,8,10
4510,Thetakeout,tichondrius,767,druid,restoration,18,8,10
4511,Kaboomy,moon-guard,767,druid,restoration,18,8,10
4512,Libel,korgath,766,druid,restoration,12,8,4
4513,Terokky,azralon,766,druid,restoration,12,8,4
4514,Hughcockman,tichondrius,766,druid,restoration,12,8,4
4515,Wildsïde,tichondrius,766,druid,restoration,18,8,10
4516,Crapster,boulderfist,766,druid,restoration,18,8,10
4517,Feykurds,sargeras,766,druid,restoration,18,8,10
4518,Bumbleebee,azralon,766,druid,restoration,24,8,16
4519,Hedwíg,ragnaros,766,druid,restoration,24,8,16
4520,Imnotinhuman,tichondrius,765,druid,restoration,12,8,4
4521,Louisvuittón,area-52,765,druid,restoration,12,8,4
4522,Dmanrepus,sargeras,765,druid,restoration,12,8,4
4523,Kupos,lightbringer,765,druid,restoration,21,8,13
4524,Guybranch,illidan,765,druid,restoration,24,8,16
4525,Slee,eredar,764,druid,restoration,12,8,4
4526,Ctarla,tichondrius,764,druid,restoration,18,8,10
4527,Leatherpig,proudmoore,764,druid,restoration,18,8,10
4528,Aurajin,spinebreaker,764,druid,restoration,24,8,16
4529,Needabandaid,arthas,764,druid,restoration,24,8,16
4530,Studioghibli,bleeding-hollow,762,druid,restoration,12,8,4
4531,Atalìa,moon-guard,762,druid,restoration,18,8,10
4532,Blitzÿ,lothar,761,druid,restoration,12,8,4
4533,Rockcow,tichondrius,761,druid,restoration,18,8,10
4534,Markóla,stormrage,761,druid,restoration,18,8,10
4535,Wortsnom,tol-barad,760,druid,restoration,12,8,4
4536,Quan,illidan,760,druid,restoration,18,8,10
4537,Meonk,frostmourne,759,druid,restoration,18,8,10
4538,Rairven,stormrage,757,druid,restoration,42,8,34
4539,Rhondarootsy,zuljin,756,druid,restoration,18,8,10
4540,Bainnê,ragnaros,755,druid,restoration,42,8,34
4541,Cadekey,illidan,752,druid,restoration,24,8,16
4542,Friarpuck,nerzhul,747,druid,restoration,12,8,4
4543,Dragondruid,dawnbringer,742,druid,restoration,35,9,26
4544,Ekj,tichondrius,735,druid,restoration,14,9,5
4545,Akanx,tichondrius,735,druid,restoration,16,9,7
4546,Elvishchamp,mugthol,733,druid,restoration,17,9,8
4547,Kadry,ragnaros,733,druid,restoration,18,8,10
4548,Kataoka,azralon,721,druid,restoration,23,11,12
4549,Rdruidchump,the-forgotten-coast,719,druid,restoration,15,9,6
4550,Basulto,tichondrius,718,druid,restoration,23,8,15
4551,Xîstance,barthilas,717,druid,restoration,23,8,15
4552,Asclepïus,tichondrius,716,druid,restoration,17,8,9
4553,Felinedreams,sargeras,714,druid,restoration,14,9,5
4554,Whiskeyblues,ursin,706,druid,restoration,24,8,16
4555,Zephiee,kelthuzad,692,druid,restoration,23,8,15
4556,Teamwork,moon-guard,681,druid,restoration,20,10,10
4557,Importedalc,zuljin,678,druid,restoration,36,8,28
4558,Crusch,shattered-halls,672,druid,restoration,12,7,5
4559,Scuzzin,zuljin,672,druid,restoration,12,7,5
4560,Skitzo,akama,672,druid,restoration,12,7,5
4561,Mymatejames,tichondrius,672,druid,restoration,12,7,5
4562,Sensations,moon-guard,672,druid,restoration,12,7,5
4563,Cameltail,kelthuzad,672,druid,restoration,12,7,5
4564,Blacksimbá,area-52,672,druid,restoration,12,7,5
4565,Razberriesz,stormrage,672,druid,restoration,12,7,5
4566,Bigdockepoch,sargeras,672,druid,restoration,12,7,5
4567,Motate,malganis,672,druid,restoration,12,7,5
4568,Toketree,sargeras,672,druid,restoration,12,7,5
4569,Tmdogwater,sargeras,672,druid,restoration,12,7,5
4570,Treeofangels,nathrezim,672,druid,restoration,12,7,5
4571,Fresh,earthen-ring,672,druid,restoration,12,7,5
4572,Spicyx,moon-guard,672,druid,restoration,12,7,5
4573,Esqueue,stormrage,672,druid,restoration,12,7,5
4574,Hmoobforshoz,wildhammer,672,druid,restoration,12,7,5
4575,Calimei,bladefist,672,druid,restoration,18,7,11
4576,Hoedrufroza,tichondrius,672,druid,restoration,18,7,11
4577,Washeddruid,area-52,672,druid,restoration,18,7,11
4578,Greentoë,sargeras,672,druid,restoration,18,7,11
4579,Dotsbots,barthilas,672,druid,restoration,18,7,11
4580,Suekey,frostmourne,672,druid,restoration,18,7,11
4581,Wùúkìí,bleeding-hollow,672,druid,restoration,24,7,17
4582,Iâmkyle,darkspear,671,druid,restoration,12,7,5
4583,Zthatchx,shadowmoon,671,druid,restoration,12,7,5
4584,Jessbearly,kiljaeden,671,druid,restoration,12,7,5
4585,Tigranesia,proudmoore,671,druid,restoration,12,7,5
4586,Hugharection,illidan,671,druid,restoration,12,7,5
4587,Heniuhojia,tichondrius,671,druid,restoration,12,7,5
4588,Tickman,altar-of-storms,671,druid,restoration,18,7,11
4589,Wildarumqt,tichondrius,671,druid,restoration,18,7,11
4590,Lilgee,kelthuzad,671,druid,restoration,18,7,11
4591,Clarice,shattered-halls,671,druid,restoration,18,7,11
4592,Boomchí,tichondrius,671,druid,restoration,18,7,11
4593,Sêxcavator,thrall,671,druid,restoration,18,7,11
4594,Topzet,azralon,671,druid,restoration,24,7,17
4595,Hellahots,spinebreaker,670,druid,restoration,12,7,5
4596,Queiq,kelthuzad,670,druid,restoration,12,7,5
4597,Erykk,dalaran,670,druid,restoration,12,7,5
4598,Flexxfurion,thrall,670,druid,restoration,18,7,11
4599,Wreckked,sargeras,670,druid,restoration,18,7,11
4600,Frave,dentarg,670,druid,restoration,24,7,17
4601,Hotpocketz,kiljaeden,670,druid,restoration,28,8,20
4602,Martymoo,bleeding-hollow,670,druid,restoration,30,7,23
4603,Dipset,khadgar,670,druid,restoration,30,7,23
4604,Dylonomancer,tichondrius,669,druid,restoration,12,7,5
4605,Nayelina,stormrage,669,druid,restoration,12,7,5
4606,Zwind,nerzhul,669,druid,restoration,16,8,8
4607,Treesonn,kelthuzad,669,druid,restoration,17,8,9
4608,Razorclaws,stormscale,669,druid,restoration,18,7,11
4609,Battiatus,malganis,669,druid,restoration,18,7,11
4610,Maggiee,arthas,669,druid,restoration,24,7,17
4611,Bloomcrue,moon-guard,668,druid,restoration,12,7,5
4612,Shiftyy,nordrassil,668,druid,restoration,19,7,12
4613,Esyiix,tichondrius,668,druid,restoration,24,7,17
4614,Mïms,area-52,667,druid,restoration,12,7,5
4615,Swagbabe,sargeras,665,druid,restoration,18,7,11
4616,Gentlesoapp,blackrock,665,druid,restoration,18,7,11
4617,Bullshifftt,kelthuzad,664,druid,restoration,12,7,5
4618,Madambuku,thrall,663,druid,restoration,12,7,5
4619,Somars,cenarius,663,druid,restoration,12,7,5
4620,Snarl,blades-edge,657,druid,restoration,12,7,5
4621,Ikova,frostmourne,650,druid,restoration,18,7,11
4622,Solbinn,nordrassil,647,druid,restoration,72,18,54
4623,Gotdruid,sargeras,639,druid,restoration,14,8,6
4624,Riddickd,malfurion,639,druid,restoration,14,8,6
4625,Kellogs,malganis,639,druid,restoration,17,7,10
4626,Warmkitteh,kiljaeden,639,druid,restoration,17,7,10
4627,Breathe,ysera,639,druid,restoration,28,7,21
4628,Wolfelord,sargeras,624,druid,restoration,21,7,14
4629,Rígo,frostmourne,622,druid,restoration,15,8,7
4630,Midoriiro,dentarg,612,druid,restoration,25,8,17
4631,Stupidtree,antonidas,607,druid,restoration,11,7,4
4632,Milkz,zuljin,607,druid,restoration,26,7,19
4633,Ordono,emerald-dream,576,druid,restoration,6,6,0
4634,Pacetwo,area-52,576,druid,restoration,6,6,0
4635,Disembles,illidan,576,druid,restoration,12,6,6
4636,Forèst,sargeras,576,druid,restoration,12,6,6
4637,Sawajirii,tichondrius,576,druid,restoration,12,6,6
4638,Xingyejingmi,tichondrius,576,druid,restoration,12,6,6
4639,Nomilk,illidan,576,druid,restoration,12,6,6
4640,Admoney,sargeras,576,druid,restoration,12,6,6
4641,Smeekqtwo,tichondrius,576,druid,restoration,12,6,6
4642,Fwaffle,bleeding-hollow,576,druid,restoration,12,6,6
4643,Gemo,tichondrius,576,druid,restoration,12,6,6
4644,Daddypompum,tichondrius,576,druid,restoration,12,6,6
4645,Afkifuthrow,ysera,576,druid,restoration,12,6,6
4646,Chinadruidss,tichondrius,576,druid,restoration,12,6,6
4647,Tigd,alleria,576,druid,restoration,12,6,6
4648,Larryjones,alleria,576,druid,restoration,12,6,6
4649,Tricklein,tichondrius,576,druid,restoration,12,6,6
4650,Krunks,frostmourne,576,druid,restoration,12,6,6
4651,Torbock,zuljin,576,druid,restoration,12,6,6
4652,Furrytorpedo,tichondrius,576,druid,restoration,12,6,6
4653,Naturenugget,sargeras,576,druid,restoration,12,6,6
4654,Bearys,area-52,576,druid,restoration,12,6,6
4655,Dirtydrood,mugthol,576,druid,restoration,12,6,6
4656,Connection,emerald-dream,576,druid,restoration,12,6,6
4657,Hawtyforever,tichondrius,576,druid,restoration,18,6,12
4658,Suublime,ragnaros,576,druid,restoration,18,6,12
4659,Nodab,tichondrius,576,druid,restoration,18,6,12
4660,Arútam,ragnaros,576,druid,restoration,18,6,12
4661,Nerglet,aerie-peak,576,druid,restoration,24,6,18
4662,Hottietottie,laughing-skull,576,druid,restoration,24,6,18
4663,Polánd,area-52,575,druid,restoration,6,6,0
4664,Gosch,stormrage,575,druid,restoration,12,6,6
4665,Flôkey,tichondrius,575,druid,restoration,12,6,6
4666,Noonoo,frostwolf,575,druid,restoration,12,6,6
4667,Bamfferal,tichondrius,575,druid,restoration,12,6,6
4668,Lahsa,tichondrius,575,druid,restoration,12,6,6
4669,Clawandørder,tichondrius,575,druid,restoration,12,6,6
4670,Cinderellax,illidan,575,druid,restoration,12,6,6
4671,Velauris,sargeras,575,druid,restoration,12,6,6
4672,Kokushe,burning-legion,575,druid,restoration,12,6,6
4673,Nightnes,sargeras,575,druid,restoration,12,6,6
4674,Weltherion,guldan,575,druid,restoration,12,6,6
4675,Nrp,stormrage,575,druid,restoration,12,6,6
4676,Jonoa,nagrand,575,druid,restoration,12,6,6
4677,Birdie,dalvengyr,575,druid,restoration,13,6,7
4678,Skullchief,barthilas,575,druid,restoration,16,7,9
4679,Treynî,tichondrius,575,druid,restoration,18,6,12
4680,Sleepypaws,silvermoon,575,druid,restoration,18,6,12
4681,Aligantor,thrall,575,druid,restoration,18,6,12
4682,Mithaelar,moon-guard,575,druid,restoration,18,6,12
4683,Dýreðaguð,gurubashi,575,druid,restoration,18,6,12
4684,Kendoboos,moon-guard,575,druid,restoration,24,6,18
4685,Elpako,ragnaros,574,druid,restoration,6,6,0
4686,Dibinha,azralon,574,druid,restoration,12,6,6
4687,Carther,korgath,574,druid,restoration,12,6,6
4688,Aranuir,emerald-dream,574,druid,restoration,18,6,12
4689,Brisketmre,dalaran,574,druid,restoration,36,6,30
4690,Lonewolfdrd,illidan,573,druid,restoration,6,6,0
4691,Quagsire,moon-guard,573,druid,restoration,18,6,12
4692,Ahlekleklekk,azralon,572,druid,restoration,12,6,6
4693,Nightshiver,bleeding-hollow,572,druid,restoration,12,6,6
4694,Dyfurion,stormrage,572,druid,restoration,12,6,6
4695,Modification,eonar,572,druid,restoration,12,6,6
4696,Kupaloidzki,proudmoore,571,druid,restoration,12,6,6
4697,Bonemaul,bonechewer,571,druid,restoration,12,6,6
4698,Kiraval,stormrage,571,druid,restoration,24,6,18
4699,Aokseer,azralon,570,druid,restoration,12,6,6
4700,Vdubz,blackrock,570,druid,restoration,12,6,6
4701,Nordway,alexstrasza,569,druid,restoration,12,6,6
4702,Naachocheeze,tichondrius,566,druid,restoration,12,6,6
4703,Onyayo,barthilas,565,druid,restoration,12,6,6
4704,Shalandrea,sargeras,552,druid,restoration,24,6,18
4705,Lililililil,stormrage,552,druid,restoration,36,6,30
4706,Istishiã,tichondrius,543,druid,restoration,14,7,7
4707,Cudbacrakhed,tichondrius,541,druid,restoration,20,7,13
4708,Isalien,kelthuzad,521,druid,restoration,21,7,14
4709,Arthemisgodx,azralon,520,druid,restoration,17,10,7
4710,Rakins,arthas,496,druid,restoration,13,6,7
4711,Windù,azralon,488,druid,restoration,16,9,7
4712,Sevend,tichondrius,480,druid,restoration,6,5,1
4713,Dëmoníc,ragnaros,480,druid,restoration,6,5,1
4714,Chaníng,frostmourne,480,druid,restoration,6,5,1
4715,Kascatm,area-52,480,druid,restoration,6,5,1
4716,Nersepha,gurubashi,480,druid,restoration,6,5,1
4717,Jaspen,bleeding-hollow,480,druid,restoration,6,5,1
4718,Treehealage,sargeras,480,druid,restoration,6,5,1
4719,Floray,tichondrius,480,druid,restoration,6,5,1
4720,Naakx,tichondrius,480,druid,restoration,6,5,1
4721,Brëed,tichondrius,480,druid,restoration,6,5,1
4722,Fanboy,magtheridon,480,druid,restoration,6,5,1
4723,Hudada,emerald-dream,480,druid,restoration,12,5,7
4724,Whìtewölf,emerald-dream,480,druid,restoration,12,5,7
4725,Twentyfour,laughing-skull,480,druid,restoration,12,5,7
4726,Pigdd,tichondrius,480,druid,restoration,12,5,7
4727,Lookhowirun,emerald-dream,480,druid,restoration,12,5,7
4728,Bobochi,tichondrius,480,druid,restoration,12,5,7
4729,Amanthw,tichondrius,480,druid,restoration,12,5,7
4730,Stamookee,area-52,480,druid,restoration,12,5,7
4731,Lukass,tichondrius,480,druid,restoration,12,5,7
4732,Shwayshift,bleeding-hollow,480,druid,restoration,12,5,7
4733,Omelet,tichondrius,480,druid,restoration,12,5,7
4734,Memoryleaks,proudmoore,480,druid,restoration,12,5,7
4735,Stormjammer,proudmoore,480,druid,restoration,12,5,7
4736,Ashstarfall,barthilas,480,druid,restoration,12,5,7
4737,Hotgoal,frostmourne,480,druid,restoration,12,5,7
4738,Suekeys,frostmourne,480,druid,restoration,12,5,7
4739,Dalrei,jubeithos,480,druid,restoration,12,5,7
4740,Shartah,zuljin,480,druid,restoration,12,5,7
4741,Cokernut,tichondrius,480,druid,restoration,12,5,7
4742,Jaydog,emerald-dream,480,druid,restoration,12,5,7
4743,Liloudadru,tichondrius,480,druid,restoration,12,5,7
4744,Stårrysky,illidan,480,druid,restoration,12,5,7
4745,Greeneguy,thrall,480,druid,restoration,12,5,7
4746,Yevenbother,tichondrius,480,druid,restoration,12,5,7
4747,Moonfannia,malganis,480,druid,restoration,12,5,7
4748,Tydruid,illidan,480,druid,restoration,12,5,7
4749,Imlordgumper,illidan,480,druid,restoration,12,5,7
4750,Mâckdâddy,kul-tiras,480,druid,restoration,12,5,7
4751,Noah,altar-of-storms,480,druid,restoration,12,5,7
4752,Teslabeam,illidan,480,druid,restoration,12,5,7
4753,Afrogx,dalaran,480,druid,restoration,12,5,7
4754,Finn,spinebreaker,480,druid,restoration,12,5,7
4755,Zemul,ragnaros,480,druid,restoration,12,5,7
4756,Tygraz,alleria,480,druid,restoration,12,5,7
4757,Duckbillby,bleeding-hollow,480,druid,restoration,14,5,9
4758,Guavajuice,stormrage,480,druid,restoration,16,5,11
4759,Hgoo,tichondrius,480,druid,restoration,18,5,13
4760,Djimbo,kelthuzad,480,druid,restoration,18,5,13
4761,Blürry,area-52,480,druid,restoration,24,5,19
4762,Spacaa,kelthuzad,480,druid,restoration,24,5,19
4763,Treezy,dalaran,480,druid,restoration,24,5,19
4764,Vacagalo,azralon,479,druid,restoration,6,5,1
4765,Queiq,malganis,479,druid,restoration,6,5,1
4766,Iiliith,moon-guard,479,druid,restoration,12,5,7
4767,Sønèca,azralon,479,druid,restoration,12,5,7
4768,Murkkd,tichondrius,479,druid,restoration,12,5,7
4769,Ateoate,stormscale,479,druid,restoration,12,5,7
4770,Mvqxd,tichondrius,479,druid,restoration,12,5,7
4771,Forest,frostmourne,479,druid,restoration,12,5,7
4772,Jamona,cenarius,479,druid,restoration,12,5,7
4773,Sharialawl,stormreaver,479,druid,restoration,12,5,7
4774,Olegoatjames,darkspear,478,druid,restoration,13,6,7
4775,Treemendous,tichondrius,478,druid,restoration,12,5,7
4776,Chupaone,dalaran,478,druid,restoration,12,5,7
4777,Natruid,sargeras,478,druid,restoration,12,5,7
4778,Fastafboy,stormrage,478,druid,restoration,12,5,7
4779,Bloodyhoofs,malganis,478,druid,restoration,12,5,7
4780,Rònaldò,drakthul,478,druid,restoration,12,5,7
4781,Scheppke,bleeding-hollow,477,druid,restoration,12,5,7
4782,Baha,azralon,477,druid,restoration,18,5,13
4783,Wraiven,elune,477,druid,restoration,18,5,13
4784,Swiftstrider,frostmourne,476,druid,restoration,10,6,4
4785,Phlap,zuljin,476,druid,restoration,12,5,7
4786,Kaldrago,detheroc,476,druid,restoration,12,5,7
4787,Muphausa,area-52,475,druid,restoration,12,5,7
4788,Bigox,area-52,475,druid,restoration,24,5,19
4789,Vuthryx,tichondrius,472,druid,restoration,18,5,13
4790,Bobruid,nagrand,469,druid,restoration,19,9,10
4791,Maerk,aerie-peak,469,druid,restoration,18,5,13
4792,Udroth,kelthuzad,468,druid,restoration,17,5,12
4793,Xiaoddi,tichondrius,463,druid,restoration,11,5,6
4794,Metaldruid,tichondrius,463,druid,restoration,11,5,6
4795,Semangarbage,tichondrius,457,druid,restoration,15,8,7
4796,Tofumation,gorgonnash,447,druid,restoration,14,6,8
4797,Fuzzie,icecrown,447,druid,restoration,16,5,11
4798,Morpheous,emerald-dream,444,druid,restoration,19,5,14
4799,Bigelbows,area-52,432,druid,restoration,15,6,9
4800,Qij,eonar,431,druid,restoration,11,5,6
4801,Breezeys,tichondrius,426,druid,restoration,15,7,8
4802,Nodeathz,sargeras,426,druid,restoration,17,6,11
4803,Gankstababy,tichondrius,426,druid,restoration,20,6,14
4804,Indicahigh,moon-guard,424,druid,restoration,16,7,9
4805,Persiancoco,area-52,422,druid,restoration,14,6,8
4806,Oongadunga,tichondrius,415,druid,restoration,14,5,9
4807,Restokinaka,dreadmaul,384,druid,restoration,6,4,2
4808,Dzone,tichondrius,384,druid,restoration,6,4,2
4809,Nøbuchi,kelthuzad,384,druid,restoration,6,4,2
4810,Shroomdealer,kelthuzad,384,druid,restoration,6,4,2
4811,Kushkilla,malganis,384,druid,restoration,6,4,2
4812,Zbh,tichondrius,384,druid,restoration,6,4,2
4813,Bambi,bleeding-hollow,384,druid,restoration,6,4,2
4814,Hottie,kelthuzad,384,druid,restoration,6,4,2
4815,Lushÿ,tichondrius,384,druid,restoration,6,4,2
4816,Armorkits,area-52,384,druid,restoration,6,4,2
4817,Doomky,area-52,384,druid,restoration,6,4,2
4818,Chyx,stormreaver,384,druid,restoration,6,4,2
4819,Metaindexqt,quelthalas,384,druid,restoration,6,4,2
4820,Glukhar,blackrock,384,druid,restoration,6,4,2
4821,Crayolaa,barthilas,384,druid,restoration,6,4,2
4822,Nbendtner,tichondrius,384,druid,restoration,6,4,2
4823,Leomerchan,stormrage,384,druid,restoration,6,4,2
4824,Êhurricane,dalaran,384,druid,restoration,6,4,2
4825,Bunrack,nerzhul,384,druid,restoration,6,4,2
4826,Jillferal,proudmoore,384,druid,restoration,6,4,2
4827,Johnnybigg,frostmourne,384,druid,restoration,6,4,2
4828,Cuzzidr,tichondrius,384,druid,restoration,6,4,2
4829,Koan,proudmoore,384,druid,restoration,6,4,2
4830,Starshípx,tichondrius,384,druid,restoration,6,4,2
4831,Bearkîng,stormrage,384,druid,restoration,6,4,2
4832,Peazoepico,tichondrius,384,druid,restoration,6,4,2
4833,Someshta,sargeras,384,druid,restoration,6,4,2
4834,Outcastmango,thrall,384,druid,restoration,6,4,2
4835,Clarityx,illidan,384,druid,restoration,6,4,2
4836,Lylek,azshara,384,druid,restoration,6,4,2
4837,Druidlstrudl,moon-guard,384,druid,restoration,6,4,2
4838,Shadru,bleeding-hollow,384,druid,restoration,12,4,8
4839,Nocup,illidan,384,druid,restoration,12,4,8
4840,Ursu,nemesis,384,druid,restoration,12,4,8
4841,Chickenwings,ragnaros,384,druid,restoration,12,4,8
4842,Figsurine,sargeras,384,druid,restoration,12,4,8
4843,Ganizote,ragnaros,384,druid,restoration,12,4,8
4844,Brittanychan,sargeras,384,druid,restoration,12,4,8
4845,Ohioman,bleeding-hollow,384,druid,restoration,12,4,8
4846,Feraldudu,illidan,384,druid,restoration,12,4,8
4847,Flyshles,frostmourne,384,druid,restoration,12,4,8
4848,Metaphysìcs,kelthuzad,384,druid,restoration,12,4,8
4849,Py,stormscale,384,druid,restoration,12,4,8
4850,Bumbally,illidan,384,druid,restoration,12,4,8
4851,Thebutterboy,stormrage,384,druid,restoration,12,4,8
4852,Bwaccowi,sargeras,384,druid,restoration,12,4,8
4853,Lillenan,illidan,384,druid,restoration,12,4,8
4854,Mé,arthas,384,druid,restoration,12,4,8
4855,Synthesïs,malganis,384,druid,restoration,12,4,8
4856,Eldertroll,boulderfist,384,druid,restoration,12,4,8
4857,Hotrecki,kelthuzad,384,druid,restoration,12,4,8
4858,Awguseon,proudmoore,384,druid,restoration,12,4,8
4859,Odenmu,ragnaros,384,druid,restoration,12,4,8
4860,Mastabtw,illidan,384,druid,restoration,12,4,8
4861,Bigshred,tichondrius,384,druid,restoration,12,4,8
4862,Stamaximdru,lightbringer,384,druid,restoration,12,4,8
4863,Tommyjimmy,andorhal,384,druid,restoration,12,4,8
4864,Bopple,tichondrius,384,druid,restoration,12,4,8
4865,Mkat,illidan,384,druid,restoration,12,4,8
4866,Mastahskills,illidan,384,druid,restoration,12,4,8
4867,Flompstomper,skullcrusher,384,druid,restoration,12,4,8
4868,Glenglooie,tichondrius,384,druid,restoration,12,4,8
4869,Tarvosx,thrall,384,druid,restoration,18,4,14
4870,Bryle,kiljaeden,383,druid,restoration,6,4,2
4871,Calleguard,terenas,383,druid,restoration,6,4,2
4872,Zelara,kilrogg,383,druid,restoration,12,4,8
4873,Jonnyutaa,emerald-dream,383,druid,restoration,12,4,8
4874,Posmard,ragnaros,383,druid,restoration,12,4,8
4875,Pahrump,stormrage,383,druid,restoration,12,4,8
4876,Hazbekbek,area-52,383,druid,restoration,12,4,8
4877,Migdrail,nemesis,383,druid,restoration,12,4,8
4878,Nightflow,emerald-dream,383,druid,restoration,12,4,8
4879,Xay,runetotem,383,druid,restoration,12,4,8
4880,Brazzar,kiljaeden,383,druid,restoration,12,4,8
4881,Ssuka,tichondrius,383,druid,restoration,12,4,8
4882,Rikey,thaurissan,383,druid,restoration,18,4,14
4883,Morphiius,archimonde,383,druid,restoration,18,4,14
4884,Madmandan,moon-guard,383,druid,restoration,18,4,14
4885,Beôrn,mugthol,382,druid,restoration,6,4,2
4886,Puzzlè,thrall,382,druid,restoration,12,4,8
4887,Guojue,tichondrius,382,druid,restoration,12,4,8
4888,Dytriax,ragnaros,381,druid,restoration,12,4,8
4889,Maldrake,quelthalas,381,druid,restoration,12,4,8
4890,Certzu,moon-guard,381,druid,restoration,18,4,14
4891,Bigbadcow,sargeras,380,druid,restoration,12,4,8
4892,Metamooseowl,crushridge,379,druid,restoration,12,4,8
4893,Yassi,earthen-ring,379,druid,restoration,12,4,8
4894,Breakthemm,bonechewer,379,druid,restoration,12,4,8
4895,Salpicow,nagrand,379,druid,restoration,12,4,8
4896,Nüg,frostmourne,379,druid,restoration,14,4,10
4897,Reyvin,illidan,362,druid,restoration,20,6,14
4898,Dashíng,proudmoore,348,druid,restoration,11,4,7
4899,Alleae,stormrage,319,druid,restoration,5,4,1
4900,Berchwunden,ragnaros,319,druid,restoration,10,4,6
4901,Elendriss,quelthalas,304,druid,restoration,13,4,9
4902,Realá,kelthuzad,288,druid,restoration,6,3,3
4903,Vadroid,dalaran,288,druid,restoration,6,3,3
4904,Hashdxm,tichondrius,288,druid,restoration,6,3,3
4905,Reptile,terenas,288,druid,restoration,6,3,3
4906,Spinach,moon-guard,288,druid,restoration,6,3,3
4907,Asian,moon-guard,288,druid,restoration,6,3,3
4908,Azaran,bleeding-hollow,288,druid,restoration,6,3,3
4909,Koratan,frostmourne,288,druid,restoration,6,3,3
4910,Wâggles,moon-guard,288,druid,restoration,6,3,3
4911,Cutefeetz,moon-guard,288,druid,restoration,6,3,3
4912,Panterarosa,ragnaros,288,druid,restoration,6,3,3
4913,Mythicdruid,ragnaros,288,druid,restoration,6,3,3
4914,Drmf,frostmourne,288,druid,restoration,6,3,3
4915,Imaoo,illidan,288,druid,restoration,6,3,3
4916,Hotwolf,tichondrius,288,druid,restoration,6,3,3
4917,Sonicphantom,kelthuzad,288,druid,restoration,6,3,3
4918,Obsesséd,aggramar,288,druid,restoration,6,3,3
4919,Ømí,quelthalas,288,druid,restoration,6,3,3
4920,Catahmine,thrall,288,druid,restoration,6,3,3
4921,Mädnhairy,zuljin,288,druid,restoration,6,3,3
4922,Tronita,frostwolf,288,druid,restoration,6,3,3
4923,Vìdá,tichondrius,288,druid,restoration,6,3,3
4924,Juicecarton,thrall,288,druid,restoration,6,3,3
4925,Yllercia,quelthalas,288,druid,restoration,6,3,3
4926,Thenog,arthas,288,druid,restoration,6,3,3
4927,Menapäws,area-52,288,druid,restoration,6,3,3
4928,Lðhnar,malganis,288,druid,restoration,6,3,3
4929,Swagglefrag,zuljin,288,druid,restoration,6,3,3
4930,Restokina,dreadmaul,288,druid,restoration,6,3,3
4931,Oneinchclaw,malganis,288,druid,restoration,6,3,3
4932,Antonniel,azralon,288,druid,restoration,6,3,3
4933,Veyx,malganis,288,druid,restoration,6,3,3
4934,Ðeepsixx,burning-legion,288,druid,restoration,6,3,3
4935,Tarlis,khazgoroth,288,druid,restoration,6,3,3
4936,Ayra,sargeras,288,druid,restoration,6,3,3
4937,Hotmuztard,sargeras,288,druid,restoration,6,3,3
4938,Càlthar,sargeras,288,druid,restoration,6,3,3
4939,Seekamp,khazgoroth,288,druid,restoration,6,3,3
4940,Nokash,tichondrius,288,druid,restoration,6,3,3
4941,Naturetazerr,sargeras,288,druid,restoration,6,3,3
4942,Qkdru,nemesis,288,druid,restoration,6,3,3
4943,Buffjungle,tichondrius,288,druid,restoration,6,3,3
4944,Gizho,sargeras,288,druid,restoration,6,3,3
4945,Junglefevers,tichondrius,288,druid,restoration,6,3,3
4946,Rdruid,zuluhed,288,druid,restoration,6,3,3
4947,Lighthoof,mannoroth,288,druid,restoration,6,3,3
4948,Owaru,stormrage,288,druid,restoration,6,3,3
4949,Eryon,nemesis,288,druid,restoration,6,3,3
4950,Wiskees,sargeras,288,druid,restoration,6,3,3
4951,Flatnose,agamaggan,288,druid,restoration,6,3,3
4952,Kcazz,thorium-brotherhood,288,druid,restoration,6,3,3
4953,Creamsoda,frostmane,288,druid,restoration,6,3,3
4954,Nightz,icecrown,288,druid,restoration,6,3,3
4955,Geno,cenarius,288,druid,restoration,6,3,3
4956,Kollective,sargeras,288,druid,restoration,6,3,3
4957,Aidoh,kelthuzad,288,druid,restoration,6,3,3
4958,Idolizeme,skullcrusher,288,druid,restoration,6,3,3
4959,Xötic,stormrage,288,druid,restoration,6,3,3
4960,Sneakiez,tichondrius,288,druid,restoration,6,3,3
4961,Catdruid,the-forgotten-coast,288,druid,restoration,6,3,3
4962,Tziv,area-52,288,druid,restoration,6,3,3
4963,Ulfvur,nagrand,288,druid,restoration,6,3,3
4964,Demitassie,wyrmrest-accord,288,druid,restoration,8,3,5
4965,Overgrowth,zuljin,288,druid,restoration,9,3,6
4966,Shiftydon,borean-tundra,288,druid,restoration,9,3,6
4967,Brotø,nemesis,288,druid,restoration,12,3,9
4968,Nuantar,nemesis,288,druid,restoration,12,3,9
4969,Endworldx,tichondrius,288,druid,restoration,12,3,9
4970,Nemoo,tichondrius,288,druid,restoration,12,3,9
4971,Oflodor,azralon,288,druid,restoration,12,3,9
4972,Sbc,anvilmar,288,druid,restoration,12,3,9
4973,Fyrleaf,lightnings-blade,288,druid,restoration,12,3,9
4974,Kitiano,thunderlord,288,druid,restoration,12,3,9
4975,Solushuffle,sargeras,288,druid,restoration,12,3,9
4976,Silasel,sargeras,288,druid,restoration,12,3,9
4977,Blacksimba,area-52,288,druid,restoration,12,3,9
4978,Soloqmenace,malganis,288,druid,restoration,12,3,9
4979,Raptormotoo,lothar,288,druid,restoration,12,3,9
4980,Borbys,sargeras,288,druid,restoration,12,3,9
4981,Garrodan,aerie-peak,288,druid,restoration,12,3,9
4982,Qdrui,tichondrius,288,druid,restoration,12,3,9
4983,Krispies,eredar,288,druid,restoration,12,3,9
4984,Wwkd,illidan,288,druid,restoration,12,3,9
4985,Theblind,korgath,288,druid,restoration,12,3,9
4986,Moobees,arthas,288,druid,restoration,12,3,9
4987,Monicaduan,frostmourne,288,druid,restoration,12,3,9
4988,Kanokoho,wyrmrest-accord,288,druid,restoration,12,3,9
4989,Biggié,bleeding-hollow,288,druid,restoration,12,3,9
4990,Quadrivium,stormrage,288,druid,restoration,12,3,9
4991,Møth,anvilmar,288,druid,restoration,12,3,9
4992,Azngødz,tichondrius,288,druid,restoration,12,3,9
4993,Deyz,ysera,288,druid,restoration,12,3,9
4994,Theømega,stormrage,288,druid,restoration,12,3,9
4995,Mattiu,area-52,288,druid,restoration,12,3,9
4996,Bøo,frostmourne,288,druid,restoration,12,3,9
4997,Cleptoresto,dalaran,288,druid,restoration,15,3,12
4998,Giddeonv,draenor,288,druid,restoration,18,3,15
4999,Friendly,wyrmrest-accord,288,druid,restoration,18,3,15
5000,Thundyrcat,tichondrius,288,druid,restoration,18,3,15
5001,Ayakuya,veknilash,287,druid,restoration,6,3,3
5002,Udala,durotan,287,druid,restoration,6,3,3
5003,Ugress,whisperwind,287,druid,restoration,6,3,3
5004,Glowstixz,tichondrius,287,druid,restoration,6,3,3
5005,Anakum,azshara,287,druid,restoration,6,3,3
5006,Sefestria,senjin,287,druid,restoration,6,3,3
5007,Breakertime,illidan,287,druid,restoration,6,3,3
5008,Budsmoke,stormrage,287,druid,restoration,6,3,3
5009,Erourk,azralon,287,druid,restoration,6,3,3
5010,Harderplease,emerald-dream,287,druid,restoration,6,3,3
5011,Xkcc,perenolde,287,druid,restoration,6,3,3
5012,Iamanoob,sargeras,287,druid,restoration,10,4,6
5013,Vulgär,kiljaeden,287,druid,restoration,12,3,9
5014,Lêsly,thrall,287,druid,restoration,12,3,9
5015,Atillah,stormscale,287,druid,restoration,12,3,9
5016,Megara,dalaran,287,druid,restoration,12,3,9
5017,Druishcat,dark-iron,287,druid,restoration,12,3,9
5018,Greythan,madoran,287,druid,restoration,18,3,15
5019,Cieran,senjin,287,druid,restoration,18,3,15
5020,Bullshiftter,ursin,286,druid,restoration,6,3,3
5021,Dcdc,malganis,286,druid,restoration,6,3,3
5022,Fortunecat,illidan,286,druid,restoration,12,3,9
5023,Sabari,area-52,285,druid,restoration,18,3,15
5024,Anastasyiar,illidan,256,druid,restoration,10,3,7
5025,Gloomy,andorhal,256,druid,restoration,10,3,7
5026,Cipozento,azralon,240,druid,restoration,9,3,6
5027,Bbabbi,tichondrius,239,druid,restoration,5,3,2
5028,Awkwarder,emerald-dream,239,druid,restoration,11,3,8
5029,Yoona,kiljaeden,234,druid,restoration,7,4,3
5030,Opiumheals,sargeras,234,druid,restoration,8,4,4
5031,Restyblazed,sargeras,234,druid,restoration,8,4,4
5032,Donaldsr,area-52,234,druid,restoration,9,4,5
5033,Stormwood,moonrunner,234,druid,restoration,21,4,17
5034,Stèvén,tichondrius,233,druid,restoration,13,4,9
5035,Gavdru,tichondrius,223,druid,restoration,8,3,5
5036,Blackmoomba,kiljaeden,192,druid,restoration,4,3,1
5037,Faentz,stormrage,192,druid,restoration,9,3,6
5038,Haful,emerald-dream,192,druid,restoration,6,2,4
5039,Firefireahh,sargeras,192,druid,restoration,6,2,4
5040,Mojoforweeks,bleeding-hollow,192,druid,restoration,6,2,4
5041,Crazywoodowl,tichondrius,192,druid,restoration,6,2,4
5042,Snugglin,kelthuzad,192,druid,restoration,6,2,4
5043,Cauroth,azralon,192,druid,restoration,6,2,4
5044,Batshi,gorefiend,192,druid,restoration,6,2,4
5045,Ghostti,stormrage,192,druid,restoration,6,2,4
5046,Tadoo,tichondrius,192,druid,restoration,6,2,4
5047,Lilcocoxoxo,shadowmoon,192,druid,restoration,6,2,4
5048,Tropikana,burning-legion,192,druid,restoration,6,2,4
5049,Psycloned,magtheridon,192,druid,restoration,6,2,4
5050,Droody,earthen-ring,192,druid,restoration,6,2,4
5051,Netflixnphil,sargeras,192,druid,restoration,6,2,4
5052,Pawpa,daggerspine,192,druid,restoration,6,2,4
5053,Fastyhands,illidan,192,druid,restoration,6,2,4
5054,Kaisuckslol,stormrage,192,druid,restoration,6,2,4
5055,Hawtzi,stormrage,192,druid,restoration,6,2,4
5056,Bigtonkatruk,tichondrius,192,druid,restoration,6,2,4
5057,Gorfrog,tichondrius,192,druid,restoration,6,2,4
5058,Freemac,tichondrius,192,druid,restoration,6,2,4
5059,Sandiegoo,destromath,192,druid,restoration,6,2,4
5060,Clonkzy,area-52,192,druid,restoration,6,2,4
5061,Runningback,emerald-dream,192,druid,restoration,6,2,4
5062,Akinetic,illidan,192,druid,restoration,6,2,4
5063,Krisdu,kelthuzad,192,druid,restoration,6,2,4
5064,Tatahe,zuljin,192,druid,restoration,6,2,4
5065,Fixn,tichondrius,192,druid,restoration,6,2,4
5066,Hatricio,ragnaros,192,druid,restoration,6,2,4
5067,Mcbeef,tichondrius,192,druid,restoration,6,2,4
5068,Nogardfan,tichondrius,192,druid,restoration,6,2,4
5069,Gepardéx,ragnaros,192,druid,restoration,6,2,4
5070,Ambassador,kelthuzad,192,druid,restoration,6,2,4
5071,Chopotron,ragnaros,192,druid,restoration,6,2,4
5072,Terminatore,kelthuzad,192,druid,restoration,6,2,4
5073,Violyte,tichondrius,192,druid,restoration,6,2,4
5074,Megasteak,lightninghoof,192,druid,restoration,6,2,4
5075,Acexten,tichondrius,192,druid,restoration,6,2,4
5076,Bekroh,crushridge,192,druid,restoration,6,2,4
5077,Cultnelf,illidan,192,druid,restoration,6,2,4
5078,Noonwalk,illidan,192,druid,restoration,6,2,4
5079,Tynsley,malganis,192,druid,restoration,6,2,4
5080,Cushionmaker,tichondrius,192,druid,restoration,6,2,4
5081,Bomp,malganis,192,druid,restoration,6,2,4
5082,Uniquexia,tichondrius,192,druid,restoration,6,2,4
5083,Loveflowers,nemesis,192,druid,restoration,6,2,4
5084,Nacur,bleeding-hollow,192,druid,restoration,6,2,4
5085,Minisavage,proudmoore,192,druid,restoration,6,2,4
5086,Niquil,hyjal,192,druid,restoration,6,2,4
5087,Levincy,thrall,192,druid,restoration,6,2,4
5088,Whiplash,deathwing,192,druid,restoration,6,2,4
5089,Hydruidponic,aegwynn,192,druid,restoration,6,2,4
5090,Five,the-underbog,192,druid,restoration,6,2,4
5091,Loved,stormrage,192,druid,restoration,6,2,4
5092,Fracxx,area-52,192,druid,restoration,6,2,4
5093,Barkcheeks,area-52,192,druid,restoration,6,2,4
5094,Relxlol,tichondrius,192,druid,restoration,6,2,4
5095,Dumpesito,frostmourne,192,druid,restoration,6,2,4
5096,Bullbuddy,wyrmrest-accord,192,druid,restoration,6,2,4
5097,Epicbehr,kiljaeden,192,druid,restoration,6,2,4
5098,Tempesd,stormrage,192,druid,restoration,6,2,4
5099,Zaddychulo,area-52,192,druid,restoration,6,2,4
5100,Kroshape,stormrage,192,druid,restoration,6,2,4
5101,Gretatunberg,skywall,192,druid,restoration,6,2,4
5102,Nightwinter,area-52,192,druid,restoration,6,2,4
5103,Zils,bleeding-hollow,192,druid,restoration,6,2,4
5104,Owlgz,barthilas,192,druid,restoration,6,2,4
5105,Murpheey,sargeras,192,druid,restoration,6,2,4
5106,Kagekuma,bleeding-hollow,192,druid,restoration,6,2,4
5107,Spoogel,area-52,192,druid,restoration,6,2,4
5108,Feeoria,lothar,192,druid,restoration,6,2,4
5109,Simperella,dalaran,192,druid,restoration,13,3,10
5110,Hotsx,frostmourne,192,druid,restoration,9,2,7
5111,Sleepyheals,tichondrius,192,druid,restoration,14,3,11
5112,Gradiluth,proudmoore,192,druid,restoration,12,2,10
5113,Urhero,sargeras,192,druid,restoration,12,2,10
5114,Kymolyia,sargeras,192,druid,restoration,12,2,10
5115,Enyu,sargeras,192,druid,restoration,12,2,10
5116,Batlex,thrall,192,druid,restoration,12,2,10
5117,Killvious,kelthuzad,192,druid,restoration,12,2,10
5118,Pinchncheeks,bleeding-hollow,192,druid,restoration,12,2,10
5119,Loganski,korialstrasz,192,druid,restoration,12,2,10
5120,Iyrnae,zuljin,192,druid,restoration,12,2,10
5121,Moocka,ragnaros,192,druid,restoration,12,2,10
5122,Moonkay,tichondrius,192,druid,restoration,12,2,10
5123,Daesdaddy,sargeras,192,druid,restoration,12,2,10
5124,Aelena,whisperwind,192,druid,restoration,12,2,10
5125,Grullandur,hakkar,192,druid,restoration,12,2,10
5126,Gahr,wyrmrest-accord,192,druid,restoration,12,2,10
5127,Kittysnuggle,emerald-dream,192,druid,restoration,12,2,10
5128,Rootslayer,tichondrius,192,druid,restoration,12,2,10
5129,Duckyy,garithos,192,druid,restoration,12,2,10
5130,Fribbleog,korgath,192,druid,restoration,12,2,10
5131,Crunchieroll,illidan,192,druid,restoration,12,2,10
5132,Trèè,frostmane,192,druid,restoration,12,2,10
5133,Bboikha,quelthalas,192,druid,restoration,12,2,10
5134,Elven,frostmourne,192,druid,restoration,12,2,10
5135,Ddizz,cairne,192,druid,restoration,12,2,10
5136,Lunmoon,thrall,192,druid,restoration,12,2,10
5137,Goorybud,tichondrius,192,druid,restoration,12,2,10
5138,Wonderhood,quelthalas,192,druid,restoration,12,2,10
5139,Bennedïct,tichondrius,192,druid,restoration,12,2,10
5140,Cpksdru,tichondrius,192,druid,restoration,12,2,10
5141,Devilzown,fenris,192,druid,restoration,18,2,16
5142,Çarpentree,sargeras,192,druid,restoration,18,2,16
5143,Brutalhealz,aegwynn,192,druid,restoration,18,2,16
5144,Clonemunster,frostmourne,192,druid,restoration,18,2,16
5145,Irontree,dunemaul,192,druid,restoration,18,2,16
5146,Moonkinx,frostwolf,191,druid,restoration,6,2,4
5147,Daweed,zuluhed,191,druid,restoration,12,2,10
5148,Voodooshiftz,emerald-dream,191,druid,restoration,12,2,10
5149,Äbÿss,tichondrius,191,druid,restoration,12,2,10
5150,Calliecat,moon-guard,191,druid,restoration,12,2,10
5151,Wantto,moknathal,190,druid,restoration,12,2,10
5152,Garritass,moon-guard,189,druid,restoration,29,2,27
5153,Dreamwalk,stormrage,175,druid,restoration,17,3,14
5154,Brbcatsonfir,malganis,175,druid,restoration,22,3,19
5155,Pvptactician,tichondrius,159,druid,restoration,11,4,7
5156,Jeppcat,tichondrius,159,druid,restoration,14,3,11
5157,Frenzymoon,zuljin,144,druid,restoration,3,3,0
5158,Pokieoaks,zuljin,138,druid,restoration,10,3,7
5159,Galind,rexxar,128,druid,restoration,4,2,2
5160,Alshari,proudmoore,128,druid,restoration,10,2,8
5161,Crunkk,thunderlord,127,druid,restoration,14,2,12
5162,Nohkotana,illidan,96,druid,restoration,3,2,1
5163,Forestmaster,area-52,96,druid,restoration,8,2,6
5164,Arienne,kelthuzad,96,druid,restoration,6,1,5
5165,Moonshocka,tichondrius,96,druid,restoration,6,1,5
5166,Arthridas,wyrmrest-accord,96,druid,restoration,6,1,5
5167,Feralgo,tichondrius,96,druid,restoration,6,1,5
5168,Rakroz,emerald-dream,96,druid,restoration,6,1,5
5169,Whitehaze,proudmoore,96,druid,restoration,6,1,5
5170,Leoho,tichondrius,96,druid,restoration,6,1,5
5171,Guap,bleeding-hollow,96,druid,restoration,6,1,5
5172,Inblooms,blackhand,96,druid,restoration,6,1,5
5173,Zabartak,lightnings-blade,96,druid,restoration,6,1,5
5174,Zeelán,emerald-dream,96,druid,restoration,6,1,5
5175,Macfluff,emerald-dream,96,druid,restoration,6,1,5
5176,Atagoo,tichondrius,96,druid,restoration,6,1,5
5177,Beldiin,khazgoroth,96,druid,restoration,6,1,5
5178,Ryhighd,sargeras,96,druid,restoration,6,1,5
5179,Ayla,gorefiend,96,druid,restoration,6,1,5
5180,Fartsicle,lightnings-blade,96,druid,restoration,6,1,5
5181,Jammi,skywall,96,druid,restoration,6,1,5
5182,Mollytonasty,demon-soul,96,druid,restoration,6,1,5
5183,Lokobah,wyrmrest-accord,96,druid,restoration,6,1,5
5184,Hille,sargeras,96,druid,restoration,6,1,5
5185,Samully,area-52,96,druid,restoration,6,1,5
5186,Mandingodam,auchindoun,96,druid,restoration,6,1,5
5187,Dotdmage,tichondrius,96,druid,restoration,6,1,5
5188,Botdruid,hyjal,96,druid,restoration,6,1,5
5189,Ðjx,stormrage,96,druid,restoration,6,1,5
5190,Ånxiety,skullcrusher,96,druid,restoration,6,1,5
5191,Kurzul,area-52,96,druid,restoration,6,1,5
5192,Tyrander,tichondrius,96,druid,restoration,6,1,5
5193,Sinistuhd,tichondrius,96,druid,restoration,6,1,5
5194,Djsummer,tichondrius,96,druid,restoration,6,1,5
5195,Hadoriss,kelthuzad,96,druid,restoration,6,1,5
5196,Rezl,sargeras,96,druid,restoration,6,1,5
5197,Fadingfast,frostmourne,96,druid,restoration,6,1,5
5198,Raìñ,tichondrius,96,druid,restoration,6,1,5
5199,Wrathmighty,frostmourne,96,druid,restoration,6,1,5
5200,Wotermelon,moon-guard,96,druid,restoration,6,1,5
5201,Jayto,frostmourne,96,druid,restoration,6,1,5
5202,Moocowbear,illidan,96,druid,restoration,6,1,5
5203,Suncintus,aggramar,96,druid,restoration,6,1,5
5204,Framess,area-52,96,druid,restoration,6,1,5
5205,Juves,frostmourne,96,druid,restoration,6,1,5
5206,Aimafengari,emerald-dream,96,druid,restoration,6,1,5
5207,Ttaure,ragnaros,96,druid,restoration,6,1,5
5208,Nìck,the-scryers,96,druid,restoration,6,1,5
5209,Chomperz,tichondrius,96,druid,restoration,6,1,5
5210,Kzdubya,stormrage,96,druid,restoration,6,1,5
5211,Solá,skywall,96,druid,restoration,6,1,5
5212,Moonfart,zuljin,96,druid,restoration,6,1,5
5213,Natürëblÿät,illidan,96,druid,restoration,6,1,5
5214,Moonkingx,ragnaros,96,druid,restoration,6,1,5
5215,Stephonxd,area-52,96,druid,restoration,6,1,5
5216,Keithmoonkin,area-52,96,druid,restoration,6,1,5
5217,Gruulnir,antonidas,96,druid,restoration,6,1,5
5218,Spatulas,malganis,96,druid,restoration,6,1,5
5219,Caminanube,quelthalas,96,druid,restoration,6,1,5
5220,Rastakant,malganis,96,druid,restoration,6,1,5
5221,Dedderita,bloodhoof,96,druid,restoration,6,1,5
5222,Nyanncat,frostmourne,96,druid,restoration,7,1,6
5223,Lirilith,shadowsong,96,druid,restoration,16,2,14
5224,Shebleeder,aegwynn,96,druid,restoration,11,1,10
5225,Foracus,sargeras,96,druid,restoration,11,1,10
5226,Kaeliah,stormrage,96,druid,restoration,12,1,11
5227,Kopidruid,barthilas,96,druid,restoration,12,1,11
5228,Sinigang,duskwood,96,druid,restoration,12,1,11
5229,Lacarne,tichondrius,96,druid,restoration,12,1,11
5230,Morpheûs,bleeding-hollow,96,druid,restoration,12,1,11
5231,Thorsèn,sargeras,96,druid,restoration,15,1,14
5232,Grakzul,blood-furnace,95,druid,restoration,9,2,7
5233,Eliteshift,frostmourne,64,druid,restoration,4,1,3
5234,Pownage,kelthuzad,64,druid,restoration,16,1,15
5235,Smorak,area-52,63,druid,restoration,2,2,0
5236,Bòmi,tichondrius,63,druid,restoration,2,2,0
5237,Suwonhealer,tichondrius,31,druid,restoration,8,1,7
5238,Neferpitou,fenris,16,druid,restoration,6,1,5
5239,Landro,tichondrius,1433,druid,guardian,101,50,51
5240,Haalls,gallywix,1107,druid,guardian,36,12,24
5241,Crashägásm,proudmoore,1062,druid,guardian,30,15,15
5242,Kesagake,feathermoon,921,druid,guardian,18,10,8
5243,Maraliss,shadowsong,890,druid,guardian,24,12,12
5244,Ashamang,emerald-dream,855,druid,guardian,12,9,3
5245,Mordu,rivendare,838,druid,guardian,25,9,16
5246,Inxert,tichondrius,792,druid,guardian,16,9,7
5247,Koan,proudmoore,671,druid,guardian,24,7,17
5248,Jacinty,saurfang,670,druid,guardian,18,7,11
5249,Multivar,burning-legion,669,druid,guardian,12,7,5
5250,Theme,frostwolf,669,druid,guardian,18,7,11
5251,Agmukar,wyrmrest-accord,659,druid,guardian,12,7,5
5252,Lycanthus,thrall,575,druid,guardian,12,6,6
5253,Ishiftalot,bleeding-hollow,573,druid,guardian,15,7,8
5254,Bjørnen,thrall,570,druid,guardian,12,6,6
5255,Giddeonv,draenor,570,druid,guardian,12,6,6
5256,Dalidielor,dalaran,480,druid,guardian,12,5,7
5257,Chärmin,area-52,479,druid,guardian,12,5,7
5258,Gifteddream,zuljin,474,druid,guardian,12,5,7
5259,Balanah,quelthalas,472,druid,guardian,15,6,9
5260,Maen,kelthuzad,384,druid,guardian,6,4,2
5261,Bigxworm,gurubashi,384,druid,guardian,12,4,8
5262,Wraithman,madoran,383,druid,guardian,6,4,2
5263,Firash,frostmourne,382,druid,guardian,6,4,2
5264,Aìón,emerald-dream,382,druid,guardian,6,4,2
5265,Tankbareass,aerie-peak,382,druid,guardian,18,4,14
5266,Read,boulderfist,288,druid,guardian,12,3,9
5267,Woozydruid,anetheron,288,druid,guardian,12,3,9
5268,Manwool,illidan,288,druid,guardian,12,3,9
5269,Cayinna,altar-of-storms,288,druid,guardian,12,3,9
5270,Deutschland,whisperwind,288,druid,guardian,12,3,9
5271,Mavren,uldaman,286,druid,guardian,6,3,3
5272,Classykitty,tichondrius,192,druid,guardian,4,3,1
5273,Skrimshaw,burning-legion,192,druid,guardian,6,2,4
5274,Athious,moon-guard,192,druid,guardian,6,2,4
5275,Mommyh,duskwood,192,druid,guardian,6,2,4
5276,Lilgushy,area-52,192,druid,guardian,6,2,4
5277,Avbox,proudmoore,192,druid,guardian,6,2,4
5278,Fluff,gurubashi,192,druid,guardian,6,2,4
5279,Battlecát,stormscale,192,druid,guardian,6,2,4
5280,Manasmi,frostmourne,191,druid,guardian,6,2,4
5281,Meliódás,area-52,191,druid,guardian,18,2,16
5282,Gornish,azralon,190,druid,guardian,12,2,10
5283,Kushtiger,ragnaros,96,druid,guardian,6,1,5
5284,Drur,zuljin,96,druid,guardian,6,1,5
5285,Agaxaido,azgalor,96,druid,guardian,6,1,5
5286,Sixfeetunder,shattered-halls,96,druid,guardian,6,1,5
5287,Wintarz,sargeras,96,druid,guardian,6,1,5
5288,Funkbear,black-dragonflight,96,druid,guardian,6,1,5
5289,Vindecca,kelthuzad,96,druid,guardian,6,1,5
5290,Aurno,queldorei,96,druid,guardian,6,1,5
5291,Woowis,stormrage,96,druid,guardian,12,1,11
5292,Vineclaw,emerald-dream,96,druid,guardian,12,1,11
5293,Kylysea,dalaran,96,druid,guardian,12,1,11
5294,Lakroz,zuljin,95,druid,guardian,6,1,5
5295,Sitruk,uldum,63,druid,guardian,10,1,9
5296,Bawbe,lightbringer,2202,druid,feral,89,51,38
5297,Marvin,stormreaver,2201,druid,feral,94,49,45
5298,Loser,stormrage,2155,druid,feral,87,46,41
5299,Nyç,sargeras,2139,druid,feral,216,116,100
5300,Angryalyu,tichondrius,2133,druid,feral,90,45,45
5301,Auntsusie,stormrage,2128,druid,feral,95,61,34
5302,Iinkinbio,alleria,2124,druid,feral,84,50,34
5303,Crunchyroll,sargeras,2100,druid,feral,162,87,75
5304,Formrage,jubeithos,2097,druid,feral,206,108,98
5305,Boomboombom,tichondrius,2054,druid,feral,119,72,47
5306,Jaguar,whisperwind,2041,druid,feral,66,39,27
5307,Floppa,whisperwind,2026,druid,feral,72,39,33
5308,Henikbite,zuljin,2018,druid,feral,125,65,60
5309,Beomjun,tichondrius,2009,druid,feral,101,57,44
5310,Yüxy,sargeras,2002,druid,feral,120,56,64
5311,Boomboomboom,misha,1986,druid,feral,93,47,46
5312,Amellies,quelthalas,1980,druid,feral,184,98,86
5313,Abstractf,sargeras,1972,druid,feral,74,44,30
5314,Trìckyz,tichondrius,1965,druid,feral,116,61,55
5315,Babekisser,stormrage,1961,druid,feral,130,69,61
5316,Vinjo,ragnaros,1955,druid,feral,90,42,48
5317,Pdfilewatch,stormrage,1943,druid,feral,42,30,12
5318,Duhfective,proudmoore,1942,druid,feral,59,32,27
5319,Feeg,sargeras,1937,druid,feral,65,33,32
5320,Chowxx,tichondrius,1937,druid,feral,90,43,47
5321,Cliodhna,kelthuzad,1914,druid,feral,78,40,38
5322,Alleae,stormrage,1908,druid,feral,54,32,22
5323,Skrambles,mugthol,1906,druid,feral,75,36,39
5324,Fappywapple,kiljaeden,1899,druid,feral,118,58,60
5325,Samuel,ravencrest,1897,druid,feral,60,33,27
5326,Floorz,firetree,1895,druid,feral,42,23,19
5327,Ripbot,sargeras,1894,druid,feral,59,31,28
5328,Duzis,tichondrius,1887,druid,feral,48,28,20
5329,Bassy,whisperwind,1885,druid,feral,70,31,39
5330,Porkonmyfork,frostmourne,1870,druid,feral,40,24,16
5331,Astrozxy,sargeras,1860,druid,feral,42,23,19
5332,Darmari,quelthalas,1852,druid,feral,60,27,33
5333,Rwhatkr,tichondrius,1847,druid,feral,47,20,27
5334,Kynvi,moon-guard,1846,druid,feral,48,24,24
5335,Sammy,scilla,1842,druid,feral,84,40,44
5336,Lesliewj,proudmoore,1840,druid,feral,65,35,30
5337,Tyxi,bleeding-hollow,1839,druid,feral,46,31,15
5338,Yukjr,stormrage,1839,druid,feral,137,66,71
5339,Yayue,tichondrius,1830,druid,feral,72,37,35
5340,Bpdferal,stormrage,1828,druid,feral,180,99,81
5341,Russiaguy,area-52,1826,druid,feral,271,141,130
5342,Porkloafed,illidan,1824,druid,feral,94,53,41
5343,Sappora,illidan,1824,druid,feral,178,92,86
5344,Feignxd,emerald-dream,1823,druid,feral,60,43,17
5345,Nuadris,azralon,1822,druid,feral,168,86,82
5346,Chrye,tichondrius,1820,druid,feral,69,35,34
5347,Calikonger,spirestone,1819,druid,feral,48,23,25
5348,Kakaroot,tichondrius,1813,druid,feral,153,78,75
5349,Hugecat,tichondrius,1812,druid,feral,60,26,34
5350,Stellar,steamwheedle-cartel,1808,druid,feral,114,54,60
5351,Ërebüs,emerald-dream,1802,druid,feral,47,22,25
5352,Notapn,tichondrius,1786,druid,feral,78,40,38
5353,Zuljor,sargeras,1784,druid,feral,24,19,5
5354,Icespicè,tichondrius,1772,druid,feral,84,38,46
5355,Killuf,quelthalas,1767,druid,feral,95,35,60
5356,Proudfurryxo,dragonmaw,1765,druid,feral,50,27,23
5357,Kobez,bleeding-hollow,1748,druid,feral,84,46,38
5358,Lemön,frostmourne,1745,druid,feral,42,21,21
5359,Vebee,frostmourne,1744,druid,feral,53,29,24
5360,Mhdd,tichondrius,1739,druid,feral,66,38,28
5361,Tyx,bleeding-hollow,1736,druid,feral,62,28,34
5362,Extic,sargeras,1730,druid,feral,66,38,28
5363,Blrr,sargeras,1730,druid,feral,60,28,32
5364,Fangry,queldorei,1725,druid,feral,106,57,49
5365,Fliip,barthilas,1711,druid,feral,53,27,26
5366,Addymeow,drenden,1709,druid,feral,54,30,24
5367,Thycamore,cenarius,1708,druid,feral,60,23,37
5368,Bearoids,daggerspine,1706,druid,feral,42,29,13
5369,Oroskii,bleeding-hollow,1705,druid,feral,60,31,29
5370,Yavà,tichondrius,1700,druid,feral,48,30,18
5371,Kolbie,emerald-dream,1699,druid,feral,107,59,48
5372,Mocfernando,sargeras,1698,druid,feral,42,23,19
5373,Cjæ,bleeding-hollow,1693,druid,feral,40,26,14
5374,Dahmu,malygos,1691,druid,feral,180,98,82
5375,Turow,firetree,1690,druid,feral,53,25,28
5376,Wildfire,nesingwary,1686,druid,feral,105,55,50
5377,Nicó,darkspear,1686,druid,feral,105,49,56
5378,Nrp,stormrage,1684,druid,feral,108,44,64
5379,Flowkie,illidan,1683,druid,feral,110,55,55
5380,Raincloud,mannoroth,1680,druid,feral,36,22,14
5381,Nitetree,thrall,1679,druid,feral,60,31,29
5382,Akanx,tichondrius,1677,druid,feral,36,21,15
5383,Hriiya,tichondrius,1676,druid,feral,47,18,29
5384,Luvgames,area-52,1673,druid,feral,76,41,35
5385,Lycanthrøpe,moon-guard,1672,druid,feral,80,35,45
5386,Bearlylegalz,kelthuzad,1671,druid,feral,48,23,25
5387,Dewfuss,tichondrius,1669,druid,feral,54,31,23
5388,Tenavï,stormrage,1668,druid,feral,42,20,22
5389,Redhotbean,tichondrius,1665,druid,feral,40,23,17
5390,Anxietyburns,stormrage,1660,druid,feral,66,40,26
5391,Plux,illidan,1658,druid,feral,162,88,74
5392,Brewdock,boulderfist,1656,druid,feral,45,21,24
5393,Chasertv,tichondrius,1650,druid,feral,36,19,17
5394,Zlegacy,anvilmar,1650,druid,feral,54,21,33
5395,Jpegcollectr,tichondrius,1649,druid,feral,66,23,43
5396,Kyoski,moon-guard,1645,druid,feral,34,19,15
5397,Unfriendly,bleeding-hollow,1644,druid,feral,113,62,51
5398,Kibbens,area-52,1643,druid,feral,196,98,98
5399,Bhen,tichondrius,1643,druid,feral,42,19,23
5400,Zirrie,stormrage,1640,druid,feral,44,25,19
5401,Ferar,frostmourne,1640,druid,feral,59,28,31
5402,Tompunch,tichondrius,1640,druid,feral,61,28,33
5403,Lucky,destromath,1638,druid,feral,150,71,79
5404,Bigbite,tichondrius,1637,druid,feral,48,27,21
5405,Xyphor,bladefist,1637,druid,feral,40,22,18
5406,Yavann,tichondrius,1636,druid,feral,106,58,48
5407,Meanbear,stormrage,1633,druid,feral,42,23,19
5408,Erykk,dalaran,1631,druid,feral,54,23,31
5409,Atrumn,emerald-dream,1631,druid,feral,78,33,45
5410,Evildooer,stormrage,1630,druid,feral,30,17,13
5411,Grizzlepaw,tichondrius,1628,druid,feral,81,46,35
5412,Foxmeowz,blackwater-raiders,1627,druid,feral,36,20,16
5413,Jazzxs,proudmoore,1627,druid,feral,36,18,18
5414,Off,ravencrest,1622,druid,feral,172,86,86
5415,Phøënîx,tichondrius,1622,druid,feral,36,17,19
5416,Cracked,vashj,1621,druid,feral,34,21,13
5417,Gabdruid,kiljaeden,1621,druid,feral,48,23,25
5418,Zyhsul,emerald-dream,1620,druid,feral,42,21,21
5419,Fuqet,kelthuzad,1620,druid,feral,111,52,59
5420,Durwyn,sargeras,1620,druid,feral,153,71,82
5421,Sïmba,andorhal,1619,druid,feral,65,26,39
5422,Enya,stormreaver,1618,druid,feral,66,31,35
5423,Hiddenfur,ragnaros,1617,druid,feral,36,19,17
5424,Poosnickety,kelthuzad,1617,druid,feral,49,21,28
5425,Wøs,area-52,1615,druid,feral,98,50,48
5426,Kdrumania,tichondrius,1614,druid,feral,152,83,69
5427,Zenlonn,emerald-dream,1614,druid,feral,41,19,22
5428,Nobruh,sargeras,1608,druid,feral,89,43,46
5429,Melez,kelthuzad,1607,druid,feral,157,82,75
5430,Chococrispis,quelthalas,1606,druid,feral,48,21,27
5431,Linkinbiox,alleria,1603,druid,feral,36,19,17
5432,Stêff,zuljin,1602,druid,feral,66,33,33
5433,Oldtomcat,moon-guard,1601,druid,feral,90,42,48
5434,Zwaski,thrall,1601,druid,feral,74,34,40
5435,Feralgo,tichondrius,1600,druid,feral,30,17,13
5436,Akamu,nemesis,1600,druid,feral,48,17,31
5437,Irontree,dunemaul,1598,druid,feral,48,23,25
5438,Ursarius,skullcrusher,1590,druid,feral,53,25,28
5439,Rank,nerzhul,1588,druid,feral,126,59,67
5440,Azrethyu,emerald-dream,1578,druid,feral,66,28,38
5441,Jaspurr,illidan,1574,druid,feral,60,33,27
5442,Conker,frostmourne,1572,druid,feral,126,63,63
5443,Skyde,sargeras,1571,druid,feral,93,42,51
5444,Franksuba,windrunner,1568,druid,feral,108,53,55
5445,Csinii,bleeding-hollow,1566,druid,feral,48,18,30
5446,Idiotferal,tortheldrin,1564,druid,feral,30,19,11
5447,Slanue,tichondrius,1556,druid,feral,64,26,38
5448,Rokaizu,dalaran,1555,druid,feral,36,17,19
5449,Kwilli,tichondrius,1552,druid,feral,56,29,27
5450,Darkombra,frostmourne,1548,druid,feral,54,27,27
5451,Sugarbawls,area-52,1546,druid,feral,66,32,34
5452,Kaisuckslol,stormrage,1543,druid,feral,150,76,74
5453,Fendiy,barthilas,1539,druid,feral,72,40,32
5454,Rahxay,quelthalas,1539,druid,feral,71,32,39
5455,Jonio,tichondrius,1539,druid,feral,71,30,41
5456,Mxdi,tichondrius,1535,druid,feral,36,19,17
5457,Fyrkax,sargeras,1534,druid,feral,24,16,8
5458,Delorík,illidan,1534,druid,feral,66,32,34
5459,Waggs,illidan,1532,druid,feral,36,16,20
5460,Amishal,stormrage,1529,druid,feral,54,19,35
5461,Cawkaw,frostwolf,1528,druid,feral,122,62,60
5462,Xanybarz,stormrage,1528,druid,feral,107,50,57
5463,Jizzie,tichondrius,1527,druid,feral,90,52,38
5464,Shreds,kirin-tor,1522,druid,feral,48,16,32
5465,Ulcera,nemesis,1520,druid,feral,48,30,18
5466,Senex,stormrage,1518,druid,feral,100,60,40
5467,Ikkarus,nemesis,1515,druid,feral,107,57,50
5468,Cätwälk,gnomeregan,1511,druid,feral,36,16,20
5469,Lakunahof,ragnaros,1510,druid,feral,33,17,16
5470,Hellodan,proudmoore,1509,druid,feral,60,26,34
5471,Kushtiger,ragnaros,1508,druid,feral,102,52,50
5472,Goldferal,illidan,1505,druid,feral,24,18,6
5473,Prowli,tichondrius,1505,druid,feral,128,69,59
5474,Swolareclips,eitrigg,1498,druid,feral,156,75,81
5475,Tree,lothar,1497,druid,feral,48,29,19
5476,Gregondor,skullcrusher,1490,druid,feral,30,16,14
5477,Bênî,emerald-dream,1489,druid,feral,114,57,57
5478,Ozex,crushridge,1484,druid,feral,42,17,25
5479,Dimsump,zuljin,1483,druid,feral,48,16,32
5480,Luluid,tichondrius,1481,druid,feral,65,30,35
5481,Revcow,malganis,1477,druid,feral,42,21,21
5482,Faelonk,frostmourne,1476,druid,feral,66,32,34
5483,Weedsmuggler,burning-legion,1471,druid,feral,179,91,88
5484,Duckystryker,tichondrius,1470,druid,feral,54,21,33
5485,Prêdator,ragnaros,1467,druid,feral,119,63,56
5486,Roots,anubarak,1466,druid,feral,63,36,27
5487,Eletto,stormrage,1466,druid,feral,48,25,23
5488,Oreganic,barthilas,1464,druid,feral,93,48,45
5489,Dillywadz,tichondrius,1463,druid,feral,158,72,86
5490,Zivak,azshara,1460,druid,feral,66,32,34
5491,Hoffhoff,area-52,1458,druid,feral,36,22,14
5492,Blut,stormrage,1458,druid,feral,186,89,97
5493,Malfurionsto,moon-guard,1458,druid,feral,42,16,26
5494,Jurasico,ragnaros,1456,druid,feral,221,110,111
5495,Badferal,blackhand,1455,druid,feral,78,38,40
5496,Erwelz,quelthalas,1455,druid,feral,41,19,22
5497,Sheeyts,tichondrius,1453,druid,feral,72,37,35
5498,Bossdru,sargeras,1447,druid,feral,47,28,19
5499,Chomperz,tichondrius,1442,druid,feral,85,45,40
5500,Prille,tichondrius,1438,druid,feral,33,16,17
5501,Dobromar,quelthalas,1435,druid,feral,18,15,3
5502,Käïïjü,tichondrius,1432,druid,feral,76,28,48
5503,Milkmoneymeo,illidan,1431,druid,feral,30,15,15
5504,Classydruid,spinebreaker,1431,druid,feral,84,39,45
5505,Feond,illidan,1430,druid,feral,94,49,45
5506,Bukybuky,tichondrius,1429,druid,feral,48,26,22
5507,Canlexd,moon-guard,1429,druid,feral,42,20,22
5508,Wowgamer,sargeras,1427,druid,feral,24,15,9
5509,Hööper,illidan,1427,druid,feral,54,19,35
5510,Shiftalk,nerzhul,1422,druid,feral,42,18,24
5511,Galind,rexxar,1421,druid,feral,28,18,10
5512,Fugekî,zuljin,1420,druid,feral,41,24,17
5513,Kaissara,nemesis,1420,druid,feral,32,17,15
5514,Bobmarli,kiljaeden,1420,druid,feral,30,15,15
5515,Ocêanus,sargeras,1417,druid,feral,18,15,3
5516,Treespec,stormrage,1414,druid,feral,29,18,11
5517,Bullcritzz,saurfang,1413,druid,feral,88,50,38
5518,Gairen,the-venture-co,1413,druid,feral,48,25,23
5519,Neetform,zuljin,1413,druid,feral,65,30,35
5520,Muwudred,stormrage,1410,druid,feral,36,15,21
5521,Clarice,shattered-halls,1409,druid,feral,24,15,9
5522,Traxxo,tichondrius,1407,druid,feral,42,17,25
5523,Sweetxtooth,area-52,1403,druid,feral,81,43,38
5524,Flowke,illidan,1401,druid,feral,32,16,16
5525,Swornenemy,mugthol,1399,druid,feral,30,18,12
5526,Snowfaerie,moon-guard,1399,druid,feral,356,186,170
5527,Chitára,ragnaros,1399,druid,feral,130,67,63
5528,Gonjatusk,ravencrest,1397,druid,feral,54,30,24
5529,Freinnar,kiljaeden,1393,druid,feral,36,15,21
5530,Ytgamezoned,darkspear,1390,druid,feral,30,16,14
5531,Oneinchclaw,malganis,1389,druid,feral,84,41,43
5532,Treeweed,tichondrius,1386,druid,feral,81,42,39
5533,Hjerim,quelthalas,1386,druid,feral,50,24,26
5534,Silvshifter,frostmourne,1382,druid,feral,29,22,7
5535,Vakimumu,anubarak,1380,druid,feral,40,18,22
5536,Hroney,area-52,1379,druid,feral,54,22,32
5537,Craak,tichondrius,1376,druid,feral,41,19,22
5538,Bigthirty,area-52,1372,druid,feral,30,19,11
5539,Fastcat,moon-guard,1369,druid,feral,54,25,29
5540,Herbx,sargeras,1366,druid,feral,60,30,30
5541,Vaniedron,zuljin,1365,druid,feral,111,43,68
5542,Gorim,area-52,1364,druid,feral,48,26,22
5543,Tardcakes,tichondrius,1362,druid,feral,62,31,31
5544,Gnairda,sargeras,1361,druid,feral,186,96,90
5545,Boll,akama,1361,druid,feral,34,15,19
5546,Lunarboy,tichondrius,1358,druid,feral,37,16,21
5547,Kilohanno,alexstrasza,1356,druid,feral,42,19,23
5548,Iamnature,dalaran,1355,druid,feral,67,30,37
5549,Fugg,frostmourne,1350,druid,feral,84,34,50
5550,Riseagainst,ragnaros,1349,druid,feral,34,23,11
5551,Darkdragoonz,barthilas,1344,druid,feral,43,20,23
5552,Floorz,bleeding-hollow,1343,druid,feral,24,14,10
5553,Azoth,hyjal,1342,druid,feral,24,14,10
5554,Senorcholo,malganis,1342,druid,feral,36,18,18
5555,Catzetzan,tichondrius,1342,druid,feral,30,14,16
5556,Smeow,zuljin,1339,druid,feral,39,16,23
5557,Brawleyx,tichondrius,1337,druid,feral,36,14,22
5558,Riemannzeta,azgalor,1336,druid,feral,54,29,25
5559,Beastbaby,eldrethalas,1336,druid,feral,36,14,22
5560,Hoppus,icecrown,1336,druid,feral,81,30,51
5561,Hoofin,blackwing-lair,1334,druid,feral,84,34,50
5562,Tenedoors,ragnaros,1334,druid,feral,54,18,36
5563,Dustin,moon-guard,1332,druid,feral,97,46,51
5564,Khyzan,illidan,1329,druid,feral,78,41,37
5565,Gapingloli,tichondrius,1327,druid,feral,39,21,18
5566,Naturestouch,tichondrius,1327,druid,feral,30,14,16
5567,Datkittydoe,kiljaeden,1323,druid,feral,43,20,23
5568,Hadox,azralon,1321,druid,feral,89,43,46
5569,Bullboy,frostmourne,1320,druid,feral,30,17,13
5570,Bleedz,mugthol,1319,druid,feral,36,18,18
5571,Panyot,kiljaeden,1318,druid,feral,60,31,29
5572,Aahx,thrall,1317,druid,feral,123,69,54
5573,Kyrô,sargeras,1317,druid,feral,29,14,15
5574,Isalien,stormrage,1313,druid,feral,62,33,29
5575,Ninefeet,argent-dawn,1311,druid,feral,72,37,35
5576,Suedle,kelthuzad,1309,druid,feral,29,14,15
5577,Jasminonmars,zuluhed,1305,druid,feral,65,36,29
5578,Asteriel,stormrage,1305,druid,feral,52,25,27
5579,Malthen,quelthalas,1304,druid,feral,78,38,40
5580,Frostelles,stormrage,1303,druid,feral,121,57,64
5581,Nyanncat,frostmourne,1302,druid,feral,30,14,16
5582,Nojiling,quelthalas,1301,druid,feral,55,24,31
5583,Azuredreams,bleeding-hollow,1301,druid,feral,36,15,21
5584,Percefhone,azralon,1300,druid,feral,92,41,51
5585,Raebies,dalaran,1297,druid,feral,99,53,46
5586,Sahksi,lothar,1297,druid,feral,60,30,30
5587,Mbarakaja,malganis,1297,druid,feral,149,70,79
5588,Anessan,silvermoon,1296,druid,feral,44,23,21
5589,Ðreadfang,tichondrius,1295,druid,feral,47,28,19
5590,Bigmolii,quelthalas,1293,druid,feral,86,34,52
5591,Awarz,drakkari,1291,druid,feral,36,14,22
5592,Erahar,illidan,1281,druid,feral,46,24,22
5593,Malu,muradin,1278,druid,feral,30,17,13
5594,Cheshiire,moon-guard,1276,druid,feral,161,75,86
5595,Súse,sargeras,1269,druid,feral,59,29,30
5596,Gotroadrash,azuremyst,1268,druid,feral,23,14,9
5597,Glockitty,tichondrius,1262,druid,feral,90,42,48
5598,Dätto,thrall,1261,druid,feral,54,25,29
5599,Feanah,tichondrius,1259,druid,feral,66,29,37
5600,Styli,tichondrius,1253,druid,feral,26,17,9
5601,Nèffex,sargeras,1247,druid,feral,18,13,5
5602,Zelyvia,moon-guard,1247,druid,feral,30,14,16
5603,Sporadiclive,sargeras,1247,druid,feral,30,13,17
5604,Mariko,area-52,1245,druid,feral,59,26,33
5605,Enchiladacat,stormrage,1243,druid,feral,24,13,11
5606,Shmayba,malganis,1241,druid,feral,24,13,11
5607,Kellydacat,azuremyst,1241,druid,feral,24,13,11
5608,Pfheral,area-52,1240,druid,feral,30,13,17
5609,Theømega,stormrage,1237,druid,feral,24,13,11
5610,Hektuk,barthilas,1235,druid,feral,34,19,15
5611,Wwf,thrall,1235,druid,feral,60,23,37
5612,Ourse,aegwynn,1234,druid,feral,77,46,31
5613,Kleanxx,tichondrius,1232,druid,feral,223,111,112
5614,Matpd,norgannon,1228,druid,feral,66,28,38
5615,Orthognathic,emerald-dream,1227,druid,feral,57,35,22
5616,Bâgheera,sargeras,1225,druid,feral,61,25,36
5617,Dkkng,dalaran,1224,druid,feral,30,16,14
5618,Xanbàr,hyjal,1222,druid,feral,35,22,13
5619,Twistach,quelthalas,1222,druid,feral,24,13,11
5620,Koducck,tichondrius,1221,druid,feral,30,13,17
5621,Yobibit,terenas,1221,druid,feral,36,14,22
5622,Swappy,korgath,1220,druid,feral,69,31,38
5623,Zelazia,area-52,1219,druid,feral,30,16,14
5624,Beargodx,stormrage,1218,druid,feral,54,28,26
5625,Scruffywolf,tichondrius,1217,druid,feral,143,63,80
5626,Berd,whisperwind,1215,druid,feral,40,20,20
5627,Midnitex,illidan,1214,druid,feral,37,16,21
5628,Psychofeör,quelthalas,1213,druid,feral,82,39,43
5629,Freddiemerk,moon-guard,1210,druid,feral,24,13,11
5630,Pusswhisperr,bleeding-hollow,1210,druid,feral,42,15,27
5631,Hermbott,proudmoore,1206,druid,feral,48,23,25
5632,Werebruin,bleeding-hollow,1201,druid,feral,61,33,28
5633,Spinach,moon-guard,1195,druid,feral,33,13,20
5634,Behrhart,stormrage,1194,druid,feral,18,13,5
5635,Beygatti,sargeras,1194,druid,feral,49,18,31
5636,Hctibrehtom,illidan,1193,druid,feral,24,20,4
5637,Kaya,hyjal,1193,druid,feral,36,13,23
5638,Destrez,ragnaros,1188,druid,feral,27,13,14
5639,Yukcyducky,tichondrius,1185,druid,feral,60,22,38
5640,Sansao,sargeras,1179,druid,feral,42,21,21
5641,Khione,dreadmaul,1172,druid,feral,68,38,30
5642,Haneulso,tichondrius,1171,druid,feral,33,14,19
5643,Dehltax,stormrage,1169,druid,feral,54,29,25
5644,Nomnomnomn,chogall,1168,druid,feral,22,13,9
5645,Xdkittyrawr,tichondrius,1168,druid,feral,94,46,48
5646,Bloodriot,wyrmrest-accord,1164,druid,feral,50,17,33
5647,Borybuilder,azralon,1153,druid,feral,52,22,30
5648,Ishiftalot,bleeding-hollow,1153,druid,feral,57,23,34
5649,Europecat,stormrage,1152,druid,feral,24,12,12
5650,Ryecoke,stormrage,1151,druid,feral,24,12,12
5651,Kiwidru,frostmourne,1150,druid,feral,18,12,6
5652,Kyrona,frostmourne,1150,druid,feral,36,22,14
5653,Chambz,tichondrius,1148,druid,feral,60,24,36
5654,Hupod,proudmoore,1146,druid,feral,36,17,19
5655,Concordya,tichondrius,1146,druid,feral,30,13,17
5656,Doblun,nemesis,1146,druid,feral,36,12,24
5657,Anastasyiar,illidan,1142,druid,feral,30,12,18
5658,Shiftex,arthas,1140,druid,feral,30,12,18
5659,Zazieraiel,moon-guard,1139,druid,feral,33,13,20
5660,Aligantor,thrall,1134,druid,feral,18,12,6
5661,Chëësëbürgër,illidan,1128,druid,feral,97,45,52
5662,Surmise,tichondrius,1127,druid,feral,30,13,17
5663,Vintera,sargeras,1123,druid,feral,99,49,50
5664,Yobolsun,sargeras,1123,druid,feral,36,16,20
5665,Elunaya,illidan,1122,druid,feral,36,15,21
5666,Tonoshapepai,azralon,1122,druid,feral,36,13,23
5667,Shahahrazad,queldorei,1118,druid,feral,36,12,24
5668,Kotau,azralon,1117,druid,feral,36,23,13
5669,Eyzie,stormrage,1115,druid,feral,36,13,23
5670,Daniin,azralon,1107,druid,feral,66,29,37
5671,Buhooki,tichondrius,1106,druid,feral,113,58,55
5672,Ðementia,stormrage,1101,druid,feral,84,47,37
5673,Azakana,sargeras,1094,druid,feral,23,12,11
5674,Leight,whisperwind,1093,druid,feral,24,14,10
5675,Mordrynn,veknilash,1092,druid,feral,28,14,14
5676,Strikinina,azralon,1091,druid,feral,61,26,35
5677,Zderhs,blackrock,1079,druid,feral,20,12,8
5678,Bernoboy,kelthuzad,1079,druid,feral,30,16,14
5679,Trevvor,thrall,1070,druid,feral,36,12,24
5680,Fb,darkspear,1069,druid,feral,20,12,8
5681,Anarad,dalaran,1068,druid,feral,42,22,20
5682,Druidsling,mugthol,1067,druid,feral,50,20,30
5683,Pokémon,grizzly-hills,1064,druid,feral,33,15,18
5684,Birdy,proudmoore,1056,druid,feral,18,11,7
5685,Glenn,norgannon,1056,druid,feral,18,11,7
5686,Switchform,kiljaeden,1056,druid,feral,18,11,7
5687,Hatergodx,ravencrest,1056,druid,feral,24,11,13
5688,Lelobull,ragnaros,1056,druid,feral,48,19,29
5689,Dangersweg,frostmourne,1056,druid,feral,30,11,19
5690,Orekinya,area-52,1055,druid,feral,24,11,13
5691,Tabbsy,frostmourne,1055,druid,feral,36,11,25
5692,Miviaris,alleria,1054,druid,feral,18,11,7
5693,Kellydabear,azuremyst,1054,druid,feral,24,11,13
5694,Myeow,illidan,1052,druid,feral,24,11,13
5695,Corv,drenden,1051,druid,feral,16,12,4
5696,Swindlestan,zuljin,1051,druid,feral,24,11,13
5697,Bloodynine,cairne,1050,druid,feral,24,11,13
5698,Clawin,frostmourne,1049,druid,feral,18,11,7
5699,Kongquest,emerald-dream,1049,druid,feral,36,11,25
5700,Nyla,nemesis,1048,druid,feral,12,11,1
5701,Vykarux,suramar,1048,druid,feral,24,11,13
5702,Yám,tichondrius,1048,druid,feral,30,11,19
5703,Dròódles,barthilas,1035,druid,feral,18,11,7
5704,Seraphim,lightnings-blade,1029,druid,feral,60,30,30
5705,Gece,dalaran,1022,druid,feral,35,15,20
5706,Screwdrivers,moon-guard,1022,druid,feral,29,11,18
5707,Amdruid,bloodhoof,1021,druid,feral,20,12,8
5708,Twigz,illidan,1018,druid,feral,91,44,47
5709,Fennel,korgath,1017,druid,feral,23,11,12
5710,Lyndonww,frostmourne,1006,druid,feral,26,12,14
5711,Ursuur,drakkari,1004,druid,feral,29,11,18
5712,Wildbeasts,proudmoore,1003,druid,feral,105,53,52
5713,Afrogx,dalaran,1001,druid,feral,24,11,13
5714,Superwrath,khaz-modan,1000,druid,feral,23,11,12
5715,Ruzkit,illidan,996,druid,feral,30,14,16
5716,Skufty,illidan,990,druid,feral,96,34,62
5717,Mojofoshobro,moonrunner,989,druid,feral,54,19,35
5718,Meldzetzan,tichondrius,960,druid,feral,12,10,2
5719,Semveta,alleria,960,druid,feral,12,10,2
5720,Soaring,moon-guard,960,druid,feral,18,10,8
5721,Hypérion,dalaran,960,druid,feral,24,10,14
5722,Buffjungle,tichondrius,960,druid,feral,26,10,16
5723,Juiceonlips,sargeras,959,druid,feral,18,10,8
5724,Kuzigothigh,thunderhorn,959,druid,feral,48,25,23
5725,Yaboidakota,stormrage,959,druid,feral,24,10,14
5726,Kekepöp,illidan,959,druid,feral,24,10,14
5727,Tysandra,sargeras,959,druid,feral,30,10,20
5728,Nearkoo,tichondrius,958,druid,feral,24,10,14
5729,Rekrasaur,emerald-dream,958,druid,feral,30,10,20
5730,Doubledówn,sargeras,957,druid,feral,72,33,39
5731,Pavel,aerie-peak,957,druid,feral,59,18,41
5732,Makonis,tichondrius,956,druid,feral,18,10,8
5733,Shiftingdean,sargeras,956,druid,feral,30,10,20
5734,Moonbow,frostmourne,954,druid,feral,18,10,8
5735,Bananawaffle,proudmoore,954,druid,feral,24,10,14
5736,Samirgodx,tichondrius,954,druid,feral,24,10,14
5737,Dorio,quelthalas,952,druid,feral,18,10,8
5738,Barbary,tichondrius,952,druid,feral,24,10,14
5739,Duckieheit,sargeras,952,druid,feral,24,10,14
5740,Hobbles,emerald-dream,949,druid,feral,24,10,14
5741,Odesellena,moon-guard,942,druid,feral,42,21,21
5742,Drdanknugs,laughing-skull,939,druid,feral,36,10,26
5743,Feraluwu,illidan,938,druid,feral,18,10,8
5744,Lusk,blades-edge,937,druid,feral,64,29,35
5745,Sisilo,bonechewer,933,druid,feral,96,40,56
5746,Téddybéar,smolderthorn,929,druid,feral,12,10,2
5747,Fanaror,frostmourne,929,druid,feral,36,18,18
5748,Arntu,malganis,924,druid,feral,17,10,7
5749,Greasemonkey,trollbane,919,druid,feral,22,12,10
5750,Sjana,bleeding-hollow,918,druid,feral,18,11,7
5751,Lacrarola,nemesis,916,druid,feral,17,10,7
5752,Skrillin,thrall,914,druid,feral,23,11,12
5753,Àspên,moon-guard,908,druid,feral,42,20,22
5754,Blêêd,stormscale,904,druid,feral,13,12,1
5755,Tt,akama,894,druid,feral,20,10,10
5756,Threeo,burning-blade,889,druid,feral,16,10,6
5757,Taurenaught,aegwynn,881,druid,feral,37,17,20
5758,Eglania,stormrage,866,druid,feral,24,11,13
5759,Retzerbil,sargeras,864,druid,feral,12,9,3
5760,Chin,ysera,864,druid,feral,12,9,3
5761,Feorb,azuremyst,864,druid,feral,24,9,15
5762,Faithxo,stormrage,864,druid,feral,24,9,15
5763,Féèd,stormrage,863,druid,feral,18,9,9
5764,Gz,icecrown,863,druid,feral,18,9,9
5765,Thaherb,korgath,863,druid,feral,24,9,15
5766,Jayp,thrall,863,druid,feral,24,9,15
5767,Wabbehkus,barthilas,862,druid,feral,36,9,27
5768,Catten,barthilas,860,druid,feral,12,9,3
5769,Tommyjimmy,andorhal,860,druid,feral,18,9,9
5770,Boofings,sargeras,860,druid,feral,18,9,9
5771,Niwßor,azralon,860,druid,feral,18,9,9
5772,Manlymanman,shandris,859,druid,feral,24,9,15
5773,Ribushe,stormrage,859,druid,feral,24,9,15
5774,Shiftyounot,shattered-hand,859,druid,feral,30,9,21
5775,Ruhgen,deathwing,858,druid,feral,26,10,16
5776,Jonoa,nagrand,858,druid,feral,24,9,15
5777,Wuarlo,moon-guard,857,druid,feral,91,43,48
5778,Rum,the-venture-co,857,druid,feral,36,14,22
5779,Wokoom,windrunner,855,druid,feral,54,20,34
5780,Tolldruid,chogall,852,druid,feral,24,10,14
5781,Koag,dalaran,851,druid,feral,23,11,12
5782,Zauska,cenarion-circle,851,druid,feral,30,9,21
5783,Drulicious,tichondrius,849,druid,feral,27,13,14
5784,Predatõr,malorne,841,druid,feral,24,10,14
5785,Sosd,kelthuzad,837,druid,feral,17,9,8
5786,Fogboom,area-52,830,druid,feral,20,10,10
5787,Mavren,uldaman,828,druid,feral,25,9,16
5788,Dreamfyre,kiljaeden,828,druid,feral,29,9,20
5789,Shartasm,anetheron,822,druid,feral,30,12,18
5790,Tatiannaa,stormreaver,815,druid,feral,15,10,5
5791,Feorelm,proudmoore,810,druid,feral,17,9,8
5792,Nephdruid,stormrage,804,druid,feral,30,9,21
5793,Ðjangø,goldrinn,801,druid,feral,17,9,8
5794,Druski,lightbringer,783,druid,feral,17,9,8
5795,Tastelikecat,kelthuzad,776,druid,feral,21,9,12
5796,Batterydruid,silvermoon,768,druid,feral,12,8,4
5797,Jason,vashj,768,druid,feral,12,8,4
5798,Anìmorph,sargeras,768,druid,feral,12,8,4
5799,Kattles,frostmourne,768,druid,feral,12,8,4
5800,Griefs,emerald-dream,768,druid,feral,12,8,4
5801,Férállgødx,area-52,768,druid,feral,18,8,10
5802,Mooncatbear,malganis,768,druid,feral,18,8,10
5803,Sylvaster,stormrage,768,druid,feral,24,8,16
5804,Germainee,shandris,768,druid,feral,24,8,16
5805,Saltydru,illidan,768,druid,feral,24,8,16
5806,Nahelae,tichondrius,767,druid,feral,12,8,4
5807,Pokeyouryolk,sargeras,767,druid,feral,12,8,4
5808,Jentzull,tichondrius,767,druid,feral,12,8,4
5809,Udderchaos,dark-iron,767,druid,feral,18,8,10
5810,Zascat,malganis,767,druid,feral,18,8,10
5811,Pergutory,frostmourne,767,druid,feral,18,8,10
5812,Kìttykat,stormrage,767,druid,feral,18,8,10
5813,Fullmoon,greymane,767,druid,feral,22,9,13
5814,Zurker,mannoroth,766,druid,feral,12,8,4
5815,Jpnerazim,quelthalas,766,druid,feral,16,8,8
5816,Angulus,darkspear,766,druid,feral,18,8,10
5817,Deaddpool,ragnaros,764,druid,feral,12,8,4
5818,Mooseknuccle,tichondrius,764,druid,feral,15,9,6
5819,Zimah,illidan,764,druid,feral,18,8,10
5820,Raknary,kelthuzad,764,druid,feral,30,8,22
5821,Framko,quelthalas,763,druid,feral,36,8,28
5822,Goorybud,tichondrius,762,druid,feral,12,8,4
5823,Gamble,the-underbog,760,druid,feral,24,8,16
5824,Cooln,bleeding-hollow,759,druid,feral,12,8,4
5825,Pawprika,tichondrius,758,druid,feral,30,9,21
5826,Ediiann,cenarius,756,druid,feral,18,8,10
5827,Mychi,ragnaros,748,druid,feral,20,9,11
5828,Reallysauce,zuljin,748,druid,feral,18,8,10
5829,Nodraent,quelthalas,741,druid,feral,18,8,10
5830,Ashmila,ragnaros,716,druid,feral,17,8,9
5831,Notinsanity,proudmoore,714,druid,feral,20,9,11
5832,Jihadibleeds,stormrage,713,druid,feral,13,9,4
5833,Mazoak,sargeras,703,druid,feral,28,8,20
5834,Byson,bleeding-hollow,702,druid,feral,17,8,9
5835,Bigdeeza,frostmourne,702,druid,feral,17,8,9
5836,Shakedru,stormrage,684,druid,feral,19,8,11
5837,Susruth,area-52,672,druid,feral,12,7,5
5838,Zðzð,zuljin,672,druid,feral,12,7,5
5839,Scuffedx,tichondrius,672,druid,feral,12,7,5
5840,Tnvï,stormrage,672,druid,feral,12,7,5
5841,Primalxd,area-52,672,druid,feral,12,7,5
5842,Dailydruid,illidan,672,druid,feral,12,7,5
5843,Shalaz,magtheridon,672,druid,feral,12,7,5
5844,Venomsecho,vashj,672,druid,feral,12,7,5
5845,Krobz,bleeding-hollow,672,druid,feral,12,7,5
5846,Elyveen,proudmoore,672,druid,feral,12,7,5
5847,Meowny,area-52,672,druid,feral,18,7,11
5848,Selendis,tichondrius,672,druid,feral,18,7,11
5849,Islayne,moon-guard,672,druid,feral,18,7,11
5850,Psyraxus,moon-guard,672,druid,feral,18,7,11
5851,Lunacore,illidan,672,druid,feral,18,7,11
5852,Ronin,arthas,672,druid,feral,18,7,11
5853,Muffbfloppn,zuljin,672,druid,feral,18,7,11
5854,Bearlyviable,stormrage,672,druid,feral,21,8,13
5855,Shiftage,frostmane,672,druid,feral,21,7,14
5856,Bobochan,tichondrius,672,druid,feral,24,7,17
5857,Houseboat,hellscream,672,druid,feral,30,7,23
5858,Happyhotter,proudmoore,671,druid,feral,12,7,5
5859,Fürïous,tichondrius,671,druid,feral,15,8,7
5860,Bearmuda,trollbane,671,druid,feral,18,7,11
5861,Corym,frostmourne,671,druid,feral,18,7,11
5862,Ännä,moon-guard,671,druid,feral,18,7,11
5863,Ruckiz,stormrage,671,druid,feral,18,7,11
5864,Momoxchan,quelthalas,671,druid,feral,18,7,11
5865,Kajla,sargeras,671,druid,feral,18,7,11
5866,Druidydruid,blackrock,671,druid,feral,18,7,11
5867,Thegrefgx,ragnaros,670,druid,feral,12,7,5
5868,Hótlife,fizzcrank,670,druid,feral,12,7,5
5869,Servax,illidan,670,druid,feral,18,7,11
5870,Curainfeliz,nemesis,669,druid,feral,12,7,5
5871,Bullshiftin,area-52,669,druid,feral,12,7,5
5872,Redness,daggerspine,669,druid,feral,18,7,11
5873,Meowzedon,sargeras,668,druid,feral,18,7,11
5874,Yokimo,amanthul,668,druid,feral,18,7,11
5875,Zeldriss,arthas,668,druid,feral,19,7,12
5876,Jordiët,dalaran,667,druid,feral,12,7,5
5877,Nokther,muradin,664,druid,feral,30,7,23
5878,Oxvxo,senjin,648,druid,feral,18,7,11
5879,Hyperlite,bonechewer,643,druid,feral,18,7,11
5880,Injail,tichondrius,640,druid,feral,16,7,9
5881,Chadwickx,illidan,639,druid,feral,11,7,4
5882,Ekkoh,sargeras,638,druid,feral,17,7,10
5883,Jeanz,bonechewer,632,druid,feral,19,9,10
5884,Slapymilf,dentarg,623,druid,feral,11,7,4
5885,Meowzetzan,tichondrius,623,druid,feral,11,7,4
5886,Puzzykat,uldum,621,druid,feral,27,7,20
5887,Gutzzu,area-52,619,druid,feral,15,7,8
5888,Weezydende,area-52,612,druid,feral,29,7,22
5889,Weedleaf,wyrmrest-accord,610,druid,feral,20,8,12
5890,Beaker,uldum,605,druid,feral,11,7,4
5891,Earlgrayl,kelthuzad,591,druid,feral,13,7,6
5892,Bigherbo,zuljin,585,druid,feral,20,8,12
5893,Duuj,illidan,576,druid,feral,6,6,0
5894,Lïberty,ragnaros,576,druid,feral,6,6,0
5895,Hybridxo,kelthuzad,576,druid,feral,6,6,0
5896,Funkattack,tichondrius,576,druid,feral,12,6,6
5897,Nelfwaifú,area-52,576,druid,feral,12,6,6
5898,Spaléxgu,azralon,576,druid,feral,12,6,6
5899,Whitetigeris,tichondrius,576,druid,feral,12,6,6
5900,Daniverse,sargeras,576,druid,feral,12,6,6
5901,Sooey,wyrmrest-accord,576,druid,feral,12,6,6
5902,Wilddeity,tichondrius,576,druid,feral,12,6,6
5903,Ogversaucey,skullcrusher,576,druid,feral,12,6,6
5904,Thontt,sargeras,576,druid,feral,12,6,6
5905,Parallax,shadowsong,576,druid,feral,12,6,6
5906,Yseraspawn,kelthuzad,576,druid,feral,12,6,6
5907,Bables,tichondrius,576,druid,feral,12,6,6
5908,Hashmall,ragnaros,576,druid,feral,12,6,6
5909,Cíphenz,illidan,576,druid,feral,12,6,6
5910,Hotmomlover,malganis,576,druid,feral,12,6,6
5911,Kittysnuggle,emerald-dream,576,druid,feral,15,7,8
5912,Høruss,azralon,576,druid,feral,15,7,8
5913,Welshblack,tichondrius,576,druid,feral,16,7,9
5914,Jinhova,stormrage,576,druid,feral,15,6,9
5915,Rebrrth,antonidas,576,druid,feral,18,6,12
5916,Poppynoff,barthilas,576,druid,feral,18,6,12
5917,Emotionally,illidan,576,druid,feral,18,6,12
5918,Kittendev,tichondrius,576,druid,feral,18,6,12
5919,Mameseph,lightnings-blade,576,druid,feral,18,6,12
5920,Pàntera,tichondrius,576,druid,feral,24,6,18
5921,Kobebeef,malganis,576,druid,feral,24,6,18
5922,Omnilul,zuljin,575,druid,feral,12,6,6
5923,Wulfjack,emerald-dream,575,druid,feral,12,6,6
5924,Allenjunior,ragnaros,575,druid,feral,12,6,6
5925,Fireeloot,tichondrius,575,druid,feral,12,6,6
5926,Davinchii,drakkari,575,druid,feral,12,6,6
5927,Austîn,moon-guard,575,druid,feral,12,6,6
5928,Druishcat,dark-iron,575,druid,feral,12,6,6
5929,Yesqt,dalaran,575,druid,feral,12,6,6
5930,Amoru,moon-guard,575,druid,feral,12,6,6
5931,Stríðsmaður,area-52,575,druid,feral,12,6,6
5932,Andaror,azralon,575,druid,feral,24,6,18
5933,Beelzehog,whisperwind,574,druid,feral,12,6,6
5934,Dinnerbone,echo-isles,573,druid,feral,12,6,6
5935,Nikozho,sargeras,573,druid,feral,18,6,12
5936,Kragma,zuluhed,572,druid,feral,12,6,6
5937,Soldadito,zuljin,572,druid,feral,15,7,8
5938,Udala,durotan,572,druid,feral,14,6,8
5939,Snowlion,the-forgotten-coast,570,druid,feral,12,6,6
5940,Expells,nemesis,569,druid,feral,18,6,12
5941,Dullbozer,thrall,543,druid,feral,11,6,5
5942,Druidcyber,stormrage,543,druid,feral,16,6,10
5943,Lémons,tichondrius,542,druid,feral,17,6,11
5944,Wtfimacat,area-52,527,druid,feral,11,6,5
5945,Ripx,khadgar,522,druid,feral,16,7,9
5946,Shadalor,frostmourne,512,druid,feral,16,6,10
5947,Ivangamaz,area-52,511,druid,feral,11,6,5
5948,Kilbys,nemesis,510,druid,feral,8,6,2
5949,Iamatomic,illidan,509,druid,feral,20,6,14
5950,Bearjoo,kelthuzad,495,druid,feral,18,6,12
5951,Ardelix,emerald-dream,480,druid,feral,6,5,1
5952,Flompstomper,skullcrusher,480,druid,feral,6,5,1
5953,Sweetpurple,elune,480,druid,feral,6,5,1
5954,Chrøniç,illidan,480,druid,feral,6,5,1
5955,Nbnbnb,proudmoore,480,druid,feral,6,5,1
5956,Gloomcat,illidan,480,druid,feral,6,5,1
5957,Idiotdruid,ragnaros,480,druid,feral,6,5,1
5958,Sweetnippies,elune,480,druid,feral,6,5,1
5959,Carboz,jubeithos,480,druid,feral,6,5,1
5960,Exxh,tichondrius,480,druid,feral,6,5,1
5961,Féralis,sargeras,480,druid,feral,6,5,1
5962,Crendorides,bleeding-hollow,480,druid,feral,12,5,7
5963,Loamie,proudmoore,480,druid,feral,12,5,7
5964,Choolah,area-52,480,druid,feral,12,5,7
5965,Frenzyirl,darkspear,480,druid,feral,12,5,7
5966,Wurow,firetree,480,druid,feral,12,5,7
5967,Feralhearted,kelthuzad,480,druid,feral,12,5,7
5968,Zeratull,cenarius,480,druid,feral,12,5,7
5969,Softshirtxo,ragnaros,480,druid,feral,12,5,7
5970,Karizikat,tichondrius,480,druid,feral,12,5,7
5971,Noet,ragnaros,480,druid,feral,12,5,7
5972,Yizhiyuren,aegwynn,480,druid,feral,12,5,7
5973,Ðárk,ragnaros,480,druid,feral,12,5,7
5974,Gunnymad,tichondrius,480,druid,feral,12,5,7
5975,Honeybeam,moon-guard,480,druid,feral,12,5,7
5976,Bloodyugly,area-52,480,druid,feral,12,5,7
5977,Mythienair,stormrage,480,druid,feral,12,5,7
5978,Cenarius,frostmourne,480,druid,feral,12,5,7
5979,Loserceo,stormrage,480,druid,feral,12,5,7
5980,Lurky,dalvengyr,480,druid,feral,12,5,7
5981,Topangâ,lightninghoof,480,druid,feral,12,5,7
5982,Scorn,spirestone,480,druid,feral,13,5,8
5983,Fredolay,tichondrius,480,druid,feral,13,5,8
5984,Oneninesix,frostmourne,480,druid,feral,18,5,13
5985,Maplêleaf,moon-guard,480,druid,feral,18,5,13
5986,Gouzz,frostmourne,480,druid,feral,18,5,13
5987,Purrcat,tichondrius,480,druid,feral,18,5,13
5988,Bere,kul-tiras,480,druid,feral,18,5,13
5989,Caelüm,area-52,480,druid,feral,18,5,13
5990,Lycanjungle,azralon,480,druid,feral,18,5,13
5991,Kayday,bloodscalp,479,druid,feral,6,5,1
5992,Mawnster,drenden,479,druid,feral,9,6,3
5993,Balthøs,moon-guard,479,druid,feral,12,5,7
5994,Animalcade,area-52,479,druid,feral,12,5,7
5995,Aeonás,tichondrius,479,druid,feral,12,5,7
5996,Nisheon,wyrmrest-accord,479,druid,feral,12,5,7
5997,Snugglin,kelthuzad,479,druid,feral,12,5,7
5998,Calani,lightnings-blade,479,druid,feral,12,5,7
5999,Hawthòrn,bloodscalp,479,druid,feral,12,5,7
6000,Ysemia,drakkari,479,druid,feral,14,5,9
6001,Giatafix,whisperwind,479,druid,feral,18,5,13
6002,Bigoldbear,moon-guard,479,druid,feral,18,5,13
6003,Ramso,skullcrusher,478,druid,feral,12,5,7
6004,Drewiid,stormrage,478,druid,feral,12,5,7
6005,Dârkfang,moon-guard,475,druid,feral,12,5,7
6006,Maplesyrup,moonrunner,431,druid,feral,11,5,6
6007,Moonrg,stormrage,431,druid,feral,11,5,6
6008,Empathz,emerald-dream,431,druid,feral,17,5,12
6009,Ninelivez,gorgonnash,426,druid,feral,22,6,16
6010,Yunekai,stormrage,415,druid,feral,11,5,6
6011,Vaelthunis,sargeras,400,druid,feral,13,5,8
6012,Reversflash,emerald-dream,384,druid,feral,6,4,2
6013,Vecuronium,tichondrius,384,druid,feral,6,4,2
6014,Aldr,tichondrius,384,druid,feral,6,4,2
6015,Orizane,moon-guard,384,druid,feral,6,4,2
6016,Kistormx,tichondrius,384,druid,feral,6,4,2
6017,Cfab,tichondrius,384,druid,feral,6,4,2
6018,Drywatter,tichondrius,384,druid,feral,6,4,2
6019,Jaegerbombx,sargeras,384,druid,feral,6,4,2
6020,Eliteshift,frostmourne,384,druid,feral,6,4,2
6021,Pressuretd,frostmourne,384,druid,feral,6,4,2
6022,Curet,lightbringer,384,druid,feral,6,4,2
6023,Oobuck,kilrogg,384,druid,feral,6,4,2
6024,Robomexi,tichondrius,384,druid,feral,6,4,2
6025,Woshiyigede,frostmourne,384,druid,feral,6,4,2
6026,Bearcathawk,sargeras,384,druid,feral,6,4,2
6027,Coolguyzack,stormscale,384,druid,feral,6,4,2
6028,Kittycudi,hyjal,384,druid,feral,6,4,2
6029,Nâturê,dalaran,384,druid,feral,6,4,2
6030,Kaldiel,ysera,384,druid,feral,6,4,2
6031,Olhosdlua,azralon,384,druid,feral,6,4,2
6032,Menapäws,area-52,384,druid,feral,6,4,2
6033,Xrw,kelthuzad,384,druid,feral,6,4,2
6034,Unfunnyferal,kelthuzad,384,druid,feral,6,4,2
6035,Sneekykitty,malygos,384,druid,feral,6,4,2
6036,Srwow,elune,384,druid,feral,6,4,2
6037,Toiiz,malganis,384,druid,feral,9,4,5
6038,Genuine,guldan,384,druid,feral,11,4,7
6039,Strixferal,zuljin,384,druid,feral,12,4,8
6040,Zzkitty,stormreaver,384,druid,feral,12,4,8
6041,Moohok,bleeding-hollow,384,druid,feral,12,4,8
6042,Heìrophant,trollbane,384,druid,feral,12,4,8
6043,Anniehall,stormrage,384,druid,feral,12,4,8
6044,Gatona,stormrage,384,druid,feral,12,4,8
6045,Carnumoose,zuljin,384,druid,feral,12,4,8
6046,Weeñor,tichondrius,384,druid,feral,12,4,8
6047,Timthecatman,frostmourne,384,druid,feral,12,4,8
6048,Gernichora,barthilas,384,druid,feral,12,4,8
6049,Pollykush,sargeras,384,druid,feral,12,4,8
6050,Toetoetoete,darrowmere,384,druid,feral,12,4,8
6051,Freshzk,azralon,384,druid,feral,12,4,8
6052,Pretzle,kelthuzad,384,druid,feral,12,4,8
6053,Rêàgøñ,tichondrius,384,druid,feral,12,4,8
6054,Quiziato,burning-legion,384,druid,feral,12,4,8
6055,Riverthorne,moon-guard,384,druid,feral,12,4,8
6056,Iamfynch,sargeras,384,druid,feral,12,4,8
6057,Atreis,malganis,384,druid,feral,12,4,8
6058,Ewok,vashj,384,druid,feral,12,4,8
6059,Riec,kiljaeden,384,druid,feral,12,4,8
6060,Yakuho,proudmoore,384,druid,feral,12,4,8
6061,Sellîas,senjin,384,druid,feral,12,4,8
6062,Save,aerie-peak,384,druid,feral,12,4,8
6063,Bënzy,frostmourne,384,druid,feral,12,4,8
6064,Feralgød,tichondrius,384,druid,feral,12,4,8
6065,Teddybear,medivh,384,druid,feral,12,4,8
6066,Auxl,tichondrius,384,druid,feral,12,4,8
6067,Hellabanx,tichondrius,384,druid,feral,12,4,8
6068,Binjuicex,frostmourne,384,druid,feral,12,4,8
6069,Carlosd,tichondrius,384,druid,feral,12,4,8
6070,Alaillais,moon-guard,384,druid,feral,12,4,8
6071,Pereréka,azralon,384,druid,feral,14,4,10
6072,Naastir,medivh,384,druid,feral,14,4,10
6073,Ráhilk,quelthalas,384,druid,feral,18,4,14
6074,Startalons,area-52,384,druid,feral,18,4,14
6075,Apothe,emerald-dream,384,druid,feral,18,4,14
6076,Berall,bleeding-hollow,383,druid,feral,6,4,2
6077,Jamesbailey,sargeras,383,druid,feral,12,4,8
6078,Mfgs,kelthuzad,383,druid,feral,12,4,8
6079,Bramth,quelthalas,383,druid,feral,12,4,8
6080,Topguncarl,illidan,383,druid,feral,12,4,8
6081,Shoboski,quelthalas,383,druid,feral,12,4,8
6082,Porrosman,quelthalas,383,druid,feral,12,4,8
6083,Nahtex,tichondrius,383,druid,feral,18,4,14
6084,Mogli,perenolde,383,druid,feral,30,4,26
6085,Cyder,thrall,382,druid,feral,10,5,5
6086,Ssimbaa,area-52,382,druid,feral,12,4,8
6087,Dalinaìr,moon-guard,382,druid,feral,12,4,8
6088,Jabiso,smolderthorn,382,druid,feral,18,4,14
6089,Zyila,garithos,367,druid,feral,11,4,7
6090,Eightyhd,ravencrest,351,druid,feral,11,4,7
6091,Pixyls,bleeding-hollow,336,druid,feral,9,4,5
6092,Shyn,goldrinn,336,druid,feral,15,4,11
6093,Defku,quelthalas,330,druid,feral,28,6,22
6094,Ashvir,wyrmrest-accord,319,druid,feral,5,4,1
6095,Bubbleshiftz,area-52,288,druid,feral,6,3,3
6096,Owlcapwn,stormreaver,288,druid,feral,6,3,3
6097,Pabag,chogall,288,druid,feral,6,3,3
6098,Ysero,area-52,288,druid,feral,6,3,3
6099,Dairycream,skullcrusher,288,druid,feral,6,3,3
6100,Nanassa,spinebreaker,288,druid,feral,6,3,3
6101,Elythria,hellscream,288,druid,feral,6,3,3
6102,Chopleaf,khadgar,288,druid,feral,6,3,3
6103,Güar,area-52,288,druid,feral,6,3,3
6104,Taurenasarus,area-52,288,druid,feral,6,3,3
6105,Ahhpalu,tichondrius,288,druid,feral,6,3,3
6106,Grimtreeper,illidan,288,druid,feral,6,3,3
6107,Askmeaboutmy,shattered-halls,288,druid,feral,6,3,3
6108,Arienne,kelthuzad,288,druid,feral,6,3,3
6109,Thecolortwoo,tichondrius,288,druid,feral,6,3,3
6110,Riddickd,malfurion,288,druid,feral,6,3,3
6111,Ÿùp,tichondrius,288,druid,feral,6,3,3
6112,Hyldru,stormrage,288,druid,feral,6,3,3
6113,Bootayclappa,sargeras,288,druid,feral,6,3,3
6114,Moobees,arthas,288,druid,feral,6,3,3
6115,Duckseasonn,sargeras,288,druid,feral,6,3,3
6116,Rairven,stormrage,288,druid,feral,6,3,3
6117,Pansensual,archimonde,288,druid,feral,6,3,3
6118,Øvernight,azralon,288,druid,feral,6,3,3
6119,Donutdruid,illidan,288,druid,feral,6,3,3
6120,Frrest,proudmoore,288,druid,feral,6,3,3
6121,Nichodameus,firetree,288,druid,feral,6,3,3
6122,Injeckx,tichondrius,288,druid,feral,6,3,3
6123,Datlogan,tichondrius,288,druid,feral,6,3,3
6124,Rotclaws,stormrage,288,druid,feral,6,3,3
6125,Gâlaxy,sargeras,288,druid,feral,6,3,3
6126,Espoir,azuremyst,288,druid,feral,6,3,3
6127,Kardien,quelthalas,288,druid,feral,6,3,3
6128,Opconvoke,illidan,288,druid,feral,6,3,3
6129,Kurokyy,frostmourne,288,druid,feral,6,3,3
6130,Hitchslaps,tichondrius,288,druid,feral,6,3,3
6131,Dramon,tichondrius,288,druid,feral,6,3,3
6132,Saelyle,illidan,288,druid,feral,6,3,3
6133,Zadayos,aerie-peak,288,druid,feral,6,3,3
6134,Plantdaddy,bladefist,288,druid,feral,6,3,3
6135,Uag,emerald-dream,288,druid,feral,6,3,3
6136,Neksir,ragnaros,288,druid,feral,6,3,3
6137,Trottystwin,emerald-dream,288,druid,feral,6,3,3
6138,Deadlykept,ragnaros,288,druid,feral,6,3,3
6139,Balnara,cenarius,288,druid,feral,6,3,3
6140,Jeperty,tichondrius,288,druid,feral,6,3,3
6141,Posmard,ragnaros,288,druid,feral,6,3,3
6142,Thorñ,cenarius,288,druid,feral,6,3,3
6143,Natureswang,bleeding-hollow,288,druid,feral,6,3,3
6144,Nofeets,azshara,288,druid,feral,6,3,3
6145,Steakjr,senjin,288,druid,feral,6,3,3
6146,Rígél,ragnaros,288,druid,feral,6,3,3
6147,Floridaman,moonrunner,288,druid,feral,6,3,3
6148,Worgbearpig,destromath,288,druid,feral,6,3,3
6149,Bigskeeve,sargeras,288,druid,feral,6,3,3
6150,Celetra,kiljaeden,288,druid,feral,6,3,3
6151,Erbirus,proudmoore,288,druid,feral,6,3,3
6152,Katatafish,azralon,288,druid,feral,6,3,3
6153,Purrfact,frostmourne,288,druid,feral,6,3,3
6154,Tasselhoof,hyjal,288,druid,feral,6,3,3
6155,Lilrichdmg,sargeras,288,druid,feral,6,3,3
6156,Ezconvoke,sargeras,288,druid,feral,6,3,3
6157,Zalmo,area-52,288,druid,feral,9,4,5
6158,Hídde,quelthalas,288,druid,feral,12,3,9
6159,Pibily,sargeras,288,druid,feral,12,3,9
6160,Vorare,tichondrius,288,druid,feral,12,3,9
6161,Solstice,frostmourne,288,druid,feral,12,3,9
6162,Uniquex,zuljin,288,druid,feral,12,3,9
6163,Drailyo,ravenholdt,288,druid,feral,12,3,9
6164,Pawpaw,terenas,288,druid,feral,12,3,9
6165,Tchallå,tichondrius,288,druid,feral,12,3,9
6166,Peppapig,mugthol,288,druid,feral,12,3,9
6167,Näna,dalaran,288,druid,feral,12,3,9
6168,Garuharken,skullcrusher,288,druid,feral,12,3,9
6169,Lovemakitty,sargeras,288,druid,feral,12,3,9
6170,Rivetrix,azralon,288,druid,feral,12,3,9
6171,Lilnippy,stormscale,288,druid,feral,12,3,9
6172,Sosorry,blackhand,288,druid,feral,12,3,9
6173,Flushi,nagrand,288,druid,feral,12,3,9
6174,Nighetager,uther,288,druid,feral,12,3,9
6175,Flayx,frostmourne,288,druid,feral,12,3,9
6176,Oo,grizzly-hills,288,druid,feral,12,3,9
6177,Catorcow,aegwynn,288,druid,feral,13,3,10
6178,Iamthewambo,bloodhoof,288,druid,feral,30,3,27
6179,Extremeshift,dalaran,287,druid,feral,8,4,4
6180,Rawrii,nemesis,287,druid,feral,6,3,3
6181,Slymar,darkspear,287,druid,feral,6,3,3
6182,Kurodash,tichondrius,287,druid,feral,6,3,3
6183,Rhaines,moon-guard,287,druid,feral,12,3,9
6184,Absoles,agamaggan,287,druid,feral,12,3,9
6185,Schwiftea,skullcrusher,287,druid,feral,12,3,9
6186,Nast,dreadmaul,287,druid,feral,12,3,9
6187,Psychosis,kul-tiras,285,druid,feral,12,3,9
6188,Kogti,malganis,255,druid,feral,4,4,0
6189,Mightymërlin,stormrage,255,druid,feral,11,3,8
6190,Punderful,stormrage,254,druid,feral,10,4,6
6191,Trippykitty,tichondrius,240,druid,feral,9,3,6
6192,Yámï,stormrage,239,druid,feral,5,3,2
6193,Pél,tichondrius,223,druid,feral,8,3,5
6194,Catahmine,thrall,223,druid,feral,8,3,5
6195,Worldly,medivh,223,druid,feral,14,3,11
6196,Ebrìthil,hyjal,208,druid,feral,7,3,4
6197,Puiltraxs,ragnaros,192,druid,feral,4,3,1
6198,Feraldudu,illidan,192,druid,feral,4,3,1
6199,Kurakai,runetotem,192,druid,feral,6,2,4
6200,Madador,bleeding-hollow,192,druid,feral,6,2,4
6201,Bullbuddy,wyrmrest-accord,192,druid,feral,6,2,4
6202,Klawzy,thrall,192,druid,feral,6,2,4
6203,Barrah,barthilas,192,druid,feral,6,2,4
6204,Pecopeco,sargeras,192,druid,feral,6,2,4
6205,Aethorax,hyjal,192,druid,feral,6,2,4
6206,Prosperz,dalaran,192,druid,feral,6,2,4
6207,Zalledori,thrall,192,druid,feral,6,2,4
6208,Illr,laughing-skull,192,druid,feral,6,2,4
6209,Augus,hyjal,192,druid,feral,6,2,4
6210,Barnedruid,stormreaver,192,druid,feral,6,2,4
6211,Driftwood,bonechewer,192,druid,feral,6,2,4
6212,Evolute,sargeras,192,druid,feral,6,2,4
6213,Numbkin,stormrage,192,druid,feral,6,2,4
6214,Stolenrims,tichondrius,192,druid,feral,6,2,4
6215,Asmondruud,tichondrius,192,druid,feral,6,2,4
6216,Hännibal,hydraxis,192,druid,feral,6,2,4
6217,Tilly,malorne,192,druid,feral,6,2,4
6218,Omgapuddycat,stormrage,192,druid,feral,6,2,4
6219,Ikova,frostmourne,192,druid,feral,6,2,4
6220,Shiftdeznutz,tichondrius,192,druid,feral,6,2,4
6221,Onewitnature,nordrassil,192,druid,feral,6,2,4
6222,Basichoe,bleeding-hollow,192,druid,feral,6,2,4
6223,Evantheomni,tichondrius,192,druid,feral,6,2,4
6224,Manwool,illidan,192,druid,feral,6,2,4
6225,Wreckked,sargeras,192,druid,feral,6,2,4
6226,Taztoc,stormrage,192,druid,feral,6,2,4
6227,Lilstuped,tichondrius,192,druid,feral,6,2,4
6228,Varietypack,antonidas,192,druid,feral,6,2,4
6229,Samsaralol,tichondrius,192,druid,feral,6,2,4
6230,Catmóm,tichondrius,192,druid,feral,6,2,4
6231,Unclebolty,frostmourne,192,druid,feral,6,2,4
6232,Kanadae,thrall,192,druid,feral,6,2,4
6233,Aurajin,spinebreaker,192,druid,feral,6,2,4
6234,Dankbite,doomhammer,192,druid,feral,6,2,4
6235,Fieryferal,kargath,192,druid,feral,6,2,4
6236,Pröfëct,ragnaros,192,druid,feral,6,2,4
6237,Anudi,whisperwind,192,druid,feral,6,2,4
6238,Athious,moon-guard,192,druid,feral,6,2,4
6239,Shiftwork,korgath,192,druid,feral,6,2,4
6240,Perlek,bleeding-hollow,192,druid,feral,6,2,4
6241,Pusscat,illidan,192,druid,feral,6,2,4
6242,Fuujinn,korgath,192,druid,feral,6,2,4
6243,Geno,cenarius,192,druid,feral,6,2,4
6244,Lemonnz,illidan,192,druid,feral,6,2,4
6245,Tootiebootie,bleeding-hollow,192,druid,feral,6,2,4
6246,Handolar,quelthalas,192,druid,feral,6,2,4
6247,Kikothecat,burning-blade,192,druid,feral,6,2,4
6248,Theliono,lightnings-blade,192,druid,feral,6,2,4
6249,Pawblems,sargeras,192,druid,feral,6,2,4
6250,Bdsurges,illidan,192,druid,feral,6,2,4
6251,Owd,tichondrius,192,druid,feral,6,2,4
6252,Meaningfully,kelthuzad,192,druid,feral,6,2,4
6253,Vivinara,moon-guard,192,druid,feral,6,2,4
6254,Karpin,area-52,192,druid,feral,6,2,4
6255,Bronaarr,nordrassil,192,druid,feral,6,2,4
6256,Nabious,malganis,192,druid,feral,6,2,4
6257,Taiga,moon-guard,192,druid,feral,6,2,4
6258,Tauretari,tichondrius,192,druid,feral,6,2,4
6259,Hehaw,kelthuzad,192,druid,feral,6,2,4
6260,Khaoticklaw,stormrage,192,druid,feral,6,2,4
6261,Milezy,area-52,192,druid,feral,6,2,4
6262,Vctrphs,nemesis,192,druid,feral,6,2,4
6263,Katskratch,sargeras,192,druid,feral,6,2,4
6264,Metaldruid,tichondrius,192,druid,feral,6,2,4
6265,Healorhell,azralon,192,druid,feral,6,2,4
6266,Snupy,area-52,192,druid,feral,6,2,4
6267,Qouro,area-52,192,druid,feral,6,2,4
6268,Eliaris,rivendare,192,druid,feral,6,2,4
6269,Yakir,kiljaeden,192,druid,feral,6,2,4
6270,Buyadoge,area-52,192,druid,feral,6,2,4
6271,Majdomoterry,proudmoore,192,druid,feral,6,2,4
6272,Fødaødruida,azralon,192,druid,feral,6,2,4
6273,Haegur,tichondrius,192,druid,feral,6,2,4
6274,Robbieshift,emerald-dream,192,druid,feral,6,2,4
6275,Lavanca,azralon,192,druid,feral,6,2,4
6276,Veryhighrn,area-52,192,druid,feral,6,2,4
6277,Uphine,area-52,192,druid,feral,6,2,4
6278,Dreadonly,tichondrius,192,druid,feral,6,2,4
6279,Timdillon,emerald-dream,192,druid,feral,6,2,4
6280,Dawsonxo,proudmoore,192,druid,feral,6,2,4
6281,Happyc,bleeding-hollow,192,druid,feral,12,2,10
6282,Imass,draka,192,druid,feral,12,2,10
6283,Meudayr,crushridge,192,druid,feral,12,2,10
6284,Drabo,boulderfist,192,druid,feral,12,2,10
6285,Ymirgore,zuljin,192,druid,feral,12,2,10
6286,Àcid,stormreaver,192,druid,feral,12,2,10
6287,Igneël,ragnaros,192,druid,feral,12,2,10
6288,Shadedmika,zuljin,192,druid,feral,12,2,10
6289,Faroo,azralon,192,druid,feral,12,2,10
6290,Codieneme,blades-edge,192,druid,feral,12,2,10
6291,Nerfdemo,kiljaeden,192,druid,feral,12,2,10
6292,Envasions,emerald-dream,192,druid,feral,12,2,10
6293,Pawz,windrunner,192,druid,feral,12,2,10
6294,Seyala,moon-guard,192,druid,feral,12,2,10
6295,Rorhenn,moon-guard,192,druid,feral,18,2,16
6296,Boomanon,illidan,191,druid,feral,6,2,4
6297,Liightbite,illidan,191,druid,feral,12,2,10
6298,Feralhearted,tichondrius,175,druid,feral,11,2,9
6299,Bowbaggins,bleeding-hollow,159,druid,feral,5,2,3
6300,Jdoozie,bleeding-hollow,159,druid,feral,5,2,3
6301,Kipsmiffly,darkspear,128,druid,feral,4,2,2
6302,Jumpjumpcat,tichondrius,96,druid,feral,3,2,1
6303,Feles,darkspear,96,druid,feral,3,2,1
6304,Importedalc,zuljin,96,druid,feral,6,1,5
6305,Krawnk,zuljin,96,druid,feral,6,1,5
6306,Wreckingcrew,emerald-dream,96,druid,feral,6,1,5
6307,Ottoro,azralon,96,druid,feral,6,1,5
6308,Lakroz,zuljin,96,druid,feral,6,1,5
6309,Captclaws,tichondrius,96,druid,feral,6,1,5
6310,Raigor,azralon,96,druid,feral,6,1,5
6311,Aigo,azralon,96,druid,feral,6,1,5
6312,Ghostboy,zuljin,96,druid,feral,6,1,5
6313,Avorah,tichondrius,96,druid,feral,6,1,5
6314,Kî,thunderlord,96,druid,feral,6,1,5
6315,Ciggy,maiev,96,druid,feral,6,1,5
6316,Morizo,proudmoore,96,druid,feral,6,1,5
6317,Valdr,stormrage,96,druid,feral,6,1,5
6318,Alope,blades-edge,96,druid,feral,6,1,5
6319,Polyproof,emerald-dream,96,druid,feral,6,1,5
6320,Yungle,tichondrius,96,druid,feral,6,1,5
6321,Thebigcat,deathwing,96,druid,feral,6,1,5
6322,Ban,chogall,96,druid,feral,6,1,5
6323,Mootality,area-52,96,druid,feral,6,1,5
6324,Édzar,area-52,96,druid,feral,6,1,5
6325,Healthy,auchindoun,96,druid,feral,6,1,5
6326,Yuandi,tichondrius,96,druid,feral,6,1,5
6327,Acórn,frostmourne,96,druid,feral,6,1,5
6328,Colinferal,thrall,96,druid,feral,6,1,5
6329,Shlümp,tichondrius,96,druid,feral,6,1,5
6330,Shawdoostorm,nemesis,96,druid,feral,6,1,5
6331,Terminated,tichondrius,96,druid,feral,6,1,5
6332,Crazypaddy,dark-iron,96,druid,feral,6,1,5
6333,Jawsbee,emerald-dream,96,druid,feral,6,1,5
6334,Samedo,sargeras,96,druid,feral,6,1,5
6335,Bootzs,kelthuzad,96,druid,feral,6,1,5
6336,Treepiss,tichondrius,96,druid,feral,6,1,5
6337,Cattdog,tichondrius,96,druid,feral,6,1,5
6338,Feralhefty,stormrage,96,druid,feral,6,1,5
6339,Tuskdaddie,sargeras,96,druid,feral,6,1,5
6340,Ilikedôggy,saurfang,96,druid,feral,6,1,5
6341,Asaptom,frostmourne,96,druid,feral,6,1,5
6342,Shïfty,tichondrius,96,druid,feral,6,1,5
6343,Frëýá,bleeding-hollow,96,druid,feral,6,1,5
6344,Hynz,barthilas,96,druid,feral,6,1,5
6345,Purpyo,bleeding-hollow,96,druid,feral,6,1,5
6346,Furrycon,ysera,96,druid,feral,6,1,5
6347,Hasemilë,dalaran,96,druid,feral,6,1,5
6348,Vernaar,laughing-skull,96,druid,feral,6,1,5
6349,Garcia,feathermoon,96,druid,feral,6,1,5
6350,Gretatunberg,skywall,96,druid,feral,6,1,5
6351,Kollective,sargeras,96,druid,feral,6,1,5
6352,Dotsgallore,garrosh,96,druid,feral,6,1,5
6353,Nyatarii,hakkar,96,druid,feral,6,1,5
6354,Droody,earthen-ring,96,druid,feral,6,1,5
6355,Naztekk,dalaran,96,druid,feral,6,1,5
6356,Deelark,skywall,96,druid,feral,6,1,5
6357,Boundless,skullcrusher,96,druid,feral,6,1,5
6358,Ashmíla,ragnaros,96,druid,feral,6,1,5
6359,Barnabie,black-dragonflight,96,druid,feral,6,1,5
6360,Dééz,illidan,96,druid,feral,6,1,5
6361,Ausbie,garona,96,druid,feral,6,1,5
6362,Chumdrumrum,malganis,96,druid,feral,6,1,5
6363,Crowaar,moon-guard,96,druid,feral,6,1,5
6364,Ticømia,stormrage,96,druid,feral,6,1,5
6365,Aquahektik,malganis,96,druid,feral,6,1,5
6366,Fortunecat,illidan,96,druid,feral,6,1,5
6367,Swippy,blackhand,96,druid,feral,6,1,5
6368,Whiplash,deathwing,96,druid,feral,6,1,5
6369,Ojira,moon-guard,96,druid,feral,6,1,5
6370,Laynahri,moon-guard,96,druid,feral,6,1,5
6371,Fuzzwuzzyqt,tichondrius,96,druid,feral,6,1,5
6372,Ärianagrande,stormrage,96,druid,feral,6,1,5
6373,Glorp,blackwater-raiders,96,druid,feral,6,1,5
6374,Fbombzz,kalecgos,96,druid,feral,6,1,5
6375,Nezrael,frostwolf,96,druid,feral,6,1,5
6376,Byefren,darkspear,96,druid,feral,7,1,6
6377,Versipex,emerald-dream,96,druid,feral,12,1,11
6378,Ballsnack,zuljin,96,druid,feral,12,1,11
6379,Habras,alterac-mountains,96,druid,feral,12,1,11
6380,Owlcapwn,tichondrius,96,druid,feral,12,1,11
6381,Wonderclam,sargeras,96,druid,feral,12,1,11
6382,Backlazsh,illidan,96,druid,feral,12,1,11
6383,Capson,darkspear,96,druid,feral,12,1,11
6384,Grovestalker,nemesis,96,druid,feral,12,1,11
6385,Funfunfrank,aegwynn,96,druid,feral,12,1,11
6386,Lonewolfdrd,illidan,96,druid,feral,12,1,11
6387,Furiøsä,quelthalas,95,druid,feral,6,1,5
6388,Skwidrific,crushridge,95,druid,feral,12,1,11
6389,Gitsnshigles,frostmourne,79,druid,feral,5,1,4
6390,Chubakea,kiljaeden,48,druid,feral,3,1,2
6391,Wierdosaur,azralon,48,druid,feral,3,1,2
6392,Bjohns,bleeding-hollow,42,druid,feral,9,2,7
6393,Enderhero,illidan,42,druid,feral,14,2,12
6394,Ânhur,tichondrius,42,druid,feral,17,2,15
6395,Dobrman,sargeras,31,druid,feral,2,1,1
6396,Psynix,zuljin,16,druid,feral,1,1,0
6397,Laryfsherman,tichondrius,2324,druid,balance,83,54,29
6398,Legionsucks,tanaris,2321,druid,balance,144,83,61
6399,Fredagn,illidan,2306,druid,balance,90,55,35
6400,Supatease,tichondrius,2302,druid,balance,123,72,51
6401,Jbz,balnazzar,2269,druid,balance,201,128,73
6402,Owl,shadowsong,2261,druid,balance,120,69,51
6403,Cti,tichondrius,2204,druid,balance,59,42,17
6404,Theforeigner,arathor,2194,druid,balance,59,46,13
6405,Notes,sargeras,2187,druid,balance,104,54,50
6406,Gugukuaipao,tichondrius,2186,druid,balance,155,83,72
6407,Flowerboï,azralon,2180,druid,balance,96,69,27
6408,Bkqtpie,tichondrius,2176,druid,balance,106,59,47
6409,Tanerno,illidan,2168,druid,balance,123,72,51
6410,Flapz,illidan,2164,druid,balance,66,38,28
6411,Sonicphantom,kelthuzad,2145,druid,balance,96,61,35
6412,Pushpop,frostmourne,2140,druid,balance,84,53,31
6413,Impëria,quelthalas,2137,druid,balance,89,58,31
6414,Mewfasa,duskwood,2135,druid,balance,147,94,53
6415,Houli,tichondrius,2134,druid,balance,96,50,46
6416,Smëagol,zuljin,2133,druid,balance,114,59,55
6417,Nbadizzyboy,illidan,2130,druid,balance,53,43,10
6418,Bigdiablo,frostmourne,2130,druid,balance,207,114,93
6419,Kidcudi,dentarg,2127,druid,balance,210,108,102
6420,Peterßigßeam,malganis,2127,druid,balance,117,60,57
6421,Xijînping,tichondrius,2125,druid,balance,69,41,28
6422,Pisces,emerald-dream,2123,druid,balance,128,75,53
6423,Boomçhicken,tichondrius,2121,druid,balance,88,48,40
6424,Dízzen,bleeding-hollow,2120,druid,balance,90,57,33
6425,Solareclipse,tichondrius,2120,druid,balance,72,43,29
6426,Tranquilo,stormrage,2118,druid,balance,114,69,45
6427,Riskies,tichondrius,2116,druid,balance,252,133,119
6428,Brose,malganis,2115,druid,balance,66,43,23
6429,Altoberano,azralon,2111,druid,balance,89,49,40
6430,Fergh,tichondrius,2109,druid,balance,83,45,38
6431,Trusyrusty,stormrage,2107,druid,balance,151,83,68
6432,Gritzxv,stormrage,2105,druid,balance,83,48,35
6433,Sqwippyd,tichondrius,2102,druid,balance,78,49,29
6434,Hessenmèow,tichondrius,2102,druid,balance,84,44,40
6435,Gspx,dalaran,2089,druid,balance,60,33,27
6436,Soggykfc,illidan,2078,druid,balance,140,76,64
6437,Treirus,sargeras,2064,druid,balance,142,96,46
6438,Catworm,sargeras,2063,druid,balance,70,46,24
6439,Nokomanida,zuljin,2053,druid,balance,75,48,27
6440,Ertuzi,tichondrius,2052,druid,balance,114,68,46
6441,Balancex,tichondrius,2049,druid,balance,120,58,62
6442,Hayase,tichondrius,2041,druid,balance,108,64,44
6443,Convokeopp,tichondrius,2034,druid,balance,54,39,15
6444,Houlix,stormrage,2034,druid,balance,283,139,144
6445,Lazygaga,zuljin,2025,druid,balance,122,67,55
6446,Megadruidx,stormrage,2022,druid,balance,81,55,26
6447,Lavlol,frostmourne,2021,druid,balance,316,166,150
6448,Lgpepperoni,tichondrius,2020,druid,balance,54,47,7
6449,Biophilic,moon-guard,2020,druid,balance,94,48,46
6450,Omends,thrall,2017,druid,balance,122,66,56
6451,Compléx,tichondrius,2016,druid,balance,78,41,37
6452,Wnxmomthicc,tichondrius,2013,druid,balance,48,31,17
6453,Flatass,cairne,2013,druid,balance,122,73,49
6454,Soulz,quelthalas,2012,druid,balance,72,43,29
6455,Murkeÿ,frostmourne,2004,druid,balance,108,50,58
6456,Babekisser,stormrage,2002,druid,balance,215,123,92
6457,Fhormations,area-52,2000,druid,balance,119,68,51
6458,Snöwghost,aerie-peak,2000,druid,balance,227,118,109
6459,Bobthehefty,area-52,1999,druid,balance,64,38,26
6460,Lazershartz,cenarion-circle,1992,druid,balance,72,36,36
6461,Zneb,darkspear,1987,druid,balance,36,29,7
6462,Dogwáter,tichondrius,1984,druid,balance,40,29,11
6463,Tòmathy,tichondrius,1982,druid,balance,65,38,27
6464,Fracxx,area-52,1981,druid,balance,30,21,9
6465,Astraldank,tichondrius,1980,druid,balance,148,85,63
6466,Firefirelol,proudmoore,1978,druid,balance,101,45,56
6467,Wereocelot,firetree,1977,druid,balance,138,83,55
6468,Starfail,illidan,1974,druid,balance,60,30,30
6469,Murruk,darkspear,1972,druid,balance,153,84,69
6470,Jimmypop,malganis,1970,druid,balance,115,71,44
6471,Cultnelf,illidan,1967,druid,balance,113,60,53
6472,Kaid,malganis,1964,druid,balance,54,33,21
6473,Pønchø,quelthalas,1960,druid,balance,56,33,23
6474,Vertderferk,tichondrius,1954,druid,balance,68,40,28
6475,John,azralon,1954,druid,balance,144,69,75
6476,Ztraws,tichondrius,1953,druid,balance,94,59,35
6477,Giantpanther,tichondrius,1951,druid,balance,66,45,21
6478,Ezgamed,tichondrius,1950,druid,balance,69,46,23
6479,Yepz,tichondrius,1945,druid,balance,75,42,33
6480,Basedcatx,tichondrius,1940,druid,balance,82,52,30
6481,Napes,tichondrius,1940,druid,balance,60,34,26
6482,Thugrose,blackrock,1938,druid,balance,48,25,23
6483,Sebastian,tichondrius,1937,druid,balance,59,36,23
6484,Spamclonewin,tichondrius,1937,druid,balance,123,73,50
6485,Toughshift,zuljin,1936,druid,balance,66,28,38
6486,Daspdruid,nagrand,1928,druid,balance,230,117,113
6487,Jakob,arygos,1926,druid,balance,162,92,70
6488,Boomkek,wyrmrest-accord,1924,druid,balance,48,33,15
6489,Jaseyxxl,area-52,1923,druid,balance,46,35,11
6490,Lovemakitty,sargeras,1922,druid,balance,78,46,32
6491,Oakwalker,moon-guard,1920,druid,balance,108,59,49
6492,Bubalolz,quelthalas,1914,druid,balance,191,101,90
6493,Herpadruid,illidan,1912,druid,balance,102,48,54
6494,Treeheehee,frostmourne,1911,druid,balance,81,60,21
6495,Locose,black-dragonflight,1911,druid,balance,48,34,14
6496,Foekinghobo,sargeras,1911,druid,balance,132,74,58
6497,Acdru,tichondrius,1911,druid,balance,67,37,30
6498,Dorizio,illidan,1910,druid,balance,64,40,24
6499,Dilondru,area-52,1906,druid,balance,117,70,47
6500,Beefnudlsoup,tichondrius,1906,druid,balance,66,39,27
6501,Etherêal,stormrage,1905,druid,balance,102,59,43
6502,Hxzard,dalaran,1905,druid,balance,146,81,65
6503,Vengex,sargeras,1904,druid,balance,48,30,18
6504,Jayelljaÿ,thrall,1899,druid,balance,129,78,51
6505,Knotgiver,moon-guard,1899,druid,balance,52,31,21
6506,Byk,tichondrius,1896,druid,balance,102,57,45
6507,Halrath,sargeras,1891,druid,balance,36,20,16
6508,Vernaar,laughing-skull,1888,druid,balance,84,47,37
6509,Bables,tichondrius,1886,druid,balance,72,45,27
6510,Celtaberano,illidan,1884,druid,balance,24,20,4
6511,Druidstin,tichondrius,1883,druid,balance,66,33,33
6512,Hefkerd,tichondrius,1881,druid,balance,30,20,10
6513,Ethan,the-venture-co,1879,druid,balance,39,26,13
6514,Lazersnewch,kelthuzad,1877,druid,balance,60,35,25
6515,Geezbutt,tichondrius,1876,druid,balance,157,80,77
6516,Psychotycxd,tichondrius,1870,druid,balance,126,69,57
6517,Sadboy,moon-guard,1869,druid,balance,161,87,74
6518,Boyoboy,thrall,1867,druid,balance,30,22,8
6519,Ràjeesh,frostmourne,1867,druid,balance,46,31,15
6520,Hydrahl,thrall,1867,druid,balance,54,35,19
6521,Çoach,tichondrius,1867,druid,balance,78,43,35
6522,Möshinòõb,proudmoore,1865,druid,balance,58,40,18
6523,Sarvi,zuljin,1864,druid,balance,33,24,9
6524,Elythria,hellscream,1863,druid,balance,30,26,4
6525,Enøsh,tichondrius,1861,druid,balance,84,45,39
6526,Vuru,azralon,1860,druid,balance,41,29,12
6527,Doomty,tichondrius,1860,druid,balance,72,42,30
6528,Mverstapp,moon-guard,1859,druid,balance,42,24,18
6529,Poliage,moon-guard,1858,druid,balance,155,89,66
6530,Mcv,tichondrius,1856,druid,balance,60,33,27
6531,Lilbeam,sargeras,1855,druid,balance,42,27,15
6532,Ericzzdd,tichondrius,1854,druid,balance,60,44,16
6533,Thundoon,tichondrius,1854,druid,balance,36,23,13
6534,Hogd,illidan,1854,druid,balance,60,35,25
6535,Rizzit,wyrmrest-accord,1852,druid,balance,58,32,26
6536,Fifty,ragnaros,1851,druid,balance,84,53,31
6537,Johnieboy,azralon,1850,druid,balance,45,32,13
6538,Angryjo,tichondrius,1850,druid,balance,64,38,26
6539,Suen,tichondrius,1848,druid,balance,48,32,16
6540,Jojo,ysera,1848,druid,balance,119,65,54
6541,Swaggu,kelthuzad,1847,druid,balance,72,44,28
6542,Idolizeme,skullcrusher,1845,druid,balance,59,30,29
6543,Laser,bonechewer,1844,druid,balance,42,27,15
6544,Judar,barthilas,1844,druid,balance,71,36,35
6545,Bentøbøx,barthilas,1841,druid,balance,47,27,20
6546,Ballinthree,illidan,1837,druid,balance,42,32,10
6547,Gèb,dalaran,1835,druid,balance,116,71,45
6548,Elunegoddess,tichondrius,1834,druid,balance,46,27,19
6549,Formhub,malganis,1834,druid,balance,84,42,42
6550,Moonflora,stormrage,1833,druid,balance,129,73,56
6551,Cousa,zuljin,1832,druid,balance,88,52,36
6552,Sawsaw,bleeding-hollow,1832,druid,balance,74,42,32
6553,Ilovediegoxo,kelthuzad,1830,druid,balance,48,32,16
6554,Komacine,emerald-dream,1830,druid,balance,403,217,186
6555,Deloria,nemesis,1829,druid,balance,42,25,17
6556,Dontnerfmore,queldorei,1829,druid,balance,66,31,35
6557,Moozzash,azralon,1828,druid,balance,54,32,22
6558,Chernovax,kelthuzad,1828,druid,balance,87,47,40
6559,Equinøxx,malganis,1827,druid,balance,47,30,17
6560,Bcup,sargeras,1826,druid,balance,54,32,22
6561,Striix,ragnaros,1824,druid,balance,42,22,20
6562,Clonemunster,frostmourne,1821,druid,balance,66,38,28
6563,Fleasy,wyrmrest-accord,1820,druid,balance,85,52,33
6564,Lunalai,bloodhoof,1820,druid,balance,96,55,41
6565,Sueycide,tichondrius,1819,druid,balance,71,34,37
6566,Dipii,proudmoore,1818,druid,balance,30,22,8
6567,Resorange,malganis,1818,druid,balance,48,29,19
6568,Dorlingus,tichondrius,1817,druid,balance,48,29,19
6569,Rìniroo,area-52,1816,druid,balance,48,30,18
6570,Xenny,chogall,1815,druid,balance,48,34,14
6571,Form,bleeding-hollow,1815,druid,balance,96,57,39
6572,Raïsin,moon-guard,1814,druid,balance,45,26,19
6573,Jacusias,stormrage,1814,druid,balance,188,102,86
6574,Animatronixz,area-52,1813,druid,balance,66,34,32
6575,Keylae,sargeras,1812,druid,balance,86,46,40
6576,Drugdoer,tichondrius,1811,druid,balance,106,64,42
6577,Thottiie,hyjal,1811,druid,balance,60,36,24
6578,Moonkay,tichondrius,1810,druid,balance,42,26,16
6579,Instar,tichondrius,1810,druid,balance,36,19,17
6580,Tôpdadwôrld,sargeras,1809,druid,balance,30,19,11
6581,Drcuy,ragnaros,1809,druid,balance,98,56,42
6582,Seyala,moon-guard,1809,druid,balance,175,99,76
6583,Wiredxd,illidan,1807,druid,balance,44,28,16
6584,Cattdog,tichondrius,1806,druid,balance,82,55,27
6585,Dustydrx,area-52,1806,druid,balance,56,34,22
6586,Lakermagik,moknathal,1806,druid,balance,43,25,18
6587,Zeromoon,frostmourne,1806,druid,balance,59,29,30
6588,Harukai,azralon,1805,druid,balance,114,67,47
6589,Exxh,tichondrius,1803,druid,balance,46,34,12
6590,Starbränd,azralon,1803,druid,balance,60,38,22
6591,Youngtree,tichondrius,1803,druid,balance,33,20,13
6592,Halenson,illidan,1803,druid,balance,70,41,29
6593,Itachi,dragonmaw,1803,druid,balance,65,38,27
6594,Vengexd,sargeras,1802,druid,balance,24,19,5
6595,Malfuria,tichondrius,1802,druid,balance,47,29,18
6596,Mythleaf,ragnaros,1802,druid,balance,120,70,50
6597,Felny,malganis,1802,druid,balance,54,26,28
6598,Buffjungle,tichondrius,1801,druid,balance,36,20,16
6599,Treelah,tichondrius,1800,druid,balance,48,29,19
6600,Evsn,tichondrius,1799,druid,balance,24,21,3
6601,Burninmoon,tichondrius,1796,druid,balance,48,28,20
6602,Metroboomy,magtheridon,1795,druid,balance,68,40,28
6603,Lekick,tichondrius,1795,druid,balance,66,36,30
6604,Chal,illidan,1791,druid,balance,53,32,21
6605,Alpine,eldrethalas,1790,druid,balance,54,35,19
6606,Hypefull,tichondrius,1790,druid,balance,48,23,25
6607,Zoteqt,kelthuzad,1789,druid,balance,157,84,73
6608,Haohomie,tichondrius,1783,druid,balance,60,42,18
6609,Destromz,zuljin,1780,druid,balance,36,24,12
6610,Ataraxie,illidan,1780,druid,balance,78,47,31
6611,Sommerrays,kelthuzad,1780,druid,balance,60,31,29
6612,Spacedruidx,illidan,1778,druid,balance,84,47,37
6613,Pipiwiwi,stormrage,1773,druid,balance,99,57,42
6614,Orollå,tichondrius,1771,druid,balance,50,29,21
6615,Oungan,illidan,1771,druid,balance,98,56,42
6616,Çørrúptíøñzx,tichondrius,1770,druid,balance,36,25,11
6617,Cirranis,moon-guard,1769,druid,balance,81,53,28
6618,Boomybro,thrall,1768,druid,balance,140,84,56
6619,Chanimal,tichondrius,1766,druid,balance,30,24,6
6620,Olongjonsson,wyrmrest-accord,1766,druid,balance,36,19,17
6621,Lilkitty,tichondrius,1764,druid,balance,148,81,67
6622,Bathrobe,bloodscalp,1762,druid,balance,48,26,22
6623,Weckxa,sargeras,1762,druid,balance,197,102,95
6624,Purkins,barthilas,1761,druid,balance,36,22,14
6625,Ailari,moon-guard,1761,druid,balance,91,52,39
6626,Catpoop,frostmourne,1759,druid,balance,42,30,12
6627,Pennytrate,barthilas,1759,druid,balance,92,54,38
6628,Cocainebeär,tichondrius,1755,druid,balance,77,39,38
6629,Cynhawts,emerald-dream,1754,druid,balance,46,27,19
6630,Swayjizz,tichondrius,1750,druid,balance,114,64,50
6631,Rikishi,executus,1749,druid,balance,54,29,25
6632,Glazinator,sargeras,1749,druid,balance,178,88,90
6633,Deviperdruid,frostmourne,1748,druid,balance,51,35,16
6634,Meowkit,blackrock,1744,druid,balance,48,33,15
6635,Ayla,gorefiend,1741,druid,balance,47,30,17
6636,Foxhoundlol,tichondrius,1741,druid,balance,66,42,24
6637,Jaxer,illidan,1741,druid,balance,111,68,43
6638,Owlyfans,frostmourne,1741,druid,balance,42,25,17
6639,Readt,malganis,1738,druid,balance,198,108,90
6640,Ebrìthil,hyjal,1737,druid,balance,54,27,27
6641,Ilovediego,stormrage,1736,druid,balance,36,21,15
6642,Kydralola,ragnaros,1735,druid,balance,36,21,15
6643,Petruccius,nordrassil,1735,druid,balance,208,104,104
6644,Nxf,sargeras,1734,druid,balance,35,21,14
6645,Druidwhat,stormrage,1734,druid,balance,153,81,72
6646,Deenut,sargeras,1733,druid,balance,36,24,12
6647,Bunnykiss,tichondrius,1733,druid,balance,79,38,41
6648,Melloj,kelthuzad,1732,druid,balance,66,38,28
6649,Yggdrasil,ravencrest,1732,druid,balance,42,24,18
6650,Daddyshift,proudmoore,1731,druid,balance,62,35,27
6651,Jemima,auchindoun,1730,druid,balance,136,80,56
6652,Nyloke,kelthuzad,1729,druid,balance,66,44,22
6653,Choosegoose,area-52,1729,druid,balance,44,29,15
6654,Scene,frostmourne,1729,druid,balance,71,40,31
6655,Dextructive,tichondrius,1729,druid,balance,124,60,64
6656,Kydro,sargeras,1728,druid,balance,48,25,23
6657,Druidk,tichondrius,1728,druid,balance,60,28,32
6658,Cobal,goldrinn,1727,druid,balance,419,216,203
6659,Trapdoorboom,illidan,1726,druid,balance,96,51,45
6660,Souress,shadowsong,1725,druid,balance,48,28,20
6661,Stinkÿ,bleeding-hollow,1724,druid,balance,63,42,21
6662,Faerie,kaelthas,1724,druid,balance,64,36,28
6663,Bukkwild,stormrage,1723,druid,balance,50,38,12
6664,Pannaxx,tichondrius,1723,druid,balance,36,24,12
6665,Naakx,tichondrius,1722,druid,balance,52,30,22
6666,Wecksox,area-52,1721,druid,balance,246,119,127
6667,Wòót,stormreaver,1719,druid,balance,84,58,26
6668,Xantastic,area-52,1719,druid,balance,42,24,18
6669,Starsucceed,illidan,1718,druid,balance,42,21,21
6670,Brainlessqt,tichondrius,1717,druid,balance,34,24,10
6671,Droodaphobé,sargeras,1714,druid,balance,59,34,25
6672,Cjæ,bleeding-hollow,1713,druid,balance,24,18,6
6673,Dànkness,frostwolf,1713,druid,balance,53,29,24
6674,Frames,area-52,1712,druid,balance,77,39,38
6675,Nophysique,zuljin,1709,druid,balance,112,62,50
6676,Líu,area-52,1705,druid,balance,90,55,35
6677,Skeevz,darkspear,1705,druid,balance,56,32,24
6678,Kyura,sargeras,1705,druid,balance,130,62,68
6679,Mädnhairy,zuljin,1703,druid,balance,45,28,17
6680,Maligoz,nemesis,1703,druid,balance,95,49,46
6681,Beamed,thrall,1702,druid,balance,24,18,6
6682,Davione,tichondrius,1702,druid,balance,46,28,18
6683,Rerob,aerie-peak,1702,druid,balance,50,26,24
6684,Whoopz,blackrock,1702,druid,balance,36,18,18
6685,Donutdruid,illidan,1701,druid,balance,46,29,17
6686,Pào,tichondrius,1701,druid,balance,45,28,17
6687,Doomdawn,sargeras,1701,druid,balance,123,65,58
6688,Pils,nemesis,1700,druid,balance,124,74,50
6689,Staystrongox,tichondrius,1700,druid,balance,70,41,29
6690,Smeepy,bleeding-hollow,1700,druid,balance,48,26,22
6691,Binjuicex,frostmourne,1699,druid,balance,45,29,16
6692,Drufasa,tichondrius,1699,druid,balance,41,23,18
6693,Kamero,tichondrius,1697,druid,balance,45,26,19
6694,Tunaren,wyrmrest-accord,1696,druid,balance,42,21,21
6695,Boomfold,tichondrius,1696,druid,balance,36,18,18
6696,Krispz,area-52,1696,druid,balance,59,29,30
6697,Protagonist,zuluhed,1695,druid,balance,37,23,14
6698,Raquelitá,ragnaros,1694,druid,balance,28,19,9
6699,Smeow,zuljin,1694,druid,balance,65,36,29
6700,Aqulaíssaela,sargeras,1694,druid,balance,42,23,19
6701,Showmanship,tichondrius,1691,druid,balance,104,59,45
6702,Bolthor,wyrmrest-accord,1691,druid,balance,84,45,39
6703,Sibby,barthilas,1691,druid,balance,90,48,42
6704,Moonrg,stormrage,1689,druid,balance,66,35,31
6705,Djayolo,illidan,1688,druid,balance,30,23,7
6706,Aule,frostmourne,1687,druid,balance,36,18,18
6707,Realmehji,wyrmrest-accord,1686,druid,balance,36,28,8
6708,Spinach,moon-guard,1686,druid,balance,104,53,51
6709,Mortqt,tichondrius,1685,druid,balance,42,23,19
6710,Khryllx,tichondrius,1683,druid,balance,36,25,11
6711,Chickenwings,ragnaros,1683,druid,balance,42,27,15
6712,Ghaal,tichondrius,1683,druid,balance,84,53,31
6713,Dárách,malganis,1683,druid,balance,90,54,36
6714,Gwiffurry,tichondrius,1683,druid,balance,54,32,22
6715,Roofty,illidan,1681,druid,balance,34,22,12
6716,Justsidious,sargeras,1679,druid,balance,30,23,7
6717,Kzinti,zuluhed,1679,druid,balance,85,41,44
6718,Lothail,windrunner,1678,druid,balance,48,25,23
6719,Ruthlessbro,sargeras,1677,druid,balance,85,45,40
6720,Pizzaparties,tichondrius,1676,druid,balance,35,28,7
6721,Myex,illidan,1676,druid,balance,48,32,16
6722,Abomasnow,turalyon,1675,druid,balance,60,35,25
6723,Glickbear,illidan,1675,druid,balance,48,26,22
6724,Ànìmàl,stormrage,1674,druid,balance,36,27,9
6725,Beamrooster,silvermoon,1672,druid,balance,48,32,16
6726,Lostnsauce,tichondrius,1669,druid,balance,60,43,17
6727,Boiledfrogs,zuljin,1669,druid,balance,30,19,11
6728,Irooftrellen,chogall,1669,druid,balance,53,26,27
6729,Halensen,illidan,1668,druid,balance,47,23,24
6730,Wallower,malganis,1667,druid,balance,54,24,30
6731,Yipëë,moon-guard,1666,druid,balance,64,34,30
6732,Ðøomkinz,azjolnerub,1665,druid,balance,48,33,15
6733,Nickyü,ragnaros,1665,druid,balance,54,23,31
6734,Partybeast,malganis,1664,druid,balance,74,55,19
6735,Animlcracker,emerald-dream,1664,druid,balance,54,36,18
6736,Gumbawl,sargeras,1662,druid,balance,36,22,14
6737,Gokki,zuljin,1660,druid,balance,77,53,24
6738,Shafted,kelthuzad,1660,druid,balance,30,20,10
6739,Seilah,lightbringer,1660,druid,balance,36,20,16
6740,Bloomqt,tichondrius,1658,druid,balance,108,62,46
6741,Foafoa,illidan,1657,druid,balance,31,19,12
6742,Verbz,arthas,1656,druid,balance,54,26,28
6743,Nåpes,frostmourne,1656,druid,balance,44,21,23
6744,Niroxic,frostmourne,1654,druid,balance,42,27,15
6745,Ehleven,tichondrius,1654,druid,balance,42,27,15
6746,Gordzak,illidan,1654,druid,balance,158,81,77
6747,Aull,kelthuzad,1653,druid,balance,36,19,17
6748,Roar,moon-guard,1652,druid,balance,45,31,14
6749,Loudpax,zuljin,1652,druid,balance,53,36,17
6750,Renithen,trollbane,1652,druid,balance,42,28,14
6751,Chedisdru,mugthol,1652,druid,balance,42,28,14
6752,Înfamous,thrall,1652,druid,balance,36,24,12
6753,Starlyxo,malganis,1652,druid,balance,59,37,22
6754,Chernlyssayo,stormrage,1652,druid,balance,50,30,20
6755,Drmf,frostmourne,1652,druid,balance,42,25,17
6756,Ashstarfall,barthilas,1651,druid,balance,36,26,10
6757,Druentia,tichondrius,1650,druid,balance,30,20,10
6758,Coldkill,burning-legion,1650,druid,balance,36,20,16
6759,Dôcteurowl,zuljin,1650,druid,balance,77,36,41
6760,Starz,arthas,1649,druid,balance,41,26,15
6761,Wasabilol,tichondrius,1647,druid,balance,79,46,33
6762,Swiftydel,frostmourne,1646,druid,balance,48,27,21
6763,Ironsightsdr,dalaran,1645,druid,balance,51,29,22
6764,Josepha,tichondrius,1643,druid,balance,30,20,10
6765,Wizdùm,frostmourne,1643,druid,balance,53,34,19
6766,Convokeula,tichondrius,1643,druid,balance,90,55,35
6767,Pankecito,ragnaros,1643,druid,balance,52,30,22
6768,Aethisra,moon-guard,1642,druid,balance,125,72,53
6769,Boomchickens,area-52,1642,druid,balance,60,33,27
6770,Partylord,malganis,1642,druid,balance,108,57,51
6771,Irl,frostmane,1641,druid,balance,41,23,18
6772,Scurse,tichondrius,1641,druid,balance,102,53,49
6773,Grapeful,frostmourne,1640,druid,balance,66,37,29
6774,Sweatypapa,tichondrius,1639,druid,balance,72,49,23
6775,Rumorxo,illidan,1639,druid,balance,30,18,12
6776,Chøpstixs,bleeding-hollow,1639,druid,balance,48,28,20
6777,Snugglin,kelthuzad,1639,druid,balance,60,31,29
6778,Goochies,aerie-peak,1638,druid,balance,29,18,11
6779,Jillferal,proudmoore,1638,druid,balance,78,47,31
6780,Handhandb,tichondrius,1638,druid,balance,30,18,12
6781,Quelarre,velen,1638,druid,balance,94,53,41
6782,Phurr,area-52,1638,druid,balance,48,25,23
6783,Brokenomega,area-52,1637,druid,balance,112,67,45
6784,Killiamp,tichondrius,1636,druid,balance,41,27,14
6785,Kïx,illidan,1636,druid,balance,38,23,15
6786,Marutot,tichondrius,1635,druid,balance,30,24,6
6787,Thamoonsbak,aggramar,1635,druid,balance,35,18,17
6788,Taylorshift,misha,1633,druid,balance,27,23,4
6789,Blitzkreigtv,area-52,1633,druid,balance,36,23,13
6790,Trapkin,tichondrius,1631,druid,balance,167,101,66
6791,Bunnyes,tichondrius,1631,druid,balance,42,22,20
6792,Midnitetoker,hyjal,1631,druid,balance,48,25,23
6793,Meatbender,frostmourne,1630,druid,balance,86,41,45
6794,Relaeh,andorhal,1629,druid,balance,36,19,17
6795,Kekepöp,illidan,1628,druid,balance,36,25,11
6796,Elyveen,proudmoore,1627,druid,balance,63,46,17
6797,Bearyhallsjr,sargeras,1627,druid,balance,24,17,7
6798,Animaldoctor,illidan,1627,druid,balance,57,38,19
6799,Jimrobloxttv,emerald-dream,1627,druid,balance,36,24,12
6800,Oppose,akama,1627,druid,balance,65,37,28
6801,Dreamwalker,bleeding-hollow,1626,druid,balance,24,17,7
6802,Muwudred,stormrage,1626,druid,balance,48,28,20
6803,Ablackdruid,moon-guard,1624,druid,balance,35,21,14
6804,Flappyjacks,elune,1624,druid,balance,42,22,20
6805,Vergota,emerald-dream,1623,druid,balance,67,46,21
6806,Moonra,malganis,1623,druid,balance,66,38,28
6807,Soonntkgo,ragnaros,1623,druid,balance,56,29,27
6808,Eseldra,area-52,1622,druid,balance,58,34,24
6809,Harryhotter,blackrock,1622,druid,balance,109,54,55
6810,Reàsons,stormrage,1622,druid,balance,66,30,36
6811,Kelagoat,kiljaeden,1620,druid,balance,54,26,28
6812,Cenariun,stormrage,1619,druid,balance,30,19,11
6813,Mûû,tichondrius,1619,druid,balance,80,46,34
6814,Contrololol,hyjal,1619,druid,balance,60,32,28
6815,Gatø,area-52,1619,druid,balance,90,42,48
6816,Cyclone,darkspear,1618,druid,balance,36,17,19
6817,Girthybeam,sargeras,1617,druid,balance,38,22,16
6818,Balanci,stormrage,1617,druid,balance,64,36,28
6819,Wildslash,proudmoore,1617,druid,balance,75,37,38
6820,Softkiller,chogall,1616,druid,balance,54,33,21
6821,Yazmawma,tichondrius,1616,druid,balance,30,18,12
6822,Cottonpaw,sargeras,1616,druid,balance,205,118,87
6823,Mastabtw,illidan,1616,druid,balance,30,17,13
6824,Treeshift,tichondrius,1615,druid,balance,53,32,21
6825,Furryswipe,proudmoore,1614,druid,balance,56,33,23
6826,Polánd,area-52,1614,druid,balance,75,43,32
6827,Fätål,ysera,1613,druid,balance,54,33,21
6828,Héisénbérg,sargeras,1613,druid,balance,48,27,21
6829,Auras,kelthuzad,1612,druid,balance,120,73,47
6830,Duglas,illidan,1612,druid,balance,91,55,36
6831,Xannê,tichondrius,1612,druid,balance,38,20,18
6832,Ellguin,malganis,1611,druid,balance,60,44,16
6833,Buckwhêât,illidan,1611,druid,balance,64,28,36
6834,Pänzerkin,sargeras,1609,druid,balance,30,21,9
6835,Yosuzume,thrall,1609,druid,balance,36,24,12
6836,Alaillais,moon-guard,1609,druid,balance,48,28,20
6837,Canek,ghostlands,1609,druid,balance,107,62,45
6838,Kittiepurry,blackrock,1607,druid,balance,112,63,49
6839,Surfingbird,tichondrius,1606,druid,balance,195,116,79
6840,Boys,bleeding-hollow,1606,druid,balance,42,24,18
6841,Braviel,stormrage,1605,druid,balance,54,32,22
6842,Raddosaurus,area-52,1605,druid,balance,83,45,38
6843,Djsummer,tichondrius,1605,druid,balance,107,56,51
6844,Yehaw,bloodhoof,1604,druid,balance,54,35,19
6845,Lyshani,thrall,1604,druid,balance,46,27,19
6846,Awazing,illidan,1604,druid,balance,53,25,28
6847,Nehrudruid,area-52,1603,druid,balance,24,17,7
6848,Anchunlol,tichondrius,1603,druid,balance,36,19,17
6849,Gallianö,frostmourne,1601,druid,balance,40,23,17
6850,Brodda,sargeras,1600,druid,balance,194,101,93
6851,Kletys,azralon,1599,druid,balance,113,57,56
6852,Stellar,steamwheedle-cartel,1597,druid,balance,24,19,5
6853,Inuyasha,sargeras,1597,druid,balance,59,34,25
6854,Fìlø,bleeding-hollow,1595,druid,balance,186,106,80
6855,Odirtytshirt,malganis,1595,druid,balance,55,27,28
6856,Skurts,tichondrius,1594,druid,balance,39,25,14
6857,Blackjésüs,kelthuzad,1594,druid,balance,153,86,67
6858,Soupbeandru,zuljin,1593,druid,balance,48,28,20
6859,Frostig,tichondrius,1593,druid,balance,30,17,13
6860,Faelonk,frostmourne,1592,druid,balance,30,23,7
6861,Soar,destromath,1592,druid,balance,62,36,26
6862,Kittycleave,tichondrius,1591,druid,balance,24,17,7
6863,Charmandxr,hyjal,1589,druid,balance,40,22,18
6864,Sodapooping,azjolnerub,1588,druid,balance,96,58,38
6865,Ånðrømæðå,sargeras,1588,druid,balance,48,26,22
6866,Davo,tichondrius,1587,druid,balance,42,27,15
6867,Seyedo,sargeras,1587,druid,balance,65,38,27
6868,Skirts,area-52,1587,druid,balance,59,34,25
6869,Còyot,stormrage,1586,druid,balance,60,30,30
6870,Korbö,zuljin,1585,druid,balance,30,18,12
6871,Torrox,tichondrius,1585,druid,balance,148,82,66
6872,Druizzy,illidan,1585,druid,balance,54,21,33
6873,Fancynut,kiljaeden,1583,druid,balance,56,26,30
6874,Yoglosmas,tichondrius,1582,druid,balance,24,19,5
6875,Shîfty,ysondre,1580,druid,balance,65,35,30
6876,Jeanz,bonechewer,1579,druid,balance,36,22,14
6877,Druiddruid,daggerspine,1577,druid,balance,59,36,23
6878,Astrals,runetotem,1577,druid,balance,39,21,18
6879,Trippyshift,hyjal,1577,druid,balance,48,24,24
6880,Lewïs,stormrage,1576,druid,balance,57,30,27
6881,Krahz,lightnings-blade,1576,druid,balance,348,177,171
6882,Darach,boulderfist,1575,druid,balance,30,21,9
6883,Quaras,frostmourne,1574,druid,balance,235,125,110
6884,Clarice,shattered-halls,1574,druid,balance,99,51,48
6885,Sombrien,stormrage,1573,druid,balance,90,46,44
6886,Mõoõoõoõoõoõ,tichondrius,1573,druid,balance,36,18,18
6887,Nodadpullout,tichondrius,1572,druid,balance,51,25,26
6888,Beretta,rexxar,1571,druid,balance,84,48,36
6889,Rayzer,bleeding-hollow,1571,druid,balance,120,64,56
6890,Theboomkin,kelthuzad,1570,druid,balance,30,19,11
6891,Saltydru,illidan,1570,druid,balance,44,25,19
6892,Bugbugz,tichondrius,1570,druid,balance,36,18,18
6893,Starsurgê,tichondrius,1569,druid,balance,66,42,24
6894,Boõsty,bleeding-hollow,1569,druid,balance,36,19,17
6895,Sadsex,illidan,1567,druid,balance,101,59,42
6896,Børing,sargeras,1566,druid,balance,60,35,25
6897,Atagoo,tichondrius,1566,druid,balance,198,103,95
6898,Maplêleaf,moon-guard,1566,druid,balance,117,60,57
6899,Venkin,gnomeregan,1566,druid,balance,96,47,49
6900,Fondra,sargeras,1564,druid,balance,37,23,14
6901,Rakex,tichondrius,1564,druid,balance,68,35,33
6902,Groggs,frostwolf,1564,druid,balance,39,20,19
6903,Ahrilee,area-52,1564,druid,balance,36,18,18
6904,Swoopy,stormrage,1563,druid,balance,79,44,35
6905,Slumpxaddy,illidan,1562,druid,balance,35,21,14
6906,Xiaoshuaigê,illidan,1562,druid,balance,30,18,12
6907,Bhboom,tichondrius,1562,druid,balance,42,19,23
6908,Delorík,illidan,1561,druid,balance,96,51,45
6909,Montrá,stormrage,1560,druid,balance,90,42,48
6910,Rokk,baelgun,1558,druid,balance,73,45,28
6911,Nasuu,bleeding-hollow,1556,druid,balance,60,36,24
6912,Zesto,nazjatar,1555,druid,balance,24,17,7
6913,Targareyen,sargeras,1555,druid,balance,47,20,27
6914,Syclonez,stormrage,1554,druid,balance,42,21,21
6915,Hasteley,khadgar,1554,druid,balance,71,34,37
6916,Thespían,tichondrius,1553,druid,balance,369,193,176
6917,Midoo,proudmoore,1553,druid,balance,48,25,23
6918,Drdrulittle,darkspear,1553,druid,balance,78,40,38
6919,Lowkie,llane,1552,druid,balance,39,21,18
6920,Darkombra,frostmourne,1552,druid,balance,60,28,32
6921,Afpak,sargeras,1551,druid,balance,60,33,27
6922,Starcastic,tichondrius,1548,druid,balance,108,57,51
6923,Treetard,altar-of-storms,1545,druid,balance,54,27,27
6924,Boome,blackrock,1544,druid,balance,60,33,27
6925,Aralix,zuljin,1544,druid,balance,108,58,50
6926,Hayop,illidan,1543,druid,balance,60,28,32
6927,Kg,cenarion-circle,1541,druid,balance,149,87,62
6928,Ihavehothots,kiljaeden,1540,druid,balance,38,26,12
6929,Zettka,tichondrius,1539,druid,balance,55,32,23
6930,Donresantis,stormreaver,1539,druid,balance,90,46,44
6931,Qs,rivendare,1539,druid,balance,89,39,50
6932,November,wyrmrest-accord,1538,druid,balance,110,62,48
6933,Offthezaza,tichondrius,1538,druid,balance,76,40,36
6934,Hikoro,sargeras,1536,druid,balance,126,74,52
6935,Skum,bloodscalp,1536,druid,balance,63,27,36
6936,Catculator,tichondrius,1534,druid,balance,27,18,9
6937,Slowreverb,silver-hand,1534,druid,balance,30,16,14
6938,Fironous,nerzhul,1532,druid,balance,36,20,16
6939,Komaner,frostmourne,1529,druid,balance,36,16,20
6940,Brockolini,tichondrius,1528,druid,balance,82,44,38
6941,Cauroth,azralon,1527,druid,balance,133,72,61
6942,Indicamicah,tichondrius,1527,druid,balance,54,29,25
6943,Druuyid,jubeithos,1526,druid,balance,114,65,49
6944,Cyeq,blackrock,1526,druid,balance,243,127,116
6945,Chaossdruid,bleeding-hollow,1525,druid,balance,95,58,37
6946,Velaana,tichondrius,1524,druid,balance,44,21,23
6947,Chiikawa,tichondrius,1524,druid,balance,36,16,20
6948,Âzn,tichondrius,1523,druid,balance,54,39,15
6949,Sweatydruidx,tichondrius,1523,druid,balance,24,16,8
6950,Dreveron,bleeding-hollow,1523,druid,balance,36,16,20
6951,Eyzie,stormrage,1522,druid,balance,62,33,29
6952,Epicworld,stormrage,1521,druid,balance,81,50,31
6953,Abn,sargeras,1521,druid,balance,30,17,13
6954,Ripdimebag,frostmourne,1520,druid,balance,46,27,19
6955,Thorothir,ragnaros,1520,druid,balance,110,62,48
6956,Druidlolwtf,area-52,1520,druid,balance,108,52,56
6957,Myeow,illidan,1520,druid,balance,74,35,39
6958,Swooped,emerald-dream,1519,druid,balance,53,29,24
6959,Adaptivv,sargeras,1518,druid,balance,30,21,9
6960,Pirira,quelthalas,1517,druid,balance,42,24,18
6961,Musha,tichondrius,1517,druid,balance,57,30,27
6962,Hagatta,stormrage,1517,druid,balance,151,77,74
6963,Skyde,sargeras,1517,druid,balance,36,17,19
6964,Faruu,tichondrius,1516,druid,balance,24,16,8
6965,Ghostowl,thrall,1516,druid,balance,66,42,24
6966,Groovyroom,tichondrius,1516,druid,balance,42,23,19
6967,Pëps,emerald-dream,1514,druid,balance,48,27,21
6968,Umadornahh,malganis,1514,druid,balance,48,26,22
6969,Kitinglol,alexstrasza,1513,druid,balance,56,28,28
6970,Haymade,sargeras,1512,druid,balance,54,32,22
6971,Blazeikin,tichondrius,1512,druid,balance,36,16,20
6972,Scrubrat,moon-guard,1511,druid,balance,35,27,8
6973,Mk,caelestrasz,1511,druid,balance,30,17,13
6974,Polvinhoo,azralon,1510,druid,balance,54,29,25
6975,Tyapet,area-52,1509,druid,balance,61,31,30
6976,Twinscroll,tichondrius,1508,druid,balance,65,44,21
6977,Zorn,lightnings-blade,1508,druid,balance,48,26,22
6978,Themustafa,tichondrius,1507,druid,balance,30,17,13
6979,Kazamura,tichondrius,1507,druid,balance,48,18,30
6980,Padavore,wyrmrest-accord,1506,druid,balance,65,40,25
6981,Neytîrî,tichondrius,1506,druid,balance,65,35,30
6982,Vyrrath,stormrage,1504,druid,balance,32,19,13
6983,Woog,moon-guard,1504,druid,balance,60,34,26
6984,Awkwarder,emerald-dream,1504,druid,balance,84,43,41
6985,Shebleeder,aegwynn,1503,druid,balance,54,30,24
6986,Daddymaple,tichondrius,1503,druid,balance,42,23,19
6987,Hoagiecannon,moon-guard,1503,druid,balance,143,75,68
6988,Jxrx,malganis,1501,druid,balance,24,16,8
6989,Rootchan,azralon,1501,druid,balance,58,38,20
6990,Nuubmurph,stormrage,1499,druid,balance,33,20,13
6991,Tak,garrosh,1496,druid,balance,36,17,19
6992,Yoloboomkin,tichondrius,1494,druid,balance,46,23,23
6993,Rashmi,kiljaeden,1494,druid,balance,36,18,18
6994,Milksquirts,thrall,1491,druid,balance,87,49,38
6995,Starsurgeon,thrall,1491,druid,balance,138,72,66
6996,Watchmecap,silvermoon,1490,druid,balance,22,18,4
6997,Wildsïde,tichondrius,1490,druid,balance,48,28,20
6998,Kallabaluwa,azralon,1490,druid,balance,41,18,23
6999,Huggerino,stormrage,1489,druid,balance,58,32,26
7000,Cabek,malganis,1488,druid,balance,60,32,28
7001,Panansy,stormrage,1488,druid,balance,254,123,131
7002,Boxtops,bleeding-hollow,1486,druid,balance,36,23,13
7003,Restorationz,tichondrius,1485,druid,balance,59,36,23
7004,Charnlok,thunderlord,1484,druid,balance,41,29,12
7005,Stepbro,malorne,1484,druid,balance,95,53,42
7006,Dreamkin,tichondrius,1484,druid,balance,48,25,23
7007,Byte,ragnaros,1482,druid,balance,29,16,13
7008,Pawpurrazzi,darkspear,1482,druid,balance,53,27,26
7009,Owlgz,barthilas,1482,druid,balance,36,18,18
7010,Taurenasarus,area-52,1479,druid,balance,33,18,15
7011,Fahnir,ragnaros,1477,druid,balance,66,37,29
7012,Haneulso,tichondrius,1477,druid,balance,237,125,112
7013,Maviç,hyjal,1477,druid,balance,90,45,45
7014,Ryügähidëki,tichondrius,1476,druid,balance,61,32,29
7015,Árès,frostmourne,1475,druid,balance,47,27,20
7016,Fripp,stormrage,1475,druid,balance,36,20,16
7017,Kuwä,proudmoore,1474,druid,balance,72,36,36
7018,Gummoo,tichondrius,1472,druid,balance,42,30,12
7019,Suncintus,aggramar,1468,druid,balance,54,24,30
7020,Softdog,stormrage,1467,druid,balance,30,19,11
7021,Thatscute,moon-guard,1466,druid,balance,312,161,151
7022,Nephdruid,stormrage,1464,druid,balance,93,53,40
7023,Redhotbean,tichondrius,1464,druid,balance,53,25,28
7024,Unclenya,barthilas,1463,druid,balance,72,32,40
7025,Clense,tichondrius,1461,druid,balance,67,38,29
7026,Bruddahderpp,tichondrius,1460,druid,balance,42,28,14
7027,Rajionu,kiljaeden,1460,druid,balance,30,20,10
7028,Zhinger,tichondrius,1460,druid,balance,79,39,40
7029,Seyon,tichondrius,1459,druid,balance,33,17,16
7030,Shiftyn,proudmoore,1457,druid,balance,30,22,8
7031,Lãzy,tichondrius,1456,druid,balance,96,53,43
7032,Yaboidakota,stormrage,1456,druid,balance,160,84,76
7033,Metal,jaedenar,1456,druid,balance,61,30,31
7034,Pooöòôp,kiljaeden,1454,druid,balance,24,18,6
7035,Aranuir,emerald-dream,1452,druid,balance,35,20,15
7036,Queiq,kelthuzad,1452,druid,balance,42,22,20
7037,Rezlur,tichondrius,1452,druid,balance,35,16,19
7038,Thunderhox,tichondrius,1451,druid,balance,67,36,31
7039,Alshari,proudmoore,1450,druid,balance,30,19,11
7040,Kittygoboom,kiljaeden,1450,druid,balance,60,24,36
7041,Paddywhacked,tichondrius,1449,druid,balance,36,22,14
7042,Jruids,stormrage,1449,druid,balance,54,32,22
7043,Cerest,kaelthas,1448,druid,balance,34,21,13
7044,Juicywap,proudmoore,1448,druid,balance,47,26,21
7045,Instanodle,proudmoore,1447,druid,balance,36,20,16
7046,Windstag,korgath,1447,druid,balance,36,17,19
7047,Sileda,nemesis,1445,druid,balance,25,18,7
7048,Rdruidchump,the-forgotten-coast,1445,druid,balance,32,19,13
7049,Syntheris,kaelthas,1445,druid,balance,87,51,36
7050,Bighomïe,emerald-dream,1445,druid,balance,48,27,21
7051,Hitchslaps,tichondrius,1445,druid,balance,36,19,17
7052,Atmospherè,tichondrius,1444,druid,balance,48,27,21
7053,Pavati,bleeding-hollow,1444,druid,balance,38,21,17
7054,Formmaster,malganis,1441,druid,balance,76,38,38
7055,Thatboiscrew,tichondrius,1439,druid,balance,35,26,9
7056,Nicotinefien,sargeras,1439,druid,balance,24,15,9
7057,Drubuzz,tichondrius,1439,druid,balance,102,56,46
7058,Lunarbalance,veknilash,1438,druid,balance,99,44,55
7059,Elvishrage,zuljin,1437,druid,balance,18,15,3
7060,Brettdadad,shandris,1437,druid,balance,30,19,11
7061,Envoy,sargeras,1435,druid,balance,60,33,27
7062,Supafat,thrall,1434,druid,balance,25,16,9
7063,Alliess,aerie-peak,1434,druid,balance,111,56,55
7064,Falkond,tichondrius,1433,druid,balance,35,18,17
7065,Squidwonk,sargeras,1433,druid,balance,48,23,25
7066,Arealdruid,moon-guard,1433,druid,balance,42,18,24
7067,Shapedance,sargeras,1431,druid,balance,35,16,19
7068,Maimz,tichondrius,1430,druid,balance,84,49,35
7069,Ularda,bleeding-hollow,1429,druid,balance,36,22,14
7070,Nokash,tichondrius,1425,druid,balance,43,17,26
7071,Squidrific,tichondrius,1424,druid,balance,71,47,24
7072,Swappy,korgath,1424,druid,balance,36,18,18
7073,Nebulose,moon-guard,1424,druid,balance,59,26,33
7074,Gaawdx,illidan,1424,druid,balance,90,39,51
7075,Tahunne,tichondrius,1423,druid,balance,88,53,35
7076,Mèowcenaary,chogall,1423,druid,balance,60,35,25
7077,Trickatreyy,kelthuzad,1421,druid,balance,37,19,18
7078,Dudur,zuljin,1420,druid,balance,72,33,39
7079,Dontfloodit,tichondrius,1419,druid,balance,87,40,47
7080,Basulto,tichondrius,1418,druid,balance,72,38,34
7081,Monsin,illidan,1418,druid,balance,120,61,59
7082,Maxspeed,tichondrius,1417,druid,balance,24,15,9
7083,Raximus,moon-guard,1417,druid,balance,84,42,42
7084,Bigherbo,zuljin,1417,druid,balance,42,19,23
7085,Seannybhoy,emerald-dream,1417,druid,balance,52,22,30
7086,Dorobloom,sargeras,1416,druid,balance,24,16,8
7087,Jentlegiant,tichondrius,1416,druid,balance,24,15,9
7088,Faroo,azralon,1416,druid,balance,40,24,16
7089,Crocface,tichondrius,1415,druid,balance,66,38,28
7090,Graffsworth,emerald-dream,1415,druid,balance,51,27,24
7091,Axiomisop,tichondrius,1414,druid,balance,53,32,21
7092,Leonardsby,tichondrius,1414,druid,balance,54,28,26
7093,Lightconvoke,norgannon,1413,druid,balance,38,19,19
7094,Gullmock,quelthalas,1412,druid,balance,78,35,43
7095,Sammio,emerald-dream,1411,druid,balance,44,23,21
7096,Wiiee,darkspear,1410,druid,balance,80,48,32
7097,Dalsardirn,sargeras,1410,druid,balance,30,17,13
7098,Sofereir,frostmourne,1410,druid,balance,155,77,78
7099,Snailbeam,shattered-hand,1410,druid,balance,48,20,28
7100,Feroz,frostmourne,1409,druid,balance,24,15,9
7101,Ocâ,cenarius,1408,druid,balance,26,17,9
7102,Swampduck,saurfang,1407,druid,balance,24,15,9
7103,Kawshuhn,bleeding-hollow,1407,druid,balance,90,51,39
7104,Côheed,bleeding-hollow,1407,druid,balance,30,15,15
7105,Chonkykitty,frostmourne,1405,druid,balance,30,19,11
7106,Slyfoxx,stonemaul,1403,druid,balance,92,53,39
7107,Jainzar,dreadmaul,1400,druid,balance,48,22,26
7108,Cudbacrakhed,tichondrius,1399,druid,balance,48,27,21
7109,Jaduss,thrall,1398,druid,balance,38,18,20
7110,Zuice,thrall,1398,druid,balance,69,32,37
7111,Ereshkïgal,stormrage,1397,druid,balance,27,16,11
7112,Nightstalkr,kelthuzad,1397,druid,balance,210,110,100
7113,Deathkahn,lightninghoof,1397,druid,balance,60,31,29
7114,Drunknoodles,stormrage,1396,druid,balance,29,16,13
7115,Ulcera,nemesis,1396,druid,balance,33,17,16
7116,Moonfart,zuljin,1393,druid,balance,47,24,23
7117,Repanda,proudmoore,1389,druid,balance,77,38,39
7118,Beastsworn,alexstrasza,1388,druid,balance,42,15,27
7119,Seneshy,azralon,1387,druid,balance,30,22,8
7120,Meowmixx,frostmane,1385,druid,balance,47,22,25
7121,Skrimshaw,burning-legion,1384,druid,balance,42,20,22
7122,Driftwood,bonechewer,1381,druid,balance,53,30,23
7123,Envasions,emerald-dream,1380,druid,balance,24,15,9
7124,Threk,spirestone,1379,druid,balance,42,16,26
7125,Nanashi,tichondrius,1378,druid,balance,30,15,15
7126,Huskars,tichondrius,1375,druid,balance,48,26,22
7127,Shemeus,malganis,1374,druid,balance,54,27,27
7128,Starsaber,dalaran,1372,druid,balance,42,24,18
7129,Saeval,korgath,1370,druid,balance,87,46,41
7130,Asteriel,stormrage,1367,druid,balance,54,24,30
7131,Binnchook,barthilas,1366,druid,balance,31,19,12
7132,Barrahjr,frostmourne,1366,druid,balance,51,28,23
7133,Skagakr,moon-guard,1366,druid,balance,131,65,66
7134,Throatjelly,blackrock,1363,druid,balance,42,23,19
7135,Justinheras,area-52,1363,druid,balance,64,35,29
7136,Druiddreams,frostmourne,1358,druid,balance,24,17,7
7137,Rígél,ragnaros,1358,druid,balance,72,37,35
7138,Qelthalas,sargeras,1355,druid,balance,189,98,91
7139,Gitsnshigles,frostmourne,1352,druid,balance,43,23,20
7140,Stärfäll,frostmourne,1351,druid,balance,24,17,7
7141,Tahnu,deathwing,1350,druid,balance,23,15,8
7142,Genghisz,area-52,1349,druid,balance,53,24,29
7143,Mythelian,icecrown,1348,druid,balance,60,34,26
7144,Aolus,kaelthas,1344,druid,balance,42,23,19
7145,Ironbark,azuremyst,1344,druid,balance,33,15,18
7146,Dekmdrui,quelthalas,1343,druid,balance,21,16,5
7147,Imshiftastic,area-52,1342,druid,balance,52,28,24
7148,Ottovonbird,tichondrius,1341,druid,balance,24,14,10
7149,Starboy,garona,1340,druid,balance,24,14,10
7150,Bigbeugs,frostmourne,1339,druid,balance,30,15,15
7151,Cheezaygx,arthas,1338,druid,balance,24,14,10
7152,Xevão,nemesis,1338,druid,balance,32,15,17
7153,Boomchí,tichondrius,1337,druid,balance,18,14,4
7154,Boomsquanch,emerald-dream,1337,druid,balance,24,14,10
7155,Boattastic,terenas,1337,druid,balance,24,14,10
7156,Tinkeress,stormrage,1337,druid,balance,96,47,49
7157,Swiftroots,tichondrius,1336,druid,balance,24,14,10
7158,Comidru,tichondrius,1336,druid,balance,30,14,16
7159,Saturday,frostmourne,1335,druid,balance,35,24,11
7160,Brawndiboom,stormrage,1335,druid,balance,71,33,38
7161,Chikinwing,illidan,1333,druid,balance,24,14,10
7162,Shibbith,nordrassil,1333,druid,balance,24,14,10
7163,Imnotinhuman,tichondrius,1333,druid,balance,41,22,19
7164,Knoxella,moon-guard,1333,druid,balance,134,69,65
7165,Droody,earthen-ring,1333,druid,balance,40,20,20
7166,Breynna,draenor,1333,druid,balance,41,20,21
7167,Yungterp,zuljin,1332,druid,balance,18,14,4
7168,Bâzinga,bleeding-hollow,1331,druid,balance,47,24,23
7169,Eldenis,drakkari,1330,druid,balance,76,40,36
7170,Roundtummy,area-52,1330,druid,balance,36,15,21
7171,Meekgrylls,frostmourne,1329,druid,balance,52,25,27
7172,Empriona,wildhammer,1328,druid,balance,25,14,11
7173,Salvattor,stormrage,1327,druid,balance,44,30,14
7174,Noteff,illidan,1327,druid,balance,30,19,11
7175,Yaboydave,stonemaul,1327,druid,balance,24,14,10
7176,Thorsèn,sargeras,1327,druid,balance,47,25,22
7177,Limikeen,bleeding-hollow,1325,druid,balance,30,15,15
7178,Renamebdsm,cenarius,1324,druid,balance,30,14,16
7179,Moohok,bleeding-hollow,1321,druid,balance,33,14,19
7180,Thickmoo,tichondrius,1319,druid,balance,87,41,46
7181,Winekoolers,malganis,1317,druid,balance,48,24,24
7182,Jonoa,nagrand,1315,druid,balance,73,42,31
7183,Shuxz,sargeras,1313,druid,balance,30,20,10
7184,Naurrog,tichondrius,1313,druid,balance,30,19,11
7185,Gepardéx,ragnaros,1313,druid,balance,126,59,67
7186,Indoee,mannoroth,1313,druid,balance,76,33,43
7187,Réko,sargeras,1311,druid,balance,46,26,20
7188,Evilakali,tichondrius,1311,druid,balance,49,27,22
7189,Flôkey,tichondrius,1311,druid,balance,42,21,21
7190,Theirs,tichondrius,1310,druid,balance,176,97,79
7191,Katobe,tichondrius,1310,druid,balance,30,15,15
7192,Audacities,bloodhoof,1309,druid,balance,46,23,23
7193,Ernest,goldrinn,1309,druid,balance,69,33,36
7194,Stepdru,sargeras,1308,druid,balance,24,14,10
7195,Floote,thrall,1308,druid,balance,58,27,31
7196,Annef,tichondrius,1307,druid,balance,42,21,21
7197,Ðjx,stormrage,1306,druid,balance,19,15,4
7198,Dahts,destromath,1306,druid,balance,24,16,8
7199,Fugginskoden,twisting-nether,1305,druid,balance,23,14,9
7200,Duakx,malganis,1305,druid,balance,30,14,16
7201,Deez,korgath,1304,druid,balance,56,23,33
7202,Doomkiñ,darkspear,1303,druid,balance,29,14,15
7203,Treemendous,nemesis,1303,druid,balance,30,14,16
7204,Sergat,stormreaver,1302,druid,balance,54,28,26
7205,Bouffecul,zuljin,1300,druid,balance,30,16,14
7206,Treezús,thrall,1300,druid,balance,64,32,32
7207,Dkat,malganis,1299,druid,balance,46,24,22
7208,Smitenkiten,baelgun,1295,druid,balance,52,23,29
7209,Pneumashift,tichondrius,1294,druid,balance,18,14,4
7210,Stupidranga,barthilas,1286,druid,balance,54,29,25
7211,Minusdruid,dalaran,1286,druid,balance,117,57,60
7212,Styless,azjolnerub,1284,druid,balance,34,17,17
7213,Lokdu,area-52,1284,druid,balance,30,15,15
7214,Redbbull,tichondrius,1282,druid,balance,60,36,24
7215,Xodz,sargeras,1282,druid,balance,42,21,21
7216,Barrah,barthilas,1280,druid,balance,70,34,36
7217,Nimfaa,nemesis,1279,druid,balance,36,21,15
7218,Solarcannon,shuhalo,1279,druid,balance,159,82,77
7219,Beal,azgalor,1279,druid,balance,93,41,52
7220,Illilydan,tichondrius,1276,druid,balance,84,38,46
7221,Zèrkz,tichondrius,1275,druid,balance,54,28,26
7222,Zeanasfaratu,spinebreaker,1273,druid,balance,45,19,26
7223,Almarasta,azralon,1272,druid,balance,31,15,16
7224,Alwind,alleria,1272,druid,balance,48,18,30
7225,Softshirtxo,ragnaros,1271,druid,balance,24,14,10
7226,Datdruidrod,illidan,1270,druid,balance,66,33,33
7227,Odweaven,thunderlord,1269,druid,balance,64,29,35
7228,Mercz,illidan,1267,druid,balance,42,26,16
7229,Sochin,nemesis,1267,druid,balance,90,49,41
7230,Kyabe,ragnaros,1267,druid,balance,73,30,43
7231,Durdern,barthilas,1264,druid,balance,24,19,5
7232,Lønewolf,sargeras,1263,druid,balance,65,32,33
7233,Spicydurid,tichondrius,1261,druid,balance,32,15,17
7234,Muscelmilk,tichondrius,1258,druid,balance,51,25,26
7235,Furu,bonechewer,1254,druid,balance,78,36,42
7236,Xenöchrist,ragnaros,1252,druid,balance,32,16,16
7237,Lavenderowl,arthas,1250,druid,balance,52,27,25
7238,Barekat,emerald-dream,1249,druid,balance,34,18,16
7239,Mayanardz,bleeding-hollow,1248,druid,balance,18,13,5
7240,Gatorskin,sargeras,1247,druid,balance,15,14,1
7241,Ratspot,stormrage,1247,druid,balance,18,13,5
7242,Ssantirap,quelthalas,1247,druid,balance,24,13,11
7243,Hugodruid,frostmourne,1247,druid,balance,24,13,11
7244,Galeshift,stormrage,1246,druid,balance,18,13,5
7245,Lawlz,aegwynn,1246,druid,balance,51,28,23
7246,Dirtdog,uther,1246,druid,balance,24,13,11
7247,Rslm,tichondrius,1246,druid,balance,43,21,22
7248,Antiherø,sargeras,1245,druid,balance,18,13,5
7249,Mntra,emerald-dream,1245,druid,balance,18,13,5
7250,Ghoouul,tichondrius,1245,druid,balance,35,14,21
7251,Sahksi,lothar,1243,druid,balance,24,13,11
7252,Johnnydrip,malganis,1243,druid,balance,24,13,11
7253,Goofyfoot,wyrmrest-accord,1243,druid,balance,42,22,20
7254,Spudpatikins,barthilas,1243,druid,balance,30,14,16
7255,Foxwit,jubeithos,1242,druid,balance,22,14,8
7256,Sym,zuljin,1242,druid,balance,24,13,11
7257,Bbkingschair,tichondrius,1241,druid,balance,18,13,5
7258,Ripkinztko,stormrage,1241,druid,balance,18,13,5
7259,Tummycummy,thrall,1240,druid,balance,18,13,5
7260,Bigboðm,tichondrius,1239,druid,balance,48,24,24
7261,Gwub,illidan,1238,druid,balance,18,13,5
7262,Girthygramps,sargeras,1238,druid,balance,24,13,11
7263,Tickler,durotan,1238,druid,balance,24,13,11
7264,Bäñgarang,tichondrius,1238,druid,balance,37,15,22
7265,Guojue,tichondrius,1237,druid,balance,46,25,21
7266,Hawkk,azralon,1237,druid,balance,56,26,30
7267,Astrixx,frostmourne,1233,druid,balance,18,13,5
7268,Råstafart,tichondrius,1231,druid,balance,36,17,19
7269,Cien,thrall,1231,druid,balance,53,23,30
7270,Catastrophic,whisperwind,1231,druid,balance,30,13,17
7271,Édzar,area-52,1230,druid,balance,70,35,35
7272,Vicvc,tichondrius,1229,druid,balance,54,29,25
7273,Vicorin,illidan,1226,druid,balance,24,13,11
7274,Lavanis,stormrage,1226,druid,balance,187,98,89
7275,Basilix,moon-guard,1226,druid,balance,63,30,33
7276,Vorare,tichondrius,1225,druid,balance,26,14,12
7277,Zentabra,proudmoore,1225,druid,balance,42,18,24
7278,Mommyx,stormrage,1224,druid,balance,30,13,17
7279,Kuroshizen,tichondrius,1224,druid,balance,94,39,55
7280,Sunboy,tichondrius,1221,druid,balance,73,36,37
7281,Morphkow,sargeras,1220,druid,balance,63,33,30
7282,Deths,frostmourne,1219,druid,balance,18,13,5
7283,Mooing,azralon,1219,druid,balance,28,19,9
7284,Acidmoon,tichondrius,1219,druid,balance,52,22,30
7285,Pokémon,grizzly-hills,1218,druid,balance,24,13,11
7286,Strallà,illidan,1217,druid,balance,96,49,47
7287,Flatnose,agamaggan,1216,druid,balance,30,13,17
7288,Nuppxx,frostmourne,1215,druid,balance,18,13,5
7289,Mutlèy,gundrak,1215,druid,balance,18,13,5
7290,Vuginas,bleeding-hollow,1215,druid,balance,62,33,29
7291,Judgedruid,scilla,1213,druid,balance,36,22,14
7292,Deed,korialstrasz,1212,druid,balance,22,14,8
7293,Crazystorm,ragnaros,1212,druid,balance,66,37,29
7294,Shivlary,stormrage,1211,druid,balance,51,29,22
7295,Lindzy,moon-guard,1210,druid,balance,78,43,35
7296,Coorvinus,stormrage,1208,druid,balance,30,13,17
7297,Elpako,ragnaros,1208,druid,balance,54,23,31
7298,Liñk,sargeras,1207,druid,balance,29,15,14
7299,Møønscar,tichondrius,1204,druid,balance,48,22,26
7300,Lazerchicken,boulderfist,1204,druid,balance,30,13,17
7301,Tankbareass,aerie-peak,1203,druid,balance,42,16,26
7302,Huoxiaoying,tichondrius,1202,druid,balance,36,21,15
7303,Trollsmind,tichondrius,1202,druid,balance,28,14,14
7304,Pleasepime,stormrage,1202,druid,balance,84,35,49
7305,Drßoom,stormrage,1201,druid,balance,87,37,50
7306,Thehooligan,stormrage,1200,druid,balance,75,41,34
7307,Feralchild,emerald-dream,1195,druid,balance,24,13,11
7308,Chillcat,illidan,1194,druid,balance,18,14,4
7309,Nolifer,sargeras,1192,druid,balance,30,17,13
7310,Dumdumdugan,korgath,1191,druid,balance,83,41,42
7311,Circadion,illidan,1189,druid,balance,30,14,16
7312,Dampnr,tichondrius,1186,druid,balance,30,14,16
7313,Maxable,alleria,1184,druid,balance,27,14,13
7314,Quincunx,tichondrius,1181,druid,balance,70,39,31
7315,Xvenusaur,bleeding-hollow,1179,druid,balance,24,16,8
7316,Stringbeáns,tanaris,1179,druid,balance,42,21,21
7317,Clawandørder,tichondrius,1178,druid,balance,20,13,7
7318,Jokerdks,tichondrius,1174,druid,balance,26,14,12
7319,Mufaasa,boulderfist,1174,druid,balance,72,37,35
7320,Vaalser,frostmourne,1173,druid,balance,47,19,28
7321,Lavanca,azralon,1171,druid,balance,30,13,17
7322,Aberdare,tichondrius,1169,druid,balance,29,13,16
7323,Immortalwild,tichondrius,1169,druid,balance,38,17,21
7324,Høt,thunderhorn,1168,druid,balance,22,13,9
7325,Trythis,tichondrius,1167,druid,balance,61,28,33
7326,Orkinetvx,frostmourne,1166,druid,balance,25,16,9
7327,Blackmoons,thunderlord,1166,druid,balance,42,15,27
7328,Alphakatt,area-52,1165,druid,balance,84,38,46
7329,Dirtydot,ragnaros,1164,druid,balance,24,14,10
7330,Baboongodx,frostmourne,1164,druid,balance,23,13,10
7331,Ryxu,emerald-dream,1161,druid,balance,26,15,11
7332,Draide,dragonblight,1159,druid,balance,31,13,18
7333,Mihnt,sargeras,1158,druid,balance,40,14,26
7334,Kattel,blackrock,1157,druid,balance,75,37,38
7335,Levincy,thrall,1156,druid,balance,60,33,27
7336,Dojacow,mannoroth,1154,druid,balance,34,16,18
7337,Wombatform,malganis,1151,druid,balance,18,12,6
7338,Ballnout,zuljin,1151,druid,balance,18,12,6
7339,Katbriel,zuljin,1151,druid,balance,18,12,6
7340,Crusch,shattered-halls,1151,druid,balance,18,12,6
7341,Borrdru,arthas,1150,druid,balance,24,12,12
7342,Hefe,terenas,1149,druid,balance,18,12,6
7343,Zebyn,tichondrius,1149,druid,balance,18,12,6
7344,Alagoano,azralon,1149,druid,balance,80,52,28
7345,Ralphrawr,barthilas,1149,druid,balance,24,12,12
7346,Maserati,emerald-dream,1148,druid,balance,18,12,6
7347,Yoona,kiljaeden,1148,druid,balance,24,12,12
7348,Jocek,stormrage,1146,druid,balance,18,12,6
7349,Flapperz,sargeras,1146,druid,balance,30,12,18
7350,Dbanned,nemesis,1144,druid,balance,24,12,12
7351,Roots,boulderfist,1144,druid,balance,30,13,17
7352,Gravshift,zuljin,1143,druid,balance,18,12,6
7353,Piping,thunderlord,1141,druid,balance,24,12,12
7354,Crashägásm,proudmoore,1140,druid,balance,49,19,30
7355,Timdillon,emerald-dream,1139,druid,balance,24,12,12
7356,Enlil,the-underbog,1139,druid,balance,24,12,12
7357,Leetpete,eitrigg,1138,druid,balance,24,12,12
7358,Dodid,laughing-skull,1137,druid,balance,60,30,30
7359,Aozeh,kiljaeden,1136,druid,balance,18,12,6
7360,Furrycringe,stormrage,1135,druid,balance,30,12,18
7361,Airinsurgent,stormrage,1135,druid,balance,30,12,18
7362,Livilla,sargeras,1134,druid,balance,24,12,12
7363,Thecovid,illidan,1134,druid,balance,89,40,49
7364,Hootyhoot,illidan,1133,druid,balance,18,12,6
7365,Scarymon,tichondrius,1133,druid,balance,21,13,8
7366,Ðementia,stormrage,1131,druid,balance,36,12,24
7367,Prismo,ravencrest,1129,druid,balance,24,12,12
7368,Treeteej,kelthuzad,1128,druid,balance,36,16,20
7369,Bayaba,tichondrius,1127,druid,balance,18,12,6
7370,Lunapuma,stonemaul,1127,druid,balance,18,12,6
7371,Kuthian,moon-guard,1126,druid,balance,39,17,22
7372,Kudro,garithos,1122,druid,balance,30,12,18
7373,Burninmôön,tichondrius,1118,druid,balance,35,12,23
7374,Toofast,lightninghoof,1114,druid,balance,18,12,6
7375,Smashthatbox,illidan,1113,druid,balance,44,17,27
7376,Seytu,sargeras,1112,druid,balance,26,13,13
7377,Naturlig,area-52,1109,druid,balance,24,13,11
7378,Ilgalsard,frostmourne,1109,druid,balance,36,16,20
7379,Mambuz,tichondrius,1100,druid,balance,60,30,30
7380,Ûñø,frostmourne,1099,druid,balance,36,21,15
7381,Alucardxd,ragnaros,1094,druid,balance,29,12,17
7382,Krazykritz,illidan,1090,druid,balance,27,13,14
7383,Coppersnout,moon-guard,1089,druid,balance,54,29,25
7384,Gorgoncity,illidan,1088,druid,balance,22,12,10
7385,Moistcream,tichondrius,1087,druid,balance,21,12,9
7386,Zeromeme,frostmourne,1086,druid,balance,20,12,8
7387,Rahkaaga,kiljaeden,1086,druid,balance,30,15,15
7388,Jâykeup,lightbringer,1085,druid,balance,32,13,19
7389,Bethemarble,sargeras,1084,druid,balance,57,22,35
7390,Iamatomic,illidan,1082,druid,balance,36,14,22
7391,Wyldthangz,stormrage,1077,druid,balance,26,12,14
7392,Koratan,frostmourne,1071,druid,balance,19,12,7
7393,Floridajoe,blackrock,1070,druid,balance,36,20,16
7394,Hootie,arygos,1060,druid,balance,33,12,21
7395,Drdoomerkin,area-52,1056,druid,balance,12,11,1
7396,Dirtmaggot,barthilas,1056,druid,balance,19,13,6
7397,Roccko,illidan,1056,druid,balance,18,11,7
7398,Slickitty,kelthuzad,1056,druid,balance,18,11,7
7399,Likorit,azralon,1055,druid,balance,18,11,7
7400,Sharialawl,stormreaver,1055,druid,balance,18,11,7
7401,Docleave,tichondrius,1055,druid,balance,18,11,7
7402,Mastahskills,illidan,1055,druid,balance,18,11,7
7403,Mooseknukel,zuljin,1055,druid,balance,18,11,7
7404,Muunragery,illidan,1055,druid,balance,18,11,7
7405,Feralgo,tichondrius,1055,druid,balance,19,11,8
7406,Druidlow,azralon,1055,druid,balance,26,14,12
7407,Ryannshiftz,proudmoore,1054,druid,balance,18,11,7
7408,Erealana,tichondrius,1054,druid,balance,18,11,7
7409,Buffclyde,blackrock,1054,druid,balance,18,11,7
7410,Quefemme,kelthuzad,1053,druid,balance,18,11,7
7411,Junaleska,lightbringer,1053,druid,balance,18,11,7
7412,Johnnybigg,frostmourne,1053,druid,balance,18,11,7
7413,Volddy,tichondrius,1053,druid,balance,24,12,12
7414,Espoir,azuremyst,1052,druid,balance,18,11,7
7415,Pecopeco,sargeras,1052,druid,balance,24,11,13
7416,Milkman,mannoroth,1052,druid,balance,30,11,19
7417,Awguseon,proudmoore,1051,druid,balance,18,11,7
7418,Milkshift,demon-soul,1051,druid,balance,24,11,13
7419,Fjblol,sargeras,1051,druid,balance,24,11,13
7420,Wildbloom,draenor,1050,druid,balance,18,11,7
7421,Boostgu,illidan,1050,druid,balance,18,11,7
7422,Samsshifter,tichondrius,1050,druid,balance,24,11,13
7423,Jawsbar,tichondrius,1050,druid,balance,24,11,13
7424,Msparker,illidan,1050,druid,balance,36,11,25
7425,Bearyhalls,frostmourne,1049,druid,balance,21,13,8
7426,Herbzlova,lightnings-blade,1049,druid,balance,24,11,13
7427,Balverixqt,tichondrius,1048,druid,balance,24,11,13
7428,Shavedtaco,azshara,1047,druid,balance,12,11,1
7429,Chikenflu,tichondrius,1047,druid,balance,22,11,11
7430,Catrene,mannoroth,1045,druid,balance,45,28,17
7431,Maulinyou,whisperwind,1045,druid,balance,18,11,7
7432,Wrathmighty,frostmourne,1040,druid,balance,27,12,15
7433,Jinglebells,kiljaeden,1038,druid,balance,18,11,7
7434,Jherrak,area-52,1035,druid,balance,18,11,7
7435,Schmeatbawls,illidan,1031,druid,balance,23,11,12
7436,Miggzii,draka,1030,druid,balance,40,17,23
7437,Muhana,runetotem,1028,druid,balance,24,11,13
7438,Nozgöth,quelthalas,1027,druid,balance,86,43,43
7439,Reeiyna,gallywix,1026,druid,balance,60,35,25
7440,Thèbearjèw,tichondrius,1024,druid,balance,55,23,32
7441,Hosehead,malganis,1023,druid,balance,24,14,10
7442,Vallk,area-52,1022,druid,balance,20,12,8
7443,Malamew,antonidas,1016,druid,balance,18,12,6
7444,Lumipawz,frostmourne,1014,druid,balance,19,12,7
7445,Riprip,tichondrius,1012,druid,balance,27,12,15
7446,Bloomsong,emerald-dream,1012,druid,balance,30,13,17
7447,Araminka,drakkari,1011,druid,balance,12,11,1
7448,Vapeculture,lightbringer,1004,druid,balance,54,31,23
7449,Dustin,moon-guard,1000,druid,balance,22,12,10
7450,Finntröll,area-52,993,druid,balance,29,11,18
7451,Boomybalboa,stormrage,990,druid,balance,17,11,6
7452,Caminanube,quelthalas,989,druid,balance,30,13,17
7453,Amigomel,emerald-dream,985,druid,balance,23,11,12
7454,Indy,rivendare,980,druid,balance,22,11,11
7455,Spazz,firetree,975,druid,balance,17,11,6
7456,Cowel,tichondrius,969,druid,balance,25,11,14
7457,Fäncy,sargeras,960,druid,balance,12,10,2
7458,Jubi,bleeding-hollow,960,druid,balance,12,10,2
7459,Smwise,tichondrius,960,druid,balance,12,10,2
7460,Omnigrind,frostmourne,960,druid,balance,18,10,8
7461,Beamerboy,bleeding-hollow,960,druid,balance,18,10,8
7462,Roben,tichondrius,960,druid,balance,18,10,8
7463,Sÿndru,illidan,960,druid,balance,18,10,8
7464,Mcy,nerzhul,960,druid,balance,18,10,8
7465,Tygraz,alleria,959,druid,balance,12,10,2
7466,Hautheurel,illidan,959,druid,balance,12,10,2
7467,Jshwills,sargeras,959,druid,balance,12,10,2
7468,Lazerbeamz,tichondrius,959,druid,balance,18,10,8
7469,Fastlife,drakkari,959,druid,balance,18,10,8
7470,Tankzsz,malganis,959,druid,balance,18,10,8
7471,Sàbrè,darkspear,959,druid,balance,18,10,8
7472,Kohru,moon-guard,959,druid,balance,18,10,8
7473,Schneidèr,quelthalas,959,druid,balance,18,10,8
7474,Ternkote,tichondrius,959,druid,balance,18,10,8
7475,Scoon,aegwynn,959,druid,balance,18,10,8
7476,Ephwürd,malganis,959,druid,balance,18,10,8
7477,Skaie,ragnaros,959,druid,balance,18,10,8
7478,Credd,zuljin,959,druid,balance,18,10,8
7479,Zils,bleeding-hollow,959,druid,balance,22,11,11
7480,Biggieclawz,tichondrius,958,druid,balance,12,10,2
7481,Bumbleebee,azralon,958,druid,balance,18,10,8
7482,Meatcat,sargeras,958,druid,balance,18,10,8
7483,Psilo,kelthuzad,958,druid,balance,18,10,8
7484,Swiftboom,stormrage,958,druid,balance,18,10,8
7485,Shumarina,mannoroth,958,druid,balance,18,10,8
7486,Tensuen,boulderfist,958,druid,balance,22,10,12
7487,Kushidabs,tichondrius,958,druid,balance,34,11,23
7488,Messyboom,illidan,957,druid,balance,12,10,2
7489,Nøzopium,kelthuzad,956,druid,balance,18,10,8
7490,Drewpg,zuljin,955,druid,balance,18,10,8
7491,Zetii,emerald-dream,955,druid,balance,18,10,8
7492,Tanguanota,quelthalas,955,druid,balance,24,10,14
7493,Maldobear,stormrage,954,druid,balance,24,10,14
7494,Moonowl,crushridge,953,druid,balance,18,10,8
7495,Santogrial,blood-furnace,953,druid,balance,46,25,21
7496,Jal,khazgoroth,953,druid,balance,20,10,10
7497,Crunkk,thunderlord,952,druid,balance,18,10,8
7498,Veraciouss,sargeras,952,druid,balance,18,10,8
7499,Barecowbear,bleeding-hollow,951,druid,balance,24,10,14
7500,Uuli,area-52,946,druid,balance,18,10,8
7501,Ðarkscar,laughing-skull,943,druid,balance,50,18,32
7502,Skiouros,emerald-dream,943,druid,balance,36,10,26
7503,Lacroix,wildhammer,938,druid,balance,12,10,2
7504,Rakelan,tichondrius,937,druid,balance,146,75,71
7505,Pilaufakka,zuljin,932,druid,balance,18,10,8
7506,Krustyora,khazgoroth,911,druid,balance,17,10,7
7507,Athious,moon-guard,909,druid,balance,29,13,16
7508,Jokey,quelthalas,906,druid,balance,18,11,7
7509,Stretchhxd,tichondrius,900,druid,balance,21,10,11
7510,Bellä,nazjatar,900,druid,balance,37,11,26
7511,Wantto,moknathal,894,druid,balance,54,26,28
7512,Jynxy,sargeras,889,druid,balance,23,10,13
7513,Nalarin,kaelthas,878,druid,balance,72,35,37
7514,Maen,kelthuzad,864,druid,balance,12,9,3
7515,Gerrt,bleeding-hollow,864,druid,balance,12,9,3
7516,Uhnoheals,tichondrius,864,druid,balance,18,9,9
7517,Lunartiç,kelthuzad,864,druid,balance,18,9,9
7518,Mvpps,thrall,864,druid,balance,18,9,9
7519,Jssy,tichondrius,864,druid,balance,18,9,9
7520,Kûramä,dalaran,864,druid,balance,18,9,9
7521,Catatonik,emerald-dream,864,druid,balance,24,9,15
7522,Coompie,frostmourne,863,druid,balance,12,9,3
7523,Cthulhuqt,kelthuzad,863,druid,balance,12,9,3
7524,Flamejacker,tichondrius,863,druid,balance,12,9,3
7525,Zmk,barthilas,863,druid,balance,12,9,3
7526,Verelyris,nordrassil,863,druid,balance,12,9,3
7527,Cdroo,burning-blade,863,druid,balance,12,9,3
7528,Hàchi,malganis,863,druid,balance,12,9,3
7529,Arnlu,malganis,863,druid,balance,18,9,9
7530,Starkraven,firetree,863,druid,balance,18,9,9
7531,Bullcritzz,saurfang,863,druid,balance,18,9,9
7532,Velaar,arthas,863,druid,balance,18,9,9
7533,Miviaris,alleria,863,druid,balance,18,9,9
7534,Cösmic,anetheron,863,druid,balance,18,9,9
7535,Môônkîn,chogall,863,druid,balance,18,9,9
7536,Doots,aegwynn,863,druid,balance,18,9,9
7537,Amookelia,tichondrius,863,druid,balance,18,9,9
7538,Columpio,area-52,863,druid,balance,18,9,9
7539,Galadriowl,dalaran,863,druid,balance,24,9,15
7540,Dolwizz,tichondrius,863,druid,balance,24,9,15
7541,Oreoshift,illidan,862,druid,balance,12,9,3
7542,Rootslayer,tichondrius,862,druid,balance,12,9,3
7543,Zugdruid,tichondrius,862,druid,balance,13,9,4
7544,Muagor,tichondrius,862,druid,balance,18,9,9
7545,Furrmissile,area-52,862,druid,balance,18,9,9
7546,Felløwship,nemesis,862,druid,balance,18,9,9
7547,Shack,alterac-mountains,862,druid,balance,18,9,9
7548,Tinkker,zuljin,861,druid,balance,12,9,3
7549,Actiad,stormrage,861,druid,balance,16,10,6
7550,Blizdontcuur,area-52,860,druid,balance,12,9,3
7551,Sanleba,tichondrius,860,druid,balance,18,9,9
7552,Itchyrat,moon-guard,859,druid,balance,18,9,9
7553,Bestik,quelthalas,859,druid,balance,24,9,15
7554,Moringo,azralon,858,druid,balance,12,9,3
7555,Ascension,emerald-dream,858,druid,balance,18,9,9
7556,Amandi,magtheridon,858,druid,balance,24,9,15
7557,Kamionero,drakkari,856,druid,balance,12,9,3
7558,Elatheris,stormrage,855,druid,balance,18,9,9
7559,Shiffterzz,tichondrius,855,druid,balance,18,9,9
7560,Slingin,illidan,855,druid,balance,30,9,21
7561,Sleek,illidan,850,druid,balance,24,9,15
7562,Everglim,azralon,847,druid,balance,24,9,15
7563,Dèmønblâckev,malganis,842,druid,balance,24,11,13
7564,Klyadedfogud,trollbane,839,druid,balance,18,9,9
7565,Rogsdruid,sargeras,830,druid,balance,13,10,3
7566,Gavalle,khaz-modan,830,druid,balance,18,9,9
7567,Nokther,muradin,830,druid,balance,28,9,19
7568,Dankasauras,tichondrius,830,druid,balance,42,13,29
7569,Taurenosorus,illidan,827,druid,balance,64,29,35
7570,Tanawak,tichondrius,815,druid,balance,17,9,8
7571,Ssïp,tichondrius,814,druid,balance,21,9,12
7572,Shifterx,illidan,810,druid,balance,22,13,9
7573,Tinyypuppyy,sargeras,806,druid,balance,30,9,21
7574,Stetile,azralon,800,druid,balance,16,9,7
7575,Leeteracola,malganis,798,druid,balance,20,9,11
7576,Grgcostanza,bleeding-hollow,793,druid,balance,14,9,5
7577,Astroshift,emerald-dream,784,druid,balance,20,9,11
7578,Chococrispis,quelthalas,768,druid,balance,12,8,4
7579,Drakemaster,aggramar,768,druid,balance,12,8,4
7580,Elyiaida,emerald-dream,768,druid,balance,12,8,4
7581,Laserxo,tichondrius,768,druid,balance,12,8,4
7582,Kittyboy,emerald-dream,768,druid,balance,12,8,4
7583,Mikelovin,nemesis,768,druid,balance,12,8,4
7584,Shaney,zuljin,768,druid,balance,12,8,4
7585,Argento,frostmourne,768,druid,balance,12,8,4
7586,Sñìp,zuljin,768,druid,balance,12,8,4
7587,Yøpìèrre,zuljin,768,druid,balance,12,8,4
7588,Aenari,anvilmar,768,druid,balance,12,8,4
7589,Guuh,tichondrius,768,druid,balance,12,8,4
7590,Starfallgg,sargeras,768,druid,balance,12,8,4
7591,Duckdie,moon-guard,768,druid,balance,12,8,4
7592,Hootforce,spirestone,768,druid,balance,12,8,4
7593,Thallid,hydraxis,768,druid,balance,12,8,4
7594,Oopygoopy,bleeding-hollow,768,druid,balance,12,8,4
7595,Ryanspeed,mugthol,768,druid,balance,12,8,4
7596,Mådge,frostmourne,768,druid,balance,12,8,4
7597,Slowbleeds,blood-furnace,768,druid,balance,12,8,4
7598,Ligerbomb,bleeding-hollow,768,druid,balance,12,8,4
7599,Sill,illidan,768,druid,balance,12,8,4
7600,Nyzear,bleeding-hollow,768,druid,balance,12,8,4
7601,Chayten,bleeding-hollow,768,druid,balance,12,8,4
7602,Catmoomoo,tichondrius,768,druid,balance,12,8,4
7603,Azakai,sargeras,768,druid,balance,12,8,4
7604,Shiftytom,spirestone,768,druid,balance,12,8,4
7605,Furor,eonar,768,druid,balance,12,8,4
7606,Onsen,tichondrius,768,druid,balance,18,8,10
7607,Arntu,malganis,767,druid,balance,12,8,4
7608,Smokeheaters,dalaran,767,druid,balance,12,8,4
7609,Starbender,arygos,767,druid,balance,12,8,4
7610,Radagaste,stormrage,767,druid,balance,12,8,4
7611,Wizgarkin,area-52,767,druid,balance,12,8,4
7612,Neurotoxins,tichondrius,767,druid,balance,12,8,4
7613,Entakkt,cenarius,767,druid,balance,12,8,4
7614,Cimanin,malganis,767,druid,balance,12,8,4
7615,Eøle,stormrage,767,druid,balance,12,8,4
7616,Xornhxb,tichondrius,767,druid,balance,12,8,4
7617,Harddeenball,area-52,767,druid,balance,15,9,6
7618,Jiya,zuljin,767,druid,balance,18,8,10
7619,Ruckiz,stormrage,767,druid,balance,18,8,10
7620,Sunmoonkong,area-52,767,druid,balance,18,8,10
7621,Ebonclaw,malganis,767,druid,balance,18,8,10
7622,Ïny,emerald-dream,767,druid,balance,18,8,10
7623,Fluff,gurubashi,767,druid,balance,18,8,10
7624,Gloomcat,illidan,767,druid,balance,18,8,10
7625,Meliódás,area-52,767,druid,balance,186,75,111
7626,Khristine,spinebreaker,767,druid,balance,24,8,16
7627,Narthurs,ragnaros,767,druid,balance,24,8,16
7628,Volgoro,thrall,766,druid,balance,12,8,4
7629,Melizaa,stormrage,766,druid,balance,12,8,4
7630,Onidudu,frostmourne,766,druid,balance,12,8,4
7631,Mornis,zuljin,766,druid,balance,12,8,4
7632,Nxghtfall,tichondrius,766,druid,balance,18,8,10
7633,Serega,skywall,766,druid,balance,18,8,10
7634,Kastro,frostwolf,766,druid,balance,18,8,10
7635,Jashrus,korgath,765,druid,balance,12,8,4
7636,Whitekongg,blackhand,765,druid,balance,15,9,6
7637,Sefestria,senjin,765,druid,balance,18,8,10
7638,Worldbullguy,area-52,765,druid,balance,18,8,10
7639,Tegrizelle,cenarion-circle,765,druid,balance,18,8,10
7640,Aton,frostwolf,764,druid,balance,12,8,4
7641,Crépes,bleeding-hollow,764,druid,balance,18,8,10
7642,Xoth,executus,764,druid,balance,18,8,10
7643,Wabbehkus,barthilas,764,druid,balance,26,8,18
7644,Psnárf,area-52,763,druid,balance,12,8,4
7645,Druidoy,tichondrius,763,druid,balance,12,8,4
7646,Anttfj,mannoroth,763,druid,balance,18,8,10
7647,Herbirove,frostmourne,762,druid,balance,12,8,4
7648,Atherra,sargeras,762,druid,balance,12,8,4
7649,Astromyles,tichondrius,762,druid,balance,25,8,17
7650,Baaksau,illidan,761,druid,balance,18,8,10
7651,Exillïs,frostmourne,761,druid,balance,23,9,14
7652,Freyaborn,sargeras,760,druid,balance,17,9,8
7653,Elsombrak,onyxia,759,druid,balance,12,8,4
7654,Dennyyd,illidan,759,druid,balance,12,8,4
7655,Jtogethendr,area-52,759,druid,balance,12,8,4
7656,Boneheir,proudmoore,757,druid,balance,21,9,12
7657,Nîghtcráwlér,tichondrius,752,druid,balance,12,8,4
7658,Seethert,quelthalas,751,druid,balance,12,8,4
7659,Outclone,tichondrius,734,druid,balance,10,9,1
7660,Elydaria,destromath,733,druid,balance,18,8,10
7661,Beleraine,moon-guard,732,druid,balance,17,8,9
7662,Outandy,quelthalas,727,druid,balance,17,8,9
7663,Buyadoge,area-52,703,druid,balance,16,8,8
7664,Mooncry,wyrmrest-accord,700,druid,balance,26,9,17
7665,Alaskanimal,illidan,696,druid,balance,16,8,8
7666,Shiftness,nordrassil,679,druid,balance,11,8,3
7667,Cfp,tichondrius,672,druid,balance,12,7,5
7668,Mofan,tichondrius,672,druid,balance,12,7,5
7669,Boomypower,dalaran,672,druid,balance,12,7,5
7670,Omegablasted,tichondrius,672,druid,balance,12,7,5
7671,Straitbeast,tichondrius,672,druid,balance,12,7,5
7672,Tratean,tichondrius,672,druid,balance,12,7,5
7673,Redscyclone,dalaran,672,druid,balance,12,7,5
7674,Hyzah,tichondrius,672,druid,balance,12,7,5
7675,Pantec,eredar,672,druid,balance,12,7,5
7676,Bippygucci,tichondrius,672,druid,balance,12,7,5
7677,Whodoüvoodoo,tichondrius,672,druid,balance,12,7,5
7678,Pigdd,tichondrius,672,druid,balance,12,7,5
7679,Alteraim,thrall,672,druid,balance,12,7,5
7680,Bronnasaurus,tichondrius,672,druid,balance,12,7,5
7681,Hllw,tichondrius,672,druid,balance,12,7,5
7682,Kittycatman,tichondrius,672,druid,balance,12,7,5
7683,Ehloheim,stormrage,672,druid,balance,12,7,5
7684,Martians,laughing-skull,672,druid,balance,12,7,5
7685,Xioqt,chogall,672,druid,balance,12,7,5
7686,Slickthick,sargeras,672,druid,balance,12,7,5
7687,Wildllama,moon-guard,672,druid,balance,12,7,5
7688,Covidcarrier,thrall,672,druid,balance,12,7,5
7689,Pepperpawz,emerald-dream,672,druid,balance,12,7,5
7690,Notsofat,deathwing,672,druid,balance,12,7,5
7691,Rennar,stormrage,672,druid,balance,12,7,5
7692,Elithyra,area-52,672,druid,balance,12,7,5
7693,Floofi,kelthuzad,672,druid,balance,12,7,5
7694,Suedou,moon-guard,672,druid,balance,12,7,5
7695,Riptin,kelthuzad,672,druid,balance,12,7,5
7696,Flapping,illidan,672,druid,balance,12,7,5
7697,Nbnbnb,proudmoore,672,druid,balance,12,7,5
7698,Donaldsr,area-52,672,druid,balance,12,7,5
7699,Immortalowl,illidan,672,druid,balance,12,7,5
7700,Lalalu,frostmourne,672,druid,balance,15,8,7
7701,Dooruid,tichondrius,672,druid,balance,18,7,11
7702,Bfaboomy,stormrage,672,druid,balance,18,7,11
7703,Dupaface,stormrage,672,druid,balance,18,7,11
7704,Trashytrash,bleeding-hollow,672,druid,balance,18,7,11
7705,Lükê,tichondrius,672,druid,balance,24,7,17
7706,Dobidas,tichondrius,671,druid,balance,12,7,5
7707,Tubemagnet,tichondrius,671,druid,balance,12,7,5
7708,Exxosd,tichondrius,671,druid,balance,12,7,5
7709,Bvó,stormrage,671,druid,balance,12,7,5
7710,Antagonist,burning-blade,671,druid,balance,12,7,5
7711,Stickyleavz,sargeras,671,druid,balance,12,7,5
7712,Trìckyz,tichondrius,671,druid,balance,12,7,5
7713,Jubeam,area-52,671,druid,balance,12,7,5
7714,Coochi,sargeras,671,druid,balance,12,7,5
7715,Jeezelouise,kelthuzad,671,druid,balance,12,7,5
7716,Dgas,tichondrius,671,druid,balance,12,7,5
7717,Catahoula,lothar,671,druid,balance,12,7,5
7718,Àbyss,moon-guard,671,druid,balance,12,7,5
7719,Sekzor,darkspear,671,druid,balance,12,7,5
7720,Ripx,khadgar,671,druid,balance,12,7,5
7721,Jazzmaster,barthilas,671,druid,balance,12,7,5
7722,Chakrabeam,kelthuzad,671,druid,balance,18,7,11
7723,Dashio,lightnings-blade,671,druid,balance,18,7,11
7724,Kelrelyrare,kiljaeden,671,druid,balance,18,7,11
7725,Barkcheeks,area-52,671,druid,balance,18,7,11
7726,Starsurged,moon-guard,671,druid,balance,18,7,11
7727,Rabbismang,area-52,671,druid,balance,24,7,17
7728,Budtender,moon-guard,670,druid,balance,12,7,5
7729,Andrés,azralon,670,druid,balance,12,7,5
7730,Oâk,farstriders,670,druid,balance,12,7,5
7731,Traxxo,tichondrius,670,druid,balance,12,7,5
7732,Chukksz,nerzhul,670,druid,balance,12,7,5
7733,Runhe,zuljin,670,druid,balance,12,7,5
7734,Teziq,sargeras,670,druid,balance,18,7,11
7735,Dizzyshiftz,dalaran,670,druid,balance,24,7,17
7736,Eurotrance,frostmourne,669,druid,balance,12,7,5
7737,Aviendiana,thrall,669,druid,balance,12,7,5
7738,Craftdruid,tichondrius,669,druid,balance,12,7,5
7739,Onecalf,tichondrius,668,druid,balance,12,7,5
7740,Wresty,frostmourne,667,druid,balance,12,7,5
7741,Boatox,jubeithos,666,druid,balance,24,7,17
7742,Bulldohz,tichondrius,665,druid,balance,12,7,5
7743,Coqeh,frostwolf,664,druid,balance,12,7,5
7744,Beammz,stormrage,664,druid,balance,15,8,7
7745,Pao,nordrassil,664,druid,balance,18,7,11
7746,Kångåwalafox,sargeras,663,druid,balance,12,7,5
7747,Azevedoo,nemesis,660,druid,balance,31,7,24
7748,Meiling,spirestone,659,druid,balance,12,7,5
7749,Abzuri,kiljaeden,655,druid,balance,15,8,7
7750,Kogas,hyjal,639,druid,balance,14,8,6
7751,Spacéchicken,stormrage,638,druid,balance,10,8,2
7752,Tumblr,terenas,624,druid,balance,9,7,2
7753,Desiration,area-52,624,druid,balance,15,7,8
7754,Neurologist,tichondrius,623,druid,balance,11,7,4
7755,Arescarriess,shuhalo,622,druid,balance,17,7,10
7756,Chankletta,quelthalas,618,druid,balance,18,8,10
7757,Warberton,moon-guard,616,druid,balance,15,7,8
7758,Lawnkin,dalaran,608,druid,balance,16,7,9
7759,Zalothianx,thrall,608,druid,balance,16,7,9
7760,Feldstarx,stormrage,607,druid,balance,14,7,7
7761,Razzldazzle,thrall,590,druid,balance,13,7,6
7762,Prev,arathor,576,druid,balance,6,6,0
7763,Starship,frostmourne,576,druid,balance,6,6,0
7764,Nardwaur,tichondrius,576,druid,balance,6,6,0
7765,Animatronz,area-52,576,druid,balance,6,6,0
7766,Juìcedbro,illidan,576,druid,balance,6,6,0
7767,Drop,shadow-council,576,druid,balance,6,6,0
7768,Claws,elune,576,druid,balance,6,6,0
7769,Starsùrge,moon-guard,576,druid,balance,6,6,0
7770,Treesrlegal,area-52,576,druid,balance,6,6,0
7771,Trynayeet,area-52,576,druid,balance,6,6,0
7772,Ory,illidan,576,druid,balance,6,6,0
7773,Nerfdemo,kiljaeden,576,druid,balance,12,6,6
7774,Celetra,kiljaeden,576,druid,balance,12,6,6
7775,Peteybears,stormrage,576,druid,balance,12,6,6
7776,Dalaverrunis,tichondrius,576,druid,balance,12,6,6
7777,Scykin,stormrage,576,druid,balance,12,6,6
7778,Slaÿr,malganis,576,druid,balance,12,6,6
7779,Polyproof,emerald-dream,576,druid,balance,12,6,6
7780,Exiledruid,area-52,576,druid,balance,12,6,6
7781,Beomjun,tichondrius,576,druid,balance,12,6,6
7782,Joux,barthilas,576,druid,balance,12,6,6
7783,Moonsliced,kiljaeden,576,druid,balance,12,6,6
7784,Zgg,ragnaros,576,druid,balance,12,6,6
7785,Treehard,malganis,576,druid,balance,12,6,6
7786,Nýla,stormrage,576,druid,balance,12,6,6
7787,Skydín,stormrage,576,druid,balance,12,6,6
7788,Jmackd,frostmourne,576,druid,balance,12,6,6
7789,Yorkville,sargeras,576,druid,balance,12,6,6
7790,Jamuestus,illidan,576,druid,balance,12,6,6
7791,Medibull,tichondrius,576,druid,balance,12,6,6
7792,Grayfan,malganis,576,druid,balance,12,6,6
7793,Brocooli,tichondrius,576,druid,balance,12,6,6
7794,Gigathicc,malganis,576,druid,balance,12,6,6
7795,Kitem,tichondrius,576,druid,balance,12,6,6
7796,Fixn,tichondrius,576,druid,balance,12,6,6
7797,Fugg,frostmourne,576,druid,balance,12,6,6
7798,Tylërðûrðên,sargeras,576,druid,balance,12,6,6
7799,Ggae,tichondrius,576,druid,balance,12,6,6
7800,Wondercat,illidan,576,druid,balance,12,6,6
7801,Bar,stormrage,576,druid,balance,12,6,6
7802,Tone,illidan,576,druid,balance,12,6,6
7803,Bamfferal,tichondrius,576,druid,balance,12,6,6
7804,Whiteglade,moon-guard,576,druid,balance,12,6,6
7805,Runforest,tichondrius,576,druid,balance,12,6,6
7806,Jacknit,illidan,576,druid,balance,12,6,6
7807,Dazedru,stormrage,576,druid,balance,12,6,6
7808,Fungamezx,bleeding-hollow,576,druid,balance,12,6,6
7809,Avishominem,magtheridon,576,druid,balance,12,6,6
7810,Versena,moon-guard,576,druid,balance,12,6,6
7811,Pincho,hyjal,576,druid,balance,12,6,6
7812,Hornny,shattered-hand,576,druid,balance,12,6,6
7813,Juqzy,area-52,576,druid,balance,12,6,6
7814,Gâlaxy,sargeras,576,druid,balance,12,6,6
7815,Notpodruida,tichondrius,576,druid,balance,13,6,7
7816,Longnus,stormrage,576,druid,balance,18,6,12
7817,Proudmom,barthilas,576,druid,balance,18,6,12
7818,Faletra,eitrigg,576,druid,balance,18,6,12
7819,Doomky,area-52,576,druid,balance,18,6,12
7820,Chrisclones,stormrage,576,druid,balance,18,6,12
7821,Droodad,mannoroth,576,druid,balance,18,6,12
7822,Drphilsmith,moon-guard,576,druid,balance,18,6,12
7823,Yorch,stormrage,576,druid,balance,18,6,12
7824,Apoc,bleeding-hollow,575,druid,balance,6,6,0
7825,Hpcorrection,bleeding-hollow,575,druid,balance,12,6,6
7826,Tariksha,sargeras,575,druid,balance,12,6,6
7827,Ridicules,cenarius,575,druid,balance,12,6,6
7828,Guybranch,illidan,575,druid,balance,12,6,6
7829,Ebichu,fenris,575,druid,balance,12,6,6
7830,Pigmanbear,kelthuzad,575,druid,balance,12,6,6
7831,Chodkiewicz,echo-isles,575,druid,balance,12,6,6
7832,Yseraspawn,kelthuzad,575,druid,balance,12,6,6
7833,Runarok,ragnaros,575,druid,balance,12,6,6
7834,Dibinha,azralon,575,druid,balance,12,6,6
7835,Sokodruid,tichondrius,575,druid,balance,18,6,12
7836,Samelthios,proudmoore,575,druid,balance,20,6,14
7837,Eintier,tichondrius,574,druid,balance,12,6,6
7838,Dradugun,hyjal,574,druid,balance,12,6,6
7839,Painsbrook,thrall,574,druid,balance,12,6,6
7840,Quagsire,moon-guard,574,druid,balance,18,6,12
7841,Xinnii,illidan,573,druid,balance,18,7,11
7842,Mctree,cenarius,572,druid,balance,12,6,6
7843,Lunnæ,ragnaros,567,druid,balance,12,6,6
7844,Proñgs,tichondrius,566,druid,balance,12,6,6
7845,Suist,moonrunner,544,druid,balance,10,6,4
7846,Casaran,anetheron,543,druid,balance,11,6,5
7847,Matock,malganis,543,druid,balance,11,6,5
7848,Boufa,dentarg,527,druid,balance,9,7,2
7849,Imhealer,drakkari,522,druid,balance,17,8,9
7850,Galind,rexxar,521,druid,balance,23,7,16
7851,Velais,exodar,512,druid,balance,22,6,16
7852,Gemineye,stormrage,511,druid,balance,11,6,5
7853,Istayfrawsty,darkspear,511,druid,balance,14,6,8
7854,Twcrazyk,tichondrius,511,druid,balance,14,6,8
7855,Rank,nerzhul,496,druid,balance,13,6,7
7856,Numbkin,stormrage,480,druid,balance,6,5,1
7857,Daroot,spinebreaker,480,druid,balance,6,5,1
7858,Fattdiabetic,tichondrius,480,druid,balance,6,5,1
7859,Prøspect,moon-guard,480,druid,balance,6,5,1
7860,Yurself,feathermoon,480,druid,balance,6,5,1
7861,Bearyhalls,sargeras,480,druid,balance,6,5,1
7862,Guår,tichondrius,480,druid,balance,6,5,1
7863,Ichangeabull,bleeding-hollow,480,druid,balance,6,5,1
7864,Crazystarz,frostmourne,480,druid,balance,6,5,1
7865,Cócorosie,tichondrius,480,druid,balance,6,5,1
7866,Rowdie,area-52,480,druid,balance,6,5,1
7867,Tinwhiskerz,bleeding-hollow,480,druid,balance,6,5,1
7868,Aoewynn,nerzhul,480,druid,balance,6,5,1
7869,Ragiix,tichondrius,480,druid,balance,6,5,1
7870,Toastsdruid,tichondrius,480,druid,balance,6,5,1
7871,Eskimocowboy,sargeras,480,druid,balance,6,5,1
7872,Dtefy,ragnaros,480,druid,balance,6,5,1
7873,Smitebacklol,tichondrius,480,druid,balance,6,5,1
7874,Stacker,malganis,480,druid,balance,6,5,1
7875,Hooffy,emerald-dream,480,druid,balance,6,5,1
7876,Canuatemyrat,tichondrius,480,druid,balance,6,5,1
7877,Miçangak,azralon,480,druid,balance,6,5,1
7878,Dojacat,tichondrius,480,druid,balance,6,5,1
7879,Hännibal,hydraxis,480,druid,balance,6,5,1
7880,Løk,sargeras,480,druid,balance,6,5,1
7881,Alindrä,moon-guard,480,druid,balance,6,5,1
7882,Rastakant,malganis,480,druid,balance,6,5,1
7883,Arwëna,tichondrius,480,druid,balance,6,5,1
7884,Mithroi,tichondrius,480,druid,balance,6,5,1
7885,Iconicxz,malganis,480,druid,balance,6,5,1
7886,Yokux,thunderlord,480,druid,balance,6,5,1
7887,Nephsis,kelthuzad,480,druid,balance,6,5,1
7888,Xiaodlol,tichondrius,480,druid,balance,6,5,1
7889,Megåtron,kelthuzad,480,druid,balance,6,5,1
7890,Hennydru,dalaran,480,druid,balance,6,5,1
7891,Galadon,tichondrius,480,druid,balance,6,5,1
7892,Zieda,sisters-of-elune,480,druid,balance,6,5,1
7893,Oo,grizzly-hills,480,druid,balance,6,5,1
7894,ßælot,quelthalas,480,druid,balance,6,5,1
7895,Finkledurp,dalaran,480,druid,balance,6,5,1
7896,Simperella,dalaran,480,druid,balance,6,5,1
7897,Sigure,zuljin,480,druid,balance,7,5,2
7898,Nodeathz,sargeras,480,druid,balance,10,6,4
7899,Phatpat,illidan,480,druid,balance,12,5,7
7900,Bigdaddyferg,illidan,480,druid,balance,12,5,7
7901,Voelcan,tichondrius,480,druid,balance,12,5,7
7902,Bigtammy,moon-guard,480,druid,balance,12,5,7
7903,Gåiâ,malganis,480,druid,balance,12,5,7
7904,Fakechower,stormreaver,480,druid,balance,12,5,7
7905,Cloninglol,darkspear,480,druid,balance,12,5,7
7906,Sodacream,illidan,480,druid,balance,12,5,7
7907,Chillygraves,stormrage,480,druid,balance,12,5,7
7908,Milkmoneymeo,illidan,480,druid,balance,12,5,7
7909,Bearwithit,sargeras,480,druid,balance,12,5,7
7910,Zuga,the-venture-co,480,druid,balance,12,5,7
7911,Paintlicker,emerald-dream,480,druid,balance,12,5,7
7912,Bubblybear,winterhoof,480,druid,balance,12,5,7
7913,Ragerag,trollbane,480,druid,balance,12,5,7
7914,Zimah,illidan,480,druid,balance,12,5,7
7915,Cynderellaa,proudmoore,480,druid,balance,12,5,7
7916,Salanzô,bleeding-hollow,480,druid,balance,12,5,7
7917,Stinky,bleeding-hollow,480,druid,balance,12,5,7
7918,Sunspot,tichondrius,480,druid,balance,12,5,7
7919,Veganmom,zuluhed,480,druid,balance,12,5,7
7920,Dotdmage,tichondrius,480,druid,balance,12,5,7
7921,Ripter,moon-guard,480,druid,balance,12,5,7
7922,Havócdh,tichondrius,480,druid,balance,12,5,7
7923,Trippykitty,tichondrius,480,druid,balance,12,5,7
7924,Bullquenepas,dalaran,480,druid,balance,12,5,7
7925,Nöches,quelthalas,480,druid,balance,12,5,7
7926,Sharkfighter,sargeras,480,druid,balance,12,5,7
7927,Lickmypaws,sargeras,480,druid,balance,12,5,7
7928,Jacinty,saurfang,480,druid,balance,12,5,7
7929,Dèrpin,thrall,480,druid,balance,15,6,9
7930,Boomiè,tichondrius,480,druid,balance,18,5,13
7931,Dobrman,sargeras,480,druid,balance,18,5,13
7932,Tuppyboom,barthilas,480,druid,balance,24,5,19
7933,Wtfiisthis,tichondrius,479,druid,balance,6,5,1
7934,Raknary,kelthuzad,479,druid,balance,12,5,7
7935,Smhyle,frostmourne,479,druid,balance,12,5,7
7936,Justwade,tichondrius,479,druid,balance,12,5,7
7937,Fourthkind,illidan,479,druid,balance,12,5,7
7938,Palermo,aerie-peak,479,druid,balance,12,5,7
7939,Damallis,anubarak,479,druid,balance,12,5,7
7940,Morphntime,blackrock,479,druid,balance,18,5,13
7941,Loggoruk,illidan,479,druid,balance,18,5,13
7942,Mantis,the-underbog,478,druid,balance,12,5,7
7943,Abzyplasm,sargeras,478,druid,balance,12,5,7
7944,Sunneater,azuremyst,478,druid,balance,12,5,7
7945,Wardruidkvn,stormreaver,474,druid,balance,29,5,24
7946,Formgodx,malganis,448,druid,balance,16,5,11
7947,Bearcathawk,sargeras,447,druid,balance,11,5,6
7948,Convoken,tichondrius,447,druid,balance,11,5,6
7949,Guron,aegwynn,432,druid,balance,21,5,16
7950,Féralis,sargeras,431,druid,balance,11,5,6
7951,Biig,stormreaver,425,druid,balance,9,8,1
7952,Jieter,malganis,415,druid,balance,8,5,3
7953,Haallanna,thunderlord,412,druid,balance,10,5,5
7954,Gigajuiced,proudmoore,400,druid,balance,7,5,2
7955,Altha,proudmoore,400,druid,balance,13,5,8
7956,Feathergun,ragnaros,384,druid,balance,6,4,2
7957,Boomkinbob,malganis,384,druid,balance,6,4,2
7958,Cashgame,malganis,384,druid,balance,6,4,2
7959,Tankyguy,ragnaros,384,druid,balance,6,4,2
7960,Bäldir,dalaran,384,druid,balance,6,4,2
7961,Splintered,kelthuzad,384,druid,balance,6,4,2
7962,Anamoorphicc,kelthuzad,384,druid,balance,6,4,2
7963,Upps,kelthuzad,384,druid,balance,6,4,2
7964,Hbf,tichondrius,384,druid,balance,6,4,2
7965,Hadoriss,kelthuzad,384,druid,balance,6,4,2
7966,Yevenbother,tichondrius,384,druid,balance,6,4,2
7967,Abelladañger,area-52,384,druid,balance,6,4,2
7968,Matinee,tichondrius,384,druid,balance,6,4,2
7969,Foxxyroxxy,malganis,384,druid,balance,6,4,2
7970,Tinishaker,ragnaros,384,druid,balance,6,4,2
7971,Watchugonndo,tichondrius,384,druid,balance,6,4,2
7972,Qyuka,area-52,384,druid,balance,6,4,2
7973,Sappyroots,area-52,384,druid,balance,6,4,2
7974,Elonmuskirl,illidan,384,druid,balance,6,4,2
7975,Twostars,thrall,384,druid,balance,6,4,2
7976,Luvgames,area-52,384,druid,balance,6,4,2
7977,Shînx,malganis,384,druid,balance,6,4,2
7978,Lukass,tichondrius,384,druid,balance,6,4,2
7979,Mcdizzil,bloodscalp,384,druid,balance,6,4,2
7980,Shinazugawa,maiev,384,druid,balance,6,4,2
7981,Spèèdy,illidan,384,druid,balance,6,4,2
7982,Daddyfresh,ursin,384,druid,balance,6,4,2
7983,Söökie,tichondrius,384,druid,balance,6,4,2
7984,Korlstone,zuljin,384,druid,balance,6,4,2
7985,Harlisu,stormrage,384,druid,balance,6,4,2
7986,Zxve,stormrage,384,druid,balance,6,4,2
7987,Ahruan,stormrage,384,druid,balance,6,4,2
7988,Nevershiftx,kirin-tor,384,druid,balance,6,4,2
7989,Dokasaurus,lightbringer,384,druid,balance,6,4,2
7990,Withwind,dalaran,384,druid,balance,6,4,2
7991,Dsoul,tichondrius,384,druid,balance,6,4,2
7992,Somarythe,moon-guard,384,druid,balance,6,4,2
7993,Calfurion,stormscale,384,druid,balance,6,4,2
7994,Druz,spirestone,384,druid,balance,6,4,2
7995,Nicklul,llane,384,druid,balance,6,4,2
7996,Armorkits,area-52,384,druid,balance,6,4,2
7997,Oldcreg,emerald-dream,384,druid,balance,6,4,2
7998,Joiczar,maelstrom,384,druid,balance,6,4,2
7999,Selfplay,barthilas,384,druid,balance,6,4,2
8000,Critkatbear,detheroc,384,druid,balance,6,4,2
8001,Yoshí,emerald-dream,384,druid,balance,6,4,2
8002,Duo,demon-soul,384,druid,balance,6,4,2
8003,Notadopted,sargeras,384,druid,balance,6,4,2
8004,Drmnheal,frostmourne,384,druid,balance,6,4,2
8005,Medsurgdruid,emerald-dream,384,druid,balance,6,4,2
8006,Hëllchaos,sargeras,384,druid,balance,6,4,2
8007,Nidalie,frostmourne,384,druid,balance,6,4,2
8008,Seekamp,khazgoroth,384,druid,balance,6,4,2
8009,Kiwidru,frostmourne,384,druid,balance,6,4,2
8010,Bearlylegál,sargeras,384,druid,balance,6,4,2
8011,Thetruetrue,sargeras,384,druid,balance,6,4,2
8012,Formz,nagrand,384,druid,balance,6,4,2
8013,Balancz,thrall,384,druid,balance,10,5,5
8014,Scraww,tichondrius,384,druid,balance,17,6,11
8015,Guitarsolos,nagrand,384,druid,balance,12,4,8
8016,Slottpocket,malganis,384,druid,balance,12,4,8
8017,Omnipaw,kelthuzad,384,druid,balance,12,4,8
8018,Einraedon,dalaran,384,druid,balance,12,4,8
8019,Aexs,kelthuzad,384,druid,balance,12,4,8
8020,Vashida,stormrage,384,druid,balance,12,4,8
8021,Wintarz,sargeras,384,druid,balance,12,4,8
8022,Altius,drakkari,384,druid,balance,12,4,8
8023,Menlove,area-52,384,druid,balance,12,4,8
8024,Tasselhoof,hyjal,384,druid,balance,12,4,8
8025,Veyrønn,stormrage,384,druid,balance,12,4,8
8026,Aesthetical,frostmourne,384,druid,balance,12,4,8
8027,Alastras,tichondrius,384,druid,balance,12,4,8
8028,Stormclaw,elune,384,druid,balance,12,4,8
8029,Amaryllis,the-underbog,384,druid,balance,12,4,8
8030,Blipshift,tichondrius,384,druid,balance,12,4,8
8031,Ayelune,stormrage,384,druid,balance,12,4,8
8032,Jakermans,area-52,384,druid,balance,12,4,8
8033,Lutein,tichondrius,384,druid,balance,12,4,8
8034,Sorh,stormrage,384,druid,balance,12,4,8
8035,Simo,kaelthas,384,druid,balance,12,4,8
8036,Bignosecow,illidan,384,druid,balance,12,4,8
8037,Zenowl,turalyon,384,druid,balance,12,4,8
8038,Madisonivyx,area-52,384,druid,balance,12,4,8
8039,Sinistuhd,tichondrius,384,druid,balance,12,4,8
8040,Katdog,warsong,384,druid,balance,18,4,14
8041,Spatulas,malganis,384,druid,balance,18,4,14
8042,Thiccybear,darkspear,383,druid,balance,6,4,2
8043,Chatdôux,zuljin,383,druid,balance,6,4,2
8044,Bulldog,runetotem,383,druid,balance,6,4,2
8045,Kukulkann,tichondrius,383,druid,balance,6,4,2
8046,Papitank,drakkari,383,druid,balance,6,4,2
8047,Balthøs,moon-guard,383,druid,balance,6,4,2
8048,Xisloko,azralon,383,druid,balance,6,4,2
8049,Aessinawisp,frostmourne,383,druid,balance,6,4,2
8050,Krunge,frostwolf,383,druid,balance,6,4,2
8051,Tyrana,bloodscalp,383,druid,balance,6,4,2
8052,Tïcks,illidan,383,druid,balance,12,4,8
8053,Scienttific,malganis,383,druid,balance,12,4,8
8054,Balantina,tichondrius,383,druid,balance,12,4,8
8055,Nobullshift,icecrown,383,druid,balance,12,4,8
8056,Skke,barthilas,383,druid,balance,12,4,8
8057,Nukaboom,elune,382,druid,balance,6,4,2
8058,Boomanon,illidan,382,druid,balance,6,4,2
8059,Thullian,stormrage,382,druid,balance,13,5,8
8060,Sever,ysera,382,druid,balance,12,4,8
8061,Meowfacebby,stormrage,367,druid,balance,11,4,7
8062,Gutanamo,stormrage,334,druid,balance,8,5,3
8063,Rahdek,azgalor,330,druid,balance,7,5,2
8064,Kimnim,tichondrius,330,druid,balance,9,6,3
8065,Ihjx,sargeras,330,druid,balance,11,6,5
8066,Yangrou,tichondrius,330,druid,balance,11,5,6
8067,Mythianan,aggramar,328,druid,balance,10,7,3
8068,Tehnklox,malorne,319,druid,balance,5,4,1
8069,Murkdruid,frostmourne,319,druid,balance,8,4,4
8070,Monicaduan,frostmourne,319,druid,balance,14,4,10
8071,Icastsmells,tichondrius,288,druid,balance,6,3,3
8072,Cronosphere,stormrage,288,druid,balance,6,3,3
8073,Sodah,tichondrius,288,druid,balance,6,3,3
8074,Papacard,stormrage,288,druid,balance,6,3,3
8075,Kyndel,kiljaeden,288,druid,balance,6,3,3
8076,Kalalana,illidan,288,druid,balance,6,3,3
8077,Loren,gorefiend,288,druid,balance,6,3,3
8078,Helpmeimbad,stormrage,288,druid,balance,6,3,3
8079,Sypìí,stormrage,288,druid,balance,6,3,3
8080,Beörne,sargeras,288,druid,balance,6,3,3
8081,Çãñçèr,frostmourne,288,druid,balance,6,3,3
8082,Jayroneowo,frostmourne,288,druid,balance,6,3,3
8083,Celestialife,frostmourne,288,druid,balance,6,3,3
8084,Kî,thunderlord,288,druid,balance,6,3,3
8085,Guidoanchovz,thrall,288,druid,balance,6,3,3
8086,Sylvanna,tichondrius,288,druid,balance,6,3,3
8087,Akiza,sargeras,288,druid,balance,6,3,3
8088,Jxred,illidan,288,druid,balance,6,3,3
8089,Cbark,ravencrest,288,druid,balance,6,3,3
8090,Crotchlicker,bloodscalp,288,druid,balance,6,3,3
8091,Vykarux,suramar,288,druid,balance,6,3,3
8092,Bwokhanji,proudmoore,288,druid,balance,6,3,3
8093,Ornaaga,blackrock,288,druid,balance,6,3,3
8094,Thumpb,bronzebeard,288,druid,balance,6,3,3
8095,Revitalize,shadowsong,288,druid,balance,6,3,3
8096,Däll,tichondrius,288,druid,balance,6,3,3
8097,Tiju,wyrmrest-accord,288,druid,balance,6,3,3
8098,Fengfeidruid,illidan,288,druid,balance,6,3,3
8099,Alleae,stormrage,288,druid,balance,6,3,3
8100,Rhorr,frostmourne,288,druid,balance,6,3,3
8101,Healthycow,illidan,288,druid,balance,6,3,3
8102,Goldentaint,tichondrius,288,druid,balance,6,3,3
8103,Ohsnapz,silvermoon,288,druid,balance,6,3,3
8104,Fauck,illidan,288,druid,balance,6,3,3
8105,Thebruiser,baelgun,288,druid,balance,6,3,3
8106,Endingitall,illidan,288,druid,balance,6,3,3
8107,Nidalie,zuljin,288,druid,balance,6,3,3
8108,Greenseed,nagrand,288,druid,balance,6,3,3
8109,Shaftomatic,tichondrius,288,druid,balance,6,3,3
8110,Luuxia,tichondrius,288,druid,balance,6,3,3
8111,Aconcat,bleeding-hollow,288,druid,balance,6,3,3
8112,Ðeepsixx,burning-legion,288,druid,balance,6,3,3
8113,Winmax,tichondrius,288,druid,balance,6,3,3
8114,Iploopedyogf,bleeding-hollow,288,druid,balance,6,3,3
8115,Jyuaiai,tichondrius,288,druid,balance,6,3,3
8116,Loraxx,bleeding-hollow,288,druid,balance,6,3,3
8117,Levelboostx,tichondrius,288,druid,balance,6,3,3
8118,Rongrong,kargath,288,druid,balance,6,3,3
8119,Dauncy,sargeras,288,druid,balance,6,3,3
8120,Silynce,tichondrius,288,druid,balance,6,3,3
8121,Uckin,bleeding-hollow,288,druid,balance,6,3,3
8122,Spooser,proudmoore,288,druid,balance,6,3,3
8123,Tabbo,uther,288,druid,balance,6,3,3
8124,Icefang,tichondrius,288,druid,balance,6,3,3
8125,Voodoopipe,tichondrius,288,druid,balance,6,3,3
8126,Pergutory,frostmourne,288,druid,balance,6,3,3
8127,Shalaz,magtheridon,288,druid,balance,6,3,3
8128,Mar,misha,288,druid,balance,6,3,3
8129,Jpylm,ysera,288,druid,balance,6,3,3
8130,Jammi,skywall,288,druid,balance,6,3,3
8131,Tugboat,saurfang,288,druid,balance,6,3,3
8132,Laazz,area-52,288,druid,balance,6,3,3
8133,Supriix,moon-guard,288,druid,balance,6,3,3
8134,Hootiepie,hyjal,288,druid,balance,6,3,3
8135,Jgb,dalaran,288,druid,balance,6,3,3
8136,Haaha,area-52,288,druid,balance,6,3,3
8137,Alcorria,area-52,288,druid,balance,6,3,3
8138,Jabawockdeez,area-52,288,druid,balance,6,3,3
8139,Azoth,hyjal,288,druid,balance,6,3,3
8140,Kaldelar,emerald-dream,288,druid,balance,6,3,3
8141,Sawachicky,frostmourne,288,druid,balance,6,3,3
8142,Bridgerén,tichondrius,288,druid,balance,6,3,3
8143,Gsd,sargeras,288,druid,balance,6,3,3
8144,ßrian,stormscale,288,druid,balance,6,3,3
8145,Waiv,area-52,288,druid,balance,6,3,3
8146,Silkyroad,tichondrius,288,druid,balance,6,3,3
8147,Hallthrok,stormrage,288,druid,balance,6,3,3
8148,Taztoc,stormrage,288,druid,balance,6,3,3
8149,Bearys,area-52,288,druid,balance,6,3,3
8150,Kickconvoke,sargeras,288,druid,balance,6,3,3
8151,Slütcakes,tichondrius,288,druid,balance,6,3,3
8152,Targeted,sargeras,288,druid,balance,6,3,3
8153,Bhíkkhu,stormrage,288,druid,balance,6,3,3
8154,Rabbithomas,malygos,288,druid,balance,6,3,3
8155,Bleedum,guldan,288,druid,balance,6,3,3
8156,Hchhi,ragnaros,288,druid,balance,6,3,3
8157,Noheárt,kelthuzad,288,druid,balance,6,3,3
8158,Delrin,garona,288,druid,balance,6,3,3
8159,Vawdka,proudmoore,288,druid,balance,9,4,5
8160,Bigswaag,malganis,288,druid,balance,7,3,4
8161,Xail,hyjal,288,druid,balance,8,3,5
8162,Wreckingcrew,emerald-dream,288,druid,balance,8,3,5
8163,Retsarehard,illidan,288,druid,balance,8,3,5
8164,Uezzon,tol-barad,288,druid,balance,12,3,9
8165,Machinex,illidan,288,druid,balance,12,3,9
8166,Feyrien,dalaran,288,druid,balance,12,3,9
8167,Alalletsa,destromath,288,druid,balance,12,3,9
8168,Scythé,stormrage,288,druid,balance,12,3,9
8169,Killersilent,quelthalas,288,druid,balance,12,3,9
8170,Drchronic,boulderfist,288,druid,balance,12,3,9
8171,Cêania,moon-guard,288,druid,balance,12,3,9
8172,Davelombardo,tichondrius,288,druid,balance,12,3,9
8173,Gilgorash,kiljaeden,288,druid,balance,12,3,9
8174,Edinhalfhorn,bonechewer,288,druid,balance,12,3,9
8175,Xalstarrot,sargeras,288,druid,balance,12,3,9
8176,Mulgorer,tichondrius,288,druid,balance,12,3,9
8177,Hottiecake,bronzebeard,288,druid,balance,12,3,9
8178,Koan,proudmoore,288,druid,balance,12,3,9
8179,Mørphea,darkspear,288,druid,balance,12,3,9
8180,Jalapenoz,wyrmrest-accord,288,druid,balance,12,3,9
8181,Plye,korgath,288,druid,balance,12,3,9
8182,Loathe,korialstrasz,288,druid,balance,12,3,9
8183,Evarene,vashj,288,druid,balance,12,3,9
8184,Teyollocuani,sargeras,288,druid,balance,12,3,9
8185,Ginunaga,tichondrius,288,druid,balance,12,3,9
8186,Wweegyy,tichondrius,287,druid,balance,6,3,3
8187,Kniitvekitta,jubeithos,287,druid,balance,6,3,3
8188,Guston,lightbringer,287,druid,balance,6,3,3
8189,Johnee,barthilas,287,druid,balance,6,3,3
8190,Bluechicken,sargeras,287,druid,balance,6,3,3
8191,Wiseoldman,jubeithos,286,druid,balance,6,3,3
8192,Clownprince,barthilas,256,druid,balance,10,3,7
8193,Vollzar,sargeras,255,druid,balance,11,3,8
8194,Amanara,echo-isles,255,druid,balance,11,3,8
8195,Bigtoeess,tichondrius,239,druid,balance,5,3,2
8196,Oddclaw,stormrage,239,druid,balance,5,3,2
8197,Corym,frostmourne,239,druid,balance,11,3,8
8198,Gorfrog,tichondrius,234,druid,balance,9,4,5
8199,Jazzman,jubeithos,223,druid,balance,14,3,11
8200,Flummoz,frostmourne,192,druid,balance,4,3,1
8201,Niwßor,azralon,192,druid,balance,10,4,6
8202,Tansdruid,area-52,192,druid,balance,6,2,4
8203,Isunami,emerald-dream,192,druid,balance,6,2,4
8204,Hagenws,azralon,192,druid,balance,6,2,4
8205,Saìyori,area-52,192,druid,balance,6,2,4
8206,Mäûled,fizzcrank,192,druid,balance,6,2,4
8207,Injeckx,tichondrius,192,druid,balance,6,2,4
8208,Blackchina,tichondrius,192,druid,balance,6,2,4
8209,Gidam,moon-guard,192,druid,balance,6,2,4
8210,Loodichriss,area-52,192,druid,balance,6,2,4
8211,Treezyn,sargeras,192,druid,balance,6,2,4
8212,Flarkage,area-52,192,druid,balance,6,2,4
8213,Enyu,sargeras,192,druid,balance,6,2,4
8214,Variandruid,kelthuzad,192,druid,balance,6,2,4
8215,Redness,daggerspine,192,druid,balance,6,2,4
8216,Hancalimon,nemesis,192,druid,balance,6,2,4
8217,Dcountts,area-52,192,druid,balance,6,2,4
8218,Adonalsium,area-52,192,druid,balance,6,2,4
8219,Wtfhommie,madoran,192,druid,balance,6,2,4
8220,Bubblebraìn,area-52,192,druid,balance,6,2,4
8221,Kångåwålafox,sargeras,192,druid,balance,6,2,4
8222,Hamïlton,ragnaros,192,druid,balance,6,2,4
8223,Overfunk,ragnaros,192,druid,balance,6,2,4
8224,Sooey,wyrmrest-accord,192,druid,balance,6,2,4
8225,Mòónwhisper,moon-guard,192,druid,balance,6,2,4
8226,Bullwïnkle,uther,192,druid,balance,6,2,4
8227,Speaks,moon-guard,192,druid,balance,6,2,4
8228,Laymonath,elune,192,druid,balance,6,2,4
8229,Dweralin,nemesis,192,druid,balance,6,2,4
8230,Ohzú,ragnaros,192,druid,balance,6,2,4
8231,Katherine,moon-guard,192,druid,balance,6,2,4
8232,Bearhug,dragonmaw,192,druid,balance,6,2,4
8233,Azshunara,moon-guard,192,druid,balance,6,2,4
8234,Stumphugger,tichondrius,192,druid,balance,6,2,4
8235,Nightnes,sargeras,192,druid,balance,6,2,4
8236,Mythicdruid,ragnaros,192,druid,balance,6,2,4
8237,Totorostard,tichondrius,192,druid,balance,6,2,4
8238,Sloppysheila,sargeras,192,druid,balance,6,2,4
8239,Lindsanr,illidan,192,druid,balance,6,2,4
8240,Smallrichard,bleeding-hollow,192,druid,balance,6,2,4
8241,Tp,dragonblight,192,druid,balance,6,2,4
8242,Lilherb,azralon,192,druid,balance,6,2,4
8243,Srbestias,quelthalas,192,druid,balance,6,2,4
8244,Hawgs,bleeding-hollow,192,druid,balance,6,2,4
8245,Guap,bleeding-hollow,192,druid,balance,6,2,4
8246,Chèétøhz,moon-guard,192,druid,balance,6,2,4
8247,Hawtzi,stormrage,192,druid,balance,6,2,4
8248,Lappz,malganis,192,druid,balance,6,2,4
8249,Glowstixz,tichondrius,192,druid,balance,6,2,4
8250,Spicyorange,dalaran,192,druid,balance,6,2,4
8251,Rakuath,zuljin,192,druid,balance,6,2,4
8252,Astroprof,bloodscalp,192,druid,balance,6,2,4
8253,Boomtastik,frostmourne,192,druid,balance,6,2,4
8254,Starsfall,tichondrius,192,druid,balance,6,2,4
8255,Hoptimus,zuljin,192,druid,balance,6,2,4
8256,Gazwazluz,lothar,192,druid,balance,6,2,4
8257,Kimgurdian,tichondrius,192,druid,balance,6,2,4
8258,Zukru,malganis,192,druid,balance,6,2,4
8259,Cbreezyy,tichondrius,192,druid,balance,6,2,4
8260,Explicít,sargeras,192,druid,balance,6,2,4
8261,Potus,illidan,192,druid,balance,6,2,4
8262,Slavenhausen,azralon,192,druid,balance,6,2,4
8263,Hasemilë,dalaran,192,druid,balance,6,2,4
8264,Octacer,malfurion,192,druid,balance,6,2,4
8265,Dedgame,malfurion,192,druid,balance,6,2,4
8266,Simeron,silvermoon,192,druid,balance,6,2,4
8267,Hellabanx,tichondrius,192,druid,balance,6,2,4
8268,Moonhorn,kelthuzad,192,druid,balance,6,2,4
8269,Moistism,tichondrius,192,druid,balance,6,2,4
8270,Saucyy,malganis,192,druid,balance,6,2,4
8271,Crycloné,stormrage,192,druid,balance,6,2,4
8272,Meowed,sargeras,192,druid,balance,6,2,4
8273,Maidah,malganis,192,druid,balance,6,2,4
8274,Bobobear,proudmoore,192,druid,balance,6,2,4
8275,Markóla,stormrage,192,druid,balance,6,2,4
8276,Shredstitute,tichondrius,192,druid,balance,6,2,4
8277,Arienne,kelthuzad,192,druid,balance,6,2,4
8278,Nokitty,tichondrius,192,druid,balance,6,2,4
8279,Pawswap,tichondrius,192,druid,balance,6,2,4
8280,Honeybeam,moon-guard,192,druid,balance,6,2,4
8281,Teladrizzle,dalaran,192,druid,balance,6,2,4
8282,Hream,echo-isles,192,druid,balance,6,2,4
8283,Absentteeth,stormrage,192,druid,balance,6,2,4
8284,Hzu,kelthuzad,192,druid,balance,6,2,4
8285,Zigh,azralon,192,druid,balance,6,2,4
8286,Malcavelli,tichondrius,192,druid,balance,6,2,4
8287,Malffurryan,draktharon,192,druid,balance,6,2,4
8288,Cathelyana,tichondrius,192,druid,balance,10,3,7
8289,Panchuwuanky,sargeras,192,druid,balance,8,2,6
8290,Daydaygo,illidan,192,druid,balance,12,2,10
8291,Alluminax,sargeras,192,druid,balance,12,2,10
8292,Thundyrcat,tichondrius,192,druid,balance,12,2,10
8293,Solaress,moon-guard,192,druid,balance,12,2,10
8294,Papaland,tichondrius,192,druid,balance,12,2,10
8295,Unhappystill,tichondrius,192,druid,balance,12,2,10
8296,Rigotakz,illidan,192,druid,balance,12,2,10
8297,Visûcius,moon-guard,192,druid,balance,12,2,10
8298,Pusscat,illidan,192,druid,balance,18,2,16
8299,Thicchicken,emerald-dream,191,druid,balance,12,2,10
8300,Stealthhero,lightbringer,159,druid,balance,5,2,3
8301,Irontree,dunemaul,159,druid,balance,5,2,3
8302,Xylemcow,malganis,159,druid,balance,5,2,3
8303,Formality,kalecgos,159,druid,balance,5,2,3
8304,Sludgischonk,stormrage,159,druid,balance,5,2,3
8305,Moonkingx,ragnaros,159,druid,balance,5,2,3
8306,Theriomorph,barthilas,138,druid,balance,10,3,7
8307,Appitrap,emerald-dream,137,druid,balance,19,3,16
8308,Nightruffles,moon-guard,128,druid,balance,4,2,2
8309,Hirtenweg,stormrage,127,druid,balance,14,2,12
8310,Aeo,frostmourne,112,druid,balance,7,2,5
8311,Alistar,scilla,96,druid,balance,3,2,1
8312,Stradamus,sargeras,96,druid,balance,3,2,1
8313,Yøpièrre,bleeding-hollow,96,druid,balance,3,2,1
8314,Scoobyshiftz,frostmourne,96,druid,balance,8,2,6
8315,Omegabeast,frostmourne,96,druid,balance,6,1,5
8316,Klint,darkspear,96,druid,balance,6,1,5
8317,Aelena,whisperwind,96,druid,balance,6,1,5
8318,Kushkilla,malganis,96,druid,balance,6,1,5
8319,Brucey,khadgar,96,druid,balance,6,1,5
8320,Øvernight,azralon,96,druid,balance,6,1,5
8321,Caponetonejr,steamwheedle-cartel,96,druid,balance,6,1,5
8322,Schlaankeyy,stormrage,96,druid,balance,6,1,5
8323,Sinapticc,proudmoore,96,druid,balance,6,1,5
8324,Kirrel,frostmourne,96,druid,balance,6,1,5
8325,Stinkycrotch,malganis,96,druid,balance,6,1,5
8326,Bowlpacka,malganis,96,druid,balance,6,1,5
8327,Torpina,malganis,96,druid,balance,6,1,5
8328,Oatmeals,fizzcrank,96,druid,balance,6,1,5
8329,Shmooglite,emerald-dream,96,druid,balance,6,1,5
8330,Chickenaeg,stormrage,96,druid,balance,6,1,5
8331,Rennan,cenarius,96,druid,balance,6,1,5
8332,Dendríta,ragnaros,96,druid,balance,6,1,5
8333,Runestar,malganis,96,druid,balance,6,1,5
8334,Thissaene,sargeras,96,druid,balance,6,1,5
8335,Ggumy,tichondrius,96,druid,balance,6,1,5
8336,Elivacheth,zuljin,96,druid,balance,6,1,5
8337,Ultracatx,tichondrius,96,druid,balance,6,1,5
8338,Tsaß,bleeding-hollow,96,druid,balance,6,1,5
8339,Cloyer,stormrage,96,druid,balance,6,1,5
8340,Grimmb,emerald-dream,96,druid,balance,6,1,5
8341,Watchlady,thunderhorn,96,druid,balance,6,1,5
8342,Furryluvr,tichondrius,96,druid,balance,6,1,5
8343,Scatpanties,moon-guard,96,druid,balance,6,1,5
8344,Walkdown,turalyon,96,druid,balance,6,1,5
8345,Notdev,grizzly-hills,96,druid,balance,6,1,5
8346,Chalupà,illidan,96,druid,balance,6,1,5
8347,Chulogringo,tichondrius,96,druid,balance,6,1,5
8348,Breedable,elune,96,druid,balance,6,1,5
8349,Hurloon,demon-soul,96,druid,balance,6,1,5
8350,Idontknowbro,bonechewer,96,druid,balance,6,1,5
8351,Youlived,aegwynn,96,druid,balance,6,1,5
8352,Stalfrus,area-52,96,druid,balance,6,1,5
8353,Travys,sargeras,96,druid,balance,6,1,5
8354,Slackoth,dalaran,96,druid,balance,6,1,5
8355,Bernwolf,moon-guard,96,druid,balance,6,1,5
8356,Skaidi,quelthalas,96,druid,balance,6,1,5
8357,Fancyprance,dalaran,96,druid,balance,6,1,5
8358,Feralmain,illidan,96,druid,balance,6,1,5
8359,Sheeftah,illidan,96,druid,balance,6,1,5
8360,Zazinium,illidan,96,druid,balance,6,1,5
8361,Goodhealer,akama,96,druid,balance,6,1,5
8362,Faldrynn,sargeras,96,druid,balance,6,1,5
8363,Gaìjin,barthilas,96,druid,balance,6,1,5
8364,Encosan,azralon,96,druid,balance,7,1,6
8365,Mayarí,sargeras,96,druid,balance,8,1,7
8366,Simbaa,blades-edge,96,druid,balance,10,1,9
8367,Kängawalafox,frostmourne,96,druid,balance,12,1,11
8368,Kodrän,stormrage,96,druid,balance,12,1,11
8369,Ranokaliki,tichondrius,89,druid,balance,10,3,7
8370,Drewcarriesu,arthas,79,druid,balance,5,2,3
8371,Raahmirtah,illidan,79,druid,balance,5,1,4
8372,Lutzenberger,nemesis,79,druid,balance,5,1,4
8373,Foggie,spirestone,79,druid,balance,5,1,4
8374,Manalune,firetree,79,druid,balance,5,1,4
8375,Zephiee,kelthuzad,79,druid,balance,5,1,4
8376,Minxminx,moon-guard,64,druid,balance,4,1,3
8377,Morpheûs,bleeding-hollow,64,druid,balance,4,1,3
8378,Hughhefferr,illidan,63,druid,balance,2,2,0
8379,Policë,skullcrusher,42,druid,balance,8,2,6
8380,Naturae,spirestone,31,druid,balance,2,1,1
8381,Mclarenz,frostmourne,31,druid,balance,2,1,1
8382,Highs,sargeras,16,druid,balance,1,1,0
8383,Äbÿss,tichondrius,16,druid,balance,1,1,0
8384,Nightsanta,emerald-dream,9,druid,balance,6,2,4
8385,Garbagevoker,scilla,2242,evoker,preservation,192,99,93
8386,Dracob,sargeras,2180,evoker,preservation,252,140,112
8387,Meraxes,moonrunner,2160,evoker,preservation,83,44,39
8388,Sleepiiheadx,stormrage,2141,evoker,preservation,96,54,42
8389,Sleepiihead,stormrage,2130,evoker,preservation,96,50,46
8390,Dragocula,tichondrius,2106,evoker,preservation,109,55,54
8391,Jakedrake,stormrage,2062,evoker,preservation,235,117,118
8392,Didy,tichondrius,2043,evoker,preservation,201,105,96
8393,Jdbthyr,malganis,2030,evoker,preservation,239,116,123
8394,Idk,proudmoore,2004,evoker,preservation,66,34,32
8395,Kiry,emerald-dream,1994,evoker,preservation,84,40,44
8396,Storeypagoda,tichondrius,1993,evoker,preservation,89,50,39
8397,Eskrizzle,thrall,1991,evoker,preservation,78,38,40
8398,Dracthyrfang,elune,1975,evoker,preservation,125,65,60
8399,Kallie,whisperwind,1971,evoker,preservation,503,250,253
8400,Eyjes,stormrage,1939,evoker,preservation,131,72,59
8401,Walf,stormrage,1923,evoker,preservation,373,190,183
8402,Sheepstealer,shuhalo,1922,evoker,preservation,72,35,37
8403,Idrinkurine,tichondrius,1918,evoker,preservation,88,45,43
8404,Ellafortnite,emerald-dream,1915,evoker,preservation,55,31,24
8405,Sloane,dunemaul,1899,evoker,preservation,51,32,19
8406,Bimbus,illidan,1887,evoker,preservation,154,85,69
8407,Mngxaltx,ragnaros,1885,evoker,preservation,78,37,41
8408,Philmcracken,proudmoore,1883,evoker,preservation,34,24,10
8409,Benym,tichondrius,1873,evoker,preservation,60,32,28
8410,Lieferant,area-52,1867,evoker,preservation,48,25,23
8411,Advancedonly,tichondrius,1867,evoker,preservation,48,23,25
8412,Draconian,frostmourne,1866,evoker,preservation,76,36,40
8413,Drupy,tichondrius,1860,evoker,preservation,60,31,29
8414,Thnake,zuljin,1839,evoker,preservation,72,38,34
8415,Selkisaurus,area-52,1834,evoker,preservation,60,29,31
8416,Ancalagøn,ragnaros,1833,evoker,preservation,70,35,35
8417,Ojigi,sargeras,1833,evoker,preservation,69,28,41
8418,Driceses,area-52,1831,evoker,preservation,72,44,28
8419,Iba,tichondrius,1828,evoker,preservation,96,54,42
8420,Ravebae,frostmourne,1828,evoker,preservation,45,25,20
8421,Neskor,moon-guard,1827,evoker,preservation,101,58,43
8422,Dragongunz,illidan,1815,evoker,preservation,42,19,23
8423,Lucardeht,illidan,1813,evoker,preservation,44,23,21
8424,Dragonkok,stormrage,1810,evoker,preservation,42,26,16
8425,Hlaargh,illidan,1809,evoker,preservation,60,31,29
8426,Dragonclause,stormrage,1809,evoker,preservation,72,32,40
8427,Furegos,zuljin,1807,evoker,preservation,48,23,25
8428,Lodekiim,malganis,1806,evoker,preservation,66,30,36
8429,Mcdonovan,stormrage,1805,evoker,preservation,81,36,45
8430,Révoked,magtheridon,1802,evoker,preservation,323,179,144
8431,Obama,dragonmaw,1801,evoker,preservation,78,33,45
8432,Novustrasza,lightbringer,1800,evoker,preservation,66,43,23
8433,Petezra,ragnaros,1800,evoker,preservation,70,33,37
8434,Livesey,thunderhorn,1791,evoker,preservation,96,56,40
8435,Drerick,illidan,1772,evoker,preservation,104,53,51
8436,Fatsu,executus,1768,evoker,preservation,54,24,30
8437,Dragontrees,illidan,1765,evoker,preservation,54,28,26
8438,Neocellx,frostwolf,1756,evoker,preservation,49,28,21
8439,Ugg,stormrage,1756,evoker,preservation,171,76,95
8440,Elimi,tichondrius,1748,evoker,preservation,36,22,14
8441,Berquone,tichondrius,1747,evoker,preservation,72,31,41
8442,Áäøxgød,ravencrest,1747,evoker,preservation,70,29,41
8443,Cerevok,area-52,1745,evoker,preservation,60,37,23
8444,Fxii,tichondrius,1737,evoker,preservation,24,20,4
8445,Phooby,sargeras,1736,evoker,preservation,72,37,35
8446,Rosestrasza,silvermoon,1734,evoker,preservation,132,63,69
8447,Stønemonkey,sargeras,1730,evoker,preservation,147,73,74
8448,Dirtydragon,uther,1724,evoker,preservation,54,22,32
8449,Kainalaz,moon-guard,1715,evoker,preservation,55,28,27
8450,Lodedragon,tichondrius,1714,evoker,preservation,108,48,60
8451,Dunkinonem,black-dragonflight,1712,evoker,preservation,642,321,321
8452,Basherm,moon-guard,1711,evoker,preservation,96,47,49
8453,Moralies,area-52,1705,evoker,preservation,48,24,24
8454,Joc,khazgoroth,1704,evoker,preservation,65,33,32
8455,Schmitty,hellscream,1689,evoker,preservation,100,48,52
8456,Evokethisdik,tichondrius,1684,evoker,preservation,37,20,17
8457,Mirandaxo,tichondrius,1684,evoker,preservation,161,73,88
8458,Courtvoke,turalyon,1667,evoker,preservation,176,92,84
8459,Usedbandage,sargeras,1667,evoker,preservation,193,98,95
8460,Hamine,tichondrius,1666,evoker,preservation,48,23,25
8461,Judra,barthilas,1665,evoker,preservation,74,38,36
8462,Velstrasza,stormrage,1664,evoker,preservation,36,20,16
8463,Dupastrasza,illidan,1664,evoker,preservation,60,25,35
8464,Vulkerr,stormrage,1663,evoker,preservation,90,51,39
8465,Gharkul,frostmourne,1663,evoker,preservation,48,25,23
8466,Daegonz,lightbringer,1657,evoker,preservation,116,57,59
8467,Deathdrake,jubeithos,1651,evoker,preservation,156,75,81
8468,Junkstam,malganis,1651,evoker,preservation,69,32,37
8469,Sandragon,ragnaros,1646,evoker,preservation,57,25,32
8470,Dragboy,stormrage,1645,evoker,preservation,116,64,52
8471,Domavem,tichondrius,1642,evoker,preservation,66,28,38
8472,Flamedramon,bleeding-hollow,1641,evoker,preservation,223,103,120
8473,Sanninv,barthilas,1638,evoker,preservation,57,26,31
8474,Trákanon,mugthol,1634,evoker,preservation,67,37,30
8475,Ðrac,bleeding-hollow,1633,evoker,preservation,53,30,23
8476,Purrlynn,tichondrius,1630,evoker,preservation,66,40,26
8477,Modenzu,malganis,1629,evoker,preservation,66,33,33
8478,Dripdrop,stormscale,1627,evoker,preservation,94,49,45
8479,Wingsoflyfe,frostmourne,1625,evoker,preservation,48,20,28
8480,Dracadukez,illidan,1625,evoker,preservation,60,21,39
8481,Dragondikz,tichondrius,1622,evoker,preservation,48,25,23
8482,Redseal,tichondrius,1621,evoker,preservation,80,37,43
8483,Dgevoker,tichondrius,1620,evoker,preservation,47,19,28
8484,Versezz,tichondrius,1619,evoker,preservation,30,17,13
8485,Seeyn,tichondrius,1615,evoker,preservation,66,27,39
8486,Grunkthyr,moon-guard,1614,evoker,preservation,47,25,22
8487,Leonilxd,tichondrius,1610,evoker,preservation,97,51,46
8488,Patzdormu,area-52,1610,evoker,preservation,42,17,25
8489,Tallcanman,kelthuzad,1609,evoker,preservation,36,17,19
8490,Bigdwagon,stormrage,1608,evoker,preservation,36,17,19
8491,Triarcs,sargeras,1606,evoker,preservation,40,21,19
8492,Tinine,frostmourne,1603,evoker,preservation,86,44,42
8493,Deadlybx,bleeding-hollow,1603,evoker,preservation,70,32,38
8494,Drakjar,nemesis,1602,evoker,preservation,48,23,25
8495,Layugos,azralon,1601,evoker,preservation,35,20,15
8496,Emperör,quelthalas,1601,evoker,preservation,91,49,42
8497,Provokker,drakkari,1600,evoker,preservation,30,21,9
8498,Jlucks,wyrmrest-accord,1600,evoker,preservation,166,94,72
8499,Veraxsys,wyrmrest-accord,1600,evoker,preservation,52,20,32
8500,Chessyk,ragnaros,1592,evoker,preservation,47,30,17
8501,Adragon,garithos,1585,evoker,preservation,77,30,47
8502,Stinkler,stormscale,1583,evoker,preservation,90,42,48
8503,Thinprivlege,area-52,1583,evoker,preservation,60,26,34
8504,Evokesyn,stormrage,1582,evoker,preservation,69,37,32
8505,Dragonkink,sargeras,1581,evoker,preservation,60,32,28
8506,Congodragon,frostmourne,1577,evoker,preservation,36,21,15
8507,Lucidreamx,tichondrius,1575,evoker,preservation,67,34,33
8508,Whethersmell,tichondrius,1566,evoker,preservation,158,71,87
8509,Drepz,dalaran,1564,evoker,preservation,63,45,18
8510,Linkinloatr,tichondrius,1563,evoker,preservation,54,23,31
8511,Buttcrease,emerald-dream,1562,evoker,preservation,42,22,20
8512,Møritz,stormrage,1562,evoker,preservation,86,40,46
8513,Twizzthyr,bleeding-hollow,1558,evoker,preservation,138,64,74
8514,Dracore,firetree,1549,evoker,preservation,215,112,103
8515,Ffaarrvv,illidan,1545,evoker,preservation,108,63,45
8516,Tonysaur,lethon,1537,evoker,preservation,30,19,11
8517,Cyndragosa,dalvengyr,1537,evoker,preservation,65,29,36
8518,Kwitty,illidan,1535,evoker,preservation,48,27,21
8519,Fláppÿbírd,bleeding-hollow,1533,evoker,preservation,24,16,8
8520,Corncrake,sargeras,1530,evoker,preservation,50,23,27
8521,Cokobra,haomarush,1529,evoker,preservation,24,16,8
8522,Zenot,malganis,1526,evoker,preservation,40,29,11
8523,Egglayer,tichondrius,1525,evoker,preservation,131,54,77
8524,Velocîraptor,bleeding-hollow,1524,evoker,preservation,92,53,39
8525,Bigbaojian,tichondrius,1522,evoker,preservation,24,16,8
8526,Eyolker,kelthuzad,1522,evoker,preservation,65,34,31
8527,Transmogplz,tichondrius,1522,evoker,preservation,66,27,39
8528,Gobananas,sargeras,1520,evoker,preservation,29,17,12
8529,Ponnukii,tichondrius,1517,evoker,preservation,172,89,83
8530,Elcigala,ragnaros,1516,evoker,preservation,257,131,126
8531,Thevochr,area-52,1514,evoker,preservation,42,27,15
8532,Dragonsteppz,aegwynn,1512,evoker,preservation,30,16,14
8533,Trembulos,malganis,1512,evoker,preservation,48,23,25
8534,Mfka,dalaran,1512,evoker,preservation,83,39,44
8535,Earthshatter,lightbringer,1510,evoker,preservation,166,91,75
8536,Ycnpass,tichondrius,1509,evoker,preservation,134,79,55
8537,Madegood,tichondrius,1508,evoker,preservation,54,26,28
8538,Dragdezenutz,bleeding-hollow,1508,evoker,preservation,94,36,58
8539,Alitasbbq,malganis,1505,evoker,preservation,36,16,20
8540,Waggon,moon-guard,1504,evoker,preservation,48,26,22
8541,Youngyongdie,tichondrius,1499,evoker,preservation,52,25,27
8542,Yop,proudmoore,1494,evoker,preservation,55,16,39
8543,Slither,terenas,1491,evoker,preservation,87,49,38
8544,Vhaegart,area-52,1491,evoker,preservation,90,38,52
8545,Snuggleboo,malganis,1490,evoker,preservation,24,16,8
8546,Emoker,magtheridon,1490,evoker,preservation,84,46,38
8547,Suffler,warsong,1488,evoker,preservation,166,93,73
8548,Dragoncods,velen,1488,evoker,preservation,48,26,22
8549,Hepzibah,kelthuzad,1488,evoker,preservation,53,23,30
8550,Virtualcrush,sisters-of-elune,1486,evoker,preservation,94,49,45
8551,Nikholatrus,malganis,1483,evoker,preservation,106,52,54
8552,Splendadaddy,kiljaeden,1482,evoker,preservation,30,16,14
8553,Sineexe,illidan,1477,evoker,preservation,86,50,36
8554,Kaidagos,tichondrius,1477,evoker,preservation,30,17,13
8555,Buttfinger,bladefist,1476,evoker,preservation,74,33,41
8556,Slimez,malganis,1476,evoker,preservation,107,47,60
8557,Ralzital,auchindoun,1476,evoker,preservation,68,29,39
8558,Healpumper,kelthuzad,1475,evoker,preservation,28,17,11
8559,Nyzara,emerald-dream,1475,evoker,preservation,78,36,42
8560,Yotus,illidan,1474,evoker,preservation,60,35,25
8561,Jacm,fizzcrank,1472,evoker,preservation,77,36,41
8562,Qiblii,moon-guard,1470,evoker,preservation,48,24,24
8563,Monavoker,bleeding-hollow,1466,evoker,preservation,36,20,16
8564,Pauly,suramar,1466,evoker,preservation,72,37,35
8565,Diavai,area-52,1466,evoker,preservation,81,35,46
8566,Setalet,zuljin,1465,evoker,preservation,47,19,28
8567,Weagle,zuljin,1465,evoker,preservation,45,18,27
8568,Delivv,hyjal,1464,evoker,preservation,78,42,36
8569,Enazen,kiljaeden,1460,evoker,preservation,83,45,38
8570,Lalargata,azralon,1459,evoker,preservation,65,32,33
8571,Giratina,area-52,1457,evoker,preservation,102,50,52
8572,Cringilisk,kelthuzad,1454,evoker,preservation,126,82,44
8573,Nulldd,tichondrius,1452,evoker,preservation,47,16,31
8574,Voithyr,moon-guard,1450,evoker,preservation,213,98,115
8575,Vormontis,azralon,1449,evoker,preservation,88,40,48
8576,Suedeshoes,bleeding-hollow,1448,evoker,preservation,162,88,74
8577,Linguistic,tichondrius,1448,evoker,preservation,36,17,19
8578,Nyxtari,ragnaros,1447,evoker,preservation,108,57,51
8579,Spyrox,zuluhed,1445,evoker,preservation,30,16,14
8580,Lizzardload,stormreaver,1445,evoker,preservation,82,37,45
8581,Nazzadormu,tichondrius,1445,evoker,preservation,70,30,40
8582,Dragisha,gnomeregan,1441,evoker,preservation,48,28,20
8583,Derazar,malganis,1438,evoker,preservation,249,111,138
8584,Squarter,kiljaeden,1437,evoker,preservation,48,28,20
8585,Bucket,wyrmrest-accord,1437,evoker,preservation,38,16,22
8586,Dweamfuego,sargeras,1434,evoker,preservation,24,15,9
8587,Apollygos,malganis,1434,evoker,preservation,54,30,24
8588,Dragonmyass,tichondrius,1434,evoker,preservation,43,17,26
8589,Gogmagog,korgath,1433,evoker,preservation,89,42,47
8590,Sovietønion,tichondrius,1433,evoker,preservation,71,32,39
8591,Biggestbroie,frostmourne,1431,evoker,preservation,30,15,15
8592,Nazatra,wyrmrest-accord,1431,evoker,preservation,107,51,56
8593,Fusrodude,shuhalo,1428,evoker,preservation,86,48,38
8594,Zakaraki,bloodscalp,1427,evoker,preservation,60,35,25
8595,Handeezol,malganis,1426,evoker,preservation,48,27,21
8596,Quickshootin,tichondrius,1426,evoker,preservation,249,115,134
8597,Kjerne,stormrage,1424,evoker,preservation,64,34,30
8598,Spyrodadrago,malganis,1423,evoker,preservation,113,50,63
8599,Annum,moon-guard,1423,evoker,preservation,60,22,38
8600,Xurota,proudmoore,1422,evoker,preservation,92,40,52
8601,Ajiz,mannoroth,1421,evoker,preservation,42,18,24
8602,Bendover,proudmoore,1420,evoker,preservation,36,19,17
8603,Kephii,eonar,1415,evoker,preservation,42,22,20
8604,Garchamp,area-52,1412,evoker,preservation,48,20,28
8605,Vyndormu,moon-guard,1410,evoker,preservation,46,22,24
8606,Runawayslave,frostmane,1409,evoker,preservation,227,106,121
8607,Zka,nemesis,1408,evoker,preservation,43,21,22
8608,Meiron,azralon,1407,evoker,preservation,66,33,33
8609,Kigglypuff,illidan,1406,evoker,preservation,36,15,21
8610,Cyntheticdr,malganis,1404,evoker,preservation,54,30,24
8611,Roogye,illidan,1403,evoker,preservation,96,49,47
8612,Miliolievo,azralon,1402,evoker,preservation,265,131,134
8613,Kaldobar,stormrage,1401,evoker,preservation,24,15,9
8614,Cjin,tichondrius,1401,evoker,preservation,30,17,13
8615,Thicscales,tichondrius,1399,evoker,preservation,70,33,37
8616,Anthyrsia,zuljin,1398,evoker,preservation,35,18,17
8617,Dylôn,tichondrius,1398,evoker,preservation,58,27,31
8618,Ráigon,ragnaros,1394,evoker,preservation,136,61,75
8619,Necrathma,tichondrius,1392,evoker,preservation,103,49,54
8620,Macismighty,emerald-dream,1390,evoker,preservation,66,36,30
8621,Kikokosta,tichondrius,1389,evoker,preservation,106,57,49
8622,Grousegamer,barthilas,1389,evoker,preservation,82,35,47
8623,Jmir,tichondrius,1389,evoker,preservation,59,24,35
8624,Growthyy,malganis,1387,evoker,preservation,35,22,13
8625,Mythsvoker,barthilas,1384,evoker,preservation,56,31,25
8626,Otsira,frostmourne,1383,evoker,preservation,48,32,16
8627,Masquemeto,illidan,1382,evoker,preservation,43,21,22
8628,Unknowndrago,kul-tiras,1376,evoker,preservation,30,15,15
8629,Tazarke,dawnbringer,1375,evoker,preservation,60,35,25
8630,Fuoco,kiljaeden,1374,evoker,preservation,50,28,22
8631,Bigdrag,blackhand,1373,evoker,preservation,103,56,47
8632,Dragonpel,azralon,1371,evoker,preservation,124,62,62
8633,Errier,tichondrius,1370,evoker,preservation,33,17,16
8634,Healmeta,sargeras,1369,evoker,preservation,308,154,154
8635,Vodkasauce,tichondrius,1369,evoker,preservation,30,15,15
8636,Xerroh,area-52,1368,evoker,preservation,76,38,38
8637,Kratheu,azralon,1368,evoker,preservation,35,15,20
8638,Pootylizard,daggerspine,1367,evoker,preservation,44,16,28
8639,Tzindelor,illidan,1364,evoker,preservation,60,27,33
8640,Friedwings,wyrmrest-accord,1359,evoker,preservation,27,16,11
8641,Greenscales,frostmourne,1358,evoker,preservation,105,43,62
8642,Aymadragon,sargeras,1357,evoker,preservation,38,15,23
8643,Misico,illidan,1355,evoker,preservation,78,46,32
8644,Thepplschamp,bloodhoof,1354,evoker,preservation,48,23,25
8645,Lifewing,bleeding-hollow,1352,evoker,preservation,67,25,42
8646,Gloamdream,cenarius,1351,evoker,preservation,171,93,78
8647,Darthjarjar,bloodscalp,1351,evoker,preservation,170,84,86
8648,Bomber,frostwolf,1351,evoker,preservation,34,16,18
8649,Quesodillas,stormreaver,1350,evoker,preservation,48,18,30
8650,Sía,drakkari,1349,evoker,preservation,48,28,20
8651,Chambea,kelthuzad,1349,evoker,preservation,59,30,29
8652,Garboker,area-52,1346,evoker,preservation,158,75,83
8653,Neffiie,dalaran,1345,evoker,preservation,96,45,51
8654,Kîñggïgàçhäð,stormrage,1343,evoker,preservation,24,14,10
8655,Kwebab,tichondrius,1343,evoker,preservation,36,14,22
8656,Feijiwang,aegwynn,1342,evoker,preservation,69,41,28
8657,Flyboy,malganis,1339,evoker,preservation,24,14,10
8658,Gotbreath,dalaran,1339,evoker,preservation,76,41,35
8659,Primshin,illidan,1339,evoker,preservation,69,34,35
8660,Enalen,azjolnerub,1338,evoker,preservation,62,29,33
8661,Actïoncat,emerald-dream,1338,evoker,preservation,69,26,43
8662,Naykir,khazgoroth,1335,evoker,preservation,24,16,8
8663,Prettycooll,dathremar,1335,evoker,preservation,24,14,10
8664,Gumbåll,bleeding-hollow,1335,evoker,preservation,168,81,87
8665,Bryagh,executus,1334,evoker,preservation,54,28,26
8666,Forsakentime,sargeras,1333,evoker,preservation,60,32,28
8667,Charbothyr,gorgonnash,1331,evoker,preservation,49,24,25
8668,Chunkè,moon-guard,1331,evoker,preservation,63,26,37
8669,Kalsit,emerald-dream,1330,evoker,preservation,58,26,32
8670,Dawitchvoker,illidan,1329,evoker,preservation,192,102,90
8671,Mäverick,kelthuzad,1327,evoker,preservation,35,23,12
8672,Caphe,nerzhul,1323,evoker,preservation,54,24,30
8673,Lilithlittle,daggerspine,1321,evoker,preservation,148,75,73
8674,Dendywings,zuljin,1321,evoker,preservation,30,14,16
8675,Verk,deathwing,1318,evoker,preservation,138,75,63
8676,Dracniel,illidan,1316,evoker,preservation,69,38,31
8677,Nitalzith,area-52,1311,evoker,preservation,48,23,25
8678,Zmaj,jubeithos,1310,evoker,preservation,24,17,7
8679,Solong,sargeras,1310,evoker,preservation,67,38,29
8680,Inkdsy,detheroc,1310,evoker,preservation,30,16,14
8681,Jazzdragon,tichondrius,1310,evoker,preservation,51,24,27
8682,Lamentation,area-52,1309,evoker,preservation,54,32,22
8683,Longaot,tichondrius,1308,evoker,preservation,28,14,14
8684,Whinks,zangarmarsh,1307,evoker,preservation,35,18,17
8685,Glizzurd,proudmoore,1306,evoker,preservation,273,133,140
8686,Zindrozarath,area-52,1306,evoker,preservation,109,53,56
8687,Aoibae,frostmourne,1303,evoker,preservation,66,30,36
8688,Kalikani,moon-guard,1303,evoker,preservation,93,41,52
8689,Wangasaur,emerald-dream,1302,evoker,preservation,55,26,29
8690,Cynderrellaa,proudmoore,1299,evoker,preservation,152,73,79
8691,Lilacstrasza,moon-guard,1297,evoker,preservation,158,77,81
8692,Oogiewoogie,doomhammer,1294,evoker,preservation,23,14,9
8693,Straxolotl,frostmourne,1293,evoker,preservation,81,33,48
8694,Shenlong,malganis,1292,evoker,preservation,101,55,46
8695,Selfhealzer,korgath,1292,evoker,preservation,80,38,42
8696,Radragão,azralon,1291,evoker,preservation,42,24,18
8697,Boseijwho,emerald-dream,1288,evoker,preservation,36,19,17
8698,Nitalash,moon-guard,1286,evoker,preservation,29,14,15
8699,Gavstarz,frostmourne,1286,evoker,preservation,30,14,16
8700,Ultis,tichondrius,1285,evoker,preservation,373,190,183
8701,Paladinex,tichondrius,1284,evoker,preservation,47,27,20
8702,Thereptile,frostmourne,1284,evoker,preservation,90,41,49
8703,Laggathaa,emerald-dream,1283,evoker,preservation,44,17,27
8704,Mëleys,ragnaros,1280,evoker,preservation,41,20,21
8705,Dragûn,stormrage,1279,evoker,preservation,30,16,14
8706,Shellessturt,kelthuzad,1278,evoker,preservation,27,14,13
8707,Velaryonhero,arthas,1277,evoker,preservation,56,29,27
8708,Feelzz,illidan,1275,evoker,preservation,37,19,18
8709,Hotdawgin,korgath,1269,evoker,preservation,70,30,40
8710,Lickndragons,sargeras,1265,evoker,preservation,36,14,22
8711,Xhamon,quelthalas,1264,evoker,preservation,56,29,27
8712,Cronós,tichondrius,1260,evoker,preservation,78,32,46
8713,Riz,blackhand,1256,evoker,preservation,83,42,41
8714,Skailyx,zuljin,1254,evoker,preservation,30,14,16
8715,Sylf,kiljaeden,1253,evoker,preservation,81,45,36
8716,Brantley,stormscale,1253,evoker,preservation,86,41,45
8717,Vgt,nemesis,1253,evoker,preservation,84,35,49
8718,Nicegirl,stormrage,1252,evoker,preservation,30,15,15
8719,Agony,emerald-dream,1252,evoker,preservation,249,121,128
8720,Mãttyy,malganis,1250,evoker,preservation,42,23,19
8721,Shudo,moon-guard,1250,evoker,preservation,95,47,48
8722,Xazxander,tichondrius,1249,evoker,preservation,78,37,41
8723,Hydrrax,dalaran,1248,evoker,preservation,190,93,97
8724,Mikoriivoker,tichondrius,1247,evoker,preservation,30,13,17
8725,Lévocatrice,hakkar,1246,evoker,preservation,58,29,29
8726,Wethotgarbee,tichondrius,1245,evoker,preservation,44,23,21
8727,Justbreathez,tichondrius,1245,evoker,preservation,35,13,22
8728,Stableboy,bleeding-hollow,1244,evoker,preservation,18,13,5
8729,Thendroz,aerie-peak,1242,evoker,preservation,95,54,41
8730,Valarakuu,illidan,1242,evoker,preservation,24,13,11
8731,Antirrhinum,zuljin,1241,evoker,preservation,36,25,11
8732,Dansauce,sargeras,1241,evoker,preservation,56,30,26
8733,Allaston,tichondrius,1240,evoker,preservation,45,28,17
8734,Zandragosa,dalaran,1240,evoker,preservation,24,13,11
8735,Nêwt,darkspear,1240,evoker,preservation,208,102,106
8736,Dkvastate,tichondrius,1236,evoker,preservation,112,56,56
8737,Zerath,frostmane,1236,evoker,preservation,30,13,17
8738,Lavagurl,stormscale,1235,evoker,preservation,30,13,17
8739,Dragocser,drakkari,1233,evoker,preservation,30,13,17
8740,Astoragosa,moon-guard,1231,evoker,preservation,61,38,23
8741,Everglow,the-forgotten-coast,1231,evoker,preservation,30,17,13
8742,Verosria,area-52,1230,evoker,preservation,24,13,11
8743,Zippityzoom,barthilas,1229,evoker,preservation,59,30,29
8744,Onornun,magtheridon,1229,evoker,preservation,66,32,34
8745,Macdrag,malganis,1228,evoker,preservation,24,13,11
8746,Kycaka,area-52,1228,evoker,preservation,46,14,32
8747,Dracndanuts,draenor,1225,evoker,preservation,32,13,19
8748,Lebronjmz,kiljaeden,1224,evoker,preservation,127,58,69
8749,Evokas,tichondrius,1223,evoker,preservation,234,120,114
8750,Mungwings,area-52,1221,evoker,preservation,43,22,21
8751,Milfwizard,tichondrius,1219,evoker,preservation,24,13,11
8752,Döublepenn,tichondrius,1219,evoker,preservation,75,40,35
8753,Skithyrix,bleeding-hollow,1218,evoker,preservation,55,28,27
8754,Dunkelzahn,gorgonnash,1214,evoker,preservation,30,15,15
8755,Amniotic,hyjal,1212,evoker,preservation,54,31,23
8756,Ysondrius,durotan,1212,evoker,preservation,48,26,22
8757,Raptormoto,lothar,1211,evoker,preservation,32,14,18
8758,Balèrion,illidan,1207,evoker,preservation,60,33,27
8759,Ghidorah,sentinels,1207,evoker,preservation,59,32,27
8760,Frozanat,kelthuzad,1205,evoker,preservation,75,34,41
8761,Sanaz,stormreaver,1204,evoker,preservation,48,25,23
8762,Allaker,kargath,1204,evoker,preservation,39,16,23
8763,Doogiehowser,azshara,1202,evoker,preservation,162,78,84
8764,Hamanv,tichondrius,1202,evoker,preservation,30,13,17
8765,Assassasin,bonechewer,1200,evoker,preservation,60,27,33
8766,Partysnaxx,thrall,1199,evoker,preservation,72,35,37
8767,Çhara,illidan,1198,evoker,preservation,126,65,61
8768,Shênlong,sargeras,1193,evoker,preservation,54,22,32
8769,Crowqt,frostmourne,1190,evoker,preservation,95,34,61
8770,Zitasanazen,tichondrius,1189,evoker,preservation,257,134,123
8771,Goonwing,frostmourne,1188,evoker,preservation,24,13,11
8772,Shook,baelgun,1188,evoker,preservation,122,62,60
8773,Bahamut,magtheridon,1186,evoker,preservation,60,25,35
8774,Wyldefire,senjin,1180,evoker,preservation,48,22,26
8775,Deralan,khaz-modan,1179,evoker,preservation,108,40,68
8776,Xblood,tichondrius,1172,evoker,preservation,42,25,17
8777,Héllfire,ghostlands,1171,evoker,preservation,36,17,19
8778,Frëëbîë,area-52,1170,evoker,preservation,30,13,17
8779,Fránky,ragnaros,1167,evoker,preservation,24,13,11
8780,Kaguax,tichondrius,1167,evoker,preservation,84,32,52
8781,Worldx,illidan,1166,evoker,preservation,24,13,11
8782,Lyingdragon,tichondrius,1166,evoker,preservation,60,26,34
8783,Tinyvoker,area-52,1166,evoker,preservation,48,14,34
8784,Mazalagon,trollbane,1165,evoker,preservation,29,15,14
8785,Brôcôlînî,zuljin,1164,evoker,preservation,25,18,7
8786,Dandera,stormrage,1164,evoker,preservation,88,40,48
8787,Draginnuts,illidan,1162,evoker,preservation,53,25,28
8788,Vermitor,sargeras,1155,evoker,preservation,24,13,11
8789,Soô,tichondrius,1152,evoker,preservation,24,12,12
8790,Mikoribreath,moknathal,1151,evoker,preservation,18,12,6
8791,Crsevencr,tichondrius,1150,evoker,preservation,18,12,6
8792,Raundur,ragnaros,1150,evoker,preservation,24,12,12
8793,Miradrake,icecrown,1150,evoker,preservation,24,12,12
8794,Mysticenergy,tichondrius,1150,evoker,preservation,60,28,32
8795,Cycircle,tichondrius,1149,evoker,preservation,24,12,12
8796,Emozoomer,malganis,1148,evoker,preservation,66,25,41
8797,Vokr,area-52,1147,evoker,preservation,24,12,12
8798,Derkscale,stormrage,1146,evoker,preservation,36,17,19
8799,Distortion,drakthul,1145,evoker,preservation,117,62,55
8800,Masondragon,darkspear,1145,evoker,preservation,30,12,18
8801,Xiwinnie,illidan,1144,evoker,preservation,36,14,22
8802,Visserion,sargeras,1143,evoker,preservation,25,14,11
8803,Detreshan,stormreaver,1142,evoker,preservation,104,57,47
8804,Potfase,tichondrius,1142,evoker,preservation,54,22,32
8805,Hakuroyime,ragnaros,1141,evoker,preservation,24,15,9
8806,Fibonac,frostmourne,1136,evoker,preservation,54,32,22
8807,Tigdragon,proudmoore,1133,evoker,preservation,30,12,18
8808,Vermax,akama,1133,evoker,preservation,45,17,28
8809,Buttstough,aerie-peak,1132,evoker,preservation,23,13,10
8810,Treadcinder,tichondrius,1130,evoker,preservation,30,14,16
8811,Blay,elune,1130,evoker,preservation,36,15,21
8812,Djdavi,azralon,1127,evoker,preservation,102,62,40
8813,Kathendrov,sargeras,1119,evoker,preservation,24,14,10
8814,Endroz,tichondrius,1119,evoker,preservation,24,12,12
8815,Drathron,tichondrius,1118,evoker,preservation,28,13,15
8816,Raykwaza,tichondrius,1114,evoker,preservation,24,12,12
8817,Draczod,proudmoore,1112,evoker,preservation,53,19,34
8818,Careflight,barthilas,1108,evoker,preservation,54,31,23
8819,Dragonwench,sargeras,1101,evoker,preservation,22,13,9
8820,Geico,spinebreaker,1100,evoker,preservation,15,13,2
8821,Ilithiphobia,ghostlands,1100,evoker,preservation,38,16,22
8822,Ashandshadow,area-52,1099,evoker,preservation,68,30,38
8823,Daikis,proudmoore,1098,evoker,preservation,42,20,22
8824,Thegrinchh,malganis,1097,evoker,preservation,81,39,42
8825,Krossbones,cenarion-circle,1096,evoker,preservation,80,47,33
8826,Bayvoker,area-52,1093,evoker,preservation,56,29,27
8827,Shintrax,ragnaros,1092,evoker,preservation,46,23,23
8828,Abigaile,illidan,1088,evoker,preservation,24,17,7
8829,Emyhr,sargeras,1084,evoker,preservation,24,13,11
8830,Draisin,zuljin,1083,evoker,preservation,24,13,11
8831,Tryhard,wyrmrest-accord,1083,evoker,preservation,78,33,45
8832,Setash,hyjal,1081,evoker,preservation,24,12,12
8833,Clubmetro,boulderfist,1081,evoker,preservation,39,18,21
8834,Lahfly,tichondrius,1079,evoker,preservation,54,33,21
8835,Qiuhan,tichondrius,1076,evoker,preservation,48,23,25
8836,Lilithà,kelthuzad,1075,evoker,preservation,30,20,10
8837,Eldenkingy,sargeras,1074,evoker,preservation,40,12,28
8838,Bobstrasz,tichondrius,1073,evoker,preservation,36,12,24
8839,Bumbledragn,moon-guard,1071,evoker,preservation,37,23,14
8840,Maxyz,khadgar,1071,evoker,preservation,42,13,29
8841,Balmoze,tichondrius,1070,evoker,preservation,60,31,29
8842,Dragonknght,tichondrius,1066,evoker,preservation,30,16,14
8843,Draganoche,zuljin,1066,evoker,preservation,30,14,16
8844,Aspecto,area-52,1066,evoker,preservation,34,13,21
8845,Yozhz,ragnaros,1059,evoker,preservation,29,13,16
8846,Dragown,sargeras,1059,evoker,preservation,30,13,17
8847,Flybro,malganis,1056,evoker,preservation,18,11,7
8848,Binidragon,tichondrius,1055,evoker,preservation,12,11,1
8849,Yoyke,tichondrius,1055,evoker,preservation,24,11,13
8850,Slippee,mugthol,1051,evoker,preservation,12,11,1
8851,Imugee,sargeras,1051,evoker,preservation,24,11,13
8852,Mordrakhuul,chogall,1051,evoker,preservation,24,11,13
8853,Puraimaru,sargeras,1049,evoker,preservation,30,11,19
8854,Sacrementus,tichondrius,1049,evoker,preservation,48,14,34
8855,Smögg,quelthalas,1046,evoker,preservation,42,19,23
8856,Draghyon,tichondrius,1044,evoker,preservation,42,11,31
8857,Drittles,illidan,1043,evoker,preservation,62,28,34
8858,Drokula,darkspear,1042,evoker,preservation,24,11,13
8859,Uniqqe,tichondrius,1041,evoker,preservation,18,11,7
8860,Amnemís,tichondrius,1040,evoker,preservation,20,12,8
8861,Rynntynn,blood-furnace,1039,evoker,preservation,24,11,13
8862,Charadrius,zuljin,1038,evoker,preservation,41,23,18
8863,Deezdragon,stormrage,1037,evoker,preservation,18,11,7
8864,Myxter,tichondrius,1035,evoker,preservation,49,25,24
8865,Drgndeeznüts,tichondrius,1035,evoker,preservation,34,13,21
8866,Carloxd,tichondrius,1035,evoker,preservation,34,12,22
8867,Blankebr,gallywix,1032,evoker,preservation,36,24,12
8868,Droggerdrago,stormreaver,1031,evoker,preservation,18,11,7
8869,Degghurtni,area-52,1026,evoker,preservation,18,11,7
8870,Mokkdala,blackrock,1026,evoker,preservation,40,12,28
8871,Evoke,boulderfist,1025,evoker,preservation,28,12,16
8872,Sophdrac,illidan,1024,evoker,preservation,43,25,18
8873,Karmakulax,wildhammer,1024,evoker,preservation,31,12,19
8874,Vandinus,stormrage,1023,evoker,preservation,38,17,21
8875,Adessa,lothar,1020,evoker,preservation,36,14,22
8876,Ownlyfans,silvermoon,1018,evoker,preservation,24,12,12
8877,Prahvlord,shuhalo,1018,evoker,preservation,60,26,34
8878,Turukmakto,illidan,1017,evoker,preservation,29,14,15
8879,Mightywings,skywall,1011,evoker,preservation,138,70,68
8880,Richviewrd,illidan,1010,evoker,preservation,36,19,17
8881,Lightbeing,nazjatar,1001,evoker,preservation,48,29,19
8882,Brahown,altar-of-storms,998,evoker,preservation,36,11,25
8883,Dmuzh,drakkari,996,evoker,preservation,257,133,124
8884,Rubellite,azralon,995,evoker,preservation,47,21,26
8885,Shenrøn,altar-of-storms,994,evoker,preservation,32,17,15
8886,Gemis,anvilmar,991,evoker,preservation,55,25,30
8887,Hover,vashj,989,evoker,preservation,27,13,14
8888,Ozmayzin,proudmoore,989,evoker,preservation,63,27,36
8889,Items,frostmourne,987,evoker,preservation,22,11,11
8890,Vyreth,sargeras,987,evoker,preservation,81,38,43
8891,Arazerazer,thrall,984,evoker,preservation,66,23,43
8892,Trillis,eldrethalas,980,evoker,preservation,30,18,12
8893,Sïgrìd,tichondrius,979,evoker,preservation,27,19,8
8894,Zackxo,moon-guard,969,evoker,preservation,32,19,13
8895,Mesamune,bonechewer,969,evoker,preservation,61,23,38
8896,Echoker,destromath,968,evoker,preservation,55,26,29
8897,Milkspurt,tichondrius,962,evoker,preservation,52,23,29
8898,Solryp,terokkar,961,evoker,preservation,125,59,66
8899,Rubyzz,illidan,960,evoker,preservation,18,10,8
8900,Syraxiez,sargeras,960,evoker,preservation,18,10,8
8901,Seviant,tichondrius,960,evoker,preservation,18,10,8
8902,Uncleìroh,tichondrius,960,evoker,preservation,24,10,14
8903,Jnitoscaly,tichondrius,959,evoker,preservation,18,10,8
8904,Cripcuhz,tichondrius,959,evoker,preservation,48,21,27
8905,Spyrotime,tichondrius,959,evoker,preservation,27,10,17
8906,Puffthemagic,lightnings-blade,958,evoker,preservation,18,10,8
8907,Truffleßutta,tichondrius,958,evoker,preservation,18,10,8
8908,Dragonsand,area-52,958,evoker,preservation,62,30,32
8909,Xaxas,boulderfist,958,evoker,preservation,24,10,14
8910,Drakthussey,illidan,957,evoker,preservation,18,10,8
8911,Dokthyr,lightbringer,956,evoker,preservation,12,10,2
8912,Lazioo,frostmourne,956,evoker,preservation,18,10,8
8913,Kymoxien,sargeras,956,evoker,preservation,18,10,8
8914,Goonguy,gnomeregan,955,evoker,preservation,12,10,2
8915,Holdherhorn,area-52,955,evoker,preservation,18,10,8
8916,Dragy,bonechewer,954,evoker,preservation,24,10,14
8917,Hoverharder,stormrage,953,evoker,preservation,18,10,8
8918,Soziin,skullcrusher,953,evoker,preservation,18,10,8
8919,Proevoker,illidan,951,evoker,preservation,18,10,8
8920,Barneydragon,stormrage,949,evoker,preservation,18,10,8
8921,Wheyvern,malganis,949,evoker,preservation,57,19,38
8922,Ayavi,illidan,942,evoker,preservation,18,10,8
8923,Gidury,tichondrius,934,evoker,preservation,90,41,49
8924,Kivoke,proudmoore,934,evoker,preservation,36,14,22
8925,Faethana,thrall,929,evoker,preservation,23,11,12
8926,Azuril,wyrmrest-accord,929,evoker,preservation,90,29,61
8927,Dragonbro,spirestone,923,evoker,preservation,18,10,8
8928,Kersava,frostmourne,919,evoker,preservation,23,10,13
8929,Justbreathe,sargeras,911,evoker,preservation,17,10,7
8930,Saintetoile,tichondrius,905,evoker,preservation,48,24,24
8931,Badvoker,area-52,902,evoker,preservation,71,26,45
8932,Cransvoker,illidan,902,evoker,preservation,30,10,20
8933,Bandel,tichondrius,896,evoker,preservation,22,12,10
8934,Kerlaan,illidan,895,evoker,preservation,18,10,8
8935,Spitdafire,tichondrius,894,evoker,preservation,27,10,17
8936,Bizzstrasza,shadowsong,886,evoker,preservation,52,21,31
8937,Mugenyan,ragnaros,879,evoker,preservation,41,21,20
8938,Ayoitspav,malganis,872,evoker,preservation,19,10,9
8939,Willowflight,illidan,867,evoker,preservation,50,23,27
8940,Mikorivoker,illidan,864,evoker,preservation,12,9,3
8941,Mewoker,sargeras,864,evoker,preservation,12,9,3
8942,Dreamfuego,tichondrius,864,evoker,preservation,12,9,3
8943,Benbm,proudmoore,864,evoker,preservation,18,9,9
8944,Calvoker,moon-guard,864,evoker,preservation,18,9,9
8945,Yaaty,tichondrius,864,evoker,preservation,24,9,15
8946,Nuubvoker,stormrage,863,evoker,preservation,18,9,9
8947,Tonymanitoba,whisperwind,863,evoker,preservation,18,9,9
8948,Wonderk,frostmourne,863,evoker,preservation,18,9,9
8949,Velocivraull,malganis,862,evoker,preservation,12,9,3
8950,Gannsito,emerald-dream,862,evoker,preservation,18,9,9
8951,Xerithious,bleeding-hollow,862,evoker,preservation,18,9,9
8952,Kakanjutan,azralon,861,evoker,preservation,16,10,6
8953,Gravityblast,tichondrius,861,evoker,preservation,24,9,15
8954,Chewydragoon,kelthuzad,860,evoker,preservation,12,9,3
8955,Binxyboy,garrosh,860,evoker,preservation,16,10,6
8956,Flowsmoke,tichondrius,859,evoker,preservation,18,9,9
8957,Arûmat,tichondrius,859,evoker,preservation,30,9,21
8958,Bjason,tichondrius,855,evoker,preservation,18,9,9
8959,Kaeszandrus,azralon,855,evoker,preservation,18,9,9
8960,Darksmoke,spirestone,855,evoker,preservation,18,9,9
8961,Linabeauty,ragnaros,854,evoker,preservation,24,9,15
8962,Rorie,farstriders,850,evoker,preservation,18,9,9
8963,Moxa,doomhammer,850,evoker,preservation,83,41,42
8964,Moiraine,kargath,850,evoker,preservation,24,9,15
8965,Hentaizilla,kiljaeden,850,evoker,preservation,55,19,36
8966,Lickyertits,tichondrius,849,evoker,preservation,24,9,15
8967,Lechonlechon,tichondrius,847,evoker,preservation,12,9,3
8968,Orïon,azralon,845,evoker,preservation,24,9,15
8969,Nuunos,tichondrius,843,evoker,preservation,23,9,14
8970,Jesstrasza,quelthalas,835,evoker,preservation,60,25,35
8971,Decyrion,bleeding-hollow,830,evoker,preservation,29,9,20
8972,Dragndeez,garrosh,824,evoker,preservation,40,9,31
8973,Sandrozeria,wyrmrest-accord,822,evoker,preservation,14,10,4
8974,Drakthuul,icecrown,819,evoker,preservation,24,11,13
8975,Hlf,tichondrius,817,evoker,preservation,20,10,10
8976,Saintpablox,illidan,810,evoker,preservation,34,10,24
8977,Yaaj,black-dragonflight,808,evoker,preservation,23,10,13
8978,Dragginhealz,stormrage,802,evoker,preservation,71,31,40
8979,Darkspyro,area-52,799,evoker,preservation,11,9,2
8980,Azuragon,illidan,793,evoker,preservation,71,23,48
8981,Itsac,daggerspine,792,evoker,preservation,30,13,17
8982,Drackaras,stormrage,790,evoker,preservation,18,9,9
8983,Æsshayád,area-52,768,evoker,preservation,12,8,4
8984,Kaddyragon,mannoroth,768,evoker,preservation,12,8,4
8985,Ninereeds,malganis,768,evoker,preservation,12,8,4
8986,Hasstle,tichondrius,768,evoker,preservation,12,8,4
8987,Rvrbzv,stormrage,768,evoker,preservation,12,8,4
8988,Epsilon,laughing-skull,768,evoker,preservation,12,8,4
8989,Abevv,bonechewer,768,evoker,preservation,12,8,4
8990,Tigthyr,alleria,768,evoker,preservation,12,8,4
8991,Chañïng,frostmourne,768,evoker,preservation,18,8,10
8992,Babylons,area-52,768,evoker,preservation,18,8,10
8993,Draggin,barthilas,768,evoker,preservation,18,8,10
8994,Messyvok,illidan,768,evoker,preservation,18,8,10
8995,Airschlong,tichondrius,768,evoker,preservation,18,8,10
8996,Sheepdoll,icecrown,768,evoker,preservation,18,8,10
8997,Djvoker,zuljin,767,evoker,preservation,12,8,4
8998,Fluffelss,moon-guard,767,evoker,preservation,12,8,4
8999,Walloper,malganis,767,evoker,preservation,12,8,4
9000,Cadwaladr,frostmourne,767,evoker,preservation,12,8,4
9001,Venjolly,wyrmrest-accord,767,evoker,preservation,18,8,10
9002,Xiaolongmei,frostmourne,767,evoker,preservation,18,8,10
9003,Slèv,frostmourne,767,evoker,preservation,18,8,10
9004,Innervoker,tichondrius,767,evoker,preservation,18,8,10
9005,Nfts,darkspear,767,evoker,preservation,24,8,16
9006,Azarke,rivendare,767,evoker,preservation,24,8,16
9007,Chue,quelthalas,766,evoker,preservation,18,8,10
9008,Nutsdragon,tichondrius,763,evoker,preservation,18,8,10
9009,Wrathiøn,sargeras,763,evoker,preservation,24,8,16
9010,Matsutake,kelthuzad,762,evoker,preservation,18,8,10
9011,Tarnuss,skullcrusher,761,evoker,preservation,24,8,16
9012,Draehgor,hyjal,758,evoker,preservation,18,8,10
9013,Crumbflaps,kelthuzad,758,evoker,preservation,24,8,16
9014,Lervish,durotan,755,evoker,preservation,12,8,4
9015,Tooby,velen,751,evoker,preservation,12,8,4
9016,Drevoker,lightbringer,748,evoker,preservation,18,8,10
9017,Criteria,burning-legion,748,evoker,preservation,18,8,10
9018,Madvillin,stormrage,747,evoker,preservation,12,8,4
9019,Zaldraka,cairne,739,evoker,preservation,20,9,11
9020,Furygos,stormrage,735,evoker,preservation,17,8,9
9021,Durtyvoker,illidan,735,evoker,preservation,22,8,14
9022,Butta,darkspear,734,evoker,preservation,17,8,9
9023,Enuzan,dalaran,734,evoker,preservation,32,8,24
9024,Polland,area-52,731,evoker,preservation,17,8,9
9025,Icthelestron,black-dragonflight,729,evoker,preservation,14,9,5
9026,Geicovoker,tichondrius,714,evoker,preservation,28,9,19
9027,Shardsnorta,chogall,708,evoker,preservation,17,8,9
9028,Tëssarion,quelthalas,704,evoker,preservation,26,10,16
9029,Wilbog,moon-guard,700,evoker,preservation,44,10,34
9030,Letharrian,sargeras,698,evoker,preservation,12,10,2
9031,Razen,silvermoon,692,evoker,preservation,16,8,8
9032,Orame,dalaran,685,evoker,preservation,25,8,17
9033,Venlormi,moon-guard,675,evoker,preservation,46,15,31
9034,Beatxqt,area-52,672,evoker,preservation,12,7,5
9035,Vroomby,area-52,672,evoker,preservation,12,7,5
9036,Whelp,shadow-council,672,evoker,preservation,12,7,5
9037,Goursaud,malganis,672,evoker,preservation,12,7,5
9038,Lilrandal,emerald-dream,672,evoker,preservation,12,7,5
9039,Slrepeat,frostmourne,672,evoker,preservation,12,7,5
9040,Skrimbles,tichondrius,672,evoker,preservation,12,7,5
9041,Iantern,dalaran,672,evoker,preservation,12,7,5
9042,Dzdv,stormrage,672,evoker,preservation,12,7,5
9043,Vrondiss,trollbane,672,evoker,preservation,12,7,5
9044,Clm,staghelm,672,evoker,preservation,12,7,5
9045,Fionyan,proudmoore,672,evoker,preservation,12,7,5
9046,Iamg,stormscale,672,evoker,preservation,18,7,11
9047,Darchomp,illidan,672,evoker,preservation,18,7,11
9048,Soyum,sargeras,672,evoker,preservation,18,7,11
9049,Orncen,emerald-dream,672,evoker,preservation,18,7,11
9050,Draikia,zuljin,672,evoker,preservation,18,7,11
9051,Toastsevoker,tichondrius,672,evoker,preservation,18,7,11
9052,Briggsybear,malganis,672,evoker,preservation,18,7,11
9053,Gaslightqt,tichondrius,672,evoker,preservation,19,7,12
9054,Hdyl,tichondrius,672,evoker,preservation,24,7,17
9055,Kontaz,icecrown,672,evoker,preservation,24,7,17
9056,Reskue,burning-legion,671,evoker,preservation,12,7,5
9057,Forlornomens,area-52,671,evoker,preservation,12,7,5
9058,Flapthewap,illidan,671,evoker,preservation,12,7,5
9059,Vertorgon,proudmoore,671,evoker,preservation,12,7,5
9060,Spicypnuts,zuljin,671,evoker,preservation,12,7,5
9061,Matchamjölk,tichondrius,671,evoker,preservation,12,7,5
9062,Boomlvx,frostmourne,671,evoker,preservation,12,7,5
9063,Toppedyouoff,thrall,671,evoker,preservation,15,7,8
9064,Longxx,dalaran,671,evoker,preservation,18,7,11
9065,Lampizard,bonechewer,671,evoker,preservation,24,7,17
9066,Bookkoo,burning-legion,671,evoker,preservation,24,7,17
9067,Rayvoker,elune,670,evoker,preservation,12,7,5
9068,Mad,aerie-peak,670,evoker,preservation,19,9,10
9069,Woozul,malganis,670,evoker,preservation,30,7,23
9070,Deezyroller,sargeras,669,evoker,preservation,12,7,5
9071,Dragonballer,trollbane,669,evoker,preservation,18,7,11
9072,Retcondragon,sargeras,669,evoker,preservation,18,7,11
9073,Rainwalkers,illidan,666,evoker,preservation,12,7,5
9074,Rilex,kelthuzad,666,evoker,preservation,12,7,5
9075,Azulnova,tichondrius,665,evoker,preservation,18,7,11
9076,Pypokay,nemesis,665,evoker,preservation,18,7,11
9077,Acidbreath,tichondrius,661,evoker,preservation,18,7,11
9078,Straightman,stormrage,661,evoker,preservation,18,7,11
9079,Falsedaze,sargeras,655,evoker,preservation,18,7,11
9080,Yiptondabs,emerald-dream,650,evoker,preservation,29,7,22
9081,Thenasath,sargeras,640,evoker,preservation,17,7,10
9082,Dreamvisage,silvermoon,638,evoker,preservation,14,8,6
9083,Ramas,burning-blade,638,evoker,preservation,32,8,24
9084,Elderdragon,nerzhul,629,evoker,preservation,16,8,8
9085,Kixxely,sargeras,623,evoker,preservation,12,8,4
9086,Terpsy,area-52,620,evoker,preservation,11,7,4
9087,Kilawatt,barthilas,620,evoker,preservation,11,7,4
9088,Tsuruda,illidan,618,evoker,preservation,21,8,13
9089,Gdragons,tichondrius,607,evoker,preservation,11,7,4
9090,Saxthyr,stormreaver,592,evoker,preservation,13,7,6
9091,Ambadragon,frostmourne,591,evoker,preservation,11,7,4
9092,Cheesedragon,tichondrius,576,evoker,preservation,6,6,0
9093,Hwansu,tichondrius,576,evoker,preservation,6,6,0
9094,Tatsurai,tichondrius,576,evoker,preservation,10,7,3
9095,Baldpython,area-52,576,evoker,preservation,12,6,6
9096,Ozvoker,area-52,576,evoker,preservation,12,6,6
9097,Diregon,kelthuzad,576,evoker,preservation,12,6,6
9098,Oldgeorge,tichondrius,576,evoker,preservation,12,6,6
9099,Kwaz,kelthuzad,576,evoker,preservation,12,6,6
9100,Wtfhappen,tichondrius,576,evoker,preservation,12,6,6
9101,Dragonman,twisting-nether,576,evoker,preservation,12,6,6
9102,Localfemboy,area-52,576,evoker,preservation,12,6,6
9103,Thegoone,bleeding-hollow,576,evoker,preservation,12,6,6
9104,Teëst,malganis,576,evoker,preservation,12,6,6
9105,Ccguzzlerx,tichondrius,576,evoker,preservation,12,6,6
9106,Saviorkai,barthilas,576,evoker,preservation,12,6,6
9107,Uneedawhip,zuljin,576,evoker,preservation,12,6,6
9108,Whitesnow,korgath,576,evoker,preservation,12,6,6
9109,Daylenx,thrall,576,evoker,preservation,12,6,6
9110,Theyevokbuda,kelthuzad,576,evoker,preservation,12,6,6
9111,Bookwyrm,khadgar,576,evoker,preservation,12,6,6
9112,Datinysmaug,stormrage,576,evoker,preservation,12,6,6
9113,Talzindera,sargeras,576,evoker,preservation,12,6,6
9114,Teddydarg,tichondrius,576,evoker,preservation,14,6,8
9115,Murphymonsta,stormscale,576,evoker,preservation,18,6,12
9116,Dragonk,dragonblight,576,evoker,preservation,18,6,12
9117,Phanthyr,tichondrius,576,evoker,preservation,18,6,12
9118,Meepslol,kiljaeden,576,evoker,preservation,18,6,12
9119,Flyingmooie,frostmourne,576,evoker,preservation,24,6,18
9120,Ryloun,sargeras,576,evoker,preservation,24,6,18
9121,Toodllesz,stormrage,575,evoker,preservation,6,6,0
9122,Crayonshinch,tichondrius,575,evoker,preservation,12,6,6
9123,Nâpâlm,aggramar,575,evoker,preservation,12,6,6
9124,Drakistraz,draenor,575,evoker,preservation,12,6,6
9125,Valadrakth,tichondrius,575,evoker,preservation,12,6,6
9126,Tekath,altar-of-storms,575,evoker,preservation,12,6,6
9127,Magnito,thorium-brotherhood,575,evoker,preservation,12,6,6
9128,Valeshkanyel,ragnaros,575,evoker,preservation,12,6,6
9129,Shinryuu,warsong,575,evoker,preservation,12,6,6
9130,Bhfflove,area-52,575,evoker,preservation,12,6,6
9131,Flameschosen,malganis,575,evoker,preservation,12,6,6
9132,Madzul,emerald-dream,575,evoker,preservation,12,6,6
9133,Skkuld,stormrage,575,evoker,preservation,12,6,6
9134,Tokeandvoke,haomarush,575,evoker,preservation,12,6,6
9135,Dragonpaws,illidan,575,evoker,preservation,12,6,6
9136,Moiraine,frostwolf,575,evoker,preservation,18,6,12
9137,Naùghtygames,area-52,575,evoker,preservation,18,6,12
9138,Sgtskip,blackrock,575,evoker,preservation,24,6,18
9139,Kyloflight,thrall,575,evoker,preservation,24,6,18
9140,Toothless,garithos,574,evoker,preservation,6,6,0
9141,Amun,frostwolf,574,evoker,preservation,12,6,6
9142,Zascar,stormrage,574,evoker,preservation,12,6,6
9143,Cinderazerat,moon-guard,574,evoker,preservation,18,6,12
9144,Azalana,thrall,574,evoker,preservation,24,6,18
9145,Rzdrag,nemesis,574,evoker,preservation,36,6,30
9146,Moraise,bonechewer,573,evoker,preservation,12,6,6
9147,Ozsandlbs,tichondrius,573,evoker,preservation,12,6,6
9148,Siquitraki,illidan,573,evoker,preservation,18,6,12
9149,Mulutlaser,frostmourne,570,evoker,preservation,12,6,6
9150,Lishalthen,frostmourne,569,evoker,preservation,12,6,6
9151,Rhaeynes,moon-guard,568,evoker,preservation,12,6,6
9152,Ankhalagor,ragnaros,567,evoker,preservation,12,6,6
9153,Preservant,stormrage,567,evoker,preservation,12,6,6
9154,Dragussy,illidan,548,evoker,preservation,28,10,18
9155,Hecklinheals,hyjal,544,evoker,preservation,13,7,6
9156,Hexavalent,tichondrius,542,evoker,preservation,11,6,5
9157,Arazen,frostmourne,539,evoker,preservation,23,6,17
9158,Spliffdragon,sargeras,528,evoker,preservation,17,6,11
9159,Fieros,area-52,527,evoker,preservation,13,6,7
9160,Imperialist,proudmoore,522,evoker,preservation,29,7,22
9161,Shenlòng,drakkari,521,evoker,preservation,15,7,8
9162,Akavoker,sargeras,521,evoker,preservation,20,7,13
9163,Supernovax,illidan,512,evoker,preservation,16,6,10
9164,Imaginedrgn,tichondrius,511,evoker,preservation,11,6,5
9165,Nwo,shattered-hand,494,evoker,preservation,11,6,5
9166,Brindletail,proudmoore,494,evoker,preservation,19,6,13
9167,Allevesh,shadow-council,480,evoker,preservation,6,5,1
9168,Arzaria,stormrage,480,evoker,preservation,6,5,1
9169,Lizardfaith,tichondrius,480,evoker,preservation,6,5,1
9170,Finnahorns,sargeras,480,evoker,preservation,6,5,1
9171,Chinadragon,balnazzar,480,evoker,preservation,6,5,1
9172,Whelpling,cenarion-circle,480,evoker,preservation,6,5,1
9173,Neewhad,malganis,480,evoker,preservation,12,5,7
9174,Fazedd,tichondrius,480,evoker,preservation,12,5,7
9175,Cirroaltos,aerie-peak,480,evoker,preservation,12,5,7
9176,Shazdrag,stormrage,480,evoker,preservation,12,5,7
9177,Supernamv,sargeras,480,evoker,preservation,12,5,7
9178,Evizzar,zuljin,480,evoker,preservation,12,5,7
9179,Hicane,tichondrius,480,evoker,preservation,12,5,7
9180,Oldmandrake,mannoroth,480,evoker,preservation,12,5,7
9181,Evvookkeerr,tichondrius,480,evoker,preservation,12,5,7
9182,Hageiz,tichondrius,480,evoker,preservation,12,5,7
9183,Imwoker,illidan,480,evoker,preservation,12,5,7
9184,Cutewing,tichondrius,480,evoker,preservation,12,5,7
9185,Chronocolter,thunderhorn,480,evoker,preservation,12,5,7
9186,Spyroguts,thrall,480,evoker,preservation,12,5,7
9187,Salusx,proudmoore,480,evoker,preservation,12,5,7
9188,Draktharl,tichondrius,480,evoker,preservation,12,5,7
9189,Roastdrake,tichondrius,480,evoker,preservation,12,5,7
9190,Aetherz,illidan,480,evoker,preservation,18,5,13
9191,Cruv,boulderfist,480,evoker,preservation,18,5,13
9192,Olindoe,tichondrius,480,evoker,preservation,18,5,13
9193,Selenian,area-52,480,evoker,preservation,24,5,19
9194,Bronyflexy,sargeras,480,evoker,preservation,24,5,19
9195,Bvo,stormrage,479,evoker,preservation,6,5,1
9196,Gemish,lethon,479,evoker,preservation,6,5,1
9197,Prevoker,kirin-tor,479,evoker,preservation,6,5,1
9198,Dracdeez,dreadmaul,479,evoker,preservation,12,5,7
9199,Selden,boulderfist,479,evoker,preservation,12,5,7
9200,Álln,sargeras,479,evoker,preservation,12,5,7
9201,Kratostrasz,moon-guard,479,evoker,preservation,12,5,7
9202,Wrathykos,thrall,479,evoker,preservation,12,5,7
9203,Cootietooter,icecrown,479,evoker,preservation,12,5,7
9204,Drizzydrag,jubeithos,479,evoker,preservation,12,5,7
9205,Rhaènyra,sargeras,479,evoker,preservation,12,5,7
9206,Drektar,the-scryers,479,evoker,preservation,12,5,7
9207,Lazzarross,area-52,479,evoker,preservation,12,5,7
9208,Maldormu,stormrage,479,evoker,preservation,12,5,7
9209,Cindermint,mugthol,479,evoker,preservation,14,5,9
9210,Bitkoinz,tichondrius,479,evoker,preservation,18,5,13
9211,Dracomedicus,frostmourne,479,evoker,preservation,22,5,17
9212,Lizardtrash,ragnaros,478,evoker,preservation,12,5,7
9213,Melbu,thunderlord,478,evoker,preservation,12,5,7
9214,Aurastella,frostwolf,478,evoker,preservation,12,5,7
9215,Scaryðragon,akama,477,evoker,preservation,12,5,7
9216,Livemaximii,moon-guard,477,evoker,preservation,12,5,7
9217,Dracoly,medivh,476,evoker,preservation,12,5,7
9218,Tazeneth,sargeras,476,evoker,preservation,12,5,7
9219,Interracial,stormscale,475,evoker,preservation,10,6,4
9220,Lisatallie,moon-guard,475,evoker,preservation,12,5,7
9221,Kaelestian,ragnaros,473,evoker,preservation,12,5,7
9222,Amoraz,tichondrius,460,evoker,preservation,23,5,18
9223,Jcii,tichondrius,447,evoker,preservation,11,5,6
9224,Enoch,chogall,440,evoker,preservation,21,7,14
9225,Got,burning-blade,432,evoker,preservation,9,5,4
9226,Bootymágic,tichondrius,431,evoker,preservation,9,6,3
9227,Temporal,mannoroth,431,evoker,preservation,9,6,3
9228,Gaserick,quelthalas,426,evoker,preservation,17,6,11
9229,Soukizilla,sargeras,416,evoker,preservation,10,5,5
9230,Tealik,frostmourne,416,evoker,preservation,16,5,11
9231,Monzydrake,emerald-dream,408,evoker,preservation,20,5,15
9232,Velahesa,sargeras,384,evoker,preservation,6,4,2
9233,Atraxian,tichondrius,384,evoker,preservation,6,4,2
9234,Docevoker,tichondrius,384,evoker,preservation,6,4,2
9235,Mtndewboy,illidan,384,evoker,preservation,6,4,2
9236,Syneestra,nemesis,384,evoker,preservation,6,4,2
9237,Ygnizem,ysera,384,evoker,preservation,6,4,2
9238,Smnsevoker,emerald-dream,384,evoker,preservation,6,4,2
9239,Jëthrø,illidan,384,evoker,preservation,6,4,2
9240,Murloc,shadowsong,384,evoker,preservation,6,4,2
9241,Ancalagðn,quelthalas,384,evoker,preservation,6,4,2
9242,Tygor,arthas,384,evoker,preservation,6,4,2
9243,Taegon,area-52,384,evoker,preservation,6,4,2
9244,Baradad,frostmourne,384,evoker,preservation,6,4,2
9245,Dyvyne,demon-soul,384,evoker,preservation,6,4,2
9246,Yessirs,shadow-council,384,evoker,preservation,6,4,2
9247,Bassblasterr,dalaran,384,evoker,preservation,6,4,2
9248,Niraz,dalaran,384,evoker,preservation,6,4,2
9249,Setrazen,illidan,384,evoker,preservation,6,4,2
9250,Exrtj,stormrage,384,evoker,preservation,6,4,2
9251,Kharizard,moon-guard,384,evoker,preservation,6,4,2
9252,Azurgos,proudmoore,384,evoker,preservation,6,4,2
9253,Dragoontekka,tichondrius,384,evoker,preservation,6,4,2
9254,Nøzmosis,area-52,384,evoker,preservation,6,4,2
9255,Swanzea,sargeras,384,evoker,preservation,6,4,2
9256,Venitsu,malganis,384,evoker,preservation,6,4,2
9257,Treysongz,area-52,384,evoker,preservation,6,4,2
9258,Spaceox,tichondrius,384,evoker,preservation,6,4,2
9259,Zaedor,stormrage,384,evoker,preservation,10,5,5
9260,Mvpjs,medivh,384,evoker,preservation,8,4,4
9261,Mignificent,sargeras,384,evoker,preservation,12,4,8
9262,Dragwyn,senjin,384,evoker,preservation,12,4,8
9263,Raphdragon,stormrage,384,evoker,preservation,12,4,8
9264,Donresantis,tichondrius,384,evoker,preservation,12,4,8
9265,Boppled,tichondrius,384,evoker,preservation,12,4,8
9266,Pensini,illidan,384,evoker,preservation,12,4,8
9267,Bryágh,wyrmrest-accord,384,evoker,preservation,12,4,8
9268,Psyydragon,azralon,384,evoker,preservation,12,4,8
9269,Oldui,frostmourne,384,evoker,preservation,12,4,8
9270,Vanyalus,uldum,384,evoker,preservation,12,4,8
9271,Yujirohanma,frostmourne,384,evoker,preservation,12,4,8
9272,Crumbsock,thrall,384,evoker,preservation,12,4,8
9273,Shoestrings,tichondrius,384,evoker,preservation,12,4,8
9274,Flipturn,illidan,384,evoker,preservation,12,4,8
9275,Dragrenghost,illidan,384,evoker,preservation,12,4,8
9276,Williamjong,tichondrius,384,evoker,preservation,12,4,8
9277,Imadargin,malganis,384,evoker,preservation,12,4,8
9278,Rawrexp,emerald-dream,384,evoker,preservation,12,4,8
9279,Galrend,firetree,384,evoker,preservation,12,4,8
9280,Satratren,moon-guard,384,evoker,preservation,12,4,8
9281,Upsdriver,dentarg,384,evoker,preservation,18,4,14
9282,Aceu,bloodhoof,383,evoker,preservation,6,4,2
9283,Xdragon,lightbringer,383,evoker,preservation,12,4,8
9284,Tihkal,spinebreaker,383,evoker,preservation,12,4,8
9285,Quesovoke,eldrethalas,383,evoker,preservation,12,4,8
9286,Dombi,moon-guard,383,evoker,preservation,12,4,8
9287,Flymuch,illidan,383,evoker,preservation,12,4,8
9288,Lunearia,stormrage,383,evoker,preservation,12,4,8
9289,Zeldaryel,azralon,382,evoker,preservation,6,4,2
9290,Tribunalis,stormrage,382,evoker,preservation,6,4,2
9291,Bigtoots,illidan,382,evoker,preservation,12,4,8
9292,Frozonic,tichondrius,381,evoker,preservation,12,4,8
9293,Danatreseth,moon-guard,380,evoker,preservation,12,4,8
9294,Ragendragon,hellscream,377,evoker,preservation,18,4,14
9295,Nyxstrasza,moknathal,366,evoker,preservation,11,4,7
9296,Snailor,eldrethalas,351,evoker,preservation,10,4,6
9297,Annazara,stormrage,336,evoker,preservation,9,4,5
9298,Zathasar,tichondrius,333,evoker,preservation,28,4,24
9299,Rápturé,tichondrius,330,evoker,preservation,16,7,9
9300,Corlys,thunderhorn,330,evoker,preservation,17,5,12
9301,Homiedraconi,nordrassil,329,evoker,preservation,12,5,7
9302,Jolynne,illidan,320,evoker,preservation,14,4,10
9303,Vlysage,dark-iron,319,evoker,preservation,5,4,1
9304,Wtsgoldpst,tichondrius,319,evoker,preservation,8,4,4
9305,Lantur,perenolde,319,evoker,preservation,16,4,12
9306,Polyrhythmic,ysera,304,evoker,preservation,7,4,3
9307,Kheeleesi,illidan,288,evoker,preservation,6,3,3
9308,Bigtitsdrag,illidan,288,evoker,preservation,6,3,3
9309,Dragonleaves,sargeras,288,evoker,preservation,6,3,3
9310,Dragonsama,area-52,288,evoker,preservation,6,3,3
9311,Dimpulse,zuljin,288,evoker,preservation,6,3,3
9312,Flexlong,tichondrius,288,evoker,preservation,6,3,3
9313,Predacious,draktharon,288,evoker,preservation,6,3,3
9314,Golden,area-52,288,evoker,preservation,6,3,3
9315,Swagdriver,moon-guard,288,evoker,preservation,6,3,3
9316,Æg,zuljin,288,evoker,preservation,6,3,3
9317,Jokko,moon-guard,288,evoker,preservation,6,3,3
9318,Draislyn,cenarion-circle,288,evoker,preservation,6,3,3
9319,Cônflicted,emerald-dream,288,evoker,preservation,6,3,3
9320,Dracoon,madoran,288,evoker,preservation,6,3,3
9321,Dracritzzx,ragnaros,288,evoker,preservation,6,3,3
9322,Setren,antonidas,288,evoker,preservation,6,3,3
9323,Thendetra,mannoroth,288,evoker,preservation,6,3,3
9324,Karuikei,proudmoore,288,evoker,preservation,6,3,3
9325,Vaeghar,anvilmar,288,evoker,preservation,6,3,3
9326,Draseew,drakkari,288,evoker,preservation,6,3,3
9327,Bad,nerzhul,288,evoker,preservation,6,3,3
9328,Rangä,caelestrasz,288,evoker,preservation,6,3,3
9329,Redhorn,frostmourne,288,evoker,preservation,6,3,3
9330,Heidibibe,tichondrius,288,evoker,preservation,6,3,3
9331,Simplerules,zuljin,288,evoker,preservation,6,3,3
9332,Icallthecops,tichondrius,288,evoker,preservation,6,3,3
9333,Garrgle,sargeras,288,evoker,preservation,6,3,3
9334,Paradïsso,tichondrius,288,evoker,preservation,6,3,3
9335,Vygrax,nerzhul,288,evoker,preservation,6,3,3
9336,Raxdragon,sargeras,288,evoker,preservation,6,3,3
9337,Jakburnon,stormrage,288,evoker,preservation,6,3,3
9338,Knowragretz,tichondrius,288,evoker,preservation,6,3,3
9339,Spyrä,moon-guard,288,evoker,preservation,6,3,3
9340,Jamörant,tichondrius,288,evoker,preservation,6,3,3
9341,Ðçßñÿåæéîùøð,tichondrius,288,evoker,preservation,6,3,3
9342,Kreutzhauser,tichondrius,288,evoker,preservation,6,3,3
9343,Chawp,tichondrius,288,evoker,preservation,6,3,3
9344,Gvoker,nemesis,288,evoker,preservation,6,3,3
9345,Flappeebird,area-52,288,evoker,preservation,6,3,3
9346,Lìthium,frostmourne,288,evoker,preservation,6,3,3
9347,Halcyonxz,tichondrius,288,evoker,preservation,6,3,3
9348,Vokefuu,illidan,288,evoker,preservation,6,3,3
9349,Dragonblazer,illidan,288,evoker,preservation,6,3,3
9350,Ruffee,frostmourne,288,evoker,preservation,6,3,3
9351,Unclelroh,kelthuzad,288,evoker,preservation,6,3,3
9352,Evoketage,malganis,288,evoker,preservation,6,3,3
9353,Sylvee,bleeding-hollow,288,evoker,preservation,7,3,4
9354,Westyvoker,arthas,288,evoker,preservation,12,3,9
9355,Explosives,blades-edge,288,evoker,preservation,12,3,9
9356,Tyrannicull,sargeras,288,evoker,preservation,12,3,9
9357,Raegon,wyrmrest-accord,288,evoker,preservation,12,3,9
9358,Drakkar,elune,288,evoker,preservation,12,3,9
9359,Elurb,illidan,288,evoker,preservation,12,3,9
9360,Ahahaa,frostmourne,288,evoker,preservation,12,3,9
9361,Velzelya,zuljin,288,evoker,preservation,12,3,9
9362,Dwacawys,zuljin,288,evoker,preservation,12,3,9
9363,Teldormu,drenden,288,evoker,preservation,12,3,9
9364,Vandornomu,illidan,288,evoker,preservation,12,3,9
9365,Cøømbuya,sargeras,288,evoker,preservation,12,3,9
9366,Vxfire,sargeras,288,evoker,preservation,12,3,9
9367,Hel,stormrage,288,evoker,preservation,12,3,9
9368,Zumanitÿ,zangarmarsh,288,evoker,preservation,12,3,9
9369,Snáckbóx,alexstrasza,288,evoker,preservation,12,3,9
9370,Stormdagger,proudmoore,288,evoker,preservation,12,3,9
9371,Galfiore,malganis,288,evoker,preservation,12,3,9
9372,Dragonbabu,area-52,288,evoker,preservation,12,3,9
9373,Deàthwing,proudmoore,288,evoker,preservation,12,3,9
9374,Discussion,area-52,288,evoker,preservation,12,3,9
9375,Jammstraza,skywall,288,evoker,preservation,12,3,9
9376,Reflexd,malganis,288,evoker,preservation,12,3,9
9377,Fugginuhh,proudmoore,288,evoker,preservation,12,3,9
9378,Jumpmaster,black-dragonflight,288,evoker,preservation,12,3,9
9379,Simmnyxia,area-52,288,evoker,preservation,12,3,9
9380,Mouthgorawr,tichondrius,288,evoker,preservation,13,3,10
9381,Wapowthion,blades-edge,288,evoker,preservation,18,3,15
9382,Windchaser,kelthuzad,288,evoker,preservation,18,3,15
9383,Rogir,zuljin,288,evoker,preservation,18,3,15
9384,Rizzanomics,zuljin,287,evoker,preservation,8,4,4
9385,Retroo,dark-iron,287,evoker,preservation,6,3,3
9386,Killerdragon,darkspear,287,evoker,preservation,6,3,3
9387,Notvez,bleeding-hollow,287,evoker,preservation,6,3,3
9388,Supereragon,area-52,287,evoker,preservation,6,3,3
9389,Dracorblaq,bleeding-hollow,287,evoker,preservation,6,3,3
9390,Saphfire,burning-legion,287,evoker,preservation,6,3,3
9391,Draktarion,ragnaros,287,evoker,preservation,12,3,9
9392,Dragoreo,illidan,287,evoker,preservation,12,3,9
9393,Tazen,bleeding-hollow,287,evoker,preservation,12,3,9
9394,Chenrong,sargeras,287,evoker,preservation,12,3,9
9395,Toothlesz,draka,287,evoker,preservation,18,3,15
9396,Kalistro,quelthalas,286,evoker,preservation,6,3,3
9397,Lawroadt,tichondrius,286,evoker,preservation,12,3,9
9398,Drakonyx,mugthol,285,evoker,preservation,12,3,9
9399,Arazarion,mugthol,285,evoker,preservation,12,3,9
9400,Jsb,moon-guard,282,evoker,preservation,30,3,27
9401,Uskrait,tichondrius,255,evoker,preservation,14,4,10
9402,Stíckyj,tichondrius,255,evoker,preservation,11,3,8
9403,Dragontamz,the-forgotten-coast,239,evoker,preservation,5,3,2
9404,Slashprovoke,frostmourne,239,evoker,preservation,5,3,2
9405,Tailia,sargeras,239,evoker,preservation,11,3,8
9406,Tugmapvpean,kelthuzad,208,evoker,preservation,7,3,4
9407,Lëåf,area-52,192,evoker,preservation,6,2,4
9408,Flappyboy,bleeding-hollow,192,evoker,preservation,6,2,4
9409,Kcwt,illidan,192,evoker,preservation,6,2,4
9410,Dwagonwage,zuljin,192,evoker,preservation,6,2,4
9411,Invdkill,azralon,192,evoker,preservation,6,2,4
9412,Smurgma,frostmane,192,evoker,preservation,6,2,4
9413,Dscim,zuljin,192,evoker,preservation,6,2,4
9414,Jessefurr,undermine,192,evoker,preservation,6,2,4
9415,Nite,lothar,192,evoker,preservation,6,2,4
9416,Wse,illidan,192,evoker,preservation,6,2,4
9417,Sketchybum,tichondrius,192,evoker,preservation,6,2,4
9418,Drugdoer,illidan,192,evoker,preservation,6,2,4
9419,Nil,malganis,192,evoker,preservation,6,2,4
9420,Racovoker,zuljin,192,evoker,preservation,6,2,4
9421,Carrnedge,area-52,192,evoker,preservation,6,2,4
9422,Slaymedaddy,proudmoore,192,evoker,preservation,6,2,4
9423,Ndr,proudmoore,192,evoker,preservation,6,2,4
9424,Tagritash,kelthuzad,192,evoker,preservation,6,2,4
9425,Scyyterr,azralon,192,evoker,preservation,6,2,4
9426,Nunez,frostmourne,192,evoker,preservation,6,2,4
9427,Lexazule,bleeding-hollow,192,evoker,preservation,6,2,4
9428,Preserveluke,moon-guard,192,evoker,preservation,6,2,4
9429,Surasi,frostmourne,192,evoker,preservation,6,2,4
9430,Froky,stormrage,192,evoker,preservation,6,2,4
9431,Hochelaga,arthas,192,evoker,preservation,6,2,4
9432,Ignicion,quelthalas,192,evoker,preservation,6,2,4
9433,Drakhaz,azralon,192,evoker,preservation,6,2,4
9434,Alexevoker,tichondrius,192,evoker,preservation,6,2,4
9435,Syfen,burning-blade,192,evoker,preservation,6,2,4
9436,Zandet,thunderlord,192,evoker,preservation,6,2,4
9437,Daemon,terokkar,192,evoker,preservation,6,2,4
9438,Conorvokes,tichondrius,192,evoker,preservation,6,2,4
9439,Koopa,malygos,192,evoker,preservation,6,2,4
9440,Sekidrac,ragnaros,192,evoker,preservation,6,2,4
9441,Astaro,area-52,192,evoker,preservation,6,2,4
9442,Dracthott,thrall,192,evoker,preservation,6,2,4
9443,Altevoker,frostmourne,192,evoker,preservation,6,2,4
9444,Exiztx,tichondrius,192,evoker,preservation,6,2,4
9445,Kalrid,sargeras,192,evoker,preservation,6,2,4
9446,Ashgaar,sargeras,192,evoker,preservation,6,2,4
9447,Stickvoker,sargeras,192,evoker,preservation,6,2,4
9448,Oatmealneil,bleeding-hollow,192,evoker,preservation,10,2,8
9449,Shellybelly,shadowmoon,192,evoker,preservation,12,2,10
9450,Contractor,emerald-dream,192,evoker,preservation,12,2,10
9451,Arkaan,malganis,192,evoker,preservation,12,2,10
9452,Zalpx,sargeras,192,evoker,preservation,12,2,10
9453,Hotblower,tichondrius,192,evoker,preservation,12,2,10
9454,Takasaki,dalaran,192,evoker,preservation,12,2,10
9455,Drakthyrmonk,hyjal,192,evoker,preservation,12,2,10
9456,Djornmustman,sargeras,192,evoker,preservation,12,2,10
9457,Shockragosa,chogall,192,evoker,preservation,12,2,10
9458,Dragonarchy,draenor,192,evoker,preservation,12,2,10
9459,Ceraxxes,tichondrius,192,evoker,preservation,12,2,10
9460,Tightp,malganis,192,evoker,preservation,12,2,10
9461,Toyatoki,stormrage,192,evoker,preservation,12,2,10
9462,Luxxa,bloodhoof,192,evoker,preservation,12,2,10
9463,Timecøp,zuljin,192,evoker,preservation,12,2,10
9464,Olesmokey,tichondrius,192,evoker,preservation,12,2,10
9465,Dadydafather,sargeras,192,evoker,preservation,24,2,22
9466,Valethal,ragnaros,191,evoker,preservation,6,2,4
9467,Dracalis,thrall,191,evoker,preservation,6,2,4
9468,Spyrð,emerald-dream,191,evoker,preservation,6,2,4
9469,Draxitar,blackrock,191,evoker,preservation,6,2,4
9470,Lacost,area-52,191,evoker,preservation,6,2,4
9471,Sodre,illidan,191,evoker,preservation,12,2,10
9472,Shadowyasuke,area-52,191,evoker,preservation,12,2,10
9473,Evooern,frostmourne,175,evoker,preservation,11,2,9
9474,Devokerkofwa,tichondrius,159,evoker,preservation,5,2,3
9475,Jetthryx,emerald-dream,159,evoker,preservation,11,2,9
9476,Dragonbush,sargeras,138,evoker,preservation,10,3,7
9477,Shíkyo,stormrage,138,evoker,preservation,20,3,17
9478,Lendren,sargeras,128,evoker,preservation,10,2,8
9479,Dragoondeez,bleeding-hollow,96,evoker,preservation,3,2,1
9480,Hutterbut,malganis,96,evoker,preservation,3,2,1
9481,Nivekk,zuljin,96,evoker,preservation,6,1,5
9482,Myjewelshurt,stormrage,96,evoker,preservation,6,1,5
9483,Dragnips,bleeding-hollow,96,evoker,preservation,6,1,5
9484,Iamthêt,sargeras,96,evoker,preservation,6,1,5
9485,Freeblaze,blackhand,96,evoker,preservation,6,1,5
9486,Mookthyr,area-52,96,evoker,preservation,6,1,5
9487,Patrdorasz,zuljin,96,evoker,preservation,6,1,5
9488,Neroker,malganis,96,evoker,preservation,6,1,5
9489,Ohmylanta,stormrage,96,evoker,preservation,6,1,5
9490,Caelïn,malganis,96,evoker,preservation,6,1,5
9491,Saînt,thrall,96,evoker,preservation,6,1,5
9492,Keedrori,thrall,96,evoker,preservation,6,1,5
9493,Ðräco,quelthalas,96,evoker,preservation,6,1,5
9494,Dragondoh,frostmourne,96,evoker,preservation,6,1,5
9495,Omars,sargeras,96,evoker,preservation,6,1,5
9496,Xampusaurio,ragnaros,96,evoker,preservation,6,1,5
9497,Ripdumpster,bonechewer,96,evoker,preservation,6,1,5
9498,Simarity,thrall,96,evoker,preservation,6,1,5
9499,Spyroh,crushridge,96,evoker,preservation,6,1,5
9500,Deviantart,emerald-dream,96,evoker,preservation,6,1,5
9501,Atreign,blackwing-lair,96,evoker,preservation,6,1,5
9502,Gamerwords,barthilas,96,evoker,preservation,6,1,5
9503,Pyrepeanut,tichondrius,96,evoker,preservation,6,1,5
9504,Tasdarallar,frostmourne,96,evoker,preservation,6,1,5
9505,Nowon,tichondrius,96,evoker,preservation,6,1,5
9506,Etereosthel,ragnaros,96,evoker,preservation,6,1,5
9507,Daraz,tichondrius,96,evoker,preservation,6,1,5
9508,Readwise,tichondrius,96,evoker,preservation,6,1,5
9509,Sobuker,wyrmrest-accord,96,evoker,preservation,6,1,5
9510,Liltj,tichondrius,96,evoker,preservation,6,1,5
9511,Hardstuckirl,tichondrius,96,evoker,preservation,6,1,5
9512,Nändy,tichondrius,96,evoker,preservation,6,1,5
9513,Trrxx,tichondrius,96,evoker,preservation,6,1,5
9514,Uwuspit,tichondrius,96,evoker,preservation,6,1,5
9515,Vermax,spirestone,96,evoker,preservation,6,1,5
9516,Vvhip,tichondrius,96,evoker,preservation,6,1,5
9517,Rdrako,emerald-dream,96,evoker,preservation,6,1,5
9518,Fkndragon,proudmoore,96,evoker,preservation,6,1,5
9519,Shruikan,lightnings-blade,96,evoker,preservation,6,1,5
9520,Henryvoker,moknathal,96,evoker,preservation,6,1,5
9521,Hausebat,moon-guard,96,evoker,preservation,6,1,5
9522,Nelphemuer,wyrmrest-accord,96,evoker,preservation,12,1,11
9523,Khorvin,proudmoore,96,evoker,preservation,12,1,11
9524,Dracarus,crushridge,96,evoker,preservation,12,1,11
9525,Tidehunter,chogall,96,evoker,preservation,12,1,11
9526,Derath,maelstrom,96,evoker,preservation,12,1,11
9527,Eragon,feathermoon,96,evoker,preservation,12,1,11
9528,Shimshine,destromath,96,evoker,preservation,12,1,11
9529,Dakotakek,illidan,96,evoker,preservation,12,1,11
9530,Morkite,moon-guard,96,evoker,preservation,12,1,11
9531,Draghone,illidan,96,evoker,preservation,12,1,11
9532,Daddyrp,tichondrius,84,evoker,preservation,20,6,14
9533,Blowmiê,area-52,79,evoker,preservation,5,1,4
9534,Gadiel,draka,31,evoker,preservation,2,1,1
9535,Thiqc,zuluhed,9,evoker,preservation,9,3,6
9536,Nikthevoker,area-52,2162,evoker,devastation,189,98,91
9537,Nikthevoker,tichondrius,2156,evoker,devastation,156,84,72
9538,Caedalade,proudmoore,2150,evoker,devastation,238,123,115
9539,Ocdgamer,malganis,2133,evoker,devastation,115,58,57
9540,Whilefalse,stormrage,2125,evoker,devastation,95,48,47
9541,Lizzimcguire,zuljin,2118,evoker,devastation,90,60,30
9542,Dametra,proudmoore,2100,evoker,devastation,108,62,46
9543,Shamblewing,arthas,2094,evoker,devastation,89,44,45
9544,Rothvoker,tichondrius,2033,evoker,devastation,121,70,51
9545,Breathalizer,sargeras,2029,evoker,devastation,90,51,39
9546,Eastwubz,norgannon,2010,evoker,devastation,138,73,65
9547,Somyr,area-52,2003,evoker,devastation,78,43,35
9548,Evokemedaddy,bleeding-hollow,1974,evoker,devastation,161,83,78
9549,Bigdrag,blackhand,1952,evoker,devastation,162,88,74
9550,Quadude,illidan,1947,evoker,devastation,197,99,98
9551,Wazgon,emerald-dream,1940,evoker,devastation,194,94,100
9552,Hutaothighs,illidan,1937,evoker,devastation,130,67,63
9553,Saryuja,thunderhorn,1922,evoker,devastation,52,36,16
9554,Dzrn,moon-guard,1922,evoker,devastation,144,72,72
9555,Meltharian,frostmourne,1911,evoker,devastation,98,55,43
9556,Azazél,borean-tundra,1910,evoker,devastation,233,126,107
9557,Arzaria,stormrage,1906,evoker,devastation,158,88,70
9558,Juicyjom,staghelm,1900,evoker,devastation,60,30,30
9559,Ayavi,illidan,1890,evoker,devastation,96,61,35
9560,Trogdør,illidan,1887,evoker,devastation,153,76,77
9561,Seldantria,dalaran,1875,evoker,devastation,71,36,35
9562,Srb,chogall,1868,evoker,devastation,101,59,42
9563,Mtndewboy,illidan,1864,evoker,devastation,48,29,19
9564,Krashbandico,zangarmarsh,1863,evoker,devastation,61,30,31
9565,Drogu,kelthuzad,1862,evoker,devastation,36,22,14
9566,Thrawn,arygos,1855,evoker,devastation,59,37,22
9567,Bugberry,illidan,1854,evoker,devastation,96,51,45
9568,Strepo,proudmoore,1851,evoker,devastation,66,34,32
9569,Royquaza,illidan,1850,evoker,devastation,60,33,27
9570,Wheezee,emerald-dream,1850,evoker,devastation,46,25,21
9571,Rescued,wyrmrest-accord,1848,evoker,devastation,54,31,23
9572,Xxkimura,tichondrius,1848,evoker,devastation,174,94,80
9573,Tatsurai,tichondrius,1845,evoker,devastation,43,24,19
9574,Fores,tichondrius,1845,evoker,devastation,127,65,62
9575,Eshen,ragnaros,1843,evoker,devastation,298,158,140
9576,Plep,wyrmrest-accord,1836,evoker,devastation,51,30,21
9577,Laneva,moon-guard,1835,evoker,devastation,128,86,42
9578,Anachronormu,mannoroth,1831,evoker,devastation,77,43,34
9579,Venarys,dalaran,1826,evoker,devastation,42,30,12
9580,Raxdragon,sargeras,1826,evoker,devastation,36,22,14
9581,Krúnsh,ragnaros,1823,evoker,devastation,191,104,87
9582,Kinndyvoker,sargeras,1823,evoker,devastation,47,23,24
9583,Chun,malganis,1821,evoker,devastation,30,19,11
9584,Gôdzevoker,area-52,1821,evoker,devastation,64,39,25
9585,Airgordan,area-52,1821,evoker,devastation,77,37,40
9586,Koalaman,area-52,1820,evoker,devastation,228,115,113
9587,Zoomi,whisperwind,1819,evoker,devastation,35,20,15
9588,Komodolong,tichondrius,1819,evoker,devastation,53,26,27
9589,Evokes,moon-guard,1818,evoker,devastation,80,41,39
9590,Kyloflight,thrall,1817,evoker,devastation,50,33,17
9591,Dracaryz,blackhand,1814,evoker,devastation,60,35,25
9592,Gridskully,quelthalas,1814,evoker,devastation,81,38,43
9593,Drakori,azralon,1812,evoker,devastation,80,49,31
9594,Gojirastraza,stormrage,1810,evoker,devastation,53,32,21
9595,Gwaelii,tichondrius,1809,evoker,devastation,105,62,43
9596,Pykan,skullcrusher,1809,evoker,devastation,47,24,23
9597,Ragedizzle,twisting-nether,1808,evoker,devastation,91,49,42
9598,Mil,lightnings-blade,1808,evoker,devastation,69,37,32
9599,Juicylizard,stormrage,1807,evoker,devastation,200,105,95
9600,Geicovoker,tichondrius,1806,evoker,devastation,52,30,22
9601,Tazriak,tichondrius,1803,evoker,devastation,83,52,31
9602,Thordak,drakkari,1801,evoker,devastation,72,40,32
9603,Fractalz,alterac-mountains,1800,evoker,devastation,169,92,77
9604,Azradormu,zuljin,1791,evoker,devastation,186,86,100
9605,Yrue,moon-guard,1779,evoker,devastation,36,19,17
9606,Draxarys,area-52,1776,evoker,devastation,224,112,112
9607,Nørbert,frostmourne,1769,evoker,devastation,48,29,19
9608,Draxarys,tichondrius,1767,evoker,devastation,280,135,145
9609,Dooklord,shuhalo,1763,evoker,devastation,54,24,30
9610,Obsidianimp,sargeras,1756,evoker,devastation,42,21,21
9611,Puf,magtheridon,1755,evoker,devastation,206,113,93
9612,Coltist,elune,1753,evoker,devastation,30,22,8
9613,Oldxdrake,sargeras,1747,evoker,devastation,138,70,68
9614,Milkymike,uldum,1745,evoker,devastation,54,33,21
9615,Emiriss,thrall,1744,evoker,devastation,88,45,43
9616,Flapples,stormrage,1743,evoker,devastation,96,53,43
9617,Mfquietus,illidan,1741,evoker,devastation,72,42,30
9618,Dracthael,stormrage,1736,evoker,devastation,63,37,26
9619,Theredmenace,barthilas,1734,evoker,devastation,41,26,15
9620,Cowboyydann,malganis,1733,evoker,devastation,29,19,10
9621,Stickvoker,sargeras,1733,evoker,devastation,66,40,26
9622,Rá,drenden,1728,evoker,devastation,78,34,44
9623,Nunez,frostmourne,1713,evoker,devastation,41,22,19
9624,Izzythelizzy,tichondrius,1710,evoker,devastation,144,79,65
9625,Betasoldier,kelthuzad,1708,evoker,devastation,95,56,39
9626,Æthyr,anubarak,1707,evoker,devastation,36,26,10
9627,Evokez,barthilas,1705,evoker,devastation,42,31,11
9628,Blowmiê,area-52,1695,evoker,devastation,131,70,61
9629,Ðeepßreath,sargeras,1692,evoker,devastation,60,32,28
9630,Jase,gilneas,1691,evoker,devastation,74,45,29
9631,Qbgosa,malganis,1688,evoker,devastation,36,21,15
9632,Scaleychad,zuljin,1688,evoker,devastation,53,27,26
9633,Arkeryte,moon-guard,1686,evoker,devastation,126,66,60
9634,Mushugon,wyrmrest-accord,1684,evoker,devastation,42,25,17
9635,Ethalem,thrall,1683,evoker,devastation,217,116,101
9636,Rizzanomics,zuljin,1683,evoker,devastation,70,31,39
9637,Djvoker,zuljin,1681,evoker,devastation,62,32,30
9638,Darkwingz,icecrown,1680,evoker,devastation,44,25,19
9639,Vhagarius,tichondrius,1680,evoker,devastation,68,32,36
9640,Eszel,thunderlord,1679,evoker,devastation,184,98,86
9641,Catvoker,area-52,1678,evoker,devastation,114,58,56
9642,Shoestrings,tichondrius,1675,evoker,devastation,108,51,57
9643,Vizora,moon-guard,1672,evoker,devastation,56,33,23
9644,Dwagonwage,zuljin,1672,evoker,devastation,54,25,29
9645,Smoochies,emerald-dream,1671,evoker,devastation,60,32,28
9646,Garlicbreth,stormrage,1671,evoker,devastation,76,40,36
9647,Shalander,proudmoore,1670,evoker,devastation,126,71,55
9648,Fizzlevoker,malganis,1670,evoker,devastation,48,23,25
9649,Beatdownbill,sargeras,1657,evoker,devastation,99,48,51
9650,Rengöku,skullcrusher,1656,evoker,devastation,42,23,19
9651,Balrôg,malganis,1656,evoker,devastation,63,29,34
9652,Dovàhkin,moon-guard,1655,evoker,devastation,66,35,31
9653,Mindme,tichondrius,1652,evoker,devastation,53,30,23
9654,Haramcad,tichondrius,1652,evoker,devastation,165,89,76
9655,Bombs,shattered-hand,1651,evoker,devastation,144,77,67
9656,Wingdeadly,tichondrius,1650,evoker,devastation,66,35,31
9657,Nazaral,mannoroth,1647,evoker,devastation,60,32,28
9658,Koralia,moon-guard,1647,evoker,devastation,42,18,24
9659,Deralan,khaz-modan,1645,evoker,devastation,36,20,16
9660,Hmong,proudmoore,1643,evoker,devastation,48,20,28
9661,Blackdragôn,stormrage,1641,evoker,devastation,43,22,21
9662,Epollyon,sargeras,1639,evoker,devastation,42,25,17
9663,Nishalethen,moon-guard,1638,evoker,devastation,56,30,26
9664,Xhamon,quelthalas,1630,evoker,devastation,52,23,29
9665,Burnyxia,zuljin,1628,evoker,devastation,48,23,25
9666,Evòker,tichondrius,1625,evoker,devastation,54,28,26
9667,Galakrønd,illidan,1624,evoker,devastation,116,63,53
9668,Derite,bonechewer,1620,evoker,devastation,28,20,8
9669,Alekoslol,area-52,1615,evoker,devastation,40,23,17
9670,Spyrodadrago,malganis,1615,evoker,devastation,54,29,25
9671,Terraxkhan,quelthalas,1614,evoker,devastation,48,21,27
9672,Zyzzy,icecrown,1613,evoker,devastation,80,48,32
9673,Psynister,illidan,1613,evoker,devastation,150,66,84
9674,Endoveire,tichondrius,1613,evoker,devastation,54,23,31
9675,Voithyr,moon-guard,1612,evoker,devastation,74,43,31
9676,Bréáth,tichondrius,1608,evoker,devastation,48,33,15
9677,Rðsè,tichondrius,1608,evoker,devastation,150,71,79
9678,Akajills,tichondrius,1607,evoker,devastation,124,70,54
9679,Eshaybruh,barthilas,1605,evoker,devastation,34,20,14
9680,Flysokan,tichondrius,1604,evoker,devastation,48,25,23
9681,Dubskis,area-52,1603,evoker,devastation,122,63,59
9682,Jereico,stonemaul,1603,evoker,devastation,78,39,39
9683,Bently,bloodhoof,1603,evoker,devastation,48,21,27
9684,Marccuss,bleeding-hollow,1601,evoker,devastation,24,17,7
9685,Ryuback,sargeras,1601,evoker,devastation,42,26,16
9686,Xhaal,tichondrius,1601,evoker,devastation,168,83,85
9687,Dragonkings,tichondrius,1599,evoker,devastation,75,33,42
9688,Imugee,sargeras,1598,evoker,devastation,54,27,27
9689,Zona,moon-guard,1597,evoker,devastation,54,26,28
9690,Ackreshanaz,nagrand,1594,evoker,devastation,36,17,19
9691,Zenithria,thrall,1593,evoker,devastation,106,54,52
9692,Batwig,tichondrius,1590,evoker,devastation,71,39,32
9693,Eternabeam,gilneas,1586,evoker,devastation,65,32,33
9694,Linguistic,tichondrius,1585,evoker,devastation,54,29,25
9695,Mayhemvoker,rexxar,1584,evoker,devastation,54,32,22
9696,Juooun,tichondrius,1583,evoker,devastation,71,31,40
9697,Algonir,wyrmrest-accord,1581,evoker,devastation,30,17,13
9698,Zeranthal,moon-guard,1580,evoker,devastation,26,17,9
9699,Pewnee,eonar,1579,evoker,devastation,47,21,26
9700,Bucket,wyrmrest-accord,1577,evoker,devastation,36,19,17
9701,Rotscale,proudmoore,1576,evoker,devastation,30,17,13
9702,Envisioned,kelthuzad,1572,evoker,devastation,36,19,17
9703,Aarax,tichondrius,1570,evoker,devastation,89,45,44
9704,Ævoker,tichondrius,1569,evoker,devastation,111,54,57
9705,Mmrglmrglmr,stormrage,1565,evoker,devastation,47,26,21
9706,Rinstraza,thrall,1564,evoker,devastation,132,66,66
9707,Drachenatem,skywall,1561,evoker,devastation,36,22,14
9708,Crappysmellz,tichondrius,1557,evoker,devastation,30,17,13
9709,Karox,moon-guard,1550,evoker,devastation,113,56,57
9710,Flippyflappy,zuljin,1549,evoker,devastation,30,17,13
9711,Kalisee,skullcrusher,1548,evoker,devastation,65,35,30
9712,Lorb,icecrown,1545,evoker,devastation,164,88,76
9713,Sintholo,sargeras,1544,evoker,devastation,98,49,49
9714,Agheel,firetree,1543,evoker,devastation,44,23,21
9715,Caelïn,malganis,1542,evoker,devastation,132,67,65
9716,Jiminsgf,tichondrius,1539,evoker,devastation,56,37,19
9717,Dragnmÿballs,blackrock,1536,evoker,devastation,34,20,14
9718,Emoker,magtheridon,1535,evoker,devastation,54,31,23
9719,Hydrogenbomb,sargeras,1530,evoker,devastation,86,47,39
9720,Børedom,burning-legion,1529,evoker,devastation,48,30,18
9721,Nxnevo,tichondrius,1529,evoker,devastation,36,19,17
9722,Quickshootin,tichondrius,1528,evoker,devastation,24,16,8
9723,You,deathwing,1528,evoker,devastation,42,24,18
9724,Embarasi,moon-guard,1528,evoker,devastation,48,27,21
9725,Chànge,lothar,1527,evoker,devastation,71,36,35
9726,Meleyx,saurfang,1527,evoker,devastation,48,24,24
9727,Hotdragon,zuljin,1526,evoker,devastation,78,43,35
9728,Drgua,tichondrius,1522,evoker,devastation,30,16,14
9729,Bryágh,wyrmrest-accord,1517,evoker,devastation,147,76,71
9730,Bumbaclot,illidan,1516,evoker,devastation,30,16,14
9731,Lïzzy,tichondrius,1515,evoker,devastation,24,16,8
9732,Kheeleesi,illidan,1515,evoker,devastation,77,40,37
9733,Bryiona,proudmoore,1515,evoker,devastation,48,22,26
9734,Spicyrooster,area-52,1514,evoker,devastation,32,18,14
9735,Olesmokey,tichondrius,1513,evoker,devastation,86,45,41
9736,Zenasatral,sargeras,1512,evoker,devastation,25,17,8
9737,Galrend,firetree,1511,evoker,devastation,78,41,37
9738,Dragontales,stormrage,1510,evoker,devastation,72,40,32
9739,Polyrhythmic,ysera,1510,evoker,devastation,79,38,41
9740,Narissian,wyrmrest-accord,1508,evoker,devastation,92,49,43
9741,Xplode,area-52,1504,evoker,devastation,176,89,87
9742,Tinine,frostmourne,1503,evoker,devastation,60,33,27
9743,Atreign,blackwing-lair,1499,evoker,devastation,55,22,33
9744,Tezzyl,kiljaeden,1498,evoker,devastation,30,16,14
9745,Tealetaz,area-52,1495,evoker,devastation,49,32,17
9746,Hochenblume,proudmoore,1494,evoker,devastation,36,17,19
9747,Ùwüdragon,tichondrius,1490,evoker,devastation,118,71,47
9748,Erling,duskwood,1490,evoker,devastation,84,46,38
9749,Xaeradroz,area-52,1486,evoker,devastation,78,41,37
9750,Netreset,illidan,1481,evoker,devastation,31,17,14
9751,Qfyre,frostmourne,1480,evoker,devastation,57,34,23
9752,Dragonvore,moon-guard,1475,evoker,devastation,23,17,6
9753,Elurb,illidan,1475,evoker,devastation,50,30,20
9754,Youdig,nazjatar,1471,evoker,devastation,30,17,13
9755,Tagzy,tichondrius,1469,evoker,devastation,51,28,23
9756,Quadarius,tichondrius,1466,evoker,devastation,105,55,50
9757,Puffthemagiq,mugthol,1465,evoker,devastation,42,24,18
9758,Curtis,shadowmoon,1465,evoker,devastation,88,49,39
9759,Zandrov,greymane,1463,evoker,devastation,39,21,18
9760,Valentis,bleeding-hollow,1461,evoker,devastation,78,44,34
9761,Dekux,elune,1459,evoker,devastation,36,16,20
9762,Mustardtiger,malorne,1458,evoker,devastation,56,31,25
9763,Rhÿu,quelthalas,1455,evoker,devastation,71,36,35
9764,Chinesedragn,tichondrius,1453,evoker,devastation,60,32,28
9765,Dragontrees,illidan,1450,evoker,devastation,36,19,17
9766,Bellerion,proudmoore,1450,evoker,devastation,48,22,26
9767,Amlug,illidan,1450,evoker,devastation,88,38,50
9768,Ýüp,tichondrius,1448,evoker,devastation,34,21,13
9769,Midi,boulderfist,1446,evoker,devastation,42,21,21
9770,Lilfootmommy,emerald-dream,1446,evoker,devastation,36,16,20
9771,Jowtzprev,ragnaros,1443,evoker,devastation,36,19,17
9772,Serthius,darkspear,1439,evoker,devastation,24,17,7
9773,Peef,tichondrius,1439,evoker,devastation,24,15,9
9774,Hoodwings,stormrage,1439,evoker,devastation,37,22,15
9775,Monkeydrake,tichondrius,1438,evoker,devastation,72,31,41
9776,Mcglizzy,stormrage,1437,evoker,devastation,54,22,32
9777,Zalzin,agamaggan,1435,evoker,devastation,92,48,44
9778,Jurokiel,sargeras,1434,evoker,devastation,135,73,62
9779,Vexosza,moon-guard,1434,evoker,devastation,30,16,14
9780,Drussyboy,illidan,1433,evoker,devastation,69,33,36
9781,Brounno,area-52,1429,evoker,devastation,76,49,27
9782,Devonstation,zuljin,1429,evoker,devastation,42,24,18
9783,Dragonbic,illidan,1423,evoker,devastation,36,16,20
9784,Evoqz,stormrage,1422,evoker,devastation,30,18,12
9785,Neith,aerie-peak,1420,evoker,devastation,41,16,25
9786,Grapthar,korgath,1418,evoker,devastation,78,41,37
9787,Trenash,illidan,1418,evoker,devastation,76,32,44
9788,Setash,kiljaeden,1416,evoker,devastation,36,21,15
9789,Shortdargon,zuljin,1414,evoker,devastation,30,15,15
9790,Desiinger,tichondrius,1411,evoker,devastation,30,17,13
9791,Talanoth,skullcrusher,1408,evoker,devastation,57,34,23
9792,Toastragosa,cenarius,1406,evoker,devastation,149,66,83
9793,Kjerne,stormrage,1404,evoker,devastation,30,20,10
9794,Valthenax,frostmourne,1404,evoker,devastation,83,33,50
9795,Thechadwasgr,bleeding-hollow,1403,evoker,devastation,62,31,31
9796,Firkrag,bleeding-hollow,1402,evoker,devastation,60,28,32
9797,Jarzilla,illidan,1401,evoker,devastation,24,15,9
9798,Favoredson,area-52,1400,evoker,devastation,48,25,23
9799,Valkalas,moon-guard,1400,evoker,devastation,63,30,33
9800,Dillss,tichondrius,1397,evoker,devastation,66,31,35
9801,Veserion,azralon,1396,evoker,devastation,90,50,40
9802,Rodgoesinya,blackrock,1392,evoker,devastation,54,30,24
9803,Blittlle,bleeding-hollow,1391,evoker,devastation,66,39,27
9804,Frequevoker,tichondrius,1390,evoker,devastation,35,15,20
9805,Devdjinn,tichondrius,1388,evoker,devastation,168,85,83
9806,Prevocker,sargeras,1388,evoker,devastation,67,28,39
9807,Tyrvin,kiljaeden,1382,evoker,devastation,145,72,73
9808,Dylawn,illidan,1379,evoker,devastation,42,23,19
9809,Howtew,jubeithos,1377,evoker,devastation,72,37,35
9810,Malygoz,frostmourne,1370,evoker,devastation,60,24,36
9811,Zeetash,illidan,1370,evoker,devastation,66,24,42
9812,Zartolas,moon-guard,1369,evoker,devastation,94,40,54
9813,Dragneel,wyrmrest-accord,1367,evoker,devastation,39,17,22
9814,Drakoris,malganis,1365,evoker,devastation,93,50,43
9815,Dailon,stormreaver,1365,evoker,devastation,39,17,22
9816,Bvo,stormrage,1364,evoker,devastation,77,41,36
9817,Navaji,tichondrius,1362,evoker,devastation,55,30,25
9818,Evokedx,area-52,1361,evoker,devastation,42,21,21
9819,Deathwingtwo,sargeras,1361,evoker,devastation,33,16,17
9820,Sidrasza,norgannon,1360,evoker,devastation,73,40,33
9821,Zayllaerth,illidan,1360,evoker,devastation,82,42,40
9822,Cròk,quelthalas,1360,evoker,devastation,33,15,18
9823,Ezarke,madoran,1359,evoker,devastation,35,17,18
9824,Thendroz,moon-guard,1357,evoker,devastation,30,18,12
9825,Grendalevo,tichondrius,1357,evoker,devastation,57,28,29
9826,Drogan,demon-soul,1356,evoker,devastation,92,55,37
9827,Valyrik,illidan,1356,evoker,devastation,110,54,56
9828,Lexgrossman,kelthuzad,1353,evoker,devastation,98,50,48
9829,Aoxila,proudmoore,1353,evoker,devastation,177,82,95
9830,Kêristrasza,wyrmrest-accord,1352,evoker,devastation,54,27,27
9831,Trazana,wyrmrest-accord,1344,evoker,devastation,29,16,13
9832,Bumbledragn,moon-guard,1344,evoker,devastation,101,49,52
9833,Sylnathaire,wyrmrest-accord,1343,evoker,devastation,84,41,43
9834,Aydetal,eonar,1343,evoker,devastation,42,20,22
9835,Âvalon,zuljin,1341,evoker,devastation,18,14,4
9836,Jwoker,malganis,1340,evoker,devastation,36,14,22
9837,Monyz,emerald-dream,1339,evoker,devastation,46,32,14
9838,Yuukee,thrall,1338,evoker,devastation,43,23,20
9839,Dîego,azralon,1333,evoker,devastation,40,24,16
9840,Zlandicaar,area-52,1329,evoker,devastation,66,31,35
9841,Acoldwall,illidan,1328,evoker,devastation,24,15,9
9842,Koralia,wyrmrest-accord,1328,evoker,devastation,30,14,16
9843,Vaelikai,korgath,1326,evoker,devastation,18,14,4
9844,Midnights,scarlet-crusade,1326,evoker,devastation,83,50,33
9845,Spicy,mannoroth,1324,evoker,devastation,34,19,15
9846,Dovå,moon-guard,1322,evoker,devastation,32,16,16
9847,Emikothyr,thrall,1319,evoker,devastation,74,41,33
9848,Tekath,altar-of-storms,1317,evoker,devastation,56,26,30
9849,Drahconne,illidan,1312,evoker,devastation,64,34,30
9850,Itwasntthis,tichondrius,1312,evoker,devastation,117,60,57
9851,Jabbawockeëz,drakkari,1310,evoker,devastation,97,51,46
9852,Skooby,drenden,1309,evoker,devastation,30,16,14
9853,Raghnard,illidan,1303,evoker,devastation,70,37,33
9854,Skykeeper,quelthalas,1300,evoker,devastation,112,58,54
9855,Zlolykcir,malganis,1299,evoker,devastation,89,48,41
9856,Vahaerys,stormrage,1296,evoker,devastation,48,21,27
9857,Vokeero,ysera,1284,evoker,devastation,72,36,36
9858,Wackthyr,frostmourne,1284,evoker,devastation,30,15,15
9859,Benares,zuljin,1279,evoker,devastation,91,43,48
9860,Sylverion,thrall,1277,evoker,devastation,70,35,35
9861,Zendrov,skywall,1276,evoker,devastation,30,14,16
9862,Golden,area-52,1274,evoker,devastation,28,14,14
9863,Draconicus,bonechewer,1266,evoker,devastation,104,52,52
9864,Nazanazar,wyrmrest-accord,1263,evoker,devastation,79,38,41
9865,Evokjoe,tortheldrin,1262,evoker,devastation,58,29,29
9866,Crogosa,quelthalas,1251,evoker,devastation,36,14,22
9867,Ezgamedeez,tichondrius,1247,evoker,devastation,24,13,11
9868,Dracomalfoyy,caelestrasz,1246,evoker,devastation,21,14,7
9869,Marknormand,area-52,1246,evoker,devastation,24,13,11
9870,Kozukimomo,area-52,1245,evoker,devastation,41,15,26
9871,Shanegillis,emerald-dream,1244,evoker,devastation,18,13,5
9872,Gutterskank,illidan,1241,evoker,devastation,23,14,9
9873,Dracfire,saurfang,1239,evoker,devastation,24,13,11
9874,Longxx,dalaran,1235,evoker,devastation,24,13,11
9875,Galakraas,proudmoore,1235,evoker,devastation,75,34,41
9876,Xm,emerald-dream,1235,evoker,devastation,31,14,17
9877,Bigbadfred,tichondrius,1234,evoker,devastation,24,13,11
9878,Raygos,nemesis,1232,evoker,devastation,56,21,35
9879,Sindraxx,stormrage,1228,evoker,devastation,48,25,23
9880,Phlegython,eredar,1226,evoker,devastation,30,13,17
9881,Dingermun,bleeding-hollow,1225,evoker,devastation,20,15,5
9882,Valakaztower,area-52,1225,evoker,devastation,36,19,17
9883,Nathx,drakkari,1222,evoker,devastation,24,18,6
9884,Cheaterz,area-52,1222,evoker,devastation,36,22,14
9885,Jugzxs,frostmourne,1213,evoker,devastation,36,14,22
9886,Azorian,vashj,1208,evoker,devastation,30,17,13
9887,Trenot,draenor,1202,evoker,devastation,42,21,21
9888,Layothyr,stormrage,1201,evoker,devastation,24,14,10
9889,Aelvina,moon-guard,1201,evoker,devastation,30,13,17
9890,Senven,blackhand,1196,evoker,devastation,30,13,17
9891,Dragkon,azuremyst,1190,evoker,devastation,54,22,32
9892,Ironscale,dalaran,1186,evoker,devastation,30,13,17
9893,Paean,moon-guard,1183,evoker,devastation,32,18,14
9894,Evooern,frostmourne,1181,evoker,devastation,84,39,45
9895,Xampusaurio,ragnaros,1178,evoker,devastation,24,13,11
9896,Yiserion,sargeras,1178,evoker,devastation,133,67,66
9897,Kaikisen,malganis,1178,evoker,devastation,41,19,22
9898,Climax,stormrage,1177,evoker,devastation,28,13,15
9899,Potfase,tichondrius,1177,evoker,devastation,32,13,19
9900,Vaayu,moon-guard,1176,evoker,devastation,24,13,11
9901,Teritwo,stormrage,1166,evoker,devastation,28,13,15
9902,Drakonyx,mugthol,1162,evoker,devastation,50,21,29
9903,Dragonpete,whisperwind,1157,evoker,devastation,36,17,19
9904,Drakhaz,azralon,1156,evoker,devastation,22,13,9
9905,Asham,azralon,1152,evoker,devastation,63,36,27
9906,Stretonaught,dalaran,1152,evoker,devastation,27,14,13
9907,Devokerx,emerald-dream,1151,evoker,devastation,18,12,6
9908,Tërminus,quelthalas,1151,evoker,devastation,18,12,6
9909,Shwaydbz,zuljin,1151,evoker,devastation,24,12,12
9910,Zindraco,thrall,1150,evoker,devastation,24,12,12
9911,Klownfiesta,thrall,1148,evoker,devastation,30,15,15
9912,Growthyy,malganis,1147,evoker,devastation,18,12,6
9913,Mythsvoker,barthilas,1147,evoker,devastation,19,12,7
9914,Aentharion,argent-dawn,1147,evoker,devastation,24,12,12
9915,Zervis,arthas,1147,evoker,devastation,30,12,18
9916,Drozul,stormrage,1145,evoker,devastation,30,12,18
9917,Loginplease,frostmourne,1144,evoker,devastation,80,36,44
9918,Unseenzblack,tichondrius,1141,evoker,devastation,18,12,6
9919,Dragoceleste,ragnaros,1140,evoker,devastation,54,26,28
9920,Dinnkyion,dalaran,1138,evoker,devastation,24,12,12
9921,Midyr,nemesis,1137,evoker,devastation,24,15,9
9922,Dragonbranch,area-52,1133,evoker,devastation,24,12,12
9923,Lorathyr,lothar,1128,evoker,devastation,24,12,12
9924,Enuzan,dalaran,1128,evoker,devastation,89,41,48
9925,Archion,azgalor,1127,evoker,devastation,35,13,22
9926,Wrecketz,tichondrius,1122,evoker,devastation,58,28,30
9927,Bhalaria,ragnaros,1113,evoker,devastation,69,25,44
9928,Paycussy,sargeras,1110,evoker,devastation,18,12,6
9929,Zitasanazen,tichondrius,1107,evoker,devastation,64,25,39
9930,Visron,stormrage,1102,evoker,devastation,53,33,20
9931,Drögón,stormrage,1100,evoker,devastation,42,27,15
9932,Crymor,lethon,1099,evoker,devastation,30,16,14
9933,Madelines,tichondrius,1097,evoker,devastation,24,13,11
9934,Byäkuyá,azralon,1091,evoker,devastation,59,30,29
9935,Zhannecgos,moon-guard,1087,evoker,devastation,28,12,16
9936,Erizcdraa,tichondrius,1069,evoker,devastation,19,12,7
9937,Durijus,tichondrius,1069,evoker,devastation,35,14,21
9938,Aktas,illidan,1063,evoker,devastation,28,12,16
9939,Ðarkwyrm,laughing-skull,1062,evoker,devastation,42,22,20
9940,Devokèr,tichondrius,1056,evoker,devastation,24,11,13
9941,Kiry,emerald-dream,1055,evoker,devastation,24,11,13
9942,Hydroponicsz,bloodscalp,1055,evoker,devastation,24,11,13
9943,Drayongari,tichondrius,1054,evoker,devastation,18,11,7
9944,Kubus,emerald-dream,1054,evoker,devastation,18,11,7
9945,Tepaku,thrall,1054,evoker,devastation,18,11,7
9946,Gypgo,ragnaros,1054,evoker,devastation,18,11,7
9947,Yousurper,thunderlord,1054,evoker,devastation,27,14,13
9948,Kinto,stormrage,1054,evoker,devastation,30,11,19
9949,Dracthyrius,thunderlord,1052,evoker,devastation,18,11,7
9950,Eìdolon,sargeras,1049,evoker,devastation,18,11,7
9951,Satanasx,illidan,1048,evoker,devastation,24,11,13
9952,Vlåd,tichondrius,1046,evoker,devastation,24,11,13
9953,Sübjugador,azralon,1042,evoker,devastation,30,20,10
9954,Notvez,bleeding-hollow,1038,evoker,devastation,31,11,20
9955,Tïtäm,area-52,1032,evoker,devastation,21,12,9
9956,Warhammerxx,tichondrius,1027,evoker,devastation,84,33,51
9957,Zippityzoom,barthilas,1026,evoker,devastation,43,18,25
9958,Nathenezital,frostmourne,1022,evoker,devastation,24,11,13
9959,Abaddragon,dalaran,1020,evoker,devastation,29,11,18
9960,Slitherin,dalaran,1014,evoker,devastation,36,11,25
9961,Flygor,quelthalas,1011,evoker,devastation,54,17,37
9962,Culture,khazgoroth,1006,evoker,devastation,15,11,4
9963,Alnuin,stormrage,1004,evoker,devastation,102,42,60
9964,Stolesom,emerald-dream,994,evoker,devastation,65,32,33
9965,Sethelys,tichondrius,989,evoker,devastation,20,11,9
9966,Daydrac,thrall,987,evoker,devastation,26,11,15
9967,Neofarian,lightbringer,986,evoker,devastation,20,11,9
9968,Dragongrim,silvermoon,986,evoker,devastation,30,14,16
9969,Taamyr,wyrmrest-accord,973,evoker,devastation,42,18,24
9970,Kazrekan,moon-guard,960,evoker,devastation,18,10,8
9971,Iantern,dalaran,960,evoker,devastation,18,10,8
9972,Ezath,zuljin,960,evoker,devastation,24,11,13
9973,Cløud,hellscream,959,evoker,devastation,12,10,2
9974,Cmiygl,proudmoore,959,evoker,devastation,12,10,2
9975,Chime,dalaran,959,evoker,devastation,18,10,8
9976,Xeerus,stormreaver,959,evoker,devastation,18,10,8
9977,Hausebat,moon-guard,959,evoker,devastation,18,10,8
9978,Basiliskgodx,tichondrius,959,evoker,devastation,18,10,8
9979,Nasdanot,zuljin,959,evoker,devastation,18,10,8
9980,Dilon,area-52,959,evoker,devastation,24,10,14
9981,Runescape,altar-of-storms,959,evoker,devastation,24,10,14
9982,Grafixx,sargeras,958,evoker,devastation,15,11,4
9983,Averithel,moon-guard,958,evoker,devastation,18,10,8
9984,Obeahfire,tichondrius,958,evoker,devastation,28,11,17
9985,Vokezuì,sargeras,958,evoker,devastation,30,10,20
9986,Dragocser,drakkari,957,evoker,devastation,18,10,8
9987,Jormungandre,wyrmrest-accord,957,evoker,devastation,18,10,8
9988,Jgdragon,sargeras,957,evoker,devastation,18,10,8
9989,Pewpowdragon,malganis,957,evoker,devastation,18,10,8
9990,Herikas,tichondrius,956,evoker,devastation,72,35,37
9991,Oatmealneil,bleeding-hollow,955,evoker,devastation,24,10,14
9992,Sinepbreath,bleeding-hollow,954,evoker,devastation,18,10,8
9993,Rangel,tol-barad,954,evoker,devastation,27,11,16
9994,Tralanoth,destromath,953,evoker,devastation,18,10,8
9995,Liekki,illidan,953,evoker,devastation,24,10,14
9996,Wizadsa,amanthul,951,evoker,devastation,12,10,2
9997,Loganvkr,illidan,950,evoker,devastation,18,10,8
9998,Dragonair,spinebreaker,950,evoker,devastation,21,10,11
9999,Fìg,wyrmrest-accord,948,evoker,devastation,18,10,8
10000,Jorlozthyr,ragnaros,948,evoker,devastation,24,10,14
10001,Prolyfe,blood-furnace,942,evoker,devastation,15,11,4
10002,Lostplanet,drakkari,937,evoker,devastation,30,10,20
10003,Escanorr,ghostlands,936,evoker,devastation,20,11,9
10004,Ryùtt,illidan,933,evoker,devastation,18,10,8
10005,Toyatoki,stormrage,930,evoker,devastation,35,13,22
10006,Salakhar,drakkari,924,evoker,devastation,14,11,3
10007,Fukhur,ragnaros,917,evoker,devastation,24,11,13
10008,Vikings,madoran,909,evoker,devastation,23,10,13
10009,Ciana,black-dragonflight,902,evoker,devastation,38,19,19
10010,Popgoesurmom,tichondrius,901,evoker,devastation,18,10,8
10011,Ezdrake,drakkari,900,evoker,devastation,36,11,25
10012,Aratre,daggerspine,897,evoker,devastation,54,21,33
10013,Arath,zangarmarsh,879,evoker,devastation,36,18,18
10014,Tireoz,frostmourne,866,evoker,devastation,48,12,36
10015,Oracle,duskwood,864,evoker,devastation,12,9,3
10016,Artemad,moon-guard,864,evoker,devastation,12,9,3
10017,Kiserys,suramar,864,evoker,devastation,12,9,3
10018,Áspect,aegwynn,864,evoker,devastation,12,9,3
10019,Gangbânk,tichondrius,864,evoker,devastation,12,9,3
10020,Gobananas,sargeras,864,evoker,devastation,12,9,3
10021,Raller,malganis,864,evoker,devastation,12,9,3
10022,Orncen,emerald-dream,864,evoker,devastation,16,10,6
10023,Puffthemagic,lightnings-blade,864,evoker,devastation,18,9,9
10024,Taylordra,tichondrius,864,evoker,devastation,18,9,9
10025,Todorøki,hyjal,864,evoker,devastation,18,9,9
10026,Bhanethyr,illidan,864,evoker,devastation,24,9,15
10027,Raikori,ragnaros,863,evoker,devastation,12,9,3
10028,Dragonsteppz,aegwynn,863,evoker,devastation,18,9,9
10029,Missjenny,korgath,863,evoker,devastation,18,9,9
10030,Siatrend,moon-guard,863,evoker,devastation,18,9,9
10031,Thyatera,ragnaros,863,evoker,devastation,18,9,9
10032,Misik,frostwolf,863,evoker,devastation,18,9,9
10033,Gharscales,tichondrius,863,evoker,devastation,24,9,15
10034,Demidas,emerald-dream,862,evoker,devastation,13,9,4
10035,Sía,drakkari,861,evoker,devastation,12,9,3
10036,Teanie,tichondrius,861,evoker,devastation,18,9,9
10037,Nasath,arthas,861,evoker,devastation,18,9,9
10038,Madashy,durotan,861,evoker,devastation,24,9,15
10039,Karaxes,gorefiend,861,evoker,devastation,24,9,15
10040,Zorashal,kiljaeden,860,evoker,devastation,12,9,3
10041,Krokuzan,ragnaros,860,evoker,devastation,18,9,9
10042,Doombreath,ragnaros,859,evoker,devastation,18,9,9
10043,Keedrori,thrall,859,evoker,devastation,19,9,10
10044,Drapybaras,bleeding-hollow,859,evoker,devastation,36,13,23
10045,Furyíon,stormrage,855,evoker,devastation,12,9,3
10046,Azuria,lothar,855,evoker,devastation,12,9,3
10047,Acnølogia,stormrage,855,evoker,devastation,18,9,9
10048,Rasec,moon-guard,843,evoker,devastation,20,9,11
10049,Acnøløgia,azralon,840,evoker,devastation,30,9,21
10050,Rikfreedom,ragnaros,836,evoker,devastation,42,19,23
10051,Stylez,anetheron,830,evoker,devastation,42,19,23
10052,Dvrk,frostmourne,812,evoker,devastation,17,9,8
10053,Dreampunk,tichondrius,784,evoker,devastation,13,9,4
10054,Nyranblood,zuljin,779,evoker,devastation,30,11,19
10055,Creachy,kiljaeden,768,evoker,devastation,12,8,4
10056,Saînt,thrall,768,evoker,devastation,12,8,4
10057,Devilmanguy,bonechewer,768,evoker,devastation,12,8,4
10058,Toastsevoker,tichondrius,768,evoker,devastation,15,9,6
10059,Dragonfarts,frostmourne,768,evoker,devastation,18,8,10
10060,Taeloc,frostmourne,768,evoker,devastation,18,8,10
10061,Drsgme,dentarg,768,evoker,devastation,18,8,10
10062,Crosis,azralon,768,evoker,devastation,18,8,10
10063,Dunkinonem,black-dragonflight,767,evoker,devastation,12,8,4
10064,Kozara,trollbane,767,evoker,devastation,18,8,10
10065,Vermax,akama,767,evoker,devastation,18,8,10
10066,Rïvé,tichondrius,767,evoker,devastation,24,8,16
10067,Arokh,frostmourne,767,evoker,devastation,30,8,22
10068,Zirath,emerald-dream,766,evoker,devastation,18,8,10
10069,Dawitchvoker,illidan,766,evoker,devastation,18,8,10
10070,Glideoure,stonemaul,766,evoker,devastation,24,8,16
10071,Aaztra,whisperwind,765,evoker,devastation,12,8,4
10072,Tinà,tichondrius,765,evoker,devastation,18,8,10
10073,Skrillerv,frostmourne,765,evoker,devastation,18,8,10
10074,Byssrak,borean-tundra,764,evoker,devastation,12,8,4
10075,Redeyés,area-52,761,evoker,devastation,12,8,4
10076,Seletgos,quelthalas,761,evoker,devastation,24,8,16
10077,Momonosuke,fizzcrank,760,evoker,devastation,18,8,10
10078,Detraa,illidan,754,evoker,devastation,12,8,4
10079,Daigrefn,echo-isles,751,evoker,devastation,18,8,10
10080,Pouncer,proudmoore,729,evoker,devastation,20,8,12
10081,Littleripper,tichondrius,724,evoker,devastation,18,8,10
10082,Onornun,magtheridon,718,evoker,devastation,17,8,9
10083,Zhyrouvion,stormrage,699,evoker,devastation,17,8,9
10084,Torakk,ravencrest,687,evoker,devastation,13,8,5
10085,Vokr,area-52,672,evoker,devastation,12,7,5
10086,Spikeyboi,eonar,672,evoker,devastation,12,7,5
10087,Caedalade,spirestone,672,evoker,devastation,12,7,5
10088,Nysian,wyrmrest-accord,672,evoker,devastation,12,7,5
10089,Axiomoixa,tichondrius,672,evoker,devastation,12,7,5
10090,Evook,tichondrius,672,evoker,devastation,12,7,5
10091,Shambly,kelthuzad,672,evoker,devastation,12,7,5
10092,Lacadabeef,tichondrius,672,evoker,devastation,12,7,5
10093,Serathrine,smolderthorn,672,evoker,devastation,12,7,5
10094,Chewbigred,vashj,672,evoker,devastation,12,7,5
10095,Dudeofdragon,illidan,672,evoker,devastation,12,7,5
10096,Superscales,zuljin,672,evoker,devastation,12,7,5
10097,Lizardgodtko,tichondrius,672,evoker,devastation,12,7,5
10098,Breezemordus,zuljin,672,evoker,devastation,12,7,5
10099,Rearcalzone,illidan,672,evoker,devastation,12,7,5
10100,Dragonherb,zuljin,672,evoker,devastation,12,7,5
10101,Ruination,lightnings-blade,672,evoker,devastation,12,7,5
10102,Écaille,dalaran,672,evoker,devastation,15,8,7
10103,Sådge,frostmourne,672,evoker,devastation,18,7,11
10104,Müshü,icecrown,672,evoker,devastation,18,7,11
10105,Dragonstonks,moon-guard,672,evoker,devastation,18,7,11
10106,Rõÿ,area-52,672,evoker,devastation,18,7,11
10107,Razistzegrlz,illidan,672,evoker,devastation,24,7,17
10108,Ggcthulhu,area-52,671,evoker,devastation,12,7,5
10109,Gôdswrath,tichondrius,671,evoker,devastation,12,7,5
10110,Glaurungr,ragnaros,671,evoker,devastation,12,7,5
10111,Xeretas,bleeding-hollow,671,evoker,devastation,12,7,5
10112,Boseijwho,emerald-dream,671,evoker,devastation,12,7,5
10113,Whiegrath,azralon,671,evoker,devastation,12,7,5
10114,Garchamp,area-52,671,evoker,devastation,15,8,7
10115,Craterearth,moon-guard,671,evoker,devastation,18,7,11
10116,Hemipenes,tichondrius,671,evoker,devastation,18,7,11
10117,Phatë,nerzhul,671,evoker,devastation,18,7,11
10118,Davidfesago,quelthalas,670,evoker,devastation,12,7,5
10119,Setchagos,emerald-dream,670,evoker,devastation,12,7,5
10120,Gulvoke,shattered-hand,670,evoker,devastation,12,7,5
10121,Beastlysoul,tichondrius,670,evoker,devastation,12,7,5
10122,Nikeze,kiljaeden,670,evoker,devastation,18,7,11
10123,Takhysis,frostmourne,670,evoker,devastation,18,7,11
10124,Lamperr,illidan,670,evoker,devastation,54,10,44
10125,Pyrepapi,thrall,669,evoker,devastation,20,8,12
10126,Fortwonty,thrall,667,evoker,devastation,12,7,5
10127,Mmanigoldo,quelthalas,667,evoker,devastation,18,7,11
10128,Sleepeasy,blackrock,667,evoker,devastation,18,7,11
10129,Evilsquirel,area-52,666,evoker,devastation,12,7,5
10130,Stormstryke,queldorei,641,evoker,devastation,35,7,28
10131,Krefugee,tichondrius,637,evoker,devastation,17,7,10
10132,Drahkoo,azralon,623,evoker,devastation,15,7,8
10133,Zérai,quelthalas,576,evoker,devastation,6,6,0
10134,Draislyn,cenarion-circle,576,evoker,devastation,6,6,0
10135,Miradrake,icecrown,576,evoker,devastation,6,6,0
10136,Ilovepolpot,tichondrius,576,evoker,devastation,6,6,0
10137,Fuecoco,proudmoore,576,evoker,devastation,6,6,0
10138,Zlyrax,moon-guard,576,evoker,devastation,6,6,0
10139,Dracthyrwa,azralon,576,evoker,devastation,6,6,0
10140,Yellowker,thrall,576,evoker,devastation,6,6,0
10141,Joopydrake,tichondrius,576,evoker,devastation,12,6,6
10142,Glizard,firetree,576,evoker,devastation,12,6,6
10143,Dafiya,thrall,576,evoker,devastation,12,6,6
10144,Vysenía,moon-guard,576,evoker,devastation,12,6,6
10145,Alucardragon,turalyon,576,evoker,devastation,12,6,6
10146,Sathregos,emerald-dream,576,evoker,devastation,12,6,6
10147,Shanaynayae,area-52,576,evoker,devastation,12,6,6
10148,Joyburn,tichondrius,576,evoker,devastation,12,6,6
10149,Uncleìroh,tichondrius,576,evoker,devastation,12,6,6
10150,Drøgon,sargeras,576,evoker,devastation,12,6,6
10151,Iamtrash,daggerspine,576,evoker,devastation,12,6,6
10152,Dâpper,queldorei,576,evoker,devastation,12,6,6
10153,Lardicønn,thrall,576,evoker,devastation,12,6,6
10154,Comepancito,quelthalas,576,evoker,devastation,12,6,6
10155,Brakkarion,wyrmrest-accord,576,evoker,devastation,12,6,6
10156,Dragønbørne,blackrock,576,evoker,devastation,12,6,6
10157,Dimatis,ragnaros,576,evoker,devastation,12,6,6
10158,Dukä,dalaran,576,evoker,devastation,15,7,8
10159,Êsh,lightbringer,576,evoker,devastation,13,6,7
10160,Xfemboyqt,area-52,576,evoker,devastation,17,7,10
10161,Syvernius,khazgoroth,576,evoker,devastation,18,6,12
10162,Saxthyr,stormreaver,576,evoker,devastation,24,6,18
10163,Avastri,moon-guard,575,evoker,devastation,12,6,6
10164,Kazecgos,zuljin,575,evoker,devastation,12,6,6
10165,Setasdan,illidan,575,evoker,devastation,12,6,6
10166,Rykuvokr,azuremyst,575,evoker,devastation,12,6,6
10167,Thalyxia,azralon,575,evoker,devastation,12,6,6
10168,Ecksdoom,sargeras,575,evoker,devastation,12,6,6
10169,Cøømbuya,sargeras,575,evoker,devastation,12,6,6
10170,Tylexstranza,malganis,575,evoker,devastation,12,6,6
10171,Koriaz,ragnaros,575,evoker,devastation,12,6,6
10172,Altri,lightnings-blade,575,evoker,devastation,12,6,6
10173,Avithori,borean-tundra,575,evoker,devastation,12,6,6
10174,Chimo,laughing-skull,575,evoker,devastation,12,6,6
10175,Dumbodragon,bleeding-hollow,575,evoker,devastation,12,6,6
10176,Vrtra,lightbringer,575,evoker,devastation,12,6,6
10177,Amaryliss,kelthuzad,575,evoker,devastation,12,6,6
10178,Lòrdope,illidan,575,evoker,devastation,12,6,6
10179,Deàthwing,proudmoore,575,evoker,devastation,18,6,12
10180,Alragos,ragnaros,575,evoker,devastation,18,6,12
10181,Bazelgos,moon-guard,575,evoker,devastation,24,6,18
10182,Snowdragon,azralon,574,evoker,devastation,12,6,6
10183,Dracnovae,emerald-dream,574,evoker,devastation,12,6,6
10184,Vermáx,caelestrasz,574,evoker,devastation,12,6,6
10185,Aegontargary,azralon,574,evoker,devastation,15,7,8
10186,Carloxd,tichondrius,574,evoker,devastation,24,6,18
10187,Syndue,malganis,573,evoker,devastation,12,6,6
10188,Noodleslut,stormrage,573,evoker,devastation,12,6,6
10189,Azuril,wyrmrest-accord,572,evoker,devastation,12,6,6
10190,Reptyle,emerald-dream,569,evoker,devastation,18,6,12
10191,Toephotos,tichondrius,558,evoker,devastation,17,6,11
10192,Lightaurae,thunderlord,556,evoker,devastation,30,6,24
10193,Pzyko,ragnaros,551,evoker,devastation,17,6,11
10194,Zindrozarath,area-52,544,evoker,devastation,10,6,4
10195,Blazor,sisters-of-elune,542,evoker,devastation,11,6,5
10196,Dragonbreaf,emerald-dream,527,evoker,devastation,11,6,5
10197,Kharibdis,kul-tiras,480,evoker,devastation,6,5,1
10198,Hugehorns,jubeithos,480,evoker,devastation,6,5,1
10199,Vellony,kelthuzad,480,evoker,devastation,6,5,1
10200,Khalt,quelthalas,480,evoker,devastation,6,5,1
10201,Emopidgey,dalaran,480,evoker,devastation,6,5,1
10202,Drakedrift,malganis,480,evoker,devastation,6,5,1
10203,Nardleberry,wyrmrest-accord,480,evoker,devastation,12,5,7
10204,Deezdragon,stormrage,480,evoker,devastation,12,5,7
10205,Stælthßømbèr,baelgun,480,evoker,devastation,12,5,7
10206,Trillvoker,illidan,480,evoker,devastation,12,5,7
10207,Ventiev,tichondrius,480,evoker,devastation,12,5,7
10208,Skylizard,illidan,480,evoker,devastation,12,5,7
10209,Rebuk,area-52,480,evoker,devastation,12,5,7
10210,Darkscale,haomarush,480,evoker,devastation,12,5,7
10211,Nuttutted,emerald-dream,480,evoker,devastation,12,5,7
10212,Dhcb,tichondrius,480,evoker,devastation,12,5,7
10213,Draehgor,hyjal,480,evoker,devastation,12,5,7
10214,Nethenezoth,auchindoun,480,evoker,devastation,12,5,7
10215,Purplerocket,illidan,480,evoker,devastation,12,5,7
10216,Ackresh,executus,480,evoker,devastation,12,5,7
10217,Dragonhyde,stormrage,480,evoker,devastation,12,5,7
10218,Vallath,zuljin,480,evoker,devastation,12,5,7
10219,Ammar,drakkari,480,evoker,devastation,12,5,7
10220,Daesired,moon-guard,480,evoker,devastation,12,5,7
10221,Galakrond,black-dragonflight,480,evoker,devastation,12,5,7
10222,Asatrat,greymane,480,evoker,devastation,12,5,7
10223,Saìntgeorge,sargeras,480,evoker,devastation,12,5,7
10224,Nelthendros,moon-guard,480,evoker,devastation,12,5,7
10225,Faahrad,azralon,480,evoker,devastation,12,5,7
10226,Ryhu,sargeras,480,evoker,devastation,12,5,7
10227,Eyedxl,magtheridon,480,evoker,devastation,12,5,7
10228,Moltqt,tichondrius,480,evoker,devastation,12,5,7
10229,Abath,quelthalas,480,evoker,devastation,14,5,9
10230,Velahesa,sargeras,480,evoker,devastation,24,5,19
10231,Emsli,moon-guard,479,evoker,devastation,6,5,1
10232,Scalesun,azralon,479,evoker,devastation,12,5,7
10233,Historius,proudmoore,479,evoker,devastation,12,5,7
10234,Dedderion,zuljin,479,evoker,devastation,12,5,7
10235,Granolajin,ragnaros,479,evoker,devastation,12,5,7
10236,Müshu,duskwood,479,evoker,devastation,12,5,7
10237,Targaryenz,malganis,479,evoker,devastation,12,5,7
10238,Draginnutz,dunemaul,479,evoker,devastation,18,5,13
10239,Niratrenn,area-52,478,evoker,devastation,12,5,7
10240,Nazervis,silver-hand,478,evoker,devastation,18,5,13
10241,Nathrach,wyrmrest-accord,477,evoker,devastation,6,5,1
10242,Sandrov,kaelthas,477,evoker,devastation,12,5,7
10243,Althenot,emerald-dream,477,evoker,devastation,12,5,7
10244,Sammalone,burning-blade,474,evoker,devastation,12,5,7
10245,Zzae,tichondrius,432,evoker,devastation,15,5,10
10246,Swolegarian,emerald-dream,431,evoker,devastation,11,5,6
10247,Kylidon,garrosh,415,evoker,devastation,8,5,3
10248,Lifcleal,moon-guard,415,evoker,devastation,14,5,9
10249,Kosstro,thunderlord,398,evoker,devastation,10,5,5
10250,Skazz,emerald-dream,384,evoker,devastation,6,4,2
10251,Foxstrazagos,hellscream,384,evoker,devastation,6,4,2
10252,Whinks,zangarmarsh,384,evoker,devastation,6,4,2
10253,Atraxian,tichondrius,384,evoker,devastation,6,4,2
10254,Deathraux,tichondrius,384,evoker,devastation,6,4,2
10255,Draisin,zuljin,384,evoker,devastation,6,4,2
10256,Shënrøn,tichondrius,384,evoker,devastation,6,4,2
10257,Emberlyn,sargeras,384,evoker,devastation,6,4,2
10258,Jenovi,tichondrius,384,evoker,devastation,6,4,2
10259,Kaidoxuchihv,ragnaros,384,evoker,devastation,6,4,2
10260,Jòrmungandr,moon-guard,384,evoker,devastation,6,4,2
10261,Dragonsbgay,stormrage,384,evoker,devastation,6,4,2
10262,Tiamaat,black-dragonflight,384,evoker,devastation,6,4,2
10263,Daemon,detheroc,384,evoker,devastation,6,4,2
10264,Ejokerxx,tichondrius,384,evoker,devastation,6,4,2
10265,Docevoker,tichondrius,384,evoker,devastation,6,4,2
10266,Swagondragon,illidan,384,evoker,devastation,6,4,2
10267,Biscotti,illidan,384,evoker,devastation,6,4,2
10268,Solazari,tichondrius,384,evoker,devastation,6,4,2
10269,Jammstraza,skywall,384,evoker,devastation,6,4,2
10270,Mcflý,sargeras,384,evoker,devastation,6,4,2
10271,Shenròn,kelthuzad,384,evoker,devastation,6,4,2
10272,Machaflux,winterhoof,384,evoker,devastation,6,4,2
10273,Kazooie,zuljin,384,evoker,devastation,6,4,2
10274,Testzvoker,dalaran,384,evoker,devastation,6,4,2
10275,Bodytypetwo,area-52,384,evoker,devastation,6,4,2
10276,Vuldon,area-52,384,evoker,devastation,6,4,2
10277,Bmbo,illidan,384,evoker,devastation,6,4,2
10278,Seaserpent,kelthuzad,384,evoker,devastation,6,4,2
10279,Ilovequiet,proudmoore,384,evoker,devastation,6,4,2
10280,Opsmybad,ragnaros,384,evoker,devastation,6,4,2
10281,Mushú,archimonde,384,evoker,devastation,6,4,2
10282,Zorlstisza,moon-guard,384,evoker,devastation,6,4,2
10283,Uhlive,area-52,384,evoker,devastation,6,4,2
10284,Azafs,azralon,384,evoker,devastation,9,5,4
10285,Shenrõn,malganis,384,evoker,devastation,15,5,10
10286,Dragonballer,trollbane,384,evoker,devastation,12,4,8
10287,Thnake,zuljin,384,evoker,devastation,12,4,8
10288,Kcwt,illidan,384,evoker,devastation,12,4,8
10289,Devåståtion,tichondrius,384,evoker,devastation,12,4,8
10290,Ghostfable,emerald-dream,384,evoker,devastation,12,4,8
10291,Usulamili,stormrage,384,evoker,devastation,12,4,8
10292,Trazer,malfurion,384,evoker,devastation,12,4,8
10293,Idiotlizard,stormrage,384,evoker,devastation,12,4,8
10294,Dragostephen,nazjatar,384,evoker,devastation,12,4,8
10295,Smacktoch,sargeras,384,evoker,devastation,12,4,8
10296,Lukamagik,boulderfist,384,evoker,devastation,12,4,8
10297,Smackthyr,thrall,384,evoker,devastation,12,4,8
10298,Dractheseus,tichondrius,384,evoker,devastation,12,4,8
10299,Rizzlordx,bleeding-hollow,384,evoker,devastation,12,4,8
10300,Nitalzith,area-52,384,evoker,devastation,12,4,8
10301,Alligatorz,sargeras,384,evoker,devastation,12,4,8
10302,Kendrac,wyrmrest-accord,384,evoker,devastation,12,4,8
10303,Cuarta,drakkari,384,evoker,devastation,12,4,8
10304,Butta,darkspear,384,evoker,devastation,12,4,8
10305,Blay,elune,384,evoker,devastation,12,4,8
10306,Baddrakthyr,moon-guard,384,evoker,devastation,12,4,8
10307,Muppetgronk,frostmourne,384,evoker,devastation,12,4,8
10308,Lindrak,azralon,384,evoker,devastation,12,4,8
10309,Munichho,spirestone,384,evoker,devastation,18,4,14
10310,Dinossauro,stormrage,383,evoker,devastation,6,4,2
10311,Rysonda,tichondrius,383,evoker,devastation,6,4,2
10312,Pläid,azuremyst,383,evoker,devastation,6,4,2
10313,Broconian,zuljin,383,evoker,devastation,12,4,8
10314,Bagelsaurus,tichondrius,383,evoker,devastation,12,4,8
10315,Jabberwockie,zuljin,383,evoker,devastation,12,4,8
10316,Äpollo,frostmourne,382,evoker,devastation,12,4,8
10317,Fearmybreath,stormrage,370,evoker,devastation,22,7,15
10318,Vermicri,zuljin,351,evoker,devastation,11,4,7
10319,Serazenoth,area-52,336,evoker,devastation,9,4,5
10320,Dragopnik,tichondrius,335,evoker,devastation,9,4,5
10321,Acindor,stormrage,335,evoker,devastation,11,4,7
10322,Carrnedge,area-52,319,evoker,devastation,5,4,1
10323,Avasd,area-52,288,evoker,devastation,6,3,3
10324,Cerisoromis,stormrage,288,evoker,devastation,6,3,3
10325,Inferna,ysera,288,evoker,devastation,6,3,3
10326,Soupywings,illidan,288,evoker,devastation,6,3,3
10327,Ceraxes,stormscale,288,evoker,devastation,6,3,3
10328,Lëåf,area-52,288,evoker,devastation,6,3,3
10329,Saintpablox,illidan,288,evoker,devastation,6,3,3
10330,Shenronda,moon-guard,288,evoker,devastation,6,3,3
10331,Yousmokemids,frostwolf,288,evoker,devastation,6,3,3
10332,Dreamfyrexi,thrall,288,evoker,devastation,6,3,3
10333,Madjeckyl,dalaran,288,evoker,devastation,6,3,3
10334,Deewey,sargeras,288,evoker,devastation,6,3,3
10335,Baddrake,moon-guard,288,evoker,devastation,6,3,3
10336,Trákanon,mugthol,288,evoker,devastation,6,3,3
10337,Jakarn,moon-guard,288,evoker,devastation,6,3,3
10338,Liefarion,barthilas,288,evoker,devastation,6,3,3
10339,Yeda,barthilas,288,evoker,devastation,6,3,3
10340,Aomend,stormrage,288,evoker,devastation,6,3,3
10341,Derkscale,stormrage,288,evoker,devastation,6,3,3
10342,Straykitty,moon-guard,288,evoker,devastation,6,3,3
10343,Deshalth,dalaran,288,evoker,devastation,6,3,3
10344,Kluath,daggerspine,288,evoker,devastation,6,3,3
10345,Hausebat,aegwynn,288,evoker,devastation,6,3,3
10346,Ripdumpster,bonechewer,288,evoker,devastation,6,3,3
10347,Magicev,tichondrius,288,evoker,devastation,6,3,3
10348,Dragoom,saurfang,288,evoker,devastation,6,3,3
10349,Drakthaer,tichondrius,288,evoker,devastation,6,3,3
10350,Platypus,tichondrius,288,evoker,devastation,6,3,3
10351,Kettor,kelthuzad,288,evoker,devastation,6,3,3
10352,Ecoera,tichondrius,288,evoker,devastation,6,3,3
10353,Bigsquirt,proudmoore,288,evoker,devastation,6,3,3
10354,Skeye,malganis,288,evoker,devastation,6,3,3
10355,Scyyterr,azralon,288,evoker,devastation,6,3,3
10356,Shennron,darkspear,288,evoker,devastation,6,3,3
10357,Spyro,nazgrel,288,evoker,devastation,6,3,3
10358,Unisex,ragnaros,288,evoker,devastation,6,3,3
10359,Brokenscales,nerzhul,288,evoker,devastation,6,3,3
10360,Lamdyn,wyrmrest-accord,288,evoker,devastation,6,3,3
10361,Dragbod,korgath,288,evoker,devastation,6,3,3
10362,Kulrainor,drakkari,288,evoker,devastation,6,3,3
10363,Varandir,frostmane,288,evoker,devastation,6,3,3
10364,Nemenyah,emerald-dream,288,evoker,devastation,6,3,3
10365,Ráigon,ragnaros,288,evoker,devastation,6,3,3
10366,Viverion,dalaran,288,evoker,devastation,10,4,6
10367,Taegon,area-52,288,evoker,devastation,10,4,6
10368,Nyldra,area-52,288,evoker,devastation,8,3,5
10369,Vandinus,stormrage,288,evoker,devastation,8,3,5
10370,Healmeta,sargeras,288,evoker,devastation,12,3,9
10371,Talonsong,wyrmrest-accord,288,evoker,devastation,12,3,9
10372,Nephrites,area-52,288,evoker,devastation,12,3,9
10373,Praac,illidan,288,evoker,devastation,12,3,9
10374,Chriszilla,tichondrius,288,evoker,devastation,12,3,9
10375,Ashenoth,antonidas,288,evoker,devastation,12,3,9
10376,Lizardlee,stormrage,288,evoker,devastation,12,3,9
10377,Enserio,stormrage,288,evoker,devastation,12,3,9
10378,Freddragon,illidan,288,evoker,devastation,12,3,9
10379,Zeralzin,aerie-peak,287,evoker,devastation,6,3,3
10380,Zenithgar,aerie-peak,287,evoker,devastation,6,3,3
10381,Evokatoke,proudmoore,287,evoker,devastation,6,3,3
10382,Myvrth,windrunner,287,evoker,devastation,12,3,9
10383,Galaxiz,bonechewer,287,evoker,devastation,12,3,9
10384,Kilnarx,uldaman,286,evoker,devastation,6,3,3
10385,Brontez,malganis,286,evoker,devastation,6,3,3
10386,Ghorin,akama,240,evoker,devastation,9,3,6
10387,Panicnodisco,zuljin,239,evoker,devastation,5,3,2
10388,Reombarth,nemesis,234,evoker,devastation,12,6,6
10389,Trrxx,tichondrius,224,evoker,devastation,10,3,7
10390,Arnoeryan,ragnaros,224,evoker,devastation,10,3,7
10391,Windylyrics,drakkari,192,evoker,devastation,6,2,4
10392,Theyevokbuda,kelthuzad,192,evoker,devastation,6,2,4
10393,Shädòwçäsper,kilrogg,192,evoker,devastation,6,2,4
10394,Racovoker,zuljin,192,evoker,devastation,6,2,4
10395,Daikon,kaelthas,192,evoker,devastation,6,2,4
10396,Dixb,illidan,192,evoker,devastation,6,2,4
10397,Vermithõr,ragnaros,192,evoker,devastation,6,2,4
10398,Nyaraoorun,uther,192,evoker,devastation,6,2,4
10399,Daebruk,ragnaros,192,evoker,devastation,6,2,4
10400,Ilithiphobia,ghostlands,192,evoker,devastation,6,2,4
10401,Siatren,shadowmoon,192,evoker,devastation,6,2,4
10402,Ralzital,auchindoun,192,evoker,devastation,6,2,4
10403,Slydawg,amanthul,192,evoker,devastation,6,2,4
10404,Analogies,stormrage,192,evoker,devastation,6,2,4
10405,Draketyr,area-52,192,evoker,devastation,6,2,4
10406,Zattanik,ragnaros,192,evoker,devastation,6,2,4
10407,Wse,illidan,192,evoker,devastation,6,2,4
10408,Pocketgiga,stormrage,192,evoker,devastation,6,2,4
10409,Lightbeing,nazjatar,192,evoker,devastation,6,2,4
10410,Mattykanish,illidan,192,evoker,devastation,6,2,4
10411,Xazxander,tichondrius,192,evoker,devastation,6,2,4
10412,Selocky,bleeding-hollow,192,evoker,devastation,6,2,4
10413,Yalena,illidan,192,evoker,devastation,6,2,4
10414,Critqueenx,destromath,192,evoker,devastation,6,2,4
10415,Eggvoker,area-52,192,evoker,devastation,6,2,4
10416,Puffed,frostmourne,192,evoker,devastation,6,2,4
10417,Joesount,frostmourne,192,evoker,devastation,6,2,4
10418,Dragonsand,area-52,192,evoker,devastation,6,2,4
10419,Daraz,tichondrius,192,evoker,devastation,6,2,4
10420,Aralzit,tichondrius,192,evoker,devastation,6,2,4
10421,Daemon,terokkar,192,evoker,devastation,6,2,4
10422,Grawlix,stormreaver,192,evoker,devastation,6,2,4
10423,Goreriders,area-52,192,evoker,devastation,6,2,4
10424,Genderboy,tichondrius,192,evoker,devastation,6,2,4
10425,Frozanat,kelthuzad,192,evoker,devastation,6,2,4
10426,Parachutes,kelthuzad,192,evoker,devastation,6,2,4
10427,Acade,tichondrius,192,evoker,devastation,6,2,4
10428,Paindragon,tol-barad,192,evoker,devastation,6,2,4
10429,Mâne,ragnaros,192,evoker,devastation,6,2,4
10430,Actïoncat,emerald-dream,192,evoker,devastation,6,2,4
10431,Nitalash,moon-guard,192,evoker,devastation,6,2,4
10432,Tasdaral,tichondrius,192,evoker,devastation,6,2,4
10433,Hellasketchy,sargeras,192,evoker,devastation,6,2,4
10434,Kazervish,wyrmrest-accord,192,evoker,devastation,6,2,4
10435,Wonyoungx,frostmourne,192,evoker,devastation,6,2,4
10436,Ytq,tichondrius,192,evoker,devastation,6,2,4
10437,Zuberion,wyrmrest-accord,192,evoker,devastation,6,2,4
10438,Brendormu,moon-guard,192,evoker,devastation,6,2,4
10439,Guavomango,moon-guard,192,evoker,devastation,6,2,4
10440,Doldorrii,terenas,192,evoker,devastation,6,2,4
10441,Desdinova,tortheldrin,192,evoker,devastation,6,2,4
10442,Dokthyr,lightbringer,192,evoker,devastation,6,2,4
10443,Darazen,scarlet-crusade,192,evoker,devastation,6,2,4
10444,Wydbro,kiljaeden,192,evoker,devastation,6,2,4
10445,Noxidian,moon-guard,192,evoker,devastation,6,2,4
10446,Kímbah,emerald-dream,192,evoker,devastation,6,2,4
10447,Magnito,thorium-brotherhood,192,evoker,devastation,6,2,4
10448,Swamper,emerald-dream,192,evoker,devastation,6,2,4
10449,Lanati,veknilash,192,evoker,devastation,6,2,4
10450,Cmdragonbalz,sargeras,192,evoker,devastation,6,2,4
10451,Cyromancerr,illidan,192,evoker,devastation,8,2,6
10452,Skizle,destromath,192,evoker,devastation,12,2,10
10453,Ragtharion,tichondrius,192,evoker,devastation,12,2,10
10454,Gamerwords,barthilas,192,evoker,devastation,12,2,10
10455,Blueblack,proudmoore,192,evoker,devastation,12,2,10
10456,Sørrøw,blades-edge,192,evoker,devastation,18,2,16
10457,Dracalis,thrall,191,evoker,devastation,6,2,4
10458,Goongdi,tichondrius,159,evoker,devastation,5,2,3
10459,Tevvez,moon-guard,159,evoker,devastation,5,2,3
10460,Deathflamee,emerald-dream,138,evoker,devastation,12,3,9
10461,Shunkagosa,frostmourne,128,evoker,devastation,4,2,2
10462,Ryü,silver-hand,128,evoker,devastation,4,2,2
10463,Eleechee,magtheridon,128,evoker,devastation,4,2,2
10464,Vïtmercon,frostmourne,128,evoker,devastation,4,2,2
10465,Booniejimbob,illidan,128,evoker,devastation,4,2,2
10466,Vormontis,azralon,112,evoker,devastation,7,2,5
10467,Tugmapvpean,kelthuzad,96,evoker,devastation,3,2,1
10468,Gavstarz,frostmourne,96,evoker,devastation,3,2,1
10469,Zealagon,ragnaros,96,evoker,devastation,6,1,5
10470,Modenzu,malganis,96,evoker,devastation,6,1,5
10471,Batterypowa,frostmourne,96,evoker,devastation,6,1,5
10472,Ackonstraza,frostmourne,96,evoker,devastation,6,1,5
10473,Bløssom,malganis,96,evoker,devastation,6,1,5
10474,Shintrax,ragnaros,96,evoker,devastation,6,1,5
10475,Dragonbornhd,tichondrius,96,evoker,devastation,6,1,5
10476,Erathiss,wyrmrest-accord,96,evoker,devastation,6,1,5
10477,Nosrej,hyjal,96,evoker,devastation,6,1,5
10478,Zinderaz,runetotem,96,evoker,devastation,6,1,5
10479,Handb,tichondrius,96,evoker,devastation,6,1,5
10480,Kurulol,ragnaros,96,evoker,devastation,6,1,5
10481,Koopa,malygos,96,evoker,devastation,6,1,5
10482,Kazadon,icecrown,96,evoker,devastation,6,1,5
10483,Asui,senjin,96,evoker,devastation,6,1,5
10484,Chillistraza,tichondrius,96,evoker,devastation,6,1,5
10485,Draconis,onyxia,96,evoker,devastation,6,1,5
10486,Aoibae,frostmourne,96,evoker,devastation,6,1,5
10487,Fígment,tichondrius,96,evoker,devastation,6,1,5
10488,Rial,frostmourne,96,evoker,devastation,6,1,5
10489,Demobreath,sargeras,96,evoker,devastation,6,1,5
10490,Charrio,illidan,96,evoker,devastation,6,1,5
10491,Bigwurrm,illidan,96,evoker,devastation,6,1,5
10492,Repd,sargeras,96,evoker,devastation,6,1,5
10493,Lucià,thrall,96,evoker,devastation,6,1,5
10494,Drakkar,elune,96,evoker,devastation,6,1,5
10495,Ðrac,bleeding-hollow,96,evoker,devastation,6,1,5
10496,Ojigi,sargeras,96,evoker,devastation,6,1,5
10497,Myjewelshurt,stormrage,96,evoker,devastation,6,1,5
10498,Warchad,stormrage,96,evoker,devastation,6,1,5
10499,Luceryz,drakkari,96,evoker,devastation,6,1,5
10500,Dracoi,illidan,96,evoker,devastation,6,1,5
10501,Pisslizard,stormrage,96,evoker,devastation,6,1,5
10502,Spyrofnir,stormrage,96,evoker,devastation,6,1,5
10503,Carnosaur,lightbringer,96,evoker,devastation,12,1,11
10504,Dracosofi,quelthalas,96,evoker,devastation,12,1,11
10505,Ysondrius,durotan,96,evoker,devastation,12,1,11
10506,Colloc,tichondrius,96,evoker,devastation,12,1,11
10507,Donormi,moon-guard,96,evoker,devastation,12,1,11
10508,Dadydafather,sargeras,96,evoker,devastation,18,1,17
10509,Embeka,illidan,95,evoker,devastation,6,1,5
10510,Bàkèd,illidan,79,evoker,devastation,5,1,4
10511,Nwo,shattered-hand,64,evoker,devastation,4,1,3
10512,Cerevok,area-52,64,evoker,devastation,4,1,3
10513,Charlestrasz,hyjal,42,evoker,devastation,11,3,8
10514,Remisha,emerald-dream,2136,hunter,marksmanship,82,44,38
10515,Darkshady,tichondrius,2108,hunter,marksmanship,84,44,40
10516,Rendel,drakkari,2038,hunter,marksmanship,143,73,70
10517,Dobarantu,tichondrius,1999,hunter,marksmanship,152,77,75
10518,Abolick,area-52,1994,hunter,marksmanship,124,64,60
10519,Imvalence,area-52,1947,hunter,marksmanship,82,36,46
10520,Globalcake,illidan,1940,hunter,marksmanship,162,86,76
10521,Fuknhunter,kiljaeden,1905,hunter,marksmanship,110,56,54
10522,Iconvoked,sargeras,1899,hunter,marksmanship,172,92,80
10523,Rakan,spinebreaker,1884,hunter,marksmanship,54,33,21
10524,Bøl,ragnaros,1882,hunter,marksmanship,30,20,10
10525,Chadsmanship,kelthuzad,1881,hunter,marksmanship,60,29,31
10526,Banshee,frostmourne,1876,hunter,marksmanship,34,22,12
10527,Hokutox,tichondrius,1870,hunter,marksmanship,68,31,37
10528,Blackjesu,blackrock,1868,hunter,marksmanship,72,33,39
10529,Renaître,tichondrius,1866,hunter,marksmanship,120,57,63
10530,Hrafn,illidan,1859,hunter,marksmanship,60,31,29
10531,Preze,moon-guard,1852,hunter,marksmanship,63,37,26
10532,Lely,tichondrius,1851,hunter,marksmanship,60,34,26
10533,Squawkers,sargeras,1848,hunter,marksmanship,78,43,35
10534,Astolenis,quelthalas,1847,hunter,marksmanship,60,29,31
10535,Hâwkêyê,thrall,1827,hunter,marksmanship,48,22,26
10536,Ingrutamig,tichondrius,1814,hunter,marksmanship,66,32,34
10537,Colada,malganis,1813,hunter,marksmanship,72,34,38
10538,Bosshunter,tichondrius,1810,hunter,marksmanship,86,43,43
10539,Nishinos,tichondrius,1808,hunter,marksmanship,183,88,95
10540,Czeroenjoyer,malganis,1803,hunter,marksmanship,66,33,33
10541,Deutêr,quelthalas,1801,hunter,marksmanship,66,35,31
10542,Trapordíe,tichondrius,1800,hunter,marksmanship,42,21,21
10543,Blaðe,kelthuzad,1794,hunter,marksmanship,84,40,44
10544,Kensho,illidan,1789,hunter,marksmanship,48,28,20
10545,Kristemis,thrall,1782,hunter,marksmanship,53,27,26
10546,Drasen,deathwing,1778,hunter,marksmanship,48,27,21
10547,Hagadinn,frostmourne,1765,hunter,marksmanship,48,21,27
10548,Boquiinha,stormrage,1759,hunter,marksmanship,90,46,44
10549,Dynith,sargeras,1756,hunter,marksmanship,39,21,18
10550,Undeadroach,tichondrius,1747,hunter,marksmanship,119,55,64
10551,Notnick,tichondrius,1747,hunter,marksmanship,84,37,47
10552,Barelyknower,area-52,1737,hunter,marksmanship,42,23,19
10553,Overgnome,ragnaros,1736,hunter,marksmanship,66,32,34
10554,Tánsøxøxø,tichondrius,1733,hunter,marksmanship,54,25,29
10555,Kkoduckk,tichondrius,1715,hunter,marksmanship,30,19,11
10556,Gohan,jubeithos,1713,hunter,marksmanship,39,22,17
10557,Blungo,azralon,1713,hunter,marksmanship,60,31,29
10558,Dolcece,tichondrius,1713,hunter,marksmanship,48,24,24
10559,Quickitty,proudmoore,1711,hunter,marksmanship,66,33,33
10560,Trapstar,aggramar,1705,hunter,marksmanship,51,31,20
10561,Babyhydra,frostmourne,1693,hunter,marksmanship,41,23,18
10562,Shatterwax,area-52,1690,hunter,marksmanship,42,21,21
10563,Ladderpolice,tichondrius,1688,hunter,marksmanship,79,42,37
10564,Tropic,proudmoore,1688,hunter,marksmanship,68,28,40
10565,Hmh,burning-legion,1686,hunter,marksmanship,197,102,95
10566,Killatrap,malganis,1677,hunter,marksmanship,42,23,19
10567,Heädshöt,malorne,1672,hunter,marksmanship,66,31,35
10568,Dudemanyeah,skullcrusher,1671,hunter,marksmanship,54,23,31
10569,Petattack,barthilas,1668,hunter,marksmanship,42,20,22
10570,Tassili,illidan,1666,hunter,marksmanship,60,23,37
10571,Vitekz,illidan,1665,hunter,marksmanship,36,25,11
10572,Shawtytraps,tichondrius,1652,hunter,marksmanship,131,53,78
10573,Gotchã,area-52,1650,hunter,marksmanship,42,27,15
10574,Aymas,sargeras,1645,hunter,marksmanship,119,62,57
10575,Surprisemfkr,emerald-dream,1637,hunter,marksmanship,60,30,30
10576,Zumago,tichondrius,1633,hunter,marksmanship,42,19,23
10577,Bigpie,daggerspine,1628,hunter,marksmanship,59,37,22
10578,Taylormadae,frostmourne,1627,hunter,marksmanship,66,37,29
10579,Gor,hyjal,1622,hunter,marksmanship,47,23,24
10580,Arjunå,sargeras,1621,hunter,marksmanship,101,56,45
10581,Easynightjr,bleeding-hollow,1620,hunter,marksmanship,225,117,108
10582,Onemoreshot,bleeding-hollow,1619,hunter,marksmanship,152,72,80
10583,Xcw,stormrage,1619,hunter,marksmanship,60,28,32
10584,Supersaiyan,antonidas,1618,hunter,marksmanship,36,17,19
10585,Alansho,tichondrius,1618,hunter,marksmanship,53,20,33
10586,Tânsøxøxø,tichondrius,1617,hunter,marksmanship,30,17,13
10587,Latesummer,tichondrius,1616,hunter,marksmanship,48,25,23
10588,Johaylon,sargeras,1616,hunter,marksmanship,42,19,23
10589,Dezertpower,sargeras,1613,hunter,marksmanship,36,20,16
10590,Snìpershot,sargeras,1612,hunter,marksmanship,61,33,28
10591,Shotashot,area-52,1612,hunter,marksmanship,36,17,19
10592,Wildder,area-52,1609,hunter,marksmanship,56,31,25
10593,Simbagrove,dalaran,1605,hunter,marksmanship,42,19,23
10594,Evaelfi,illidan,1605,hunter,marksmanship,40,17,23
10595,Tyrmaakk,emerald-dream,1604,hunter,marksmanship,40,23,17
10596,Dienasty,zuljin,1601,hunter,marksmanship,30,21,9
10597,Toxarch,aggramar,1598,hunter,marksmanship,42,20,22
10598,Headshoot,tichondrius,1594,hunter,marksmanship,59,31,28
10599,Dracõ,proudmoore,1591,hunter,marksmanship,78,39,39
10600,Jubiscleudo,azralon,1585,hunter,marksmanship,97,44,53
10601,Plopslopper,frostmourne,1580,hunter,marksmanship,48,28,20
10602,Mambothehunt,stormrage,1579,hunter,marksmanship,60,33,27
10603,Drivebymac,tichondrius,1578,hunter,marksmanship,42,21,21
10604,Dummorogh,stormrage,1578,hunter,marksmanship,108,51,57
10605,Tren,blackrock,1573,hunter,marksmanship,29,17,12
10606,Flämma,azralon,1573,hunter,marksmanship,90,40,50
10607,Richmond,lightnings-blade,1572,hunter,marksmanship,54,26,28
10608,Wìkkihx,emerald-dream,1568,hunter,marksmanship,48,25,23
10609,Papiskrill,staghelm,1568,hunter,marksmanship,91,42,49
10610,Swagprince,skullcrusher,1563,hunter,marksmanship,52,32,20
10611,Stimpblimp,jubeithos,1563,hunter,marksmanship,48,19,29
10612,Onemøreshot,bleeding-hollow,1561,hunter,marksmanship,108,54,54
10613,Saloran,akama,1560,hunter,marksmanship,84,48,36
10614,Gnomorecum,kiljaeden,1558,hunter,marksmanship,87,54,33
10615,Shotsphodays,sargeras,1558,hunter,marksmanship,72,37,35
10616,Crounzz,sargeras,1558,hunter,marksmanship,51,23,28
10617,Rampagez,tichondrius,1555,hunter,marksmanship,36,19,17
10618,Luchadoris,malganis,1552,hunter,marksmanship,60,30,30
10619,Alyywn,tichondrius,1551,hunter,marksmanship,101,44,57
10620,Hötdôg,kiljaeden,1548,hunter,marksmanship,36,20,16
10621,Mukbangbj,terenas,1546,hunter,marksmanship,70,37,33
10622,Aueria,kiljaeden,1540,hunter,marksmanship,48,18,30
10623,Hämhunter,stormrage,1539,hunter,marksmanship,48,31,17
10624,Arrowslol,stormrage,1537,hunter,marksmanship,48,23,25
10625,Huntncheekz,kelthuzad,1534,hunter,marksmanship,76,38,38
10626,Metalgear,icecrown,1533,hunter,marksmanship,66,34,32
10627,Unravel,tichondrius,1532,hunter,marksmanship,57,34,23
10628,Undien,area-52,1532,hunter,marksmanship,34,18,16
10629,Hitts,barthilas,1531,hunter,marksmanship,53,27,26
10630,Smokabombom,eredar,1530,hunter,marksmanship,34,18,16
10631,Boggartt,ragnaros,1530,hunter,marksmanship,46,21,25
10632,Zugbrained,illidan,1529,hunter,marksmanship,48,26,22
10633,Lilbang,thrall,1529,hunter,marksmanship,42,19,23
10634,Kekkww,hyjal,1526,hunter,marksmanship,48,25,23
10635,Acelol,proudmoore,1524,hunter,marksmanship,142,80,62
10636,Tommychong,shandris,1524,hunter,marksmanship,46,19,27
10637,Guacmec,tichondrius,1521,hunter,marksmanship,48,28,20
10638,Elfymcelf,arthas,1520,hunter,marksmanship,84,39,45
10639,Gretress,azralon,1520,hunter,marksmanship,66,28,38
10640,Grands,tortheldrin,1519,hunter,marksmanship,54,26,28
10641,Lsily,tichondrius,1519,hunter,marksmanship,36,16,20
10642,Maia,frostwolf,1518,hunter,marksmanship,66,30,36
10643,Bowflexen,illidan,1518,hunter,marksmanship,42,19,23
10644,Odin,goldrinn,1516,hunter,marksmanship,101,46,55
10645,Insanedabz,tichondrius,1515,hunter,marksmanship,72,35,37
10646,Wockqt,kiljaeden,1514,hunter,marksmanship,37,17,20
10647,Mehontar,area-52,1509,hunter,marksmanship,42,20,22
10648,Boomphaque,ravencrest,1506,hunter,marksmanship,76,36,40
10649,Kimghak,tichondrius,1506,hunter,marksmanship,49,20,29
10650,Lostfaith,tichondrius,1504,hunter,marksmanship,66,36,30
10651,Thebweh,ragnaros,1504,hunter,marksmanship,35,17,18
10652,Rïve,tichondrius,1504,hunter,marksmanship,36,17,19
10653,Marshen,zuljin,1503,hunter,marksmanship,36,17,19
10654,Baixiaochu,area-52,1503,hunter,marksmanship,87,41,46
10655,Huntkiller,tichondrius,1502,hunter,marksmanship,28,18,10
10656,Tup,guldan,1499,hunter,marksmanship,51,28,23
10657,Lixniqua,tichondrius,1498,hunter,marksmanship,75,38,37
10658,Bertimus,sargeras,1498,hunter,marksmanship,42,17,25
10659,Maximos,lightnings-blade,1498,hunter,marksmanship,66,25,41
10660,Papacohen,stormrage,1495,hunter,marksmanship,45,22,23
10661,Lildex,demon-soul,1494,hunter,marksmanship,30,18,12
10662,Takeiya,zuljin,1494,hunter,marksmanship,29,16,13
10663,Jotosalsa,blackrock,1494,hunter,marksmanship,48,26,22
10664,Rubinaldo,azralon,1494,hunter,marksmanship,30,16,14
10665,Föcker,emerald-dream,1492,hunter,marksmanship,25,19,6
10666,Esler,quelthalas,1490,hunter,marksmanship,54,28,26
10667,Yozsh,azralon,1485,hunter,marksmanship,47,32,15
10668,Pâl,quelthalas,1481,hunter,marksmanship,42,21,21
10669,Deliond,moon-guard,1481,hunter,marksmanship,91,45,46
10670,Booyakah,hyjal,1475,hunter,marksmanship,36,19,17
10671,Lederniertra,gorefiend,1475,hunter,marksmanship,212,109,103
10672,Windrein,ysondre,1475,hunter,marksmanship,48,20,28
10673,Barrohunt,tichondrius,1473,hunter,marksmanship,49,31,18
10674,Somethinggo,tichondrius,1472,hunter,marksmanship,161,77,84
10675,Xcisiion,nagrand,1470,hunter,marksmanship,161,82,79
10676,Scourgesurge,kiljaeden,1470,hunter,marksmanship,42,21,21
10677,Gq,garona,1470,hunter,marksmanship,36,16,20
10678,Killshøtß,tichondrius,1466,hunter,marksmanship,54,25,29
10679,Legeye,malganis,1465,hunter,marksmanship,48,21,27
10680,Sagadegêmeos,stormrage,1465,hunter,marksmanship,48,16,32
10681,Lowlore,moon-guard,1463,hunter,marksmanship,96,52,44
10682,Angelickon,tichondrius,1462,hunter,marksmanship,38,18,20
10683,Zeenuts,sargeras,1461,hunter,marksmanship,47,24,23
10684,Skybourne,nemesis,1457,hunter,marksmanship,36,23,13
10685,Bomomatic,zuljin,1454,hunter,marksmanship,30,18,12
10686,Cyrsmen,ragnaros,1454,hunter,marksmanship,75,34,41
10687,Tóri,emerald-dream,1445,hunter,marksmanship,47,25,22
10688,Bwaa,illidan,1444,hunter,marksmanship,83,38,45
10689,Chï,zuljin,1442,hunter,marksmanship,97,49,48
10690,Hemathios,drakkari,1442,hunter,marksmanship,50,21,29
10691,Amyrkvothe,ragnaros,1439,hunter,marksmanship,54,20,34
10692,Pokcmvmxckm,senjin,1433,hunter,marksmanship,66,35,31
10693,Crazyeasy,azshara,1431,hunter,marksmanship,30,15,15
10694,Lewanker,zuljin,1429,hunter,marksmanship,42,23,19
10695,Vibøra,stormrage,1429,hunter,marksmanship,126,56,70
10696,Valimhir,tichondrius,1429,hunter,marksmanship,36,16,20
10697,Mèseeks,bleeding-hollow,1427,hunter,marksmanship,60,34,26
10698,Nelosi,shadowmoon,1427,hunter,marksmanship,42,18,24
10699,Renzô,sargeras,1425,hunter,marksmanship,45,28,17
10700,Lokuhzmarcus,goldrinn,1423,hunter,marksmanship,54,30,24
10701,Timmee,bleeding-hollow,1421,hunter,marksmanship,24,15,9
10702,Leucis,cenarius,1420,hunter,marksmanship,18,15,3
10703,Boombob,sargeras,1415,hunter,marksmanship,53,24,29
10704,Backpedalftw,darrowmere,1414,hunter,marksmanship,30,15,15
10705,Zasnar,malganis,1413,hunter,marksmanship,30,15,15
10706,Aimz,zuluhed,1411,hunter,marksmanship,67,26,41
10707,Vergillx,ragnaros,1409,hunter,marksmanship,74,45,29
10708,Klannis,quelthalas,1409,hunter,marksmanship,42,19,23
10709,Ryukuzen,tichondrius,1409,hunter,marksmanship,36,15,21
10710,Dnicee,stormrage,1408,hunter,marksmanship,36,28,8
10711,Ssdslol,bleeding-hollow,1407,hunter,marksmanship,91,53,38
10712,Cashhapp,zuljin,1407,hunter,marksmanship,129,66,63
10713,Pwnagraphic,barthilas,1407,hunter,marksmanship,64,25,39
10714,Joshmckin,area-52,1406,hunter,marksmanship,116,53,63
10715,Mariaassjx,ragnaros,1406,hunter,marksmanship,102,46,56
10716,Voidmarksman,whisperwind,1404,hunter,marksmanship,49,30,19
10717,Grànd,tortheldrin,1402,hunter,marksmanship,35,17,18
10718,Slayou,uldum,1399,hunter,marksmanship,36,21,15
10719,Madsniper,thunderlord,1397,hunter,marksmanship,42,22,20
10720,Lookøut,moon-guard,1396,hunter,marksmanship,44,18,26
10721,Cholohippie,blackrock,1394,hunter,marksmanship,49,26,23
10722,Littledougie,boulderfist,1392,hunter,marksmanship,42,23,19
10723,Ashx,khazgoroth,1392,hunter,marksmanship,30,15,15
10724,Insulin,moonrunner,1390,hunter,marksmanship,36,17,19
10725,Rockenrique,nemesis,1390,hunter,marksmanship,36,16,20
10726,Trapshawty,darkspear,1389,hunter,marksmanship,48,17,31
10727,ßeãst,bladefist,1387,hunter,marksmanship,24,16,8
10728,Automatic,illidan,1386,hunter,marksmanship,51,23,28
10729,Artemyzz,tichondrius,1384,hunter,marksmanship,36,15,21
10730,Grayføxx,twisting-nether,1381,hunter,marksmanship,30,17,13
10731,Staticarrow,norgannon,1377,hunter,marksmanship,96,45,51
10732,Rumzi,thrall,1375,hunter,marksmanship,36,21,15
10733,Dominate,frostmourne,1374,hunter,marksmanship,48,23,25
10734,Hunsak,ragnaros,1373,hunter,marksmanship,30,20,10
10735,Húntingarrow,area-52,1373,hunter,marksmanship,72,36,36
10736,Idiiot,sargeras,1373,hunter,marksmanship,68,33,35
10737,Precísion,malganis,1372,hunter,marksmanship,35,18,17
10738,Gorîlla,sargeras,1371,hunter,marksmanship,66,31,35
10739,Leshwi,ragnaros,1370,hunter,marksmanship,47,23,24
10740,Wìllòw,khazgoroth,1368,hunter,marksmanship,42,16,26
10741,Malebolick,ragnaros,1367,hunter,marksmanship,65,27,38
10742,Lukhas,moon-guard,1367,hunter,marksmanship,60,24,36
10743,Blackhuntr,garona,1366,hunter,marksmanship,187,97,90
10744,Adive,drakkari,1366,hunter,marksmanship,73,34,39
10745,Chokemescara,stormrage,1364,hunter,marksmanship,36,16,20
10746,Jumaanji,gurubashi,1362,hunter,marksmanship,70,36,34
10747,Kronicbeast,bleeding-hollow,1360,hunter,marksmanship,96,42,54
10748,Bowinc,greymane,1357,hunter,marksmanship,24,15,9
10749,Benme,illidan,1357,hunter,marksmanship,162,73,89
10750,Pleyadez,drakkari,1356,hunter,marksmanship,42,24,18
10751,Braxigarr,area-52,1356,hunter,marksmanship,217,104,113
10752,Elendïr,tichondrius,1353,hunter,marksmanship,48,25,23
10753,Watchmanjoe,grizzly-hills,1350,hunter,marksmanship,54,30,24
10754,Uwuessy,illidan,1348,hunter,marksmanship,66,30,36
10755,Kyukon,illidan,1345,hunter,marksmanship,36,18,18
10756,Diisdik,tichondrius,1344,hunter,marksmanship,51,23,28
10757,Mizhu,ragnaros,1343,hunter,marksmanship,70,38,32
10758,Bootywhop,dalaran,1342,hunter,marksmanship,24,14,10
10759,Hurstt,kelthuzad,1341,hunter,marksmanship,56,27,29
10760,Ripmytoast,chogall,1338,hunter,marksmanship,169,94,75
10761,Huntonthic,korgath,1338,hunter,marksmanship,38,16,22
10762,Toniic,moon-guard,1337,hunter,marksmanship,54,33,21
10763,Vonkrieg,tichondrius,1337,hunter,marksmanship,36,14,22
10764,Orgpopeyes,illidan,1336,hunter,marksmanship,24,14,10
10765,Dvei,silvermoon,1336,hunter,marksmanship,57,25,32
10766,Azaz,khaz-modan,1332,hunter,marksmanship,54,25,29
10767,Tonnyfab,ragnaros,1326,hunter,marksmanship,34,19,15
10768,Hukkx,kalecgos,1325,hunter,marksmanship,50,22,28
10769,Dathunterr,azralon,1325,hunter,marksmanship,65,28,37
10770,Softhunter,tichondrius,1324,hunter,marksmanship,36,14,22
10771,Murza,korgath,1323,hunter,marksmanship,24,15,9
10772,Xhartanis,magtheridon,1323,hunter,marksmanship,63,31,32
10773,Kä,blackhand,1321,hunter,marksmanship,66,28,38
10774,Ahegoface,frostmourne,1321,hunter,marksmanship,54,19,35
10775,Ärtémisa,quelthalas,1320,hunter,marksmanship,35,19,16
10776,Tristiae,stormrage,1319,hunter,marksmanship,67,36,31
10777,Péppérmínt,korgath,1318,hunter,marksmanship,22,15,7
10778,Dogezandalar,illidan,1317,hunter,marksmanship,40,18,22
10779,Explosief,area-52,1315,hunter,marksmanship,60,30,30
10780,Ricas,malganis,1315,hunter,marksmanship,98,44,54
10781,Shooterzz,illidan,1314,hunter,marksmanship,24,16,8
10782,Akomata,emerald-dream,1313,hunter,marksmanship,24,14,10
10783,Shøtii,tichondrius,1309,hunter,marksmanship,24,14,10
10784,Condorexe,illidan,1307,hunter,marksmanship,72,28,44
10785,Smoothbrain,khadgar,1307,hunter,marksmanship,52,19,33
10786,Thirià,garona,1306,hunter,marksmanship,18,14,4
10787,Rekshot,amanthul,1306,hunter,marksmanship,150,73,77
10788,Jeezyxxii,shadowmoon,1305,hunter,marksmanship,36,15,21
10789,Wolverhino,thrall,1304,hunter,marksmanship,48,21,27
10790,Albe,azralon,1303,hunter,marksmanship,76,37,39
10791,Cocobread,stormreaver,1303,hunter,marksmanship,48,21,27
10792,Snewboy,malganis,1299,hunter,marksmanship,24,14,10
10793,Celph,moon-guard,1299,hunter,marksmanship,48,20,28
10794,Sleepyjoee,dalaran,1297,hunter,marksmanship,36,18,18
10795,Gunther,korgath,1296,hunter,marksmanship,30,14,16
10796,Mensrea,illidan,1294,hunter,marksmanship,47,30,17
10797,Markymarc,tichondrius,1294,hunter,marksmanship,35,14,21
10798,Déadshot,thaurissan,1294,hunter,marksmanship,36,14,22
10799,Urtthel,stormrage,1293,hunter,marksmanship,28,17,11
10800,Krattøs,bleeding-hollow,1293,hunter,marksmanship,34,16,18
10801,Rhaygon,arthas,1293,hunter,marksmanship,39,16,23
10802,Ghudi,moon-guard,1292,hunter,marksmanship,26,15,11
10803,Swolfp,tichondrius,1291,hunter,marksmanship,40,16,24
10804,Glediator,tichondrius,1288,hunter,marksmanship,112,51,61
10805,Shadowhokage,zuljin,1286,hunter,marksmanship,30,14,16
10806,Kalibah,azralon,1285,hunter,marksmanship,81,30,51
10807,Hoboh,illidan,1284,hunter,marksmanship,77,34,43
10808,Toowizeë,barthilas,1284,hunter,marksmanship,35,14,21
10809,Juhyeon,tichondrius,1284,hunter,marksmanship,46,17,29
10810,Gromtheponch,area-52,1280,hunter,marksmanship,43,22,21
10811,Rawrzy,sargeras,1278,hunter,marksmanship,29,14,15
10812,Lotatinyfish,malganis,1275,hunter,marksmanship,36,20,16
10813,Bojob,azgalor,1275,hunter,marksmanship,51,26,25
10814,Amanazàra,tichondrius,1275,hunter,marksmanship,48,23,25
10815,Sniperarmy,dalaran,1274,hunter,marksmanship,103,52,51
10816,Darylovejr,destromath,1274,hunter,marksmanship,38,16,22
10817,Nights,nemesis,1271,hunter,marksmanship,24,15,9
10818,Gothew,turalyon,1270,hunter,marksmanship,24,14,10
10819,Thaden,akama,1268,hunter,marksmanship,36,17,19
10820,Zaheerz,sargeras,1268,hunter,marksmanship,30,14,16
10821,Picaubica,kiljaeden,1268,hunter,marksmanship,41,15,26
10822,Spyhunter,malganis,1266,hunter,marksmanship,67,28,39
10823,Xephert,ragnaros,1265,hunter,marksmanship,48,22,26
10824,Cloudbuck,aegwynn,1262,hunter,marksmanship,58,22,36
10825,Apaweclover,stormrage,1259,hunter,marksmanship,250,123,127
10826,Lightweight,kelthuzad,1257,hunter,marksmanship,47,22,25
10827,Ragnarlobkk,ragnaros,1255,hunter,marksmanship,51,26,25
10828,Jerybery,gundrak,1253,hunter,marksmanship,29,18,11
10829,Solomine,jubeithos,1251,hunter,marksmanship,36,15,21
10830,Ëzy,frostmourne,1246,hunter,marksmanship,60,33,27
10831,Comebacks,ragnaros,1245,hunter,marksmanship,24,13,11
10832,Duruainn,zuljin,1245,hunter,marksmanship,73,33,40
10833,Hoeswannafuk,stormrage,1243,hunter,marksmanship,24,13,11
10834,Vipermaster,azralon,1243,hunter,marksmanship,46,24,22
10835,Oattes,daggerspine,1243,hunter,marksmanship,30,13,17
10836,Hogshanks,moon-guard,1242,hunter,marksmanship,24,13,11
10837,Booffmeister,area-52,1242,hunter,marksmanship,24,13,11
10838,Seenobody,stormrage,1242,hunter,marksmanship,100,51,49
10839,Rudekeef,illidan,1240,hunter,marksmanship,24,13,11
10840,Lafleche,kiljaeden,1239,hunter,marksmanship,29,15,14
10841,Islachan,ragnaros,1238,hunter,marksmanship,30,13,17
10842,Coolwhip,demon-soul,1237,hunter,marksmanship,40,20,20
10843,Hunimi,elune,1237,hunter,marksmanship,32,14,18
10844,Birgite,stormrage,1237,hunter,marksmanship,48,17,31
10845,Sootgarbage,sargeras,1235,hunter,marksmanship,18,13,5
10846,Pokeyourbutt,hydraxis,1235,hunter,marksmanship,24,13,11
10847,Killz,skullcrusher,1234,hunter,marksmanship,44,21,23
10848,Drillklinton,tichondrius,1234,hunter,marksmanship,42,18,24
10849,Lolknocked,alexstrasza,1233,hunter,marksmanship,27,14,13
10850,Enuk,nagrand,1232,hunter,marksmanship,52,26,26
10851,Gstring,kelthuzad,1232,hunter,marksmanship,78,31,47
10852,Chikkynuggy,destromath,1228,hunter,marksmanship,33,14,19
10853,Fuzzypjs,stormrage,1226,hunter,marksmanship,33,14,19
10854,Caylix,sargeras,1216,hunter,marksmanship,36,14,22
10855,Targetreaper,proudmoore,1215,hunter,marksmanship,24,13,11
10856,Sukr,korgath,1215,hunter,marksmanship,98,37,61
10857,Give,draktharon,1214,hunter,marksmanship,33,14,19
10858,Malkuri,medivh,1213,hunter,marksmanship,35,13,22
10859,Puresport,hyjal,1212,hunter,marksmanship,24,13,11
10860,Kritsu,tichondrius,1209,hunter,marksmanship,41,20,21
10861,Chainmaster,misha,1204,hunter,marksmanship,97,47,50
10862,Augus,eredar,1202,hunter,marksmanship,41,15,26
10863,Buckethole,doomhammer,1198,hunter,marksmanship,36,18,18
10864,Calî,stormscale,1195,hunter,marksmanship,30,14,16
10865,Vinranya,sargeras,1194,hunter,marksmanship,75,34,41
10866,Chaðs,amanthul,1190,hunter,marksmanship,39,21,18
10867,Kayzia,lightninghoof,1190,hunter,marksmanship,29,13,16
10868,Raneldar,proudmoore,1190,hunter,marksmanship,96,37,59
10869,Bluecoral,frostmourne,1189,hunter,marksmanship,51,21,30
10870,Valieev,black-dragonflight,1188,hunter,marksmanship,42,25,17
10871,Ilovehippos,laughing-skull,1188,hunter,marksmanship,145,67,78
10872,Forthethrill,area-52,1187,hunter,marksmanship,45,24,21
10873,Oopsurtrappd,darkspear,1186,hunter,marksmanship,29,16,13
10874,Juicyjams,moon-guard,1186,hunter,marksmanship,24,13,11
10875,Sunnimuffens,deathwing,1181,hunter,marksmanship,47,23,24
10876,Zock,lothar,1181,hunter,marksmanship,98,47,51
10877,Fova,wyrmrest-accord,1179,hunter,marksmanship,19,14,5
10878,Doubletappz,stormrage,1178,hunter,marksmanship,36,15,21
10879,Chïnchïlla,zuljin,1176,hunter,marksmanship,21,14,7
10880,Rocroc,gurubashi,1175,hunter,marksmanship,66,29,37
10881,Silverweaver,illidan,1174,hunter,marksmanship,30,15,15
10882,Ellishunter,frostmourne,1174,hunter,marksmanship,64,23,41
10883,Aftërlyfe,tichondrius,1170,hunter,marksmanship,29,14,15
10884,Critaclyzm,moon-guard,1169,hunter,marksmanship,36,14,22
10885,Patmypet,terenas,1167,hunter,marksmanship,30,14,16
10886,Mezmore,thrall,1167,hunter,marksmanship,54,24,30
10887,Moüserat,moon-guard,1162,hunter,marksmanship,114,55,59
10888,Netorip,azralon,1161,hunter,marksmanship,27,13,14
10889,Miscreant,kelthuzad,1160,hunter,marksmanship,32,13,19
10890,Cu,frostmourne,1159,hunter,marksmanship,19,13,6
10891,Primalus,tichondrius,1152,hunter,marksmanship,24,12,12
10892,Hunterlist,frostmourne,1151,hunter,marksmanship,24,12,12
10893,Negãn,tichondrius,1151,hunter,marksmanship,24,12,12
10894,Bowdown,moon-guard,1150,hunter,marksmanship,54,28,26
10895,Killincrew,scilla,1149,hunter,marksmanship,38,19,19
10896,Spunky,zuluhed,1149,hunter,marksmanship,24,12,12
10897,Floozyfairy,daggerspine,1149,hunter,marksmanship,53,26,27
10898,Zuuvuya,nemesis,1149,hunter,marksmanship,56,20,36
10899,Nes,azuremyst,1148,hunter,marksmanship,24,12,12
10900,Spiketurtle,queldorei,1148,hunter,marksmanship,30,13,17
10901,Clemenlemon,illidan,1147,hunter,marksmanship,24,14,10
10902,Ocromiun,illidan,1146,hunter,marksmanship,39,13,26
10903,Topshotx,tichondrius,1145,hunter,marksmanship,18,12,6
10904,Desolater,bleeding-hollow,1143,hunter,marksmanship,36,12,24
10905,Inability,emerald-dream,1142,hunter,marksmanship,30,12,18
10906,Jenniekim,mugthol,1141,hunter,marksmanship,19,13,6
10907,Sugarboyy,darkspear,1141,hunter,marksmanship,30,14,16
10908,Alindra,zuluhed,1141,hunter,marksmanship,60,25,35
10909,Òriòn,tichondrius,1141,hunter,marksmanship,36,12,24
10910,Zgabriel,azralon,1140,hunter,marksmanship,24,12,12
10911,Stupidgodx,tichondrius,1140,hunter,marksmanship,24,12,12
10912,Foxhe,hyjal,1137,hunter,marksmanship,42,22,20
10913,Tenlbbow,illidan,1137,hunter,marksmanship,24,12,12
10914,Cßo,tichondrius,1135,hunter,marksmanship,60,27,33
10915,Sï,anubarak,1135,hunter,marksmanship,30,12,18
10916,Vhan,azralon,1133,hunter,marksmanship,44,19,25
10917,Oqqo,tichondrius,1132,hunter,marksmanship,51,21,30
10918,Jarloo,madoran,1129,hunter,marksmanship,35,19,16
10919,Bigolhippy,frostmourne,1129,hunter,marksmanship,24,12,12
10920,Táká,quelthalas,1129,hunter,marksmanship,30,13,17
10921,Kánnah,ragnaros,1126,hunter,marksmanship,120,63,57
10922,Clockwörk,sargeras,1125,hunter,marksmanship,21,13,8
10923,Tiofil,goldrinn,1124,hunter,marksmanship,24,14,10
10924,Linedalina,wyrmrest-accord,1119,hunter,marksmanship,30,14,16
10925,Starkmeister,stormrage,1118,hunter,marksmanship,30,12,18
10926,Wixyy,aegwynn,1114,hunter,marksmanship,58,23,35
10927,Pikochon,illidan,1114,hunter,marksmanship,47,15,32
10928,Mathund,gurubashi,1112,hunter,marksmanship,131,60,71
10929,Yaboismokey,aerie-peak,1112,hunter,marksmanship,35,15,20
10930,Grimbleneep,emerald-dream,1111,hunter,marksmanship,40,16,24
10931,Daytrade,stormrage,1108,hunter,marksmanship,18,12,6
10932,Repotro,drakkari,1108,hunter,marksmanship,42,14,28
10933,Aoolfs,stormrage,1107,hunter,marksmanship,48,20,28
10934,Halibut,quelthalas,1106,hunter,marksmanship,47,25,22
10935,Bemaa,frostmourne,1106,hunter,marksmanship,42,21,21
10936,Rykár,kiljaeden,1106,hunter,marksmanship,24,12,12
10937,Huuntard,proudmoore,1104,hunter,marksmanship,29,12,17
10938,Týrak,illidan,1100,hunter,marksmanship,24,12,12
10939,Bentrick,altar-of-storms,1097,hunter,marksmanship,33,18,15
10940,Udietofast,illidan,1092,hunter,marksmanship,77,31,46
10941,Veranir,nemesis,1091,hunter,marksmanship,98,49,49
10942,Mikeangel,hydraxis,1091,hunter,marksmanship,27,12,15
10943,Yadír,quelthalas,1091,hunter,marksmanship,66,29,37
10944,Malo,dragonmaw,1090,hunter,marksmanship,30,16,14
10945,Angelacross,azralon,1087,hunter,marksmanship,54,26,28
10946,Sitaelh,quelthalas,1082,hunter,marksmanship,30,17,13
10947,Maxwel,sargeras,1082,hunter,marksmanship,175,86,89
10948,Ud,eldrethalas,1081,hunter,marksmanship,17,12,5
10949,Lezzbow,tichondrius,1081,hunter,marksmanship,61,32,29
10950,Redskul,azralon,1081,hunter,marksmanship,30,15,15
10951,Ackzar,ragnaros,1077,hunter,marksmanship,76,37,39
10952,Chetta,ragnaros,1075,hunter,marksmanship,41,14,27
10953,Pewpow,barthilas,1072,hunter,marksmanship,60,28,32
10954,Katebishop,nemesis,1071,hunter,marksmanship,22,12,10
10955,Towness,kelthuzad,1067,hunter,marksmanship,48,23,25
10956,Fartingshot,proudmoore,1065,hunter,marksmanship,35,13,22
10957,Thoopered,korgath,1062,hunter,marksmanship,65,33,32
10958,Thunter,kiljaeden,1060,hunter,marksmanship,24,14,10
10959,Piloks,gallywix,1058,hunter,marksmanship,42,20,22
10960,Imperatrix,emerald-dream,1058,hunter,marksmanship,72,25,47
10961,Runsfromcops,sargeras,1056,hunter,marksmanship,18,11,7
10962,Gvjellybeans,tichondrius,1056,hunter,marksmanship,18,11,7
10963,Ryutiz,fizzcrank,1056,hunter,marksmanship,30,11,19
10964,Orber,stormrage,1055,hunter,marksmanship,18,11,7
10965,Redzic,tichondrius,1054,hunter,marksmanship,18,11,7
10966,Landon,lightnings-blade,1054,hunter,marksmanship,24,11,13
10967,Inktray,durotan,1054,hunter,marksmanship,30,11,19
10968,Longshánks,stormrage,1052,hunter,marksmanship,24,11,13
10969,Callenna,zuljin,1051,hunter,marksmanship,18,11,7
10970,Shootipie,hyjal,1051,hunter,marksmanship,18,11,7
10971,Tråppin,sargeras,1050,hunter,marksmanship,21,12,9
10972,Blimpbooty,stormrage,1050,hunter,marksmanship,24,11,13
10973,Balun,sargeras,1049,hunter,marksmanship,24,11,13
10974,Vansatih,azralon,1047,hunter,marksmanship,66,27,39
10975,Fëanora,quelthalas,1044,hunter,marksmanship,24,11,13
10976,Sumom,darrowmere,1043,hunter,marksmanship,99,45,54
10977,Porkerr,black-dragonflight,1040,hunter,marksmanship,48,25,23
10978,Corruptid,moon-guard,1039,hunter,marksmanship,18,11,7
10979,Tazent,moon-guard,1039,hunter,marksmanship,24,11,13
10980,Deadalot,dalaran,1038,hunter,marksmanship,18,11,7
10981,Yoimiya,thunderlord,1036,hunter,marksmanship,41,18,23
10982,Baldor,stormrage,1036,hunter,marksmanship,66,27,39
10983,Sartros,drakkari,1034,hunter,marksmanship,19,13,6
10984,Huntnfizzle,dethecus,1031,hunter,marksmanship,18,11,7
10985,Nelandris,tichondrius,1031,hunter,marksmanship,60,25,35
10986,Vendortrash,aggramar,1029,hunter,marksmanship,24,12,12
10987,Trìggered,dark-iron,1028,hunter,marksmanship,30,13,17
10988,Delukzin,azralon,1028,hunter,marksmanship,38,13,25
10989,Silenciozzo,azralon,1026,hunter,marksmanship,42,17,25
10990,Emeri,winterhoof,1025,hunter,marksmanship,18,11,7
10991,Wwing,frostwolf,1023,hunter,marksmanship,244,120,124
10992,Benryats,area-52,1019,hunter,marksmanship,36,11,25
10993,Metalstorm,draenor,1018,hunter,marksmanship,23,11,12
10994,Madogite,azralon,1017,hunter,marksmanship,66,37,29
10995,Flacidhunter,kelthuzad,1017,hunter,marksmanship,30,12,18
10996,Shukucingjr,illidan,1015,hunter,marksmanship,39,23,16
10997,Kødran,stormrage,1013,hunter,marksmanship,54,26,28
10998,Jzander,ragnaros,1010,hunter,marksmanship,20,13,7
10999,Thyraza,proudmoore,1010,hunter,marksmanship,24,11,13
11000,Secure,doomhammer,1010,hunter,marksmanship,42,18,24
11001,Triggaplease,jubeithos,1008,hunter,marksmanship,67,37,30
11002,Killerxzxz,stormrage,1007,hunter,marksmanship,24,13,11
11003,Aïmïng,tichondrius,1006,hunter,marksmanship,24,11,13
11004,Salsa,hakkar,1005,hunter,marksmanship,107,39,68
11005,Brenri,boulderfist,1003,hunter,marksmanship,30,15,15
11006,Styles,thaurissan,1003,hunter,marksmanship,24,12,12
11007,Torturekilla,bleeding-hollow,1003,hunter,marksmanship,54,26,28
11008,Koonorc,dalaran,998,hunter,marksmanship,46,22,24
11009,Kalinor,cenarius,992,hunter,marksmanship,42,18,24
11010,Balgair,hakkar,991,hunter,marksmanship,46,24,22
11011,Scottcrume,area-52,990,hunter,marksmanship,60,27,33
11012,Nelay,ragnaros,988,hunter,marksmanship,23,11,12
11013,Ritler,frostmourne,987,hunter,marksmanship,21,11,10
11014,Myrfes,ragnaros,982,hunter,marksmanship,28,11,17
11015,Àbyss,shandris,982,hunter,marksmanship,42,15,27
11016,Kuramax,senjin,975,hunter,marksmanship,89,39,50
11017,Galaxxis,bonechewer,974,hunter,marksmanship,51,26,25
11018,Iiwii,burning-legion,969,hunter,marksmanship,19,11,8
11019,Tiidkloul,illidan,968,hunter,marksmanship,18,12,6
11020,Reanivan,kiljaeden,968,hunter,marksmanship,66,24,42
11021,Drjingajanga,zuluhed,961,hunter,marksmanship,33,13,20
11022,Hanabanana,wyrmrest-accord,960,hunter,marksmanship,12,10,2
11023,Nainit,sargeras,960,hunter,marksmanship,18,10,8
11024,Goonsh,tichondrius,960,hunter,marksmanship,18,10,8
11025,Zota,frostmourne,960,hunter,marksmanship,18,10,8
11026,Kagaramar,hellscream,960,hunter,marksmanship,21,11,10
11027,Taumelz,sargeras,960,hunter,marksmanship,24,10,14
11028,Sylvaa,tichondrius,960,hunter,marksmanship,30,10,20
11029,Brewster,burning-legion,959,hunter,marksmanship,24,10,14
11030,Ñðñdêsçrípt,frostmourne,959,hunter,marksmanship,30,10,20
11031,Austelos,moon-guard,958,hunter,marksmanship,18,10,8
11032,Lilnatty,area-52,958,hunter,marksmanship,27,11,16
11033,Deadshöt,bleeding-hollow,958,hunter,marksmanship,30,10,20
11034,Revo,darkspear,957,hunter,marksmanship,18,10,8
11035,Zulorion,the-forgotten-coast,956,hunter,marksmanship,24,10,14
11036,Dartháne,moon-guard,956,hunter,marksmanship,29,11,18
11037,Chuvug,quelthalas,955,hunter,marksmanship,24,10,14
11038,Grimcask,ragnaros,955,hunter,marksmanship,24,10,14
11039,Klitz,lightninghoof,954,hunter,marksmanship,18,10,8
11040,Hawkeyë,ragnaros,954,hunter,marksmanship,18,10,8
11041,Daymanaahh,malfurion,954,hunter,marksmanship,24,10,14
11042,Xaveco,gallywix,954,hunter,marksmanship,58,23,35
11043,Twist,burning-legion,953,hunter,marksmanship,12,10,2
11044,Skelyeelegno,perenolde,953,hunter,marksmanship,18,10,8
11045,Shuweet,moon-guard,953,hunter,marksmanship,24,10,14
11046,Damadar,tichondrius,953,hunter,marksmanship,24,10,14
11047,Konar,nemesis,952,hunter,marksmanship,60,23,37
11048,Verdao,stormrage,952,hunter,marksmanship,30,10,20
11049,Moonet,amanthul,948,hunter,marksmanship,18,10,8
11050,Vanhe,quelthalas,947,hunter,marksmanship,18,10,8
11051,Katnie,azralon,947,hunter,marksmanship,52,25,27
11052,Milktoker,tichondrius,947,hunter,marksmanship,24,10,14
11053,Globlauncher,tichondrius,946,hunter,marksmanship,18,10,8
11054,Moktarg,archimonde,936,hunter,marksmanship,29,11,18
11055,Lazygnome,azshara,934,hunter,marksmanship,23,11,12
11056,Zarely,frostmourne,932,hunter,marksmanship,24,10,14
11057,Nachtcloverr,stormrage,931,hunter,marksmanship,63,27,36
11058,Jamzlol,frostmourne,930,hunter,marksmanship,23,14,9
11059,Thundershots,tichondrius,927,hunter,marksmanship,62,23,39
11060,Adbéélitø,ragnaros,926,hunter,marksmanship,36,18,18
11061,Silhouettes,barthilas,923,hunter,marksmanship,27,13,14
11062,Ontarget,cairne,921,hunter,marksmanship,76,34,42
11063,Wael,perenolde,920,hunter,marksmanship,29,10,19
11064,Viciosa,bleeding-hollow,914,hunter,marksmanship,30,16,14
11065,Dairoxd,drakkari,912,hunter,marksmanship,29,14,15
11066,Zievieda,hellscream,910,hunter,marksmanship,24,12,12
11067,Lauannÿ,gallywix,910,hunter,marksmanship,118,55,63
11068,Blaws,tichondrius,906,hunter,marksmanship,27,10,17
11069,Onehitrip,illidan,904,hunter,marksmanship,90,38,52
11070,Flechá,illidan,900,hunter,marksmanship,17,10,7
11071,Desolateone,nazgrel,900,hunter,marksmanship,42,21,21
11072,Déadlyshot,tichondrius,900,hunter,marksmanship,77,36,41
11073,Cazadorelite,tichondrius,900,hunter,marksmanship,59,16,43
11074,Huntercotoco,azralon,894,hunter,marksmanship,47,24,23
11075,Amonerhunter,bleeding-hollow,893,hunter,marksmanship,24,11,13
11076,Fourkayiv,azgalor,889,hunter,marksmanship,41,18,23
11077,Brenogam,azralon,884,hunter,marksmanship,33,16,17
11078,Yamanashi,black-dragonflight,884,hunter,marksmanship,114,55,59
11079,Ganeva,sargeras,883,hunter,marksmanship,30,14,16
11080,Alleessa,goldrinn,883,hunter,marksmanship,54,21,33
11081,Jetlinx,thrall,881,hunter,marksmanship,21,12,9
11082,Nightwatch,kelthuzad,877,hunter,marksmanship,18,10,8
11083,Rödrigö,azralon,876,hunter,marksmanship,30,14,16
11084,Thaendra,moon-guard,865,hunter,marksmanship,23,11,12
11085,Karazuba,ragnaros,865,hunter,marksmanship,89,33,56
11086,Eratichunt,illidan,864,hunter,marksmanship,18,9,9
11087,Xonios,frostwolf,864,hunter,marksmanship,24,9,15
11088,Hunghang,frostmourne,864,hunter,marksmanship,24,9,15
11089,Singletap,barthilas,864,hunter,marksmanship,24,9,15
11090,Trapkeithx,frostmourne,864,hunter,marksmanship,24,9,15
11091,Drãgenox,quelthalas,864,hunter,marksmanship,24,9,15
11092,Keenz,frostmourne,864,hunter,marksmanship,24,9,15
11093,Rambot,bleeding-hollow,863,hunter,marksmanship,12,9,3
11094,Photos,moon-guard,863,hunter,marksmanship,14,9,5
11095,Pkn,chogall,863,hunter,marksmanship,18,9,9
11096,Ohifren,proudmoore,863,hunter,marksmanship,18,9,9
11097,Dôntlosmebro,stormrage,863,hunter,marksmanship,18,9,9
11098,Ultrasj,malfurion,863,hunter,marksmanship,18,9,9
11099,Telånnas,illidan,863,hunter,marksmanship,18,9,9
11100,Torrthack,area-52,863,hunter,marksmanship,18,9,9
11101,Dayanier,ragnaros,863,hunter,marksmanship,18,9,9
11102,Bacchantress,tichondrius,863,hunter,marksmanship,18,9,9
11103,Junglejam,elune,863,hunter,marksmanship,24,9,15
11104,Nosmoke,kargath,863,hunter,marksmanship,24,9,15
11105,Vivaswan,tichondrius,863,hunter,marksmanship,24,9,15
11106,Fangs,arthas,862,hunter,marksmanship,12,9,3
11107,Ðaybreâker,tichondrius,862,hunter,marksmanship,12,9,3
11108,Airpodpro,emerald-dream,862,hunter,marksmanship,12,9,3
11109,Mídnîght,azralon,862,hunter,marksmanship,18,9,9
11110,Syrach,area-52,862,hunter,marksmanship,18,9,9
11111,Audioannie,thrall,862,hunter,marksmanship,18,9,9
11112,Varrinda,wyrmrest-accord,862,hunter,marksmanship,24,9,15
11113,Insgesicht,proudmoore,862,hunter,marksmanship,24,9,15
11114,Snipastyle,twisting-nether,861,hunter,marksmanship,30,9,21
11115,Twistedtawl,area-52,860,hunter,marksmanship,18,9,9
11116,Junka,bleeding-hollow,860,hunter,marksmanship,18,9,9
11117,Illt,blackrock,860,hunter,marksmanship,18,9,9
11118,Loyalrely,tichondrius,859,hunter,marksmanship,18,9,9
11119,Arzant,quelthalas,858,hunter,marksmanship,12,9,3
11120,Coldhunger,uldum,857,hunter,marksmanship,12,9,3
11121,Trikshot,magtheridon,855,hunter,marksmanship,18,10,8
11122,Herroo,thrall,855,hunter,marksmanship,30,9,21
11123,Azx,tichondrius,851,hunter,marksmanship,18,9,9
11124,Avindal,greymane,850,hunter,marksmanship,18,9,9
11125,Iililillilii,tichondrius,848,hunter,marksmanship,28,12,16
11126,Kazzanval,sargeras,843,hunter,marksmanship,18,9,9
11127,Zettl,eredar,843,hunter,marksmanship,78,32,46
11128,Jvmr,azralon,842,hunter,marksmanship,38,17,21
11129,Arbeis,area-52,841,hunter,marksmanship,42,11,31
11130,Apochuntz,greymane,839,hunter,marksmanship,24,11,13
11131,Zelanst,illidan,838,hunter,marksmanship,18,9,9
11132,Muggzzy,malygos,824,hunter,marksmanship,18,9,9
11133,Iamtotoro,area-52,809,hunter,marksmanship,28,9,19
11134,Richihunt,ragnaros,802,hunter,marksmanship,32,10,22
11135,Ciils,sargeras,798,hunter,marksmanship,22,9,13
11136,Fian,lightnings-blade,797,hunter,marksmanship,22,9,13
11137,Skyloss,illidan,775,hunter,marksmanship,42,12,30
11138,Tamsynn,stormrage,769,hunter,marksmanship,54,15,39
11139,Entrapment,stormrage,768,hunter,marksmanship,12,8,4
11140,Doves,wyrmrest-accord,768,hunter,marksmanship,12,8,4
11141,Ashx,nemesis,768,hunter,marksmanship,12,8,4
11142,Ragshunt,stormrage,768,hunter,marksmanship,12,8,4
11143,Achillez,bleeding-hollow,768,hunter,marksmanship,18,8,10
11144,Soul,sargeras,768,hunter,marksmanship,24,8,16
11145,Tharlor,aegwynn,768,hunter,marksmanship,24,8,16
11146,Woeisyou,stormrage,768,hunter,marksmanship,24,8,16
11147,Civvo,dalaran,768,hunter,marksmanship,24,8,16
11148,Shootybooty,arygos,768,hunter,marksmanship,24,8,16
11149,Suyesh,tichondrius,767,hunter,marksmanship,12,8,4
11150,Cimotsw,stormrage,767,hunter,marksmanship,12,8,4
11151,Huntnmaster,thrall,767,hunter,marksmanship,12,8,4
11152,Mensita,quelthalas,767,hunter,marksmanship,18,8,10
11153,Zengrin,quelthalas,767,hunter,marksmanship,18,8,10
11154,Cufless,proudmoore,767,hunter,marksmanship,18,8,10
11155,Ravanskull,burning-blade,767,hunter,marksmanship,18,8,10
11156,Xtina,drakkari,767,hunter,marksmanship,18,8,10
11157,Aewyn,malganis,767,hunter,marksmanship,18,8,10
11158,Vileplumè,stormrage,767,hunter,marksmanship,18,8,10
11159,Yory,tol-barad,767,hunter,marksmanship,18,8,10
11160,Runethkape,kelthuzad,767,hunter,marksmanship,18,8,10
11161,Waqz,tichondrius,767,hunter,marksmanship,18,8,10
11162,Diertz,area-52,767,hunter,marksmanship,18,8,10
11163,Rickshaw,frostmourne,767,hunter,marksmanship,18,8,10
11164,Tarah,lightbringer,767,hunter,marksmanship,24,8,16
11165,Mööky,frostmourne,766,hunter,marksmanship,12,8,4
11166,Saltz,tichondrius,766,hunter,marksmanship,12,8,4
11167,Ramdy,quelthalas,766,hunter,marksmanship,12,8,4
11168,Zèd,azralon,766,hunter,marksmanship,18,8,10
11169,Ladright,altar-of-storms,766,hunter,marksmanship,18,8,10
11170,Trochillidae,dragonmaw,766,hunter,marksmanship,18,8,10
11171,Raiku,aggramar,766,hunter,marksmanship,18,8,10
11172,Noeffort,frostmourne,766,hunter,marksmanship,18,8,10
11173,Deathspot,thrall,766,hunter,marksmanship,18,8,10
11174,Zindula,malganis,766,hunter,marksmanship,19,8,11
11175,Kìkìjiki,emerald-dream,765,hunter,marksmanship,18,8,10
11176,Kòng,quelthalas,765,hunter,marksmanship,24,8,16
11177,Daahm,malganis,765,hunter,marksmanship,25,8,17
11178,Taynen,azralon,764,hunter,marksmanship,18,8,10
11179,Myciri,proudmoore,764,hunter,marksmanship,18,8,10
11180,Rattrap,proudmoore,763,hunter,marksmanship,24,8,16
11181,Kluako,stormreaver,762,hunter,marksmanship,12,8,4
11182,Deathwynd,malfurion,762,hunter,marksmanship,12,8,4
11183,Thisguÿ,arthas,762,hunter,marksmanship,18,8,10
11184,Sorid,medivh,761,hunter,marksmanship,12,8,4
11185,Enonoa,thunderlord,760,hunter,marksmanship,12,8,4
11186,Porta,zuljin,757,hunter,marksmanship,16,9,7
11187,Heapstack,stormrage,753,hunter,marksmanship,18,8,10
11188,Huntercry,ragnaros,751,hunter,marksmanship,12,8,4
11189,Niceshotboi,azgalor,751,hunter,marksmanship,24,8,16
11190,Arshuntica,blackrock,750,hunter,marksmanship,18,8,10
11191,Lynnì,khadgar,750,hunter,marksmanship,18,8,10
11192,Returners,emerald-dream,750,hunter,marksmanship,18,8,10
11193,Xshadowdemon,korgath,749,hunter,marksmanship,12,8,4
11194,Aksalaz,area-52,749,hunter,marksmanship,17,8,9
11195,Belieli,ragnaros,740,hunter,marksmanship,22,8,14
11196,Mackin,maelstrom,740,hunter,marksmanship,24,8,16
11197,Volga,haomarush,733,hunter,marksmanship,16,8,8
11198,Mayohater,sargeras,714,hunter,marksmanship,33,9,24
11199,Andalora,malganis,703,hunter,marksmanship,11,8,3
11200,Llachiip,zuljin,702,hunter,marksmanship,17,9,8
11201,Dasvydanya,illidan,702,hunter,marksmanship,19,9,10
11202,Qúin,frostmourne,702,hunter,marksmanship,23,9,14
11203,Fizzleshot,malganis,699,hunter,marksmanship,18,8,10
11204,Felkrozzul,kalecgos,672,hunter,marksmanship,9,8,1
11205,Neyith,frostmourne,672,hunter,marksmanship,12,7,5
11206,Hyrus,shadowmoon,672,hunter,marksmanship,12,7,5
11207,Snipezone,kelthuzad,672,hunter,marksmanship,12,7,5
11208,Goosejuicer,emerald-dream,672,hunter,marksmanship,12,7,5
11209,Keboks,alleria,672,hunter,marksmanship,12,7,5
11210,Kaptincrunch,skywall,672,hunter,marksmanship,12,7,5
11211,Neverhunter,azralon,672,hunter,marksmanship,12,7,5
11212,Mms,frostmourne,672,hunter,marksmanship,12,7,5
11213,Kaznik,ragnaros,672,hunter,marksmanship,12,7,5
11214,Ehnub,stormrage,672,hunter,marksmanship,12,7,5
11215,Mörgoth,quelthalas,672,hunter,marksmanship,12,7,5
11216,Shotmaster,tichondrius,672,hunter,marksmanship,12,7,5
11217,Enty,khazgoroth,672,hunter,marksmanship,12,7,5
11218,Kookh,area-52,672,hunter,marksmanship,12,7,5
11219,Drupert,tichondrius,672,hunter,marksmanship,12,7,5
11220,Mochaxd,stormrage,672,hunter,marksmanship,14,7,7
11221,Tirrill,malganis,672,hunter,marksmanship,18,7,11
11222,Jimryl,illidan,672,hunter,marksmanship,18,7,11
11223,Focusfire,khazgoroth,672,hunter,marksmanship,18,7,11
11224,Ping,tol-barad,672,hunter,marksmanship,18,7,11
11225,Bombanodos,kelthuzad,672,hunter,marksmanship,18,7,11
11226,Bigzane,darkspear,672,hunter,marksmanship,24,7,17
11227,Datbigbowdoe,illidan,672,hunter,marksmanship,24,7,17
11228,Larree,kelthuzad,671,hunter,marksmanship,12,7,5
11229,Getnukedbud,emerald-dream,671,hunter,marksmanship,12,7,5
11230,Kneecrippler,proudmoore,671,hunter,marksmanship,12,7,5
11231,Geraldson,proudmoore,671,hunter,marksmanship,12,7,5
11232,Vatits,dalaran,671,hunter,marksmanship,12,7,5
11233,Neoxbow,wyrmrest-accord,671,hunter,marksmanship,12,7,5
11234,Ocui,ragnaros,671,hunter,marksmanship,12,7,5
11235,Ethne,garithos,671,hunter,marksmanship,12,7,5
11236,Xhare,stormrage,671,hunter,marksmanship,12,7,5
11237,Zhions,ragnaros,671,hunter,marksmanship,12,7,5
11238,Sunyourmom,proudmoore,671,hunter,marksmanship,12,7,5
11239,Texploto,area-52,671,hunter,marksmanship,12,7,5
11240,Dest,azralon,671,hunter,marksmanship,12,7,5
11241,Hannover,ragnaros,671,hunter,marksmanship,12,7,5
11242,Jackrandall,frostmourne,671,hunter,marksmanship,18,7,11
11243,Lyricly,lightbringer,671,hunter,marksmanship,18,7,11
11244,Löbo,quelthalas,671,hunter,marksmanship,18,7,11
11245,Glittergun,sargeras,671,hunter,marksmanship,18,7,11
11246,Sáns,sargeras,671,hunter,marksmanship,18,7,11
11247,Kalizra,quelthalas,671,hunter,marksmanship,18,7,11
11248,Obsol,hyjal,671,hunter,marksmanship,18,7,11
11249,Kaeuljua,tichondrius,671,hunter,marksmanship,18,7,11
11250,Såvagehunter,malganis,671,hunter,marksmanship,18,7,11
11251,Toesgoes,thrall,671,hunter,marksmanship,18,7,11
11252,Schbaltz,tichondrius,671,hunter,marksmanship,18,7,11
11253,Navagee,tichondrius,671,hunter,marksmanship,18,7,11
11254,Wij,turalyon,671,hunter,marksmanship,24,8,16
11255,Cullowhee,proudmoore,671,hunter,marksmanship,23,7,16
11256,Soljer,kiljaeden,671,hunter,marksmanship,24,7,17
11257,Temara,icecrown,671,hunter,marksmanship,24,7,17
11258,Valane,ragnaros,671,hunter,marksmanship,24,7,17
11259,Untermench,tichondrius,670,hunter,marksmanship,12,7,5
11260,Joogeenda,kaelthas,670,hunter,marksmanship,12,7,5
11261,Clutchxx,tichondrius,670,hunter,marksmanship,12,7,5
11262,Kìngjaybroni,sargeras,670,hunter,marksmanship,12,7,5
11263,Cócaine,tichondrius,670,hunter,marksmanship,19,8,11
11264,Gagau,stormrage,670,hunter,marksmanship,18,7,11
11265,Wolfyyxx,stormrage,670,hunter,marksmanship,18,7,11
11266,Westbrooke,illidan,669,hunter,marksmanship,18,7,11
11267,Lilzoomer,barthilas,668,hunter,marksmanship,12,7,5
11268,Minzuki,drakkari,668,hunter,marksmanship,18,7,11
11269,Ues,shuhalo,667,hunter,marksmanship,13,7,6
11270,Mahty,stormrage,665,hunter,marksmanship,12,7,5
11271,Infamousorc,chogall,654,hunter,marksmanship,23,7,16
11272,Righthole,area-52,640,hunter,marksmanship,22,7,15
11273,Mawlotov,barthilas,639,hunter,marksmanship,23,7,16
11274,Øparin,azralon,633,hunter,marksmanship,11,7,4
11275,Grukar,tichondrius,623,hunter,marksmanship,17,7,10
11276,Muerteaterry,ragnaros,618,hunter,marksmanship,18,8,10
11277,Mesiauzx,stormrage,618,hunter,marksmanship,22,9,13
11278,Butimbutters,bleeding-hollow,617,hunter,marksmanship,22,8,14
11279,Dsizzle,tichondrius,617,hunter,marksmanship,26,8,18
11280,Maveraxx,executus,616,hunter,marksmanship,21,7,14
11281,Kushminion,zuljin,607,hunter,marksmanship,14,9,5
11282,Typh,saurfang,607,hunter,marksmanship,11,7,4
11283,Ekzoo,tichondrius,607,hunter,marksmanship,11,7,4
11284,Hokutoxx,tichondrius,607,hunter,marksmanship,20,7,13
11285,Krossx,thrall,591,hunter,marksmanship,12,7,5
11286,Póra,stormrage,582,hunter,marksmanship,17,8,9
11287,Drewshot,sargeras,576,hunter,marksmanship,6,6,0
11288,Summerrain,illidan,576,hunter,marksmanship,6,6,0
11289,Deejwithabow,frostmourne,576,hunter,marksmanship,6,6,0
11290,Donotrunaway,ragnaros,576,hunter,marksmanship,12,6,6
11291,Elmozz,thrall,576,hunter,marksmanship,12,6,6
11292,Rizzbow,dalvengyr,576,hunter,marksmanship,12,6,6
11293,Mhd,stormrage,576,hunter,marksmanship,12,6,6
11294,Êlautismo,wyrmrest-accord,576,hunter,marksmanship,12,6,6
11295,Juwannaaim,lethon,576,hunter,marksmanship,12,6,6
11296,Mochigelato,kelthuzad,576,hunter,marksmanship,12,6,6
11297,Murderone,undermine,576,hunter,marksmanship,12,6,6
11298,Groomme,area-52,576,hunter,marksmanship,12,6,6
11299,Xohzabu,wyrmrest-accord,576,hunter,marksmanship,12,6,6
11300,Nerfmeplezz,area-52,576,hunter,marksmanship,12,6,6
11301,Zaamsa,ragnaros,576,hunter,marksmanship,12,6,6
11302,Birbwatcher,moon-guard,576,hunter,marksmanship,12,6,6
11303,Ozarks,kiljaeden,576,hunter,marksmanship,12,6,6
11304,Pulso,illidan,576,hunter,marksmanship,12,6,6
11305,Aoti,nerzhul,576,hunter,marksmanship,12,6,6
11306,Kimbaa,tichondrius,576,hunter,marksmanship,12,6,6
11307,Aurzwraek,proudmoore,576,hunter,marksmanship,12,6,6
11308,Laurenx,illidan,576,hunter,marksmanship,12,6,6
11309,Throre,bleeding-hollow,576,hunter,marksmanship,12,6,6
11310,Gritzix,frostmourne,576,hunter,marksmanship,12,6,6
11311,Mdizzly,zuljin,576,hunter,marksmanship,12,6,6
11312,Gugubird,proudmoore,576,hunter,marksmanship,12,6,6
11313,Cù,frostmourne,576,hunter,marksmanship,12,6,6
11314,Spanerd,moon-guard,576,hunter,marksmanship,12,6,6
11315,Kyudo,moon-guard,576,hunter,marksmanship,12,6,6
11316,Rangêr,frostmourne,576,hunter,marksmanship,12,6,6
11317,Vicecheney,illidan,576,hunter,marksmanship,12,6,6
11318,Nightgecko,elune,576,hunter,marksmanship,12,6,6
11319,Ssds,sargeras,576,hunter,marksmanship,12,6,6
11320,Vårelse,sargeras,576,hunter,marksmanship,12,6,6
11321,Tokez,moon-guard,576,hunter,marksmanship,14,6,8
11322,Cloudzbow,moon-guard,576,hunter,marksmanship,18,6,12
11323,Skillkiting,area-52,576,hunter,marksmanship,18,6,12
11324,Bigkolache,zuljin,576,hunter,marksmanship,18,6,12
11325,Shcrimps,proudmoore,576,hunter,marksmanship,18,6,12
11326,Gnometoprace,illidan,576,hunter,marksmanship,18,6,12
11327,Aaggros,sargeras,576,hunter,marksmanship,18,6,12
11328,Tandope,sargeras,576,hunter,marksmanship,18,6,12
11329,Shotfromhell,sargeras,576,hunter,marksmanship,21,6,15
11330,Jônathan,tichondrius,576,hunter,marksmanship,24,6,18
11331,Cerrundan,icecrown,575,hunter,marksmanship,12,6,6
11332,Lagginwaggin,azgalor,575,hunter,marksmanship,12,6,6
11333,Kazes,stormrage,575,hunter,marksmanship,12,6,6
11334,Cobrag,tichondrius,575,hunter,marksmanship,12,6,6
11335,Thehunturd,dalaran,575,hunter,marksmanship,12,6,6
11336,Sylvaethas,lightninghoof,575,hunter,marksmanship,12,6,6
11337,Alinûs,stormrage,575,hunter,marksmanship,12,6,6
11338,Hobbës,kelthuzad,575,hunter,marksmanship,12,6,6
11339,Doug,illidan,575,hunter,marksmanship,12,6,6
11340,Brosk,drakthul,575,hunter,marksmanship,12,6,6
11341,Taphh,moon-guard,575,hunter,marksmanship,12,6,6
11342,Aragörnn,azralon,575,hunter,marksmanship,12,6,6
11343,Littlespike,queldorei,575,hunter,marksmanship,12,6,6
11344,Projectilez,sargeras,575,hunter,marksmanship,12,6,6
11345,Gresga,dalaran,575,hunter,marksmanship,12,6,6
11346,Chipsncheese,korgath,575,hunter,marksmanship,12,6,6
11347,Dirtbagchaz,illidan,575,hunter,marksmanship,12,6,6
11348,Silentzkill,tichondrius,575,hunter,marksmanship,12,6,6
11349,Onlyfeìgns,frostmourne,575,hunter,marksmanship,12,6,6
11350,Lahyanhou,azjolnerub,575,hunter,marksmanship,18,6,12
11351,Tazmaniak,gorefiend,575,hunter,marksmanship,18,6,12
11352,Ididntdoit,blackhand,575,hunter,marksmanship,18,6,12
11353,Youngpo,thunderlord,575,hunter,marksmanship,18,6,12
11354,Arbclimbs,frostmane,575,hunter,marksmanship,18,6,12
11355,Marcusrarnis,zuljin,574,hunter,marksmanship,12,6,6
11356,Zeddunn,stormrage,574,hunter,marksmanship,12,6,6
11357,Hildihunt,stormrage,574,hunter,marksmanship,12,6,6
11358,Folgadoo,azralon,574,hunter,marksmanship,18,6,12
11359,Blåckhat,frostmourne,573,hunter,marksmanship,30,6,24
11360,Recebaa,barthilas,572,hunter,marksmanship,12,6,6
11361,Jogoran,thunderlord,571,hunter,marksmanship,12,6,6
11362,Àlëxx,aegwynn,571,hunter,marksmanship,24,6,18
11363,Scoundrella,sargeras,570,hunter,marksmanship,12,6,6
11364,Tungles,tichondrius,570,hunter,marksmanship,24,6,18
11365,Lennfear,frostmourne,568,hunter,marksmanship,18,6,12
11366,Vaelanor,destromath,566,hunter,marksmanship,12,6,6
11367,Beastmodeqt,blood-furnace,566,hunter,marksmanship,18,6,12
11368,Nickhell,azralon,565,hunter,marksmanship,12,6,6
11369,Neef,mannoroth,564,hunter,marksmanship,24,6,18
11370,Ratspit,chogall,557,hunter,marksmanship,11,6,5
11371,Erudraugdin,quelthalas,545,hunter,marksmanship,24,6,18
11372,Gymli,destromath,543,hunter,marksmanship,11,6,5
11373,Jaydemo,thunderhorn,527,hunter,marksmanship,17,6,11
11374,Remixjy,burning-blade,522,hunter,marksmanship,16,7,9
11375,Cns,tichondrius,521,hunter,marksmanship,20,7,13
11376,Jonsnow,lightnings-blade,519,hunter,marksmanship,15,6,9
11377,Dainsleif,perenolde,512,hunter,marksmanship,10,6,4
11378,Pogcheddar,tichondrius,511,hunter,marksmanship,14,6,8
11379,Tracershot,malganis,511,hunter,marksmanship,14,6,8
11380,Gemky,ragnaros,511,hunter,marksmanship,14,6,8
11381,Cplski,kelthuzad,511,hunter,marksmanship,16,6,10
11382,Stepbroski,moon-guard,510,hunter,marksmanship,14,6,8
11383,Brainzz,emerald-dream,509,hunter,marksmanship,16,7,9
11384,Chickenzzack,tichondrius,480,hunter,marksmanship,6,5,1
11385,Knerf,silvermoon,480,hunter,marksmanship,6,5,1
11386,Thrandrial,smolderthorn,480,hunter,marksmanship,6,5,1
11387,Shootandloot,zuljin,480,hunter,marksmanship,6,5,1
11388,Kimchishotxo,tichondrius,480,hunter,marksmanship,6,5,1
11389,Chasseür,quelthalas,480,hunter,marksmanship,6,5,1
11390,Johhnweed,ragnaros,480,hunter,marksmanship,6,5,1
11391,Taije,arthas,480,hunter,marksmanship,6,5,1
11392,Zmghost,nathrezim,480,hunter,marksmanship,6,5,1
11393,Bendotexe,stormrage,480,hunter,marksmanship,6,5,1
11394,Qthunterr,dalaran,480,hunter,marksmanship,6,5,1
11395,Idtrapthat,nordrassil,480,hunter,marksmanship,9,5,4
11396,Thewïld,tichondrius,480,hunter,marksmanship,12,5,7
11397,Ongorn,lightninghoof,480,hunter,marksmanship,12,5,7
11398,Teaks,aggramar,480,hunter,marksmanship,12,5,7
11399,Baehydra,frostmourne,480,hunter,marksmanship,12,5,7
11400,Kattarry,moon-guard,480,hunter,marksmanship,12,5,7
11401,Stephkurryz,tichondrius,480,hunter,marksmanship,12,5,7
11402,Thejessiah,tichondrius,480,hunter,marksmanship,12,5,7
11403,Arraza,ragnaros,480,hunter,marksmanship,12,5,7
11404,Duckpow,frostmourne,480,hunter,marksmanship,12,5,7
11405,Bullzeyê,kelthuzad,480,hunter,marksmanship,12,5,7
11406,Valro,hyjal,480,hunter,marksmanship,12,5,7
11407,Fjdominador,azralon,480,hunter,marksmanship,12,5,7
11408,Xísa,proudmoore,480,hunter,marksmanship,12,5,7
11409,Josyv,quelthalas,480,hunter,marksmanship,12,5,7
11410,Soloshuffle,kelthuzad,480,hunter,marksmanship,12,5,7
11411,Ownshot,kiljaeden,480,hunter,marksmanship,12,5,7
11412,Qqshot,emerald-dream,480,hunter,marksmanship,12,5,7
11413,Eldotbrod,quelthalas,480,hunter,marksmanship,12,5,7
11414,Hunt,the-underbog,480,hunter,marksmanship,12,5,7
11415,Jaywuz,tichondrius,480,hunter,marksmanship,12,5,7
11416,Lagshots,kelthuzad,480,hunter,marksmanship,12,5,7
11417,Snoplow,illidan,480,hunter,marksmanship,12,5,7
11418,Kyujin,ragnaros,480,hunter,marksmanship,12,5,7
11419,Boomheadshot,blood-furnace,480,hunter,marksmanship,12,5,7
11420,Rorijii,tichondrius,480,hunter,marksmanship,12,5,7
11421,Hyü,hyjal,480,hunter,marksmanship,12,5,7
11422,Stingyshot,thrall,480,hunter,marksmanship,12,5,7
11423,Lianm,stormrage,480,hunter,marksmanship,12,5,7
11424,Aloa,nagrand,480,hunter,marksmanship,12,5,7
11425,Davidbowey,bonechewer,480,hunter,marksmanship,12,5,7
11426,Omniquiver,sargeras,480,hunter,marksmanship,12,5,7
11427,Connora,stormrage,480,hunter,marksmanship,12,5,7
11428,Slobon,tichondrius,480,hunter,marksmanship,12,5,7
11429,Kaelhim,warsong,480,hunter,marksmanship,12,5,7
11430,Lilbowbigdam,emerald-dream,480,hunter,marksmanship,12,5,7
11431,Reys,bonechewer,480,hunter,marksmanship,15,6,9
11432,Regretful,kelthuzad,480,hunter,marksmanship,13,5,8
11433,Hhappy,tichondrius,480,hunter,marksmanship,18,5,13
11434,Shootybootìe,tichondrius,480,hunter,marksmanship,18,5,13
11435,Eurekasl,ragnaros,480,hunter,marksmanship,18,5,13
11436,Jahir,tichondrius,480,hunter,marksmanship,18,5,13
11437,Blickys,area-52,480,hunter,marksmanship,18,5,13
11438,Absinther,emerald-dream,480,hunter,marksmanship,18,5,13
11439,Ikiteforfood,zuljin,480,hunter,marksmanship,18,5,13
11440,Ownyoufast,darkspear,480,hunter,marksmanship,24,5,19
11441,Guntrïx,stormrage,480,hunter,marksmanship,24,5,19
11442,Runimurder,zuljin,479,hunter,marksmanship,6,5,1
11443,Ritrune,anvilmar,479,hunter,marksmanship,6,5,1
11444,Hishamo,aggramar,479,hunter,marksmanship,6,5,1
11445,Lws,ragnaros,479,hunter,marksmanship,6,5,1
11446,Globalhunter,emerald-dream,479,hunter,marksmanship,12,5,7
11447,Peitowyn,illidan,479,hunter,marksmanship,12,5,7
11448,Hunchback,emerald-dream,479,hunter,marksmanship,12,5,7
11449,Ëz,ragnaros,479,hunter,marksmanship,12,5,7
11450,Rykbad,area-52,479,hunter,marksmanship,12,5,7
11451,Papiquezo,nagrand,479,hunter,marksmanship,12,5,7
11452,Logonman,rexxar,479,hunter,marksmanship,12,5,7
11453,Blurrí,area-52,479,hunter,marksmanship,12,5,7
11454,Alluminant,gilneas,479,hunter,marksmanship,12,5,7
11455,Momomomo,draka,479,hunter,marksmanship,12,5,7
11456,Pathius,uldaman,479,hunter,marksmanship,12,5,7
11457,Ohhsnaapp,blood-furnace,479,hunter,marksmanship,12,5,7
11458,Mayhunter,ragnaros,479,hunter,marksmanship,13,5,8
11459,Diur,ragnaros,479,hunter,marksmanship,15,5,10
11460,Enzym,archimonde,479,hunter,marksmanship,18,5,13
11461,Mulnaaj,zuljin,479,hunter,marksmanship,18,5,13
11462,Ashaelyn,wyrmrest-accord,479,hunter,marksmanship,18,5,13
11463,Seyd,barthilas,479,hunter,marksmanship,18,5,13
11464,Guarambare,ragnaros,479,hunter,marksmanship,18,5,13
11465,Johar,nerzhul,479,hunter,marksmanship,18,5,13
11466,Lyssavirhus,azralon,478,hunter,marksmanship,12,5,7
11467,Ozzoty,tol-barad,478,hunter,marksmanship,12,5,7
11468,Damnnicebutt,borean-tundra,478,hunter,marksmanship,20,7,13
11469,Tularac,sentinels,477,hunter,marksmanship,12,5,7
11470,Cio,fizzcrank,477,hunter,marksmanship,12,5,7
11471,Survival,dentarg,477,hunter,marksmanship,12,5,7
11472,Darkmaximus,echo-isles,477,hunter,marksmanship,18,5,13
11473,Puttry,stormrage,476,hunter,marksmanship,12,5,7
11474,Àrsha,gallywix,475,hunter,marksmanship,12,5,7
11475,Lanney,firetree,473,hunter,marksmanship,12,5,7
11476,Hartman,frostwolf,473,hunter,marksmanship,18,5,13
11477,Oorudun,hellscream,472,hunter,marksmanship,12,5,7
11478,Raun,anvilmar,453,hunter,marksmanship,17,5,12
11479,Againzt,tichondrius,447,hunter,marksmanship,12,6,6
11480,Diavál,area-52,447,hunter,marksmanship,11,5,6
11481,Zøkøtrøkø,ragnaros,446,hunter,marksmanship,22,5,17
11482,Mukeru,stormrage,432,hunter,marksmanship,9,5,4
11483,Jud,thunderlord,432,hunter,marksmanship,21,5,16
11484,Wook,hyjal,431,hunter,marksmanship,11,5,6
11485,Noriee,destromath,431,hunter,marksmanship,15,5,10
11486,Nirika,moon-guard,416,hunter,marksmanship,10,5,5
11487,Beatnass,cairne,384,hunter,marksmanship,6,4,2
11488,Gunstorms,dalaran,384,hunter,marksmanship,6,4,2
11489,Aimbôt,frostmourne,384,hunter,marksmanship,6,4,2
11490,Côckblocked,tichondrius,384,hunter,marksmanship,6,4,2
11491,Trapwiz,firetree,384,hunter,marksmanship,6,4,2
11492,Seyu,tichondrius,384,hunter,marksmanship,6,4,2
11493,Infatuatedx,moon-guard,384,hunter,marksmanship,6,4,2
11494,Cornstalk,area-52,384,hunter,marksmanship,6,4,2
11495,Huataran,stormrage,384,hunter,marksmanship,6,4,2
11496,Anecko,zuljin,384,hunter,marksmanship,6,4,2
11497,Huumpoutine,burning-blade,384,hunter,marksmanship,6,4,2
11498,Junmuxiao,ragnaros,384,hunter,marksmanship,6,4,2
11499,Gogey,area-52,384,hunter,marksmanship,6,4,2
11500,Tdarknet,quelthalas,384,hunter,marksmanship,6,4,2
11501,Llhopital,ragnaros,384,hunter,marksmanship,6,4,2
11502,Wellerman,firetree,384,hunter,marksmanship,6,4,2
11503,Subdue,tichondrius,384,hunter,marksmanship,6,4,2
11504,Relapse,dreadmaul,384,hunter,marksmanship,6,4,2
11505,Blamethenaga,sargeras,384,hunter,marksmanship,6,4,2
11506,Swish,burning-legion,384,hunter,marksmanship,6,4,2
11507,Malcab,tichondrius,384,hunter,marksmanship,6,4,2
11508,Smokabonbon,eredar,384,hunter,marksmanship,6,4,2
11509,Silvertokay,ragnaros,384,hunter,marksmanship,6,4,2
11510,Maidán,azralon,384,hunter,marksmanship,6,4,2
11511,Archetype,bladefist,384,hunter,marksmanship,6,4,2
11512,Hyjix,stormrage,384,hunter,marksmanship,6,4,2
11513,Sylos,moon-guard,384,hunter,marksmanship,6,4,2
11514,Déwi,tichondrius,384,hunter,marksmanship,6,4,2
11515,Frîck,bleeding-hollow,384,hunter,marksmanship,6,4,2
11516,Cashisabeast,zuljin,384,hunter,marksmanship,6,4,2
11517,Stfd,illidan,384,hunter,marksmanship,6,4,2
11518,Venj,proudmoore,384,hunter,marksmanship,6,4,2
11519,Shootbert,malganis,384,hunter,marksmanship,6,4,2
11520,Swoljashotxp,area-52,384,hunter,marksmanship,6,4,2
11521,Muckenfoose,frostmourne,384,hunter,marksmanship,6,4,2
11522,Rektarrow,area-52,384,hunter,marksmanship,6,4,2
11523,Hitemup,bleeding-hollow,384,hunter,marksmanship,6,4,2
11524,Folf,turalyon,384,hunter,marksmanship,6,4,2
11525,Lexodream,bleeding-hollow,384,hunter,marksmanship,6,4,2
11526,Arteene,illidan,384,hunter,marksmanship,6,4,2
11527,Raevon,kelthuzad,384,hunter,marksmanship,6,4,2
11528,Bärney,frostmourne,384,hunter,marksmanship,6,4,2
11529,Zendarae,tichondrius,384,hunter,marksmanship,6,4,2
11530,Emilysamuels,tichondrius,384,hunter,marksmanship,6,4,2
11531,Balaria,tichondrius,384,hunter,marksmanship,6,4,2
11532,Hordworld,tichondrius,384,hunter,marksmanship,6,4,2
11533,Moyria,quelthalas,384,hunter,marksmanship,6,4,2
11534,Hyyz,proudmoore,384,hunter,marksmanship,6,4,2
11535,Foxyevermew,tichondrius,384,hunter,marksmanship,6,4,2
11536,Jojojobo,tichondrius,384,hunter,marksmanship,6,4,2
11537,Oromís,dalaran,384,hunter,marksmanship,6,4,2
11538,Elmerfuddx,terokkar,384,hunter,marksmanship,6,4,2
11539,Malthiz,antonidas,384,hunter,marksmanship,8,4,4
11540,Limpnoodle,nerzhul,384,hunter,marksmanship,12,4,8
11541,Zipzyup,tichondrius,384,hunter,marksmanship,12,4,8
11542,Skillvanas,stormrage,384,hunter,marksmanship,12,4,8
11543,Robobop,stormrage,384,hunter,marksmanship,12,4,8
11544,Dropflag,stormrage,384,hunter,marksmanship,12,4,8
11545,Bowsbéforhos,stormrage,384,hunter,marksmanship,12,4,8
11546,Kumari,lothar,384,hunter,marksmanship,12,4,8
11547,Dmasterbiter,zuljin,384,hunter,marksmanship,12,4,8
11548,Lilbic,bleeding-hollow,384,hunter,marksmanship,12,4,8
11549,Sylvanâs,bleeding-hollow,384,hunter,marksmanship,12,4,8
11550,Hywhan,stormrage,384,hunter,marksmanship,12,4,8
11551,Ojmo,arthas,384,hunter,marksmanship,12,4,8
11552,Trippyhunter,akama,384,hunter,marksmanship,12,4,8
11553,Xeriife,stormrage,384,hunter,marksmanship,12,4,8
11554,Revö,area-52,384,hunter,marksmanship,12,4,8
11555,Ningiiwose,garona,384,hunter,marksmanship,12,4,8
11556,Samsin,sargeras,384,hunter,marksmanship,12,4,8
11557,Percision,bonechewer,384,hunter,marksmanship,12,4,8
11558,Msghunter,sargeras,384,hunter,marksmanship,12,4,8
11559,Vion,mannoroth,384,hunter,marksmanship,12,4,8
11560,Bleedwolf,tichondrius,384,hunter,marksmanship,12,4,8
11561,Crimsonmm,ragnaros,384,hunter,marksmanship,12,4,8
11562,Taurenseason,sargeras,384,hunter,marksmanship,12,4,8
11563,Enchantras,jaedenar,384,hunter,marksmanship,12,4,8
11564,Joton,tichondrius,384,hunter,marksmanship,12,4,8
11565,Karev,area-52,384,hunter,marksmanship,12,4,8
11566,Ganzilla,aerie-peak,384,hunter,marksmanship,12,4,8
11567,Emérr,drakkari,384,hunter,marksmanship,12,4,8
11568,Shottz,blackhand,384,hunter,marksmanship,12,4,8
11569,Junglar,eitrigg,384,hunter,marksmanship,12,4,8
11570,Yønkøu,azralon,384,hunter,marksmanship,12,4,8
11571,Sabo,nemesis,384,hunter,marksmanship,12,4,8
11572,Patroclo,azralon,384,hunter,marksmanship,12,4,8
11573,Aaron,jubeithos,384,hunter,marksmanship,12,4,8
11574,Gstygodx,frostmourne,384,hunter,marksmanship,12,4,8
11575,Braindeadorc,illidan,384,hunter,marksmanship,12,4,8
11576,Mabaku,tichondrius,384,hunter,marksmanship,12,4,8
11577,Vélos,illidan,384,hunter,marksmanship,12,4,8
11578,Saralli,thrall,384,hunter,marksmanship,12,4,8
11579,Crackshotzz,illidan,384,hunter,marksmanship,12,4,8
11580,Artemisagro,greymane,384,hunter,marksmanship,12,4,8
11581,Lánárhóádés,tichondrius,384,hunter,marksmanship,12,4,8
11582,Ðïanä,azralon,384,hunter,marksmanship,12,4,8
11583,Whatalexa,tichondrius,384,hunter,marksmanship,12,4,8
11584,Bowtech,kelthuzad,384,hunter,marksmanship,13,4,9
11585,Kiteftw,tichondrius,384,hunter,marksmanship,18,4,14
11586,Abloodelf,zuljin,384,hunter,marksmanship,18,4,14
11587,Peashooter,sargeras,384,hunter,marksmanship,19,4,15
11588,Comtambisuon,frostmourne,383,hunter,marksmanship,6,4,2
11589,Snäpträp,stormrage,383,hunter,marksmanship,6,4,2
11590,Meriah,bleeding-hollow,383,hunter,marksmanship,6,4,2
11591,Soulbutter,malganis,383,hunter,marksmanship,6,4,2
11592,Dathronin,chogall,383,hunter,marksmanship,6,4,2
11593,Getkited,tichondrius,383,hunter,marksmanship,6,4,2
11594,Essya,frostmourne,383,hunter,marksmanship,6,4,2
11595,Franzkafka,azralon,383,hunter,marksmanship,6,4,2
11596,Euphylesz,garrosh,383,hunter,marksmanship,10,4,6
11597,Juanita,laughing-skull,383,hunter,marksmanship,12,4,8
11598,Zenwrath,illidan,383,hunter,marksmanship,12,4,8
11599,Djpwnz,bladefist,383,hunter,marksmanship,12,4,8
11600,Amsalja,tichondrius,383,hunter,marksmanship,12,4,8
11601,Rottinghood,hyjal,383,hunter,marksmanship,12,4,8
11602,Aridan,area-52,383,hunter,marksmanship,12,4,8
11603,Shootingjaem,tichondrius,383,hunter,marksmanship,12,4,8
11604,Brody,eitrigg,383,hunter,marksmanship,12,4,8
11605,Mynnokyr,gallywix,383,hunter,marksmanship,12,4,8
11606,Diacachimbaa,ragnaros,383,hunter,marksmanship,12,4,8
11607,Zérõ,area-52,383,hunter,marksmanship,12,4,8
11608,Fermra,dunemaul,383,hunter,marksmanship,12,4,8
11609,Minibrö,tichondrius,383,hunter,marksmanship,12,4,8
11610,Nevon,azralon,383,hunter,marksmanship,18,4,14
11611,Oohuntsoo,emerald-dream,382,hunter,marksmanship,6,4,2
11612,Rzan,fenris,382,hunter,marksmanship,6,4,2
11613,Eaudelune,vashj,382,hunter,marksmanship,12,4,8
11614,Twofeathers,wyrmrest-accord,381,hunter,marksmanship,12,4,8
11615,Skatenos,tortheldrin,381,hunter,marksmanship,12,4,8
11616,Murozz,malganis,379,hunter,marksmanship,12,4,8
11617,Äzrael,elune,379,hunter,marksmanship,12,4,8
11618,Venessie,moon-guard,379,hunter,marksmanship,12,4,8
11619,Arighthunt,frostmourne,367,hunter,marksmanship,17,4,13
11620,Hyesik,tichondrius,362,hunter,marksmanship,21,7,14
11621,Bloodarrow,tichondrius,351,hunter,marksmanship,11,4,7
11622,Rnger,aerie-peak,350,hunter,marksmanship,12,5,7
11623,Trappxy,sargeras,336,hunter,marksmanship,9,4,5
11624,Zucarita,tichondrius,330,hunter,marksmanship,9,5,4
11625,Nubcaks,nerzhul,330,hunter,marksmanship,21,5,16
11626,Pérséús,ragnaros,320,hunter,marksmanship,10,4,6
11627,Stupïd,tichondrius,319,hunter,marksmanship,5,4,1
11628,Aimian,frostmourne,319,hunter,marksmanship,8,4,4
11629,Kazug,destromath,319,hunter,marksmanship,12,5,7
11630,Berkhof,tichondrius,319,hunter,marksmanship,14,4,10
11631,Dagre,the-forgotten-coast,304,hunter,marksmanship,13,4,9
11632,Canadïan,stormrage,288,hunter,marksmanship,6,3,3
11633,Skum,tichondrius,288,hunter,marksmanship,6,3,3
11634,Azairxd,tichondrius,288,hunter,marksmanship,6,3,3
11635,Tobroken,perenolde,288,hunter,marksmanship,6,3,3
11636,Weegnomie,wyrmrest-accord,288,hunter,marksmanship,6,3,3
11637,Trænquility,tichondrius,288,hunter,marksmanship,6,3,3
11638,Uc,khadgar,288,hunter,marksmanship,6,3,3
11639,Racoon,spinebreaker,288,hunter,marksmanship,6,3,3
11640,Wonshawt,tichondrius,288,hunter,marksmanship,6,3,3
11641,Brumbuh,tichondrius,288,hunter,marksmanship,6,3,3
11642,Vashra,stormrage,288,hunter,marksmanship,6,3,3
11643,Eatmybow,nemesis,288,hunter,marksmanship,6,3,3
11644,Mikey,exodar,288,hunter,marksmanship,6,3,3
11645,Chootembro,thunderlord,288,hunter,marksmanship,6,3,3
11646,Wannakill,stormrage,288,hunter,marksmanship,6,3,3
11647,Vinksy,sargeras,288,hunter,marksmanship,6,3,3
11648,Silvershot,emerald-dream,288,hunter,marksmanship,6,3,3
11649,Traphouse,blackrock,288,hunter,marksmanship,6,3,3
11650,Stupedhunter,tichondrius,288,hunter,marksmanship,6,3,3
11651,Sosaho,sargeras,288,hunter,marksmanship,6,3,3
11652,Javoj,drakkari,288,hunter,marksmanship,6,3,3
11653,Cyboreg,stormrage,288,hunter,marksmanship,6,3,3
11654,Dranel,nordrassil,288,hunter,marksmanship,6,3,3
11655,Bamfhunt,darkspear,288,hunter,marksmanship,6,3,3
11656,Muffhuntér,blackrock,288,hunter,marksmanship,6,3,3
11657,Starsabov,emerald-dream,288,hunter,marksmanship,6,3,3
11658,Mtuanwm,tichondrius,288,hunter,marksmanship,6,3,3
11659,Physical,destromath,288,hunter,marksmanship,6,3,3
11660,Baoßun,thrall,288,hunter,marksmanship,6,3,3
11661,Gunshow,wyrmrest-accord,288,hunter,marksmanship,6,3,3
11662,Bloodyman,korgath,288,hunter,marksmanship,6,3,3
11663,Tìnker,stormrage,288,hunter,marksmanship,6,3,3
11664,Zym,the-forgotten-coast,288,hunter,marksmanship,6,3,3
11665,Waldrom,arathor,288,hunter,marksmanship,6,3,3
11666,Grimdrakk,zuljin,288,hunter,marksmanship,6,3,3
11667,Xtremesnipez,frostmourne,288,hunter,marksmanship,6,3,3
11668,Alliestrasza,azralon,288,hunter,marksmanship,6,3,3
11669,Iannieht,illidan,288,hunter,marksmanship,6,3,3
11670,Perfectcrit,area-52,288,hunter,marksmanship,6,3,3
11671,Sabanna,proudmoore,288,hunter,marksmanship,6,3,3
11672,Daggétt,zuljin,288,hunter,marksmanship,6,3,3
11673,Dandogg,tichondrius,288,hunter,marksmanship,6,3,3
11674,Carot,dalaran,288,hunter,marksmanship,6,3,3
11675,Allondra,proudmoore,288,hunter,marksmanship,6,3,3
11676,Bernelli,kelthuzad,288,hunter,marksmanship,6,3,3
11677,Tichong,tichondrius,288,hunter,marksmanship,6,3,3
11678,Buzzkiller,sargeras,288,hunter,marksmanship,6,3,3
11679,Worewolf,lightninghoof,288,hunter,marksmanship,6,3,3
11680,Goatshots,lightninghoof,288,hunter,marksmanship,6,3,3
11681,Konungr,zuljin,288,hunter,marksmanship,6,3,3
11682,Antily,kelthuzad,288,hunter,marksmanship,6,3,3
11683,Rivs,detheroc,288,hunter,marksmanship,6,3,3
11684,Plastera,zuljin,288,hunter,marksmanship,6,3,3
11685,Ligmubhole,queldorei,288,hunter,marksmanship,6,3,3
11686,Ÿöskë,tichondrius,288,hunter,marksmanship,6,3,3
11687,Auset,aegwynn,288,hunter,marksmanship,6,3,3
11688,Eforas,ragnaros,288,hunter,marksmanship,6,3,3
11689,Ropivacaine,illidan,288,hunter,marksmanship,6,3,3
11690,Maxifier,tichondrius,288,hunter,marksmanship,6,3,3
11691,Halosucks,sargeras,288,hunter,marksmanship,6,3,3
11692,Wolfmilkers,illidan,288,hunter,marksmanship,6,3,3
11693,Ròllinafatty,dark-iron,288,hunter,marksmanship,6,3,3
11694,Kynigi,bleeding-hollow,288,hunter,marksmanship,6,3,3
11695,Wasteyou,tichondrius,288,hunter,marksmanship,6,3,3
11696,Kansolly,tichondrius,288,hunter,marksmanship,6,3,3
11697,Kormas,illidan,288,hunter,marksmanship,6,3,3
11698,Sereom,frostmourne,288,hunter,marksmanship,6,3,3
11699,Luckynoodlle,frostmourne,288,hunter,marksmanship,6,3,3
11700,Candîce,moon-guard,288,hunter,marksmanship,6,3,3
11701,Exabyssus,bleeding-hollow,288,hunter,marksmanship,6,3,3
11702,Zeonas,tichondrius,288,hunter,marksmanship,6,3,3
11703,Madjango,illidan,288,hunter,marksmanship,6,3,3
11704,Casadora,dark-iron,288,hunter,marksmanship,6,3,3
11705,Internade,frostmourne,288,hunter,marksmanship,6,3,3
11706,Evilslaug,tichondrius,288,hunter,marksmanship,6,3,3
11707,Humiliation,mugthol,288,hunter,marksmanship,6,3,3
11708,Deepbowjob,sargeras,288,hunter,marksmanship,6,3,3
11709,Gorhound,tichondrius,288,hunter,marksmanship,6,3,3
11710,Cloakedninja,illidan,288,hunter,marksmanship,6,3,3
11711,Khasu,ragnaros,288,hunter,marksmanship,6,3,3
11712,Thugbeast,tichondrius,288,hunter,marksmanship,6,3,3
11713,Playnogames,moon-guard,288,hunter,marksmanship,6,3,3
11714,Kong,tichondrius,288,hunter,marksmanship,6,3,3
11715,Innerhunt,aegwynn,288,hunter,marksmanship,6,3,3
11716,Arithrawn,area-52,288,hunter,marksmanship,6,3,3
11717,Chimpx,moon-guard,288,hunter,marksmanship,6,3,3
11718,Ytsejammer,eonar,288,hunter,marksmanship,6,3,3
11719,Inked,frostmourne,288,hunter,marksmanship,6,3,3
11720,Fruitenveg,frostmourne,288,hunter,marksmanship,6,3,3
11721,Triggamikê,tichondrius,288,hunter,marksmanship,6,3,3
11722,Wolftracer,sargeras,288,hunter,marksmanship,6,3,3
11723,Hawkeyees,ragnaros,288,hunter,marksmanship,6,3,3
11724,Krelas,eldrethalas,288,hunter,marksmanship,6,3,3
11725,Zzackchicken,tichondrius,288,hunter,marksmanship,6,3,3
11726,Sindain,bloodscalp,288,hunter,marksmanship,6,3,3
11727,Tetz,kelthuzad,288,hunter,marksmanship,6,3,3
11728,Kallindo,sargeras,288,hunter,marksmanship,6,3,3
11729,Kaitoo,tichondrius,288,hunter,marksmanship,6,3,3
11730,Tugh,maiev,288,hunter,marksmanship,6,3,3
11731,Chapushoot,ragnaros,288,hunter,marksmanship,6,3,3
11732,Blakespace,area-52,288,hunter,marksmanship,6,3,3
11733,Quondo,boulderfist,288,hunter,marksmanship,6,3,3
11734,Tajo,sargeras,288,hunter,marksmanship,6,3,3
11735,Keliara,dunemaul,288,hunter,marksmanship,6,3,3
11736,Mojopojo,tichondrius,288,hunter,marksmanship,12,4,8
11737,Segfault,korgath,288,hunter,marksmanship,10,3,7
11738,Snigskytte,dreadmaul,288,hunter,marksmanship,11,3,8
11739,Prpl,sargeras,288,hunter,marksmanship,15,4,11
11740,Sliperysaly,tichondrius,288,hunter,marksmanship,12,3,9
11741,Zeedii,dalaran,288,hunter,marksmanship,12,3,9
11742,Hefty,azuremyst,288,hunter,marksmanship,12,3,9
11743,Alyzza,sargeras,288,hunter,marksmanship,12,3,9
11744,Ryhew,emerald-dream,288,hunter,marksmanship,12,3,9
11745,Blarck,shattered-halls,288,hunter,marksmanship,12,3,9
11746,Oua,queldorei,288,hunter,marksmanship,12,3,9
11747,Peña,trollbane,288,hunter,marksmanship,12,3,9
11748,Skywrecker,bleeding-hollow,288,hunter,marksmanship,12,3,9
11749,Gustavitch,executus,288,hunter,marksmanship,12,3,9
11750,Fatehunter,bleeding-hollow,288,hunter,marksmanship,12,3,9
11751,Sparkco,area-52,288,hunter,marksmanship,12,3,9
11752,Drysst,tichondrius,288,hunter,marksmanship,12,3,9
11753,Strixx,emerald-dream,288,hunter,marksmanship,12,3,9
11754,Boltflux,nemesis,288,hunter,marksmanship,12,3,9
11755,Shablagoosh,zuljin,288,hunter,marksmanship,12,3,9
11756,Xsparkys,kargath,288,hunter,marksmanship,12,3,9
11757,Princssdaizy,zuljin,288,hunter,marksmanship,12,3,9
11758,Exiun,sargeras,288,hunter,marksmanship,12,3,9
11759,Wadadly,malganis,288,hunter,marksmanship,12,3,9
11760,Shifted,quelthalas,288,hunter,marksmanship,12,3,9
11761,Hatara,quelthalas,288,hunter,marksmanship,12,3,9
11762,Tmd,thrall,288,hunter,marksmanship,12,3,9
11763,Blaisian,frostmourne,288,hunter,marksmanship,12,3,9
11764,Aerefix,frostmourne,288,hunter,marksmanship,12,3,9
11765,Lumbygoblin,illidan,288,hunter,marksmanship,13,3,10
11766,Huntdawgg,illidan,288,hunter,marksmanship,18,3,15
11767,Winstônwolf,spinebreaker,288,hunter,marksmanship,18,3,15
11768,Demolitions,kelthuzad,288,hunter,marksmanship,18,3,15
11769,Lapelada,ragnaros,287,hunter,marksmanship,6,3,3
11770,Slayemz,barthilas,287,hunter,marksmanship,6,3,3
11771,Steelfeather,hellscream,287,hunter,marksmanship,6,3,3
11772,Multicereal,quelthalas,287,hunter,marksmanship,6,3,3
11773,Downtimes,illidan,287,hunter,marksmanship,6,3,3
11774,Drâgônâr,stormrage,287,hunter,marksmanship,6,3,3
11775,Ghazzghkuull,ragnaros,287,hunter,marksmanship,6,3,3
11776,Lulaladraun,azralon,287,hunter,marksmanship,12,3,9
11777,Divinee,undermine,287,hunter,marksmanship,12,3,9
11778,Tarbabies,mannoroth,287,hunter,marksmanship,12,3,9
11779,Darthwillie,cenarius,287,hunter,marksmanship,12,3,9
11780,Bumbow,tichondrius,287,hunter,marksmanship,12,3,9
11781,Lorelåii,tichondrius,286,hunter,marksmanship,6,3,3
11782,Axtlas,moonrunner,286,hunter,marksmanship,6,3,3
11783,Irishnia,bleeding-hollow,286,hunter,marksmanship,6,3,3
11784,Weirdjeff,alexstrasza,286,hunter,marksmanship,6,3,3
11785,Aeclpysis,dark-iron,281,hunter,marksmanship,12,5,7
11786,Mythman,area-52,255,hunter,marksmanship,14,4,10
11787,Setepalms,azralon,239,hunter,marksmanship,5,3,2
11788,Brorc,kul-tiras,239,hunter,marksmanship,5,3,2
11789,Glôck,dalaran,239,hunter,marksmanship,11,3,8
11790,Knowtraps,area-52,234,hunter,marksmanship,7,4,3
11791,Druskritag,moon-guard,234,hunter,marksmanship,10,4,6
11792,Demongirl,arathor,231,hunter,marksmanship,25,4,21
11793,Almighty,trollbane,229,hunter,marksmanship,29,6,23
11794,Downworlder,darkspear,223,hunter,marksmanship,8,3,5
11795,Andrømeda,frostmourne,208,hunter,marksmanship,7,3,4
11796,Lamb,undermine,202,hunter,marksmanship,11,4,7
11797,Farverr,area-52,192,hunter,marksmanship,4,3,1
11798,Traitorously,daggerspine,192,hunter,marksmanship,9,3,6
11799,Ramchi,burning-blade,192,hunter,marksmanship,6,2,4
11800,Sogeki,kelthuzad,192,hunter,marksmanship,6,2,4
11801,Muscletooth,moon-guard,192,hunter,marksmanship,6,2,4
11802,Mtq,thrall,192,hunter,marksmanship,6,2,4
11803,Gadorim,kelthuzad,192,hunter,marksmanship,6,2,4
11804,Salvatiel,stormrage,192,hunter,marksmanship,6,2,4
11805,Lulafourdedo,stormrage,192,hunter,marksmanship,6,2,4
11806,Shoccka,thrall,192,hunter,marksmanship,6,2,4
11807,Blowedazchit,bonechewer,192,hunter,marksmanship,6,2,4
11808,Deletedyou,tichondrius,192,hunter,marksmanship,6,2,4
11809,Áppóló,spinebreaker,192,hunter,marksmanship,6,2,4
11810,Lorgor,eonar,192,hunter,marksmanship,6,2,4
11811,Blury,tichondrius,192,hunter,marksmanship,6,2,4
11812,Inurah,malganis,192,hunter,marksmanship,6,2,4
11813,Desdee,icecrown,192,hunter,marksmanship,6,2,4
11814,Zhona,moon-guard,192,hunter,marksmanship,6,2,4
11815,Erebor,malganis,192,hunter,marksmanship,6,2,4
11816,Thiccshawts,moon-guard,192,hunter,marksmanship,6,2,4
11817,Tus,tichondrius,192,hunter,marksmanship,6,2,4
11818,Fleshfeast,tichondrius,192,hunter,marksmanship,6,2,4
11819,Lukara,darkspear,192,hunter,marksmanship,6,2,4
11820,Bstic,quelthalas,192,hunter,marksmanship,6,2,4
11821,Bôdon,illidan,192,hunter,marksmanship,6,2,4
11822,Xpyroshot,area-52,192,hunter,marksmanship,6,2,4
11823,Kahtniss,quelthalas,192,hunter,marksmanship,6,2,4
11824,Hideontrap,malganis,192,hunter,marksmanship,6,2,4
11825,Geeshot,area-52,192,hunter,marksmanship,6,2,4
11826,Commonbuck,area-52,192,hunter,marksmanship,6,2,4
11827,Àngèl,malganis,192,hunter,marksmanship,6,2,4
11828,Pumpydumpy,malganis,192,hunter,marksmanship,6,2,4
11829,Ensnare,wyrmrest-accord,192,hunter,marksmanship,6,2,4
11830,Yembohi,queldorei,192,hunter,marksmanship,6,2,4
11831,Lanarhoades,firetree,192,hunter,marksmanship,6,2,4
11832,Cazaaires,quelthalas,192,hunter,marksmanship,6,2,4
11833,Hfn,stormrage,192,hunter,marksmanship,6,2,4
11834,Bowzørx,tichondrius,192,hunter,marksmanship,6,2,4
11835,Warsh,anubarak,192,hunter,marksmanship,6,2,4
11836,Huntugz,frostmourne,192,hunter,marksmanship,6,2,4
11837,Percival,firetree,192,hunter,marksmanship,6,2,4
11838,Dikbender,tichondrius,192,hunter,marksmanship,6,2,4
11839,Camorcaist,stormrage,192,hunter,marksmanship,6,2,4
11840,Petmydog,aegwynn,192,hunter,marksmanship,6,2,4
11841,Terapista,area-52,192,hunter,marksmanship,6,2,4
11842,Tyraelias,kaelthas,192,hunter,marksmanship,6,2,4
11843,Yonzo,area-52,192,hunter,marksmanship,6,2,4
11844,Anilora,wyrmrest-accord,192,hunter,marksmanship,6,2,4
11845,Whitemàne,dalaran,192,hunter,marksmanship,6,2,4
11846,Jebote,frostmourne,192,hunter,marksmanship,6,2,4
11847,Wartoz,dragonblight,192,hunter,marksmanship,6,2,4
11848,Leeshaarrow,moon-guard,192,hunter,marksmanship,6,2,4
11849,Kïwwï,tichondrius,192,hunter,marksmanship,6,2,4
11850,Xxunderoath,frostwolf,192,hunter,marksmanship,6,2,4
11851,Rëxx,moon-guard,192,hunter,marksmanship,6,2,4
11852,Alssong,tichondrius,192,hunter,marksmanship,6,2,4
11853,Penelòpe,wyrmrest-accord,192,hunter,marksmanship,6,2,4
11854,Léfty,nagrand,192,hunter,marksmanship,6,2,4
11855,Ctrlaltdel,gundrak,192,hunter,marksmanship,6,2,4
11856,Huntbodom,drakkari,192,hunter,marksmanship,6,2,4
11857,Zumythriel,stormrage,192,hunter,marksmanship,6,2,4
11858,Nord,draka,192,hunter,marksmanship,6,2,4
11859,Haki,gallywix,192,hunter,marksmanship,6,2,4
11860,Córnell,tichondrius,192,hunter,marksmanship,6,2,4
11861,Huntingyou,destromath,192,hunter,marksmanship,6,2,4
11862,Ayrana,tichondrius,192,hunter,marksmanship,6,2,4
11863,Yortrox,ragnaros,192,hunter,marksmanship,6,2,4
11864,Xuxoo,nemesis,192,hunter,marksmanship,6,2,4
11865,Stormjin,arthas,192,hunter,marksmanship,6,2,4
11866,Otirrub,deathwing,192,hunter,marksmanship,6,2,4
11867,Cuchulláin,area-52,192,hunter,marksmanship,6,2,4
11868,Knator,area-52,192,hunter,marksmanship,6,2,4
11869,Torvauk,bleeding-hollow,192,hunter,marksmanship,6,2,4
11870,Ilîiìîìiilil,bleeding-hollow,192,hunter,marksmanship,6,2,4
11871,Vitae,shattered-halls,192,hunter,marksmanship,6,2,4
11872,Hárd,illidan,192,hunter,marksmanship,6,2,4
11873,Angrypepe,bleeding-hollow,192,hunter,marksmanship,6,2,4
11874,Cornbreadfed,gorgonnash,192,hunter,marksmanship,6,2,4
11875,Huntkillerx,illidan,192,hunter,marksmanship,6,2,4
11876,Dreezzy,bleeding-hollow,192,hunter,marksmanship,6,2,4
11877,Rumnaheim,nemesis,192,hunter,marksmanship,6,2,4
11878,Crownchild,illidan,192,hunter,marksmanship,6,2,4
11879,Ðevil,ragnaros,192,hunter,marksmanship,6,2,4
11880,Ragar,korialstrasz,192,hunter,marksmanship,6,2,4
11881,Latherel,bleeding-hollow,192,hunter,marksmanship,6,2,4
11882,Kanta,bleeding-hollow,192,hunter,marksmanship,6,2,4
11883,Namøscä,nemesis,192,hunter,marksmanship,6,2,4
11884,Jathriel,zuljin,192,hunter,marksmanship,6,2,4
11885,Huntgar,earthen-ring,192,hunter,marksmanship,6,2,4
11886,Íkíte,zuljin,192,hunter,marksmanship,6,2,4
11887,Gotskill,lethon,192,hunter,marksmanship,6,2,4
11888,Magvez,tichondrius,192,hunter,marksmanship,6,2,4
11889,Symz,ragnaros,192,hunter,marksmanship,6,2,4
11890,Ramblin,ragnaros,192,hunter,marksmanship,6,2,4
11891,Illweedx,kiljaeden,192,hunter,marksmanship,6,2,4
11892,Holytrap,destromath,192,hunter,marksmanship,6,2,4
11893,Justhunter,moknathal,192,hunter,marksmanship,6,2,4
11894,Geldyn,stormreaver,192,hunter,marksmanship,6,2,4
11895,Doopers,kiljaeden,192,hunter,marksmanship,6,2,4
11896,Amptx,tichondrius,192,hunter,marksmanship,6,2,4
11897,Zaghoward,fenris,192,hunter,marksmanship,6,2,4
11898,Cefla,illidan,192,hunter,marksmanship,6,2,4
11899,Arantir,drakkari,192,hunter,marksmanship,6,2,4
11900,Isitrng,aggramar,192,hunter,marksmanship,6,2,4
11901,Sinsix,akama,192,hunter,marksmanship,6,2,4
11902,Mohz,kiljaeden,192,hunter,marksmanship,6,2,4
11903,Voodoohunter,blood-furnace,192,hunter,marksmanship,6,2,4
11904,Fizzleegear,area-52,192,hunter,marksmanship,6,2,4
11905,Sobala,azralon,192,hunter,marksmanship,6,2,4
11906,Zackmorris,kelthuzad,192,hunter,marksmanship,6,2,4
11907,Bloodrainia,ravencrest,192,hunter,marksmanship,6,2,4
11908,Firskin,frostmourne,192,hunter,marksmanship,6,2,4
11909,Skolzero,azralon,192,hunter,marksmanship,6,2,4
11910,Jgodsslayer,tichondrius,192,hunter,marksmanship,6,2,4
11911,Pichsolika,frostmourne,192,hunter,marksmanship,6,2,4
11912,Stormwardenx,turalyon,192,hunter,marksmanship,6,2,4
11913,Tarkovs,area-52,192,hunter,marksmanship,6,2,4
11914,Pandaslayr,garrosh,192,hunter,marksmanship,6,2,4
11915,Zeaks,emerald-dream,192,hunter,marksmanship,6,2,4
11916,Baruz,tichondrius,192,hunter,marksmanship,6,2,4
11917,Ðecarlis,azralon,192,hunter,marksmanship,6,2,4
11918,Bionix,sargeras,192,hunter,marksmanship,6,2,4
11919,Gangstashot,burning-legion,192,hunter,marksmanship,6,2,4
11920,Bendoon,sargeras,192,hunter,marksmanship,6,2,4
11921,Lemmiewînkzz,sargeras,192,hunter,marksmanship,6,2,4
11922,Regerts,sargeras,192,hunter,marksmanship,6,2,4
11923,Nubberton,sargeras,192,hunter,marksmanship,6,2,4
11924,Thugio,sargeras,192,hunter,marksmanship,6,2,4
11925,Kreaytion,sargeras,192,hunter,marksmanship,6,2,4
11926,Happyhunting,sargeras,192,hunter,marksmanship,6,2,4
11927,Mickyluvin,emerald-dream,192,hunter,marksmanship,6,2,4
11928,Brindlë,kelthuzad,192,hunter,marksmanship,11,3,8
11929,Sevitham,dalaran,192,hunter,marksmanship,12,2,10
11930,Thunderox,tichondrius,192,hunter,marksmanship,12,2,10
11931,Killdred,bonechewer,192,hunter,marksmanship,12,2,10
11932,Zarknoth,cenarius,192,hunter,marksmanship,12,2,10
11933,Shafttrapper,queldorei,192,hunter,marksmanship,12,2,10
11934,Littleagu,proudmoore,192,hunter,marksmanship,12,2,10
11935,Dojaqat,frostmourne,192,hunter,marksmanship,12,2,10
11936,Roboputa,quelthalas,192,hunter,marksmanship,12,2,10
11937,Warpedshots,malganis,192,hunter,marksmanship,12,2,10
11938,Seekem,destromath,192,hunter,marksmanship,12,2,10
11939,Sharpzy,jubeithos,192,hunter,marksmanship,12,2,10
11940,Luvtits,bonechewer,192,hunter,marksmanship,12,2,10
11941,Stïinck,azralon,192,hunter,marksmanship,12,2,10
11942,Eaglesx,skullcrusher,192,hunter,marksmanship,12,2,10
11943,Warrioress,illidan,192,hunter,marksmanship,12,2,10
11944,Xulag,tichondrius,192,hunter,marksmanship,12,2,10
11945,Najmoira,area-52,192,hunter,marksmanship,12,2,10
11946,Hunterish,area-52,192,hunter,marksmanship,12,2,10
11947,Johnwayne,alterac-mountains,192,hunter,marksmanship,12,2,10
11948,Josthar,thrall,192,hunter,marksmanship,12,2,10
11949,Findbind,altar-of-storms,192,hunter,marksmanship,12,2,10
11950,Larts,fenris,192,hunter,marksmanship,12,2,10
11951,Chinchompas,bleeding-hollow,192,hunter,marksmanship,18,2,16
11952,Sylviannas,frostmourne,191,hunter,marksmanship,6,2,4
11953,Wörg,elune,191,hunter,marksmanship,6,2,4
11954,Goofyfingers,illidan,191,hunter,marksmanship,12,2,10
11955,ßonßon,stormrage,160,hunter,marksmanship,10,2,8
11956,Amorial,barthilas,159,hunter,marksmanship,5,2,3
11957,Hunntard,veknilash,159,hunter,marksmanship,5,2,3
11958,Wike,hyjal,159,hunter,marksmanship,5,2,3
11959,Thesloott,azshara,159,hunter,marksmanship,5,2,3
11960,Clintbartun,shadowsong,159,hunter,marksmanship,5,2,3
11961,Ryonel,moon-guard,159,hunter,marksmanship,11,2,9
11962,Tanneritez,bleeding-hollow,144,hunter,marksmanship,11,2,9
11963,Dusle,azralon,138,hunter,marksmanship,8,3,5
11964,Darthski,drenden,138,hunter,marksmanship,12,4,8
11965,Pvrisxoxo,frostmourne,138,hunter,marksmanship,9,3,6
11966,Ünknown,sargeras,138,hunter,marksmanship,10,3,7
11967,Plsnobanmee,frostmourne,137,hunter,marksmanship,9,5,4
11968,Ifeignalot,stormscale,128,hunter,marksmanship,4,2,2
11969,Yarthax,illidan,128,hunter,marksmanship,4,2,2
11970,Darance,sargeras,128,hunter,marksmanship,4,2,2
11971,Lúthiel,azralon,127,hunter,marksmanship,8,2,6
11972,Razer,anvilmar,96,hunter,marksmanship,3,2,1
11973,Ïmprîsôñ,dalaran,96,hunter,marksmanship,3,2,1
11974,Shootr,darkspear,96,hunter,marksmanship,3,2,1
11975,Bensonlmn,tichondrius,96,hunter,marksmanship,9,2,7
11976,Drakkoniss,spinebreaker,96,hunter,marksmanship,6,1,5
11977,Wolfmastera,zuljin,96,hunter,marksmanship,6,1,5
11978,Cowboytroy,exodar,96,hunter,marksmanship,6,1,5
11979,Hunternao,nemesis,96,hunter,marksmanship,6,1,5
11980,Hellcry,khadgar,96,hunter,marksmanship,6,1,5
11981,Zirstorm,altar-of-storms,96,hunter,marksmanship,6,1,5
11982,Keelif,arthas,96,hunter,marksmanship,6,1,5
11983,Smackadoodlé,illidan,96,hunter,marksmanship,6,1,5
11984,Beldhur,archimonde,96,hunter,marksmanship,6,1,5
11985,Infinitý,zuljin,96,hunter,marksmanship,6,1,5
11986,Traxêx,nemesis,96,hunter,marksmanship,6,1,5
11987,Gabitoqt,gallywix,96,hunter,marksmanship,6,1,5
11988,Jaidev,nemesis,96,hunter,marksmanship,6,1,5
11989,Desarus,archimonde,96,hunter,marksmanship,6,1,5
11990,Ethùg,area-52,96,hunter,marksmanship,6,1,5
11991,Siimmplicitz,area-52,96,hunter,marksmanship,6,1,5
11992,Ashner,illidan,96,hunter,marksmanship,6,1,5
11993,Wellfaír,area-52,96,hunter,marksmanship,6,1,5
11994,Vilguz,illidan,96,hunter,marksmanship,6,1,5
11995,Hyena,kelthuzad,96,hunter,marksmanship,6,1,5
11996,Sarutovy,kelthuzad,96,hunter,marksmanship,6,1,5
11997,Arawnz,emerald-dream,96,hunter,marksmanship,6,1,5
11998,Minnervva,malganis,96,hunter,marksmanship,6,1,5
11999,Lesley,illidan,96,hunter,marksmanship,6,1,5
12000,Boongtokes,illidan,96,hunter,marksmanship,6,1,5
12001,Shootdogg,mannoroth,96,hunter,marksmanship,6,1,5
12002,Laudion,quelthalas,96,hunter,marksmanship,6,1,5
12003,Deadlyattack,barthilas,96,hunter,marksmanship,6,1,5
12004,Artilleria,quelthalas,96,hunter,marksmanship,6,1,5
12005,Dogtagluke,stormrage,96,hunter,marksmanship,6,1,5
12006,Ikiteforgold,zuljin,96,hunter,marksmanship,6,1,5
12007,Derenit,ragnaros,96,hunter,marksmanship,6,1,5
12008,Evemae,sargeras,96,hunter,marksmanship,6,1,5
12009,Panchovill,ragnaros,96,hunter,marksmanship,6,1,5
12010,Mirãbel,drakkari,96,hunter,marksmanship,6,1,5
12011,Crazyshot,drakkari,96,hunter,marksmanship,6,1,5
12012,Pilk,daggerspine,96,hunter,marksmanship,6,1,5
12013,Rämbow,frostmourne,96,hunter,marksmanship,6,1,5
12014,Hopsmatei,azralon,96,hunter,marksmanship,6,1,5
12015,Brutalhit,bonechewer,96,hunter,marksmanship,6,1,5
12016,Cocobage,destromath,96,hunter,marksmanship,6,1,5
12017,Garkia,hyjal,96,hunter,marksmanship,6,1,5
12018,Exitwoundz,hyjal,96,hunter,marksmanship,6,1,5
12019,Longshott,azralon,96,hunter,marksmanship,6,1,5
12020,Darkarcher,hyjal,96,hunter,marksmanship,6,1,5
12021,Necroshotz,kul-tiras,96,hunter,marksmanship,6,1,5
12022,Faceshots,tichondrius,96,hunter,marksmanship,6,1,5
12023,Rockehm,frostmourne,96,hunter,marksmanship,6,1,5
12024,Seizedhunt,frostmourne,96,hunter,marksmanship,6,1,5
12025,Shootermgavn,frostmourne,96,hunter,marksmanship,6,1,5
12026,Nodar,quelthalas,96,hunter,marksmanship,6,1,5
12027,Samanta,blood-furnace,96,hunter,marksmanship,6,1,5
12028,Htcrazykofwa,tichondrius,96,hunter,marksmanship,6,1,5
12029,Narukín,tichondrius,96,hunter,marksmanship,6,1,5
12030,Anndaria,tichondrius,96,hunter,marksmanship,6,1,5
12031,Fingamyquill,tichondrius,96,hunter,marksmanship,6,1,5
12032,Rensv,frostmourne,96,hunter,marksmanship,6,1,5
12033,Terezhunt,tichondrius,96,hunter,marksmanship,6,1,5
12034,Insönnia,azralon,96,hunter,marksmanship,6,1,5
12035,Biehuixin,tichondrius,96,hunter,marksmanship,6,1,5
12036,Autaila,thunderlord,96,hunter,marksmanship,6,1,5
12037,Solderboi,tichondrius,96,hunter,marksmanship,6,1,5
12038,Dreygar,dawnbringer,96,hunter,marksmanship,6,1,5
12039,Puppyghoul,malganis,96,hunter,marksmanship,6,1,5
12040,Maquire,tichondrius,96,hunter,marksmanship,6,1,5
12041,Zünma,tichondrius,96,hunter,marksmanship,6,1,5
12042,Ruhak,windrunner,96,hunter,marksmanship,6,1,5
12043,Elknut,sargeras,96,hunter,marksmanship,6,1,5
12044,Arin,suramar,96,hunter,marksmanship,6,1,5
12045,Blaptz,wyrmrest-accord,96,hunter,marksmanship,6,1,5
12046,Lailyann,sargeras,96,hunter,marksmanship,6,1,5
12047,Hovahdo,proudmoore,96,hunter,marksmanship,6,1,5
12048,Fleshfair,kiljaeden,96,hunter,marksmanship,6,1,5
12049,Ruvathir,wyrmrest-accord,96,hunter,marksmanship,6,1,5
12050,Kiatus,nesingwary,96,hunter,marksmanship,6,1,5
12051,Zral,dragonmaw,96,hunter,marksmanship,6,1,5
12052,Clacktar,wyrmrest-accord,96,hunter,marksmanship,6,1,5
12053,Gunwalk,azjolnerub,96,hunter,marksmanship,6,1,5
12054,Tastysauce,wyrmrest-accord,96,hunter,marksmanship,6,1,5
12055,Fawn,moon-guard,96,hunter,marksmanship,6,1,5
12056,Coppersnout,wyrmrest-accord,96,hunter,marksmanship,6,1,5
12057,Citizen,dragonmaw,96,hunter,marksmanship,6,1,5
12058,Surfbum,lightbringer,96,hunter,marksmanship,6,1,5
12059,Jumeog,stormscale,96,hunter,marksmanship,6,1,5
12060,Nickaz,frostmourne,96,hunter,marksmanship,8,1,7
12061,Bophadeaz,sargeras,96,hunter,marksmanship,12,1,11
12062,Missedshot,frostmourne,96,hunter,marksmanship,12,1,11
12063,Kofan,darkspear,96,hunter,marksmanship,12,1,11
12064,Tarapandas,kilrogg,96,hunter,marksmanship,12,1,11
12065,Hawneyduo,skullcrusher,96,hunter,marksmanship,12,1,11
12066,Cerébro,illidan,96,hunter,marksmanship,12,1,11
12067,Jacobsladder,illidan,96,hunter,marksmanship,12,1,11
12068,Xalmoinmybow,illidan,96,hunter,marksmanship,12,1,11
12069,Elanor,feathermoon,96,hunter,marksmanship,18,1,17
12070,Strixis,blood-furnace,95,hunter,marksmanship,6,1,5
12071,Setbackhunt,illidan,79,hunter,marksmanship,5,1,4
12072,Trionias,malfurion,79,hunter,marksmanship,5,1,4
12073,Dashing,magtheridon,79,hunter,marksmanship,5,1,4
12074,Raymose,tichondrius,64,hunter,marksmanship,4,1,3
12075,Huntsmate,tichondrius,64,hunter,marksmanship,4,1,3
12076,Nyloc,dalvengyr,64,hunter,marksmanship,4,1,3
12077,Killarth,quelthalas,48,hunter,marksmanship,3,1,2
12078,Ahncheolsoo,tichondrius,42,hunter,marksmanship,11,2,9
12079,Dapoosyx,tichondrius,31,hunter,marksmanship,2,1,1
12080,Suntail,dalaran,2208,hunter,survival,111,58,53
12081,Saiiph,bleeding-hollow,2169,hunter,survival,144,74,70
12082,Cëb,stormrage,2157,hunter,survival,168,84,84
12083,Disciple,darkspear,2152,hunter,survival,74,43,31
12084,Cadencex,stormrage,2131,hunter,survival,135,69,66
12085,Buffmm,kelthuzad,2130,hunter,survival,90,46,44
12086,Hotmuscleman,tichondrius,2127,hunter,survival,74,45,29
12087,Malukaca,azralon,2121,hunter,survival,137,69,68
12088,Capncams,emerald-dream,2120,hunter,survival,130,68,62
12089,Aimbotmir,zuljin,2065,hunter,survival,74,35,39
12090,Pridefulz,stormrage,2062,hunter,survival,170,85,85
12091,Gloomy,dark-iron,2054,hunter,survival,54,41,13
12092,Legoelass,emerald-dream,2040,hunter,survival,191,105,86
12093,Kansolly,tichondrius,2040,hunter,survival,105,54,51
12094,Missedmytrap,draenor,2018,hunter,survival,60,38,22
12095,Djtraphouse,stormrage,2013,hunter,survival,132,67,65
12096,Ungrella,malganis,2001,hunter,survival,81,44,37
12097,Noimnotokay,tichondrius,1992,hunter,survival,113,57,56
12098,Wmsgs,tichondrius,1992,hunter,survival,129,63,66
12099,Maxiam,frostmourne,1989,hunter,survival,71,37,34
12100,Nearly,wyrmrest-accord,1987,hunter,survival,79,40,39
12101,Koupon,tichondrius,1987,hunter,survival,95,48,47
12102,Dijhoni,moon-guard,1985,hunter,survival,119,63,56
12103,Veyronnx,stormrage,1980,hunter,survival,108,62,46
12104,Hamslapper,shattered-hand,1971,hunter,survival,135,66,69
12105,Bicmex,sargeras,1970,hunter,survival,42,29,13
12106,Ynoit,sargeras,1968,hunter,survival,82,44,38
12107,Pokìmane,tichondrius,1961,hunter,survival,98,62,36
12108,Galavant,frostmourne,1960,hunter,survival,98,52,46
12109,Ferex,tichondrius,1953,hunter,survival,57,36,21
12110,Lèkïnhø,azralon,1953,hunter,survival,72,36,36
12111,Foxyhood,ragnaros,1941,hunter,survival,125,67,58
12112,Sikhunt,frostmourne,1939,hunter,survival,60,35,25
12113,Neverturtlex,tichondrius,1929,hunter,survival,42,24,18
12114,Aurelx,tichondrius,1920,hunter,survival,42,30,12
12115,Dwx,bleeding-hollow,1911,hunter,survival,66,35,31
12116,Leonilc,tichondrius,1907,hunter,survival,78,36,42
12117,Kubu,emerald-dream,1898,hunter,survival,91,58,33
12118,Briggsx,sargeras,1894,hunter,survival,48,26,22
12119,Effyh,emerald-dream,1889,hunter,survival,152,79,73
12120,Ruskö,tichondrius,1888,hunter,survival,31,20,11
12121,Dyucol,tichondrius,1883,hunter,survival,113,65,48
12122,Runecrossbow,barthilas,1882,hunter,survival,144,71,73
12123,Drasen,deathwing,1874,hunter,survival,54,30,24
12124,Bergy,thrall,1873,hunter,survival,54,30,24
12125,Anisphia,tichondrius,1873,hunter,survival,204,109,95
12126,Queríde,emerald-dream,1871,hunter,survival,59,41,18
12127,Kzmo,gnomeregan,1870,hunter,survival,30,23,7
12128,Coggenda,sargeras,1866,hunter,survival,156,88,68
12129,Jalinhabbei,azralon,1862,hunter,survival,53,28,25
12130,Hwslol,tichondrius,1861,hunter,survival,136,71,65
12131,Dirtysoap,tichondrius,1861,hunter,survival,63,31,32
12132,Covlol,illidan,1857,hunter,survival,42,21,21
12133,Destrumz,zuljin,1855,hunter,survival,66,31,35
12134,Notnunca,tichondrius,1850,hunter,survival,60,33,27
12135,Ikiteforfood,zuljin,1847,hunter,survival,32,20,12
12136,Kelarcia,moon-guard,1846,hunter,survival,65,29,36
12137,Pylorih,area-52,1842,hunter,survival,51,35,16
12138,Finito,bladefist,1841,hunter,survival,151,75,76
12139,Neonjz,ragnaros,1841,hunter,survival,66,31,35
12140,Sartel,tichondrius,1837,hunter,survival,178,92,86
12141,Pathofsexile,tichondrius,1835,hunter,survival,123,63,60
12142,Ssds,sargeras,1834,hunter,survival,42,26,16
12143,Queride,area-52,1833,hunter,survival,54,27,27
12144,Endsnear,stormrage,1830,hunter,survival,66,31,35
12145,Gvoo,tichondrius,1829,hunter,survival,30,24,6
12146,Exhausted,blackrock,1829,hunter,survival,90,38,52
12147,Sobit,tichondrius,1827,hunter,survival,36,23,13
12148,Goonsh,tichondrius,1826,hunter,survival,48,32,16
12149,Mlemily,stormrage,1826,hunter,survival,47,31,16
12150,Otii,tichondrius,1826,hunter,survival,126,57,69
12151,Gabiña,tichondrius,1822,hunter,survival,232,115,117
12152,Angrybow,ragnaros,1821,hunter,survival,36,25,11
12153,Thoromel,wyrmrest-accord,1820,hunter,survival,66,33,33
12154,Chimeralol,area-52,1815,hunter,survival,102,65,37
12155,Kisuke,khaz-modan,1815,hunter,survival,54,34,20
12156,Trapula,tichondrius,1814,hunter,survival,84,46,38
12157,Joón,moon-guard,1808,hunter,survival,43,26,17
12158,Jagaerz,emerald-dream,1808,hunter,survival,42,23,19
12159,Krømatik,tichondrius,1807,hunter,survival,42,23,19
12160,Raef,azralon,1804,hunter,survival,60,32,28
12161,Ratonh,ragnaros,1801,hunter,survival,156,88,68
12162,Fizzleegear,area-52,1801,hunter,survival,171,82,89
12163,Huntmon,nemesis,1800,hunter,survival,48,31,17
12164,Jîñßæçhïñæ,sargeras,1800,hunter,survival,66,29,37
12165,Moroally,sargeras,1799,hunter,survival,42,25,17
12166,Carnidon,area-52,1796,hunter,survival,193,97,96
12167,Concur,frostmourne,1792,hunter,survival,126,65,61
12168,Misogynistaf,tichondrius,1785,hunter,survival,34,20,14
12169,Terapista,area-52,1783,hunter,survival,72,35,37
12170,Leaku,illidan,1775,hunter,survival,52,34,18
12171,Sniffler,barthilas,1772,hunter,survival,42,19,23
12172,Percival,firetree,1770,hunter,survival,36,19,17
12173,Acres,emerald-dream,1765,hunter,survival,66,32,34
12174,Pathed,azralon,1761,hunter,survival,54,31,23
12175,Woriath,quelthalas,1761,hunter,survival,96,50,46
12176,Skàdii,tichondrius,1754,hunter,survival,91,50,41
12177,Sensator,barthilas,1753,hunter,survival,58,33,25
12178,Vlf,tichondrius,1753,hunter,survival,60,30,30
12179,Shootin,frostmourne,1749,hunter,survival,42,22,20
12180,Xyzv,tichondrius,1744,hunter,survival,36,19,17
12181,Saltstream,tichondrius,1744,hunter,survival,96,40,56
12182,Nishinos,tichondrius,1739,hunter,survival,170,85,85
12183,Sylvanne,sargeras,1737,hunter,survival,42,20,22
12184,Caiodluffy,malganis,1729,hunter,survival,60,30,30
12185,Hibyexo,illidan,1728,hunter,survival,36,22,14
12186,Peppancini,wyrmrest-accord,1725,hunter,survival,53,34,19
12187,Alphaqt,dethecus,1721,hunter,survival,36,19,17
12188,Róckzero,quelthalas,1714,hunter,survival,163,81,82
12189,Fictìon,kelthuzad,1712,hunter,survival,35,21,14
12190,Stevemonday,stormrage,1711,hunter,survival,96,53,43
12191,Yeahimsad,tichondrius,1709,hunter,survival,24,18,6
12192,Blåker,bleeding-hollow,1709,hunter,survival,72,38,34
12193,Töxic,dalaran,1707,hunter,survival,37,25,12
12194,Dirtysoap,sargeras,1707,hunter,survival,42,18,24
12195,Názzul,area-52,1705,hunter,survival,30,18,12
12196,Partz,darkspear,1702,hunter,survival,56,35,21
12197,Scytsbow,illidan,1700,hunter,survival,48,26,22
12198,Samcro,rivendare,1700,hunter,survival,65,33,32
12199,Yip,moon-guard,1698,hunter,survival,39,20,19
12200,Kyujin,ragnaros,1697,hunter,survival,102,56,46
12201,Bbaronsamedi,darkspear,1693,hunter,survival,51,27,24
12202,Svhunt,frostmourne,1692,hunter,survival,32,18,14
12203,Gnarwallz,stormrage,1691,hunter,survival,60,32,28
12204,Henhøuse,illidan,1691,hunter,survival,48,24,24
12205,Táká,quelthalas,1689,hunter,survival,60,38,22
12206,Knewbee,emerald-dream,1689,hunter,survival,69,37,32
12207,Noxtis,kiljaeden,1689,hunter,survival,36,18,18
12208,Axezul,tichondrius,1688,hunter,survival,42,23,19
12209,Arrów,duskwood,1688,hunter,survival,36,18,18
12210,Boogiemas,akama,1686,hunter,survival,30,20,10
12211,Budgetben,stormrage,1682,hunter,survival,33,19,14
12212,Truckrsaurus,tichondrius,1681,hunter,survival,87,45,42
12213,Spinze,stormrage,1677,hunter,survival,24,18,6
12214,Bjornwald,thrall,1675,hunter,survival,304,156,148
12215,Shablagoosh,zuljin,1672,hunter,survival,45,23,22
12216,Réxon,quelthalas,1672,hunter,survival,105,51,54
12217,Snowynightt,proudmoore,1671,hunter,survival,132,65,67
12218,Arsk,ragnaros,1670,hunter,survival,45,19,26
12219,Ingridaniela,aegwynn,1668,hunter,survival,30,20,10
12220,Poston,ragnaros,1666,hunter,survival,63,30,33
12221,Crypy,illidan,1664,hunter,survival,48,24,24
12222,Iyne,stormrage,1663,hunter,survival,24,18,6
12223,Trapgodxo,moon-guard,1658,hunter,survival,27,19,8
12224,Fleche,aggramar,1658,hunter,survival,30,20,10
12225,Blackdevil,magtheridon,1656,hunter,survival,48,24,24
12226,Ganemdar,sargeras,1653,hunter,survival,57,22,35
12227,Ajacs,zuljin,1647,hunter,survival,35,24,11
12228,Undien,area-52,1647,hunter,survival,60,35,25
12229,Henroyer,quelthalas,1646,hunter,survival,30,19,11
12230,Reeiko,ragnaros,1641,hunter,survival,36,22,14
12231,Ryukotsu,tichondrius,1641,hunter,survival,49,24,25
12232,Liekis,darkspear,1641,hunter,survival,60,26,34
12233,Vigon,stormrage,1640,hunter,survival,99,53,46
12234,Bendotexe,stormrage,1638,hunter,survival,36,21,15
12235,Asarden,jubeithos,1637,hunter,survival,60,35,25
12236,Killshøtß,tichondrius,1634,hunter,survival,84,43,41
12237,Covloltrap,illidan,1633,hunter,survival,24,21,3
12238,Vhelkan,senjin,1632,hunter,survival,36,23,13
12239,Kaitoo,tichondrius,1632,hunter,survival,47,27,20
12240,Nimeer,tichondrius,1632,hunter,survival,82,45,37
12241,Tyjes,stormrage,1632,hunter,survival,45,23,22
12242,Moartraps,zuljin,1631,hunter,survival,36,21,15
12243,Dooper,malfurion,1628,hunter,survival,87,45,42
12244,Dju,stormrage,1628,hunter,survival,48,23,25
12245,Voidarrows,area-52,1626,hunter,survival,41,24,17
12246,Warhog,wyrmrest-accord,1626,hunter,survival,61,34,27
12247,Hazzeth,thrall,1625,hunter,survival,30,19,11
12248,Bigbillx,tichondrius,1623,hunter,survival,30,17,13
12249,Viòlenc,tichondrius,1621,hunter,survival,41,24,17
12250,Skyland,tichondrius,1621,hunter,survival,60,32,28
12251,Køjo,emerald-dream,1620,hunter,survival,50,31,19
12252,Shooting,sargeras,1619,hunter,survival,76,44,32
12253,Mxabyycc,tichondrius,1619,hunter,survival,54,30,24
12254,Buffnac,tichondrius,1618,hunter,survival,42,17,25
12255,Cuddlestomp,magtheridon,1614,hunter,survival,46,24,22
12256,Triplethreat,bleeding-hollow,1612,hunter,survival,77,42,35
12257,Mmx,whisperwind,1611,hunter,survival,67,40,27
12258,Nandorius,proudmoore,1606,hunter,survival,60,29,31
12259,Haemøphilus,area-52,1605,hunter,survival,30,18,12
12260,Uhm,laughing-skull,1604,hunter,survival,82,47,35
12261,Tøkÿöghøül,agamaggan,1603,hunter,survival,30,19,11
12262,Schurk,illidan,1602,hunter,survival,120,64,56
12263,Swordshot,moon-guard,1601,hunter,survival,85,41,44
12264,Limpingspoon,kelthuzad,1600,hunter,survival,114,64,50
12265,Imapacifist,barthilas,1600,hunter,survival,69,37,32
12266,Fkurrules,frostmourne,1596,hunter,survival,103,56,47
12267,Mckim,tichondrius,1595,hunter,survival,47,23,24
12268,Yolloswag,tichondrius,1591,hunter,survival,72,40,32
12269,Stylebende,tichondrius,1588,hunter,survival,42,22,20
12270,Titanaxis,tichondrius,1588,hunter,survival,185,95,90
12271,Noxickk,sargeras,1587,hunter,survival,30,19,11
12272,Randël,nemesis,1582,hunter,survival,36,23,13
12273,Soyos,sargeras,1581,hunter,survival,59,30,29
12274,Xtina,drakkari,1577,hunter,survival,71,40,31
12275,Helïos,drakkari,1576,hunter,survival,42,23,19
12276,Bigiesmalls,moon-guard,1572,hunter,survival,54,28,26
12277,Xebbec,sargeras,1571,hunter,survival,80,43,37
12278,Drifting,bleeding-hollow,1569,hunter,survival,60,34,26
12279,Dazarrow,burning-blade,1569,hunter,survival,41,17,24
12280,Interleukin,frostwolf,1568,hunter,survival,173,93,80
12281,Lenacraft,frostmourne,1568,hunter,survival,36,18,18
12282,Arazian,stormrage,1566,hunter,survival,40,22,18
12283,Fabfilter,tichondrius,1564,hunter,survival,40,21,19
12284,Xenonviper,bleeding-hollow,1563,hunter,survival,66,33,33
12285,Vinnieone,kiljaeden,1561,hunter,survival,30,20,10
12286,Mckennagrace,tichondrius,1558,hunter,survival,54,29,25
12287,Ripsurvival,area-52,1554,hunter,survival,40,24,16
12288,Equilibrium,tol-barad,1554,hunter,survival,74,40,34
12289,Berenal,moon-guard,1554,hunter,survival,144,69,75
12290,Lfg,bleeding-hollow,1553,hunter,survival,53,31,22
12291,Huntasaurus,saurfang,1553,hunter,survival,66,32,34
12292,Kimbaa,tichondrius,1552,hunter,survival,48,23,25
12293,Nicochan,senjin,1551,hunter,survival,66,28,38
12294,Viólenc,tichondrius,1548,hunter,survival,36,18,18
12295,Kurnos,hyjal,1547,hunter,survival,24,18,6
12296,Krouno,ragnaros,1543,hunter,survival,36,18,18
12297,Dephobius,azralon,1540,hunter,survival,71,37,34
12298,Mateko,amanthul,1538,hunter,survival,44,21,23
12299,Trapdaddyx,thrall,1534,hunter,survival,24,16,8
12300,Garfieldbb,tichondrius,1531,hunter,survival,36,16,20
12301,Robotwo,illidan,1529,hunter,survival,24,16,8
12302,Viiu,sargeras,1528,hunter,survival,24,16,8
12303,Exh,tichondrius,1527,hunter,survival,107,52,55
12304,Pivott,wyrmrest-accord,1526,hunter,survival,186,96,90
12305,Kukulkan,haomarush,1525,hunter,survival,123,64,59
12306,Sativ,moknathal,1524,hunter,survival,54,27,27
12307,Dorkins,azralon,1521,hunter,survival,75,35,40
12308,Meowtard,kaelthas,1520,hunter,survival,66,31,35
12309,Hildebald,moon-guard,1517,hunter,survival,58,33,25
12310,Brewster,burning-legion,1517,hunter,survival,30,16,14
12311,Ronnïn,proudmoore,1517,hunter,survival,42,21,21
12312,Opsi,ragnaros,1516,hunter,survival,52,23,29
12313,Lyler,tichondrius,1514,hunter,survival,40,23,17
12314,Met,dentarg,1514,hunter,survival,50,24,26
12315,Trap,vashj,1512,hunter,survival,36,21,15
12316,Ceejaee,tichondrius,1511,hunter,survival,66,31,35
12317,Jubulba,frostwolf,1502,hunter,survival,24,16,8
12318,Hrywnn,azralon,1501,hunter,survival,206,114,92
12319,Spromix,ragnaros,1500,hunter,survival,42,23,19
12320,Pfizershot,tichondrius,1496,hunter,survival,54,28,26
12321,Fâmôûs,tichondrius,1495,hunter,survival,36,19,17
12322,Tharoks,tichondrius,1494,hunter,survival,54,27,27
12323,Darkèlfo,azralon,1483,hunter,survival,64,39,25
12324,Rooman,ragnaros,1477,hunter,survival,48,24,24
12325,Evilfury,tichondrius,1475,hunter,survival,148,73,75
12326,Nussyo,tichondrius,1474,hunter,survival,30,17,13
12327,Rúdrá,area-52,1468,hunter,survival,145,76,69
12328,Eliandriss,quelthalas,1468,hunter,survival,70,33,37
12329,Altarare,ragnaros,1467,hunter,survival,279,135,144
12330,Gadorim,kelthuzad,1465,hunter,survival,115,54,61
12331,Dudemanyeah,black-dragonflight,1464,hunter,survival,106,52,54
12332,Weedhoof,barthilas,1463,hunter,survival,60,35,25
12333,Alby,deathwing,1459,hunter,survival,67,33,34
12334,Kaawhii,stormrage,1457,hunter,survival,24,18,6
12335,Kyoü,drakkari,1457,hunter,survival,64,41,23
12336,Tuohnosaj,sargeras,1454,hunter,survival,72,33,39
12337,Dversive,nagrand,1452,hunter,survival,33,18,15
12338,Shadeckz,stormrage,1451,hunter,survival,80,36,44
12339,Volkr,bleeding-hollow,1450,hunter,survival,102,51,51
12340,Sukr,korgath,1450,hunter,survival,45,22,23
12341,Civvo,dalaran,1447,hunter,survival,63,32,31
12342,Legalt,tichondrius,1445,hunter,survival,68,33,35
12343,Shtealo,ragnaros,1443,hunter,survival,60,31,29
12344,Core,gorefiend,1442,hunter,survival,45,21,24
12345,Cndavyjones,akama,1439,hunter,survival,30,15,15
12346,Hunterdemond,ragnaros,1439,hunter,survival,95,47,48
12347,Seanpennis,barthilas,1437,hunter,survival,24,15,9
12348,Krimzus,hyjal,1436,hunter,survival,42,21,21
12349,Jawbreakër,tichondrius,1434,hunter,survival,44,22,22
12350,Jarhar,nesingwary,1432,hunter,survival,96,44,52
12351,Kensho,illidan,1432,hunter,survival,36,15,21
12352,Raiku,aggramar,1427,hunter,survival,36,17,19
12353,Kula,haomarush,1424,hunter,survival,52,24,28
12354,Grandpopjim,illidan,1423,hunter,survival,30,15,15
12355,Pdg,ragnaros,1422,hunter,survival,54,31,23
12356,Grizzlydeath,stormrage,1421,hunter,survival,54,33,21
12357,Shinhyez,tichondrius,1419,hunter,survival,30,15,15
12358,Soulwarden,haomarush,1417,hunter,survival,36,17,19
12359,Huntranger,malganis,1416,hunter,survival,35,17,18
12360,Exxonerous,sargeras,1414,hunter,survival,72,37,35
12361,Mayamia,ragnaros,1413,hunter,survival,54,24,30
12362,Ivansotes,quelthalas,1409,hunter,survival,39,18,21
12363,Gildthorn,frostmourne,1406,hunter,survival,42,22,20
12364,Aniraza,ragnaros,1404,hunter,survival,33,18,15
12365,Audiofly,tichondrius,1400,hunter,survival,62,35,27
12366,Darkarrow,hyjal,1399,hunter,survival,55,30,25
12367,Rayuwa,azralon,1398,hunter,survival,85,42,43
12368,Kenjipoo,tichondrius,1395,hunter,survival,30,15,15
12369,Apokryph,stormrage,1394,hunter,survival,48,35,13
12370,Zakorai,thrall,1392,hunter,survival,66,36,30
12371,Shytshot,dalaran,1391,hunter,survival,55,26,29
12372,Zänich,tichondrius,1387,hunter,survival,36,18,18
12373,Toross,stormscale,1379,hunter,survival,73,29,44
12374,Bolognã,tichondrius,1378,hunter,survival,29,15,14
12375,Rirand,dalaran,1376,hunter,survival,53,26,27
12376,Xfo,bleeding-hollow,1374,hunter,survival,36,23,13
12377,Luckboy,tichondrius,1372,hunter,survival,136,69,67
12378,Killconfirm,sargeras,1369,hunter,survival,59,24,35
12379,Fìebs,queldorei,1368,hunter,survival,53,25,28
12380,Navagee,tichondrius,1364,hunter,survival,47,25,22
12381,Gichiwalrus,emerald-dream,1362,hunter,survival,72,40,32
12382,Fallacies,moon-guard,1360,hunter,survival,120,59,61
12383,Wetpeach,frostmourne,1357,hunter,survival,58,29,29
12384,Gunka,illidan,1349,hunter,survival,35,17,18
12385,Liñcoln,sargeras,1346,hunter,survival,28,15,13
12386,Lamerpvp,tichondrius,1343,hunter,survival,18,14,4
12387,Cocobread,stormreaver,1343,hunter,survival,96,41,55
12388,Htniss,tichondrius,1343,hunter,survival,36,15,21
12389,Ickstab,illidan,1342,hunter,survival,18,14,4
12390,Tumerok,barthilas,1342,hunter,survival,24,14,10
12391,Animityx,illidan,1340,hunter,survival,39,18,21
12392,Champjones,senjin,1339,hunter,survival,24,14,10
12393,Wingclippin,stormrage,1338,hunter,survival,24,16,8
12394,Jollycraze,spirestone,1337,hunter,survival,18,14,4
12395,Zêrø,moon-guard,1336,hunter,survival,18,14,4
12396,Åpe,illidan,1334,hunter,survival,24,14,10
12397,Clinteastwoo,ragnaros,1334,hunter,survival,30,14,16
12398,Thalrae,quelthalas,1334,hunter,survival,48,22,26
12399,Bowzørx,tichondrius,1331,hunter,survival,30,14,16
12400,Hawkethorn,moon-guard,1331,hunter,survival,86,37,49
12401,Pedropete,barthilas,1331,hunter,survival,36,14,22
12402,Extremis,emerald-dream,1329,hunter,survival,42,20,22
12403,Bigsexi,kiljaeden,1329,hunter,survival,62,27,35
12404,Viró,sargeras,1325,hunter,survival,27,15,12
12405,Huntardadoo,nemesis,1325,hunter,survival,29,14,15
12406,Hankjr,thunderlord,1319,hunter,survival,59,37,22
12407,Taiberianrex,khazgoroth,1317,hunter,survival,48,28,20
12408,Buggyhuntz,stormrage,1317,hunter,survival,42,16,26
12409,Zorht,ragnaros,1316,hunter,survival,152,77,75
12410,Nippoc,aerie-peak,1314,hunter,survival,18,14,4
12411,Chiad,kargath,1313,hunter,survival,36,22,14
12412,Ryonel,moon-guard,1313,hunter,survival,167,81,86
12413,Inheart,khazgoroth,1313,hunter,survival,42,16,26
12414,Henesis,sargeras,1312,hunter,survival,42,18,24
12415,Mypeach,frostmourne,1310,hunter,survival,60,30,30
12416,Draban,stormrage,1305,hunter,survival,30,14,16
12417,Bredys,quelthalas,1295,hunter,survival,42,15,27
12418,Vilguz,illidan,1294,hunter,survival,28,14,14
12419,Dreebizz,gorefiend,1294,hunter,survival,62,25,37
12420,Hovahdo,proudmoore,1287,hunter,survival,35,14,21
12421,Rogaldornn,thrall,1280,hunter,survival,47,23,24
12422,Lashga,wyrmrest-accord,1279,hunter,survival,45,17,28
12423,Ajira,stormrage,1277,hunter,survival,30,14,16
12424,Vongard,wyrmrest-accord,1277,hunter,survival,52,24,28
12425,Orgpopeyes,illidan,1275,hunter,survival,37,15,22
12426,Vanthel,ragnaros,1274,hunter,survival,50,22,28
12427,Nanotorque,moon-guard,1273,hunter,survival,84,44,40
12428,Lorethor,kaelthas,1270,hunter,survival,36,15,21
12429,Gxswow,tichondrius,1268,hunter,survival,66,30,36
12430,Vhan,azralon,1266,hunter,survival,81,42,39
12431,Ghuntcassh,quelthalas,1262,hunter,survival,30,18,12
12432,Félíx,ragnaros,1251,hunter,survival,42,16,26
12433,Skriill,tichondrius,1249,hunter,survival,48,21,27
12434,Budika,ragnaros,1247,hunter,survival,18,13,5
12435,Fancyox,frostmourne,1247,hunter,survival,18,13,5
12436,Duckpow,frostmourne,1247,hunter,survival,60,24,36
12437,Hawkem,illidan,1246,hunter,survival,24,13,11
12438,Ariädne,sargeras,1239,hunter,survival,72,27,45
12439,Fangtreason,sargeras,1233,hunter,survival,24,13,11
12440,Ropivacaine,illidan,1232,hunter,survival,30,13,17
12441,Wharble,illidan,1230,hunter,survival,24,13,11
12442,Azx,tichondrius,1230,hunter,survival,30,13,17
12443,Offensive,dragonmaw,1222,hunter,survival,31,14,17
12444,Nucleosome,stormrage,1219,hunter,survival,24,13,11
12445,Rojpube,frostmourne,1215,hunter,survival,29,13,16
12446,Daymanaahh,malfurion,1209,hunter,survival,42,19,23
12447,Cufless,proudmoore,1204,hunter,survival,36,13,23
12448,Arkeryn,azralon,1203,hunter,survival,18,13,5
12449,Firesail,kelthuzad,1199,hunter,survival,73,33,40
12450,Rykbad,area-52,1195,hunter,survival,24,13,11
12451,Tinsho,drakkari,1191,hunter,survival,36,17,19
12452,Wartoz,dragonblight,1190,hunter,survival,59,40,19
12453,Rairin,tichondrius,1190,hunter,survival,47,20,27
12454,Bangerzx,stormrage,1185,hunter,survival,24,13,11
12455,Awârz,drakkari,1178,hunter,survival,20,13,7
12456,Nigthunt,quelthalas,1176,hunter,survival,27,13,14
12457,Gruì,malganis,1168,hunter,survival,26,13,13
12458,Kukulkán,muradin,1164,hunter,survival,28,13,15
12459,Banai,the-underbog,1164,hunter,survival,49,17,32
12460,Trapordie,stormrage,1162,hunter,survival,30,13,17
12461,Gigabigly,wyrmrest-accord,1152,hunter,survival,18,12,6
12462,Drunknachos,bleeding-hollow,1150,hunter,survival,24,12,12
12463,Broskina,stormrage,1150,hunter,survival,24,12,12
12464,Laralodge,stormrage,1150,hunter,survival,78,32,46
12465,Barnbougle,sargeras,1149,hunter,survival,18,12,6
12466,Crimsoncoast,tichondrius,1149,hunter,survival,18,12,6
12467,Giraffetrap,zuljin,1147,hunter,survival,18,12,6
12468,Freebeë,area-52,1147,hunter,survival,24,12,12
12469,Rhyzen,drenden,1146,hunter,survival,18,12,6
12470,Kekkww,hyjal,1146,hunter,survival,24,12,12
12471,Fälke,stormrage,1146,hunter,survival,24,12,12
12472,Arcos,emerald-dream,1138,hunter,survival,18,12,6
12473,Xitara,stormrage,1137,hunter,survival,24,12,12
12474,Chopsley,feathermoon,1136,hunter,survival,71,30,41
12475,Eastera,tichondrius,1119,hunter,survival,68,30,38
12476,Rayhuntard,tichondrius,1115,hunter,survival,23,12,11
12477,Expskippy,darkspear,1110,hunter,survival,44,27,17
12478,Allahakbar,ragnaros,1110,hunter,survival,30,12,18
12479,Eithelleta,frostmourne,1106,hunter,survival,42,15,27
12480,Kimchishotxo,tichondrius,1103,hunter,survival,23,12,11
12481,Chicall,kalecgos,1096,hunter,survival,31,13,18
12482,Vansatih,azralon,1080,hunter,survival,82,45,37
12483,Lesseneth,aegwynn,1072,hunter,survival,48,20,28
12484,Scythedom,tichondrius,1056,hunter,survival,18,11,7
12485,Yiyixx,tichondrius,1056,hunter,survival,18,11,7
12486,Toxarch,aggramar,1055,hunter,survival,18,11,7
12487,Plsbepatient,wyrmrest-accord,1054,hunter,survival,18,11,7
12488,Shakeasaurus,sargeras,1054,hunter,survival,24,11,13
12489,Reignwolf,nemesis,1053,hunter,survival,18,11,7
12490,Jaw,hakkar,1053,hunter,survival,18,11,7
12491,Thoriden,amanthul,1051,hunter,survival,54,14,40
12492,Aheefeog,proudmoore,1050,hunter,survival,21,12,9
12493,Zhafiro,drakkari,1037,hunter,survival,24,14,10
12494,Panm,runetotem,1034,hunter,survival,27,12,15
12495,Akigga,arthas,1033,hunter,survival,18,11,7
12496,Kaïmsael,kelthuzad,1016,hunter,survival,71,40,31
12497,Gairkill,area-52,999,hunter,survival,95,50,45
12498,Lucarcher,stormrage,988,hunter,survival,17,11,6
12499,Thrandrial,smolderthorn,985,hunter,survival,20,11,9
12500,Hellrayserr,azralon,970,hunter,survival,24,11,13
12501,Virindi,barthilas,960,hunter,survival,12,10,2
12502,Sbgrv,dalaran,960,hunter,survival,18,10,8
12503,Chiline,frostmourne,960,hunter,survival,18,10,8
12504,Corpo,area-52,960,hunter,survival,24,10,14
12505,Covlolzz,illidan,960,hunter,survival,24,10,14
12506,Emart,bloodhoof,960,hunter,survival,24,10,14
12507,Zipzyo,tichondrius,960,hunter,survival,24,10,14
12508,Snipin,ragnaros,960,hunter,survival,30,10,20
12509,Kêdokî,sargeras,959,hunter,survival,12,10,2
12510,Piñg,tichondrius,959,hunter,survival,18,10,8
12511,Tyleraq,area-52,959,hunter,survival,18,10,8
12512,Zizilio,kelthuzad,959,hunter,survival,18,10,8
12513,Anêmos,ragnaros,959,hunter,survival,18,10,8
12514,Egurl,firetree,959,hunter,survival,18,10,8
12515,Ifoxs,bleeding-hollow,959,hunter,survival,18,10,8
12516,Stepzback,malganis,959,hunter,survival,18,10,8
12517,Rickybobby,warsong,959,hunter,survival,18,10,8
12518,Plainrain,tichondrius,959,hunter,survival,18,10,8
12519,Venoc,bleeding-hollow,959,hunter,survival,24,10,14
12520,Downer,antonidas,958,hunter,survival,24,10,14
12521,Kimchimaster,tichondrius,958,hunter,survival,26,10,16
12522,Fanikita,azralon,957,hunter,survival,15,11,4
12523,Wouow,tichondrius,957,hunter,survival,18,10,8
12524,Huntingjutsu,kelthuzad,957,hunter,survival,18,10,8
12525,Tempistworg,greymane,957,hunter,survival,52,25,27
12526,Snoopinator,malganis,957,hunter,survival,24,10,14
12527,Daréz,blackrock,956,hunter,survival,16,11,5
12528,Figurinet,sargeras,955,hunter,survival,18,10,8
12529,Syvarris,medivh,943,hunter,survival,17,10,7
12530,Demtings,dark-iron,925,hunter,survival,32,11,21
12531,Ogamì,aegwynn,923,hunter,survival,16,10,6
12532,Lavo,borean-tundra,923,hunter,survival,25,10,15
12533,Survïvalïst,bleeding-hollow,911,hunter,survival,17,10,7
12534,Cybella,darkspear,910,hunter,survival,23,10,13
12535,Narakara,stormreaver,896,hunter,survival,17,10,7
12536,Crapshot,daggerspine,885,hunter,survival,33,10,23
12537,Jaywaz,tichondrius,864,hunter,survival,12,9,3
12538,Weedzy,tichondrius,864,hunter,survival,12,9,3
12539,Hunterguyy,tichondrius,864,hunter,survival,12,9,3
12540,Tigglyjits,tichondrius,864,hunter,survival,12,9,3
12541,Puffcopeak,illidan,864,hunter,survival,12,9,3
12542,Adobo,garona,864,hunter,survival,12,9,3
12543,Desari,thunderhorn,864,hunter,survival,18,9,9
12544,Arcobaleno,tichondrius,864,hunter,survival,18,9,9
12545,Frêäkk,ragnaros,864,hunter,survival,21,10,11
12546,Scottmeyers,proudmoore,864,hunter,survival,24,9,15
12547,Sharkzooka,illidan,864,hunter,survival,24,9,15
12548,Serpantsting,moon-guard,863,hunter,survival,18,9,9
12549,Sarvaxagar,tichondrius,863,hunter,survival,18,9,9
12550,Ganderion,sargeras,863,hunter,survival,21,10,11
12551,Landscape,kiljaeden,863,hunter,survival,24,9,15
12552,Lovoo,sargeras,862,hunter,survival,12,9,3
12553,Vulkru,azralon,862,hunter,survival,18,9,9
12554,Vietnrg,doomhammer,862,hunter,survival,18,9,9
12555,Packlead,sargeras,861,hunter,survival,18,9,9
12556,Tejodite,thrall,860,hunter,survival,24,9,15
12557,Éygon,sargeras,860,hunter,survival,24,9,15
12558,Zotahunterx,ragnaros,859,hunter,survival,24,9,15
12559,Mabaku,tichondrius,858,hunter,survival,12,9,3
12560,Nowê,azralon,857,hunter,survival,24,9,15
12561,Obsididan,aerie-peak,855,hunter,survival,24,9,15
12562,Prettysure,nesingwary,851,hunter,survival,25,12,13
12563,Lisbboax,stormrage,844,hunter,survival,27,11,16
12564,Shukucingjr,illidan,842,hunter,survival,18,9,9
12565,Blaymorrd,senjin,839,hunter,survival,18,9,9
12566,Jaykwan,boulderfist,829,hunter,survival,17,9,8
12567,Elccid,tichondrius,768,hunter,survival,12,8,4
12568,Toozz,frostmourne,768,hunter,survival,12,8,4
12569,Árröw,arygos,768,hunter,survival,12,8,4
12570,Iizerd,illidan,768,hunter,survival,12,8,4
12571,Envoltorio,ragnaros,768,hunter,survival,12,8,4
12572,Yøske,tichondrius,768,hunter,survival,12,8,4
12573,Eain,wyrmrest-accord,768,hunter,survival,12,8,4
12574,Anooß,tichondrius,768,hunter,survival,15,9,6
12575,Fineye,illidan,768,hunter,survival,14,8,6
12576,Diddycombe,stormrage,768,hunter,survival,18,8,10
12577,Kimssis,tichondrius,768,hunter,survival,18,8,10
12578,Madival,ragnaros,768,hunter,survival,18,8,10
12579,Buttercocoa,kelthuzad,768,hunter,survival,18,8,10
12580,Maxlol,stormrage,768,hunter,survival,18,8,10
12581,Eref,sargeras,768,hunter,survival,24,8,16
12582,Bicflop,azralon,767,hunter,survival,12,8,4
12583,Korasaya,area-52,767,hunter,survival,18,8,10
12584,Trixster,lethon,767,hunter,survival,18,8,10
12585,Dogwoöd,emerald-dream,767,hunter,survival,18,8,10
12586,Rummaker,mugthol,767,hunter,survival,18,8,10
12587,Wakkå,mugthol,767,hunter,survival,21,9,12
12588,Mmchode,zuljin,767,hunter,survival,24,8,16
12589,Chokemescara,stormrage,767,hunter,survival,30,8,22
12590,Greyh,madoran,766,hunter,survival,12,8,4
12591,Ariran,illidan,766,hunter,survival,18,8,10
12592,Segulah,dalaran,766,hunter,survival,18,8,10
12593,Hunfor,anubarak,766,hunter,survival,18,8,10
12594,Lohse,emerald-dream,765,hunter,survival,18,8,10
12595,Loochlin,sargeras,765,hunter,survival,21,8,13
12596,Wìllòw,khazgoroth,765,hunter,survival,24,8,16
12597,Sterge,maiev,764,hunter,survival,18,8,10
12598,Haumer,wyrmrest-accord,763,hunter,survival,12,8,4
12599,Riivali,quelthalas,763,hunter,survival,24,8,16
12600,Emiri,dalaran,763,hunter,survival,24,8,16
12601,Querosushi,ragnaros,760,hunter,survival,18,8,10
12602,Rensv,frostmourne,759,hunter,survival,18,8,10
12603,Iraxium,illidan,735,hunter,survival,14,9,5
12604,Khaoskills,thunderlord,732,hunter,survival,25,11,14
12605,Dirtypolee,bleeding-hollow,719,hunter,survival,17,8,9
12606,Thrakgor,wyrmrest-accord,713,hunter,survival,23,10,13
12607,Kalgorn,emerald-dream,697,hunter,survival,16,8,8
12608,Superiorkill,arathor,686,hunter,survival,13,8,5
12609,Mattyhuntz,tichondrius,672,hunter,survival,12,7,5
12610,Seratoninx,malganis,672,hunter,survival,12,7,5
12611,Fannypacks,dragonmaw,672,hunter,survival,12,7,5
12612,Jamesön,sargeras,672,hunter,survival,12,7,5
12613,Vânillaice,stormrage,672,hunter,survival,12,7,5
12614,Onécare,bleeding-hollow,672,hunter,survival,12,7,5
12615,Ozzsimp,stormrage,672,hunter,survival,12,7,5
12616,Endxworld,tichondrius,672,hunter,survival,12,7,5
12617,Magvez,tichondrius,672,hunter,survival,12,7,5
12618,Pfheign,area-52,672,hunter,survival,12,7,5
12619,Glediator,tichondrius,672,hunter,survival,12,7,5
12620,Huntbay,destromath,672,hunter,survival,12,7,5
12621,Joree,medivh,672,hunter,survival,12,7,5
12622,Twodoobies,ghostlands,672,hunter,survival,12,7,5
12623,Trenbolone,frostmourne,672,hunter,survival,12,7,5
12624,Zouzu,area-52,672,hunter,survival,12,7,5
12625,Lovevv,frostmourne,672,hunter,survival,12,7,5
12626,Negligent,sargeras,672,hunter,survival,12,7,5
12627,Bowowner,aggramar,672,hunter,survival,12,7,5
12628,Oronir,frostmourne,672,hunter,survival,12,7,5
12629,Arraza,ragnaros,672,hunter,survival,12,7,5
12630,Bombbot,zuljin,672,hunter,survival,18,7,11
12631,Meowimadog,spinebreaker,672,hunter,survival,18,7,11
12632,Porrainga,auchindoun,672,hunter,survival,18,7,11
12633,Trumpmerica,illidan,672,hunter,survival,18,7,11
12634,Pablita,drakkari,671,hunter,survival,12,7,5
12635,Sarqis,lightbringer,671,hunter,survival,12,7,5
12636,Ziaxel,bleeding-hollow,671,hunter,survival,12,7,5
12637,Genocell,thunderlord,671,hunter,survival,12,7,5
12638,Gaezangsu,tichondrius,671,hunter,survival,24,7,17
12639,Turquesaa,wyrmrest-accord,670,hunter,survival,12,7,5
12640,Catboikilla,altar-of-storms,639,hunter,survival,17,7,10
12641,Cagooggo,moon-guard,638,hunter,survival,16,7,9
12642,Rotthem,ragnaros,638,hunter,survival,20,8,12
12643,Trappin,malganis,623,hunter,survival,11,7,4
12644,Éshen,illidan,623,hunter,survival,11,7,4
12645,Lartrius,bleeding-hollow,621,hunter,survival,15,8,7
12646,Arrebol,tichondrius,608,hunter,survival,16,7,9
12647,Primez,sargeras,607,hunter,survival,11,7,4
12648,Crissy,crushridge,606,hunter,survival,14,7,7
12649,Odynshowl,stormrage,605,hunter,survival,11,7,4
12650,Drees,nerzhul,576,hunter,survival,6,6,0
12651,Garkia,hyjal,576,hunter,survival,6,6,0
12652,Ðevil,ragnaros,576,hunter,survival,6,6,0
12653,Ÿöskë,tichondrius,576,hunter,survival,6,6,0
12654,Ivanjackenov,illidan,576,hunter,survival,10,7,3
12655,Turkshot,area-52,576,hunter,survival,12,6,6
12656,Wezkerh,ragnaros,576,hunter,survival,12,6,6
12657,Traponomics,stormrage,576,hunter,survival,12,6,6
12658,Kelx,azralon,576,hunter,survival,12,6,6
12659,Tazsic,mannoroth,576,hunter,survival,12,6,6
12660,Carnosynn,sargeras,576,hunter,survival,12,6,6
12661,Woeisyou,stormrage,576,hunter,survival,12,6,6
12662,Mctrapturds,tichondrius,576,hunter,survival,12,6,6
12663,Imbrokenlol,kiljaeden,576,hunter,survival,12,6,6
12664,Jésús,dalaran,576,hunter,survival,12,6,6
12665,Yoske,tichondrius,576,hunter,survival,12,6,6
12666,Walterwhite,trollbane,576,hunter,survival,12,6,6
12667,Drupert,tichondrius,576,hunter,survival,12,6,6
12668,Mythfive,stormrage,576,hunter,survival,12,6,6
12669,Amhavgun,tichondrius,576,hunter,survival,12,6,6
12670,Zerark,kelthuzad,576,hunter,survival,13,6,7
12671,Lahinch,darkspear,576,hunter,survival,21,7,14
12672,Pilesofpoop,sargeras,576,hunter,survival,18,6,12
12673,Bôwbafett,sargeras,575,hunter,survival,12,6,6
12674,Xeiana,proudmoore,575,hunter,survival,12,6,6
12675,Zepplin,medivh,575,hunter,survival,12,6,6
12676,Týrak,illidan,575,hunter,survival,12,6,6
12677,Jathriel,zuljin,575,hunter,survival,12,6,6
12678,Vortann,proudmoore,575,hunter,survival,18,6,12
12679,Bushytails,illidan,573,hunter,survival,18,6,12
12680,Tyrokk,barthilas,543,hunter,survival,18,6,12
12681,Dräkö,tichondrius,527,hunter,survival,15,7,8
12682,Hediilyan,azralon,522,hunter,survival,16,7,9
12683,Pxry,drenden,511,hunter,survival,11,6,5
12684,Tmzsteezy,tichondrius,480,hunter,survival,6,5,1
12685,Fiftyyddash,tichondrius,480,hunter,survival,6,5,1
12686,Ewife,illidan,480,hunter,survival,6,5,1
12687,Selenis,khadgar,480,hunter,survival,6,5,1
12688,Gufanyaun,tichondrius,480,hunter,survival,6,5,1
12689,Lawyerpbj,tichondrius,480,hunter,survival,6,5,1
12690,Joeexotíc,moknathal,480,hunter,survival,6,5,1
12691,Kanta,bleeding-hollow,480,hunter,survival,6,5,1
12692,Jäger,zuljin,480,hunter,survival,6,5,1
12693,Keenai,moon-guard,480,hunter,survival,6,5,1
12694,Jonah,sargeras,480,hunter,survival,6,5,1
12695,Grimbrew,garona,480,hunter,survival,6,5,1
12696,Honorola,twisting-nether,480,hunter,survival,6,5,1
12697,Poorapple,tichondrius,480,hunter,survival,6,5,1
12698,Narukín,tichondrius,480,hunter,survival,6,5,1
12699,Casadega,sargeras,480,hunter,survival,10,6,4
12700,Jumpkick,azralon,480,hunter,survival,12,5,7
12701,Elmoon,zuljin,480,hunter,survival,12,5,7
12702,Downrange,stonemaul,480,hunter,survival,12,5,7
12703,Goromi,tichondrius,480,hunter,survival,12,5,7
12704,Luckione,destromath,480,hunter,survival,12,5,7
12705,Alansho,tichondrius,480,hunter,survival,12,5,7
12706,Minxed,sargeras,480,hunter,survival,12,5,7
12707,Brissy,sargeras,480,hunter,survival,12,5,7
12708,Bastÿ,area-52,480,hunter,survival,12,5,7
12709,Mambothehunt,stormrage,480,hunter,survival,12,5,7
12710,Mìtáng,moon-guard,480,hunter,survival,12,5,7
12711,Firskin,frostmourne,480,hunter,survival,12,5,7
12712,Droj,stormrage,480,hunter,survival,12,5,7
12713,Shootnoscore,vashj,480,hunter,survival,15,6,9
12714,Ashtron,trollbane,480,hunter,survival,18,5,13
12715,Sealteamrick,frostmourne,479,hunter,survival,12,5,7
12716,Belvhar,skullcrusher,479,hunter,survival,12,5,7
12717,Villainshunt,stormrage,479,hunter,survival,12,5,7
12718,Pastelitoz,tichondrius,479,hunter,survival,21,6,15
12719,Calvarîam,korgath,479,hunter,survival,18,5,13
12720,Javlinz,thrall,478,hunter,survival,10,6,4
12721,Sitalces,ragnaros,474,hunter,survival,12,5,7
12722,Crumpit,moon-guard,426,hunter,survival,22,6,16
12723,Cinnybunz,malganis,415,hunter,survival,16,6,10
12724,Rinehart,dalaran,415,hunter,survival,14,5,9
12725,Cptx,kelthuzad,384,hunter,survival,6,4,2
12726,Ehhee,twisting-nether,384,hunter,survival,6,4,2
12727,Bigpets,azralon,384,hunter,survival,6,4,2
12728,Pulso,illidan,384,hunter,survival,6,4,2
12729,Junglefever,skywall,384,hunter,survival,6,4,2
12730,Trapful,illidan,384,hunter,survival,6,4,2
12731,Nastoid,area-52,384,hunter,survival,6,4,2
12732,Ikitefordmt,zuljin,384,hunter,survival,6,4,2
12733,Ethxx,emerald-dream,384,hunter,survival,6,4,2
12734,Bendoon,sargeras,384,hunter,survival,6,4,2
12735,Chasseür,quelthalas,384,hunter,survival,6,4,2
12736,Petstun,moon-guard,384,hunter,survival,6,4,2
12737,Litchi,illidan,384,hunter,survival,6,4,2
12738,Swagprince,skullcrusher,384,hunter,survival,6,4,2
12739,Spitballa,emerald-dream,384,hunter,survival,6,4,2
12740,Virgim,kelthuzad,384,hunter,survival,6,4,2
12741,Mokuraak,emerald-dream,384,hunter,survival,6,4,2
12742,Pumpkinovo,tichondrius,384,hunter,survival,6,4,2
12743,Ðfac,moon-guard,384,hunter,survival,6,4,2
12744,Equalizér,sargeras,384,hunter,survival,6,4,2
12745,Prêd,malganis,384,hunter,survival,6,4,2
12746,Rankonee,area-52,384,hunter,survival,6,4,2
12747,Huntardxo,moon-guard,384,hunter,survival,6,4,2
12748,Pokeahuntasz,frostmourne,384,hunter,survival,6,4,2
12749,Alfaan,moon-guard,384,hunter,survival,6,4,2
12750,Riram,stormrage,384,hunter,survival,6,4,2
12751,Hunterlolxd,altar-of-storms,384,hunter,survival,6,4,2
12752,Pouncedgg,sargeras,384,hunter,survival,6,4,2
12753,Malkuri,medivh,384,hunter,survival,6,4,2
12754,Mameikilled,saurfang,384,hunter,survival,6,4,2
12755,Ratherbully,tichondrius,384,hunter,survival,6,4,2
12756,Thefanbus,tichondrius,384,hunter,survival,6,4,2
12757,Volbz,barthilas,384,hunter,survival,6,4,2
12758,Æßç,ragnaros,384,hunter,survival,6,4,2
12759,Wapnonymous,mugthol,384,hunter,survival,6,4,2
12760,Boomseed,nagrand,384,hunter,survival,6,4,2
12761,Arrowmatic,frostmourne,384,hunter,survival,6,4,2
12762,Thalyxion,moon-guard,384,hunter,survival,6,4,2
12763,Hyena,kelthuzad,384,hunter,survival,9,5,4
12764,Gunicks,illidan,384,hunter,survival,12,4,8
12765,Braindeadorc,illidan,384,hunter,survival,12,4,8
12766,Leftty,illidan,384,hunter,survival,12,4,8
12767,Camfeed,illidan,384,hunter,survival,12,4,8
12768,Àngèl,malganis,384,hunter,survival,12,4,8
12769,Malikyr,moon-guard,384,hunter,survival,12,4,8
12770,Golorn,malganis,384,hunter,survival,12,4,8
12771,Michaeljfox,area-52,384,hunter,survival,12,4,8
12772,Fâpple,stormrage,384,hunter,survival,12,4,8
12773,Stupidgodx,tichondrius,384,hunter,survival,12,4,8
12774,Aaggros,sargeras,384,hunter,survival,12,4,8
12775,Keenz,frostmourne,384,hunter,survival,12,4,8
12776,Goonlmao,hyjal,384,hunter,survival,12,4,8
12777,Oatmeallover,stormrage,384,hunter,survival,12,4,8
12778,Eforas,ragnaros,384,hunter,survival,12,4,8
12779,Bambii,fizzcrank,384,hunter,survival,12,4,8
12780,Wolfsok,norgannon,384,hunter,survival,12,4,8
12781,Blizhunt,thunderlord,384,hunter,survival,12,4,8
12782,Lasagnadaddy,maiev,384,hunter,survival,12,4,8
12783,Wkx,tichondrius,384,hunter,survival,12,4,8
12784,Cakeislife,kelthuzad,384,hunter,survival,18,4,14
12785,Onehitrip,illidan,383,hunter,survival,6,4,2
12786,Berzxd,stormrage,383,hunter,survival,6,4,2
12787,Tydee,nagrand,383,hunter,survival,18,4,14
12788,Rukkora,deathwing,382,hunter,survival,12,4,8
12789,Platonium,stormrage,351,hunter,survival,8,5,3
12790,Gaahl,aggramar,351,hunter,survival,8,5,3
12791,Acidhunt,tichondrius,320,hunter,survival,16,4,12
12792,Adamariss,stormrage,319,hunter,survival,16,4,12
12793,Zà,sargeras,288,hunter,survival,6,3,3
12794,Loogan,sargeras,288,hunter,survival,6,3,3
12795,Petkd,frostmourne,288,hunter,survival,6,3,3
12796,Hazzersk,ragnaros,288,hunter,survival,6,3,3
12797,Seiber,quelthalas,288,hunter,survival,6,3,3
12798,Mistrj,frostmourne,288,hunter,survival,6,3,3
12799,Soul,sargeras,288,hunter,survival,6,3,3
12800,Pridefulzjr,stormrage,288,hunter,survival,6,3,3
12801,Sniperælite,korgath,288,hunter,survival,6,3,3
12802,Twom,area-52,288,hunter,survival,6,3,3
12803,Furipoon,stormrage,288,hunter,survival,6,3,3
12804,Samsin,sargeras,288,hunter,survival,6,3,3
12805,Whitemàne,dalaran,288,hunter,survival,6,3,3
12806,Pistolon,quelthalas,288,hunter,survival,6,3,3
12807,Cantantie,tichondrius,288,hunter,survival,6,3,3
12808,Troglav,drakkari,288,hunter,survival,6,3,3
12809,Badseedz,kargath,288,hunter,survival,6,3,3
12810,Lemmetrap,illidan,288,hunter,survival,6,3,3
12811,Ünitedi,nemesis,288,hunter,survival,6,3,3
12812,Cuervostreet,ragnaros,288,hunter,survival,6,3,3
12813,Slowdamage,ragnaros,288,hunter,survival,6,3,3
12814,Rustyspork,muradin,288,hunter,survival,6,3,3
12815,Moistbooger,emerald-dream,288,hunter,survival,6,3,3
12816,Gorgrokk,area-52,288,hunter,survival,6,3,3
12817,Goodtimez,sargeras,288,hunter,survival,6,3,3
12818,Slowhunterr,tichondrius,288,hunter,survival,6,3,3
12819,Makeastinky,malfurion,288,hunter,survival,6,3,3
12820,Dirtymongrel,barthilas,288,hunter,survival,6,3,3
12821,Arigon,frostmane,288,hunter,survival,6,3,3
12822,Shootdogg,mannoroth,288,hunter,survival,6,3,3
12823,Calidian,moon-guard,288,hunter,survival,6,3,3
12824,Lowlore,moon-guard,288,hunter,survival,6,3,3
12825,Trapmasterx,tichondrius,288,hunter,survival,6,3,3
12826,Slimshadie,kiljaeden,288,hunter,survival,6,3,3
12827,Wooftoof,frostmourne,288,hunter,survival,6,3,3
12828,Thesniperx,sargeras,288,hunter,survival,6,3,3
12829,Trapirl,tichondrius,288,hunter,survival,6,3,3
12830,Fearna,destromath,288,hunter,survival,6,3,3
12831,Spårrow,alleria,288,hunter,survival,6,3,3
12832,Soukken,ragnaros,288,hunter,survival,6,3,3
12833,Rûff,azralon,288,hunter,survival,6,3,3
12834,Glockin,zuljin,288,hunter,survival,6,3,3
12835,Hackerman,tichondrius,288,hunter,survival,6,3,3
12836,Embaçado,bleeding-hollow,288,hunter,survival,6,3,3
12837,Runecbow,eonar,288,hunter,survival,12,3,9
12838,Daxar,ragnaros,288,hunter,survival,12,3,9
12839,Kalibah,azralon,288,hunter,survival,12,3,9
12840,Aiyanafox,moon-guard,288,hunter,survival,12,3,9
12841,Gutshott,tichondrius,288,hunter,survival,12,3,9
12842,Wildhùnt,tichondrius,288,hunter,survival,12,3,9
12843,Lixniqua,tichondrius,288,hunter,survival,12,3,9
12844,Kowabungy,tichondrius,288,hunter,survival,12,3,9
12845,Kharñe,tichondrius,288,hunter,survival,12,3,9
12846,Iol,blades-edge,288,hunter,survival,12,3,9
12847,Vizkha,azralon,287,hunter,survival,6,3,3
12848,Waylòn,moon-guard,287,hunter,survival,12,3,9
12849,Drunkbunny,tichondrius,271,hunter,survival,11,3,8
12850,Mokaonly,wildhammer,256,hunter,survival,8,4,4
12851,Crèpes,bleeding-hollow,239,hunter,survival,5,3,2
12852,Yogurtti,zuljin,239,hunter,survival,5,3,2
12853,Violénc,tichondrius,234,hunter,survival,16,4,12
12854,Raeshots,area-52,233,hunter,survival,15,5,10
12855,Moscato,cenarion-circle,232,hunter,survival,14,4,10
12856,Cumman,sargeras,208,hunter,survival,7,3,4
12857,Rifomen,illidan,192,hunter,survival,9,3,6
12858,Woobinman,tichondrius,192,hunter,survival,6,2,4
12859,Dobuu,tichondrius,192,hunter,survival,6,2,4
12860,Yukisong,bleeding-hollow,192,hunter,survival,6,2,4
12861,Achilles,twisting-nether,192,hunter,survival,6,2,4
12862,Gobygobbs,magtheridon,192,hunter,survival,6,2,4
12863,Razzldazzlbb,thrall,192,hunter,survival,6,2,4
12864,Légölás,tichondrius,192,hunter,survival,6,2,4
12865,Sharpster,zuljin,192,hunter,survival,6,2,4
12866,Toruhagakure,tichondrius,192,hunter,survival,6,2,4
12867,Côckblocked,tichondrius,192,hunter,survival,6,2,4
12868,Gunudown,haomarush,192,hunter,survival,6,2,4
12869,Xoxono,frostmourne,192,hunter,survival,6,2,4
12870,Imraghorn,sargeras,192,hunter,survival,6,2,4
12871,Gomrog,gurubashi,192,hunter,survival,6,2,4
12872,Kravern,ragnaros,192,hunter,survival,6,2,4
12873,Harposmash,trollbane,192,hunter,survival,6,2,4
12874,Clampula,sargeras,192,hunter,survival,6,2,4
12875,Pint,madoran,192,hunter,survival,6,2,4
12876,Cosmodome,daggerspine,192,hunter,survival,6,2,4
12877,Dfnhdft,stormrage,192,hunter,survival,6,2,4
12878,Bboo,bonechewer,192,hunter,survival,6,2,4
12879,Araghrn,draktharon,192,hunter,survival,6,2,4
12880,Ishotmydog,malganis,192,hunter,survival,6,2,4
12881,Gaim,dalaran,192,hunter,survival,6,2,4
12882,Traptations,sargeras,192,hunter,survival,6,2,4
12883,Oattes,daggerspine,192,hunter,survival,6,2,4
12884,Ryohlin,sargeras,192,hunter,survival,6,2,4
12885,Sunchea,arygos,192,hunter,survival,6,2,4
12886,Nelandris,tichondrius,192,hunter,survival,6,2,4
12887,Zellor,wyrmrest-accord,192,hunter,survival,6,2,4
12888,Thazen,sargeras,192,hunter,survival,6,2,4
12889,Blackjesu,blackrock,192,hunter,survival,6,2,4
12890,Nahzah,stormrage,192,hunter,survival,6,2,4
12891,Saelym,arthas,192,hunter,survival,6,2,4
12892,Slipox,sargeras,192,hunter,survival,6,2,4
12893,Sebastian,blackhand,192,hunter,survival,6,2,4
12894,Viio,sargeras,192,hunter,survival,6,2,4
12895,Splewsh,area-52,192,hunter,survival,6,2,4
12896,Zèd,azralon,192,hunter,survival,6,2,4
12897,Eclipsie,aerie-peak,192,hunter,survival,6,2,4
12898,Pedropete,frostmourne,192,hunter,survival,6,2,4
12899,Rainzs,stormrage,192,hunter,survival,6,2,4
12900,Zackèse,area-52,192,hunter,survival,6,2,4
12901,Pooshot,kelthuzad,192,hunter,survival,6,2,4
12902,Cio,fizzcrank,192,hunter,survival,6,2,4
12903,Lenyuecf,proudmoore,192,hunter,survival,6,2,4
12904,Comebacks,ragnaros,192,hunter,survival,6,2,4
12905,Spizsnipes,malganis,192,hunter,survival,6,2,4
12906,Gswag,malganis,192,hunter,survival,6,2,4
12907,Qua,perenolde,192,hunter,survival,6,2,4
12908,Rimbar,ysera,192,hunter,survival,6,2,4
12909,Shaftgravy,area-52,192,hunter,survival,6,2,4
12910,Trígger,azshara,192,hunter,survival,6,2,4
12911,Shïndow,ragnaros,192,hunter,survival,6,2,4
12912,Eekbarbadrkl,frostmourne,192,hunter,survival,6,2,4
12913,Mirdous,moon-guard,192,hunter,survival,6,2,4
12914,Raythør,area-52,192,hunter,survival,12,2,10
12915,Zhona,moon-guard,192,hunter,survival,12,2,10
12916,Linova,stormrage,192,hunter,survival,12,2,10
12917,Skrìms,tichondrius,192,hunter,survival,12,2,10
12918,Kaldrool,frostmourne,192,hunter,survival,12,2,10
12919,Lawafla,area-52,138,hunter,survival,8,3,5
12920,Xradû,dawnbringer,138,hunter,survival,9,3,6
12921,Morganson,moon-guard,138,hunter,survival,22,4,18
12922,Bránn,quelthalas,128,hunter,survival,4,2,2
12923,Fenrock,cenarius,96,hunter,survival,3,2,1
12924,Whitecake,area-52,96,hunter,survival,3,2,1
12925,Critz,undermine,96,hunter,survival,6,1,5
12926,Taofang,emerald-dream,96,hunter,survival,6,1,5
12927,Fearlesarrow,suramar,96,hunter,survival,6,1,5
12928,Kölhberg,azralon,96,hunter,survival,6,1,5
12929,Esser,mannoroth,96,hunter,survival,6,1,5
12930,Feignqt,illidan,96,hunter,survival,6,1,5
12931,Floorislava,durotan,96,hunter,survival,6,1,5
12932,Legosshi,darrowmere,96,hunter,survival,6,1,5
12933,Feorbxl,proudmoore,96,hunter,survival,6,1,5
12934,Killerxzxz,stormrage,96,hunter,survival,6,1,5
12935,Nevertraps,tichondrius,96,hunter,survival,6,1,5
12936,Shottz,aerie-peak,96,hunter,survival,6,1,5
12937,Survbot,malganis,96,hunter,survival,6,1,5
12938,Jîlt,aerie-peak,96,hunter,survival,6,1,5
12939,Sobala,azralon,96,hunter,survival,6,1,5
12940,Dusle,azralon,96,hunter,survival,6,1,5
12941,Tezlekhan,haomarush,96,hunter,survival,6,1,5
12942,Terrabytés,kelthuzad,96,hunter,survival,6,1,5
12943,Bloodarrow,tichondrius,96,hunter,survival,6,1,5
12944,Weegnomie,wyrmrest-accord,96,hunter,survival,6,1,5
12945,Skybourne,nemesis,96,hunter,survival,6,1,5
12946,Lammy,bleeding-hollow,96,hunter,survival,6,1,5
12947,Elroyjetson,arthas,96,hunter,survival,6,1,5
12948,Lance,darrowmere,96,hunter,survival,6,1,5
12949,Montakka,illidan,79,hunter,survival,5,1,4
12950,Luangg,tichondrius,31,hunter,survival,2,1,1
12951,Therealpafo,tichondrius,31,hunter,survival,8,1,7
12952,Saiiph,bleeding-hollow,2274,hunter,beastmastery,136,76,60
12953,Sphericsnow,shuhalo,2210,hunter,beastmastery,95,51,44
12954,Missedmytrap,agamaggan,2149,hunter,beastmastery,80,46,34
12955,Zujo,emerald-dream,2134,hunter,beastmastery,173,89,84
12956,Traptations,sargeras,2132,hunter,beastmastery,72,39,33
12957,Ucl,tichondrius,2125,hunter,beastmastery,90,45,45
12958,Eref,sargeras,2116,hunter,beastmastery,78,42,36
12959,Wmsgs,tichondrius,2116,hunter,beastmastery,129,64,65
12960,Studiosx,tichondrius,2105,hunter,beastmastery,88,46,42
12961,Warpath,ursin,2088,hunter,beastmastery,114,63,51
12962,Maiyev,quelthalas,2074,hunter,beastmastery,95,52,43
12963,Fish,darkspear,2070,hunter,beastmastery,90,45,45
12964,Hfn,stormrage,2058,hunter,beastmastery,70,37,33
12965,Outz,anvilmar,2049,hunter,beastmastery,300,153,147
12966,Pãrzival,tichondrius,2042,hunter,beastmastery,60,30,30
12967,Manyu,tichondrius,2035,hunter,beastmastery,69,34,35
12968,Hazzersk,ragnaros,2023,hunter,beastmastery,161,78,83
12969,Cannondale,tichondrius,1993,hunter,beastmastery,36,21,15
12970,Trapful,illidan,1989,hunter,beastmastery,78,40,38
12971,Beastmunster,frostmourne,1984,hunter,beastmastery,72,34,38
12972,Antø,tichondrius,1978,hunter,beastmastery,129,62,67
12973,Pokìmane,tichondrius,1968,hunter,beastmastery,104,60,44
12974,Genom,tichondrius,1957,hunter,beastmastery,336,171,165
12975,Vëëv,proudmoore,1953,hunter,beastmastery,89,47,42
12976,Arcobaleno,tichondrius,1952,hunter,beastmastery,89,44,45
12977,Edarkness,gurubashi,1941,hunter,beastmastery,109,56,53
12978,Axlee,tichondrius,1941,hunter,beastmastery,237,116,121
12979,Zeddead,magtheridon,1935,hunter,beastmastery,142,74,68
12980,Øverdose,ragnaros,1935,hunter,beastmastery,54,28,26
12981,Arsk,ragnaros,1934,hunter,beastmastery,136,70,66
12982,Zugbrained,illidan,1925,hunter,beastmastery,142,78,64
12983,Blackathena,tichondrius,1922,hunter,beastmastery,126,65,61
12984,Lenacraft,frostmourne,1917,hunter,beastmastery,66,41,25
12985,Wodhunterxdd,sargeras,1915,hunter,beastmastery,70,34,36
12986,Headshotzplz,tichondrius,1912,hunter,beastmastery,62,34,28
12987,Mhter,tichondrius,1893,hunter,beastmastery,61,31,30
12988,Nyxus,tichondrius,1887,hunter,beastmastery,125,63,62
12989,Lamerpvp,tichondrius,1885,hunter,beastmastery,50,31,19
12990,Perawantua,frostmourne,1878,hunter,beastmastery,61,35,26
12991,Ashenga,cairne,1878,hunter,beastmastery,126,69,57
12992,Mugiwara,frostwolf,1877,hunter,beastmastery,42,25,17
12993,Taterballs,illidan,1873,hunter,beastmastery,72,37,35
12994,Argryta,azralon,1872,hunter,beastmastery,47,22,25
12995,Graar,tichondrius,1871,hunter,beastmastery,48,25,23
12996,Notvn,illidan,1869,hunter,beastmastery,53,29,24
12997,Lilstinstin,tichondrius,1867,hunter,beastmastery,42,23,19
12998,Dekestei,bleeding-hollow,1867,hunter,beastmastery,65,27,38
12999,Veevx,proudmoore,1862,hunter,beastmastery,71,46,25
13000,Hogx,sargeras,1862,hunter,beastmastery,72,32,40
13001,Lkw,tichondrius,1859,hunter,beastmastery,62,29,33
13002,Nelay,ragnaros,1857,hunter,beastmastery,106,59,47
13003,Trapandclap,tichondrius,1857,hunter,beastmastery,71,33,38
13004,Orber,stormrage,1856,hunter,beastmastery,266,135,131
13005,Koridelse,nemesis,1854,hunter,beastmastery,126,62,64
13006,Somethinggo,tichondrius,1854,hunter,beastmastery,70,34,36
13007,Faniquitinha,stormrage,1854,hunter,beastmastery,54,25,29
13008,Ñotorious,frostmane,1852,hunter,beastmastery,53,27,26
13009,Trappxy,sargeras,1851,hunter,beastmastery,48,27,21
13010,Cashisabeast,zuljin,1851,hunter,beastmastery,46,25,21
13011,Nutellacrepe,kelthuzad,1851,hunter,beastmastery,200,101,99
13012,Nollzey,frostmourne,1847,hunter,beastmastery,45,22,23
13013,Bolanite,illidan,1846,hunter,beastmastery,48,27,21
13014,Bogen,nemesis,1846,hunter,beastmastery,70,38,32
13015,Inktray,durotan,1844,hunter,beastmastery,37,22,15
13016,Kensho,illidan,1844,hunter,beastmastery,148,71,77
13017,Ðeatheater,tichondrius,1843,hunter,beastmastery,41,21,20
13018,Aqq,moon-guard,1842,hunter,beastmastery,98,58,40
13019,Monffbe,tichondrius,1842,hunter,beastmastery,60,28,32
13020,Benay,emerald-dream,1838,hunter,beastmastery,42,28,14
13021,Auwstin,tichondrius,1837,hunter,beastmastery,55,31,24
13022,Bowrockobama,illidan,1836,hunter,beastmastery,69,37,32
13023,Ârtæmïs,stormrage,1835,hunter,beastmastery,48,24,24
13024,Sxra,area-52,1834,hunter,beastmastery,58,32,26
13025,Mørodox,sargeras,1834,hunter,beastmastery,54,24,30
13026,Hollymarie,nazjatar,1832,hunter,beastmastery,48,31,17
13027,Absinther,emerald-dream,1829,hunter,beastmastery,66,41,25
13028,Nerfthepet,blackrock,1828,hunter,beastmastery,66,42,24
13029,Dju,stormrage,1828,hunter,beastmastery,95,51,44
13030,Playnogames,moon-guard,1828,hunter,beastmastery,42,21,21
13031,Negãn,tichondrius,1826,hunter,beastmastery,80,41,39
13032,Sosaho,sargeras,1825,hunter,beastmastery,41,21,20
13033,Sniperælite,korgath,1824,hunter,beastmastery,55,32,23
13034,Phatshiet,anvilmar,1823,hunter,beastmastery,50,31,19
13035,Jeffersan,illidan,1823,hunter,beastmastery,149,72,77
13036,Zumago,tichondrius,1823,hunter,beastmastery,118,54,64
13037,Kenshaunter,azralon,1823,hunter,beastmastery,65,28,37
13038,Zefbaby,quelthalas,1822,hunter,beastmastery,66,31,35
13039,Tyreu,tichondrius,1820,hunter,beastmastery,59,30,29
13040,Torolol,tichondrius,1819,hunter,beastmastery,126,73,53
13041,Grimrokk,malganis,1819,hunter,beastmastery,78,40,38
13042,Songhammer,tichondrius,1818,hunter,beastmastery,82,47,35
13043,Phayzd,sargeras,1818,hunter,beastmastery,66,34,32
13044,Scuffedshots,tichondrius,1817,hunter,beastmastery,74,43,31
13045,Flitt,zuljin,1815,hunter,beastmastery,36,19,17
13046,Audeline,tichondrius,1815,hunter,beastmastery,69,33,36
13047,Comebacks,ragnaros,1814,hunter,beastmastery,72,41,31
13048,Goonsh,tichondrius,1813,hunter,beastmastery,40,25,15
13049,Asukaw,barthilas,1813,hunter,beastmastery,57,28,29
13050,Mythxplosive,ragnaros,1813,hunter,beastmastery,73,32,41
13051,Drektorath,bleeding-hollow,1812,hunter,beastmastery,66,34,32
13052,Logjohn,frostmourne,1811,hunter,beastmastery,40,20,20
13053,Kybelís,dalaran,1810,hunter,beastmastery,110,61,49
13054,Hogd,sargeras,1810,hunter,beastmastery,54,26,28
13055,Robinhooz,illidan,1807,hunter,beastmastery,187,102,85
13056,Wilmaßallfit,malganis,1807,hunter,beastmastery,65,29,36
13057,Hurak,elune,1805,hunter,beastmastery,65,35,30
13058,Swang,kiljaeden,1805,hunter,beastmastery,49,24,25
13059,Sobewan,staghelm,1805,hunter,beastmastery,92,42,50
13060,Twopumphunt,tichondrius,1804,hunter,beastmastery,30,19,11
13061,Kytan,shadowmoon,1804,hunter,beastmastery,168,82,86
13062,Sarutobi,black-dragonflight,1804,hunter,beastmastery,66,29,37
13063,Lenalena,tichondrius,1803,hunter,beastmastery,59,33,26
13064,Kabalaku,moon-guard,1802,hunter,beastmastery,130,72,58
13065,Warcher,azralon,1802,hunter,beastmastery,60,32,28
13066,Hg,illidan,1800,hunter,beastmastery,38,25,13
13067,Kangarookyle,illidan,1800,hunter,beastmastery,96,58,38
13068,Shafttrapper,queldorei,1800,hunter,beastmastery,119,64,55
13069,Fernn,illidan,1800,hunter,beastmastery,94,48,46
13070,Funkyjunk,arthas,1800,hunter,beastmastery,72,35,37
13071,Easonl,tichondrius,1795,hunter,beastmastery,113,48,65
13072,Pathofsexile,tichondrius,1783,hunter,beastmastery,93,43,50
13073,Xgoh,sargeras,1782,hunter,beastmastery,42,22,20
13074,Liarael,illidan,1779,hunter,beastmastery,95,46,49
13075,Hunterphil,hyjal,1777,hunter,beastmastery,66,39,27
13076,Mckim,tichondrius,1775,hunter,beastmastery,48,28,20
13077,Kyló,sargeras,1774,hunter,beastmastery,54,26,28
13078,Zå,dalaran,1772,hunter,beastmastery,63,33,30
13079,Quietqt,ragnaros,1770,hunter,beastmastery,106,54,52
13080,Savagerko,illidan,1766,hunter,beastmastery,57,27,30
13081,Tytonic,bleeding-hollow,1765,hunter,beastmastery,54,28,26
13082,Skywvlker,illidan,1764,hunter,beastmastery,65,29,36
13083,Perffect,sargeras,1763,hunter,beastmastery,57,24,33
13084,Infinit,onyxia,1761,hunter,beastmastery,64,27,37
13085,Yucca,drenden,1760,hunter,beastmastery,36,20,16
13086,Spizsnipes,malganis,1756,hunter,beastmastery,48,24,24
13087,Tracershot,malganis,1754,hunter,beastmastery,83,49,34
13088,Datbigbowdoe,illidan,1752,hunter,beastmastery,36,23,13
13089,Tembaktytyd,barthilas,1751,hunter,beastmastery,49,24,25
13090,Fockewulf,dragonmaw,1750,hunter,beastmastery,90,40,50
13091,Airpodpro,emerald-dream,1747,hunter,beastmastery,36,21,15
13092,Cuchulláin,area-52,1744,hunter,beastmastery,114,59,55
13093,Wodhunterxdd,tichondrius,1743,hunter,beastmastery,26,19,7
13094,Madbéê,tichondrius,1741,hunter,beastmastery,41,19,22
13095,Austelos,moon-guard,1738,hunter,beastmastery,71,38,33
13096,Livelovelaff,tichondrius,1736,hunter,beastmastery,48,26,22
13097,Deathtomyfoe,sargeras,1735,hunter,beastmastery,54,21,33
13098,Pineapplees,tichondrius,1733,hunter,beastmastery,54,29,25
13099,Dahmer,greymane,1732,hunter,beastmastery,62,29,33
13100,Melov,frostmourne,1730,hunter,beastmastery,64,30,34
13101,Kidao,emerald-dream,1729,hunter,beastmastery,54,30,24
13102,Skysmile,tichondrius,1726,hunter,beastmastery,42,24,18
13103,Krunkz,frostmourne,1724,hunter,beastmastery,53,33,20
13104,Turtlegirl,tichondrius,1724,hunter,beastmastery,41,20,21
13105,Reparcero,quelthalas,1723,hunter,beastmastery,42,20,22
13106,Bootydoo,illidan,1721,hunter,beastmastery,124,64,60
13107,Twixzorz,boulderfist,1716,hunter,beastmastery,60,28,32
13108,Survivalists,kelthuzad,1715,hunter,beastmastery,30,22,8
13109,Lucki,blades-edge,1715,hunter,beastmastery,60,34,26
13110,Acres,emerald-dream,1714,hunter,beastmastery,27,19,8
13111,Çute,moon-guard,1714,hunter,beastmastery,48,29,19
13112,Revalay,emerald-dream,1711,hunter,beastmastery,54,32,22
13113,Edelyysa,arthas,1711,hunter,beastmastery,180,89,91
13114,Raymose,tichondrius,1709,hunter,beastmastery,40,20,20
13115,Flanzo,illidan,1708,hunter,beastmastery,48,25,23
13116,Shablagoosh,zuljin,1706,hunter,beastmastery,37,25,12
13117,Sbplayshunt,akama,1706,hunter,beastmastery,48,19,29
13118,Parnicyon,frostmourne,1705,hunter,beastmastery,164,90,74
13119,Hyjax,darkspear,1701,hunter,beastmastery,43,26,17
13120,Killshøtß,tichondrius,1701,hunter,beastmastery,65,30,35
13121,Fatalshots,bonechewer,1699,hunter,beastmastery,42,24,18
13122,Wodunaz,stormrage,1698,hunter,beastmastery,71,45,26
13123,Thtswap,moon-guard,1697,hunter,beastmastery,36,26,10
13124,Nobito,quelthalas,1694,hunter,beastmastery,109,60,49
13125,Jfkd,sargeras,1694,hunter,beastmastery,52,21,31
13126,Diegoshotz,zuljin,1689,hunter,beastmastery,46,23,23
13127,Shadowfangs,tichondrius,1689,hunter,beastmastery,66,31,35
13128,Cresselia,drakkari,1686,hunter,beastmastery,53,29,24
13129,Fabbs,frostmourne,1686,hunter,beastmastery,52,26,26
13130,Biehuixin,tichondrius,1685,hunter,beastmastery,50,27,23
13131,Kenpachie,jubeithos,1684,hunter,beastmastery,29,20,9
13132,Lilskill,lightnings-blade,1682,hunter,beastmastery,30,18,12
13133,Sniper,area-52,1680,hunter,beastmastery,133,64,69
13134,Kapukapu,illidan,1679,hunter,beastmastery,30,18,12
13135,Silverbite,garona,1678,hunter,beastmastery,92,51,41
13136,Coopshot,darkspear,1675,hunter,beastmastery,69,40,29
13137,Saiiphz,bleeding-hollow,1675,hunter,beastmastery,40,22,18
13138,Illsugoi,frostwolf,1675,hunter,beastmastery,93,46,47
13139,Tuân,azgalor,1674,hunter,beastmastery,36,23,13
13140,Alaurys,moon-guard,1674,hunter,beastmastery,35,18,17
13141,Bowreckage,malganis,1673,hunter,beastmastery,66,27,39
13142,Facerolled,area-52,1670,hunter,beastmastery,75,45,30
13143,Lemmetrap,illidan,1667,hunter,beastmastery,30,18,12
13144,Koalahunter,area-52,1667,hunter,beastmastery,76,31,45
13145,Junglefever,skywall,1664,hunter,beastmastery,34,20,14
13146,Hokutoxx,tichondrius,1663,hunter,beastmastery,61,25,36
13147,Warrccjr,steamwheedle-cartel,1661,hunter,beastmastery,35,18,17
13148,Cw,gorefiend,1660,hunter,beastmastery,36,20,16
13149,Dj,arygos,1658,hunter,beastmastery,36,21,15
13150,Squeekin,sargeras,1657,hunter,beastmastery,27,22,5
13151,Showmakerc,proudmoore,1656,hunter,beastmastery,77,35,42
13152,Gufanyaun,tichondrius,1654,hunter,beastmastery,34,18,16
13153,Gumbro,malganis,1653,hunter,beastmastery,72,43,29
13154,Rndx,sargeras,1653,hunter,beastmastery,46,20,26
13155,Sylviai,hyjal,1652,hunter,beastmastery,77,40,37
13156,Kwinoah,zuljin,1652,hunter,beastmastery,174,84,90
13157,Mukbangbj,terenas,1651,hunter,beastmastery,78,42,36
13158,Tyrokk,barthilas,1649,hunter,beastmastery,45,21,24
13159,Eastwood,tichondrius,1648,hunter,beastmastery,92,41,51
13160,Camhaanes,area-52,1646,hunter,beastmastery,119,67,52
13161,Ipickmynose,tichondrius,1645,hunter,beastmastery,45,27,18
13162,Mauklindaufe,fenris,1644,hunter,beastmastery,85,43,42
13163,Mlemily,stormrage,1643,hunter,beastmastery,63,36,27
13164,Cachín,ragnaros,1642,hunter,beastmastery,54,26,28
13165,Montakka,illidan,1638,hunter,beastmastery,48,26,22
13166,Andalora,malganis,1638,hunter,beastmastery,61,27,34
13167,Elad,tichondrius,1637,hunter,beastmastery,60,35,25
13168,Publicpooper,tichondrius,1637,hunter,beastmastery,36,21,15
13169,Energiser,stormrage,1637,hunter,beastmastery,58,29,29
13170,Dreygar,dawnbringer,1636,hunter,beastmastery,105,55,50
13171,Mcclintock,executus,1636,hunter,beastmastery,41,21,20
13172,Drakarth,khazgoroth,1635,hunter,beastmastery,47,22,25
13173,Kahll,azralon,1634,hunter,beastmastery,54,24,30
13174,Montano,area-52,1633,hunter,beastmastery,32,22,10
13175,Lexandr,tichondrius,1633,hunter,beastmastery,90,51,39
13176,Airhunt,thrall,1632,hunter,beastmastery,42,19,23
13177,Axxll,tichondrius,1629,hunter,beastmastery,55,25,30
13178,Dpdóugh,illidan,1628,hunter,beastmastery,106,55,51
13179,Dirtymongrel,barthilas,1628,hunter,beastmastery,72,35,37
13180,Cocoapuffs,cenarius,1627,hunter,beastmastery,36,17,19
13181,Vox,tichondrius,1626,hunter,beastmastery,30,20,10
13182,Onemoreshot,bleeding-hollow,1626,hunter,beastmastery,84,44,40
13183,Layloww,thrall,1626,hunter,beastmastery,36,18,18
13184,Ryûkø,quelthalas,1626,hunter,beastmastery,48,23,25
13185,Phiyuh,stormrage,1624,hunter,beastmastery,60,36,24
13186,Liadrelle,proudmoore,1624,hunter,beastmastery,57,24,33
13187,Whitecake,area-52,1623,hunter,beastmastery,40,25,15
13188,Grimbrew,garona,1623,hunter,beastmastery,41,24,17
13189,Svsnipe,tichondrius,1623,hunter,beastmastery,58,33,25
13190,Mojopotato,stormrage,1623,hunter,beastmastery,53,24,29
13191,Illweedx,kiljaeden,1623,hunter,beastmastery,101,42,59
13192,Shootsb,tichondrius,1623,hunter,beastmastery,58,24,34
13193,Zakalla,malganis,1622,hunter,beastmastery,62,33,29
13194,Trickshotss,illidan,1621,hunter,beastmastery,106,63,43
13195,Metrallon,black-dragonflight,1621,hunter,beastmastery,53,29,24
13196,Shootnskoot,icecrown,1618,hunter,beastmastery,24,17,7
13197,Consanguin,sargeras,1618,hunter,beastmastery,36,22,14
13198,Casperonni,illidan,1618,hunter,beastmastery,78,42,36
13199,Rürü,illidan,1618,hunter,beastmastery,40,21,19
13200,Sambucca,daggerspine,1617,hunter,beastmastery,42,21,21
13201,Oblivîon,illidan,1616,hunter,beastmastery,59,38,21
13202,Huntinpuss,tichondrius,1616,hunter,beastmastery,32,18,14
13203,Terpa,nemesis,1616,hunter,beastmastery,161,83,78
13204,Telånnas,illidan,1616,hunter,beastmastery,42,21,21
13205,Skytrooper,boulderfist,1616,hunter,beastmastery,59,26,33
13206,Wøden,draka,1614,hunter,beastmastery,72,38,34
13207,Legoflaiz,drakkari,1614,hunter,beastmastery,48,23,25
13208,Apøllö,kilrogg,1614,hunter,beastmastery,262,123,139
13209,Ecl,azralon,1613,hunter,beastmastery,48,27,21
13210,Häm,dalaran,1613,hunter,beastmastery,114,63,51
13211,Skarasha,tichondrius,1610,hunter,beastmastery,42,22,20
13212,Mambothehunt,stormrage,1610,hunter,beastmastery,59,27,32
13213,Razor,destromath,1610,hunter,beastmastery,54,24,30
13214,Yughii,stormrage,1609,hunter,beastmastery,36,17,19
13215,Cobrakhan,tichondrius,1608,hunter,beastmastery,66,42,24
13216,Bertimus,sargeras,1608,hunter,beastmastery,132,61,71
13217,Focusfire,khazgoroth,1607,hunter,beastmastery,66,32,34
13218,Mordriva,azjolnerub,1607,hunter,beastmastery,53,25,28
13219,Shootnoscore,vashj,1606,hunter,beastmastery,83,46,37
13220,Sissleto,tichondrius,1606,hunter,beastmastery,239,116,123
13221,Legacyhunter,nazgrel,1605,hunter,beastmastery,30,17,13
13222,Ðfac,moon-guard,1604,hunter,beastmastery,60,26,34
13223,Légölás,tichondrius,1603,hunter,beastmastery,72,41,31
13224,Beasting,moon-guard,1603,hunter,beastmastery,36,20,16
13225,Bamfhunt,darkspear,1603,hunter,beastmastery,46,25,21
13226,Jillypoo,azralon,1602,hunter,beastmastery,30,21,9
13227,Axis,mugthol,1601,hunter,beastmastery,85,45,40
13228,Aazua,frostmourne,1601,hunter,beastmastery,45,22,23
13229,Snewfly,tichondrius,1600,hunter,beastmastery,54,36,18
13230,Kenji,sargeras,1599,hunter,beastmastery,56,23,33
13231,Vanero,eonar,1598,hunter,beastmastery,48,22,26
13232,Asurvivor,suramar,1596,hunter,beastmastery,157,81,76
13233,Zyzzmirin,illidan,1596,hunter,beastmastery,66,30,36
13234,Pinêapplê,bleeding-hollow,1595,hunter,beastmastery,30,18,12
13235,Sñïpêr,tichondrius,1595,hunter,beastmastery,36,19,17
13236,Hofftimus,tichondrius,1591,hunter,beastmastery,71,47,24
13237,Spídër,maiev,1591,hunter,beastmastery,38,20,18
13238,Killwill,illidan,1587,hunter,beastmastery,54,28,26
13239,Xionos,wyrmrest-accord,1587,hunter,beastmastery,78,39,39
13240,Sashagreen,frostmourne,1585,hunter,beastmastery,83,43,40
13241,Toxarch,aggramar,1585,hunter,beastmastery,78,39,39
13242,Nooche,bleeding-hollow,1582,hunter,beastmastery,30,20,10
13243,Partz,darkspear,1580,hunter,beastmastery,30,19,11
13244,Teneightt,tichondrius,1578,hunter,beastmastery,62,30,32
13245,Mournebow,tichondrius,1574,hunter,beastmastery,267,144,123
13246,Fkkroglash,barthilas,1573,hunter,beastmastery,36,23,13
13247,Zennifi,bleeding-hollow,1573,hunter,beastmastery,73,36,37
13248,Kopula,illidan,1569,hunter,beastmastery,55,30,25
13249,Rëxx,moon-guard,1565,hunter,beastmastery,68,39,29
13250,Sonichunterr,illidan,1563,hunter,beastmastery,64,38,26
13251,Icecaffemoca,tichondrius,1562,hunter,beastmastery,45,19,26
13252,Assbow,kiljaeden,1561,hunter,beastmastery,36,18,18
13253,Nalasdottirh,moon-guard,1559,hunter,beastmastery,30,17,13
13254,Lasix,burning-blade,1559,hunter,beastmastery,107,52,55
13255,Urzoth,tichondrius,1556,hunter,beastmastery,42,26,16
13256,Kniightjayyx,kelthuzad,1552,hunter,beastmastery,78,32,46
13257,Keboks,alleria,1551,hunter,beastmastery,33,18,15
13258,Reay,frostmourne,1551,hunter,beastmastery,36,19,17
13259,Tinyted,nathrezim,1550,hunter,beastmastery,42,21,21
13260,Scythedom,tichondrius,1550,hunter,beastmastery,42,17,25
13261,Bigolekack,tichondrius,1547,hunter,beastmastery,36,19,17
13262,Gernon,frostmourne,1546,hunter,beastmastery,39,20,19
13263,Nitroxl,illidan,1545,hunter,beastmastery,54,29,25
13264,Kushaddict,lightnings-blade,1545,hunter,beastmastery,150,64,86
13265,Despairius,moon-guard,1543,hunter,beastmastery,44,25,19
13266,Outfazed,tichondrius,1543,hunter,beastmastery,81,45,36
13267,Limcross,drakkari,1543,hunter,beastmastery,50,27,23
13268,Ungoliánt,cairne,1541,hunter,beastmastery,54,28,26
13269,Rektarrow,area-52,1541,hunter,beastmastery,41,19,22
13270,Dôntlosmebro,stormrage,1540,hunter,beastmastery,66,37,29
13271,Ñðñdêsçrípt,frostmourne,1540,hunter,beastmastery,69,35,34
13272,Varka,area-52,1539,hunter,beastmastery,36,20,16
13273,Petkd,frostmourne,1538,hunter,beastmastery,42,23,19
13274,Cerébro,illidan,1538,hunter,beastmastery,78,31,47
13275,Laurenx,illidan,1537,hunter,beastmastery,33,20,13
13276,Kaizong,hyjal,1537,hunter,beastmastery,29,17,12
13277,Runforthehil,barthilas,1537,hunter,beastmastery,60,30,30
13278,Yandralen,kiljaeden,1533,hunter,beastmastery,69,37,32
13279,Getrekt,azralon,1533,hunter,beastmastery,45,20,25
13280,Freebeë,area-52,1531,hunter,beastmastery,85,49,36
13281,Tsuro,area-52,1529,hunter,beastmastery,29,17,12
13282,Teaks,aggramar,1527,hunter,beastmastery,30,16,14
13283,Breezekeeper,area-52,1527,hunter,beastmastery,78,40,38
13284,Shadowtensai,stormrage,1527,hunter,beastmastery,78,34,44
13285,Snipin,ragnaros,1527,hunter,beastmastery,42,16,26
13286,Robnhunt,tichondrius,1526,hunter,beastmastery,30,16,14
13287,Sindragostra,tichondrius,1526,hunter,beastmastery,123,62,61
13288,Kript,dragonmaw,1526,hunter,beastmastery,325,156,169
13289,Tus,tichondrius,1526,hunter,beastmastery,36,16,20
13290,Phindo,agamaggan,1525,hunter,beastmastery,30,17,13
13291,Uzpak,tichondrius,1524,hunter,beastmastery,59,34,25
13292,Overshot,tichondrius,1522,hunter,beastmastery,60,23,37
13293,Smullik,wyrmrest-accord,1521,hunter,beastmastery,36,16,20
13294,Mortalz,barthilas,1519,hunter,beastmastery,155,76,79
13295,Readtitle,malganis,1518,hunter,beastmastery,54,31,23
13296,Clinteastwoo,ragnaros,1517,hunter,beastmastery,48,16,32
13297,Hazzeth,thrall,1516,hunter,beastmastery,30,21,9
13298,Bonnèy,zuljin,1516,hunter,beastmastery,48,31,17
13299,Existential,moon-guard,1513,hunter,beastmastery,36,19,17
13300,Cyrsmen,ragnaros,1511,hunter,beastmastery,162,80,82
13301,Gamestopceo,tichondrius,1511,hunter,beastmastery,84,41,43
13302,Selhort,quelthalas,1511,hunter,beastmastery,72,31,41
13303,Internade,frostmourne,1509,hunter,beastmastery,54,25,29
13304,Myladyy,zuljin,1509,hunter,beastmastery,59,24,35
13305,Sanchode,tichondrius,1508,hunter,beastmastery,48,20,28
13306,Bustyredhead,kelthuzad,1508,hunter,beastmastery,41,16,25
13307,Velhokoira,illidan,1507,hunter,beastmastery,54,31,23
13308,Diavál,area-52,1506,hunter,beastmastery,42,24,18
13309,Chaw,nathrezim,1506,hunter,beastmastery,74,39,35
13310,Volbz,barthilas,1505,hunter,beastmastery,36,16,20
13311,Shockwave,velen,1504,hunter,beastmastery,182,93,89
13312,Emilysamuels,tichondrius,1503,hunter,beastmastery,24,16,8
13313,Pankyrangs,kelthuzad,1503,hunter,beastmastery,48,24,24
13314,Stalkstride,destromath,1503,hunter,beastmastery,72,35,37
13315,Brokiînn,aegwynn,1503,hunter,beastmastery,105,51,54
13316,Rcman,tichondrius,1501,hunter,beastmastery,36,27,9
13317,Chrest,sargeras,1500,hunter,beastmastery,76,39,37
13318,Irøneye,sargeras,1499,hunter,beastmastery,55,20,35
13319,Yaisk,tichondrius,1498,hunter,beastmastery,62,35,27
13320,Statistic,black-dragonflight,1496,hunter,beastmastery,36,17,19
13321,Ramchi,burning-blade,1494,hunter,beastmastery,61,33,28
13322,Reloadz,shattered-hand,1494,hunter,beastmastery,34,18,16
13323,Xuorias,area-52,1494,hunter,beastmastery,47,24,23
13324,Luckshot,destromath,1494,hunter,beastmastery,42,21,21
13325,Pavlovik,ragnaros,1491,hunter,beastmastery,60,25,35
13326,ßoness,area-52,1491,hunter,beastmastery,48,18,30
13327,Sereom,frostmourne,1490,hunter,beastmastery,95,55,40
13328,Wredd,nemesis,1488,hunter,beastmastery,35,20,15
13329,Bootylickin,tichondrius,1487,hunter,beastmastery,30,17,13
13330,Szone,tichondrius,1487,hunter,beastmastery,88,43,45
13331,Laras,blades-edge,1484,hunter,beastmastery,36,22,14
13332,Chizhi,tichondrius,1484,hunter,beastmastery,90,45,45
13333,Horcnbeans,bleeding-hollow,1484,hunter,beastmastery,105,51,54
13334,Ullr,gurubashi,1484,hunter,beastmastery,60,19,41
13335,Jjack,muradin,1482,hunter,beastmastery,54,29,25
13336,Chowyunfatss,proudmoore,1481,hunter,beastmastery,112,53,59
13337,Rengarok,emerald-dream,1480,hunter,beastmastery,44,23,21
13338,Grànd,tortheldrin,1480,hunter,beastmastery,66,33,33
13339,Scourgesurge,kiljaeden,1478,hunter,beastmastery,145,71,74
13340,Mopgodxqt,nemesis,1478,hunter,beastmastery,42,19,23
13341,Josyv,quelthalas,1477,hunter,beastmastery,36,21,15
13342,Garzb,area-52,1476,hunter,beastmastery,42,22,20
13343,Aguntur,ragnaros,1474,hunter,beastmastery,99,59,40
13344,Virolac,tichondrius,1469,hunter,beastmastery,32,16,16
13345,Oceandoom,tichondrius,1468,hunter,beastmastery,93,52,41
13346,Crounzz,sargeras,1468,hunter,beastmastery,54,16,38
13347,Caetomon,kiljaeden,1467,hunter,beastmastery,29,18,11
13348,Zaetor,ragnaros,1466,hunter,beastmastery,78,43,35
13349,Tacos,kelthuzad,1465,hunter,beastmastery,36,22,14
13350,Sootgarbage,sargeras,1464,hunter,beastmastery,72,42,30
13351,Dlabio,emerald-dream,1461,hunter,beastmastery,90,46,44
13352,Unrealpewpew,lightbringer,1461,hunter,beastmastery,72,32,40
13353,Danncer,alexstrasza,1459,hunter,beastmastery,102,56,46
13354,Yager,kalecgos,1456,hunter,beastmastery,28,17,11
13355,Punjisticks,tichondrius,1454,hunter,beastmastery,104,49,55
13356,Kleankilla,malganis,1453,hunter,beastmastery,38,22,16
13357,Dontmissz,tichondrius,1449,hunter,beastmastery,42,24,18
13358,Limpnoodle,nerzhul,1445,hunter,beastmastery,113,55,58
13359,Kouandjio,area-52,1444,hunter,beastmastery,36,18,18
13360,Recha,emerald-dream,1442,hunter,beastmastery,30,17,13
13361,Zanahoria,stormscale,1442,hunter,beastmastery,43,19,24
13362,Ehnó,illidan,1441,hunter,beastmastery,33,17,16
13363,Daarrk,thrall,1441,hunter,beastmastery,82,39,43
13364,Junmuxiao,ragnaros,1441,hunter,beastmastery,48,22,26
13365,Shedowhunter,azralon,1439,hunter,beastmastery,24,17,7
13366,Lashga,wyrmrest-accord,1439,hunter,beastmastery,47,22,25
13367,Yugno,wildhammer,1437,hunter,beastmastery,30,16,14
13368,Aristæos,kelthuzad,1436,hunter,beastmastery,77,40,37
13369,Sungoro,tichondrius,1436,hunter,beastmastery,78,35,43
13370,Squírtle,ragnaros,1436,hunter,beastmastery,36,15,21
13371,Tânsøxøxø,tichondrius,1436,hunter,beastmastery,42,15,27
13372,Sarahbeara,moonrunner,1435,hunter,beastmastery,24,15,9
13373,Scirfreez,ragnaros,1435,hunter,beastmastery,60,25,35
13374,Seatback,arathor,1432,hunter,beastmastery,76,33,43
13375,Kkoner,illidan,1431,hunter,beastmastery,24,15,9
13376,Fames,shuhalo,1431,hunter,beastmastery,49,22,27
13377,Zemphoths,eredar,1429,hunter,beastmastery,33,15,18
13378,Ddänz,kiljaeden,1429,hunter,beastmastery,45,16,29
13379,Sharpster,zuljin,1427,hunter,beastmastery,61,30,31
13380,Wolfarms,area-52,1427,hunter,beastmastery,69,32,37
13381,Critterz,gorgonnash,1427,hunter,beastmastery,65,28,37
13382,Iyne,stormrage,1427,hunter,beastmastery,36,15,21
13383,Munyshotz,tichondrius,1426,hunter,beastmastery,86,50,36
13384,Sasorï,nemesis,1424,hunter,beastmastery,24,15,9
13385,Skeetslinger,illidan,1424,hunter,beastmastery,39,16,23
13386,Syldris,proudmoore,1423,hunter,beastmastery,24,15,9
13387,ßutter,thunderlord,1423,hunter,beastmastery,38,17,21
13388,Boomseed,nagrand,1420,hunter,beastmastery,34,16,18
13389,Mukeru,stormrage,1418,hunter,beastmastery,24,15,9
13390,Taelen,aegwynn,1417,hunter,beastmastery,47,24,23
13391,Araghrn,draktharon,1417,hunter,beastmastery,111,54,57
13392,Gannidema,illidan,1416,hunter,beastmastery,30,17,13
13393,Eldlichi,proudmoore,1416,hunter,beastmastery,48,20,28
13394,Belime,korgath,1415,hunter,beastmastery,96,53,43
13395,Sülivan,zuljin,1415,hunter,beastmastery,49,27,22
13396,Terminatôr,malganis,1415,hunter,beastmastery,36,15,21
13397,Drunkhunter,malygos,1414,hunter,beastmastery,24,15,9
13398,Blackspit,ragnaros,1411,hunter,beastmastery,41,23,18
13399,Hobbléfoot,proudmoore,1409,hunter,beastmastery,36,15,21
13400,Drig,korgath,1409,hunter,beastmastery,47,19,28
13401,Morganson,moon-guard,1407,hunter,beastmastery,174,83,91
13402,Cyboreg,stormrage,1403,hunter,beastmastery,41,23,18
13403,Sioul,bleeding-hollow,1403,hunter,beastmastery,30,15,15
13404,Darthski,drenden,1402,hunter,beastmastery,51,24,27
13405,Sliturthroat,barthilas,1402,hunter,beastmastery,50,20,30
13406,Thezeus,barthilas,1402,hunter,beastmastery,41,15,26
13407,Lilpoots,warsong,1401,hunter,beastmastery,59,28,31
13408,Orcanjo,azralon,1400,hunter,beastmastery,42,19,23
13409,Overshot,barthilas,1397,hunter,beastmastery,24,16,8
13410,Jyttrg,tichondrius,1396,hunter,beastmastery,65,34,31
13411,Timmee,bleeding-hollow,1392,hunter,beastmastery,36,15,21
13412,Liillilliil,tichondrius,1391,hunter,beastmastery,31,16,15
13413,Paganfinn,tichondrius,1391,hunter,beastmastery,66,29,37
13414,Tentoontrey,emerald-dream,1390,hunter,beastmastery,42,20,22
13415,Legolasbow,tichondrius,1386,hunter,beastmastery,52,26,26
13416,Tearsofnoobs,tichondrius,1381,hunter,beastmastery,33,16,17
13417,Viperstng,area-52,1380,hunter,beastmastery,70,40,30
13418,Fruitenveg,frostmourne,1374,hunter,beastmastery,36,18,18
13419,Tearsofrogue,tichondrius,1373,hunter,beastmastery,30,16,14
13420,Chrise,darkspear,1371,hunter,beastmastery,24,18,6
13421,Phaction,tichondrius,1369,hunter,beastmastery,60,26,34
13422,Jangle,mannoroth,1368,hunter,beastmastery,34,19,15
13423,Lilbic,bleeding-hollow,1367,hunter,beastmastery,27,18,9
13424,Cottonshots,dalaran,1367,hunter,beastmastery,60,27,33
13425,Hillside,frostmourne,1364,hunter,beastmastery,23,15,8
13426,Boward,illidan,1362,hunter,beastmastery,67,36,31
13427,Revbubs,darkspear,1360,hunter,beastmastery,54,26,28
13428,Ryukuzen,tichondrius,1359,hunter,beastmastery,35,15,20
13429,Femonemos,nemesis,1358,hunter,beastmastery,30,17,13
13430,Cigâro,thrall,1358,hunter,beastmastery,123,60,63
13431,Shlandy,frostmourne,1356,hunter,beastmastery,32,18,14
13432,Keknine,gnomeregan,1356,hunter,beastmastery,66,29,37
13433,Reallybroke,stormrage,1355,hunter,beastmastery,33,16,17
13434,Tokendaily,sargeras,1353,hunter,beastmastery,72,40,32
13435,Vruul,sargeras,1352,hunter,beastmastery,64,30,34
13436,Fleetfox,tichondrius,1351,hunter,beastmastery,49,23,26
13437,Pokérap,dalaran,1347,hunter,beastmastery,42,17,25
13438,Borudin,stormrage,1344,hunter,beastmastery,161,71,90
13439,Spèedbump,stormrage,1342,hunter,beastmastery,63,29,34
13440,Lilien,khazgoroth,1341,hunter,beastmastery,30,18,12
13441,Goongarg,frostmourne,1341,hunter,beastmastery,24,14,10
13442,Bro,malorne,1341,hunter,beastmastery,72,34,38
13443,Tergls,illidan,1341,hunter,beastmastery,73,33,40
13444,Kârân,tichondrius,1341,hunter,beastmastery,60,27,33
13445,Choclit,scilla,1341,hunter,beastmastery,42,14,28
13446,Mitulla,wyrmrest-accord,1339,hunter,beastmastery,44,22,22
13447,Clydebarro,sargeras,1339,hunter,beastmastery,30,14,16
13448,Oatmeallover,stormrage,1339,hunter,beastmastery,30,14,16
13449,Peterming,tichondrius,1339,hunter,beastmastery,108,49,59
13450,Euclase,bleeding-hollow,1338,hunter,beastmastery,46,23,23
13451,Damadar,tichondrius,1338,hunter,beastmastery,30,14,16
13452,Aiollus,stormreaver,1338,hunter,beastmastery,30,14,16
13453,Pvrisxoxo,frostmourne,1337,hunter,beastmastery,31,15,16
13454,Crownchild,illidan,1336,hunter,beastmastery,24,14,10
13455,Skulgor,zuljin,1336,hunter,beastmastery,66,34,32
13456,Psychiatry,bonechewer,1336,hunter,beastmastery,70,35,35
13457,Azx,tichondrius,1336,hunter,beastmastery,42,19,23
13458,Stel,tichondrius,1335,hunter,beastmastery,33,17,16
13459,Bubbzar,frostmourne,1334,hunter,beastmastery,24,14,10
13460,Shootiepie,hyjal,1333,hunter,beastmastery,24,14,10
13461,Aggargh,baelgun,1332,hunter,beastmastery,33,18,15
13462,Daken,ysera,1330,hunter,beastmastery,24,14,10
13463,Mvpwonder,frostmourne,1330,hunter,beastmastery,42,14,28
13464,Khaydarin,sargeras,1329,hunter,beastmastery,30,14,16
13465,Luprikus,maelstrom,1328,hunter,beastmastery,29,14,15
13466,Jaysuper,zuljin,1328,hunter,beastmastery,36,14,22
13467,Oblíviion,stormrage,1327,hunter,beastmastery,44,23,21
13468,Frostyarrow,moon-guard,1325,hunter,beastmastery,55,28,27
13469,Bulleitrye,illidan,1325,hunter,beastmastery,58,28,30
13470,Starsworn,moon-guard,1323,hunter,beastmastery,30,16,14
13471,Finalshot,barthilas,1323,hunter,beastmastery,33,15,18
13472,Bowna,stormscale,1323,hunter,beastmastery,54,20,34
13473,Xonios,frostwolf,1320,hunter,beastmastery,24,15,9
13474,Fusionrpg,quelthalas,1320,hunter,beastmastery,30,17,13
13475,Eightbeers,bleeding-hollow,1320,hunter,beastmastery,56,29,27
13476,Jesticles,zuljin,1320,hunter,beastmastery,60,30,30
13477,Bingdat,area-52,1319,hunter,beastmastery,31,16,15
13478,Pingaamarela,nemesis,1319,hunter,beastmastery,138,70,68
13479,Petmayo,tichondrius,1318,hunter,beastmastery,18,14,4
13480,Doug,illidan,1317,hunter,beastmastery,30,14,16
13481,Wulfgeng,azgalor,1313,hunter,beastmastery,80,39,41
13482,Jetzy,illidan,1311,hunter,beastmastery,65,30,35
13483,Narus,whisperwind,1310,hunter,beastmastery,48,26,22
13484,Hoboh,illidan,1310,hunter,beastmastery,66,32,34
13485,Lizymcguire,malganis,1308,hunter,beastmastery,42,23,19
13486,Varthurg,ragnaros,1308,hunter,beastmastery,30,15,15
13487,Kamikazey,tichondrius,1304,hunter,beastmastery,36,18,18
13488,Bluebow,tichondrius,1302,hunter,beastmastery,96,46,50
13489,Javoz,drakkari,1302,hunter,beastmastery,36,14,22
13490,Bacatran,darkspear,1301,hunter,beastmastery,58,32,26
13491,Sunchea,arygos,1300,hunter,beastmastery,30,14,16
13492,Trailbreaker,trollbane,1299,hunter,beastmastery,69,43,26
13493,Zzsocrateszz,dragonmaw,1298,hunter,beastmastery,104,52,52
13494,Jacobsladder,illidan,1293,hunter,beastmastery,113,51,62
13495,Darksector,nemesis,1290,hunter,beastmastery,41,14,27
13496,Alitharia,nerzhul,1288,hunter,beastmastery,153,67,86
13497,Voodoohunter,blood-furnace,1286,hunter,beastmastery,30,15,15
13498,Vaettai,barthilas,1286,hunter,beastmastery,72,32,40
13499,Mikey,exodar,1284,hunter,beastmastery,27,15,12
13500,Airtight,area-52,1281,hunter,beastmastery,53,24,29
13501,Bepee,auchindoun,1279,hunter,beastmastery,89,48,41
13502,Huukend,azjolnerub,1277,hunter,beastmastery,48,23,25
13503,Thiccit,illidan,1276,hunter,beastmastery,42,21,21
13504,Alexbm,amanthul,1271,hunter,beastmastery,44,27,17
13505,Iar,tichondrius,1270,hunter,beastmastery,30,18,12
13506,Glediator,tichondrius,1269,hunter,beastmastery,45,21,24
13507,Fallenfates,stormrage,1268,hunter,beastmastery,78,36,42
13508,Trapz,hellscream,1267,hunter,beastmastery,96,48,48
13509,Rnger,aerie-peak,1267,hunter,beastmastery,55,25,30
13510,Therooth,bleeding-hollow,1262,hunter,beastmastery,24,14,10
13511,Bubbz,bloodscalp,1261,hunter,beastmastery,66,33,33
13512,Scattertrap,ragnaros,1260,hunter,beastmastery,19,14,5
13513,Lastanar,amanthul,1258,hunter,beastmastery,90,45,45
13514,Vesity,tichondrius,1249,hunter,beastmastery,50,23,27
13515,Broydiesnipe,illidan,1247,hunter,beastmastery,18,13,5
13516,Alexxspewpew,ragnaros,1247,hunter,beastmastery,23,13,10
13517,Frankabingle,area-52,1247,hunter,beastmastery,30,13,17
13518,Wastdpenguin,area-52,1247,hunter,beastmastery,30,13,17
13519,Slowhunterr,tichondrius,1247,hunter,beastmastery,36,13,23
13520,Carlitocool,tichondrius,1246,hunter,beastmastery,18,13,5
13521,Refinedx,sargeras,1246,hunter,beastmastery,18,13,5
13522,Gabulmenina,nemesis,1245,hunter,beastmastery,24,13,11
13523,Reeload,tichondrius,1244,hunter,beastmastery,24,13,11
13524,Tyleraq,area-52,1244,hunter,beastmastery,24,13,11
13525,Shotmieye,thunderhorn,1244,hunter,beastmastery,60,30,30
13526,Ascer,gurubashi,1244,hunter,beastmastery,98,48,50
13527,Maquire,tichondrius,1244,hunter,beastmastery,36,17,19
13528,Digitizoid,tichondrius,1244,hunter,beastmastery,30,13,17
13529,Craftarrow,tichondrius,1243,hunter,beastmastery,41,21,20
13530,Wickyz,malganis,1243,hunter,beastmastery,30,13,17
13531,Heparinqt,area-52,1242,hunter,beastmastery,36,13,23
13532,Mmeep,illidan,1241,hunter,beastmastery,24,13,11
13533,Angrypepe,bleeding-hollow,1240,hunter,beastmastery,30,13,17
13534,Wadadly,malganis,1239,hunter,beastmastery,138,66,72
13535,Ioioi,tichondrius,1238,hunter,beastmastery,34,16,18
13536,Fistbirtdor,illidan,1237,hunter,beastmastery,24,13,11
13537,Nebulahaze,stormrage,1236,hunter,beastmastery,38,18,20
13538,Timogen,illidan,1236,hunter,beastmastery,36,16,20
13539,Nogaro,nemesis,1235,hunter,beastmastery,42,20,22
13540,Hynathios,azralon,1233,hunter,beastmastery,30,13,17
13541,Bobbysmurica,cenarion-circle,1233,hunter,beastmastery,48,20,28
13542,Honeygold,tichondrius,1233,hunter,beastmastery,51,19,32
13543,Rbtz,illidan,1231,hunter,beastmastery,17,13,4
13544,Xtop,draktharon,1231,hunter,beastmastery,23,15,8
13545,Mithrandiel,blood-furnace,1229,hunter,beastmastery,87,45,42
13546,Snypêr,tichondrius,1229,hunter,beastmastery,30,13,17
13547,Highdroe,tichondrius,1228,hunter,beastmastery,48,25,23
13548,Luoca,shuhalo,1227,hunter,beastmastery,24,13,11
13549,Angdre,tichondrius,1227,hunter,beastmastery,30,13,17
13550,Skywrecker,bleeding-hollow,1226,hunter,beastmastery,24,13,11
13551,Hovahdo,proudmoore,1224,hunter,beastmastery,23,13,10
13552,Hughneutron,kirin-tor,1224,hunter,beastmastery,147,76,71
13553,Urimiel,daggerspine,1223,hunter,beastmastery,36,16,20
13554,Wrècked,kiljaeden,1222,hunter,beastmastery,30,13,17
13555,Bromance,kaelthas,1221,hunter,beastmastery,36,18,18
13556,Grands,tortheldrin,1219,hunter,beastmastery,29,14,15
13557,Havymetal,andorhal,1219,hunter,beastmastery,48,20,28
13558,Machiko,gorefiend,1218,hunter,beastmastery,30,13,17
13559,Anaiset,hyjal,1217,hunter,beastmastery,24,13,11
13560,Xxo,frostmourne,1215,hunter,beastmastery,34,13,21
13561,Norcklow,ragnaros,1211,hunter,beastmastery,46,18,28
13562,Deirrë,saurfang,1209,hunter,beastmastery,41,17,24
13563,Hairyhype,malganis,1207,hunter,beastmastery,42,19,23
13564,Artilleria,quelthalas,1207,hunter,beastmastery,42,18,24
13565,Hitts,kelthuzad,1206,hunter,beastmastery,25,14,11
13566,Desydn,draenor,1206,hunter,beastmastery,143,72,71
13567,Ydaine,alexstrasza,1206,hunter,beastmastery,75,33,42
13568,Gejagt,sargeras,1201,hunter,beastmastery,25,14,11
13569,Winchestyr,lightbringer,1201,hunter,beastmastery,30,14,16
13570,Tmac,winterhoof,1198,hunter,beastmastery,53,28,25
13571,Kathoey,wyrmrest-accord,1198,hunter,beastmastery,48,19,29
13572,Rypunzul,proudmoore,1196,hunter,beastmastery,24,13,11
13573,Ownyoufast,darkspear,1193,hunter,beastmastery,30,13,17
13574,Shootaids,illidan,1192,hunter,beastmastery,44,22,22
13575,Gaktog,area-52,1189,hunter,beastmastery,27,13,14
13576,Chetta,ragnaros,1187,hunter,beastmastery,66,28,38
13577,Kaxer,illidan,1182,hunter,beastmastery,65,33,32
13578,Genx,frostmane,1182,hunter,beastmastery,35,15,20
13579,Alaranel,kiljaeden,1181,hunter,beastmastery,48,20,28
13580,Shneedle,illidan,1180,hunter,beastmastery,54,22,32
13581,Thetrickyone,area-52,1180,hunter,beastmastery,52,20,32
13582,Aztrappin,illidan,1177,hunter,beastmastery,63,24,39
13583,Fixnoone,moon-guard,1176,hunter,beastmastery,38,18,20
13584,Warsh,anubarak,1173,hunter,beastmastery,34,19,15
13585,Tiraa,kelthuzad,1170,hunter,beastmastery,42,15,27
13586,Itsdoom,sargeras,1169,hunter,beastmastery,24,16,8
13587,Thiccshawts,moon-guard,1162,hunter,beastmastery,24,13,11
13588,Frenzyfire,whisperwind,1162,hunter,beastmastery,39,16,23
13589,Iffy,dentarg,1161,hunter,beastmastery,24,14,10
13590,Nightfal,emerald-dream,1158,hunter,beastmastery,42,15,27
13591,Arucedd,frostmourne,1156,hunter,beastmastery,59,25,34
13592,Chrønic,khadgar,1155,hunter,beastmastery,24,13,11
13593,Lustblitz,illidan,1152,hunter,beastmastery,18,12,6
13594,Wildlifezoo,tichondrius,1152,hunter,beastmastery,24,12,12
13595,Malvnfresh,tichondrius,1152,hunter,beastmastery,24,12,12
13596,Shot,shuhalo,1151,hunter,beastmastery,18,12,6
13597,Survenant,zuljin,1151,hunter,beastmastery,24,12,12
13598,Xorian,frostmourne,1151,hunter,beastmastery,24,12,12
13599,Urukkz,goldrinn,1151,hunter,beastmastery,24,12,12
13600,Fxsb,tichondrius,1151,hunter,beastmastery,30,12,18
13601,Shrian,illidan,1150,hunter,beastmastery,25,12,13
13602,Fanikita,azralon,1150,hunter,beastmastery,36,12,24
13603,Kroozeh,illidan,1149,hunter,beastmastery,24,12,12
13604,Squishasf,tichondrius,1148,hunter,beastmastery,18,12,6
13605,Topshunter,sargeras,1148,hunter,beastmastery,82,45,37
13606,Funnk,tichondrius,1148,hunter,beastmastery,24,12,12
13607,Sax,stormreaver,1147,hunter,beastmastery,24,12,12
13608,Puffcopeak,illidan,1147,hunter,beastmastery,24,12,12
13609,Suetyic,tichondrius,1147,hunter,beastmastery,24,12,12
13610,Yembohi,queldorei,1145,hunter,beastmastery,18,12,6
13611,Cuteorcgirl,sargeras,1145,hunter,beastmastery,38,15,23
13612,Ragnarlobkk,ragnaros,1144,hunter,beastmastery,148,71,77
13613,Dooper,malfurion,1141,hunter,beastmastery,30,12,18
13614,Nøtsurê,llane,1140,hunter,beastmastery,30,12,18
13615,Gratmuk,ragnaros,1139,hunter,beastmastery,30,12,18
13616,Floopze,burning-legion,1138,hunter,beastmastery,24,12,12
13617,Alwaysblazed,hyjal,1138,hunter,beastmastery,24,12,12
13618,Dyz,ragnaros,1137,hunter,beastmastery,28,13,15
13619,Karev,area-52,1134,hunter,beastmastery,24,12,12
13620,Blury,tichondrius,1131,hunter,beastmastery,29,13,16
13621,Blimpbooty,stormrage,1130,hunter,beastmastery,41,20,21
13622,Revö,area-52,1129,hunter,beastmastery,30,12,18
13623,Juicedhunter,tichondrius,1128,hunter,beastmastery,24,12,12
13624,Camperbill,borean-tundra,1127,hunter,beastmastery,25,14,11
13625,Huñté,stormrage,1127,hunter,beastmastery,24,12,12
13626,Kälec,quelthalas,1127,hunter,beastmastery,66,32,34
13627,Neverhunter,azralon,1127,hunter,beastmastery,30,13,17
13628,Xarmozao,nemesis,1127,hunter,beastmastery,39,14,25
13629,Qpoc,tichondrius,1120,hunter,beastmastery,44,20,24
13630,Mvpbunny,tichondrius,1117,hunter,beastmastery,46,21,25
13631,Exitwoundz,hyjal,1114,hunter,beastmastery,23,12,11
13632,Argent,altar-of-storms,1113,hunter,beastmastery,24,12,12
13633,Hetaya,haomarush,1111,hunter,beastmastery,93,41,52
13634,Brokenstars,illidan,1108,hunter,beastmastery,146,70,76
13635,Vegamax,illidan,1106,hunter,beastmastery,24,14,10
13636,Ukamau,ragnaros,1105,hunter,beastmastery,30,17,13
13637,Rhonishot,tichondrius,1104,hunter,beastmastery,43,15,28
13638,Merkidy,illidan,1099,hunter,beastmastery,17,12,5
13639,Arrowae,sargeras,1098,hunter,beastmastery,44,22,22
13640,Setepalms,azralon,1097,hunter,beastmastery,21,12,9
13641,Shmurda,duskwood,1095,hunter,beastmastery,94,37,57
13642,Omegalulzxd,kelthuzad,1092,hunter,beastmastery,105,45,60
13643,Funwell,dalaran,1090,hunter,beastmastery,29,14,15
13644,Zalyssavara,aerie-peak,1085,hunter,beastmastery,27,12,15
13645,Morenarösa,nemesis,1078,hunter,beastmastery,36,14,22
13646,Eithelleta,frostmourne,1078,hunter,beastmastery,48,18,30
13647,Quigfoot,area-52,1077,hunter,beastmastery,63,25,38
13648,Riivali,quelthalas,1076,hunter,beastmastery,59,23,36
13649,Buyaga,stormreaver,1073,hunter,beastmastery,72,37,35
13650,Brendenhunt,area-52,1071,hunter,beastmastery,17,12,5
13651,Dracð,malganis,1071,hunter,beastmastery,30,14,16
13652,Dadhatesme,stormrage,1066,hunter,beastmastery,27,12,15
13653,Hog,darkspear,1056,hunter,beastmastery,18,11,7
13654,Jawnhunter,tichondrius,1056,hunter,beastmastery,24,11,13
13655,Nodougaelark,dalaran,1056,hunter,beastmastery,24,11,13
13656,Prêd,malganis,1056,hunter,beastmastery,27,12,15
13657,Unicom,malganis,1056,hunter,beastmastery,30,11,19
13658,Darkoshuntar,tichondrius,1055,hunter,beastmastery,18,11,7
13659,Ryutiz,fizzcrank,1055,hunter,beastmastery,18,11,7
13660,Tashio,aerie-peak,1055,hunter,beastmastery,24,11,13
13661,Emmihunt,tichondrius,1055,hunter,beastmastery,24,11,13
13662,Undeadroach,tichondrius,1055,hunter,beastmastery,24,11,13
13663,Datadyne,stormrage,1054,hunter,beastmastery,12,11,1
13664,Selljzs,zuljin,1054,hunter,beastmastery,18,11,7
13665,Qlbl,tichondrius,1054,hunter,beastmastery,18,11,7
13666,Ispamtraps,emerald-dream,1054,hunter,beastmastery,18,11,7
13667,Anastasia,gorgonnash,1052,hunter,beastmastery,18,11,7
13668,Sagadegêmeos,stormrage,1052,hunter,beastmastery,30,11,19
13669,Asynic,blades-edge,1052,hunter,beastmastery,30,11,19
13670,Cummis,skullcrusher,1051,hunter,beastmastery,18,11,7
13671,Hohohohahah,gallywix,1051,hunter,beastmastery,30,11,19
13672,Lunarlunar,khadgar,1051,hunter,beastmastery,30,11,19
13673,Zünma,tichondrius,1050,hunter,beastmastery,24,11,13
13674,Gølin,aerie-peak,1049,hunter,beastmastery,30,11,19
13675,Memënto,barthilas,1049,hunter,beastmastery,30,11,19
13676,Freeside,emerald-dream,1048,hunter,beastmastery,18,11,7
13677,Wingclipped,kelthuzad,1048,hunter,beastmastery,18,11,7
13678,Computer,darkspear,1048,hunter,beastmastery,24,11,13
13679,ßaelon,malganis,1047,hunter,beastmastery,12,11,1
13680,Kynagidas,korgath,1047,hunter,beastmastery,24,11,13
13681,Vord,frostmourne,1046,hunter,beastmastery,24,11,13
13682,Conizle,sargeras,1045,hunter,beastmastery,24,11,13
13683,Cilnolm,moon-guard,1045,hunter,beastmastery,24,11,13
13684,Gandson,fizzcrank,1045,hunter,beastmastery,29,12,17
13685,Wogolas,barthilas,1044,hunter,beastmastery,18,11,7
13686,Youngteflon,bonechewer,1043,hunter,beastmastery,24,11,13
13687,Jijiyoyo,tichondrius,1041,hunter,beastmastery,41,13,28
13688,Zooker,tichondrius,1039,hunter,beastmastery,29,11,18
13689,Faldran,earthen-ring,1038,hunter,beastmastery,94,39,55
13690,Frenzygirl,azralon,1036,hunter,beastmastery,18,11,7
13691,More,khadgar,1035,hunter,beastmastery,30,11,19
13692,Vicluvv,stormrage,1034,hunter,beastmastery,23,11,12
13693,Hatteras,drakthul,1032,hunter,beastmastery,44,12,32
13694,Caytano,quelthalas,1031,hunter,beastmastery,24,15,9
13695,Erik,nemesis,1028,hunter,beastmastery,135,65,70
13696,Huntercry,ragnaros,1026,hunter,beastmastery,18,11,7
13697,Puhpsy,azralon,1024,hunter,beastmastery,42,24,18
13698,Robingear,baelgun,1024,hunter,beastmastery,123,58,65
13699,Elisen,frostmourne,1021,hunter,beastmastery,42,13,29
13700,Spitballa,emerald-dream,1020,hunter,beastmastery,28,11,17
13701,Bolbathefett,shadowsong,1020,hunter,beastmastery,30,11,19
13702,Taedulos,azralon,1019,hunter,beastmastery,36,19,17
13703,Fifie,azgalor,1011,hunter,beastmastery,31,12,19
13704,Jônathan,tichondrius,1010,hunter,beastmastery,18,11,7
13705,Hunterjim,tichondrius,1005,hunter,beastmastery,26,12,14
13706,Rairin,tichondrius,1004,hunter,beastmastery,65,33,32
13707,Sylriynn,moon-guard,1004,hunter,beastmastery,23,11,12
13708,Håwkeye,hyjal,1003,hunter,beastmastery,109,53,56
13709,Antihero,norgannon,1001,hunter,beastmastery,20,12,8
13710,Eddyholiday,tichondrius,1001,hunter,beastmastery,26,13,13
13711,Falesta,sargeras,999,hunter,beastmastery,28,12,16
13712,Flexxbow,thrall,994,hunter,beastmastery,23,13,10
13713,Robobrain,area-52,993,hunter,beastmastery,23,11,12
13714,Londen,tichondrius,987,hunter,beastmastery,30,15,15
13715,Onihanzo,thrall,987,hunter,beastmastery,25,12,13
13716,Zullypewpew,stormrage,982,hunter,beastmastery,17,11,6
13717,Brendie,thrall,973,hunter,beastmastery,166,76,90
13718,Dayneryz,quelthalas,971,hunter,beastmastery,32,11,21
13719,Erovianoria,silver-hand,968,hunter,beastmastery,57,29,28
13720,Maveraxx,executus,961,hunter,beastmastery,36,14,22
13721,Bliv,tichondrius,960,hunter,beastmastery,12,10,2
13722,Ahhpash,tichondrius,960,hunter,beastmastery,16,11,5
13723,Gööber,hyjal,960,hunter,beastmastery,18,10,8
13724,Dualp,tichondrius,960,hunter,beastmastery,18,10,8
13725,Sniperfx,lightbringer,960,hunter,beastmastery,18,10,8
13726,Wovow,tichondrius,960,hunter,beastmastery,18,10,8
13727,Worsthunt,tichondrius,960,hunter,beastmastery,18,10,8
13728,Yná,azralon,960,hunter,beastmastery,18,10,8
13729,Lilprimary,tichondrius,960,hunter,beastmastery,18,10,8
13730,Shinhyez,tichondrius,960,hunter,beastmastery,18,10,8
13731,Pumplum,kiljaeden,960,hunter,beastmastery,18,10,8
13732,Fishxxo,frostmourne,960,hunter,beastmastery,24,10,14
13733,Willdey,frostmourne,960,hunter,beastmastery,24,10,14
13734,Focús,laughing-skull,960,hunter,beastmastery,24,10,14
13735,Justforfunxx,tichondrius,960,hunter,beastmastery,30,10,20
13736,Rosebullets,bleeding-hollow,959,hunter,beastmastery,18,10,8
13737,Tmnarcanttv,tichondrius,959,hunter,beastmastery,18,10,8
13738,Geregaux,sargeras,959,hunter,beastmastery,18,10,8
13739,Evolushun,kiljaeden,959,hunter,beastmastery,21,11,10
13740,Stonehard,mugthol,959,hunter,beastmastery,24,10,14
13741,Cantcatchtin,tichondrius,959,hunter,beastmastery,24,10,14
13742,Yangthekhunt,tichondrius,959,hunter,beastmastery,24,10,14
13743,Vigon,stormrage,959,hunter,beastmastery,24,10,14
13744,Orgpopeyes,illidan,959,hunter,beastmastery,24,10,14
13745,Lrnb,tichondrius,959,hunter,beastmastery,24,10,14
13746,Huntfaceguy,agamaggan,959,hunter,beastmastery,24,10,14
13747,Leyliann,quelthalas,959,hunter,beastmastery,27,11,16
13748,Kimbaa,tichondrius,959,hunter,beastmastery,30,10,20
13749,Aquabat,wildhammer,958,hunter,beastmastery,18,10,8
13750,Quickfyre,stormrage,958,hunter,beastmastery,18,10,8
13751,Askelon,firetree,958,hunter,beastmastery,21,11,10
13752,Celarla,tichondrius,958,hunter,beastmastery,21,11,10
13753,Tazer,area-52,958,hunter,beastmastery,24,10,14
13754,Marexx,tichondrius,958,hunter,beastmastery,24,10,14
13755,Pafäcïle,tichondrius,958,hunter,beastmastery,24,10,14
13756,Imthaböss,nazjatar,957,hunter,beastmastery,23,10,13
13757,Tanarin,bleeding-hollow,957,hunter,beastmastery,24,10,14
13758,Mikly,ragnaros,957,hunter,beastmastery,24,10,14
13759,Terrygross,sargeras,957,hunter,beastmastery,24,10,14
13760,Sumom,darrowmere,957,hunter,beastmastery,44,18,26
13761,Littledougie,boulderfist,957,hunter,beastmastery,30,10,20
13762,Hyena,kelthuzad,955,hunter,beastmastery,24,10,14
13763,Piu,illidan,955,hunter,beastmastery,24,10,14
13764,Kaliaraan,bleeding-hollow,955,hunter,beastmastery,24,10,14
13765,Trim,tichondrius,954,hunter,beastmastery,18,10,8
13766,Murdaugh,icecrown,954,hunter,beastmastery,18,10,8
13767,Rocchettâ,kirin-tor,954,hunter,beastmastery,18,10,8
13768,Elyssandrá,thrall,954,hunter,beastmastery,24,10,14
13769,Deepcarver,tichondrius,954,hunter,beastmastery,24,10,14
13770,Gïzmo,malganis,953,hunter,beastmastery,18,10,8
13771,Rezkiin,tichondrius,953,hunter,beastmastery,18,10,8
13772,Rotokrim,emerald-dream,952,hunter,beastmastery,160,77,83
13773,Huntertimes,ragnaros,951,hunter,beastmastery,12,10,2
13774,Raikuu,skullcrusher,951,hunter,beastmastery,36,18,18
13775,Steelaeon,moon-guard,951,hunter,beastmastery,24,10,14
13776,Easypoacher,tichondrius,948,hunter,beastmastery,18,10,8
13777,Namikawa,stormrage,948,hunter,beastmastery,18,10,8
13778,Flacidhunter,kelthuzad,948,hunter,beastmastery,24,10,14
13779,Böuntyhuntêr,area-52,948,hunter,beastmastery,24,10,14
13780,ßaeløn,malganis,947,hunter,beastmastery,15,11,4
13781,Leaii,thrall,944,hunter,beastmastery,43,24,19
13782,Jezoo,frostmourne,937,hunter,beastmastery,30,10,20
13783,Shootyurshot,stormrage,927,hunter,beastmastery,20,11,9
13784,Finol,azralon,926,hunter,beastmastery,14,11,3
13785,Entrapment,emerald-dream,924,hunter,beastmastery,23,10,13
13786,Çhexmix,kiljaeden,910,hunter,beastmastery,15,10,5
13787,Actehón,ragnaros,909,hunter,beastmastery,36,18,18
13788,Thiccphat,sargeras,908,hunter,beastmastery,17,10,7
13789,Coyner,tichondrius,907,hunter,beastmastery,21,10,11
13790,Wael,perenolde,905,hunter,beastmastery,17,10,7
13791,Glizzys,cairne,904,hunter,beastmastery,29,12,17
13792,Saltz,tichondrius,901,hunter,beastmastery,21,11,10
13793,Loktarnum,illidan,894,hunter,beastmastery,20,10,10
13794,Ketulirantle,azralon,891,hunter,beastmastery,46,13,33
13795,Foh,kelthuzad,888,hunter,beastmastery,17,10,7
13796,Wkg,azgalor,886,hunter,beastmastery,18,10,8
13797,Naestrá,bleeding-hollow,864,hunter,beastmastery,12,9,3
13798,Huntations,sargeras,864,hunter,beastmastery,12,9,3
13799,Lubze,bleeding-hollow,864,hunter,beastmastery,12,9,3
13800,Bmhuntlol,illidan,864,hunter,beastmastery,12,9,3
13801,Slipox,sargeras,864,hunter,beastmastery,12,9,3
13802,Petattack,barthilas,864,hunter,beastmastery,12,9,3
13803,Lilsynchfyb,sargeras,864,hunter,beastmastery,18,9,9
13804,Yatyegatchun,illidan,864,hunter,beastmastery,18,9,9
13805,Nflmaster,malganis,864,hunter,beastmastery,18,9,9
13806,Deutêr,quelthalas,864,hunter,beastmastery,18,9,9
13807,Zizilio,kelthuzad,864,hunter,beastmastery,18,9,9
13808,Airlol,tichondrius,864,hunter,beastmastery,18,9,9
13809,Flor,boulderfist,864,hunter,beastmastery,18,9,9
13810,Déwi,tichondrius,864,hunter,beastmastery,18,9,9
13811,Xbloody,tichondrius,864,hunter,beastmastery,18,9,9
13812,Esstark,bleeding-hollow,864,hunter,beastmastery,18,9,9
13813,Hagadinn,frostmourne,864,hunter,beastmastery,18,9,9
13814,Balrröt,malganis,864,hunter,beastmastery,24,9,15
13815,Dirtyytroll,area-52,864,hunter,beastmastery,24,9,15
13816,Arteene,illidan,864,hunter,beastmastery,24,9,15
13817,Scurvypete,perenolde,864,hunter,beastmastery,24,9,15
13818,Katiepie,frostmourne,864,hunter,beastmastery,30,9,21
13819,Reic,kiljaeden,863,hunter,beastmastery,15,10,5
13820,Twoshotzz,darkspear,863,hunter,beastmastery,15,10,5
13821,Khels,stormreaver,863,hunter,beastmastery,16,10,6
13822,Jamzlol,frostmourne,863,hunter,beastmastery,18,9,9
13823,Nikronos,quelthalas,863,hunter,beastmastery,18,9,9
13824,Hendó,korgath,863,hunter,beastmastery,18,9,9
13825,Snowjin,stormrage,863,hunter,beastmastery,18,9,9
13826,Viral,grizzly-hills,863,hunter,beastmastery,18,9,9
13827,Tethro,zuljin,863,hunter,beastmastery,18,9,9
13828,Drivebyjuju,dentarg,863,hunter,beastmastery,18,9,9
13829,Booffmeister,area-52,863,hunter,beastmastery,18,9,9
13830,Akoshi,illidan,863,hunter,beastmastery,18,9,9
13831,Xernen,thrall,863,hunter,beastmastery,18,9,9
13832,Tarah,lightbringer,863,hunter,beastmastery,24,9,15
13833,Nubberton,sargeras,863,hunter,beastmastery,24,9,15
13834,Bleedwish,tichondrius,863,hunter,beastmastery,31,9,22
13835,Seáhawk,kiljaeden,862,hunter,beastmastery,12,9,3
13836,Loriandel,proudmoore,862,hunter,beastmastery,14,9,5
13837,Strongene,aegwynn,862,hunter,beastmastery,18,9,9
13838,Kinete,proudmoore,862,hunter,beastmastery,18,9,9
13839,Qúin,frostmourne,862,hunter,beastmastery,18,9,9
13840,Toross,stormscale,862,hunter,beastmastery,18,9,9
13841,Puppe,sargeras,862,hunter,beastmastery,21,10,11
13842,Hawkeye,boulderfist,862,hunter,beastmastery,24,9,15
13843,Artemisa,warsong,862,hunter,beastmastery,24,9,15
13844,Korasaurus,tichondrius,861,hunter,beastmastery,12,9,3
13845,Hrodvitnir,quelthalas,861,hunter,beastmastery,24,9,15
13846,Exotichunter,the-underbog,861,hunter,beastmastery,24,9,15
13847,Trápngap,barthilas,861,hunter,beastmastery,24,9,15
13848,Jahir,tichondrius,860,hunter,beastmastery,18,9,9
13849,Goinghuntin,frostmourne,859,hunter,beastmastery,18,9,9
13850,Xeriife,stormrage,858,hunter,beastmastery,19,9,10
13851,Chuphunts,tichondrius,857,hunter,beastmastery,12,9,3
13852,Vexxør,bleeding-hollow,856,hunter,beastmastery,18,9,9
13853,Kalekros,tichondrius,856,hunter,beastmastery,30,9,21
13854,Galerius,illidan,855,hunter,beastmastery,30,9,21
13855,Sagittarion,malfurion,854,hunter,beastmastery,19,10,9
13856,Shiztec,malganis,854,hunter,beastmastery,24,9,15
13857,Hunterdps,gurubashi,851,hunter,beastmastery,18,9,9
13858,Survival,dentarg,851,hunter,beastmastery,24,9,15
13859,Eggsquatch,emerald-dream,844,hunter,beastmastery,12,9,3
13860,Noahxkhalel,azralon,832,hunter,beastmastery,29,9,20
13861,Åspect,aegwynn,831,hunter,beastmastery,17,9,8
13862,Spunky,zuluhed,830,hunter,beastmastery,17,9,8
13863,Flamenco,arthas,830,hunter,beastmastery,17,9,8
13864,Vastiks,dalaran,829,hunter,beastmastery,26,9,17
13865,Coletrickle,chogall,822,hunter,beastmastery,32,10,22
13866,Monatre,fizzcrank,816,hunter,beastmastery,21,9,12
13867,Rawspits,kiljaeden,814,hunter,beastmastery,29,9,20
13868,Vyalaris,emerald-dream,813,hunter,beastmastery,21,9,12
13869,Smallsouljah,demon-soul,810,hunter,beastmastery,21,9,12
13870,Trianthel,azralon,803,hunter,beastmastery,18,10,8
13871,Bagurgur,tichondrius,799,hunter,beastmastery,16,9,7
13872,Jonyvi,stormrage,798,hunter,beastmastery,19,10,9
13873,Anya,proudmoore,789,hunter,beastmastery,36,13,23
13874,Puns,stormreaver,768,hunter,beastmastery,12,8,4
13875,Meshunt,tichondrius,768,hunter,beastmastery,12,8,4
13876,Ogstrutt,zuljin,768,hunter,beastmastery,12,8,4
13877,Bowzørx,tichondrius,768,hunter,beastmastery,12,8,4
13878,Seljzs,zuljin,768,hunter,beastmastery,12,8,4
13879,Chippendales,illidan,768,hunter,beastmastery,12,8,4
13880,Jsrhuntz,sargeras,768,hunter,beastmastery,12,8,4
13881,Flub,shadow-council,768,hunter,beastmastery,12,8,4
13882,Turbows,proudmoore,768,hunter,beastmastery,12,8,4
13883,Urukah,gallywix,768,hunter,beastmastery,18,8,10
13884,Yonzo,area-52,768,hunter,beastmastery,18,8,10
13885,Tigglyjits,tichondrius,768,hunter,beastmastery,18,8,10
13886,Heädshöt,malorne,768,hunter,beastmastery,18,8,10
13887,Kolosaltraps,tichondrius,768,hunter,beastmastery,18,8,10
13888,Oblitus,zuljin,768,hunter,beastmastery,18,8,10
13889,Kellsier,nordrassil,768,hunter,beastmastery,18,8,10
13890,Ddukgue,tichondrius,768,hunter,beastmastery,18,8,10
13891,Bicas,emerald-dream,768,hunter,beastmastery,18,8,10
13892,Teammatescba,tichondrius,768,hunter,beastmastery,18,8,10
13893,Seongnam,tichondrius,768,hunter,beastmastery,18,8,10
13894,Trapordíe,tichondrius,768,hunter,beastmastery,18,8,10
13895,Katherìnelol,tichondrius,768,hunter,beastmastery,21,9,12
13896,Aamoody,bloodhoof,768,hunter,beastmastery,24,8,16
13897,Flacidpasta,sargeras,767,hunter,beastmastery,12,8,4
13898,Remièl,frostmourne,767,hunter,beastmastery,12,8,4
13899,Hackerman,tichondrius,767,hunter,beastmastery,12,8,4
13900,Cxnt,saurfang,767,hunter,beastmastery,15,9,6
13901,Gorgoon,sargeras,767,hunter,beastmastery,16,9,7
13902,Morbow,proudmoore,767,hunter,beastmastery,18,8,10
13903,Bowjingles,blackrock,767,hunter,beastmastery,18,8,10
13904,Thehunturd,dalaran,767,hunter,beastmastery,18,8,10
13905,Picapaul,stormrage,767,hunter,beastmastery,18,8,10
13906,Jesselos,stormrage,767,hunter,beastmastery,18,8,10
13907,Flîp,daggerspine,767,hunter,beastmastery,18,8,10
13908,Jímmycorn,sargeras,767,hunter,beastmastery,18,8,10
13909,Zephanno,sargeras,767,hunter,beastmastery,18,8,10
13910,Raphgun,stormrage,767,hunter,beastmastery,18,8,10
13911,Brickgrimes,illidan,767,hunter,beastmastery,19,8,11
13912,Lûrtz,aegwynn,767,hunter,beastmastery,21,8,13
13913,Folf,turalyon,767,hunter,beastmastery,24,8,16
13914,Blanar,quelthalas,767,hunter,beastmastery,30,8,22
13915,Laudion,quelthalas,766,hunter,beastmastery,12,8,4
13916,Traps,deathwing,766,hunter,beastmastery,18,8,10
13917,Atheranni,azralon,766,hunter,beastmastery,18,8,10
13918,Satours,quelthalas,766,hunter,beastmastery,18,8,10
13919,Hideontrap,malganis,766,hunter,beastmastery,18,8,10
13920,Thirtyeight,blades-edge,766,hunter,beastmastery,18,8,10
13921,Byrdh,zuljin,766,hunter,beastmastery,21,9,12
13922,Crumpit,moon-guard,766,hunter,beastmastery,27,8,19
13923,Calbone,stormrage,765,hunter,beastmastery,12,8,4
13924,Ivix,sargeras,765,hunter,beastmastery,12,8,4
13925,Handicrap,tichondrius,765,hunter,beastmastery,16,9,7
13926,Hunt,akama,765,hunter,beastmastery,24,8,16
13927,Gigawrench,darkspear,763,hunter,beastmastery,12,8,4
13928,Skarioth,azralon,763,hunter,beastmastery,18,8,10
13929,Grøøves,dalaran,763,hunter,beastmastery,18,8,10
13930,Ashantii,hakkar,762,hunter,beastmastery,12,8,4
13931,Shamtus,bladefist,762,hunter,beastmastery,12,8,4
13932,Halberick,quelthalas,762,hunter,beastmastery,12,8,4
13933,Jayker,illidan,762,hunter,beastmastery,12,8,4
13934,Werekluetus,sargeras,762,hunter,beastmastery,18,8,10
13935,Élmérfudd,tichondrius,762,hunter,beastmastery,24,8,16
13936,Bakharnabi,azralon,760,hunter,beastmastery,18,8,10
13937,Ophiela,shuhalo,759,hunter,beastmastery,36,8,28
13938,Shikago,wyrmrest-accord,758,hunter,beastmastery,24,8,16
13939,Massivattack,skullcrusher,758,hunter,beastmastery,24,8,16
13940,Blankshot,doomhammer,757,hunter,beastmastery,18,8,10
13941,Bblsallday,illidan,754,hunter,beastmastery,12,8,4
13942,Androki,stormrage,752,hunter,beastmastery,12,8,4
13943,Raevenah,dalaran,747,hunter,beastmastery,12,8,4
13944,Stimpblimp,jubeithos,736,hunter,beastmastery,16,8,8
13945,Vendortrash,aggramar,733,hunter,beastmastery,17,8,9
13946,Timberex,drenden,715,hunter,beastmastery,15,8,7
13947,Kysii,burning-blade,714,hunter,beastmastery,21,8,13
13948,Cloxygen,moon-guard,713,hunter,beastmastery,22,9,13
13949,Popster,cenarius,704,hunter,beastmastery,16,8,8
13950,Plastera,zuljin,704,hunter,beastmastery,28,8,20
13951,Petpenguin,kelthuzad,703,hunter,beastmastery,11,8,3
13952,Yozomoto,nordrassil,703,hunter,beastmastery,14,8,6
13953,Jinchuriki,shadow-council,703,hunter,beastmastery,28,8,20
13954,Snoozee,emerald-dream,702,hunter,beastmastery,20,8,12
13955,Pheijaumn,azralon,687,hunter,beastmastery,13,8,5
13956,Mylaqt,malganis,672,hunter,beastmastery,12,7,5
13957,Sakedji,area-52,672,hunter,beastmastery,12,7,5
13958,Snapyaf,area-52,672,hunter,beastmastery,12,7,5
13959,Mehontar,area-52,672,hunter,beastmastery,12,7,5
13960,Alfentanil,thrall,672,hunter,beastmastery,12,7,5
13961,Akirarika,wyrmrest-accord,672,hunter,beastmastery,12,7,5
13962,Mauiies,sargeras,672,hunter,beastmastery,12,7,5
13963,Yolotraps,thrall,672,hunter,beastmastery,12,7,5
13964,Pmø,sargeras,672,hunter,beastmastery,12,7,5
13965,Gotrap,saurfang,672,hunter,beastmastery,12,7,5
13966,Gentledream,dalaran,672,hunter,beastmastery,12,7,5
13967,Wellerman,firetree,672,hunter,beastmastery,12,7,5
13968,Gunbladez,burning-blade,672,hunter,beastmastery,12,7,5
13969,Litchi,illidan,672,hunter,beastmastery,12,7,5
13970,Mhters,tichondrius,672,hunter,beastmastery,12,7,5
13971,Starkhaven,firetree,672,hunter,beastmastery,12,7,5
13972,Cumman,sargeras,672,hunter,beastmastery,12,7,5
13973,Handmemygun,aggramar,672,hunter,beastmastery,12,7,5
13974,Gun,shadowsong,672,hunter,beastmastery,12,7,5
13975,Balldik,bleeding-hollow,672,hunter,beastmastery,12,7,5
13976,Barainto,tichondrius,672,hunter,beastmastery,12,7,5
13977,Skippyh,zuluhed,672,hunter,beastmastery,12,7,5
13978,Xerosa,emerald-dream,672,hunter,beastmastery,12,7,5
13979,Snowmnz,tichondrius,672,hunter,beastmastery,12,7,5
13980,Downor,malganis,672,hunter,beastmastery,12,7,5
13981,Jsr,tichondrius,672,hunter,beastmastery,12,7,5
13982,Grannygatya,tichondrius,672,hunter,beastmastery,12,7,5
13983,Jawnhunterii,tichondrius,672,hunter,beastmastery,12,7,5
13984,Buzzkilla,mannoroth,672,hunter,beastmastery,12,7,5
13985,Cinnybunz,malganis,672,hunter,beastmastery,12,7,5
13986,Crimsoncoast,tichondrius,672,hunter,beastmastery,12,7,5
13987,Csantana,sargeras,672,hunter,beastmastery,12,7,5
13988,Hollowhunt,sentinels,672,hunter,beastmastery,12,7,5
13989,Beabalm,dalaran,672,hunter,beastmastery,12,7,5
13990,Tusxx,tichondrius,672,hunter,beastmastery,12,7,5
13991,Shaytime,proudmoore,672,hunter,beastmastery,16,8,8
13992,Houdan,frostmourne,672,hunter,beastmastery,16,7,9
13993,Ðevil,ragnaros,672,hunter,beastmastery,18,7,11
13994,Souperman,malganis,672,hunter,beastmastery,18,7,11
13995,Sylpheous,bleeding-hollow,672,hunter,beastmastery,18,7,11
13996,Geeshot,area-52,672,hunter,beastmastery,18,7,11
13997,Joerogan,hydraxis,672,hunter,beastmastery,18,7,11
13998,Chunco,ragnaros,672,hunter,beastmastery,18,7,11
13999,Antares,dalaran,672,hunter,beastmastery,18,7,11
14000,Dreagneal,ragnaros,672,hunter,beastmastery,18,7,11
14001,Clowntown,illidan,672,hunter,beastmastery,18,7,11
14002,Sunsinfour,proudmoore,672,hunter,beastmastery,24,7,17
14003,Titanaxis,tichondrius,672,hunter,beastmastery,24,7,17
14004,Melinda,kilrogg,671,hunter,beastmastery,12,7,5
14005,Anniefuchsia,stormrage,671,hunter,beastmastery,12,7,5
14006,Winzip,whisperwind,671,hunter,beastmastery,12,7,5
14007,Scrubmastery,emerald-dream,671,hunter,beastmastery,12,7,5
14008,Pillarington,tichondrius,671,hunter,beastmastery,12,7,5
14009,Valintine,the-scryers,671,hunter,beastmastery,12,7,5
14010,Mannypew,kelthuzad,671,hunter,beastmastery,12,7,5
14011,Deadlyarrows,ragnaros,671,hunter,beastmastery,12,7,5
14012,Minkô,tichondrius,671,hunter,beastmastery,12,7,5
14013,Óriion,zuljin,671,hunter,beastmastery,12,7,5
14014,Jendell,area-52,671,hunter,beastmastery,12,7,5
14015,Spunkked,tichondrius,671,hunter,beastmastery,12,7,5
14016,Exploits,stormrage,671,hunter,beastmastery,12,7,5
14017,Lavo,borean-tundra,671,hunter,beastmastery,12,7,5
14018,Wook,hyjal,671,hunter,beastmastery,12,7,5
14019,Beardedeagle,tichondrius,671,hunter,beastmastery,15,8,7
14020,Shdwhntrclub,wyrmrest-accord,671,hunter,beastmastery,18,7,11
14021,Heylenny,area-52,671,hunter,beastmastery,18,7,11
14022,Threethirty,thrall,671,hunter,beastmastery,18,7,11
14023,Nephewblasty,nagrand,671,hunter,beastmastery,18,7,11
14024,Peiching,proudmoore,671,hunter,beastmastery,18,7,11
14025,Mooséhunt,wyrmrest-accord,671,hunter,beastmastery,18,7,11
14026,Genowin,sargeras,671,hunter,beastmastery,18,7,11
14027,Amortiz,illidan,671,hunter,beastmastery,18,7,11
14028,Cotó,stormrage,671,hunter,beastmastery,18,7,11
14029,Ratfood,tichondrius,671,hunter,beastmastery,23,7,16
14030,Enigmer,area-52,670,hunter,beastmastery,12,7,5
14031,Yanzz,spinebreaker,670,hunter,beastmastery,12,7,5
14032,Bittitan,frostmourne,670,hunter,beastmastery,12,7,5
14033,Topgun,laughing-skull,670,hunter,beastmastery,12,7,5
14034,Madness,zuljin,670,hunter,beastmastery,12,7,5
14035,Myrfes,ragnaros,670,hunter,beastmastery,18,7,11
14036,Fawn,moon-guard,670,hunter,beastmastery,18,7,11
14037,Spaeth,borean-tundra,670,hunter,beastmastery,24,7,17
14038,Aybeara,area-52,669,hunter,beastmastery,18,7,11
14039,Fynnigan,shandris,669,hunter,beastmastery,18,7,11
14040,Neurosurgery,azralon,669,hunter,beastmastery,18,7,11
14041,Terusa,ragnaros,667,hunter,beastmastery,24,7,17
14042,Strafenshoot,darkspear,666,hunter,beastmastery,12,7,5
14043,Badboyzcry,deathwing,666,hunter,beastmastery,12,7,5
14044,Eastera,tichondrius,663,hunter,beastmastery,27,8,19
14045,Cbramatacera,drakkari,661,hunter,beastmastery,12,7,5
14046,Ruthgarth,akama,661,hunter,beastmastery,18,7,11
14047,Theprovider,burning-blade,659,hunter,beastmastery,12,7,5
14048,Benryats,area-52,657,hunter,beastmastery,21,8,13
14049,Legendhunter,quelthalas,655,hunter,beastmastery,12,8,4
14050,Lyduc,barthilas,655,hunter,beastmastery,17,7,10
14051,Pewpew,gallywix,649,hunter,beastmastery,23,7,16
14052,Boomsprocket,khazgoroth,639,hunter,beastmastery,8,8,0
14053,Hikkupz,tichondrius,639,hunter,beastmastery,17,7,10
14054,Hawkkeye,thunderlord,639,hunter,beastmastery,17,7,10
14055,Scaredcrow,azshara,639,hunter,beastmastery,28,7,21
14056,Sleepywrld,area-52,638,hunter,beastmastery,17,7,10
14057,Hunbatz,dalaran,634,hunter,beastmastery,19,9,10
14058,Árescarries,shuhalo,623,hunter,beastmastery,15,7,8
14059,Ashx,nemesis,623,hunter,beastmastery,17,7,10
14060,Lieolaste,area-52,618,hunter,beastmastery,17,7,10
14061,Danion,aerie-peak,607,hunter,beastmastery,16,7,9
14062,Supdawg,aggramar,607,hunter,beastmastery,17,7,10
14063,Shootdogg,mannoroth,607,hunter,beastmastery,20,7,13
14064,Shanghunt,cenarius,604,hunter,beastmastery,14,7,7
14065,Oshosiwar,ragnaros,588,hunter,beastmastery,21,7,14
14066,Igotapvpness,tichondrius,576,hunter,beastmastery,6,6,0
14067,Drwíggles,smolderthorn,576,hunter,beastmastery,6,6,0
14068,Rekkis,area-52,576,hunter,beastmastery,6,6,0
14069,Gassmask,area-52,576,hunter,beastmastery,6,6,0
14070,Jjaro,area-52,576,hunter,beastmastery,6,6,0
14071,Píps,maelstrom,576,hunter,beastmastery,6,6,0
14072,Shøz,wyrmrest-accord,576,hunter,beastmastery,12,6,6
14073,Jonah,sargeras,576,hunter,beastmastery,12,6,6
14074,Jagare,tichondrius,576,hunter,beastmastery,12,6,6
14075,Thoridhal,quelthalas,576,hunter,beastmastery,12,6,6
14076,Ordius,azralon,576,hunter,beastmastery,12,6,6
14077,Raadun,terokkar,576,hunter,beastmastery,12,6,6
14078,Hunterpk,lightbringer,576,hunter,beastmastery,12,6,6
14079,Zookeepah,tichondrius,576,hunter,beastmastery,12,6,6
14080,Khanittus,area-52,576,hunter,beastmastery,12,6,6
14081,Ahncheolsoo,tichondrius,576,hunter,beastmastery,12,6,6
14082,Jalinhabbei,azralon,576,hunter,beastmastery,12,6,6
14083,Toniic,moon-guard,576,hunter,beastmastery,12,6,6
14084,Despise,frostmourne,576,hunter,beastmastery,12,6,6
14085,Invisabootz,hyjal,576,hunter,beastmastery,12,6,6
14086,Pikabow,tichondrius,576,hunter,beastmastery,12,6,6
14087,Recklaw,frostmourne,576,hunter,beastmastery,12,6,6
14088,Ærês,ysondre,576,hunter,beastmastery,12,6,6
14089,Thebush,dragonmaw,576,hunter,beastmastery,12,6,6
14090,Retaâáàäãart,tichondrius,576,hunter,beastmastery,12,6,6
14091,Alochol,vashj,576,hunter,beastmastery,12,6,6
14092,Orqism,tichondrius,576,hunter,beastmastery,12,6,6
14093,Huntncheekz,kelthuzad,576,hunter,beastmastery,12,6,6
14094,Vindication,ysera,576,hunter,beastmastery,12,6,6
14095,Tangoda,tichondrius,576,hunter,beastmastery,12,6,6
14096,Jboogie,malganis,576,hunter,beastmastery,12,6,6
14097,Evilblammo,thorium-brotherhood,576,hunter,beastmastery,12,6,6
14098,Jockitch,wildhammer,576,hunter,beastmastery,12,6,6
14099,Drdill,gorefiend,576,hunter,beastmastery,12,6,6
14100,Peregrin,burning-legion,576,hunter,beastmastery,12,6,6
14101,Dbrickashaw,proudmoore,576,hunter,beastmastery,12,6,6
14102,Hxnry,barthilas,576,hunter,beastmastery,12,6,6
14103,Somethinglit,sargeras,576,hunter,beastmastery,12,6,6
14104,Spottedoger,burning-legion,576,hunter,beastmastery,12,6,6
14105,Actioh,stormrage,576,hunter,beastmastery,12,6,6
14106,Raerdun,bonechewer,576,hunter,beastmastery,12,6,6
14107,Balboa,tortheldrin,576,hunter,beastmastery,12,6,6
14108,Daylilycoast,emerald-dream,576,hunter,beastmastery,12,6,6
14109,Jwzz,tichondrius,576,hunter,beastmastery,12,6,6
14110,Gennaro,ragnaros,576,hunter,beastmastery,12,6,6
14111,Huntard,stormrage,576,hunter,beastmastery,12,6,6
14112,Nytefell,skullcrusher,576,hunter,beastmastery,12,6,6
14113,Wongy,tichondrius,576,hunter,beastmastery,12,6,6
14114,Gravshot,zuljin,576,hunter,beastmastery,12,6,6
14115,Zertkal,undermine,576,hunter,beastmastery,12,6,6
14116,Wapnonymous,mugthol,576,hunter,beastmastery,12,6,6
14117,Skyfel,aggramar,576,hunter,beastmastery,12,6,6
14118,Zeedii,dalaran,576,hunter,beastmastery,12,6,6
14119,Robitur,sargeras,576,hunter,beastmastery,12,6,6
14120,Kånade,ragnaros,576,hunter,beastmastery,12,6,6
14121,Fma,stormrage,576,hunter,beastmastery,12,6,6
14122,Bloodymalik,tichondrius,576,hunter,beastmastery,12,6,6
14123,Kyoü,drakkari,576,hunter,beastmastery,12,6,6
14124,Shyck,ragnaros,576,hunter,beastmastery,12,6,6
14125,Misakilr,illidan,576,hunter,beastmastery,13,6,7
14126,Arraza,ragnaros,576,hunter,beastmastery,16,7,9
14127,Ljai,gilneas,576,hunter,beastmastery,18,6,12
14128,Nishinos,tichondrius,576,hunter,beastmastery,18,6,12
14129,Kanta,bleeding-hollow,576,hunter,beastmastery,18,6,12
14130,Mørødox,sargeras,576,hunter,beastmastery,18,6,12
14131,Virgim,kelthuzad,576,hunter,beastmastery,18,6,12
14132,Pieman,azuremyst,576,hunter,beastmastery,18,6,12
14133,Bighuntz,bleeding-hollow,576,hunter,beastmastery,24,6,18
14134,Sniffler,barthilas,576,hunter,beastmastery,24,6,18
14135,Yolloswag,tichondrius,576,hunter,beastmastery,24,6,18
14136,Beastbaal,sargeras,576,hunter,beastmastery,24,6,18
14137,Lulafourdedo,stormrage,575,hunter,beastmastery,7,6,1
14138,Noitrag,azralon,575,hunter,beastmastery,11,6,5
14139,Míbu,lightbringer,575,hunter,beastmastery,12,6,6
14140,Mindbreaker,illidan,575,hunter,beastmastery,12,6,6
14141,Gammaraven,dalaran,575,hunter,beastmastery,12,6,6
14142,Drimhuzzah,velen,575,hunter,beastmastery,12,6,6
14143,Eastwake,stormrage,575,hunter,beastmastery,12,6,6
14144,Recoyl,proudmoore,575,hunter,beastmastery,12,6,6
14145,Ovî,area-52,575,hunter,beastmastery,12,6,6
14146,Burtone,aegwynn,575,hunter,beastmastery,12,6,6
14147,Wdb,tichondrius,575,hunter,beastmastery,12,6,6
14148,Yobby,area-52,575,hunter,beastmastery,12,6,6
14149,Fireshots,tichondrius,575,hunter,beastmastery,12,6,6
14150,Gwarnar,stormrage,575,hunter,beastmastery,12,6,6
14151,Asuryakha,darkspear,575,hunter,beastmastery,12,6,6
14152,Jayken,gnomeregan,575,hunter,beastmastery,12,6,6
14153,Rankhor,darkspear,575,hunter,beastmastery,12,6,6
14154,Sabanna,proudmoore,575,hunter,beastmastery,12,6,6
14155,Horsegirl,chogall,575,hunter,beastmastery,12,6,6
14156,Galadrieel,magtheridon,575,hunter,beastmastery,18,6,12
14157,Aliciaomg,andorhal,575,hunter,beastmastery,18,6,12
14158,Balsagoth,azralon,575,hunter,beastmastery,18,6,12
14159,Mouthymerc,zuljin,575,hunter,beastmastery,18,6,12
14160,Tozier,destromath,575,hunter,beastmastery,18,6,12
14161,Camorcaist,stormrage,575,hunter,beastmastery,18,6,12
14162,Chimpx,moon-guard,575,hunter,beastmastery,18,6,12
14163,Trionias,malfurion,575,hunter,beastmastery,24,6,18
14164,Arcticuz,aegwynn,574,hunter,beastmastery,12,6,6
14165,Nekrongar,agamaggan,574,hunter,beastmastery,12,6,6
14166,Kalibah,azralon,574,hunter,beastmastery,18,6,12
14167,Sapphie,frostmourne,574,hunter,beastmastery,24,6,18
14168,Rikitiki,bleeding-hollow,573,hunter,beastmastery,12,6,6
14169,Foffy,darkspear,573,hunter,beastmastery,12,6,6
14170,Elfinballz,khadgar,573,hunter,beastmastery,18,6,12
14171,Dakirell,drakkari,573,hunter,beastmastery,18,6,12
14172,Dethh,dunemaul,572,hunter,beastmastery,12,6,6
14173,Drpenatrator,barthilas,572,hunter,beastmastery,12,6,6
14174,Pewpewd,tichondrius,572,hunter,beastmastery,12,6,6
14175,Dragonman,grizzly-hills,572,hunter,beastmastery,30,6,24
14176,Katmang,frostmourne,571,hunter,beastmastery,18,6,12
14177,Speirs,tichondrius,570,hunter,beastmastery,18,6,12
14178,Daréz,blackrock,569,hunter,beastmastery,19,8,11
14179,Kargathx,ragnaros,569,hunter,beastmastery,20,8,12
14180,Bluehead,emerald-dream,566,hunter,beastmastery,12,6,6
14181,Skullgrain,eitrigg,559,hunter,beastmastery,17,6,11
14182,Parâsite,kelthuzad,559,hunter,beastmastery,23,6,17
14183,Jîa,tichondrius,544,hunter,beastmastery,16,6,10
14184,Squeeb,frostmourne,543,hunter,beastmastery,14,7,7
14185,Habanero,anetheron,543,hunter,beastmastery,14,7,7
14186,Tezlekhan,haomarush,543,hunter,beastmastery,17,6,11
14187,Viserysll,azralon,542,hunter,beastmastery,11,6,5
14188,Trycen,bleeding-hollow,527,hunter,beastmastery,11,6,5
14189,Rachetbutt,tichondrius,527,hunter,beastmastery,11,6,5
14190,Pikepounder,tichondrius,527,hunter,beastmastery,15,6,9
14191,Socrato,tichondrius,526,hunter,beastmastery,11,6,5
14192,Ataxyus,area-52,512,hunter,beastmastery,10,6,4
14193,Bowjobs,stormscale,511,hunter,beastmastery,14,6,8
14194,Aluminumfoil,kelthuzad,510,hunter,beastmastery,11,6,5
14195,Bagodonuts,malganis,510,hunter,beastmastery,17,7,10
14196,Malthiz,antonidas,507,hunter,beastmastery,22,8,14
14197,Jackcoügh,frostmourne,496,hunter,beastmastery,13,6,7
14198,Zock,lothar,494,hunter,beastmastery,19,6,13
14199,Zansnipes,dalaran,480,hunter,beastmastery,6,5,1
14200,Tukki,quelthalas,480,hunter,beastmastery,6,5,1
14201,Unloaded,illidan,480,hunter,beastmastery,6,5,1
14202,Oeoeoeoeoeoe,alterac-mountains,480,hunter,beastmastery,6,5,1
14203,Bluez,tichondrius,480,hunter,beastmastery,6,5,1
14204,Cojáx,dalaran,480,hunter,beastmastery,6,5,1
14205,Slêv,frostmourne,480,hunter,beastmastery,6,5,1
14206,Hitx,tichondrius,480,hunter,beastmastery,6,5,1
14207,Laoai,tichondrius,480,hunter,beastmastery,6,5,1
14208,Nsjp,darkspear,480,hunter,beastmastery,6,5,1
14209,Añtø,tichondrius,480,hunter,beastmastery,6,5,1
14210,Traptrinket,sargeras,480,hunter,beastmastery,6,5,1
14211,Berkhof,tichondrius,480,hunter,beastmastery,6,5,1
14212,Linkolnn,sargeras,480,hunter,beastmastery,6,5,1
14213,Plsnobanmee,frostmourne,480,hunter,beastmastery,6,5,1
14214,Yajr,black-dragonflight,480,hunter,beastmastery,6,5,1
14215,Brokensnipez,area-52,480,hunter,beastmastery,6,5,1
14216,Wopper,moon-guard,480,hunter,beastmastery,6,5,1
14217,Arrebol,tichondrius,480,hunter,beastmastery,6,5,1
14218,Tèrrabite,sargeras,480,hunter,beastmastery,6,5,1
14219,Chimeralol,area-52,480,hunter,beastmastery,6,5,1
14220,Nokda,tichondrius,480,hunter,beastmastery,6,5,1
14221,Darylovejr,destromath,480,hunter,beastmastery,6,5,1
14222,Kkoduckk,tichondrius,480,hunter,beastmastery,6,5,1
14223,Arthäsxd,azralon,480,hunter,beastmastery,6,5,1
14224,Dankshunt,arthas,480,hunter,beastmastery,6,5,1
14225,Megahuntard,bleeding-hollow,480,hunter,beastmastery,6,5,1
14226,Airoh,gorefiend,480,hunter,beastmastery,10,6,4
14227,Grizmin,sargeras,480,hunter,beastmastery,12,5,7
14228,Skillvanas,stormrage,480,hunter,beastmastery,12,5,7
14229,Sunflwerdawn,emerald-dream,480,hunter,beastmastery,12,5,7
14230,Lissavi,tichondrius,480,hunter,beastmastery,12,5,7
14231,Drakku,zuljin,480,hunter,beastmastery,12,5,7
14232,Wønky,stormrage,480,hunter,beastmastery,12,5,7
14233,Imperatrix,emerald-dream,480,hunter,beastmastery,12,5,7
14234,Chouklak,zuljin,480,hunter,beastmastery,12,5,7
14235,Silveraero,ghostlands,480,hunter,beastmastery,12,5,7
14236,Oblio,silvermoon,480,hunter,beastmastery,12,5,7
14237,Killaseason,akama,480,hunter,beastmastery,12,5,7
14238,Pichsolika,frostmourne,480,hunter,beastmastery,12,5,7
14239,Sinvat,tichondrius,480,hunter,beastmastery,12,5,7
14240,Tosila,tichondrius,480,hunter,beastmastery,12,5,7
14241,Lindsang,illidan,480,hunter,beastmastery,12,5,7
14242,Hitcompleted,moon-guard,480,hunter,beastmastery,12,5,7
14243,Thejw,firetree,480,hunter,beastmastery,12,5,7
14244,Orcbeast,illidan,480,hunter,beastmastery,12,5,7
14245,Twoshotz,stormrage,480,hunter,beastmastery,12,5,7
14246,Nashi,burning-blade,480,hunter,beastmastery,12,5,7
14247,Yesterday,draka,480,hunter,beastmastery,12,5,7
14248,Roostersauce,durotan,480,hunter,beastmastery,12,5,7
14249,Nj,kiljaeden,480,hunter,beastmastery,12,5,7
14250,Mostmanly,tichondrius,480,hunter,beastmastery,12,5,7
14251,Kurmojo,hyjal,480,hunter,beastmastery,12,5,7
14252,Køk,agamaggan,480,hunter,beastmastery,12,5,7
14253,Chipsncheese,korgath,480,hunter,beastmastery,12,5,7
14254,Àthenaa,malygos,480,hunter,beastmastery,12,5,7
14255,Banai,the-underbog,480,hunter,beastmastery,12,5,7
14256,Mojopojo,tichondrius,480,hunter,beastmastery,12,5,7
14257,Fallacies,moon-guard,480,hunter,beastmastery,12,5,7
14258,Valeous,azjolnerub,480,hunter,beastmastery,12,5,7
14259,Ariais,zangarmarsh,480,hunter,beastmastery,12,5,7
14260,Survchris,bleeding-hollow,480,hunter,beastmastery,12,5,7
14261,Ferex,tichondrius,480,hunter,beastmastery,12,5,7
14262,Michaeljfox,area-52,480,hunter,beastmastery,12,5,7
14263,Smexyhunter,moon-guard,480,hunter,beastmastery,12,5,7
14264,Taphh,moon-guard,480,hunter,beastmastery,12,5,7
14265,Alssong,tichondrius,480,hunter,beastmastery,12,5,7
14266,Bowzza,area-52,480,hunter,beastmastery,12,5,7
14267,Powdersoak,area-52,480,hunter,beastmastery,12,5,7
14268,Mav,dragonmaw,480,hunter,beastmastery,14,5,9
14269,Bøl,ragnaros,480,hunter,beastmastery,16,5,11
14270,Chetxs,bleeding-hollow,480,hunter,beastmastery,18,5,13
14271,Trycaza,ragnaros,480,hunter,beastmastery,18,5,13
14272,Motegi,illidan,480,hunter,beastmastery,18,5,13
14273,Grindal,drakkari,480,hunter,beastmastery,18,5,13
14274,Soulshots,malganis,480,hunter,beastmastery,18,5,13
14275,Prierhunt,frostmourne,480,hunter,beastmastery,18,5,13
14276,Cophunter,tichondrius,480,hunter,beastmastery,18,5,13
14277,Blockbusters,sargeras,480,hunter,beastmastery,18,5,13
14278,Kaitoo,tichondrius,480,hunter,beastmastery,18,5,13
14279,Amoreiene,stormrage,480,hunter,beastmastery,18,5,13
14280,Semiautmatic,thrall,480,hunter,beastmastery,18,5,13
14281,Snoogen,illidan,480,hunter,beastmastery,18,5,13
14282,Sizzimus,area-52,479,hunter,beastmastery,6,5,1
14283,Mafghine,malganis,479,hunter,beastmastery,6,5,1
14284,Segulah,dalaran,479,hunter,beastmastery,6,5,1
14285,Zpax,area-52,479,hunter,beastmastery,6,5,1
14286,Zhanzu,quelthalas,479,hunter,beastmastery,12,5,7
14287,Kairoke,azralon,479,hunter,beastmastery,12,5,7
14288,Traxêx,nemesis,479,hunter,beastmastery,12,5,7
14289,Mecatrón,quelthalas,479,hunter,beastmastery,12,5,7
14290,Chosan,sargeras,479,hunter,beastmastery,12,5,7
14291,Equipmunk,arthas,479,hunter,beastmastery,12,5,7
14292,Shoya,nerzhul,479,hunter,beastmastery,12,5,7
14293,Deadlyattack,barthilas,479,hunter,beastmastery,12,5,7
14294,Trushôtz,tichondrius,479,hunter,beastmastery,17,5,12
14295,Boomup,tichondrius,479,hunter,beastmastery,21,6,15
14296,Snipershot,blackrock,479,hunter,beastmastery,18,5,13
14297,Smider,magtheridon,479,hunter,beastmastery,18,5,13
14298,Starkmeister,stormrage,479,hunter,beastmastery,18,5,13
14299,Seenobody,stormrage,479,hunter,beastmastery,23,5,18
14300,Zarrockk,emerald-dream,478,hunter,beastmastery,12,5,7
14301,Fiznits,nerzhul,478,hunter,beastmastery,18,5,13
14302,Slowbear,kiljaeden,477,hunter,beastmastery,12,5,7
14303,Feralhuntard,muradin,477,hunter,beastmastery,12,5,7
14304,Mehtcurious,ragnaros,470,hunter,beastmastery,18,5,13
14305,Gunther,korgath,447,hunter,beastmastery,11,5,6
14306,Travisshot,tichondrius,447,hunter,beastmastery,11,5,6
14307,Verzatyle,frostwolf,447,hunter,beastmastery,11,5,6
14308,Revenantz,stormrage,447,hunter,beastmastery,11,5,6
14309,Vuur,korialstrasz,447,hunter,beastmastery,19,6,13
14310,Rástakhan,ragnaros,431,hunter,beastmastery,11,5,6
14311,Hazzlôk,cairne,426,hunter,beastmastery,20,7,13
14312,Malgar,zuljin,415,hunter,beastmastery,11,5,6
14313,Resonators,tichondrius,400,hunter,beastmastery,13,5,8
14314,Fizzpow,blackrock,384,hunter,beastmastery,6,4,2
14315,Naxhunter,stormrage,384,hunter,beastmastery,6,4,2
14316,Silvershot,emerald-dream,384,hunter,beastmastery,6,4,2
14317,Terezhunt,tichondrius,384,hunter,beastmastery,6,4,2
14318,Dcousins,tichondrius,384,hunter,beastmastery,6,4,2
14319,Bmobepip,malganis,384,hunter,beastmastery,6,4,2
14320,Yosra,frostmourne,384,hunter,beastmastery,6,4,2
14321,Ashevan,stormrage,384,hunter,beastmastery,6,4,2
14322,Szeh,tichondrius,384,hunter,beastmastery,6,4,2
14323,Sôuleater,moon-guard,384,hunter,beastmastery,6,4,2
14324,Ithanna,quelthalas,384,hunter,beastmastery,6,4,2
14325,Gorillafart,spirestone,384,hunter,beastmastery,6,4,2
14326,Markymarc,tichondrius,384,hunter,beastmastery,6,4,2
14327,Bigkolache,zuljin,384,hunter,beastmastery,6,4,2
14328,Baconzola,dalaran,384,hunter,beastmastery,6,4,2
14329,Jerso,zuljin,384,hunter,beastmastery,6,4,2
14330,Bodangel,galakrond,384,hunter,beastmastery,6,4,2
14331,Reilerhunt,stormrage,384,hunter,beastmastery,6,4,2
14332,Redzic,tichondrius,384,hunter,beastmastery,6,4,2
14333,Kong,tichondrius,384,hunter,beastmastery,6,4,2
14334,Ragerab,trollbane,384,hunter,beastmastery,6,4,2
14335,Bufluu,bleeding-hollow,384,hunter,beastmastery,6,4,2
14336,Moash,spinebreaker,384,hunter,beastmastery,6,4,2
14337,Coolbeanz,boulderfist,384,hunter,beastmastery,6,4,2
14338,Eglon,bleeding-hollow,384,hunter,beastmastery,6,4,2
14339,Küky,ragnaros,384,hunter,beastmastery,6,4,2
14340,Malcab,tichondrius,384,hunter,beastmastery,6,4,2
14341,Zubo,tichondrius,384,hunter,beastmastery,6,4,2
14342,Dd,frostmourne,384,hunter,beastmastery,6,4,2
14343,Splosiv,stormrage,384,hunter,beastmastery,6,4,2
14344,Tezcâtlipocâ,sargeras,384,hunter,beastmastery,6,4,2
14345,Sindshai,onyxia,384,hunter,beastmastery,6,4,2
14346,Skað,lightbringer,384,hunter,beastmastery,6,4,2
14347,Mexishots,tichondrius,384,hunter,beastmastery,6,4,2
14348,Zarnick,frostwolf,384,hunter,beastmastery,6,4,2
14349,Tupirani,azralon,384,hunter,beastmastery,6,4,2
14350,Chichi,korgath,384,hunter,beastmastery,6,4,2
14351,Probo,aegwynn,384,hunter,beastmastery,6,4,2
14352,Dexh,frostmourne,384,hunter,beastmastery,6,4,2
14353,Whatfoxsay,tichondrius,384,hunter,beastmastery,6,4,2
14354,Skytah,darkspear,384,hunter,beastmastery,6,4,2
14355,Shiki,icecrown,384,hunter,beastmastery,6,4,2
14356,Lowlore,moon-guard,384,hunter,beastmastery,6,4,2
14357,Infatuatedx,moon-guard,384,hunter,beastmastery,6,4,2
14358,Yeaheh,area-52,384,hunter,beastmastery,6,4,2
14359,Föcker,emerald-dream,384,hunter,beastmastery,6,4,2
14360,Chikkynuggy,destromath,384,hunter,beastmastery,6,4,2
14361,Dayquillx,illidan,384,hunter,beastmastery,6,4,2
14362,Chokemescara,stormrage,384,hunter,beastmastery,6,4,2
14363,Eazyaimz,thrall,384,hunter,beastmastery,6,4,2
14364,Drinktodrown,moon-guard,384,hunter,beastmastery,6,4,2
14365,Berreydingle,norgannon,384,hunter,beastmastery,6,4,2
14366,Coppersnout,wyrmrest-accord,384,hunter,beastmastery,6,4,2
14367,Snipingmilfs,zuluhed,384,hunter,beastmastery,6,4,2
14368,Ziêg,eonar,384,hunter,beastmastery,6,4,2
14369,Nakyash,ragnaros,384,hunter,beastmastery,9,5,4
14370,Jeonghun,tichondrius,384,hunter,beastmastery,9,5,4
14371,Anteróz,tichondrius,384,hunter,beastmastery,9,4,5
14372,Rycksanches,quelthalas,384,hunter,beastmastery,10,4,6
14373,Kok,andorhal,384,hunter,beastmastery,12,4,8
14374,Macabre,scilla,384,hunter,beastmastery,12,4,8
14375,Xcisiion,nagrand,384,hunter,beastmastery,12,4,8
14376,Iililillilii,tichondrius,384,hunter,beastmastery,12,4,8
14377,Grimshot,boulderfist,384,hunter,beastmastery,12,4,8
14378,Calypso,chromaggus,384,hunter,beastmastery,12,4,8
14379,Vencc,tichondrius,384,hunter,beastmastery,12,4,8
14380,Cndavyjones,akama,384,hunter,beastmastery,12,4,8
14381,Bangerzx,stormrage,384,hunter,beastmastery,12,4,8
14382,Noxura,illidan,384,hunter,beastmastery,12,4,8
14383,Rogshunt,sargeras,384,hunter,beastmastery,12,4,8
14384,Dampteeth,sargeras,384,hunter,beastmastery,12,4,8
14385,Moùrningwood,stormrage,384,hunter,beastmastery,12,4,8
14386,Softhunter,tichondrius,384,hunter,beastmastery,12,4,8
14387,Withoutraps,quelthalas,384,hunter,beastmastery,12,4,8
14388,Devastavi,proudmoore,384,hunter,beastmastery,12,4,8
14389,Arcuz,quelthalas,384,hunter,beastmastery,12,4,8
14390,Mingsomnia,kiljaeden,384,hunter,beastmastery,12,4,8
14391,Bówjòb,nordrassil,384,hunter,beastmastery,12,4,8
14392,Bazanguita,tichondrius,384,hunter,beastmastery,12,4,8
14393,Saharä,illidan,384,hunter,beastmastery,12,4,8
14394,Dangerclam,barthilas,384,hunter,beastmastery,12,4,8
14395,Bowsauce,khadgar,384,hunter,beastmastery,12,4,8
14396,Tigerswood,sargeras,384,hunter,beastmastery,12,4,8
14397,Elywen,alexstrasza,384,hunter,beastmastery,12,4,8
14398,Gaydin,zuljin,384,hunter,beastmastery,12,4,8
14399,Valrosan,stormrage,384,hunter,beastmastery,12,4,8
14400,Päinal,area-52,384,hunter,beastmastery,12,4,8
14401,Vandescar,illidan,384,hunter,beastmastery,12,4,8
14402,Seanpaì,tichondrius,384,hunter,beastmastery,12,4,8
14403,Oztroza,grizzly-hills,384,hunter,beastmastery,12,4,8
14404,Pirateninja,illidan,384,hunter,beastmastery,12,4,8
14405,Grumaku,area-52,384,hunter,beastmastery,12,4,8
14406,Shatterwax,area-52,384,hunter,beastmastery,12,4,8
14407,Lookoutt,tichondrius,384,hunter,beastmastery,12,4,8
14408,Oddangel,azuremyst,384,hunter,beastmastery,12,4,8
14409,Odb,kelthuzad,384,hunter,beastmastery,12,4,8
14410,Throwadox,malganis,384,hunter,beastmastery,12,4,8
14411,Miansi,tichondrius,384,hunter,beastmastery,12,4,8
14412,Inetpub,stormrage,384,hunter,beastmastery,12,4,8
14413,Alkynabm,kelthuzad,384,hunter,beastmastery,12,4,8
14414,Skycaptaín,lightbringer,384,hunter,beastmastery,12,4,8
14415,Shaevie,lothar,384,hunter,beastmastery,12,4,8
14416,Cluhaywood,zuljin,384,hunter,beastmastery,12,4,8
14417,Doves,wyrmrest-accord,384,hunter,beastmastery,12,4,8
14418,Thugio,sargeras,384,hunter,beastmastery,12,4,8
14419,Teddybowschi,sargeras,384,hunter,beastmastery,12,4,8
14420,Twopawshunta,tichondrius,384,hunter,beastmastery,12,4,8
14421,Killatrap,malganis,384,hunter,beastmastery,12,4,8
14422,Zylen,tichondrius,384,hunter,beastmastery,12,4,8
14423,Sèasons,tichondrius,384,hunter,beastmastery,15,4,11
14424,Atheos,gallywix,384,hunter,beastmastery,18,4,14
14425,Ruffini,tichondrius,384,hunter,beastmastery,18,4,14
14426,Löö,arthas,384,hunter,beastmastery,23,4,19
14427,Gichiwalrus,emerald-dream,383,hunter,beastmastery,6,4,2
14428,Eeremm,drakkari,383,hunter,beastmastery,6,4,2
14429,Bboo,bonechewer,383,hunter,beastmastery,6,4,2
14430,Paulayork,drakthul,383,hunter,beastmastery,12,4,8
14431,Lamper,emerald-dream,383,hunter,beastmastery,12,4,8
14432,Àléç,mannoroth,383,hunter,beastmastery,12,4,8
14433,Lazygnome,azshara,383,hunter,beastmastery,12,4,8
14434,Beatnyou,tichondrius,383,hunter,beastmastery,12,4,8
14435,Böwjøb,illidan,383,hunter,beastmastery,12,4,8
14436,Huntmeplz,proudmoore,383,hunter,beastmastery,18,4,14
14437,Fiury,hyjal,382,hunter,beastmastery,6,4,2
14438,Etb,bleeding-hollow,382,hunter,beastmastery,12,4,8
14439,Wuzi,echo-isles,380,hunter,beastmastery,12,4,8
14440,Ire,kelthuzad,367,hunter,beastmastery,11,4,7
14441,Nalsa,tichondrius,367,hunter,beastmastery,11,4,7
14442,Sylaris,arathor,366,hunter,beastmastery,11,4,7
14443,Linszsz,nemesis,361,hunter,beastmastery,17,6,11
14444,Kemper,dragonmaw,351,hunter,beastmastery,11,4,7
14445,Clinkz,chogall,351,hunter,beastmastery,11,4,7
14446,Vínçent,blood-furnace,351,hunter,beastmastery,17,4,13
14447,Sadarrow,frostmourne,334,hunter,beastmastery,11,4,7
14448,Hediilyan,azralon,330,hunter,beastmastery,11,6,5
14449,Bugsßunny,sargeras,330,hunter,beastmastery,16,5,11
14450,Punkrockguy,illidan,319,hunter,beastmastery,14,4,10
14451,Seeq,illidan,288,hunter,beastmastery,6,3,3
14452,Tremobbin,kelthuzad,288,hunter,beastmastery,6,3,3
14453,Terrabytés,kelthuzad,288,hunter,beastmastery,6,3,3
14454,Jungling,kelthuzad,288,hunter,beastmastery,6,3,3
14455,Moyria,quelthalas,288,hunter,beastmastery,6,3,3
14456,Mogradme,shadowsong,288,hunter,beastmastery,6,3,3
14457,Tetzuo,illidan,288,hunter,beastmastery,6,3,3
14458,Gupples,frostwolf,288,hunter,beastmastery,6,3,3
14459,Miraclez,nerzhul,288,hunter,beastmastery,6,3,3
14460,Cefla,illidan,288,hunter,beastmastery,6,3,3
14461,Saynice,warsong,288,hunter,beastmastery,6,3,3
14462,Backa,jubeithos,288,hunter,beastmastery,6,3,3
14463,Ironova,illidan,288,hunter,beastmastery,6,3,3
14464,Grayføxx,twisting-nether,288,hunter,beastmastery,6,3,3
14465,Worewolf,lightninghoof,288,hunter,beastmastery,6,3,3
14466,Mastasnipa,illidan,288,hunter,beastmastery,6,3,3
14467,Kite,dathremar,288,hunter,beastmastery,6,3,3
14468,Mcfibers,malganis,288,hunter,beastmastery,6,3,3
14469,Latrampoza,quelthalas,288,hunter,beastmastery,6,3,3
14470,Schumann,ursin,288,hunter,beastmastery,6,3,3
14471,Bountybud,kiljaeden,288,hunter,beastmastery,6,3,3
14472,Bmsurvmm,tichondrius,288,hunter,beastmastery,6,3,3
14473,Billcsbyswtr,sargeras,288,hunter,beastmastery,6,3,3
14474,Herroo,thrall,288,hunter,beastmastery,6,3,3
14475,Limpingspoon,kelthuzad,288,hunter,beastmastery,6,3,3
14476,Beastmodex,quelthalas,288,hunter,beastmastery,6,3,3
14477,Karumä,thrall,288,hunter,beastmastery,6,3,3
14478,Doubletappz,stormrage,288,hunter,beastmastery,6,3,3
14479,Yoyoletsgo,malganis,288,hunter,beastmastery,6,3,3
14480,Scolhunter,scarlet-crusade,288,hunter,beastmastery,6,3,3
14481,Mulnaaj,zuljin,288,hunter,beastmastery,6,3,3
14482,Braxigarr,area-52,288,hunter,beastmastery,6,3,3
14483,Nyloc,dalvengyr,288,hunter,beastmastery,6,3,3
14484,Chadbowsman,tichondrius,288,hunter,beastmastery,6,3,3
14485,Blastinnagas,tichondrius,288,hunter,beastmastery,6,3,3
14486,Euamomilfs,azralon,288,hunter,beastmastery,6,3,3
14487,Wolfzburg,moon-guard,288,hunter,beastmastery,6,3,3
14488,Sotsöl,ragnaros,288,hunter,beastmastery,6,3,3
14489,Hellbow,ragnaros,288,hunter,beastmastery,6,3,3
14490,Ballistik,area-52,288,hunter,beastmastery,6,3,3
14491,Anatric,illidan,288,hunter,beastmastery,6,3,3
14492,Deahtgab,ragnaros,288,hunter,beastmastery,6,3,3
14493,Salvatiel,stormrage,288,hunter,beastmastery,6,3,3
14494,Leadblaster,gorefiend,288,hunter,beastmastery,6,3,3
14495,Vikshen,illidan,288,hunter,beastmastery,6,3,3
14496,Realzanderr,antonidas,288,hunter,beastmastery,6,3,3
14497,Kathelvia,area-52,288,hunter,beastmastery,6,3,3
14498,Toxicbowjobs,tichondrius,288,hunter,beastmastery,6,3,3
14499,Trailed,dalaran,288,hunter,beastmastery,6,3,3
14500,Redthedeer,warsong,288,hunter,beastmastery,6,3,3
14501,Harosh,azralon,288,hunter,beastmastery,6,3,3
14502,Siimmplicitz,area-52,288,hunter,beastmastery,6,3,3
14503,Relaxnerd,antonidas,288,hunter,beastmastery,6,3,3
14504,Goraku,dalaran,288,hunter,beastmastery,6,3,3
14505,Perfectcrit,area-52,288,hunter,beastmastery,6,3,3
14506,Viavii,barthilas,288,hunter,beastmastery,6,3,3
14507,Norgalys,proudmoore,288,hunter,beastmastery,6,3,3
14508,Huntmon,nemesis,288,hunter,beastmastery,6,3,3
14509,Therealgam,the-underbog,288,hunter,beastmastery,6,3,3
14510,Zeroday,emerald-dream,288,hunter,beastmastery,6,3,3
14511,Firskin,frostmourne,288,hunter,beastmastery,6,3,3
14512,Gudlukk,stormrage,288,hunter,beastmastery,6,3,3
14513,Teaa,dalaran,288,hunter,beastmastery,6,3,3
14514,Raainha,stormrage,288,hunter,beastmastery,6,3,3
14515,Guacmec,tichondrius,288,hunter,beastmastery,6,3,3
14516,Longshott,azralon,288,hunter,beastmastery,6,3,3
14517,Díllý,area-52,288,hunter,beastmastery,6,3,3
14518,Deuzebuk,azralon,288,hunter,beastmastery,6,3,3
14519,Burguir,ragnaros,288,hunter,beastmastery,6,3,3
14520,Nexxa,muradin,288,hunter,beastmastery,6,3,3
14521,Makeastinky,malfurion,288,hunter,beastmastery,6,3,3
14522,Vinksy,sargeras,288,hunter,beastmastery,6,3,3
14523,Gugubird,proudmoore,288,hunter,beastmastery,6,3,3
14524,Wannakill,stormrage,288,hunter,beastmastery,6,3,3
14525,Emart,bloodhoof,288,hunter,beastmastery,6,3,3
14526,Chrisp,bloodhoof,288,hunter,beastmastery,6,3,3
14527,Georgigeo,turalyon,288,hunter,beastmastery,6,3,3
14528,Vicarnam,uldum,288,hunter,beastmastery,6,3,3
14529,Crinkx,arthas,288,hunter,beastmastery,6,3,3
14530,Añto,tichondrius,288,hunter,beastmastery,6,3,3
14531,Britannian,moon-guard,288,hunter,beastmastery,6,3,3
14532,Lelreisw,goldrinn,288,hunter,beastmastery,6,3,3
14533,Jellyleg,bleeding-hollow,288,hunter,beastmastery,6,3,3
14534,Cernos,malganis,288,hunter,beastmastery,6,3,3
14535,Çrimson,frostmourne,288,hunter,beastmastery,6,3,3
14536,Pewpewbang,muradin,288,hunter,beastmastery,6,3,3
14537,Brorc,kul-tiras,288,hunter,beastmastery,6,3,3
14538,Hahahahahaha,frostmourne,288,hunter,beastmastery,6,3,3
14539,Trixex,darkspear,288,hunter,beastmastery,6,3,3
14540,Enonoa,thunderlord,288,hunter,beastmastery,6,3,3
14541,Nightstålkër,moon-guard,288,hunter,beastmastery,6,3,3
14542,Comtambisuon,frostmourne,288,hunter,beastmastery,6,3,3
14543,Tibineids,stormrage,288,hunter,beastmastery,6,3,3
14544,Shikay,frostmourne,288,hunter,beastmastery,6,3,3
14545,Ontop,draka,288,hunter,beastmastery,6,3,3
14546,Mynds,stormrage,288,hunter,beastmastery,6,3,3
14547,Aldurion,wyrmrest-accord,288,hunter,beastmastery,6,3,3
14548,Trickshot,hakkar,288,hunter,beastmastery,6,3,3
14549,Archetype,bladefist,288,hunter,beastmastery,6,3,3
14550,Venj,proudmoore,288,hunter,beastmastery,6,3,3
14551,Radat,stormscale,288,hunter,beastmastery,6,3,3
14552,Bagofsnit,frostmourne,288,hunter,beastmastery,6,3,3
14553,Adapted,proudmoore,288,hunter,beastmastery,6,3,3
14554,Barrohunt,tichondrius,288,hunter,beastmastery,6,3,3
14555,Wiittig,hyjal,288,hunter,beastmastery,6,3,3
14556,Wanshöt,tichondrius,288,hunter,beastmastery,6,3,3
14557,Exabyssus,bleeding-hollow,288,hunter,beastmastery,6,3,3
14558,Harmfulwang,emerald-dream,288,hunter,beastmastery,6,3,3
14559,Lyler,tichondrius,288,hunter,beastmastery,6,3,3
14560,Shallwe,frostmourne,288,hunter,beastmastery,6,3,3
14561,Kahoykeso,frostmourne,288,hunter,beastmastery,6,3,3
14562,Lelantos,stonemaul,288,hunter,beastmastery,6,3,3
14563,Soberish,bleeding-hollow,288,hunter,beastmastery,6,3,3
14564,Fakerz,stormrage,288,hunter,beastmastery,6,3,3
14565,Popshotz,khazgoroth,288,hunter,beastmastery,6,3,3
14566,Sibbleiv,boulderfist,288,hunter,beastmastery,6,3,3
14567,Onahai,tichondrius,288,hunter,beastmastery,6,3,3
14568,Hannes,boulderfist,288,hunter,beastmastery,6,3,3
14569,Orangegummy,frostmourne,288,hunter,beastmastery,9,4,5
14570,Llachiip,zuljin,288,hunter,beastmastery,10,4,6
14571,Brewster,burning-legion,288,hunter,beastmastery,12,3,9
14572,Autismo,garithos,288,hunter,beastmastery,12,3,9
14573,Ruckq,stormrage,288,hunter,beastmastery,12,3,9
14574,Rinasonline,sargeras,288,hunter,beastmastery,12,3,9
14575,Johnwïck,moon-guard,288,hunter,beastmastery,12,3,9
14576,Harÿn,nemesis,288,hunter,beastmastery,12,3,9
14577,Rice,veknilash,288,hunter,beastmastery,12,3,9
14578,Nikå,ragnaros,288,hunter,beastmastery,12,3,9
14579,Auset,aegwynn,288,hunter,beastmastery,12,3,9
14580,Fistbèk,bleeding-hollow,288,hunter,beastmastery,12,3,9
14581,Rooman,ragnaros,288,hunter,beastmastery,12,3,9
14582,Dunkam,quelthalas,288,hunter,beastmastery,12,3,9
14583,Jgalth,chogall,288,hunter,beastmastery,12,3,9
14584,Zhona,moon-guard,288,hunter,beastmastery,12,3,9
14585,Dodirty,laughing-skull,288,hunter,beastmastery,12,3,9
14586,Bowflëx,zuljin,288,hunter,beastmastery,12,3,9
14587,Wargodthor,blades-edge,288,hunter,beastmastery,12,3,9
14588,Neríne,drakkari,288,hunter,beastmastery,12,3,9
14589,Delanooch,rexxar,288,hunter,beastmastery,12,3,9
14590,Kharthorin,moon-guard,288,hunter,beastmastery,12,3,9
14591,Thiande,zuljin,288,hunter,beastmastery,12,3,9
14592,Icculus,norgannon,288,hunter,beastmastery,12,3,9
14593,Gunwalk,azjolnerub,288,hunter,beastmastery,12,3,9
14594,Leggodex,caelestrasz,288,hunter,beastmastery,12,3,9
14595,Ryanderanged,wyrmrest-accord,288,hunter,beastmastery,12,3,9
14596,Reachme,moon-guard,288,hunter,beastmastery,12,3,9
14597,Grlzzlyadams,norgannon,288,hunter,beastmastery,12,3,9
14598,Digsites,emerald-dream,288,hunter,beastmastery,12,3,9
14599,Dieplox,thunderhorn,288,hunter,beastmastery,12,3,9
14600,Tanrith,dark-iron,288,hunter,beastmastery,12,3,9
14601,Natnat,sargeras,288,hunter,beastmastery,12,3,9
14602,Toozz,frostmourne,288,hunter,beastmastery,12,3,9
14603,ßloodmain,tichondrius,288,hunter,beastmastery,12,3,9
14604,Prowd,staghelm,288,hunter,beastmastery,12,3,9
14605,Yiyixx,tichondrius,288,hunter,beastmastery,18,3,15
14606,Kango,azgalor,288,hunter,beastmastery,18,3,15
14607,Bëcäüsë,proudmoore,288,hunter,beastmastery,18,3,15
14608,Ledan,lightnings-blade,287,hunter,beastmastery,6,3,3
14609,Euroniimus,ragnaros,287,hunter,beastmastery,6,3,3
14610,Luzyfer,quelthalas,287,hunter,beastmastery,6,3,3
14611,Wolftracer,sargeras,287,hunter,beastmastery,6,3,3
14612,Pureguava,gorefiend,287,hunter,beastmastery,6,3,3
14613,Braindeadly,malganis,287,hunter,beastmastery,6,3,3
14614,Arin,suramar,287,hunter,beastmastery,12,3,9
14615,Acotas,blades-edge,286,hunter,beastmastery,6,3,3
14616,Darkally,blades-edge,285,hunter,beastmastery,12,3,9
14617,Salurian,destromath,271,hunter,beastmastery,11,3,8
14618,Bulszeye,azgalor,255,hunter,beastmastery,8,4,4
14619,Pokeyourbutt,hydraxis,240,hunter,beastmastery,15,3,12
14620,Kaelhim,warsong,239,hunter,beastmastery,5,3,2
14621,Vicecheney,illidan,239,hunter,beastmastery,5,3,2
14622,Diisdik,tichondrius,239,hunter,beastmastery,5,3,2
14623,Léfty,nagrand,239,hunter,beastmastery,11,3,8
14624,Djcummyfeet,stormrage,234,hunter,beastmastery,17,6,11
14625,Feralcat,nazjatar,208,hunter,beastmastery,13,3,10
14626,Powerful,aerie-peak,192,hunter,beastmastery,6,2,4
14627,Cufless,proudmoore,192,hunter,beastmastery,6,2,4
14628,Hollee,turalyon,192,hunter,beastmastery,6,2,4
14629,Slobon,tichondrius,192,hunter,beastmastery,6,2,4
14630,Darksniper,proudmoore,192,hunter,beastmastery,6,2,4
14631,Diacachimbaa,ragnaros,192,hunter,beastmastery,6,2,4
14632,Zoopdapoop,dalaran,192,hunter,beastmastery,6,2,4
14633,Alikay,ragnaros,192,hunter,beastmastery,6,2,4
14634,Neverwipes,frostmourne,192,hunter,beastmastery,6,2,4
14635,Munrrack,ragnaros,192,hunter,beastmastery,6,2,4
14636,Defacecilth,dalaran,192,hunter,beastmastery,6,2,4
14637,Purpreynolds,tichondrius,192,hunter,beastmastery,6,2,4
14638,Ivanjackenov,illidan,192,hunter,beastmastery,6,2,4
14639,Frìtz,barthilas,192,hunter,beastmastery,6,2,4
14640,Tichong,tichondrius,192,hunter,beastmastery,6,2,4
14641,Nanotorque,moon-guard,192,hunter,beastmastery,6,2,4
14642,Elivivia,tichondrius,192,hunter,beastmastery,6,2,4
14643,Kaloh,daggerspine,192,hunter,beastmastery,6,2,4
14644,Verzoz,illidan,192,hunter,beastmastery,6,2,4
14645,Hectorbuñue,quelthalas,192,hunter,beastmastery,6,2,4
14646,Gilv,frostmourne,192,hunter,beastmastery,6,2,4
14647,Stfd,illidan,192,hunter,beastmastery,6,2,4
14648,Ellishunter,frostmourne,192,hunter,beastmastery,6,2,4
14649,Gohan,jubeithos,192,hunter,beastmastery,6,2,4
14650,Pickshot,boulderfist,192,hunter,beastmastery,6,2,4
14651,Presleyjane,tichondrius,192,hunter,beastmastery,6,2,4
14652,Illrannevian,garrosh,192,hunter,beastmastery,6,2,4
14653,Antwonziezz,tichondrius,192,hunter,beastmastery,6,2,4
14654,Chømp,tichondrius,192,hunter,beastmastery,6,2,4
14655,Rhyzen,drenden,192,hunter,beastmastery,6,2,4
14656,Barrelsofrum,illidan,192,hunter,beastmastery,6,2,4
14657,Etarie,malganis,192,hunter,beastmastery,6,2,4
14658,Twocranes,tichondrius,192,hunter,beastmastery,6,2,4
14659,Dreadrahl,deathwing,192,hunter,beastmastery,6,2,4
14660,Rsttlegore,stormscale,192,hunter,beastmastery,6,2,4
14661,Magvez,tichondrius,192,hunter,beastmastery,6,2,4
14662,Smokiiganja,proudmoore,192,hunter,beastmastery,6,2,4
14663,Hötdôg,kiljaeden,192,hunter,beastmastery,6,2,4
14664,Capnjack,hyjal,192,hunter,beastmastery,6,2,4
14665,Jbahh,hyjal,192,hunter,beastmastery,6,2,4
14666,Gruì,malganis,192,hunter,beastmastery,6,2,4
14667,Öops,hyjal,192,hunter,beastmastery,6,2,4
14668,Kudzue,illidan,192,hunter,beastmastery,6,2,4
14669,Sativ,moknathal,192,hunter,beastmastery,6,2,4
14670,Kansolly,tichondrius,192,hunter,beastmastery,6,2,4
14671,Varianhunter,kelthuzad,192,hunter,beastmastery,6,2,4
14672,Shootermgavn,frostmourne,192,hunter,beastmastery,6,2,4
14673,Hìrcine,nesingwary,192,hunter,beastmastery,6,2,4
14674,Pressbro,tichondrius,192,hunter,beastmastery,6,2,4
14675,Bloodstark,dreadmaul,192,hunter,beastmastery,6,2,4
14676,Kaptincrunch,skywall,192,hunter,beastmastery,6,2,4
14677,Wooftoof,frostmourne,192,hunter,beastmastery,6,2,4
14678,Zeront,garona,192,hunter,beastmastery,6,2,4
14679,Critaclyzm,moon-guard,192,hunter,beastmastery,6,2,4
14680,Solderboi,tichondrius,192,hunter,beastmastery,6,2,4
14681,Vanpeltz,illidan,192,hunter,beastmastery,6,2,4
14682,Camfeed,illidan,192,hunter,beastmastery,6,2,4
14683,Skolzero,azralon,192,hunter,beastmastery,6,2,4
14684,Mojito,frostmourne,192,hunter,beastmastery,6,2,4
14685,Rúdrá,area-52,192,hunter,beastmastery,6,2,4
14686,Nevon,azralon,192,hunter,beastmastery,6,2,4
14687,Thunderbúll,tichondrius,192,hunter,beastmastery,6,2,4
14688,Åî,tichondrius,192,hunter,beastmastery,6,2,4
14689,Castíèl,thrall,192,hunter,beastmastery,6,2,4
14690,Notoffended,sargeras,192,hunter,beastmastery,6,2,4
14691,Caligar,tichondrius,192,hunter,beastmastery,6,2,4
14692,Søapbubble,tichondrius,192,hunter,beastmastery,6,2,4
14693,Fjdominador,azralon,192,hunter,beastmastery,6,2,4
14694,Xavííer,tichondrius,192,hunter,beastmastery,6,2,4
14695,Graatata,shandris,192,hunter,beastmastery,6,2,4
14696,Sukr,korgath,192,hunter,beastmastery,6,2,4
14697,Halaruka,area-52,192,hunter,beastmastery,6,2,4
14698,Chaseurnoir,exodar,192,hunter,beastmastery,6,2,4
14699,Autoshotxprt,frostmourne,192,hunter,beastmastery,6,2,4
14700,Rämbow,frostmourne,192,hunter,beastmastery,6,2,4
14701,Jacss,azralon,192,hunter,beastmastery,6,2,4
14702,Bluntcrushed,area-52,192,hunter,beastmastery,6,2,4
14703,Zarknoth,cenarius,192,hunter,beastmastery,6,2,4
14704,Dynith,sargeras,192,hunter,beastmastery,6,2,4
14705,Hüh,area-52,192,hunter,beastmastery,6,2,4
14706,Harrowin,area-52,192,hunter,beastmastery,6,2,4
14707,Mídnîght,azralon,192,hunter,beastmastery,6,2,4
14708,Behavior,nemesis,192,hunter,beastmastery,6,2,4
14709,Titzyø,area-52,192,hunter,beastmastery,6,2,4
14710,Survbot,malganis,192,hunter,beastmastery,6,2,4
14711,Monffbc,tichondrius,192,hunter,beastmastery,6,2,4
14712,Csadark,nemesis,192,hunter,beastmastery,6,2,4
14713,Tarkovs,area-52,192,hunter,beastmastery,6,2,4
14714,Nubcaks,nerzhul,192,hunter,beastmastery,6,2,4
14715,Ussy,area-52,192,hunter,beastmastery,6,2,4
14716,Rostter,azralon,192,hunter,beastmastery,6,2,4
14717,Shådé,stormrage,192,hunter,beastmastery,6,2,4
14718,Nfo,lightbringer,192,hunter,beastmastery,6,2,4
14719,Pfheign,area-52,192,hunter,beastmastery,6,2,4
14720,Zaydenm,sargeras,192,hunter,beastmastery,6,2,4
14721,Blakespace,area-52,192,hunter,beastmastery,6,2,4
14722,Clütch,darkspear,192,hunter,beastmastery,6,2,4
14723,Equalizér,sargeras,192,hunter,beastmastery,6,2,4
14724,Greasyboi,tichondrius,192,hunter,beastmastery,6,2,4
14725,Arrowbadoors,azralon,192,hunter,beastmastery,6,2,4
14726,Dsizzle,tichondrius,192,hunter,beastmastery,6,2,4
14727,Madsniper,thunderlord,192,hunter,beastmastery,6,2,4
14728,Islapuwitaro,azjolnerub,192,hunter,beastmastery,6,2,4
14729,Warplaquee,zuljin,192,hunter,beastmastery,6,2,4
14730,Fova,wyrmrest-accord,192,hunter,beastmastery,6,2,4
14731,Estilingada,azralon,192,hunter,beastmastery,6,2,4
14732,Jojojobo,tichondrius,192,hunter,beastmastery,6,2,4
14733,Bernice,darrowmere,192,hunter,beastmastery,6,2,4
14734,Ratbasterrd,darkspear,192,hunter,beastmastery,6,2,4
14735,Jxbupx,tichondrius,192,hunter,beastmastery,6,2,4
14736,Shootr,darkspear,192,hunter,beastmastery,6,2,4
14737,Kenhay,wyrmrest-accord,192,hunter,beastmastery,6,2,4
14738,Zellor,wyrmrest-accord,192,hunter,beastmastery,6,2,4
14739,Nahzah,stormrage,192,hunter,beastmastery,6,2,4
14740,Juicyfruit,bleeding-hollow,192,hunter,beastmastery,6,2,4
14741,Impërïum,zuljin,192,hunter,beastmastery,6,2,4
14742,Ganderion,sargeras,192,hunter,beastmastery,6,2,4
14743,Blickymon,wyrmrest-accord,192,hunter,beastmastery,6,2,4
14744,Dnicee,stormrage,192,hunter,beastmastery,6,2,4
14745,Revengexyz,zuljin,192,hunter,beastmastery,6,2,4
14746,Garble,darkspear,192,hunter,beastmastery,6,2,4
14747,Budget,emerald-dream,192,hunter,beastmastery,6,2,4
14748,Aaggros,sargeras,192,hunter,beastmastery,6,2,4
14749,Ikiteforfood,zuljin,192,hunter,beastmastery,6,2,4
14750,Totolol,trollbane,192,hunter,beastmastery,6,2,4
14751,Thazen,sargeras,192,hunter,beastmastery,6,2,4
14752,Singer,lothar,192,hunter,beastmastery,6,2,4
14753,Viracha,stormrage,192,hunter,beastmastery,6,2,4
14754,Snaken,the-forgotten-coast,192,hunter,beastmastery,6,2,4
14755,Expskippy,darkspear,192,hunter,beastmastery,6,2,4
14756,Jämmëdclïp,emerald-dream,192,hunter,beastmastery,6,2,4
14757,Skillhunter,tichondrius,192,hunter,beastmastery,6,2,4
14758,Rockoutt,emerald-dream,192,hunter,beastmastery,6,2,4
14759,Seratoninx,malganis,192,hunter,beastmastery,9,2,7
14760,Meetdmonster,illidan,192,hunter,beastmastery,12,2,10
14761,Aeriladin,moon-guard,192,hunter,beastmastery,12,2,10
14762,Carloslaun,drakkari,192,hunter,beastmastery,12,2,10
14763,Lhax,stormrage,192,hunter,beastmastery,12,2,10
14764,Tánsøxøxø,tichondrius,192,hunter,beastmastery,12,2,10
14765,Ãmi,moon-guard,192,hunter,beastmastery,12,2,10
14766,Ijii,tichondrius,192,hunter,beastmastery,12,2,10
14767,Bjj,eonar,192,hunter,beastmastery,12,2,10
14768,Mphunter,azralon,192,hunter,beastmastery,12,2,10
14769,Arrowzpeckt,tichondrius,192,hunter,beastmastery,12,2,10
14770,Hughboner,illidan,192,hunter,beastmastery,12,2,10
14771,Gunnpowder,malganis,192,hunter,beastmastery,12,2,10
14772,Thyladaern,kiljaeden,192,hunter,beastmastery,12,2,10
14773,Khabul,area-52,192,hunter,beastmastery,12,2,10
14774,Sojun,jaedenar,192,hunter,beastmastery,14,2,12
14775,Gilonate,tichondrius,192,hunter,beastmastery,18,2,16
14776,Moapax,azralon,191,hunter,beastmastery,6,2,4
14777,Recebaa,barthilas,191,hunter,beastmastery,6,2,4
14778,Aiilton,gallywix,191,hunter,beastmastery,6,2,4
14779,Tuvasa,blood-furnace,191,hunter,beastmastery,6,2,4
14780,Stoneforged,ragnaros,191,hunter,beastmastery,6,2,4
14781,Kolarius,emerald-dream,191,hunter,beastmastery,6,2,4
14782,Enrage,queldorei,191,hunter,beastmastery,12,2,10
14783,Drakarÿs,drakkari,191,hunter,beastmastery,12,2,10
14784,Kelgar,the-scryers,191,hunter,beastmastery,12,2,10
14785,Maximum,tichondrius,159,hunter,beastmastery,5,2,3
14786,Stèlla,frostmourne,159,hunter,beastmastery,5,2,3
14787,Helikaon,deathwing,159,hunter,beastmastery,5,2,3
14788,Skrìms,tichondrius,159,hunter,beastmastery,5,2,3
14789,Luckione,destromath,144,hunter,beastmastery,9,2,7
14790,Lele,stormrage,138,hunter,beastmastery,8,4,4
14791,Pikochon,illidan,138,hunter,beastmastery,12,3,9
14792,Twatshót,burning-legion,131,hunter,beastmastery,16,5,11
14793,Piñg,tichondrius,128,hunter,beastmastery,4,2,2
14794,Beastmastr,garrosh,128,hunter,beastmastery,4,2,2
14795,Owoonisan,illidan,128,hunter,beastmastery,4,2,2
14796,Laviè,tichondrius,112,hunter,beastmastery,4,3,1
14797,Predatðr,frostmourne,96,hunter,beastmastery,6,1,5
14798,Singletap,barthilas,96,hunter,beastmastery,6,1,5
14799,Varag,amanthul,96,hunter,beastmastery,6,1,5
14800,Sõulhunter,frostmourne,96,hunter,beastmastery,6,1,5
14801,Wârhunt,frostmourne,96,hunter,beastmastery,6,1,5
14802,Birggitte,the-venture-co,96,hunter,beastmastery,6,1,5
14803,Justin,agamaggan,96,hunter,beastmastery,6,1,5
14804,Muckenfoose,frostmourne,96,hunter,beastmastery,6,1,5
14805,Baehydra,frostmourne,96,hunter,beastmastery,6,1,5
14806,Taumelz,sargeras,96,hunter,beastmastery,6,1,5
14807,Xcopel,azralon,96,hunter,beastmastery,6,1,5
14808,Jootuber,barthilas,96,hunter,beastmastery,6,1,5
14809,Slipperyqt,frostmourne,96,hunter,beastmastery,6,1,5
14810,Tybierious,illidan,96,hunter,beastmastery,6,1,5
14811,Ghostone,sargeras,96,hunter,beastmastery,6,1,5
14812,Patcherson,kargath,96,hunter,beastmastery,6,1,5
14813,Jaboe,thrall,96,hunter,beastmastery,6,1,5
14814,Shoccka,thrall,96,hunter,beastmastery,6,1,5
14815,Squiik,wildhammer,96,hunter,beastmastery,6,1,5
14816,Fadingtrapz,jubeithos,96,hunter,beastmastery,6,1,5
14817,Cynasia,maelstrom,96,hunter,beastmastery,6,1,5
14818,Bosshunt,whisperwind,96,hunter,beastmastery,6,1,5
14819,Cocobread,stormreaver,96,hunter,beastmastery,6,1,5
14820,Jiawoweixin,illidan,96,hunter,beastmastery,6,1,5
14821,Physical,destromath,96,hunter,beastmastery,6,1,5
14822,Frenchhtoast,sargeras,96,hunter,beastmastery,6,1,5
14823,Henhøuse,illidan,96,hunter,beastmastery,6,1,5
14824,Dusle,azralon,96,hunter,beastmastery,6,1,5
14825,Sobala,azralon,96,hunter,beastmastery,6,1,5
14826,Carot,dalaran,96,hunter,beastmastery,6,1,5
14827,Bertiebott,zuljin,96,hunter,beastmastery,6,1,5
14828,Bellaphonte,stormrage,96,hunter,beastmastery,6,1,5
14829,Shadeckz,stormrage,96,hunter,beastmastery,6,1,5
14830,Panm,runetotem,96,hunter,beastmastery,6,1,5
14831,Taurenseason,sargeras,96,hunter,beastmastery,6,1,5
14832,Oldmandave,stormrage,96,hunter,beastmastery,6,1,5
14833,Nachtcloverr,stormrage,96,hunter,beastmastery,6,1,5
14834,Slimetime,tichondrius,96,hunter,beastmastery,6,1,5
14835,Boido,ghostlands,96,hunter,beastmastery,6,1,5
14836,Foakus,zuljin,96,hunter,beastmastery,6,1,5
14837,Båttousai,kiljaeden,96,hunter,beastmastery,6,1,5
14838,Wamion,zuljin,96,hunter,beastmastery,6,1,5
14839,Jabbar,bleeding-hollow,96,hunter,beastmastery,6,1,5
14840,Ilîiìîìiilil,bleeding-hollow,96,hunter,beastmastery,6,1,5
14841,Ferrettss,bleeding-hollow,96,hunter,beastmastery,6,1,5
14842,Murk,spirestone,96,hunter,beastmastery,6,1,5
14843,Percival,firetree,96,hunter,beastmastery,6,1,5
14844,Nearsightedd,area-52,96,hunter,beastmastery,6,1,5
14845,Arthanyz,quelthalas,96,hunter,beastmastery,6,1,5
14846,Boyarsky,area-52,96,hunter,beastmastery,6,1,5
14847,Appä,lightnings-blade,96,hunter,beastmastery,6,1,5
14848,Tarakii,moon-guard,96,hunter,beastmastery,6,1,5
14849,Allgasnocap,kelthuzad,96,hunter,beastmastery,6,1,5
14850,Marksmanpain,malganis,96,hunter,beastmastery,6,1,5
14851,Warpedshots,malganis,96,hunter,beastmastery,6,1,5
14852,Bithiáh,quelthalas,96,hunter,beastmastery,6,1,5
14853,Pampas,darkspear,96,hunter,beastmastery,6,1,5
14854,Penelòpe,wyrmrest-accord,96,hunter,beastmastery,6,1,5
14855,Opsi,ragnaros,96,hunter,beastmastery,6,1,5
14856,Mtuanwm,tichondrius,96,hunter,beastmastery,6,1,5
14857,Soulreaperts,ragnaros,96,hunter,beastmastery,6,1,5
14858,Rexxiga,kiljaeden,96,hunter,beastmastery,6,1,5
14859,Poonbaddy,kiljaeden,96,hunter,beastmastery,6,1,5
14860,Xclaw,llane,96,hunter,beastmastery,6,1,5
14861,Nimbioth,proudmoore,96,hunter,beastmastery,6,1,5
14862,Darkhunterr,tichondrius,96,hunter,beastmastery,6,1,5
14863,Wixyy,aegwynn,96,hunter,beastmastery,6,1,5
14864,Bigpie,daggerspine,96,hunter,beastmastery,6,1,5
14865,Huntardness,moon-guard,96,hunter,beastmastery,6,1,5
14866,Audiofly,tichondrius,96,hunter,beastmastery,6,1,5
14867,Robious,tichondrius,96,hunter,beastmastery,6,1,5
14868,Derekscrow,tichondrius,96,hunter,beastmastery,6,1,5
14869,Espaada,tichondrius,96,hunter,beastmastery,6,1,5
14870,Sóggybóxers,tichondrius,96,hunter,beastmastery,6,1,5
14871,Brody,eitrigg,96,hunter,beastmastery,6,1,5
14872,Ballinpotato,tichondrius,96,hunter,beastmastery,6,1,5
14873,Globlauncher,tichondrius,96,hunter,beastmastery,6,1,5
14874,Twistedx,tichondrius,96,hunter,beastmastery,6,1,5
14875,Bendotexe,stormrage,96,hunter,beastmastery,7,1,6
14876,Ferdphin,dalaran,96,hunter,beastmastery,12,1,11
14877,Blackstaur,illidan,96,hunter,beastmastery,12,1,11
14878,Arielma,illidan,96,hunter,beastmastery,12,1,11
14879,Rekows,stormrage,96,hunter,beastmastery,12,1,11
14880,Tstormzz,stormrage,96,hunter,beastmastery,12,1,11
14881,Sylvanãs,ragnaros,96,hunter,beastmastery,12,1,11
14882,Divineseraph,dentarg,96,hunter,beastmastery,12,1,11
14883,Tydee,nagrand,96,hunter,beastmastery,12,1,11
14884,Desoh,kelthuzad,96,hunter,beastmastery,12,1,11
14885,Tinsho,drakkari,96,hunter,beastmastery,12,1,11
14886,Newdanni,barthilas,95,hunter,beastmastery,18,1,17
14887,Alby,daggerspine,79,hunter,beastmastery,5,1,4
14888,Muffkick,illidan,64,hunter,beastmastery,4,1,3
14889,Kölhberg,azralon,64,hunter,beastmastery,10,1,9
14890,Triggamikê,tichondrius,63,hunter,beastmastery,2,2,0
14891,Memorypet,proudmoore,48,hunter,beastmastery,3,1,2
14892,Yory,tol-barad,48,hunter,beastmastery,3,1,2
14893,Falsifier,ragnaros,48,hunter,beastmastery,3,1,2
14894,Wonshawt,tichondrius,48,hunter,beastmastery,3,1,2
14895,Jumeog,stormscale,42,hunter,beastmastery,7,2,5
14896,Bowjoblul,stormrage,42,hunter,beastmastery,9,2,7
14897,Gasslight,area-52,31,hunter,beastmastery,2,1,1
14898,Khillin,destromath,31,hunter,beastmastery,2,1,1
14899,Timesteal,tichondrius,31,hunter,beastmastery,2,1,1
14900,Voladren,moon-guard,31,hunter,beastmastery,2,1,1
14901,Numbing,sargeras,2233,mage,arcane,100,54,46
14902,Juicemage,tichondrius,2207,mage,arcane,95,52,43
14903,Venruki,tichondrius,2137,mage,arcane,78,44,34
14904,Cvark,sargeras,2123,mage,arcane,76,45,31
14905,Ktp,tichondrius,2118,mage,arcane,84,50,34
14906,Junglejape,tichondrius,1967,mage,arcane,54,35,19
14907,Oneschool,sargeras,1963,mage,arcane,60,33,27
14908,Arcanemagek,tichondrius,1907,mage,arcane,48,32,16
14909,Bambambilly,kelthuzad,1893,mage,arcane,96,53,43
14910,Whiterice,zuljin,1879,mage,arcane,50,31,19
14911,Bíscuít,illidan,1864,mage,arcane,139,76,63
14912,Birdfather,tichondrius,1861,mage,arcane,48,33,15
14913,Snortmeth,area-52,1841,mage,arcane,90,58,32
14914,Vampìrelolz,tichondrius,1809,mage,arcane,48,26,22
14915,Delibro,tichondrius,1786,mage,arcane,64,35,29
14916,Elfmage,tichondrius,1777,mage,arcane,30,19,11
14917,Mokelovin,sargeras,1763,mage,arcane,59,30,29
14918,Hallat,archimonde,1735,mage,arcane,338,166,172
14919,Ezchallenger,undermine,1724,mage,arcane,78,33,45
14920,Lmaginedying,illidan,1715,mage,arcane,30,24,6
14921,Dawitchery,illidan,1712,mage,arcane,52,23,29
14922,Zps,illidan,1706,mage,arcane,72,40,32
14923,Badboykilla,dentarg,1704,mage,arcane,39,33,6
14924,Arianark,sargeras,1697,mage,arcane,90,55,35
14925,Hocusjokus,frostmourne,1691,mage,arcane,30,21,9
14926,Edgkey,illidan,1688,mage,arcane,50,25,25
14927,Spart,runetotem,1676,mage,arcane,45,20,25
14928,Clutchy,gorefiend,1672,mage,arcane,42,29,13
14929,Ligmmah,stormrage,1672,mage,arcane,36,21,15
14930,Nyj,tichondrius,1668,mage,arcane,59,33,26
14931,Maegwynah,jaedenar,1665,mage,arcane,40,20,20
14932,Bananappeal,kelthuzad,1661,mage,arcane,46,22,24
14933,Shwaysted,burning-blade,1657,mage,arcane,42,22,20
14934,Tbkz,amanthul,1656,mage,arcane,42,20,22
14935,Exterminatüs,tichondrius,1652,mage,arcane,81,41,40
14936,Höövalt,illidan,1641,mage,arcane,30,20,10
14937,Spitemage,tichondrius,1638,mage,arcane,103,49,54
14938,Xialing,tichondrius,1631,mage,arcane,40,24,16
14939,Spellsteål,malganis,1627,mage,arcane,53,31,22
14940,Magecombe,thrall,1617,mage,arcane,30,17,13
14941,Dmgperseç,tichondrius,1612,mage,arcane,30,20,10
14942,Proximalol,tichondrius,1610,mage,arcane,36,20,16
14943,Ject,ragnaros,1606,mage,arcane,155,84,71
14944,Hööva,illidan,1604,mage,arcane,30,17,13
14945,Rhythmdog,tichondrius,1603,mage,arcane,45,21,24
14946,Primearcanis,tol-barad,1601,mage,arcane,48,22,26
14947,Höövaltx,illidan,1600,mage,arcane,36,19,17
14948,Sestren,zuljin,1591,mage,arcane,73,34,39
14949,Felsparkles,area-52,1589,mage,arcane,54,30,24
14950,Waisted,kelthuzad,1563,mage,arcane,33,20,13
14951,Clernlol,emerald-dream,1548,mage,arcane,60,27,33
14952,Kickpollyplx,lothar,1547,mage,arcane,65,43,22
14953,Perrc,area-52,1546,mage,arcane,174,88,86
14954,Zhanna,nazjatar,1535,mage,arcane,96,47,49
14955,Prosperoh,burning-legion,1526,mage,arcane,48,25,23
14956,Dbox,stormscale,1525,mage,arcane,82,44,38
14957,Agoniey,illidan,1525,mage,arcane,138,69,69
14958,Étel,nemesis,1524,mage,arcane,36,17,19
14959,Vênsêr,emerald-dream,1523,mage,arcane,36,17,19
14960,Lucidaze,daggerspine,1502,mage,arcane,133,65,68
14961,Cyphen,proudmoore,1500,mage,arcane,30,16,14
14962,Alode,moon-guard,1498,mage,arcane,48,29,19
14963,Maplemage,akama,1494,mage,arcane,172,91,81
14964,Beerbelly,tichondrius,1486,mage,arcane,65,39,26
14965,Hustle,frostmourne,1483,mage,arcane,102,53,49
14966,Wretchy,ragnaros,1473,mage,arcane,61,33,28
14967,Linkolni,azralon,1462,mage,arcane,111,59,52
14968,Hennimage,sargeras,1459,mage,arcane,146,84,62
14969,Missile,frostmourne,1454,mage,arcane,36,17,19
14970,Swàn,stormrage,1444,mage,arcane,42,23,19
14971,Sáron,quelthalas,1431,mage,arcane,78,41,37
14972,Lünå,onyxia,1429,mage,arcane,42,28,14
14973,Balencii,kiljaeden,1419,mage,arcane,24,15,9
14974,Somariais,illidan,1399,mage,arcane,42,20,22
14975,Söngs,goldrinn,1387,mage,arcane,24,15,9
14976,Frozonnee,aggramar,1379,mage,arcane,24,15,9
14977,Wizzyx,illidan,1373,mage,arcane,40,21,19
14978,Castarcane,nordrassil,1370,mage,arcane,36,17,19
14979,Avandal,proudmoore,1362,mage,arcane,71,29,42
14980,Astrojrue,sargeras,1353,mage,arcane,41,21,20
14981,Melkdud,wyrmrest-accord,1341,mage,arcane,24,14,10
14982,Magnesiium,illidan,1330,mage,arcane,28,15,13
14983,Themagicman,whisperwind,1324,mage,arcane,42,17,25
14984,Coôler,illidan,1313,mage,arcane,39,16,23
14985,Szrp,stormrage,1306,mage,arcane,51,23,28
14986,Ruzam,area-52,1303,mage,arcane,186,91,95
14987,Draell,drakkari,1301,mage,arcane,54,30,24
14988,Véyda,emerald-dream,1300,mage,arcane,60,30,30
14989,Airbnb,area-52,1299,mage,arcane,46,26,20
14990,Valrendor,nazjatar,1298,mage,arcane,96,54,42
14991,Zayth,silvermoon,1297,mage,arcane,42,21,21
14992,Gin,nemesis,1296,mage,arcane,48,24,24
14993,Oharvestero,illidan,1290,mage,arcane,31,16,15
14994,Chezzmasterx,misha,1289,mage,arcane,69,34,35
14995,Jedamere,proudmoore,1260,mage,arcane,48,23,25
14996,Strêss,kelthuzad,1255,mage,arcane,123,60,63
14997,Skywalkerino,azralon,1254,mage,arcane,139,72,67
14998,Gessin,area-52,1245,mage,arcane,100,50,50
14999,Nedrin,nemesis,1244,mage,arcane,66,32,34
15000,Aosin,wyrmrest-accord,1240,mage,arcane,18,13,5
15001,Unlike,sargeras,1235,mage,arcane,71,29,42
15002,Antifreezex,tichondrius,1223,mage,arcane,70,39,31
15003,Kevymarts,tichondrius,1210,mage,arcane,36,14,22
15004,Chëryl,proudmoore,1197,mage,arcane,142,67,75
15005,Dereliction,nagrand,1185,mage,arcane,102,52,50
15006,Holbrook,greymane,1175,mage,arcane,90,41,49
15007,Greenwise,illidan,1170,mage,arcane,54,28,26
15008,Gryd,area-52,1165,mage,arcane,90,47,43
15009,Yonzho,area-52,1160,mage,arcane,20,13,7
15010,Fearhades,drakkari,1159,mage,arcane,24,13,11
15011,Nekrobear,nemesis,1150,mage,arcane,36,16,20
15012,Thewizârd,stormrage,1143,mage,arcane,234,119,115
15013,Caseyjelly,tichondrius,1142,mage,arcane,24,12,12
15014,Allýria,stormrage,1138,mage,arcane,30,12,18
15015,Firehawk,azralon,1133,mage,arcane,24,15,9
15016,Cokézero,frostmourne,1128,mage,arcane,49,24,25
15017,Nunezz,mannoroth,1117,mage,arcane,36,18,18
15018,Badwoman,tichondrius,1111,mage,arcane,36,13,23
15019,Oyagi,moon-guard,1097,mage,arcane,89,42,47
15020,Cassanara,moon-guard,1090,mage,arcane,30,13,17
15021,Klausgc,sargeras,1084,mage,arcane,20,12,8
15022,Tsarevich,fizzcrank,1069,mage,arcane,48,22,26
15023,Flaux,sargeras,1055,mage,arcane,18,11,7
15024,Tommagic,tichondrius,1055,mage,arcane,30,11,19
15025,Wïzarduous,mannoroth,1053,mage,arcane,18,11,7
15026,Enthy,frostmourne,1052,mage,arcane,24,11,13
15027,Zukoprince,azralon,1051,mage,arcane,12,11,1
15028,Shmage,dragonmaw,1050,mage,arcane,24,11,13
15029,Celciius,stormrage,1035,mage,arcane,38,12,26
15030,Melkra,tichondrius,1033,mage,arcane,24,11,13
15031,Sceledrus,quelthalas,1017,mage,arcane,24,11,13
15032,Kittikk,tichondrius,1005,mage,arcane,119,53,66
15033,Maiddan,azralon,1000,mage,arcane,20,12,8
15034,Smoks,stormrage,973,mage,arcane,26,12,14
15035,Raeign,frostmourne,972,mage,arcane,141,67,74
15036,Nightsaber,blackrock,960,mage,arcane,12,10,2
15037,Sorankim,tichondrius,960,mage,arcane,18,10,8
15038,Windwìtch,quelthalas,960,mage,arcane,18,10,8
15039,Gachaguy,bleeding-hollow,960,mage,arcane,30,10,20
15040,Velvetlurker,sargeras,959,mage,arcane,24,10,14
15041,Zerathremar,proudmoore,958,mage,arcane,18,10,8
15042,Haze,hyjal,955,mage,arcane,18,10,8
15043,Tagere,moon-guard,954,mage,arcane,24,10,14
15044,Orderlight,alexstrasza,954,mage,arcane,24,10,14
15045,Wizfajita,malganis,951,mage,arcane,24,10,14
15046,Wøogles,sargeras,946,mage,arcane,24,10,14
15047,Morkleen,korgath,943,mage,arcane,30,10,20
15048,Shadows,exodar,934,mage,arcane,24,10,14
15049,Akagamix,sargeras,924,mage,arcane,36,17,19
15050,Dietdeww,borean-tundra,913,mage,arcane,18,10,8
15051,Khierlana,hellscream,903,mage,arcane,66,27,39
15052,Mastablastar,windrunner,899,mage,arcane,23,10,13
15053,Søkø,tichondrius,868,mage,arcane,30,11,19
15054,Jazzgroyper,sargeras,864,mage,arcane,18,9,9
15055,Viôlentj,area-52,863,mage,arcane,12,9,3
15056,Arcalìte,illidan,863,mage,arcane,15,10,5
15057,Harshx,bleeding-hollow,863,mage,arcane,18,9,9
15058,Pandazed,proudmoore,863,mage,arcane,18,9,9
15059,Blaxmagic,stormrage,862,mage,arcane,18,9,9
15060,Edisia,moon-guard,862,mage,arcane,18,9,9
15061,Instataterz,eonar,833,mage,arcane,29,9,20
15062,Sherian,queldorei,832,mage,arcane,18,9,9
15063,Drainbamage,coilfang,810,mage,arcane,54,10,44
15064,Jackson,altar-of-storms,809,mage,arcane,60,17,43
15065,Kirayu,gilneas,798,mage,arcane,16,9,7
15066,Unmix,tichondrius,794,mage,arcane,20,9,11
15067,Spellstéal,tichondrius,768,mage,arcane,12,8,4
15068,Lewpithy,area-52,768,mage,arcane,12,8,4
15069,Glaciated,the-forgotten-coast,768,mage,arcane,12,8,4
15070,Cinnamon,boulderfist,768,mage,arcane,12,8,4
15071,Eludin,aegwynn,768,mage,arcane,18,8,10
15072,Jööz,deathwing,768,mage,arcane,18,8,10
15073,Mageboy,bonechewer,768,mage,arcane,18,8,10
15074,Watchmepog,tichondrius,767,mage,arcane,12,8,4
15075,Crøwgawd,tichondrius,767,mage,arcane,12,8,4
15076,Fakebusiness,area-52,767,mage,arcane,18,8,10
15077,Delana,darkspear,766,mage,arcane,24,8,16
15078,Boredmoomoo,thunderlord,765,mage,arcane,12,8,4
15079,Archtype,azralon,764,mage,arcane,24,8,16
15080,Christensen,stormrage,761,mage,arcane,18,8,10
15081,Randalf,dragonmaw,755,mage,arcane,12,8,4
15082,Aycc,tichondrius,735,mage,arcane,17,8,9
15083,Failedwizard,frostmourne,714,mage,arcane,34,10,24
15084,Perkaset,turalyon,703,mage,arcane,17,8,9
15085,Noescaping,illidan,687,mage,arcane,19,8,11
15086,Rof,sargeras,672,mage,arcane,12,7,5
15087,Valériemeow,tichondrius,672,mage,arcane,18,7,11
15088,Zezima,spirestone,671,mage,arcane,12,7,5
15089,Murr,boulderfist,671,mage,arcane,12,7,5
15090,Ankidar,quelthalas,671,mage,arcane,18,7,11
15091,Warthormage,stormrage,670,mage,arcane,12,7,5
15092,Austere,boulderfist,670,mage,arcane,12,7,5
15093,Derkrìeger,turalyon,670,mage,arcane,18,7,11
15094,Zimzum,bladefist,666,mage,arcane,12,7,5
15095,Cubanarox,gallywix,661,mage,arcane,24,7,17
15096,Karamzov,zuljin,652,mage,arcane,24,7,17
15097,Softbody,barthilas,634,mage,arcane,27,7,20
15098,Arcanochillz,ghostlands,621,mage,arcane,21,8,13
15099,Fryry,dalaran,576,mage,arcane,12,6,6
15100,Astroner,frostmourne,576,mage,arcane,12,6,6
15101,Aeghis,stormrage,576,mage,arcane,12,6,6
15102,Nazmagus,hydraxis,576,mage,arcane,18,6,12
15103,Cicciozi,sargeras,576,mage,arcane,24,6,18
15104,Moond,drakkari,575,mage,arcane,12,6,6
15105,Zulugara,barthilas,575,mage,arcane,18,6,12
15106,Mageyoulooks,kelthuzad,575,mage,arcane,18,6,12
15107,Lacouet,lightnings-blade,575,mage,arcane,24,6,18
15108,Ispell,tichondrius,573,mage,arcane,24,6,18
15109,Enfuegoe,tichondrius,571,mage,arcane,12,6,6
15110,Waef,quelthalas,571,mage,arcane,12,6,6
15111,Esien,tichondrius,522,mage,arcane,20,7,13
15112,Skillsbro,arthas,480,mage,arcane,6,5,1
15113,Zeró,frostmourne,480,mage,arcane,6,5,1
15114,Wauzcrol,quelthalas,480,mage,arcane,12,5,7
15115,Dagreatone,malganis,480,mage,arcane,12,5,7
15116,Shäräpova,zuljin,480,mage,arcane,12,5,7
15117,Hansol,farstriders,480,mage,arcane,12,5,7
15118,Maxtorgar,quelthalas,480,mage,arcane,12,5,7
15119,Diamondx,ragnaros,480,mage,arcane,12,5,7
15120,Hogdog,illidan,480,mage,arcane,18,5,13
15121,Kosiris,tichondrius,480,mage,arcane,18,5,13
15122,Humpadumplin,wyrmrest-accord,478,mage,arcane,24,5,19
15123,Merlon,dalaran,476,mage,arcane,12,5,7
15124,Culours,stormrage,472,mage,arcane,12,5,7
15125,Squishymage,moon-guard,446,mage,arcane,17,5,12
15126,Baskal,area-52,431,mage,arcane,17,5,12
15127,Larouse,quelthalas,415,mage,arcane,8,5,3
15128,Asalumm,quelthalas,398,mage,arcane,13,6,7
15129,Garrieto,sargeras,384,mage,arcane,6,4,2
15130,Rositajonez,terenas,384,mage,arcane,6,4,2
15131,Imbusting,kiljaeden,384,mage,arcane,6,4,2
15132,Gelokay,tichondrius,384,mage,arcane,6,4,2
15133,Wanming,tichondrius,384,mage,arcane,6,4,2
15134,Magicos,frostmourne,384,mage,arcane,6,4,2
15135,Tuggernaug,malganis,384,mage,arcane,6,4,2
15136,Lightsoran,tichondrius,384,mage,arcane,6,4,2
15137,Hasteboy,kelthuzad,384,mage,arcane,6,4,2
15138,Cømbust,frostmourne,384,mage,arcane,6,4,2
15139,Jordèb,sargeras,384,mage,arcane,6,4,2
15140,Dogmagetw,tichondrius,384,mage,arcane,6,4,2
15141,Fredcouples,tichondrius,384,mage,arcane,6,4,2
15142,Skoals,thrall,384,mage,arcane,6,4,2
15143,Chilléd,tichondrius,384,mage,arcane,6,4,2
15144,Parapio,tichondrius,384,mage,arcane,6,4,2
15145,Lavaera,illidan,384,mage,arcane,6,4,2
15146,Azeroth,boulderfist,384,mage,arcane,7,4,3
15147,Nesomage,destromath,384,mage,arcane,12,4,8
15148,Gobbstoppers,dalaran,384,mage,arcane,12,4,8
15149,Billzeye,dalaran,384,mage,arcane,12,4,8
15150,Biotic,kiljaeden,384,mage,arcane,12,4,8
15151,Forestella,tichondrius,384,mage,arcane,12,4,8
15152,Bigbuttangel,borean-tundra,384,mage,arcane,12,4,8
15153,Scxut,tichondrius,384,mage,arcane,12,4,8
15154,Khaldyn,tichondrius,384,mage,arcane,12,4,8
15155,Inmylife,tichondrius,384,mage,arcane,12,4,8
15156,Granmago,azralon,384,mage,arcane,12,4,8
15157,Hogslop,saurfang,384,mage,arcane,12,4,8
15158,Döömsage,hydraxis,384,mage,arcane,12,4,8
15159,Frozorfs,tichondrius,384,mage,arcane,18,4,14
15160,Thetodd,emerald-dream,382,mage,arcane,6,4,2
15161,Preckwinkle,moon-guard,382,mage,arcane,12,4,8
15162,Ærtai,black-dragonflight,304,mage,arcane,7,4,3
15163,Moogician,aerie-peak,304,mage,arcane,7,4,3
15164,Grarg,stormrage,301,mage,arcane,7,4,3
15165,Kârén,aggramar,288,mage,arcane,6,3,3
15166,Xythros,stormrage,288,mage,arcane,6,3,3
15167,Vengefuly,tichondrius,288,mage,arcane,6,3,3
15168,Unknownblast,kul-tiras,288,mage,arcane,6,3,3
15169,Milfmaster,aerie-peak,288,mage,arcane,6,3,3
15170,Kogin,thrall,288,mage,arcane,6,3,3
15171,Sazza,tichondrius,288,mage,arcane,6,3,3
15172,Koro,tichondrius,288,mage,arcane,6,3,3
15173,Pwnstarx,proudmoore,288,mage,arcane,6,3,3
15174,Snoogma,illidan,288,mage,arcane,6,3,3
15175,Natzue,sargeras,288,mage,arcane,6,3,3
15176,Bobbyyx,sargeras,288,mage,arcane,6,3,3
15177,Xzude,korgath,288,mage,arcane,6,3,3
15178,Madpoondog,frostmourne,288,mage,arcane,6,3,3
15179,Zerodium,sargeras,288,mage,arcane,6,3,3
15180,Neverbroke,illidan,288,mage,arcane,6,3,3
15181,Adrazell,sargeras,288,mage,arcane,6,3,3
15182,Overratedxd,moon-guard,288,mage,arcane,6,3,3
15183,Jizzlez,tichondrius,288,mage,arcane,6,3,3
15184,Myrondor,tichondrius,288,mage,arcane,6,3,3
15185,Watchmesleep,tichondrius,288,mage,arcane,6,3,3
15186,Levalol,aggramar,288,mage,arcane,10,4,6
15187,Arçanemage,tichondrius,288,mage,arcane,12,3,9
15188,Elux,whisperwind,288,mage,arcane,12,3,9
15189,Toknsmoke,tichondrius,288,mage,arcane,12,3,9
15190,Heflash,azralon,288,mage,arcane,12,3,9
15191,Fasttwitch,kiljaeden,288,mage,arcane,12,3,9
15192,Skittels,azshara,288,mage,arcane,12,3,9
15193,Matmagic,drakkari,288,mage,arcane,13,3,10
15194,Freehoñgkong,tichondrius,288,mage,arcane,18,3,15
15195,Calcaster,aegwynn,287,mage,arcane,6,3,3
15196,Kryptekk,area-52,287,mage,arcane,6,3,3
15197,Ìgnìtìöñ,whisperwind,287,mage,arcane,12,3,9
15198,Prosperoo,aerie-peak,286,mage,arcane,6,3,3
15199,Arcanin,thunderlord,285,mage,arcane,12,3,9
15200,Etyx,tichondrius,239,mage,arcane,5,3,2
15201,Pay,nordrassil,223,mage,arcane,9,3,6
15202,Røcco,azralon,192,mage,arcane,4,3,1
15203,Opiumlord,tichondrius,192,mage,arcane,6,2,4
15204,Emden,khadgar,192,mage,arcane,6,2,4
15205,Sheepshot,dentarg,192,mage,arcane,6,2,4
15206,Ferdabombs,tichondrius,192,mage,arcane,6,2,4
15207,Mershon,tichondrius,192,mage,arcane,6,2,4
15208,Maguín,tichondrius,192,mage,arcane,6,2,4
15209,Alìv,tichondrius,192,mage,arcane,6,2,4
15210,Chinkins,illidan,192,mage,arcane,6,2,4
15211,Vensyr,stormrage,192,mage,arcane,6,2,4
15212,Pullmefingy,illidan,192,mage,arcane,6,2,4
15213,Vengx,tichondrius,192,mage,arcane,6,2,4
15214,Xpez,stormrage,192,mage,arcane,6,2,4
15215,Furrblock,tichondrius,192,mage,arcane,6,2,4
15216,Amoredis,the-venture-co,192,mage,arcane,6,2,4
15217,Akunimon,ragnaros,192,mage,arcane,6,2,4
15218,Burna,amanthul,192,mage,arcane,6,2,4
15219,Frostecho,moon-guard,192,mage,arcane,6,2,4
15220,Blastgodx,stormrage,192,mage,arcane,6,2,4
15221,Xunalatu,frostmourne,192,mage,arcane,6,2,4
15222,Crinkit,frostmourne,192,mage,arcane,6,2,4
15223,Icebish,skullcrusher,192,mage,arcane,6,2,4
15224,Caimil,echo-isles,192,mage,arcane,6,2,4
15225,Umber,dreadmaul,192,mage,arcane,6,2,4
15226,Xannymancan,tichondrius,192,mage,arcane,6,2,4
15227,Mymaage,andorhal,192,mage,arcane,6,2,4
15228,Fakelovè,area-52,192,mage,arcane,6,2,4
15229,Duffs,hyjal,192,mage,arcane,6,2,4
15230,Highafrn,area-52,192,mage,arcane,6,2,4
15231,Shimmerpoly,sargeras,192,mage,arcane,6,2,4
15232,Sweetypie,fenris,192,mage,arcane,6,2,4
15233,Compactor,emerald-dream,192,mage,arcane,12,2,10
15234,Mcshwackin,area-52,192,mage,arcane,12,2,10
15235,Barbarabush,hellscream,192,mage,arcane,12,2,10
15236,Gatka,quelthalas,192,mage,arcane,12,2,10
15237,Vires,kelthuzad,159,mage,arcane,5,2,3
15238,Respektwaman,tichondrius,128,mage,arcane,4,2,2
15239,Purpledrank,nagrand,96,mage,arcane,9,2,7
15240,Nachtt,sargeras,96,mage,arcane,6,1,5
15241,Flomin,tichondrius,96,mage,arcane,6,1,5
15242,Nazztwren,bleeding-hollow,96,mage,arcane,6,1,5
15243,Darthez,darkspear,96,mage,arcane,6,1,5
15244,Genozyde,elune,96,mage,arcane,6,1,5
15245,Coldrin,tichondrius,96,mage,arcane,6,1,5
15246,Singheart,tichondrius,96,mage,arcane,6,1,5
15247,Pollybot,tichondrius,96,mage,arcane,6,1,5
15248,Gôøglëlòl,nemesis,96,mage,arcane,6,1,5
15249,Burrbon,area-52,96,mage,arcane,6,1,5
15250,Xlordpagan,sargeras,96,mage,arcane,6,1,5
15251,Sahaquiel,tichondrius,96,mage,arcane,6,1,5
15252,Casarenarrus,staghelm,96,mage,arcane,6,1,5
15253,Trippy,senjin,96,mage,arcane,6,1,5
15254,Needmyvape,moon-guard,96,mage,arcane,6,1,5
15255,Hvnlyfathr,stormrage,96,mage,arcane,6,1,5
15256,Smôl,emerald-dream,96,mage,arcane,6,1,5
15257,Krazsus,tichondrius,96,mage,arcane,6,1,5
15258,Elemenopi,thrall,96,mage,arcane,6,1,5
15259,Mageki,ragnaros,96,mage,arcane,6,1,5
15260,Quinnfreeze,boulderfist,96,mage,arcane,6,1,5
15261,Ignit,stormrage,96,mage,arcane,6,1,5
15262,Telkham,tichondrius,96,mage,arcane,6,1,5
15263,Octané,illidan,96,mage,arcane,6,1,5
15264,Illúmi,moon-guard,96,mage,arcane,6,1,5
15265,Greaterbust,tichondrius,96,mage,arcane,12,1,11
15266,Nikittomage,echo-isles,96,mage,arcane,12,1,11
15267,Poofnpass,malorne,95,mage,arcane,6,1,5
15268,Kralien,dalaran,95,mage,arcane,6,1,5
15269,Sausage,boulderfist,84,mage,arcane,10,4,6
15270,Scribe,anvilmar,79,mage,arcane,5,1,4
15271,Frostmaul,dreadmaul,79,mage,arcane,11,1,10
15272,Keepinitnoob,tichondrius,63,mage,arcane,2,2,0
15273,Privilege,dragonmaw,31,mage,arcane,8,1,7
15274,Setback,illidan,2122,mage,fire,138,69,69
15275,Hansol,farstriders,2120,mage,fire,84,42,42
15276,Valériemeow,tichondrius,2097,mage,fire,115,57,58
15277,Xiaoxiaochu,tichondrius,2062,mage,fire,176,108,68
15278,Dáddyshark,sargeras,2057,mage,fire,127,64,63
15279,Talibandzx,sargeras,2042,mage,fire,159,77,82
15280,Asetback,illidan,2035,mage,fire,120,58,62
15281,Kyphosis,illidan,2022,mage,fire,107,64,43
15282,Taylorlol,tichondrius,2019,mage,fire,135,64,71
15283,Horoba,sargeras,2011,mage,fire,186,90,96
15284,Adjudicatory,tichondrius,2003,mage,fire,69,34,35
15285,Kasperkar,illidan,1991,mage,fire,245,124,121
15286,Vcamusorz,tichondrius,1970,mage,fire,166,87,79
15287,Gohonn,emerald-dream,1964,mage,fire,132,76,56
15288,Bigfirebat,tichondrius,1964,mage,fire,119,60,59
15289,Aeghis,stormrage,1958,mage,fire,48,26,22
15290,Getmaged,bleeding-hollow,1943,mage,fire,64,40,24
15291,Udmx,zuljin,1928,mage,fire,79,47,32
15292,Peachygamer,stormscale,1921,mage,fire,198,99,99
15293,Starxen,tichondrius,1915,mage,fire,54,31,23
15294,Purpscurp,illidan,1914,mage,fire,130,74,56
15295,Ranj,tichondrius,1913,mage,fire,73,35,38
15296,Poundcakezx,tichondrius,1905,mage,fire,54,28,26
15297,Vazlgs,tichondrius,1902,mage,fire,72,42,30
15298,Benisp,stormrage,1898,mage,fire,68,35,33
15299,Sorankim,tichondrius,1893,mage,fire,54,30,24
15300,Nightsaber,blackrock,1869,mage,fire,42,26,16
15301,Sunskim,tichondrius,1864,mage,fire,65,32,33
15302,Sorcerous,bloodhoof,1861,mage,fire,151,89,62
15303,Ròÿ,area-52,1861,mage,fire,72,37,35
15304,Opisop,kelthuzad,1858,mage,fire,60,32,28
15305,Degen,laughing-skull,1842,mage,fire,46,31,15
15306,Ksmackm,illidan,1842,mage,fire,65,34,31
15307,Undeadmerlin,zuljin,1834,mage,fire,54,30,24
15308,Rmxd,malganis,1833,mage,fire,90,46,44
15309,Wanming,tichondrius,1832,mage,fire,60,35,25
15310,Vampìrelolz,tichondrius,1828,mage,fire,47,25,22
15311,Csx,turalyon,1826,mage,fire,132,73,59
15312,Cinnablast,darkspear,1824,mage,fire,26,20,6
15313,Fwooshinator,malganis,1823,mage,fire,71,56,15
15314,Såni,tichondrius,1819,mage,fire,67,39,28
15315,Kraxos,stormrage,1814,mage,fire,108,62,46
15316,Yaya,kargath,1811,mage,fire,105,51,54
15317,Wiredcc,illidan,1805,mage,fire,30,20,10
15318,Notini,azralon,1805,mage,fire,131,63,68
15319,Epod,illidan,1801,mage,fire,60,28,32
15320,Juju,tichondrius,1796,mage,fire,75,44,31
15321,Zoryack,azralon,1791,mage,fire,96,50,46
15322,Pinkmagetko,tichondrius,1775,mage,fire,36,19,17
15323,Volkazar,sargeras,1766,mage,fire,39,21,18
15324,Käxs,ragnaros,1762,mage,fire,42,21,21
15325,Yorgøs,ragnaros,1736,mage,fire,60,31,29
15326,Formi,frostmourne,1734,mage,fire,54,29,25
15327,Highms,stormrage,1727,mage,fire,54,28,26
15328,Icetomeetyu,bleeding-hollow,1726,mage,fire,185,92,93
15329,Dropdeadlol,bonechewer,1725,mage,fire,78,48,30
15330,Deepgodsz,azralon,1725,mage,fire,42,23,19
15331,Wizarts,ragnaros,1725,mage,fire,60,27,33
15332,Stergenutfr,tichondrius,1720,mage,fire,42,27,15
15333,Englavian,frostmane,1709,mage,fire,54,28,26
15334,Háté,ragnaros,1709,mage,fire,114,47,67
15335,Snoogma,illidan,1702,mage,fire,35,25,10
15336,Mângo,frostmourne,1699,mage,fire,24,18,6
15337,Likebutter,tichondrius,1695,mage,fire,30,22,8
15338,Younghehe,tichondrius,1692,mage,fire,148,77,71
15339,Dagreatone,malganis,1687,mage,fire,46,24,22
15340,Banquetmeal,emerald-dream,1686,mage,fire,42,27,15
15341,Farragan,ragnaros,1686,mage,fire,42,18,24
15342,Alenikus,blackhand,1680,mage,fire,98,50,48
15343,Nickioxox,tichondrius,1674,mage,fire,24,18,6
15344,Bighot,tichondrius,1673,mage,fire,90,53,37
15345,Ligmmah,stormrage,1669,mage,fire,66,39,27
15346,Ööf,emerald-dream,1667,mage,fire,66,30,36
15347,Daddymayhem,proudmoore,1653,mage,fire,54,24,30
15348,Magibe,thrall,1652,mage,fire,36,24,12
15349,Itshug,area-52,1652,mage,fire,53,27,26
15350,Lycheeoolong,frostmourne,1649,mage,fire,38,22,16
15351,Varroc,quelthalas,1647,mage,fire,124,58,66
15352,Pootysmooch,sargeras,1639,mage,fire,54,33,21
15353,Oi,frostwolf,1636,mage,fire,75,48,27
15354,Chionê,velen,1634,mage,fire,30,18,12
15355,Tuniepop,sargeras,1631,mage,fire,89,44,45
15356,Rockoe,tichondrius,1630,mage,fire,76,44,32
15357,Trippy,senjin,1630,mage,fire,60,30,30
15358,Vcamus,tichondrius,1629,mage,fire,24,17,7
15359,Ârcano,ragnaros,1628,mage,fire,53,29,24
15360,Gigatuts,stormrage,1625,mage,fire,42,22,20
15361,Enthy,frostmourne,1623,mage,fire,60,30,30
15362,Tweydey,tichondrius,1621,mage,fire,30,17,13
15363,Thxo,hyjal,1620,mage,fire,87,41,46
15364,Dexpy,tichondrius,1619,mage,fire,37,20,17
15365,Myrondor,tichondrius,1611,mage,fire,78,43,35
15366,Creaystar,area-52,1611,mage,fire,202,97,105
15367,Wotl,tichondrius,1610,mage,fire,181,94,87
15368,Chainpoly,area-52,1609,mage,fire,37,25,12
15369,Muztaccio,tichondrius,1608,mage,fire,59,31,28
15370,Fruitdealerr,tichondrius,1607,mage,fire,48,29,19
15371,Torched,stormreaver,1605,mage,fire,42,21,21
15372,Zarkanis,tichondrius,1604,mage,fire,49,25,24
15373,Mushys,stormrage,1601,mage,fire,35,22,13
15374,Jardz,area-52,1597,mage,fire,42,21,21
15375,Sakurai,tichondrius,1593,mage,fire,48,28,20
15376,Djpolymorph,stormrage,1587,mage,fire,102,58,44
15377,Murcury,tichondrius,1584,mage,fire,238,122,116
15378,Pzaz,moon-guard,1582,mage,fire,50,30,20
15379,Sandylove,zuljin,1582,mage,fire,36,17,19
15380,Hpthewizard,deathwing,1579,mage,fire,89,52,37
15381,Iceward,frostmourne,1579,mage,fire,66,30,36
15382,Magicmaghar,area-52,1577,mage,fire,42,24,18
15383,Garbagemage,barthilas,1572,mage,fire,78,41,37
15384,Firewreckage,malganis,1566,mage,fire,68,31,37
15385,Kev,sentinels,1559,mage,fire,102,55,47
15386,Marrioo,tichondrius,1555,mage,fire,42,22,20
15387,Audacy,sargeras,1551,mage,fire,138,69,69
15388,Wickymorph,barthilas,1549,mage,fire,53,25,28
15389,Trolson,sargeras,1546,mage,fire,54,26,28
15390,Lilbabyx,stormrage,1538,mage,fire,74,39,35
15391,Xs,stormrage,1534,mage,fire,120,67,53
15392,Teetems,sargeras,1530,mage,fire,116,59,57
15393,Fifthelëment,emerald-dream,1529,mage,fire,119,65,54
15394,Squantanimo,shadowmoon,1527,mage,fire,53,26,27
15395,Kindle,malorne,1525,mage,fire,33,18,15
15396,Lolololololo,kelthuzad,1525,mage,fire,198,100,98
15397,Magekylex,proudmoore,1522,mage,fire,99,58,41
15398,Pyroshima,barthilas,1522,mage,fire,89,44,45
15399,Biscobush,turalyon,1519,mage,fire,30,18,12
15400,Crazytime,tichondrius,1519,mage,fire,42,23,19
15401,Albbano,tichondrius,1518,mage,fire,24,16,8
15402,Fookz,malganis,1515,mage,fire,60,32,28
15403,Imannoyingha,darkspear,1510,mage,fire,71,37,34
15404,Mager,dentarg,1508,mage,fire,62,40,22
15405,Ultrá,stormscale,1504,mage,fire,72,42,30
15406,Skryte,mannoroth,1504,mage,fire,40,22,18
15407,Coneofkony,bleeding-hollow,1503,mage,fire,30,20,10
15408,Bajaoreily,zangarmarsh,1501,mage,fire,36,17,19
15409,Anuub,kelthuzad,1497,mage,fire,36,20,16
15410,Pòlly,illidan,1495,mage,fire,42,25,17
15411,Wïzarduous,mannoroth,1494,mage,fire,48,30,18
15412,Mariomario,tichondrius,1494,mage,fire,60,35,25
15413,Juul,emerald-dream,1492,mage,fire,126,62,64
15414,Mirimida,ragnaros,1490,mage,fire,105,61,44
15415,Beerandmagic,zuljin,1487,mage,fire,30,16,14
15416,Coolhandz,tichondrius,1487,mage,fire,47,24,23
15417,Dârkus,sargeras,1487,mage,fire,122,60,62
15418,Grynthwzrd,stormrage,1484,mage,fire,42,24,18
15419,Streetember,nemesis,1483,mage,fire,78,35,43
15420,Toastedoats,hyjal,1482,mage,fire,85,46,39
15421,Jojomage,thrall,1473,mage,fire,138,71,67
15422,Chickenspank,stormrage,1473,mage,fire,36,18,18
15423,Nazmagus,hydraxis,1470,mage,fire,93,51,42
15424,Anàrchy,emerald-dream,1469,mage,fire,51,29,22
15425,Leonr,tichondrius,1464,mage,fire,65,39,26
15426,Smallbrainz,emerald-dream,1462,mage,fire,60,34,26
15427,Ferdabombs,tichondrius,1460,mage,fire,90,50,40
15428,Frostpimp,anubarak,1460,mage,fire,60,22,38
15429,Singheart,tichondrius,1457,mage,fire,162,80,82
15430,Pyroflinger,stormrage,1453,mage,fire,90,46,44
15431,Worldonfire,ragnaros,1450,mage,fire,160,80,80
15432,Sparklepoof,tichondrius,1449,mage,fire,29,17,12
15433,Bettybonk,cenarius,1449,mage,fire,42,20,22
15434,Firèballin,tichondrius,1441,mage,fire,31,17,14
15435,Sabrita,proudmoore,1440,mage,fire,36,16,20
15436,Xanthan,runetotem,1437,mage,fire,39,21,18
15437,Swaglo,illidan,1435,mage,fire,40,18,22
15438,Sahala,frostmourne,1424,mage,fire,42,19,23
15439,Sydrol,area-52,1423,mage,fire,129,68,61
15440,Jööz,deathwing,1423,mage,fire,45,20,25
15441,Yooyar,barthilas,1422,mage,fire,130,60,70
15442,Snanth,black-dragonflight,1420,mage,fire,51,29,22
15443,Øzmage,area-52,1416,mage,fire,21,16,5
15444,Mudohir,stormrage,1415,mage,fire,34,16,18
15445,Skoffla,executus,1411,mage,fire,42,22,20
15446,Eekzlol,illidan,1409,mage,fire,30,16,14
15447,Snuurf,ragnaros,1406,mage,fire,60,31,29
15448,Ålmøst,tichondrius,1405,mage,fire,65,36,29
15449,Dreadparadox,bleeding-hollow,1405,mage,fire,34,16,18
15450,Yeetcannøn,illidan,1403,mage,fire,30,15,15
15451,Marajaade,tichondrius,1403,mage,fire,80,38,42
15452,Mayumî,moon-guard,1401,mage,fire,34,18,16
15453,Whiteyx,saurfang,1399,mage,fire,52,29,23
15454,Wakkaflame,stormrage,1398,mage,fire,48,19,29
15455,Ruzam,area-52,1394,mage,fire,66,31,35
15456,Jundead,dalaran,1393,mage,fire,79,46,33
15457,Hööva,illidan,1392,mage,fire,71,35,36
15458,Jizzlez,tichondrius,1392,mage,fire,48,23,25
15459,Eazzybaby,eredar,1388,mage,fire,424,217,207
15460,Coôler,illidan,1388,mage,fire,84,40,44
15461,Gasolína,stormrage,1385,mage,fire,48,28,20
15462,Purpledrank,nagrand,1385,mage,fire,85,39,46
15463,Leaso,tichondrius,1384,mage,fire,45,22,23
15464,Neglect,moknathal,1375,mage,fire,30,16,14
15465,Wzrdxz,tichondrius,1370,mage,fire,36,17,19
15466,Mageonthc,korgath,1368,mage,fire,23,15,8
15467,Melkra,tichondrius,1367,mage,fire,52,26,26
15468,Garungar,antonidas,1361,mage,fire,24,15,9
15469,Coltrip,azralon,1359,mage,fire,83,38,45
15470,Elwyn,dunemaul,1358,mage,fire,60,29,31
15471,Zstyle,frostmourne,1355,mage,fire,37,22,15
15472,Elysõna,area-52,1349,mage,fire,72,35,37
15473,Prinseza,quelthalas,1345,mage,fire,55,27,28
15474,Badaszbich,tichondrius,1344,mage,fire,36,20,16
15475,Sikeyzlol,bleeding-hollow,1343,mage,fire,24,14,10
15476,Coldcaster,mugthol,1340,mage,fire,74,40,34
15477,Dearasian,ragnaros,1335,mage,fire,60,32,28
15478,Búrsting,kelthuzad,1334,mage,fire,31,16,15
15479,Adrazell,sargeras,1333,mage,fire,42,21,21
15480,Gødvana,frostmourne,1331,mage,fire,30,18,12
15481,Charkoalzz,moon-guard,1323,mage,fire,29,14,15
15482,Holbrook,greymane,1316,mage,fire,49,24,25
15483,Quizzard,blackrock,1310,mage,fire,28,15,13
15484,Raynark,nemesis,1307,mage,fire,30,18,12
15485,Waffles,ravencrest,1307,mage,fire,62,29,33
15486,Kevymarts,tichondrius,1304,mage,fire,30,15,15
15487,Jjijuns,tichondrius,1302,mage,fire,40,18,22
15488,Carnelius,bleeding-hollow,1292,mage,fire,63,32,31
15489,Rudeswizard,area-52,1291,mage,fire,73,32,41
15490,Adronicus,tichondrius,1287,mage,fire,60,31,29
15491,Magination,frostmourne,1284,mage,fire,42,18,24
15492,Hypernova,vashj,1277,mage,fire,41,19,22
15493,Kronicblast,bleeding-hollow,1270,mage,fire,57,24,33
15494,Abzy,sargeras,1264,mage,fire,60,29,31
15495,Helcarwen,area-52,1261,mage,fire,60,30,30
15496,Christjan,tichondrius,1260,mage,fire,138,72,66
15497,Zulugara,barthilas,1258,mage,fire,36,19,17
15498,Hositonet,malganis,1257,mage,fire,63,35,28
15499,Reddfire,proudmoore,1253,mage,fire,42,15,27
15500,Smigui,azralon,1252,mage,fire,152,71,81
15501,Babysharky,uther,1249,mage,fire,34,14,20
15502,Glaucus,illidan,1247,mage,fire,18,13,5
15503,Fíery,blades-edge,1243,mage,fire,72,34,38
15504,Alzagen,ragnaros,1241,mage,fire,56,26,30
15505,Subscribe,malganis,1238,mage,fire,36,14,22
15506,Feogato,proudmoore,1237,mage,fire,60,29,31
15507,Polymedaddi,tichondrius,1236,mage,fire,36,13,23
15508,Politeness,tichondrius,1233,mage,fire,24,13,11
15509,Christensen,stormrage,1231,mage,fire,30,17,13
15510,Slumpgodd,frostmourne,1230,mage,fire,30,13,17
15511,Gadgítte,moon-guard,1229,mage,fire,24,13,11
15512,Aerligar,area-52,1225,mage,fire,24,13,11
15513,Dragonie,nordrassil,1224,mage,fire,45,23,22
15514,Cymbalta,azralon,1219,mage,fire,29,20,9
15515,Zinnos,tichondrius,1218,mage,fire,30,13,17
15516,Archtype,azralon,1217,mage,fire,18,13,5
15517,Genthruz,ragnaros,1215,mage,fire,48,22,26
15518,Mongomike,stormrage,1205,mage,fire,63,26,37
15519,Hadlly,tichondrius,1197,mage,fire,23,13,10
15520,Sorrenton,sargeras,1186,mage,fire,41,23,18
15521,Burist,illidan,1185,mage,fire,38,19,19
15522,Esfire,frostmourne,1185,mage,fire,48,23,25
15523,Zonmague,drakkari,1177,mage,fire,36,17,19
15524,Iguanodon,proudmoore,1159,mage,fire,56,29,27
15525,Tamarolfrost,illidan,1158,mage,fire,19,13,6
15526,Gradmage,proudmoore,1156,mage,fire,50,20,30
15527,Maxvila,kelthuzad,1152,mage,fire,18,12,6
15528,Snaregodx,area-52,1151,mage,fire,18,12,6
15529,Kjuuler,moon-guard,1151,mage,fire,24,12,12
15530,Dmgdaddy,zuljin,1150,mage,fire,30,12,18
15531,Rhykx,malganis,1149,mage,fire,18,12,6
15532,Frostymart,arthas,1149,mage,fire,18,12,6
15533,Coldsnapy,frostmourne,1148,mage,fire,24,12,12
15534,Balmunc,proudmoore,1147,mage,fire,18,12,6
15535,Chumpp,tichondrius,1147,mage,fire,18,12,6
15536,Dorkski,bleeding-hollow,1147,mage,fire,115,49,66
15537,Absentbrain,stormrage,1145,mage,fire,24,12,12
15538,Eatnu,tichondrius,1142,mage,fire,24,12,12
15539,Arrcadia,darkspear,1142,mage,fire,30,12,18
15540,Grymorum,ragnaros,1141,mage,fire,30,12,18
15541,Fleët,tichondrius,1139,mage,fire,18,12,6
15542,Usirfail,bleeding-hollow,1133,mage,fire,30,12,18
15543,Gnarwallx,stormrage,1132,mage,fire,30,12,18
15544,Wawakun,ragnaros,1127,mage,fire,30,14,16
15545,Magalí,nemesis,1122,mage,fire,36,16,20
15546,Xzilence,aerie-peak,1118,mage,fire,30,12,18
15547,Sánzunokawa,quelthalas,1109,mage,fire,27,16,11
15548,Noescaping,illidan,1102,mage,fire,24,12,12
15549,Saladguy,thrall,1101,mage,fire,42,14,28
15550,Gempette,tichondrius,1095,mage,fire,23,12,11
15551,Wazzerd,moon-guard,1093,mage,fire,27,12,15
15552,Guccilaflur,proudmoore,1082,mage,fire,27,12,15
15553,Crnomage,area-52,1081,mage,fire,23,12,11
15554,Pikoda,azralon,1066,mage,fire,28,12,16
15555,Lightsoran,tichondrius,1055,mage,fire,18,11,7
15556,Flaux,sargeras,1055,mage,fire,18,11,7
15557,Alorae,wyrmrest-accord,1054,mage,fire,18,11,7
15558,Avicci,shattered-halls,1054,mage,fire,30,11,19
15559,Blinksz,korgath,1053,mage,fire,18,11,7
15560,Cinns,moon-guard,1051,mage,fire,24,11,13
15561,Radakos,emerald-dream,1050,mage,fire,24,11,13
15562,Snoü,proudmoore,1049,mage,fire,30,11,19
15563,Harlloo,the-underbog,1049,mage,fire,30,11,19
15564,Kryptekk,area-52,1048,mage,fire,24,11,13
15565,Erlendr,moon-guard,1041,mage,fire,44,22,22
15566,Shashyta,drakkari,1031,mage,fire,54,14,40
15567,Flame,arthas,1028,mage,fire,30,11,19
15568,Putridìty,thrall,1024,mage,fire,24,11,13
15569,Ispell,tichondrius,1024,mage,fire,72,29,43
15570,Psycles,dragonmaw,1022,mage,fire,36,11,25
15571,Asönia,illidan,1020,mage,fire,30,11,19
15572,Ops,frostmourne,1009,mage,fire,117,62,55
15573,Hotjazzfarts,sargeras,1003,mage,fire,61,35,26
15574,Minerves,tichondrius,1001,mage,fire,28,13,15
15575,Grandpapi,arthas,997,mage,fire,23,11,12
15576,Amge,uldum,991,mage,fire,20,11,9
15577,Coldblooded,zuljin,991,mage,fire,41,14,27
15578,Absolutepowa,bleeding-hollow,986,mage,fire,20,11,9
15579,Bàttlemage,nagrand,982,mage,fire,36,21,15
15580,Sasghengis,frostmourne,981,mage,fire,36,16,20
15581,Lilmj,kelthuzad,970,mage,fire,25,11,14
15582,Endmepls,ysera,965,mage,fire,96,40,56
15583,Skaq,tichondrius,960,mage,fire,12,10,2
15584,Tupactopus,tichondrius,960,mage,fire,18,10,8
15585,Mokelovin,sargeras,959,mage,fire,18,10,8
15586,Squidio,stormrage,959,mage,fire,18,10,8
15587,Zakume,stormrage,958,mage,fire,18,10,8
15588,Osh,malorne,957,mage,fire,24,10,14
15589,Preceptør,azralon,957,mage,fire,24,10,14
15590,Alunarassra,tichondrius,956,mage,fire,24,10,14
15591,Dårks,area-52,955,mage,fire,24,10,14
15592,Ripburn,stormrage,953,mage,fire,47,20,27
15593,Etyx,tichondrius,953,mage,fire,30,10,20
15594,Flavaflame,mugthol,952,mage,fire,18,10,8
15595,Hýdro,ghostlands,951,mage,fire,30,16,14
15596,Clapsyou,illidan,951,mage,fire,24,10,14
15597,Zukoprince,azralon,950,mage,fire,12,10,2
15598,Abstractgoat,tichondrius,946,mage,fire,30,15,15
15599,Vamkari,ragnaros,942,mage,fire,18,10,8
15600,Coldarei,nagrand,928,mage,fire,27,12,15
15601,Dojacute,frostmourne,910,mage,fire,17,10,7
15602,Senegau,azralon,902,mage,fire,51,23,28
15603,Coldrin,tichondrius,897,mage,fire,28,11,17
15604,Alywgard,sargeras,894,mage,fire,22,10,12
15605,Beji,frostmourne,894,mage,fire,38,17,21
15606,Alaramaria,sargeras,886,mage,fire,18,10,8
15607,Jaysaucetv,tichondrius,878,mage,fire,19,10,9
15608,Squishymage,frostmourne,877,mage,fire,25,10,15
15609,Tungstentoes,shuhalo,875,mage,fire,21,12,9
15610,Nakana,area-52,875,mage,fire,52,25,27
15611,Strêss,kelthuzad,870,mage,fire,22,12,10
15612,Béssie,area-52,869,mage,fire,44,20,24
15613,Bigpøppapump,tichondrius,864,mage,fire,24,9,15
15614,Ddouble,tichondrius,863,mage,fire,18,9,9
15615,Dabsx,moon-guard,863,mage,fire,18,9,9
15616,Shimmerpoly,sargeras,863,mage,fire,24,9,15
15617,Scmage,exodar,862,mage,fire,18,9,9
15618,Desfunz,mugthol,862,mage,fire,18,9,9
15619,Unknownblast,kul-tiras,862,mage,fire,26,9,17
15620,Nachtt,sargeras,861,mage,fire,18,9,9
15621,Ingrumatig,tichondrius,861,mage,fire,24,9,15
15622,Fryry,dalaran,860,mage,fire,24,9,15
15623,Baelthezer,moon-guard,858,mage,fire,21,12,9
15624,Halfsquad,malfurion,858,mage,fire,18,9,9
15625,Product,mugthol,858,mage,fire,18,9,9
15626,Freez,garona,858,mage,fire,21,10,11
15627,Gadalka,frostmourne,857,mage,fire,18,9,9
15628,Othokk,tichondrius,852,mage,fire,24,9,15
15629,Dánó,lightbringer,843,mage,fire,62,26,36
15630,Umber,dreadmaul,829,mage,fire,17,9,8
15631,Ljaie,lightbringer,813,mage,fire,17,9,8
15632,Phantose,sargeras,808,mage,fire,22,10,12
15633,Arcanemain,kargath,799,mage,fire,42,18,24
15634,Pyrotactics,sargeras,796,mage,fire,28,9,19
15635,Mágos,stormrage,768,mage,fire,12,8,4
15636,Pherixsw,stormrage,768,mage,fire,12,8,4
15637,Dandrix,sargeras,768,mage,fire,12,8,4
15638,Castana,tichondrius,768,mage,fire,18,8,10
15639,Avócadó,malganis,768,mage,fire,18,8,10
15640,Salvick,emerald-dream,768,mage,fire,18,8,10
15641,Cumbus,stormrage,768,mage,fire,24,8,16
15642,Kawailenard,tichondrius,767,mage,fire,12,8,4
15643,Ogfresh,area-52,767,mage,fire,12,8,4
15644,Raisonmage,tichondrius,767,mage,fire,12,8,4
15645,Isendra,bleeding-hollow,767,mage,fire,12,8,4
15646,Ashenlad,moon-guard,766,mage,fire,18,8,10
15647,Tarmiel,quelthalas,765,mage,fire,24,8,16
15648,Isoicast,moon-guard,759,mage,fire,22,11,11
15649,Brànd,antonidas,758,mage,fire,12,8,4
15650,Orianne,windrunner,750,mage,fire,12,8,4
15651,Pyrlos,terokkar,738,mage,fire,24,9,15
15652,Orionmage,frostmourne,720,mage,fire,15,8,7
15653,Dìus,malganis,719,mage,fire,17,8,9
15654,Letitgoo,azralon,715,mage,fire,25,9,16
15655,Drewann,draenor,704,mage,fire,16,8,8
15656,Shmagee,azralon,684,mage,fire,13,8,5
15657,Sos,kelthuzad,672,mage,fire,12,7,5
15658,Xythros,stormrage,672,mage,fire,12,7,5
15659,Tuggernaug,malganis,672,mage,fire,12,7,5
15660,Vamplol,tichondrius,672,mage,fire,12,7,5
15661,Warpfactor,malganis,672,mage,fire,12,7,5
15662,Osirax,frostmane,672,mage,fire,12,7,5
15663,Belven,proudmoore,672,mage,fire,12,7,5
15664,Silimage,area-52,672,mage,fire,12,7,5
15665,Strumms,tichondrius,672,mage,fire,18,7,11
15666,Vastlord,stormrage,672,mage,fire,18,7,11
15667,Bigdjohnson,dalaran,672,mage,fire,18,7,11
15668,Blastfire,stormrage,671,mage,fire,12,7,5
15669,Diewnuts,zuljin,671,mage,fire,12,7,5
15670,Mymrmage,mannoroth,671,mage,fire,12,7,5
15671,Allhitz,ragnaros,671,mage,fire,12,7,5
15672,Aulle,whisperwind,671,mage,fire,12,7,5
15673,Lucidaze,daggerspine,671,mage,fire,12,7,5
15674,Ásune,moon-guard,671,mage,fire,12,7,5
15675,Keileon,tichondrius,671,mage,fire,12,7,5
15676,Alàh,stormscale,671,mage,fire,18,7,11
15677,Dreaming,draktharon,670,mage,fire,12,7,5
15678,Fanshen,tichondrius,670,mage,fire,17,7,10
15679,Supermajor,frostmourne,670,mage,fire,18,7,11
15680,Tmo,mannoroth,670,mage,fire,24,7,17
15681,Boptimus,moonrunner,666,mage,fire,12,7,5
15682,Vonfrmdao,illidan,624,mage,fire,15,8,7
15683,Slipqt,tichondrius,607,mage,fire,22,7,15
15684,Chumleyson,eonar,606,mage,fire,14,7,7
15685,Mômö,argent-dawn,606,mage,fire,22,7,15
15686,Mzr,proudmoore,576,mage,fire,6,6,0
15687,Strdelmaker,tichondrius,576,mage,fire,6,6,0
15688,Itizar,frostmourne,576,mage,fire,6,6,0
15689,Eludin,aegwynn,576,mage,fire,12,6,6
15690,Cuterthanyou,sargeras,576,mage,fire,12,6,6
15691,Tearsfórgód,kelthuzad,576,mage,fire,12,6,6
15692,Laradria,kiljaeden,576,mage,fire,12,6,6
15693,Myfamilygpie,nazgrel,576,mage,fire,12,6,6
15694,Shmoked,kelthuzad,576,mage,fire,12,6,6
15695,Mageboy,bonechewer,576,mage,fire,12,6,6
15696,Omagawd,tichondrius,576,mage,fire,12,6,6
15697,Fakewarlockk,illidan,576,mage,fire,12,6,6
15698,Kaylemage,tichondrius,576,mage,fire,12,6,6
15699,Fredcouples,tichondrius,576,mage,fire,12,6,6
15700,Herzthroh,stormrage,576,mage,fire,12,6,6
15701,Ghili,tichondrius,576,mage,fire,12,6,6
15702,Gtown,kelthuzad,576,mage,fire,12,6,6
15703,Sourpatchkds,emerald-dream,576,mage,fire,12,6,6
15704,Leakyboots,illidan,576,mage,fire,12,6,6
15705,Frostboy,borean-tundra,576,mage,fire,12,6,6
15706,Toteypotter,frostmourne,576,mage,fire,12,6,6
15707,Magicmidget,malganis,576,mage,fire,12,6,6
15708,Wakamage,area-52,576,mage,fire,12,6,6
15709,Plutón,tichondrius,576,mage,fire,12,6,6
15710,Darkisfrosty,tichondrius,576,mage,fire,12,6,6
15711,Jonboym,illidan,576,mage,fire,12,6,6
15712,Magicmichel,malganis,576,mage,fire,12,6,6
15713,Velvetlurker,tichondrius,576,mage,fire,12,6,6
15714,Aangx,stormrage,576,mage,fire,16,7,9
15715,Stimml,blood-furnace,576,mage,fire,18,6,12
15716,Pecs,kiljaeden,576,mage,fire,18,6,12
15717,Linkolni,azralon,576,mage,fire,18,6,12
15718,Choccoeu,illidan,576,mage,fire,20,6,14
15719,Insightæ,frostmourne,575,mage,fire,10,7,3
15720,Magja,bloodhoof,575,mage,fire,12,6,6
15721,Minuswizard,dalaran,575,mage,fire,12,6,6
15722,Astroblasty,tichondrius,575,mage,fire,18,6,12
15723,Eraticmage,illidan,575,mage,fire,24,6,18
15724,Calínico,quelthalas,575,mage,fire,24,6,18
15725,Pellemus,malganis,574,mage,fire,12,6,6
15726,Spellpowa,khaz-modan,574,mage,fire,12,6,6
15727,Calcaster,aegwynn,573,mage,fire,18,6,12
15728,Xannymancan,tichondrius,573,mage,fire,30,6,24
15729,Zendrix,bonechewer,571,mage,fire,18,6,12
15730,Ashex,moon-guard,559,mage,fire,18,7,11
15731,Thragè,sargeras,543,mage,fire,11,6,5
15732,Glacier,firetree,543,mage,fire,11,6,5
15733,Magicke,azgalor,542,mage,fire,22,6,16
15734,Sossmage,jaedenar,528,mage,fire,9,6,3
15735,Ghostrr,tichondrius,511,mage,fire,8,6,2
15736,Maxmie,sargeras,480,mage,fire,6,5,1
15737,Youezdawg,tichondrius,480,mage,fire,6,5,1
15738,Shaabby,shadowmoon,480,mage,fire,6,5,1
15739,Slavic,sargeras,480,mage,fire,6,5,1
15740,Ject,ragnaros,480,mage,fire,6,5,1
15741,Hocusjokus,frostmourne,480,mage,fire,6,5,1
15742,Ñïz,bleeding-hollow,480,mage,fire,6,5,1
15743,Polypolypoly,kiljaeden,480,mage,fire,10,6,4
15744,Dbsheep,kul-tiras,480,mage,fire,12,5,7
15745,Icestory,tichondrius,480,mage,fire,12,5,7
15746,Arishasis,tichondrius,480,mage,fire,12,5,7
15747,Espyy,area-52,480,mage,fire,12,5,7
15748,Quikcast,archimonde,480,mage,fire,12,5,7
15749,Numbing,sargeras,480,mage,fire,12,5,7
15750,Honeydutchss,black-dragonflight,480,mage,fire,12,5,7
15751,Pugsmugg,icecrown,480,mage,fire,12,5,7
15752,Baida,kelthuzad,480,mage,fire,12,5,7
15753,Diamondx,ragnaros,480,mage,fire,12,5,7
15754,Covín,malganis,480,mage,fire,12,5,7
15755,Marxeflamer,ragnaros,480,mage,fire,12,5,7
15756,Entomas,quelthalas,480,mage,fire,12,5,7
15757,Jikario,zuljin,480,mage,fire,12,5,7
15758,Cnumlab,proudmoore,480,mage,fire,12,5,7
15759,Magicalbuns,illidan,480,mage,fire,12,5,7
15760,Kushjointz,tichondrius,480,mage,fire,12,5,7
15761,Imhotboi,illidan,480,mage,fire,12,5,7
15762,Kqlyy,tichondrius,480,mage,fire,12,5,7
15763,Skillcap,nagrand,480,mage,fire,12,5,7
15764,Zerosaspect,thrall,480,mage,fire,12,5,7
15765,Connorq,stormrage,480,mage,fire,12,5,7
15766,Marther,whisperwind,480,mage,fire,12,5,7
15767,Bxgs,tichondrius,480,mage,fire,12,5,7
15768,Kyriê,darkspear,480,mage,fire,12,5,7
15769,Lambsalsa,tichondrius,480,mage,fire,12,5,7
15770,Aapple,tichondrius,480,mage,fire,17,5,12
15771,Mageyoulooks,kelthuzad,480,mage,fire,18,5,13
15772,Siayo,stormscale,480,mage,fire,18,5,13
15773,Tunax,tichondrius,480,mage,fire,18,5,13
15774,Finanahs,sargeras,479,mage,fire,12,5,7
15775,Mescudi,bonechewer,479,mage,fire,12,5,7
15776,Xunalatu,frostmourne,479,mage,fire,12,5,7
15777,Shadowgalaxy,arthas,479,mage,fire,12,5,7
15778,Apolarus,bonechewer,478,mage,fire,12,5,7
15779,Frogpapi,illidan,478,mage,fire,12,5,7
15780,Gwenage,tichondrius,472,mage,fire,12,5,7
15781,Shotö,skullcrusher,463,mage,fire,17,5,12
15782,Søkø,tichondrius,451,mage,fire,20,7,13
15783,Roastbeefxd,tichondrius,447,mage,fire,11,5,6
15784,Prepcook,dalaran,447,mage,fire,11,5,6
15785,Licklix,tichondrius,446,mage,fire,10,5,5
15786,Jazen,quelthalas,432,mage,fire,15,6,9
15787,Myelvenlady,proudmoore,431,mage,fire,11,5,6
15788,Certifried,emerald-dream,415,mage,fire,14,5,9
15789,Molassess,illidan,400,mage,fire,13,5,8
15790,Fullsheep,emerald-dream,384,mage,fire,6,4,2
15791,Mithràndìr,tichondrius,384,mage,fire,6,4,2
15792,Crøwgawd,tichondrius,384,mage,fire,6,4,2
15793,Pollybot,tichondrius,384,mage,fire,6,4,2
15794,Sifr,tichondrius,384,mage,fire,6,4,2
15795,Refreshments,bleeding-hollow,384,mage,fire,6,4,2
15796,Haze,hyjal,384,mage,fire,6,4,2
15797,Jasmine,moon-guard,384,mage,fire,6,4,2
15798,Zokorzik,area-52,384,mage,fire,6,4,2
15799,Cømbust,frostmourne,384,mage,fire,6,4,2
15800,Floatyz,tichondrius,384,mage,fire,6,4,2
15801,Jazzgroyper,sargeras,384,mage,fire,6,4,2
15802,Keepv,tichondrius,384,mage,fire,6,4,2
15803,Gíldrin,proudmoore,384,mage,fire,6,4,2
15804,Majjix,illidan,384,mage,fire,6,4,2
15805,Frozonnee,aggramar,384,mage,fire,6,4,2
15806,Chapelrat,sargeras,384,mage,fire,6,4,2
15807,Poonfarmer,zangarmarsh,384,mage,fire,6,4,2
15808,Fïtz,quelthalas,384,mage,fire,6,4,2
15809,Burstyboi,frostmourne,384,mage,fire,6,4,2
15810,Frankkie,mugthol,384,mage,fire,6,4,2
15811,Extremeways,tichondrius,384,mage,fire,6,4,2
15812,Pyröz,kelthuzad,384,mage,fire,6,4,2
15813,Gominsi,tichondrius,384,mage,fire,6,4,2
15814,Frogbum,fizzcrank,384,mage,fire,10,5,5
15815,Dytonie,moon-guard,384,mage,fire,9,4,5
15816,Aquralina,moon-guard,384,mage,fire,12,4,8
15817,Elfmage,tichondrius,384,mage,fire,12,4,8
15818,Felsparkles,area-52,384,mage,fire,12,4,8
15819,Spookydookie,dark-iron,384,mage,fire,12,4,8
15820,Dasanimomo,sargeras,384,mage,fire,12,4,8
15821,Droppinbombs,draka,384,mage,fire,12,4,8
15822,Cacaushow,stormrage,384,mage,fire,12,4,8
15823,Tìnkerspell,stormrage,384,mage,fire,12,4,8
15824,Aeg,stormrage,384,mage,fire,12,4,8
15825,Cam,kul-tiras,384,mage,fire,12,4,8
15826,Uwuwhatnow,tichondrius,384,mage,fire,12,4,8
15827,Arialla,mannoroth,384,mage,fire,12,4,8
15828,Percivaltp,scarlet-crusade,384,mage,fire,12,4,8
15829,Hogslop,saurfang,384,mage,fire,12,4,8
15830,Sarahbeth,khadgar,384,mage,fire,12,4,8
15831,Ejzok,dreadmaul,384,mage,fire,12,4,8
15832,Thiio,tichondrius,384,mage,fire,12,4,8
15833,Udó,proudmoore,384,mage,fire,12,4,8
15834,Galsola,bronzebeard,384,mage,fire,12,4,8
15835,Pigdancel,tichondrius,384,mage,fire,12,4,8
15836,Gôøglëlòl,nemesis,384,mage,fire,18,4,14
15837,Neferpitøu,tichondrius,383,mage,fire,6,4,2
15838,Noyade,illidan,383,mage,fire,6,4,2
15839,Drewzz,tichondrius,383,mage,fire,8,4,4
15840,Chuggin,emerald-dream,383,mage,fire,15,5,10
15841,Wetguuch,area-52,383,mage,fire,12,4,8
15842,Hockisonz,moon-guard,383,mage,fire,12,4,8
15843,Soulwiper,illidan,383,mage,fire,17,5,12
15844,Smoney,icecrown,383,mage,fire,18,4,14
15845,Pyromidget,khazgoroth,382,mage,fire,12,4,8
15846,Kopke,ragnaros,381,mage,fire,13,4,9
15847,Hollfz,nemesis,367,mage,fire,11,4,7
15848,Vixm,stormrage,352,mage,fire,10,5,5
15849,Tmharp,tichondrius,336,mage,fire,9,5,4
15850,Gö,tichondrius,288,mage,fire,6,3,3
15851,Azuriex,tichondrius,288,mage,fire,6,3,3
15852,Ancientmagik,area-52,288,mage,fire,6,3,3
15853,Gandrich,drakkari,288,mage,fire,6,3,3
15854,Zerathremar,proudmoore,288,mage,fire,6,3,3
15855,Globglob,tichondrius,288,mage,fire,6,3,3
15856,Urbadxd,llane,288,mage,fire,6,3,3
15857,Síra,firetree,288,mage,fire,6,3,3
15858,Bhalec,kelthuzad,288,mage,fire,6,3,3
15859,Easyfreeze,sargeras,288,mage,fire,6,3,3
15860,Hasteboy,kelthuzad,288,mage,fire,6,3,3
15861,Kylar,icecrown,288,mage,fire,6,3,3
15862,Polyenjoyerx,ysera,288,mage,fire,6,3,3
15863,Emvepee,sargeras,288,mage,fire,6,3,3
15864,Kuther,draenor,288,mage,fire,6,3,3
15865,Thecorruptor,malorne,288,mage,fire,6,3,3
15866,Mindthegap,tichondrius,288,mage,fire,6,3,3
15867,Ave,anetheron,288,mage,fire,6,3,3
15868,Bergan,sargeras,288,mage,fire,6,3,3
15869,Rhoadies,malfurion,288,mage,fire,6,3,3
15870,Shírley,tichondrius,288,mage,fire,6,3,3
15871,Jimmyhendrix,wildhammer,288,mage,fire,6,3,3
15872,Novice,barthilas,288,mage,fire,6,3,3
15873,Wqnmlgbdy,tichondrius,288,mage,fire,6,3,3
15874,Botoslàp,dragonmaw,288,mage,fire,6,3,3
15875,Bombr,sargeras,288,mage,fire,6,3,3
15876,Whyze,malganis,288,mage,fire,6,3,3
15877,Chilléd,tichondrius,288,mage,fire,6,3,3
15878,Garion,moon-guard,288,mage,fire,6,3,3
15879,Bøfa,tichondrius,288,mage,fire,6,3,3
15880,Polyburst,darkspear,288,mage,fire,6,3,3
15881,Vengefuly,tichondrius,288,mage,fire,6,3,3
15882,Blinkinghobo,sargeras,288,mage,fire,6,3,3
15883,Gåndalf,ragnaros,288,mage,fire,6,3,3
15884,Kyliec,tichondrius,288,mage,fire,6,3,3
15885,Zenzoh,azuremyst,288,mage,fire,6,3,3
15886,Rhunón,dalaran,288,mage,fire,6,3,3
15887,Zuhbo,moon-guard,288,mage,fire,6,3,3
15888,Chez,tichondrius,288,mage,fire,6,3,3
15889,Kassekx,area-52,288,mage,fire,6,3,3
15890,Mntaindew,bleeding-hollow,288,mage,fire,6,3,3
15891,Slinkyslink,area-52,288,mage,fire,6,3,3
15892,Yòkai,tichondrius,288,mage,fire,6,3,3
15893,Svips,illidan,288,mage,fire,6,3,3
15894,Boorster,illidan,288,mage,fire,6,3,3
15895,Pollylol,proudmoore,288,mage,fire,6,3,3
15896,Lampert,tichondrius,288,mage,fire,6,3,3
15897,Missingxx,silvermoon,288,mage,fire,6,3,3
15898,Tráshmage,zuljin,288,mage,fire,6,3,3
15899,Rích,tichondrius,288,mage,fire,6,3,3
15900,Frostkage,tichondrius,288,mage,fire,6,3,3
15901,Nuzzle,boulderfist,288,mage,fire,8,3,5
15902,Turbogeo,shuhalo,288,mage,fire,12,3,9
15903,Fatalexo,tichondrius,288,mage,fire,12,3,9
15904,Nilla,hyjal,288,mage,fire,12,3,9
15905,Danggurl,tichondrius,288,mage,fire,12,3,9
15906,Funkeoto,thrall,288,mage,fire,12,3,9
15907,Orkinekek,frostmourne,288,mage,fire,12,3,9
15908,Mendittorosa,tichondrius,288,mage,fire,12,3,9
15909,Keionti,dalaran,288,mage,fire,12,3,9
15910,Gnomegeddons,dalaran,288,mage,fire,24,3,21
15911,Frostyii,stonemaul,287,mage,fire,6,3,3
15912,Harlen,quelthalas,287,mage,fire,6,3,3
15913,Aphazia,kiljaeden,287,mage,fire,6,3,3
15914,Baelzharon,hellscream,287,mage,fire,12,3,9
15915,Kittikk,tichondrius,284,mage,fire,18,3,15
15916,Nesomage,destromath,256,mage,fire,10,3,7
15917,Rossanopolis,tichondrius,255,mage,fire,17,3,14
15918,Nephalem,moknathal,240,mage,fire,9,3,6
15919,Orderlight,alexstrasza,239,mage,fire,5,3,2
15920,Genozyde,elune,239,mage,fire,5,3,2
15921,Fizario,barthilas,239,mage,fire,5,3,2
15922,Feenìx,tichondrius,234,mage,fire,6,4,2
15923,Wabï,tichondrius,234,mage,fire,9,4,5
15924,Flomin,tichondrius,234,mage,fire,16,6,10
15925,Cînderellas,proudmoore,234,mage,fire,13,4,9
15926,Vakina,tichondrius,223,mage,fire,12,3,9
15927,Rennifer,malganis,192,mage,fire,9,3,6
15928,Trollsita,thrall,192,mage,fire,6,2,4
15929,Arianark,sargeras,192,mage,fire,6,2,4
15930,Kymowiz,sargeras,192,mage,fire,6,2,4
15931,Pòpsmóke,tichondrius,192,mage,fire,6,2,4
15932,Privilege,dragonmaw,192,mage,fire,6,2,4
15933,Akephálos,drakkari,192,mage,fire,6,2,4
15934,Notria,illidan,192,mage,fire,6,2,4
15935,Gotya,tichondrius,192,mage,fire,6,2,4
15936,Yellowfevrz,thrall,192,mage,fire,6,2,4
15937,Elhechizero,quelthalas,192,mage,fire,6,2,4
15938,Avandal,proudmoore,192,mage,fire,6,2,4
15939,Zënith,quelthalas,192,mage,fire,6,2,4
15940,Karameltart,barthilas,192,mage,fire,6,2,4
15941,Burna,amanthul,192,mage,fire,6,2,4
15942,Dustychill,illidan,192,mage,fire,6,2,4
15943,Thedodgex,sargeras,192,mage,fire,6,2,4
15944,Dohnutt,tichondrius,192,mage,fire,6,2,4
15945,Preplex,thrall,192,mage,fire,6,2,4
15946,Shardgodx,kelthuzad,192,mage,fire,6,2,4
15947,Massivepoo,barthilas,192,mage,fire,6,2,4
15948,Wauzcrol,quelthalas,192,mage,fire,6,2,4
15949,Tannbone,illidan,192,mage,fire,6,2,4
15950,Jinglehz,frostmourne,192,mage,fire,6,2,4
15951,Gódsfather,kelthuzad,192,mage,fire,6,2,4
15952,Defaultx,turalyon,192,mage,fire,6,2,4
15953,Trízín,frostmourne,192,mage,fire,6,2,4
15954,Alïce,kelthuzad,192,mage,fire,6,2,4
15955,Bojackal,illidan,192,mage,fire,6,2,4
15956,Stooki,tichondrius,192,mage,fire,6,2,4
15957,Zuqo,sargeras,192,mage,fire,6,2,4
15958,Emìlia,malygos,192,mage,fire,6,2,4
15959,Naimi,malganis,192,mage,fire,6,2,4
15960,Aquafiona,garona,192,mage,fire,6,2,4
15961,Valodrin,tichondrius,192,mage,fire,6,2,4
15962,Juniel,bleeding-hollow,192,mage,fire,6,2,4
15963,Cradic,tichondrius,192,mage,fire,6,2,4
15964,Ghostblaze,blackhand,192,mage,fire,6,2,4
15965,Trebbiano,illidan,192,mage,fire,6,2,4
15966,Killemz,dragonmaw,192,mage,fire,6,2,4
15967,Magifish,malganis,192,mage,fire,6,2,4
15968,Variex,tichondrius,192,mage,fire,6,2,4
15969,Iludron,aegwynn,192,mage,fire,6,2,4
15970,Pendrake,sargeras,192,mage,fire,6,2,4
15971,Yonzho,area-52,192,mage,fire,6,2,4
15972,Juicemage,tichondrius,192,mage,fire,6,2,4
15973,Snowday,nerzhul,192,mage,fire,6,2,4
15974,Gunzz,aegwynn,192,mage,fire,6,2,4
15975,Natzue,sargeras,192,mage,fire,6,2,4
15976,Khelzter,area-52,192,mage,fire,6,2,4
15977,Kaboodlz,stormrage,192,mage,fire,6,2,4
15978,Missile,frostmourne,192,mage,fire,6,2,4
15979,Itension,tichondrius,192,mage,fire,6,2,4
15980,Chadicewayne,tichondrius,192,mage,fire,6,2,4
15981,Magiër,tichondrius,192,mage,fire,6,2,4
15982,Sogood,tanaris,192,mage,fire,6,2,4
15983,Burrbon,area-52,192,mage,fire,6,2,4
15984,Orangemilk,hyjal,192,mage,fire,6,2,4
15985,Quickwizard,tichondrius,192,mage,fire,6,2,4
15986,Coldnuke,stormrage,192,mage,fire,6,2,4
15987,Maddoggs,tichondrius,192,mage,fire,6,2,4
15988,Piratecaster,kargath,192,mage,fire,6,2,4
15989,Chillstep,dark-iron,192,mage,fire,6,2,4
15990,Ignitex,bleeding-hollow,192,mage,fire,6,2,4
15991,Telkham,tichondrius,192,mage,fire,6,2,4
15992,Randommagi,area-52,192,mage,fire,6,2,4
15993,Faeylyn,stormrage,192,mage,fire,6,2,4
15994,Remana,anvilmar,192,mage,fire,6,2,4
15995,Ellywizzle,tichondrius,192,mage,fire,6,2,4
15996,Xoese,illidan,192,mage,fire,6,2,4
15997,Clickhard,suramar,192,mage,fire,6,2,4
15998,Starguy,terenas,192,mage,fire,6,2,4
15999,Ðfuego,azralon,192,mage,fire,6,2,4
16000,Rbn,tichondrius,192,mage,fire,6,2,4
16001,Josephaqil,tichondrius,192,mage,fire,6,2,4
16002,Friézá,stormrage,192,mage,fire,6,2,4
16003,Xxnova,moon-guard,192,mage,fire,6,2,4
16004,Likelyhard,tichondrius,192,mage,fire,6,2,4
16005,Pipeguzzler,zuljin,192,mage,fire,6,2,4
16006,Roggitman,emerald-dream,192,mage,fire,6,2,4
16007,Parruka,warsong,192,mage,fire,6,2,4
16008,Abrácadaver,frostwolf,192,mage,fire,10,3,7
16009,Flamiohotman,illidan,192,mage,fire,7,2,5
16010,Arnx,tichondrius,192,mage,fire,11,2,9
16011,Driel,illidan,192,mage,fire,12,2,10
16012,Spellbrker,stormrage,192,mage,fire,12,2,10
16013,Flippendicus,stormrage,192,mage,fire,12,2,10
16014,Bic,darrowmere,192,mage,fire,12,2,10
16015,Granmago,azralon,192,mage,fire,12,2,10
16016,Skatas,barthilas,192,mage,fire,12,2,10
16017,Saydar,stormrage,192,mage,fire,12,2,10
16018,Chelseâ,emerald-dream,192,mage,fire,12,2,10
16019,Abruaa,area-52,192,mage,fire,12,2,10
16020,Mageymeows,dalaran,191,mage,fire,6,2,4
16021,Magemajor,uldum,191,mage,fire,12,2,10
16022,Prosperoo,aerie-peak,191,mage,fire,12,2,10
16023,Neroclover,ysera,191,mage,fire,24,2,22
16024,Madalon,nemesis,160,mage,fire,10,2,8
16025,Razaklov,tichondrius,159,mage,fire,5,2,3
16026,Kindlin,frostmourne,159,mage,fire,5,2,3
16027,Zezima,spirestone,159,mage,fire,5,2,3
16028,Fingerblaste,malganis,138,mage,fire,16,3,13
16029,Yeweiliang,tichondrius,128,mage,fire,4,2,2
16030,Eromir,dawnbringer,128,mage,fire,4,2,2
16031,Dwayniewayni,tichondrius,128,mage,fire,4,2,2
16032,Ratfather,the-forgotten-coast,128,mage,fire,4,2,2
16033,Supremeboxer,tichondrius,127,mage,fire,8,2,6
16034,Neltar,dalaran,112,mage,fire,7,2,5
16035,Mxdeez,tichondrius,96,mage,fire,3,2,1
16036,Haliax,bronzebeard,96,mage,fire,3,2,1
16037,Édika,area-52,96,mage,fire,6,1,5
16038,Iamsol,area-52,96,mage,fire,6,1,5
16039,Jaçkjaçk,moon-guard,96,mage,fire,6,1,5
16040,Merreda,sargeras,96,mage,fire,6,1,5
16041,Caldian,wyrmrest-accord,96,mage,fire,6,1,5
16042,Pyroeuphoria,dark-iron,96,mage,fire,6,1,5
16043,Prosperoh,burning-legion,96,mage,fire,6,1,5
16044,Truewinter,tichondrius,96,mage,fire,6,1,5
16045,Pyrophobia,mannoroth,96,mage,fire,6,1,5
16046,Dildope,frostmourne,96,mage,fire,6,1,5
16047,Ignit,stormrage,96,mage,fire,6,1,5
16048,Magicmooman,thunderlord,96,mage,fire,6,1,5
16049,Hyndoriann,azgalor,96,mage,fire,6,1,5
16050,Tabuta,ravenholdt,96,mage,fire,6,1,5
16051,Eldrielle,frostmourne,96,mage,fire,6,1,5
16052,Nazztwren,bleeding-hollow,96,mage,fire,6,1,5
16053,Brayni,wyrmrest-accord,96,mage,fire,6,1,5
16054,Nomidian,area-52,96,mage,fire,6,1,5
16055,Pyromaniac,stormscale,96,mage,fire,6,1,5
16056,Miapolyafoo,stormrage,96,mage,fire,6,1,5
16057,Clutchy,gorefiend,96,mage,fire,6,1,5
16058,Arkuran,proudmoore,96,mage,fire,6,1,5
16059,Jarethleon,ragnaros,96,mage,fire,6,1,5
16060,Muted,frostmourne,96,mage,fire,6,1,5
16061,Firemids,thrall,96,mage,fire,6,1,5
16062,Lv,stormscale,96,mage,fire,6,1,5
16063,Dâzk,sargeras,96,mage,fire,6,1,5
16064,Phrana,tichondrius,96,mage,fire,6,1,5
16065,Bbaxter,stormrage,96,mage,fire,6,1,5
16066,Elemenopi,thrall,96,mage,fire,6,1,5
16067,Trojay,malganis,96,mage,fire,6,1,5
16068,Djp,tichondrius,96,mage,fire,6,1,5
16069,Couto,tichondrius,96,mage,fire,6,1,5
16070,Rolypolyman,tichondrius,96,mage,fire,6,1,5
16071,Memnor,amanthul,96,mage,fire,6,1,5
16072,Ssmurfett,dalaran,96,mage,fire,6,1,5
16073,Tonydippin,illidan,96,mage,fire,6,1,5
16074,Clickersz,sargeras,96,mage,fire,6,1,5
16075,Rieltar,barthilas,96,mage,fire,6,1,5
16076,Somnuss,barthilas,96,mage,fire,7,1,6
16077,Zuroz,dathremar,96,mage,fire,12,1,11
16078,Duhquarius,warsong,96,mage,fire,12,1,11
16079,Allesanda,sargeras,96,mage,fire,12,1,11
16080,Mideon,whisperwind,95,mage,fire,6,1,5
16081,Jarvase,mugthol,79,mage,fire,5,1,4
16082,Savanali,kelthuzad,79,mage,fire,5,1,4
16083,Noquemacuuh,ragnaros,79,mage,fire,5,1,4
16084,Jaked,frostmourne,79,mage,fire,5,1,4
16085,Redeyez,arthas,48,mage,fire,9,1,8
16086,Juicemage,tichondrius,2239,mage,frost,144,79,65
16087,Valériemeow,tichondrius,2061,mage,frost,88,46,42
16088,Cremgotrockd,blackrock,2032,mage,frost,107,58,49
16089,Stonedmonkeý,tichondrius,2016,mage,frost,131,63,68
16090,Lawuera,quelthalas,2011,mage,frost,96,48,48
16091,Easyfreeze,sargeras,1996,mage,frost,48,27,21
16092,Juicechanel,tichondrius,1996,mage,frost,64,34,30
16093,Backjing,tichondrius,1969,mage,frost,87,42,45
16094,Koro,tichondrius,1956,mage,frost,121,63,58
16095,Ghostrr,tichondrius,1949,mage,frost,160,86,74
16096,Zerodium,sargeras,1938,mage,frost,83,44,39
16097,Hogmantwo,illidan,1935,mage,frost,54,29,25
16098,Smuky,stormrage,1916,mage,frost,101,49,52
16099,Douyuweifa,tichondrius,1911,mage,frost,65,31,34
16100,Elkiador,area-52,1909,mage,frost,30,21,9
16101,Joe,llane,1901,mage,frost,129,65,64
16102,Grumpyòlfart,tichondrius,1898,mage,frost,132,67,65
16103,Kassmage,skullcrusher,1897,mage,frost,120,57,63
16104,Vazlgs,tichondrius,1896,mage,frost,82,47,35
16105,Faynet,dalaran,1891,mage,frost,117,64,53
16106,Yeweiliang,tichondrius,1891,mage,frost,330,173,157
16107,Ams,aerie-peak,1890,mage,frost,60,33,27
16108,Snaregodx,area-52,1885,mage,frost,59,31,28
16109,Gôøglëlòl,nemesis,1864,mage,frost,235,125,110
16110,Tupactopus,tichondrius,1861,mage,frost,54,27,27
16111,Flaux,sargeras,1859,mage,frost,52,36,16
16112,Theydeadx,illidan,1858,mage,frost,47,31,16
16113,Pigdancell,tichondrius,1858,mage,frost,60,25,35
16114,Corgim,thrall,1857,mage,frost,65,33,32
16115,Fròzt,ragnaros,1857,mage,frost,72,31,41
16116,Mcdfries,tichondrius,1853,mage,frost,60,32,28
16117,Miilky,tichondrius,1852,mage,frost,60,30,30
16118,Xanthilia,chogall,1849,mage,frost,96,49,47
16119,Hideongp,barthilas,1842,mage,frost,108,54,54
16120,Maebalim,tichondrius,1835,mage,frost,48,27,21
16121,Evilnuts,quelthalas,1832,mage,frost,61,34,27
16122,Dahp,thrall,1831,mage,frost,47,23,24
16123,Stöpwatch,hyjal,1830,mage,frost,60,39,21
16124,Cunzhang,tichondrius,1824,mage,frost,54,24,30
16125,Gelokay,tichondrius,1821,mage,frost,42,25,17
16126,Chrisxo,azuremyst,1820,mage,frost,42,24,18
16127,Miketao,tichondrius,1820,mage,frost,67,31,36
16128,Evilear,andorhal,1819,mage,frost,66,33,33
16129,Chez,tichondrius,1818,mage,frost,30,19,11
16130,Bamx,stormrage,1817,mage,frost,48,26,22
16131,Cømbust,frostmourne,1816,mage,frost,72,50,22
16132,Hunchojack,tichondrius,1814,mage,frost,60,24,36
16133,Quippy,kiljaeden,1813,mage,frost,309,156,153
16134,Leakyboots,illidan,1812,mage,frost,47,25,22
16135,Ribot,sargeras,1812,mage,frost,60,28,32
16136,Koozay,kelthuzad,1805,mage,frost,65,38,27
16137,Maegwynah,stormrage,1804,mage,frost,66,29,37
16138,Aapple,tichondrius,1803,mage,frost,60,32,28
16139,Instincts,uldum,1796,mage,frost,42,25,17
16140,Ligmmah,stormrage,1792,mage,frost,110,61,49
16141,Kissradiox,tichondrius,1791,mage,frost,132,63,69
16142,Dtbmar,misha,1788,mage,frost,76,35,41
16143,Theetwotime,area-52,1786,mage,frost,142,73,69
16144,Drewdy,stormreaver,1783,mage,frost,30,19,11
16145,Valtessa,stormrage,1781,mage,frost,54,32,22
16146,Endymiòn,tichondrius,1780,mage,frost,48,24,24
16147,Sheepgodx,malganis,1779,mage,frost,35,20,15
16148,Kleinz,quelthalas,1776,mage,frost,91,54,37
16149,Sestren,zuljin,1766,mage,frost,54,25,29
16150,Covil,tichondrius,1765,mage,frost,48,24,24
16151,Factszxy,area-52,1761,mage,frost,41,29,12
16152,Rhythmdog,tichondrius,1758,mage,frost,60,25,35
16153,Hogdog,illidan,1751,mage,frost,54,28,26
16154,Dace,tichondrius,1745,mage,frost,47,26,21
16155,Mokelovin,sargeras,1744,mage,frost,47,30,17
16156,Téfy,ragnaros,1744,mage,frost,59,34,25
16157,Srinshi,sargeras,1736,mage,frost,142,68,74
16158,Jerawokee,undermine,1735,mage,frost,67,30,37
16159,Laserface,bleeding-hollow,1733,mage,frost,60,34,26
16160,Ingcho,tichondrius,1730,mage,frost,72,32,40
16161,Castana,tichondrius,1729,mage,frost,116,54,62
16162,Illumià,illidan,1719,mage,frost,26,20,6
16163,Traelol,blades-edge,1715,mage,frost,114,58,56
16164,Golfirl,doomhammer,1715,mage,frost,42,21,21
16165,Sifr,tichondrius,1713,mage,frost,36,18,18
16166,Riddickl,malfurion,1708,mage,frost,96,46,50
16167,Headbake,malganis,1705,mage,frost,42,24,18
16168,Luckysir,illidan,1704,mage,frost,42,21,21
16169,Feener,stormreaver,1704,mage,frost,36,18,18
16170,Pitball,area-52,1702,mage,frost,103,51,52
16171,Polyenjoyerx,ysera,1701,mage,frost,106,55,51
16172,Rizke,tichondrius,1701,mage,frost,35,18,17
16173,Glaciated,the-forgotten-coast,1699,mage,frost,74,38,36
16174,Fromcanadaqc,stormrage,1689,mage,frost,41,24,17
16175,Zinnos,tichondrius,1684,mage,frost,214,105,109
16176,Pichorrá,quelthalas,1683,mage,frost,80,46,34
16177,Persia,illidan,1683,mage,frost,53,24,29
16178,Sabrita,proudmoore,1680,mage,frost,92,47,45
16179,Stealing,barthilas,1680,mage,frost,36,18,18
16180,Jtizzlè,tichondrius,1679,mage,frost,59,33,26
16181,Deallus,tichondrius,1677,mage,frost,82,40,42
16182,Alurion,moon-guard,1673,mage,frost,32,21,11
16183,Factsx,area-52,1669,mage,frost,42,22,20
16184,Chrislongtv,tichondrius,1669,mage,frost,533,271,262
16185,Kymowiz,sargeras,1669,mage,frost,42,19,23
16186,Tommagic,tichondrius,1666,mage,frost,40,23,17
16187,Bravden,area-52,1664,mage,frost,48,27,21
16188,Stimml,blood-furnace,1662,mage,frost,66,38,28
16189,Arcayne,tichondrius,1662,mage,frost,121,66,55
16190,Baleiabranca,stormrage,1662,mage,frost,82,37,45
16191,Tatertots,bladefist,1658,mage,frost,47,18,29
16192,Bmuafgfe,tichondrius,1655,mage,frost,33,20,13
16193,Dexd,laughing-skull,1655,mage,frost,54,32,22
16194,Bambambilly,kelthuzad,1655,mage,frost,75,35,40
16195,Minverces,tichondrius,1653,mage,frost,40,23,17
16196,Arcánè,velen,1652,mage,frost,29,19,10
16197,Dve,frostmourne,1651,mage,frost,84,51,33
16198,Entm,burning-blade,1651,mage,frost,42,22,20
16199,Tjofmajik,stormrage,1651,mage,frost,42,20,22
16200,Magecombe,thrall,1649,mage,frost,49,25,24
16201,Zhangxiaowu,tichondrius,1648,mage,frost,50,32,18
16202,Luxør,aegwynn,1647,mage,frost,30,18,12
16203,Zorexx,area-52,1643,mage,frost,61,30,31
16204,Lemmiwïnks,area-52,1640,mage,frost,32,21,11
16205,Scarablast,bleeding-hollow,1639,mage,frost,49,25,24
16206,Gûmbÿ,illidan,1636,mage,frost,36,28,8
16207,Charmed,black-dragonflight,1635,mage,frost,86,45,41
16208,Venachi,emerald-dream,1633,mage,frost,146,83,63
16209,Mayumî,moon-guard,1632,mage,frost,42,21,21
16210,Lambsalsa,tichondrius,1631,mage,frost,42,18,24
16211,Atra,spinebreaker,1629,mage,frost,48,23,25
16212,Zssy,tichondrius,1626,mage,frost,41,29,12
16213,Zezima,spirestone,1625,mage,frost,36,23,13
16214,Elyandria,proudmoore,1625,mage,frost,42,23,19
16215,Xialing,tichondrius,1625,mage,frost,35,18,17
16216,Erîol,ragnaros,1623,mage,frost,80,45,35
16217,Mashii,kiljaeden,1620,mage,frost,36,17,19
16218,Fgnb,sargeras,1619,mage,frost,36,23,13
16219,Triuneward,tichondrius,1619,mage,frost,42,22,20
16220,Neverblockx,kirin-tor,1618,mage,frost,30,17,13
16221,Animatronic,moon-guard,1618,mage,frost,177,89,88
16222,Gwyn,nemesis,1614,mage,frost,54,29,25
16223,Hüz,frostmourne,1611,mage,frost,35,27,8
16224,Whosdismage,illidan,1608,mage,frost,36,22,14
16225,Syntacks,lightnings-blade,1608,mage,frost,231,115,116
16226,Snoogensftw,tichondrius,1602,mage,frost,36,17,19
16227,Preceptør,azralon,1601,mage,frost,61,33,28
16228,Fawcett,khazgoroth,1598,mage,frost,78,40,38
16229,Savanali,kelthuzad,1596,mage,frost,48,26,22
16230,Blinkbow,tichondrius,1595,mage,frost,102,46,56
16231,Dorsia,jaedenar,1594,mage,frost,28,20,8
16232,Frostpimp,anubarak,1594,mage,frost,62,27,35
16233,Flâvor,illidan,1593,mage,frost,54,29,25
16234,Praestigium,barthilas,1583,mage,frost,74,39,35
16235,Mageonthcc,korgath,1583,mage,frost,98,49,49
16236,Axecap,tichondrius,1578,mage,frost,72,38,34
16237,Enflame,tichondrius,1576,mage,frost,36,27,9
16238,Squidio,stormrage,1570,mage,frost,125,68,57
16239,Eldrielle,frostmourne,1569,mage,frost,312,162,150
16240,Crithappy,baelgun,1568,mage,frost,48,26,22
16241,Alùcârd,tichondrius,1567,mage,frost,58,31,27
16242,Frizbee,sargeras,1567,mage,frost,39,19,20
16243,Orderlight,alexstrasza,1567,mage,frost,108,49,59
16244,Nickioxox,tichondrius,1567,mage,frost,41,17,24
16245,Pocsermage,drakkari,1562,mage,frost,34,17,17
16246,Icestory,tichondrius,1560,mage,frost,75,26,49
16247,Affewxd,lothar,1557,mage,frost,126,65,61
16248,Deathrøll,moon-guard,1552,mage,frost,84,48,36
16249,Sheepu,bladefist,1551,mage,frost,106,59,47
16250,Marisadaze,tichondrius,1546,mage,frost,57,23,34
16251,Maagin,zuljin,1540,mage,frost,140,75,65
16252,Nairmage,tichondrius,1540,mage,frost,38,20,18
16253,Frostitutex,illidan,1538,mage,frost,37,17,20
16254,Toaststrudel,tichondrius,1537,mage,frost,58,27,31
16255,Biglance,frostmourne,1533,mage,frost,36,17,19
16256,Frostqt,area-52,1532,mage,frost,132,71,61
16257,Yorgøs,ragnaros,1530,mage,frost,30,16,14
16258,Littlejay,kelthuzad,1528,mage,frost,30,16,14
16259,Priyel,hyjal,1526,mage,frost,56,29,27
16260,Fakebusiness,area-52,1524,mage,frost,162,84,78
16261,Lorlene,frostmourne,1524,mage,frost,175,78,97
16262,Couto,tichondrius,1522,mage,frost,35,17,18
16263,Qsc,barthilas,1521,mage,frost,135,67,68
16264,Galacticslug,tichondrius,1519,mage,frost,48,28,20
16265,Magetherian,frostmourne,1519,mage,frost,78,39,39
16266,Slipqt,tichondrius,1519,mage,frost,77,38,39
16267,Sheepshot,dentarg,1517,mage,frost,30,16,14
16268,Floofies,moon-guard,1516,mage,frost,133,65,68
16269,Soulberg,emerald-dream,1515,mage,frost,83,38,45
16270,Yourefat,emerald-dream,1514,mage,frost,72,48,24
16271,Icegiants,tichondrius,1507,mage,frost,53,30,23
16272,Deverror,frostmourne,1507,mage,frost,189,89,100
16273,Dillor,tichondrius,1505,mage,frost,153,77,76
16274,Playsfrost,skullcrusher,1501,mage,frost,106,62,44
16275,Khadberry,aerie-peak,1501,mage,frost,71,34,37
16276,Sáron,quelthalas,1499,mage,frost,69,37,32
16277,Zeshilol,stormrage,1499,mage,frost,45,19,26
16278,Wolfgangvn,stormrage,1495,mage,frost,43,20,23
16279,Kazmir,area-52,1494,mage,frost,41,16,25
16280,Burritsacold,bleeding-hollow,1491,mage,frost,54,26,28
16281,Ehcos,stormrage,1490,mage,frost,54,23,31
16282,Guyza,frostmourne,1489,mage,frost,41,18,23
16283,Datazonfire,illidan,1488,mage,frost,36,22,14
16284,Kabonkle,drakthul,1487,mage,frost,56,24,32
16285,Genswift,thrall,1486,mage,frost,60,27,33
16286,Corruptionz,nemesis,1485,mage,frost,48,25,23
16287,Song,sargeras,1485,mage,frost,83,42,41
16288,Emetah,ysera,1485,mage,frost,60,27,33
16289,Omnislasher,terenas,1482,mage,frost,115,53,62
16290,Hermanmiller,tichondrius,1480,mage,frost,78,41,37
16291,Pibb,rivendare,1480,mage,frost,48,25,23
16292,Léstat,quelthalas,1479,mage,frost,36,21,15
16293,Frussy,blood-furnace,1479,mage,frost,72,39,33
16294,Clm,lightnings-blade,1479,mage,frost,113,59,54
16295,Cubanmage,drakkari,1477,mage,frost,42,19,23
16296,Osnapmage,malganis,1475,mage,frost,249,124,125
16297,Tris,malganis,1475,mage,frost,45,20,25
16298,Fbd,bloodscalp,1473,mage,frost,30,16,14
16299,Ado,zuluhed,1471,mage,frost,114,59,55
16300,Kitenic,proudmoore,1470,mage,frost,59,33,26
16301,Enterthevoid,proudmoore,1463,mage,frost,36,21,15
16302,Noescaping,illidan,1463,mage,frost,41,19,22
16303,Revised,sargeras,1462,mage,frost,94,52,42
16304,Gtó,sargeras,1462,mage,frost,95,44,51
16305,Somnix,emerald-dream,1462,mage,frost,36,16,20
16306,Kh,stormrage,1460,mage,frost,81,44,37
16307,Umber,dreadmaul,1457,mage,frost,174,84,90
16308,Megladon,tichondrius,1452,mage,frost,29,21,8
16309,Tifrodo,azralon,1452,mage,frost,70,39,31
16310,Raisonmage,tichondrius,1452,mage,frost,36,20,16
16311,Coôler,illidan,1451,mage,frost,160,90,70
16312,Kfortyone,kiljaeden,1450,mage,frost,30,16,14
16313,Myxzz,barthilas,1450,mage,frost,252,130,122
16314,Jikario,zuljin,1450,mage,frost,36,18,18
16315,Nereidan,drakkari,1448,mage,frost,56,26,30
16316,Minerves,tichondrius,1446,mage,frost,42,20,22
16317,Trebbiano,illidan,1444,mage,frost,151,77,74
16318,Tylers,moon-guard,1443,mage,frost,42,23,19
16319,Bettybonk,cenarius,1441,mage,frost,59,26,33
16320,Wienerjeff,area-52,1439,mage,frost,30,22,8
16321,Pvpbilly,tichondrius,1439,mage,frost,24,15,9
16322,Ciaooh,tichondrius,1438,mage,frost,30,16,14
16323,Fròzen,moon-guard,1436,mage,frost,74,35,39
16324,Forged,tichondrius,1436,mage,frost,48,19,29
16325,Snowmassive,illidan,1435,mage,frost,36,17,19
16326,Sesshomaru,emerald-dream,1433,mage,frost,51,18,33
16327,Vornz,sargeras,1432,mage,frost,61,28,33
16328,Mkudos,ragnaros,1431,mage,frost,77,38,39
16329,Mmine,tichondrius,1430,mage,frost,30,15,15
16330,Trolson,sargeras,1425,mage,frost,102,45,57
16331,Scrúmp,tichondrius,1421,mage,frost,60,29,31
16332,Mclanda,frostmourne,1418,mage,frost,98,47,51
16333,Gazzuu,ragnaros,1413,mage,frost,42,22,20
16334,Valtaira,wyrmrest-accord,1412,mage,frost,77,49,28
16335,Jaked,frostmourne,1412,mage,frost,42,15,27
16336,Vecna,tichondrius,1411,mage,frost,103,47,56
16337,Paü,illidan,1409,mage,frost,76,31,45
16338,Perrc,area-52,1407,mage,frost,128,56,72
16339,Canva,barthilas,1406,mage,frost,41,25,16
16340,Nate,black-dragonflight,1404,mage,frost,128,65,63
16341,Gualter,nemesis,1403,mage,frost,141,79,62
16342,Gunzup,lightnings-blade,1403,mage,frost,30,15,15
16343,Gasolína,stormrage,1401,mage,frost,100,47,53
16344,Archewing,azjolnerub,1399,mage,frost,42,16,26
16345,Respectx,nemesis,1398,mage,frost,64,27,37
16346,Zirkur,mannoroth,1395,mage,frost,38,17,21
16347,Starscreamm,ragnaros,1394,mage,frost,34,20,14
16348,Azhim,tichondrius,1394,mage,frost,54,25,29
16349,Yulian,tichondrius,1392,mage,frost,91,48,43
16350,Crymachine,garrosh,1391,mage,frost,33,17,16
16351,Boejanglz,frostmourne,1390,mage,frost,28,17,11
16352,Affinitty,zuljin,1389,mage,frost,42,24,18
16353,Kahili,stormrage,1389,mage,frost,71,32,39
16354,Hhappier,tichondrius,1388,mage,frost,53,26,27
16355,Maguín,tichondrius,1384,mage,frost,30,15,15
16356,Kouks,tichondrius,1383,mage,frost,23,15,8
16357,Froshar,ragnaros,1380,mage,frost,36,15,21
16358,Zoidy,bleeding-hollow,1377,mage,frost,35,15,20
16359,Phoenixic,frostmourne,1376,mage,frost,132,60,72
16360,Shatturd,sargeras,1376,mage,frost,48,17,31
16361,Tagere,moon-guard,1370,mage,frost,80,38,42
16362,Roseofsharon,tichondrius,1368,mage,frost,36,15,21
16363,Creatïne,stormrage,1367,mage,frost,89,43,46
16364,Rrite,tichondrius,1366,mage,frost,29,15,14
16365,Icybanter,emerald-dream,1363,mage,frost,36,18,18
16366,Kevymarts,tichondrius,1358,mage,frost,54,31,23
16367,Moyuu,proudmoore,1358,mage,frost,174,81,93
16368,Koulder,zuljin,1357,mage,frost,30,18,12
16369,Starkp,ragnaros,1357,mage,frost,177,86,91
16370,Chadyus,illidan,1356,mage,frost,36,15,21
16371,Tentaçao,stormrage,1352,mage,frost,68,34,34
16372,Mëlkart,ragnaros,1351,mage,frost,60,29,31
16373,Asparagoose,stormrage,1347,mage,frost,29,15,14
16374,Radiku,blood-furnace,1347,mage,frost,31,16,15
16375,Freez,garona,1346,mage,frost,40,18,22
16376,Anarista,wyrmrest-accord,1345,mage,frost,24,15,9
16377,Cheesebuns,proudmoore,1345,mage,frost,43,16,27
16378,Vampìrelolz,tichondrius,1344,mage,frost,24,14,10
16379,Icyspring,tichondrius,1343,mage,frost,18,14,4
16380,Osh,malorne,1343,mage,frost,26,15,11
16381,Mâsterkush,tichondrius,1343,mage,frost,46,23,23
16382,Cryogeniks,illidan,1343,mage,frost,30,14,16
16383,Milambehr,elune,1340,mage,frost,30,16,14
16384,Mageyoulooks,kelthuzad,1340,mage,frost,36,17,19
16385,Safety,stormreaver,1337,mage,frost,106,57,49
16386,Plainblaine,illidan,1337,mage,frost,98,47,51
16387,Krabby,malganis,1337,mage,frost,66,26,40
16388,Clownspocket,tichondrius,1336,mage,frost,83,46,37
16389,Frøzzen,quelthalas,1336,mage,frost,129,59,70
16390,Luckysix,illidan,1336,mage,frost,36,14,22
16391,Safu,bleeding-hollow,1335,mage,frost,120,63,57
16392,Tarmiel,quelthalas,1335,mage,frost,42,22,20
16393,Ruzam,area-52,1334,mage,frost,97,48,49
16394,Rích,tichondrius,1330,mage,frost,126,56,70
16395,Juul,emerald-dream,1328,mage,frost,237,109,128
16396,Selless,zuljin,1325,mage,frost,66,33,33
16397,Vorass,kelthuzad,1325,mage,frost,30,15,15
16398,Lachawr,stormrage,1324,mage,frost,95,51,44
16399,Lucyphilis,stormrage,1323,mage,frost,74,40,34
16400,Warmweather,nagrand,1323,mage,frost,30,14,16
16401,Soia,ragnaros,1318,mage,frost,108,55,53
16402,Andorlin,barthilas,1315,mage,frost,47,22,25
16403,Ragemage,borean-tundra,1311,mage,frost,59,20,39
16404,Mntaindew,bleeding-hollow,1309,mage,frost,35,14,21
16405,Numz,sargeras,1302,mage,frost,94,42,52
16406,Kryliak,ragnaros,1301,mage,frost,54,31,23
16407,Frostítute,alterac-mountains,1299,mage,frost,60,28,32
16408,Xárdas,quelthalas,1298,mage,frost,82,44,38
16409,Jugobomb,madoran,1297,mage,frost,30,17,13
16410,Merkkinz,thrall,1296,mage,frost,59,30,29
16411,Linhny,tichondrius,1295,mage,frost,51,24,27
16412,Frostitutå,eonar,1293,mage,frost,118,54,64
16413,Magicbunny,andorhal,1284,mage,frost,183,90,93
16414,Alìv,tichondrius,1281,mage,frost,148,65,83
16415,Thergon,kul-tiras,1279,mage,frost,32,17,15
16416,Derpmanjr,area-52,1277,mage,frost,60,39,21
16417,Skynhet,ragnaros,1277,mage,frost,36,16,20
16418,Somethinglos,sargeras,1273,mage,frost,106,47,59
16419,Cheapsects,drakthul,1272,mage,frost,32,17,15
16420,Feogato,proudmoore,1271,mage,frost,147,73,74
16421,Meer,stonemaul,1270,mage,frost,30,17,13
16422,Ignit,stormrage,1269,mage,frost,34,17,17
16423,Throatdemon,hakkar,1269,mage,frost,36,15,21
16424,Luckysi,illidan,1268,mage,frost,38,15,23
16425,Hotpeachpie,zuljin,1266,mage,frost,68,35,33
16426,Vengefuly,tichondrius,1264,mage,frost,34,17,17
16427,Samuoa,tichondrius,1261,mage,frost,30,17,13
16428,Satív,moknathal,1258,mage,frost,42,25,17
16429,Degenhours,illidan,1253,mage,frost,51,25,26
16430,Unleáshed,moonrunner,1252,mage,frost,123,61,62
16431,Marrioo,tichondrius,1243,mage,frost,30,13,17
16432,Isellstuff,thrall,1243,mage,frost,30,13,17
16433,Kabrax,nerzhul,1243,mage,frost,36,13,23
16434,Burstage,destromath,1238,mage,frost,30,13,17
16435,Aosin,wyrmrest-accord,1238,mage,frost,30,13,17
16436,Agniih,azralon,1236,mage,frost,66,31,35
16437,Epifeni,blackrock,1235,mage,frost,39,14,25
16438,Rankryman,quelthalas,1231,mage,frost,58,29,29
16439,Frostzadan,quelthalas,1228,mage,frost,56,23,33
16440,Dumblexgamer,ragnaros,1224,mage,frost,66,28,38
16441,Rossanopolis,tichondrius,1223,mage,frost,24,13,11
16442,Jobar,malganis,1221,mage,frost,24,13,11
16443,Magifish,malganis,1220,mage,frost,44,25,19
16444,Jagmag,area-52,1219,mage,frost,18,14,4
16445,Jejihev,drakkari,1219,mage,frost,35,17,18
16446,Makén,illidan,1218,mage,frost,48,32,16
16447,Wowenjoyer,area-52,1213,mage,frost,82,39,43
16448,Kromeus,illidan,1210,mage,frost,36,16,20
16449,Ejzok,dreadmaul,1210,mage,frost,57,19,38
16450,Cìfel,quelthalas,1209,mage,frost,25,15,10
16451,Ràmdas,hyjal,1208,mage,frost,24,13,11
16452,Canassa,azralon,1208,mage,frost,113,58,55
16453,Akagamix,sargeras,1205,mage,frost,47,20,27
16454,Numaïr,kiljaeden,1205,mage,frost,62,25,37
16455,Acarilla,stormrage,1199,mage,frost,54,20,34
16456,Iceehott,kargath,1198,mage,frost,61,32,29
16457,Giovannie,zuluhed,1195,mage,frost,24,13,11
16458,Layolis,area-52,1195,mage,frost,56,29,27
16459,Valrendor,nazjatar,1191,mage,frost,79,36,43
16460,Dooie,sargeras,1188,mage,frost,28,19,9
16461,Whyammage,dalaran,1185,mage,frost,71,40,31
16462,Who,emerald-dream,1185,mage,frost,46,24,22
16463,Copperfield,dreadmaul,1185,mage,frost,80,33,47
16464,Palruki,tichondrius,1185,mage,frost,54,19,35
16465,Alatria,frostmourne,1183,mage,frost,42,14,28
16466,Sølem,frostmourne,1182,mage,frost,36,16,20
16467,Maigoddess,proudmoore,1180,mage,frost,71,29,42
16468,Twinklestars,sargeras,1179,mage,frost,72,40,32
16469,Trippy,senjin,1178,mage,frost,26,13,13
16470,Featherboo,stormrage,1178,mage,frost,35,16,19
16471,Chade,dunemaul,1178,mage,frost,53,22,31
16472,Sahir,thaurissan,1173,mage,frost,30,14,16
16473,Defarefa,frostmourne,1173,mage,frost,70,31,39
16474,Pendrake,sargeras,1170,mage,frost,34,13,21
16475,Gsr,nerzhul,1169,mage,frost,34,14,20
16476,Darkrukia,tichondrius,1168,mage,frost,63,32,31
16477,Zlint,quelthalas,1167,mage,frost,25,13,12
16478,Aquariusmoon,bonechewer,1166,mage,frost,54,28,26
16479,Toesuckerlol,tichondrius,1164,mage,frost,33,16,17
16480,Gatka,quelthalas,1164,mage,frost,245,116,129
16481,Esun,moon-guard,1160,mage,frost,30,17,13
16482,Devlux,area-52,1158,mage,frost,104,50,54
16483,Khaldyn,tichondrius,1156,mage,frost,132,65,67
16484,Tyrecgosa,tichondrius,1155,mage,frost,54,26,28
16485,Guji,area-52,1154,mage,frost,29,14,15
16486,Cavit,wyrmrest-accord,1153,mage,frost,63,29,34
16487,Iceward,frostmourne,1151,mage,frost,18,12,6
16488,Czq,tichondrius,1150,mage,frost,18,12,6
16489,Damage,skullcrusher,1150,mage,frost,31,13,18
16490,Pëpz,emerald-dream,1150,mage,frost,30,12,18
16491,Seeu,tichondrius,1149,mage,frost,42,12,30
16492,Zaddyx,whisperwind,1147,mage,frost,24,12,12
16493,Rekonx,tichondrius,1145,mage,frost,37,15,22
16494,Sturmrevenge,lightnings-blade,1144,mage,frost,114,56,58
16495,Yungice,hyjal,1144,mage,frost,36,14,22
16496,Harrypothead,senjin,1143,mage,frost,17,13,4
16497,Corrmic,winterhoof,1142,mage,frost,42,21,21
16498,Vasthrash,bleeding-hollow,1142,mage,frost,78,33,45
16499,Diixynormus,illidan,1141,mage,frost,30,17,13
16500,Tsuchek,tichondrius,1139,mage,frost,24,12,12
16501,Ibalyn,khazgoroth,1138,mage,frost,95,47,48
16502,Thatotherguy,lightnings-blade,1137,mage,frost,22,13,9
16503,Magicmooman,thunderlord,1137,mage,frost,24,12,12
16504,Eriktherod,maelstrom,1136,mage,frost,30,12,18
16505,Skdonkay,nerzhul,1131,mage,frost,65,34,31
16506,Mageeoh,bleeding-hollow,1128,mage,frost,41,14,27
16507,Fatum,ragnaros,1124,mage,frost,32,14,18
16508,Elwyn,dunemaul,1123,mage,frost,27,13,14
16509,Nazneen,elune,1122,mage,frost,73,31,42
16510,Gunzz,aegwynn,1122,mage,frost,30,12,18
16511,Paidemago,azralon,1121,mage,frost,24,14,10
16512,Coldfrønt,moon-guard,1120,mage,frost,48,21,27
16513,Bellåtrîx,quelthalas,1115,mage,frost,18,12,6
16514,Drumzter,ragnaros,1114,mage,frost,35,19,16
16515,Quietusllil,gurubashi,1111,mage,frost,66,37,29
16516,Osda,azralon,1111,mage,frost,36,19,17
16517,Corucia,echo-isles,1111,mage,frost,202,96,106
16518,Levitaine,bleeding-hollow,1110,mage,frost,38,19,19
16519,Shäräpova,zuljin,1109,mage,frost,24,12,12
16520,Castingmommy,moon-guard,1108,mage,frost,73,37,36
16521,Discoinferno,kelthuzad,1107,mage,frost,21,13,8
16522,Gryd,area-52,1102,mage,frost,76,38,38
16523,Twirkin,proudmoore,1102,mage,frost,36,18,18
16524,Cocmagic,kelthuzad,1101,mage,frost,27,13,14
16525,Hollerin,whisperwind,1098,mage,frost,18,12,6
16526,Memnor,amanthul,1098,mage,frost,24,12,12
16527,Aherom,ragnaros,1095,mage,frost,21,13,8
16528,Magedango,bleeding-hollow,1095,mage,frost,35,14,21
16529,Moonfhang,azralon,1094,mage,frost,215,103,112
16530,Littlebeth,azjolnerub,1091,mage,frost,60,30,30
16531,Azzurn,doomhammer,1090,mage,frost,24,13,11
16532,Pizzle,perenolde,1086,mage,frost,30,16,14
16533,Ralzarek,zuluhed,1085,mage,frost,30,15,15
16534,Helcarwen,area-52,1081,mage,frost,31,13,18
16535,Magekingz,shattered-halls,1080,mage,frost,54,27,27
16536,Mindthegap,tichondrius,1079,mage,frost,45,25,20
16537,Därkmägician,tichondrius,1075,mage,frost,26,12,14
16538,Arkoz,tichondrius,1071,mage,frost,18,12,6
16539,Evierix,illidan,1065,mage,frost,81,36,45
16540,Mageolisious,kelthuzad,1063,mage,frost,30,12,18
16541,Boldwarp,dalaran,1061,mage,frost,23,12,11
16542,Smáckington,tichondrius,1060,mage,frost,81,35,46
16543,Icebboxx,tichondrius,1057,mage,frost,24,13,11
16544,Lildabpen,tichondrius,1057,mage,frost,86,34,52
16545,Dealzy,malganis,1056,mage,frost,18,11,7
16546,Cayoux,darkspear,1055,mage,frost,18,11,7
16547,Xuxä,stormrage,1055,mage,frost,18,11,7
16548,Janchi,moon-guard,1055,mage,frost,24,11,13
16549,Cumbustyomom,illidan,1055,mage,frost,24,11,13
16550,Pivnert,boulderfist,1055,mage,frost,24,11,13
16551,Angerfrost,khazgoroth,1054,mage,frost,36,22,14
16552,Babyspise,nathrezim,1054,mage,frost,18,11,7
16553,Renoria,norgannon,1054,mage,frost,24,11,13
16554,Gadogear,draka,1054,mage,frost,30,11,19
16555,Doubledown,kiljaeden,1053,mage,frost,18,11,7
16556,Wickednoob,malganis,1053,mage,frost,120,55,65
16557,Xannymancan,tichondrius,1052,mage,frost,60,23,37
16558,Walrusxo,kelthuzad,1052,mage,frost,30,11,19
16559,Auralyn,wyrmrest-accord,1051,mage,frost,25,11,14
16560,Zuqo,sargeras,1050,mage,frost,18,11,7
16561,Zibbo,ragnaros,1046,mage,frost,18,11,7
16562,Ceadruk,darkspear,1046,mage,frost,30,14,16
16563,Deadsayru,drakkari,1046,mage,frost,24,11,13
16564,Skywalkerino,azralon,1045,mage,frost,24,11,13
16565,Keahiláni,area-52,1043,mage,frost,27,13,14
16566,Magicke,azgalor,1042,mage,frost,23,14,9
16567,Gradivous,emerald-dream,1042,mage,frost,88,39,49
16568,Devoh,dunemaul,1040,mage,frost,20,11,9
16569,Khrixa,illidan,1036,mage,frost,114,55,59
16570,Supergun,tichondrius,1036,mage,frost,23,11,12
16571,Pugsmugg,icecrown,1032,mage,frost,49,13,36
16572,Sluagh,terenas,1031,mage,frost,52,24,28
16573,Ispell,tichondrius,1025,mage,frost,18,14,4
16574,Chinye,tichondrius,1022,mage,frost,20,12,8
16575,Drbloodmuscl,black-dragonflight,1020,mage,frost,36,15,21
16576,Trollsita,thrall,1013,mage,frost,18,11,7
16577,Sènding,sargeras,1010,mage,frost,42,11,31
16578,Diegoneally,bleeding-hollow,1009,mage,frost,24,11,13
16579,Rizzbot,sargeras,1005,mage,frost,75,27,48
16580,Jaymage,agamaggan,994,mage,frost,37,13,24
16581,Worknlurk,malganis,992,mage,frost,24,12,12
16582,Mystics,dawnbringer,991,mage,frost,70,25,45
16583,Megapasta,illidan,989,mage,frost,23,11,12
16584,Superoirity,trollbane,988,mage,frost,48,24,24
16585,Drfrostie,anvilmar,987,mage,frost,20,11,9
16586,Prometheus,crushridge,986,mage,frost,52,27,25
16587,Thatlejund,tichondrius,986,mage,frost,28,11,17
16588,Jayfunk,sargeras,984,mage,frost,23,11,12
16589,Bòóyah,muradin,980,mage,frost,40,21,19
16590,Grudel,archimonde,979,mage,frost,41,21,20
16591,Bigpinkies,korgath,976,mage,frost,36,13,23
16592,Deadmarley,blackhand,975,mage,frost,24,11,13
16593,Dejavuh,dalaran,972,mage,frost,54,25,29
16594,Xoxmage,frostmourne,965,mage,frost,60,29,31
16595,Torthie,burning-blade,960,mage,frost,12,10,2
16596,Hadlly,tichondrius,960,mage,frost,18,10,8
16597,Kassody,kelthuzad,959,mage,frost,12,10,2
16598,Legendkiller,bleeding-hollow,959,mage,frost,18,10,8
16599,Nukedat,proudmoore,959,mage,frost,18,10,8
16600,Qcomberoo,frostmane,959,mage,frost,27,11,16
16601,Aluce,frostmourne,958,mage,frost,18,10,8
16602,Bigmêan,boulderfist,958,mage,frost,18,10,8
16603,Pyroshima,barthilas,958,mage,frost,34,11,23
16604,Hylord,tichondrius,957,mage,frost,18,10,8
16605,Zunyu,tichondrius,957,mage,frost,18,10,8
16606,Aurumpaleas,moon-guard,956,mage,frost,24,11,13
16607,Trízín,frostmourne,954,mage,frost,18,10,8
16608,Nnenna,bonechewer,952,mage,frost,18,10,8
16609,Imoen,zangarmarsh,951,mage,frost,36,15,21
16610,Keelaron,proudmoore,949,mage,frost,24,10,14
16611,Rasmin,greymane,948,mage,frost,40,22,18
16612,Shírley,tichondrius,948,mage,frost,30,10,20
16613,Sciona,suramar,947,mage,frost,21,10,11
16614,Tyning,blood-furnace,947,mage,frost,24,10,14
16615,Misfyre,malganis,946,mage,frost,28,11,17
16616,Onlyfansme,dalaran,939,mage,frost,18,10,8
16617,Tristania,archimonde,935,mage,frost,62,32,30
16618,Bubbleblower,hakkar,935,mage,frost,24,10,14
16619,Briélla,area-52,934,mage,frost,18,10,8
16620,Crankweigth,rivendare,933,mage,frost,78,36,42
16621,Trollings,azralon,925,mage,frost,63,30,33
16622,Fireace,emerald-dream,922,mage,frost,17,10,7
16623,Trentos,illidan,922,mage,frost,36,16,20
16624,Peetufo,whisperwind,920,mage,frost,23,10,13
16625,Marschubas,drakthul,917,mage,frost,65,28,37
16626,Åquå,area-52,912,mage,frost,20,11,9
16627,Aramire,drakkari,911,mage,frost,21,11,10
16628,Mongera,bonechewer,909,mage,frost,38,19,19
16629,Ultrá,stormscale,909,mage,frost,21,10,11
16630,Moesel,emerald-dream,908,mage,frost,15,11,4
16631,Redeyez,arthas,908,mage,frost,48,20,28
16632,Leocius,daggerspine,906,mage,frost,23,10,13
16633,Critique,malorne,894,mage,frost,54,27,27
16634,Mageboy,bonechewer,894,mage,frost,29,10,19
16635,Scár,blackrock,873,mage,frost,14,10,4
16636,Lilpolyx,illidan,864,mage,frost,12,9,3
16637,Rositajonez,terenas,864,mage,frost,12,9,3
16638,Benzos,eitrigg,864,mage,frost,12,9,3
16639,Furisheep,stormrage,864,mage,frost,12,9,3
16640,Nalabb,illidan,864,mage,frost,12,9,3
16641,Kaylemage,tichondrius,864,mage,frost,12,9,3
16642,Hyoonsfeet,stormrage,864,mage,frost,18,9,9
16643,Fromcanada,eitrigg,864,mage,frost,18,9,9
16644,Weathersmell,tichondrius,864,mage,frost,18,9,9
16645,Saydar,stormrage,864,mage,frost,24,9,15
16646,Messiaah,tichondrius,864,mage,frost,24,9,15
16647,Skoals,thrall,864,mage,frost,29,10,19
16648,Nicemangoes,proudmoore,863,mage,frost,12,9,3
16649,Blinkbotx,proudmoore,863,mage,frost,18,9,9
16650,Lastiari,wyrmrest-accord,863,mage,frost,18,9,9
16651,Blinkharder,stormrage,863,mage,frost,24,9,15
16652,Boredomkïlls,burning-legion,862,mage,frost,18,9,9
16653,Cryyo,queldorei,862,mage,frost,18,9,9
16654,Skillcap,nagrand,862,mage,frost,18,9,9
16655,Åøe,tichondrius,862,mage,frost,18,9,9
16656,Jodebabss,dalaran,862,mage,frost,18,9,9
16657,Tunax,tichondrius,862,mage,frost,24,9,15
16658,Haruká,ragnaros,862,mage,frost,27,10,17
16659,Shenme,moon-guard,861,mage,frost,20,9,11
16660,Fruza,emerald-dream,860,mage,frost,16,10,6
16661,Zaxrie,malganis,860,mage,frost,18,9,9
16662,Remana,anvilmar,859,mage,frost,18,9,9
16663,Plunks,bleeding-hollow,859,mage,frost,39,10,29
16664,Vallet,ragnaros,858,mage,frost,12,9,3
16665,Cuoreforte,moon-guard,858,mage,frost,24,9,15
16666,Cùrtiñ,tichondrius,858,mage,frost,30,9,21
16667,Cransmage,illidan,856,mage,frost,18,9,9
16668,Kaboozles,area-52,853,mage,frost,24,9,15
16669,Soya,sargeras,852,mage,frost,24,9,15
16670,Naoz,ragnaros,851,mage,frost,18,9,9
16671,Bandagris,garrosh,840,mage,frost,21,10,11
16672,Jarethleon,ragnaros,837,mage,frost,21,11,10
16673,Âürõrâ,firetree,834,mage,frost,24,9,15
16674,Dannyyoo,blackrock,831,mage,frost,17,9,8
16675,Craftin,sargeras,827,mage,frost,18,9,9
16676,Hiiamtay,azralon,826,mage,frost,14,10,4
16677,Itoncruxy,tichondrius,825,mage,frost,69,30,39
16678,Erykk,mugthol,810,mage,frost,33,10,23
16679,Zionist,earthen-ring,796,mage,frost,14,9,5
16680,Hirune,ragnaros,782,mage,frost,22,10,12
16681,Taylorrain,arthas,779,mage,frost,30,10,20
16682,Frightmare,sargeras,768,mage,frost,12,8,4
16683,Tonystonerz,lightnings-blade,768,mage,frost,12,8,4
16684,Wiztopher,frostmourne,768,mage,frost,12,8,4
16685,Dearyuanmage,tichondrius,768,mage,frost,12,8,4
16686,Pandazed,stormscale,768,mage,frost,12,8,4
16687,Eyesofrage,tichondrius,768,mage,frost,12,8,4
16688,Nefm,frostmourne,768,mage,frost,12,8,4
16689,Arrokoth,malganis,768,mage,frost,12,8,4
16690,Lycheeoolong,frostmourne,768,mage,frost,18,8,10
16691,Dead,nemesis,768,mage,frost,18,8,10
16692,Mcdude,kiljaeden,768,mage,frost,18,8,10
16693,Zstyle,frostmourne,768,mage,frost,18,8,10
16694,Yeetcannøn,illidan,768,mage,frost,18,8,10
16695,Magibe,thrall,768,mage,frost,18,8,10
16696,Pigdancel,tichondrius,768,mage,frost,18,8,10
16697,Bigdjohnson,dalaran,767,mage,frost,12,8,4
16698,Frosttwoop,moon-guard,767,mage,frost,12,8,4
16699,Seeumaybe,proudmoore,767,mage,frost,12,8,4
16700,Neomage,elune,767,mage,frost,12,8,4
16701,Arcaneshally,area-52,767,mage,frost,12,8,4
16702,Mempool,darkspear,767,mage,frost,12,8,4
16703,Nôtôrious,thrall,767,mage,frost,12,8,4
16704,Staytrill,stormreaver,767,mage,frost,18,8,10
16705,Nargine,tichondrius,767,mage,frost,18,8,10
16706,Wickymorph,barthilas,767,mage,frost,18,8,10
16707,Numb,trollbane,767,mage,frost,18,8,10
16708,Qtqq,malganis,767,mage,frost,18,8,10
16709,Vamplol,tichondrius,767,mage,frost,18,8,10
16710,Badboykilla,dentarg,767,mage,frost,21,9,12
16711,Gardes,tichondrius,767,mage,frost,24,8,16
16712,Aqcamus,illidan,766,mage,frost,12,8,4
16713,Travarra,terenas,766,mage,frost,18,8,10
16714,Rmprmp,tichondrius,764,mage,frost,18,8,10
16715,Nynalith,area-52,764,mage,frost,18,8,10
16716,Snowjôb,illidan,764,mage,frost,24,8,16
16717,Marvelcuck,sargeras,763,mage,frost,12,8,4
16718,Frenk,moon-guard,763,mage,frost,24,8,16
16719,Syndra,korialstrasz,763,mage,frost,24,8,16
16720,Crizzpy,tichondrius,762,mage,frost,18,8,10
16721,Vantus,tichondrius,757,mage,frost,14,8,6
16722,Ratrider,dreadmaul,752,mage,frost,12,8,4
16723,Fizario,barthilas,751,mage,frost,23,9,14
16724,Artruis,detheroc,748,mage,frost,12,8,4
16725,Brynach,trollbane,744,mage,frost,18,8,10
16726,Bandmaid,emerald-dream,736,mage,frost,16,9,7
16727,Comaner,frostmourne,735,mage,frost,17,8,9
16728,Omegablink,sargeras,734,mage,frost,17,8,9
16729,Letitgoo,azralon,733,mage,frost,34,17,17
16730,Heca,tichondrius,719,mage,frost,11,8,3
16731,Stankfreezer,thrall,719,mage,frost,11,8,3
16732,Hambürglar,garrosh,719,mage,frost,15,9,6
16733,Ìgnìtìöñ,whisperwind,718,mage,frost,21,8,13
16734,Myfamilygpie,nazgrel,672,mage,frost,12,7,5
16735,Mângo,frostmourne,672,mage,frost,12,7,5
16736,Kujousara,stormrage,672,mage,frost,12,7,5
16737,Stinkyblinky,bleeding-hollow,672,mage,frost,12,7,5
16738,Sylendron,area-52,672,mage,frost,12,7,5
16739,Mushys,stormrage,672,mage,frost,12,7,5
16740,Tofusmell,illidan,672,mage,frost,12,7,5
16741,Proximalol,tichondrius,672,mage,frost,12,7,5
16742,Reptär,demon-soul,672,mage,frost,12,7,5
16743,Georgian,malfurion,672,mage,frost,12,7,5
16744,Elfvis,deathwing,672,mage,frost,12,7,5
16745,Toteypotter,frostmourne,672,mage,frost,12,7,5
16746,Emvepee,sargeras,672,mage,frost,12,7,5
16747,Neovim,stormrage,672,mage,frost,12,7,5
16748,Kygores,tichondrius,672,mage,frost,12,7,5
16749,Tibbit,kelthuzad,672,mage,frost,12,7,5
16750,Crnomage,area-52,672,mage,frost,12,7,5
16751,Snôz,malganis,672,mage,frost,12,7,5
16752,Hugostiglets,dreadmaul,672,mage,frost,12,7,5
16753,Ntys,frostmourne,672,mage,frost,12,7,5
16754,Tynka,drakkari,672,mage,frost,12,7,5
16755,Ankidar,quelthalas,672,mage,frost,12,7,5
16756,Lillb,bleeding-hollow,672,mage,frost,18,7,11
16757,Licklix,tichondrius,672,mage,frost,18,7,11
16758,Privilege,burning-legion,672,mage,frost,18,7,11
16759,Coldshouldér,nerzhul,672,mage,frost,18,7,11
16760,Xàr,ragnaros,672,mage,frost,18,7,11
16761,Chunzhangfs,tichondrius,672,mage,frost,18,7,11
16762,Betrian,quelthalas,672,mage,frost,18,7,11
16763,Fortemage,tichondrius,672,mage,frost,24,7,17
16764,Burist,illidan,671,mage,frost,12,7,5
16765,Snoogma,illidan,671,mage,frost,12,7,5
16766,Rekys,black-dragonflight,671,mage,frost,12,7,5
16767,Khaziiong,scilla,671,mage,frost,12,7,5
16768,Nihilitý,malganis,671,mage,frost,12,7,5
16769,Nhinsanity,ghostlands,671,mage,frost,12,7,5
16770,Solusek,garona,671,mage,frost,12,7,5
16771,Dairian,whisperwind,671,mage,frost,12,7,5
16772,Blinksz,korgath,671,mage,frost,12,7,5
16773,Tokiaro,tortheldrin,671,mage,frost,12,7,5
16774,Üman,bleeding-hollow,671,mage,frost,12,7,5
16775,Zedroçk,shadowmoon,671,mage,frost,12,7,5
16776,Bruxelejolie,twisting-nether,671,mage,frost,12,7,5
16777,Annalee,ragnaros,671,mage,frost,18,7,11
16778,Baemers,tichondrius,671,mage,frost,18,7,11
16779,Optic,chogall,671,mage,frost,18,7,11
16780,Oharvestero,illidan,671,mage,frost,18,7,11
16781,Kasparhausar,garithos,671,mage,frost,18,7,11
16782,Elemenopi,thrall,671,mage,frost,18,7,11
16783,Nickygift,tichondrius,671,mage,frost,18,7,11
16784,Elegantbroth,illidan,671,mage,frost,18,7,11
16785,Ranje,kiljaeden,670,mage,frost,12,7,5
16786,Syura,ragnaros,670,mage,frost,12,7,5
16787,Tchass,skullcrusher,670,mage,frost,12,7,5
16788,Aulie,burning-blade,670,mage,frost,12,7,5
16789,Kidfurry,wyrmrest-accord,670,mage,frost,12,7,5
16790,Putosucio,nordrassil,670,mage,frost,18,7,11
16791,Sparklmotion,cenarius,670,mage,frost,18,7,11
16792,Starguy,laughing-skull,670,mage,frost,18,7,11
16793,Cäelüm,area-52,670,mage,frost,24,7,17
16794,Criticalness,illidan,669,mage,frost,12,7,5
16795,Zalatirix,bleeding-hollow,669,mage,frost,12,7,5
16796,Scorgasm,thrall,669,mage,frost,12,7,5
16797,Banída,stormrage,669,mage,frost,12,7,5
16798,Icelordd,ragnaros,669,mage,frost,13,7,6
16799,Nohealani,dragonmaw,667,mage,frost,15,8,7
16800,Iesca,ragnaros,665,mage,frost,12,7,5
16801,Evieril,tichondrius,665,mage,frost,12,7,5
16802,Leets,mugthol,664,mage,frost,12,7,5
16803,Dánó,lightbringer,663,mage,frost,24,7,17
16804,Tigoditties,emerald-dream,662,mage,frost,12,7,5
16805,Vendizzle,malganis,654,mage,frost,23,7,16
16806,Slaash,barthilas,639,mage,frost,14,8,6
16807,Dohnutt,tichondrius,638,mage,frost,11,7,4
16808,Shaynna,tichondrius,624,mage,frost,15,7,8
16809,Leeandroo,quelthalas,623,mage,frost,17,7,10
16810,Ghostblaze,blackhand,621,mage,frost,15,8,7
16811,Kandyperreo,ragnaros,617,mage,frost,23,8,15
16812,Ghili,tichondrius,607,mage,frost,11,7,4
16813,Ghrámz,stormrage,607,mage,frost,16,7,9
16814,Gralnur,kelthuzad,606,mage,frost,14,7,7
16815,Ineedashave,shandris,606,mage,frost,20,7,13
16816,Parruka,warsong,605,mage,frost,26,7,19
16817,Blinkmind,stormrage,576,mage,frost,6,6,0
16818,Fakewizard,frostmane,576,mage,frost,6,6,0
16819,Iceqube,drenden,576,mage,frost,6,6,0
16820,Redhell,dalaran,576,mage,frost,6,6,0
16821,Vamage,goldrinn,576,mage,frost,12,6,6
16822,Moogician,aerie-peak,576,mage,frost,12,6,6
16823,Arynnwyll,chogall,576,mage,frost,12,6,6
16824,Alludèd,illidan,576,mage,frost,12,6,6
16825,Fireguard,azralon,576,mage,frost,12,6,6
16826,Pollylol,proudmoore,576,mage,frost,12,6,6
16827,Faire,stonemaul,576,mage,frost,12,6,6
16828,Phuzadd,tichondrius,576,mage,frost,12,6,6
16829,Mägë,kirin-tor,576,mage,frost,12,6,6
16830,Saymenre,tichondrius,576,mage,frost,12,6,6
16831,Hýdramist,sargeras,576,mage,frost,12,6,6
16832,Johncxvii,sargeras,576,mage,frost,12,6,6
16833,Fromcanada,tichondrius,576,mage,frost,18,6,12
16834,Maxtorgar,quelthalas,576,mage,frost,18,6,12
16835,Fatalexo,tichondrius,576,mage,frost,18,6,12
16836,Soukidiot,sargeras,576,mage,frost,18,6,12
16837,Bustercraft,kelthuzad,576,mage,frost,18,6,12
16838,Twiztidwitch,burning-legion,576,mage,frost,24,6,18
16839,Tundraga,malganis,575,mage,frost,12,6,6
16840,Dchee,nerzhul,575,mage,frost,12,6,6
16841,Baultery,moon-guard,575,mage,frost,12,6,6
16842,Highafrn,area-52,575,mage,frost,12,6,6
16843,Casual,arthas,575,mage,frost,12,6,6
16844,Smoney,icecrown,575,mage,frost,12,6,6
16845,Bootygoats,emerald-dream,575,mage,frost,12,6,6
16846,Oogabooga,lethon,575,mage,frost,12,6,6
16847,Bloodpumper,thrall,575,mage,frost,12,6,6
16848,Fakewarlockk,illidan,575,mage,frost,18,6,12
16849,Hasty,emerald-dream,575,mage,frost,18,6,12
16850,Fabled,stonemaul,575,mage,frost,18,6,12
16851,Lucidgaze,bonechewer,575,mage,frost,18,6,12
16852,Aarne,thrall,575,mage,frost,18,6,12
16853,Skywarp,blackhand,575,mage,frost,23,6,17
16854,Kalzak,hyjal,574,mage,frost,12,6,6
16855,Kaël,area-52,574,mage,frost,12,6,6
16856,Tonepedo,zuljin,574,mage,frost,18,6,12
16857,Gelile,tichondrius,574,mage,frost,18,6,12
16858,Lincepotter,quelthalas,574,mage,frost,18,6,12
16859,Srloko,azralon,574,mage,frost,24,6,18
16860,Zehlks,garrosh,573,mage,frost,12,6,6
16861,Sohotritenow,malganis,573,mage,frost,18,6,12
16862,Crimpster,illidan,573,mage,frost,24,6,18
16863,Avers,frostwolf,572,mage,frost,18,6,12
16864,Ärià,sargeras,571,mage,frost,12,6,6
16865,Sodrezinn,illidan,571,mage,frost,12,6,6
16866,Freyia,mugthol,569,mage,frost,18,6,12
16867,Silverstrza,gnomeregan,567,mage,frost,12,6,6
16868,Meliam,tichondrius,557,mage,frost,29,6,23
16869,Arckayne,zuljin,543,mage,frost,11,6,5
16870,Ozwauld,emerald-dream,526,mage,frost,11,6,5
16871,Triambukh,grizzly-hills,525,mage,frost,20,7,13
16872,Iladiin,malganis,521,mage,frost,16,7,9
16873,Jooss,quelthalas,521,mage,frost,18,7,11
16874,Pidge,aggramar,519,mage,frost,22,6,16
16875,Tatersmaccs,sargeras,517,mage,frost,20,7,13
16876,Emieralol,tichondrius,512,mage,frost,10,6,4
16877,Aycc,tichondrius,512,mage,frost,10,6,4
16878,Ereblink,proudmoore,511,mage,frost,11,6,5
16879,Maac,nemesis,511,mage,frost,11,6,5
16880,Zabaione,stormrage,508,mage,frost,16,6,10
16881,Fromcanadaqc,zuljin,480,mage,frost,6,5,1
16882,Elwynnforest,sargeras,480,mage,frost,6,5,1
16883,Hansol,farstriders,480,mage,frost,6,5,1
16884,Moonpie,frostmane,480,mage,frost,6,5,1
16885,Matchstickk,tichondrius,480,mage,frost,6,5,1
16886,Flavaflame,mugthol,480,mage,frost,6,5,1
16887,Jarvase,mugthol,480,mage,frost,10,6,4
16888,Juniel,bleeding-hollow,480,mage,frost,10,6,4
16889,Veritas,wildhammer,480,mage,frost,10,6,4
16890,Zime,moon-guard,480,mage,frost,12,5,7
16891,Cinns,moon-guard,480,mage,frost,12,5,7
16892,Polymurph,terenas,480,mage,frost,12,5,7
16893,Arcaninez,bleeding-hollow,480,mage,frost,12,5,7
16894,Lewpithy,area-52,480,mage,frost,12,5,7
16895,Skizzlés,bleeding-hollow,480,mage,frost,12,5,7
16896,Kayenri,area-52,480,mage,frost,12,5,7
16897,Harlloo,the-underbog,480,mage,frost,12,5,7
16898,Siobhána,moon-guard,480,mage,frost,12,5,7
16899,Frostytoez,firetree,480,mage,frost,12,5,7
16900,Starguy,terenas,480,mage,frost,12,5,7
16901,Garbagemage,barthilas,480,mage,frost,12,5,7
16902,Isömetrics,tichondrius,480,mage,frost,12,5,7
16903,Hustle,frostmourne,480,mage,frost,12,5,7
16904,Låvazza,tichondrius,480,mage,frost,12,5,7
16905,Gadwick,alexstrasza,480,mage,frost,12,5,7
16906,Tëy,zuljin,480,mage,frost,12,5,7
16907,Legendary,deathwing,480,mage,frost,12,5,7
16908,Mcshwackin,area-52,480,mage,frost,12,5,7
16909,Icetomeetyu,bleeding-hollow,480,mage,frost,12,5,7
16910,Adronicus,tichondrius,480,mage,frost,12,5,7
16911,Arendelle,kiljaeden,480,mage,frost,12,5,7
16912,Puvö,tichondrius,480,mage,frost,12,5,7
16913,Vires,kelthuzad,480,mage,frost,12,5,7
16914,Dreddpool,barthilas,480,mage,frost,18,5,13
16915,Coolbuts,area-52,480,mage,frost,18,5,13
16916,Mikwam,proudmoore,479,mage,frost,6,5,1
16917,Piixxiie,sargeras,479,mage,frost,6,5,1
16918,Odinzz,azralon,479,mage,frost,12,5,7
16919,Édika,area-52,479,mage,frost,12,5,7
16920,Dimmershnitz,draka,479,mage,frost,12,5,7
16921,Phazora,suramar,479,mage,frost,12,5,7
16922,Kevdra,kelthuzad,479,mage,frost,12,5,7
16923,Loa,hydraxis,479,mage,frost,12,5,7
16924,Cezax,frostmourne,479,mage,frost,12,5,7
16925,Kpoppin,stormrage,479,mage,frost,12,5,7
16926,Limeade,ursin,479,mage,frost,12,5,7
16927,Brokser,quelthalas,479,mage,frost,12,5,7
16928,Grimreefer,trollbane,479,mage,frost,12,5,7
16929,Daddyplease,bleeding-hollow,479,mage,frost,12,5,7
16930,Inumano,laughing-skull,479,mage,frost,12,5,7
16931,Ehduh,onyxia,477,mage,frost,12,5,7
16932,Claddagh,kelthuzad,473,mage,frost,12,5,7
16933,Magusia,emerald-dream,447,mage,frost,11,5,6
16934,Barkäi,ragnaros,432,mage,frost,15,5,10
16935,Cerisium,kiljaeden,431,mage,frost,11,5,6
16936,Summey,tichondrius,431,mage,frost,11,5,6
16937,Lillbean,thunderlord,425,mage,frost,13,6,7
16938,Quinnfreeze,boulderfist,414,mage,frost,11,5,6
16939,Powder,lightninghoof,400,mage,frost,15,7,8
16940,Gai,lightnings-blade,384,mage,frost,6,4,2
16941,Zzyuh,proudmoore,384,mage,frost,6,4,2
16942,Kutulu,aerie-peak,384,mage,frost,6,4,2
16943,Voiddude,proudmoore,384,mage,frost,6,4,2
16944,Lohkey,darkspear,384,mage,frost,6,4,2
16945,Zgodspeedz,stormrage,384,mage,frost,6,4,2
16946,Frostkage,tichondrius,384,mage,frost,6,4,2
16947,Myrondor,tichondrius,384,mage,frost,6,4,2
16948,Hocusjokus,frostmourne,384,mage,frost,6,4,2
16949,Ratfather,the-forgotten-coast,384,mage,frost,6,4,2
16950,Dashdoor,stormrage,384,mage,frost,6,4,2
16951,Froznpizza,zuljin,384,mage,frost,6,4,2
16952,Frobo,mannoroth,384,mage,frost,6,4,2
16953,Vixm,stormrage,384,mage,frost,6,4,2
16954,Bçøløñápûðgé,illidan,384,mage,frost,6,4,2
16955,Cewchí,tichondrius,384,mage,frost,6,4,2
16956,Hammed,dalaran,384,mage,frost,6,4,2
16957,Kälis,zuljin,384,mage,frost,6,4,2
16958,Brobo,chogall,384,mage,frost,6,4,2
16959,Poonfarmer,zangarmarsh,384,mage,frost,6,4,2
16960,Irrandina,moon-guard,384,mage,frost,6,4,2
16961,Danbì,ragnaros,384,mage,frost,6,4,2
16962,Frðstítutè,tichondrius,384,mage,frost,6,4,2
16963,Unlike,sargeras,384,mage,frost,6,4,2
16964,Pzaz,moon-guard,384,mage,frost,6,4,2
16965,Çhíllßrõ,tichondrius,384,mage,frost,6,4,2
16966,Arillius,malganis,384,mage,frost,6,4,2
16967,Fromcanadaqc,tichondrius,384,mage,frost,6,4,2
16968,Rieltar,barthilas,384,mage,frost,6,4,2
16969,Arkane,barthilas,384,mage,frost,6,4,2
16970,Aigam,hyjal,384,mage,frost,6,4,2
16971,Finnese,medivh,384,mage,frost,6,4,2
16972,Neverbroke,illidan,384,mage,frost,6,4,2
16973,Jamesper,tichondrius,384,mage,frost,6,4,2
16974,Polymedaddi,tichondrius,384,mage,frost,6,4,2
16975,Variex,tichondrius,384,mage,frost,6,4,2
16976,Zolix,malganis,384,mage,frost,6,4,2
16977,Snipymagus,shattered-hand,384,mage,frost,9,5,4
16978,Horizons,moon-guard,384,mage,frost,12,4,8
16979,Dallamar,frostwolf,384,mage,frost,12,4,8
16980,Yippmagus,area-52,384,mage,frost,12,4,8
16981,Themageguy,eitrigg,384,mage,frost,12,4,8
16982,Novokaine,area-52,384,mage,frost,12,4,8
16983,Yeuxbleus,tichondrius,384,mage,frost,12,4,8
16984,Splocke,azralon,384,mage,frost,12,4,8
16985,Artty,velen,384,mage,frost,12,4,8
16986,Jorzan,kelthuzad,384,mage,frost,12,4,8
16987,Gemaicy,sargeras,384,mage,frost,12,4,8
16988,Darthez,darkspear,384,mage,frost,12,4,8
16989,Nexttmage,area-52,384,mage,frost,12,4,8
16990,Coldcaster,mugthol,384,mage,frost,12,4,8
16991,Bluedustfart,illidan,384,mage,frost,12,4,8
16992,Fantabulous,korgath,384,mage,frost,12,4,8
16993,Perkaset,turalyon,384,mage,frost,12,4,8
16994,Hhavok,scarlet-crusade,384,mage,frost,12,4,8
16995,Badaszbich,tichondrius,384,mage,frost,12,4,8
16996,Aloredron,illidan,384,mage,frost,12,4,8
16997,Caseyjelly,tichondrius,384,mage,frost,12,4,8
16998,Unmix,tichondrius,384,mage,frost,12,4,8
16999,Klinkr,illidan,384,mage,frost,12,4,8
17000,Meduka,proudmoore,384,mage,frost,12,4,8
17001,Astería,ragnaros,384,mage,frost,14,4,10
17002,Rolypolyman,tichondrius,384,mage,frost,18,4,14
17003,Snanth,black-dragonflight,384,mage,frost,18,4,14
17004,Fullmetal,jaedenar,384,mage,frost,18,4,14
17005,Rastafarix,ragnaros,384,mage,frost,18,4,14
17006,Floopse,agamaggan,383,mage,frost,6,4,2
17007,Brôcolîni,zuljin,383,mage,frost,6,4,2
17008,Gaduri,tichondrius,383,mage,frost,12,4,8
17009,Robinesque,moon-guard,383,mage,frost,12,4,8
17010,Cynafox,moon-guard,383,mage,frost,12,4,8
17011,Rkbj,korgath,383,mage,frost,18,4,14
17012,Dieselonfire,the-venture-co,382,mage,frost,6,4,2
17013,Brezman,tichondrius,382,mage,frost,12,4,8
17014,Neacel,tichondrius,382,mage,frost,12,4,8
17015,Kuni,ghostlands,382,mage,frost,12,4,8
17016,Killerflaco,drakkari,381,mage,frost,24,4,20
17017,Homodilf,blackrock,379,mage,frost,12,4,8
17018,Eirwan,illidan,379,mage,frost,12,4,8
17019,Magicginger,barthilas,352,mage,frost,16,4,12
17020,Cowwboydan,malganis,351,mage,frost,8,5,3
17021,Lirahmi,quelthalas,351,mage,frost,11,4,7
17022,Freezeup,area-52,349,mage,frost,14,7,7
17023,Titsncoke,proudmoore,336,mage,frost,9,4,5
17024,Mugiara,azralon,335,mage,frost,9,4,5
17025,Coldrin,tichondrius,330,mage,frost,15,5,10
17026,Devkek,area-52,330,mage,frost,22,7,15
17027,Icëblöck,ysera,329,mage,frost,6,5,1
17028,Lezafort,area-52,320,mage,frost,16,4,12
17029,Crøwgawd,tichondrius,304,mage,frost,7,4,3
17030,Cruxx,ragnaros,288,mage,frost,6,3,3
17031,Quinnc,tichondrius,288,mage,frost,6,3,3
17032,Percivaltp,scarlet-crusade,288,mage,frost,6,3,3
17033,Kogin,thrall,288,mage,frost,6,3,3
17034,Gobstpper,nagrand,288,mage,frost,6,3,3
17035,Natallyn,stormrage,288,mage,frost,6,3,3
17036,Urbadxd,llane,288,mage,frost,6,3,3
17037,Botoslàp,dragonmaw,288,mage,frost,6,3,3
17038,Dotznsheep,zuljin,288,mage,frost,6,3,3
17039,Índís,ragnaros,288,mage,frost,6,3,3
17040,Nksbluedeath,area-52,288,mage,frost,6,3,3
17041,Blinkinghobo,sargeras,288,mage,frost,6,3,3
17042,Killemz,dragonmaw,288,mage,frost,6,3,3
17043,Eraticmage,illidan,288,mage,frost,6,3,3
17044,Mäz,malorne,288,mage,frost,6,3,3
17045,Pyroseraph,bleeding-hollow,288,mage,frost,6,3,3
17046,Magicianqt,tichondrius,288,mage,frost,6,3,3
17047,Frostytits,spirestone,288,mage,frost,6,3,3
17048,Kryptekk,area-52,288,mage,frost,6,3,3
17049,Ingrumatig,tichondrius,288,mage,frost,6,3,3
17050,Kazimìr,tichondrius,288,mage,frost,6,3,3
17051,Ðontßlink,illidan,288,mage,frost,6,3,3
17052,Thxo,hyjal,288,mage,frost,6,3,3
17053,Hékate,moon-guard,288,mage,frost,6,3,3
17054,Aurumium,illidan,288,mage,frost,6,3,3
17055,Coneofkony,bleeding-hollow,288,mage,frost,6,3,3
17056,Fredcouples,tichondrius,288,mage,frost,6,3,3
17057,Betaduck,bleeding-hollow,288,mage,frost,6,3,3
17058,Orangemilk,hyjal,288,mage,frost,6,3,3
17059,Illúmi,moon-guard,288,mage,frost,6,3,3
17060,Krililin,stormrage,288,mage,frost,6,3,3
17061,Címegripe,stormrage,288,mage,frost,6,3,3
17062,Lilsake,sargeras,288,mage,frost,6,3,3
17063,Bigchilly,malganis,288,mage,frost,6,3,3
17064,Missingxx,silvermoon,288,mage,frost,6,3,3
17065,Youngwiz,arthas,288,mage,frost,6,3,3
17066,Kaïdis,nemesis,288,mage,frost,6,3,3
17067,Kqlyy,tichondrius,288,mage,frost,6,3,3
17068,Honchó,velen,288,mage,frost,6,3,3
17069,Abruaa,area-52,288,mage,frost,6,3,3
17070,Linsz,nemesis,288,mage,frost,6,3,3
17071,Oomoo,malganis,288,mage,frost,6,3,3
17072,Isuikido,nemesis,288,mage,frost,6,3,3
17073,Zukoprince,azralon,288,mage,frost,6,3,3
17074,Bønemage,azralon,288,mage,frost,6,3,3
17075,Toastmg,tichondrius,288,mage,frost,6,3,3
17076,Atwyxn,illidan,288,mage,frost,6,3,3
17077,Personah,darkspear,288,mage,frost,6,3,3
17078,Chriglol,black-dragonflight,288,mage,frost,6,3,3
17079,Murcury,tichondrius,288,mage,frost,6,3,3
17080,Icetooseeyou,barthilas,288,mage,frost,6,3,3
17081,Dragonie,nordrassil,288,mage,frost,6,3,3
17082,Bound,emerald-dream,288,mage,frost,6,3,3
17083,Léras,stormrage,288,mage,frost,6,3,3
17084,Maelista,tichondrius,288,mage,frost,6,3,3
17085,Trozkov,dalaran,288,mage,frost,6,3,3
17086,Murderlin,tichondrius,288,mage,frost,6,3,3
17087,Ariezx,kelthuzad,288,mage,frost,6,3,3
17088,Nalla,nerzhul,288,mage,frost,6,3,3
17089,Packaged,emerald-dream,288,mage,frost,6,3,3
17090,Blâzer,nazjatar,288,mage,frost,6,3,3
17091,Etyx,tichondrius,288,mage,frost,10,4,6
17092,Vague,tichondrius,288,mage,frost,9,3,6
17093,Voidera,wyrmrest-accord,288,mage,frost,12,3,9
17094,Ezchallenger,undermine,288,mage,frost,12,3,9
17095,Fracxure,area-52,288,mage,frost,12,3,9
17096,Fingeredx,zuljin,288,mage,frost,12,3,9
17097,Littleguzto,garrosh,288,mage,frost,12,3,9
17098,Albbano,tichondrius,288,mage,frost,12,3,9
17099,Hqscoltt,azralon,288,mage,frost,12,3,9
17100,Frostcakes,quelthalas,288,mage,frost,12,3,9
17101,Grynthwzrd,stormrage,288,mage,frost,12,3,9
17102,Steefers,arygos,288,mage,frost,12,3,9
17103,Bartholomew,lothar,288,mage,frost,12,3,9
17104,Worldonfire,ragnaros,288,mage,frost,12,3,9
17105,Linadeslayer,chogall,288,mage,frost,12,3,9
17106,Daydreamz,lightnings-blade,288,mage,frost,12,3,9
17107,Calcaster,aegwynn,288,mage,frost,12,3,9
17108,Draell,drakkari,288,mage,frost,12,3,9
17109,Bootyclapper,shadowmoon,288,mage,frost,12,3,9
17110,Houdiinii,illidan,288,mage,frost,12,3,9
17111,Radakos,emerald-dream,288,mage,frost,12,3,9
17112,Rabeiro,tichondrius,288,mage,frost,12,3,9
17113,Anuub,kelthuzad,288,mage,frost,12,3,9
17114,Argyron,fizzcrank,288,mage,frost,12,3,9
17115,Queimabixo,azralon,287,mage,frost,6,3,3
17116,Applemage,ragnaros,287,mage,frost,6,3,3
17117,Icehero,tichondrius,287,mage,frost,6,3,3
17118,Shimotama,malganis,287,mage,frost,6,3,3
17119,Gufi,drakkari,287,mage,frost,6,3,3
17120,Clausolas,ragnaros,287,mage,frost,6,3,3
17121,Cawyro,caelestrasz,287,mage,frost,12,3,9
17122,Colddevil,hyjal,287,mage,frost,13,3,10
17123,Lünâliä,bleeding-hollow,286,mage,frost,6,3,3
17124,Mideon,whisperwind,286,mage,frost,6,3,3
17125,Grausum,tichondrius,256,mage,frost,10,3,7
17126,Taevy,tichondrius,256,mage,frost,10,3,7
17127,Chuekona,ragnaros,256,mage,frost,10,3,7
17128,Cheyz,onyxia,239,mage,frost,5,3,2
17129,Unydae,frostmourne,239,mage,frost,5,3,2
17130,Drewann,draenor,239,mage,frost,5,3,2
17131,Kizran,frostmourne,239,mage,frost,5,3,2
17132,Itsoveryo,jubeithos,239,mage,frost,11,3,8
17133,Saski,nathrezim,234,mage,frost,6,4,2
17134,Gtown,kelthuzad,234,mage,frost,11,4,7
17135,Thaldarian,emerald-dream,234,mage,frost,13,4,9
17136,Skerei,azralon,234,mage,frost,19,4,15
17137,Rayricefan,blood-furnace,192,mage,frost,4,3,1
17138,Abracadaver,greymane,192,mage,frost,4,3,1
17139,Xar,guldan,192,mage,frost,6,2,4
17140,Pyröz,kelthuzad,192,mage,frost,6,2,4
17141,Undersky,tichondrius,192,mage,frost,6,2,4
17142,Muskybiggie,bleeding-hollow,192,mage,frost,6,2,4
17143,Strêss,kelthuzad,192,mage,frost,6,2,4
17144,Nunezz,mannoroth,192,mage,frost,6,2,4
17145,Audacy,sargeras,192,mage,frost,6,2,4
17146,Vyyp,echo-isles,192,mage,frost,6,2,4
17147,Afknz,frostmourne,192,mage,frost,6,2,4
17148,Makius,area-52,192,mage,frost,6,2,4
17149,Magiaguarra,ragnaros,192,mage,frost,6,2,4
17150,Manadart,quelthalas,192,mage,frost,6,2,4
17151,Duhquarius,warsong,192,mage,frost,6,2,4
17152,Xenagozs,antonidas,192,mage,frost,6,2,4
17153,Westii,illidan,192,mage,frost,6,2,4
17154,Biillionaire,frostmourne,192,mage,frost,6,2,4
17155,Kickpollyplx,lothar,192,mage,frost,6,2,4
17156,Cradic,tichondrius,192,mage,frost,6,2,4
17157,Drdocx,frostmourne,192,mage,frost,6,2,4
17158,Jayma,moon-guard,192,mage,frost,6,2,4
17159,Bluishhue,thrall,192,mage,frost,6,2,4
17160,Elvin,frostmourne,192,mage,frost,6,2,4
17161,Eretik,ragnaros,192,mage,frost,6,2,4
17162,Agoniey,illidan,192,mage,frost,6,2,4
17163,Echoz,frostmourne,192,mage,frost,6,2,4
17164,Vailor,whisperwind,192,mage,frost,6,2,4
17165,Cottonmage,malganis,192,mage,frost,6,2,4
17166,Rapidmage,malganis,192,mage,frost,6,2,4
17167,Mageethot,moon-guard,192,mage,frost,6,2,4
17168,Choctøp,frostmourne,192,mage,frost,6,2,4
17169,Sophrates,burning-blade,192,mage,frost,6,2,4
17170,Abstractgoat,tichondrius,192,mage,frost,6,2,4
17171,Mager,dentarg,192,mage,frost,6,2,4
17172,Cantblocklul,baelgun,192,mage,frost,6,2,4
17173,Suprido,illidan,192,mage,frost,6,2,4
17174,Winstonchill,zuljin,192,mage,frost,6,2,4
17175,Tanedos,tichondrius,192,mage,frost,6,2,4
17176,Ryusuke,thrall,192,mage,frost,6,2,4
17177,Yellowfevrz,thrall,192,mage,frost,6,2,4
17178,Fineous,kalecgos,192,mage,frost,6,2,4
17179,Vortex,fenris,192,mage,frost,6,2,4
17180,Vallfire,malganis,192,mage,frost,6,2,4
17181,Drewzz,tichondrius,192,mage,frost,6,2,4
17182,Avicci,shattered-halls,192,mage,frost,6,2,4
17183,Gradmage,proudmoore,192,mage,frost,6,2,4
17184,Korky,dalvengyr,192,mage,frost,6,2,4
17185,Smók,ragnaros,192,mage,frost,6,2,4
17186,Sparqablink,tichondrius,192,mage,frost,6,2,4
17187,Fïtz,quelthalas,192,mage,frost,6,2,4
17188,Dinklord,azuremyst,192,mage,frost,6,2,4
17189,Arkuran,proudmoore,192,mage,frost,6,2,4
17190,Stìnkfîst,tichondrius,192,mage,frost,6,2,4
17191,Elhechizero,quelthalas,192,mage,frost,6,2,4
17192,Whiteyx,saurfang,192,mage,frost,6,2,4
17193,Rbn,tichondrius,192,mage,frost,6,2,4
17194,Raynark,nemesis,192,mage,frost,6,2,4
17195,Aangx,stormrage,192,mage,frost,6,2,4
17196,Jainamommy,emerald-dream,192,mage,frost,6,2,4
17197,Kammany,thrall,192,mage,frost,6,2,4
17198,Getmaged,bleeding-hollow,192,mage,frost,6,2,4
17199,Roarly,stonemaul,192,mage,frost,6,2,4
17200,Quesomancer,illidan,192,mage,frost,6,2,4
17201,Ironwolft,tichondrius,192,mage,frost,6,2,4
17202,Crazytime,tichondrius,192,mage,frost,6,2,4
17203,Fleët,tichondrius,192,mage,frost,6,2,4
17204,Ayci,velen,192,mage,frost,6,2,4
17205,Nachtt,sargeras,192,mage,frost,6,2,4
17206,Vênsêr,emerald-dream,192,mage,frost,6,2,4
17207,Wyss,azralon,192,mage,frost,6,2,4
17208,Xü,stormrage,192,mage,frost,6,2,4
17209,Anyahs,tichondrius,192,mage,frost,6,2,4
17210,Chelseâ,emerald-dream,192,mage,frost,6,2,4
17211,Karameltart,barthilas,192,mage,frost,6,2,4
17212,Iguanodon,proudmoore,192,mage,frost,6,2,4
17213,Ess,tichondrius,192,mage,frost,6,2,4
17214,Undeadmager,nerzhul,192,mage,frost,6,2,4
17215,Icebish,skullcrusher,192,mage,frost,6,2,4
17216,Granmago,azralon,192,mage,frost,6,2,4
17217,Viccluvin,stormrage,192,mage,frost,6,2,4
17218,Earff,kiljaeden,192,mage,frost,6,2,4
17219,Herzthroh,stormrage,192,mage,frost,6,2,4
17220,Airsickjet,kiljaeden,192,mage,frost,6,2,4
17221,Clickhard,suramar,192,mage,frost,9,2,7
17222,Joare,area-52,192,mage,frost,12,2,10
17223,Excentral,tichondrius,192,mage,frost,12,2,10
17224,Sîmply,zuljin,192,mage,frost,12,2,10
17225,Bossmage,tichondrius,192,mage,frost,12,2,10
17226,Mendittorosa,tichondrius,192,mage,frost,12,2,10
17227,Rán,spirestone,192,mage,frost,12,2,10
17228,Converseqt,stormrage,192,mage,frost,12,2,10
17229,Mageyoulooks,shattered-hand,192,mage,frost,12,2,10
17230,Hositonet,malganis,192,mage,frost,12,2,10
17231,Tracemaker,emerald-dream,192,mage,frost,12,2,10
17232,Adxion,quelthalas,192,mage,frost,12,2,10
17233,Dylanpickles,darkspear,192,mage,frost,12,2,10
17234,Zerg,fenris,192,mage,frost,12,2,10
17235,Mônstâ,thrall,192,mage,frost,12,2,10
17236,Èvilmage,blackrock,192,mage,frost,12,2,10
17237,Wqnmlgbdy,tichondrius,192,mage,frost,18,2,16
17238,Kahldyn,stormrage,191,mage,frost,4,3,1
17239,Alladen,anubarak,191,mage,frost,6,2,4
17240,Rathrizar,emerald-dream,191,mage,frost,6,2,4
17241,Hense,stormrage,191,mage,frost,6,2,4
17242,Bittérs,tichondrius,191,mage,frost,6,2,4
17243,Cheapped,emerald-dream,175,mage,frost,6,3,3
17244,Blakus,tichondrius,159,mage,frost,6,3,3
17245,Frosteddiks,shattered-halls,159,mage,frost,5,2,3
17246,Erudit,tichondrius,144,mage,frost,15,2,13
17247,Shardgodx,kelthuzad,138,mage,frost,8,4,4
17248,Vìllyn,boulderfist,138,mage,frost,12,4,8
17249,Máximus,illidan,128,mage,frost,4,2,2
17250,Idamnedu,crushridge,128,mage,frost,4,2,2
17251,Firèballin,tichondrius,128,mage,frost,4,2,2
17252,Goingmassive,frostmourne,127,mage,frost,4,2,2
17253,Proviet,frostmourne,127,mage,frost,8,2,6
17254,Sillycole,emerald-dream,96,mage,frost,3,2,1
17255,Thôrsena,ursin,96,mage,frost,3,2,1
17256,Bigsplosions,kiljaeden,96,mage,frost,3,2,1
17257,Neverworks,tichondrius,96,mage,frost,6,1,5
17258,Fadedfire,area-52,96,mage,frost,6,1,5
17259,Michaelbust,tichondrius,96,mage,frost,6,1,5
17260,Oring,tichondrius,96,mage,frost,6,1,5
17261,Fookz,malganis,96,mage,frost,6,1,5
17262,Truewinter,tichondrius,96,mage,frost,6,1,5
17263,Pyrofrost,stonemaul,96,mage,frost,6,1,5
17264,Litiria,burning-blade,96,mage,frost,6,1,5
17265,Stormfrieza,tichondrius,96,mage,frost,6,1,5
17266,Furrblock,tichondrius,96,mage,frost,6,1,5
17267,Exonerate,mannoroth,96,mage,frost,6,1,5
17268,Politeness,tichondrius,96,mage,frost,6,1,5
17269,Pblastdatass,stormrage,96,mage,frost,6,1,5
17270,Ogfresh,area-52,96,mage,frost,6,1,5
17271,Coolhandz,tichondrius,96,mage,frost,6,1,5
17272,Naviator,tichondrius,96,mage,frost,6,1,5
17273,Gíldrin,proudmoore,96,mage,frost,6,1,5
17274,Magicmom,wyrmrest-accord,96,mage,frost,6,1,5
17275,Thiccness,hydraxis,96,mage,frost,6,1,5
17276,Yeonmok,tichondrius,96,mage,frost,6,1,5
17277,Soulbite,barthilas,96,mage,frost,6,1,5
17278,Dathoe,laughing-skull,96,mage,frost,6,1,5
17279,Jizzlez,tichondrius,96,mage,frost,6,1,5
17280,Trevihl,malganis,96,mage,frost,6,1,5
17281,Alode,moon-guard,96,mage,frost,6,1,5
17282,Freezze,malganis,96,mage,frost,6,1,5
17283,Wuzzo,tichondrius,96,mage,frost,6,1,5
17284,Ichirou,stormrage,96,mage,frost,6,1,5
17285,Professor,khadgar,96,mage,frost,6,1,5
17286,Gnòmêrcy,kelthuzad,96,mage,frost,6,1,5
17287,Geekm,frostmourne,96,mage,frost,6,1,5
17288,Åpollous,frostmourne,96,mage,frost,6,1,5
17289,Mïzzfreeze,haomarush,96,mage,frost,6,1,5
17290,Ricter,hyjal,96,mage,frost,6,1,5
17291,Aerodynamiq,area-52,96,mage,frost,6,1,5
17292,Themose,sargeras,96,mage,frost,6,1,5
17293,Mastacombust,illidan,96,mage,frost,6,1,5
17294,Beerandmagic,zuljin,96,mage,frost,6,1,5
17295,Majx,eldrethalas,96,mage,frost,6,1,5
17296,Adrazell,sargeras,96,mage,frost,6,1,5
17297,Ârcano,ragnaros,96,mage,frost,6,1,5
17298,Ñõxx,sargeras,96,mage,frost,6,1,5
17299,Pizzatest,area-52,96,mage,frost,12,1,11
17300,Taladas,suramar,96,mage,frost,12,1,11
17301,Ldc,kelthuzad,96,mage,frost,12,1,11
17302,Vensyr,stormrage,96,mage,frost,12,1,11
17303,Badiatorr,alterac-mountains,96,mage,frost,12,1,11
17304,Voxbluvine,hakkar,96,mage,frost,12,1,11
17305,Zei,bleeding-hollow,96,mage,frost,12,1,11
17306,Pyrophobia,mannoroth,96,mage,frost,12,1,11
17307,Thebraveonee,frostmourne,95,mage,frost,6,1,5
17308,Icemaker,destromath,95,mage,frost,18,1,17
17309,Notria,illidan,79,mage,frost,5,1,4
17310,Buckybever,illidan,79,mage,frost,11,1,10
17311,Frostybihh,bonechewer,64,mage,frost,4,1,3
17312,Unclekyle,skullcrusher,48,mage,frost,3,1,2
17313,Lv,stormscale,48,mage,frost,9,1,8
17314,Kushjointz,tichondrius,42,mage,frost,11,3,8
17315,Dazby,tichondrius,42,mage,frost,11,3,8
17316,Hoecakez,tichondrius,31,mage,frost,2,1,1
17317,Dãnwun,tichondrius,2284,monk,mistweaver,96,60,36
17318,Meepmonk,tichondrius,2283,monk,mistweaver,96,60,36
17319,Dannycarey,tichondrius,2278,monk,mistweaver,78,55,23
17320,Garbagemonk,scilla,2277,monk,mistweaver,191,120,71
17321,Woezx,stormreaver,2264,monk,mistweaver,68,47,21
17322,Mysticallx,sargeras,2259,monk,mistweaver,84,53,31
17323,Sharkpiglet,illidan,2249,monk,mistweaver,90,57,33
17324,Boogstyle,malganis,2245,monk,mistweaver,130,76,54
17325,Linlol,tichondrius,2240,monk,mistweaver,472,274,198
17326,Weavied,sargeras,2215,monk,mistweaver,156,84,72
17327,Zenjj,thorium-brotherhood,2211,monk,mistweaver,158,92,66
17328,Jep,tichondrius,2190,monk,mistweaver,138,88,50
17329,Hernameplz,proudmoore,2179,monk,mistweaver,117,64,53
17330,Cool,crushridge,2167,monk,mistweaver,126,75,51
17331,Idiotgriefer,tichondrius,2160,monk,mistweaver,78,48,30
17332,Sharkpiggie,illidan,2159,monk,mistweaver,78,45,33
17333,Mãsterpõ,tichondrius,2155,monk,mistweaver,295,156,139
17334,Emoeres,kelthuzad,2151,monk,mistweaver,104,55,49
17335,Flarks,area-52,2151,monk,mistweaver,155,80,75
17336,Oliveirarr,tichondrius,2150,monk,mistweaver,144,81,63
17337,Moonym,nagrand,2144,monk,mistweaver,80,48,32
17338,Oblivæon,tichondrius,2143,monk,mistweaver,72,45,27
17339,Sloppyroppy,tichondrius,2143,monk,mistweaver,107,62,45
17340,Dro,khadgar,2141,monk,mistweaver,66,39,27
17341,Moremoretea,tichondrius,2140,monk,mistweaver,87,53,34
17342,Illify,tichondrius,2139,monk,mistweaver,66,52,14
17343,Cuteballs,tichondrius,2138,monk,mistweaver,81,50,31
17344,Oldmanswirl,mugthol,2137,monk,mistweaver,84,50,34
17345,Dowsk,tichondrius,2136,monk,mistweaver,88,52,36
17346,Jetnoob,sargeras,2136,monk,mistweaver,108,60,48
17347,Crunchyrollx,tichondrius,2135,monk,mistweaver,66,49,17
17348,Xeus,darkspear,2133,monk,mistweaver,60,38,22
17349,Hydroz,dethecus,2131,monk,mistweaver,77,46,31
17350,Parodies,illidan,2131,monk,mistweaver,103,53,50
17351,Woggitie,jubeithos,2129,monk,mistweaver,68,45,23
17352,Igriefidiots,tichondrius,2129,monk,mistweaver,71,40,31
17353,Ringofpeace,sargeras,2128,monk,mistweaver,60,40,20
17354,Griefgodx,tichondrius,2127,monk,mistweaver,88,49,39
17355,Vaen,kelthuzad,2126,monk,mistweaver,78,47,31
17356,Wheatsli,malganis,2126,monk,mistweaver,138,81,57
17357,Yangroumo,tichondrius,2123,monk,mistweaver,125,76,49
17358,Vaemonka,stormrage,2123,monk,mistweaver,201,120,81
17359,Babyfaceqt,skullcrusher,2123,monk,mistweaver,184,103,81
17360,Canghaigg,tichondrius,2122,monk,mistweaver,150,94,56
17361,Purgenm,tichondrius,2122,monk,mistweaver,90,52,38
17362,Secdog,tichondrius,2118,monk,mistweaver,84,44,40
17363,Kicub,emerald-dream,2115,monk,mistweaver,84,44,40
17364,Itzokinlol,malganis,2113,monk,mistweaver,114,70,44
17365,Firewatches,emerald-dream,2113,monk,mistweaver,72,42,30
17366,Akiramenaide,tichondrius,2112,monk,mistweaver,60,43,17
17367,Akkiira,sargeras,2112,monk,mistweaver,72,42,30
17368,Sintifissti,sargeras,2111,monk,mistweaver,62,41,21
17369,Gsdfjskpx,sargeras,2107,monk,mistweaver,306,165,141
17370,Drdabz,illidan,2105,monk,mistweaver,60,35,25
17371,Glqjkglbfgdl,zuljin,2105,monk,mistweaver,150,84,66
17372,Raddxd,illidan,2101,monk,mistweaver,71,44,27
17373,Waggìes,moon-guard,2101,monk,mistweaver,83,50,33
17374,Melonmuncher,duskwood,2101,monk,mistweaver,135,79,56
17375,Heywhatsup,emerald-dream,2097,monk,mistweaver,102,50,52
17376,Proghouse,illidan,2089,monk,mistweaver,90,47,43
17377,Nezly,sargeras,2077,monk,mistweaver,78,41,37
17378,Drracaryss,sargeras,2060,monk,mistweaver,203,125,78
17379,Gabîmaru,area-52,2058,monk,mistweaver,135,80,55
17380,Strugglebus,sargeras,2056,monk,mistweaver,42,31,11
17381,Huaren,tichondrius,2048,monk,mistweaver,137,78,59
17382,Ðrägønéyèz,malygos,2047,monk,mistweaver,193,104,89
17383,Breadweaver,malganis,2046,monk,mistweaver,96,47,49
17384,Wagfu,moon-guard,2045,monk,mistweaver,70,40,30
17385,Originull,darkspear,2045,monk,mistweaver,95,53,42
17386,Heha,tichondrius,2036,monk,mistweaver,305,156,149
17387,Zuhak,tichondrius,2033,monk,mistweaver,66,36,30
17388,Nohandslost,blackrock,2033,monk,mistweaver,206,103,103
17389,Fizzlefarmer,moon-guard,2031,monk,mistweaver,89,54,35
17390,Millé,frostmourne,2025,monk,mistweaver,60,36,24
17391,Brazfu,skullcrusher,2023,monk,mistweaver,123,74,49
17392,Zhoku,tichondrius,2020,monk,mistweaver,58,34,24
17393,Triixxy,thrall,2018,monk,mistweaver,101,64,37
17394,Gameníne,tichondrius,2012,monk,mistweaver,60,36,24
17395,Mcoos,tichondrius,2011,monk,mistweaver,186,112,74
17396,Punchgodx,greymane,2010,monk,mistweaver,78,46,32
17397,Nfm,cairne,2006,monk,mistweaver,143,79,64
17398,Chadweave,moon-guard,2004,monk,mistweaver,279,151,128
17399,Voidstate,stormrage,2001,monk,mistweaver,131,71,60
17400,Sypìì,stormrage,2000,monk,mistweaver,108,58,50
17401,Àvríam,stormrage,1999,monk,mistweaver,95,45,50
17402,Leetcoder,tichondrius,1998,monk,mistweaver,189,117,72
17403,Tekuto,tichondrius,1996,monk,mistweaver,91,63,28
17404,Orbgodx,darkspear,1996,monk,mistweaver,66,39,27
17405,Thèwy,tichondrius,1995,monk,mistweaver,47,30,17
17406,Taeeun,tichondrius,1994,monk,mistweaver,57,38,19
17407,Kris,llane,1994,monk,mistweaver,89,51,38
17408,Tyrfan,sargeras,1994,monk,mistweaver,154,84,70
17409,Bhoredom,kiljaeden,1992,monk,mistweaver,146,80,66
17410,Natalié,caelestrasz,1991,monk,mistweaver,60,37,23
17411,Sevymonk,stormrage,1990,monk,mistweaver,102,62,40
17412,Thet,sargeras,1989,monk,mistweaver,177,90,87
17413,Wingchungus,sargeras,1987,monk,mistweaver,42,30,12
17414,Moldboy,area-52,1987,monk,mistweaver,63,38,25
17415,Jiwå,terenas,1985,monk,mistweaver,648,328,320
17416,Danarolls,spirestone,1982,monk,mistweaver,83,40,43
17417,Nesoween,tichondrius,1979,monk,mistweaver,110,65,45
17418,Bungfist,stormrage,1977,monk,mistweaver,35,25,10
17419,Vinnyd,tichondrius,1976,monk,mistweaver,39,27,12
17420,Speedcapped,area-52,1974,monk,mistweaver,132,65,67
17421,Martiálfarts,malganis,1973,monk,mistweaver,42,30,12
17422,Liltuna,icecrown,1968,monk,mistweaver,42,26,16
17423,Assez,tichondrius,1966,monk,mistweaver,74,37,37
17424,Físterxd,bleeding-hollow,1965,monk,mistweaver,164,93,71
17425,Pragma,kiljaeden,1964,monk,mistweaver,66,37,29
17426,Venfuki,tichondrius,1963,monk,mistweaver,60,35,25
17427,Jakethegreat,moknathal,1963,monk,mistweaver,187,108,79
17428,Canghaimonk,tichondrius,1957,monk,mistweaver,84,42,42
17429,Wetchickennz,tichondrius,1955,monk,mistweaver,148,84,64
17430,Hafezassad,illidan,1954,monk,mistweaver,48,23,25
17431,Swurvex,bleeding-hollow,1953,monk,mistweaver,72,34,38
17432,Qtmonk,emerald-dream,1950,monk,mistweaver,159,93,66
17433,Vongg,tichondrius,1950,monk,mistweaver,66,36,30
17434,Zamist,sargeras,1949,monk,mistweaver,84,52,32
17435,Morzmyth,nemesis,1945,monk,mistweaver,166,86,80
17436,Poscom,tichondrius,1944,monk,mistweaver,155,104,51
17437,Grif,nazjatar,1942,monk,mistweaver,207,108,99
17438,Yasysy,tichondrius,1938,monk,mistweaver,42,25,17
17439,Xcrispy,scilla,1936,monk,mistweaver,55,38,17
17440,Ilovekok,sargeras,1933,monk,mistweaver,84,64,20
17441,Xzeer,illidan,1933,monk,mistweaver,53,36,17
17442,Beez,balnazzar,1931,monk,mistweaver,69,35,34
17443,Pandacottoco,azralon,1924,monk,mistweaver,78,44,34
17444,Imdabes,velen,1923,monk,mistweaver,72,39,33
17445,Postmark,tichondrius,1922,monk,mistweaver,60,34,26
17446,Vethosis,illidan,1921,monk,mistweaver,43,27,16
17447,Lmhs,tichondrius,1920,monk,mistweaver,54,32,22
17448,Ònó,quelthalas,1919,monk,mistweaver,67,39,28
17449,Brewsome,bloodhoof,1919,monk,mistweaver,82,43,39
17450,Michæ,quelthalas,1917,monk,mistweaver,232,130,102
17451,Watersheep,darkspear,1916,monk,mistweaver,60,33,27
17452,Wolf,shattered-hand,1915,monk,mistweaver,42,24,18
17453,Soprà,zuljin,1914,monk,mistweaver,63,39,24
17454,Nuriva,tichondrius,1913,monk,mistweaver,70,50,20
17455,Abellmonk,tichondrius,1910,monk,mistweaver,203,117,86
17456,Paperfist,stormrage,1906,monk,mistweaver,126,87,39
17457,Benneroy,moon-guard,1906,monk,mistweaver,30,20,10
17458,Neuron,spirestone,1906,monk,mistweaver,44,23,21
17459,Wrxx,kelthuzad,1905,monk,mistweaver,328,163,165
17460,Basedbuck,dalaran,1904,monk,mistweaver,36,23,13
17461,Mavvi,tichondrius,1904,monk,mistweaver,128,71,57
17462,Sillyguy,stormrage,1901,monk,mistweaver,107,69,38
17463,Cardrik,thrall,1901,monk,mistweaver,149,79,70
17464,Toyotasupra,emerald-dream,1898,monk,mistweaver,72,46,26
17465,Kansú,ragnaros,1898,monk,mistweaver,94,49,45
17466,Liteup,smolderthorn,1897,monk,mistweaver,444,226,218
17467,Furiousfrank,stormrage,1894,monk,mistweaver,30,20,10
17468,Worldhopperx,area-52,1894,monk,mistweaver,89,57,32
17469,Zukki,zuljin,1894,monk,mistweaver,130,73,57
17470,Kristië,stormrage,1891,monk,mistweaver,42,30,12
17471,Taichí,tichondrius,1891,monk,mistweaver,65,35,30
17472,Nakedidiot,kelthuzad,1888,monk,mistweaver,54,35,19
17473,Suamw,tichondrius,1888,monk,mistweaver,115,55,60
17474,Actualcrime,tichondrius,1886,monk,mistweaver,54,29,25
17475,Fenriranger,tichondrius,1885,monk,mistweaver,90,63,27
17476,Zengriff,ysondre,1885,monk,mistweaver,72,44,28
17477,Rokkon,sargeras,1885,monk,mistweaver,78,45,33
17478,Zuhakmw,tichondrius,1885,monk,mistweaver,100,47,53
17479,Zeçe,tichondrius,1879,monk,mistweaver,36,23,13
17480,Suhjoon,bleeding-hollow,1878,monk,mistweaver,160,80,80
17481,Toozmania,stormrage,1876,monk,mistweaver,52,31,21
17482,Nilox,sargeras,1876,monk,mistweaver,120,65,55
17483,Vramonk,area-52,1875,monk,mistweaver,47,27,20
17484,Sifu,bleeding-hollow,1873,monk,mistweaver,59,36,23
17485,Discurzed,barthilas,1873,monk,mistweaver,175,99,76
17486,Spicyx,kiljaeden,1871,monk,mistweaver,30,24,6
17487,Xdfu,stormrage,1870,monk,mistweaver,54,35,19
17488,Canadá,bleeding-hollow,1869,monk,mistweaver,54,37,17
17489,Robocto,area-52,1869,monk,mistweaver,102,61,41
17490,Timermørk,kalecgos,1867,monk,mistweaver,92,57,35
17491,Shùù,tichondrius,1866,monk,mistweaver,65,37,28
17492,Dalillama,stormreaver,1865,monk,mistweaver,48,31,17
17493,Logtich,moon-guard,1864,monk,mistweaver,78,42,36
17494,Okchat,emerald-dream,1862,monk,mistweaver,119,76,43
17495,Søpra,zuljin,1861,monk,mistweaver,120,71,49
17496,Lexxbtw,thrall,1860,monk,mistweaver,131,73,58
17497,Papermade,barthilas,1860,monk,mistweaver,48,26,22
17498,Monktease,tichondrius,1860,monk,mistweaver,66,34,32
17499,Aegea,illidan,1859,monk,mistweaver,55,30,25
17500,Quitw,tichondrius,1859,monk,mistweaver,61,32,29
17501,Cmonktwo,turalyon,1858,monk,mistweaver,54,31,23
17502,Meepmonk,kilrogg,1858,monk,mistweaver,39,21,18
17503,Sevenmonk,tichondrius,1857,monk,mistweaver,54,36,18
17504,Tokol,tichondrius,1857,monk,mistweaver,168,90,78
17505,Esqu,sargeras,1856,monk,mistweaver,36,22,14
17506,Cmonk,turalyon,1856,monk,mistweaver,40,24,16
17507,Threefanandy,kelthuzad,1855,monk,mistweaver,36,23,13
17508,Piilsburry,sargeras,1855,monk,mistweaver,48,26,22
17509,Praggers,proudmoore,1855,monk,mistweaver,107,53,54
17510,Slunka,tichondrius,1854,monk,mistweaver,48,27,21
17511,Shad,frostmourne,1853,monk,mistweaver,102,58,44
17512,Zdeg,tichondrius,1852,monk,mistweaver,51,28,23
17513,Ileffsinll,illidan,1851,monk,mistweaver,107,60,47
17514,Velzarria,zuljin,1850,monk,mistweaver,48,32,16
17515,Fluval,moon-guard,1850,monk,mistweaver,71,47,24
17516,Celerein,illidan,1850,monk,mistweaver,112,60,52
17517,Damogen,spinebreaker,1849,monk,mistweaver,54,28,26
17518,Zipmw,tichondrius,1848,monk,mistweaver,66,36,30
17519,Proxy,ragnaros,1846,monk,mistweaver,46,31,15
17520,Senseipwnda,stormrage,1846,monk,mistweaver,71,43,28
17521,Tonyboloney,tichondrius,1845,monk,mistweaver,42,25,17
17522,Dampdampdamp,tichondrius,1844,monk,mistweaver,24,20,4
17523,Fîstweave,emerald-dream,1844,monk,mistweaver,77,45,32
17524,Yujiro,draktharon,1843,monk,mistweaver,36,23,13
17525,Dwánesan,tichondrius,1843,monk,mistweaver,72,44,28
17526,Crabfest,zuljin,1843,monk,mistweaver,60,35,25
17527,Sniffinsteak,laughing-skull,1842,monk,mistweaver,36,29,7
17528,Xinergy,illidan,1840,monk,mistweaver,98,65,33
17529,Stonemists,ragnaros,1840,monk,mistweaver,65,40,25
17530,Nabunaga,illidan,1837,monk,mistweaver,42,34,8
17531,Hinåta,thrall,1837,monk,mistweaver,40,26,14
17532,Baychiz,sargeras,1837,monk,mistweaver,42,25,17
17533,Irraeine,malganis,1836,monk,mistweaver,48,31,17
17534,Zarenki,tichondrius,1835,monk,mistweaver,73,33,40
17535,Spacebar,ysondre,1834,monk,mistweaver,54,31,23
17536,Blackoutmonk,stormreaver,1833,monk,mistweaver,131,80,51
17537,Gogumamonk,tichondrius,1833,monk,mistweaver,48,24,24
17538,Guarantee,tichondrius,1832,monk,mistweaver,182,102,80
17539,Cmonkey,turalyon,1831,monk,mistweaver,48,31,17
17540,Carzzy,sargeras,1829,monk,mistweaver,35,23,12
17541,Drunkenfist,chogall,1829,monk,mistweaver,71,32,39
17542,Tirionx,area-52,1828,monk,mistweaver,215,125,90
17543,Baoma,tichondrius,1827,monk,mistweaver,95,55,40
17544,Monklike,illidan,1827,monk,mistweaver,60,30,30
17545,Gentleuncle,tichondrius,1826,monk,mistweaver,125,72,53
17546,Macrobrewski,tichondrius,1825,monk,mistweaver,41,32,9
17547,Jackouse,frostmourne,1824,monk,mistweaver,50,31,19
17548,Harkwind,azralon,1824,monk,mistweaver,151,89,62
17549,Hugdealer,warsong,1823,monk,mistweaver,80,47,33
17550,Gtmdyjs,illidan,1822,monk,mistweaver,29,20,9
17551,Ekn,tichondrius,1822,monk,mistweaver,30,20,10
17552,Jojostar,shadowsong,1822,monk,mistweaver,54,32,22
17553,Copula,illidan,1822,monk,mistweaver,272,141,131
17554,Tazi,chromaggus,1821,monk,mistweaver,84,50,34
17555,Mackiechan,kelthuzad,1821,monk,mistweaver,134,77,57
17556,Voltio,frostmane,1820,monk,mistweaver,103,68,35
17557,Chaddington,malorne,1820,monk,mistweaver,48,30,18
17558,Monknutt,tichondrius,1819,monk,mistweaver,56,32,24
17559,Mð,vashj,1819,monk,mistweaver,174,91,83
17560,Ilovefrogs,stormrage,1819,monk,mistweaver,60,30,30
17561,Bootÿmagic,tichondrius,1818,monk,mistweaver,102,70,32
17562,Malibrew,proudmoore,1817,monk,mistweaver,42,29,13
17563,Ándi,barthilas,1817,monk,mistweaver,53,28,25
17564,Bubblepony,illidan,1817,monk,mistweaver,313,164,149
17565,Spook,kalecgos,1816,monk,mistweaver,49,35,14
17566,Chaihard,sargeras,1816,monk,mistweaver,45,25,20
17567,Yobeel,tichondrius,1816,monk,mistweaver,54,23,31
17568,Qup,lightbringer,1815,monk,mistweaver,66,49,17
17569,Xhilong,quelthalas,1815,monk,mistweaver,48,28,20
17570,Phunkymonkey,mannoroth,1814,monk,mistweaver,90,50,40
17571,Dancah,eitrigg,1813,monk,mistweaver,30,19,11
17572,Mixon,archimonde,1813,monk,mistweaver,30,19,11
17573,Aviee,illidan,1813,monk,mistweaver,162,72,90
17574,Intra,exodar,1812,monk,mistweaver,150,79,71
17575,Mistpump,tichondrius,1811,monk,mistweaver,48,26,22
17576,Cangry,area-52,1809,monk,mistweaver,60,31,29
17577,Epî,tichondrius,1809,monk,mistweaver,247,122,125
17578,Phattea,thrall,1808,monk,mistweaver,48,31,17
17579,Djkungfu,thrall,1808,monk,mistweaver,156,95,61
17580,Yokuu,thunderlord,1808,monk,mistweaver,54,29,25
17581,Jaja,kiljaeden,1807,monk,mistweaver,48,28,20
17582,Abeldra,moon-guard,1807,monk,mistweaver,82,42,40
17583,Sayflight,tichondrius,1807,monk,mistweaver,72,31,41
17584,Itdreams,illidan,1806,monk,mistweaver,42,25,17
17585,Timed,shuhalo,1806,monk,mistweaver,49,26,23
17586,Shiinobi,area-52,1806,monk,mistweaver,140,74,66
17587,Astrino,zuljin,1805,monk,mistweaver,42,29,13
17588,Chimaekrush,tichondrius,1805,monk,mistweaver,36,24,12
17589,Briàr,area-52,1805,monk,mistweaver,48,27,21
17590,Strongmandan,twisting-nether,1805,monk,mistweaver,42,23,19
17591,Onlyfansx,ragnaros,1805,monk,mistweaver,256,139,117
17592,Cenfu,malganis,1805,monk,mistweaver,72,29,43
17593,Imdabes,destromath,1804,monk,mistweaver,87,38,49
17594,Vrieden,illidan,1804,monk,mistweaver,99,42,57
17595,Keshir,sargeras,1803,monk,mistweaver,69,45,24
17596,Zundor,ghostlands,1802,monk,mistweaver,32,25,7
17597,Kungfoocious,tichondrius,1802,monk,mistweaver,57,33,24
17598,ßullsack,barthilas,1802,monk,mistweaver,108,57,51
17599,Mixflo,bleeding-hollow,1802,monk,mistweaver,39,20,19
17600,Wootzhu,zuljin,1802,monk,mistweaver,122,62,60
17601,Mistweave,aerie-peak,1801,monk,mistweaver,54,34,20
17602,Vanmonk,eonar,1801,monk,mistweaver,54,33,21
17603,Squalicorax,area-52,1801,monk,mistweaver,47,24,23
17604,Jiucho,dalaran,1800,monk,mistweaver,35,23,12
17605,Monjimen,ragnaros,1800,monk,mistweaver,185,107,78
17606,Mekawa,gurubashi,1799,monk,mistweaver,40,26,14
17607,Hawainpunch,stormscale,1799,monk,mistweaver,42,27,15
17608,Tiptea,stormrage,1799,monk,mistweaver,42,23,19
17609,Caffeinated,barthilas,1798,monk,mistweaver,244,118,126
17610,Toonington,sargeras,1797,monk,mistweaver,57,39,18
17611,Cromulent,saurfang,1792,monk,mistweaver,134,70,64
17612,Sqmw,tichondrius,1791,monk,mistweaver,36,22,14
17613,Roypoker,illidan,1785,monk,mistweaver,48,34,14
17614,Fingies,whisperwind,1784,monk,mistweaver,54,32,22
17615,Oppsimop,frostmourne,1783,monk,mistweaver,72,38,34
17616,Rexfiend,tichondrius,1782,monk,mistweaver,24,19,5
17617,Hepp,stormrage,1781,monk,mistweaver,48,32,16
17618,Triarcs,area-52,1781,monk,mistweaver,36,24,12
17619,Ttvchickchau,tichondrius,1779,monk,mistweaver,125,75,50
17620,Valhira,kiljaeden,1779,monk,mistweaver,66,39,27
17621,Coomweaver,stormrage,1778,monk,mistweaver,42,22,20
17622,Gummycat,bonechewer,1776,monk,mistweaver,186,100,86
17623,Fistinator,blackrock,1774,monk,mistweaver,54,35,19
17624,Lgee,kelthuzad,1774,monk,mistweaver,30,19,11
17625,Akkiraa,sargeras,1769,monk,mistweaver,36,23,13
17626,Femalejam,darkspear,1768,monk,mistweaver,54,33,21
17627,Trackstarx,area-52,1767,monk,mistweaver,30,25,5
17628,Daito,jubeithos,1767,monk,mistweaver,110,62,48
17629,Iightning,dentarg,1762,monk,mistweaver,66,40,26
17630,Wigglygiggly,mannoroth,1762,monk,mistweaver,66,38,28
17631,Jayvex,illidan,1762,monk,mistweaver,72,37,35
17632,Itspoils,illidan,1759,monk,mistweaver,55,41,14
17633,Crypomunkz,malganis,1758,monk,mistweaver,35,23,12
17634,Manggi,tichondrius,1758,monk,mistweaver,121,76,45
17635,Ïtächï,illidan,1758,monk,mistweaver,48,22,26
17636,Lovehate,zuljin,1756,monk,mistweaver,66,34,32
17637,Mikamonk,illidan,1755,monk,mistweaver,75,45,30
17638,Monkeymonk,eonar,1755,monk,mistweaver,36,19,17
17639,Rîce,burning-blade,1754,monk,mistweaver,42,29,13
17640,Elvenmonk,frostmane,1754,monk,mistweaver,42,26,16
17641,Rokk,rivendare,1754,monk,mistweaver,78,44,34
17642,Onecoolmonk,tichondrius,1753,monk,mistweaver,45,31,14
17643,Grabbitz,kelthuzad,1751,monk,mistweaver,42,27,15
17644,Bouncycheeks,frostmourne,1751,monk,mistweaver,90,50,40
17645,Dræmwalker,malygos,1751,monk,mistweaver,621,310,311
17646,Spinharder,stormrage,1750,monk,mistweaver,65,38,27
17647,Ensaymada,frostmourne,1750,monk,mistweaver,138,71,67
17648,Callmekoldi,dalaran,1748,monk,mistweaver,93,52,41
17649,Gamesuxlol,the-underbog,1747,monk,mistweaver,96,55,41
17650,Tippity,stormrage,1746,monk,mistweaver,37,24,13
17651,Bebuu,proudmoore,1744,monk,mistweaver,65,44,21
17652,Chonmist,darkspear,1743,monk,mistweaver,74,48,26
17653,Mxf,tichondrius,1743,monk,mistweaver,36,23,13
17654,Mistpowaz,stormrage,1742,monk,mistweaver,143,84,59
17655,Sixesm,dalaran,1742,monk,mistweaver,36,20,16
17656,Elesm,area-52,1741,monk,mistweaver,84,31,53
17657,Beerflow,stormrage,1740,monk,mistweaver,103,53,50
17658,Vernki,laughing-skull,1738,monk,mistweaver,59,36,23
17659,Bobbytheorc,tichondrius,1738,monk,mistweaver,35,21,14
17660,Starçandy,tichondrius,1737,monk,mistweaver,108,58,50
17661,Soö,tichondrius,1737,monk,mistweaver,48,25,23
17662,Decompress,illidan,1734,monk,mistweaver,93,55,38
17663,Antriai,icecrown,1734,monk,mistweaver,60,26,34
17664,Sleeks,bonechewer,1733,monk,mistweaver,114,64,50
17665,Ricearolli,area-52,1731,monk,mistweaver,36,26,10
17666,Shlunks,illidan,1730,monk,mistweaver,217,120,97
17667,Doomstroller,aegwynn,1728,monk,mistweaver,123,64,59
17668,Cystweaver,dalaran,1726,monk,mistweaver,65,41,24
17669,Toxicbeans,tichondrius,1726,monk,mistweaver,72,39,33
17670,Fistofchanny,tichondrius,1725,monk,mistweaver,104,57,47
17671,Ajizzaÿ,saurfang,1725,monk,mistweaver,92,46,46
17672,Onepunçhman,stormreaver,1724,monk,mistweaver,78,48,30
17673,Flavier,illidan,1724,monk,mistweaver,48,25,23
17674,Smoovhoov,kiljaeden,1723,monk,mistweaver,30,19,11
17675,Supbro,hyjal,1723,monk,mistweaver,30,18,12
17676,Smallboots,area-52,1722,monk,mistweaver,30,24,6
17677,Steelcase,frostmourne,1722,monk,mistweaver,47,26,21
17678,Ðescubra,stormrage,1721,monk,mistweaver,80,44,36
17679,Moushindeiru,sargeras,1719,monk,mistweaver,42,35,7
17680,Deathsteel,emerald-dream,1718,monk,mistweaver,29,19,10
17681,Gramazen,tichondrius,1718,monk,mistweaver,42,25,17
17682,Phtarded,stormreaver,1715,monk,mistweaver,128,66,62
17683,Alexìn,sargeras,1712,monk,mistweaver,79,50,29
17684,Alphamist,thrall,1711,monk,mistweaver,30,18,12
17685,Buhmonk,thrall,1710,monk,mistweaver,60,34,26
17686,Noremaç,frostmourne,1709,monk,mistweaver,36,21,15
17687,Gauche,arygos,1709,monk,mistweaver,168,88,80
17688,Betasquadxd,bleeding-hollow,1707,monk,mistweaver,43,25,18
17689,Gundamfish,tichondrius,1707,monk,mistweaver,42,22,20
17690,Misthealz,black-dragonflight,1705,monk,mistweaver,89,57,32
17691,Gnappyy,tichondrius,1705,monk,mistweaver,30,18,12
17692,Knuqz,stormrage,1705,monk,mistweaver,36,18,18
17693,Røllitup,illidan,1704,monk,mistweaver,54,34,20
17694,Yamatoqt,frostmourne,1704,monk,mistweaver,48,29,19
17695,Bouncymoo,frostmourne,1704,monk,mistweaver,30,18,12
17696,Omihli,sargeras,1704,monk,mistweaver,48,28,20
17697,Bloodyxmonk,firetree,1704,monk,mistweaver,55,31,24
17698,Spot,kelthuzad,1704,monk,mistweaver,48,24,24
17699,Turbokíll,proudmoore,1703,monk,mistweaver,36,22,14
17700,Ellesig,ragnaros,1702,monk,mistweaver,184,94,90
17701,Mexii,hellscream,1702,monk,mistweaver,203,98,105
17702,Kawali,thrall,1701,monk,mistweaver,72,40,32
17703,Sparksgamer,ragnaros,1701,monk,mistweaver,36,18,18
17704,Badonkadonk,kiljaeden,1701,monk,mistweaver,66,27,39
17705,Hansul,tichondrius,1700,monk,mistweaver,83,38,45
17706,Qarmax,azralon,1699,monk,mistweaver,30,18,12
17707,Qxt,tichondrius,1699,monk,mistweaver,52,31,21
17708,Krömbopulos,magtheridon,1696,monk,mistweaver,36,24,12
17709,Zaqqari,wyrmrest-accord,1695,monk,mistweaver,48,24,24
17710,Rizzdriver,moon-guard,1694,monk,mistweaver,60,37,23
17711,Greenstar,bleeding-hollow,1692,monk,mistweaver,175,94,81
17712,Linsey,frostmourne,1691,monk,mistweaver,36,20,16
17713,Jiubak,dalaran,1691,monk,mistweaver,48,26,22
17714,Snuggubae,moon-guard,1691,monk,mistweaver,84,44,40
17715,Babychi,frostmourne,1690,monk,mistweaver,51,29,22
17716,Mariabaraks,darkspear,1690,monk,mistweaver,102,56,46
17717,Greenbrews,area-52,1690,monk,mistweaver,192,100,92
17718,Wildfists,tichondrius,1690,monk,mistweaver,559,288,271
17719,Gujunpyó,sargeras,1688,monk,mistweaver,78,48,30
17720,Roogymw,emerald-dream,1688,monk,mistweaver,70,39,31
17721,Hyori,saurfang,1688,monk,mistweaver,42,23,19
17722,Colbz,barthilas,1687,monk,mistweaver,42,27,15
17723,Bromonster,zuljin,1687,monk,mistweaver,36,18,18
17724,Cohenn,tichondrius,1686,monk,mistweaver,24,18,6
17725,Botweaver,proudmoore,1686,monk,mistweaver,80,45,35
17726,Proventos,azralon,1686,monk,mistweaver,252,139,113
17727,Spencere,hyjal,1686,monk,mistweaver,84,44,40
17728,Victuskk,tichondrius,1685,monk,mistweaver,28,23,5
17729,Unclety,tichondrius,1685,monk,mistweaver,42,24,18
17730,Ropturttlê,tichondrius,1684,monk,mistweaver,36,24,12
17731,Confa,ragnaros,1684,monk,mistweaver,154,65,89
17732,Aráshicage,malganis,1681,monk,mistweaver,48,29,19
17733,Vïolët,moon-guard,1681,monk,mistweaver,202,118,84
17734,Fisetèrr,kelthuzad,1680,monk,mistweaver,59,35,24
17735,Motogp,tichondrius,1680,monk,mistweaver,128,61,67
17736,Yeji,altar-of-storms,1680,monk,mistweaver,103,48,55
17737,Dwãrf,tichondrius,1678,monk,mistweaver,36,25,11
17738,Stepfistz,aegwynn,1677,monk,mistweaver,66,36,30
17739,Zenox,rexxar,1675,monk,mistweaver,90,46,44
17740,Xblingtron,malganis,1675,monk,mistweaver,59,24,35
17741,Brewy,bloodhoof,1674,monk,mistweaver,24,19,5
17742,Zawlp,sargeras,1674,monk,mistweaver,48,30,18
17743,Drunkentoker,illidan,1673,monk,mistweaver,48,26,22
17744,Takugava,illidan,1671,monk,mistweaver,60,40,20
17745,Stonymcblaze,malganis,1671,monk,mistweaver,42,25,17
17746,Tezcatyo,malganis,1671,monk,mistweaver,54,32,22
17747,Djuice,tichondrius,1670,monk,mistweaver,42,25,17
17748,Fisticufs,bleeding-hollow,1670,monk,mistweaver,42,23,19
17749,Quitschi,tichondrius,1669,monk,mistweaver,42,26,16
17750,Alekun,quelthalas,1669,monk,mistweaver,146,75,71
17751,Loudpäck,dalaran,1666,monk,mistweaver,41,26,15
17752,Nahr,tichondrius,1666,monk,mistweaver,39,22,17
17753,Nugskis,dalaran,1666,monk,mistweaver,263,135,128
17754,Twoshero,tichondrius,1665,monk,mistweaver,34,22,12
17755,Mememories,tichondrius,1665,monk,mistweaver,74,46,28
17756,Ichiros,cenarion-circle,1665,monk,mistweaver,214,124,90
17757,Cherep,kiljaeden,1665,monk,mistweaver,93,49,44
17758,Winfred,bleeding-hollow,1663,monk,mistweaver,54,36,18
17759,Rektral,ragnaros,1663,monk,mistweaver,58,32,26
17760,Dirtyde,sargeras,1663,monk,mistweaver,130,63,67
17761,Mistweaverxo,malganis,1662,monk,mistweaver,116,65,51
17762,Zuen,ragnaros,1662,monk,mistweaver,200,101,99
17763,Gomon,terenas,1661,monk,mistweaver,29,20,9
17764,Èmacs,barthilas,1661,monk,mistweaver,35,24,11
17765,Jeskâi,tichondrius,1660,monk,mistweaver,45,26,19
17766,Crispeel,tichondrius,1660,monk,mistweaver,42,24,18
17767,Seokdenam,tichondrius,1660,monk,mistweaver,84,47,37
17768,Chessyx,ragnaros,1660,monk,mistweaver,42,20,22
17769,Rectus,proudmoore,1659,monk,mistweaver,30,22,8
17770,Teewin,area-52,1659,monk,mistweaver,83,57,26
17771,Séthrogèn,tichondrius,1659,monk,mistweaver,30,20,10
17772,Dupaweaver,stormrage,1659,monk,mistweaver,59,26,33
17773,Cheetosnmilk,malganis,1658,monk,mistweaver,35,20,15
17774,Damndaniel,hyjal,1658,monk,mistweaver,106,53,53
17775,Serikko,frostmourne,1657,monk,mistweaver,44,26,18
17776,Carlyjepsen,shadowmoon,1657,monk,mistweaver,85,45,40
17777,Cööked,illidan,1656,monk,mistweaver,63,33,30
17778,Greenrice,thrall,1655,monk,mistweaver,52,33,19
17779,Velenious,tichondrius,1655,monk,mistweaver,113,68,45
17780,Inalambrico,quelthalas,1654,monk,mistweaver,30,18,12
17781,Moonhealsyou,moon-guard,1653,monk,mistweaver,88,55,33
17782,Zachxd,onyxia,1653,monk,mistweaver,42,26,16
17783,Tonytornado,proudmoore,1651,monk,mistweaver,84,40,44
17784,Udderpunch,barthilas,1650,monk,mistweaver,53,30,23
17785,Chadmw,illidan,1649,monk,mistweaver,24,18,6
17786,Rexzilla,tichondrius,1648,monk,mistweaver,36,25,11
17787,Notblakexo,tichondrius,1647,monk,mistweaver,35,19,16
17788,Lilsloptop,moon-guard,1646,monk,mistweaver,149,90,59
17789,Swuseng,tichondrius,1646,monk,mistweaver,36,21,15
17790,Grublord,stormrage,1646,monk,mistweaver,41,21,20
17791,Calvana,tichondrius,1645,monk,mistweaver,129,53,76
17792,Miillkz,zuljin,1644,monk,mistweaver,47,25,22
17793,Ahnlev,ragnaros,1643,monk,mistweaver,116,66,50
17794,Ææøææôææôææô,illidan,1642,monk,mistweaver,138,88,50
17795,Xhangtu,thrall,1642,monk,mistweaver,94,59,35
17796,Swoleypoley,tichondrius,1642,monk,mistweaver,36,21,15
17797,Tenoseven,area-52,1640,monk,mistweaver,21,19,2
17798,Centalink,barthilas,1640,monk,mistweaver,56,38,18
17799,Rhorkfist,frostmourne,1640,monk,mistweaver,43,23,20
17800,Djux,zuljin,1639,monk,mistweaver,30,20,10
17801,Versachi,stormreaver,1639,monk,mistweaver,78,44,34
17802,Pichau,zuljin,1638,monk,mistweaver,33,22,11
17803,Blasê,frostmourne,1638,monk,mistweaver,30,18,12
17804,Starryysky,illidan,1637,monk,mistweaver,30,24,6
17805,Liké,tichondrius,1636,monk,mistweaver,54,32,22
17806,Paralee,tichondrius,1635,monk,mistweaver,48,34,14
17807,Ropgobbler,muradin,1634,monk,mistweaver,30,18,12
17808,Gellindra,malganis,1633,monk,mistweaver,24,18,6
17809,Tazermw,sargeras,1633,monk,mistweaver,62,36,26
17810,Sixsticks,tichondrius,1633,monk,mistweaver,70,37,33
17811,Ermac,kiljaeden,1632,monk,mistweaver,47,32,15
17812,Minaffection,tichondrius,1632,monk,mistweaver,36,19,17
17813,Avm,azralon,1632,monk,mistweaver,60,31,29
17814,Ludan,eredar,1629,monk,mistweaver,160,85,75
17815,Místme,tichondrius,1629,monk,mistweaver,78,41,37
17816,Baldbutcute,darkspear,1627,monk,mistweaver,28,19,9
17817,Gooncave,stormrage,1627,monk,mistweaver,52,24,28
17818,Avãrîce,stormrage,1626,monk,mistweaver,24,17,7
17819,Wittymonk,illidan,1625,monk,mistweaver,99,57,42
17820,Bodhisattvax,bleeding-hollow,1625,monk,mistweaver,42,24,18
17821,Stinkycok,tichondrius,1625,monk,mistweaver,30,17,13
17822,Tyforprecog,kelthuzad,1625,monk,mistweaver,36,20,16
17823,Monke,onyxia,1625,monk,mistweaver,42,23,19
17824,Innerchii,tichondrius,1624,monk,mistweaver,24,17,7
17825,Rañga,caelestrasz,1624,monk,mistweaver,66,37,29
17826,Revivalol,dragonmaw,1624,monk,mistweaver,47,25,22
17827,Fistergand,frostwolf,1623,monk,mistweaver,37,30,7
17828,Röshi,kelthuzad,1623,monk,mistweaver,54,35,19
17829,Liteup,korgath,1623,monk,mistweaver,96,59,37
17830,Zhíu,ragnaros,1623,monk,mistweaver,54,33,21
17831,Nicotinetap,tichondrius,1623,monk,mistweaver,30,18,12
17832,Kaylux,stormrage,1623,monk,mistweaver,30,17,13
17833,Timbomist,kelthuzad,1622,monk,mistweaver,39,22,17
17834,Ywingtsuan,frostmourne,1622,monk,mistweaver,41,21,20
17835,Whaes,thrall,1621,monk,mistweaver,24,17,7
17836,Diobrando,illidan,1621,monk,mistweaver,63,40,23
17837,Valian,tichondrius,1621,monk,mistweaver,42,22,20
17838,Gabaan,azralon,1620,monk,mistweaver,30,17,13
17839,Monkwalker,tichondrius,1620,monk,mistweaver,66,35,31
17840,Barelroll,proudmoore,1619,monk,mistweaver,69,49,20
17841,Swolington,proudmoore,1619,monk,mistweaver,41,26,15
17842,Swiftm,thrall,1619,monk,mistweaver,207,120,87
17843,Intertwine,frostmourne,1619,monk,mistweaver,30,17,13
17844,Avz,azralon,1618,monk,mistweaver,30,21,9
17845,Brews,black-dragonflight,1618,monk,mistweaver,31,17,14
17846,Stormpounder,proudmoore,1616,monk,mistweaver,60,40,20
17847,Locusta,tichondrius,1616,monk,mistweaver,30,19,11
17848,Drinkkin,bleeding-hollow,1616,monk,mistweaver,114,68,46
17849,Mwgodqtxtko,nazjatar,1616,monk,mistweaver,54,32,22
17850,Sebsws,proudmoore,1616,monk,mistweaver,100,59,41
17851,Wpola,tichondrius,1616,monk,mistweaver,30,17,13
17852,Nekzí,sargeras,1615,monk,mistweaver,30,20,10
17853,Bréwmaster,stormrage,1615,monk,mistweaver,36,17,19
17854,Mukboo,tichondrius,1615,monk,mistweaver,36,17,19
17855,Hitaru,azralon,1614,monk,mistweaver,54,35,19
17856,Xtacie,sargeras,1614,monk,mistweaver,66,30,36
17857,Furyjames,quelthalas,1614,monk,mistweaver,91,40,51
17858,Keiirah,zuluhed,1614,monk,mistweaver,60,24,36
17859,Pacee,deathwing,1613,monk,mistweaver,24,17,7
17860,Greenvan,tichondrius,1613,monk,mistweaver,24,17,7
17861,Kûshi,stormrage,1613,monk,mistweaver,35,23,12
17862,Kendro,trollbane,1613,monk,mistweaver,59,38,21
17863,Somebodym,illidan,1613,monk,mistweaver,36,22,14
17864,Yunmen,blades-edge,1613,monk,mistweaver,113,61,52
17865,Toastsmonk,tichondrius,1612,monk,mistweaver,30,21,9
17866,Qords,tichondrius,1612,monk,mistweaver,148,77,71
17867,Snoodle,korgath,1610,monk,mistweaver,114,67,47
17868,Sudury,tichondrius,1610,monk,mistweaver,96,55,41
17869,Pingpang,stormreaver,1610,monk,mistweaver,81,46,35
17870,Korata,frostwolf,1610,monk,mistweaver,42,23,19
17871,Samzo,barthilas,1609,monk,mistweaver,45,24,21
17872,Hîbîscus,illidan,1609,monk,mistweaver,32,17,15
17873,Planetariumz,bleeding-hollow,1608,monk,mistweaver,320,168,152
17874,Mîstchievous,sargeras,1607,monk,mistweaver,28,21,7
17875,Jadestørmz,illidan,1607,monk,mistweaver,30,20,10
17876,Santiaguiño,ragnaros,1607,monk,mistweaver,71,27,44
17877,Cryptmist,frostmourne,1606,monk,mistweaver,36,25,11
17878,Mýthik,hyjal,1606,monk,mistweaver,66,37,29
17879,Slipperybobs,tichondrius,1605,monk,mistweaver,71,46,25
17880,Tarkir,quelthalas,1605,monk,mistweaver,89,55,34
17881,Tamingpanda,wildhammer,1605,monk,mistweaver,60,33,27
17882,Pandaiax,area-52,1605,monk,mistweaver,59,31,28
17883,Luvdeluxe,skullcrusher,1605,monk,mistweaver,61,30,31
17884,Eppsmonk,tichondrius,1604,monk,mistweaver,30,18,12
17885,Oblivion,wildhammer,1604,monk,mistweaver,61,36,25
17886,Xtramist,tichondrius,1604,monk,mistweaver,30,17,13
17887,Gnetic,nemesis,1604,monk,mistweaver,86,46,40
17888,Azahri,sargeras,1603,monk,mistweaver,35,23,12
17889,Goochtickles,bleeding-hollow,1602,monk,mistweaver,128,79,49
17890,Gess,stormscale,1602,monk,mistweaver,108,54,54
17891,Showshoway,tichondrius,1602,monk,mistweaver,95,47,48
17892,Docpalpatine,tichondrius,1602,monk,mistweaver,36,17,19
17893,Xuenws,tichondrius,1602,monk,mistweaver,84,36,48
17894,Bowstâff,lightbringer,1601,monk,mistweaver,36,22,14
17895,Boomtac,moon-guard,1601,monk,mistweaver,51,28,23
17896,Zeroxe,area-52,1600,monk,mistweaver,42,30,12
17897,Manchu,stormrage,1599,monk,mistweaver,30,18,12
17898,Ramisan,barthilas,1598,monk,mistweaver,47,29,18
17899,Vynchi,area-52,1596,monk,mistweaver,35,26,9
17900,Suntzulml,quelthalas,1596,monk,mistweaver,94,46,48
17901,Monkney,tichondrius,1595,monk,mistweaver,72,48,24
17902,Whoonmonk,tichondrius,1595,monk,mistweaver,63,38,25
17903,Hunkymonky,thrall,1595,monk,mistweaver,69,40,29
17904,Bobbybiz,bleeding-hollow,1595,monk,mistweaver,128,74,54
17905,Lightskinmon,area-52,1595,monk,mistweaver,42,23,19
17906,Tamonger,stormrage,1595,monk,mistweaver,194,106,88
17907,Ccop,kelthuzad,1594,monk,mistweaver,30,21,9
17908,Integrity,durotan,1594,monk,mistweaver,112,58,54
17909,Senseii,dathremar,1592,monk,mistweaver,54,35,19
17910,Onees,tichondrius,1590,monk,mistweaver,99,49,50
17911,Pp,icecrown,1589,monk,mistweaver,31,27,4
17912,Merkey,tichondrius,1588,monk,mistweaver,66,35,31
17913,Brosiedon,sargeras,1588,monk,mistweaver,148,71,77
17914,Coralys,sargeras,1587,monk,mistweaver,42,36,6
17915,Songwei,barthilas,1587,monk,mistweaver,89,50,39
17916,Cisneros,doomhammer,1587,monk,mistweaver,201,110,91
17917,Neonep,stormrage,1586,monk,mistweaver,130,72,58
17918,Kwoon,hyjal,1585,monk,mistweaver,52,30,22
17919,Lickthefist,sargeras,1582,monk,mistweaver,24,17,7
17920,Musachi,barthilas,1582,monk,mistweaver,84,41,43
17921,Yepcocc,lightbringer,1581,monk,mistweaver,29,17,12
17922,Patfu,area-52,1581,monk,mistweaver,29,17,12
17923,Adop,dark-iron,1581,monk,mistweaver,84,46,38
17924,Crypslegacy,tichondrius,1579,monk,mistweaver,138,69,69
17925,Pandacottoca,azralon,1578,monk,mistweaver,36,20,16
17926,Waataafaak,malganis,1578,monk,mistweaver,92,47,45
17927,Pumakicks,tichondrius,1576,monk,mistweaver,70,37,33
17928,Lozza,jubeithos,1574,monk,mistweaver,54,32,22
17929,Chevvyy,azshara,1573,monk,mistweaver,36,18,18
17930,Beboté,quelthalas,1573,monk,mistweaver,205,97,108
17931,Sodamint,sargeras,1572,monk,mistweaver,48,23,25
17932,Mistastep,tichondrius,1572,monk,mistweaver,84,40,44
17933,Buffmonkdmg,tichondrius,1571,monk,mistweaver,90,48,42
17934,Ckqt,stormrage,1569,monk,mistweaver,41,23,18
17935,Boneykicks,tichondrius,1569,monk,mistweaver,42,21,21
17936,Ghðst,ragnaros,1566,monk,mistweaver,36,20,16
17937,Mvqws,tichondrius,1564,monk,mistweaver,32,24,8
17938,Bebess,moon-guard,1564,monk,mistweaver,51,28,23
17939,Eatmykïtty,dalaran,1563,monk,mistweaver,36,23,13
17940,Frogsarecool,stormrage,1563,monk,mistweaver,40,20,20
17941,Hatsu,madoran,1562,monk,mistweaver,155,79,76
17942,Tiduskies,crushridge,1562,monk,mistweaver,54,25,29
17943,Fistuhcuffs,sargeras,1561,monk,mistweaver,87,49,38
17944,Wide,scarlet-crusade,1560,monk,mistweaver,30,17,13
17945,Spaazz,tichondrius,1559,monk,mistweaver,83,53,30
17946,Iovegõd,tichondrius,1559,monk,mistweaver,66,41,25
17947,Bøkky,frostmourne,1558,monk,mistweaver,96,59,37
17948,Buoymoose,bleeding-hollow,1557,monk,mistweaver,53,35,18
17949,Bunnygal,thaurissan,1557,monk,mistweaver,143,73,70
17950,Aramonk,tichondrius,1554,monk,mistweaver,64,37,27
17951,Mistysweep,sargeras,1553,monk,mistweaver,67,34,33
17952,Zerker,nagrand,1552,monk,mistweaver,55,26,29
17953,Nelly,grizzly-hills,1552,monk,mistweaver,36,17,19
17954,Zugroi,frostmourne,1551,monk,mistweaver,30,25,5
17955,Jackphan,azralon,1551,monk,mistweaver,100,58,42
17956,Nailtech,tichondrius,1550,monk,mistweaver,66,37,29
17957,Sabersatin,sargeras,1550,monk,mistweaver,42,21,21
17958,Statue,cenarius,1549,monk,mistweaver,29,17,12
17959,Frenchfries,dragonmaw,1547,monk,mistweaver,72,34,38
17960,Chopschtichs,kiljaeden,1543,monk,mistweaver,41,24,17
17961,Haiyà,malganis,1542,monk,mistweaver,30,17,13
17962,Zettelkasten,tichondrius,1541,monk,mistweaver,36,17,19
17963,Bruceki,bleeding-hollow,1540,monk,mistweaver,47,26,21
17964,Dragonwhirl,stormrage,1540,monk,mistweaver,65,35,30
17965,Omii,darkspear,1540,monk,mistweaver,34,17,17
17966,Miniswag,arthas,1540,monk,mistweaver,42,18,24
17967,Ghim,frostmourne,1540,monk,mistweaver,61,26,35
17968,Notfw,tichondrius,1540,monk,mistweaver,64,27,37
17969,Viralpog,bleeding-hollow,1539,monk,mistweaver,60,32,28
17970,Hiiyaa,tichondrius,1537,monk,mistweaver,110,56,54
17971,Scrapfu,proudmoore,1536,monk,mistweaver,83,44,39
17972,Snoozzy,kelthuzad,1536,monk,mistweaver,36,17,19
17973,Roloyolo,illidan,1536,monk,mistweaver,52,19,33
17974,Grizzm,sargeras,1535,monk,mistweaver,60,34,26
17975,Squaanched,emerald-dream,1535,monk,mistweaver,48,17,31
17976,Forgèt,kelthuzad,1534,monk,mistweaver,30,16,14
17977,Lonebamboo,tichondrius,1534,monk,mistweaver,50,24,26
17978,Keileas,moon-guard,1534,monk,mistweaver,94,43,51
17979,Titanus,chogall,1533,monk,mistweaver,24,19,5
17980,Prisonike,bleeding-hollow,1533,monk,mistweaver,48,25,23
17981,Monkybidness,tichondrius,1533,monk,mistweaver,45,23,22
17982,Fehthermane,area-52,1531,monk,mistweaver,82,51,31
17983,Dryungpwnz,zuljin,1530,monk,mistweaver,72,44,28
17984,Ekèl,tichondrius,1530,monk,mistweaver,101,53,48
17985,Brucechez,tichondrius,1529,monk,mistweaver,24,16,8
17986,Chiban,misha,1529,monk,mistweaver,30,18,12
17987,Dlysezzic,tichondrius,1529,monk,mistweaver,65,33,32
17988,Banterx,sargeras,1528,monk,mistweaver,79,39,40
17989,Carzo,area-52,1527,monk,mistweaver,38,23,15
17990,Kariwanji,tichondrius,1527,monk,mistweaver,251,132,119
17991,Turbofist,bleeding-hollow,1526,monk,mistweaver,35,17,18
17992,Lépøissøn,tichondrius,1525,monk,mistweaver,30,16,14
17993,Atsugin,khazgoroth,1525,monk,mistweaver,36,16,20
17994,Rockemsockem,gorefiend,1524,monk,mistweaver,72,41,31
17995,Sóntix,sargeras,1523,monk,mistweaver,29,17,12
17996,Mistohh,kiljaeden,1522,monk,mistweaver,24,16,8
17997,Metakillër,ragnaros,1522,monk,mistweaver,76,37,39
17998,Marsha,tichondrius,1522,monk,mistweaver,72,31,41
17999,Dedracula,quelthalas,1521,monk,mistweaver,45,33,12
18000,Jitsu,frostmane,1521,monk,mistweaver,105,64,41
18001,Kaelastra,stormrage,1520,monk,mistweaver,102,60,42
18002,Yuï,bleeding-hollow,1519,monk,mistweaver,24,16,8
18003,Muzzye,frostmourne,1519,monk,mistweaver,218,124,94
18004,Kiqz,stormrage,1519,monk,mistweaver,30,16,14
18005,Yurm,moon-guard,1518,monk,mistweaver,54,38,16
18006,Ghorb,boulderfist,1518,monk,mistweaver,81,44,37
18007,Aledal,agamaggan,1517,monk,mistweaver,66,41,25
18008,Mymissteak,darkspear,1516,monk,mistweaver,37,20,17
18009,Ophibrew,zuljin,1516,monk,mistweaver,30,16,14
18010,Romdansik,tichondrius,1515,monk,mistweaver,136,73,63
18011,Zeroskil,thrall,1514,monk,mistweaver,33,19,14
18012,Jlowbob,tichondrius,1514,monk,mistweaver,42,22,20
18013,Soothinn,tichondrius,1513,monk,mistweaver,54,37,17
18014,Bussyweaver,sargeras,1513,monk,mistweaver,123,74,49
18015,Chelada,sargeras,1513,monk,mistweaver,48,22,26
18016,Themonkfunk,bleeding-hollow,1511,monk,mistweaver,36,25,11
18017,Josciel,ragnaros,1511,monk,mistweaver,403,201,202
18018,Äncient,quelthalas,1509,monk,mistweaver,89,56,33
18019,Aioffe,emerald-dream,1509,monk,mistweaver,30,16,14
18020,Oakleet,bleeding-hollow,1507,monk,mistweaver,48,27,21
18021,Aokuâng,malganis,1506,monk,mistweaver,90,55,35
18022,Bastilaqt,korgath,1506,monk,mistweaver,127,70,57
18023,Cranekicks,moon-guard,1505,monk,mistweaver,227,121,106
18024,Greenpigo,tichondrius,1504,monk,mistweaver,18,17,1
18025,Zarma,stormrage,1502,monk,mistweaver,76,44,32
18026,Jerumay,tichondrius,1502,monk,mistweaver,52,29,23
18027,Axellrod,tichondrius,1500,monk,mistweaver,60,38,22
18028,Kungfused,frostmourne,1500,monk,mistweaver,36,18,18
18029,Rakia,moon-guard,1500,monk,mistweaver,172,83,89
18030,Xomonik,borean-tundra,1499,monk,mistweaver,66,39,27
18031,Ferrarí,quelthalas,1499,monk,mistweaver,281,153,128
18032,Lekrosa,thrall,1499,monk,mistweaver,71,38,33
18033,Xenitate,bleeding-hollow,1497,monk,mistweaver,30,17,13
18034,Fissg,frostmourne,1496,monk,mistweaver,30,17,13
18035,Märthä,azralon,1496,monk,mistweaver,143,74,69
18036,Tinypunch,emerald-dream,1496,monk,mistweaver,72,34,38
18037,Igaku,windrunner,1495,monk,mistweaver,30,16,14
18038,Närza,kelthuzad,1492,monk,mistweaver,42,24,18
18039,Vorikson,stormrage,1492,monk,mistweaver,198,96,102
18040,Seung,duskwood,1492,monk,mistweaver,255,121,134
18041,Juchiyosamu,illidan,1491,monk,mistweaver,27,16,11
18042,Lýøp,illidan,1491,monk,mistweaver,30,16,14
18043,Tirêd,sargeras,1488,monk,mistweaver,96,51,45
18044,Fistnanweavn,dawnbringer,1488,monk,mistweaver,132,62,70
18045,Slashsmack,caelestrasz,1487,monk,mistweaver,54,26,28
18046,Conormonk,tichondrius,1486,monk,mistweaver,24,18,6
18047,Jugies,emerald-dream,1486,monk,mistweaver,42,26,16
18048,Warzsong,azralon,1486,monk,mistweaver,54,33,21
18049,Saeloon,frostmourne,1486,monk,mistweaver,77,36,41
18050,Buddhabud,sargeras,1485,monk,mistweaver,54,28,26
18051,Wohrfnok,illidan,1484,monk,mistweaver,30,20,10
18052,Grandpå,tichondrius,1484,monk,mistweaver,42,23,19
18053,Swiftyboi,tichondrius,1483,monk,mistweaver,132,64,68
18054,Gsv,sargeras,1482,monk,mistweaver,138,80,58
18055,Pagtuk,daggerspine,1482,monk,mistweaver,60,28,32
18056,Slothman,nagrand,1481,monk,mistweaver,48,27,21
18057,Âfrika,ysondre,1480,monk,mistweaver,65,31,34
18058,Florla,illidan,1479,monk,mistweaver,28,17,11
18059,Clipping,tichondrius,1478,monk,mistweaver,48,29,19
18060,Talented,azuremyst,1477,monk,mistweaver,63,41,22
18061,Fister,garithos,1476,monk,mistweaver,58,38,20
18062,Monkpowaz,stormrage,1476,monk,mistweaver,42,26,16
18063,Lasagnacàt,moon-guard,1475,monk,mistweaver,30,18,12
18064,Bruceteå,area-52,1473,monk,mistweaver,29,19,10
18065,Mòñk,shattered-halls,1473,monk,mistweaver,42,26,16
18066,Missweaver,sargeras,1473,monk,mistweaver,62,31,31
18067,Wheygodx,lothar,1471,monk,mistweaver,42,28,14
18068,Tuss,tichondrius,1471,monk,mistweaver,46,18,28
18069,Willowa,frostmourne,1470,monk,mistweaver,50,30,20
18070,Xxgonchi,quelthalas,1469,monk,mistweaver,122,72,50
18071,Hadryan,proudmoore,1469,monk,mistweaver,80,43,37
18072,Dareelyst,arygos,1469,monk,mistweaver,36,16,20
18073,Rockcalm,malganis,1468,monk,mistweaver,62,28,34
18074,Brewmanchew,frostmourne,1466,monk,mistweaver,42,26,16
18075,Dovhug,draenor,1465,monk,mistweaver,66,30,36
18076,Gotmonk,aggramar,1464,monk,mistweaver,30,19,11
18077,Iamamonk,kelthuzad,1461,monk,mistweaver,26,20,6
18078,Himah,area-52,1460,monk,mistweaver,36,16,20
18079,Gnomepuncher,dalaran,1459,monk,mistweaver,48,25,23
18080,Iluvthugnmcz,sargeras,1459,monk,mistweaver,112,58,54
18081,Fistea,frostmourne,1459,monk,mistweaver,45,21,24
18082,Fisthealz,area-52,1458,monk,mistweaver,24,19,5
18083,Kazov,proudmoore,1458,monk,mistweaver,178,92,86
18084,Fidgetspinna,zuljin,1457,monk,mistweaver,38,18,20
18085,Guïnness,tichondrius,1455,monk,mistweaver,30,18,12
18086,Pcyesh,nemesis,1455,monk,mistweaver,70,37,33
18087,Americå,zuljin,1453,monk,mistweaver,60,39,21
18088,Bobthedrag,illidan,1453,monk,mistweaver,69,36,33
18089,Fairyeflora,wyrmrest-accord,1452,monk,mistweaver,48,31,17
18090,Baee,cairne,1451,monk,mistweaver,43,17,26
18091,Pomonk,nazjatar,1450,monk,mistweaver,69,45,24
18092,Reque,illidan,1450,monk,mistweaver,206,116,90
18093,Endér,tichondrius,1450,monk,mistweaver,157,82,75
18094,Xtrememisty,frostmourne,1449,monk,mistweaver,66,35,31
18095,Lunarc,mannoroth,1445,monk,mistweaver,81,46,35
18096,Lidela,sargeras,1445,monk,mistweaver,52,27,25
18097,Göat,emerald-dream,1445,monk,mistweaver,45,22,23
18098,Meshugah,quelthalas,1445,monk,mistweaver,90,42,48
18099,Puoll,gallywix,1443,monk,mistweaver,99,55,44
18100,Toastage,tichondrius,1443,monk,mistweaver,30,16,14
18101,Sshri,illidan,1442,monk,mistweaver,131,60,71
18102,Sorowblade,lothar,1441,monk,mistweaver,32,20,12
18103,Sangthos,darkspear,1441,monk,mistweaver,150,66,84
18104,Nerf,malganis,1438,monk,mistweaver,24,15,9
18105,Elcidx,tichondrius,1438,monk,mistweaver,24,15,9
18106,Bigs,duskwood,1438,monk,mistweaver,35,15,20
18107,Pinkgucci,thrall,1438,monk,mistweaver,53,21,32
18108,Kynalla,thunderlord,1435,monk,mistweaver,24,15,9
18109,Outhume,eredar,1435,monk,mistweaver,30,15,15
18110,Themys,zuljin,1434,monk,mistweaver,30,19,11
18111,Hogarg,emerald-dream,1434,monk,mistweaver,24,15,9
18112,Dhomonk,rexxar,1434,monk,mistweaver,29,17,12
18113,Benex,tichondrius,1434,monk,mistweaver,35,19,16
18114,Monktor,dalaran,1433,monk,mistweaver,72,38,34
18115,Fartknocker,magtheridon,1433,monk,mistweaver,30,15,15
18116,Safiel,proudmoore,1433,monk,mistweaver,118,51,67
18117,Softer,frostmane,1432,monk,mistweaver,24,15,9
18118,Mungka,tichondrius,1432,monk,mistweaver,94,47,47
18119,Gotosleepkid,dalaran,1432,monk,mistweaver,50,25,25
18120,Glad,stormscale,1431,monk,mistweaver,294,154,140
18121,Akván,ragnaros,1430,monk,mistweaver,31,18,13
18122,Fuqame,kiljaeden,1428,monk,mistweaver,42,19,23
18123,Ashamah,bleeding-hollow,1427,monk,mistweaver,18,15,3
18124,Chiang,chogall,1426,monk,mistweaver,23,17,6
18125,Abdoolah,illidan,1426,monk,mistweaver,81,41,40
18126,Poundmedaddi,tichondrius,1425,monk,mistweaver,111,69,42
18127,Fistlord,zuljin,1425,monk,mistweaver,32,18,14
18128,Tenshu,runetotem,1425,monk,mistweaver,93,48,45
18129,Pøkemonk,malganis,1424,monk,mistweaver,24,15,9
18130,Tobyblack,illidan,1424,monk,mistweaver,87,45,42
18131,Bergoth,bleeding-hollow,1422,monk,mistweaver,24,15,9
18132,Friskyfister,tichondrius,1422,monk,mistweaver,30,15,15
18133,Leemîn,tichondrius,1421,monk,mistweaver,36,24,12
18134,Brüce,ragnaros,1421,monk,mistweaver,57,33,24
18135,Mustaf,stormrage,1421,monk,mistweaver,114,56,58
18136,Jasonmonk,sargeras,1420,monk,mistweaver,31,19,12
18137,Taijutzu,darkspear,1419,monk,mistweaver,24,15,9
18138,Comonk,area-52,1416,monk,mistweaver,24,15,9
18139,Ralphiex,tichondrius,1411,monk,mistweaver,101,53,48
18140,Ninetrigrams,illidan,1411,monk,mistweaver,32,15,17
18141,Shoumi,turalyon,1410,monk,mistweaver,30,17,13
18142,Healzpapi,tichondrius,1408,monk,mistweaver,148,76,72
18143,Nelda,gorgonnash,1407,monk,mistweaver,66,39,27
18144,Sobuu,wyrmrest-accord,1406,monk,mistweaver,30,24,6
18145,Ojiin,wyrmrest-accord,1405,monk,mistweaver,197,105,92
18146,Bbyyoda,illidan,1404,monk,mistweaver,46,26,20
18147,Ggjudo,sargeras,1404,monk,mistweaver,30,15,15
18148,Thirteendads,turalyon,1403,monk,mistweaver,35,17,18
18149,Saulgóòdman,tichondrius,1402,monk,mistweaver,36,15,21
18150,Xiang,dreadmaul,1401,monk,mistweaver,48,29,19
18151,Güwop,tichondrius,1401,monk,mistweaver,48,25,23
18152,Bbunglee,tichondrius,1400,monk,mistweaver,41,27,14
18153,Phatcheeks,aegwynn,1400,monk,mistweaver,66,37,29
18154,Carlosm,tichondrius,1398,monk,mistweaver,30,19,11
18155,Jèricho,thrall,1397,monk,mistweaver,60,32,28
18156,Janeil,wyrmrest-accord,1397,monk,mistweaver,228,119,109
18157,Zoltwo,sargeras,1395,monk,mistweaver,30,15,15
18158,Edbtz,illidan,1394,monk,mistweaver,24,18,6
18159,Bresmeatfore,barthilas,1394,monk,mistweaver,42,25,17
18160,Kemmy,ravencrest,1393,monk,mistweaver,31,17,14
18161,Mcfisted,area-52,1393,monk,mistweaver,57,25,32
18162,Odindad,tichondrius,1392,monk,mistweaver,42,21,21
18163,Htm,barthilas,1392,monk,mistweaver,41,16,25
18164,Mcfluffey,area-52,1391,monk,mistweaver,89,49,40
18165,Zonianman,tichondrius,1391,monk,mistweaver,95,51,44
18166,Vum,quelthalas,1385,monk,mistweaver,21,16,5
18167,Mightbweavin,bleeding-hollow,1385,monk,mistweaver,108,48,60
18168,Drama,tichondrius,1384,monk,mistweaver,26,18,8
18169,Bârcõdë,tichondrius,1384,monk,mistweaver,36,23,13
18170,Justsidiousm,sargeras,1383,monk,mistweaver,24,16,8
18171,Telospateo,ragnaros,1383,monk,mistweaver,36,19,17
18172,Redweave,moon-guard,1383,monk,mistweaver,36,17,19
18173,Flixz,stormrage,1382,monk,mistweaver,48,25,23
18174,Docwang,malganis,1381,monk,mistweaver,42,27,15
18175,Riokhan,ragnaros,1381,monk,mistweaver,54,31,23
18176,Exuperjun,emerald-dream,1381,monk,mistweaver,34,16,18
18177,Valiantroar,shandris,1381,monk,mistweaver,38,16,22
18178,Noodalie,moon-guard,1378,monk,mistweaver,24,18,6
18179,Manicata,tichondrius,1378,monk,mistweaver,75,41,34
18180,Shandaspanda,rivendare,1378,monk,mistweaver,54,26,28
18181,Monkeynut,whisperwind,1377,monk,mistweaver,89,51,38
18182,Vegoku,moon-guard,1377,monk,mistweaver,84,45,39
18183,Pablojám,ragnaros,1375,monk,mistweaver,42,23,19
18184,Mystafista,tichondrius,1375,monk,mistweaver,29,15,14
18185,Afabled,drakkari,1373,monk,mistweaver,48,26,22
18186,Ozen,burning-blade,1373,monk,mistweaver,74,38,36
18187,Baroon,chogall,1373,monk,mistweaver,93,40,53
18188,Metalmønk,nerzhul,1372,monk,mistweaver,43,29,14
18189,Sinistuhm,tichondrius,1371,monk,mistweaver,47,25,22
18190,Rhynoo,lothar,1371,monk,mistweaver,96,51,45
18191,Kylièjenner,gilneas,1370,monk,mistweaver,70,39,31
18192,Thyfist,frostmourne,1369,monk,mistweaver,28,16,12
18193,Lanifear,area-52,1364,monk,mistweaver,35,20,15
18194,Vonn,drakkari,1364,monk,mistweaver,72,36,36
18195,Tianji,malganis,1363,monk,mistweaver,42,26,16
18196,Tert,aerie-peak,1363,monk,mistweaver,146,83,63
18197,ßrewslèè,tichondrius,1363,monk,mistweaver,86,48,38
18198,Lõgan,azralon,1362,monk,mistweaver,46,24,22
18199,Chuks,nerzhul,1358,monk,mistweaver,164,91,73
18200,Ataxic,illidan,1355,monk,mistweaver,29,15,14
18201,Pandalee,skullcrusher,1353,monk,mistweaver,36,26,10
18202,Ninjagordu,nemesis,1353,monk,mistweaver,118,57,61
18203,Goocn,tichondrius,1351,monk,mistweaver,36,17,19
18204,Ragemore,emerald-dream,1349,monk,mistweaver,25,15,10
18205,Pandemikmonk,turalyon,1349,monk,mistweaver,48,22,26
18206,Cdeez,malganis,1347,monk,mistweaver,36,23,13
18207,Monkqi,lightbringer,1344,monk,mistweaver,30,23,7
18208,Veejaex,stormreaver,1343,monk,mistweaver,18,14,4
18209,Onegai,tichondrius,1343,monk,mistweaver,18,14,4
18210,Itsnoozes,illidan,1343,monk,mistweaver,18,14,4
18211,Rylens,draka,1343,monk,mistweaver,40,25,15
18212,Jiskweaver,sargeras,1343,monk,mistweaver,24,14,10
18213,Siserfister,sargeras,1343,monk,mistweaver,24,14,10
18214,Khylu,kelthuzad,1342,monk,mistweaver,18,14,4
18215,Cnww,tichondrius,1342,monk,mistweaver,24,14,10
18216,Cilantrõ,malorne,1341,monk,mistweaver,30,21,9
18217,Coldridge,bleeding-hollow,1341,monk,mistweaver,24,14,10
18218,Emporertrump,bleeding-hollow,1341,monk,mistweaver,151,71,80
18219,Meâghân,bladefist,1340,monk,mistweaver,18,14,4
18220,Evyllyn,bleeding-hollow,1340,monk,mistweaver,18,14,4
18221,Alternatives,sargeras,1339,monk,mistweaver,18,14,4
18222,Azurro,jubeithos,1339,monk,mistweaver,18,14,4
18223,Catmonk,the-forgotten-coast,1338,monk,mistweaver,24,14,10
18224,Inkar,tichondrius,1338,monk,mistweaver,30,14,16
18225,Dblfistez,stormreaver,1337,monk,mistweaver,46,18,28
18226,Zenmasta,exodar,1336,monk,mistweaver,30,17,13
18227,Ðamntaiyo,sargeras,1336,monk,mistweaver,35,19,16
18228,Ryantiger,tichondrius,1336,monk,mistweaver,30,14,16
18229,Chainwax,korgath,1335,monk,mistweaver,36,20,16
18230,Lazeekick,sargeras,1335,monk,mistweaver,30,14,16
18231,Iielia,wyrmrest-accord,1335,monk,mistweaver,35,16,19
18232,Hoggs,sargeras,1333,monk,mistweaver,55,34,21
18233,Chañi,ragnaros,1333,monk,mistweaver,59,33,26
18234,Chongal,whisperwind,1332,monk,mistweaver,24,14,10
18235,Inebriated,auchindoun,1329,monk,mistweaver,24,14,10
18236,Donnieyen,area-52,1328,monk,mistweaver,30,14,16
18237,Waxxi,barthilas,1327,monk,mistweaver,109,62,47
18238,Tenzing,azgalor,1324,monk,mistweaver,24,14,10
18239,Bradyfour,moon-guard,1324,monk,mistweaver,40,17,23
18240,Momochi,malygos,1323,monk,mistweaver,30,16,14
18241,Nerfmonk,spirestone,1322,monk,mistweaver,24,14,10
18242,Jeffdagnome,moon-guard,1320,monk,mistweaver,96,48,48
18243,Turkspin,smolderthorn,1319,monk,mistweaver,24,19,5
18244,Gerranni,wyrmrest-accord,1318,monk,mistweaver,24,16,8
18245,Bullët,tichondrius,1317,monk,mistweaver,30,18,12
18246,Lotusdream,argent-dawn,1317,monk,mistweaver,72,37,35
18247,Shon,frostmourne,1316,monk,mistweaver,24,14,10
18248,Albusventos,azralon,1315,monk,mistweaver,35,21,14
18249,Brewswayne,argent-dawn,1315,monk,mistweaver,24,14,10
18250,Smackdat,azjolnerub,1315,monk,mistweaver,58,29,29
18251,Johnkreese,andorhal,1313,monk,mistweaver,30,14,16
18252,Tanskee,sargeras,1312,monk,mistweaver,35,20,15
18253,Naxanax,area-52,1312,monk,mistweaver,60,29,31
18254,Breezymist,doomhammer,1311,monk,mistweaver,30,14,16
18255,Nuubchi,stormrage,1310,monk,mistweaver,24,14,10
18256,Ric,gundrak,1310,monk,mistweaver,69,38,31
18257,Dashenna,illidan,1310,monk,mistweaver,84,32,52
18258,Punch,lothar,1309,monk,mistweaver,31,18,13
18259,Odogin,tichondrius,1307,monk,mistweaver,65,41,24
18260,Sweatweaver,frostmourne,1306,monk,mistweaver,94,43,51
18261,Hafu,wildhammer,1305,monk,mistweaver,54,29,25
18262,Dextr,arthas,1302,monk,mistweaver,27,14,13
18263,Hirahxx,frostmourne,1301,monk,mistweaver,27,16,11
18264,Keyszz,tichondrius,1301,monk,mistweaver,182,80,102
18265,Alianli,tichondrius,1301,monk,mistweaver,59,14,45
18266,Kickbone,tichondrius,1300,monk,mistweaver,60,30,30
18267,Chitacos,trollbane,1300,monk,mistweaver,30,14,16
18268,Damemasduro,ragnaros,1299,monk,mistweaver,415,197,218
18269,Szuka,tichondrius,1297,monk,mistweaver,36,20,16
18270,Kocksnapper,stormreaver,1297,monk,mistweaver,76,42,34
18271,Lawroadp,tichondrius,1295,monk,mistweaver,57,33,24
18272,Izolatedrin,tichondrius,1293,monk,mistweaver,17,14,3
18273,Ymiron,smolderthorn,1292,monk,mistweaver,42,15,27
18274,Monkisses,bonechewer,1290,monk,mistweaver,65,36,29
18275,Gomey,bleeding-hollow,1287,monk,mistweaver,26,15,11
18276,Teil,illidan,1287,monk,mistweaver,42,23,19
18277,Gallorex,frostmourne,1286,monk,mistweaver,42,24,18
18278,Baittor,proudmoore,1283,monk,mistweaver,27,15,12
18279,Boozebear,spirestone,1282,monk,mistweaver,136,68,68
18280,Kìmjungheal,tichondrius,1281,monk,mistweaver,41,21,20
18281,Ungankable,sargeras,1281,monk,mistweaver,130,63,67
18282,Chnzhs,tichondrius,1281,monk,mistweaver,58,18,40
18283,Zeiana,proudmoore,1280,monk,mistweaver,38,22,16
18284,Holdmychi,stormrage,1279,monk,mistweaver,55,29,26
18285,Iloki,shuhalo,1279,monk,mistweaver,81,40,41
18286,Miçrosoft,area-52,1278,monk,mistweaver,66,40,26
18287,Valapan,tichondrius,1278,monk,mistweaver,48,25,23
18288,Byakugan,moon-guard,1277,monk,mistweaver,41,23,18
18289,Börg,bleeding-hollow,1277,monk,mistweaver,38,19,19
18290,Giatzo,barthilas,1263,monk,mistweaver,55,25,30
18291,Onekickman,dalaran,1262,monk,mistweaver,66,37,29
18292,Moltenbeard,trollbane,1261,monk,mistweaver,24,17,7
18293,Makimä,stormrage,1260,monk,mistweaver,54,28,26
18294,Zenquadz,elune,1259,monk,mistweaver,36,25,11
18295,Marimonkori,stormscale,1258,monk,mistweaver,63,32,31
18296,Ninjatoots,aerie-peak,1255,monk,mistweaver,79,42,37
18297,Omimonk,sargeras,1251,monk,mistweaver,56,24,32
18298,Donnieyen,aerie-peak,1250,monk,mistweaver,19,14,5
18299,Maiitoguy,illidan,1250,monk,mistweaver,48,24,24
18300,Verelaana,moon-guard,1249,monk,mistweaver,23,14,9
18301,Shefcurry,boulderfist,1248,monk,mistweaver,24,13,11
18302,Mwomegalul,sargeras,1248,monk,mistweaver,30,13,17
18303,Fatnugly,sargeras,1247,monk,mistweaver,18,13,5
18304,Annisokay,bleeding-hollow,1247,monk,mistweaver,18,13,5
18305,Beefyteet,tichondrius,1247,monk,mistweaver,18,13,5
18306,Friendshipx,emerald-dream,1247,monk,mistweaver,18,13,5
18307,Ticmonk,frostmourne,1247,monk,mistweaver,18,13,5
18308,Feel,frostmourne,1247,monk,mistweaver,18,13,5
18309,Gothamonk,tichondrius,1247,monk,mistweaver,24,13,11
18310,Evilstep,tichondrius,1247,monk,mistweaver,60,31,29
18311,Ojarax,bleeding-hollow,1246,monk,mistweaver,18,13,5
18312,Steadfastsr,black-dragonflight,1246,monk,mistweaver,18,13,5
18313,Mirokushan,skywall,1246,monk,mistweaver,117,65,52
18314,Floka,bleeding-hollow,1245,monk,mistweaver,18,13,5
18315,Hîddëncløùdx,tichondrius,1245,monk,mistweaver,18,13,5
18316,Afw,moon-guard,1245,monk,mistweaver,32,18,14
18317,Kênpächi,rexxar,1245,monk,mistweaver,24,13,11
18318,Ieatshrooms,malfurion,1245,monk,mistweaver,60,25,35
18319,Drunkgiraffe,zuljin,1244,monk,mistweaver,18,13,5
18320,Ironfistorm,stormrage,1244,monk,mistweaver,36,24,12
18321,Shilakamesn,tichondrius,1244,monk,mistweaver,24,13,11
18322,Mis,tichondrius,1243,monk,mistweaver,24,13,11
18323,Karynia,illidan,1243,monk,mistweaver,56,26,30
18324,Psypalm,zuljin,1242,monk,mistweaver,18,13,5
18325,React,frostwolf,1242,monk,mistweaver,18,13,5
18326,Raígon,ragnaros,1242,monk,mistweaver,24,13,11
18327,Kreacher,ravencrest,1242,monk,mistweaver,71,37,34
18328,Rehder,barthilas,1241,monk,mistweaver,24,13,11
18329,Poppyharlow,saurfang,1240,monk,mistweaver,24,17,7
18330,Noogiie,barthilas,1238,monk,mistweaver,22,14,8
18331,Originalmonk,tichondrius,1237,monk,mistweaver,18,13,5
18332,Madkickzack,blades-edge,1237,monk,mistweaver,30,13,17
18333,Oyyo,tichondrius,1237,monk,mistweaver,95,35,60
18334,Lolkungfu,spirestone,1234,monk,mistweaver,24,13,11
18335,Kodrik,tichondrius,1234,monk,mistweaver,84,44,40
18336,Midfrie,ghostlands,1233,monk,mistweaver,24,15,9
18337,Knaveus,frostmourne,1233,monk,mistweaver,54,30,24
18338,Bossmonk,tichondrius,1233,monk,mistweaver,24,13,11
18339,Siddlez,frostmourne,1231,monk,mistweaver,34,25,9
18340,Lothnälar,ragnaros,1231,monk,mistweaver,36,26,10
18341,Taichichuan,tichondrius,1231,monk,mistweaver,40,22,18
18342,Azizyzz,barthilas,1231,monk,mistweaver,42,20,22
18343,Shinarri,thrall,1230,monk,mistweaver,132,71,61
18344,Shizunô,stormrage,1229,monk,mistweaver,30,14,16
18345,Hymasterlol,tichondrius,1229,monk,mistweaver,30,13,17
18346,Fkedyourwife,dalaran,1227,monk,mistweaver,30,13,17
18347,Gôrr,tichondrius,1226,monk,mistweaver,42,23,19
18348,Zefta,moon-guard,1226,monk,mistweaver,42,18,24
18349,Petsëmatary,bleeding-hollow,1224,monk,mistweaver,41,16,25
18350,Trüa,stormrage,1222,monk,mistweaver,18,13,5
18351,Cheesemónk,tichondrius,1222,monk,mistweaver,30,13,17
18352,Habuba,eredar,1221,monk,mistweaver,18,13,5
18353,Binghe,illidan,1221,monk,mistweaver,63,35,28
18354,Ninjahogan,azgalor,1221,monk,mistweaver,32,15,17
18355,Cammy,aerie-peak,1219,monk,mistweaver,32,20,12
18356,Troutline,bonechewer,1218,monk,mistweaver,84,50,34
18357,Zarakna,sargeras,1217,monk,mistweaver,133,66,67
18358,Xulieng,tichondrius,1215,monk,mistweaver,331,169,162
18359,Monxellius,moon-guard,1215,monk,mistweaver,93,45,48
18360,Purging,draka,1214,monk,mistweaver,71,49,22
18361,Sedition,emerald-dream,1213,monk,mistweaver,317,159,158
18362,Mortimir,echo-isles,1213,monk,mistweaver,30,14,16
18363,Phoenixspark,gnomeregan,1211,monk,mistweaver,18,13,5
18364,Genjen,bleeding-hollow,1210,monk,mistweaver,22,13,9
18365,Monktyson,barthilas,1206,monk,mistweaver,42,27,15
18366,Karatechawp,bleeding-hollow,1206,monk,mistweaver,22,14,8
18367,Biggoosie,korgath,1206,monk,mistweaver,76,47,29
18368,Chunkynorris,stormscale,1206,monk,mistweaver,38,18,20
18369,Michaeljordn,destromath,1199,monk,mistweaver,44,16,28
18370,Pepperoncini,korgath,1199,monk,mistweaver,54,17,37
18371,Menadraene,wyrmrest-accord,1198,monk,mistweaver,26,14,12
18372,Puffpuffp,nazgrel,1196,monk,mistweaver,24,13,11
18373,Zsalcior,jaedenar,1195,monk,mistweaver,36,24,12
18374,Darkheälzz,sargeras,1194,monk,mistweaver,93,44,49
18375,Drexlla,barthilas,1191,monk,mistweaver,38,23,15
18376,Poppinbrews,thrall,1191,monk,mistweaver,28,15,13
18377,Vardeh,stormscale,1191,monk,mistweaver,30,14,16
18378,Titofresh,quelthalas,1191,monk,mistweaver,33,15,18
18379,Raphzen,stormrage,1189,monk,mistweaver,33,17,16
18380,Soapy,moon-guard,1188,monk,mistweaver,35,16,19
18381,Soderbergh,ysera,1185,monk,mistweaver,36,13,23
18382,Orenj,boulderfist,1182,monk,mistweaver,30,16,14
18383,Ratioed,moon-guard,1181,monk,mistweaver,47,32,15
18384,Miretunie,arathor,1181,monk,mistweaver,54,32,22
18385,Galiplays,zangarmarsh,1180,monk,mistweaver,29,16,13
18386,Ludafist,whisperwind,1179,monk,mistweaver,66,33,33
18387,Blackthorne,illidan,1179,monk,mistweaver,30,14,16
18388,Anthuri,frostmourne,1178,monk,mistweaver,41,28,13
18389,Soothem,tichondrius,1178,monk,mistweaver,24,16,8
18390,Kreezoo,tichondrius,1178,monk,mistweaver,51,24,27
18391,Haruko,baelgun,1178,monk,mistweaver,40,13,27
18392,Kromkwando,burning-blade,1177,monk,mistweaver,42,13,29
18393,Iseeyouqt,tichondrius,1176,monk,mistweaver,20,13,7
18394,Puya,nemesis,1174,monk,mistweaver,30,14,16
18395,Raidenmnx,tichondrius,1174,monk,mistweaver,30,13,17
18396,Mongénoio,nemesis,1172,monk,mistweaver,26,13,13
18397,Hamandchi,sargeras,1169,monk,mistweaver,23,16,7
18398,Evílryü,quelthalas,1168,monk,mistweaver,27,16,11
18399,Darrhon,illidan,1166,monk,mistweaver,113,54,59
18400,Hie,laughing-skull,1166,monk,mistweaver,90,38,52
18401,Shwankeesha,thrall,1165,monk,mistweaver,28,14,14
18402,Monkoala,illidan,1160,monk,mistweaver,30,17,13
18403,Madmint,illidan,1159,monk,mistweaver,60,26,34
18404,Valdosta,bloodscalp,1158,monk,mistweaver,48,25,23
18405,Callibella,amanthul,1155,monk,mistweaver,26,13,13
18406,Xaurian,firetree,1153,monk,mistweaver,22,13,9
18407,Austinm,tichondrius,1152,monk,mistweaver,18,12,6
18408,Magmuruk,garrosh,1152,monk,mistweaver,18,12,6
18409,Miley,lethon,1151,monk,mistweaver,18,12,6
18410,Kungpaofish,tichondrius,1151,monk,mistweaver,24,12,12
18411,Enfoque,quelthalas,1150,monk,mistweaver,47,26,21
18412,Dreamscapexo,kelthuzad,1150,monk,mistweaver,24,12,12
18413,Musedz,barthilas,1149,monk,mistweaver,30,12,18
18414,Lartridia,malganis,1148,monk,mistweaver,18,12,6
18415,Onlythumbs,area-52,1148,monk,mistweaver,18,12,6
18416,Santhz,ragnaros,1148,monk,mistweaver,18,12,6
18417,Trojanz,malganis,1148,monk,mistweaver,24,12,12
18418,Strixx,silvermoon,1147,monk,mistweaver,18,14,4
18419,Zallie,frostmourne,1147,monk,mistweaver,18,12,6
18420,Nazvik,quelthalas,1146,monk,mistweaver,18,12,6
18421,Oochi,illidan,1146,monk,mistweaver,24,12,12
18422,Kaniou,proudmoore,1146,monk,mistweaver,29,13,16
18423,Azenia,barthilas,1146,monk,mistweaver,30,12,18
18424,Jagichan,area-52,1145,monk,mistweaver,18,12,6
18425,Monkaveli,ursin,1145,monk,mistweaver,78,37,41
18426,Taipanni,sargeras,1143,monk,mistweaver,30,12,18
18427,Lørðjimmy,sargeras,1142,monk,mistweaver,18,12,6
18428,Antimoine,saurfang,1142,monk,mistweaver,36,22,14
18429,Bibibi,moon-guard,1140,monk,mistweaver,24,12,12
18430,Calmemaybe,darkspear,1138,monk,mistweaver,18,12,6
18431,Drfoochi,tichondrius,1138,monk,mistweaver,30,12,18
18432,Lumïnous,moon-guard,1136,monk,mistweaver,30,14,16
18433,Selfhealings,korgath,1135,monk,mistweaver,24,12,12
18434,Kexti,wyrmrest-accord,1135,monk,mistweaver,45,18,27
18435,Affrika,ragnaros,1133,monk,mistweaver,47,21,26
18436,Trapeez,kelthuzad,1132,monk,mistweaver,18,12,6
18437,Herbivorous,sargeras,1131,monk,mistweaver,24,12,12
18438,Modelman,area-52,1130,monk,mistweaver,26,14,12
18439,Gobfu,emerald-dream,1130,monk,mistweaver,65,26,39
18440,Fitmonje,drakkari,1126,monk,mistweaver,43,22,21
18441,Boostmonk,terenas,1126,monk,mistweaver,78,34,44
18442,Fistmeister,tichondrius,1125,monk,mistweaver,30,19,11
18443,Ursorcen,frostmourne,1122,monk,mistweaver,33,16,17
18444,Honjada,tichondrius,1121,monk,mistweaver,18,12,6
18445,Fluffykitty,deathwing,1119,monk,mistweaver,45,19,26
18446,Whiteknight,tichondrius,1118,monk,mistweaver,14,13,1
18447,Hastle,windrunner,1116,monk,mistweaver,66,37,29
18448,Tinze,bonechewer,1115,monk,mistweaver,35,14,21
18449,Orbí,tichondrius,1111,monk,mistweaver,48,32,16
18450,Halfaling,tichondrius,1109,monk,mistweaver,18,12,6
18451,Smokee,blackhand,1107,monk,mistweaver,24,12,12
18452,Lolcutie,shandris,1105,monk,mistweaver,37,21,16
18453,Dokfu,tichondrius,1105,monk,mistweaver,159,86,73
18454,Emenboats,zuljin,1096,monk,mistweaver,70,44,26
18455,Kimonk,proudmoore,1095,monk,mistweaver,36,21,15
18456,Gentle,cenarius,1093,monk,mistweaver,26,12,14
18457,Shoguns,zuljin,1091,monk,mistweaver,48,24,24
18458,Brewamp,zuljin,1091,monk,mistweaver,29,13,16
18459,Fonnf,nemesis,1086,monk,mistweaver,20,12,8
18460,Focalors,proudmoore,1085,monk,mistweaver,20,12,8
18461,Rowbur,thrall,1077,monk,mistweaver,33,22,11
18462,Harryrichard,sargeras,1073,monk,mistweaver,23,12,11
18463,Lita,barthilas,1071,monk,mistweaver,17,12,5
18464,Keeanuweaves,tichondrius,1069,monk,mistweaver,13,12,1
18465,Shaolyyn,zuljin,1068,monk,mistweaver,54,29,25
18466,Muzzen,fizzcrank,1068,monk,mistweaver,28,13,15
18467,Hakushin,ragnaros,1067,monk,mistweaver,36,20,16
18468,Razod,stormrage,1066,monk,mistweaver,154,74,80
18469,Kfpanda,hellscream,1065,monk,mistweaver,72,35,37
18470,Duelist,the-scryers,1056,monk,mistweaver,12,11,1
18471,Lustymonk,kelthuzad,1056,monk,mistweaver,12,11,1
18472,Jmanownz,stormrage,1056,monk,mistweaver,12,11,1
18473,Haren,gundrak,1056,monk,mistweaver,18,11,7
18474,Mistussy,sargeras,1056,monk,mistweaver,18,11,7
18475,Solidww,moon-guard,1055,monk,mistweaver,12,11,1
18476,Gooseoba,tichondrius,1055,monk,mistweaver,12,11,1
18477,Axibar,tichondrius,1055,monk,mistweaver,18,11,7
18478,Iplus,thrall,1055,monk,mistweaver,18,11,7
18479,Fkinbis,area-52,1055,monk,mistweaver,18,11,7
18480,Stephenia,tichondrius,1055,monk,mistweaver,18,11,7
18481,Undertickle,illidan,1055,monk,mistweaver,18,11,7
18482,Alandis,spinebreaker,1055,monk,mistweaver,18,11,7
18483,Bubear,stormreaver,1055,monk,mistweaver,18,11,7
18484,Lemmetouch,illidan,1055,monk,mistweaver,24,11,13
18485,Chillionaíre,proudmoore,1055,monk,mistweaver,24,11,13
18486,Taelinn,moonrunner,1055,monk,mistweaver,30,11,19
18487,Evilbit,boulderfist,1054,monk,mistweaver,18,11,7
18488,Cungflu,crushridge,1054,monk,mistweaver,24,11,13
18489,Dreadknotz,hyjal,1054,monk,mistweaver,42,17,25
18490,Tisafister,kelthuzad,1053,monk,mistweaver,18,11,7
18491,Zoochans,tichondrius,1053,monk,mistweaver,67,40,27
18492,Hache,azjolnerub,1053,monk,mistweaver,80,34,46
18493,Theymistbuda,kelthuzad,1052,monk,mistweaver,12,11,1
18494,Djslimweaver,stormrage,1052,monk,mistweaver,14,11,3
18495,Havasupai,turalyon,1052,monk,mistweaver,18,11,7
18496,Wungpo,the-forgotten-coast,1052,monk,mistweaver,18,11,7
18497,Karnbroo,frostmourne,1052,monk,mistweaver,24,11,13
18498,Rileyreidfan,azjolnerub,1051,monk,mistweaver,18,11,7
18499,Pappaya,tichondrius,1051,monk,mistweaver,18,11,7
18500,Superbae,area-52,1051,monk,mistweaver,24,11,13
18501,Fistful,destromath,1050,monk,mistweaver,12,11,1
18502,Hazelbazel,bleeding-hollow,1050,monk,mistweaver,18,11,7
18503,Eldrik,stormrage,1050,monk,mistweaver,18,11,7
18504,Dégg,thrall,1050,monk,mistweaver,18,11,7
18505,Caellum,quelthalas,1048,monk,mistweaver,18,11,7
18506,Cooltran,tichondrius,1048,monk,mistweaver,18,11,7
18507,Ilani,malganis,1047,monk,mistweaver,18,11,7
18508,Proctology,tichondrius,1047,monk,mistweaver,18,11,7
18509,Gngrbeardman,tichondrius,1047,monk,mistweaver,27,12,15
18510,Wraithfire,uldum,1047,monk,mistweaver,30,12,18
18511,Shaolinmists,malganis,1045,monk,mistweaver,12,11,1
18512,Pimpolhona,nemesis,1045,monk,mistweaver,30,11,19
18513,Steenkk,tichondrius,1042,monk,mistweaver,54,25,29
18514,Gguldduk,tichondrius,1038,monk,mistweaver,16,12,4
18515,Thors,gorgonnash,1038,monk,mistweaver,24,13,11
18516,Teancrumpets,wyrmrest-accord,1038,monk,mistweaver,48,20,28
18517,Leësin,ragnaros,1037,monk,mistweaver,18,11,7
18518,Tadaku,dalaran,1033,monk,mistweaver,37,17,20
18519,Reinah,malganis,1033,monk,mistweaver,30,11,19
18520,Merand,tichondrius,1031,monk,mistweaver,36,20,16
18521,Baiji,gorefiend,1030,monk,mistweaver,12,11,1
18522,Mahhnaga,tichondrius,1030,monk,mistweaver,89,36,53
18523,Marnartou,zuljin,1026,monk,mistweaver,12,11,1
18524,Hapgido,deathwing,1025,monk,mistweaver,56,26,30
18525,Ambuinc,burning-blade,1024,monk,mistweaver,18,11,7
18526,Dalillamas,sargeras,1023,monk,mistweaver,14,12,2
18527,Schein,sargeras,1023,monk,mistweaver,17,11,6
18528,Grizzchan,sargeras,1017,monk,mistweaver,17,11,6
18529,Ainz,nagrand,1016,monk,mistweaver,30,15,15
18530,Vitcheztein,ragnaros,1007,monk,mistweaver,17,11,6
18531,Twizzurp,magtheridon,1007,monk,mistweaver,21,12,9
18532,Bigjuicers,bleeding-hollow,1006,monk,mistweaver,17,11,6
18533,Deadlyzz,gilneas,1006,monk,mistweaver,87,47,40
18534,Vencö,tichondrius,1001,monk,mistweaver,33,11,22
18535,Clutchinmist,malganis,1000,monk,mistweaver,40,12,28
18536,Wmo,tichondrius,997,monk,mistweaver,17,11,6
18537,Joeyfists,frostwolf,997,monk,mistweaver,24,11,13
18538,Sonicenergy,tichondrius,997,monk,mistweaver,27,12,15
18539,Zendemic,thrall,996,monk,mistweaver,30,17,13
18540,Telrande,ysondre,994,monk,mistweaver,35,24,11
18541,Sukrit,darkspear,993,monk,mistweaver,40,19,21
18542,Hinudhera,barthilas,993,monk,mistweaver,69,32,37
18543,Chopy,dragonblight,991,monk,mistweaver,48,21,27
18544,Mintbear,illidan,984,monk,mistweaver,14,11,3
18545,Monkgringo,azralon,983,monk,mistweaver,48,27,21
18546,Kpeste,tichondrius,981,monk,mistweaver,60,30,30
18547,Bomer,moknathal,980,monk,mistweaver,49,29,20
18548,Winniethepoo,borean-tundra,975,monk,mistweaver,19,11,8
18549,Ogsimpsonn,tichondrius,972,monk,mistweaver,20,11,9
18550,Whitepotato,bleeding-hollow,969,monk,mistweaver,126,65,61
18551,Sipu,wyrmrest-accord,969,monk,mistweaver,41,20,21
18552,Klanianhere,sargeras,960,monk,mistweaver,12,10,2
18553,Drizzywow,arathor,960,monk,mistweaver,12,10,2
18554,Woes,stormreaver,960,monk,mistweaver,12,10,2
18555,Hype,ursin,960,monk,mistweaver,12,10,2
18556,Mywave,bleeding-hollow,960,monk,mistweaver,18,10,8
18557,Agilities,sargeras,960,monk,mistweaver,18,10,8
18558,Mauvem,tichondrius,960,monk,mistweaver,18,10,8
18559,Chignar,dathremar,960,monk,mistweaver,18,10,8
18560,Milkshayx,kiljaeden,960,monk,mistweaver,18,10,8
18561,Greenfriend,illidan,960,monk,mistweaver,18,10,8
18562,Titti,korgath,960,monk,mistweaver,18,10,8
18563,Fheng,emerald-dream,960,monk,mistweaver,18,10,8
18564,Mlngo,illidan,960,monk,mistweaver,18,10,8
18565,Dapperdabz,illidan,960,monk,mistweaver,18,10,8
18566,Barlyfe,tichondrius,960,monk,mistweaver,24,10,14
18567,Shâdòw,ragnaros,959,monk,mistweaver,12,10,2
18568,Mïstyfïsty,moon-guard,959,monk,mistweaver,12,10,2
18569,Hanlover,tichondrius,959,monk,mistweaver,12,10,2
18570,Sharpstorm,darkspear,959,monk,mistweaver,12,10,2
18571,Melpaine,frostmourne,959,monk,mistweaver,18,10,8
18572,Insidedog,frostmourne,959,monk,mistweaver,18,10,8
18573,Cymonka,sargeras,959,monk,mistweaver,18,10,8
18574,Battlecruise,tichondrius,959,monk,mistweaver,18,10,8
18575,Chanîng,frostmourne,959,monk,mistweaver,18,10,8
18576,Anabolicx,khazgoroth,959,monk,mistweaver,24,10,14
18577,Trazmold,emerald-dream,958,monk,mistweaver,18,10,8
18578,Lostinmistz,tichondrius,958,monk,mistweaver,18,10,8
18579,Monkgov,illidan,958,monk,mistweaver,18,10,8
18580,Inkers,detheroc,957,monk,mistweaver,18,10,8
18581,Oldfashheals,tichondrius,957,monk,mistweaver,24,10,14
18582,Mizzycash,malganis,957,monk,mistweaver,26,10,16
18583,Hashìba,kiljaeden,956,monk,mistweaver,12,10,2
18584,Kungfumika,ragnaros,955,monk,mistweaver,24,10,14
18585,Diligentmonk,illidan,955,monk,mistweaver,27,11,16
18586,Chìforce,sargeras,955,monk,mistweaver,35,10,25
18587,Wessex,sargeras,954,monk,mistweaver,18,10,8
18588,Bojflow,dalaran,954,monk,mistweaver,18,10,8
18589,Kailzchi,area-52,951,monk,mistweaver,18,10,8
18590,Asliam,undermine,951,monk,mistweaver,18,10,8
18591,Brewtalitops,illidan,950,monk,mistweaver,18,10,8
18592,Shinobui,jubeithos,950,monk,mistweaver,18,10,8
18593,Dirtyshef,deathwing,949,monk,mistweaver,45,11,34
18594,Gazzoxsan,chogall,946,monk,mistweaver,25,10,15
18595,Jæmz,moon-guard,944,monk,mistweaver,36,13,23
18596,Chugs,malorne,938,monk,mistweaver,36,10,26
18597,Polofasho,illidan,934,monk,mistweaver,17,10,7
18598,Boojaa,silvermoon,931,monk,mistweaver,54,20,34
18599,Ultramaga,dentarg,927,monk,mistweaver,28,10,18
18600,Siamack,illidan,920,monk,mistweaver,14,11,3
18601,Karkata,sargeras,914,monk,mistweaver,48,20,28
18602,Kangeroo,tichondrius,912,monk,mistweaver,21,11,10
18603,Sensey,veknilash,910,monk,mistweaver,17,10,7
18604,Xbrewtal,tichondrius,909,monk,mistweaver,30,17,13
18605,Lovechabill,darkspear,906,monk,mistweaver,17,10,7
18606,Ægo,sargeras,906,monk,mistweaver,22,11,11
18607,Chavbrew,stormrage,894,monk,mistweaver,17,10,7
18608,Delassian,moon-guard,894,monk,mistweaver,37,16,21
18609,Inbu,tichondrius,893,monk,mistweaver,26,10,16
18610,Stickbundle,illidan,888,monk,mistweaver,15,11,4
18611,Edj,drenden,884,monk,mistweaver,75,37,38
18612,Monkgyfatso,tichondrius,878,monk,mistweaver,11,10,1
18613,Galyndra,darkspear,877,monk,mistweaver,13,10,3
18614,Imnumberone,alterac-mountains,864,monk,mistweaver,12,9,3
18615,Jonnymon,sargeras,864,monk,mistweaver,12,9,3
18616,Ggonext,wyrmrest-accord,864,monk,mistweaver,12,9,3
18617,Franqx,tichondrius,864,monk,mistweaver,12,9,3
18618,Sâx,stormreaver,864,monk,mistweaver,12,9,3
18619,Pisswalker,area-52,864,monk,mistweaver,12,9,3
18620,Horndog,skullcrusher,864,monk,mistweaver,12,9,3
18621,Flicksx,arthas,864,monk,mistweaver,12,9,3
18622,Mistyfisty,laughing-skull,864,monk,mistweaver,14,9,5
18623,Wizlee,tichondrius,864,monk,mistweaver,18,9,9
18624,Kármah,emerald-dream,864,monk,mistweaver,18,9,9
18625,Gottí,sargeras,864,monk,mistweaver,18,9,9
18626,Pinkfairy,wyrmrest-accord,864,monk,mistweaver,18,9,9
18627,Kriticalkush,kelthuzad,864,monk,mistweaver,18,9,9
18628,Paraíba,azralon,864,monk,mistweaver,24,9,15
18629,Hulkhogan,mugthol,863,monk,mistweaver,14,11,3
18630,Theminivan,sargeras,863,monk,mistweaver,12,9,3
18631,Maicuta,thrall,863,monk,mistweaver,12,9,3
18632,Tubby,eredar,863,monk,mistweaver,12,9,3
18633,Brewley,thrall,863,monk,mistweaver,12,9,3
18634,Kazzichi,area-52,863,monk,mistweaver,12,9,3
18635,Brewtillis,tichondrius,863,monk,mistweaver,12,9,3
18636,Ztalian,moon-guard,863,monk,mistweaver,12,9,3
18637,Fistfreak,stormrage,863,monk,mistweaver,12,9,3
18638,Tjab,kiljaeden,863,monk,mistweaver,18,9,9
18639,Julipz,tichondrius,863,monk,mistweaver,18,9,9
18640,Madmoose,smolderthorn,863,monk,mistweaver,24,10,14
18641,Icytoned,kelthuzad,863,monk,mistweaver,24,9,15
18642,Ørçhid,ravenholdt,862,monk,mistweaver,12,9,3
18643,Masamunes,thrall,862,monk,mistweaver,12,9,3
18644,Zac,veknilash,862,monk,mistweaver,12,9,3
18645,Madussy,zuljin,862,monk,mistweaver,24,9,15
18646,Kromrax,stormrage,862,monk,mistweaver,24,9,15
18647,Kungupanda,nesingwary,862,monk,mistweaver,24,9,15
18648,Jhaded,tichondrius,862,monk,mistweaver,24,9,15
18649,Kaølin,azralon,861,monk,mistweaver,12,9,3
18650,Kirshta,kelthuzad,861,monk,mistweaver,12,9,3
18651,Rosellina,kelthuzad,861,monk,mistweaver,18,9,9
18652,Snuzzao,darkspear,861,monk,mistweaver,20,9,11
18653,Palomagozzu,ragnaros,860,monk,mistweaver,12,9,3
18654,Mintÿ,wyrmrest-accord,860,monk,mistweaver,18,9,9
18655,Håzê,kul-tiras,860,monk,mistweaver,18,9,9
18656,Moonkers,tichondrius,860,monk,mistweaver,18,9,9
18657,Yudrin,zuljin,859,monk,mistweaver,24,9,15
18658,Fludz,burning-blade,859,monk,mistweaver,24,9,15
18659,Monkism,warsong,855,monk,mistweaver,12,9,3
18660,Winwakamank,sargeras,855,monk,mistweaver,24,9,15
18661,Eago,sargeras,852,monk,mistweaver,24,9,15
18662,Bullshido,aerie-peak,851,monk,mistweaver,18,9,9
18663,Epptwo,aggramar,851,monk,mistweaver,30,9,21
18664,Ragepalm,aegwynn,848,monk,mistweaver,18,9,9
18665,Lilbee,azjolnerub,845,monk,mistweaver,18,9,9
18666,Sìrtankallot,stormrage,837,monk,mistweaver,32,9,23
18667,Kimchimaj,tichondrius,832,monk,mistweaver,18,9,9
18668,Twinktoez,bleeding-hollow,831,monk,mistweaver,14,10,4
18669,Tcoon,frostmourne,830,monk,mistweaver,20,10,10
18670,Sihgriid,tichondrius,826,monk,mistweaver,20,10,10
18671,Seaja,malganis,823,monk,mistweaver,99,26,73
18672,Kyndrïa,tichondrius,819,monk,mistweaver,65,26,39
18673,Goodluck,madoran,809,monk,mistweaver,27,10,17
18674,Tokkyo,frostmourne,804,monk,mistweaver,66,15,51
18675,Picoree,frostmourne,799,monk,mistweaver,15,10,5
18676,Gino,proudmoore,799,monk,mistweaver,154,69,85
18677,Jeolmyung,tichondrius,798,monk,mistweaver,14,9,5
18678,Mastahp,tichondrius,797,monk,mistweaver,22,9,13
18679,Akfourseven,barthilas,795,monk,mistweaver,71,32,39
18680,Qlispe,bloodscalp,784,monk,mistweaver,76,35,41
18681,Dreamy,mugthol,773,monk,mistweaver,42,12,30
18682,Scrypter,proudmoore,768,monk,mistweaver,12,8,4
18683,Garg,malganis,768,monk,mistweaver,12,8,4
18684,Tubescreamer,barthilas,768,monk,mistweaver,12,8,4
18685,Anandamayi,emerald-dream,768,monk,mistweaver,12,8,4
18686,Tuladura,tichondrius,768,monk,mistweaver,12,8,4
18687,Zxenn,tichondrius,768,monk,mistweaver,12,8,4
18688,Torakigai,ghostlands,768,monk,mistweaver,12,8,4
18689,Bralex,black-dragonflight,768,monk,mistweaver,12,8,4
18690,Ninjachavez,tichondrius,768,monk,mistweaver,12,8,4
18691,Kaystorm,stormrage,768,monk,mistweaver,12,8,4
18692,Monkzilla,tichondrius,768,monk,mistweaver,12,8,4
18693,Pantypirate,tichondrius,768,monk,mistweaver,12,8,4
18694,Picklefartjr,malfurion,768,monk,mistweaver,12,8,4
18695,Sainlaurent,tichondrius,768,monk,mistweaver,12,8,4
18696,Udmonk,tichondrius,768,monk,mistweaver,12,8,4
18697,Cuckoon,malganis,768,monk,mistweaver,12,8,4
18698,Sàìñtàsønìà,kelthuzad,768,monk,mistweaver,12,8,4
18699,Shquiz,sargeras,768,monk,mistweaver,12,8,4
18700,Funkmunk,aegwynn,768,monk,mistweaver,12,8,4
18701,Omnly,stormrage,768,monk,mistweaver,12,8,4
18702,Kaskã,tichondrius,768,monk,mistweaver,12,8,4
18703,Mmrmonkey,tichondrius,768,monk,mistweaver,18,8,10
18704,Kwatann,bonechewer,768,monk,mistweaver,18,8,10
18705,Backflip,nemesis,768,monk,mistweaver,18,8,10
18706,Imafqnbaby,tichondrius,768,monk,mistweaver,18,8,10
18707,Pumpsx,area-52,768,monk,mistweaver,18,8,10
18708,Erwynz,tichondrius,768,monk,mistweaver,24,8,16
18709,Blitzcombo,thrall,767,monk,mistweaver,12,8,4
18710,Lenee,frostmourne,767,monk,mistweaver,12,8,4
18711,Abird,tichondrius,767,monk,mistweaver,12,8,4
18712,Zenspice,stormrage,767,monk,mistweaver,12,8,4
18713,Mightbewôrth,thunderhorn,767,monk,mistweaver,12,8,4
18714,Chicheez,sargeras,767,monk,mistweaver,12,8,4
18715,Rolybones,boulderfist,767,monk,mistweaver,12,8,4
18716,Voltekkor,tichondrius,767,monk,mistweaver,14,8,6
18717,Barleygar,tichondrius,767,monk,mistweaver,18,8,10
18718,Dabnhash,emerald-dream,767,monk,mistweaver,18,8,10
18719,Bogez,area-52,767,monk,mistweaver,18,8,10
18720,Elfass,bleeding-hollow,767,monk,mistweaver,18,8,10
18721,Selfiestíck,tichondrius,766,monk,mistweaver,12,8,4
18722,Artomist,stormrage,766,monk,mistweaver,12,8,4
18723,Apexian,kelthuzad,766,monk,mistweaver,12,8,4
18724,Barnåcle,darkspear,766,monk,mistweaver,12,8,4
18725,Karaka,ysera,766,monk,mistweaver,12,8,4
18726,Feynzen,frostmourne,766,monk,mistweaver,12,8,4
18727,Wzzi,tichondrius,765,monk,mistweaver,18,8,10
18728,Slinger,kalecgos,764,monk,mistweaver,16,9,7
18729,Scips,fizzcrank,764,monk,mistweaver,18,8,10
18730,Kushmintz,whisperwind,762,monk,mistweaver,18,8,10
18731,Fufu,terokkar,761,monk,mistweaver,18,8,10
18732,Fusionspell,stormrage,747,monk,mistweaver,24,8,16
18733,Prddoss,quelthalas,745,monk,mistweaver,12,8,4
18734,Sätsu,bleeding-hollow,735,monk,mistweaver,17,8,9
18735,Áasuna,ragnaros,734,monk,mistweaver,20,9,11
18736,Thaliondor,stormrage,720,monk,mistweaver,15,9,6
18737,Kryflex,frostmourne,720,monk,mistweaver,15,9,6
18738,Bombshellxo,illidan,719,monk,mistweaver,11,8,3
18739,Cloq,kelthuzad,719,monk,mistweaver,17,8,9
18740,Rektfu,emerald-dream,708,monk,mistweaver,21,9,12
18741,Diagrams,tichondrius,703,monk,mistweaver,11,8,3
18742,Djwushu,blackhand,698,monk,mistweaver,20,8,12
18743,Crãsh,quelthalas,697,monk,mistweaver,16,8,8
18744,Hirav,khazgoroth,697,monk,mistweaver,21,9,12
18745,Shortbuss,aegwynn,696,monk,mistweaver,14,8,6
18746,Minttea,kiljaeden,690,monk,mistweaver,28,9,19
18747,Ammonk,bloodhoof,672,monk,mistweaver,12,7,5
18748,Aniwhy,tichondrius,672,monk,mistweaver,12,7,5
18749,Kelstrike,sargeras,672,monk,mistweaver,12,7,5
18750,Kegwalker,earthen-ring,672,monk,mistweaver,12,7,5
18751,Tuesdây,wyrmrest-accord,672,monk,mistweaver,12,7,5
18752,Brimhildaa,tichondrius,672,monk,mistweaver,12,7,5
18753,Pandatrainer,drakkari,672,monk,mistweaver,12,7,5
18754,Laggytoodope,kelthuzad,672,monk,mistweaver,12,7,5
18755,Valelarus,doomhammer,672,monk,mistweaver,12,7,5
18756,Zbell,sargeras,672,monk,mistweaver,12,7,5
18757,Kyrap,stormscale,672,monk,mistweaver,12,7,5
18758,Mundane,sargeras,672,monk,mistweaver,12,7,5
18759,Yangzai,tichondrius,672,monk,mistweaver,12,7,5
18760,Missclickx,azralon,672,monk,mistweaver,12,7,5
18761,Synpunch,tichondrius,672,monk,mistweaver,12,7,5
18762,Notrof,korgath,672,monk,mistweaver,12,7,5
18763,Saiyañ,proudmoore,672,monk,mistweaver,12,7,5
18764,Galeindra,whisperwind,672,monk,mistweaver,12,7,5
18765,Boorams,tichondrius,672,monk,mistweaver,12,7,5
18766,Mwr,frostmourne,672,monk,mistweaver,12,7,5
18767,Rookere,malganis,672,monk,mistweaver,12,7,5
18768,Copamine,dalaran,672,monk,mistweaver,12,7,5
18769,Lynio,area-52,672,monk,mistweaver,12,7,5
18770,Darong,tichondrius,672,monk,mistweaver,12,7,5
18771,Truefists,stormrage,672,monk,mistweaver,12,7,5
18772,Toothpick,blackrock,672,monk,mistweaver,12,7,5
18773,Moönk,tichondrius,672,monk,mistweaver,12,7,5
18774,Jaxvisto,dalaran,672,monk,mistweaver,12,7,5
18775,Ashmisty,kelthuzad,672,monk,mistweaver,12,7,5
18776,Fistay,burning-legion,672,monk,mistweaver,15,8,7
18777,Beejae,tichondrius,672,monk,mistweaver,14,7,7
18778,Èxpèrtisè,jubeithos,672,monk,mistweaver,14,7,7
18779,Sjw,icecrown,672,monk,mistweaver,14,7,7
18780,Zkingmonk,stormrage,672,monk,mistweaver,18,7,11
18781,Thevy,area-52,672,monk,mistweaver,18,7,11
18782,Monktu,frostmourne,672,monk,mistweaver,18,7,11
18783,Audrun,frostmourne,672,monk,mistweaver,18,7,11
18784,Caliroll,gorefiend,672,monk,mistweaver,18,7,11
18785,Hoofweaver,proudmoore,672,monk,mistweaver,24,7,17
18786,Iwonson,mugthol,671,monk,mistweaver,12,7,5
18787,Touzin,bleeding-hollow,671,monk,mistweaver,12,7,5
18788,Delightni,area-52,671,monk,mistweaver,12,7,5
18789,Monkydoo,blackhand,671,monk,mistweaver,12,7,5
18790,Kurtall,area-52,671,monk,mistweaver,12,7,5
18791,Decha,skywall,671,monk,mistweaver,12,7,5
18792,Crankxx,malganis,671,monk,mistweaver,12,7,5
18793,Jbonk,hyjal,671,monk,mistweaver,12,7,5
18794,Tigraxus,proudmoore,671,monk,mistweaver,12,7,5
18795,Alisoly,tichondrius,671,monk,mistweaver,12,7,5
18796,Rôbo,emerald-dream,671,monk,mistweaver,12,7,5
18797,Fìst,hyjal,671,monk,mistweaver,12,7,5
18798,Hornymonkale,thrall,671,monk,mistweaver,12,7,5
18799,Shórtlived,skullcrusher,671,monk,mistweaver,13,7,6
18800,Táishen,wyrmrest-accord,671,monk,mistweaver,16,8,8
18801,Metapôd,tichondrius,671,monk,mistweaver,15,7,8
18802,Divaweaver,sargeras,671,monk,mistweaver,18,7,11
18803,Aotd,tichondrius,671,monk,mistweaver,18,7,11
18804,Bükki,ragnaros,671,monk,mistweaver,18,7,11
18805,Atiantian,proudmoore,671,monk,mistweaver,24,7,17
18806,Cosetteb,proudmoore,670,monk,mistweaver,12,7,5
18807,Kongpoo,kelthuzad,670,monk,mistweaver,12,7,5
18808,Microdose,blackrock,670,monk,mistweaver,18,7,11
18809,Khaldi,tichondrius,670,monk,mistweaver,19,7,12
18810,Tusil,tichondrius,670,monk,mistweaver,24,7,17
18811,Pandaranga,saurfang,670,monk,mistweaver,28,8,20
18812,Unlemike,runetotem,669,monk,mistweaver,12,7,5
18813,Nymchi,stormrage,669,monk,mistweaver,12,7,5
18814,Melyodis,thrall,669,monk,mistweaver,18,7,11
18815,Ghostmk,nagrand,667,monk,mistweaver,18,7,11
18816,Balooballs,frostmourne,667,monk,mistweaver,18,7,11
18817,Wetspaghetti,malganis,661,monk,mistweaver,18,7,11
18818,Munchan,hyjal,654,monk,mistweaver,11,9,2
18819,Matchuh,stormrage,643,monk,mistweaver,25,8,17
18820,Karu,barthilas,639,monk,mistweaver,18,8,10
18821,Rènh,ragnaros,639,monk,mistweaver,17,7,10
18822,Reflexsivex,malganis,638,monk,mistweaver,11,7,4
18823,Sourcandyx,area-52,624,monk,mistweaver,15,7,8
18824,Blessedbalor,tichondrius,624,monk,mistweaver,21,7,14
18825,Praydoh,tichondrius,623,monk,mistweaver,11,7,4
18826,Jetchi,proudmoore,623,monk,mistweaver,11,7,4
18827,Dasubb,crushridge,623,monk,mistweaver,11,7,4
18828,Azz,barthilas,623,monk,mistweaver,11,7,4
18829,Aerona,stormreaver,617,monk,mistweaver,12,8,4
18830,Coachputmein,barthilas,607,monk,mistweaver,11,7,4
18831,Robochöp,emerald-dream,606,monk,mistweaver,14,7,7
18832,Larkssmw,zuljin,576,monk,mistweaver,6,6,0
18833,Watty,zuljin,576,monk,mistweaver,6,6,0
18834,Kruxx,anvilmar,576,monk,mistweaver,6,6,0
18835,Minivanmom,illidan,576,monk,mistweaver,6,6,0
18836,Monkmarz,malygos,576,monk,mistweaver,6,6,0
18837,Ezqueue,area-52,576,monk,mistweaver,6,6,0
18838,Nevercranex,kirin-tor,576,monk,mistweaver,6,6,0
18839,Anagark,barthilas,576,monk,mistweaver,6,6,0
18840,Munkï,tichondrius,576,monk,mistweaver,6,6,0
18841,Chrîstmas,proudmoore,576,monk,mistweaver,6,6,0
18842,Bdâwg,frostmourne,576,monk,mistweaver,6,6,0
18843,Brujitsu,thrall,576,monk,mistweaver,12,6,6
18844,Wuwei,onyxia,576,monk,mistweaver,12,6,6
18845,Jieterchan,malganis,576,monk,mistweaver,12,6,6
18846,Lumiän,area-52,576,monk,mistweaver,12,6,6
18847,Raonoc,sargeras,576,monk,mistweaver,12,6,6
18848,Khungfeu,area-52,576,monk,mistweaver,12,6,6
18849,Transcend,nerzhul,576,monk,mistweaver,12,6,6
18850,Meisterbrew,garona,576,monk,mistweaver,12,6,6
18851,Sekushî,kelthuzad,576,monk,mistweaver,12,6,6
18852,Bearmode,wyrmrest-accord,576,monk,mistweaver,12,6,6
18853,Underpants,skullcrusher,576,monk,mistweaver,12,6,6
18854,Krob,bleeding-hollow,576,monk,mistweaver,12,6,6
18855,Saitamâ,tichondrius,576,monk,mistweaver,12,6,6
18856,Imakeplaysyo,illidan,576,monk,mistweaver,12,6,6
18857,Kaztíel,ragnaros,576,monk,mistweaver,12,6,6
18858,Fïish,stormrage,576,monk,mistweaver,12,6,6
18859,Gnomshini,proudmoore,576,monk,mistweaver,12,6,6
18860,Ñightingale,queldorei,576,monk,mistweaver,12,6,6
18861,Xitearith,ragnaros,576,monk,mistweaver,12,6,6
18862,Nukeproof,stormreaver,576,monk,mistweaver,12,6,6
18863,Cerrado,emerald-dream,576,monk,mistweaver,12,6,6
18864,Grimaku,tichondrius,576,monk,mistweaver,12,6,6
18865,Dungfish,mugthol,576,monk,mistweaver,12,6,6
18866,Vayce,barthilas,576,monk,mistweaver,12,6,6
18867,Peachtea,burning-legion,576,monk,mistweaver,12,6,6
18868,Shaqkobe,stormrage,576,monk,mistweaver,12,6,6
18869,Aerlin,tichondrius,576,monk,mistweaver,12,6,6
18870,Demisodax,tichondrius,576,monk,mistweaver,12,6,6
18871,Aiswalle,illidan,576,monk,mistweaver,12,6,6
18872,Magnustavick,bleeding-hollow,576,monk,mistweaver,12,6,6
18873,Janim,illidan,576,monk,mistweaver,12,6,6
18874,Danceofchiji,tichondrius,576,monk,mistweaver,12,6,6
18875,Karrigwyn,tichondrius,576,monk,mistweaver,12,6,6
18876,Mtsalt,bleeding-hollow,576,monk,mistweaver,12,6,6
18877,Até,azralon,576,monk,mistweaver,12,6,6
18878,Boppweave,tichondrius,576,monk,mistweaver,12,6,6
18879,Wèave,tichondrius,576,monk,mistweaver,12,6,6
18880,Eightpoint,illidan,576,monk,mistweaver,12,6,6
18881,Dreamfist,emerald-dream,576,monk,mistweaver,12,6,6
18882,Dracc,zuljin,576,monk,mistweaver,12,6,6
18883,Pai,sargeras,576,monk,mistweaver,12,6,6
18884,Faccemelter,illidan,576,monk,mistweaver,12,6,6
18885,Sumaran,hydraxis,576,monk,mistweaver,12,6,6
18886,Billycobham,tichondrius,576,monk,mistweaver,12,6,6
18887,Steyi,nazjatar,576,monk,mistweaver,12,6,6
18888,Broyoulined,spirestone,576,monk,mistweaver,12,6,6
18889,Mwgapper,sargeras,576,monk,mistweaver,18,6,12
18890,Simarity,kelthuzad,576,monk,mistweaver,18,6,12
18891,Tragictea,zuljin,576,monk,mistweaver,18,6,12
18892,Fistweebin,area-52,576,monk,mistweaver,18,6,12
18893,Philthyjutsu,moon-guard,575,monk,mistweaver,6,6,0
18894,Littlegeorge,moon-guard,575,monk,mistweaver,6,6,0
18895,Kafuru,quelthalas,575,monk,mistweaver,10,7,3
18896,Putisucia,nordrassil,575,monk,mistweaver,12,6,6
18897,Biglinky,sargeras,575,monk,mistweaver,12,6,6
18898,Itsjohnnylol,azuremyst,575,monk,mistweaver,12,6,6
18899,Glitchi,area-52,575,monk,mistweaver,12,6,6
18900,Medge,kelthuzad,575,monk,mistweaver,12,6,6
18901,Clytpuncher,emerald-dream,575,monk,mistweaver,12,6,6
18902,Nf,zuljin,575,monk,mistweaver,12,6,6
18903,Kung,tichondrius,575,monk,mistweaver,12,6,6
18904,Soysaucë,malganis,575,monk,mistweaver,12,6,6
18905,Laopow,area-52,575,monk,mistweaver,12,6,6
18906,Misha,akama,575,monk,mistweaver,12,6,6
18907,Hibìscus,tichondrius,575,monk,mistweaver,12,6,6
18908,Xinn,kiljaeden,575,monk,mistweaver,12,6,6
18909,Fânnybâws,stormrage,575,monk,mistweaver,12,6,6
18910,Morhe,the-forgotten-coast,575,monk,mistweaver,12,6,6
18911,Ormchi,stormrage,575,monk,mistweaver,13,6,7
18912,Freepunchz,frostmourne,575,monk,mistweaver,18,6,12
18913,Opmother,elune,575,monk,mistweaver,18,6,12
18914,Neww,tichondrius,575,monk,mistweaver,18,6,12
18915,Blorkk,area-52,574,monk,mistweaver,12,6,6
18916,Touchkarma,stormrage,574,monk,mistweaver,12,6,6
18917,Yanedin,dalaran,574,monk,mistweaver,12,6,6
18918,Shihfu,azralon,574,monk,mistweaver,18,6,12
18919,Monjepa,illidan,574,monk,mistweaver,18,6,12
18920,Tubbytiph,ghostlands,574,monk,mistweaver,24,6,18
18921,Bluemyselph,tichondrius,573,monk,mistweaver,18,6,12
18922,Mënace,skullcrusher,572,monk,mistweaver,12,6,6
18923,Dokuho,silvermoon,572,monk,mistweaver,12,6,6
18924,Gaturis,tichondrius,572,monk,mistweaver,21,7,14
18925,Bógus,tichondrius,571,monk,mistweaver,12,6,6
18926,Samanosukee,illidan,571,monk,mistweaver,12,6,6
18927,Paladinei,tichondrius,571,monk,mistweaver,12,6,6
18928,Keekismonk,gorefiend,566,monk,mistweaver,12,6,6
18929,Dejohnette,quelthalas,565,monk,mistweaver,12,6,6
18930,Boofie,perenolde,559,monk,mistweaver,11,6,5
18931,Gyunyumanjuu,proudmoore,559,monk,mistweaver,11,6,5
18932,Sohéi,proudmoore,559,monk,mistweaver,17,6,11
18933,Monkeybooze,sargeras,543,monk,mistweaver,14,7,7
18934,Yookho,tichondrius,527,monk,mistweaver,11,7,4
18935,Domisalamii,sargeras,527,monk,mistweaver,11,6,5
18936,Mfmiscreant,illidan,522,monk,mistweaver,22,7,15
18937,Mastamonksta,illidan,512,monk,mistweaver,16,6,10
18938,Räyè,tichondrius,511,monk,mistweaver,8,6,2
18939,Immamonkey,tichondrius,511,monk,mistweaver,10,6,4
18940,Oldmanwalker,mannoroth,511,monk,mistweaver,11,6,5
18941,Tbrew,area-52,511,monk,mistweaver,14,6,8
18942,Çät,frostmourne,511,monk,mistweaver,14,6,8
18943,Healyboi,bronzebeard,511,monk,mistweaver,16,6,10
18944,Figurines,sargeras,496,monk,mistweaver,19,6,13
18945,Roskoh,area-52,493,monk,mistweaver,19,6,13
18946,Koyon,sargeras,480,monk,mistweaver,6,5,1
18947,Rivnn,sargeras,480,monk,mistweaver,6,5,1
18948,Zbhm,illidan,480,monk,mistweaver,6,5,1
18949,Meepz,arthas,480,monk,mistweaver,6,5,1
18950,Spirits,dreadmaul,480,monk,mistweaver,6,5,1
18951,Zammymonk,area-52,480,monk,mistweaver,6,5,1
18952,Chingwang,frostmourne,480,monk,mistweaver,6,5,1
18953,Donatello,arthas,480,monk,mistweaver,6,5,1
18954,Jaige,illidan,480,monk,mistweaver,6,5,1
18955,Kayflock,tichondrius,480,monk,mistweaver,6,5,1
18956,Yuldaddy,tichondrius,480,monk,mistweaver,6,5,1
18957,Swiixm,frostmourne,480,monk,mistweaver,6,5,1
18958,Elcidw,tichondrius,480,monk,mistweaver,6,5,1
18959,Getswept,area-52,480,monk,mistweaver,6,5,1
18960,Yajirobei,area-52,480,monk,mistweaver,6,5,1
18961,Satiremaster,frostmourne,480,monk,mistweaver,6,5,1
18962,Møzy,darkspear,480,monk,mistweaver,6,5,1
18963,Prf,ragnaros,480,monk,mistweaver,6,5,1
18964,Pungeebi,tichondrius,480,monk,mistweaver,6,5,1
18965,Siddharthä,barthilas,480,monk,mistweaver,6,5,1
18966,Genia,ragnaros,480,monk,mistweaver,6,5,1
18967,Stepfíster,tichondrius,480,monk,mistweaver,6,5,1
18968,Dragonwarior,zuluhed,480,monk,mistweaver,6,5,1
18969,Jurassaf,illidan,480,monk,mistweaver,6,5,1
18970,Pinot,dragonmaw,480,monk,mistweaver,6,5,1
18971,Alvinete,tichondrius,480,monk,mistweaver,6,5,1
18972,Zhuangnimane,tichondrius,480,monk,mistweaver,6,5,1
18973,Theodôn,dalaran,480,monk,mistweaver,6,5,1
18974,Fangerlia,moon-guard,480,monk,mistweaver,6,5,1
18975,Pyoapple,tichondrius,480,monk,mistweaver,6,5,1
18976,Møzy,tichondrius,480,monk,mistweaver,6,5,1
18977,Ceronash,dalaran,480,monk,mistweaver,6,5,1
18978,Mistwalk,tichondrius,480,monk,mistweaver,6,5,1
18979,Grumpî,tichondrius,480,monk,mistweaver,6,5,1
18980,Pandatong,tichondrius,480,monk,mistweaver,6,5,1
18981,Tamagotchi,emerald-dream,480,monk,mistweaver,6,5,1
18982,Choibaedal,tichondrius,480,monk,mistweaver,7,5,2
18983,Kaiøken,tichondrius,480,monk,mistweaver,12,5,7
18984,Vashnir,lothar,480,monk,mistweaver,12,5,7
18985,Otzyy,turalyon,480,monk,mistweaver,12,5,7
18986,Chronost,sargeras,480,monk,mistweaver,12,5,7
18987,Bigolbootay,tichondrius,480,monk,mistweaver,12,5,7
18988,Onak,illidan,480,monk,mistweaver,12,5,7
18989,Fortyozkilla,thrall,480,monk,mistweaver,12,5,7
18990,Nîxs,frostmourne,480,monk,mistweaver,12,5,7
18991,Kungfused,antonidas,480,monk,mistweaver,12,5,7
18992,Piece,blackrock,480,monk,mistweaver,12,5,7
18993,Crìstiano,malganis,480,monk,mistweaver,12,5,7
18994,Palumorww,deathwing,480,monk,mistweaver,12,5,7
18995,Judo,khadgar,480,monk,mistweaver,12,5,7
18996,Palden,blackrock,480,monk,mistweaver,12,5,7
18997,Duckpond,nerzhul,480,monk,mistweaver,12,5,7
18998,Eraticmonk,illidan,480,monk,mistweaver,12,5,7
18999,Rockyßalboa,sargeras,480,monk,mistweaver,12,5,7
19000,Xavelha,tichondrius,480,monk,mistweaver,12,5,7
19001,Ouibaguette,kelthuzad,480,monk,mistweaver,12,5,7
19002,Nawzhy,emerald-dream,480,monk,mistweaver,12,5,7
19003,Amybaby,sargeras,480,monk,mistweaver,12,5,7
19004,Masonn,kiljaeden,480,monk,mistweaver,12,5,7
19005,Catchmemaybe,stormscale,480,monk,mistweaver,12,5,7
19006,Whipllash,tichondrius,480,monk,mistweaver,12,5,7
19007,Paradissô,tichondrius,480,monk,mistweaver,12,5,7
19008,Gnarmony,malganis,480,monk,mistweaver,12,5,7
19009,Btipton,tichondrius,480,monk,mistweaver,12,5,7
19010,Biggyballs,tichondrius,480,monk,mistweaver,12,5,7
19011,Danceschi,area-52,480,monk,mistweaver,12,5,7
19012,Ocmonk,hyjal,480,monk,mistweaver,12,5,7
19013,Màngø,ragnaros,480,monk,mistweaver,18,5,13
19014,Bruiseu,illidan,480,monk,mistweaver,18,5,13
19015,Blackflag,queldorei,480,monk,mistweaver,18,5,13
19016,Cckknckr,sargeras,480,monk,mistweaver,24,5,19
19017,Patman,nazjatar,479,monk,mistweaver,6,5,1
19018,Badkarmasix,tichondrius,479,monk,mistweaver,6,5,1
19019,Monqq,tichondrius,479,monk,mistweaver,6,5,1
19020,Bitrau,destromath,479,monk,mistweaver,12,5,7
19021,Tianhu,sargeras,479,monk,mistweaver,12,5,7
19022,Angrybrewski,tichondrius,479,monk,mistweaver,12,5,7
19023,Paticus,area-52,479,monk,mistweaver,12,5,7
19024,Wisepaw,tichondrius,479,monk,mistweaver,12,5,7
19025,Stephani,turalyon,479,monk,mistweaver,12,5,7
19026,Jayjaybrew,area-52,479,monk,mistweaver,12,5,7
19027,Annara,tichondrius,479,monk,mistweaver,12,5,7
19028,Tigmo,alleria,479,monk,mistweaver,12,5,7
19029,Troutz,sargeras,479,monk,mistweaver,12,5,7
19030,Satchelgizmo,tichondrius,479,monk,mistweaver,18,5,13
19031,Ltsneaky,bladefist,479,monk,mistweaver,30,5,25
19032,Shmello,akama,478,monk,mistweaver,6,5,1
19033,Sahalee,emerald-dream,478,monk,mistweaver,12,5,7
19034,Cahuun,baelgun,478,monk,mistweaver,12,5,7
19035,Safigirl,doomhammer,478,monk,mistweaver,12,5,7
19036,Tutulee,tichondrius,477,monk,mistweaver,6,5,1
19037,Yungsun,ragnaros,463,monk,mistweaver,13,6,7
19038,Drgigglez,tichondrius,463,monk,mistweaver,11,5,6
19039,Whatdaheal,darkspear,451,monk,mistweaver,36,9,27
19040,Foomanshoes,shandris,448,monk,mistweaver,22,5,17
19041,Bengal,arthas,447,monk,mistweaver,11,5,6
19042,Onlyhands,whisperwind,446,monk,mistweaver,11,5,6
19043,Beefdadyfist,tichondrius,440,monk,mistweaver,24,8,16
19044,Supmybrew,frostmourne,431,monk,mistweaver,11,5,6
19045,Indrazzxx,jubeithos,426,monk,mistweaver,11,7,4
19046,Bellátíx,quelthalas,426,monk,mistweaver,17,9,8
19047,Obàma,tichondrius,426,monk,mistweaver,13,6,7
19048,Matsakaicin,azralon,426,monk,mistweaver,16,6,10
19049,Durath,burning-blade,415,monk,mistweaver,10,5,5
19050,Danie,nerzhul,384,monk,mistweaver,6,4,2
19051,Tinyboots,area-52,384,monk,mistweaver,6,4,2
19052,Ufs,illidan,384,monk,mistweaver,6,4,2
19053,Snoogiee,khazgoroth,384,monk,mistweaver,6,4,2
19054,Avendare,tichondrius,384,monk,mistweaver,6,4,2
19055,Srgtbingo,azgalor,384,monk,mistweaver,6,4,2
19056,Globalmonk,emerald-dream,384,monk,mistweaver,6,4,2
19057,Bamboozile,arthas,384,monk,mistweaver,6,4,2
19058,Zamzae,tichondrius,384,monk,mistweaver,6,4,2
19059,Jmonks,stormrage,384,monk,mistweaver,6,4,2
19060,Dude,tichondrius,384,monk,mistweaver,6,4,2
19061,Brantkicks,tichondrius,384,monk,mistweaver,6,4,2
19062,Kokochiggy,tichondrius,384,monk,mistweaver,6,4,2
19063,Nipfuu,maelstrom,384,monk,mistweaver,6,4,2
19064,Teddybéar,illidan,384,monk,mistweaver,6,4,2
19065,Blpkosher,tichondrius,384,monk,mistweaver,6,4,2
19066,Lyla,aegwynn,384,monk,mistweaver,6,4,2
19067,Monkatron,arthas,384,monk,mistweaver,6,4,2
19068,Freeoni,sargeras,384,monk,mistweaver,6,4,2
19069,Jâzze,zuljin,384,monk,mistweaver,6,4,2
19070,Kobuya,tichondrius,384,monk,mistweaver,6,4,2
19071,Mêlon,tichondrius,384,monk,mistweaver,6,4,2
19072,Ericfu,tichondrius,384,monk,mistweaver,6,4,2
19073,Treysongz,illidan,384,monk,mistweaver,6,4,2
19074,Kwazinator,area-52,384,monk,mistweaver,6,4,2
19075,Crentist,mannoroth,384,monk,mistweaver,6,4,2
19076,Kharazina,azralon,384,monk,mistweaver,6,4,2
19077,Lingerer,aerie-peak,384,monk,mistweaver,6,4,2
19078,Macnia,frostmourne,384,monk,mistweaver,6,4,2
19079,Justamönk,moon-guard,384,monk,mistweaver,6,4,2
19080,Renzin,gilneas,384,monk,mistweaver,6,4,2
19081,Brucetea,chogall,384,monk,mistweaver,6,4,2
19082,Dontchattome,sargeras,384,monk,mistweaver,6,4,2
19083,Balduglybaby,tichondrius,384,monk,mistweaver,6,4,2
19084,Rizzjutsu,stormrage,384,monk,mistweaver,6,4,2
19085,Jellobag,frostmane,384,monk,mistweaver,6,4,2
19086,Keepcryin,gorefiend,384,monk,mistweaver,6,4,2
19087,Keyndanlamor,sargeras,384,monk,mistweaver,6,4,2
19088,Talker,stormrage,384,monk,mistweaver,6,4,2
19089,Howziexd,tichondrius,384,monk,mistweaver,6,4,2
19090,Shakeweightt,blackrock,384,monk,mistweaver,6,4,2
19091,Nakiki,cenarion-circle,384,monk,mistweaver,6,4,2
19092,Dakism,sargeras,384,monk,mistweaver,6,4,2
19093,Doodoodookie,thunderhorn,384,monk,mistweaver,6,4,2
19094,Nikitip,tichondrius,384,monk,mistweaver,6,4,2
19095,Nezkabad,frostmourne,384,monk,mistweaver,6,4,2
19096,Mõnk,illidan,384,monk,mistweaver,12,4,8
19097,Mccoy,quelthalas,384,monk,mistweaver,12,4,8
19098,Manxxin,illidan,384,monk,mistweaver,12,4,8
19099,Argoholic,proudmoore,384,monk,mistweaver,12,4,8
19100,Nutbag,norgannon,384,monk,mistweaver,12,4,8
19101,Pax,boulderfist,384,monk,mistweaver,12,4,8
19102,Hoyocochino,quelthalas,384,monk,mistweaver,12,4,8
19103,Fistorcstar,daggerspine,384,monk,mistweaver,12,4,8
19104,Sim,frostmourne,384,monk,mistweaver,12,4,8
19105,Tanipto,tichondrius,384,monk,mistweaver,12,4,8
19106,Zënløvë,tichondrius,384,monk,mistweaver,12,4,8
19107,Pandàmonium,frostmourne,384,monk,mistweaver,12,4,8
19108,Valkana,kelthuzad,384,monk,mistweaver,12,4,8
19109,Neversweep,tichondrius,384,monk,mistweaver,12,4,8
19110,Shredmw,tichondrius,384,monk,mistweaver,12,4,8
19111,Crakgirl,malganis,384,monk,mistweaver,12,4,8
19112,Sprinkli,sargeras,384,monk,mistweaver,12,4,8
19113,Rxtea,darkspear,384,monk,mistweaver,12,4,8
19114,Darkeiji,stormrage,384,monk,mistweaver,12,4,8
19115,Darylphilbin,emerald-dream,384,monk,mistweaver,12,4,8
19116,Macktickle,zuljin,384,monk,mistweaver,12,4,8
19117,Migchi,sargeras,384,monk,mistweaver,12,4,8
19118,Fluffykaboom,destromath,384,monk,mistweaver,12,4,8
19119,Windwalken,sargeras,384,monk,mistweaver,12,4,8
19120,Jincíe,area-52,384,monk,mistweaver,12,4,8
19121,Jimbojenkins,bleeding-hollow,384,monk,mistweaver,12,4,8
19122,Eqoy,moon-guard,384,monk,mistweaver,12,4,8
19123,Nicolascåge,destromath,384,monk,mistweaver,12,4,8
19124,Mockz,dentarg,384,monk,mistweaver,12,4,8
19125,Iamapotato,tichondrius,384,monk,mistweaver,18,4,14
19126,Åvå,emerald-dream,384,monk,mistweaver,18,4,14
19127,Zyemell,tichondrius,383,monk,mistweaver,12,4,8
19128,Jigong,bleeding-hollow,383,monk,mistweaver,12,4,8
19129,Esleif,moonrunner,383,monk,mistweaver,12,4,8
19130,Izgoku,frostmane,383,monk,mistweaver,18,4,14
19131,Rollbot,kelthuzad,382,monk,mistweaver,6,4,2
19132,Lushona,ragnaros,382,monk,mistweaver,6,4,2
19133,Drzoid,thrall,382,monk,mistweaver,12,4,8
19134,Sence,lightnings-blade,382,monk,mistweaver,18,4,14
19135,Saltyone,firetree,351,monk,mistweaver,8,5,3
19136,Sáble,stormrage,351,monk,mistweaver,11,4,7
19137,Lenakai,malganis,351,monk,mistweaver,11,4,7
19138,Bakus,tichondrius,336,monk,mistweaver,11,5,6
19139,ßiggiesmallz,barthilas,330,monk,mistweaver,12,5,7
19140,Kimchidelite,gorefiend,319,monk,mistweaver,5,4,1
19141,Drkeen,frostmourne,288,monk,mistweaver,10,5,5
19142,Aphrodîîte,area-52,288,monk,mistweaver,6,3,3
19143,Ryukenshin,proudmoore,288,monk,mistweaver,6,3,3
19144,Bosschops,illidan,288,monk,mistweaver,6,3,3
19145,Fistër,area-52,288,monk,mistweaver,6,3,3
19146,Berzerk,dalvengyr,288,monk,mistweaver,6,3,3
19147,Notcheez,area-52,288,monk,mistweaver,6,3,3
19148,Kotonnoha,quelthalas,288,monk,mistweaver,6,3,3
19149,Orgrrim,area-52,288,monk,mistweaver,6,3,3
19150,Lundch,tichondrius,288,monk,mistweaver,6,3,3
19151,Maybeyooshi,kelthuzad,288,monk,mistweaver,6,3,3
19152,Foxjade,thrall,288,monk,mistweaver,6,3,3
19153,Ðreadhot,malganis,288,monk,mistweaver,6,3,3
19154,Darkjab,tichondrius,288,monk,mistweaver,6,3,3
19155,Sterow,kiljaeden,288,monk,mistweaver,6,3,3
19156,Macproblem,malganis,288,monk,mistweaver,6,3,3
19157,Ighostgirls,thrall,288,monk,mistweaver,6,3,3
19158,Seii,ravenholdt,288,monk,mistweaver,6,3,3
19159,Tambher,lightbringer,288,monk,mistweaver,6,3,3
19160,Grogio,wyrmrest-accord,288,monk,mistweaver,6,3,3
19161,Gguldduck,tichondrius,288,monk,mistweaver,6,3,3
19162,Teclas,ragnaros,288,monk,mistweaver,6,3,3
19163,Mystï,silvermoon,288,monk,mistweaver,6,3,3
19164,Arinix,tichondrius,288,monk,mistweaver,6,3,3
19165,Maripaulita,ragnaros,288,monk,mistweaver,6,3,3
19166,Imisswodxo,illidan,288,monk,mistweaver,6,3,3
19167,Fistin,laughing-skull,288,monk,mistweaver,6,3,3
19168,Zeelos,kelthuzad,288,monk,mistweaver,6,3,3
19169,Möösê,moon-guard,288,monk,mistweaver,6,3,3
19170,Phlexz,jubeithos,288,monk,mistweaver,6,3,3
19171,Streetcreds,bleeding-hollow,288,monk,mistweaver,6,3,3
19172,Hundski,bleeding-hollow,288,monk,mistweaver,6,3,3
19173,Chingu,ragnaros,288,monk,mistweaver,6,3,3
19174,Greenteafrãp,bleeding-hollow,288,monk,mistweaver,6,3,3
19175,Graoul,thaurissan,288,monk,mistweaver,6,3,3
19176,Rzeznik,boulderfist,288,monk,mistweaver,6,3,3
19177,Loppjr,tichondrius,288,monk,mistweaver,6,3,3
19178,Vidrus,gorefiend,288,monk,mistweaver,6,3,3
19179,Kayla,ursin,288,monk,mistweaver,6,3,3
19180,Austaar,frostmourne,288,monk,mistweaver,6,3,3
19181,Monaks,barthilas,288,monk,mistweaver,6,3,3
19182,Madson,darkspear,288,monk,mistweaver,6,3,3
19183,Ase,frostwolf,288,monk,mistweaver,6,3,3
19184,Rasgacrú,stormrage,288,monk,mistweaver,6,3,3
19185,Zchi,zuljin,288,monk,mistweaver,6,3,3
19186,Giggacuck,frostmourne,288,monk,mistweaver,6,3,3
19187,Shadowbringr,proudmoore,288,monk,mistweaver,6,3,3
19188,Mythsmonkx,barthilas,288,monk,mistweaver,6,3,3
19189,Lindraice,illidan,288,monk,mistweaver,6,3,3
19190,Abevx,bonechewer,288,monk,mistweaver,6,3,3
19191,Stunnedheals,arthas,288,monk,mistweaver,6,3,3
19192,Mingfei,uther,288,monk,mistweaver,6,3,3
19193,Feelsogöod,tichondrius,288,monk,mistweaver,6,3,3
19194,Yaloon,stormrage,288,monk,mistweaver,6,3,3
19195,Lemeta,tichondrius,288,monk,mistweaver,6,3,3
19196,Zzizzi,tichondrius,288,monk,mistweaver,6,3,3
19197,Növa,alterac-mountains,288,monk,mistweaver,6,3,3
19198,Zaçh,frostmane,288,monk,mistweaver,6,3,3
19199,Polyphia,lothar,288,monk,mistweaver,6,3,3
19200,Lyántrying,korgath,288,monk,mistweaver,6,3,3
19201,Furrykisser,tichondrius,288,monk,mistweaver,6,3,3
19202,Fammi,stormrage,288,monk,mistweaver,6,3,3
19203,Cädemaddöx,stormrage,288,monk,mistweaver,6,3,3
19204,Fysicalx,stormrage,288,monk,mistweaver,6,3,3
19205,Spacoli,stormrage,288,monk,mistweaver,6,3,3
19206,Densíty,kiljaeden,288,monk,mistweaver,6,3,3
19207,Stigzz,stormrage,288,monk,mistweaver,6,3,3
19208,Voguex,area-52,288,monk,mistweaver,6,3,3
19209,Quartztiger,sargeras,288,monk,mistweaver,6,3,3
19210,Droppinfast,sargeras,288,monk,mistweaver,6,3,3
19211,Cannenmonk,sargeras,288,monk,mistweaver,6,3,3
19212,Omnivò,emerald-dream,288,monk,mistweaver,6,3,3
19213,Monkêy,ghostlands,288,monk,mistweaver,6,3,3
19214,Spiritmist,sargeras,288,monk,mistweaver,6,3,3
19215,Miýagi,sargeras,288,monk,mistweaver,6,3,3
19216,ßöe,sargeras,288,monk,mistweaver,6,3,3
19217,Swansational,sargeras,288,monk,mistweaver,6,3,3
19218,Thatfknguy,sargeras,288,monk,mistweaver,6,3,3
19219,Slimweaver,stormrage,288,monk,mistweaver,11,4,7
19220,Kúrios,azralon,288,monk,mistweaver,10,3,7
19221,Fitofryfitof,aegwynn,288,monk,mistweaver,12,3,9
19222,Øtpp,sargeras,288,monk,mistweaver,12,3,9
19223,Chilliweaver,frostmourne,288,monk,mistweaver,12,3,9
19224,Korvishka,malganis,288,monk,mistweaver,12,3,9
19225,Mwtouch,nemesis,288,monk,mistweaver,12,3,9
19226,Selfîe,ysera,288,monk,mistweaver,12,3,9
19227,Absolutvodca,nemesis,288,monk,mistweaver,12,3,9
19228,Awwchi,tichondrius,288,monk,mistweaver,12,3,9
19229,Vchii,tichondrius,288,monk,mistweaver,12,3,9
19230,Wørm,emerald-dream,288,monk,mistweaver,12,3,9
19231,Wizcaulifa,stormrage,288,monk,mistweaver,12,3,9
19232,Katalina,alexstrasza,288,monk,mistweaver,12,3,9
19233,Deyseddia,azgalor,287,monk,mistweaver,6,3,3
19234,Rosinhood,illidan,287,monk,mistweaver,6,3,3
19235,Gatsbi,arthas,287,monk,mistweaver,6,3,3
19236,Holandri,moon-guard,287,monk,mistweaver,6,3,3
19237,Alanimistw,khadgar,287,monk,mistweaver,6,3,3
19238,Starskreem,tichondrius,287,monk,mistweaver,6,3,3
19239,Fistidmi,area-52,287,monk,mistweaver,11,4,7
19240,Shlumpuh,tichondrius,287,monk,mistweaver,16,4,12
19241,Uninvited,perenolde,286,monk,mistweaver,6,3,3
19242,Lilpielover,zuljin,286,monk,mistweaver,15,4,11
19243,Braindi,arathor,271,monk,mistweaver,11,3,8
19244,Fiztingfaded,area-52,265,monk,mistweaver,20,6,14
19245,Lildae,burning-legion,256,monk,mistweaver,4,4,0
19246,Koragro,tichondrius,239,monk,mistweaver,5,3,2
19247,Zeisei,wyrmrest-accord,234,monk,mistweaver,10,4,6
19248,Friedpanda,kelthuzad,234,monk,mistweaver,16,4,12
19249,Hirado,kelthuzad,234,monk,mistweaver,16,4,12
19250,Raymond,malganis,192,monk,mistweaver,4,3,1
19251,Hunchojack,undermine,192,monk,mistweaver,4,3,1
19252,Furryfisttin,illidan,192,monk,mistweaver,8,3,5
19253,Fäded,trollbane,192,monk,mistweaver,6,2,4
19254,Flagreturned,illidan,192,monk,mistweaver,6,2,4
19255,Aquamonk,tichondrius,192,monk,mistweaver,6,2,4
19256,Monky,black-dragonflight,192,monk,mistweaver,6,2,4
19257,Iililiililil,stormrage,192,monk,mistweaver,6,2,4
19258,Hugerichard,wyrmrest-accord,192,monk,mistweaver,6,2,4
19259,Theriní,stormrage,192,monk,mistweaver,6,2,4
19260,Silkymoves,tichondrius,192,monk,mistweaver,6,2,4
19261,Privm,moonrunner,192,monk,mistweaver,6,2,4
19262,Skadouch,wyrmrest-accord,192,monk,mistweaver,6,2,4
19263,Jittersx,silvermoon,192,monk,mistweaver,6,2,4
19264,Prodigious,illidan,192,monk,mistweaver,6,2,4
19265,Hitchslapz,tichondrius,192,monk,mistweaver,6,2,4
19266,Rubntug,zuljin,192,monk,mistweaver,6,2,4
19267,Odradek,thunderlord,192,monk,mistweaver,6,2,4
19268,Banidiin,moon-guard,192,monk,mistweaver,6,2,4
19269,Melocotonn,goldrinn,192,monk,mistweaver,6,2,4
19270,Zengoku,zuljin,192,monk,mistweaver,6,2,4
19271,Sebasu,perenolde,192,monk,mistweaver,6,2,4
19272,Selocke,bleeding-hollow,192,monk,mistweaver,6,2,4
19273,Foxmacleod,bleeding-hollow,192,monk,mistweaver,6,2,4
19274,Tigerlust,sargeras,192,monk,mistweaver,6,2,4
19275,Caralia,exodar,192,monk,mistweaver,6,2,4
19276,Kîkû,moon-guard,192,monk,mistweaver,6,2,4
19277,Lilknucks,bonechewer,192,monk,mistweaver,6,2,4
19278,Bamboøzled,daggerspine,192,monk,mistweaver,6,2,4
19279,Tàekwondo,drakkari,192,monk,mistweaver,6,2,4
19280,Tarae,nagrand,192,monk,mistweaver,6,2,4
19281,Streetjezus,bloodhoof,192,monk,mistweaver,6,2,4
19282,Kåelarayn,moon-guard,192,monk,mistweaver,6,2,4
19283,Dustyweaver,illidan,192,monk,mistweaver,6,2,4
19284,Feihung,executus,192,monk,mistweaver,6,2,4
19285,Jaybum,sargeras,192,monk,mistweaver,6,2,4
19286,Mistbeard,aggramar,192,monk,mistweaver,6,2,4
19287,Zåz,nazgrel,192,monk,mistweaver,6,2,4
19288,Dreadneck,sargeras,192,monk,mistweaver,6,2,4
19289,Ashenn,area-52,192,monk,mistweaver,6,2,4
19290,Wamii,tichondrius,192,monk,mistweaver,6,2,4
19291,Fïstbeaver,malganis,192,monk,mistweaver,6,2,4
19292,Bodyshot,area-52,192,monk,mistweaver,6,2,4
19293,Fortnight,emerald-dream,192,monk,mistweaver,6,2,4
19294,Xanzee,area-52,192,monk,mistweaver,6,2,4
19295,Lackofsleep,tichondrius,192,monk,mistweaver,6,2,4
19296,Drfistyfingr,malganis,192,monk,mistweaver,6,2,4
19297,Acena,stormrage,192,monk,mistweaver,6,2,4
19298,Apparent,lightnings-blade,192,monk,mistweaver,6,2,4
19299,Nilonsso,sargeras,192,monk,mistweaver,6,2,4
19300,Onepunch,exodar,192,monk,mistweaver,7,2,5
19301,Coffeek,area-52,192,monk,mistweaver,8,2,6
19302,Whtnyhuston,sargeras,192,monk,mistweaver,8,2,6
19303,Glowsgreenby,area-52,192,monk,mistweaver,8,2,6
19304,Jooshy,tichondrius,192,monk,mistweaver,12,2,10
19305,Mung,boulderfist,192,monk,mistweaver,12,2,10
19306,Kick,dragonmaw,192,monk,mistweaver,12,2,10
19307,Whynotec,tichondrius,192,monk,mistweaver,12,2,10
19308,Ðetroitsmash,sargeras,192,monk,mistweaver,12,2,10
19309,Missmagda,darkspear,192,monk,mistweaver,12,2,10
19310,Hellcow,frostmourne,192,monk,mistweaver,12,2,10
19311,Bubblekit,nerzhul,192,monk,mistweaver,12,2,10
19312,Tacoma,sargeras,192,monk,mistweaver,12,2,10
19313,Ixport,moon-guard,192,monk,mistweaver,12,2,10
19314,Monkik,laughing-skull,192,monk,mistweaver,12,2,10
19315,Sanytea,sargeras,192,monk,mistweaver,12,2,10
19316,Chuggernaut,illidan,192,monk,mistweaver,15,2,13
19317,Fatde,daggerspine,192,monk,mistweaver,18,2,16
19318,Senzmist,lightbringer,191,monk,mistweaver,6,2,4
19319,Jeme,tichondrius,191,monk,mistweaver,6,2,4
19320,Realisthands,barthilas,191,monk,mistweaver,6,2,4
19321,Honestworkz,area-52,191,monk,mistweaver,6,2,4
19322,Rorik,deathwing,191,monk,mistweaver,12,2,10
19323,Varlena,wyrmrest-accord,180,monk,mistweaver,15,6,9
19324,Phystweaver,malganis,175,monk,mistweaver,11,2,9
19325,Hyugga,azralon,159,monk,mistweaver,5,2,3
19326,Craziediemon,malganis,138,monk,mistweaver,8,3,5
19327,ßøøstêðçhåñ,illidan,138,monk,mistweaver,9,3,6
19328,Fijiwater,stormrage,138,monk,mistweaver,9,3,6
19329,Vyostao,ragnaros,138,monk,mistweaver,11,3,8
19330,Averagéjoe,tichondrius,127,monk,mistweaver,8,2,6
19331,Charrek,zuljin,96,monk,mistweaver,6,1,5
19332,Notthefather,area-52,96,monk,mistweaver,6,1,5
19333,Mënmä,ragnaros,96,monk,mistweaver,6,1,5
19334,Kaÿñ,area-52,96,monk,mistweaver,6,1,5
19335,Fatboyswag,tichondrius,96,monk,mistweaver,6,1,5
19336,Kiawe,zuljin,96,monk,mistweaver,6,1,5
19337,Samaera,uther,96,monk,mistweaver,6,1,5
19338,Danicah,altar-of-storms,96,monk,mistweaver,6,1,5
19339,Kimmyfists,tichondrius,96,monk,mistweaver,6,1,5
19340,Ünarù,area-52,96,monk,mistweaver,6,1,5
19341,Yunei,tichondrius,96,monk,mistweaver,6,1,5
19342,Súprä,stormrage,96,monk,mistweaver,6,1,5
19343,Brewtalìty,tichondrius,96,monk,mistweaver,6,1,5
19344,Naveex,bleeding-hollow,96,monk,mistweaver,6,1,5
19345,Ogmonk,skullcrusher,96,monk,mistweaver,6,1,5
19346,Farmerstan,sargeras,96,monk,mistweaver,6,1,5
19347,Lomist,nazjatar,96,monk,mistweaver,6,1,5
19348,Zrza,tichondrius,96,monk,mistweaver,6,1,5
19349,Voodubrew,area-52,96,monk,mistweaver,6,1,5
19350,Ezpzmonk,bloodscalp,96,monk,mistweaver,6,1,5
19351,Raylá,kelthuzad,96,monk,mistweaver,6,1,5
19352,Monkuxe,zuljin,96,monk,mistweaver,6,1,5
19353,Hedgefrogs,stormrage,96,monk,mistweaver,6,1,5
19354,Frankènmonk,illidan,96,monk,mistweaver,6,1,5
19355,Stickyloads,illidan,96,monk,mistweaver,6,1,5
19356,Ruion,moon-guard,96,monk,mistweaver,6,1,5
19357,Rockfu,illidan,96,monk,mistweaver,6,1,5
19358,Shrimptown,dalaran,96,monk,mistweaver,6,1,5
19359,Onegai,illidan,96,monk,mistweaver,6,1,5
19360,Daeio,burning-legion,96,monk,mistweaver,6,1,5
19361,Lainerya,moon-guard,96,monk,mistweaver,6,1,5
19362,Kenvuki,emerald-dream,96,monk,mistweaver,6,1,5
19363,Kungfucheeks,illidan,96,monk,mistweaver,6,1,5
19364,Turkeydinner,frostmourne,96,monk,mistweaver,6,1,5
19365,Findorato,windrunner,96,monk,mistweaver,6,1,5
19366,Dankestkhan,korialstrasz,96,monk,mistweaver,6,1,5
19367,Froggie,illidan,96,monk,mistweaver,6,1,5
19368,Jamesboong,illidan,96,monk,mistweaver,6,1,5
19369,Squidbillie,moon-guard,96,monk,mistweaver,6,1,5
19370,Kayakpunch,moon-guard,96,monk,mistweaver,6,1,5
19371,Faméd,stormrage,96,monk,mistweaver,8,1,7
19372,Ghostsofur,tichondrius,96,monk,mistweaver,12,1,11
19373,Nornangus,sargeras,96,monk,mistweaver,12,1,11
19374,Eliwenn,ragnaros,96,monk,mistweaver,12,1,11
19375,Zenmidget,kelthuzad,96,monk,mistweaver,12,1,11
19376,Selectra,malfurion,95,monk,mistweaver,6,1,5
19377,Sputnîk,nemesis,84,monk,mistweaver,16,6,10
19378,Excitable,moon-guard,84,monk,mistweaver,11,4,7
19379,Fairymonk,frostwolf,79,monk,mistweaver,5,1,4
19380,Clixstermonk,area-52,79,monk,mistweaver,5,1,4
19381,Thalreyzian,vashj,64,monk,mistweaver,4,1,3
19382,Majinyooshi,kelthuzad,64,monk,mistweaver,4,1,3
19383,Deethnutth,bleeding-hollow,63,monk,mistweaver,2,2,0
19384,Mindengo,sargeras,42,monk,mistweaver,9,3,6
19385,Fumoo,sargeras,42,monk,mistweaver,10,3,7
19386,Sivedrafely,arthas,42,monk,mistweaver,17,2,15
19387,Epucphail,kelthuzad,1221,monk,brewmaster,78,33,45
19388,Worldpvp,nerzhul,1049,monk,brewmaster,33,12,21
19389,Omgar,frostmourne,1046,monk,brewmaster,44,17,27
19390,Daesun,quelthalas,672,monk,brewmaster,12,7,5
19391,Morpheous,whisperwind,383,monk,brewmaster,6,4,2
19392,Doughboy,skullcrusher,383,monk,brewmaster,12,4,8
19393,Robbo,tichondrius,288,monk,brewmaster,6,3,3
19394,Quaria,moon-guard,288,monk,brewmaster,18,3,15
19395,Rín,dalaran,192,monk,brewmaster,6,2,4
19396,Drunkfight,zuljin,192,monk,brewmaster,18,2,16
19397,Encry,zuljin,191,monk,brewmaster,6,2,4
19398,Ferrarí,quelthalas,79,monk,brewmaster,11,1,10
19399,Iminglee,area-52,2280,monk,windwalker,106,57,49
19400,Neighbors,sargeras,2265,monk,windwalker,103,58,45
19401,Keyam,illidan,2208,monk,windwalker,101,54,47
19402,Yerky,stormrage,2151,monk,windwalker,77,44,33
19403,Sean,nazjatar,2143,monk,windwalker,72,38,34
19404,Senseiww,sargeras,2143,monk,windwalker,126,64,62
19405,Pacmankr,tichondrius,2135,monk,windwalker,153,80,73
19406,Thewy,tichondrius,2132,monk,windwalker,108,55,53
19407,Fueld,burning-legion,2130,monk,windwalker,306,157,149
19408,Droguex,tichondrius,2128,monk,windwalker,222,111,111
19409,Cmx,sargeras,2125,monk,windwalker,172,88,84
19410,Judo,agamaggan,2123,monk,windwalker,81,43,38
19411,Primez,frostmourne,2115,monk,windwalker,71,40,31
19412,Riversøng,frostmourne,2115,monk,windwalker,84,46,38
19413,Flattsww,tichondrius,2111,monk,windwalker,274,140,134
19414,Stárset,illidan,2104,monk,windwalker,96,54,42
19415,Iílílílílílí,area-52,2101,monk,windwalker,84,43,41
19416,Catgallery,tichondrius,2100,monk,windwalker,203,105,98
19417,Homun,tichondrius,2071,monk,windwalker,83,43,40
19418,Fatal,bonechewer,2059,monk,windwalker,118,65,53
19419,Rickybobbyx,vashj,2057,monk,windwalker,113,56,57
19420,Chyx,tichondrius,2035,monk,windwalker,76,37,39
19421,Liamllama,barthilas,2023,monk,windwalker,164,86,78
19422,Hypnøtìze,frostmourne,2019,monk,windwalker,143,76,67
19423,Fínzy,tichondrius,2017,monk,windwalker,167,88,79
19424,Nehji,illidan,2008,monk,windwalker,99,52,47
19425,Blackpandax,tichondrius,2008,monk,windwalker,107,55,52
19426,Larryjonés,area-52,2003,monk,windwalker,161,80,81
19427,Rytes,moon-guard,1993,monk,windwalker,159,83,76
19428,Touchofdeáth,stormrage,1989,monk,windwalker,137,76,61
19429,Baddi,uldum,1984,monk,windwalker,124,66,58
19430,Cuteirl,tichondrius,1970,monk,windwalker,84,53,31
19431,Lodbork,tichondrius,1970,monk,windwalker,371,193,178
19432,Spotifyfan,ysera,1966,monk,windwalker,159,87,72
19433,Crashandflow,zuljin,1961,monk,windwalker,60,33,27
19434,Shïvïr,azralon,1961,monk,windwalker,147,77,70
19435,Mikephoenix,tichondrius,1956,monk,windwalker,42,26,16
19436,Bdw,tichondrius,1955,monk,windwalker,142,84,58
19437,Bigherosixx,tichondrius,1941,monk,windwalker,66,36,30
19438,Chopt,zuljin,1940,monk,windwalker,78,36,42
19439,Repbrew,sargeras,1934,monk,windwalker,81,40,41
19440,Vybïn,tichondrius,1932,monk,windwalker,264,135,129
19441,Wondý,quelthalas,1931,monk,windwalker,173,86,87
19442,Frootsmoothi,thrall,1929,monk,windwalker,77,38,39
19443,Madtiger,scilla,1928,monk,windwalker,102,50,52
19444,Wwlékinhø,azralon,1924,monk,windwalker,54,33,21
19445,Sínsayer,tichondrius,1920,monk,windwalker,78,34,44
19446,Serthean,illidan,1919,monk,windwalker,158,81,77
19447,Marçi,moon-guard,1917,monk,windwalker,85,41,44
19448,Edenx,sargeras,1906,monk,windwalker,48,27,21
19449,Dzq,stormrage,1906,monk,windwalker,87,48,39
19450,Weathermanxv,kelthuzad,1896,monk,windwalker,123,56,67
19451,Xanaxåddict,sargeras,1893,monk,windwalker,179,94,85
19452,Threnody,malganis,1891,monk,windwalker,82,39,43
19453,Maozhën,tichondrius,1882,monk,windwalker,60,31,29
19454,Jaxvisto,dalaran,1868,monk,windwalker,101,51,50
19455,Screwz,tichondrius,1867,monk,windwalker,67,33,34
19456,Artam,thrall,1859,monk,windwalker,65,40,25
19457,Torkscrew,bleeding-hollow,1850,monk,windwalker,36,21,15
19458,Syerzie,dalaran,1849,monk,windwalker,81,40,41
19459,Guylian,tichondrius,1845,monk,windwalker,58,30,28
19460,Tschi,illidan,1844,monk,windwalker,42,29,13
19461,Helvectius,tichondrius,1843,monk,windwalker,192,90,102
19462,Smokechief,hyjal,1841,monk,windwalker,48,27,21
19463,Züdo,area-52,1841,monk,windwalker,105,55,50
19464,Omnly,stormrage,1841,monk,windwalker,50,26,24
19465,Allmight,wyrmrest-accord,1839,monk,windwalker,105,58,47
19466,Absurd,mannoroth,1836,monk,windwalker,33,21,12
19467,Kuranchi,sargeras,1836,monk,windwalker,42,23,19
19468,Sunfistway,sargeras,1835,monk,windwalker,80,48,32
19469,Karmerr,proudmoore,1835,monk,windwalker,66,35,31
19470,Yuujitsu,sargeras,1827,monk,windwalker,114,59,55
19471,Monkatron,arthas,1827,monk,windwalker,101,52,49
19472,Lopez,sargeras,1825,monk,windwalker,54,35,19
19473,Nelariah,wyrmrest-accord,1822,monk,windwalker,59,28,31
19474,Sylash,ragnaros,1821,monk,windwalker,36,21,15
19475,Sentomaru,bleeding-hollow,1820,monk,windwalker,66,33,33
19476,Inbu,tichondrius,1820,monk,windwalker,87,39,48
19477,Fátë,tichondrius,1819,monk,windwalker,96,42,54
19478,Micai,thrall,1813,monk,windwalker,42,25,17
19479,Jamut,stormrage,1812,monk,windwalker,54,23,31
19480,Turbofist,bleeding-hollow,1803,monk,windwalker,42,25,17
19481,Vai,korgath,1801,monk,windwalker,82,43,39
19482,Accidntprone,zangarmarsh,1801,monk,windwalker,54,28,26
19483,Muhli,kiljaeden,1800,monk,windwalker,42,22,20
19484,Conngaline,stormreaver,1794,monk,windwalker,281,136,145
19485,Brewceo,area-52,1787,monk,windwalker,66,34,32
19486,Lahri,silvermoon,1786,monk,windwalker,68,41,27
19487,Alps,darkspear,1780,monk,windwalker,48,24,24
19488,Unhappyclown,tichondrius,1776,monk,windwalker,125,70,55
19489,Rockyßalboa,sargeras,1774,monk,windwalker,85,50,35
19490,Zionk,tichondrius,1768,monk,windwalker,96,68,28
19491,Monkgyatso,drakthul,1761,monk,windwalker,114,60,54
19492,Tristantwo,sargeras,1761,monk,windwalker,96,47,49
19493,Furiamvp,stormrage,1759,monk,windwalker,48,26,22
19494,Haharetsdead,illidan,1758,monk,windwalker,125,71,54
19495,Jümmy,area-52,1757,monk,windwalker,54,26,28
19496,Jåðëðrägøñ,sargeras,1745,monk,windwalker,61,36,25
19497,Kagebunshin,kelthuzad,1744,monk,windwalker,42,25,17
19498,Bruceteå,area-52,1744,monk,windwalker,36,19,17
19499,Zynflex,tichondrius,1743,monk,windwalker,59,27,32
19500,Lker,sargeras,1740,monk,windwalker,60,31,29
19501,Snebyos,tichondrius,1739,monk,windwalker,72,43,29
19502,Pandagirlw,tichondrius,1735,monk,windwalker,72,43,29
19503,Ambal,hellscream,1734,monk,windwalker,55,32,23
19504,Kárma,malganis,1731,monk,windwalker,42,24,18
19505,Robbo,tichondrius,1730,monk,windwalker,54,25,29
19506,Gigached,zuljin,1730,monk,windwalker,63,28,35
19507,Jasey,area-52,1729,monk,windwalker,29,21,8
19508,Jükedx,stormrage,1728,monk,windwalker,91,54,37
19509,Mechamonk,aerie-peak,1728,monk,windwalker,105,46,59
19510,Raphåel,area-52,1722,monk,windwalker,35,18,17
19511,Percentx,tichondrius,1722,monk,windwalker,36,18,18
19512,Khawai,sargeras,1720,monk,windwalker,36,23,13
19513,Boostedww,bloodscalp,1720,monk,windwalker,48,25,23
19514,Lhiri,moon-guard,1718,monk,windwalker,48,22,26
19515,Takkeya,zuljin,1713,monk,windwalker,42,25,17
19516,Zenluckydo,grizzly-hills,1712,monk,windwalker,71,41,30
19517,Orkmonk,tichondrius,1708,monk,windwalker,42,28,14
19518,Tenooki,illidan,1707,monk,windwalker,41,19,22
19519,Tippytap,bleeding-hollow,1707,monk,windwalker,54,23,31
19520,Setback,tichondrius,1706,monk,windwalker,24,18,6
19521,Hiurge,tichondrius,1706,monk,windwalker,36,21,15
19522,Tôpsônworld,tichondrius,1700,monk,windwalker,66,39,27
19523,Titanus,chogall,1700,monk,windwalker,343,177,166
19524,Pankekz,tichondrius,1698,monk,windwalker,132,69,63
19525,Wolffangfist,sargeras,1695,monk,windwalker,75,45,30
19526,Daracus,kelthuzad,1694,monk,windwalker,38,24,14
19527,Napbox,bleeding-hollow,1694,monk,windwalker,92,44,48
19528,Shírÿu,azralon,1691,monk,windwalker,41,24,17
19529,Maomaogun,tichondrius,1687,monk,windwalker,30,23,7
19530,Bamron,fizzcrank,1686,monk,windwalker,101,52,49
19531,Shids,barthilas,1686,monk,windwalker,47,22,25
19532,Watercowz,tichondrius,1684,monk,windwalker,24,18,6
19533,Thåi,anubarak,1682,monk,windwalker,48,19,29
19534,Vanmonk,eonar,1681,monk,windwalker,36,18,18
19535,Ghooch,illidan,1676,monk,windwalker,48,27,21
19536,Zhoku,tichondrius,1674,monk,windwalker,30,19,11
19537,Jdanîel,ragnaros,1671,monk,windwalker,42,21,21
19538,Zenigma,area-52,1670,monk,windwalker,45,24,21
19539,Dea,thrall,1670,monk,windwalker,84,43,41
19540,Rakije,barthilas,1669,monk,windwalker,66,40,26
19541,Bigpoppap,tichondrius,1668,monk,windwalker,54,29,25
19542,Madtigon,scilla,1668,monk,windwalker,42,22,20
19543,Hèllòkîttý,illidan,1666,monk,windwalker,30,19,11
19544,Hæt,stormrage,1665,monk,windwalker,48,23,25
19545,Rigi,stormrage,1661,monk,windwalker,95,43,52
19546,Bussÿ,area-52,1659,monk,windwalker,43,25,18
19547,Hotwatertank,area-52,1658,monk,windwalker,48,29,19
19548,Thuyvan,barthilas,1657,monk,windwalker,42,23,19
19549,Adamthemonk,proudmoore,1654,monk,windwalker,39,26,13
19550,Rockxtv,illidan,1651,monk,windwalker,42,18,24
19551,Phistea,area-52,1648,monk,windwalker,36,19,17
19552,Dumplíngs,emerald-dream,1647,monk,windwalker,59,27,32
19553,Bearface,blades-edge,1646,monk,windwalker,82,33,49
19554,Capiirotta,nemesis,1645,monk,windwalker,104,61,43
19555,Mists,velen,1645,monk,windwalker,54,31,23
19556,Oxli,emerald-dream,1645,monk,windwalker,46,26,20
19557,Ludanford,eitrigg,1643,monk,windwalker,48,22,26
19558,Öñlýfåñs,tichondrius,1642,monk,windwalker,35,20,15
19559,Foxchik,zuljin,1641,monk,windwalker,76,42,34
19560,Sonsia,arthas,1639,monk,windwalker,94,56,38
19561,Galaxystrike,illidan,1638,monk,windwalker,36,20,16
19562,Akumà,tichondrius,1636,monk,windwalker,48,19,29
19563,Lidä,tichondrius,1636,monk,windwalker,48,18,30
19564,Jaspier,quelthalas,1633,monk,windwalker,48,24,24
19565,Ranchy,zuljin,1631,monk,windwalker,78,41,37
19566,Kungpóa,sargeras,1628,monk,windwalker,39,23,16
19567,Senritsuh,drakkari,1625,monk,windwalker,40,18,22
19568,Ddoongmonk,tichondrius,1625,monk,windwalker,48,21,27
19569,Plucky,tichondrius,1624,monk,windwalker,37,18,19
19570,Tnsnow,illidan,1623,monk,windwalker,36,21,15
19571,Saucyfists,silvermoon,1622,monk,windwalker,48,26,22
19572,Fistyuh,illidan,1621,monk,windwalker,30,20,10
19573,Fuqmeh,darkspear,1621,monk,windwalker,84,42,42
19574,Jigong,bleeding-hollow,1620,monk,windwalker,42,23,19
19575,Karelio,wyrmrest-accord,1619,monk,windwalker,48,22,26
19576,Aidenww,area-52,1618,monk,windwalker,24,17,7
19577,Jerax,thunderlord,1617,monk,windwalker,97,55,42
19578,Fimeu,kiljaeden,1617,monk,windwalker,54,28,26
19579,Corsan,illidan,1616,monk,windwalker,42,30,12
19580,Hadoukeñ,thrall,1616,monk,windwalker,41,22,19
19581,Jbills,muradin,1615,monk,windwalker,71,41,30
19582,Singao,malganis,1614,monk,windwalker,38,21,17
19583,Zeati,tichondrius,1613,monk,windwalker,24,17,7
19584,Azizyzz,barthilas,1613,monk,windwalker,30,20,10
19585,Euman,sargeras,1613,monk,windwalker,36,21,15
19586,Shaszx,zuljin,1613,monk,windwalker,41,22,19
19587,Themanski,area-52,1612,monk,windwalker,46,24,22
19588,Cpapi,sargeras,1612,monk,windwalker,60,30,30
19589,Fapmonk,illidan,1611,monk,windwalker,59,39,20
19590,Xradu,dawnbringer,1611,monk,windwalker,66,41,25
19591,Mastâ,kelthuzad,1610,monk,windwalker,98,50,48
19592,Fistnu,aggramar,1608,monk,windwalker,83,49,34
19593,Bakedmonk,smolderthorn,1608,monk,windwalker,46,22,24
19594,Windmónk,tichondrius,1606,monk,windwalker,120,56,64
19595,Shisama,area-52,1605,monk,windwalker,24,17,7
19596,Daeio,burning-legion,1605,monk,windwalker,31,19,12
19597,Rennafgc,stormrage,1605,monk,windwalker,36,20,16
19598,Flyingfury,illidan,1604,monk,windwalker,54,25,29
19599,Chongzly,frostmourne,1602,monk,windwalker,54,28,26
19600,Hím,garrosh,1601,monk,windwalker,70,43,27
19601,Bruhmesoftly,thrall,1601,monk,windwalker,60,34,26
19602,Pepeloser,illidan,1601,monk,windwalker,48,23,25
19603,Ronk,the-forgotten-coast,1600,monk,windwalker,30,17,13
19604,Dirtypunch,proudmoore,1598,monk,windwalker,42,19,23
19605,Windwalker,blackhand,1597,monk,windwalker,35,19,16
19606,Mitras,dragonblight,1594,monk,windwalker,30,19,11
19607,Lingerer,aerie-peak,1593,monk,windwalker,110,57,53
19608,Marcusm,bleeding-hollow,1592,monk,windwalker,33,20,13
19609,Surgarush,moon-guard,1592,monk,windwalker,106,64,42
19610,Druta,illidan,1589,monk,windwalker,42,32,10
19611,Xas,sentinels,1585,monk,windwalker,36,19,17
19612,Reprap,elune,1582,monk,windwalker,58,33,25
19613,Kogoli,frostwolf,1580,monk,windwalker,101,47,54
19614,Råii,sargeras,1579,monk,windwalker,30,20,10
19615,Wonderx,darkspear,1579,monk,windwalker,30,20,10
19616,Toyotatacoma,bleeding-hollow,1578,monk,windwalker,36,23,13
19617,Copenfist,black-dragonflight,1578,monk,windwalker,36,21,15
19618,Yogiji,proudmoore,1577,monk,windwalker,36,20,16
19619,Mhmmzz,sargeras,1575,monk,windwalker,36,17,19
19620,Xìðñ,moon-guard,1574,monk,windwalker,66,44,22
19621,Pinot,dragonmaw,1572,monk,windwalker,42,17,25
19622,Panduh,moon-guard,1568,monk,windwalker,78,40,38
19623,Meatwrap,mugthol,1566,monk,windwalker,52,26,26
19624,Ehdunno,kelthuzad,1560,monk,windwalker,38,22,16
19625,Banyasong,tichondrius,1555,monk,windwalker,102,57,45
19626,Kómugi,area-52,1554,monk,windwalker,131,70,61
19627,Gøgeta,stormrage,1554,monk,windwalker,119,58,61
19628,Altaidm,ragnaros,1554,monk,windwalker,42,17,25
19629,Dïsturbedtko,azralon,1552,monk,windwalker,120,58,62
19630,Fistnafurry,tichondrius,1550,monk,windwalker,42,21,21
19631,Chucksandmk,barthilas,1548,monk,windwalker,54,25,29
19632,Nagato,nemesis,1545,monk,windwalker,23,17,6
19633,Borekkar,emerald-dream,1544,monk,windwalker,41,22,19
19634,Chingu,ragnaros,1543,monk,windwalker,123,59,64
19635,Therapeutics,moon-guard,1543,monk,windwalker,102,47,55
19636,Healzpapi,tichondrius,1541,monk,windwalker,84,55,29
19637,Pokinpooters,stormrage,1536,monk,windwalker,129,65,64
19638,Xyän,bleeding-hollow,1534,monk,windwalker,30,16,14
19639,Katsübooy,azralon,1534,monk,windwalker,273,142,131
19640,Çraßsßùrgêr,bonechewer,1533,monk,windwalker,24,16,8
19641,Zaabuza,azralon,1528,monk,windwalker,60,39,21
19642,Drakfu,tichondrius,1527,monk,windwalker,45,26,19
19643,Brewbaker,hyjal,1527,monk,windwalker,74,41,33
19644,Napoleonic,vashj,1524,monk,windwalker,30,20,10
19645,Peacefulpaco,malganis,1524,monk,windwalker,36,19,17
19646,Hagano,drakkari,1523,monk,windwalker,107,55,52
19647,Muritors,ragnaros,1523,monk,windwalker,36,17,19
19648,Byakugun,wyrmrest-accord,1522,monk,windwalker,36,21,15
19649,Naagg,tichondrius,1521,monk,windwalker,30,16,14
19650,Yoshifistsu,malganis,1521,monk,windwalker,54,26,28
19651,Odogin,tichondrius,1520,monk,windwalker,65,42,23
19652,Göllyjee,tichondrius,1517,monk,windwalker,84,36,48
19653,Bløødÿ,ragnaros,1516,monk,windwalker,21,17,4
19654,Wartenja,frostmourne,1516,monk,windwalker,84,41,43
19655,Kutz,proudmoore,1512,monk,windwalker,81,40,41
19656,Unlike,tichondrius,1510,monk,windwalker,96,44,52
19657,Odi,stonemaul,1509,monk,windwalker,101,48,53
19658,Sgarbossa,tortheldrin,1509,monk,windwalker,42,16,26
19659,Dabzin,stormrage,1508,monk,windwalker,79,41,38
19660,Arizøna,illidan,1507,monk,windwalker,80,44,36
19661,Shishosenin,quelthalas,1507,monk,windwalker,182,88,94
19662,Hòlygòd,dalaran,1505,monk,windwalker,64,33,31
19663,Geekweek,frostmourne,1503,monk,windwalker,30,17,13
19664,Npepper,khadgar,1503,monk,windwalker,52,23,29
19665,Daddyrugburn,area-52,1502,monk,windwalker,77,38,39
19666,Varn,frostmourne,1500,monk,windwalker,95,46,49
19667,ßlesséd,tichondrius,1497,monk,windwalker,54,22,32
19668,Ascilica,firetree,1495,monk,windwalker,24,16,8
19669,Tigerstrikes,sargeras,1494,monk,windwalker,30,19,11
19670,Harde,thrall,1492,monk,windwalker,65,29,36
19671,Rocketfist,bleeding-hollow,1487,monk,windwalker,66,32,34
19672,Simonb,tichondrius,1487,monk,windwalker,54,24,30
19673,Rockemsockem,gorefiend,1485,monk,windwalker,90,48,42
19674,Kiulang,kelthuzad,1483,monk,windwalker,93,44,49
19675,Nject,malganis,1479,monk,windwalker,36,23,13
19676,Aubiemonk,malygos,1479,monk,windwalker,30,16,14
19677,Broomooster,bleeding-hollow,1479,monk,windwalker,47,20,27
19678,Sivedrafely,arthas,1475,monk,windwalker,60,30,30
19679,Ökami,tichondrius,1473,monk,windwalker,48,24,24
19680,Shôckley,tichondrius,1468,monk,windwalker,105,54,51
19681,Ohgiddyttv,dalaran,1466,monk,windwalker,77,40,37
19682,Jegann,tichondrius,1463,monk,windwalker,110,51,59
19683,Tyroneßanks,stormrage,1457,monk,windwalker,36,20,16
19684,Mastahp,tichondrius,1457,monk,windwalker,42,23,19
19685,Killmachine,farstriders,1454,monk,windwalker,144,72,72
19686,Showshoway,tichondrius,1450,monk,windwalker,59,26,33
19687,PlayerHHQLNK,moon-guard,1448,monk,windwalker,60,30,30
19688,Lickthefist,sargeras,1445,monk,windwalker,24,16,8
19689,Mikeyx,area-52,1439,monk,windwalker,24,15,9
19690,Ahrk,emerald-dream,1439,monk,windwalker,58,20,38
19691,Kawasakii,tichondrius,1438,monk,windwalker,148,76,72
19692,Lavinci,area-52,1437,monk,windwalker,30,15,15
19693,Rocketfrogg,bleeding-hollow,1434,monk,windwalker,36,15,21
19694,Duhäst,sargeras,1433,monk,windwalker,24,15,9
19695,Fistys,area-52,1433,monk,windwalker,117,60,57
19696,Izu,senjin,1433,monk,windwalker,30,15,15
19697,Heiwei,stormrage,1432,monk,windwalker,24,15,9
19698,Elfoverde,stormrage,1430,monk,windwalker,24,15,9
19699,Xølik,draenor,1429,monk,windwalker,24,15,9
19700,Xuenws,tichondrius,1429,monk,windwalker,24,15,9
19701,Yamoshì,stormrage,1425,monk,windwalker,48,25,23
19702,Domiik,ragnaros,1421,monk,windwalker,30,15,15
19703,Wind,misha,1419,monk,windwalker,49,31,18
19704,Miýagi,sargeras,1419,monk,windwalker,24,15,9
19705,Dazzler,ragnaros,1419,monk,windwalker,66,35,31
19706,Convectuoso,illidan,1414,monk,windwalker,24,15,9
19707,Sleýin,tichondrius,1412,monk,windwalker,112,59,53
19708,Daslow,quelthalas,1412,monk,windwalker,146,75,71
19709,Gesir,tichondrius,1408,monk,windwalker,30,15,15
19710,Butjaum,stormrage,1407,monk,windwalker,58,26,32
19711,Smoothboxing,tichondrius,1405,monk,windwalker,110,62,48
19712,Sodamint,sargeras,1403,monk,windwalker,44,16,28
19713,Creonus,proudmoore,1400,monk,windwalker,56,24,32
19714,Bunnygal,thaurissan,1396,monk,windwalker,38,16,22
19715,Bhodie,zuljin,1395,monk,windwalker,53,20,33
19716,Milkychi,frostmourne,1392,monk,windwalker,40,15,25
19717,Eavale,destromath,1391,monk,windwalker,71,37,34
19718,Tacofox,tichondrius,1391,monk,windwalker,66,32,34
19719,Shlumpuh,tichondrius,1385,monk,windwalker,42,18,24
19720,Onepunchman,quelthalas,1384,monk,windwalker,39,16,23
19721,Backfliptime,ragnaros,1383,monk,windwalker,34,19,15
19722,Callae,dreadmaul,1383,monk,windwalker,36,17,19
19723,Gún,ragnaros,1381,monk,windwalker,83,41,42
19724,Pepepunch,bleeding-hollow,1381,monk,windwalker,36,15,21
19725,Astrofu,tichondrius,1373,monk,windwalker,64,26,38
19726,Bradyfour,moon-guard,1372,monk,windwalker,65,33,32
19727,Brewmaker,sargeras,1372,monk,windwalker,46,22,24
19728,Shianjuo,ragnaros,1372,monk,windwalker,42,20,22
19729,Sarious,lightbringer,1368,monk,windwalker,172,91,81
19730,Kungxxl,kiljaeden,1368,monk,windwalker,73,37,36
19731,Tassmonk,hyjal,1367,monk,windwalker,36,17,19
19732,Rïggen,thrall,1360,monk,windwalker,23,15,8
19733,Dakenprime,tichondrius,1359,monk,windwalker,58,28,30
19734,Screwballz,blackrock,1354,monk,windwalker,75,32,43
19735,Kriticalkush,kelthuzad,1353,monk,windwalker,24,17,7
19736,Owned,dreadmaul,1349,monk,windwalker,36,23,13
19737,Sultanofwind,malganis,1344,monk,windwalker,24,14,10
19738,Nyofu,moon-guard,1343,monk,windwalker,24,14,10
19739,Hîddènsõündx,tichondrius,1343,monk,windwalker,30,14,16
19740,Zuì,sargeras,1342,monk,windwalker,24,14,10
19741,Garmakasmonk,skullcrusher,1341,monk,windwalker,34,19,15
19742,Bluntdoctor,stormreaver,1340,monk,windwalker,66,24,42
19743,Facekandy,tichondrius,1338,monk,windwalker,28,15,13
19744,Sterow,kiljaeden,1338,monk,windwalker,30,14,16
19745,Skymonge,stormrage,1338,monk,windwalker,104,48,56
19746,Tingum,kelthuzad,1337,monk,windwalker,34,15,19
19747,Ghaelessi,senjin,1336,monk,windwalker,77,42,35
19748,Novoctek,quelthalas,1336,monk,windwalker,30,14,16
19749,Feelsogöod,tichondrius,1332,monk,windwalker,28,15,13
19750,Jdkick,sargeras,1331,monk,windwalker,36,14,22
19751,Resolver,stormscale,1327,monk,windwalker,46,24,22
19752,Trapeez,kelthuzad,1326,monk,windwalker,58,32,26
19753,Saltystepbro,illidan,1323,monk,windwalker,24,14,10
19754,Omimonk,sargeras,1314,monk,windwalker,24,14,10
19755,Acharä,tichondrius,1305,monk,windwalker,36,20,16
19756,Madbuffz,nemesis,1305,monk,windwalker,60,26,34
19757,Goonkeg,frostmourne,1304,monk,windwalker,30,14,16
19758,Xøxo,trollbane,1303,monk,windwalker,30,15,15
19759,Sedition,emerald-dream,1299,monk,windwalker,88,45,43
19760,Xiaowën,nemesis,1298,monk,windwalker,57,28,29
19761,Tino,kelthuzad,1295,monk,windwalker,66,35,31
19762,Slapstun,barthilas,1295,monk,windwalker,48,18,30
19763,Jacquelline,moon-guard,1294,monk,windwalker,36,19,17
19764,Anarska,thrall,1291,monk,windwalker,96,46,50
19765,Dodried,ragnaros,1290,monk,windwalker,52,24,28
19766,Yrn,crushridge,1287,monk,windwalker,60,32,28
19767,Fanetö,stormrage,1283,monk,windwalker,48,15,33
19768,Wutangkillaß,kiljaeden,1266,monk,windwalker,48,18,30
19769,Okoh,wyrmrest-accord,1264,monk,windwalker,26,15,11
19770,Weezzyboi,tichondrius,1263,monk,windwalker,42,22,20
19771,Natus,greymane,1262,monk,windwalker,36,18,18
19772,Kungfüsed,stormrage,1260,monk,windwalker,24,14,10
19773,Udderpunch,barthilas,1259,monk,windwalker,25,14,11
19774,Supremekick,frostmourne,1254,monk,windwalker,43,27,16
19775,Opmother,elune,1252,monk,windwalker,35,19,16
19776,Pangpoong,tichondrius,1249,monk,windwalker,99,44,55
19777,Djjackyd,stormrage,1247,monk,windwalker,24,13,11
19778,Hamyu,illidan,1247,monk,windwalker,30,15,15
19779,Baconbiscuit,area-52,1247,monk,windwalker,30,13,17
19780,Prostotak,area-52,1246,monk,windwalker,18,13,5
19781,Pamii,quelthalas,1246,monk,windwalker,36,13,23
19782,Båshkin,terenas,1245,monk,windwalker,42,19,23
19783,Bükki,ragnaros,1243,monk,windwalker,18,13,5
19784,Bowlbreak,sargeras,1243,monk,windwalker,36,20,16
19785,Nuclearpunch,tichondrius,1242,monk,windwalker,24,13,11
19786,Nightww,area-52,1241,monk,windwalker,24,13,11
19787,Tianhu,sargeras,1239,monk,windwalker,30,15,15
19788,Slapcîty,bleeding-hollow,1238,monk,windwalker,30,13,17
19789,Razielic,frostmourne,1233,monk,windwalker,48,21,27
19790,Zettelkasten,tichondrius,1232,monk,windwalker,72,35,37
19791,Ráchez,tichondrius,1231,monk,windwalker,22,14,8
19792,Finesse,frostwolf,1227,monk,windwalker,18,13,5
19793,Rbs,tichondrius,1226,monk,windwalker,54,17,37
19794,Ruckm,stormrage,1225,monk,windwalker,24,13,11
19795,Stickyloads,illidan,1220,monk,windwalker,72,33,39
19796,Highku,drenden,1219,monk,windwalker,24,14,10
19797,Gurda,wyrmrest-accord,1203,monk,windwalker,72,34,38
19798,Ofn,moon-guard,1202,monk,windwalker,96,45,51
19799,Xéia,area-52,1201,monk,windwalker,60,23,37
19800,Rufaso,sargeras,1199,monk,windwalker,54,24,30
19801,Akanq,tichondrius,1194,monk,windwalker,27,13,14
19802,Marstol,bleeding-hollow,1186,monk,windwalker,53,31,22
19803,Silvopanda,azralon,1185,monk,windwalker,107,55,52
19804,Hinakii,dalaran,1172,monk,windwalker,120,50,70
19805,Sleepÿ,area-52,1171,monk,windwalker,84,34,50
19806,Milktank,medivh,1167,monk,windwalker,69,40,29
19807,Mommysalamii,moon-guard,1167,monk,windwalker,25,13,12
19808,Moopdahoop,stormrage,1162,monk,windwalker,73,41,32
19809,Kandinarra,jubeithos,1156,monk,windwalker,52,28,24
19810,Leehofook,azshara,1154,monk,windwalker,66,30,36
19811,Linkya,daggerspine,1152,monk,windwalker,22,14,8
19812,Xedou,azralon,1151,monk,windwalker,18,12,6
19813,Soprà,zuljin,1151,monk,windwalker,24,12,12
19814,Alshee,nagrand,1151,monk,windwalker,27,13,14
19815,Hybrid,stormrage,1150,monk,windwalker,18,12,6
19816,Pikotaro,tichondrius,1150,monk,windwalker,24,12,12
19817,Antiherox,sargeras,1149,monk,windwalker,18,12,6
19818,Excalibrew,malganis,1149,monk,windwalker,24,12,12
19819,Allure,frostmourne,1147,monk,windwalker,24,12,12
19820,Phistycuffs,bleeding-hollow,1147,monk,windwalker,30,12,18
19821,Jajabelugeng,tichondrius,1144,monk,windwalker,18,12,6
19822,Anavara,drakkari,1144,monk,windwalker,36,18,18
19823,Tenshu,runetotem,1141,monk,windwalker,24,12,12
19824,Mechabre,stormrage,1140,monk,windwalker,18,12,6
19825,Delorenzi,hellscream,1137,monk,windwalker,24,12,12
19826,Chihad,stormrage,1135,monk,windwalker,18,12,6
19827,Kfpeeves,sargeras,1134,monk,windwalker,30,15,15
19828,Shinjiki,tichondrius,1134,monk,windwalker,29,12,17
19829,Bigxthaplug,moon-guard,1132,monk,windwalker,30,12,18
19830,Boldyr,sargeras,1128,monk,windwalker,24,12,12
19831,Shinaniganz,chogall,1128,monk,windwalker,42,17,25
19832,Stigzz,stormrage,1118,monk,windwalker,23,12,11
19833,Jimothydab,lightbringer,1117,monk,windwalker,23,12,11
19834,Gorton,lightbringer,1114,monk,windwalker,24,12,12
19835,Haco,malganis,1114,monk,windwalker,29,12,17
19836,Imonkalot,destromath,1111,monk,windwalker,55,23,32
19837,Lyfegiver,blackrock,1110,monk,windwalker,20,13,7
19838,Jinpo,lightninghoof,1110,monk,windwalker,60,32,28
19839,Loadedfries,frostmourne,1110,monk,windwalker,24,12,12
19840,Fitmonje,drakkari,1108,monk,windwalker,28,13,15
19841,Bonflur,quelthalas,1105,monk,windwalker,286,144,142
19842,Angerday,illidan,1097,monk,windwalker,30,12,18
19843,Tzidkiyahu,barthilas,1090,monk,windwalker,18,13,5
19844,Deadlyfist,stormrage,1089,monk,windwalker,47,19,28
19845,Astteell,proudmoore,1089,monk,windwalker,39,13,26
19846,Drektarz,area-52,1085,monk,windwalker,75,33,42
19847,Ojiin,wyrmrest-accord,1079,monk,windwalker,24,13,11
19848,Quanon,stormreaver,1071,monk,windwalker,33,14,19
19849,Calmpunchman,mannoroth,1070,monk,windwalker,25,12,13
19850,Veso,tichondrius,1056,monk,windwalker,12,11,1
19851,Yavaxye,stormrage,1056,monk,windwalker,24,11,13
19852,Abenobashi,malganis,1055,monk,windwalker,18,11,7
19853,Whitepandax,tichondrius,1055,monk,windwalker,18,11,7
19854,Hate,korialstrasz,1055,monk,windwalker,18,11,7
19855,Rubntug,zuljin,1055,monk,windwalker,18,11,7
19856,Kungfupurk,bleeding-hollow,1055,monk,windwalker,18,11,7
19857,Gaslighterr,tichondrius,1055,monk,windwalker,18,11,7
19858,Songokusan,thrall,1055,monk,windwalker,18,11,7
19859,Sockem,arthas,1055,monk,windwalker,24,11,13
19860,Powerfisterr,stormrage,1054,monk,windwalker,18,11,7
19861,Monkamax,tichondrius,1054,monk,windwalker,18,11,7
19862,Wimdrewk,quelthalas,1053,monk,windwalker,39,12,27
19863,Kristiana,aegwynn,1052,monk,windwalker,18,11,7
19864,Hira,zuljin,1052,monk,windwalker,30,11,19
19865,Píñg,area-52,1051,monk,windwalker,30,11,19
19866,Niked,tichondrius,1050,monk,windwalker,30,11,19
19867,Sandii,azralon,1049,monk,windwalker,51,29,22
19868,Whtnyhuston,sargeras,1049,monk,windwalker,24,11,13
19869,Chowlaos,coilfang,1048,monk,windwalker,18,11,7
19870,Senseî,altar-of-storms,1048,monk,windwalker,30,11,19
19871,Chaosrose,area-52,1044,monk,windwalker,18,11,7
19872,Lexivixi,khazgoroth,1044,monk,windwalker,24,12,12
19873,Tremonk,kelthuzad,1043,monk,windwalker,18,11,7
19874,Monkii,bonechewer,1041,monk,windwalker,21,14,7
19875,Jnx,emerald-dream,1038,monk,windwalker,24,11,13
19876,Arshavin,skullcrusher,1038,monk,windwalker,30,11,19
19877,Currycooker,tichondrius,1037,monk,windwalker,23,11,12
19878,Mcnipple,moonrunner,1036,monk,windwalker,18,11,7
19879,Shocclol,stormrage,1036,monk,windwalker,21,12,9
19880,Natintell,drakkari,1032,monk,windwalker,71,33,38
19881,Abboo,hyjal,1030,monk,windwalker,24,12,12
19882,Blackychan,scilla,1027,monk,windwalker,36,15,21
19883,Steenkk,tichondrius,1023,monk,windwalker,24,11,13
19884,Kuffy,kelthuzad,1021,monk,windwalker,17,11,6
19885,Sébástián,drakkari,1021,monk,windwalker,52,28,24
19886,Åsurã,stormrage,1021,monk,windwalker,34,11,23
19887,Leafondawind,boulderfist,1020,monk,windwalker,29,11,18
19888,Rosarìolover,stormrage,1008,monk,windwalker,36,18,18
19889,Averagewang,sargeras,1007,monk,windwalker,30,16,14
19890,Brewzllee,tichondrius,1000,monk,windwalker,66,34,32
19891,Fatde,daggerspine,991,monk,windwalker,47,27,20
19892,Rollsroycist,trollbane,974,monk,windwalker,43,24,19
19893,Tobearus,stormscale,974,monk,windwalker,29,13,16
19894,Fettywhopper,kaelthas,960,monk,windwalker,12,10,2
19895,Shadmtwo,tichondrius,960,monk,windwalker,12,10,2
19896,Aýre,ravencrest,960,monk,windwalker,12,10,2
19897,Bumbleechi,azralon,960,monk,windwalker,18,10,8
19898,Afrosamurai,thrall,960,monk,windwalker,18,10,8
19899,Telospateo,ragnaros,960,monk,windwalker,18,10,8
19900,Innerverse,tichondrius,960,monk,windwalker,18,10,8
19901,Kinkykyle,emerald-dream,960,monk,windwalker,24,10,14
19902,Dwarfmonk,tichondrius,960,monk,windwalker,24,10,14
19903,Lolqtxd,sargeras,960,monk,windwalker,24,10,14
19904,Tazermw,sargeras,959,monk,windwalker,12,10,2
19905,Quanyaozu,ragnaros,959,monk,windwalker,18,10,8
19906,Stendari,moon-guard,959,monk,windwalker,18,10,8
19907,Goldfornudez,area-52,959,monk,windwalker,18,10,8
19908,Gelgameks,eredar,959,monk,windwalker,24,10,14
19909,Squidie,tichondrius,959,monk,windwalker,30,10,20
19910,Thäiländiä,bleeding-hollow,958,monk,windwalker,30,18,12
19911,Mattyj,darkspear,958,monk,windwalker,24,10,14
19912,Sxywind,azgalor,957,monk,windwalker,18,10,8
19913,Mônkdunk,daggerspine,957,monk,windwalker,18,10,8
19914,Avz,azralon,957,monk,windwalker,24,10,14
19915,Skyvaan,barthilas,956,monk,windwalker,18,10,8
19916,Ezpzmonk,bloodscalp,956,monk,windwalker,21,11,10
19917,Thalreyzian,vashj,954,monk,windwalker,24,10,14
19918,Megatraun,tichondrius,953,monk,windwalker,18,10,8
19919,Alcaquito,goldrinn,950,monk,windwalker,18,10,8
19920,Chigang,deathwing,949,monk,windwalker,24,10,14
19921,Hehex,bleeding-hollow,943,monk,windwalker,23,10,13
19922,Madmint,illidan,941,monk,windwalker,23,11,12
19923,Mynamegeorge,area-52,941,monk,windwalker,40,17,23
19924,Lööpér,tichondrius,939,monk,windwalker,18,10,8
19925,Nutcrakerz,tichondrius,935,monk,windwalker,24,13,11
19926,Ryucko,azralon,933,monk,windwalker,18,10,8
19927,Mcwallets,moon-guard,933,monk,windwalker,78,33,45
19928,Captnmurphy,tichondrius,927,monk,windwalker,17,10,7
19929,Hylithia,proudmoore,923,monk,windwalker,18,10,8
19930,Metios,aggramar,916,monk,windwalker,29,10,19
19931,Ipmán,moon-guard,892,monk,windwalker,41,18,23
19932,Whizz,frostmane,879,monk,windwalker,19,10,9
19933,Veganbacon,mannoroth,875,monk,windwalker,14,10,4
19934,Rhyskrispiez,sargeras,864,monk,windwalker,12,9,3
19935,Peachcactus,sargeras,864,monk,windwalker,12,9,3
19936,Poormanx,illidan,864,monk,windwalker,12,9,3
19937,Gucchimane,illidan,864,monk,windwalker,12,9,3
19938,Reeperfist,area-52,864,monk,windwalker,12,9,3
19939,Danimalz,stormrage,864,monk,windwalker,12,9,3
19940,Garypool,emerald-dream,864,monk,windwalker,15,9,6
19941,Molta,tichondrius,864,monk,windwalker,18,9,9
19942,Jaige,illidan,864,monk,windwalker,18,9,9
19943,Tmjojo,tichondrius,864,monk,windwalker,24,9,15
19944,Chiang,chogall,864,monk,windwalker,24,9,15
19945,Lalpu,tichondrius,864,monk,windwalker,24,9,15
19946,Headsmasher,wyrmrest-accord,863,monk,windwalker,18,9,9
19947,Mannkin,zuluhed,863,monk,windwalker,18,9,9
19948,Azzmane,bronzebeard,863,monk,windwalker,18,9,9
19949,Stepsista,sargeras,863,monk,windwalker,18,9,9
19950,Helicopter,borean-tundra,863,monk,windwalker,18,9,9
19951,Röllup,area-52,863,monk,windwalker,18,9,9
19952,Kahpital,azralon,863,monk,windwalker,18,9,9
19953,Tomatosaucin,area-52,863,monk,windwalker,18,9,9
19954,Honkbazz,illidan,863,monk,windwalker,24,9,15
19955,Somethingre,sargeras,862,monk,windwalker,12,9,3
19956,Chingwang,frostmourne,862,monk,windwalker,12,9,3
19957,Blumpfu,thrall,862,monk,windwalker,18,9,9
19958,Duwhack,wyrmrest-accord,862,monk,windwalker,18,9,9
19959,Yeawe,tichondrius,862,monk,windwalker,18,9,9
19960,Mapaly,ragnaros,862,monk,windwalker,18,9,9
19961,Fornoraisin,thrall,862,monk,windwalker,36,9,27
19962,Kaishya,emerald-dream,861,monk,windwalker,12,9,3
19963,Æeeæ,hakkar,861,monk,windwalker,12,9,3
19964,Kentodne,stormrage,861,monk,windwalker,18,9,9
19965,Zackesé,area-52,861,monk,windwalker,24,9,15
19966,Ryútt,illidan,860,monk,windwalker,24,9,15
19967,Romeonjuliet,tichondrius,859,monk,windwalker,18,9,9
19968,Dynamo,blackrock,859,monk,windwalker,24,9,15
19969,Selfless,gilneas,858,monk,windwalker,18,9,9
19970,Wwmonks,sargeras,857,monk,windwalker,12,9,3
19971,Felgolos,azralon,857,monk,windwalker,15,10,5
19972,Acena,stormrage,856,monk,windwalker,24,9,15
19973,Acindian,malganis,853,monk,windwalker,18,9,9
19974,Agroétudo,azralon,838,monk,windwalker,18,9,9
19975,Scarlos,tichondrius,832,monk,windwalker,175,84,91
19976,Thekilla,aegwynn,827,monk,windwalker,18,9,9
19977,Yeonguo,drakthul,795,monk,windwalker,16,9,7
19978,Rykouu,area-52,784,monk,windwalker,19,9,10
19979,Allmother,area-52,784,monk,windwalker,25,9,16
19980,Hitchslapz,tichondrius,783,monk,windwalker,13,9,4
19981,Raskalnikov,kelthuzad,777,monk,windwalker,20,10,10
19982,Khungfeu,area-52,768,monk,windwalker,12,8,4
19983,Hitman,thrall,768,monk,windwalker,12,8,4
19984,Livitsu,aerie-peak,768,monk,windwalker,12,8,4
19985,Mcbluffin,onyxia,768,monk,windwalker,12,8,4
19986,Iremía,azralon,768,monk,windwalker,12,8,4
19987,Zoomerxd,stormrage,768,monk,windwalker,12,8,4
19988,Twichyling,tichondrius,768,monk,windwalker,12,8,4
19989,Slimcognito,zuljin,768,monk,windwalker,18,8,10
19990,Dobsy,bleeding-hollow,768,monk,windwalker,18,8,10
19991,Richywayne,bleeding-hollow,768,monk,windwalker,18,8,10
19992,Stepfistz,aegwynn,768,monk,windwalker,18,8,10
19993,Ojii,tichondrius,768,monk,windwalker,18,8,10
19994,Rerolled,moon-guard,768,monk,windwalker,18,8,10
19995,Lørdjåshïn,azjolnerub,768,monk,windwalker,18,8,10
19996,Mahatmä,dalaran,768,monk,windwalker,18,8,10
19997,Gnomepuncher,dalaran,768,monk,windwalker,18,8,10
19998,Hitt,barthilas,768,monk,windwalker,18,8,10
19999,Ballok,bleeding-hollow,768,monk,windwalker,18,8,10
20000,Güwop,tichondrius,768,monk,windwalker,18,8,10
20001,Taggz,thunderlord,768,monk,windwalker,18,8,10
20002,Monke,onyxia,768,monk,windwalker,24,8,16
20003,Raikou,frostmourne,767,monk,windwalker,12,8,4
20004,Tews,quelthalas,767,monk,windwalker,12,8,4
20005,Prickhead,sargeras,767,monk,windwalker,15,9,6
20006,Metalmønk,nerzhul,767,monk,windwalker,18,8,10
20007,Silkzy,frostwolf,767,monk,windwalker,18,8,10
20008,Pipochen,ragnaros,767,monk,windwalker,18,8,10
20009,Punchiboi,thrall,767,monk,windwalker,18,8,10
20010,Supernam,sargeras,767,monk,windwalker,18,8,10
20011,Faashbae,illidan,767,monk,windwalker,18,8,10
20012,Zukki,zuljin,767,monk,windwalker,18,8,10
20013,Suspicious,malfurion,767,monk,windwalker,18,8,10
20014,Saiyajinsoul,ragnaros,767,monk,windwalker,18,8,10
20015,Biggyballs,tichondrius,767,monk,windwalker,18,8,10
20016,Luckystrike,area-52,767,monk,windwalker,24,8,16
20017,Yoshimotto,area-52,766,monk,windwalker,12,8,4
20018,Nf,zuljin,766,monk,windwalker,12,8,4
20019,Anatomyx,kelthuzad,766,monk,windwalker,12,8,4
20020,Ragraxx,quelthalas,766,monk,windwalker,18,8,10
20021,Extinctión,stormscale,762,monk,windwalker,12,8,4
20022,Sprinkli,sargeras,761,monk,windwalker,24,8,16
20023,Iamanangel,illidan,759,monk,windwalker,12,8,4
20024,Kylièjenner,gilneas,755,monk,windwalker,18,8,10
20025,Kilabit,azshara,742,monk,windwalker,22,9,13
20026,Misery,stormscale,719,monk,windwalker,11,8,3
20027,Raninn,bleeding-hollow,704,monk,windwalker,16,8,8
20028,Chaipie,kelthuzad,703,monk,windwalker,11,8,3
20029,Bakha,illidan,703,monk,windwalker,11,8,3
20030,Onepunch,exodar,702,monk,windwalker,14,8,6
20031,Kryptikkyt,gilneas,672,monk,windwalker,12,7,5
20032,Garofalo,tichondrius,672,monk,windwalker,12,7,5
20033,Incaustik,ragnaros,672,monk,windwalker,12,7,5
20034,Adilm,illidan,672,monk,windwalker,12,7,5
20035,Gigagirth,emerald-dream,672,monk,windwalker,12,7,5
20036,Porxhub,tichondrius,672,monk,windwalker,12,7,5
20037,Goldx,ragnaros,672,monk,windwalker,12,7,5
20038,Wizcaulifa,stormrage,672,monk,windwalker,12,7,5
20039,Tokyozesty,area-52,672,monk,windwalker,12,7,5
20040,Bibis,sargeras,672,monk,windwalker,12,7,5
20041,Shiphappens,barthilas,672,monk,windwalker,12,7,5
20042,Touchbot,tichondrius,672,monk,windwalker,12,7,5
20043,Dragonwhirl,stormrage,672,monk,windwalker,12,7,5
20044,Dkdakìng,stormrage,672,monk,windwalker,12,7,5
20045,Yoojimin,kiljaeden,672,monk,windwalker,12,7,5
20046,Ristion,moon-guard,672,monk,windwalker,12,7,5
20047,Ganjäsmoke,skullcrusher,672,monk,windwalker,12,7,5
20048,Kudrix,frostwolf,672,monk,windwalker,12,7,5
20049,Dublefist,draktharon,672,monk,windwalker,12,7,5
20050,Ázão,stormrage,672,monk,windwalker,12,7,5
20051,Jowtaro,azralon,672,monk,windwalker,12,7,5
20052,Shry,kiljaeden,672,monk,windwalker,12,7,5
20053,Atengie,stormrage,672,monk,windwalker,12,7,5
20054,Jxyfist,illidan,672,monk,windwalker,12,7,5
20055,Lilpøøter,tichondrius,672,monk,windwalker,12,7,5
20056,Bramicaye,malganis,672,monk,windwalker,12,7,5
20057,Vuadeira,azralon,672,monk,windwalker,12,7,5
20058,Gothamonk,tichondrius,672,monk,windwalker,12,7,5
20059,Ftxyolo,azralon,672,monk,windwalker,12,7,5
20060,Iol,whisperwind,672,monk,windwalker,12,7,5
20061,Buffmonkdmg,tichondrius,672,monk,windwalker,15,8,7
20062,Stevezee,barthilas,672,monk,windwalker,18,7,11
20063,Verizani,stormrage,672,monk,windwalker,18,7,11
20064,Popchi,stormrage,672,monk,windwalker,18,7,11
20065,Tapzm,area-52,672,monk,windwalker,18,7,11
20066,Grocerymonk,malganis,672,monk,windwalker,18,7,11
20067,Atsuyuki,nemesis,672,monk,windwalker,18,7,11
20068,Awcfanboy,bleeding-hollow,672,monk,windwalker,21,8,13
20069,Judgevr,frostmourne,672,monk,windwalker,23,8,15
20070,Monkyun,tichondrius,672,monk,windwalker,24,7,17
20071,Zenkam,ragnaros,672,monk,windwalker,24,7,17
20072,Quietbegger,sargeras,671,monk,windwalker,12,7,5
20073,Bauddor,ragnaros,671,monk,windwalker,12,7,5
20074,Caulífla,barthilas,671,monk,windwalker,12,7,5
20075,Asaltofsorts,tichondrius,671,monk,windwalker,12,7,5
20076,Reckin,frostmourne,671,monk,windwalker,12,7,5
20077,Keys,earthen-ring,671,monk,windwalker,12,7,5
20078,Jackboi,the-underbog,671,monk,windwalker,18,7,11
20079,Leozen,skullcrusher,671,monk,windwalker,18,7,11
20080,Chuchinga,tichondrius,670,monk,windwalker,13,8,5
20081,Minusmonk,dalaran,670,monk,windwalker,12,7,5
20082,Cryptique,tichondrius,670,monk,windwalker,12,7,5
20083,Owenxdd,stormrage,670,monk,windwalker,12,7,5
20084,Gentlefists,sargeras,670,monk,windwalker,18,7,11
20085,Samaelsin,emerald-dream,670,monk,windwalker,24,7,17
20086,Kuungfoo,tichondrius,667,monk,windwalker,12,7,5
20087,Hyun,stormrage,666,monk,windwalker,12,7,5
20088,Kush,dalvengyr,665,monk,windwalker,12,7,5
20089,Traxshin,kelthuzad,664,monk,windwalker,18,7,11
20090,Aedale,emerald-dream,661,monk,windwalker,18,7,11
20091,Pastarasta,malganis,658,monk,windwalker,12,7,5
20092,Liänä,quelthalas,658,monk,windwalker,18,7,11
20093,Léesin,stormrage,655,monk,windwalker,17,7,10
20094,Kurha,queldorei,644,monk,windwalker,18,7,11
20095,Mùnkey,nagrand,638,monk,windwalker,17,7,10
20096,Sistafistaa,akama,606,monk,windwalker,14,7,7
20097,Sckmonk,tichondrius,606,monk,windwalker,16,7,9
20098,Aizu,ragnaros,576,monk,windwalker,6,6,0
20099,Selfîe,ysera,576,monk,windwalker,6,6,0
20100,Srýbrø,illidan,576,monk,windwalker,6,6,0
20101,Griswolld,ragnaros,576,monk,windwalker,6,6,0
20102,Goblinitto,archimonde,576,monk,windwalker,6,6,0
20103,Twïst,tichondrius,576,monk,windwalker,6,6,0
20104,Wwrizz,frostmane,576,monk,windwalker,6,6,0
20105,Makgøra,malganis,576,monk,windwalker,6,6,0
20106,Grimpossible,malganis,576,monk,windwalker,6,6,0
20107,Aveium,moon-guard,576,monk,windwalker,6,6,0
20108,Monkfy,moon-guard,576,monk,windwalker,6,6,0
20109,Xua,sargeras,576,monk,windwalker,12,6,6
20110,Bvndio,ragnaros,576,monk,windwalker,12,6,6
20111,Gójó,tichondrius,576,monk,windwalker,12,6,6
20112,Tulalong,area-52,576,monk,windwalker,12,6,6
20113,Syffer,sargeras,576,monk,windwalker,12,6,6
20114,Xuenfu,tichondrius,576,monk,windwalker,12,6,6
20115,Creamchop,stormreaver,576,monk,windwalker,12,6,6
20116,Affected,lightninghoof,576,monk,windwalker,12,6,6
20117,Vandamme,durotan,576,monk,windwalker,12,6,6
20118,Yimmy,zuluhed,576,monk,windwalker,12,6,6
20119,Silvyrx,boulderfist,576,monk,windwalker,12,6,6
20120,Läôtzu,fizzcrank,576,monk,windwalker,12,6,6
20121,Xoir,tichondrius,576,monk,windwalker,12,6,6
20122,Monksoon,tichondrius,576,monk,windwalker,12,6,6
20123,Pinkgucci,thrall,576,monk,windwalker,12,6,6
20124,Neejitsu,malganis,576,monk,windwalker,12,6,6
20125,Xinghao,tichondrius,576,monk,windwalker,12,6,6
20126,Bakacia,ragnaros,576,monk,windwalker,12,6,6
20127,Tahs,azralon,576,monk,windwalker,12,6,6
20128,Hèàvy,stormrage,576,monk,windwalker,12,6,6
20129,Tinypunch,emerald-dream,576,monk,windwalker,12,6,6
20130,Forthekicks,tichondrius,576,monk,windwalker,19,8,11
20131,Monjimen,ragnaros,576,monk,windwalker,18,6,12
20132,Awsmonk,malygos,576,monk,windwalker,18,6,12
20133,Káizen,area-52,576,monk,windwalker,18,6,12
20134,Jatzai,emerald-dream,576,monk,windwalker,28,6,22
20135,Ipnam,kelthuzad,575,monk,windwalker,10,7,3
20136,Weewalker,wyrmrest-accord,575,monk,windwalker,12,6,6
20137,Atulzo,emerald-dream,575,monk,windwalker,12,6,6
20138,Kalrsk,frostmourne,575,monk,windwalker,12,6,6
20139,Rowenoa,tichondrius,575,monk,windwalker,18,6,12
20140,Kajjou,illidan,575,monk,windwalker,20,6,14
20141,Linwong,garithos,574,monk,windwalker,12,6,6
20142,Dragorovich,aerie-peak,574,monk,windwalker,12,6,6
20143,Fistidmi,area-52,573,monk,windwalker,12,6,6
20144,Tøxicø,quelthalas,572,monk,windwalker,16,7,9
20145,Nedpanders,nagrand,564,monk,windwalker,12,6,6
20146,Phuumyn,llane,543,monk,windwalker,11,6,5
20147,Wft,frostmourne,527,monk,windwalker,11,6,5
20148,Shindoro,bonechewer,521,monk,windwalker,16,10,6
20149,Nitrobrewed,stormrage,480,monk,windwalker,6,5,1
20150,Poem,grizzly-hills,480,monk,windwalker,6,5,1
20151,Akir,zuljin,480,monk,windwalker,6,5,1
20152,Pikadejegue,nemesis,480,monk,windwalker,6,5,1
20153,Pleasetouch,emerald-dream,480,monk,windwalker,6,5,1
20154,Miresa,kelthuzad,480,monk,windwalker,6,5,1
20155,Shevchenkô,quelthalas,480,monk,windwalker,6,5,1
20156,Xunzao,emerald-dream,480,monk,windwalker,6,5,1
20157,Yenjung,azralon,480,monk,windwalker,6,5,1
20158,Koochies,aegwynn,480,monk,windwalker,6,5,1
20159,Doczen,malganis,480,monk,windwalker,6,5,1
20160,Pandagendon,quelthalas,480,monk,windwalker,6,5,1
20161,Zakaza,kelthuzad,480,monk,windwalker,6,5,1
20162,Danksweaver,malganis,480,monk,windwalker,6,5,1
20163,Monkskiiz,tichondrius,480,monk,windwalker,6,5,1
20164,Kimmyfists,tichondrius,480,monk,windwalker,6,5,1
20165,Varimå,area-52,480,monk,windwalker,6,5,1
20166,Drunkmaster,frostmourne,480,monk,windwalker,6,5,1
20167,Hennyww,dalaran,480,monk,windwalker,6,5,1
20168,Iflykites,zuljin,480,monk,windwalker,6,5,1
20169,Iloveabby,sargeras,480,monk,windwalker,6,5,1
20170,Kuranchi,illidan,480,monk,windwalker,6,5,1
20171,Blazebeast,blackhand,480,monk,windwalker,9,6,3
20172,Tyrus,kelthuzad,480,monk,windwalker,9,5,4
20173,Mepepegaclap,malganis,480,monk,windwalker,12,5,7
20174,Ilvory,tichondrius,480,monk,windwalker,12,5,7
20175,Ferknights,moon-guard,480,monk,windwalker,12,5,7
20176,Smigz,area-52,480,monk,windwalker,12,5,7
20177,Flattswwjr,tichondrius,480,monk,windwalker,12,5,7
20178,Tripster,wyrmrest-accord,480,monk,windwalker,12,5,7
20179,Suntzuvius,tichondrius,480,monk,windwalker,12,5,7
20180,Plagai,fizzcrank,480,monk,windwalker,12,5,7
20181,Gêrôx,sargeras,480,monk,windwalker,12,5,7
20182,Valdur,sargeras,480,monk,windwalker,12,5,7
20183,Zhíu,ragnaros,480,monk,windwalker,12,5,7
20184,Bokchoii,sargeras,480,monk,windwalker,12,5,7
20185,Kickkick,burning-blade,480,monk,windwalker,12,5,7
20186,Antril,bleeding-hollow,480,monk,windwalker,12,5,7
20187,Lokimana,zuljin,480,monk,windwalker,12,5,7
20188,Rozlynnww,tichondrius,480,monk,windwalker,12,5,7
20189,Zadaa,alleria,480,monk,windwalker,12,5,7
20190,Xueyu,malganis,480,monk,windwalker,12,5,7
20191,Aydowon,illidan,480,monk,windwalker,12,5,7
20192,Idonthustle,area-52,480,monk,windwalker,12,5,7
20193,Tenkix,zuljin,480,monk,windwalker,12,5,7
20194,Miuss,illidan,480,monk,windwalker,12,5,7
20195,Akrethar,medivh,480,monk,windwalker,12,5,7
20196,Maisoftheart,barthilas,480,monk,windwalker,18,5,13
20197,Gabaan,azralon,480,monk,windwalker,18,5,13
20198,Vinndz,azralon,480,monk,windwalker,18,5,13
20199,Zmajevratnik,illidan,479,monk,windwalker,6,5,1
20200,Shà,kelthuzad,479,monk,windwalker,12,5,7
20201,Søuei,skullcrusher,479,monk,windwalker,12,5,7
20202,Kiukiukiu,tichondrius,479,monk,windwalker,12,5,7
20203,Tamonk,veknilash,478,monk,windwalker,6,5,1
20204,Leisa,jaedenar,463,monk,windwalker,11,5,6
20205,Mcmaplol,tichondrius,447,monk,windwalker,11,5,6
20206,Clytpuncher,emerald-dream,447,monk,windwalker,11,5,6
20207,Chisuschrist,hyjal,432,monk,windwalker,15,5,10
20208,Ighostgirls,thrall,431,monk,windwalker,11,5,6
20209,Prettyflacko,thrall,416,monk,windwalker,10,5,5
20210,Gorblox,emerald-dream,384,monk,windwalker,6,4,2
20211,Stevìl,medivh,384,monk,windwalker,6,4,2
20212,Korgark,tichondrius,384,monk,windwalker,6,4,2
20213,Saitamami,tichondrius,384,monk,windwalker,6,4,2
20214,Ðøhkø,nemesis,384,monk,windwalker,6,4,2
20215,Wørm,emerald-dream,384,monk,windwalker,6,4,2
20216,Barleygar,tichondrius,384,monk,windwalker,6,4,2
20217,Cowsgonuts,gorefiend,384,monk,windwalker,6,4,2
20218,Kiggo,bonechewer,384,monk,windwalker,6,4,2
20219,Trembull,gurubashi,384,monk,windwalker,6,4,2
20220,Arunaa,tichondrius,384,monk,windwalker,6,4,2
20221,Preceptonk,azralon,384,monk,windwalker,6,4,2
20222,Xulieng,tichondrius,384,monk,windwalker,6,4,2
20223,Castiwhite,quelthalas,384,monk,windwalker,6,4,2
20224,Liucang,archimonde,384,monk,windwalker,6,4,2
20225,Cowhoe,icecrown,384,monk,windwalker,6,4,2
20226,Imperio,stormrage,384,monk,windwalker,6,4,2
20227,Satchelgizmo,tichondrius,384,monk,windwalker,6,4,2
20228,Pathad,stormrage,384,monk,windwalker,6,4,2
20229,Monkespin,stormrage,384,monk,windwalker,6,4,2
20230,Ezpumpm,azralon,384,monk,windwalker,6,4,2
20231,Delaî,dalaran,384,monk,windwalker,6,4,2
20232,Research,frostmourne,384,monk,windwalker,6,4,2
20233,Molific,gurubashi,384,monk,windwalker,6,4,2
20234,Karatay,tichondrius,384,monk,windwalker,6,4,2
20235,Iarw,tichondrius,384,monk,windwalker,6,4,2
20236,Illiea,cenarius,384,monk,windwalker,6,4,2
20237,Vetting,stormrage,384,monk,windwalker,6,4,2
20238,Fistedby,nesingwary,384,monk,windwalker,6,4,2
20239,Coldridge,bleeding-hollow,384,monk,windwalker,6,4,2
20240,Beverage,frostmourne,384,monk,windwalker,6,4,2
20241,Sistuhfista,tichondrius,384,monk,windwalker,6,4,2
20242,Lowkn,sargeras,384,monk,windwalker,6,4,2
20243,Kame,moon-guard,384,monk,windwalker,6,4,2
20244,Orbgodx,darkspear,384,monk,windwalker,6,4,2
20245,Punchbuggy,frostmourne,384,monk,windwalker,6,4,2
20246,Aedalithe,stormrage,384,monk,windwalker,6,4,2
20247,Champoo,executus,384,monk,windwalker,6,4,2
20248,Thewyjr,illidan,384,monk,windwalker,6,4,2
20249,Fiddletix,stormrage,384,monk,windwalker,6,4,2
20250,Hazed,lightbringer,384,monk,windwalker,6,4,2
20251,Evanyfist,proudmoore,384,monk,windwalker,6,4,2
20252,Fivebears,blackwing-lair,384,monk,windwalker,6,4,2
20253,Vernki,laughing-skull,384,monk,windwalker,6,4,2
20254,Eçua,tichondrius,384,monk,windwalker,7,4,3
20255,Serenitys,tanaris,384,monk,windwalker,9,4,5
20256,Jxytwo,arygos,384,monk,windwalker,12,4,8
20257,Jayr,bleeding-hollow,384,monk,windwalker,12,4,8
20258,Paracetamonk,kelthuzad,384,monk,windwalker,12,4,8
20259,Wheresmyjuul,malganis,384,monk,windwalker,12,4,8
20260,Inko,ragnaros,384,monk,windwalker,12,4,8
20261,Fluffykitty,deathwing,384,monk,windwalker,12,4,8
20262,Xinvictus,frostmourne,384,monk,windwalker,12,4,8
20263,Evilstep,tichondrius,384,monk,windwalker,12,4,8
20264,Kfp,gorefiend,384,monk,windwalker,12,4,8
20265,Ramisan,barthilas,384,monk,windwalker,12,4,8
20266,Machita,spirestone,384,monk,windwalker,12,4,8
20267,Mysticzen,tichondrius,384,monk,windwalker,12,4,8
20268,Chijinx,area-52,384,monk,windwalker,12,4,8
20269,Cranjis,agamaggan,384,monk,windwalker,12,4,8
20270,Piece,blackrock,384,monk,windwalker,12,4,8
20271,Ohtani,frostwolf,384,monk,windwalker,12,4,8
20272,Raekwan,area-52,384,monk,windwalker,12,4,8
20273,Ferrarí,quelthalas,384,monk,windwalker,12,4,8
20274,Fruitpünch,tichondrius,384,monk,windwalker,12,4,8
20275,Solrise,wyrmrest-accord,384,monk,windwalker,12,4,8
20276,Giorhno,ragnaros,384,monk,windwalker,12,4,8
20277,Rookz,drakthul,384,monk,windwalker,12,4,8
20278,Merçeÿ,tichondrius,384,monk,windwalker,12,4,8
20279,Merand,tichondrius,384,monk,windwalker,12,4,8
20280,Talondien,dalaran,384,monk,windwalker,12,4,8
20281,Cudzingtin,dalaran,384,monk,windwalker,12,4,8
20282,Threnz,magtheridon,384,monk,windwalker,12,4,8
20283,Zanmonk,moon-guard,383,monk,windwalker,6,4,2
20284,Chugs,malorne,383,monk,windwalker,18,4,14
20285,Miyage,emerald-dream,382,monk,windwalker,6,4,2
20286,Viko,llane,382,monk,windwalker,6,4,2
20287,Liw,quelthalas,362,monk,windwalker,21,7,14
20288,Broxxenidas,quelthalas,351,monk,windwalker,11,4,7
20289,Nakuang,tichondrius,339,monk,windwalker,24,7,17
20290,Atreia,malganis,330,monk,windwalker,8,5,3
20291,Pånkekz,tichondrius,319,monk,windwalker,5,4,1
20292,Sahhalea,sargeras,319,monk,windwalker,14,4,10
20293,Lackofsleep,tichondrius,288,monk,windwalker,6,3,3
20294,Harvex,area-52,288,monk,windwalker,6,3,3
20295,Choibaedal,tichondrius,288,monk,windwalker,6,3,3
20296,Cráne,duskwood,288,monk,windwalker,6,3,3
20297,Tababtz,illidan,288,monk,windwalker,6,3,3
20298,ßluedream,dalaran,288,monk,windwalker,6,3,3
20299,Raires,tichondrius,288,monk,windwalker,6,3,3
20300,Brewtool,tichondrius,288,monk,windwalker,6,3,3
20301,Bakicaa,dalaran,288,monk,windwalker,6,3,3
20302,Zexana,gorefiend,288,monk,windwalker,6,3,3
20303,Rafyww,tichondrius,288,monk,windwalker,6,3,3
20304,Giatzo,barthilas,288,monk,windwalker,6,3,3
20305,Evilbit,boulderfist,288,monk,windwalker,6,3,3
20306,Reflexsivex,malganis,288,monk,windwalker,6,3,3
20307,Smalltall,area-52,288,monk,windwalker,6,3,3
20308,Imasterl,proudmoore,288,monk,windwalker,6,3,3
20309,Pusily,tichondrius,288,monk,windwalker,6,3,3
20310,Gulmokk,tichondrius,288,monk,windwalker,6,3,3
20311,Slurrpslutt,proudmoore,288,monk,windwalker,6,3,3
20312,Lomist,nazjatar,288,monk,windwalker,6,3,3
20313,Trunkx,area-52,288,monk,windwalker,6,3,3
20314,Atezo,tichondrius,288,monk,windwalker,6,3,3
20315,Mlngo,illidan,288,monk,windwalker,6,3,3
20316,Röllö,tichondrius,288,monk,windwalker,6,3,3
20317,Legolos,runetotem,288,monk,windwalker,6,3,3
20318,Bromonster,zuljin,288,monk,windwalker,6,3,3
20319,Frimayadri,area-52,288,monk,windwalker,6,3,3
20320,Mistérfister,blackrock,288,monk,windwalker,6,3,3
20321,Highaskite,tichondrius,288,monk,windwalker,6,3,3
20322,Kuafu,illidan,288,monk,windwalker,6,3,3
20323,Iilmachoggy,stormrage,288,monk,windwalker,6,3,3
20324,Swurvex,bleeding-hollow,288,monk,windwalker,6,3,3
20325,Daspmonk,nagrand,288,monk,windwalker,6,3,3
20326,Redami,gnomeregan,288,monk,windwalker,6,3,3
20327,Oyyo,tichondrius,288,monk,windwalker,6,3,3
20328,Monklad,malganis,288,monk,windwalker,6,3,3
20329,Dripharder,tichondrius,288,monk,windwalker,6,3,3
20330,Maserati,azjolnerub,288,monk,windwalker,6,3,3
20331,Triixxy,thrall,288,monk,windwalker,6,3,3
20332,Sýññ,illidan,288,monk,windwalker,6,3,3
20333,Gngrbeardman,tichondrius,288,monk,windwalker,6,3,3
20334,Pandaforlife,area-52,288,monk,windwalker,6,3,3
20335,Goodluck,madoran,288,monk,windwalker,6,3,3
20336,Momkisserl,sargeras,288,monk,windwalker,6,3,3
20337,Tigerlust,sargeras,288,monk,windwalker,6,3,3
20338,Dorander,frostmourne,288,monk,windwalker,6,3,3
20339,Hábìtz,area-52,288,monk,windwalker,6,3,3
20340,Skippa,emerald-dream,288,monk,windwalker,6,3,3
20341,Mcfluffey,area-52,288,monk,windwalker,6,3,3
20342,Detox,sargeras,288,monk,windwalker,6,3,3
20343,Tonkchi,khaz-modan,288,monk,windwalker,6,3,3
20344,Fistay,burning-legion,288,monk,windwalker,6,3,3
20345,Gageismonk,mugthol,288,monk,windwalker,6,3,3
20346,Tictox,sargeras,288,monk,windwalker,6,3,3
20347,Rhonco,quelthalas,288,monk,windwalker,6,3,3
20348,Jubei,dragonmaw,288,monk,windwalker,6,3,3
20349,Karkata,sargeras,288,monk,windwalker,6,3,3
20350,Burash,frostwolf,288,monk,windwalker,6,3,3
20351,Bogez,area-52,288,monk,windwalker,6,3,3
20352,Hellcow,frostmourne,288,monk,windwalker,6,3,3
20353,Silestial,sargeras,288,monk,windwalker,6,3,3
20354,Heavytrain,azralon,288,monk,windwalker,6,3,3
20355,Sosm,kelthuzad,288,monk,windwalker,6,3,3
20356,Muffinz,shattered-halls,288,monk,windwalker,6,3,3
20357,Spaaca,kelthuzad,288,monk,windwalker,6,3,3
20358,Apølon,azralon,288,monk,windwalker,6,3,3
20359,Kallandron,thunderhorn,288,monk,windwalker,6,3,3
20360,Hanzøu,ragnaros,288,monk,windwalker,6,3,3
20361,Mgzx,kelthuzad,288,monk,windwalker,6,3,3
20362,Rumlee,sargeras,288,monk,windwalker,6,3,3
20363,Rampant,anubarak,288,monk,windwalker,9,4,5
20364,Siddharthä,barthilas,288,monk,windwalker,12,3,9
20365,Raviolipolie,sargeras,288,monk,windwalker,12,3,9
20366,Chunlee,tichondrius,288,monk,windwalker,12,3,9
20367,Shizzyowoxd,bleeding-hollow,288,monk,windwalker,12,3,9
20368,Bujiburger,frostmourne,288,monk,windwalker,12,3,9
20369,Vova,bleeding-hollow,288,monk,windwalker,12,3,9
20370,Senseixww,sargeras,288,monk,windwalker,12,3,9
20371,Jãe,stormrage,288,monk,windwalker,12,3,9
20372,Paramendic,frostwolf,288,monk,windwalker,12,3,9
20373,Joreg,moon-guard,288,monk,windwalker,12,3,9
20374,Meatcleave,kiljaeden,288,monk,windwalker,12,3,9
20375,Mistyfist,bleeding-hollow,288,monk,windwalker,12,3,9
20376,Dmhsaint,sargeras,288,monk,windwalker,12,3,9
20377,Atarii,emerald-dream,288,monk,windwalker,12,3,9
20378,Wwx,whisperwind,288,monk,windwalker,12,3,9
20379,Tofugoku,area-52,288,monk,windwalker,12,3,9
20380,Breakbonez,dalaran,288,monk,windwalker,18,3,15
20381,Brewmooser,area-52,287,monk,windwalker,6,3,3
20382,Pandalex,draenor,287,monk,windwalker,6,3,3
20383,Ogre,the-venture-co,287,monk,windwalker,6,3,3
20384,Thedeäd,stormrage,287,monk,windwalker,12,3,9
20385,Gaziee,tichondrius,271,monk,windwalker,11,3,8
20386,Dafuqk,stormrage,256,monk,windwalker,16,3,13
20387,Hellrosennin,area-52,239,monk,windwalker,5,3,2
20388,Rockfu,illidan,239,monk,windwalker,5,3,2
20389,Kfchi,tichondrius,192,monk,windwalker,4,3,1
20390,Mùk,tichondrius,192,monk,windwalker,4,3,1
20391,Dangodxz,quelthalas,192,monk,windwalker,4,3,1
20392,Klamfu,thrall,192,monk,windwalker,4,3,1
20393,Jadiel,quelthalas,192,monk,windwalker,6,2,4
20394,Privix,tichondrius,192,monk,windwalker,6,2,4
20395,Averagéjoe,tichondrius,192,monk,windwalker,6,2,4
20396,Imafqnbaby,tichondrius,192,monk,windwalker,6,2,4
20397,Bhoredom,kiljaeden,192,monk,windwalker,6,2,4
20398,Fuchizaki,ragnaros,192,monk,windwalker,6,2,4
20399,Takazawas,bonechewer,192,monk,windwalker,6,2,4
20400,Lonebamboo,tichondrius,192,monk,windwalker,6,2,4
20401,Heävenly,kelthuzad,192,monk,windwalker,6,2,4
20402,Ãcé,ragnaros,192,monk,windwalker,6,2,4
20403,Xarra,bleeding-hollow,192,monk,windwalker,6,2,4
20404,Fistpumps,thrall,192,monk,windwalker,6,2,4
20405,Prf,ragnaros,192,monk,windwalker,6,2,4
20406,Akiiko,draenor,192,monk,windwalker,6,2,4
20407,Grëyfox,sargeras,192,monk,windwalker,6,2,4
20408,Robocto,area-52,192,monk,windwalker,6,2,4
20409,Troutz,sargeras,192,monk,windwalker,6,2,4
20410,Flicksx,arthas,192,monk,windwalker,6,2,4
20411,Dragoro,exodar,192,monk,windwalker,6,2,4
20412,Boeingair,kelthuzad,192,monk,windwalker,6,2,4
20413,Monkbro,altar-of-storms,192,monk,windwalker,6,2,4
20414,Spirits,dreadmaul,192,monk,windwalker,6,2,4
20415,Wât,bleeding-hollow,192,monk,windwalker,6,2,4
20416,Théwy,tichondrius,192,monk,windwalker,6,2,4
20417,Bakusao,bleeding-hollow,192,monk,windwalker,6,2,4
20418,Ludenz,emerald-dream,192,monk,windwalker,6,2,4
20419,Ked,ragnaros,192,monk,windwalker,6,2,4
20420,Sickbanga,barthilas,192,monk,windwalker,6,2,4
20421,Transcend,nerzhul,192,monk,windwalker,6,2,4
20422,Induhca,area-52,192,monk,windwalker,6,2,4
20423,Mîstchievous,sargeras,192,monk,windwalker,6,2,4
20424,Brëwslee,twisting-nether,192,monk,windwalker,6,2,4
20425,Jüdo,barthilas,192,monk,windwalker,6,2,4
20426,Tadaku,dalaran,192,monk,windwalker,6,2,4
20427,Furrykisser,tichondrius,192,monk,windwalker,6,2,4
20428,Zengawd,magtheridon,192,monk,windwalker,6,2,4
20429,Deyasth,zuljin,192,monk,windwalker,6,2,4
20430,Monkuban,destromath,192,monk,windwalker,6,2,4
20431,Thöran,ragnaros,192,monk,windwalker,6,2,4
20432,Pvptone,bleeding-hollow,192,monk,windwalker,6,2,4
20433,Strongmandan,twisting-nether,192,monk,windwalker,6,2,4
20434,Toxicaff,dalaran,192,monk,windwalker,6,2,4
20435,Icesmoker,frostmourne,192,monk,windwalker,6,2,4
20436,Streetcreds,bleeding-hollow,192,monk,windwalker,6,2,4
20437,Gumrag,illidan,192,monk,windwalker,6,2,4
20438,Epî,tichondrius,192,monk,windwalker,6,2,4
20439,Hutmok,dalaran,192,monk,windwalker,6,2,4
20440,Puraimu,sargeras,192,monk,windwalker,6,2,4
20441,Homunculusx,bleeding-hollow,192,monk,windwalker,6,2,4
20442,Coomerww,kelthuzad,192,monk,windwalker,6,2,4
20443,Möösê,moon-guard,192,monk,windwalker,6,2,4
20444,Romeoe,muradin,192,monk,windwalker,6,2,4
20445,Taringa,drakkari,192,monk,windwalker,6,2,4
20446,Lìpz,zuljin,192,monk,windwalker,6,2,4
20447,Upcoming,moon-guard,192,monk,windwalker,6,2,4
20448,Deathgoku,norgannon,192,monk,windwalker,6,2,4
20449,Hydraoxy,moon-guard,192,monk,windwalker,6,2,4
20450,Fumoo,sargeras,192,monk,windwalker,6,2,4
20451,Kitfisty,kiljaeden,192,monk,windwalker,6,2,4
20452,Hossdelgadoe,kiljaeden,192,monk,windwalker,6,2,4
20453,Youngnudy,sargeras,192,monk,windwalker,6,2,4
20454,Defacen,illidan,192,monk,windwalker,6,2,4
20455,Gøldéngødx,tichondrius,192,monk,windwalker,6,2,4
20456,Salanzoww,bleeding-hollow,192,monk,windwalker,6,2,4
20457,Saywha,windrunner,192,monk,windwalker,6,2,4
20458,Sinistuhm,tichondrius,192,monk,windwalker,6,2,4
20459,Merrell,area-52,192,monk,windwalker,6,2,4
20460,Keloxx,ragnaros,192,monk,windwalker,6,2,4
20461,Çhëèch,tichondrius,192,monk,windwalker,11,2,9
20462,Pongo,kelthuzad,192,monk,windwalker,12,2,10
20463,Xinpa,quelthalas,192,monk,windwalker,12,2,10
20464,Razekahl,wyrmrest-accord,192,monk,windwalker,12,2,10
20465,Eliwenn,ragnaros,192,monk,windwalker,12,2,10
20466,Dankestkhan,korialstrasz,192,monk,windwalker,12,2,10
20467,Bruceflea,gurubashi,192,monk,windwalker,18,2,16
20468,Fistermus,tichondrius,192,monk,windwalker,18,2,16
20469,Hontaruk,ragnaros,175,monk,windwalker,11,2,9
20470,Punch,agamaggan,175,monk,windwalker,11,2,9
20471,Wheatsli,malganis,159,monk,windwalker,5,2,3
20472,Stellae,emerald-dream,159,monk,windwalker,5,2,3
20473,Lazy,shattered-halls,159,monk,windwalker,5,2,3
20474,Habzz,tichondrius,159,monk,windwalker,5,2,3
20475,Goku,frostmourne,159,monk,windwalker,5,2,3
20476,Fendi,stormrage,159,monk,windwalker,5,2,3
20477,Heartsies,sargeras,128,monk,windwalker,4,2,2
20478,Versuri,azralon,128,monk,windwalker,10,2,8
20479,Jayjaybrew,area-52,96,monk,windwalker,3,2,1
20480,Neaxain,tichondrius,96,monk,windwalker,3,2,1
20481,Monkwayz,emerald-dream,96,monk,windwalker,3,2,1
20482,Teewin,area-52,96,monk,windwalker,6,1,5
20483,Giriom,thrall,96,monk,windwalker,6,1,5
20484,Æsir,moon-guard,96,monk,windwalker,6,1,5
20485,Buddaba,tichondrius,96,monk,windwalker,6,1,5
20486,Bwan,kelthuzad,96,monk,windwalker,6,1,5
20487,Lainerya,moon-guard,96,monk,windwalker,6,1,5
20488,Banidiin,moon-guard,96,monk,windwalker,6,1,5
20489,Quaria,moon-guard,96,monk,windwalker,6,1,5
20490,Nbatrap,stormrage,96,monk,windwalker,6,1,5
20491,Alkaholik,stormrage,96,monk,windwalker,6,1,5
20492,Forestweaver,area-52,96,monk,windwalker,6,1,5
20493,Okuraseru,bleeding-hollow,96,monk,windwalker,6,1,5
20494,Imingleejr,illidan,96,monk,windwalker,6,1,5
20495,Plotting,tichondrius,96,monk,windwalker,6,1,5
20496,Cerocool,hyjal,96,monk,windwalker,6,1,5
20497,Saruyo,frostmourne,96,monk,windwalker,6,1,5
20498,Netang,emerald-dream,96,monk,windwalker,6,1,5
20499,Monkanome,gilneas,96,monk,windwalker,6,1,5
20500,Ischys,kelthuzad,96,monk,windwalker,6,1,5
20501,Jh,korgath,96,monk,windwalker,6,1,5
20502,Munnk,stormreaver,96,monk,windwalker,6,1,5
20503,Piccolo,emerald-dream,96,monk,windwalker,6,1,5
20504,Zinque,emerald-dream,96,monk,windwalker,6,1,5
20505,Omoplàta,illidan,96,monk,windwalker,6,1,5
20506,Tmtricks,tichondrius,96,monk,windwalker,6,1,5
20507,Windlordx,illidan,96,monk,windwalker,6,1,5
20508,Kablam,frostmourne,96,monk,windwalker,6,1,5
20509,Srshy,drakkari,96,monk,windwalker,6,1,5
20510,Gablle,tol-barad,96,monk,windwalker,6,1,5
20511,Obiiwan,tichondrius,96,monk,windwalker,6,1,5
20512,Sanemi,amanthul,96,monk,windwalker,6,1,5
20513,Friëden,quelthalas,96,monk,windwalker,6,1,5
20514,Yípman,uldum,96,monk,windwalker,6,1,5
20515,Srgtbingo,azgalor,96,monk,windwalker,6,1,5
20516,Pléb,kelthuzad,96,monk,windwalker,6,1,5
20517,Shinobiww,area-52,96,monk,windwalker,6,1,5
20518,Legsweeps,tichondrius,96,monk,windwalker,6,1,5
20519,Memurk,bleeding-hollow,96,monk,windwalker,6,1,5
20520,Xhu,kelthuzad,96,monk,windwalker,6,1,5
20521,Chipócluda,ragnaros,96,monk,windwalker,6,1,5
20522,Molsonicee,tichondrius,96,monk,windwalker,6,1,5
20523,Comical,malygos,96,monk,windwalker,6,1,5
20524,Cmon,icecrown,96,monk,windwalker,12,1,11
20525,Tuskytwofist,kargath,96,monk,windwalker,12,1,11
20526,Yosisoy,zuljin,79,monk,windwalker,5,1,4
20527,Zhatafaq,ragnaros,48,monk,windwalker,3,1,2
20528,Kreese,rivendare,42,monk,windwalker,9,2,7
20529,Cosetteb,proudmoore,31,monk,windwalker,2,1,1
20530,Notamønk,bonechewer,31,monk,windwalker,2,1,1
20531,Laggyfist,frostmourne,16,monk,windwalker,1,1,0
20532,Rèxpéi,area-52,2157,paladin,holy,84,48,36
20533,Overwhelm,muradin,2125,paladin,holy,64,39,25
20534,Sunita,arthas,2116,paladin,holy,189,99,90
20535,Pattar,area-52,2107,paladin,holy,66,37,29
20536,Dreathhammer,muradin,2093,paladin,holy,96,48,48
20537,Holylolz,ragnaros,2042,paladin,holy,198,99,99
20538,Bubblebuddyx,tichondrius,2037,paladin,holy,71,34,37
20539,Tmborn,tichondrius,2035,paladin,holy,89,40,49
20540,Digglesx,area-52,2012,paladin,holy,78,35,43
20541,Braindeadrsj,anetheron,1990,paladin,holy,161,90,71
20542,Bilmurii,zuljin,1981,paladin,holy,96,51,45
20543,Nickimahoj,tichondrius,1943,paladin,holy,81,42,39
20544,Eskerda,azralon,1939,paladin,holy,160,77,83
20545,Bombboyoz,area-52,1936,paladin,holy,84,44,40
20546,Flõw,gnomeregan,1919,paladin,holy,84,52,32
20547,Hamsti,sargeras,1909,paladin,holy,125,63,62
20548,Baelsimp,illidan,1898,paladin,holy,96,50,46
20549,Flashv,barthilas,1896,paladin,holy,62,32,30
20550,Pelletbrain,emerald-dream,1892,paladin,holy,192,103,89
20551,Saacbot,area-52,1890,paladin,holy,75,29,46
20552,Angrycubanx,black-dragonflight,1887,paladin,holy,50,25,25
20553,Thejustice,tichondrius,1875,paladin,holy,138,69,69
20554,Bravepala,tichondrius,1862,paladin,holy,78,35,43
20555,Thejustices,tichondrius,1860,paladin,holy,36,22,14
20556,Curator,emerald-dream,1859,paladin,holy,56,29,27
20557,Sde,kelthuzad,1855,paladin,holy,132,61,71
20558,Sojupapi,area-52,1842,paladin,holy,108,54,54
20559,Dýstopia,stormrage,1841,paladin,holy,41,21,20
20560,Skillenjoyer,tichondrius,1839,paladin,holy,78,49,29
20561,Csupremacy,tichondrius,1839,paladin,holy,64,30,34
20562,Bushyy,tichondrius,1838,paladin,holy,54,26,28
20563,Duallkore,stormrage,1835,paladin,holy,78,42,36
20564,Insthy,illidan,1831,paladin,holy,66,38,28
20565,Nyctemavanna,ragnaros,1831,paladin,holy,94,50,44
20566,Cynthianna,tichondrius,1830,paladin,holy,206,108,98
20567,Ðáx,sargeras,1828,paladin,holy,75,39,36
20568,Ppgdx,azralon,1826,paladin,holy,78,34,44
20569,Caveyodeler,zuluhed,1822,paladin,holy,47,28,19
20570,Cyphinx,darkspear,1822,paladin,holy,103,48,55
20571,Memnoche,frostmane,1821,paladin,holy,89,53,36
20572,Sacbubldead,area-52,1820,paladin,holy,126,79,47
20573,Truluck,area-52,1820,paladin,holy,111,56,55
20574,Perfect,crushridge,1820,paladin,holy,56,28,28
20575,Deadlyassian,sargeras,1819,paladin,holy,100,54,46
20576,Fonypally,tichondrius,1815,paladin,holy,332,171,161
20577,Uxe,zuljin,1812,paladin,holy,60,30,30
20578,Judgejim,barthilas,1812,paladin,holy,144,66,78
20579,Fukndibs,kiljaeden,1811,paladin,holy,172,85,87
20580,Sd,kelthuzad,1811,paladin,holy,123,59,64
20581,Bubblist,tichondrius,1811,paladin,holy,68,28,40
20582,Jaywalker,baelgun,1810,paladin,holy,36,21,15
20583,Bravepl,tichondrius,1808,paladin,holy,73,28,45
20584,Dracfire,zuljin,1807,paladin,holy,45,24,21
20585,Zetsubõ,stormrage,1806,paladin,holy,54,24,30
20586,Ængelic,barthilas,1803,paladin,holy,202,107,95
20587,Dyppally,moon-guard,1803,paladin,holy,102,51,51
20588,Wtbmana,frostmourne,1801,paladin,holy,72,39,33
20589,Tylennis,archimonde,1801,paladin,holy,172,82,90
20590,Richpiana,nathrezim,1800,paladin,holy,106,60,46
20591,Hongwoosang,tichondrius,1795,paladin,holy,188,89,99
20592,Amourranth,stormrage,1785,paladin,holy,52,30,22
20593,Airbad,tichondrius,1785,paladin,holy,53,23,30
20594,Scrubbinton,zuljin,1784,paladin,holy,90,43,47
20595,Reverbz,malganis,1781,paladin,holy,84,31,53
20596,Veejayx,tichondrius,1775,paladin,holy,44,21,23
20597,Zilea,kiljaeden,1768,paladin,holy,48,24,24
20598,Hps,argent-dawn,1759,paladin,holy,42,22,20
20599,Scamlikely,tichondrius,1758,paladin,holy,96,49,47
20600,Colepal,zuljin,1754,paladin,holy,66,25,41
20601,Defensezone,tichondrius,1749,paladin,holy,74,36,38
20602,Chenzo,exodar,1746,paladin,holy,184,95,89
20603,Boomda,tichondrius,1740,paladin,holy,176,96,80
20604,Ihaveajob,zuluhed,1730,paladin,holy,42,23,19
20605,Mercedez,bleeding-hollow,1724,paladin,holy,54,28,26
20606,Brynnhild,stormrage,1722,paladin,holy,102,55,47
20607,Kustp,tichondrius,1718,paladin,holy,183,105,78
20608,Fixyouz,mannoroth,1718,paladin,holy,118,55,63
20609,Beyondsausag,malganis,1718,paladin,holy,89,41,48
20610,Ckaïnë,stormrage,1714,paladin,holy,68,36,32
20611,Softsister,tichondrius,1713,paladin,holy,42,22,20
20612,Kevinthecube,nerzhul,1705,paladin,holy,42,31,11
20613,Heaven,gurubashi,1705,paladin,holy,47,22,25
20614,Careless,malganis,1704,paladin,holy,36,18,18
20615,Taargaryenn,tichondrius,1701,paladin,holy,60,32,28
20616,Holymooie,frostmourne,1692,paladin,holy,30,18,12
20617,Fortold,bloodhoof,1692,paladin,holy,54,23,31
20618,Virabelle,gurubashi,1690,paladin,holy,48,25,23
20619,Evylinn,burning-legion,1684,paladin,holy,126,69,57
20620,Hats,icecrown,1676,paladin,holy,165,80,85
20621,Tenêbrae,area-52,1674,paladin,holy,52,33,19
20622,Thorfinaa,moon-guard,1673,paladin,holy,41,24,17
20623,Sàga,hyjal,1671,paladin,holy,53,29,24
20624,Mvpj,medivh,1669,paladin,holy,153,78,75
20625,Cheerleader,bleeding-hollow,1668,paladin,holy,138,62,76
20626,Imshmackedd,darkspear,1663,paladin,holy,84,35,49
20627,Tiernoo,illidan,1662,paladin,holy,98,46,52
20628,Landrysdad,malorne,1660,paladin,holy,54,26,28
20629,Ivan,tichondrius,1659,paladin,holy,136,62,74
20630,Sacridas,fizzcrank,1657,paladin,holy,36,20,16
20631,Zunit,laughing-skull,1656,paladin,holy,46,22,24
20632,Avengom,tichondrius,1653,paladin,holy,357,179,178
20633,Xciss,kiljaeden,1652,paladin,holy,246,119,127
20634,Mayru,ragnaros,1651,paladin,holy,39,20,19
20635,Pallice,queldorei,1651,paladin,holy,96,43,53
20636,Bombboyozjr,area-52,1649,paladin,holy,30,20,10
20637,Lalatinaford,amanthul,1647,paladin,holy,76,44,32
20638,Ppgddxx,azralon,1643,paladin,holy,30,18,12
20639,Nerfretpls,area-52,1642,paladin,holy,42,20,22
20640,Citylights,tichondrius,1640,paladin,holy,27,19,8
20641,Dazargeros,moon-guard,1638,paladin,holy,132,66,66
20642,Bpalaayo,kelthuzad,1636,paladin,holy,94,37,57
20643,Ellyarian,emerald-dream,1635,paladin,holy,42,22,20
20644,Teenytoots,burning-legion,1635,paladin,holy,69,26,43
20645,Yuuichi,moon-guard,1634,paladin,holy,64,29,35
20646,Gwok,thrall,1633,paladin,holy,136,76,60
20647,Enzõ,illidan,1632,paladin,holy,42,23,19
20648,Rhönin,sargeras,1632,paladin,holy,54,22,32
20649,Rhunon,dalaran,1631,paladin,holy,78,41,37
20650,Shazuwu,illidan,1630,paladin,holy,30,17,13
20651,Xcuse,tichondrius,1630,paladin,holy,84,43,41
20652,Bopthebomb,sargeras,1628,paladin,holy,65,32,33
20653,Pála,dalaran,1625,paladin,holy,164,80,84
20654,Deepnasty,galakrond,1624,paladin,holy,215,110,105
20655,Barcie,lothar,1624,paladin,holy,54,18,36
20656,Mangoflash,malganis,1622,paladin,holy,48,18,30
20657,Bopbotx,area-52,1621,paladin,holy,49,17,32
20658,Gospel,duskwood,1617,paladin,holy,65,37,28
20659,Scoopzi,frostmourne,1616,paladin,holy,47,27,20
20660,Rhönin,illidan,1616,paladin,holy,42,22,20
20661,Ascion,tichondrius,1614,paladin,holy,119,58,61
20662,Caitthegreat,malorne,1613,paladin,holy,42,23,19
20663,Sekitar,ragnaros,1611,paladin,holy,155,79,76
20664,Zergmé,executus,1610,paladin,holy,42,21,21
20665,Ricopal,frostmourne,1610,paladin,holy,36,17,19
20666,Jealp,sargeras,1608,paladin,holy,42,26,16
20667,Roundhere,area-52,1608,paladin,holy,30,18,12
20668,Larryhoova,malganis,1608,paladin,holy,36,20,16
20669,Crâfty,bleeding-hollow,1608,paladin,holy,83,45,38
20670,Forsakenlite,sargeras,1606,paladin,holy,90,41,49
20671,Ddeuk,tichondrius,1603,paladin,holy,373,189,184
20672,Minefujiko,tichondrius,1603,paladin,holy,377,191,186
20673,Erikx,smolderthorn,1601,paladin,holy,120,66,54
20674,Orphandog,zuljin,1600,paladin,holy,29,21,8
20675,Sevenword,tichondrius,1600,paladin,holy,52,31,21
20676,Gjoker,azralon,1600,paladin,holy,42,25,17
20677,Chonsic,darkspear,1599,paladin,holy,64,28,36
20678,Jiraya,nemesis,1598,paladin,holy,79,39,40
20679,Saveursavior,bleeding-hollow,1597,paladin,holy,129,64,65
20680,Wuhbp,illidan,1596,paladin,holy,88,44,44
20681,Bushys,tichondrius,1596,paladin,holy,36,18,18
20682,Guerrer,hyjal,1594,paladin,holy,404,208,196
20683,Asherm,moon-guard,1590,paladin,holy,98,48,50
20684,Retsincewod,zuluhed,1586,paladin,holy,54,28,26
20685,Molki,tichondrius,1583,paladin,holy,99,59,40
20686,Thelac,dalaran,1575,paladin,holy,72,39,33
20687,Regivän,azralon,1575,paladin,holy,78,39,39
20688,Pasda,frostmourne,1575,paladin,holy,53,22,31
20689,Dodgeandhoj,nerzhul,1572,paladin,holy,36,19,17
20690,Aluríel,quelthalas,1568,paladin,holy,56,28,28
20691,Peelmeree,kelthuzad,1565,paladin,holy,36,18,18
20692,Beejae,stormreaver,1565,paladin,holy,41,17,24
20693,Quertz,sargeras,1564,paladin,holy,62,44,18
20694,Hônòr,thrall,1564,paladin,holy,51,29,22
20695,Naxzy,quelthalas,1564,paladin,holy,36,20,16
20696,Sprjustice,frostmourne,1562,paladin,holy,36,18,18
20697,Raigha,stormrage,1558,paladin,holy,36,19,17
20698,Gazapal,thrall,1556,paladin,holy,150,83,67
20699,Drägonmynuts,tichondrius,1556,paladin,holy,103,43,60
20700,Montageflav,illidan,1554,paladin,holy,56,27,29
20701,Gorgona,illidan,1551,paladin,holy,107,53,54
20702,Crabsaladpal,illidan,1550,paladin,holy,112,62,50
20703,Handsomedan,twisting-nether,1550,paladin,holy,54,26,28
20704,Jiberish,illidan,1548,paladin,holy,110,53,57
20705,Blarr,azshara,1541,paladin,holy,60,25,35
20706,Riptonix,stormrage,1540,paladin,holy,121,66,55
20707,Discordnitro,illidan,1539,paladin,holy,36,20,16
20708,Runihaveaids,stormrage,1538,paladin,holy,154,78,76
20709,Shagalaga,tichondrius,1534,paladin,holy,78,37,41
20710,Baitur,zuljin,1530,paladin,holy,31,17,14
20711,Avahir,moon-guard,1528,paladin,holy,60,30,30
20712,Solfire,stormreaver,1526,paladin,holy,74,32,42
20713,Rodrigo,frostmourne,1524,paladin,holy,69,34,35
20714,Kidstable,nathrezim,1523,paladin,holy,70,27,43
20715,Songminsu,proudmoore,1522,paladin,holy,70,28,42
20716,Beyönd,quelthalas,1520,paladin,holy,78,39,39
20717,Pandahorn,tichondrius,1520,paladin,holy,54,23,31
20718,Dageraad,tichondrius,1519,paladin,holy,30,16,14
20719,Bigoldman,tichondrius,1519,paladin,holy,72,37,35
20720,Drisx,sargeras,1514,paladin,holy,78,35,43
20721,Maeyz,sargeras,1511,paladin,holy,126,67,59
20722,Bushÿ,tichondrius,1508,paladin,holy,94,52,42
20723,Humañ,tichondrius,1507,paladin,holy,60,32,28
20724,Cjqcjq,tichondrius,1507,paladin,holy,41,21,20
20725,Buqi,barthilas,1506,paladin,holy,39,17,22
20726,Kdex,tichondrius,1505,paladin,holy,84,37,47
20727,Ageroÿ,sargeras,1503,paladin,holy,61,31,30
20728,Doofum,stormrage,1503,paladin,holy,131,58,73
20729,Serendipidy,bleeding-hollow,1503,paladin,holy,98,43,55
20730,Brumm,quelthalas,1501,paladin,holy,77,39,38
20731,Vitabro,bleeding-hollow,1500,paladin,holy,101,56,45
20732,Wokeinator,malganis,1500,paladin,holy,231,125,106
20733,Rarth,nemesis,1497,paladin,holy,47,20,27
20734,Rg,nerzhul,1496,paladin,holy,179,86,93
20735,Jeromee,area-52,1496,paladin,holy,48,19,29
20736,Haitishammer,stormrage,1494,paladin,holy,78,37,41
20737,Lightkillerx,thrall,1494,paladin,holy,84,37,47
20738,Wonpai,frostmourne,1490,paladin,holy,36,18,18
20739,Xinqingle,tichondrius,1489,paladin,holy,329,162,167
20740,Nickiminhoj,stormrage,1488,paladin,holy,51,29,22
20741,Donkeydumper,wyrmrest-accord,1486,paladin,holy,118,67,51
20742,Allitharis,tichondrius,1486,paladin,holy,97,53,44
20743,Condone,earthen-ring,1484,paladin,holy,90,41,49
20744,Leónrey,stormrage,1484,paladin,holy,57,20,37
20745,Regivan,nemesis,1479,paladin,holy,42,16,26
20746,Senorbaxter,emerald-dream,1478,paladin,holy,48,17,31
20747,Dewlight,zuljin,1477,paladin,holy,161,77,84
20748,Jorik,lightbringer,1477,paladin,holy,42,20,22
20749,Granklol,tichondrius,1476,paladin,holy,50,25,25
20750,Percüles,sargeras,1473,paladin,holy,66,38,28
20751,Prettylightx,kelthuzad,1473,paladin,holy,164,79,85
20752,Ibury,quelthalas,1472,paladin,holy,131,60,71
20753,Ryhigh,sargeras,1471,paladin,holy,48,19,29
20754,Droopyz,quelthalas,1468,paladin,holy,60,26,34
20755,Judgemode,the-scryers,1468,paladin,holy,96,41,55
20756,Varies,kelthuzad,1466,paladin,holy,34,16,18
20757,Daenrahh,azralon,1465,paladin,holy,164,84,80
20758,Gotomars,tichondrius,1465,paladin,holy,71,34,37
20759,Glørythrives,tichondrius,1465,paladin,holy,57,25,32
20760,Konvi,tichondrius,1464,paladin,holy,60,24,36
20761,Traumaboy,terenas,1463,paladin,holy,57,28,29
20762,Cohesion,draenor,1461,paladin,holy,77,35,42
20763,Bebebig,tichondrius,1460,paladin,holy,60,35,25
20764,Indemnity,wildhammer,1457,paladin,holy,69,40,29
20765,Nume,nesingwary,1456,paladin,holy,90,47,43
20766,Gankstapwn,tichondrius,1455,paladin,holy,53,24,29
20767,Devöut,aggramar,1453,paladin,holy,103,48,55
20768,Holyterror,dentarg,1451,paladin,holy,42,23,19
20769,Zakath,the-underbog,1449,paladin,holy,72,31,41
20770,Zoeyxo,tichondrius,1448,paladin,holy,80,42,38
20771,Noback,ragnaros,1448,paladin,holy,66,31,35
20772,Handyandy,kelthuzad,1447,paladin,holy,100,52,48
20773,Kihluxo,frostmourne,1446,paladin,holy,101,56,45
20774,Wálker,ragnaros,1446,paladin,holy,74,39,35
20775,Holyknight,veknilash,1446,paladin,holy,71,32,39
20776,Celsica,kelthuzad,1443,paladin,holy,153,73,80
20777,Chowdar,proudmoore,1443,paladin,holy,78,36,42
20778,Holyprotectr,tichondrius,1442,paladin,holy,30,17,13
20779,Danyuel,zuljin,1441,paladin,holy,86,39,47
20780,Sigmapepe,quelthalas,1436,paladin,holy,96,52,44
20781,Cynical,dalvengyr,1435,paladin,holy,108,59,49
20782,Zephyrvalor,sargeras,1430,paladin,holy,42,18,24
20783,Kriegmeister,amanthul,1429,paladin,holy,48,24,24
20784,Rezmefool,tichondrius,1428,paladin,holy,115,54,61
20785,Sinfolly,whisperwind,1427,paladin,holy,66,33,33
20786,Omfgitsyang,tichondrius,1426,paladin,holy,30,18,12
20787,Nrpzy,stormrage,1425,paladin,holy,83,39,44
20788,Lothnalar,ragnaros,1424,paladin,holy,54,23,31
20789,Mabia,tichondrius,1421,paladin,holy,215,111,104
20790,Graceyrae,tichondrius,1419,paladin,holy,50,30,20
20791,Jpwx,barthilas,1419,paladin,holy,30,15,15
20792,Amadeo,hyjal,1418,paladin,holy,95,44,51
20793,Decalli,tichondrius,1417,paladin,holy,69,35,34
20794,Danpros,azralon,1417,paladin,holy,66,24,42
20795,Bosat,drakkari,1416,paladin,holy,36,15,21
20796,Xuanxingchai,tichondrius,1413,paladin,holy,72,30,42
20797,Vodokus,area-52,1412,paladin,holy,48,17,31
20798,Piïls,sargeras,1410,paladin,holy,36,15,21
20799,Jezëbel,azralon,1408,paladin,holy,24,15,9
20800,Vasar,tichondrius,1406,paladin,holy,37,26,11
20801,Wonpaiv,frostmourne,1404,paladin,holy,35,15,20
20802,Moonmi,tichondrius,1403,paladin,holy,115,61,54
20803,Nxkita,sargeras,1403,paladin,holy,54,28,26
20804,Oralen,daggerspine,1402,paladin,holy,48,24,24
20805,Nanøha,frostmourne,1402,paladin,holy,88,26,62
20806,Delilahxoxo,mugthol,1400,paladin,holy,45,18,27
20807,Talantyr,zuljin,1398,paladin,holy,48,23,25
20808,Uprise,chogall,1397,paladin,holy,66,33,33
20809,Fabîan,guldan,1395,paladin,holy,42,22,20
20810,Vêgenace,proudmoore,1394,paladin,holy,39,19,20
20811,Dadcantsac,frostmourne,1391,paladin,holy,81,38,43
20812,Anea,kelthuzad,1388,paladin,holy,32,17,15
20813,Summercarma,area-52,1387,paladin,holy,27,15,12
20814,Luminainre,zuljin,1384,paladin,holy,149,66,83
20815,Liå,frostmourne,1383,paladin,holy,84,43,41
20816,Ricemang,kiljaeden,1380,paladin,holy,53,24,29
20817,Samaze,tichondrius,1378,paladin,holy,99,46,53
20818,Twck,hyjal,1374,paladin,holy,114,55,59
20819,Lu,the-venture-co,1371,paladin,holy,34,15,19
20820,Fiate,azralon,1370,paladin,holy,36,16,20
20821,Jimmipepe,quelthalas,1369,paladin,holy,42,24,18
20822,Shaidd,bleeding-hollow,1368,paladin,holy,77,34,43
20823,Zacháry,sargeras,1367,paladin,holy,176,87,89
20824,Saeranella,moon-guard,1366,paladin,holy,106,44,62
20825,Granitei,quelthalas,1365,paladin,holy,39,18,21
20826,Paladinaa,lothar,1364,paladin,holy,104,41,63
20827,Odiinn,stormscale,1363,paladin,holy,73,32,41
20828,Gorilla,kiljaeden,1362,paladin,holy,59,15,44
20829,Holyhades,auchindoun,1360,paladin,holy,85,46,39
20830,Rengen,frostmourne,1360,paladin,holy,42,22,20
20831,Choonsly,tichondrius,1356,paladin,holy,69,36,33
20832,Bakoø,tichondrius,1354,paladin,holy,53,24,29
20833,Holyramen,illidan,1354,paladin,holy,146,66,80
20834,Palapoxi,arygos,1353,paladin,holy,54,23,31
20835,Splashleyy,bleeding-hollow,1353,paladin,holy,96,40,56
20836,Saphri,kiljaeden,1353,paladin,holy,63,26,37
20837,Brioc,tichondrius,1352,paladin,holy,30,17,13
20838,Galabanja,malganis,1350,paladin,holy,42,24,18
20839,Hawtwangs,proudmoore,1349,paladin,holy,48,26,22
20840,Flippo,sargeras,1346,paladin,holy,36,17,19
20841,Quadrifoglio,moon-guard,1344,paladin,holy,199,100,99
20842,Airbusx,tichondrius,1343,paladin,holy,24,14,10
20843,Miswalkpally,ragnaros,1342,paladin,holy,30,14,16
20844,Censy,tichondrius,1341,paladin,holy,24,14,10
20845,Dartpuncher,frostmourne,1340,paladin,holy,42,21,21
20846,Chunzhangsqs,tichondrius,1339,paladin,holy,36,14,22
20847,Therealdeal,sargeras,1338,paladin,holy,51,28,23
20848,Htmlar,tichondrius,1338,paladin,holy,75,41,34
20849,Xiaoladin,frostmourne,1337,paladin,holy,25,16,9
20850,Güido,stormrage,1337,paladin,holy,42,23,19
20851,Minereth,quelthalas,1337,paladin,holy,59,30,29
20852,Leonrey,stormrage,1337,paladin,holy,43,21,22
20853,Dwarrior,quelthalas,1337,paladin,holy,33,15,18
20854,Donoph,blades-edge,1336,paladin,holy,42,20,22
20855,Finerkane,quelthalas,1334,paladin,holy,138,62,76
20856,Alphanerd,burning-blade,1333,paladin,holy,55,27,28
20857,Hawianbread,stormrage,1331,paladin,holy,60,33,27
20858,Buri,tichondrius,1330,paladin,holy,42,17,25
20859,Maleguz,azralon,1328,paladin,holy,220,112,108
20860,Syrenz,khazgoroth,1327,paladin,holy,42,24,18
20861,Castleknight,tichondrius,1327,paladin,holy,36,14,22
20862,Catechism,laughing-skull,1325,paladin,holy,44,24,20
20863,Jordenz,bonechewer,1324,paladin,holy,30,14,16
20864,Consecrated,daggerspine,1324,paladin,holy,75,30,45
20865,Ryhighh,sargeras,1324,paladin,holy,81,32,49
20866,Mcllovin,kiljaeden,1323,paladin,holy,60,28,32
20867,Dimior,quelthalas,1322,paladin,holy,54,29,25
20868,Paladinaiko,nemesis,1322,paladin,holy,111,56,55
20869,Zantdemption,frostmourne,1322,paladin,holy,30,15,15
20870,Kektrixia,tichondrius,1318,paladin,holy,24,15,9
20871,Ùnholypally,jubeithos,1316,paladin,holy,71,42,29
20872,Valandiel,proudmoore,1315,paladin,holy,61,15,46
20873,Holyslapy,illidan,1313,paladin,holy,59,34,25
20874,Hodl,barthilas,1311,paladin,holy,95,49,46
20875,Kenric,quelthalas,1309,paladin,holy,43,18,25
20876,Solanin,frostmourne,1307,paladin,holy,57,30,27
20877,Ramphastoz,quelthalas,1307,paladin,holy,60,26,34
20878,Ozpal,burning-blade,1305,paladin,holy,38,24,14
20879,Errant,bonechewer,1305,paladin,holy,53,31,22
20880,Santiadin,ragnaros,1304,paladin,holy,20,15,5
20881,Jestiny,amanthul,1302,paladin,holy,73,39,34
20882,Dreadrot,azralon,1302,paladin,holy,50,24,26
20883,Unbreakable,antonidas,1301,paladin,holy,30,21,9
20884,Sorkar,tichondrius,1301,paladin,holy,129,66,63
20885,Ironpaladin,sargeras,1297,paladin,holy,90,39,51
20886,Jaenus,azralon,1296,paladin,holy,54,25,29
20887,Vurian,uther,1295,paladin,holy,90,36,54
20888,Malakor,thrall,1293,paladin,holy,63,32,31
20889,Goodwood,ghostlands,1293,paladin,holy,90,41,49
20890,Thiccholy,deathwing,1289,paladin,holy,122,70,52
20891,Theebus,tichondrius,1287,paladin,holy,47,15,32
20892,Blessthfall,bleeding-hollow,1286,paladin,holy,51,14,37
20893,Mawning,kelthuzad,1277,paladin,holy,122,61,61
20894,Phinnik,tichondrius,1276,paladin,holy,178,91,87
20895,Imabandagins,bleeding-hollow,1274,paladin,holy,30,15,15
20896,Swordstrikes,tichondrius,1271,paladin,holy,29,14,15
20897,Galeras,norgannon,1271,paladin,holy,121,52,69
20898,Lilfingered,malganis,1267,paladin,holy,36,19,17
20899,Merll,ragnaros,1265,paladin,holy,115,55,60
20900,Affrika,ysondre,1264,paladin,holy,104,52,52
20901,Pallin,sargeras,1264,paladin,holy,90,41,49
20902,Quarall,blackhand,1263,paladin,holy,52,25,27
20903,Psuito,ragnaros,1258,paladin,holy,48,25,23
20904,Salipally,dalaran,1258,paladin,holy,101,46,55
20905,Brenenk,quelthalas,1257,paladin,holy,65,32,33
20906,Vithar,bleeding-hollow,1257,paladin,holy,116,56,60
20907,Babylonfive,zuluhed,1257,paladin,holy,51,21,30
20908,Holysplonk,stonemaul,1255,paladin,holy,72,30,42
20909,Swazanaseger,frostmourne,1252,paladin,holy,36,19,17
20910,Wukongsunn,dalaran,1251,paladin,holy,30,14,16
20911,Sinay,azshara,1250,paladin,holy,40,23,17
20912,Holyredx,bleeding-hollow,1250,paladin,holy,96,52,44
20913,Chewiipal,dalaran,1248,paladin,holy,45,26,19
20914,Röniin,ragnaros,1248,paladin,holy,262,134,128
20915,Whitekao,illidan,1247,paladin,holy,18,13,5
20916,Colbroggins,crushridge,1246,paladin,holy,36,18,18
20917,Everrlasting,tichondrius,1245,paladin,holy,30,13,17
20918,Darkbringer,frostmourne,1244,paladin,holy,63,31,32
20919,Stephon,area-52,1244,paladin,holy,30,13,17
20920,Cewekmbek,barthilas,1244,paladin,holy,36,13,23
20921,Kensyzs,tichondrius,1244,paladin,holy,36,13,23
20922,Bubblepigo,tichondrius,1243,paladin,holy,36,22,14
20923,Nikopala,tichondrius,1242,paladin,holy,30,17,13
20924,Sologriefer,sargeras,1242,paladin,holy,30,13,17
20925,Abellpally,tichondrius,1241,paladin,holy,30,13,17
20926,Herroprease,frostmane,1241,paladin,holy,30,13,17
20927,Aulty,sargeras,1241,paladin,holy,30,13,17
20928,Scarlet,skywall,1241,paladin,holy,30,13,17
20929,Denthus,dragonmaw,1240,paladin,holy,30,13,17
20930,Bërzerk,zuluhed,1239,paladin,holy,36,13,23
20931,Kristienna,boulderfist,1236,paladin,holy,35,16,19
20932,Hughmyron,stormrage,1235,paladin,holy,18,13,5
20933,Cbm,tichondrius,1235,paladin,holy,23,14,9
20934,Fuzed,frostmourne,1234,paladin,holy,159,80,79
20935,Judgynomnom,the-underbog,1234,paladin,holy,36,13,23
20936,Neurôtoxins,frostmourne,1233,paladin,holy,24,13,11
20937,Kencyxx,tichondrius,1233,paladin,holy,30,13,17
20938,Oldgrumpster,stormrage,1232,paladin,holy,93,43,50
20939,Harryhui,tichondrius,1231,paladin,holy,24,13,11
20940,Diebeatus,zuljin,1231,paladin,holy,54,25,29
20941,Amiigo,tichondrius,1231,paladin,holy,36,13,23
20942,Aoishie,bleeding-hollow,1229,paladin,holy,84,38,46
20943,Justizz,vashj,1228,paladin,holy,65,35,30
20944,Enuug,malfurion,1226,paladin,holy,42,23,19
20945,Mundomaloo,quelthalas,1226,paladin,holy,59,31,28
20946,Crocfacex,tichondrius,1226,paladin,holy,46,18,28
20947,Negodoskate,nemesis,1225,paladin,holy,189,91,98
20948,Szsfstnoob,tichondrius,1224,paladin,holy,30,13,17
20949,Aellithiene,tichondrius,1221,paladin,holy,30,13,17
20950,Elizzabeth,skullcrusher,1220,paladin,holy,35,21,14
20951,Cudiskush,tichondrius,1219,paladin,holy,42,23,19
20952,Ramspartan,drakkari,1218,paladin,holy,106,52,54
20953,Whangsta,tichondrius,1217,paladin,holy,48,21,27
20954,Boarfarmer,tichondrius,1215,paladin,holy,81,35,46
20955,Saffranzord,azralon,1214,paladin,holy,73,35,38
20956,Undefeatæd,korgath,1214,paladin,holy,42,20,22
20957,Tandury,tichondrius,1214,paladin,holy,60,28,32
20958,Kamaelyn,proudmoore,1211,paladin,holy,133,68,65
20959,Capedcrusade,area-52,1208,paladin,holy,24,13,11
20960,Hobbsone,trollbane,1208,paladin,holy,113,43,70
20961,Yérn,barthilas,1208,paladin,holy,42,15,27
20962,Xq,aegwynn,1205,paladin,holy,38,18,20
20963,Lightleadsme,sargeras,1205,paladin,holy,36,15,21
20964,Randuir,proudmoore,1204,paladin,holy,48,26,22
20965,Burgalveist,azgalor,1202,paladin,holy,25,15,10
20966,Chopsparks,khadgar,1201,paladin,holy,147,75,72
20967,Maaxxee,zuljin,1200,paladin,holy,27,13,14
20968,Mörphêus,tichondrius,1197,paladin,holy,54,30,24
20969,Encantado,thrall,1196,paladin,holy,31,15,16
20970,Shorthordeon,kelthuzad,1194,paladin,holy,54,30,24
20971,Dreemie,tichondrius,1194,paladin,holy,54,20,34
20972,Dbolpala,frostmourne,1192,paladin,holy,48,26,22
20973,Pemodyne,illidan,1189,paladin,holy,54,16,38
20974,Pallythre,proudmoore,1187,paladin,holy,54,23,31
20975,Faileeria,malganis,1185,paladin,holy,36,25,11
20976,Sixtynine,nathrezim,1180,paladin,holy,78,35,43
20977,Prosykt,sargeras,1179,paladin,holy,36,14,22
20978,Myrthedara,kargath,1178,paladin,holy,33,16,17
20979,Barbaluzz,quelthalas,1174,paladin,holy,257,123,134
20980,Stemi,kelthuzad,1171,paladin,holy,41,15,26
20981,Cowladino,tichondrius,1169,paladin,holy,36,15,21
20982,Bárdokø,ragnaros,1168,paladin,holy,60,28,32
20983,Coltlocks,sargeras,1168,paladin,holy,36,14,22
20984,Clehley,turalyon,1162,paladin,holy,36,16,20
20985,Hammercy,tichondrius,1155,paladin,holy,73,39,34
20986,Chewyjitsu,tichondrius,1155,paladin,holy,42,15,27
20987,Onecmpeter,kelthuzad,1152,paladin,holy,67,38,29
20988,Boxjang,tichondrius,1149,paladin,holy,24,12,12
20989,Savagegirlz,tichondrius,1147,paladin,holy,76,33,43
20990,Bubblebooty,drakthul,1146,paladin,holy,54,33,21
20991,Kënsi,quelthalas,1146,paladin,holy,140,71,69
20992,Zenkk,sargeras,1146,paladin,holy,28,13,15
20993,Toesy,area-52,1146,paladin,holy,64,27,37
20994,Renteria,sargeras,1144,paladin,holy,24,12,12
20995,Sinara,detheroc,1143,paladin,holy,119,56,63
20996,Repèntance,stormrage,1142,paladin,holy,24,12,12
20997,Dazztrain,barthilas,1139,paladin,holy,24,12,12
20998,Deepsearide,illidan,1139,paladin,holy,54,26,28
20999,Exxin,turalyon,1139,paladin,holy,90,40,50
21000,Elogant,mannoroth,1138,paladin,holy,58,33,25
21001,Flareous,moon-guard,1138,paladin,holy,30,12,18
21002,Massivesac,frostmourne,1135,paladin,holy,18,12,6
21003,Crüst,proudmoore,1135,paladin,holy,24,12,12
21004,Daik,proudmoore,1134,paladin,holy,24,15,9
21005,Toroke,nemesis,1133,paladin,holy,54,29,25
21006,Alarter,azralon,1128,paladin,holy,36,13,23
21007,Dóminos,quelthalas,1127,paladin,holy,24,12,12
21008,Belmonte,greymane,1125,paladin,holy,18,12,6
21009,Kentö,area-52,1123,paladin,holy,30,14,16
21010,Bonz,ragnaros,1121,paladin,holy,24,12,12
21011,Sloppybobby,zuljin,1119,paladin,holy,30,16,14
21012,Ziggzag,hyjal,1117,paladin,holy,78,34,44
21013,Dawnhammer,mugthol,1115,paladin,holy,52,25,27
21014,Biwi,zuljin,1115,paladin,holy,61,25,36
21015,Ëd,moon-guard,1110,paladin,holy,168,83,85
21016,Zowolf,quelthalas,1108,paladin,holy,65,33,32
21017,Acori,azralon,1108,paladin,holy,39,18,21
21018,Kelthor,azralon,1104,paladin,holy,36,18,18
21019,Lovehan,tichondrius,1103,paladin,holy,27,12,15
21020,Holysols,zuljin,1102,paladin,holy,24,12,12
21021,Moogmodular,malganis,1100,paladin,holy,39,15,24
21022,Lavarball,tichondrius,1098,paladin,holy,41,14,27
21023,Rykeran,warsong,1096,paladin,holy,96,55,41
21024,Balanoriaa,azralon,1092,paladin,holy,62,29,33
21025,Lobõ,ragnaros,1086,paladin,holy,48,18,30
21026,Maín,tichondrius,1085,paladin,holy,22,12,10
21027,Liadrin,sentinels,1085,paladin,holy,29,12,17
21028,Teloniow,quelthalas,1084,paladin,holy,38,19,19
21029,Hivers,stormrage,1081,paladin,holy,48,22,26
21030,Spikele,barthilas,1079,paladin,holy,30,13,17
21031,Joeboomers,tichondrius,1078,paladin,holy,60,33,27
21032,Shocka,norgannon,1078,paladin,holy,90,48,42
21033,Maldobarr,stormrage,1075,paladin,holy,30,12,18
21034,Resio,illidan,1068,paladin,holy,36,13,23
21035,Lycheelz,illidan,1064,paladin,holy,48,26,22
21036,Unworn,proudmoore,1064,paladin,holy,36,17,19
21037,Júpiter,kiljaeden,1064,paladin,holy,40,17,23
21038,Justeight,stormrage,1063,paladin,holy,35,16,19
21039,Vidalia,barthilas,1062,paladin,holy,23,12,11
21040,Buckybarnes,gorefiend,1061,paladin,holy,42,26,16
21041,Cephadrome,proudmoore,1058,paladin,holy,42,20,22
21042,Mèdic,illidan,1057,paladin,holy,62,34,28
21043,Mctacos,proudmoore,1056,paladin,holy,12,11,1
21044,Odriew,sargeras,1056,paladin,holy,18,11,7
21045,Narcissism,emerald-dream,1056,paladin,holy,18,11,7
21046,Babe,crushridge,1056,paladin,holy,24,11,13
21047,Twichy,tichondrius,1055,paladin,holy,18,11,7
21048,Waifu,area-52,1055,paladin,holy,18,11,7
21049,Lazio,frostmourne,1055,paladin,holy,24,11,13
21050,Holodecoy,bleeding-hollow,1055,paladin,holy,27,12,15
21051,Lickmysacx,tichondrius,1055,paladin,holy,30,11,19
21052,Roundbutts,stormrage,1054,paladin,holy,18,11,7
21053,Aldrion,stormrage,1054,paladin,holy,24,11,13
21054,Beerüs,crushridge,1053,paladin,holy,48,22,26
21055,Eldessia,wyrmrest-accord,1052,paladin,holy,24,11,13
21056,Malakk,zuljin,1051,paladin,holy,47,25,22
21057,Tigranes,proudmoore,1051,paladin,holy,24,11,13
21058,Ramhammerz,sargeras,1051,paladin,holy,54,23,31
21059,Nilin,tichondrius,1050,paladin,holy,18,11,7
21060,Overthrrow,kelthuzad,1050,paladin,holy,138,71,67
21061,Kolmourn,deathwing,1048,paladin,holy,30,11,19
21062,Palooma,area-52,1047,paladin,holy,72,29,43
21063,Notdjalex,zuljin,1046,paladin,holy,18,11,7
21064,Hybbo,runetotem,1042,paladin,holy,24,12,12
21065,Tyriam,stormscale,1038,paladin,holy,18,11,7
21066,Yadiyadiyada,barthilas,1038,paladin,holy,18,11,7
21067,Mcduss,proudmoore,1037,paladin,holy,18,11,7
21068,Jacobhowda,tichondrius,1037,paladin,holy,30,11,19
21069,Nugsbunne,tichondrius,1035,paladin,holy,115,49,66
21070,Pheriox,agamaggan,1032,paladin,holy,24,11,13
21071,Starfaith,illidan,1032,paladin,holy,67,27,40
21072,Lukas,vashj,1030,paladin,holy,132,65,67
21073,Va,onyxia,1029,paladin,holy,54,26,28
21074,Wrathmatics,arthas,1028,paladin,holy,35,14,21
21075,Palqq,tichondrius,1025,paladin,holy,24,11,13
21076,Kipow,proudmoore,1024,paladin,holy,24,11,13
21077,Klansey,magtheridon,1023,paladin,holy,54,30,24
21078,Ahundo,stonemaul,1022,paladin,holy,35,18,17
21079,Center,ragnaros,1022,paladin,holy,23,11,12
21080,Tylnish,hyjal,1021,paladin,holy,24,11,13
21081,Troxnar,ragnaros,1020,paladin,holy,34,22,12
21082,Palaadiin,sargeras,1019,paladin,holy,48,24,24
21083,Xöchïqüëtzäl,tichondrius,1016,paladin,holy,23,11,12
21084,Varenka,stormrage,1015,paladin,holy,83,36,47
21085,Iamholyman,dragonmaw,1014,paladin,holy,29,14,15
21086,Vamir,magtheridon,1014,paladin,holy,30,13,17
21087,Ihr,kiljaeden,1013,paladin,holy,63,28,35
21088,Jazzmatic,dalaran,1012,paladin,holy,23,11,12
21089,Paladinomoto,sargeras,1011,paladin,holy,29,12,17
21090,Rajava,gallywix,1008,paladin,holy,54,26,28
21091,Kbot,zuljin,1005,paladin,holy,15,11,4
21092,Tarnak,kelthuzad,1005,paladin,holy,33,11,22
21093,Paulx,malganis,999,paladin,holy,87,46,41
21094,Gigadunker,tichondrius,999,paladin,holy,29,13,16
21095,Minouther,area-52,996,paladin,holy,68,25,43
21096,Caobobby,tichondrius,996,paladin,holy,39,12,27
21097,Ðß,arthas,995,paladin,holy,30,15,15
21098,Westlysñipes,tichondrius,995,paladin,holy,92,44,48
21099,Hzo,tichondrius,989,paladin,holy,17,11,6
21100,Kaina,wildhammer,987,paladin,holy,53,22,31
21101,Colombía,illidan,986,paladin,holy,54,27,27
21102,Agravaine,moon-guard,986,paladin,holy,23,11,12
21103,Ckemosabe,emerald-dream,985,paladin,holy,32,11,21
21104,Dispirit,the-forgotten-coast,981,paladin,holy,17,11,6
21105,Shanvo,tichondrius,977,paladin,holy,34,21,13
21106,Adventholy,tichondrius,970,paladin,holy,36,15,21
21107,Huijji,illidan,967,paladin,holy,24,15,9
21108,Photons,emerald-dream,966,paladin,holy,24,13,11
21109,Seonghwa,kelthuzad,964,paladin,holy,52,28,24
21110,Romeoo,silver-hand,964,paladin,holy,66,26,40
21111,Hammerabi,moon-guard,963,paladin,holy,21,13,8
21112,Imajeala,thrall,961,paladin,holy,40,21,19
21113,Thoryin,tichondrius,960,paladin,holy,12,10,2
21114,Síríús,malganis,960,paladin,holy,15,11,4
21115,Svitanie,bleeding-hollow,960,paladin,holy,80,38,42
21116,Showtíme,steamwheedle-cartel,959,paladin,holy,18,10,8
21117,Arevia,stormrage,959,paladin,holy,18,10,8
21118,Kencyz,tichondrius,959,paladin,holy,18,10,8
21119,Boundric,emerald-dream,959,paladin,holy,18,10,8
21120,Madorian,bleeding-hollow,959,paladin,holy,24,10,14
21121,Bubblet,bleeding-hollow,958,paladin,holy,18,10,8
21122,Klam,kelthuzad,958,paladin,holy,24,10,14
21123,Vajuicy,dalaran,957,paladin,holy,24,10,14
21124,Lightswitchx,stormrage,957,paladin,holy,24,10,14
21125,Jdxqt,darkspear,957,paladin,holy,30,10,20
21126,Viviana,shadowmoon,955,paladin,holy,24,10,14
21127,Marklite,area-52,955,paladin,holy,24,10,14
21128,Raenilil,area-52,955,paladin,holy,30,12,18
21129,Evanlina,bleeding-hollow,953,paladin,holy,18,10,8
21130,Avasti,proudmoore,953,paladin,holy,24,10,14
21131,Dragonchaos,ragnaros,953,paladin,holy,27,11,16
21132,Sanasana,spirestone,952,paladin,holy,18,10,8
21133,Palladomal,azralon,952,paladin,holy,30,10,20
21134,Snnow,stormrage,951,paladin,holy,30,19,11
21135,Motoa,stormrage,951,paladin,holy,18,10,8
21136,Sventyn,frostmourne,951,paladin,holy,25,11,14
21137,Paladam,burning-blade,948,paladin,holy,24,10,14
21138,Holydood,thunderhorn,947,paladin,holy,18,10,8
21139,Stompcomp,tichondrius,945,paladin,holy,63,29,34
21140,Tolliver,area-52,944,paladin,holy,18,11,7
21141,Lazygamerr,sargeras,944,paladin,holy,18,10,8
21142,Blackiron,frostmourne,941,paladin,holy,23,10,13
21143,Doidyph,frostmourne,935,paladin,holy,24,10,14
21144,Eradrae,mannoroth,933,paladin,holy,18,10,8
21145,Gênji,eldrethalas,930,paladin,holy,54,20,34
21146,Saìdelia,moon-guard,929,paladin,holy,71,24,47
21147,Swamprat,zuljin,922,paladin,holy,23,10,13
21148,Shâka,stormrage,919,paladin,holy,45,22,23
21149,Mianheyo,quelthalas,919,paladin,holy,35,14,21
21150,Hentaiangel,kiljaeden,918,paladin,holy,39,19,20
21151,Rogrmurtaugh,sargeras,912,paladin,holy,20,11,9
21152,Psychorino,tichondrius,906,paladin,holy,27,10,17
21153,Grumpybubble,sargeras,905,paladin,holy,19,11,8
21154,Zhahira,hakkar,905,paladin,holy,24,10,14
21155,Gillgamesh,sentinels,901,paladin,holy,18,11,7
21156,Thaedrun,hydraxis,896,paladin,holy,54,26,28
21157,Fedpowell,tichondrius,894,paladin,holy,23,10,13
21158,Monad,nazjatar,893,paladin,holy,36,15,21
21159,Shananakin,azshara,892,paladin,holy,29,13,16
21160,Stormzy,zuljin,890,paladin,holy,23,10,13
21161,Takodaddy,elune,889,paladin,holy,16,10,6
21162,Lennon,stormrage,885,paladin,holy,78,35,43
21163,Zakh,proudmoore,882,paladin,holy,26,11,15
21164,Papakatsu,proudmoore,878,paladin,holy,48,22,26
21165,Ascension,amanthul,866,paladin,holy,120,44,76
21166,Bobthemad,proudmoore,864,paladin,holy,12,9,3
21167,Trâshcårt,sargeras,864,paladin,holy,12,9,3
21168,Sovice,illidan,864,paladin,holy,12,9,3
21169,Deadry,ysera,864,paladin,holy,18,9,9
21170,Adrizzyx,barthilas,864,paladin,holy,18,9,9
21171,Rachaelucky,malganis,864,paladin,holy,18,9,9
21172,Zilzag,moon-guard,864,paladin,holy,23,9,14
21173,Diamondwater,tichondrius,864,paladin,holy,24,9,15
21174,Racketyman,illidan,863,paladin,holy,12,9,3
21175,Superzero,area-52,863,paladin,holy,12,9,3
21176,Sutadansa,doomhammer,863,paladin,holy,77,42,35
21177,Onlycams,sargeras,863,paladin,holy,24,9,15
21178,Lhpal,ragnaros,862,paladin,holy,12,9,3
21179,Holymorph,tichondrius,862,paladin,holy,18,9,9
21180,Msheen,azralon,861,paladin,holy,12,9,3
21181,Kusotarão,nemesis,861,paladin,holy,18,9,9
21182,Palltard,illidan,861,paladin,holy,24,9,15
21183,Atelva,moon-guard,859,paladin,holy,17,9,8
21184,Hopeyouheal,sargeras,859,paladin,holy,18,9,9
21185,Chånïng,frostmourne,859,paladin,holy,24,9,15
21186,Herakleitos,firetree,858,paladin,holy,18,9,9
21187,Mobitz,dalvengyr,858,paladin,holy,24,9,15
21188,Stricken,kul-tiras,857,paladin,holy,24,9,15
21189,Spamsalot,malganis,857,paladin,holy,24,9,15
21190,Holyiseasy,alleria,853,paladin,holy,29,11,18
21191,Nedorshock,stormrage,853,paladin,holy,24,9,15
21192,Lafasíta,ragnaros,852,paladin,holy,24,9,15
21193,Veronica,sentinels,852,paladin,holy,42,9,33
21194,Vëlar,tichondrius,851,paladin,holy,18,9,9
21195,Mytolo,malganis,851,paladin,holy,24,9,15
21196,Nualrossan,veknilash,848,paladin,holy,53,21,32
21197,Maalik,thrall,844,paladin,holy,18,9,9
21198,Andormu,wyrmrest-accord,841,paladin,holy,18,9,9
21199,Vaalbara,fizzcrank,834,paladin,holy,24,9,15
21200,Jaok,tichondrius,831,paladin,holy,21,10,11
21201,Bainn,nerzhul,822,paladin,holy,73,31,42
21202,Alltoohuman,nagrand,821,paladin,holy,23,9,14
21203,Nea,argent-dawn,811,paladin,holy,77,29,48
21204,Praisin,zuljin,805,paladin,holy,18,9,9
21205,Palaknight,tichondrius,804,paladin,holy,54,18,36
21206,Davinity,senjin,799,paladin,holy,23,9,14
21207,Athanaiëll,proudmoore,792,paladin,holy,16,10,6
21208,Holyfrénzy,thrall,776,paladin,holy,25,9,16
21209,Swellowsx,tichondrius,768,paladin,holy,12,8,4
21210,Archerxx,ragnaros,768,paladin,holy,12,8,4
21211,Alkyna,kelthuzad,768,paladin,holy,12,8,4
21212,Kritzyx,stormrage,768,paladin,holy,12,8,4
21213,Lòuisvuttion,tichondrius,768,paladin,holy,12,8,4
21214,Denke,thrall,768,paladin,holy,18,8,10
21215,Pality,illidan,768,paladin,holy,18,8,10
21216,Artús,ragnaros,768,paladin,holy,18,8,10
21217,Zero,anetheron,768,paladin,holy,18,8,10
21218,Voladis,malganis,768,paladin,holy,30,8,22
21219,Usebandage,sargeras,767,paladin,holy,12,8,4
21220,Bestpally,alterac-mountains,767,paladin,holy,12,8,4
21221,Mhera,sargeras,767,paladin,holy,12,8,4
21222,Kriegstier,scarlet-crusade,767,paladin,holy,12,8,4
21223,Linaiah,moon-guard,767,paladin,holy,12,8,4
21224,Wonpai,barthilas,767,paladin,holy,18,8,10
21225,Miniweiner,proudmoore,767,paladin,holy,18,8,10
21226,Trancelancer,kelthuzad,767,paladin,holy,18,8,10
21227,Lanzzelot,goldrinn,767,paladin,holy,18,8,10
21228,Hruuhwa,wyrmrest-accord,766,paladin,holy,12,8,4
21229,Caike,frostmourne,766,paladin,holy,12,8,4
21230,Bulgecranker,tichondrius,766,paladin,holy,12,8,4
21231,Palawun,nerzhul,766,paladin,holy,24,8,16
21232,Thonar,stormrage,765,paladin,holy,12,8,4
21233,Revenere,tichondrius,765,paladin,holy,36,8,28
21234,Grumpy,the-forgotten-coast,764,paladin,holy,12,8,4
21235,Instaded,illidan,764,paladin,holy,18,8,10
21236,Pambam,thrall,763,paladin,holy,18,9,9
21237,Jereth,kelthuzad,763,paladin,holy,18,8,10
21238,Etlas,windrunner,763,paladin,holy,18,8,10
21239,Porkwatchy,eonar,762,paladin,holy,24,8,16
21240,Sweettartts,zuljin,762,paladin,holy,30,8,22
21241,Blacktemplar,area-52,755,paladin,holy,18,8,10
21242,Darkwingdad,illidan,752,paladin,holy,33,13,20
21243,Willycrow,nordrassil,740,paladin,holy,18,8,10
21244,Møcha,moon-guard,732,paladin,holy,20,9,11
21245,Mirotchburns,illidan,724,paladin,holy,16,9,7
21246,Ashera,amanthul,722,paladin,holy,26,9,17
21247,Kirilx,vashj,718,paladin,holy,15,9,6
21248,Mfn,tichondrius,714,paladin,holy,18,9,9
21249,Salivan,darkspear,710,paladin,holy,21,9,12
21250,Ilovecanada,sargeras,672,paladin,holy,12,7,5
21251,Shxz,illidan,672,paladin,holy,12,7,5
21252,Imsuffering,zuljin,672,paladin,holy,12,7,5
21253,Cheers,garona,672,paladin,holy,12,7,5
21254,Gimmethéloot,stormrage,672,paladin,holy,12,7,5
21255,Fredward,bleeding-hollow,672,paladin,holy,12,7,5
21256,Oîn,area-52,672,paladin,holy,12,7,5
21257,Bigolbittiez,tichondrius,672,paladin,holy,12,7,5
21258,Xiaoholy,barthilas,672,paladin,holy,12,7,5
21259,Crinject,sargeras,672,paladin,holy,12,7,5
21260,Mlpx,stormrage,672,paladin,holy,12,7,5
21261,Loganholy,tichondrius,672,paladin,holy,12,7,5
21262,Busdid,sargeras,672,paladin,holy,12,7,5
21263,Orekilol,stormrage,672,paladin,holy,18,7,11
21264,Emmipal,tichondrius,672,paladin,holy,18,7,11
21265,Paintthinner,frostmourne,672,paladin,holy,18,7,11
21266,Zayiro,eonar,672,paladin,holy,24,7,17
21267,Stompedlawl,illidan,672,paladin,holy,24,7,17
21268,Sensible,sargeras,672,paladin,holy,24,7,17
21269,Boraz,bleeding-hollow,672,paladin,holy,36,7,29
21270,Doktavius,lightbringer,671,paladin,holy,12,7,5
21271,Thin,ragnaros,671,paladin,holy,12,7,5
21272,Lördnextdoor,tichondrius,671,paladin,holy,12,7,5
21273,Cirillah,quelthalas,671,paladin,holy,12,7,5
21274,Loguto,stormrage,671,paladin,holy,18,7,11
21275,Virkas,area-52,671,paladin,holy,18,7,11
21276,Lemmiéwinkzz,sargeras,671,paladin,holy,18,7,11
21277,Animal,korialstrasz,671,paladin,holy,18,7,11
21278,Shoppee,jubeithos,671,paladin,holy,18,7,11
21279,Sýteck,sargeras,671,paladin,holy,24,7,17
21280,Éætûgýäëí,area-52,671,paladin,holy,42,8,34
21281,Korvén,area-52,670,paladin,holy,12,7,5
21282,Meatburger,stormrage,670,paladin,holy,18,7,11
21283,Rebelion,nagrand,670,paladin,holy,24,7,17
21284,Drgn,azgalor,670,paladin,holy,30,7,23
21285,Pluto,the-underbog,669,paladin,holy,12,7,5
21286,Saxmurderz,tichondrius,669,paladin,holy,12,7,5
21287,Solef,stormrage,669,paladin,holy,18,7,11
21288,Røusseff,azralon,669,paladin,holy,18,7,11
21289,Stationarity,frostmourne,669,paladin,holy,18,7,11
21290,Kimahri,anvilmar,669,paladin,holy,36,7,29
21291,Voxoen,bleeding-hollow,668,paladin,holy,12,7,5
21292,Madcandy,illidan,667,paladin,holy,12,7,5
21293,Mikeawk,tichondrius,667,paladin,holy,30,7,23
21294,Geroden,tichondrius,665,paladin,holy,18,7,11
21295,Bangerzzx,sargeras,663,paladin,holy,18,7,11
21296,Chaós,queldorei,657,paladin,holy,18,7,11
21297,Snowdawg,blackhand,654,paladin,holy,24,7,17
21298,Ryuzu,arathor,640,paladin,holy,16,8,8
21299,Emojunz,ragnaros,638,paladin,holy,11,7,4
21300,Mycow,tichondrius,638,paladin,holy,17,7,10
21301,Lucciuzz,tichondrius,638,paladin,holy,23,7,16
21302,Mamothman,barthilas,622,paladin,holy,18,9,9
21303,Jonfox,stormrage,621,paladin,holy,13,8,5
21304,Mojiberus,wyrmrest-accord,606,paladin,holy,14,7,7
21305,Heniou,tichondrius,605,paladin,holy,19,8,11
21306,Erán,quelthalas,600,paladin,holy,14,7,7
21307,Turnevil,wyrmrest-accord,591,paladin,holy,19,7,12
21308,Wonpait,frostmourne,576,paladin,holy,9,7,2
21309,Holymomia,blackrock,576,paladin,holy,12,6,6
21310,Goldensmile,frostmourne,576,paladin,holy,12,6,6
21311,Amadin,winterhoof,576,paladin,holy,12,6,6
21312,Eskerda,nemesis,576,paladin,holy,12,6,6
21313,Fadiez,sargeras,576,paladin,holy,12,6,6
21314,Squarehammer,blackrock,576,paladin,holy,12,6,6
21315,Dequincy,tichondrius,576,paladin,holy,12,6,6
21316,Tríno,malganis,576,paladin,holy,12,6,6
21317,Drossp,illidan,576,paladin,holy,12,6,6
21318,Piura,stormreaver,576,paladin,holy,12,6,6
21319,Tolentino,elune,576,paladin,holy,12,6,6
21320,Catharsis,tichondrius,576,paladin,holy,12,6,6
21321,Ironjudge,hakkar,576,paladin,holy,17,6,11
21322,Mânz,stormrage,576,paladin,holy,18,6,12
21323,Remibear,tichondrius,576,paladin,holy,18,6,12
21324,Marleigh,kelthuzad,576,paladin,holy,18,6,12
21325,Lindnerxo,malganis,576,paladin,holy,18,6,12
21326,Okcheon,tichondrius,576,paladin,holy,18,6,12
21327,Bopsamdi,barthilas,576,paladin,holy,18,6,12
21328,Nikxx,tichondrius,576,paladin,holy,18,6,12
21329,Marien,kelthuzad,576,paladin,holy,18,6,12
21330,Kelosia,bonechewer,576,paladin,holy,18,6,12
21331,Santiagolol,ragnaros,576,paladin,holy,24,6,18
21332,Acpally,tichondrius,576,paladin,holy,24,6,18
21333,Ooppa,proudmoore,576,paladin,holy,25,6,19
21334,Okx,illidan,575,paladin,holy,6,6,0
21335,Cassiel,barthilas,575,paladin,holy,12,6,6
21336,Mendes,stormrage,575,paladin,holy,12,6,6
21337,Bigpal,area-52,575,paladin,holy,12,6,6
21338,Nochance,queldorei,575,paladin,holy,12,6,6
21339,Roachpally,area-52,575,paladin,holy,12,6,6
21340,Nøzawkalypse,kelthuzad,575,paladin,holy,12,6,6
21341,Emptyjump,eredar,575,paladin,holy,12,6,6
21342,Auralyon,tichondrius,575,paladin,holy,12,6,6
21343,Leatherfase,dalaran,575,paladin,holy,12,6,6
21344,Vänhélsing,tichondrius,575,paladin,holy,13,6,7
21345,Hojadin,area-52,575,paladin,holy,18,6,12
21346,Tig,alleria,575,paladin,holy,18,6,12
21347,Asunä,bloodscalp,575,paladin,holy,18,6,12
21348,Theprimus,darkspear,574,paladin,holy,6,6,0
21349,Rhonielson,tichondrius,574,paladin,holy,12,6,6
21350,Freyr,deathwing,574,paladin,holy,12,6,6
21351,Mcpuffin,aggramar,574,paladin,holy,12,6,6
21352,Hitsilent,warsong,574,paladin,holy,12,6,6
21353,Sixthycent,kiljaeden,574,paladin,holy,12,6,6
21354,Ahsys,tichondrius,574,paladin,holy,18,6,12
21355,Kilion,illidan,574,paladin,holy,18,6,12
21356,Boostsixty,proudmoore,573,paladin,holy,18,6,12
21357,Iluvitar,kiljaeden,573,paladin,holy,18,6,12
21358,Mitshuki,ragnaros,573,paladin,holy,18,6,12
21359,Ducii,stormrage,571,paladin,holy,18,6,12
21360,Cloûd,tichondrius,570,paladin,holy,13,6,7
21361,Maplleafs,kelthuzad,560,paladin,holy,24,6,18
21362,Orleenz,zuljin,559,paladin,holy,18,6,12
21363,Fayernaa,proudmoore,557,paladin,holy,10,7,3
21364,Powtilted,thrall,543,paladin,holy,11,6,5
21365,Redpally,emerald-dream,543,paladin,holy,16,6,10
21366,Eboi,daggerspine,542,paladin,holy,26,7,19
21367,Biggestkritz,frostmourne,511,paladin,holy,14,6,8
21368,Trivana,durotan,496,paladin,holy,7,6,1
21369,Holythunderx,tichondrius,496,paladin,holy,19,6,13
21370,Badboí,azralon,480,paladin,holy,6,5,1
21371,Zanduncy,stormrage,480,paladin,holy,6,5,1
21372,Dlt,frostmourne,480,paladin,holy,6,5,1
21373,Yogafire,kelthuzad,480,paladin,holy,6,5,1
21374,Zenastra,moon-guard,480,paladin,holy,6,5,1
21375,Saintus,proudmoore,480,paladin,holy,12,5,7
21376,Beila,illidan,480,paladin,holy,12,5,7
21377,Drunknbum,area-52,480,paladin,holy,12,5,7
21378,Velline,tichondrius,480,paladin,holy,12,5,7
21379,Vicentê,ragnaros,480,paladin,holy,12,5,7
21380,Garethorne,illidan,480,paladin,holy,12,5,7
21381,Leddie,stormrage,480,paladin,holy,12,5,7
21382,Lyticmartyr,bleeding-hollow,480,paladin,holy,12,5,7
21383,Gøldenlight,illidan,480,paladin,holy,12,5,7
21384,Vaerume,sargeras,480,paladin,holy,12,5,7
21385,Tèhflip,tichondrius,480,paladin,holy,12,5,7
21386,Twoshockz,stormrage,480,paladin,holy,12,5,7
21387,Subotai,frostmourne,480,paladin,holy,12,5,7
21388,Timeparadox,illidan,480,paladin,holy,12,5,7
21389,Alessan,nemesis,480,paladin,holy,12,5,7
21390,Hamen,frostwolf,480,paladin,holy,12,5,7
21391,Zhangliyi,tichondrius,480,paladin,holy,12,5,7
21392,Gareyn,moon-guard,480,paladin,holy,12,5,7
21393,Mightypally,area-52,480,paladin,holy,12,5,7
21394,Trycider,lightninghoof,480,paladin,holy,12,5,7
21395,Fartburger,saurfang,480,paladin,holy,12,5,7
21396,Inmortall,illidan,480,paladin,holy,12,5,7
21397,Bíteme,sargeras,480,paladin,holy,15,6,9
21398,Chimp,kiljaeden,480,paladin,holy,18,5,13
21399,Trevmagoosey,tichondrius,480,paladin,holy,18,5,13
21400,Chrisgrin,malganis,480,paladin,holy,18,5,13
21401,Flow,spinebreaker,480,paladin,holy,18,5,13
21402,Wêsleypipes,crushridge,480,paladin,holy,18,5,13
21403,Aberos,stonemaul,480,paladin,holy,23,5,18
21404,Mootumba,boulderfist,480,paladin,holy,24,5,19
21405,Annii,aegwynn,479,paladin,holy,6,5,1
21406,Bubbleosèven,tichondrius,479,paladin,holy,6,5,1
21407,Joelsama,area-52,479,paladin,holy,12,5,7
21408,Marcopolo,azralon,479,paladin,holy,12,5,7
21409,Mileihot,quelthalas,479,paladin,holy,12,5,7
21410,Mightythorxx,tichondrius,479,paladin,holy,12,5,7
21411,Holyshasha,tichondrius,479,paladin,holy,12,5,7
21412,Gyle,stormrage,479,paladin,holy,12,5,7
21413,Tankgreed,quelthalas,479,paladin,holy,12,5,7
21414,Goksuu,ragnaros,479,paladin,holy,12,5,7
21415,Loabandit,malorne,479,paladin,holy,12,5,7
21416,Meistyr,thrall,479,paladin,holy,18,5,13
21417,Healadelphia,illidan,479,paladin,holy,18,5,13
21418,Yobnai,zuljin,478,paladin,holy,12,5,7
21419,Whosharted,area-52,478,paladin,holy,12,5,7
21420,Boiducéu,azralon,478,paladin,holy,12,5,7
21421,Duecesz,area-52,478,paladin,holy,26,5,21
21422,Sovereignt,aggramar,477,paladin,holy,12,5,7
21423,Goingturbo,wyrmrest-accord,477,paladin,holy,12,5,7
21424,Thaeldan,archimonde,477,paladin,holy,18,5,13
21425,Bullivan,sisters-of-elune,477,paladin,holy,18,5,13
21426,Visanth,bonechewer,474,paladin,holy,15,5,10
21427,Redentor,dalaran,473,paladin,holy,12,5,7
21428,Parts,aerie-peak,468,paladin,holy,30,5,25
21429,Fleshoflíght,azjolnerub,463,paladin,holy,11,5,6
21430,Toastedheals,stormreaver,463,paladin,holy,17,5,12
21431,Blancaflór,ragnaros,447,paladin,holy,11,5,6
21432,Ziggerqt,stormrage,432,paladin,holy,15,5,10
21433,Nivie,moon-guard,430,paladin,holy,15,5,10
21434,Rashell,garrosh,426,paladin,holy,16,7,9
21435,Retribution,mannoroth,426,paladin,holy,23,6,17
21436,Monts,azralon,425,paladin,holy,20,7,13
21437,Ziti,bonechewer,415,paladin,holy,8,5,3
21438,Cyandra,moon-guard,400,paladin,holy,7,5,2
21439,Dewagon,area-52,398,paladin,holy,25,5,20
21440,Kigz,illidan,384,paladin,holy,6,4,2
21441,Eladore,hakkar,384,paladin,holy,6,4,2
21442,Decree,rexxar,384,paladin,holy,6,4,2
21443,Ladanthal,barthilas,384,paladin,holy,6,4,2
21444,Icac,stormrage,384,paladin,holy,6,4,2
21445,Ùthèr,tichondrius,384,paladin,holy,6,4,2
21446,Auraingraham,stormscale,384,paladin,holy,6,4,2
21447,Volphorix,illidan,384,paladin,holy,6,4,2
21448,Rc,tichondrius,384,paladin,holy,6,4,2
21449,Ohthatguy,sargeras,384,paladin,holy,6,4,2
21450,Arleos,mannoroth,384,paladin,holy,6,4,2
21451,Immensepower,tichondrius,384,paladin,holy,6,4,2
21452,Mywifeisbad,tichondrius,384,paladin,holy,6,4,2
21453,Ceeten,tichondrius,384,paladin,holy,6,4,2
21454,Îcandy,stormrage,384,paladin,holy,6,4,2
21455,Dumpytrucks,sargeras,384,paladin,holy,6,4,2
21456,Lightwerk,frostmourne,384,paladin,holy,6,4,2
21457,Respect,black-dragonflight,384,paladin,holy,6,4,2
21458,Kymosolopal,sargeras,384,paladin,holy,6,4,2
21459,Pradå,tichondrius,384,paladin,holy,6,4,2
21460,Penpal,sargeras,384,paladin,holy,12,4,8
21461,Swolsus,illidan,384,paladin,holy,12,4,8
21462,Cadap,bleeding-hollow,384,paladin,holy,12,4,8
21463,Ajlol,thrall,384,paladin,holy,12,4,8
21464,Devsrdumb,bonechewer,384,paladin,holy,12,4,8
21465,Klamindor,emerald-dream,384,paladin,holy,12,4,8
21466,Floweezy,thrall,384,paladin,holy,12,4,8
21467,Alicethemad,aerie-peak,384,paladin,holy,12,4,8
21468,Wangzu,wildhammer,384,paladin,holy,12,4,8
21469,Bighardshock,aggramar,384,paladin,holy,12,4,8
21470,Lesauceboss,tichondrius,384,paladin,holy,12,4,8
21471,Dimix,sargeras,384,paladin,holy,12,4,8
21472,Bigtimepali,tichondrius,384,paladin,holy,12,4,8
21473,Daflash,emerald-dream,384,paladin,holy,12,4,8
21474,Sacratess,area-52,384,paladin,holy,12,4,8
21475,Ðáxø,sargeras,384,paladin,holy,12,4,8
21476,Nontheism,malganis,384,paladin,holy,12,4,8
21477,Purdicks,emerald-dream,384,paladin,holy,12,4,8
21478,Nikkixo,ysera,384,paladin,holy,12,4,8
21479,Alkina,kelthuzad,384,paladin,holy,12,4,8
21480,Nerfrets,stormrage,384,paladin,holy,12,4,8
21481,Contémpt,kelthuzad,384,paladin,holy,12,4,8
21482,Derbizzle,darkspear,384,paladin,holy,12,4,8
21483,Saintcassi,wyrmrest-accord,384,paladin,holy,12,4,8
21484,Holygutzz,barthilas,384,paladin,holy,12,4,8
21485,Gotredwings,proudmoore,384,paladin,holy,12,4,8
21486,Waldir,silver-hand,384,paladin,holy,12,4,8
21487,Doorii,tichondrius,384,paladin,holy,18,4,14
21488,Hímüra,nemesis,384,paladin,holy,18,4,14
21489,Cutebtw,zuljin,384,paladin,holy,18,4,14
21490,Beebopper,illidan,384,paladin,holy,18,4,14
21491,Bloodangelz,sargeras,384,paladin,holy,18,4,14
21492,Retholyprot,tichondrius,384,paladin,holy,18,4,14
21493,Ardrider,emerald-dream,384,paladin,holy,18,4,14
21494,Kaminasol,quelthalas,384,paladin,holy,18,4,14
21495,Scah,illidan,383,paladin,holy,6,4,2
21496,Holyflux,winterhoof,383,paladin,holy,6,4,2
21497,Vorex,ragnaros,383,paladin,holy,12,4,8
21498,Thulamon,zuljin,383,paladin,holy,12,4,8
21499,Guççi,thunderlord,383,paladin,holy,12,4,8
21500,Akromma,drakkari,383,paladin,holy,12,4,8
21501,Lightbeard,feathermoon,383,paladin,holy,12,4,8
21502,Lunchmoney,aggramar,383,paladin,holy,12,4,8
21503,Gokzurah,dragonmaw,383,paladin,holy,18,4,14
21504,Anjøs,azralon,383,paladin,holy,18,4,14
21505,Cooldbrew,frostmourne,383,paladin,holy,18,4,14
21506,Alyosya,barthilas,383,paladin,holy,24,4,20
21507,Unsungherø,skywall,382,paladin,holy,6,4,2
21508,Rustacian,area-52,380,paladin,holy,12,4,8
21509,Gnomeslapper,frostmourne,351,paladin,holy,11,4,7
21510,Palewan,kiljaeden,351,paladin,holy,11,4,7
21511,Aärøn,stormrage,351,paladin,holy,11,4,7
21512,Nabora,aggramar,351,paladin,holy,11,4,7
21513,Nvgesus,undermine,329,paladin,holy,16,5,11
21514,Veeve,emerald-dream,304,paladin,holy,7,4,3
21515,Nulric,moon-guard,304,paladin,holy,13,4,9
21516,Holzinger,quelthalas,288,paladin,holy,6,3,3
21517,Grimmey,azjolnerub,288,paladin,holy,6,3,3
21518,Árrest,tichondrius,288,paladin,holy,6,3,3
21519,Sadamell,tichondrius,288,paladin,holy,6,3,3
21520,Ingrìd,ragnaros,288,paladin,holy,6,3,3
21521,Iamguess,stormscale,288,paladin,holy,6,3,3
21522,Zpsychotycx,tichondrius,288,paladin,holy,6,3,3
21523,Lachaple,illidan,288,paladin,holy,6,3,3
21524,Madsama,quelthalas,288,paladin,holy,6,3,3
21525,Lànd,tichondrius,288,paladin,holy,6,3,3
21526,Laythoz,hyjal,288,paladin,holy,6,3,3
21527,Sixty,sargeras,288,paladin,holy,6,3,3
21528,Sigfriéd,tichondrius,288,paladin,holy,6,3,3
21529,Kusunoki,kelthuzad,288,paladin,holy,6,3,3
21530,Hazkal,sargeras,288,paladin,holy,6,3,3
21531,Kaleroenin,cenarius,288,paladin,holy,6,3,3
21532,Jackywacky,malganis,288,paladin,holy,6,3,3
21533,Supercutee,malganis,288,paladin,holy,6,3,3
21534,Repgodx,illidan,288,paladin,holy,6,3,3
21535,Schwârts,blackrock,288,paladin,holy,6,3,3
21536,Loyantal,tichondrius,288,paladin,holy,6,3,3
21537,Datguysname,illidan,288,paladin,holy,6,3,3
21538,Alîcë,wyrmrest-accord,288,paladin,holy,6,3,3
21539,Feelsögood,tichondrius,288,paladin,holy,6,3,3
21540,Killmoth,illidan,288,paladin,holy,6,3,3
21541,Thyedron,azralon,288,paladin,holy,6,3,3
21542,Lamas,kelthuzad,288,paladin,holy,6,3,3
21543,Mindfoolness,sargeras,288,paladin,holy,6,3,3
21544,Breesh,nerzhul,288,paladin,holy,6,3,3
21545,Kharissia,proudmoore,288,paladin,holy,6,3,3
21546,Twodkittyy,kelthuzad,288,paladin,holy,6,3,3
21547,Soapgirl,area-52,288,paladin,holy,6,3,3
21548,Holysheesh,cenarion-circle,288,paladin,holy,6,3,3
21549,Nipon,stormrage,288,paladin,holy,6,3,3
21550,Wonpæi,frostmourne,288,paladin,holy,6,3,3
21551,Psalms,lightnings-blade,288,paladin,holy,6,3,3
21552,Dayatthespa,stormrage,288,paladin,holy,6,3,3
21553,Brightcore,stormrage,288,paladin,holy,6,3,3
21554,Phut,stormrage,288,paladin,holy,6,3,3
21555,Clare,burning-blade,288,paladin,holy,6,3,3
21556,Miggsy,stormrage,288,paladin,holy,6,3,3
21557,Botburger,stormrage,288,paladin,holy,6,3,3
21558,Yacè,moon-guard,288,paladin,holy,6,3,3
21559,Leronos,zuljin,288,paladin,holy,6,3,3
21560,Gutzzx,frostmourne,288,paladin,holy,6,3,3
21561,Paen,area-52,288,paladin,holy,6,3,3
21562,Gothsick,zuljin,288,paladin,holy,6,3,3
21563,Aduhrawl,moon-guard,288,paladin,holy,6,3,3
21564,Odinns,proudmoore,288,paladin,holy,6,3,3
21565,Quits,tichondrius,288,paladin,holy,12,3,9
21566,Milonus,frostmourne,288,paladin,holy,12,3,9
21567,Dartherion,shandris,288,paladin,holy,12,3,9
21568,Imabigkidnow,emerald-dream,288,paladin,holy,12,3,9
21569,Dráugus,azralon,288,paladin,holy,12,3,9
21570,Kommuna,stormscale,288,paladin,holy,12,3,9
21571,Picorii,frostmourne,288,paladin,holy,12,3,9
21572,Hemmyr,deathwing,288,paladin,holy,12,3,9
21573,Yanggongru,sargeras,288,paladin,holy,12,3,9
21574,Ahkairee,whisperwind,288,paladin,holy,12,3,9
21575,Thichammer,frostmourne,288,paladin,holy,12,3,9
21576,Drippinheals,eitrigg,288,paladin,holy,12,3,9
21577,Serca,khadgar,288,paladin,holy,12,3,9
21578,Prâytorian,illidan,288,paladin,holy,12,3,9
21579,Palazin,frostmourne,288,paladin,holy,12,3,9
21580,Repths,illidan,288,paladin,holy,12,3,9
21581,Teerblood,illidan,288,paladin,holy,12,3,9
21582,Holycowisroy,illidan,288,paladin,holy,12,3,9
21583,Haldry,wyrmrest-accord,288,paladin,holy,12,3,9
21584,Bigboppapump,lightnings-blade,288,paladin,holy,18,3,15
21585,Flarisic,kelthuzad,288,paladin,holy,18,3,15
21586,Hugokpz,quelthalas,288,paladin,holy,18,3,15
21587,Alogagain,frostmourne,288,paladin,holy,18,3,15
21588,Mathalt,area-52,288,paladin,holy,18,3,15
21589,Holyslapz,nazjatar,287,paladin,holy,6,3,3
21590,Avantasias,sargeras,287,paladin,holy,12,3,9
21591,Fokatayew,korialstrasz,287,paladin,holy,12,3,9
21592,Spacebacon,thunderlord,287,paladin,holy,12,3,9
21593,Rost,jaedenar,287,paladin,holy,24,3,21
21594,Callmeweazy,arathor,286,paladin,holy,12,3,9
21595,Hehealsyou,alleria,285,paladin,holy,12,3,9
21596,Schnabdain,exodar,285,paladin,holy,18,3,15
21597,Cristineth,tanaris,255,paladin,holy,8,4,4
21598,Antivaxer,frostmourne,255,paladin,holy,11,3,8
21599,Iradruidz,tichondrius,255,paladin,holy,11,3,8
21600,Holywoof,agamaggan,234,paladin,holy,11,5,6
21601,Itheternal,dalaran,234,paladin,holy,9,4,5
21602,Tyygore,nagrand,234,paladin,holy,13,5,8
21603,Inarit,thrall,232,paladin,holy,22,5,17
21604,Ronnierawdog,frostmourne,192,paladin,holy,6,2,4
21605,Jastella,illidan,192,paladin,holy,6,2,4
21606,Bigdmcgee,frostmourne,192,paladin,holy,6,2,4
21607,Jiaofu,illidan,192,paladin,holy,6,2,4
21608,Toonchies,barthilas,192,paladin,holy,6,2,4
21609,Raywhite,kelthuzad,192,paladin,holy,6,2,4
21610,Gnomesexer,illidan,192,paladin,holy,6,2,4
21611,Kagranac,moon-guard,192,paladin,holy,6,2,4
21612,Pallydeen,illidan,192,paladin,holy,6,2,4
21613,Flexxborn,thrall,192,paladin,holy,6,2,4
21614,Borngood,tichondrius,192,paladin,holy,6,2,4
21615,Smôres,sargeras,192,paladin,holy,6,2,4
21616,Elchupalibre,tichondrius,192,paladin,holy,6,2,4
21617,Gilazhar,eldrethalas,192,paladin,holy,6,2,4
21618,Zhula,nerzhul,192,paladin,holy,6,2,4
21619,Goldieg,tichondrius,192,paladin,holy,6,2,4
21620,Hitabull,hyjal,192,paladin,holy,6,2,4
21621,Iolwhat,sargeras,192,paladin,holy,6,2,4
21622,Papaa,nemesis,192,paladin,holy,6,2,4
21623,Rawpaladin,blackrock,192,paladin,holy,6,2,4
21624,Pearlx,ragnaros,192,paladin,holy,6,2,4
21625,Turnipfãrmer,tichondrius,192,paladin,holy,6,2,4
21626,Veguê,ragnaros,192,paladin,holy,6,2,4
21627,Eicke,malganis,192,paladin,holy,6,2,4
21628,Bakapal,tichondrius,192,paladin,holy,6,2,4
21629,Stormwinter,azralon,192,paladin,holy,6,2,4
21630,Gabs,quelthalas,192,paladin,holy,6,2,4
21631,Antoniano,ragnaros,192,paladin,holy,6,2,4
21632,Lazydin,tichondrius,192,paladin,holy,6,2,4
21633,Sainttom,sargeras,192,paladin,holy,6,2,4
21634,Numenor,kiljaeden,192,paladin,holy,6,2,4
21635,Svane,thunderlord,192,paladin,holy,6,2,4
21636,Mangchì,tichondrius,192,paladin,holy,6,2,4
21637,Trâgedy,azjolnerub,192,paladin,holy,6,2,4
21638,Chinaballoon,moonrunner,192,paladin,holy,6,2,4
21639,Tumatauenga,burning-blade,192,paladin,holy,6,2,4
21640,Lovinglight,zuljin,192,paladin,holy,6,2,4
21641,Kimbr,gallywix,192,paladin,holy,6,2,4
21642,Romaztlan,area-52,192,paladin,holy,6,2,4
21643,Lørdthemar,azralon,192,paladin,holy,6,2,4
21644,Irêsha,quelthalas,192,paladin,holy,6,2,4
21645,Razzypal,sargeras,192,paladin,holy,6,2,4
21646,Raiel,aegwynn,192,paladin,holy,6,2,4
21647,Akj,tichondrius,192,paladin,holy,6,2,4
21648,Goldirock,quelthalas,192,paladin,holy,6,2,4
21649,Breach,blades-edge,192,paladin,holy,6,2,4
21650,Naxzero,shadowsong,192,paladin,holy,8,2,6
21651,Anderentonso,tichondrius,192,paladin,holy,9,2,7
21652,Piupiubiu,stormrage,192,paladin,holy,12,2,10
21653,Willywønka,azgalor,192,paladin,holy,12,2,10
21654,Bighausse,thrall,192,paladin,holy,12,2,10
21655,Gavril,kirin-tor,192,paladin,holy,12,2,10
21656,Dwemeor,azuremyst,192,paladin,holy,12,2,10
21657,Carmiínha,azralon,192,paladin,holy,12,2,10
21658,Dissident,stormrage,192,paladin,holy,12,2,10
21659,Einheilagr,stormrage,192,paladin,holy,12,2,10
21660,Märdrius,tichondrius,192,paladin,holy,12,2,10
21661,Cehart,windrunner,192,paladin,holy,12,2,10
21662,Murkpal,frostmourne,192,paladin,holy,12,2,10
21663,Trojani,malganis,192,paladin,holy,12,2,10
21664,Minzyy,frostmourne,192,paladin,holy,12,2,10
21665,Hxnny,kiljaeden,192,paladin,holy,12,2,10
21666,Milkovir,quelthalas,192,paladin,holy,18,2,16
21667,Shoresy,terokkar,192,paladin,holy,18,2,16
21668,Waifupaladin,azralon,192,paladin,holy,18,2,16
21669,Levarious,thunderlord,192,paladin,holy,18,2,16
21670,Holygota,nemesis,191,paladin,holy,6,2,4
21671,Holymomo,malganis,191,paladin,holy,6,2,4
21672,Prh,frostmourne,191,paladin,holy,6,2,4
21673,Splyts,stormrage,191,paladin,holy,16,3,13
21674,Arobelse,sargeras,191,paladin,holy,12,2,10
21675,Itsoverninek,emerald-dream,159,paladin,holy,17,2,15
21676,Hearthledger,ragnaros,144,paladin,holy,3,3,0
21677,Whitedozer,darkspear,138,paladin,holy,10,4,6
21678,Luxsit,tichondrius,138,paladin,holy,11,3,8
21679,Guelmin,azralon,112,paladin,holy,7,2,5
21680,Myû,korgath,112,paladin,holy,7,2,5
21681,Tetulia,quelthalas,96,paladin,holy,6,1,5
21682,Traditionalp,area-52,96,paladin,holy,6,1,5
21683,Badnold,area-52,96,paladin,holy,6,1,5
21684,Sevina,twisting-nether,96,paladin,holy,6,1,5
21685,Deadlyassian,ysera,96,paladin,holy,6,1,5
21686,Kamí,elune,96,paladin,holy,6,1,5
21687,Therëv,zuljin,96,paladin,holy,6,1,5
21688,Chakris,wyrmrest-accord,96,paladin,holy,6,1,5
21689,Crosjudge,zuljin,96,paladin,holy,6,1,5
21690,Tfcpaladin,the-forgotten-coast,96,paladin,holy,6,1,5
21691,Lgbtq,trollbane,96,paladin,holy,6,1,5
21692,Vîxey,ragnaros,96,paladin,holy,6,1,5
21693,Criaharn,turalyon,96,paladin,holy,6,1,5
21694,Wings,arygos,96,paladin,holy,6,1,5
21695,Netéro,skywall,96,paladin,holy,6,1,5
21696,Combidin,garrosh,96,paladin,holy,6,1,5
21697,Cathraga,moknathal,96,paladin,holy,6,1,5
21698,Silreck,ragnaros,96,paladin,holy,6,1,5
21699,Rhinno,lothar,96,paladin,holy,6,1,5
21700,Lightsòut,frostmourne,96,paladin,holy,6,1,5
21701,Elrecka,stormrage,96,paladin,holy,6,1,5
21702,Elronda,malganis,96,paladin,holy,6,1,5
21703,Ploppers,sargeras,96,paladin,holy,6,1,5
21704,Oncehumanoid,stormrage,96,paladin,holy,6,1,5
21705,Cremefraichè,tichondrius,96,paladin,holy,6,1,5
21706,Boppal,tichondrius,96,paladin,holy,6,1,5
21707,Greddlok,rivendare,96,paladin,holy,6,1,5
21708,Yikyok,stormrage,96,paladin,holy,6,1,5
21709,Trixzthot,barthilas,96,paladin,holy,6,1,5
21710,Wrekster,tichondrius,96,paladin,holy,6,1,5
21711,Krypton,tichondrius,96,paladin,holy,6,1,5
21712,ßls,illidan,96,paladin,holy,6,1,5
21713,Burgasari,tichondrius,96,paladin,holy,6,1,5
21714,Parzsival,blood-furnace,96,paladin,holy,6,1,5
21715,Jeffylolmar,sargeras,96,paladin,holy,6,1,5
21716,Luxs,tichondrius,96,paladin,holy,6,1,5
21717,Syrenadrel,hydraxis,96,paladin,holy,6,1,5
21718,Owllii,frostwolf,96,paladin,holy,6,1,5
21719,Keltheas,rivendare,96,paladin,holy,6,1,5
21720,Obllivionn,wildhammer,96,paladin,holy,6,1,5
21721,Evilpallie,illidan,96,paladin,holy,6,1,5
21722,Kurook,moon-guard,96,paladin,holy,6,1,5
21723,Mfpink,thrall,96,paladin,holy,6,1,5
21724,Zwilliam,frostmourne,96,paladin,holy,6,1,5
21725,Sherrill,nagrand,96,paladin,holy,6,1,5
21726,Palabora,kelthuzad,96,paladin,holy,6,1,5
21727,Kaynè,senjin,96,paladin,holy,6,1,5
21728,Khaosactual,proudmoore,96,paladin,holy,6,1,5
21729,Arturias,kiljaeden,96,paladin,holy,6,1,5
21730,Ripadin,dunemaul,96,paladin,holy,11,1,10
21731,Grîshnâkh,ragnaros,96,paladin,holy,11,1,10
21732,Ordained,moonrunner,96,paladin,holy,12,1,11
21733,Dapallytroll,area-52,96,paladin,holy,12,1,11
21734,Midnightboto,dragonmaw,96,paladin,holy,12,1,11
21735,Nickpala,bleeding-hollow,96,paladin,holy,12,1,11
21736,Soloist,tichondrius,96,paladin,holy,12,1,11
21737,Elladan,illidan,96,paladin,holy,12,1,11
21738,Zentrick,whisperwind,96,paladin,holy,12,1,11
21739,Jwilks,black-dragonflight,96,paladin,holy,12,1,11
21740,Lafawndah,blackhand,96,paladin,holy,12,1,11
21741,Vanquishyr,stormrage,96,paladin,holy,12,1,11
21742,Vexe,emerald-dream,96,paladin,holy,12,1,11
21743,Granada,kirin-tor,95,paladin,holy,6,1,5
21744,Arlé,stormrage,95,paladin,holy,6,1,5
21745,Ååron,thrall,89,paladin,holy,11,3,8
21746,Tmzoeyqt,tichondrius,84,paladin,holy,9,4,5
21747,Emilywilis,sargeras,84,paladin,holy,17,5,12
21748,Athenia,moon-guard,63,paladin,holy,6,3,3
21749,Jkethuhsnake,ghostlands,48,paladin,holy,21,1,20
21750,Alpinestârs,tichondrius,42,paladin,holy,9,2,7
21751,Justinbebr,tichondrius,42,paladin,holy,14,3,11
21752,Durendin,bonechewer,31,paladin,holy,2,1,1
21753,Kziwei,stormrage,31,paladin,holy,2,1,1
21754,Shkafell,ragnaros,9,paladin,holy,8,2,6
21755,Oghal,frostmourne,9,paladin,holy,23,3,20
21756,Vanguards,tichondrius,2192,paladin,retribution,78,43,35
21757,Imitlol,alexstrasza,2154,paladin,retribution,181,91,90
21758,Hamburgeryu,tichondrius,2119,paladin,retribution,100,49,51
21759,Coolvelic,tichondrius,2110,paladin,retribution,156,79,77
21760,Picachü,ragnaros,2104,paladin,retribution,125,63,62
21761,Yuji,darkspear,2102,paladin,retribution,108,54,54
21762,Hollyflame,tichondrius,2086,paladin,retribution,149,76,73
21763,Tramatic,sargeras,2076,paladin,retribution,78,42,36
21764,Quitzz,tichondrius,2050,paladin,retribution,117,58,59
21765,Venguards,azralon,2049,paladin,retribution,97,50,47
21766,Shôtgun,tichondrius,2047,paladin,retribution,90,45,45
21767,Aldda,azralon,2047,paladin,retribution,128,62,66
21768,Evanguards,tichondrius,2046,paladin,retribution,184,91,93
21769,Xexe,stormreaver,2030,paladin,retribution,150,74,76
21770,Lanteranth,drenden,2024,paladin,retribution,198,96,102
21771,Wasteddwolf,tichondrius,2022,paladin,retribution,117,60,57
21772,Angryvelic,tichondrius,2019,paladin,retribution,87,41,46
21773,Alicê,moon-guard,2018,paladin,retribution,84,41,43
21774,Dreamcastx,tichondrius,2016,paladin,retribution,149,74,75
21775,Slíckhuman,spinebreaker,2009,paladin,retribution,60,41,19
21776,Furylolz,tichondrius,2009,paladin,retribution,70,35,35
21777,Condiments,earthen-ring,2007,paladin,retribution,90,47,43
21778,Xiaoqingye,tichondrius,1995,paladin,retribution,78,41,37
21779,Caperx,tichondrius,1994,paladin,retribution,48,21,27
21780,Notvelic,tichondrius,1993,paladin,retribution,99,46,53
21781,Genericuser,sargeras,1984,paladin,retribution,82,44,38
21782,Ryuseiblade,ragnaros,1983,paladin,retribution,120,56,64
21783,Smortain,tichondrius,1973,paladin,retribution,84,39,45
21784,Bigdickrick,ragnaros,1972,paladin,retribution,54,32,22
21785,Maledraenei,sargeras,1970,paladin,retribution,113,54,59
21786,Ämoureux,bleeding-hollow,1970,paladin,retribution,141,67,74
21787,Theblèss,tichondrius,1969,paladin,retribution,121,56,65
21788,Alpinestârs,tichondrius,1967,paladin,retribution,122,60,62
21789,Memorisë,ragnaros,1965,paladin,retribution,171,92,79
21790,Caveyodeler,zuluhed,1962,paladin,retribution,66,31,35
21791,Kubota,sargeras,1958,paladin,retribution,60,36,24
21792,Mashbringer,moon-guard,1958,paladin,retribution,60,33,27
21793,Dreamcastz,tichondrius,1957,paladin,retribution,48,33,15
21794,Vânguards,tichondrius,1957,paladin,retribution,48,29,19
21795,Mwqyyds,tichondrius,1953,paladin,retribution,90,44,46
21796,Asukaba,sargeras,1950,paladin,retribution,68,33,35
21797,Xuantianchai,tichondrius,1944,paladin,retribution,60,36,24
21798,Dratzq,ragnaros,1938,paladin,retribution,90,49,41
21799,Bestowed,moon-guard,1933,paladin,retribution,87,44,43
21800,Bartharious,malganis,1932,paladin,retribution,78,37,41
21801,Nbtv,tichondrius,1931,paladin,retribution,78,36,42
21802,Daxxj,akama,1929,paladin,retribution,146,68,78
21803,Indivisionxp,tichondrius,1928,paladin,retribution,55,34,21
21804,Xxwitcherxx,stormrage,1928,paladin,retribution,99,55,44
21805,Omnnii,tichondrius,1928,paladin,retribution,71,38,33
21806,Damionblade,proudmoore,1928,paladin,retribution,217,116,101
21807,Simplybést,zuljin,1927,paladin,retribution,129,61,68
21808,Lvladen,sargeras,1927,paladin,retribution,72,32,40
21809,Yccorz,frostmourne,1917,paladin,retribution,190,96,94
21810,Mürlin,illidan,1915,paladin,retribution,159,83,76
21811,Ozzium,ragnaros,1912,paladin,retribution,131,65,66
21812,Monkeypala,dathremar,1911,paladin,retribution,54,30,24
21813,Metallíka,nemesis,1910,paladin,retribution,77,36,41
21814,Conndiment,earthen-ring,1909,paladin,retribution,78,37,41
21815,Hammrekt,illidan,1905,paladin,retribution,48,25,23
21816,Furgalicious,area-52,1904,paladin,retribution,125,60,65
21817,Bøgård,sargeras,1901,paladin,retribution,201,100,101
21818,Ohuo,tichondrius,1900,paladin,retribution,286,151,135
21819,Angelguards,tichondrius,1900,paladin,retribution,60,30,30
21820,Parlore,moon-guard,1895,paladin,retribution,162,87,75
21821,Bullmarket,tichondrius,1895,paladin,retribution,161,73,88
21822,Danceholy,tichondrius,1894,paladin,retribution,81,39,42
21823,Swurvezx,bleeding-hollow,1892,paladin,retribution,41,25,16
21824,Cønk,khadgar,1892,paladin,retribution,170,100,70
21825,Kamadonezuko,illidan,1892,paladin,retribution,89,44,45
21826,Fuchí,tichondrius,1891,paladin,retribution,182,90,92
21827,Lazypally,frostmourne,1890,paladin,retribution,48,25,23
21828,Attkdmgcurry,illidan,1890,paladin,retribution,71,34,37
21829,Dtaitou,tichondrius,1889,paladin,retribution,60,28,32
21830,Dankrachet,thrall,1888,paladin,retribution,72,35,37
21831,Vendatha,darkspear,1887,paladin,retribution,30,25,5
21832,Hellsingwolf,zuljin,1885,paladin,retribution,30,20,10
21833,Pécorino,malganis,1884,paladin,retribution,52,31,21
21834,Kurôsh,kalecgos,1883,paladin,retribution,90,46,44
21835,Pomboxd,stormrage,1881,paladin,retribution,72,45,27
21836,Iäl,tichondrius,1881,paladin,retribution,71,31,40
21837,Zeldoul,magtheridon,1879,paladin,retribution,71,36,35
21838,Retxsilver,thrall,1875,paladin,retribution,124,64,60
21839,Roushex,sargeras,1875,paladin,retribution,72,35,37
21840,Mcconnell,sargeras,1873,paladin,retribution,54,33,21
21841,Voidaz,stormscale,1873,paladin,retribution,60,31,29
21842,Zanur,tichondrius,1869,paladin,retribution,154,78,76
21843,Koyoikonan,tichondrius,1867,paladin,retribution,42,28,14
21844,Fairgame,dathremar,1867,paladin,retribution,48,22,26
21845,Alexjones,stormrage,1866,paladin,retribution,78,43,35
21846,Xilio,tichondrius,1865,paladin,retribution,72,36,36
21847,Peledin,azralon,1864,paladin,retribution,77,41,36
21848,Juffury,illidan,1861,paladin,retribution,66,32,34
21849,Getmeabag,tichondrius,1861,paladin,retribution,54,25,29
21850,Talymra,ragnaros,1860,paladin,retribution,72,38,34
21851,Víkk,zuljin,1860,paladin,retribution,182,94,88
21852,Vip,frostmourne,1859,paladin,retribution,78,41,37
21853,Chuoo,proudmoore,1859,paladin,retribution,46,22,24
21854,Draenkz,quelthalas,1858,paladin,retribution,51,31,20
21855,Younghova,kelthuzad,1857,paladin,retribution,78,38,40
21856,Clapstick,illidan,1857,paladin,retribution,66,30,36
21857,Zyzzftw,stormrage,1856,paladin,retribution,53,31,22
21858,Ðiviñe,zuluhed,1854,paladin,retribution,102,56,46
21859,Retroreq,tichondrius,1854,paladin,retribution,166,88,78
21860,Ðori,tichondrius,1854,paladin,retribution,65,31,34
21861,Homelanderp,tichondrius,1851,paladin,retribution,75,37,38
21862,Foofs,shadowmoon,1851,paladin,retribution,53,26,27
21863,Solanin,frostmourne,1849,paladin,retribution,35,20,15
21864,Burnning,tichondrius,1849,paladin,retribution,57,30,27
21865,Hurv,area-52,1848,paladin,retribution,53,30,23
21866,Mixz,bleeding-hollow,1843,paladin,retribution,60,36,24
21867,Nishru,sargeras,1843,paladin,retribution,60,32,28
21868,Auxilio,arathor,1843,paladin,retribution,60,29,31
21869,Divinehammer,proudmoore,1843,paladin,retribution,66,31,35
21870,Saakero,illidan,1841,paladin,retribution,36,22,14
21871,Mikhàël,stormscale,1840,paladin,retribution,52,37,15
21872,Truthkeeper,moon-guard,1840,paladin,retribution,47,23,24
21873,Luosiding,tichondrius,1840,paladin,retribution,155,68,87
21874,Chuckvandam,illidan,1839,paladin,retribution,54,36,18
21875,Popje,zuljin,1839,paladin,retribution,36,20,16
21876,Grifnballs,agamaggan,1839,paladin,retribution,56,31,25
21877,Immobilized,frostmourne,1839,paladin,retribution,58,29,29
21878,Mvpj,medivh,1839,paladin,retribution,48,23,25
21879,Kushsessions,zuljin,1837,paladin,retribution,42,20,22
21880,Holychris,shadowmoon,1837,paladin,retribution,72,31,41
21881,Alodorx,tichondrius,1836,paladin,retribution,36,23,13
21882,Kangsang,illidan,1835,paladin,retribution,70,33,37
21883,Lolcraftv,tichondrius,1834,paladin,retribution,60,30,30
21884,Dkdldkdld,tichondrius,1833,paladin,retribution,36,27,9
21885,Lilglick,illidan,1833,paladin,retribution,36,21,15
21886,Masqadin,tichondrius,1832,paladin,retribution,36,26,10
21887,Leonilx,tichondrius,1832,paladin,retribution,48,21,27
21888,Kaitúr,stormrage,1831,paladin,retribution,56,29,27
21889,ßò,area-52,1830,paladin,retribution,46,31,15
21890,Awbie,moon-guard,1830,paladin,retribution,60,30,30
21891,Eldenblade,moon-guard,1829,paladin,retribution,54,31,23
21892,Coldzerox,ragnaros,1829,paladin,retribution,161,82,79
21893,Honeydutchtv,black-dragonflight,1829,paladin,retribution,174,79,95
21894,Hammrekt,kelthuzad,1829,paladin,retribution,47,20,27
21895,Chainsapally,stormrage,1828,paladin,retribution,54,38,16
21896,Palabora,kelthuzad,1828,paladin,retribution,53,28,25
21897,Bornterrible,queldorei,1828,paladin,retribution,54,25,29
21898,Idenline,moon-guard,1827,paladin,retribution,59,30,29
21899,Wolfs,firetree,1826,paladin,retribution,66,29,37
21900,Monchmon,tichondrius,1824,paladin,retribution,47,24,23
21901,Praysnblaze,zuljin,1824,paladin,retribution,55,28,27
21902,Apollidin,malganis,1824,paladin,retribution,57,23,34
21903,Bohring,bleeding-hollow,1823,paladin,retribution,48,26,22
21904,Zozo,zuljin,1823,paladin,retribution,59,29,30
21905,Saradomin,kelthuzad,1822,paladin,retribution,129,66,63
21906,Mikeqiaodan,tichondrius,1822,paladin,retribution,102,47,55
21907,Olixx,blackrock,1821,paladin,retribution,54,30,24
21908,Kíngkáísér,azralon,1820,paladin,retribution,29,20,9
21909,Malakor,thrall,1820,paladin,retribution,150,79,71
21910,Blackcandle,tichondrius,1819,paladin,retribution,48,29,19
21911,Yorøchi,azralon,1819,paladin,retribution,57,31,26
21912,Geöspäwn,tichondrius,1819,paladin,retribution,39,20,19
21913,Anbivilent,moon-guard,1819,paladin,retribution,48,23,25
21914,Cardynivans,tichondrius,1819,paladin,retribution,67,25,42
21915,Hargol,stormrage,1818,paladin,retribution,90,43,47
21916,Zett,jubeithos,1818,paladin,retribution,97,45,52
21917,Dorex,moon-guard,1817,paladin,retribution,111,72,39
21918,Dazargeros,moon-guard,1817,paladin,retribution,30,19,11
21919,Nr,blood-furnace,1817,paladin,retribution,54,32,22
21920,Dwimberlike,ragnaros,1816,paladin,retribution,56,37,19
21921,Chadsteroid,sargeras,1816,paladin,retribution,48,29,19
21922,Kooi,illidan,1816,paladin,retribution,78,35,43
21923,Tyrillian,aerie-peak,1816,paladin,retribution,48,21,27
21924,Kíngkáiser,azralon,1815,paladin,retribution,46,27,19
21925,Zulmay,malganis,1814,paladin,retribution,156,78,78
21926,Beautiful,proudmoore,1813,paladin,retribution,129,67,62
21927,Dorktanian,stormrage,1813,paladin,retribution,78,40,38
21928,Toughxguy,sargeras,1813,paladin,retribution,86,44,42
21929,Sukilol,tichondrius,1813,paladin,retribution,78,39,39
21930,Rethumtv,tichondrius,1812,paladin,retribution,72,30,42
21931,Arkadiano,drakkari,1812,paladin,retribution,78,29,49
21932,Animepower,moon-guard,1811,paladin,retribution,94,56,38
21933,Triston,area-52,1810,paladin,retribution,120,66,54
21934,Lilcyans,ragnaros,1810,paladin,retribution,66,34,32
21935,Primaryee,tichondrius,1810,paladin,retribution,121,53,68
21936,Ladeon,proudmoore,1809,paladin,retribution,72,44,28
21937,Dréveleth,quelthalas,1809,paladin,retribution,95,41,54
21938,Fussyotter,stormreaver,1808,paladin,retribution,103,59,44
21939,Sweetfish,kiljaeden,1808,paladin,retribution,53,29,24
21940,Màli,akama,1808,paladin,retribution,52,20,32
21941,Savøx,sargeras,1807,paladin,retribution,136,78,58
21942,Stêvêts,tichondrius,1807,paladin,retribution,36,20,16
21943,Downways,sargeras,1807,paladin,retribution,73,39,34
21944,Profundity,area-52,1807,paladin,retribution,70,37,33
21945,Ratg,frostmourne,1807,paladin,retribution,46,24,22
21946,Velstadt,sargeras,1807,paladin,retribution,66,29,37
21947,Gelosagrado,illidan,1807,paladin,retribution,113,48,65
21948,Jhasøn,quelthalas,1806,paladin,retribution,60,40,20
21949,Pornenjoyer,dalaran,1806,paladin,retribution,30,19,11
21950,Darcobs,ragnaros,1806,paladin,retribution,172,90,82
21951,Pambeazley,bronzebeard,1806,paladin,retribution,46,23,23
21952,Pramethious,sargeras,1806,paladin,retribution,72,34,38
21953,Erodan,moon-guard,1806,paladin,retribution,88,38,50
21954,Annihilàtion,frostmourne,1805,paladin,retribution,42,30,12
21955,Antlkd,quelthalas,1805,paladin,retribution,59,31,28
21956,Koketsu,ragnaros,1805,paladin,retribution,219,109,110
21957,Panncakeman,tichondrius,1804,paladin,retribution,60,33,27
21958,Ironblade,zuljin,1804,paladin,retribution,54,29,25
21959,Palli,moon-guard,1804,paladin,retribution,60,31,29
21960,Lumbersnack,moon-guard,1804,paladin,retribution,75,36,39
21961,Thantore,scilla,1804,paladin,retribution,76,34,42
21962,Justicejosh,frostmourne,1803,paladin,retribution,42,25,17
21963,Reypally,dalaran,1803,paladin,retribution,132,66,66
21964,Niubcjq,tichondrius,1803,paladin,retribution,42,19,23
21965,Lucy,sargeras,1803,paladin,retribution,72,32,40
21966,Disappearing,stormrage,1802,paladin,retribution,48,31,17
21967,Sâdê,bleeding-hollow,1802,paladin,retribution,36,19,17
21968,Gunderbok,emerald-dream,1801,paladin,retribution,63,33,30
21969,Mabia,tichondrius,1801,paladin,retribution,72,37,35
21970,Sôck,zuljin,1800,paladin,retribution,44,22,22
21971,Ha,bleeding-hollow,1800,paladin,retribution,64,26,38
21972,Angelicwhim,stormrage,1799,paladin,retribution,42,24,18
21973,Lyrz,sargeras,1796,paladin,retribution,109,65,44
21974,Teknik,stormscale,1795,paladin,retribution,124,63,61
21975,Dúrnir,stormscale,1794,paladin,retribution,30,19,11
21976,Kádabrak,tichondrius,1794,paladin,retribution,54,34,20
21977,Traize,kelthuzad,1787,paladin,retribution,36,24,12
21978,Zeyrox,stormrage,1787,paladin,retribution,48,24,24
21979,Iqt,moon-guard,1784,paladin,retribution,90,37,53
21980,Andelko,tichondrius,1783,paladin,retribution,36,21,15
21981,Giørther,ragnaros,1783,paladin,retribution,57,29,28
21982,Retsaíyan,tichondrius,1782,paladin,retribution,60,28,32
21983,Mortaine,moon-guard,1782,paladin,retribution,87,40,47
21984,Judgejudyx,sargeras,1781,paladin,retribution,31,21,10
21985,Therëv,zuljin,1781,paladin,retribution,77,35,42
21986,Naverpay,tichondrius,1779,paladin,retribution,40,22,18
21987,Dampenedxd,bleeding-hollow,1779,paladin,retribution,98,45,53
21988,Zakladchick,illidan,1778,paladin,retribution,48,26,22
21989,Nhsvikings,bleeding-hollow,1777,paladin,retribution,59,31,28
21990,Marthellus,quelthalas,1774,paladin,retribution,63,28,35
21991,Rasler,stormrage,1773,paladin,retribution,144,73,71
21992,Thebless,tichondrius,1770,paladin,retribution,47,27,20
21993,Holyfused,illidan,1770,paladin,retribution,47,24,23
21994,Promethèus,jubeithos,1769,paladin,retribution,60,30,30
21995,Syleith,shadow-council,1768,paladin,retribution,115,54,61
21996,Rahkinishu,khaz-modan,1766,paladin,retribution,189,109,80
21997,Jonathein,barthilas,1766,paladin,retribution,132,67,65
21998,Talivar,kelthuzad,1765,paladin,retribution,126,74,52
21999,Pallehx,tichondrius,1765,paladin,retribution,59,28,31
22000,Thørmento,azralon,1765,paladin,retribution,105,47,58
22001,Ópsv,quelthalas,1758,paladin,retribution,167,96,71
22002,Fylerz,blackhand,1758,paladin,retribution,84,47,37
22003,Christtel,stormrage,1757,paladin,retribution,60,31,29
22004,Teniale,moon-guard,1756,paladin,retribution,48,23,25
22005,Lejeñd,stormrage,1756,paladin,retribution,53,25,28
22006,Berryblast,shadowmoon,1755,paladin,retribution,48,32,16
22007,Neonblade,illidan,1752,paladin,retribution,88,42,46
22008,Lunalunar,quelthalas,1750,paladin,retribution,53,28,25
22009,Whosyadaddy,tichondrius,1750,paladin,retribution,84,44,40
22010,Scarotv,malganis,1750,paladin,retribution,60,29,31
22011,Litium,frostmourne,1746,paladin,retribution,48,27,21
22012,Soverejgn,bleeding-hollow,1746,paladin,retribution,286,135,151
22013,Traceless,emerald-dream,1745,paladin,retribution,111,66,45
22014,Thebubbajay,illidan,1743,paladin,retribution,54,31,23
22015,Wing,frostwolf,1743,paladin,retribution,84,45,39
22016,Xiddin,frostmourne,1743,paladin,retribution,60,31,29
22017,Htnhy,aegwynn,1743,paladin,retribution,60,24,36
22018,Rashbringer,azgalor,1742,paladin,retribution,67,34,33
22019,Galeatus,tichondrius,1742,paladin,retribution,58,22,36
22020,Josxth,stormrage,1741,paladin,retribution,54,29,25
22021,Alxndrr,area-52,1741,paladin,retribution,66,34,32
22022,Lundor,ragnaros,1740,paladin,retribution,119,57,62
22023,Helldevil,zuljin,1739,paladin,retribution,48,25,23
22024,Luzoscura,quelthalas,1738,paladin,retribution,72,41,31
22025,Johnmacclane,azralon,1738,paladin,retribution,135,72,63
22026,Popwings,azralon,1738,paladin,retribution,52,27,25
22027,Handyandy,kelthuzad,1738,paladin,retribution,96,42,54
22028,Arkcadius,frostmourne,1737,paladin,retribution,72,37,35
22029,Dippedxd,tichondrius,1735,paladin,retribution,60,32,28
22030,Gellehar,barthilas,1735,paladin,retribution,36,19,17
22031,Siire,darkspear,1734,paladin,retribution,48,29,19
22032,Remethea,sargeras,1733,paladin,retribution,129,67,62
22033,Konesky,dalaran,1732,paladin,retribution,40,21,19
22034,Lilthroatbby,malganis,1732,paladin,retribution,114,49,65
22035,Galatus,tichondrius,1729,paladin,retribution,47,23,24
22036,Alduur,aggramar,1728,paladin,retribution,48,30,18
22037,Loisterly,bladefist,1728,paladin,retribution,110,58,52
22038,Thrax,spirestone,1727,paladin,retribution,129,59,70
22039,Cristø,stormrage,1727,paladin,retribution,72,30,42
22040,Quinnzel,barthilas,1726,paladin,retribution,68,37,31
22041,Coleta,stormrage,1725,paladin,retribution,42,28,14
22042,Nah,emerald-dream,1725,paladin,retribution,57,30,27
22043,Avenging,wyrmrest-accord,1724,paladin,retribution,44,26,18
22044,Bigdaddysdic,illidan,1724,paladin,retribution,96,48,48
22045,Nume,nesingwary,1724,paladin,retribution,58,23,35
22046,Riseandgrind,tichondrius,1723,paladin,retribution,36,18,18
22047,Çestlavie,korgath,1722,paladin,retribution,60,33,27
22048,Puredecuy,ragnaros,1722,paladin,retribution,42,19,23
22049,Mihawk,drenden,1721,paladin,retribution,30,21,9
22050,Raxadin,stormrage,1720,paladin,retribution,48,25,23
22051,Elegan,frostmourne,1719,paladin,retribution,60,30,30
22052,Mmbakes,shadowsong,1718,paladin,retribution,30,19,11
22053,Holywaffle,nemesis,1718,paladin,retribution,109,57,52
22054,Retrachet,thrall,1717,paladin,retribution,42,21,21
22055,Notae,icecrown,1717,paladin,retribution,42,21,21
22056,Slaneesh,ragnaros,1717,paladin,retribution,36,18,18
22057,Vanath,bleeding-hollow,1716,paladin,retribution,54,30,24
22058,Éætûgýäëí,area-52,1716,paladin,retribution,42,18,24
22059,Kaithen,quelthalas,1714,paladin,retribution,197,101,96
22060,Ssjlimit,tichondrius,1713,paladin,retribution,53,27,26
22061,Áldin,ragnaros,1711,paladin,retribution,40,23,17
22062,Nqe,area-52,1710,paladin,retribution,64,39,25
22063,Imcomingbro,blackrock,1710,paladin,retribution,56,27,29
22064,Svinadin,emerald-dream,1708,paladin,retribution,36,21,15
22065,Watchamebaba,malganis,1708,paladin,retribution,54,21,33
22066,Whathehell,black-dragonflight,1707,paladin,retribution,123,60,63
22067,Miktley,area-52,1707,paladin,retribution,48,22,26
22068,Nitemareforu,stormreaver,1706,paladin,retribution,72,44,28
22069,Triginhall,moon-guard,1706,paladin,retribution,59,27,32
22070,Lokâr,lightbringer,1706,paladin,retribution,66,30,36
22071,Egirlret,tichondrius,1706,paladin,retribution,48,21,27
22072,Oneaßoveall,azralon,1705,paladin,retribution,73,42,31
22073,Dippedlol,tichondrius,1705,paladin,retribution,42,23,19
22074,Genovah,sargeras,1703,paladin,retribution,36,22,14
22075,Bakafish,tichondrius,1702,paladin,retribution,24,18,6
22076,Beaconlol,proudmoore,1701,paladin,retribution,55,37,18
22077,Buckey,kilrogg,1699,paladin,retribution,52,28,24
22078,Lepirate,emerald-dream,1699,paladin,retribution,36,18,18
22079,Joeschmo,area-52,1697,paladin,retribution,42,24,18
22080,Yérn,barthilas,1697,paladin,retribution,36,18,18
22081,Voodoovon,tichondrius,1697,paladin,retribution,89,42,47
22082,Bubblemark,tichondrius,1697,paladin,retribution,91,39,52
22083,Agamemnom,tichondrius,1696,paladin,retribution,160,85,75
22084,Zèrà,thunderhorn,1696,paladin,retribution,42,20,22
22085,Bizzaz,moon-guard,1696,paladin,retribution,72,30,42
22086,Evangelìne,darkspear,1695,paladin,retribution,36,23,13
22087,Paladincane,sargeras,1695,paladin,retribution,120,61,59
22088,Axcvnz,draka,1694,paladin,retribution,42,23,19
22089,Vapanor,ragnaros,1694,paladin,retribution,48,25,23
22090,Strøngkiing,bleeding-hollow,1694,paladin,retribution,48,24,24
22091,Practícal,moon-guard,1693,paladin,retribution,66,35,31
22092,Dazn,tichondrius,1693,paladin,retribution,78,26,52
22093,Keltar,burning-blade,1692,paladin,retribution,30,18,12
22094,Lalatinx,quelthalas,1692,paladin,retribution,72,37,35
22095,Justnikop,tichondrius,1692,paladin,retribution,115,56,59
22096,Galedance,tichondrius,1692,paladin,retribution,46,21,25
22097,Dârkk,tichondrius,1691,paladin,retribution,36,20,16
22098,Clownfister,barthilas,1690,paladin,retribution,54,29,25
22099,Xeldar,tichondrius,1689,paladin,retribution,72,37,35
22100,Pickleret,emerald-dream,1689,paladin,retribution,108,51,57
22101,Rédbarön,illidan,1689,paladin,retribution,51,24,27
22102,Usdacertifed,lightnings-blade,1688,paladin,retribution,155,75,80
22103,ßountystrike,sargeras,1687,paladin,retribution,60,26,34
22104,Goldnhart,wyrmrest-accord,1686,paladin,retribution,72,37,35
22105,Arquidea,tichondrius,1686,paladin,retribution,66,33,33
22106,Titannious,stormrage,1686,paladin,retribution,107,52,55
22107,Shiryn,illidan,1685,paladin,retribution,48,24,24
22108,Incubus,rexxar,1683,paladin,retribution,54,24,30
22109,Nizzy,caelestrasz,1683,paladin,retribution,42,18,24
22110,Hînøkåmí,tichondrius,1681,paladin,retribution,42,24,18
22111,Bravepala,tichondrius,1680,paladin,retribution,54,20,34
22112,Sasorï,stormrage,1679,paladin,retribution,90,41,49
22113,Griffïth,thrall,1678,paladin,retribution,30,18,12
22114,Konsentrate,tichondrius,1678,paladin,retribution,156,80,76
22115,Clee,sargeras,1678,paladin,retribution,87,44,43
22116,Mordirhar,tichondrius,1678,paladin,retribution,54,23,31
22117,Hólyélf,illidan,1678,paladin,retribution,84,35,49
22118,Ashkandi,tichondrius,1675,paladin,retribution,84,40,44
22119,Roguesmoker,zuljin,1674,paladin,retribution,36,20,16
22120,Kuico,ragnaros,1674,paladin,retribution,48,24,24
22121,Tagex,malganis,1673,paladin,retribution,137,69,68
22122,Chriskriego,frostmourne,1671,paladin,retribution,60,24,36
22123,Pantufä,stormrage,1670,paladin,retribution,41,21,20
22124,Zarrakra,daggerspine,1669,paladin,retribution,93,51,42
22125,Pumperjer,tichondrius,1669,paladin,retribution,53,26,27
22126,Boarfarmer,tichondrius,1669,paladin,retribution,48,23,25
22127,Galeast,tichondrius,1668,paladin,retribution,60,24,36
22128,Powermonster,tichondrius,1666,paladin,retribution,42,19,23
22129,Lidranas,sargeras,1665,paladin,retribution,51,31,20
22130,Haiden,goldrinn,1665,paladin,retribution,55,23,32
22131,Ibullyourmom,tichondrius,1664,paladin,retribution,53,24,29
22132,Jxke,barthilas,1663,paladin,retribution,41,20,21
22133,Stompëd,proudmoore,1663,paladin,retribution,62,29,33
22134,Finaljustice,sargeras,1661,paladin,retribution,30,19,11
22135,Xenk,moon-guard,1659,paladin,retribution,34,18,16
22136,Crismj,tichondrius,1659,paladin,retribution,78,41,37
22137,Bigjiba,proudmoore,1658,paladin,retribution,48,25,23
22138,Alyxandr,dalaran,1658,paladin,retribution,48,24,24
22139,Midheaven,moon-guard,1656,paladin,retribution,59,36,23
22140,Slashnroses,tichondrius,1656,paladin,retribution,44,19,25
22141,Sabotsaint,tichondrius,1656,paladin,retribution,49,20,29
22142,Relentless,magtheridon,1655,paladin,retribution,71,41,30
22143,Djdiogø,azralon,1655,paladin,retribution,98,46,52
22144,Reckcowning,area-52,1655,paladin,retribution,48,20,28
22145,Lillm,malganis,1654,paladin,retribution,36,21,15
22146,Paladinomg,darkspear,1654,paladin,retribution,130,74,56
22147,Forthestreet,tichondrius,1654,paladin,retribution,88,48,40
22148,Iggÿ,illidan,1654,paladin,retribution,70,30,40
22149,Itzcupcake,illidan,1653,paladin,retribution,120,69,51
22150,Duffnroses,tichondrius,1653,paladin,retribution,60,27,33
22151,Palimedic,sargeras,1653,paladin,retribution,84,37,47
22152,Hozna,andorhal,1652,paladin,retribution,61,36,25
22153,Toguro,kelthuzad,1652,paladin,retribution,64,36,28
22154,Backdrop,proudmoore,1652,paladin,retribution,133,67,66
22155,Mazaltoff,proudmoore,1652,paladin,retribution,84,42,42
22156,Rethir,illidan,1651,paladin,retribution,41,26,15
22157,Lanach,lightbringer,1651,paladin,retribution,64,33,31
22158,Orivia,spirestone,1651,paladin,retribution,54,26,28
22159,Trixtur,tichondrius,1651,paladin,retribution,60,28,32
22160,Malandru,darrowmere,1649,paladin,retribution,63,28,35
22161,Matthrian,moon-guard,1649,paladin,retribution,60,22,38
22162,Likzebawlz,tichondrius,1648,paladin,retribution,42,25,17
22163,Comeuppance,wyrmrest-accord,1648,paladin,retribution,118,61,57
22164,Divínos,area-52,1647,paladin,retribution,60,31,29
22165,Nasnyl,stormrage,1646,paladin,retribution,42,20,22
22166,Parkwons,tichondrius,1646,paladin,retribution,60,23,37
22167,Bigolcriddys,barthilas,1645,paladin,retribution,36,21,15
22168,Feannor,drakkari,1645,paladin,retribution,52,29,23
22169,Geedee,ysera,1645,paladin,retribution,70,39,31
22170,Eneraxx,proudmoore,1645,paladin,retribution,48,20,28
22171,Trippën,tichondrius,1644,paladin,retribution,163,86,77
22172,Tyirr,kelthuzad,1644,paladin,retribution,102,49,53
22173,Semellem,bloodhoof,1644,paladin,retribution,48,23,25
22174,Därth,azralon,1644,paladin,retribution,46,20,26
22175,Palabeshar,area-52,1644,paladin,retribution,48,18,30
22176,Beefjustice,velen,1643,paladin,retribution,48,27,21
22177,Sevik,garithos,1643,paladin,retribution,66,35,31
22178,Jackstank,dragonmaw,1642,paladin,retribution,53,33,20
22179,Garlond,moon-guard,1642,paladin,retribution,42,25,17
22180,Seraphini,illidan,1642,paladin,retribution,65,34,31
22181,Oathen,proudmoore,1642,paladin,retribution,56,27,29
22182,Kalgormoth,ragnaros,1641,paladin,retribution,53,21,32
22183,Serås,silvermoon,1640,paladin,retribution,66,43,23
22184,Shiadfang,tichondrius,1640,paladin,retribution,72,39,33
22185,Lleo,nemesis,1640,paladin,retribution,118,54,64
22186,Izidar,tichondrius,1639,paladin,retribution,36,24,12
22187,Bakapal,tichondrius,1639,paladin,retribution,42,22,20
22188,Dayuanzhong,tichondrius,1639,paladin,retribution,51,21,30
22189,Theseusz,tichondrius,1638,paladin,retribution,36,26,10
22190,Candysugar,tichondrius,1638,paladin,retribution,30,18,12
22191,Notneo,zuljin,1638,paladin,retribution,53,31,22
22192,Ceyh,ragnaros,1638,paladin,retribution,53,25,28
22193,Benoít,zuljin,1637,paladin,retribution,84,48,36
22194,Brightstar,azjolnerub,1637,paladin,retribution,71,39,32
22195,Dimdabbin,malganis,1637,paladin,retribution,42,22,20
22196,Palejandro,illidan,1637,paladin,retribution,95,49,46
22197,Saccro,area-52,1637,paladin,retribution,114,57,57
22198,Sosalo,sargeras,1637,paladin,retribution,51,23,28
22199,Jud,frostmourne,1636,paladin,retribution,90,43,47
22200,Palban,tichondrius,1635,paladin,retribution,60,31,29
22201,Lightowen,draka,1634,paladin,retribution,46,22,24
22202,Cyanss,ragnaros,1634,paladin,retribution,47,19,28
22203,Beardy,emerald-dream,1633,paladin,retribution,60,36,24
22204,Inmortall,illidan,1632,paladin,retribution,54,30,24
22205,Mílkywayx,stormrage,1632,paladin,retribution,102,51,51
22206,Mesmi,moon-guard,1631,paladin,retribution,66,31,35
22207,Craq,alexstrasza,1631,paladin,retribution,56,26,30
22208,Zayblade,dragonblight,1630,paladin,retribution,40,23,17
22209,Tobaz,azralon,1630,paladin,retribution,85,48,37
22210,Ulrah,moon-guard,1629,paladin,retribution,120,68,52
22211,Hristian,tichondrius,1629,paladin,retribution,42,22,20
22212,Thoreal,thrall,1629,paladin,retribution,78,37,41
22213,Chancellor,azralon,1628,paladin,retribution,168,94,74
22214,Varekaì,frostmourne,1628,paladin,retribution,147,78,69
22215,Derigoth,quelthalas,1628,paladin,retribution,42,20,22
22216,Ítsyôúñötmé,tichondrius,1627,paladin,retribution,68,38,30
22217,Kíbá,malganis,1627,paladin,retribution,33,18,15
22218,Sathandrä,sargeras,1627,paladin,retribution,63,27,36
22219,Bastiion,stormrage,1626,paladin,retribution,64,32,32
22220,Davinshki,stormrage,1625,paladin,retribution,43,25,18
22221,Fluffnac,tichondrius,1625,paladin,retribution,30,17,13
22222,Notbärry,area-52,1625,paladin,retribution,48,27,21
22223,Renckay,ragnaros,1625,paladin,retribution,99,52,47
22224,Aeterias,dalaran,1625,paladin,retribution,81,41,40
22225,Chajaaro,ragnaros,1625,paladin,retribution,67,33,34
22226,Apnea,ragnaros,1625,paladin,retribution,125,53,72
22227,Moød,ragnaros,1624,paladin,retribution,53,27,26
22228,Techno,tichondrius,1623,paladin,retribution,175,89,86
22229,Radacos,emerald-dream,1623,paladin,retribution,160,80,80
22230,Sugnidrom,frostmourne,1623,paladin,retribution,46,23,23
22231,Joeyrat,area-52,1623,paladin,retribution,42,20,22
22232,Retrodino,anvilmar,1623,paladin,retribution,48,21,27
22233,Xuanxingchai,tichondrius,1623,paladin,retribution,42,17,25
22234,Cyrenity,tichondrius,1623,paladin,retribution,59,19,40
22235,Litler,tichondrius,1622,paladin,retribution,44,30,14
22236,Gobblerr,blackrock,1622,paladin,retribution,30,20,10
22237,Hazexd,illidan,1621,paladin,retribution,36,20,16
22238,Dashhighborn,sargeras,1621,paladin,retribution,71,38,33
22239,Faladrim,moon-guard,1621,paladin,retribution,160,84,76
22240,Michaelsmith,frostmourne,1621,paladin,retribution,36,17,19
22241,Rukkas,sargeras,1621,paladin,retribution,54,21,33
22242,Alanthor,ragnaros,1620,paladin,retribution,120,58,62
22243,Valytonz,wyrmrest-accord,1620,paladin,retribution,36,17,19
22244,Marcêl,quelthalas,1619,paladin,retribution,36,22,14
22245,Pinkies,frostmourne,1619,paladin,retribution,57,33,24
22246,Bbtea,frostmourne,1619,paladin,retribution,48,20,28
22247,Glørious,drakkari,1618,paladin,retribution,90,42,48
22248,Tuuro,stormrage,1618,paladin,retribution,141,65,76
22249,Outkas,area-52,1617,paladin,retribution,30,17,13
22250,Aleríon,ragnaros,1617,paladin,retribution,175,89,86
22251,Weike,barthilas,1617,paladin,retribution,70,28,42
22252,Lawmower,sargeras,1616,paladin,retribution,54,32,22
22253,Royalfather,tichondrius,1615,paladin,retribution,40,26,14
22254,Drholypurp,tichondrius,1615,paladin,retribution,59,31,28
22255,Outstrike,tichondrius,1615,paladin,retribution,36,17,19
22256,Thenextx,illidan,1615,paladin,retribution,66,22,44
22257,Raelan,icecrown,1614,paladin,retribution,71,49,22
22258,Merculios,stormrage,1614,paladin,retribution,57,31,26
22259,Healmeboi,tichondrius,1614,paladin,retribution,68,33,35
22260,Stax,moon-guard,1614,paladin,retribution,42,17,25
22261,Pockopea,arygos,1613,paladin,retribution,84,52,32
22262,Bramot,moon-guard,1613,paladin,retribution,36,20,16
22263,Xbloodknight,malganis,1613,paladin,retribution,50,27,23
22264,Milizi,zuljin,1613,paladin,retribution,72,32,40
22265,Galess,tichondrius,1613,paladin,retribution,48,17,31
22266,Yusha,barthilas,1612,paladin,retribution,41,28,13
22267,Tesak,emerald-dream,1612,paladin,retribution,102,53,49
22268,Moolishous,frostmourne,1612,paladin,retribution,83,43,40
22269,Telarøn,stormrage,1612,paladin,retribution,200,101,99
22270,Jvbai,area-52,1612,paladin,retribution,87,39,48
22271,Swiftskillz,bleeding-hollow,1611,paladin,retribution,127,69,58
22272,Kevybevy,stormrage,1611,paladin,retribution,150,81,69
22273,Accépting,sargeras,1611,paladin,retribution,84,40,44
22274,Rahmie,kiljaeden,1611,paladin,retribution,96,41,55
22275,Purejudgemnt,area-52,1610,paladin,retribution,54,33,21
22276,Beeftink,tichondrius,1609,paladin,retribution,100,51,49
22277,Allîe,malganis,1609,paladin,retribution,73,37,36
22278,Battlepope,thrall,1609,paladin,retribution,59,27,32
22279,Regivan,nemesis,1609,paladin,retribution,54,21,33
22280,Sololeveling,malganis,1608,paladin,retribution,98,48,50
22281,Golden,tichondrius,1608,paladin,retribution,42,20,22
22282,Holyroro,area-52,1607,paladin,retribution,44,26,18
22283,Yezzyll,korgath,1607,paladin,retribution,30,17,13
22284,Wasembroder,ragnaros,1607,paladin,retribution,89,50,39
22285,Gattís,stormrage,1607,paladin,retribution,54,29,25
22286,Trolladin,rivendare,1607,paladin,retribution,110,51,59
22287,Shakalot,illidan,1607,paladin,retribution,48,21,27
22288,Marehk,thrall,1606,paladin,retribution,59,32,27
22289,Southerly,tichondrius,1606,paladin,retribution,78,39,39
22290,Aefuezar,earthen-ring,1606,paladin,retribution,56,28,28
22291,Stônemôuntan,moon-guard,1606,paladin,retribution,72,26,46
22292,Munaru,illidan,1605,paladin,retribution,30,21,9
22293,Pçpaladin,stormrage,1605,paladin,retribution,36,21,15
22294,Chrisader,stormrage,1605,paladin,retribution,36,19,17
22295,Dïlly,area-52,1605,paladin,retribution,84,43,41
22296,Getdiswork,malygos,1605,paladin,retribution,105,52,53
22297,Virtuosi,area-52,1604,paladin,retribution,42,23,19
22298,Xeniél,illidan,1604,paladin,retribution,36,19,17
22299,Arreliya,sargeras,1604,paladin,retribution,78,41,37
22300,Rycerzforge,ragnaros,1604,paladin,retribution,74,38,36
22301,Actionb,aggramar,1604,paladin,retribution,90,41,49
22302,Rhegyna,quelthalas,1603,paladin,retribution,48,26,22
22303,Plophero,moon-guard,1603,paladin,retribution,54,28,26
22304,Skylinator,bleeding-hollow,1603,paladin,retribution,59,26,33
22305,Jowliet,stormrage,1601,paladin,retribution,36,17,19
22306,Elcíd,quelthalas,1601,paladin,retribution,87,34,53
22307,Aethelwulf,stormrage,1600,paladin,retribution,42,24,18
22308,Minidin,kiljaeden,1599,paladin,retribution,36,17,19
22309,Elëssar,ragnaros,1598,paladin,retribution,83,44,39
22310,Samgonz,tichondrius,1597,paladin,retribution,54,32,22
22311,Esçanór,darkspear,1597,paladin,retribution,49,25,24
22312,Skilladin,zuljin,1596,paladin,retribution,48,24,24
22313,Pandoro,tichondrius,1594,paladin,retribution,49,29,20
22314,Kozk,quelthalas,1594,paladin,retribution,159,92,67
22315,Happybubbles,tichondrius,1594,paladin,retribution,36,20,16
22316,Layonhánd,ragnaros,1593,paladin,retribution,48,22,26
22317,Amanzhul,quelthalas,1593,paladin,retribution,48,21,27
22318,Alpengeist,turalyon,1591,paladin,retribution,36,19,17
22319,Gimlias,kelthuzad,1591,paladin,retribution,42,21,21
22320,Cøøkïë,frostmourne,1590,paladin,retribution,42,22,20
22321,Torinel,illidan,1590,paladin,retribution,35,17,18
22322,Auralyon,tichondrius,1590,paladin,retribution,42,17,25
22323,Sinmca,moon-guard,1588,paladin,retribution,60,34,26
22324,Eurekasret,ragnaros,1587,paladin,retribution,65,33,32
22325,Hedilyan,azralon,1587,paladin,retribution,96,48,48
22326,Sandokhán,ragnaros,1587,paladin,retribution,42,19,23
22327,Ilovecl,tichondrius,1586,paladin,retribution,54,32,22
22328,Yukíteru,illidan,1586,paladin,retribution,39,18,21
22329,Cowsecration,ragnaros,1585,paladin,retribution,24,17,7
22330,Whyta,azralon,1584,paladin,retribution,145,75,70
22331,Fótm,bleeding-hollow,1583,paladin,retribution,72,36,36
22332,Lightlana,frostwolf,1583,paladin,retribution,68,34,34
22333,Marvallous,area-52,1583,paladin,retribution,52,25,27
22334,Landeren,khazgoroth,1582,paladin,retribution,48,22,26
22335,Taphos,icecrown,1581,paladin,retribution,53,30,23
22336,Utherpendrag,bladefist,1581,paladin,retribution,72,28,44
22337,Lucianz,ragnaros,1580,paladin,retribution,54,25,29
22338,Borrus,malygos,1579,paladin,retribution,78,40,38
22339,Lecheroø,tichondrius,1579,paladin,retribution,42,21,21
22340,Danaimei,tichondrius,1577,paladin,retribution,36,19,17
22341,Rimjobrachel,barthilas,1577,paladin,retribution,86,42,44
22342,Fuknshané,area-52,1577,paladin,retribution,68,32,36
22343,Malacriianza,quelthalas,1576,paladin,retribution,54,30,24
22344,Leztatium,quelthalas,1576,paladin,retribution,42,21,21
22345,Daddytoad,tichondrius,1576,paladin,retribution,54,24,30
22346,Ellyee,jaedenar,1576,paladin,retribution,70,29,41
22347,Syreqt,nemesis,1575,paladin,retribution,36,19,17
22348,Neovincent,aggramar,1574,paladin,retribution,30,18,12
22349,Fìlìgree,tichondrius,1574,paladin,retribution,55,30,25
22350,Ruhn,eldrethalas,1574,paladin,retribution,36,18,18
22351,Razneroka,ragnaros,1573,paladin,retribution,39,22,17
22352,Daleroth,ragnaros,1573,paladin,retribution,39,22,17
22353,Stackmymoney,kelthuzad,1572,paladin,retribution,50,22,28
22354,Pocserpala,drakkari,1571,paladin,retribution,30,19,11
22355,Ezael,crushridge,1570,paladin,retribution,42,21,21
22356,Purdicks,emerald-dream,1569,paladin,retribution,142,71,71
22357,Mormdring,fizzcrank,1569,paladin,retribution,59,26,33
22358,Htmlar,tichondrius,1568,paladin,retribution,40,17,23
22359,Guerrer,hyjal,1567,paladin,retribution,60,33,27
22360,Obsolete,onyxia,1567,paladin,retribution,36,18,18
22361,Coffeepal,tichondrius,1567,paladin,retribution,48,23,25
22362,Cillessá,kelthuzad,1566,paladin,retribution,78,41,37
22363,Émiluss,stormrage,1566,paladin,retribution,36,18,18
22364,Xerobite,quelthalas,1566,paladin,retribution,36,18,18
22365,Chiphazard,stormscale,1566,paladin,retribution,58,23,35
22366,Ragarèn,emerald-dream,1565,paladin,retribution,36,17,19
22367,Andrilsteh,malganis,1565,paladin,retribution,102,45,57
22368,Fionno,quelthalas,1564,paladin,retribution,116,58,58
22369,Tantradin,area-52,1564,paladin,retribution,48,20,28
22370,Andallar,nordrassil,1562,paladin,retribution,36,23,13
22371,Aiseyqt,frostmourne,1562,paladin,retribution,90,57,33
22372,Lagwat,sargeras,1561,paladin,retribution,48,31,17
22373,Rxes,frostmourne,1561,paladin,retribution,99,43,56
22374,Baeflux,kelthuzad,1560,paladin,retribution,48,19,29
22375,Luret,tichondrius,1557,paladin,retribution,34,17,17
22376,Insideous,kelthuzad,1557,paladin,retribution,69,34,35
22377,Redoubt,archimonde,1557,paladin,retribution,35,17,18
22378,Vêgenace,proudmoore,1556,paladin,retribution,48,24,24
22379,Missusomutch,azralon,1556,paladin,retribution,50,17,33
22380,Lit,alexstrasza,1555,paladin,retribution,46,19,27
22381,Ibustcheeks,sargeras,1554,paladin,retribution,35,17,18
22382,Flykzu,azralon,1554,paladin,retribution,160,74,86
22383,Crybátt,quelthalas,1553,paladin,retribution,68,35,33
22384,Luminiscente,ragnaros,1553,paladin,retribution,58,29,29
22385,Alexieus,wyrmrest-accord,1553,paladin,retribution,71,32,39
22386,Filthyape,wyrmrest-accord,1552,paladin,retribution,66,39,27
22387,Lumaros,wyrmrest-accord,1552,paladin,retribution,48,25,23
22388,Thastrian,stormreaver,1552,paladin,retribution,60,31,29
22389,Notoriouus,bleeding-hollow,1552,paladin,retribution,42,18,24
22390,Yovan,proudmoore,1551,paladin,retribution,90,51,39
22391,Holybirkkal,arthas,1551,paladin,retribution,47,25,22
22392,Albïreo,drakkari,1550,paladin,retribution,54,28,26
22393,Holyjoint,uther,1550,paladin,retribution,92,39,53
22394,Mcholy,thrall,1549,paladin,retribution,50,27,23
22395,Sàgadegemeós,stormrage,1548,paladin,retribution,54,31,23
22396,Evilmerdoc,kelthuzad,1548,paladin,retribution,36,18,18
22397,Caribourider,tichondrius,1548,paladin,retribution,65,29,36
22398,Mordered,proudmoore,1548,paladin,retribution,46,18,28
22399,Scrubble,thrall,1547,paladin,retribution,90,44,46
22400,Varlip,wyrmrest-accord,1545,paladin,retribution,53,18,35
22401,Ënfos,azralon,1541,paladin,retribution,36,17,19
22402,Thaldun,wyrmrest-accord,1541,paladin,retribution,95,41,54
22403,Ðoflamingo,area-52,1540,paladin,retribution,72,38,34
22404,Quadrifoglio,moon-guard,1540,paladin,retribution,138,70,68
22405,Brokeniron,wyrmrest-accord,1539,paladin,retribution,66,31,35
22406,Frùglé,sargeras,1538,paladin,retribution,36,20,16
22407,Zalndraeda,barthilas,1538,paladin,retribution,96,48,48
22408,Celethor,wyrmrest-accord,1537,paladin,retribution,54,30,24
22409,Tatakaicjq,tichondrius,1537,paladin,retribution,33,18,15
22410,Thepinkdept,proudmoore,1537,paladin,retribution,38,20,18
22411,Nilin,tichondrius,1537,paladin,retribution,54,27,27
22412,Aberpal,illidan,1535,paladin,retribution,41,23,18
22413,Dazedpal,tichondrius,1535,paladin,retribution,289,150,139
22414,Greciâ,ragnaros,1535,paladin,retribution,42,18,24
22415,Hammrekt,sargeras,1534,paladin,retribution,24,16,8
22416,Tearet,tichondrius,1534,paladin,retribution,24,16,8
22417,Álkair,ragnaros,1534,paladin,retribution,83,36,47
22418,Jager,medivh,1533,paladin,retribution,71,41,30
22419,Retcuzyaknow,illidan,1533,paladin,retribution,36,16,20
22420,Ezcoatl,stormrage,1530,paladin,retribution,92,47,45
22421,Arlanso,frostmourne,1530,paladin,retribution,40,18,22
22422,Loyality,sargeras,1530,paladin,retribution,36,16,20
22423,Beardedbrute,korgath,1529,paladin,retribution,30,16,14
22424,Schankyy,stormrage,1529,paladin,retribution,36,19,17
22425,Deepsearide,illidan,1529,paladin,retribution,119,61,58
22426,Unfairness,skullcrusher,1528,paladin,retribution,63,33,30
22427,Ástridr,moon-guard,1528,paladin,retribution,95,43,52
22428,Arturias,kiljaeden,1527,paladin,retribution,77,38,39
22429,Oneshotman,stormrage,1526,paladin,retribution,30,16,14
22430,Ironcoco,ragnaros,1526,paladin,retribution,38,19,19
22431,Kenpachí,doomhammer,1525,paladin,retribution,42,30,12
22432,Venxpeita,azralon,1525,paladin,retribution,24,16,8
22433,Rektwings,area-52,1525,paladin,retribution,30,16,14
22434,Dragin,azralon,1525,paladin,retribution,41,21,20
22435,Palaxoto,nemesis,1525,paladin,retribution,48,19,29
22436,Shaidd,bleeding-hollow,1524,paladin,retribution,98,49,49
22437,Mfgspally,kelthuzad,1523,paladin,retribution,54,31,23
22438,Blitzzed,area-52,1522,paladin,retribution,35,18,17
22439,Sneeber,stormrage,1520,paladin,retribution,72,34,38
22440,Anjurus,moon-guard,1519,paladin,retribution,30,16,14
22441,Castïël,area-52,1519,paladin,retribution,157,77,80
22442,Tzakial,area-52,1519,paladin,retribution,42,16,26
22443,Gude,sargeras,1518,paladin,retribution,30,16,14
22444,Shartea,moon-guard,1518,paladin,retribution,58,29,29
22445,Týrael,uldum,1517,paladin,retribution,48,28,20
22446,Chewyjitsu,tichondrius,1517,paladin,retribution,30,17,13
22447,Worshipmex,tichondrius,1517,paladin,retribution,36,20,16
22448,Eustace,thunderhorn,1517,paladin,retribution,35,19,16
22449,Sweetcandy,sargeras,1517,paladin,retribution,42,21,21
22450,Souyiro,sargeras,1517,paladin,retribution,36,16,20
22451,Ascetic,barthilas,1517,paladin,retribution,200,87,113
22452,Lorenzinho,azralon,1516,paladin,retribution,80,42,38
22453,Buddyolpally,proudmoore,1515,paladin,retribution,36,19,17
22454,Tofuupal,tichondrius,1514,paladin,retribution,36,16,20
22455,Poisson,wildhammer,1514,paladin,retribution,36,16,20
22456,Kawkpaladin,kaelthas,1512,paladin,retribution,60,31,29
22457,Pàladwarf,stormrage,1511,paladin,retribution,51,26,25
22458,Sniper,uther,1510,paladin,retribution,30,16,14
22459,Protein,magtheridon,1509,paladin,retribution,42,16,26
22460,Mysticblade,sargeras,1508,paladin,retribution,54,31,23
22461,Temote,anvilmar,1508,paladin,retribution,54,27,27
22462,Cyreus,emerald-dream,1508,paladin,retribution,57,26,31
22463,Miemiesage,illidan,1508,paladin,retribution,42,16,26
22464,Yazuka,wyrmrest-accord,1506,paladin,retribution,54,30,24
22465,Cókelol,zuljin,1506,paladin,retribution,78,42,36
22466,Istril,ragnaros,1506,paladin,retribution,292,152,140
22467,Preacherfudd,area-52,1506,paladin,retribution,42,21,21
22468,Angrytitan,tichondrius,1504,paladin,retribution,42,17,25
22469,Pvrisxx,frostmourne,1503,paladin,retribution,54,28,26
22470,Bubblelol,bloodhoof,1503,paladin,retribution,51,17,34
22471,Xk,kiljaeden,1502,paladin,retribution,30,16,14
22472,Rhodela,illidan,1502,paladin,retribution,48,24,24
22473,Kiritazuma,ravencrest,1502,paladin,retribution,78,37,41
22474,Alphanerd,burning-blade,1501,paladin,retribution,42,26,16
22475,Rohrn,firetree,1501,paladin,retribution,55,32,23
22476,Notae,alexstrasza,1501,paladin,retribution,35,16,19
22477,Norlannd,ragnaros,1499,paladin,retribution,30,16,14
22478,Kookamønga,tichondrius,1498,paladin,retribution,67,32,35
22479,Mäýhëm,sargeras,1497,paladin,retribution,36,22,14
22480,Hinataa,illidan,1497,paladin,retribution,81,45,36
22481,Audris,chogall,1497,paladin,retribution,65,29,36
22482,Tøpbløke,frostmourne,1495,paladin,retribution,109,59,50
22483,Hamertime,wyrmrest-accord,1495,paladin,retribution,92,47,45
22484,Konthrus,azralon,1494,paladin,retribution,77,49,28
22485,Schwârts,blackrock,1494,paladin,retribution,70,36,34
22486,Emmastoned,bleeding-hollow,1493,paladin,retribution,54,27,27
22487,Anivan,moon-guard,1493,paladin,retribution,42,21,21
22488,Bogùs,tichondrius,1493,paladin,retribution,36,16,20
22489,Ignasius,blood-furnace,1492,paladin,retribution,48,22,26
22490,Yiqieyouwei,proudmoore,1492,paladin,retribution,42,18,24
22491,Holdup,moon-guard,1491,paladin,retribution,35,25,10
22492,Upaitaon,stormrage,1491,paladin,retribution,54,27,27
22493,Holydiver,sargeras,1490,paladin,retribution,96,44,52
22494,Nocomus,andorhal,1489,paladin,retribution,60,28,32
22495,Mathieü,zuljin,1488,paladin,retribution,36,20,16
22496,Dgâza,tichondrius,1488,paladin,retribution,36,17,19
22497,Oppression,kul-tiras,1488,paladin,retribution,53,19,34
22498,Dzx,nemesis,1487,paladin,retribution,263,135,128
22499,Grîshnâkh,ragnaros,1487,paladin,retribution,119,61,58
22500,Hägär,tichondrius,1487,paladin,retribution,54,23,31
22501,Haunter,akama,1485,paladin,retribution,54,25,29
22502,Dcountt,area-52,1484,paladin,retribution,47,22,25
22503,Levian,spirestone,1483,paladin,retribution,90,46,44
22504,Greasysteve,stormrage,1482,paladin,retribution,60,33,27
22505,Lebowski,nordrassil,1482,paladin,retribution,36,19,17
22506,Smallhammer,aegwynn,1482,paladin,retribution,66,28,38
22507,Dalgren,quelthalas,1482,paladin,retribution,81,30,51
22508,Sammyste,elune,1480,paladin,retribution,86,46,40
22509,Ralo,khaz-modan,1480,paladin,retribution,30,16,14
22510,Joltie,quelthalas,1480,paladin,retribution,155,82,73
22511,Freiermoth,shadowmoon,1480,paladin,retribution,135,69,66
22512,Gokuu,korgath,1480,paladin,retribution,84,42,42
22513,Forlam,sargeras,1480,paladin,retribution,108,45,63
22514,Areuss,tichondrius,1479,paladin,retribution,29,16,13
22515,Ogholyhands,bleeding-hollow,1479,paladin,retribution,42,23,19
22516,Janokaluo,wyrmrest-accord,1479,paladin,retribution,89,46,43
22517,Killeralan,quelthalas,1477,paladin,retribution,74,34,40
22518,Jøestar,proudmoore,1477,paladin,retribution,58,26,32
22519,Jonfox,stormrage,1476,paladin,retribution,61,32,29
22520,Sconci,whisperwind,1475,paladin,retribution,42,20,22
22521,Azoruken,quelthalas,1475,paladin,retribution,71,31,40
22522,Redemptiøn,nemesis,1475,paladin,retribution,60,20,40
22523,Arecht,moon-guard,1474,paladin,retribution,30,19,11
22524,Fressbee,nathrezim,1473,paladin,retribution,41,19,22
22525,Alexese,area-52,1472,paladin,retribution,71,39,32
22526,Chadatron,tichondrius,1472,paladin,retribution,36,17,19
22527,Zuthora,alleria,1471,paladin,retribution,70,37,33
22528,Ellanaria,thrall,1471,paladin,retribution,117,61,56
22529,Beshiki,hakkar,1471,paladin,retribution,286,139,147
22530,Piea,tichondrius,1471,paladin,retribution,48,22,26
22531,Yoboyindahiz,stormrage,1471,paladin,retribution,57,23,34
22532,Rykorth,moon-guard,1470,paladin,retribution,33,20,13
22533,Carnagias,bleeding-hollow,1470,paladin,retribution,71,38,33
22534,Charleyy,stormscale,1469,paladin,retribution,78,45,33
22535,Pijbins,moon-guard,1469,paladin,retribution,66,34,32
22536,Atterz,azralon,1469,paladin,retribution,40,18,22
22537,Freddieroach,tichondrius,1469,paladin,retribution,36,16,20
22538,Ezpzxd,arygos,1467,paladin,retribution,38,19,19
22539,Vasharien,nerzhul,1467,paladin,retribution,74,35,39
22540,Dimmadome,frostmourne,1465,paladin,retribution,78,50,28
22541,Nicret,tichondrius,1464,paladin,retribution,24,18,6
22542,Toughlife,tichondrius,1464,paladin,retribution,72,28,44
22543,Nohpalli,kelthuzad,1463,paladin,retribution,79,43,36
22544,Bañe,lightbringer,1463,paladin,retribution,81,35,46
22545,Bronytime,illidan,1462,paladin,retribution,29,16,13
22546,Dreyan,wyrmrest-accord,1462,paladin,retribution,47,23,24
22547,Killmönger,tichondrius,1462,paladin,retribution,58,25,33
22548,Sanguinata,shadowsong,1461,paladin,retribution,47,30,17
22549,Snussp,emerald-dream,1461,paladin,retribution,69,32,37
22550,Crayt,tichondrius,1461,paladin,retribution,97,40,57
22551,Lasteroy,nemesis,1459,paladin,retribution,29,16,13
22552,Konarik,stormrage,1459,paladin,retribution,46,25,21
22553,Bapped,dalaran,1459,paladin,retribution,54,24,30
22554,Athenauwu,illidan,1458,paladin,retribution,40,19,21
22555,Valardaharis,thunderlord,1457,paladin,retribution,100,43,57
22556,Theholysword,tichondrius,1457,paladin,retribution,41,16,25
22557,Dentarg,garrosh,1456,paladin,retribution,54,29,25
22558,Esixtytwoone,area-52,1455,paladin,retribution,30,21,9
22559,Folgimar,moon-guard,1455,paladin,retribution,72,37,35
22560,Orestis,stormrage,1455,paladin,retribution,39,20,19
22561,Thalorian,azshara,1455,paladin,retribution,51,25,26
22562,Astharor,nemesis,1454,paladin,retribution,70,40,30
22563,Psadin,thunderlord,1454,paladin,retribution,48,23,25
22564,Sovereignt,aggramar,1453,paladin,retribution,157,84,73
22565,Monchy,bleeding-hollow,1453,paladin,retribution,52,27,25
22566,Wwanntae,tichondrius,1453,paladin,retribution,60,26,34
22567,Yamush,silver-hand,1452,paladin,retribution,36,18,18
22568,Cammack,thrall,1452,paladin,retribution,63,25,38
22569,Vexxa,nerzhul,1451,paladin,retribution,36,18,18
22570,Murtag,bloodscalp,1451,paladin,retribution,36,18,18
22571,Tacien,tichondrius,1451,paladin,retribution,112,54,58
22572,Cyäbyë,frostmourne,1450,paladin,retribution,30,18,12
22573,Drtom,mannoroth,1450,paladin,retribution,39,21,18
22574,Liaadrin,azralon,1450,paladin,retribution,32,16,16
22575,Solandiis,tichondrius,1450,paladin,retribution,67,32,35
22576,Airplane,malygos,1449,paladin,retribution,24,16,8
22577,Lustros,stormrage,1449,paladin,retribution,66,28,38
22578,Avati,sargeras,1448,paladin,retribution,22,16,6
22579,Californía,bleeding-hollow,1448,paladin,retribution,37,23,14
22580,Bladetm,proudmoore,1448,paladin,retribution,62,28,34
22581,Aoishie,bleeding-hollow,1444,paladin,retribution,96,45,51
22582,Muffinknight,quelthalas,1443,paladin,retribution,55,36,19
22583,Iluminadoor,nemesis,1442,paladin,retribution,29,19,10
22584,Weskar,frostwolf,1440,paladin,retribution,42,24,18
22585,Faowin,sargeras,1440,paladin,retribution,72,32,40
22586,Awake,chogall,1439,paladin,retribution,24,15,9
22587,Taeret,tichondrius,1439,paladin,retribution,24,15,9
22588,Blulux,ragnaros,1439,paladin,retribution,71,39,32
22589,Kkgame,tichondrius,1439,paladin,retribution,37,19,18
22590,Bilbain,proudmoore,1439,paladin,retribution,203,103,100
22591,Zadragon,sargeras,1438,paladin,retribution,54,27,27
22592,Cesah,tichondrius,1436,paladin,retribution,24,15,9
22593,Oppressive,moon-guard,1436,paladin,retribution,291,135,156
22594,Xalø,ragnaros,1435,paladin,retribution,24,15,9
22595,Zolktro,stormrage,1435,paladin,retribution,52,27,25
22596,Mitchyc,stormrage,1435,paladin,retribution,66,33,33
22597,Warmpôcket,proudmoore,1435,paladin,retribution,66,26,40
22598,Whitearmor,draenor,1434,paladin,retribution,42,24,18
22599,Lumíty,sargeras,1434,paladin,retribution,137,70,67
22600,Gimli,mannoroth,1434,paladin,retribution,36,15,21
22601,Onitenshi,stormscale,1432,paladin,retribution,85,41,44
22602,Antarcticala,frostmourne,1432,paladin,retribution,48,20,28
22603,Saakadin,illidan,1431,paladin,retribution,24,15,9
22604,Perzeføne,quelthalas,1431,paladin,retribution,41,20,21
22605,Rasc,barthilas,1431,paladin,retribution,42,18,24
22606,Sprinkills,frostmourne,1430,paladin,retribution,27,19,8
22607,Richiggaa,illidan,1430,paladin,retribution,47,29,18
22608,Aztraseneco,ragnaros,1430,paladin,retribution,104,59,45
22609,Lmd,tichondrius,1429,paladin,retribution,54,29,25
22610,Supercharged,area-52,1429,paladin,retribution,30,15,15
22611,Pugnosano,black-dragonflight,1429,paladin,retribution,36,17,19
22612,Dawncröwn,stormrage,1429,paladin,retribution,53,17,36
22613,Falaran,azralon,1428,paladin,retribution,62,32,30
22614,Aiethyria,tichondrius,1427,paladin,retribution,24,15,9
22615,Messeb,veknilash,1427,paladin,retribution,145,80,65
22616,Wesdarian,jaedenar,1427,paladin,retribution,90,41,49
22617,Donao,illidan,1426,paladin,retribution,66,35,31
22618,Talantyr,zuljin,1426,paladin,retribution,78,36,42
22619,Holiness,stormreaver,1426,paladin,retribution,42,15,27
22620,Tribiani,lightbringer,1425,paladin,retribution,24,15,9
22621,Dallyon,stormrage,1425,paladin,retribution,24,15,9
22622,Mathalt,area-52,1425,paladin,retribution,51,26,25
22623,Superpaladin,stormrage,1425,paladin,retribution,53,23,30
22624,Floquiinhos,azralon,1425,paladin,retribution,36,15,21
22625,Jursch,emerald-dream,1424,paladin,retribution,145,73,72
22626,Tekar,altar-of-storms,1424,paladin,retribution,42,17,25
22627,Modjytech,tichondrius,1422,paladin,retribution,66,24,42
22628,Plniss,tichondrius,1421,paladin,retribution,36,15,21
22629,Arahann,bleeding-hollow,1420,paladin,retribution,29,16,13
22630,Palpinga,kelthuzad,1420,paladin,retribution,44,18,26
22631,Tåine,suramar,1420,paladin,retribution,48,16,32
22632,Annhette,sargeras,1418,paladin,retribution,31,15,16
22633,Lolslikeomg,malganis,1418,paladin,retribution,96,39,57
22634,Galanblack,dalaran,1417,paladin,retribution,56,31,25
22635,Napstër,ragnaros,1417,paladin,retribution,36,15,21
22636,Wagyou,skywall,1416,paladin,retribution,30,15,15
22637,Yawnbringer,tichondrius,1416,paladin,retribution,108,52,56
22638,Balrok,cenarius,1415,paladin,retribution,185,93,92
22639,Hdmi,darkspear,1415,paladin,retribution,41,20,21
22640,Andrinn,nemesis,1415,paladin,retribution,51,24,27
22641,Minzyy,frostmourne,1414,paladin,retribution,24,15,9
22642,Zadquel,ragnaros,1414,paladin,retribution,59,30,29
22643,Lightcast,moon-guard,1414,paladin,retribution,66,33,33
22644,Savagedemise,barthilas,1413,paladin,retribution,55,28,27
22645,Justicierø,aegwynn,1413,paladin,retribution,42,21,21
22646,Solgrïm,wyrmrest-accord,1412,paladin,retribution,42,21,21
22647,Nuggetpusher,thunderlord,1410,paladin,retribution,31,16,15
22648,Ödin,scarlet-crusade,1410,paladin,retribution,30,15,15
22649,Bullzor,aerie-peak,1409,paladin,retribution,49,33,16
22650,Smashnasty,area-52,1409,paladin,retribution,24,15,9
22651,Tìg,proudmoore,1409,paladin,retribution,59,33,26
22652,Releváncé,barthilas,1409,paladin,retribution,66,31,35
22653,Vaqoh,ragnaros,1409,paladin,retribution,36,15,21
22654,Kalboko,twisting-nether,1408,paladin,retribution,45,23,22
22655,Reìarthur,stormrage,1408,paladin,retribution,72,32,40
22656,Kulandis,stormrage,1408,paladin,retribution,57,24,33
22657,Cloaxy,azgalor,1408,paladin,retribution,78,29,49
22658,Anafensa,malganis,1408,paladin,retribution,42,15,27
22659,Milke,chogall,1407,paladin,retribution,36,17,19
22660,Szeq,tichondrius,1405,paladin,retribution,32,16,16
22661,Outlivz,hyjal,1404,paladin,retribution,33,17,16
22662,Fây,sargeras,1404,paladin,retribution,42,15,27
22663,Kêrmit,zuljin,1403,paladin,retribution,25,16,9
22664,Zimzob,stormscale,1403,paladin,retribution,30,15,15
22665,Swietomierz,proudmoore,1403,paladin,retribution,48,20,28
22666,Againstfilet,azralon,1403,paladin,retribution,60,17,43
22667,Jdgmnt,sargeras,1401,paladin,retribution,72,33,39
22668,Eamon,kelthuzad,1400,paladin,retribution,29,15,14
22669,Viclovin,stormrage,1400,paladin,retribution,34,17,17
22670,Holyham,fizzcrank,1398,paladin,retribution,48,27,21
22671,Chuckman,skullcrusher,1397,paladin,retribution,30,16,14
22672,Pvppaulx,moon-guard,1397,paladin,retribution,36,19,17
22673,Kadbury,icecrown,1396,paladin,retribution,154,64,90
22674,Rhodius,dalaran,1393,paladin,retribution,42,23,19
22675,Tmac,azralon,1393,paladin,retribution,68,35,33
22676,Belregn,illidan,1393,paladin,retribution,78,36,42
22677,Öpäf,steamwheedle-cartel,1393,paladin,retribution,49,21,28
22678,Emethala,windrunner,1392,paladin,retribution,36,19,17
22679,Tooholy,kiljaeden,1391,paladin,retribution,64,42,22
22680,Tronzyy,trollbane,1391,paladin,retribution,35,15,20
22681,Judgmentor,malganis,1391,paladin,retribution,82,34,48
22682,Droden,tichondrius,1390,paladin,retribution,55,29,26
22683,Dannyram,zuljin,1390,paladin,retribution,51,25,26
22684,Shampin,alexstrasza,1390,paladin,retribution,36,17,19
22685,Uxd,tichondrius,1390,paladin,retribution,36,16,20
22686,Industry,firetree,1389,paladin,retribution,27,16,11
22687,Smorezz,bonechewer,1389,paladin,retribution,72,37,35
22688,Cryptdog,illidan,1389,paladin,retribution,39,16,23
22689,Damndoi,tichondrius,1388,paladin,retribution,30,15,15
22690,Slowedreverb,stormrage,1387,paladin,retribution,81,42,39
22691,Granisdh,aegwynn,1387,paladin,retribution,54,27,27
22692,Pallytoot,aerie-peak,1386,paladin,retribution,60,35,25
22693,Erowyn,tichondrius,1385,paladin,retribution,30,15,15
22694,Simplesam,draenor,1385,paladin,retribution,36,15,21
22695,Belgrieve,proudmoore,1384,paladin,retribution,48,22,26
22696,Urfavxbf,baelgun,1383,paladin,retribution,104,56,48
22697,Oschy,moon-guard,1382,paladin,retribution,91,45,46
22698,Blindburn,ragnaros,1379,paladin,retribution,36,17,19
22699,Sozmsjackson,barthilas,1379,paladin,retribution,39,17,22
22700,Elsinore,senjin,1377,paladin,retribution,35,19,16
22701,Kaelthasar,azralon,1376,paladin,retribution,30,15,15
22702,Fabolouss,tichondrius,1375,paladin,retribution,78,43,35
22703,Delanadras,kelthuzad,1375,paladin,retribution,47,19,28
22704,Stdee,zuljin,1372,paladin,retribution,57,30,27
22705,Kalendawn,moon-guard,1370,paladin,retribution,55,33,22
22706,Bigdoosa,frostmourne,1370,paladin,retribution,34,18,16
22707,Superzooted,sargeras,1370,paladin,retribution,34,15,19
22708,Theretpally,kelthuzad,1370,paladin,retribution,48,21,27
22709,Dfbattlepass,kelthuzad,1369,paladin,retribution,67,36,31
22710,Sländers,sargeras,1369,paladin,retribution,65,29,36
22711,Minitas,blackrock,1369,paladin,retribution,42,15,27
22712,Kellissandra,aerie-peak,1368,paladin,retribution,84,34,50
22713,Pal,blackhand,1366,paladin,retribution,36,20,16
22714,Björñ,moon-guard,1366,paladin,retribution,33,16,17
22715,Scubàlicous,magtheridon,1366,paladin,retribution,42,19,23
22716,Wîckèd,tichondrius,1366,paladin,retribution,35,15,20
22717,Bebopin,tichondrius,1365,paladin,retribution,34,16,18
22718,Hurukpaly,azralon,1365,paladin,retribution,52,23,29
22719,Honeybunza,area-52,1365,paladin,retribution,34,15,19
22720,Áthz,ragnaros,1363,paladin,retribution,41,21,20
22721,Hùck,alexstrasza,1363,paladin,retribution,110,51,59
22722,Feelsögood,tichondrius,1363,paladin,retribution,33,15,18
22723,Alvick,icecrown,1363,paladin,retribution,39,16,23
22724,Akâme,kelthuzad,1361,paladin,retribution,22,15,7
22725,PlayerHRFWDC,garrosh,1361,paladin,retribution,48,27,21
22726,Carliitoz,quelthalas,1361,paladin,retribution,55,19,36
22727,Cyniaria,moon-guard,1360,paladin,retribution,90,44,46
22728,Sellenagomez,malganis,1359,paladin,retribution,48,21,27
22729,Salaminhoo,azralon,1358,paladin,retribution,24,16,8
22730,Clayban,stormrage,1358,paladin,retribution,36,20,16
22731,Xoxoxoxoxoxo,aegwynn,1357,paladin,retribution,48,23,25
22732,Tarnyb,illidan,1357,paladin,retribution,32,15,17
22733,Wickedwingz,sargeras,1356,paladin,retribution,30,15,15
22734,Hokkan,quelthalas,1353,paladin,retribution,47,24,23
22735,Andronik,bleeding-hollow,1352,paladin,retribution,33,16,17
22736,Keltec,bonechewer,1351,paladin,retribution,51,18,33
22737,Tlahtoani,illidan,1350,paladin,retribution,23,15,8
22738,Zantdemption,frostmourne,1349,paladin,retribution,29,15,14
22739,Øxøxø,emerald-dream,1347,paladin,retribution,78,41,37
22740,Hazmât,illidan,1347,paladin,retribution,81,32,49
22741,Dwurim,moon-guard,1346,paladin,retribution,48,26,22
22742,Ddeadwhisper,executus,1345,paladin,retribution,104,56,48
22743,Chinsta,zuljin,1344,paladin,retribution,24,16,8
22744,Retman,azuremyst,1344,paladin,retribution,42,17,25
22745,Sophany,shattered-halls,1343,paladin,retribution,34,21,13
22746,Bossmin,tichondrius,1343,paladin,retribution,24,14,10
22747,Forzanapoli,tichondrius,1343,paladin,retribution,30,14,16
22748,Kumdonia,illidan,1343,paladin,retribution,30,14,16
22749,Worder,tichondrius,1342,paladin,retribution,24,15,9
22750,Bigdogchief,stormrage,1342,paladin,retribution,24,14,10
22751,Draidan,area-52,1342,paladin,retribution,68,32,36
22752,Gabbynator,emerald-dream,1342,paladin,retribution,30,14,16
22753,Xygra,stormrage,1342,paladin,retribution,30,14,16
22754,Hefaista,ragnaros,1342,paladin,retribution,36,14,22
22755,Bluerunebar,illidan,1340,paladin,retribution,24,14,10
22756,Retsonictwo,tichondrius,1340,paladin,retribution,30,14,16
22757,Samphlty,azralon,1340,paladin,retribution,30,14,16
22758,Bubblestar,ragnaros,1340,paladin,retribution,56,23,33
22759,Xandia,aegwynn,1340,paladin,retribution,42,14,28
22760,Youguessedit,stormrage,1339,paladin,retribution,24,14,10
22761,Stöneblood,moon-guard,1339,paladin,retribution,36,14,22
22762,Bulioevn,emerald-dream,1338,paladin,retribution,39,18,21
22763,Healsonyou,windrunner,1338,paladin,retribution,36,14,22
22764,Amarnath,turalyon,1337,paladin,retribution,27,16,11
22765,Palajeans,stormrage,1337,paladin,retribution,24,14,10
22766,Erethonis,bladefist,1337,paladin,retribution,60,28,32
22767,Neró,quelthalas,1337,paladin,retribution,55,25,30
22768,Wlq,frostmourne,1336,paladin,retribution,71,29,42
22769,Shecara,malygos,1335,paladin,retribution,72,40,32
22770,Lyricism,tichondrius,1335,paladin,retribution,36,18,18
22771,Avantasias,sargeras,1335,paladin,retribution,82,39,43
22772,Waffletrain,tichondrius,1334,paladin,retribution,34,15,19
22773,Jaikerino,emerald-dream,1334,paladin,retribution,36,14,22
22774,Väkariän,quelthalas,1333,paladin,retribution,30,14,16
22775,Gixpal,skullcrusher,1332,paladin,retribution,36,19,17
22776,Malorian,azgalor,1332,paladin,retribution,48,21,27
22777,Forged,steamwheedle-cartel,1332,paladin,retribution,108,47,61
22778,Lüuz,area-52,1332,paladin,retribution,42,15,27
22779,Heraolympian,black-dragonflight,1331,paladin,retribution,24,15,9
22780,Trogdorpwn,bonechewer,1331,paladin,retribution,30,17,13
22781,Mobitz,dalvengyr,1331,paladin,retribution,48,25,23
22782,Allixis,wyrmrest-accord,1330,paladin,retribution,40,15,25
22783,Däkh,sargeras,1329,paladin,retribution,24,14,10
22784,Yree,ragnaros,1329,paladin,retribution,30,14,16
22785,Brightsaber,tichondrius,1328,paladin,retribution,63,34,29
22786,Adrockiller,quelthalas,1328,paladin,retribution,38,17,21
22787,Øðyn,sargeras,1327,paladin,retribution,30,14,16
22788,Snowcrow,tichondrius,1327,paladin,retribution,80,36,44
22789,Melize,area-52,1325,paladin,retribution,118,57,61
22790,Søøka,azralon,1325,paladin,retribution,48,16,32
22791,Akabanee,ragnaros,1324,paladin,retribution,24,14,10
22792,Athenariel,bleeding-hollow,1324,paladin,retribution,49,23,26
22793,Christman,illidan,1323,paladin,retribution,78,33,45
22794,Jizii,tichondrius,1322,paladin,retribution,24,14,10
22795,Thankyouswen,tichondrius,1321,paladin,retribution,48,22,26
22796,Rusinator,bonechewer,1320,paladin,retribution,24,14,10
22797,Dralkou,kaelthas,1320,paladin,retribution,56,20,36
22798,Sventyn,frostmourne,1320,paladin,retribution,41,14,27
22799,Bennu,sargeras,1319,paladin,retribution,45,17,28
22800,Lashlan,barthilas,1318,paladin,retribution,32,20,12
22801,Taîno,thrall,1318,paladin,retribution,68,35,33
22802,Arkanica,moon-guard,1318,paladin,retribution,41,16,25
22803,Wésters,quelthalas,1317,paladin,retribution,103,44,59
22804,Hwanko,tichondrius,1316,paladin,retribution,28,20,8
22805,Morneau,malganis,1315,paladin,retribution,210,101,109
22806,Critxx,tichondrius,1315,paladin,retribution,77,36,41
22807,Hapii,tichondrius,1315,paladin,retribution,47,18,29
22808,Bigpin,shattered-hand,1314,paladin,retribution,29,14,15
22809,Siberios,stormrage,1313,paladin,retribution,30,14,16
22810,Ludvigsen,hakkar,1313,paladin,retribution,36,14,22
22811,Autoattacker,mannoroth,1312,paladin,retribution,24,14,10
22812,Melloow,azralon,1311,paladin,retribution,91,43,48
22813,Trg,azralon,1310,paladin,retribution,24,14,10
22814,Shlaps,crushridge,1310,paladin,retribution,60,26,34
22815,Sote,lightnings-blade,1309,paladin,retribution,27,15,12
22816,Trainstorm,emerald-dream,1309,paladin,retribution,38,19,19
22817,Snowcrest,cenarius,1309,paladin,retribution,48,22,26
22818,Ajoladin,illidan,1308,paladin,retribution,51,22,29
22819,Retrah,azralon,1306,paladin,retribution,24,14,10
22820,Levarious,thunderlord,1305,paladin,retribution,78,36,42
22821,Happywow,tichondrius,1302,paladin,retribution,59,30,29
22822,Atrayeus,dawnbringer,1300,paladin,retribution,48,21,27
22823,Saucepally,laughing-skull,1299,paladin,retribution,55,30,25
22824,Oneminute,nerzhul,1299,paladin,retribution,42,21,21
22825,Giulio,moon-guard,1298,paladin,retribution,59,30,29
22826,Vtyr,nemesis,1297,paladin,retribution,51,23,28
22827,Krinkin,illidan,1297,paladin,retribution,42,14,28
22828,Verguetas,ragnaros,1296,paladin,retribution,40,17,23
22829,Sunwrath,quelthalas,1296,paladin,retribution,72,29,43
22830,Herrit,frostmourne,1295,paladin,retribution,120,65,55
22831,Serran,durotan,1294,paladin,retribution,42,15,27
22832,Jugheadqc,mugthol,1293,paladin,retribution,57,28,29
22833,Paladingirl,darkspear,1292,paladin,retribution,92,50,42
22834,Refulgent,moon-guard,1291,paladin,retribution,41,25,16
22835,Walleis,moon-guard,1290,paladin,retribution,58,22,36
22836,Vêndar,ragnaros,1289,paladin,retribution,78,33,45
22837,Lawbandit,tichondrius,1287,paladin,retribution,28,16,12
22838,Tutankhammer,stormrage,1286,paladin,retribution,58,28,30
22839,Dedsxy,tichondrius,1286,paladin,retribution,30,14,16
22840,Broxon,tichondrius,1285,paladin,retribution,58,30,28
22841,Gainen,illidan,1285,paladin,retribution,47,24,23
22842,Paliodin,dalaran,1284,paladin,retribution,36,15,21
22843,Silvabac,illidan,1283,paladin,retribution,23,14,9
22844,Ôdenswrath,stormscale,1283,paladin,retribution,92,44,48
22845,Arnblass,magtheridon,1283,paladin,retribution,57,24,33
22846,Nadrela,burning-blade,1281,paladin,retribution,42,25,17
22847,Garcinddra,vashj,1281,paladin,retribution,28,15,13
22848,Fossilz,sargeras,1279,paladin,retribution,29,14,15
22849,Navicc,zuljin,1279,paladin,retribution,29,14,15
22850,Kiergann,quelthalas,1277,paladin,retribution,54,23,31
22851,Mikehawkhuge,area-52,1276,paladin,retribution,42,22,20
22852,Yuccalicious,area-52,1275,paladin,retribution,53,23,30
22853,Carolena,thaurissan,1274,paladin,retribution,74,31,43
22854,Perfectgirl,maiev,1273,paladin,retribution,71,34,37
22855,Throwable,illidan,1273,paladin,retribution,64,26,38
22856,Webothhateme,tichondrius,1272,paladin,retribution,30,17,13
22857,Khorgus,gundrak,1271,paladin,retribution,54,27,27
22858,Såssy,moon-guard,1270,paladin,retribution,66,28,38
22859,Synthetic,moon-guard,1268,paladin,retribution,78,40,38
22860,Giltronix,thrall,1266,paladin,retribution,54,27,27
22861,Imhardirl,area-52,1265,paladin,retribution,23,14,9
22862,Formergf,crushridge,1265,paladin,retribution,60,29,31
22863,Äeriah,fizzcrank,1265,paladin,retribution,36,16,20
22864,Ðetroity,stormrage,1263,paladin,retribution,41,22,19
22865,Tonnerre,silvermoon,1263,paladin,retribution,61,29,32
22866,Gwendolyynn,moon-guard,1262,paladin,retribution,28,20,8
22867,Bayaz,emerald-dream,1262,paladin,retribution,48,26,22
22868,Galaxahan,bonechewer,1262,paladin,retribution,64,30,34
22869,Punative,darkspear,1262,paladin,retribution,48,16,32
22870,Garruckadin,dalaran,1261,paladin,retribution,25,14,11
22871,Sïrenek,tichondrius,1260,paladin,retribution,55,27,28
22872,Canadianeh,malganis,1260,paladin,retribution,66,28,38
22873,Faaqmee,gorefiend,1259,paladin,retribution,24,15,9
22874,Todesgott,tichondrius,1259,paladin,retribution,30,15,15
22875,Fogonaventa,nemesis,1259,paladin,retribution,48,16,32
22876,Toyotasupra,azgalor,1258,paladin,retribution,42,24,18
22877,Dárí,stormrage,1258,paladin,retribution,108,51,57
22878,Holyshôckz,stormrage,1258,paladin,retribution,35,16,19
22879,Belena,jaedenar,1258,paladin,retribution,36,16,20
22880,Quickthing,dalaran,1257,paladin,retribution,59,34,25
22881,Minlarkwa,frostmourne,1257,paladin,retribution,30,16,14
22882,Ozirus,frostmourne,1256,paladin,retribution,32,14,18
22883,Soana,alexstrasza,1255,paladin,retribution,78,48,30
22884,Aretwin,dalaran,1255,paladin,retribution,30,14,16
22885,Balster,moon-guard,1254,paladin,retribution,43,18,25
22886,Palacamâ,quelthalas,1252,paladin,retribution,32,14,18
22887,Zanthus,shadow-council,1248,paladin,retribution,24,13,11
22888,Venturep,azralon,1247,paladin,retribution,24,13,11
22889,Hojdin,tichondrius,1247,paladin,retribution,30,13,17
22890,Dubliner,garona,1247,paladin,retribution,30,13,17
22891,Davinchi,laughing-skull,1246,paladin,retribution,41,24,17
22892,Lainn,zuljin,1246,paladin,retribution,30,17,13
22893,Steelbreaker,deathwing,1246,paladin,retribution,47,21,26
22894,Beyönd,quelthalas,1246,paladin,retribution,30,13,17
22895,Zephyrvalor,sargeras,1245,paladin,retribution,54,32,22
22896,Paladinaa,lothar,1245,paladin,retribution,30,13,17
22897,Pérona,tichondrius,1245,paladin,retribution,30,13,17
22898,Onemassacre,spirestone,1245,paladin,retribution,36,13,23
22899,Lvlone,sargeras,1244,paladin,retribution,24,15,9
22900,Hammerina,antonidas,1244,paladin,retribution,35,16,19
22901,Aduhrawl,moon-guard,1244,paladin,retribution,38,14,24
22902,Goons,frostmourne,1244,paladin,retribution,36,13,23
22903,Yugee,doomhammer,1243,paladin,retribution,24,13,11
22904,Doktavius,lightbringer,1243,paladin,retribution,24,13,11
22905,Gànnicus,korgath,1243,paladin,retribution,30,13,17
22906,Cuteluna,tichondrius,1243,paladin,retribution,30,13,17
22907,Deployed,kaelthas,1243,paladin,retribution,36,13,23
22908,Tedward,emerald-dream,1242,paladin,retribution,24,13,11
22909,Rockbell,kiljaeden,1242,paladin,retribution,24,13,11
22910,Gareesa,wyrmrest-accord,1242,paladin,retribution,24,13,11
22911,Bebitufiufiu,illidan,1242,paladin,retribution,24,13,11
22912,Anastos,anvilmar,1241,paladin,retribution,24,13,11
22913,Aurken,ragnaros,1241,paladin,retribution,30,13,17
22914,Holychow,tichondrius,1240,paladin,retribution,24,13,11
22915,Saintpower,stormscale,1239,paladin,retribution,24,13,11
22916,Saphiraz,wildhammer,1239,paladin,retribution,30,13,17
22917,Bawek,azralon,1239,paladin,retribution,36,13,23
22918,Ziberax,chogall,1238,paladin,retribution,22,13,9
22919,Sacredstella,illidan,1238,paladin,retribution,24,13,11
22920,Deftonia,stormrage,1238,paladin,retribution,65,31,34
22921,Rigotakp,illidan,1237,paladin,retribution,30,13,17
22922,Siaaryn,darkspear,1237,paladin,retribution,30,13,17
22923,Pristinne,darkspear,1237,paladin,retribution,82,34,48
22924,Sconey,andorhal,1237,paladin,retribution,34,14,20
22925,Ablunedion,illidan,1237,paladin,retribution,41,14,27
22926,Carenye,thunderhorn,1235,paladin,retribution,37,16,21
22927,Hammerzite,whisperwind,1234,paladin,retribution,24,13,11
22928,Noblelight,saurfang,1233,paladin,retribution,29,17,12
22929,Huitz,drakkari,1231,paladin,retribution,48,23,25
22930,Krawmwell,lothar,1230,paladin,retribution,78,43,35
22931,Uunjaaku,kiljaeden,1230,paladin,retribution,45,22,23
22932,Luke,frostwolf,1230,paladin,retribution,29,13,16
22933,Legible,tichondrius,1228,paladin,retribution,28,15,13
22934,Narsys,tichondrius,1228,paladin,retribution,36,13,23
22935,Heindallr,nemesis,1227,paladin,retribution,42,19,23
22936,Thorsenâ,sargeras,1226,paladin,retribution,27,17,10
22937,Thadose,bonechewer,1226,paladin,retribution,52,31,21
22938,Hiikari,silver-hand,1225,paladin,retribution,30,14,16
22939,Dankpaladin,frostwolf,1224,paladin,retribution,30,13,17
22940,Amarith,queldorei,1224,paladin,retribution,76,31,45
22941,Vanthor,emerald-dream,1223,paladin,retribution,24,13,11
22942,Ulessys,bleeding-hollow,1223,paladin,retribution,54,27,27
22943,Ekyu,sargeras,1222,paladin,retribution,25,15,10
22944,Albion,sargeras,1222,paladin,retribution,36,13,23
22945,Füriøsa,quelthalas,1221,paladin,retribution,59,29,30
22946,Areaky,khazgoroth,1220,paladin,retribution,38,22,16
22947,Gorriuke,wyrmrest-accord,1220,paladin,retribution,24,13,11
22948,Demihoj,illidan,1220,paladin,retribution,36,13,23
22949,Theuss,nerzhul,1219,paladin,retribution,47,17,30
22950,Naghret,area-52,1218,paladin,retribution,24,13,11
22951,Beastyone,tichondrius,1218,paladin,retribution,110,58,52
22952,Uglymugz,area-52,1218,paladin,retribution,37,16,21
22953,Gramaton,malfurion,1217,paladin,retribution,36,15,21
22954,Redeviliu,tichondrius,1217,paladin,retribution,41,15,26
22955,Brucedwal,moon-guard,1216,paladin,retribution,45,22,23
22956,Aellâ,bloodscalp,1214,paladin,retribution,134,70,64
22957,Mïkhael,nemesis,1214,paladin,retribution,74,26,48
22958,Brsjak,frostmourne,1212,paladin,retribution,41,18,23
22959,Pallynation,korgath,1211,paladin,retribution,30,13,17
22960,Armstrongz,bleeding-hollow,1210,paladin,retribution,36,13,23
22961,Hodne,blackhand,1208,paladin,retribution,24,13,11
22962,Barbaluzz,quelthalas,1207,paladin,retribution,31,16,15
22963,Xenagos,akama,1207,paladin,retribution,30,13,17
22964,Longinus,eredar,1206,paladin,retribution,24,13,11
22965,Amgirlinv,malganis,1206,paladin,retribution,26,14,12
22966,Lostkanvas,azralon,1205,paladin,retribution,24,14,10
22967,Rediems,drakkari,1203,paladin,retribution,42,21,21
22968,Hellhawk,hellscream,1202,paladin,retribution,24,13,11
22969,Mechelle,thrall,1202,paladin,retribution,74,37,37
22970,Hibrael,azralon,1201,paladin,retribution,56,32,24
22971,Stõnêdpimp,agamaggan,1201,paladin,retribution,29,13,16
22972,Dewlight,zuljin,1200,paladin,retribution,36,22,14
22973,Sturka,illidan,1199,paladin,retribution,60,29,31
22974,Cexus,tichondrius,1198,paladin,retribution,23,13,10
22975,Oathden,area-52,1198,paladin,retribution,34,18,16
22976,Finishearlyx,kelthuzad,1198,paladin,retribution,35,13,22
22977,Lucigiorna,stormrage,1197,paladin,retribution,50,22,28
22978,Haiyaa,frostwolf,1197,paladin,retribution,48,18,30
22979,Botïs,sargeras,1195,paladin,retribution,33,20,13
22980,Canadapants,kelthuzad,1194,paladin,retribution,24,14,10
22981,Irantir,drakkari,1194,paladin,retribution,47,18,29
22982,Kittylickers,tichondrius,1193,paladin,retribution,96,54,42
22983,Eetswaz,frostmourne,1193,paladin,retribution,36,20,16
22984,Shusekki,drakkari,1192,paladin,retribution,96,46,50
22985,Albagail,draka,1192,paladin,retribution,28,13,15
22986,Spartus,area-52,1191,paladin,retribution,26,15,11
22987,Avelane,caelestrasz,1191,paladin,retribution,52,24,28
22988,Dynamais,barthilas,1190,paladin,retribution,42,15,27
22989,Xalixxa,wyrmrest-accord,1189,paladin,retribution,36,14,22
22990,Popwingzz,sargeras,1188,paladin,retribution,42,14,28
22991,Pìerre,ragnaros,1186,paladin,retribution,116,59,57
22992,Reptaur,bleeding-hollow,1185,paladin,retribution,64,31,33
22993,Excalibur,amanthul,1185,paladin,retribution,31,14,17
22994,Holycower,tichondrius,1182,paladin,retribution,24,15,9
22995,Sweatylight,bleeding-hollow,1181,paladin,retribution,56,25,31
22996,Páláx,stormrage,1181,paladin,retribution,51,22,29
22997,Paim,tol-barad,1179,paladin,retribution,32,13,19
22998,Noskill,moonrunner,1176,paladin,retribution,48,29,19
22999,Mareaaturbo,azralon,1174,paladin,retribution,23,13,10
23000,Bubbleöseven,agamaggan,1173,paladin,retribution,39,18,21
23001,Greasy,quelthalas,1173,paladin,retribution,32,13,19
23002,Schnabdain,exodar,1171,paladin,retribution,66,36,30
23003,Crosshammer,quelthalas,1170,paladin,retribution,42,20,22
23004,Linias,quelthalas,1169,paladin,retribution,21,14,7
23005,Souljahgirl,demon-soul,1168,paladin,retribution,42,18,24
23006,Suncrashkid,nerzhul,1166,paladin,retribution,127,70,57
23007,Soopadupa,trollbane,1164,paladin,retribution,68,36,32
23008,Skylexx,ragnaros,1164,paladin,retribution,30,13,17
23009,Solomonss,frostmourne,1163,paladin,retribution,58,21,37
23010,Ktwocrank,dalaran,1162,paladin,retribution,31,13,18
23011,Thaly,shadowmoon,1161,paladin,retribution,49,20,29
23012,Draerys,drakkari,1159,paladin,retribution,36,26,10
23013,Procs,hyjal,1157,paladin,retribution,20,15,5
23014,Meanlight,zuljin,1156,paladin,retribution,60,30,30
23015,Statícx,ragnaros,1156,paladin,retribution,85,35,50
23016,Kaysonso,thunderlord,1153,paladin,retribution,43,15,28
23017,Hammrekt,dalaran,1152,paladin,retribution,18,12,6
23018,Huavi,tichondrius,1152,paladin,retribution,18,12,6
23019,Ghøjan,malganis,1152,paladin,retribution,23,15,8
23020,Scathol,tichondrius,1152,paladin,retribution,24,12,12
23021,Vânguârds,tichondrius,1152,paladin,retribution,24,12,12
23022,Cöjax,dalaran,1151,paladin,retribution,18,12,6
23023,Zhaslk,ragnaros,1151,paladin,retribution,24,12,12
23024,ßrittany,gnomeregan,1151,paladin,retribution,24,12,12
23025,Iloveqiqi,sargeras,1151,paladin,retribution,24,12,12
23026,Sacredknight,kelthuzad,1151,paladin,retribution,24,12,12
23027,Lhacius,drakkari,1151,paladin,retribution,28,13,15
23028,Sukmyret,sargeras,1151,paladin,retribution,30,12,18
23029,Geospawn,tichondrius,1151,paladin,retribution,30,12,18
23030,Dragynfist,malganis,1151,paladin,retribution,30,12,18
23031,Britanybich,area-52,1150,paladin,retribution,24,12,12
23032,Nattandin,ragnaros,1150,paladin,retribution,24,12,12
23033,Hurrîcane,illidan,1150,paladin,retribution,30,12,18
23034,Thazadin,barthilas,1149,paladin,retribution,22,13,9
23035,Blackpie,bleeding-hollow,1149,paladin,retribution,24,12,12
23036,Yeeter,thrall,1149,paladin,retribution,24,12,12
23037,Vaaga,quelthalas,1149,paladin,retribution,24,12,12
23038,Tanishalfelf,stormrage,1149,paladin,retribution,24,12,12
23039,Zcho,proudmoore,1149,paladin,retribution,24,12,12
23040,Retosterone,stormrage,1149,paladin,retribution,30,12,18
23041,Kadryck,drakkari,1148,paladin,retribution,18,12,6
23042,Leennoox,quelthalas,1148,paladin,retribution,31,17,14
23043,Cuchuflaiz,drakkari,1148,paladin,retribution,24,12,12
23044,Sigmond,azralon,1148,paladin,retribution,27,13,14
23045,Dontaylor,tichondrius,1148,paladin,retribution,30,12,18
23046,Bigdpally,frostmourne,1148,paladin,retribution,36,12,24
23047,Eskannór,quelthalas,1147,paladin,retribution,24,12,12
23048,Arkoth,kelthuzad,1147,paladin,retribution,24,12,12
23049,Blasstar,quelthalas,1147,paladin,retribution,24,12,12
23050,Phanna,the-forgotten-coast,1147,paladin,retribution,24,12,12
23051,Snoogans,korgath,1147,paladin,retribution,30,12,18
23052,Dachenkov,tichondrius,1146,paladin,retribution,18,12,6
23053,Barcar,area-52,1146,paladin,retribution,24,12,12
23054,Røshea,hydraxis,1146,paladin,retribution,24,12,12
23055,Véxv,emerald-dream,1146,paladin,retribution,36,12,24
23056,Luminainre,zuljin,1145,paladin,retribution,24,12,12
23057,Deosfires,ragnaros,1145,paladin,retribution,28,13,15
23058,Xdiegox,stormrage,1145,paladin,retribution,30,12,18
23059,Rafaela,alterac-mountains,1144,paladin,retribution,18,12,6
23060,Lightshope,coilfang,1143,paladin,retribution,18,12,6
23061,Thoti,tichondrius,1143,paladin,retribution,25,12,13
23062,Scudstock,tichondrius,1143,paladin,retribution,71,34,37
23063,Polypal,zuljin,1143,paladin,retribution,30,12,18
23064,Seongje,tichondrius,1143,paladin,retribution,39,13,26
23065,Stormwinter,azralon,1143,paladin,retribution,36,12,24
23066,Ginbirdup,kelthuzad,1141,paladin,retribution,18,12,6
23067,Dwk,thrall,1141,paladin,retribution,30,12,18
23068,Holyskeeter,thunderhorn,1141,paladin,retribution,31,12,19
23069,Beachyo,tichondrius,1140,paladin,retribution,18,12,6
23070,Elbigboy,tichondrius,1140,paladin,retribution,83,42,41
23071,Victidin,quelthalas,1138,paladin,retribution,24,12,12
23072,Oopalaoo,azralon,1137,paladin,retribution,24,12,12
23073,Areura,hellscream,1134,paladin,retribution,21,13,8
23074,Pallyhealed,tichondrius,1134,paladin,retribution,27,12,15
23075,Huuzhaa,tichondrius,1134,paladin,retribution,29,12,17
23076,Dresdén,skullcrusher,1133,paladin,retribution,18,12,6
23077,Meltedcheese,destromath,1132,paladin,retribution,30,15,15
23078,Miitt,blackrock,1132,paladin,retribution,24,12,12
23079,Ðß,arthas,1132,paladin,retribution,30,13,17
23080,Tatánka,ragnaros,1130,paladin,retribution,24,12,12
23081,Jdn,ysera,1130,paladin,retribution,60,29,31
23082,Iceburg,shadowmoon,1128,paladin,retribution,24,12,12
23083,Arun,arthas,1128,paladin,retribution,33,15,18
23084,Pallypapa,galakrond,1127,paladin,retribution,18,12,6
23085,Chbestafera,nemesis,1127,paladin,retribution,18,12,6
23086,Ducii,stormrage,1126,paladin,retribution,46,22,24
23087,Damorte,ragnaros,1125,paladin,retribution,30,15,15
23088,Dirkadirkka,stormrage,1125,paladin,retribution,24,12,12
23089,Sparkchaser,proudmoore,1125,paladin,retribution,24,12,12
23090,Newerlight,tichondrius,1124,paladin,retribution,25,13,12
23091,Grimhammer,the-scryers,1123,paladin,retribution,50,27,23
23092,Dannoruk,ragnaros,1121,paladin,retribution,30,12,18
23093,Aowynd,tichondrius,1118,paladin,retribution,73,37,36
23094,Zaklehblue,daggerspine,1118,paladin,retribution,60,24,36
23095,Shadowarius,aerie-peak,1117,paladin,retribution,54,24,30
23096,Deathwyz,thunderlord,1116,paladin,retribution,36,14,22
23097,Streetsaint,frostmourne,1114,paladin,retribution,66,32,34
23098,Thal,silvermoon,1113,paladin,retribution,24,13,11
23099,Vanillur,tichondrius,1113,paladin,retribution,49,22,27
23100,Sandicang,azuremyst,1112,paladin,retribution,54,27,27
23101,Eddardstark,agamaggan,1111,paladin,retribution,34,15,19
23102,Drágons,stormrage,1109,paladin,retribution,72,30,42
23103,Holyshoc,kiljaeden,1109,paladin,retribution,38,15,23
23104,Drekgor,drakkari,1108,paladin,retribution,30,14,16
23105,Greatgirthy,hyjal,1106,paladin,retribution,30,13,17
23106,Thanatiel,area-52,1104,paladin,retribution,66,37,29
23107,Savagefck,sargeras,1103,paladin,retribution,24,15,9
23108,Fortueni,illidan,1103,paladin,retribution,88,51,37
23109,Oraborra,area-52,1103,paladin,retribution,30,12,18
23110,Gtate,azjolnerub,1102,paladin,retribution,23,12,11
23111,Decareos,tichondrius,1102,paladin,retribution,29,12,17
23112,Virrata,tichondrius,1098,paladin,retribution,20,13,7
23113,Trappadin,sargeras,1098,paladin,retribution,30,14,16
23114,Riggar,uther,1098,paladin,retribution,42,18,24
23115,Velyssatha,moon-guard,1094,paladin,retribution,23,12,11
23116,Joelanson,blood-furnace,1092,paladin,retribution,30,16,14
23117,Traditionalp,area-52,1092,paladin,retribution,25,13,12
23118,Omenix,laughing-skull,1091,paladin,retribution,29,12,17
23119,Durothar,dalaran,1090,paladin,retribution,30,16,14
23120,Cheesetitan,tichondrius,1090,paladin,retribution,52,22,30
23121,Mcbraín,quelthalas,1089,paladin,retribution,30,12,18
23122,Alairius,tichondrius,1087,paladin,retribution,23,15,8
23123,Killumminati,tichondrius,1087,paladin,retribution,21,13,8
23124,Soyafed,mugthol,1086,paladin,retribution,24,13,11
23125,Mybadfoo,lethon,1085,paladin,retribution,18,13,5
23126,Jinfandi,gurubashi,1079,paladin,retribution,30,12,18
23127,Bubblegums,nagrand,1078,paladin,retribution,63,36,27
23128,Uhklathel,quelthalas,1078,paladin,retribution,39,15,24
23129,Eliasor,illidan,1077,paladin,retribution,18,13,5
23130,Lízandor,ragnaros,1077,paladin,retribution,17,12,5
23131,Zir,frostmourne,1077,paladin,retribution,47,24,23
23132,Warswordz,stormrage,1077,paladin,retribution,40,16,24
23133,Clefairy,arathor,1076,paladin,retribution,39,23,16
23134,Zorkus,turalyon,1073,paladin,retribution,42,22,20
23135,Vlandor,area-52,1067,paladin,retribution,23,12,11
23136,Adelsman,quelthalas,1065,paladin,retribution,24,12,12
23137,Diablosgrim,stormrage,1061,paladin,retribution,18,14,4
23138,Billnighy,alleria,1061,paladin,retribution,42,18,24
23139,Holygerp,darrowmere,1060,paladin,retribution,18,12,6
23140,Andras,emerald-dream,1059,paladin,retribution,22,12,10
23141,Chilenoman,ragnaros,1057,paladin,retribution,30,14,16
23142,Rikkupìgu,sargeras,1056,paladin,retribution,18,11,7
23143,Ashenhallow,alexstrasza,1056,paladin,retribution,18,11,7
23144,Hardnow,emerald-dream,1056,paladin,retribution,24,11,13
23145,Makayla,kiljaeden,1056,paladin,retribution,24,11,13
23146,Thørîm,nazjatar,1056,paladin,retribution,30,12,18
23147,Siq,arthas,1056,paladin,retribution,30,11,19
23148,Bakednub,malganis,1056,paladin,retribution,35,11,24
23149,Redarted,thrall,1055,paladin,retribution,18,11,7
23150,Volcathos,moon-guard,1055,paladin,retribution,18,11,7
23151,Reptila,bonechewer,1055,paladin,retribution,18,11,7
23152,Subtilizer,tichondrius,1055,paladin,retribution,18,11,7
23153,Pathalerix,eonar,1055,paladin,retribution,18,11,7
23154,Ricocheto,ragnaros,1055,paladin,retribution,18,11,7
23155,Pallysmack,stormrage,1055,paladin,retribution,24,11,13
23156,Wde,zuljin,1055,paladin,retribution,31,12,19
23157,Redspine,azralon,1055,paladin,retribution,30,11,19
23158,Nightz,eonar,1055,paladin,retribution,30,11,19
23159,Gannecus,bleeding-hollow,1054,paladin,retribution,18,11,7
23160,Rexx,frostmourne,1054,paladin,retribution,18,11,7
23161,Hrota,laughing-skull,1054,paladin,retribution,18,11,7
23162,Keenos,frostmourne,1054,paladin,retribution,19,11,8
23163,Pallyzo,zuljin,1054,paladin,retribution,24,11,13
23164,Telvannî,sargeras,1054,paladin,retribution,24,11,13
23165,Mattilla,tichondrius,1054,paladin,retribution,24,11,13
23166,Zazaron,kiljaeden,1054,paladin,retribution,30,11,19
23167,Varaben,sargeras,1054,paladin,retribution,36,11,25
23168,Nest,stormrage,1053,paladin,retribution,18,11,7
23169,Ðreschí,ragnaros,1053,paladin,retribution,22,11,11
23170,Sancthia,area-52,1053,paladin,retribution,24,11,13
23171,Mundomaloo,quelthalas,1053,paladin,retribution,24,11,13
23172,Divineknight,moonrunner,1053,paladin,retribution,24,11,13
23173,Dividin,stormrage,1053,paladin,retribution,24,11,13
23174,Mixnut,tichondrius,1053,paladin,retribution,30,11,19
23175,Cripplemakër,stormrage,1052,paladin,retribution,18,11,7
23176,Vynesonia,emerald-dream,1052,paladin,retribution,21,12,9
23177,Brolando,hyjal,1052,paladin,retribution,24,11,13
23178,Xinqingle,tichondrius,1052,paladin,retribution,30,11,19
23179,Iesous,kiljaeden,1051,paladin,retribution,18,11,7
23180,Ragnore,shadow-council,1051,paladin,retribution,21,12,9
23181,Exulta,illidan,1051,paladin,retribution,60,32,28
23182,Libertylol,tichondrius,1051,paladin,retribution,28,12,16
23183,Caonizumu,area-52,1051,paladin,retribution,30,11,19
23184,Ranthoril,hydraxis,1050,paladin,retribution,12,11,1
23185,Kaélthas,eonar,1050,paladin,retribution,24,11,13
23186,Cowhair,tichondrius,1050,paladin,retribution,24,11,13
23187,Ødin,turalyon,1049,paladin,retribution,18,11,7
23188,Reaslovak,jubeithos,1049,paladin,retribution,18,11,7
23189,Wickedpälly,kelthuzad,1049,paladin,retribution,18,11,7
23190,Wasimodo,emerald-dream,1049,paladin,retribution,60,29,31
23191,Mangguo,tichondrius,1049,paladin,retribution,24,11,13
23192,Lïgma,dalaran,1048,paladin,retribution,18,11,7
23193,Unknownplay,tichondrius,1048,paladin,retribution,18,11,7
23194,Schalpy,illidan,1048,paladin,retribution,24,11,13
23195,Jagehbombs,tichondrius,1047,paladin,retribution,24,11,13
23196,Stonekey,warsong,1046,paladin,retribution,18,11,7
23197,Kiboko,tichondrius,1046,paladin,retribution,19,11,8
23198,Theldart,ragnaros,1046,paladin,retribution,24,11,13
23199,Souiler,thunderlord,1045,paladin,retribution,22,12,10
23200,Denhoward,proudmoore,1045,paladin,retribution,24,11,13
23201,Guji,jubeithos,1045,paladin,retribution,24,11,13
23202,Strobeyjr,tichondrius,1044,paladin,retribution,24,11,13
23203,Rensvall,frostmourne,1043,paladin,retribution,24,13,11
23204,Pldd,tichondrius,1043,paladin,retribution,25,12,13
23205,Hyperforce,area-52,1043,paladin,retribution,24,11,13
23206,Missoutale,aerie-peak,1043,paladin,retribution,76,31,45
23207,Dorzwaz,draka,1042,paladin,retribution,18,11,7
23208,Berthalas,stormrage,1042,paladin,retribution,18,11,7
23209,Cuthroat,area-52,1042,paladin,retribution,204,104,100
23210,Menaus,duskwood,1040,paladin,retribution,18,11,7
23211,Neutroo,stormrage,1039,paladin,retribution,24,11,13
23212,Mikezheng,tichondrius,1039,paladin,retribution,30,11,19
23213,Willhookah,azralon,1034,paladin,retribution,54,25,29
23214,Bainn,nerzhul,1033,paladin,retribution,49,28,21
23215,Mortika,frostmourne,1033,paladin,retribution,30,14,16
23216,Atreuss,moon-guard,1029,paladin,retribution,42,21,21
23217,Asunima,wyrmrest-accord,1029,paladin,retribution,24,11,13
23218,Bradoxx,thorium-brotherhood,1026,paladin,retribution,42,21,21
23219,Soledad,tichondrius,1024,paladin,retribution,24,11,13
23220,Theseuus,stormrage,1020,paladin,retribution,54,24,30
23221,Furnost,drenden,1019,paladin,retribution,23,11,12
23222,Stepurgameup,ghostlands,1018,paladin,retribution,18,11,7
23223,Thorviim,azralon,1016,paladin,retribution,32,14,18
23224,Volorick,dalaran,1016,paladin,retribution,38,13,25
23225,Bigjwpb,illidan,1014,paladin,retribution,190,93,97
23226,Jeinova,barthilas,1013,paladin,retribution,48,29,19
23227,Thirtyfivemm,area-52,1013,paladin,retribution,52,27,25
23228,Sisterbubble,dathremar,1013,paladin,retribution,29,11,18
23229,Avlystein,wyrmrest-accord,1013,paladin,retribution,71,24,47
23230,Alpine,nordrassil,1009,paladin,retribution,85,44,41
23231,Nejie,nazjatar,1009,paladin,retribution,42,21,21
23232,Kènjii,sargeras,1009,paladin,retribution,34,16,18
23233,Tuff,ysera,1008,paladin,retribution,36,21,15
23234,Sanctum,barthilas,1008,paladin,retribution,135,65,70
23235,Keu,emerald-dream,1008,paladin,retribution,63,26,37
23236,Salvations,queldorei,1001,paladin,retribution,48,21,27
23237,Smithulu,kelthuzad,997,paladin,retribution,45,24,21
23238,Tyrswrath,sargeras,992,paladin,retribution,36,19,17
23239,Iammj,skywall,990,paladin,retribution,17,11,6
23240,Shishoknight,quelthalas,989,paladin,retribution,26,11,15
23241,Guanglong,malganis,989,paladin,retribution,26,11,15
23242,Veroth,caelestrasz,988,paladin,retribution,26,11,15
23243,Lêe,dalaran,987,paladin,retribution,15,12,3
23244,Tharkeves,cenarius,987,paladin,retribution,22,11,11
23245,Playandrunn,illidan,984,paladin,retribution,22,11,11
23246,Layoya,aerie-peak,984,paladin,retribution,22,11,11
23247,Vinjonc,drenden,977,paladin,retribution,54,27,27
23248,Johnyfresh,jubeithos,977,paladin,retribution,33,12,21
23249,Mikkylol,tichondrius,974,paladin,retribution,22,11,11
23250,Loween,thunderlord,973,paladin,retribution,42,15,27
23251,Hammerhitter,lightbringer,972,paladin,retribution,36,14,22
23252,Anyatay,ragnaros,971,paladin,retribution,59,16,43
23253,Reti,ursin,967,paladin,retribution,155,80,75
23254,Follower,sargeras,967,paladin,retribution,71,31,40
23255,Kmackk,tichondrius,960,paladin,retribution,18,10,8
23256,Dreneisha,malganis,960,paladin,retribution,18,10,8
23257,Holyshockss,stormrage,960,paladin,retribution,18,10,8
23258,Meleegodx,darkspear,960,paladin,retribution,18,10,8
23259,Eloinflated,malganis,960,paladin,retribution,18,10,8
23260,Hasmere,tichondrius,960,paladin,retribution,18,10,8
23261,Ienhova,area-52,960,paladin,retribution,18,10,8
23262,Fumaçaa,nemesis,960,paladin,retribution,27,13,14
23263,Friendfriend,proudmoore,960,paladin,retribution,24,10,14
23264,Miketavius,moon-guard,960,paladin,retribution,24,10,14
23265,Komonai,illidan,960,paladin,retribution,24,10,14
23266,Talionz,illidan,960,paladin,retribution,24,10,14
23267,Kikazaru,moon-guard,960,paladin,retribution,30,10,20
23268,Demonissh,area-52,960,paladin,retribution,30,10,20
23269,Bizaro,malganis,960,paladin,retribution,30,10,20
23270,Dogf,tichondrius,960,paladin,retribution,35,10,25
23271,Cryof,illidan,960,paladin,retribution,36,10,26
23272,Kasoon,illidan,959,paladin,retribution,12,10,2
23273,Jaimi,stormreaver,959,paladin,retribution,12,10,2
23274,Atair,antonidas,959,paladin,retribution,12,10,2
23275,Darguen,ragnaros,959,paladin,retribution,16,11,5
23276,Daeyang,tichondrius,959,paladin,retribution,18,10,8
23277,Shawra,moon-guard,959,paladin,retribution,18,10,8
23278,Mesaa,illidan,959,paladin,retribution,18,10,8
23279,ßöbby,sargeras,959,paladin,retribution,18,10,8
23280,Kayaman,tichondrius,959,paladin,retribution,18,10,8
23281,Déathkiing,area-52,959,paladin,retribution,24,10,14
23282,Ponytail,dark-iron,959,paladin,retribution,24,10,14
23283,Hôtt,kul-tiras,959,paladin,retribution,24,10,14
23284,Roddaric,nerzhul,959,paladin,retribution,24,10,14
23285,Lestaroth,goldrinn,959,paladin,retribution,30,10,20
23286,Zensargge,tichondrius,959,paladin,retribution,36,10,26
23287,Runö,frostmourne,959,paladin,retribution,37,10,27
23288,Littlebadbad,tichondrius,958,paladin,retribution,12,10,2
23289,Sathras,madoran,958,paladin,retribution,18,10,8
23290,Lichkingdenn,stormrage,958,paladin,retribution,18,10,8
23291,Ssparkk,stormrage,958,paladin,retribution,24,10,14
23292,Umbrasanctus,daggerspine,958,paladin,retribution,24,10,14
23293,Verdicts,moon-guard,958,paladin,retribution,30,10,20
23294,Zoliz,tichondrius,958,paladin,retribution,30,10,20
23295,Balango,azralon,957,paladin,retribution,18,10,8
23296,Olsen,stormrage,957,paladin,retribution,18,10,8
23297,Hurtmypp,stormrage,957,paladin,retribution,18,10,8
23298,Grünt,ragnaros,957,paladin,retribution,18,10,8
23299,Vallahad,emerald-dream,957,paladin,retribution,18,10,8
23300,Luxord,ysera,957,paladin,retribution,22,11,11
23301,Angriel,azralon,957,paladin,retribution,24,10,14
23302,Dyskrazia,thrall,957,paladin,retribution,24,10,14
23303,Vulkaros,azralon,956,paladin,retribution,12,10,2
23304,Caylorn,illidan,956,paladin,retribution,18,10,8
23305,Vejita,frostmourne,955,paladin,retribution,18,10,8
23306,Heälmeñow,tichondrius,955,paladin,retribution,24,10,14
23307,Winbott,sargeras,955,paladin,retribution,30,10,20
23308,Lunchboxpaly,stormrage,954,paladin,retribution,18,10,8
23309,Puresight,kelthuzad,954,paladin,retribution,18,10,8
23310,Cacaine,goldrinn,954,paladin,retribution,21,11,10
23311,Sòl,stormrage,954,paladin,retribution,24,10,14
23312,Didymus,boulderfist,954,paladin,retribution,41,17,24
23313,Justsmiteit,dalaran,953,paladin,retribution,18,10,8
23314,Aura,stormreaver,952,paladin,retribution,18,10,8
23315,Azëitona,azralon,952,paladin,retribution,18,10,8
23316,Exeneyder,elune,952,paladin,retribution,25,10,15
23317,Vassen,echo-isles,950,paladin,retribution,24,10,14
23318,ßlððdyßðnez,malganis,949,paladin,retribution,18,10,8
23319,Talvyr,icecrown,948,paladin,retribution,24,10,14
23320,Xhotbutters,korgath,945,paladin,retribution,31,13,18
23321,Gamber,frostmourne,944,paladin,retribution,24,10,14
23322,Redyomi,drakkari,943,paladin,retribution,30,10,20
23323,Pathed,aerie-peak,941,paladin,retribution,23,10,13
23324,Deltajk,drakkari,932,paladin,retribution,36,18,18
23325,Leona,stormrage,927,paladin,retribution,16,11,5
23326,Nerfret,zuljin,926,paladin,retribution,14,11,3
23327,Tonimâster,misha,926,paladin,retribution,23,10,13
23328,Mehchelol,azgalor,923,paladin,retribution,24,14,10
23329,Quotation,silvermoon,923,paladin,retribution,20,11,9
23330,Diësëlsmoke,bronzebeard,917,paladin,retribution,18,10,8
23331,Toepuller,doomhammer,917,paladin,retribution,42,21,21
23332,Goldranger,hakkar,916,paladin,retribution,42,22,20
23333,Kokuryuha,quelthalas,916,paladin,retribution,46,21,25
23334,Rönän,sargeras,911,paladin,retribution,17,10,7
23335,Stinaz,quelthalas,911,paladin,retribution,23,10,13
23336,Rebukezz,dalaran,911,paladin,retribution,23,10,13
23337,Stealhearsp,tichondrius,905,paladin,retribution,29,10,19
23338,Zentrick,whisperwind,902,paladin,retribution,42,16,26
23339,Lilsquirt,proudmoore,901,paladin,retribution,23,14,9
23340,Kilidin,illidan,899,paladin,retribution,21,10,11
23341,Elgigante,azshara,897,paladin,retribution,18,10,8
23342,Kaharule,akama,896,paladin,retribution,22,10,12
23343,Gorostas,kelthuzad,896,paladin,retribution,22,10,12
23344,Denthor,lightbringer,894,paladin,retribution,20,10,10
23345,Kaladini,jubeithos,893,paladin,retribution,16,10,6
23346,Àmárìs,tichondrius,882,paladin,retribution,22,10,12
23347,Allandaa,frostmourne,878,paladin,retribution,25,10,15
23348,Noholy,nemesis,872,paladin,retribution,37,11,26
23349,Arimae,turalyon,864,paladin,retribution,12,9,3
23350,Kaetix,frostmourne,864,paladin,retribution,12,9,3
23351,Arukan,ragnaros,864,paladin,retribution,12,9,3
23352,Slivkoff,wyrmrest-accord,864,paladin,retribution,12,9,3
23353,Chrigpal,tichondrius,864,paladin,retribution,12,9,3
23354,Warstompgg,ragnaros,864,paladin,retribution,12,9,3
23355,Swegswog,frostmourne,864,paladin,retribution,12,9,3
23356,Raggnarokk,kelthuzad,864,paladin,retribution,12,9,3
23357,Naughtygames,area-52,864,paladin,retribution,12,9,3
23358,Mardùk,stormrage,864,paladin,retribution,12,9,3
23359,Dublek,tichondrius,864,paladin,retribution,12,9,3
23360,Pallyseeker,thrall,864,paladin,retribution,12,9,3
23361,Wölfheärt,tichondrius,864,paladin,retribution,12,9,3
23362,Emiaru,illidan,864,paladin,retribution,16,10,6
23363,Moocowd,senjin,864,paladin,retribution,18,9,9
23364,Marvinceo,stormreaver,864,paladin,retribution,18,9,9
23365,Brohtato,area-52,864,paladin,retribution,18,9,9
23366,Zzerox,ragnaros,864,paladin,retribution,18,9,9
23367,Jelial,chogall,864,paladin,retribution,18,9,9
23368,Bigdixss,tichondrius,864,paladin,retribution,18,9,9
23369,Axeliee,kiljaeden,864,paladin,retribution,18,9,9
23370,Héber,nemesis,864,paladin,retribution,18,9,9
23371,Beefdaddyx,tichondrius,864,paladin,retribution,18,9,9
23372,Enjoy,frostmourne,864,paladin,retribution,18,9,9
23373,Talions,illidan,864,paladin,retribution,18,9,9
23374,Attkdamdam,illidan,864,paladin,retribution,18,9,9
23375,Rockdeath,sargeras,864,paladin,retribution,18,9,9
23376,Wogyu,area-52,864,paladin,retribution,18,9,9
23377,Miniell,tichondrius,864,paladin,retribution,18,9,9
23378,Kishou,stormrage,864,paladin,retribution,21,10,11
23379,Diebygcd,tichondrius,864,paladin,retribution,19,9,10
23380,Yáhtzee,tichondrius,864,paladin,retribution,22,10,12
23381,Justeight,stormrage,864,paladin,retribution,21,9,12
23382,Stoof,arygos,864,paladin,retribution,24,9,15
23383,Traevel,moon-guard,864,paladin,retribution,24,9,15
23384,Pistis,kelthuzad,864,paladin,retribution,24,9,15
23385,Fatkidslag,sargeras,864,paladin,retribution,24,9,15
23386,Saintgeórge,frostmourne,864,paladin,retribution,25,9,16
23387,Inquisídor,nemesis,863,paladin,retribution,12,9,3
23388,Heathen,spirestone,863,paladin,retribution,12,9,3
23389,Ultralord,dragonmaw,863,paladin,retribution,12,9,3
23390,Glorious,drakkari,863,paladin,retribution,12,9,3
23391,Pallyofhell,area-52,863,paladin,retribution,12,9,3
23392,Mightythorxx,tichondrius,863,paladin,retribution,12,9,3
23393,Utherparty,frostmourne,863,paladin,retribution,16,10,6
23394,Sleekz,moon-guard,863,paladin,retribution,18,9,9
23395,Enril,azgalor,863,paladin,retribution,18,9,9
23396,Heizero,area-52,863,paladin,retribution,18,9,9
23397,Ironprice,tichondrius,863,paladin,retribution,18,9,9
23398,Loraven,wyrmrest-accord,863,paladin,retribution,18,9,9
23399,Jhaann,tichondrius,863,paladin,retribution,18,9,9
23400,Whackadin,illidan,863,paladin,retribution,18,9,9
23401,Teewrecks,frostmourne,863,paladin,retribution,18,9,9
23402,Sephiroth,hyjal,863,paladin,retribution,18,9,9
23403,Lightballz,vashj,863,paladin,retribution,18,9,9
23404,Avacii,illidan,863,paladin,retribution,18,9,9
23405,Paliwarrior,illidan,863,paladin,retribution,18,9,9
23406,Liquidkoala,lightbringer,863,paladin,retribution,18,9,9
23407,Articilia,ragnaros,863,paladin,retribution,18,9,9
23408,Amntir,sargeras,863,paladin,retribution,24,9,15
23409,Thickdam,korgath,863,paladin,retribution,24,9,15
23410,Nuuska,dalaran,863,paladin,retribution,24,9,15
23411,Rivzx,tichondrius,863,paladin,retribution,24,9,15
23412,Detrimentãl,nagrand,863,paladin,retribution,24,9,15
23413,Galadriele,zuljin,863,paladin,retribution,24,9,15
23414,Fokatayew,korialstrasz,863,paladin,retribution,24,9,15
23415,Zerohöur,emerald-dream,863,paladin,retribution,30,9,21
23416,Zrkoria,ragnaros,863,paladin,retribution,36,9,27
23417,Ástedór,ragnaros,862,paladin,retribution,12,9,3
23418,Keiora,sargeras,862,paladin,retribution,12,9,3
23419,Badboí,azralon,862,paladin,retribution,12,9,3
23420,Chàrron,garrosh,862,paladin,retribution,18,9,9
23421,Illëst,stormrage,862,paladin,retribution,18,9,9
23422,Athenax,area-52,862,paladin,retribution,18,9,9
23423,Jajabola,zuljin,862,paladin,retribution,18,9,9
23424,Lightblade,stormrage,862,paladin,retribution,18,9,9
23425,Oniizuna,thrall,862,paladin,retribution,18,9,9
23426,Rhoche,ysera,862,paladin,retribution,18,9,9
23427,Pinelli,aegwynn,862,paladin,retribution,18,9,9
23428,Omegaziion,garrosh,862,paladin,retribution,18,9,9
23429,Kelthálas,illidan,862,paladin,retribution,24,9,15
23430,Restitution,area-52,862,paladin,retribution,24,9,15
23431,Boogerred,korialstrasz,862,paladin,retribution,24,9,15
23432,Velarelan,moon-guard,862,paladin,retribution,24,9,15
23433,Lightvader,illidan,862,paladin,retribution,24,9,15
23434,Stevas,khazgoroth,861,paladin,retribution,12,9,3
23435,Pikatripa,quelthalas,861,paladin,retribution,12,9,3
23436,Borélock,kelthuzad,861,paladin,retribution,18,9,9
23437,Kommuna,stormscale,861,paladin,retribution,18,9,9
23438,Bojanglz,frostmourne,861,paladin,retribution,21,10,11
23439,Rennalux,stormrage,861,paladin,retribution,24,9,15
23440,Vaelinarys,ragnaros,860,paladin,retribution,12,9,3
23441,Aeroßlaze,dragonmaw,860,paladin,retribution,18,9,9
23442,Unholypally,suramar,860,paladin,retribution,24,9,15
23443,Sona,jubeithos,860,paladin,retribution,24,9,15
23444,Easiestcomp,sargeras,859,paladin,retribution,18,9,9
23445,Khetzi,thunderhorn,859,paladin,retribution,18,9,9
23446,Kylarha,stormrage,859,paladin,retribution,18,9,9
23447,Layonthis,the-venture-co,859,paladin,retribution,18,9,9
23448,Madalynn,quelthalas,859,paladin,retribution,24,9,15
23449,Biggin,garona,859,paladin,retribution,108,36,72
23450,Alysca,tichondrius,858,paladin,retribution,18,9,9
23451,Derethen,emerald-dream,858,paladin,retribution,18,9,9
23452,Irongiant,grizzly-hills,858,paladin,retribution,18,9,9
23453,Vick,zuljin,857,paladin,retribution,12,9,3
23454,Holyzeen,darkspear,857,paladin,retribution,17,11,6
23455,Alerz,moon-guard,857,paladin,retribution,15,9,6
23456,Atilas,ragnaros,856,paladin,retribution,18,9,9
23457,Frostbitee,nerzhul,856,paladin,retribution,18,9,9
23458,Zerolayer,proudmoore,855,paladin,retribution,12,9,3
23459,Morddrohung,hyjal,855,paladin,retribution,12,9,3
23460,Kaidao,black-dragonflight,854,paladin,retribution,18,9,9
23461,Agonyss,quelthalas,853,paladin,retribution,18,9,9
23462,Goldfînger,zuljin,853,paladin,retribution,24,9,15
23463,Pallydin,smolderthorn,849,paladin,retribution,18,9,9
23464,Rcon,khadgar,849,paladin,retribution,18,9,9
23465,Leyon,alterac-mountains,847,paladin,retribution,18,9,9
23466,Brahion,icecrown,846,paladin,retribution,18,9,9
23467,Sycomaniac,illidan,846,paladin,retribution,23,9,14
23468,Morthalos,moon-guard,845,paladin,retribution,23,9,14
23469,Hotdgwatr,bleeding-hollow,843,paladin,retribution,24,10,14
23470,Avaheal,dragonmaw,842,paladin,retribution,23,9,14
23471,Pickypally,moon-guard,835,paladin,retribution,18,9,9
23472,Brioc,tichondrius,832,paladin,retribution,22,9,13
23473,Holyrump,bleeding-hollow,815,paladin,retribution,15,10,5
23474,Fiate,azralon,815,paladin,retribution,23,9,14
23475,Bigsamtp,laughing-skull,811,paladin,retribution,17,9,8
23476,Cozzey,amanthul,810,paladin,retribution,17,9,8
23477,Theboxx,frostmourne,810,paladin,retribution,28,11,17
23478,Porterhousee,bleeding-hollow,807,paladin,retribution,23,11,12
23479,Burstpink,zuljin,799,paladin,retribution,16,9,7
23480,Lizzyz,illidan,799,paladin,retribution,20,9,11
23481,Prosykt,sargeras,799,paladin,retribution,26,9,17
23482,Witewolf,illidan,798,paladin,retribution,19,10,9
23483,Erós,azralon,798,paladin,retribution,22,9,13
23484,Lightfdre,rexxar,797,paladin,retribution,33,11,22
23485,Kûrâmâ,ragnaros,796,paladin,retribution,16,9,7
23486,Kiloalpha,area-52,791,paladin,retribution,22,9,13
23487,Lítebearer,kelthuzad,787,paladin,retribution,17,9,8
23488,Kletüs,quelthalas,784,paladin,retribution,13,9,4
23489,Jdisco,bonechewer,782,paladin,retribution,19,9,10
23490,Alexandros,nordrassil,768,paladin,retribution,12,8,4
23491,Unicornslayr,antonidas,768,paladin,retribution,12,8,4
23492,Franckz,ragnaros,768,paladin,retribution,12,8,4
23493,Takinvcards,area-52,768,paladin,retribution,12,8,4
23494,Schmïtty,tichondrius,768,paladin,retribution,12,8,4
23495,Arellis,barthilas,768,paladin,retribution,12,8,4
23496,Céllash,tichondrius,768,paladin,retribution,12,8,4
23497,Eskynor,sargeras,768,paladin,retribution,12,8,4
23498,Soymilkdrnka,sargeras,768,paladin,retribution,12,8,4
23499,Mortalbeef,zuljin,768,paladin,retribution,12,8,4
23500,Brotherjon,stormrage,768,paladin,retribution,12,8,4
23501,Swellows,tichondrius,768,paladin,retribution,12,8,4
23502,Tolliver,area-52,768,paladin,retribution,12,8,4
23503,Pochanaw,wyrmrest-accord,768,paladin,retribution,12,8,4
23504,Djangø,azuremyst,768,paladin,retribution,12,8,4
23505,Bubblless,thrall,768,paladin,retribution,12,8,4
23506,Laboøn,stormrage,768,paladin,retribution,12,8,4
23507,Luzmu,azralon,768,paladin,retribution,12,8,4
23508,Ennvy,nemesis,768,paladin,retribution,12,8,4
23509,Nornix,fenris,768,paladin,retribution,12,8,4
23510,Hatchet,skullcrusher,768,paladin,retribution,12,8,4
23511,Liangguang,tichondrius,768,paladin,retribution,12,8,4
23512,Dasp,nagrand,768,paladin,retribution,12,8,4
23513,Rendyrend,frostmourne,768,paladin,retribution,12,8,4
23514,Lightsheart,lightbringer,768,paladin,retribution,12,8,4
23515,Cutebtw,zuljin,768,paladin,retribution,16,9,7
23516,Grimreaperx,azralon,768,paladin,retribution,17,8,9
23517,Duhvine,malganis,768,paladin,retribution,18,8,10
23518,Dynamism,frostmourne,768,paladin,retribution,18,8,10
23519,Torosagrado,drakkari,768,paladin,retribution,18,8,10
23520,Nozfferatu,drakkari,768,paladin,retribution,18,8,10
23521,Auranove,azralon,768,paladin,retribution,18,8,10
23522,Jereth,kelthuzad,768,paladin,retribution,18,8,10
23523,Bubbletaunt,frostmourne,768,paladin,retribution,18,8,10
23524,Maanuel,ragnaros,768,paladin,retribution,18,8,10
23525,Hge,proudmoore,768,paladin,retribution,18,8,10
23526,Hamerfall,tichondrius,768,paladin,retribution,18,8,10
23527,Kymmy,ragnaros,768,paladin,retribution,18,8,10
23528,Jebpal,tichondrius,768,paladin,retribution,18,8,10
23529,Howlerhead,illidan,768,paladin,retribution,18,8,10
23530,Brifos,sargeras,768,paladin,retribution,18,8,10
23531,Tævèn,tichondrius,768,paladin,retribution,18,8,10
23532,Jachugz,tichondrius,768,paladin,retribution,18,8,10
23533,Smiteup,sargeras,768,paladin,retribution,18,8,10
23534,Roshord,quelthalas,768,paladin,retribution,18,8,10
23535,Daion,quelthalas,768,paladin,retribution,18,8,10
23536,Jakkatähn,malganis,768,paladin,retribution,18,8,10
23537,Ratkiller,barthilas,768,paladin,retribution,18,8,10
23538,Caution,rexxar,768,paladin,retribution,18,8,10
23539,Bøble,thrall,768,paladin,retribution,18,8,10
23540,Nadinebb,proudmoore,768,paladin,retribution,18,8,10
23541,Gatzu,tichondrius,768,paladin,retribution,18,8,10
23542,Vanquishy,burning-legion,768,paladin,retribution,18,8,10
23543,Isayas,tichondrius,768,paladin,retribution,24,8,16
23544,Cnret,tichondrius,768,paladin,retribution,24,8,16
23545,Adamantïum,azralon,768,paladin,retribution,24,8,16
23546,Bubbleblade,burning-blade,768,paladin,retribution,24,8,16
23547,Jivvy,eredar,768,paladin,retribution,24,8,16
23548,Marcopolo,azralon,768,paladin,retribution,24,8,16
23549,Vibránium,tichondrius,768,paladin,retribution,24,8,16
23550,Rexpeitaboot,azralon,768,paladin,retribution,24,8,16
23551,Wantsome,frostmourne,768,paladin,retribution,25,8,17
23552,Crasíus,quelthalas,768,paladin,retribution,30,8,22
23553,Garethorne,illidan,768,paladin,retribution,30,8,22
23554,Roundhere,area-52,768,paladin,retribution,30,8,22
23555,Pallydestroy,stormrage,768,paladin,retribution,30,8,22
23556,Noctisu,tichondrius,768,paladin,retribution,30,8,22
23557,Mægenta,tichondrius,767,paladin,retribution,12,8,4
23558,Smitetheweak,rivendare,767,paladin,retribution,12,8,4
23559,Husurdaddy,dalaran,767,paladin,retribution,12,8,4
23560,Greybrox,barthilas,767,paladin,retribution,12,8,4
23561,Keit,moon-guard,767,paladin,retribution,12,8,4
23562,Elhoj,illidan,767,paladin,retribution,12,8,4
23563,Hqknight,moon-guard,767,paladin,retribution,12,8,4
23564,Darkeclipse,area-52,767,paladin,retribution,12,8,4
23565,Sowasred,emerald-dream,767,paladin,retribution,12,8,4
23566,Gospel,duskwood,767,paladin,retribution,12,8,4
23567,Doobiehigh,proudmoore,767,paladin,retribution,18,8,10
23568,Dontsleep,magtheridon,767,paladin,retribution,18,8,10
23569,Vindictacho,tichondrius,767,paladin,retribution,18,8,10
23570,Nutsmashèr,illidan,767,paladin,retribution,18,8,10
23571,Yurinos,illidan,767,paladin,retribution,18,8,10
23572,Ashess,sargeras,767,paladin,retribution,18,8,10
23573,Nightfallz,farstriders,767,paladin,retribution,18,8,10
23574,Amlovích,quelthalas,767,paladin,retribution,18,8,10
23575,Bruhstice,area-52,767,paladin,retribution,18,8,10
23576,Sermon,moon-guard,767,paladin,retribution,18,8,10
23577,Holytrev,tichondrius,767,paladin,retribution,18,8,10
23578,Stroods,stormrage,767,paladin,retribution,18,8,10
23579,Deafheavens,moon-guard,767,paladin,retribution,18,8,10
23580,Rodsley,zuljin,767,paladin,retribution,18,8,10
23581,Lygophobia,frostmourne,767,paladin,retribution,18,8,10
23582,Yehdardi,frostmourne,767,paladin,retribution,18,8,10
23583,Xytoken,tichondrius,767,paladin,retribution,18,8,10
23584,Cathode,area-52,767,paladin,retribution,18,8,10
23585,Nooplug,illidan,767,paladin,retribution,18,8,10
23586,Hughkane,tichondrius,767,paladin,retribution,18,8,10
23587,Saifollah,area-52,767,paladin,retribution,30,8,22
23588,Malavon,azralon,766,paladin,retribution,12,8,4
23589,Biblestomp,laughing-skull,766,paladin,retribution,12,8,4
23590,Otorten,bladefist,766,paladin,retribution,12,8,4
23591,Passion,wyrmrest-accord,766,paladin,retribution,12,8,4
23592,Judgementalz,frostwolf,766,paladin,retribution,12,8,4
23593,Deesqueezie,area-52,766,paladin,retribution,12,8,4
23594,Egufro,frostwolf,766,paladin,retribution,13,8,5
23595,Masho,skullcrusher,766,paladin,retribution,18,8,10
23596,Chippo,aegwynn,766,paladin,retribution,18,8,10
23597,Hanael,quelthalas,766,paladin,retribution,19,8,11
23598,Torvus,bonechewer,766,paladin,retribution,22,9,13
23599,Holyfilers,thunderlord,766,paladin,retribution,24,8,16
23600,Nikinaki,stormrage,765,paladin,retribution,12,8,4
23601,Cederas,sargeras,765,paladin,retribution,12,8,4
23602,Zuljaboi,thrall,765,paladin,retribution,12,8,4
23603,Kristary,ragnaros,765,paladin,retribution,12,8,4
23604,Holyhammered,kelthuzad,765,paladin,retribution,12,8,4
23605,Gírthbrooks,hyjal,765,paladin,retribution,12,8,4
23606,Mothh,terokkar,765,paladin,retribution,12,8,4
23607,Ichigò,sargeras,765,paladin,retribution,18,8,10
23608,Gigadorff,stormrage,765,paladin,retribution,18,8,10
23609,Butchur,area-52,765,paladin,retribution,30,8,22
23610,Xanamun,magtheridon,764,paladin,retribution,18,8,10
23611,Yenkmeilleur,zuljin,763,paladin,retribution,12,8,4
23612,Deathblazer,blades-edge,763,paladin,retribution,18,8,10
23613,Guccii,quelthalas,763,paladin,retribution,18,8,10
23614,Palade,proudmoore,763,paladin,retribution,18,8,10
23615,Amorimbr,area-52,763,paladin,retribution,24,8,16
23616,Jebadia,proudmoore,762,paladin,retribution,12,8,4
23617,Unicochori,drakkari,762,paladin,retribution,18,8,10
23618,Gys,ragnaros,762,paladin,retribution,18,8,10
23619,Eldirn,bleeding-hollow,761,paladin,retribution,12,8,4
23620,Flisk,garona,761,paladin,retribution,12,8,4
23621,Lucifuge,twisting-nether,760,paladin,retribution,12,8,4
23622,Slar,emerald-dream,760,paladin,retribution,18,8,10
23623,Darkknes,quelthalas,760,paladin,retribution,18,8,10
23624,Mandragor,borean-tundra,759,paladin,retribution,12,8,4
23625,Aladid,aggramar,758,paladin,retribution,12,8,4
23626,Trodos,quelthalas,758,paladin,retribution,12,8,4
23627,Appolas,shattered-hand,758,paladin,retribution,12,8,4
23628,Nerfmehpls,ragnaros,755,paladin,retribution,18,8,10
23629,Populate,tichondrius,752,paladin,retribution,12,8,4
23630,Maverickxz,nemesis,751,paladin,retribution,23,8,15
23631,Cleavix,tichondrius,751,paladin,retribution,35,8,27
23632,Oogablah,wyrmrest-accord,749,paladin,retribution,12,8,4
23633,Maelie,shadowmoon,749,paladin,retribution,12,8,4
23634,Palavittar,azralon,749,paladin,retribution,17,9,8
23635,Shanuslight,moon-guard,742,paladin,retribution,21,9,12
23636,Yulasa,area-52,735,paladin,retribution,14,9,5
23637,Hekki,ragnaros,735,paladin,retribution,19,8,11
23638,Són,ragnaros,735,paladin,retribution,23,8,15
23639,Xcream,nemesis,735,paladin,retribution,32,9,23
23640,Swholly,senjin,733,paladin,retribution,21,10,11
23641,Felordron,silvermoon,731,paladin,retribution,22,9,13
23642,Retgasm,drakthul,729,paladin,retribution,16,8,8
23643,Whisk,tichondrius,720,paladin,retribution,15,8,7
23644,Bomdia,stormrage,720,paladin,retribution,15,8,7
23645,Mádz,ragnaros,718,paladin,retribution,17,8,9
23646,Juang,arthas,717,paladin,retribution,46,18,28
23647,Romonite,bleeding-hollow,715,paladin,retribution,29,8,21
23648,Lilbursty,tichondrius,714,paladin,retribution,19,9,10
23649,Andorsi,elune,714,paladin,retribution,21,9,12
23650,Ryanslover,kelthuzad,714,paladin,retribution,23,9,14
23651,Exwars,moon-guard,713,paladin,retribution,14,9,5
23652,Pantheeon,altar-of-storms,713,paladin,retribution,30,9,21
23653,Connextion,terenas,704,paladin,retribution,16,8,8
23654,Xandish,illidan,703,paladin,retribution,14,8,6
23655,Làzårus,area-52,703,paladin,retribution,22,8,14
23656,Wadalee,tichondrius,702,paladin,retribution,26,8,18
23657,Palaðu,azralon,700,paladin,retribution,14,8,6
23658,Paullokis,gallywix,686,paladin,retribution,13,8,5
23659,Turtlehoof,thrall,684,paladin,retribution,19,8,11
23660,Jackedx,sargeras,672,paladin,retribution,12,7,5
23661,Montecrîsto,area-52,672,paladin,retribution,12,7,5
23662,Steezyret,barthilas,672,paladin,retribution,12,7,5
23663,Dabbicus,tichondrius,672,paladin,retribution,12,7,5
23664,Thrandeill,bleeding-hollow,672,paladin,retribution,12,7,5
23665,Armstrong,azralon,672,paladin,retribution,12,7,5
23666,Shadoweelite,sargeras,672,paladin,retribution,12,7,5
23667,Wèbb,burning-legion,672,paladin,retribution,12,7,5
23668,Marhaus,emerald-dream,672,paladin,retribution,12,7,5
23669,Zaxxous,hyjal,672,paladin,retribution,12,7,5
23670,Chäinswellx,area-52,672,paladin,retribution,12,7,5
23671,Supernampal,sargeras,672,paladin,retribution,12,7,5
23672,Furylolx,tichondrius,672,paladin,retribution,12,7,5
23673,Tmwesker,azralon,672,paladin,retribution,12,7,5
23674,Darthhelios,illidan,672,paladin,retribution,12,7,5
23675,Ÿøzsh,azralon,672,paladin,retribution,12,7,5
23676,Aurðra,kiljaeden,672,paladin,retribution,12,7,5
23677,Furdaddylant,drenden,672,paladin,retribution,12,7,5
23678,Noitra,azralon,672,paladin,retribution,12,7,5
23679,Griezadin,azgalor,672,paladin,retribution,12,7,5
23680,Bootyfùnk,tichondrius,672,paladin,retribution,12,7,5
23681,Iloveket,blackrock,672,paladin,retribution,12,7,5
23682,Theehopper,shandris,672,paladin,retribution,12,7,5
23683,Condign,moon-guard,672,paladin,retribution,12,7,5
23684,Pals,bronzebeard,672,paladin,retribution,12,7,5
23685,Zözo,zuljin,672,paladin,retribution,12,7,5
23686,Trejetë,tichondrius,672,paladin,retribution,12,7,5
23687,Vozy,bronzebeard,672,paladin,retribution,12,7,5
23688,Rektributíon,area-52,672,paladin,retribution,12,7,5
23689,Thephreak,madoran,672,paladin,retribution,12,7,5
23690,Nosferätu,illidan,672,paladin,retribution,12,7,5
23691,Paltarrd,bleeding-hollow,672,paladin,retribution,12,7,5
23692,Safename,area-52,672,paladin,retribution,12,7,5
23693,Qsx,bleeding-hollow,672,paladin,retribution,12,7,5
23694,Fakesimp,illidan,672,paladin,retribution,12,7,5
23695,Mikâel,cairne,672,paladin,retribution,12,7,5
23696,Skuxxlord,khazgoroth,672,paladin,retribution,12,7,5
23697,Hèlfar,wyrmrest-accord,672,paladin,retribution,12,7,5
23698,Araguaney,bleeding-hollow,672,paladin,retribution,12,7,5
23699,Steelemantle,moon-guard,672,paladin,retribution,12,7,5
23700,Meridional,tichondrius,672,paladin,retribution,12,7,5
23701,Popwingsz,nemesis,672,paladin,retribution,12,7,5
23702,Âllmíght,quelthalas,672,paladin,retribution,12,7,5
23703,Holycar,illidan,672,paladin,retribution,12,7,5
23704,Greatwyrm,illidan,672,paladin,retribution,12,7,5
23705,Montyer,ragnaros,672,paladin,retribution,12,7,5
23706,Turner,skullcrusher,672,paladin,retribution,12,7,5
23707,Kanaki,gilneas,672,paladin,retribution,12,7,5
23708,Merkzz,arthas,672,paladin,retribution,12,7,5
23709,Unitiss,velen,672,paladin,retribution,12,7,5
23710,Holreshee,tichondrius,672,paladin,retribution,12,7,5
23711,Bighoochie,moon-guard,672,paladin,retribution,12,7,5
23712,Mes,dragonmaw,672,paladin,retribution,12,7,5
23713,Ròwdy,area-52,672,paladin,retribution,12,7,5
23714,Sonatas,ursin,672,paladin,retribution,15,8,7
23715,Paladan,tichondrius,672,paladin,retribution,17,7,10
23716,Trfreedomz,frostmourne,672,paladin,retribution,18,7,11
23717,Bdaws,tichondrius,672,paladin,retribution,18,7,11
23718,Cliftôn,illidan,672,paladin,retribution,18,7,11
23719,Nerilliah,sargeras,672,paladin,retribution,18,7,11
23720,Édzor,area-52,672,paladin,retribution,18,7,11
23721,Orin,guldan,672,paladin,retribution,18,7,11
23722,Hakson,stormrage,672,paladin,retribution,18,7,11
23723,Drízzy,ragnaros,672,paladin,retribution,18,7,11
23724,Moistbible,kelthuzad,672,paladin,retribution,18,7,11
23725,Manryux,tichondrius,672,paladin,retribution,18,7,11
23726,Kloud,sargeras,672,paladin,retribution,18,7,11
23727,Gummybearz,doomhammer,672,paladin,retribution,18,7,11
23728,Ziti,bonechewer,672,paladin,retribution,18,7,11
23729,Eurthswrath,lightbringer,672,paladin,retribution,18,7,11
23730,Nawwll,stonemaul,672,paladin,retribution,18,7,11
23731,Anjocaído,nemesis,672,paladin,retribution,18,7,11
23732,Pâpito,drakkari,672,paladin,retribution,18,7,11
23733,Teamamerica,proudmoore,672,paladin,retribution,18,7,11
23734,Hølyshyt,tichondrius,672,paladin,retribution,18,7,11
23735,Aldhebarán,ragnaros,672,paladin,retribution,18,7,11
23736,Wryly,mannoroth,672,paladin,retribution,18,7,11
23737,Hulfsark,stormrage,672,paladin,retribution,18,7,11
23738,Xvetis,thrall,672,paladin,retribution,18,7,11
23739,Kipow,proudmoore,672,paladin,retribution,18,7,11
23740,Atalzel,kiljaeden,672,paladin,retribution,18,7,11
23741,Uoenò,moon-guard,672,paladin,retribution,18,7,11
23742,Shoresy,terokkar,672,paladin,retribution,18,7,11
23743,Rillumas,wyrmrest-accord,672,paladin,retribution,18,7,11
23744,Geospawn,bleeding-hollow,672,paladin,retribution,18,7,11
23745,Drriz,stormrage,672,paladin,retribution,18,7,11
23746,Aledin,frostmourne,672,paladin,retribution,18,7,11
23747,Tothegravetv,illidan,672,paladin,retribution,18,7,11
23748,Neverwogx,kirin-tor,672,paladin,retribution,18,7,11
23749,Bubbleblast,elune,672,paladin,retribution,18,7,11
23750,Rakzan,nerzhul,672,paladin,retribution,18,7,11
23751,Covidin,quelthalas,672,paladin,retribution,18,7,11
23752,Pugnacity,stormrage,672,paladin,retribution,18,7,11
23753,Kamí,elune,672,paladin,retribution,21,7,14
23754,Kaupe,barthilas,672,paladin,retribution,23,7,16
23755,Hayden,stormscale,672,paladin,retribution,24,7,17
23756,Haimdallr,azralon,672,paladin,retribution,24,7,17
23757,Ganan,frostmane,672,paladin,retribution,24,7,17
23758,Ballsmcgee,bleeding-hollow,672,paladin,retribution,24,7,17
23759,Ledster,kelthuzad,672,paladin,retribution,24,7,17
23760,Heatyr,malganis,672,paladin,retribution,24,7,17
23761,Kyuubî,bloodhoof,672,paladin,retribution,24,7,17
23762,Goozlight,area-52,672,paladin,retribution,24,7,17
23763,Goldmembër,malganis,672,paladin,retribution,24,7,17
23764,Digider,area-52,672,paladin,retribution,24,7,17
23765,Tanesdeline,area-52,671,paladin,retribution,12,7,5
23766,Shadd,destromath,671,paladin,retribution,12,7,5
23767,Dabnpaladin,kelthuzad,671,paladin,retribution,12,7,5
23768,Koohny,stormrage,671,paladin,retribution,12,7,5
23769,Darktank,malganis,671,paladin,retribution,12,7,5
23770,Mhelyssa,goldrinn,671,paladin,retribution,12,7,5
23771,Lystia,malfurion,671,paladin,retribution,12,7,5
23772,Tonytoi,aegwynn,671,paladin,retribution,12,7,5
23773,Jåy,nazjatar,671,paladin,retribution,12,7,5
23774,Crematória,azralon,671,paladin,retribution,12,7,5
23775,Zerofans,ragnaros,671,paladin,retribution,12,7,5
23776,Ðrêâð,kirin-tor,671,paladin,retribution,12,7,5
23777,Prophesied,zuljin,671,paladin,retribution,12,7,5
23778,Torujo,drakkari,671,paladin,retribution,12,7,5
23779,Elemezs,tichondrius,671,paladin,retribution,12,7,5
23780,Ranknoob,khazgoroth,671,paladin,retribution,12,7,5
23781,Smuglý,wyrmrest-accord,671,paladin,retribution,12,7,5
23782,Ironpaladin,sargeras,671,paladin,retribution,12,7,5
23783,Darawin,korgath,671,paladin,retribution,12,7,5
23784,Holyretribut,tichondrius,671,paladin,retribution,12,7,5
23785,Thorean,sargeras,671,paladin,retribution,12,7,5
23786,Ruca,icecrown,671,paladin,retribution,12,7,5
23787,Annii,aegwynn,671,paladin,retribution,12,7,5
23788,Jaybbers,malganis,671,paladin,retribution,12,7,5
23789,Showfet,dalaran,671,paladin,retribution,16,8,8
23790,Auriol,azshara,671,paladin,retribution,14,7,7
23791,Eutectic,moon-guard,671,paladin,retribution,18,7,11
23792,Babyshuangs,illidan,671,paladin,retribution,18,7,11
23793,Vaelicus,emerald-dream,671,paladin,retribution,18,7,11
23794,Basslinee,quelthalas,671,paladin,retribution,18,7,11
23795,Giorgyos,ragnaros,671,paladin,retribution,18,7,11
23796,Kaidoz,aegwynn,671,paladin,retribution,18,7,11
23797,Tyelca,zuljin,671,paladin,retribution,18,7,11
23798,Blaeng,shandris,671,paladin,retribution,18,7,11
23799,Contritus,kiljaeden,671,paladin,retribution,18,7,11
23800,Gemutlich,khazgoroth,671,paladin,retribution,18,7,11
23801,Misskilljoy,proudmoore,671,paladin,retribution,18,7,11
23802,Valtariel,wyrmrest-accord,671,paladin,retribution,18,7,11
23803,Golozzakum,tichondrius,671,paladin,retribution,18,7,11
23804,Ane,gorefiend,671,paladin,retribution,18,7,11
23805,Nibuwolfx,daggerspine,671,paladin,retribution,18,7,11
23806,Släyèr,tichondrius,671,paladin,retribution,18,7,11
23807,Imrahilaf,korialstrasz,671,paladin,retribution,24,7,17
23808,Doraléous,illidan,671,paladin,retribution,24,7,17
23809,Swissalami,proudmoore,670,paladin,retribution,12,7,5
23810,Hanno,azshara,670,paladin,retribution,12,7,5
23811,Biggwill,proudmoore,670,paladin,retribution,12,7,5
23812,Itsapoc,sargeras,670,paladin,retribution,12,7,5
23813,Tomaz,ragnaros,670,paladin,retribution,12,7,5
23814,Holychach,tichondrius,670,paladin,retribution,12,7,5
23815,Riek,sargeras,670,paladin,retribution,16,8,8
23816,Mindfoolness,sargeras,670,paladin,retribution,18,7,11
23817,Rampetos,mannoroth,670,paladin,retribution,18,7,11
23818,Jorgevercilo,azralon,670,paladin,retribution,18,7,11
23819,Augus,arygos,670,paladin,retribution,18,7,11
23820,Tpane,kelthuzad,670,paladin,retribution,18,7,11
23821,Murdameek,area-52,670,paladin,retribution,24,7,17
23822,Terroll,bonechewer,669,paladin,retribution,13,7,6
23823,Vargonha,azralon,669,paladin,retribution,18,9,9
23824,Tpaartes,mannoroth,669,paladin,retribution,18,7,11
23825,Sîegfried,moon-guard,669,paladin,retribution,18,7,11
23826,Denstain,kul-tiras,669,paladin,retribution,18,7,11
23827,Bingbingcd,tichondrius,669,paladin,retribution,18,7,11
23828,Rynis,arthas,669,paladin,retribution,22,8,14
23829,Salvø,tichondrius,669,paladin,retribution,24,7,17
23830,Murtsza,ragnaros,669,paladin,retribution,24,7,17
23831,Sponce,kirin-tor,669,paladin,retribution,30,7,23
23832,Praisin,zuljin,668,paladin,retribution,12,7,5
23833,Marshman,kelthuzad,668,paladin,retribution,12,7,5
23834,Unsung,stormreaver,668,paladin,retribution,18,7,11
23835,Holyrõller,malganis,668,paladin,retribution,18,7,11
23836,Pengideath,barthilas,668,paladin,retribution,18,7,11
23837,Bennygee,moonrunner,668,paladin,retribution,24,7,17
23838,Kapaw,windrunner,667,paladin,retribution,12,7,5
23839,Tacosmells,thunderlord,667,paladin,retribution,18,7,11
23840,Mandow,tichondrius,667,paladin,retribution,22,8,14
23841,Imsoosmall,sargeras,666,paladin,retribution,12,7,5
23842,Calmador,proudmoore,666,paladin,retribution,12,7,5
23843,Toogud,moon-guard,666,paladin,retribution,21,8,13
23844,Jonnywick,duskwood,665,paladin,retribution,12,7,5
23845,Chaosbubble,burning-legion,665,paladin,retribution,18,7,11
23846,Palgiga,tichondrius,664,paladin,retribution,12,7,5
23847,Dweezill,daggerspine,664,paladin,retribution,18,7,11
23848,Tectorr,proudmoore,661,paladin,retribution,12,7,5
23849,Nicepally,moon-guard,657,paladin,retribution,18,7,11
23850,Blake,frostmourne,655,paladin,retribution,23,7,16
23851,Palliful,runetotem,651,paladin,retribution,18,7,11
23852,Reînhard,drakkari,639,paladin,retribution,18,8,10
23853,Vietnomeez,tichondrius,639,paladin,retribution,17,7,10
23854,Cherrypally,area-52,639,paladin,retribution,17,7,10
23855,Epòc,frostmourne,639,paladin,retribution,20,8,12
23856,Hanicon,dragonmaw,638,paladin,retribution,16,7,9
23857,Fatalpally,antonidas,633,paladin,retribution,17,7,10
23858,Taéyeon,quelthalas,624,paladin,retribution,15,7,8
23859,Táçô,illidan,623,paladin,retribution,11,7,4
23860,Wingalings,malganis,623,paladin,retribution,11,7,4
23861,Krossfyre,kiljaeden,623,paladin,retribution,17,7,10
23862,Strabic,stormrage,623,paladin,retribution,27,8,19
23863,Jortesh,tichondrius,622,paladin,retribution,15,7,8
23864,Shuckles,windrunner,618,paladin,retribution,26,8,18
23865,Antoniano,ragnaros,617,paladin,retribution,13,8,5
23866,Thorsmites,sargeras,616,paladin,retribution,29,11,18
23867,Krixes,firetree,615,paladin,retribution,18,8,10
23868,Frêyr,barthilas,608,paladin,retribution,22,7,15
23869,Andelk,tichondrius,607,paladin,retribution,11,7,4
23870,Chestbrah,nemesis,607,paladin,retribution,14,7,7
23871,Tolkki,dalaran,607,paladin,retribution,26,7,19
23872,Krønos,nordrassil,602,paladin,retribution,22,7,15
23873,Ylilliana,illidan,592,paladin,retribution,19,7,12
23874,Sixtynine,nathrezim,592,paladin,retribution,31,7,24
23875,Warbird,lightnings-blade,591,paladin,retribution,13,7,6
23876,Theomere,sargeras,586,paladin,retribution,27,10,17
23877,Bubbledober,tichondrius,576,paladin,retribution,6,6,0
23878,Liht,blood-furnace,576,paladin,retribution,6,6,0
23879,Fierfox,moon-guard,576,paladin,retribution,6,6,0
23880,Fibonaci,sargeras,576,paladin,retribution,6,6,0
23881,Sneely,kelthuzad,576,paladin,retribution,6,6,0
23882,Lucard,drakkari,576,paladin,retribution,6,6,0
23883,Thøradin,moon-guard,576,paladin,retribution,6,6,0
23884,Xandiê,sargeras,576,paladin,retribution,6,6,0
23885,Damnhammer,tichondrius,576,paladin,retribution,10,7,3
23886,Mikeyqt,nemesis,576,paladin,retribution,12,6,6
23887,Ashbrînger,emerald-dream,576,paladin,retribution,12,6,6
23888,Thuggrnaut,darkspear,576,paladin,retribution,12,6,6
23889,Bloodeladin,deathwing,576,paladin,retribution,12,6,6
23890,Emetselchs,tichondrius,576,paladin,retribution,12,6,6
23891,Seeys,tichondrius,576,paladin,retribution,12,6,6
23892,Cybopig,kelthuzad,576,paladin,retribution,12,6,6
23893,Ashley,sargeras,576,paladin,retribution,12,6,6
23894,Thaléros,tichondrius,576,paladin,retribution,12,6,6
23895,Brpistol,azralon,576,paladin,retribution,12,6,6
23896,Rhoruk,turalyon,576,paladin,retribution,12,6,6
23897,Sonicblazer,darrowmere,576,paladin,retribution,12,6,6
23898,Cübe,malganis,576,paladin,retribution,12,6,6
23899,Rohad,thrall,576,paladin,retribution,12,6,6
23900,Pudgë,bleeding-hollow,576,paladin,retribution,12,6,6
23901,Hammerd,area-52,576,paladin,retribution,12,6,6
23902,Cvpal,stormrage,576,paladin,retribution,12,6,6
23903,Zägreus,moon-guard,576,paladin,retribution,12,6,6
23904,Enj,stormrage,576,paladin,retribution,12,6,6
23905,Lyà,area-52,576,paladin,retribution,12,6,6
23906,Escanøor,stormrage,576,paladin,retribution,12,6,6
23907,Margit,moon-guard,576,paladin,retribution,12,6,6
23908,Shourins,tichondrius,576,paladin,retribution,12,6,6
23909,Checkeettpal,sargeras,576,paladin,retribution,12,6,6
23910,Badbad,icecrown,576,paladin,retribution,12,6,6
23911,Lmac,frostmourne,576,paladin,retribution,12,6,6
23912,Immensepower,tichondrius,576,paladin,retribution,12,6,6
23913,Lebubbles,azuremyst,576,paladin,retribution,12,6,6
23914,Tacohuntter,stormrage,576,paladin,retribution,12,6,6
23915,Joeseph,stormrage,576,paladin,retribution,12,6,6
23916,Onnakishi,azralon,576,paladin,retribution,12,6,6
23917,Jabrohnie,sargeras,576,paladin,retribution,12,6,6
23918,Snivasgo,ragnaros,576,paladin,retribution,12,6,6
23919,Memepaladin,area-52,576,paladin,retribution,12,6,6
23920,Banzz,azralon,576,paladin,retribution,12,6,6
23921,Klamindor,emerald-dream,576,paladin,retribution,12,6,6
23922,Holycrp,proudmoore,576,paladin,retribution,12,6,6
23923,Accept,frostmourne,576,paladin,retribution,12,6,6
23924,Cinacalcet,dalaran,576,paladin,retribution,12,6,6
23925,Aura,emerald-dream,576,paladin,retribution,12,6,6
23926,Bigdig,stormrage,576,paladin,retribution,12,6,6
23927,Proctrlx,tichondrius,576,paladin,retribution,12,6,6
23928,Irushthots,tichondrius,576,paladin,retribution,12,6,6
23929,Careyprice,area-52,576,paladin,retribution,12,6,6
23930,Glynisir,sargeras,576,paladin,retribution,12,6,6
23931,Sacerbelator,zuluhed,576,paladin,retribution,12,6,6
23932,Germ,korgath,576,paladin,retribution,12,6,6
23933,Skarlagen,moon-guard,576,paladin,retribution,12,6,6
23934,Gronmpa,nemesis,576,paladin,retribution,12,6,6
23935,Gambitdin,moon-guard,576,paladin,retribution,12,6,6
23936,Xlnc,illidan,576,paladin,retribution,12,6,6
23937,Panicbubblin,stormrage,576,paladin,retribution,12,6,6
23938,Crtinsideyou,skullcrusher,576,paladin,retribution,12,6,6
23939,Pállyho,tichondrius,576,paladin,retribution,12,6,6
23940,Fallenp,hakkar,576,paladin,retribution,12,6,6
23941,Troegenator,stormrage,576,paladin,retribution,12,6,6
23942,Çløúdéd,area-52,576,paladin,retribution,12,6,6
23943,Obeliskk,frostmourne,576,paladin,retribution,12,6,6
23944,Venter,bleeding-hollow,576,paladin,retribution,12,6,6
23945,Soapgirl,area-52,576,paladin,retribution,12,6,6
23946,Zèró,terokkar,576,paladin,retribution,12,6,6
23947,Trixzthot,barthilas,576,paladin,retribution,12,6,6
23948,Alphali,quelthalas,576,paladin,retribution,12,6,6
23949,Tazanian,aegwynn,576,paladin,retribution,12,6,6
23950,Geesworld,nazjatar,576,paladin,retribution,12,6,6
23951,Dýnamo,azralon,576,paladin,retribution,12,6,6
23952,Gánico,ragnaros,576,paladin,retribution,12,6,6
23953,Sabêr,mannoroth,576,paladin,retribution,12,6,6
23954,Beluros,tichondrius,576,paladin,retribution,12,6,6
23955,Valandur,kelthuzad,576,paladin,retribution,12,6,6
23956,Koûtt,ragnaros,576,paladin,retribution,12,6,6
23957,Kaïty,azralon,576,paladin,retribution,12,6,6
23958,Arraladin,tichondrius,576,paladin,retribution,12,6,6
23959,Shrektacular,malganis,576,paladin,retribution,12,6,6
23960,Byebyetwinks,khaz-modan,576,paladin,retribution,12,6,6
23961,Bigkspally,korgath,576,paladin,retribution,12,6,6
23962,Seballedo,drakkari,576,paladin,retribution,12,6,6
23963,Yungcheezy,illidan,576,paladin,retribution,12,6,6
23964,Sparticuss,frostmane,576,paladin,retribution,12,6,6
23965,Ltt,dalaran,576,paladin,retribution,12,6,6
23966,Raywhite,kelthuzad,576,paladin,retribution,12,6,6
23967,Retboy,archimonde,576,paladin,retribution,12,6,6
23968,Vozy,shandris,576,paladin,retribution,12,6,6
23969,Onixx,kargath,576,paladin,retribution,12,6,6
23970,Avasti,proudmoore,576,paladin,retribution,12,6,6
23971,Totalaustin,sargeras,576,paladin,retribution,12,6,6
23972,Lumberjack,bloodhoof,576,paladin,retribution,12,6,6
23973,Bloodyängel,emerald-dream,576,paladin,retribution,12,6,6
23974,Çhñkzrèt,illidan,576,paladin,retribution,12,6,6
23975,Glorgrim,emerald-dream,576,paladin,retribution,12,6,6
23976,Vilert,balnazzar,576,paladin,retribution,12,6,6
23977,Nyroxz,quelthalas,576,paladin,retribution,12,6,6
23978,Crânkdât,frostmourne,576,paladin,retribution,12,6,6
23979,Cause,farstriders,576,paladin,retribution,12,6,6
23980,Bootcrusader,thrall,576,paladin,retribution,15,7,8
23981,Sunwalker,tichondrius,576,paladin,retribution,17,6,11
23982,Koreancannon,tichondrius,576,paladin,retribution,21,7,14
23983,Respect,moon-guard,576,paladin,retribution,18,6,12
23984,Nufi,magtheridon,576,paladin,retribution,18,6,12
23985,Wreathy,sargeras,576,paladin,retribution,18,6,12
23986,Slowmoshend,illidan,576,paladin,retribution,18,6,12
23987,Felwythe,emerald-dream,576,paladin,retribution,18,6,12
23988,Jucker,tichondrius,576,paladin,retribution,18,6,12
23989,Kochinodin,ragnaros,576,paladin,retribution,18,6,12
23990,Astolfo,tortheldrin,576,paladin,retribution,18,6,12
23991,Retz,tichondrius,576,paladin,retribution,18,6,12
23992,Kronicle,bleeding-hollow,576,paladin,retribution,18,6,12
23993,Shiftybugar,tichondrius,576,paladin,retribution,18,6,12
23994,Divineera,frostmourne,576,paladin,retribution,18,6,12
23995,Goldskìn,sargeras,576,paladin,retribution,18,6,12
23996,Exorcìst,tichondrius,576,paladin,retribution,18,6,12
23997,Bergz,agamaggan,576,paladin,retribution,18,6,12
23998,Niksilp,malfurion,576,paladin,retribution,18,6,12
23999,Liandroa,stormrage,576,paladin,retribution,18,6,12
24000,Riggen,thrall,576,paladin,retribution,18,6,12
24001,Suro,moon-guard,576,paladin,retribution,18,6,12
24002,Emaus,tichondrius,576,paladin,retribution,18,6,12
24003,Hetodo,blood-furnace,576,paladin,retribution,18,6,12
24004,Spala,tichondrius,576,paladin,retribution,18,6,12
24005,Bageru,gnomeregan,576,paladin,retribution,18,6,12
24006,Júdgedredd,illidan,576,paladin,retribution,18,6,12
24007,Gogofisco,moonrunner,576,paladin,retribution,18,6,12
24008,Terrordin,illidan,576,paladin,retribution,18,6,12
24009,Iloveyouxoxo,tichondrius,576,paladin,retribution,18,6,12
24010,Lightslion,stormrage,576,paladin,retribution,18,6,12
24011,Pheonixpally,azralon,576,paladin,retribution,24,6,18
24012,Pallyfreddyy,frostmourne,576,paladin,retribution,24,6,18
24013,Dragrias,altar-of-storms,575,paladin,retribution,10,7,3
24014,Yuzuru,mannoroth,575,paladin,retribution,12,6,6
24015,Haziel,darkspear,575,paladin,retribution,12,6,6
24016,Drágônbôrn,tichondrius,575,paladin,retribution,12,6,6
24017,Angelz,garrosh,575,paladin,retribution,12,6,6
24018,Toscadin,ragnaros,575,paladin,retribution,12,6,6
24019,Skyangel,illidan,575,paladin,retribution,12,6,6
24020,Laluce,malganis,575,paladin,retribution,12,6,6
24021,Killmode,kelthuzad,575,paladin,retribution,12,6,6
24022,Jovolur,dalaran,575,paladin,retribution,12,6,6
24023,Sarkorius,moon-guard,575,paladin,retribution,12,6,6
24024,Blëssëd,zuljin,575,paladin,retribution,12,6,6
24025,Ikanacanyon,stormrage,575,paladin,retribution,12,6,6
24026,Übermane,illidan,575,paladin,retribution,12,6,6
24027,Llght,hydraxis,575,paladin,retribution,12,6,6
24028,Potiguar,azralon,575,paladin,retribution,12,6,6
24029,Crixius,eredar,575,paladin,retribution,12,6,6
24030,Pocacoco,azralon,575,paladin,retribution,12,6,6
24031,Shaggrilla,trollbane,575,paladin,retribution,12,6,6
24032,Knobody,emerald-dream,575,paladin,retribution,12,6,6
24033,Onecmpeter,kelthuzad,575,paladin,retribution,12,6,6
24034,Willzaum,azralon,575,paladin,retribution,12,6,6
24035,Heiinneken,queldorei,575,paladin,retribution,12,6,6
24036,Karimpro,emerald-dream,575,paladin,retribution,15,7,8
24037,Holyginger,barthilas,575,paladin,retribution,15,7,8
24038,Trekpii,area-52,575,paladin,retribution,13,6,7
24039,Vosailer,illidan,575,paladin,retribution,16,7,9
24040,Bebedor,azralon,575,paladin,retribution,15,6,9
24041,Killstien,illidan,575,paladin,retribution,18,6,12
24042,Oceangal,illidan,575,paladin,retribution,18,6,12
24043,Valdi,stonemaul,575,paladin,retribution,18,6,12
24044,Cropcircles,whisperwind,575,paladin,retribution,18,6,12
24045,Vecknilashx,quelthalas,575,paladin,retribution,24,6,18
24046,Ihmperiuus,quelthalas,574,paladin,retribution,12,6,6
24047,Palman,frostmourne,574,paladin,retribution,12,6,6
24048,Akeero,khaz-modan,574,paladin,retribution,12,6,6
24049,Halordriest,tichondrius,574,paladin,retribution,18,6,12
24050,Tamahu,azralon,574,paladin,retribution,18,6,12
24051,Darqtank,smolderthorn,574,paladin,retribution,18,6,12
24052,Judgemèntal,illidan,574,paladin,retribution,20,6,14
24053,Phankro,quelthalas,573,paladin,retribution,12,6,6
24054,Tauyoshi,azjolnerub,573,paladin,retribution,12,6,6
24055,Gämä,azralon,573,paladin,retribution,18,6,12
24056,Chadrickk,tichondrius,572,paladin,retribution,12,6,6
24057,Ajaex,area-52,571,paladin,retribution,12,6,6
24058,Kalerien,wildhammer,571,paladin,retribution,12,6,6
24059,Lucent,duskwood,571,paladin,retribution,18,6,12
24060,Niáa,quelthalas,570,paladin,retribution,18,6,12
24061,Palâdino,azralon,568,paladin,retribution,21,7,14
24062,Halldhyr,quelthalas,566,paladin,retribution,12,6,6
24063,Rëtribution,tichondrius,559,paladin,retribution,18,7,11
24064,Bellamor,burning-blade,543,paladin,retribution,11,6,5
24065,Gloren,garrosh,543,paladin,retribution,17,6,11
24066,Buffalosaucé,illidan,543,paladin,retribution,17,6,11
24067,Suslazin,area-52,543,paladin,retribution,20,7,13
24068,Hadagoodlay,zuljin,528,paladin,retribution,15,6,9
24069,Yulzypal,tichondrius,527,paladin,retribution,11,6,5
24070,Rugay,sargeras,527,paladin,retribution,11,6,5
24071,Vardrik,darkspear,527,paladin,retribution,15,6,9
24072,Briaelyne,tichondrius,522,paladin,retribution,25,8,17
24073,Nathaniel,galakrond,511,paladin,retribution,14,6,8
24074,ßìgdám,bleeding-hollow,511,paladin,retribution,17,6,11
24075,Javiermiléi,quelthalas,511,paladin,retribution,26,6,20
24076,Dexko,silvermoon,509,paladin,retribution,12,7,5
24077,Releváncé,frostmourne,496,paladin,retribution,27,6,21
24078,Spàrhawke,stormrage,495,paladin,retribution,13,6,7
24079,Fionax,frostmourne,495,paladin,retribution,21,6,15
24080,Senorwang,dalaran,494,paladin,retribution,13,6,7
24081,Mollymatt,drenden,480,paladin,retribution,6,5,1
24082,Ganrof,mugthol,480,paladin,retribution,6,5,1
24083,Mizumaru,sargeras,480,paladin,retribution,6,5,1
24084,Chopsparks,khadgar,480,paladin,retribution,6,5,1
24085,Anarkay,frostmourne,480,paladin,retribution,6,5,1
24086,Divenelena,sargeras,480,paladin,retribution,6,5,1
24087,Aurelea,frostmourne,480,paladin,retribution,6,5,1
24088,Mandymuze,illidan,480,paladin,retribution,6,5,1
24089,Stricken,kul-tiras,480,paladin,retribution,6,5,1
24090,Mendaltv,dalaran,480,paladin,retribution,6,5,1
24091,Fálko,azralon,480,paladin,retribution,6,5,1
24092,Moozafa,kiljaeden,480,paladin,retribution,6,5,1
24093,Solidifyxz,area-52,480,paladin,retribution,6,5,1
24094,Kdym,azralon,480,paladin,retribution,6,5,1
24095,Rangedmelee,stormrage,480,paladin,retribution,6,5,1
24096,Capsiel,caelestrasz,480,paladin,retribution,6,5,1
24097,Kelimir,dathremar,480,paladin,retribution,6,5,1
24098,Oldlemon,tichondrius,480,paladin,retribution,6,5,1
24099,Jianwen,kargath,480,paladin,retribution,6,5,1
24100,Kimitail,tichondrius,480,paladin,retribution,6,5,1
24101,Mmrdonator,icecrown,480,paladin,retribution,6,5,1
24102,Mardrïus,tichondrius,480,paladin,retribution,6,5,1
24103,Mcjudgin,kilrogg,480,paladin,retribution,6,5,1
24104,Demetriusxy,tichondrius,480,paladin,retribution,6,5,1
24105,Fistrozenemy,illidan,480,paladin,retribution,6,5,1
24106,Gramsby,aggramar,480,paladin,retribution,6,5,1
24107,Pickleparker,stormrage,480,paladin,retribution,6,5,1
24108,Pallisix,barthilas,480,paladin,retribution,6,5,1
24109,Zeprikito,nemesis,480,paladin,retribution,6,5,1
24110,Devvn,laughing-skull,480,paladin,retribution,6,5,1
24111,Speedlight,ragnaros,480,paladin,retribution,6,5,1
24112,Adrieoss,stormrage,480,paladin,retribution,6,5,1
24113,Overbet,area-52,480,paladin,retribution,9,6,3
24114,Smaugg,boulderfist,480,paladin,retribution,9,6,3
24115,Siamac,illidan,480,paladin,retribution,13,7,6
24116,Shinymoo,laughing-skull,480,paladin,retribution,12,5,7
24117,Sigismud,quelthalas,480,paladin,retribution,12,5,7
24118,Lastal,kiljaeden,480,paladin,retribution,12,5,7
24119,Brocolinî,zuljin,480,paladin,retribution,12,5,7
24120,Addisen,malganis,480,paladin,retribution,12,5,7
24121,Sabericdos,proudmoore,480,paladin,retribution,12,5,7
24122,Flavor,cairne,480,paladin,retribution,12,5,7
24123,Gavriel,quelthalas,480,paladin,retribution,12,5,7
24124,Kuyueh,tichondrius,480,paladin,retribution,12,5,7
24125,Wetterguuch,area-52,480,paladin,retribution,12,5,7
24126,Faithkiller,garrosh,480,paladin,retribution,12,5,7
24127,Hekcthor,ragnaros,480,paladin,retribution,12,5,7
24128,Mateeka,malganis,480,paladin,retribution,12,5,7
24129,Thrasheric,ragnaros,480,paladin,retribution,12,5,7
24130,Rakkhalar,ragnaros,480,paladin,retribution,12,5,7
24131,Vain,shuhalo,480,paladin,retribution,12,5,7
24132,Abegáil,area-52,480,paladin,retribution,12,5,7
24133,Runscapemain,feathermoon,480,paladin,retribution,12,5,7
24134,Thickgirl,bleeding-hollow,480,paladin,retribution,12,5,7
24135,Imperious,anetheron,480,paladin,retribution,12,5,7
24136,Alecx,tichondrius,480,paladin,retribution,12,5,7
24137,Retsupreme,tichondrius,480,paladin,retribution,12,5,7
24138,Leaelda,wyrmrest-accord,480,paladin,retribution,12,5,7
24139,Bettyböp,bleeding-hollow,480,paladin,retribution,12,5,7
24140,Chenghisret,tichondrius,480,paladin,retribution,12,5,7
24141,Zulyourmom,tichondrius,480,paladin,retribution,12,5,7
24142,Toojazzyleah,proudmoore,480,paladin,retribution,12,5,7
24143,Mikeawk,tichondrius,480,paladin,retribution,12,5,7
24144,Gotenks,trollbane,480,paladin,retribution,12,5,7
24145,Connore,stormrage,480,paladin,retribution,12,5,7
24146,Xizzor,darkspear,480,paladin,retribution,12,5,7
24147,Shiningtendi,aerie-peak,480,paladin,retribution,12,5,7
24148,Raveen,veknilash,480,paladin,retribution,12,5,7
24149,Valkaurus,drakkari,480,paladin,retribution,12,5,7
24150,Pique,malganis,480,paladin,retribution,12,5,7
24151,Joonzu,frostmane,480,paladin,retribution,12,5,7
24152,Dinobe,arthas,480,paladin,retribution,12,5,7
24153,Remorâ,blackrock,480,paladin,retribution,12,5,7
24154,Jadedx,stormrage,480,paladin,retribution,12,5,7
24155,Farmerzonly,tichondrius,480,paladin,retribution,12,5,7
24156,Dawsonthebos,grizzly-hills,480,paladin,retribution,12,5,7
24157,Namiiswan,area-52,480,paladin,retribution,12,5,7
24158,Uneazyxx,tichondrius,480,paladin,retribution,12,5,7
24159,Héathèn,area-52,480,paladin,retribution,12,5,7
24160,Shadomourne,arthas,480,paladin,retribution,12,5,7
24161,Daddyspit,arthas,480,paladin,retribution,12,5,7
24162,ßraveheart,zuljin,480,paladin,retribution,12,5,7
24163,Wonas,ragnaros,480,paladin,retribution,12,5,7
24164,Ravage,lothar,480,paladin,retribution,12,5,7
24165,Liadryn,kiljaeden,480,paladin,retribution,12,5,7
24166,Níngjìngy,tichondrius,480,paladin,retribution,12,5,7
24167,Rikku,undermine,480,paladin,retribution,12,5,7
24168,Gennara,ragnaros,480,paladin,retribution,12,5,7
24169,Yoroding,tichondrius,480,paladin,retribution,12,5,7
24170,Rùckûs,tichondrius,480,paladin,retribution,12,5,7
24171,Noleyboo,proudmoore,480,paladin,retribution,12,5,7
24172,Thin,ragnaros,480,paladin,retribution,12,5,7
24173,Delaswing,quelthalas,480,paladin,retribution,12,5,7
24174,Lücid,arthas,480,paladin,retribution,12,5,7
24175,Soterios,daggerspine,480,paladin,retribution,12,5,7
24176,Dalance,draka,480,paladin,retribution,12,5,7
24177,Únhøly,aegwynn,480,paladin,retribution,12,5,7
24178,Maxduo,bleeding-hollow,480,paladin,retribution,12,5,7
24179,Randvi,sargeras,480,paladin,retribution,12,5,7
24180,Littlemoses,exodar,480,paladin,retribution,12,5,7
24181,Heamis,thunderlord,480,paladin,retribution,12,5,7
24182,Callandør,illidan,480,paladin,retribution,12,5,7
24183,Bullpaladin,barthilas,480,paladin,retribution,12,5,7
24184,Shadòw,emerald-dream,480,paladin,retribution,12,5,7
24185,Hegarth,archimonde,480,paladin,retribution,12,5,7
24186,Jaenus,azralon,480,paladin,retribution,12,5,7
24187,Jinuhn,illidan,480,paladin,retribution,12,5,7
24188,Jaslexa,illidan,480,paladin,retribution,12,5,7
24189,Aeoliá,moon-guard,480,paladin,retribution,12,5,7
24190,Adrexious,dalaran,480,paladin,retribution,12,5,7
24191,Dimsimbar,frostmourne,480,paladin,retribution,12,5,7
24192,Beatman,blades-edge,480,paladin,retribution,12,5,7
24193,Dipho,illidan,480,paladin,retribution,12,5,7
24194,Malicia,malorne,480,paladin,retribution,12,5,7
24195,Yellowmay,sargeras,480,paladin,retribution,12,5,7
24196,Athamon,nemesis,480,paladin,retribution,12,5,7
24197,Hallastus,stormrage,480,paladin,retribution,12,5,7
24198,Dirtbagg,demon-soul,480,paladin,retribution,12,5,7
24199,Cedwarlancy,sargeras,480,paladin,retribution,12,5,7
24200,Delightt,sargeras,480,paladin,retribution,12,5,7
24201,Jonbonholy,sargeras,480,paladin,retribution,12,5,7
24202,Kirklandbeef,gorefiend,480,paladin,retribution,12,5,7
24203,Itaghí,sargeras,480,paladin,retribution,12,5,7
24204,Holytankadin,alleria,480,paladin,retribution,12,5,7
24205,Amyrana,medivh,480,paladin,retribution,12,5,7
24206,Ssawsy,illidan,480,paladin,retribution,12,5,7
24207,Crucifuk,sargeras,480,paladin,retribution,12,5,7
24208,Alequin,stormrage,480,paladin,retribution,12,5,7
24209,Wahpop,sargeras,480,paladin,retribution,12,5,7
24210,Dehya,sargeras,480,paladin,retribution,12,5,7
24211,Minzyp,illidan,480,paladin,retribution,12,5,7
24212,Kaelel,barthilas,480,paladin,retribution,12,5,7
24213,Ganster,dreadmaul,480,paladin,retribution,12,5,7
24214,Keelroi,sargeras,480,paladin,retribution,12,5,7
24215,Bold,frostmourne,480,paladin,retribution,12,5,7
24216,Bigolhammer,khadgar,480,paladin,retribution,12,5,7
24217,Methor,thrall,480,paladin,retribution,12,5,7
24218,Critadins,thrall,480,paladin,retribution,12,5,7
24219,Dragomnnm,stormrage,480,paladin,retribution,12,5,7
24220,Frepz,illidan,480,paladin,retribution,16,6,10
24221,Exer,ragnaros,480,paladin,retribution,18,5,13
24222,Holycots,stormrage,480,paladin,retribution,18,5,13
24223,Chriscoz,korgath,480,paladin,retribution,18,5,13
24224,Immunelf,azgalor,480,paladin,retribution,18,5,13
24225,Kraggar,arthas,480,paladin,retribution,18,5,13
24226,Tieberion,bleeding-hollow,480,paladin,retribution,18,5,13
24227,Downs,tichondrius,480,paladin,retribution,18,5,13
24228,Papazon,tichondrius,480,paladin,retribution,18,5,13
24229,Reehzlol,stormrage,480,paladin,retribution,18,5,13
24230,Valinorean,nemesis,480,paladin,retribution,18,5,13
24231,Zightmare,azralon,480,paladin,retribution,18,5,13
24232,Photons,emerald-dream,480,paladin,retribution,18,5,13
24233,Ulcerà,azralon,480,paladin,retribution,18,5,13
24234,Paradisso,tichondrius,480,paladin,retribution,18,5,13
24235,Nidalee,kilrogg,480,paladin,retribution,18,5,13
24236,Kurasi,frostmourne,480,paladin,retribution,18,5,13
24237,Melgamis,quelthalas,480,paladin,retribution,18,5,13
24238,Razuel,frostmourne,480,paladin,retribution,18,5,13
24239,Ztpz,illidan,480,paladin,retribution,18,5,13
24240,Purged,wyrmrest-accord,480,paladin,retribution,18,5,13
24241,Midnightboto,dragonmaw,480,paladin,retribution,18,5,13
24242,Typheuz,wyrmrest-accord,480,paladin,retribution,18,5,13
24243,Møemøeda,illidan,480,paladin,retribution,18,5,13
24244,Tikkun,area-52,480,paladin,retribution,18,5,13
24245,Sakicc,dalaran,480,paladin,retribution,18,5,13
24246,Deecompose,sargeras,480,paladin,retribution,18,5,13
24247,Artherion,kelthuzad,480,paladin,retribution,27,6,21
24248,Trapqueenlol,alterac-mountains,480,paladin,retribution,24,5,19
24249,Spoelstra,dragonmaw,480,paladin,retribution,24,5,19
24250,Zero,garona,480,paladin,retribution,30,5,25
24251,Azdan,ragnaros,480,paladin,retribution,30,5,25
24252,Abuenano,ragnaros,479,paladin,retribution,6,5,1
24253,Kremation,zuljin,479,paladin,retribution,6,5,1
24254,Dredberserk,stormrage,479,paladin,retribution,12,5,7
24255,Calithia,destromath,479,paladin,retribution,12,5,7
24256,Heneaz,quelthalas,479,paladin,retribution,12,5,7
24257,Noctis,nerzhul,479,paladin,retribution,12,5,7
24258,Reedeemer,bonechewer,479,paladin,retribution,12,5,7
24259,Murderous,frostmourne,479,paladin,retribution,12,5,7
24260,Mordrime,moon-guard,479,paladin,retribution,12,5,7
24261,Ashera,amanthul,479,paladin,retribution,12,5,7
24262,Zelrich,moon-guard,479,paladin,retribution,12,5,7
24263,Robz,malygos,479,paladin,retribution,12,5,7
24264,Memoríez,zuljin,479,paladin,retribution,12,5,7
24265,Ðarksealz,laughing-skull,479,paladin,retribution,12,5,7
24266,Cowsavior,terenas,479,paladin,retribution,12,5,7
24267,Inqa,thunderlord,479,paladin,retribution,12,5,7
24268,Onemorelight,sargeras,479,paladin,retribution,12,5,7
24269,Khels,gilneas,479,paladin,retribution,12,5,7
24270,Brightfire,dawnbringer,479,paladin,retribution,18,5,13
24271,Provail,stormrage,479,paladin,retribution,18,5,13
24272,Astralweed,quelthalas,479,paladin,retribution,18,5,13
24273,Alluxian,zuljin,479,paladin,retribution,18,5,13
24274,Griz,magtheridon,479,paladin,retribution,18,5,13
24275,Kief,emerald-dream,479,paladin,retribution,18,5,13
24276,Kajoruun,bleeding-hollow,479,paladin,retribution,24,5,19
24277,Palypunchh,darrowmere,478,paladin,retribution,12,6,6
24278,Neipala,ragnaros,478,paladin,retribution,12,5,7
24279,Impia,tichondrius,478,paladin,retribution,12,5,7
24280,Chengduqq,illidan,478,paladin,retribution,12,5,7
24281,Lagun,wyrmrest-accord,478,paladin,retribution,12,5,7
24282,Boomeers,emerald-dream,478,paladin,retribution,18,5,13
24283,Vonfraud,lightbringer,478,paladin,retribution,18,5,13
24284,Benzen,bleeding-hollow,477,paladin,retribution,12,5,7
24285,Jammsheed,arthas,477,paladin,retribution,12,5,7
24286,Kaminasol,quelthalas,477,paladin,retribution,18,5,13
24287,Pedromuulos,misha,477,paladin,retribution,24,5,19
24288,Solstein,dalaran,474,paladin,retribution,12,5,7
24289,Vengecide,proudmoore,473,paladin,retribution,12,5,7
24290,Dubaron,burning-blade,473,paladin,retribution,12,5,7
24291,Kforty,kiljaeden,458,paladin,retribution,18,7,11
24292,Pablito,fizzcrank,457,paladin,retribution,21,7,14
24293,Thepallyx,silvermoon,448,paladin,retribution,16,5,11
24294,Jireen,tichondrius,447,paladin,retribution,11,5,6
24295,Árèz,frostmourne,441,paladin,retribution,17,7,10
24296,Zzf,turalyon,431,paladin,retribution,11,5,6
24297,Neverforgot,quelthalas,431,paladin,retribution,11,5,6
24298,Naeamen,dragonmaw,430,paladin,retribution,9,6,3
24299,Ahzreal,garona,426,paladin,retribution,16,8,8
24300,Regivän,azralon,426,paladin,retribution,12,6,6
24301,Hálløwéð,firetree,426,paladin,retribution,14,6,8
24302,Stankylordz,sargeras,426,paladin,retribution,19,8,11
24303,Rashrind,moon-guard,426,paladin,retribution,23,8,15
24304,Kimochiyuh,illidan,425,paladin,retribution,17,7,10
24305,Ææøææøææøææø,illidan,416,paladin,retribution,10,5,5
24306,Yemotis,emerald-dream,416,paladin,retribution,10,5,5
24307,Stahny,thrall,415,paladin,retribution,10,5,5
24308,Saviorsavior,bleeding-hollow,415,paladin,retribution,11,5,6
24309,Artaxerxes,stormrage,415,paladin,retribution,14,5,9
24310,Epxilon,ragnaros,415,paladin,retribution,14,5,9
24311,Wrekkin,stormrage,415,paladin,retribution,14,5,9
24312,Waffulzz,moonrunner,415,paladin,retribution,20,5,15
24313,Insîght,frostmourne,414,paladin,retribution,16,5,11
24314,Rainingrets,tichondrius,404,paladin,retribution,28,10,18
24315,Thechoseno,tichondrius,400,paladin,retribution,13,5,8
24316,Iamriched,illidan,400,paladin,retribution,13,5,8
24317,Tinithis,tichondrius,399,paladin,retribution,5,5,0
24318,Rspect,trollbane,399,paladin,retribution,5,5,0
24319,Sydnneeyy,kelthuzad,399,paladin,retribution,5,5,0
24320,Crithealss,dalaran,384,paladin,retribution,6,4,2
24321,Laurenlight,tichondrius,384,paladin,retribution,6,4,2
24322,Vxm,illidan,384,paladin,retribution,6,4,2
24323,Thottylight,stormrage,384,paladin,retribution,6,4,2
24324,Täintcrusher,illidan,384,paladin,retribution,6,4,2
24325,Inquísítor,stormrage,384,paladin,retribution,6,4,2
24326,Slakyph,zuljin,384,paladin,retribution,6,4,2
24327,Bloodrefuge,tichondrius,384,paladin,retribution,6,4,2
24328,Babylonfive,zuluhed,384,paladin,retribution,6,4,2
24329,Dillysdilly,zuljin,384,paladin,retribution,6,4,2
24330,Ðorlie,malganis,384,paladin,retribution,6,4,2
24331,Pray,thunderlord,384,paladin,retribution,6,4,2
24332,Daylit,proudmoore,384,paladin,retribution,6,4,2
24333,Anaxxie,azralon,384,paladin,retribution,6,4,2
24334,Tayvar,stormrage,384,paladin,retribution,6,4,2
24335,Rohlin,boulderfist,384,paladin,retribution,6,4,2
24336,Dwarfineas,dalaran,384,paladin,retribution,6,4,2
24337,Nikho,thunderlord,384,paladin,retribution,6,4,2
24338,Tiduz,tichondrius,384,paladin,retribution,6,4,2
24339,Raphaelo,tichondrius,384,paladin,retribution,6,4,2
24340,Carneguisada,sargeras,384,paladin,retribution,6,4,2
24341,Eduardoap,azralon,384,paladin,retribution,6,4,2
24342,Rhaegorn,drakkari,384,paladin,retribution,6,4,2
24343,Aohxmathoss,zuljin,384,paladin,retribution,6,4,2
24344,Saîntpaul,shattered-halls,384,paladin,retribution,6,4,2
24345,Legèndaïry,tichondrius,384,paladin,retribution,6,4,2
24346,Masemune,bonechewer,384,paladin,retribution,6,4,2
24347,Thüridan,azralon,384,paladin,retribution,6,4,2
24348,Pappablanco,stormrage,384,paladin,retribution,6,4,2
24349,Goontaa,staghelm,384,paladin,retribution,6,4,2
24350,Westee,stormrage,384,paladin,retribution,6,4,2
24351,Dazztrain,barthilas,384,paladin,retribution,6,4,2
24352,Sasukee,quelthalas,384,paladin,retribution,6,4,2
24353,Baladine,zuljin,384,paladin,retribution,6,4,2
24354,Butterbeanz,tanaris,384,paladin,retribution,6,4,2
24355,Gilgamesh,moonrunner,384,paladin,retribution,6,4,2
24356,Robo,tichondrius,384,paladin,retribution,6,4,2
24357,Pennywenny,barthilas,384,paladin,retribution,6,4,2
24358,Wyrmblood,moon-guard,384,paladin,retribution,6,4,2
24359,Dörisseline,tichondrius,384,paladin,retribution,6,4,2
24360,Souldrainlol,quelthalas,384,paladin,retribution,6,4,2
24361,Crewsade,sargeras,384,paladin,retribution,6,4,2
24362,Shïnjïtsu,tichondrius,384,paladin,retribution,6,4,2
24363,Pallyalli,burning-blade,384,paladin,retribution,6,4,2
24364,Invictus,onyxia,384,paladin,retribution,6,4,2
24365,Saulhudson,bleeding-hollow,384,paladin,retribution,6,4,2
24366,Reclusiarch,tichondrius,384,paladin,retribution,6,4,2
24367,Kaypross,area-52,384,paladin,retribution,6,4,2
24368,Thadrian,nazgrel,384,paladin,retribution,6,4,2
24369,Seven,blackwing-lair,384,paladin,retribution,6,4,2
24370,Awsem,barthilas,384,paladin,retribution,6,4,2
24371,Bubblebùtt,tichondrius,384,paladin,retribution,6,4,2
24372,Hellcallerl,quelthalas,384,paladin,retribution,6,4,2
24373,Farlayne,quelthalas,384,paladin,retribution,6,4,2
24374,Navex,tichondrius,384,paladin,retribution,6,4,2
24375,Shadp,frostmourne,384,paladin,retribution,6,4,2
24376,Easiestclass,azshara,384,paladin,retribution,6,4,2
24377,Grinzin,azralon,384,paladin,retribution,6,4,2
24378,Mightymagnus,silvermoon,384,paladin,retribution,6,4,2
24379,Pallyjs,anetheron,384,paladin,retribution,6,4,2
24380,Taiffan,azralon,384,paladin,retribution,6,4,2
24381,Anstyl,moon-guard,384,paladin,retribution,6,4,2
24382,Coffiecup,frostmane,384,paladin,retribution,6,4,2
24383,Bübbleboy,malganis,384,paladin,retribution,6,4,2
24384,Notaefc,icecrown,384,paladin,retribution,6,4,2
24385,Èmmà,stormrage,384,paladin,retribution,6,4,2
24386,Leoros,blackrock,384,paladin,retribution,6,4,2
24387,Ironpallyx,garrosh,384,paladin,retribution,6,4,2
24388,Bruxx,twisting-nether,384,paladin,retribution,6,4,2
24389,Tifalockhart,dathremar,384,paladin,retribution,6,4,2
24390,Wosy,azralon,384,paladin,retribution,6,4,2
24391,Strattaltork,ragnaros,384,paladin,retribution,6,4,2
24392,Cenital,quelthalas,384,paladin,retribution,6,4,2
24393,Doç,stormrage,384,paladin,retribution,6,4,2
24394,Åphrodite,bleeding-hollow,384,paladin,retribution,6,4,2
24395,Icepondpal,proudmoore,384,paladin,retribution,6,4,2
24396,Fâmed,tichondrius,384,paladin,retribution,6,4,2
24397,Dinapal,frostmourne,384,paladin,retribution,6,4,2
24398,Mystictoast,area-52,384,paladin,retribution,6,4,2
24399,Temptrez,bleeding-hollow,384,paladin,retribution,6,4,2
24400,Xöchïqüëtzäl,tichondrius,384,paladin,retribution,6,4,2
24401,Crocfacex,tichondrius,384,paladin,retribution,6,4,2
24402,Merlinä,illidan,384,paladin,retribution,6,4,2
24403,Rexinarr,area-52,384,paladin,retribution,6,4,2
24404,Yuliu,magtheridon,384,paladin,retribution,6,4,2
24405,Khanid,emerald-dream,384,paladin,retribution,6,4,2
24406,Redempshun,drenden,384,paladin,retribution,6,4,2
24407,Gåbrîel,emerald-dream,384,paladin,retribution,6,4,2
24408,Luluwu,stormrage,384,paladin,retribution,6,4,2
24409,Daylin,tichondrius,384,paladin,retribution,6,4,2
24410,Bübbleqt,exodar,384,paladin,retribution,6,4,2
24411,Plottwists,bleeding-hollow,384,paladin,retribution,6,4,2
24412,Limitier,proudmoore,384,paladin,retribution,6,4,2
24413,Shirael,ragnaros,384,paladin,retribution,6,4,2
24414,Chunggus,eredar,384,paladin,retribution,6,4,2
24415,Bisket,illidan,384,paladin,retribution,6,4,2
24416,Prôphêt,stormrage,384,paladin,retribution,6,4,2
24417,Couraegus,azgalor,384,paladin,retribution,6,4,2
24418,Fxxku,tichondrius,384,paladin,retribution,6,4,2
24419,Illustrata,illidan,384,paladin,retribution,6,4,2
24420,Darkestday,hellscream,384,paladin,retribution,6,4,2
24421,Minikalina,ragnaros,384,paladin,retribution,6,4,2
24422,Ascencer,spirestone,384,paladin,retribution,6,4,2
24423,Trisøn,area-52,384,paladin,retribution,6,4,2
24424,Laventus,area-52,384,paladin,retribution,6,4,2
24425,Sunraiz,tichondrius,384,paladin,retribution,6,4,2
24426,Cratt,chromaggus,384,paladin,retribution,6,4,2
24427,Reckoniing,moon-guard,384,paladin,retribution,6,4,2
24428,Silreck,ragnaros,384,paladin,retribution,6,4,2
24429,Cobaine,illidan,384,paladin,retribution,6,4,2
24430,Bigddady,quelthalas,384,paladin,retribution,8,4,4
24431,Thõre,frostmourne,384,paladin,retribution,15,5,10
24432,Greenracer,kiljaeden,384,paladin,retribution,12,4,8
24433,Andromëdä,hyjal,384,paladin,retribution,12,4,8
24434,Ibull,stormscale,384,paladin,retribution,12,4,8
24435,Varuul,nerzhul,384,paladin,retribution,12,4,8
24436,Oppaladin,elune,384,paladin,retribution,12,4,8
24437,Zøzø,zuljin,384,paladin,retribution,12,4,8
24438,Tomcat,bladefist,384,paladin,retribution,12,4,8
24439,Bracen,emerald-dream,384,paladin,retribution,12,4,8
24440,Whoowhat,zuljin,384,paladin,retribution,12,4,8
24441,Phattpump,tichondrius,384,paladin,retribution,12,4,8
24442,Ridethispony,tichondrius,384,paladin,retribution,12,4,8
24443,Dohsevèn,tichondrius,384,paladin,retribution,12,4,8
24444,Aricen,thunderhorn,384,paladin,retribution,12,4,8
24445,Humbubble,cairne,384,paladin,retribution,12,4,8
24446,Ddawz,proudmoore,384,paladin,retribution,12,4,8
24447,Delukk,azralon,384,paladin,retribution,12,4,8
24448,Mikeelul,tichondrius,384,paladin,retribution,12,4,8
24449,Aewynn,nemesis,384,paladin,retribution,12,4,8
24450,Dmghack,tichondrius,384,paladin,retribution,12,4,8
24451,Botch,drenden,384,paladin,retribution,12,4,8
24452,Krypton,tichondrius,384,paladin,retribution,12,4,8
24453,Inareus,agamaggan,384,paladin,retribution,12,4,8
24454,Jimxeung,tichondrius,384,paladin,retribution,12,4,8
24455,Goloh,shadowmoon,384,paladin,retribution,12,4,8
24456,Roodictz,zuljin,384,paladin,retribution,12,4,8
24457,Kratosq,tichondrius,384,paladin,retribution,12,4,8
24458,Veshral,arthas,384,paladin,retribution,12,4,8
24459,Tëmplar,bleeding-hollow,384,paladin,retribution,12,4,8
24460,Remm,emerald-dream,384,paladin,retribution,12,4,8
24461,Zexion,azralon,384,paladin,retribution,12,4,8
24462,Illhaveacoke,moon-guard,384,paladin,retribution,12,4,8
24463,Simpforomenx,emerald-dream,384,paladin,retribution,12,4,8
24464,Kamianna,tichondrius,384,paladin,retribution,12,4,8
24465,Sethy,feathermoon,384,paladin,retribution,12,4,8
24466,Icekiss,tichondrius,384,paladin,retribution,12,4,8
24467,Eettooko,aegwynn,384,paladin,retribution,12,4,8
24468,Lunchboxz,nazjatar,384,paladin,retribution,12,4,8
24469,Adapa,azralon,384,paladin,retribution,12,4,8
24470,Lépéedophil,zuljin,384,paladin,retribution,12,4,8
24471,Vynlorderan,area-52,384,paladin,retribution,12,4,8
24472,Corrán,thrall,384,paladin,retribution,12,4,8
24473,Kurook,moon-guard,384,paladin,retribution,12,4,8
24474,Baptism,shattered-hand,384,paladin,retribution,12,4,8
24475,Harke,drakkari,384,paladin,retribution,12,4,8
24476,Kyrianjutsu,area-52,384,paladin,retribution,12,4,8
24477,Lokkillos,drakkari,384,paladin,retribution,12,4,8
24478,Hrrothgar,muradin,384,paladin,retribution,12,4,8
24479,Dezul,stormscale,384,paladin,retribution,12,4,8
24480,Tufybighamer,malganis,384,paladin,retribution,12,4,8
24481,Petunias,malganis,384,paladin,retribution,12,4,8
24482,Roländ,thrall,384,paladin,retribution,12,4,8
24483,Holyflopper,malganis,384,paladin,retribution,12,4,8
24484,Korijame,area-52,384,paladin,retribution,12,4,8
24485,Glexann,sargeras,384,paladin,retribution,12,4,8
24486,Blackmuu,malganis,384,paladin,retribution,12,4,8
24487,Hisenberg,drakkari,384,paladin,retribution,12,4,8
24488,Strugglèbus,thrall,384,paladin,retribution,12,4,8
24489,Simonis,windrunner,384,paladin,retribution,12,4,8
24490,Volphorix,illidan,384,paladin,retribution,12,4,8
24491,Oroürke,stormrage,384,paladin,retribution,12,4,8
24492,Dionysius,silvermoon,384,paladin,retribution,12,4,8
24493,Crazysyco,proudmoore,384,paladin,retribution,12,4,8
24494,Sahbabii,baelgun,384,paladin,retribution,12,4,8
24495,Catuvalos,kiljaeden,384,paladin,retribution,12,4,8
24496,Rusticles,aerie-peak,384,paladin,retribution,12,4,8
24497,Lightahean,proudmoore,384,paladin,retribution,12,4,8
24498,Grimmune,illidan,384,paladin,retribution,12,4,8
24499,Juliusplzher,area-52,384,paladin,retribution,12,4,8
24500,Pallyforeva,sargeras,384,paladin,retribution,12,4,8
24501,Ippótis,sargeras,384,paladin,retribution,12,4,8
24502,Holladrik,frostmourne,384,paladin,retribution,12,4,8
24503,Sixty,sargeras,384,paladin,retribution,12,4,8
24504,Uholypala,dalaran,384,paladin,retribution,12,4,8
24505,Adauto,illidan,384,paladin,retribution,12,4,8
24506,Aidillon,shadowsong,384,paladin,retribution,12,4,8
24507,Drakensang,tichondrius,384,paladin,retribution,12,4,8
24508,Senion,velen,384,paladin,retribution,12,4,8
24509,Vhaun,cairne,384,paladin,retribution,12,4,8
24510,Sigmapepe,quelthalas,384,paladin,retribution,12,4,8
24511,Eddf,ursin,384,paladin,retribution,12,4,8
24512,Grimdel,moon-guard,384,paladin,retribution,12,4,8
24513,Leail,frostmourne,384,paladin,retribution,12,4,8
24514,Picorii,frostmourne,384,paladin,retribution,12,4,8
24515,Kreigvar,moon-guard,384,paladin,retribution,12,4,8
24516,Heavener,tichondrius,384,paladin,retribution,12,4,8
24517,Lânnâ,tichondrius,384,paladin,retribution,12,4,8
24518,Àpolo,stormrage,384,paladin,retribution,12,4,8
24519,Givinpowpows,korgath,384,paladin,retribution,12,4,8
24520,Wards,thunderlord,384,paladin,retribution,12,4,8
24521,Mashy,moon-guard,384,paladin,retribution,12,4,8
24522,Dose,moon-guard,384,paladin,retribution,12,4,8
24523,Gripadin,tichondrius,384,paladin,retribution,12,4,8
24524,Blikzy,caelestrasz,384,paladin,retribution,12,4,8
24525,Andrevz,ragnaros,384,paladin,retribution,12,4,8
24526,Kiami,tichondrius,384,paladin,retribution,12,4,8
24527,Theril,kelthuzad,384,paladin,retribution,12,4,8
24528,Taelpalx,stormrage,384,paladin,retribution,12,4,8
24529,Crystahlmeth,sargeras,384,paladin,retribution,12,4,8
24530,Msjudged,blackrock,384,paladin,retribution,12,4,8
24531,Adrn,tichondrius,384,paladin,retribution,12,4,8
24532,Returdstrenf,illidan,384,paladin,retribution,12,4,8
24533,Fragnum,barthilas,384,paladin,retribution,12,4,8
24534,Ajulgedang,frostmourne,384,paladin,retribution,12,4,8
24535,Jeddmaus,tichondrius,384,paladin,retribution,12,4,8
24536,Hrizul,drakthul,384,paladin,retribution,12,4,8
24537,Retspec,darkspear,384,paladin,retribution,12,4,8
24538,Lenneth,nordrassil,384,paladin,retribution,12,4,8
24539,Elflicious,illidan,384,paladin,retribution,12,4,8
24540,Prettylightx,kelthuzad,384,paladin,retribution,12,4,8
24541,Rocknpally,icecrown,384,paladin,retribution,12,4,8
24542,Toxanator,frostmourne,384,paladin,retribution,12,4,8
24543,Clariten,ghostlands,384,paladin,retribution,12,4,8
24544,Niolite,ragnaros,384,paladin,retribution,12,4,8
24545,Jimithing,senjin,384,paladin,retribution,12,4,8
24546,Akiralons,ragnaros,384,paladin,retribution,12,4,8
24547,Thaleros,tichondrius,384,paladin,retribution,12,4,8
24548,Moltensilver,emerald-dream,384,paladin,retribution,12,4,8
24549,Rightz,muradin,384,paladin,retribution,12,4,8
24550,Smöke,frostmourne,384,paladin,retribution,12,4,8
24551,Jade,black-dragonflight,384,paladin,retribution,12,4,8
24552,Retneyspears,darkspear,384,paladin,retribution,12,4,8
24553,Smontis,sargeras,384,paladin,retribution,12,4,8
24554,Landryy,icecrown,384,paladin,retribution,12,4,8
24555,Blargnarg,area-52,384,paladin,retribution,12,4,8
24556,Bauldrin,moon-guard,384,paladin,retribution,12,4,8
24557,Billystacks,illidan,384,paladin,retribution,12,4,8
24558,Roundbutts,stormrage,384,paladin,retribution,12,4,8
24559,Acquiesce,bleeding-hollow,384,paladin,retribution,16,5,11
24560,Batmanp,quelthalas,384,paladin,retribution,13,4,9
24561,Talurius,azralon,384,paladin,retribution,18,4,14
24562,Tylnish,hyjal,384,paladin,retribution,18,4,14
24563,Draknals,illidan,384,paladin,retribution,18,4,14
24564,Ccpx,area-52,384,paladin,retribution,18,4,14
24565,Powercelest,quelthalas,384,paladin,retribution,18,4,14
24566,Theadona,runetotem,384,paladin,retribution,18,4,14
24567,Indemnity,wildhammer,384,paladin,retribution,18,4,14
24568,Hupa,crushridge,384,paladin,retribution,18,4,14
24569,Essexqt,blackhand,384,paladin,retribution,18,4,14
24570,Ongang,illidan,384,paladin,retribution,18,4,14
24571,Caityaj,illidan,384,paladin,retribution,18,4,14
24572,Malisaa,tichondrius,384,paladin,retribution,18,4,14
24573,Chuizz,frostmourne,384,paladin,retribution,18,4,14
24574,Mhakoi,bleeding-hollow,384,paladin,retribution,24,4,20
24575,Iskándar,tichondrius,384,paladin,retribution,24,4,20
24576,Hasla,tichondrius,384,paladin,retribution,24,4,20
24577,Backfattammy,bleeding-hollow,384,paladin,retribution,24,4,20
24578,Dabsmaster,dalaran,383,paladin,retribution,6,4,2
24579,Pajjy,azralon,383,paladin,retribution,6,4,2
24580,Sinficha,quelthalas,383,paladin,retribution,6,4,2
24581,Themachon,stormrage,383,paladin,retribution,6,4,2
24582,Brandforge,thunderlord,383,paladin,retribution,6,4,2
24583,Mooroy,moon-guard,383,paladin,retribution,12,4,8
24584,Kennysun,azralon,383,paladin,retribution,12,4,8
24585,Holyqt,thunderlord,383,paladin,retribution,12,4,8
24586,Ginwow,hakkar,383,paladin,retribution,12,4,8
24587,Øexørcistta,nemesis,383,paladin,retribution,12,4,8
24588,Hølydiver,rivendare,383,paladin,retribution,12,4,8
24589,Holyburger,hakkar,383,paladin,retribution,12,4,8
24590,Piojopaladin,quelthalas,383,paladin,retribution,13,4,9
24591,Scyni,kelthuzad,383,paladin,retribution,13,4,9
24592,Balnot,blackrock,383,paladin,retribution,18,4,14
24593,Funkknight,sargeras,383,paladin,retribution,18,4,14
24594,Hadrianus,azralon,383,paladin,retribution,24,4,20
24595,Kenbad,aegwynn,382,paladin,retribution,6,4,2
24596,Lailaa,balnazzar,382,paladin,retribution,12,4,8
24597,Derpnstein,gorgonnash,382,paladin,retribution,12,4,8
24598,Slædgæhæmmær,bonechewer,382,paladin,retribution,18,4,14
24599,Caitlyn,nazjatar,381,paladin,retribution,12,4,8
24600,Sparklepuss,turalyon,379,paladin,retribution,12,4,8
24601,Amerok,malfurion,378,paladin,retribution,18,4,14
24602,Novachrono,bladefist,367,paladin,retribution,9,5,4
24603,Barzø,tichondrius,367,paladin,retribution,11,4,7
24604,Mèdic,illidan,367,paladin,retribution,11,4,7
24605,Goinglarge,frostmourne,367,paladin,retribution,11,4,7
24606,Rétribution,farstriders,367,paladin,retribution,11,4,7
24607,Crucifine,wyrmrest-accord,367,paladin,retribution,11,4,7
24608,Kegmight,emerald-dream,367,paladin,retribution,17,4,13
24609,Mop,eitrigg,367,paladin,retribution,17,4,13
24610,Ssggk,proudmoore,366,paladin,retribution,11,4,7
24611,Bibimbop,boulderfist,352,paladin,retribution,13,5,8
24612,Gordonryan,bleeding-hollow,352,paladin,retribution,16,4,12
24613,Páladian,quelthalas,351,paladin,retribution,11,4,7
24614,Bruujqt,moon-guard,336,paladin,retribution,9,5,4
24615,Titansnake,illidan,336,paladin,retribution,9,4,5
24616,Meduselda,kelthuzad,335,paladin,retribution,9,5,4
24617,Ethernaly,quelthalas,335,paladin,retribution,11,4,7
24618,Kaallell,blackhand,329,paladin,retribution,16,5,11
24619,Asolace,dark-iron,320,paladin,retribution,10,4,6
24620,Wellowar,moon-guard,320,paladin,retribution,10,4,6
24621,Junmá,tichondrius,319,paladin,retribution,5,4,1
24622,Ruulight,tichondrius,319,paladin,retribution,5,4,1
24623,Holyshasha,tichondrius,319,paladin,retribution,8,4,4
24624,Karig,sargeras,319,paladin,retribution,8,4,4
24625,Jadelong,azshara,319,paladin,retribution,8,4,4
24626,Jnxzster,sargeras,319,paladin,retribution,8,4,4
24627,Gryphin,moon-guard,319,paladin,retribution,8,4,4
24628,Holynaps,malganis,319,paladin,retribution,9,4,5
24629,Darkjewmagic,frostmourne,319,paladin,retribution,14,4,10
24630,Torrthak,area-52,304,paladin,retribution,7,4,3
24631,Pipay,proudmoore,288,paladin,retribution,6,3,3
24632,Palinator,bleeding-hollow,288,paladin,retribution,6,3,3
24633,Zakh,proudmoore,288,paladin,retribution,6,3,3
24634,Rickadin,bleeding-hollow,288,paladin,retribution,6,3,3
24635,Moox,wyrmrest-accord,288,paladin,retribution,6,3,3
24636,Lomis,azgalor,288,paladin,retribution,6,3,3
24637,Judgem,tichondrius,288,paladin,retribution,6,3,3
24638,Shakemup,stormrage,288,paladin,retribution,6,3,3
24639,Eleonorr,proudmoore,288,paladin,retribution,6,3,3
24640,Kanachi,bleeding-hollow,288,paladin,retribution,6,3,3
24641,Bíteme,sargeras,288,paladin,retribution,6,3,3
24642,Coldverdict,tichondrius,288,paladin,retribution,6,3,3
24643,Evelimash,bloodhoof,288,paladin,retribution,6,3,3
24644,Borisdablade,bleeding-hollow,288,paladin,retribution,6,3,3
24645,Svenn,eredar,288,paladin,retribution,6,3,3
24646,Basstian,bleeding-hollow,288,paladin,retribution,6,3,3
24647,Brahlix,area-52,288,paladin,retribution,6,3,3
24648,Shibbz,illidan,288,paladin,retribution,6,3,3
24649,Daigorro,illidan,288,paladin,retribution,6,3,3
24650,Halnarran,area-52,288,paladin,retribution,6,3,3
24651,Senisse,illidan,288,paladin,retribution,6,3,3
24652,Purekiller,destromath,288,paladin,retribution,6,3,3
24653,Everith,bleeding-hollow,288,paladin,retribution,6,3,3
24654,Imposstopzc,chogall,288,paladin,retribution,6,3,3
24655,Layson,uldum,288,paladin,retribution,6,3,3
24656,Yugawn,maiev,288,paladin,retribution,6,3,3
24657,Justsaiyen,bleeding-hollow,288,paladin,retribution,6,3,3
24658,Konyfotm,bleeding-hollow,288,paladin,retribution,6,3,3
24659,Astasia,laughing-skull,288,paladin,retribution,6,3,3
24660,Ankhz,area-52,288,paladin,retribution,6,3,3
24661,Pemodyne,illidan,288,paladin,retribution,6,3,3
24662,Syvir,area-52,288,paladin,retribution,6,3,3
24663,Sinhero,area-52,288,paladin,retribution,6,3,3
24664,Varo,laughing-skull,288,paladin,retribution,6,3,3
24665,Sâbër,moon-guard,288,paladin,retribution,6,3,3
24666,Kahleesy,sargeras,288,paladin,retribution,6,3,3
24667,Bigboytime,area-52,288,paladin,retribution,6,3,3
24668,Bubblet,bleeding-hollow,288,paladin,retribution,6,3,3
24669,Nhanless,tichondrius,288,paladin,retribution,6,3,3
24670,Karwryn,magtheridon,288,paladin,retribution,6,3,3
24671,Selivara,zuljin,288,paladin,retribution,6,3,3
24672,Nerfretpls,area-52,288,paladin,retribution,6,3,3
24673,Warchaos,skullcrusher,288,paladin,retribution,6,3,3
24674,Ironboxer,tichondrius,288,paladin,retribution,6,3,3
24675,Sóláris,moon-guard,288,paladin,retribution,6,3,3
24676,Potatopasta,area-52,288,paladin,retribution,6,3,3
24677,Finnthepally,proudmoore,288,paladin,retribution,6,3,3
24678,Lasonil,zuljin,288,paladin,retribution,6,3,3
24679,Valadinna,tichondrius,288,paladin,retribution,6,3,3
24680,Nalenne,alexstrasza,288,paladin,retribution,6,3,3
24681,Mòse,emerald-dream,288,paladin,retribution,6,3,3
24682,Krackanut,kelthuzad,288,paladin,retribution,6,3,3
24683,Leá,illidan,288,paladin,retribution,6,3,3
24684,Buttflapster,proudmoore,288,paladin,retribution,6,3,3
24685,Vynlen,uldaman,288,paladin,retribution,6,3,3
24686,Danks,arthas,288,paladin,retribution,6,3,3
24687,Itzon,proudmoore,288,paladin,retribution,6,3,3
24688,Scamadin,tichondrius,288,paladin,retribution,6,3,3
24689,Reiot,sargeras,288,paladin,retribution,6,3,3
24690,Dfz,mannoroth,288,paladin,retribution,6,3,3
24691,Vük,destromath,288,paladin,retribution,6,3,3
24692,Kegman,thrall,288,paladin,retribution,6,3,3
24693,Taynos,tichondrius,288,paladin,retribution,6,3,3
24694,Nickotines,kelthuzad,288,paladin,retribution,6,3,3
24695,Barbesacrer,zuljin,288,paladin,retribution,6,3,3
24696,Camcam,thrall,288,paladin,retribution,6,3,3
24697,Reallyfe,skullcrusher,288,paladin,retribution,6,3,3
24698,Timu,suramar,288,paladin,retribution,6,3,3
24699,Jeffprobstt,kelthuzad,288,paladin,retribution,6,3,3
24700,Kloernstarr,sargeras,288,paladin,retribution,6,3,3
24701,Rectaluse,dalaran,288,paladin,retribution,6,3,3
24702,Pvar,stormrage,288,paladin,retribution,6,3,3
24703,Brodyb,malganis,288,paladin,retribution,6,3,3
24704,Tadaki,dalaran,288,paladin,retribution,6,3,3
24705,Kyperion,stormrage,288,paladin,retribution,6,3,3
24706,Supreme,farstriders,288,paladin,retribution,6,3,3
24707,Mohrdeth,bonechewer,288,paladin,retribution,6,3,3
24708,Misbah,stormrage,288,paladin,retribution,6,3,3
24709,Doogo,cenarius,288,paladin,retribution,6,3,3
24710,Apocryphx,stormrage,288,paladin,retribution,6,3,3
24711,Berapal,tichondrius,288,paladin,retribution,6,3,3
24712,Uver,tichondrius,288,paladin,retribution,6,3,3
24713,Zeroret,tichondrius,288,paladin,retribution,6,3,3
24714,Xbertiize,tichondrius,288,paladin,retribution,6,3,3
24715,Mcfleye,malganis,288,paladin,retribution,6,3,3
24716,Morlunè,tichondrius,288,paladin,retribution,6,3,3
24717,Assaultron,dalaran,288,paladin,retribution,6,3,3
24718,Zoroastrø,azralon,288,paladin,retribution,6,3,3
24719,Pirofosfato,azralon,288,paladin,retribution,6,3,3
24720,Merphy,tichondrius,288,paladin,retribution,6,3,3
24721,Gloryholy,shattered-hand,288,paladin,retribution,6,3,3
24722,Zugzorr,azralon,288,paladin,retribution,6,3,3
24723,Freiror,azralon,288,paladin,retribution,6,3,3
24724,Beepsmash,executus,288,paladin,retribution,6,3,3
24725,Shaktii,ragnaros,288,paladin,retribution,6,3,3
24726,Kôld,tichondrius,288,paladin,retribution,6,3,3
24727,Lawdeedawh,tichondrius,288,paladin,retribution,6,3,3
24728,Stamptime,emerald-dream,288,paladin,retribution,6,3,3
24729,Marof,spirestone,288,paladin,retribution,6,3,3
24730,Sadamell,tichondrius,288,paladin,retribution,6,3,3
24731,Mvpp,dalaran,288,paladin,retribution,6,3,3
24732,Boladosx,azralon,288,paladin,retribution,6,3,3
24733,Avataar,blades-edge,288,paladin,retribution,6,3,3
24734,Xupalaa,azralon,288,paladin,retribution,6,3,3
24735,Theßest,baelgun,288,paladin,retribution,6,3,3
24736,Dráugus,azralon,288,paladin,retribution,6,3,3
24737,Bigdamham,tichondrius,288,paladin,retribution,6,3,3
24738,Cocodog,kiljaeden,288,paladin,retribution,6,3,3
24739,Lituation,sargeras,288,paladin,retribution,6,3,3
24740,Bigdumpy,thaurissan,288,paladin,retribution,6,3,3
24741,Menjo,malganis,288,paladin,retribution,6,3,3
24742,Ýøg,tichondrius,288,paladin,retribution,6,3,3
24743,Lêggy,moon-guard,288,paladin,retribution,6,3,3
24744,Orangepa,dalaran,288,paladin,retribution,6,3,3
24745,Hypheríon,ragnaros,288,paladin,retribution,6,3,3
24746,Milkmemamma,nordrassil,288,paladin,retribution,6,3,3
24747,Tyronethebbc,tichondrius,288,paladin,retribution,6,3,3
24748,Nussaar,kelthuzad,288,paladin,retribution,6,3,3
24749,Hybrix,tichondrius,288,paladin,retribution,6,3,3
24750,Pauliss,sargeras,288,paladin,retribution,6,3,3
24751,Edjr,stormrage,288,paladin,retribution,6,3,3
24752,Bootacious,tichondrius,288,paladin,retribution,6,3,3
24753,Vincentnero,runetotem,288,paladin,retribution,6,3,3
24754,Wálker,ragnaros,288,paladin,retribution,6,3,3
24755,Mki,kargath,288,paladin,retribution,6,3,3
24756,Nohtu,quelthalas,288,paladin,retribution,6,3,3
24757,Àxçël,hyjal,288,paladin,retribution,6,3,3
24758,Gstbubble,hyjal,288,paladin,retribution,6,3,3
24759,Varezion,vashj,288,paladin,retribution,6,3,3
24760,Deadlyskills,arathor,288,paladin,retribution,6,3,3
24761,Snippdeux,garrosh,288,paladin,retribution,6,3,3
24762,Chiraqret,thunderhorn,288,paladin,retribution,6,3,3
24763,Jojoboskies,aegwynn,288,paladin,retribution,6,3,3
24764,Retsuxks,twisting-nether,288,paladin,retribution,6,3,3
24765,Holyham,bonechewer,288,paladin,retribution,6,3,3
24766,Nevanethus,frostmourne,288,paladin,retribution,6,3,3
24767,Gapingpooter,shadowmoon,288,paladin,retribution,6,3,3
24768,Shockdoctor,stormrage,288,paladin,retribution,6,3,3
24769,Aëriy,moon-guard,288,paladin,retribution,6,3,3
24770,Ulfsark,garrosh,288,paladin,retribution,6,3,3
24771,Darthalion,quelthalas,288,paladin,retribution,6,3,3
24772,Akain,tichondrius,288,paladin,retribution,6,3,3
24773,Zercker,ragnaros,288,paladin,retribution,6,3,3
24774,Rost,jaedenar,288,paladin,retribution,6,3,3
24775,Beato,silvermoon,288,paladin,retribution,6,3,3
24776,Jónò,tichondrius,288,paladin,retribution,6,3,3
24777,Ximenita,ragnaros,288,paladin,retribution,6,3,3
24778,Holyshrekt,frostmourne,288,paladin,retribution,6,3,3
24779,Cairdk,ragnaros,288,paladin,retribution,6,3,3
24780,Tisu,kiljaeden,288,paladin,retribution,6,3,3
24781,Hadory,shattered-halls,288,paladin,retribution,6,3,3
24782,Urpi,drakkari,288,paladin,retribution,6,3,3
24783,Lencelia,deathwing,288,paladin,retribution,6,3,3
24784,Dominance,blackrock,288,paladin,retribution,6,3,3
24785,Lorainn,ragnaros,288,paladin,retribution,6,3,3
24786,Funk,sargeras,288,paladin,retribution,6,3,3
24787,Meith,ragnaros,288,paladin,retribution,6,3,3
24788,Runebane,doomhammer,288,paladin,retribution,6,3,3
24789,Flareous,moon-guard,288,paladin,retribution,6,3,3
24790,Zenpally,doomhammer,288,paladin,retribution,6,3,3
24791,Principe,queldorei,288,paladin,retribution,6,3,3
24792,Nâtion,cenarius,288,paladin,retribution,6,3,3
24793,Bleeked,emerald-dream,288,paladin,retribution,6,3,3
24794,Kithrah,dathremar,288,paladin,retribution,6,3,3
24795,Elri,ragnaros,288,paladin,retribution,6,3,3
24796,Pahlevahn,stormrage,288,paladin,retribution,6,3,3
24797,Luxuriousman,fizzcrank,288,paladin,retribution,6,3,3
24798,Bigdmcgee,frostmourne,288,paladin,retribution,6,3,3
24799,Rebelion,nagrand,288,paladin,retribution,6,3,3
24800,Otame,quelthalas,288,paladin,retribution,6,3,3
24801,Ulrìck,quelthalas,288,paladin,retribution,6,3,3
24802,Nyxkithar,nagrand,288,paladin,retribution,6,3,3
24803,Transwoman,frostmourne,288,paladin,retribution,6,3,3
24804,Dev,frostwolf,288,paladin,retribution,6,3,3
24805,Jestiny,amanthul,288,paladin,retribution,6,3,3
24806,Obbzz,spirestone,288,paladin,retribution,6,3,3
24807,Thortanous,icecrown,288,paladin,retribution,9,4,5
24808,Hermacles,stormrage,288,paladin,retribution,7,3,4
24809,Ivanko,dalaran,288,paladin,retribution,7,3,4
24810,Xanaxlol,sargeras,288,paladin,retribution,10,4,6
24811,Retattack,area-52,288,paladin,retribution,10,4,6
24812,Asukaxt,illidan,288,paladin,retribution,12,3,9
24813,Wälly,garona,288,paladin,retribution,12,3,9
24814,Ucvnt,illidan,288,paladin,retribution,12,3,9
24815,Gashlycrumb,tichondrius,288,paladin,retribution,12,3,9
24816,Jafbe,mugthol,288,paladin,retribution,12,3,9
24817,Gingibeno,tichondrius,288,paladin,retribution,12,3,9
24818,Boopif,sargeras,288,paladin,retribution,12,3,9
24819,Tíron,dalaran,288,paladin,retribution,12,3,9
24820,Olorunn,tichondrius,288,paladin,retribution,12,3,9
24821,Wasabipal,malganis,288,paladin,retribution,12,3,9
24822,Vaaleria,dalaran,288,paladin,retribution,12,3,9
24823,Bigplucker,kelthuzad,288,paladin,retribution,12,3,9
24824,Donsagrado,quelthalas,288,paladin,retribution,12,3,9
24825,Yeluh,malganis,288,paladin,retribution,12,3,9
24826,Vanas,stormrage,288,paladin,retribution,12,3,9
24827,Lungjuice,stormrage,288,paladin,retribution,12,3,9
24828,Grindlimg,dalaran,288,paladin,retribution,12,3,9
24829,Baconsock,kelthuzad,288,paladin,retribution,12,3,9
24830,Bubblebooty,drakthul,288,paladin,retribution,12,3,9
24831,Hahe,tichondrius,288,paladin,retribution,12,3,9
24832,Quelite,sargeras,288,paladin,retribution,12,3,9
24833,Chetmorton,emerald-dream,288,paladin,retribution,12,3,9
24834,Tolleytrain,malganis,288,paladin,retribution,12,3,9
24835,Cromsecrate,dalaran,288,paladin,retribution,12,3,9
24836,Aenwyl,quelthalas,288,paladin,retribution,12,3,9
24837,Dalden,trollbane,288,paladin,retribution,12,3,9
24838,Palâdin,zuljin,288,paladin,retribution,12,3,9
24839,Dárkness,blades-edge,288,paladin,retribution,12,3,9
24840,Corni,kiljaeden,288,paladin,retribution,12,3,9
24841,Geekpala,thrall,288,paladin,retribution,12,3,9
24842,Marrike,moon-guard,288,paladin,retribution,12,3,9
24843,Koltar,stormrage,288,paladin,retribution,12,3,9
24844,Ultrah,area-52,288,paladin,retribution,12,3,9
24845,Kuoch,shandris,288,paladin,retribution,12,3,9
24846,Lue,boulderfist,288,paladin,retribution,12,3,9
24847,Walkerbait,nazgrel,288,paladin,retribution,12,3,9
24848,Spiritkeep,veknilash,288,paladin,retribution,12,3,9
24849,Johnus,lightbringer,288,paladin,retribution,12,3,9
24850,Dävis,ragnaros,288,paladin,retribution,12,3,9
24851,Claudleon,drakkari,288,paladin,retribution,12,3,9
24852,Bulbi,emerald-dream,288,paladin,retribution,12,3,9
24853,Uzbadkhazad,ragnaros,288,paladin,retribution,12,3,9
24854,Nik,the-underbog,288,paladin,retribution,12,3,9
24855,Jontapally,stormrage,288,paladin,retribution,12,3,9
24856,Rxxkiee,tichondrius,288,paladin,retribution,12,3,9
24857,Thnannan,tichondrius,288,paladin,retribution,12,3,9
24858,ßén,bleeding-hollow,288,paladin,retribution,12,3,9
24859,Amega,bleeding-hollow,288,paladin,retribution,12,3,9
24860,Sàber,tichondrius,288,paladin,retribution,12,3,9
24861,Troyamat,nemesis,288,paladin,retribution,12,3,9
24862,Calvary,stormscale,288,paladin,retribution,12,3,9
24863,Sessybrexy,bleeding-hollow,288,paladin,retribution,12,3,9
24864,Oilme,bleeding-hollow,288,paladin,retribution,12,3,9
24865,Madworld,moon-guard,288,paladin,retribution,12,3,9
24866,Unspankable,burning-legion,288,paladin,retribution,12,3,9
24867,Säv,tichondrius,288,paladin,retribution,12,3,9
24868,Homeboywill,hyjal,288,paladin,retribution,12,3,9
24869,Flashstark,area-52,288,paladin,retribution,12,3,9
24870,Tarkovkappa,illidan,288,paladin,retribution,12,3,9
24871,Sivan,crushridge,288,paladin,retribution,12,3,9
24872,Kreigan,hellscream,288,paladin,retribution,12,3,9
24873,Aeltharix,blackwater-raiders,288,paladin,retribution,12,3,9
24874,Mwanmwa,blades-edge,288,paladin,retribution,12,3,9
24875,Kadabrak,area-52,288,paladin,retribution,12,3,9
24876,Bigjoetheceo,mannoroth,288,paladin,retribution,12,3,9
24877,Pallypòwer,garrosh,288,paladin,retribution,12,3,9
24878,Smokeys,sargeras,288,paladin,retribution,12,3,9
24879,Dragonbait,khadgar,288,paladin,retribution,12,3,9
24880,Eljosco,nordrassil,288,paladin,retribution,12,3,9
24881,Slania,area-52,288,paladin,retribution,12,3,9
24882,Kaorah,drakkari,288,paladin,retribution,12,3,9
24883,Aduynn,tichondrius,288,paladin,retribution,12,3,9
24884,Ðeathguise,ysera,288,paladin,retribution,12,3,9
24885,Paladatrox,ragnaros,288,paladin,retribution,12,3,9
24886,Zaeris,proudmoore,288,paladin,retribution,12,3,9
24887,Hardclimacks,frostmourne,288,paladin,retribution,12,3,9
24888,Brutaldeath,area-52,288,paladin,retribution,12,3,9
24889,Kentö,area-52,288,paladin,retribution,12,3,9
24890,Fknnoath,frostmourne,288,paladin,retribution,12,3,9
24891,Treezey,durotan,288,paladin,retribution,12,3,9
24892,Leronos,zuljin,288,paladin,retribution,12,3,9
24893,Theodrei,darrowmere,288,paladin,retribution,12,3,9
24894,Varthinator,stormrage,288,paladin,retribution,12,3,9
24895,Elpal,thrall,288,paladin,retribution,12,3,9
24896,Kelleybelly,black-dragonflight,288,paladin,retribution,13,3,10
24897,Fourchon,tichondrius,288,paladin,retribution,18,3,15
24898,Pepepally,area-52,288,paladin,retribution,18,3,15
24899,Bullworm,ragnaros,288,paladin,retribution,18,3,15
24900,Divinedabs,stormrage,288,paladin,retribution,18,3,15
24901,Whangsta,tichondrius,288,paladin,retribution,24,3,21
24902,Iralyn,frostmane,287,paladin,retribution,6,3,3
24903,Sweetpally,moonrunner,287,paladin,retribution,6,3,3
24904,Kimbr,gallywix,287,paladin,retribution,6,3,3
24905,Matøs,stormrage,287,paladin,retribution,6,3,3
24906,Covidxlx,hakkar,287,paladin,retribution,6,3,3
24907,Dragollias,anvilmar,287,paladin,retribution,12,3,9
24908,Níka,turalyon,287,paladin,retribution,12,3,9
24909,Reathe,llane,287,paladin,retribution,12,3,9
24910,Laylee,anvilmar,287,paladin,retribution,12,3,9
24911,Cruz,silver-hand,286,paladin,retribution,12,3,9
24912,Hukah,darkspear,286,paladin,retribution,18,3,15
24913,Milkmi,frostmourne,271,paladin,retribution,11,3,8
24914,Ronatiú,tichondrius,271,paladin,retribution,11,3,8
24915,Feelmenu,deathwing,271,paladin,retribution,11,3,8
24916,Ôv,norgannon,256,paladin,retribution,4,4,0
24917,Gabrielú,lightninghoof,256,paladin,retribution,10,3,7
24918,Logaen,stormrage,256,paladin,retribution,16,3,13
24919,Gusset,tichondrius,255,paladin,retribution,8,4,4
24920,Wunderbread,dalaran,255,paladin,retribution,11,3,8
24921,Lorgax,alterac-mountains,240,paladin,retribution,9,3,6
24922,Fulgal,jubeithos,240,paladin,retribution,9,3,6
24923,Helberth,stormrage,239,paladin,retribution,5,3,2
24924,Sôsaboy,tichondrius,239,paladin,retribution,5,3,2
24925,Badmix,tichondrius,239,paladin,retribution,5,3,2
24926,Narthres,drakkari,239,paladin,retribution,5,3,2
24927,Palitard,tichondrius,234,paladin,retribution,7,5,2
24928,Swiftysh,ragnaros,234,paladin,retribution,9,4,5
24929,Stinkystan,korgath,234,paladin,retribution,10,4,6
24930,Filoz,ragnaros,234,paladin,retribution,17,5,12
24931,Wainkywink,malganis,234,paladin,retribution,15,4,11
24932,Livalil,chogall,224,paladin,retribution,16,3,13
24933,Wabukis,twisting-nether,223,paladin,retribution,8,3,5
24934,Argonis,shadowsong,223,paladin,retribution,8,3,5
24935,Flynnee,illidan,223,paladin,retribution,8,3,5
24936,Ráky,quelthalas,223,paladin,retribution,14,3,11
24937,Moistsaiyan,blood-furnace,206,paladin,retribution,7,3,4
24938,Keegân,area-52,192,paladin,retribution,4,3,1
24939,Zhspeilian,tichondrius,192,paladin,retribution,11,4,7
24940,Anonymvs,eredar,192,paladin,retribution,9,3,6
24941,Achalius,queldorei,192,paladin,retribution,6,2,4
24942,Moshio,nagrand,192,paladin,retribution,6,2,4
24943,Whyurunning,area-52,192,paladin,retribution,6,2,4
24944,Blessinofsac,nagrand,192,paladin,retribution,6,2,4
24945,Cyliex,illidan,192,paladin,retribution,6,2,4
24946,Issac,tichondrius,192,paladin,retribution,6,2,4
24947,Diänë,ragnaros,192,paladin,retribution,6,2,4
24948,Tyrack,ragnaros,192,paladin,retribution,6,2,4
24949,Roity,proudmoore,192,paladin,retribution,6,2,4
24950,Helioos,stormrage,192,paladin,retribution,6,2,4
24951,Sgtskittles,aggramar,192,paladin,retribution,6,2,4
24952,Outofholy,stormrage,192,paladin,retribution,6,2,4
24953,Vengx,sargeras,192,paladin,retribution,6,2,4
24954,Abivion,stormrage,192,paladin,retribution,6,2,4
24955,Paladam,burning-blade,192,paladin,retribution,6,2,4
24956,Trê,sargeras,192,paladin,retribution,6,2,4
24957,Pushabuton,illidan,192,paladin,retribution,6,2,4
24958,Pallypallyy,aerie-peak,192,paladin,retribution,6,2,4
24959,Ret,onyxia,192,paladin,retribution,6,2,4
24960,Ðuel,area-52,192,paladin,retribution,6,2,4
24961,Felkor,caelestrasz,192,paladin,retribution,6,2,4
24962,Haznthley,proudmoore,192,paladin,retribution,6,2,4
24963,Holypumper,moon-guard,192,paladin,retribution,6,2,4
24964,Legionret,thrall,192,paladin,retribution,6,2,4
24965,Vindified,tichondrius,192,paladin,retribution,6,2,4
24966,Farvadin,illidan,192,paladin,retribution,6,2,4
24967,Réalg,area-52,192,paladin,retribution,6,2,4
24968,Angelscrÿ,stormrage,192,paladin,retribution,6,2,4
24969,Blastoise,drakkari,192,paladin,retribution,6,2,4
24970,Joepepperoni,korgath,192,paladin,retribution,6,2,4
24971,Inexcusable,wyrmrest-accord,192,paladin,retribution,6,2,4
24972,Ezekìël,tichondrius,192,paladin,retribution,6,2,4
24973,Ordinary,greymane,192,paladin,retribution,6,2,4
24974,Juanvaldez,muradin,192,paladin,retribution,6,2,4
24975,Tôhru,ragnaros,192,paladin,retribution,6,2,4
24976,Disastroùs,frostmourne,192,paladin,retribution,6,2,4
24977,Kanyewes,zuluhed,192,paladin,retribution,6,2,4
24978,Xavorn,illidan,192,paladin,retribution,6,2,4
24979,Gasunits,stormrage,192,paladin,retribution,6,2,4
24980,Durotar,ragnaros,192,paladin,retribution,6,2,4
24981,Majinpal,illidan,192,paladin,retribution,6,2,4
24982,Ríf,sargeras,192,paladin,retribution,6,2,4
24983,Octí,quelthalas,192,paladin,retribution,6,2,4
24984,Bøzø,stormrage,192,paladin,retribution,6,2,4
24985,Tysads,darkspear,192,paladin,retribution,6,2,4
24986,Fizzlewig,malganis,192,paladin,retribution,6,2,4
24987,Hølyknìght,tichondrius,192,paladin,retribution,6,2,4
24988,Noscajj,tichondrius,192,paladin,retribution,6,2,4
24989,Tyberas,wyrmrest-accord,192,paladin,retribution,6,2,4
24990,Corthic,area-52,192,paladin,retribution,6,2,4
24991,Baloria,stormrage,192,paladin,retribution,6,2,4
24992,Mickelodeon,sargeras,192,paladin,retribution,6,2,4
24993,Eull,skullcrusher,192,paladin,retribution,6,2,4
24994,Xoppo,tichondrius,192,paladin,retribution,6,2,4
24995,Alkon,quelthalas,192,paladin,retribution,6,2,4
24996,Crânkz,blackrock,192,paladin,retribution,6,2,4
24997,Fairbairn,tichondrius,192,paladin,retribution,6,2,4
24998,Virisanctii,stormrage,192,paladin,retribution,6,2,4
24999,Oxycleän,doomhammer,192,paladin,retribution,6,2,4
25000,Juiicebox,darrowmere,192,paladin,retribution,6,2,4
25001,Lightkillerx,thrall,192,paladin,retribution,6,2,4
25002,Voro,barthilas,192,paladin,retribution,6,2,4
25003,Hyphenated,frostmourne,192,paladin,retribution,6,2,4
25004,Brucitenjr,illidan,192,paladin,retribution,6,2,4
25005,Johnygoodboi,khazgoroth,192,paladin,retribution,6,2,4
25006,Pallylyfe,wyrmrest-accord,192,paladin,retribution,6,2,4
25007,Holypoizan,tichondrius,192,paladin,retribution,6,2,4
25008,Motrîn,sargeras,192,paladin,retribution,6,2,4
25009,Mexipaladin,thrall,192,paladin,retribution,6,2,4
25010,Bigboynathan,frostmourne,192,paladin,retribution,6,2,4
25011,Toto,sargeras,192,paladin,retribution,6,2,4
25012,Crimsonjudge,sargeras,192,paladin,retribution,6,2,4
25013,Aewein,ragnaros,192,paladin,retribution,6,2,4
25014,Sinsy,moon-guard,192,paladin,retribution,6,2,4
25015,Rochet,kiljaeden,192,paladin,retribution,6,2,4
25016,Spanx,blackwing-lair,192,paladin,retribution,6,2,4
25017,Izaacckk,hakkar,192,paladin,retribution,6,2,4
25018,Herbzilla,haomarush,192,paladin,retribution,6,2,4
25019,Ugotburstt,arthas,192,paladin,retribution,6,2,4
25020,Svane,thunderlord,192,paladin,retribution,6,2,4
25021,Retro,magtheridon,192,paladin,retribution,6,2,4
25022,Rây,stormrage,192,paladin,retribution,6,2,4
25023,Drintense,area-52,192,paladin,retribution,6,2,4
25024,Thejüdge,malfurion,192,paladin,retribution,6,2,4
25025,Piousgecko,illidan,192,paladin,retribution,6,2,4
25026,Révolution,barthilas,192,paladin,retribution,6,2,4
25027,Crijr,ragnaros,192,paladin,retribution,6,2,4
25028,Kêy,the-venture-co,192,paladin,retribution,6,2,4
25029,Aválerion,proudmoore,192,paladin,retribution,6,2,4
25030,Omegabubble,garrosh,192,paladin,retribution,6,2,4
25031,Thaidron,area-52,192,paladin,retribution,6,2,4
25032,Oroth,ragnaros,192,paladin,retribution,6,2,4
25033,Varianpally,kelthuzad,192,paladin,retribution,6,2,4
25034,Stainless,magtheridon,192,paladin,retribution,6,2,4
25035,Honeyduw,moon-guard,192,paladin,retribution,6,2,4
25036,Blackflare,undermine,192,paladin,retribution,6,2,4
25037,Vankaer,uldum,192,paladin,retribution,6,2,4
25038,Sigurd,khadgar,192,paladin,retribution,6,2,4
25039,Shanehere,thrall,192,paladin,retribution,6,2,4
25040,Palåth,barthilas,192,paladin,retribution,6,2,4
25041,Morcant,drakkari,192,paladin,retribution,6,2,4
25042,Alphönsë,quelthalas,192,paladin,retribution,6,2,4
25043,Liht,khazgoroth,192,paladin,retribution,6,2,4
25044,Ryuuku,gilneas,192,paladin,retribution,6,2,4
25045,Gordyn,khazgoroth,192,paladin,retribution,6,2,4
25046,Zyden,hellscream,192,paladin,retribution,6,2,4
25047,Stlthykilla,cenarion-circle,192,paladin,retribution,6,2,4
25048,Angeluzlk,quelthalas,192,paladin,retribution,6,2,4
25049,Litjoint,hyjal,192,paladin,retribution,6,2,4
25050,Machoo,laughing-skull,192,paladin,retribution,6,2,4
25051,Greatblade,barthilas,192,paladin,retribution,6,2,4
25052,Mereoleona,elune,192,paladin,retribution,6,2,4
25053,Shaqueefah,illidan,192,paladin,retribution,6,2,4
25054,Hulc,ysera,192,paladin,retribution,6,2,4
25055,Hopebreaker,spinebreaker,192,paladin,retribution,6,2,4
25056,Schooiez,tichondrius,192,paladin,retribution,6,2,4
25057,Lilpally,frostmourne,192,paladin,retribution,6,2,4
25058,Domiet,bleeding-hollow,192,paladin,retribution,6,2,4
25059,Gersin,azralon,192,paladin,retribution,6,2,4
25060,Prèèd,frostmourne,192,paladin,retribution,6,2,4
25061,Alexandros,the-underbog,192,paladin,retribution,6,2,4
25062,Narcolepso,azralon,192,paladin,retribution,6,2,4
25063,Rite,azralon,192,paladin,retribution,6,2,4
25064,Misease,illidan,192,paladin,retribution,6,2,4
25065,Criskaruz,ragnaros,192,paladin,retribution,6,2,4
25066,Pelegroot,azralon,192,paladin,retribution,6,2,4
25067,Adavinn,azjolnerub,192,paladin,retribution,6,2,4
25068,Quinnl,dreadmaul,192,paladin,retribution,6,2,4
25069,Nestus,shuhalo,192,paladin,retribution,6,2,4
25070,Loocille,frostmourne,192,paladin,retribution,6,2,4
25071,Bërzerk,zuluhed,192,paladin,retribution,6,2,4
25072,Hinamattsuri,velen,192,paladin,retribution,6,2,4
25073,Saamuus,quelthalas,192,paladin,retribution,6,2,4
25074,Kigz,illidan,192,paladin,retribution,6,2,4
25075,Gîmply,proudmoore,192,paladin,retribution,6,2,4
25076,Theodden,tichondrius,192,paladin,retribution,6,2,4
25077,Passinpeace,tichondrius,192,paladin,retribution,6,2,4
25078,Parkhwi,tichondrius,192,paladin,retribution,6,2,4
25079,Oxoslayeroxo,firetree,192,paladin,retribution,6,2,4
25080,Snuggymuffin,barthilas,192,paladin,retribution,6,2,4
25081,Mercuryx,tichondrius,192,paladin,retribution,6,2,4
25082,Pállymán,proudmoore,192,paladin,retribution,6,2,4
25083,Hogù,tichondrius,192,paladin,retribution,6,2,4
25084,Zoeyxo,tichondrius,192,paladin,retribution,6,2,4
25085,Forprophet,blackrock,192,paladin,retribution,6,2,4
25086,Heartsend,nerzhul,192,paladin,retribution,6,2,4
25087,Killerspally,area-52,192,paladin,retribution,6,2,4
25088,Lightgasm,alterac-mountains,192,paladin,retribution,6,2,4
25089,Jazzmatic,dalaran,192,paladin,retribution,6,2,4
25090,Moohulk,ragnaros,192,paladin,retribution,6,2,4
25091,Crazymikey,bleeding-hollow,192,paladin,retribution,6,2,4
25092,Buri,tichondrius,192,paladin,retribution,6,2,4
25093,Guelmin,azralon,192,paladin,retribution,6,2,4
25094,Airane,sargeras,192,paladin,retribution,6,2,4
25095,Treizen,frostmourne,192,paladin,retribution,6,2,4
25096,Taddedpally,tichondrius,192,paladin,retribution,6,2,4
25097,Yeshayah,dalaran,192,paladin,retribution,6,2,4
25098,Lilby,lightbringer,192,paladin,retribution,6,2,4
25099,Rekos,zuljin,192,paladin,retribution,6,2,4
25100,Tomackin,quelthalas,192,paladin,retribution,6,2,4
25101,Honeydews,zuljin,192,paladin,retribution,6,2,4
25102,Wreckina,tichondrius,192,paladin,retribution,6,2,4
25103,Ramises,nemesis,192,paladin,retribution,6,2,4
25104,Reepr,tichondrius,192,paladin,retribution,6,2,4
25105,Ohsoclose,bleeding-hollow,192,paladin,retribution,6,2,4
25106,Thunddarr,stormrage,192,paladin,retribution,6,2,4
25107,Repèntance,stormrage,192,paladin,retribution,6,2,4
25108,Chrisqwa,sargeras,192,paladin,retribution,6,2,4
25109,Überlin,whisperwind,192,paladin,retribution,6,2,4
25110,Krabbiepatty,wyrmrest-accord,192,paladin,retribution,6,2,4
25111,Stöny,illidan,192,paladin,retribution,6,2,4
25112,Nicerice,dalaran,192,paladin,retribution,6,2,4
25113,Whittia,wyrmrest-accord,192,paladin,retribution,6,2,4
25114,Felourian,malganis,192,paladin,retribution,6,2,4
25115,Rúdely,tichondrius,192,paladin,retribution,6,2,4
25116,Exalter,malganis,192,paladin,retribution,6,2,4
25117,Astrøworld,sargeras,192,paladin,retribution,6,2,4
25118,Flexedonyou,sentinels,192,paladin,retribution,6,2,4
25119,Granada,kirin-tor,192,paladin,retribution,6,2,4
25120,Stunnaax,frostmourne,192,paladin,retribution,6,2,4
25121,Twatiegodx,malganis,192,paladin,retribution,6,2,4
25122,Cudiskush,tichondrius,192,paladin,retribution,6,2,4
25123,Reivilly,azralon,192,paladin,retribution,6,2,4
25124,Smolbeef,tichondrius,192,paladin,retribution,6,2,4
25125,Dithfeo,tichondrius,192,paladin,retribution,6,2,4
25126,Cïelo,dragonmaw,192,paladin,retribution,6,2,4
25127,Invïctus,dalaran,192,paladin,retribution,6,2,4
25128,Sweettartts,zuljin,192,paladin,retribution,6,2,4
25129,Joshington,stormrage,192,paladin,retribution,6,2,4
25130,Blackbeerd,stormrage,192,paladin,retribution,6,2,4
25131,Gwff,tichondrius,192,paladin,retribution,6,2,4
25132,Ookcoo,tichondrius,192,paladin,retribution,6,2,4
25133,Desterro,quelthalas,192,paladin,retribution,6,2,4
25134,Alasper,malganis,192,paladin,retribution,6,2,4
25135,Hafra,zuljin,192,paladin,retribution,6,2,4
25136,Guacamello,emerald-dream,192,paladin,retribution,6,2,4
25137,Madnhairy,zuljin,192,paladin,retribution,6,2,4
25138,Paintpumper,malganis,192,paladin,retribution,6,2,4
25139,Shebas,kilrogg,192,paladin,retribution,6,2,4
25140,Crosjudge,zuljin,192,paladin,retribution,6,2,4
25141,Omensageiro,azralon,192,paladin,retribution,6,2,4
25142,Ghatte,azralon,192,paladin,retribution,6,2,4
25143,Malakk,zuljin,192,paladin,retribution,6,2,4
25144,Jaok,tichondrius,192,paladin,retribution,6,2,4
25145,Dynastyhero,area-52,192,paladin,retribution,6,2,4
25146,Freslys,zuljin,192,paladin,retribution,6,2,4
25147,Chombe,tichondrius,192,paladin,retribution,6,2,4
25148,Verzuhazadon,tichondrius,192,paladin,retribution,6,2,4
25149,Mazexd,illidan,192,paladin,retribution,6,2,4
25150,Psychlight,quelthalas,192,paladin,retribution,6,2,4
25151,Spyglas,quelthalas,192,paladin,retribution,6,2,4
25152,Byonsay,zuljin,192,paladin,retribution,6,2,4
25153,Neydisa,sargeras,192,paladin,retribution,6,2,4
25154,Aleio,moon-guard,192,paladin,retribution,6,2,4
25155,Sac,sargeras,192,paladin,retribution,6,2,4
25156,Yedema,tichondrius,192,paladin,retribution,6,2,4
25157,Capedcrusade,area-52,192,paladin,retribution,6,2,4
25158,Bigdret,moon-guard,192,paladin,retribution,6,2,4
25159,Grim,eonar,192,paladin,retribution,6,2,4
25160,Armasexodus,barthilas,192,paladin,retribution,6,2,4
25161,Quiznossubs,kelthuzad,192,paladin,retribution,6,2,4
25162,Petsmacker,dalaran,192,paladin,retribution,6,2,4
25163,Whataio,tichondrius,192,paladin,retribution,6,2,4
25164,Mynnorath,emerald-dream,192,paladin,retribution,6,2,4
25165,Roseheart,emerald-dream,192,paladin,retribution,6,2,4
25166,Avengzeus,tichondrius,192,paladin,retribution,6,2,4
25167,Brand,emerald-dream,192,paladin,retribution,6,2,4
25168,Oynx,emerald-dream,192,paladin,retribution,6,2,4
25169,Lxwd,tichondrius,192,paladin,retribution,6,2,4
25170,Strîkes,emerald-dream,192,paladin,retribution,6,2,4
25171,Solånar,bloodscalp,192,paladin,retribution,7,2,5
25172,Jessecash,tichondrius,192,paladin,retribution,12,3,9
25173,Takz,daggerspine,192,paladin,retribution,8,2,6
25174,Murgly,tichondrius,192,paladin,retribution,8,2,6
25175,Azajudgeman,nemesis,192,paladin,retribution,9,2,7
25176,Sïncere,frostmourne,192,paladin,retribution,12,2,10
25177,Dánteé,ragnaros,192,paladin,retribution,12,2,10
25178,Cronodxl,quelthalas,192,paladin,retribution,12,2,10
25179,Yawnday,farstriders,192,paladin,retribution,12,2,10
25180,Seltzer,tichondrius,192,paladin,retribution,12,2,10
25181,Supermetroid,vashj,192,paladin,retribution,12,2,10
25182,Vantz,tichondrius,192,paladin,retribution,12,2,10
25183,Ricopal,frostmourne,192,paladin,retribution,12,2,10
25184,Rîf,malganis,192,paladin,retribution,12,2,10
25185,Disconnect,azjolnerub,192,paladin,retribution,12,2,10
25186,Rayli,dalaran,192,paladin,retribution,12,2,10
25187,Twodkittyy,kelthuzad,192,paladin,retribution,12,2,10
25188,Dirtfunk,illidan,192,paladin,retribution,12,2,10
25189,Goomie,icecrown,192,paladin,retribution,12,2,10
25190,Anahl,icecrown,192,paladin,retribution,12,2,10
25191,Grimsfate,emerald-dream,192,paladin,retribution,12,2,10
25192,Clrty,area-52,192,paladin,retribution,12,2,10
25193,Arminhamer,sargeras,192,paladin,retribution,12,2,10
25194,Xinoh,area-52,192,paladin,retribution,12,2,10
25195,Seratox,illidan,192,paladin,retribution,12,2,10
25196,Bubzfordubz,sargeras,192,paladin,retribution,12,2,10
25197,Cabacarl,quelthalas,192,paladin,retribution,12,2,10
25198,Lamer,proudmoore,192,paladin,retribution,12,2,10
25199,Alyosya,barthilas,192,paladin,retribution,12,2,10
25200,Holyshifts,exodar,192,paladin,retribution,12,2,10
25201,Criixx,malganis,192,paladin,retribution,12,2,10
25202,Renorhal,moon-guard,192,paladin,retribution,12,2,10
25203,Sleepybiden,darkspear,192,paladin,retribution,12,2,10
25204,Ghratadin,bleeding-hollow,192,paladin,retribution,12,2,10
25205,Aetol,proudmoore,192,paladin,retribution,12,2,10
25206,Elarilein,emerald-dream,192,paladin,retribution,12,2,10
25207,Milfcrusader,tichondrius,192,paladin,retribution,12,2,10
25208,Slithix,stormreaver,192,paladin,retribution,12,2,10
25209,Trippierett,bloodscalp,192,paladin,retribution,12,2,10
25210,Kaiyleigh,sargeras,192,paladin,retribution,12,2,10
25211,Holyelfs,boulderfist,192,paladin,retribution,12,2,10
25212,Fazoéli,stormrage,192,paladin,retribution,12,2,10
25213,Goldfaith,sargeras,192,paladin,retribution,12,2,10
25214,Paladocka,stormrage,192,paladin,retribution,12,2,10
25215,Matrium,kiljaeden,192,paladin,retribution,18,2,16
25216,Dorisseline,emerald-dream,192,paladin,retribution,18,2,16
25217,Imnoracist,thrall,192,paladin,retribution,18,2,16
25218,Runandhide,aerie-peak,192,paladin,retribution,18,2,16
25219,Túss,khazgoroth,191,paladin,retribution,6,2,4
25220,Vegetå,malganis,180,paladin,retribution,31,6,25
25221,Thugmuffin,thrall,176,paladin,retribution,7,3,4
25222,Wokeinator,malganis,175,paladin,retribution,11,3,8
25223,Baalduru,borean-tundra,175,paladin,retribution,11,2,9
25224,Laysonus,moon-guard,169,paladin,retribution,11,4,7
25225,Bubbletop,tichondrius,169,paladin,retribution,11,4,7
25226,Nalahra,moon-guard,159,paladin,retribution,5,2,3
25227,Sorgeno,ursin,159,paladin,retribution,5,2,3
25228,Zyllo,area-52,159,paladin,retribution,5,2,3
25229,Ubbhe,quelthalas,159,paladin,retribution,5,2,3
25230,Zoobro,tichondrius,159,paladin,retribution,5,2,3
25231,Whoopsie,dragonmaw,159,paladin,retribution,5,2,3
25232,Prïmavera,azralon,159,paladin,retribution,5,2,3
25233,Beelzebøss,frostmourne,159,paladin,retribution,5,2,3
25234,Kaorii,mannoroth,159,paladin,retribution,5,2,3
25235,Bringbackrmp,tichondrius,159,paladin,retribution,5,2,3
25236,Luðo,moon-guard,159,paladin,retribution,5,2,3
25237,Pallydeen,illidan,159,paladin,retribution,5,2,3
25238,Vero,agamaggan,159,paladin,retribution,17,2,15
25239,Whiplashlol,frostwolf,144,paladin,retribution,3,3,0
25240,Holeesheett,tichondrius,144,paladin,retribution,9,2,7
25241,Ájummalukout,tichondrius,138,paladin,retribution,9,3,6
25242,Åddict,kelthuzad,138,paladin,retribution,10,3,7
25243,Iæl,stormrage,138,paladin,retribution,10,3,7
25244,Dathromir,stormrage,138,paladin,retribution,15,3,12
25245,Bubbleosèven,tichondrius,138,paladin,retribution,16,3,13
25246,Modafinil,bonechewer,138,paladin,retribution,20,3,17
25247,Sweetbunz,altar-of-storms,128,paladin,retribution,4,2,2
25248,Mikwa,ragnaros,128,paladin,retribution,4,2,2
25249,Stârfôx,area-52,128,paladin,retribution,4,2,2
25250,Molodino,nemesis,128,paladin,retribution,4,2,2
25251,Sofiora,thunderlord,128,paladin,retribution,10,2,8
25252,Khileeha,sargeras,128,paladin,retribution,10,2,8
25253,Celerios,stormreaver,127,paladin,retribution,8,2,6
25254,Gaismagorm,ragnaros,96,paladin,retribution,3,2,1
25255,Utho,wyrmrest-accord,96,paladin,retribution,3,2,1
25256,Swordstrikes,tichondrius,96,paladin,retribution,3,2,1
25257,Dazak,ragnaros,96,paladin,retribution,3,2,1
25258,Tsunin,area-52,96,paladin,retribution,3,2,1
25259,Shalith,thrall,96,paladin,retribution,3,2,1
25260,Simple,ghostlands,96,paladin,retribution,16,3,13
25261,Luiiguii,drakkari,96,paladin,retribution,6,1,5
25262,Chakin,burning-legion,96,paladin,retribution,6,1,5
25263,Aldwyn,deathwing,96,paladin,retribution,6,1,5
25264,Minjikim,tichondrius,96,paladin,retribution,6,1,5
25265,Carloss,drakkari,96,paladin,retribution,6,1,5
25266,Rg,nerzhul,96,paladin,retribution,6,1,5
25267,Meanervini,kiljaeden,96,paladin,retribution,6,1,5
25268,Ariolo,baelgun,96,paladin,retribution,6,1,5
25269,Tazzul,turalyon,96,paladin,retribution,6,1,5
25270,Parts,aerie-peak,96,paladin,retribution,6,1,5
25271,Këys,earthen-ring,96,paladin,retribution,6,1,5
25272,Fistopain,staghelm,96,paladin,retribution,6,1,5
25273,Sóapbubble,tichondrius,96,paladin,retribution,6,1,5
25274,Tehbeasty,hyjal,96,paladin,retribution,6,1,5
25275,Urudith,azralon,96,paladin,retribution,6,1,5
25276,Chøcølatte,azralon,96,paladin,retribution,6,1,5
25277,Wilmâ,ragnaros,96,paladin,retribution,6,1,5
25278,Phokboi,shattered-hand,96,paladin,retribution,6,1,5
25279,Lettuceprey,the-underbog,96,paladin,retribution,6,1,5
25280,Lightmessiah,perenolde,96,paladin,retribution,6,1,5
25281,Goksuu,ragnaros,96,paladin,retribution,6,1,5
25282,Saffuki,frostmourne,96,paladin,retribution,6,1,5
25283,Zwilliam,frostmourne,96,paladin,retribution,6,1,5
25284,Smudgexy,frostmourne,96,paladin,retribution,6,1,5
25285,Liongolden,azralon,96,paladin,retribution,6,1,5
25286,Xkillz,korgath,96,paladin,retribution,6,1,5
25287,Phelix,lightninghoof,96,paladin,retribution,6,1,5
25288,Conámi,ragnaros,96,paladin,retribution,6,1,5
25289,Ashlane,tichondrius,96,paladin,retribution,6,1,5
25290,Adobro,tichondrius,96,paladin,retribution,6,1,5
25291,Retsarro,frostmourne,96,paladin,retribution,6,1,5
25292,Rodrigo,frostmourne,96,paladin,retribution,6,1,5
25293,Kënsi,quelthalas,96,paladin,retribution,6,1,5
25294,Partenna,quelthalas,96,paladin,retribution,6,1,5
25295,Daukan,quelthalas,96,paladin,retribution,6,1,5
25296,Acpally,tichondrius,96,paladin,retribution,6,1,5
25297,Riçky,tichondrius,96,paladin,retribution,6,1,5
25298,Coffeebean,quelthalas,96,paladin,retribution,6,1,5
25299,Cots,azralon,96,paladin,retribution,6,1,5
25300,Deviill,winterhoof,96,paladin,retribution,6,1,5
25301,Fourwives,sargeras,96,paladin,retribution,6,1,5
25302,Warhero,sargeras,96,paladin,retribution,6,1,5
25303,Ashlïe,moon-guard,96,paladin,retribution,6,1,5
25304,Daelann,moon-guard,96,paladin,retribution,6,1,5
25305,Bravsirrobin,firetree,96,paladin,retribution,6,1,5
25306,Maeyz,sargeras,96,paladin,retribution,6,1,5
25307,Donoph,blades-edge,96,paladin,retribution,6,1,5
25308,Retrib,tichondrius,96,paladin,retribution,6,1,5
25309,Fpaladin,tichondrius,96,paladin,retribution,6,1,5
25310,Giita,quelthalas,96,paladin,retribution,6,1,5
25311,Dûälïpä,barthilas,96,paladin,retribution,6,1,5
25312,Marcovk,quelthalas,96,paladin,retribution,6,1,5
25313,Lòuisvuttion,tichondrius,96,paladin,retribution,6,1,5
25314,Solambul,tichondrius,96,paladin,retribution,6,1,5
25315,Tehgodofdmg,tichondrius,96,paladin,retribution,6,1,5
25316,Erindor,emerald-dream,96,paladin,retribution,6,1,5
25317,Brynleigh,malganis,96,paladin,retribution,6,1,5
25318,Mentalíssues,moon-guard,96,paladin,retribution,6,1,5
25319,Boundric,emerald-dream,96,paladin,retribution,6,1,5
25320,Yesdaddyxo,emerald-dream,96,paladin,retribution,6,1,5
25321,Yøu,tichondrius,96,paladin,retribution,6,1,5
25322,Angusbeef,hyjal,96,paladin,retribution,6,1,5
25323,Flashbubble,sargeras,96,paladin,retribution,6,1,5
25324,Rodt,dalaran,96,paladin,retribution,6,1,5
25325,Mugann,malganis,96,paladin,retribution,6,1,5
25326,Desrexen,malganis,96,paladin,retribution,6,1,5
25327,Cupidxbye,tichondrius,96,paladin,retribution,6,1,5
25328,Scrubdin,illidan,96,paladin,retribution,6,1,5
25329,Burom,kelthuzad,96,paladin,retribution,6,1,5
25330,Krelya,ragnaros,96,paladin,retribution,6,1,5
25331,Beebopper,illidan,96,paladin,retribution,6,1,5
25332,Bosmoklikdat,moon-guard,96,paladin,retribution,6,1,5
25333,Synnderilla,wyrmrest-accord,96,paladin,retribution,6,1,5
25334,Kaylafell,kelthuzad,96,paladin,retribution,6,1,5
25335,Zulzander,kelthuzad,96,paladin,retribution,6,1,5
25336,Aragonns,illidan,96,paladin,retribution,6,1,5
25337,Astraelon,bleeding-hollow,96,paladin,retribution,6,1,5
25338,Asellusarc,kelthuzad,96,paladin,retribution,6,1,5
25339,Slantee,illidan,96,paladin,retribution,6,1,5
25340,Tradalia,illidan,96,paladin,retribution,6,1,5
25341,Sneakycastro,bleeding-hollow,96,paladin,retribution,6,1,5
25342,Nytto,lightnings-blade,96,paladin,retribution,6,1,5
25343,Kytheon,zuluhed,96,paladin,retribution,6,1,5
25344,Bubbllicious,thrall,96,paladin,retribution,6,1,5
25345,Palajem,stormrage,96,paladin,retribution,6,1,5
25346,Gazef,proudmoore,96,paladin,retribution,6,1,5
25347,Shamashjoel,black-dragonflight,96,paladin,retribution,6,1,5
25348,Sleyn,stormrage,96,paladin,retribution,6,1,5
25349,Ownedcrazy,stormrage,96,paladin,retribution,6,1,5
25350,Justtrollin,black-dragonflight,96,paladin,retribution,6,1,5
25351,Ssjgodvy,illidan,96,paladin,retribution,6,1,5
25352,Airndel,illidan,96,paladin,retribution,6,1,5
25353,Chapichapi,illidan,96,paladin,retribution,6,1,5
25354,Amazarak,stormrage,96,paladin,retribution,6,1,5
25355,Thòrisòn,stormrage,96,paladin,retribution,6,1,5
25356,Skeeta,area-52,96,paladin,retribution,6,1,5
25357,Maldobarr,stormrage,96,paladin,retribution,6,1,5
25358,Sunnix,illidan,96,paladin,retribution,6,1,5
25359,Dafoq,stormrage,96,paladin,retribution,6,1,5
25360,Chainjustice,area-52,96,paladin,retribution,6,1,5
25361,Paldan,illidan,96,paladin,retribution,6,1,5
25362,Thumos,sargeras,96,paladin,retribution,6,1,5
25363,Skadooshh,illidan,96,paladin,retribution,6,1,5
25364,Holyxsmokes,illidan,96,paladin,retribution,6,1,5
25365,Orthín,stormrage,96,paladin,retribution,6,1,5
25366,Scah,illidan,96,paladin,retribution,6,1,5
25367,Serazan,moon-guard,96,paladin,retribution,6,1,5
25368,Valadinn,tichondrius,96,paladin,retribution,6,1,5
25369,Nvrbubble,area-52,96,paladin,retribution,6,1,5
25370,Scarllye,illidan,96,paladin,retribution,6,1,5
25371,Samsaratry,proudmoore,96,paladin,retribution,6,1,5
25372,Franchy,stormrage,96,paladin,retribution,6,1,5
25373,Tenethor,area-52,96,paladin,retribution,6,1,5
25374,Terppy,stormrage,96,paladin,retribution,6,1,5
25375,Kamakazê,sargeras,96,paladin,retribution,6,1,5
25376,Smïthh,area-52,96,paladin,retribution,6,1,5
25377,Chuggawhugga,area-52,96,paladin,retribution,6,1,5
25378,Alk,windrunner,96,paladin,retribution,6,1,5
25379,Duecesz,area-52,96,paladin,retribution,6,1,5
25380,Chawbanger,proudmoore,96,paladin,retribution,6,1,5
25381,Djset,blackhand,96,paladin,retribution,6,1,5
25382,Tooshka,azshara,96,paladin,retribution,6,1,5
25383,Retski,thrall,96,paladin,retribution,6,1,5
25384,Zealotry,tichondrius,96,paladin,retribution,6,1,5
25385,Ahrieze,moon-guard,96,paladin,retribution,6,1,5
25386,Sanddor,moon-guard,96,paladin,retribution,6,1,5
25387,Pipesmoke,dunemaul,96,paladin,retribution,6,1,5
25388,Balloony,stormrage,96,paladin,retribution,6,1,5
25389,Cyona,gallywix,96,paladin,retribution,6,1,5
25390,Retx,arthas,96,paladin,retribution,6,1,5
25391,Scuffedhoj,tichondrius,96,paladin,retribution,6,1,5
25392,Krulu,thrall,96,paladin,retribution,6,1,5
25393,Gressilin,arthas,96,paladin,retribution,6,1,5
25394,Holyclapzy,stormrage,96,paladin,retribution,6,1,5
25395,Darksaint,hellscream,96,paladin,retribution,6,1,5
25396,Jüstice,tichondrius,96,paladin,retribution,6,1,5
25397,Talahar,boulderfist,96,paladin,retribution,6,1,5
25398,Holythanos,bleeding-hollow,96,paladin,retribution,6,1,5
25399,Bruwdblood,bleeding-hollow,96,paladin,retribution,6,1,5
25400,Gdesign,tichondrius,96,paladin,retribution,6,1,5
25401,Coltoniac,kaelthas,96,paladin,retribution,6,1,5
25402,Judgémental,bleeding-hollow,96,paladin,retribution,6,1,5
25403,Goodwood,ghostlands,96,paladin,retribution,6,1,5
25404,Shádøwy,nemesis,96,paladin,retribution,6,1,5
25405,Ryudoshël,nemesis,96,paladin,retribution,6,1,5
25406,Actionman,bleeding-hollow,96,paladin,retribution,6,1,5
25407,Pùteduvilage,zuljin,96,paladin,retribution,6,1,5
25408,Odos,zuljin,96,paladin,retribution,6,1,5
25409,Momhips,bloodscalp,96,paladin,retribution,6,1,5
25410,Laelias,lightbringer,96,paladin,retribution,6,1,5
25411,Bigshaftt,gorgonnash,96,paladin,retribution,6,1,5
25412,Lowther,bleeding-hollow,96,paladin,retribution,6,1,5
25413,Càséy,zuljin,96,paladin,retribution,6,1,5
25414,Brank,agamaggan,96,paladin,retribution,6,1,5
25415,Poeboyz,stormrage,96,paladin,retribution,6,1,5
25416,Kregar,kelthuzad,96,paladin,retribution,7,1,6
25417,Lelythia,bleeding-hollow,96,paladin,retribution,7,1,6
25418,Trinkysteve,frostmane,96,paladin,retribution,7,1,6
25419,Zatoci,shadowsong,96,paladin,retribution,11,1,10
25420,Shamo,stormreaver,96,paladin,retribution,12,1,11
25421,Yoropal,tichondrius,96,paladin,retribution,12,1,11
25422,Firexfist,gurubashi,96,paladin,retribution,12,1,11
25423,Axiskai,gorgonnash,96,paladin,retribution,12,1,11
25424,Lorenzojr,sargeras,96,paladin,retribution,12,1,11
25425,Yobnai,zuljin,96,paladin,retribution,12,1,11
25426,Séykän,ragnaros,96,paladin,retribution,12,1,11
25427,Hojpocketx,tichondrius,96,paladin,retribution,12,1,11
25428,Æpaldin,tichondrius,96,paladin,retribution,12,1,11
25429,Hondacivicsi,mannoroth,96,paladin,retribution,12,1,11
25430,Oshia,destromath,96,paladin,retribution,12,1,11
25431,Catholica,tichondrius,96,paladin,retribution,12,1,11
25432,Zalacar,azralon,96,paladin,retribution,12,1,11
25433,Roosterface,azjolnerub,96,paladin,retribution,12,1,11
25434,Whosyourdady,azjolnerub,96,paladin,retribution,12,1,11
25435,Rimorse,illidan,96,paladin,retribution,12,1,11
25436,Reinhardburm,quelthalas,96,paladin,retribution,12,1,11
25437,Geykum,tichondrius,96,paladin,retribution,17,1,16
25438,Hottest,wyrmrest-accord,84,paladin,retribution,13,5,8
25439,Torms,illidan,79,paladin,retribution,3,3,0
25440,Laydarus,frostmourne,79,paladin,retribution,5,1,4
25441,Taego,tichondrius,79,paladin,retribution,5,1,4
25442,Goldieg,tichondrius,79,paladin,retribution,5,1,4
25443,Bowdown,wildhammer,79,paladin,retribution,5,1,4
25444,Ryxxi,sargeras,79,paladin,retribution,5,1,4
25445,Divinetoco,stormrage,79,paladin,retribution,5,1,4
25446,Hivers,stormrage,79,paladin,retribution,11,1,10
25447,Sondaar,madoran,73,paladin,retribution,17,3,14
25448,Dronedròp,illidan,63,paladin,retribution,2,2,0
25449,Piston,kiljaeden,63,paladin,retribution,2,2,0
25450,Belenor,quelthalas,63,paladin,retribution,2,2,0
25451,Jerseÿ,sargeras,48,paladin,retribution,3,1,2
25452,Eljefee,emerald-dream,42,paladin,retribution,11,3,8
25453,Thisissus,tichondrius,42,paladin,retribution,8,2,6
25454,Dabakle,stormrage,42,paladin,retribution,8,2,6
25455,Newwow,tichondrius,42,paladin,retribution,9,2,7
25456,Pearlx,ragnaros,42,paladin,retribution,10,2,8
25457,Voncruz,proudmoore,42,paladin,retribution,12,2,10
25458,Patrious,moon-guard,31,paladin,retribution,2,1,1
25459,Gorila,stormrage,31,paladin,retribution,2,1,1
25460,Bluether,sargeras,16,paladin,retribution,1,1,0
25461,Naizen,tichondrius,16,paladin,retribution,1,1,0
25462,ßleider,quelthalas,1906,paladin,protection,55,39,16
25463,Ëlmaster,nemesis,1831,paladin,protection,126,80,46
25464,Degenratebri,moon-guard,1779,paladin,protection,53,39,14
25465,Aluvia,malygos,1741,paladin,protection,70,50,20
25466,Zhspeilian,tichondrius,1730,paladin,protection,84,47,37
25467,Höpönpöppö,frostmourne,1729,paladin,protection,48,26,22
25468,Crâfty,bleeding-hollow,1717,paladin,protection,101,55,46
25469,Motates,malganis,1706,paladin,protection,93,48,45
25470,Kierolechita,ragnaros,1677,paladin,protection,226,116,110
25471,Uglyboyryan,sargeras,1666,paladin,protection,96,55,41
25472,Eclipsor,bleeding-hollow,1657,paladin,protection,48,30,18
25473,Vondonna,moon-guard,1655,paladin,protection,113,65,48
25474,Aopidsfihjov,stormrage,1649,paladin,protection,48,34,14
25475,Sôlux,quelthalas,1638,paladin,protection,56,31,25
25476,Lxwd,tichondrius,1636,paladin,protection,131,66,65
25477,Sutadansa,doomhammer,1632,paladin,protection,146,71,75
25478,Jimmipepe,quelthalas,1622,paladin,protection,48,31,17
25479,Bighardshock,aggramar,1610,paladin,protection,30,18,12
25480,Sigmapepe,quelthalas,1605,paladin,protection,42,26,16
25481,Zephyrvalor,sargeras,1601,paladin,protection,146,69,77
25482,Blackmiya,tichondrius,1570,paladin,protection,31,20,11
25483,Øziris,goldrinn,1567,paladin,protection,74,33,41
25484,Rehtua,bleeding-hollow,1557,paladin,protection,83,35,48
25485,Aeythyr,wyrmrest-accord,1495,paladin,protection,54,27,27
25486,Chozverialyz,ysondre,1494,paladin,protection,68,32,36
25487,Borrus,malygos,1480,paladin,protection,36,19,17
25488,Modafinil,bonechewer,1455,paladin,protection,111,53,58
25489,Zexion,azralon,1450,paladin,protection,45,19,26
25490,Wowmike,sargeras,1434,paladin,protection,60,28,32
25491,Íaan,drakkari,1433,paladin,protection,70,43,27
25492,Domocho,azgalor,1417,paladin,protection,42,22,20
25493,Cusino,tichondrius,1412,paladin,protection,44,22,22
25494,Arcilys,illidan,1398,paladin,protection,60,29,31
25495,Bt,quelthalas,1376,paladin,protection,41,25,16
25496,Rakasho,azralon,1370,paladin,protection,60,23,37
25497,Almeta,kelthuzad,1350,paladin,protection,36,18,18
25498,Goldjade,khazgoroth,1344,paladin,protection,77,30,47
25499,Goeun,destromath,1342,paladin,protection,31,15,16
25500,Stormvikingx,darkspear,1336,paladin,protection,24,14,10
25501,Khrome,cenarion-circle,1328,paladin,protection,134,44,90
25502,Herimi,drakkari,1324,paladin,protection,71,27,44
25503,Jkethuhsnake,ghostlands,1306,paladin,protection,51,31,20
25504,Poorly,thorium-brotherhood,1292,paladin,protection,30,16,14
25505,Lythos,dathremar,1286,paladin,protection,36,17,19
25506,Thorsmites,sargeras,1273,paladin,protection,48,18,30
25507,Dankerton,tichondrius,1259,paladin,protection,22,14,8
25508,Ronor,thorium-brotherhood,1219,paladin,protection,30,14,16
25509,Imthabromb,dragonblight,1206,paladin,protection,35,18,17
25510,Lelythia,bleeding-hollow,1161,paladin,protection,65,25,40
25511,Palahogx,sargeras,1150,paladin,protection,24,12,12
25512,Gredo,queldorei,1070,paladin,protection,17,12,5
25513,Zakh,proudmoore,1053,paladin,protection,18,11,7
25514,Penitent,barthilas,1052,paladin,protection,18,11,7
25515,Bullivan,sisters-of-elune,963,paladin,protection,40,14,26
25516,Bubblemark,tichondrius,959,paladin,protection,24,10,14
25517,Strontimus,moon-guard,958,paladin,protection,12,10,2
25518,Ndnpaly,bonechewer,953,paladin,protection,12,10,2
25519,Ratzon,dalaran,950,paladin,protection,18,10,8
25520,Matadore,arygos,908,paladin,protection,22,11,11
25521,Chanimalf,tichondrius,880,paladin,protection,13,10,3
25522,Alexcydragon,quelthalas,863,paladin,protection,18,9,9
25523,Hittit,thrall,859,paladin,protection,30,9,21
25524,Negativeiq,moon-guard,798,paladin,protection,10,10,0
25525,Protdream,tichondrius,768,paladin,protection,12,8,4
25526,Courageousz,dalaran,768,paladin,protection,18,8,10
25527,Crusâder,area-52,767,paladin,protection,24,8,16
25528,Lothwrynn,senjin,762,paladin,protection,18,8,10
25529,Kittié,proudmoore,760,paladin,protection,30,8,22
25530,Halnoth,dethecus,702,paladin,protection,11,8,3
25531,Valkaire,area-52,671,paladin,protection,12,7,5
25532,Dirkdigglerz,bleeding-hollow,670,paladin,protection,18,7,11
25533,Whëëls,stormreaver,576,paladin,protection,12,6,6
25534,Sølis,alleria,576,paladin,protection,12,6,6
25535,Danthorin,malfurion,575,paladin,protection,24,6,18
25536,Gotankz,moon-guard,480,paladin,protection,12,5,7
25537,Kiehui,lightbringer,480,paladin,protection,12,5,7
25538,Bullmarket,tichondrius,480,paladin,protection,18,5,13
25539,Lewstelamon,korialstrasz,446,paladin,protection,10,6,4
25540,Typhoontravv,thrall,384,paladin,protection,6,4,2
25541,Holyknight,veknilash,384,paladin,protection,14,5,9
25542,Xbloodknight,malganis,384,paladin,protection,12,4,8
25543,Gîmply,proudmoore,384,paladin,protection,12,4,8
25544,Belmorlin,moon-guard,384,paladin,protection,12,4,8
25545,Bullheaded,silvermoon,384,paladin,protection,12,4,8
25546,Jahirie,aegwynn,351,paladin,protection,17,4,13
25547,Isecretly,stormrage,335,paladin,protection,7,7,0
25548,Trâgedy,azjolnerub,288,paladin,protection,6,3,3
25549,Thortanous,icecrown,288,paladin,protection,6,3,3
25550,Kooshh,thunderlord,288,paladin,protection,12,3,9
25551,Urfavxbf,baelgun,288,paladin,protection,13,3,10
25552,Saeranella,moon-guard,240,paladin,protection,9,3,6
25553,Blâckhârt,saurfang,234,paladin,protection,9,4,5
25554,Tankfest,sargeras,192,paladin,protection,6,2,4
25555,Xinqingle,tichondrius,192,paladin,protection,6,2,4
25556,Poppadock,veknilash,192,paladin,protection,6,2,4
25557,Immensepower,tichondrius,192,paladin,protection,6,2,4
25558,Consecrated,daggerspine,192,paladin,protection,12,2,10
25559,Zifre,ragnaros,192,paladin,protection,12,2,10
25560,Dwarvendude,sargeras,159,paladin,protection,11,2,9
25561,Taillien,bonechewer,96,paladin,protection,6,1,5
25562,Holykura,thrall,96,paladin,protection,6,1,5
25563,Lasonil,zuljin,96,paladin,protection,6,1,5
25564,Combidin,garrosh,96,paladin,protection,6,1,5
25565,Chàrron,garrosh,79,paladin,protection,5,1,4
25566,Garbagedisc,scilla,2139,priest,holy,114,56,58
25567,Yötönyö,sargeras,2082,priest,holy,114,57,57
25568,Priestlike,tichondrius,2010,priest,holy,127,68,59
25569,Dogbutt,burning-legion,1996,priest,holy,222,111,111
25570,Pickle,illidan,1974,priest,holy,86,49,37
25571,Fusira,gurubashi,1941,priest,holy,48,25,23
25572,Rustymvp,nagrand,1902,priest,holy,68,31,37
25573,Tirrify,frostmourne,1899,priest,holy,54,29,25
25574,Cokeheals,kelthuzad,1897,priest,holy,42,26,16
25575,Fluent,emerald-dream,1895,priest,holy,192,91,101
25576,Onemission,whisperwind,1889,priest,holy,72,27,45
25577,Cinnalite,darkspear,1870,priest,holy,42,29,13
25578,Pianohouse,illidan,1862,priest,holy,72,35,37
25579,Teslashield,bleeding-hollow,1856,priest,holy,54,25,29
25580,Ninbara,tichondrius,1851,priest,holy,102,49,53
25581,Tookiex,stormrage,1847,priest,holy,61,29,32
25582,Lilyxo,bleeding-hollow,1845,priest,holy,72,36,36
25583,Hyouka,area-52,1844,priest,holy,268,143,125
25584,Peat,hyjal,1844,priest,holy,54,27,27
25585,Lëønë,nemesis,1842,priest,holy,148,93,55
25586,Superduperr,illidan,1840,priest,holy,66,33,33
25587,Saintjpii,tichondrius,1839,priest,holy,143,84,59
25588,Vandalia,shadowsong,1837,priest,holy,181,89,92
25589,Citrinesta,illidan,1835,priest,holy,197,121,76
25590,Gerpe,stormrage,1830,priest,holy,189,106,83
25591,Haruspex,azralon,1825,priest,holy,106,52,54
25592,Lagemela,quelthalas,1825,priest,holy,101,47,54
25593,Nickydamous,moon-guard,1817,priest,holy,66,38,28
25594,Iniquitatem,tichondrius,1817,priest,holy,60,23,37
25595,Tromnasty,area-52,1816,priest,holy,90,53,37
25596,Whitetails,illidan,1816,priest,holy,54,31,23
25597,Rootandboot,frostmourne,1815,priest,holy,49,29,20
25598,Onikûdaki,sargeras,1814,priest,holy,86,37,49
25599,Sweatynick,proudmoore,1813,priest,holy,227,109,118
25600,Immthuggin,tichondrius,1813,priest,holy,120,53,67
25601,Scyner,bleeding-hollow,1811,priest,holy,152,87,65
25602,Dmgisop,illidan,1811,priest,holy,141,80,61
25603,Clarifytwo,arathor,1809,priest,holy,48,29,19
25604,Bloodlinex,malganis,1806,priest,holy,171,102,69
25605,Pipelayerx,illidan,1804,priest,holy,50,25,25
25606,Murkd,tichondrius,1804,priest,holy,145,68,77
25607,Gill,proudmoore,1800,priest,holy,148,78,70
25608,Whalexo,kelthuzad,1799,priest,holy,51,24,27
25609,Jjmms,akama,1782,priest,holy,205,105,100
25610,Turnipp,sargeras,1780,priest,holy,42,19,23
25611,Dreckie,sargeras,1779,priest,holy,141,71,70
25612,Zenelu,tichondrius,1775,priest,holy,482,239,243
25613,Santyel,ragnaros,1768,priest,holy,72,43,29
25614,Moonideli,moon-guard,1765,priest,holy,72,36,36
25615,Mastuti,azralon,1763,priest,holy,77,34,43
25616,Goodlife,frostmourne,1753,priest,holy,107,52,55
25617,Heavyflo,kelthuzad,1746,priest,holy,96,49,47
25618,Nanatoo,sargeras,1743,priest,holy,42,22,20
25619,Pancakeboi,tichondrius,1739,priest,holy,95,46,49
25620,Zazul,frostmane,1734,priest,holy,107,61,46
25621,Icychain,area-52,1726,priest,holy,35,19,16
25622,Soulghast,gorefiend,1720,priest,holy,42,24,18
25623,Iloveethan,moon-guard,1717,priest,holy,53,32,21
25624,Packet,zuluhed,1715,priest,holy,36,26,10
25625,Cheekypriest,stormrage,1714,priest,holy,66,30,36
25626,Eccentricx,sargeras,1712,priest,holy,30,18,12
25627,Snowymooie,frostmourne,1697,priest,holy,54,25,29
25628,Falsegodx,tichondrius,1688,priest,holy,108,56,52
25629,Geoffrred,illidan,1686,priest,holy,54,21,33
25630,Pws,azralon,1683,priest,holy,66,29,37
25631,Candohp,frostmourne,1682,priest,holy,42,22,20
25632,Soloqqt,tichondrius,1675,priest,holy,42,24,18
25633,Gaudthree,tichondrius,1675,priest,holy,48,26,22
25634,Minipriest,sargeras,1673,priest,holy,42,20,22
25635,Óst,tichondrius,1673,priest,holy,42,18,24
25636,ßsimp,darrowmere,1670,priest,holy,77,35,42
25637,Cosmicyiff,area-52,1666,priest,holy,76,38,38
25638,Clarify,arathor,1664,priest,holy,78,34,44
25639,Cryptron,tichondrius,1660,priest,holy,114,50,64
25640,Iluvthgnmicz,sargeras,1655,priest,holy,57,30,27
25641,Illmindofmoo,sargeras,1645,priest,holy,41,18,23
25642,Wøo,area-52,1643,priest,holy,169,89,80
25643,Dream,kelthuzad,1639,priest,holy,60,27,33
25644,Bopang,emerald-dream,1638,priest,holy,59,27,32
25645,Wankenobi,stormrage,1634,priest,holy,280,140,140
25646,Fäctor,bleeding-hollow,1633,priest,holy,44,23,21
25647,Meatboxmoldy,blood-furnace,1630,priest,holy,46,25,21
25648,Elbowbeans,tichondrius,1629,priest,holy,94,43,51
25649,Hardiness,tichondrius,1627,priest,holy,66,45,21
25650,Punkndrublic,sargeras,1625,priest,holy,165,83,82
25651,Wisdumos,frostmourne,1625,priest,holy,72,36,36
25652,Washdp,frostmourne,1621,priest,holy,48,21,27
25653,Dgpriest,tichondrius,1620,priest,holy,48,23,25
25654,Moosepriestx,sargeras,1619,priest,holy,36,17,19
25655,Lickless,illidan,1611,priest,holy,42,20,22
25656,Mynaevis,malganis,1610,priest,holy,30,17,13
25657,Pigogo,tichondrius,1608,priest,holy,53,29,24
25658,Leoshi,turalyon,1604,priest,holy,48,27,21
25659,Dylbags,frostmourne,1600,priest,holy,35,21,14
25660,Manbooty,illidan,1588,priest,holy,39,22,17
25661,Alathea,elune,1586,priest,holy,189,88,101
25662,Dypkillet,moon-guard,1582,priest,holy,150,71,79
25663,ßeautiful,sargeras,1562,priest,holy,42,22,20
25664,Krobs,bleeding-hollow,1559,priest,holy,48,20,28
25665,Cerebrill,bleeding-hollow,1557,priest,holy,45,22,23
25666,Tarlex,illidan,1555,priest,holy,94,43,51
25667,Oyy,barthilas,1553,priest,holy,138,72,66
25668,Avis,illidan,1539,priest,holy,110,54,56
25669,Heluupa,illidan,1538,priest,holy,113,71,42
25670,Tookz,stormrage,1530,priest,holy,24,16,8
25671,Nielbomb,tichondrius,1527,priest,holy,414,206,208
25672,Soaphia,kelthuzad,1525,priest,holy,130,65,65
25673,Dispassion,stormrage,1523,priest,holy,182,90,92
25674,Archbishop,stormscale,1514,priest,holy,79,42,37
25675,Ducky,drakthul,1513,priest,holy,60,35,25
25676,Saetia,drenden,1513,priest,holy,69,40,29
25677,Sacrifer,moon-guard,1513,priest,holy,102,52,50
25678,Joeschmoe,proudmoore,1512,priest,holy,42,22,20
25679,Sooyáaa,illidan,1512,priest,holy,188,85,103
25680,Boboxiao,illidan,1512,priest,holy,47,16,31
25681,Cutiepriest,gnomeregan,1511,priest,holy,114,66,48
25682,Noniok,blackrock,1507,priest,holy,50,31,19
25683,Downturn,tichondrius,1507,priest,holy,42,18,24
25684,Sukeena,malganis,1503,priest,holy,119,56,63
25685,Chervz,chogall,1503,priest,holy,42,18,24
25686,Handsumheals,kiljaeden,1500,priest,holy,49,27,22
25687,Giveheadpats,moon-guard,1496,priest,holy,164,80,84
25688,Tazzi,chromaggus,1494,priest,holy,79,35,44
25689,Soleyxo,frostmourne,1489,priest,holy,54,31,23
25690,Fyne,kelthuzad,1488,priest,holy,111,51,60
25691,Cardinalpéll,frostmourne,1487,priest,holy,47,25,22
25692,Chadopri,stormrage,1486,priest,holy,42,26,16
25693,Kostantina,kelthuzad,1484,priest,holy,42,18,24
25694,Cantheel,stormrage,1483,priest,holy,132,66,66
25695,Tranquilty,tichondrius,1480,priest,holy,84,36,48
25696,Goyimhealer,area-52,1476,priest,holy,53,23,30
25697,Symbolofhope,moon-guard,1474,priest,holy,45,20,25
25698,Illyasviel,terenas,1472,priest,holy,103,41,62
25699,Edmen,stormrage,1464,priest,holy,90,44,46
25700,Ayanamil,tichondrius,1460,priest,holy,79,57,22
25701,Vampiric,laughing-skull,1460,priest,holy,68,38,30
25702,Dawnside,wyrmrest-accord,1454,priest,holy,636,341,295
25703,Plebiss,burning-blade,1450,priest,holy,190,100,90
25704,Anguishment,stormrage,1448,priest,holy,165,80,85
25705,Adrenalinn,illidan,1447,priest,holy,48,27,21
25706,Griddly,alterac-mountains,1445,priest,holy,55,17,38
25707,Owlchubz,mannoroth,1443,priest,holy,121,57,64
25708,Artiannaa,bleeding-hollow,1436,priest,holy,63,39,24
25709,Necroplasma,area-52,1433,priest,holy,55,31,24
25710,Xedus,mannoroth,1433,priest,holy,74,32,42
25711,Arçhángël,moon-guard,1431,priest,holy,72,38,34
25712,Matthiass,thrall,1429,priest,holy,172,81,91
25713,Pesca,proudmoore,1429,priest,holy,36,15,21
25714,Wrinkletink,whisperwind,1426,priest,holy,49,24,25
25715,Musashibo,kelthuzad,1426,priest,holy,57,19,38
25716,Jiñx,destromath,1424,priest,holy,30,15,15
25717,Stonemonkeyp,sargeras,1422,priest,holy,163,82,81
25718,Gosilly,tichondrius,1417,priest,holy,24,15,9
25719,Holyb,tichondrius,1413,priest,holy,77,41,36
25720,Tòxìç,stormrage,1411,priest,holy,187,96,91
25721,Mizzbehavn,tichondrius,1410,priest,holy,50,26,24
25722,Kaelthos,quelthalas,1407,priest,holy,59,29,30
25723,Kovaxx,frostmourne,1407,priest,holy,156,74,82
25724,Berzum,chogall,1406,priest,holy,36,17,19
25725,Bubbles,drakthul,1404,priest,holy,394,191,203
25726,Bestgirlna,area-52,1404,priest,holy,114,50,64
25727,Reverenced,stormrage,1401,priest,holy,84,48,36
25728,Fenty,nemesis,1400,priest,holy,42,25,17
25729,Sacredforce,sargeras,1400,priest,holy,66,21,45
25730,Strivedaily,proudmoore,1397,priest,holy,216,101,115
25731,Merellia,moon-guard,1395,priest,holy,72,37,35
25732,Pettypriest,dalaran,1394,priest,holy,201,95,106
25733,Floquii,area-52,1391,priest,holy,52,25,27
25734,Soapfan,kelthuzad,1387,priest,holy,195,94,101
25735,Rolence,tichondrius,1381,priest,holy,68,34,34
25736,Rihen,tichondrius,1381,priest,holy,471,231,240
25737,Plod,kelthuzad,1380,priest,holy,42,25,17
25738,Etain,bloodscalp,1380,priest,holy,65,35,30
25739,Akaneo,tichondrius,1380,priest,holy,36,18,18
25740,Applepieyum,illidan,1380,priest,holy,78,30,48
25741,Åutumn,tichondrius,1374,priest,holy,26,18,8
25742,Doob,ghostlands,1374,priest,holy,42,22,20
25743,Methodist,proudmoore,1374,priest,holy,78,28,50
25744,Padrecarras,ragnaros,1373,priest,holy,36,15,21
25745,Cruxave,aegwynn,1366,priest,holy,46,23,23
25746,Sabene,greymane,1364,priest,holy,91,44,47
25747,Holynug,stormrage,1361,priest,holy,30,16,14
25748,Taashigi,frostmourne,1360,priest,holy,34,16,18
25749,Mikeyxo,gnomeregan,1359,priest,holy,44,26,18
25750,Cutensoft,moon-guard,1354,priest,holy,54,27,27
25751,Quartzolio,azralon,1353,priest,holy,59,35,24
25752,Maddrox,sargeras,1351,priest,holy,36,20,16
25753,Xenatic,emerald-dream,1351,priest,holy,108,51,57
25754,Shaldra,bleeding-hollow,1348,priest,holy,109,64,45
25755,Preacherr,bonechewer,1348,priest,holy,36,20,16
25756,Esvary,quelthalas,1347,priest,holy,116,62,54
25757,Dispersed,thrall,1347,priest,holy,80,37,43
25758,Holyshytt,tichondrius,1346,priest,holy,55,30,25
25759,Sappes,area-52,1346,priest,holy,54,27,27
25760,Dioecesis,moon-guard,1345,priest,holy,83,30,53
25761,Holyfromrmp,tichondrius,1344,priest,holy,57,25,32
25762,Klondikebar,whisperwind,1341,priest,holy,42,22,20
25763,Ænußís,stormrage,1335,priest,holy,84,46,38
25764,Spriest,kul-tiras,1332,priest,holy,74,41,33
25765,Chemod,quelthalas,1331,priest,holy,41,22,19
25766,Trufumthunzi,illidan,1330,priest,holy,26,17,9
25767,Aisperwind,shadowsong,1323,priest,holy,78,37,41
25768,Healztonic,dalaran,1323,priest,holy,85,38,47
25769,Discospider,sargeras,1316,priest,holy,31,16,15
25770,Operandi,sargeras,1315,priest,holy,29,16,13
25771,Lexiié,area-52,1312,priest,holy,55,33,22
25772,Mercý,zuljin,1309,priest,holy,60,34,26
25773,Ksâh,bleeding-hollow,1309,priest,holy,36,17,19
25774,Phearix,zuljin,1309,priest,holy,48,20,28
25775,Arterrmis,barthilas,1307,priest,holy,53,26,27
25776,Animè,zuluhed,1305,priest,holy,89,52,37
25777,Xinferesia,sargeras,1305,priest,holy,61,25,36
25778,Xrafa,azralon,1301,priest,holy,84,38,46
25779,Priestlie,malganis,1301,priest,holy,70,28,42
25780,Spïcÿ,frostmourne,1296,priest,holy,54,27,27
25781,Duhàst,sargeras,1296,priest,holy,95,43,52
25782,Xanky,frostmourne,1287,priest,holy,34,18,16
25783,Hizha,tichondrius,1287,priest,holy,36,19,17
25784,Gracarix,frostmourne,1285,priest,holy,30,17,13
25785,Macko,wyrmrest-accord,1279,priest,holy,31,15,16
25786,Amaristinaa,frostmourne,1279,priest,holy,46,21,25
25787,Djdazzle,kargath,1278,priest,holy,29,14,15
25788,Padreamarol,ragnaros,1274,priest,holy,48,23,25
25789,Duskherald,zuljin,1274,priest,holy,96,45,51
25790,Lilyanná,tichondrius,1270,priest,holy,42,20,22
25791,Freshtodeath,malganis,1269,priest,holy,42,23,19
25792,Raskreia,dragonmaw,1268,priest,holy,30,14,16
25793,Mkenze,moon-guard,1268,priest,holy,156,69,87
25794,Tegridyfarm,malganis,1265,priest,holy,35,19,16
25795,Threesclass,tichondrius,1262,priest,holy,29,14,15
25796,Tytusx,stormrage,1262,priest,holy,32,14,18
25797,Alrüna,moon-guard,1253,priest,holy,62,30,32
25798,Galadrael,quelthalas,1252,priest,holy,35,16,19
25799,Iggyp,hyjal,1251,priest,holy,72,35,37
25800,Zallstan,zuljin,1249,priest,holy,30,15,15
25801,Bjorke,tichondrius,1247,priest,holy,30,13,17
25802,Oxynor,zuljin,1246,priest,holy,24,13,11
25803,Yyuan,tichondrius,1244,priest,holy,24,13,11
25804,Holiermilk,demon-soul,1243,priest,holy,221,99,122
25805,Irídium,area-52,1243,priest,holy,30,13,17
25806,Fanseband,dalaran,1240,priest,holy,41,22,19
25807,Manocloth,frostmourne,1239,priest,holy,25,15,10
25808,Cléah,sargeras,1235,priest,holy,113,53,60
25809,Junatoh,area-52,1231,priest,holy,55,29,26
25810,Healgirls,dalaran,1230,priest,holy,59,28,31
25811,Nowwow,tichondrius,1230,priest,holy,30,14,16
25812,Aiwa,winterhoof,1229,priest,holy,18,13,5
25813,Hatxsu,emerald-dream,1229,priest,holy,40,17,23
25814,Valkur,aegwynn,1227,priest,holy,150,70,80
25815,Littlebat,proudmoore,1226,priest,holy,76,39,37
25816,Zerolimitzz,arthas,1225,priest,holy,48,22,26
25817,Whitepigogo,tichondrius,1225,priest,holy,30,13,17
25818,Giusep,tichondrius,1225,priest,holy,42,16,26
25819,Edessa,lothar,1225,priest,holy,71,27,44
25820,Celinsa,ragnaros,1223,priest,holy,36,18,18
25821,Tïto,blackrock,1220,priest,holy,44,20,24
25822,Leggoscams,tichondrius,1217,priest,holy,28,14,14
25823,Titô,frostmourne,1215,priest,holy,53,28,25
25824,Firewatcher,sisters-of-elune,1214,priest,holy,30,17,13
25825,Akainuu,nazjatar,1207,priest,holy,55,22,33
25826,Dóctóre,thrall,1205,priest,holy,61,24,37
25827,Bismund,chogall,1203,priest,holy,42,22,20
25828,Daisie,bleeding-hollow,1202,priest,holy,85,43,42
25829,Stayhealed,tichondrius,1201,priest,holy,45,22,23
25830,Akö,jubeithos,1200,priest,holy,30,14,16
25831,Vernis,nazjatar,1200,priest,holy,36,15,21
25832,Dagaen,thunderlord,1199,priest,holy,209,104,105
25833,Pílí,drakkari,1198,priest,holy,60,28,32
25834,Ukizeal,moknathal,1192,priest,holy,134,63,71
25835,Theophobe,illidan,1190,priest,holy,85,45,40
25836,Darkheals,azralon,1190,priest,holy,52,20,32
25837,Qtasiangirl,emerald-dream,1190,priest,holy,39,14,25
25838,Stennic,emerald-dream,1183,priest,holy,33,17,16
25839,Dolandir,quelthalas,1181,priest,holy,30,18,12
25840,Kazehanaa,ragnaros,1180,priest,holy,30,16,14
25841,Kälashnikova,ragnaros,1180,priest,holy,104,51,53
25842,Flemyth,eitrigg,1180,priest,holy,40,16,24
25843,Ghostiepants,tichondrius,1177,priest,holy,35,13,22
25844,Haushauha,azralon,1164,priest,holy,48,23,25
25845,Suzzanna,frostmourne,1160,priest,holy,41,23,18
25846,Etros,wyrmrest-accord,1156,priest,holy,90,38,52
25847,Ranøth,deathwing,1155,priest,holy,74,31,43
25848,Milkgulper,illidan,1152,priest,holy,24,12,12
25849,Leonihpriest,nemesis,1151,priest,holy,30,12,18
25850,Trompiscola,quelthalas,1151,priest,holy,30,12,18
25851,Endure,moon-guard,1149,priest,holy,24,12,12
25852,Mêgumin,area-52,1147,priest,holy,18,13,5
25853,Maiyennefer,proudmoore,1146,priest,holy,34,13,21
25854,Selket,stormscale,1145,priest,holy,96,42,54
25855,Meiev,quelthalas,1139,priest,holy,24,12,12
25856,Pottime,tichondrius,1139,priest,holy,76,33,43
25857,Kasiry,ragnaros,1137,priest,holy,90,37,53
25858,Tianqing,tichondrius,1126,priest,holy,34,12,22
25859,Benjamints,thrall,1124,priest,holy,24,12,12
25860,Voidthulhu,stormrage,1124,priest,holy,131,48,83
25861,Dactylion,moon-guard,1119,priest,holy,24,12,12
25862,Æsir,skullcrusher,1119,priest,holy,30,12,18
25863,Niná,arathor,1114,priest,holy,20,13,7
25864,Zojhira,khazgoroth,1114,priest,holy,66,32,34
25865,Carray,goldrinn,1113,priest,holy,49,16,33
25866,Anemonie,gorefiend,1111,priest,holy,112,46,66
25867,Atlana,gilneas,1107,priest,holy,24,16,8
25868,Mailboxxy,kelthuzad,1107,priest,holy,42,18,24
25869,Karenpigbear,area-52,1091,priest,holy,215,95,120
25870,Kytiana,blackwing-lair,1088,priest,holy,548,266,282
25871,Sôlîånia,alterac-mountains,1081,priest,holy,39,27,12
25872,Deathrina,moon-guard,1079,priest,holy,27,13,14
25873,Beckzz,illidan,1070,priest,holy,26,17,9
25874,Fayth,maiev,1070,priest,holy,29,15,14
25875,Mavuiss,barthilas,1069,priest,holy,25,12,13
25876,Floppytatas,illidan,1060,priest,holy,147,70,77
25877,Badgoy,dalaran,1056,priest,holy,24,11,13
25878,Pesian,dalaran,1055,priest,holy,22,12,10
25879,Kernelious,illidan,1055,priest,holy,24,11,13
25880,Iilmama,area-52,1054,priest,holy,18,11,7
25881,Holypopocat,tichondrius,1052,priest,holy,21,12,9
25882,Hypepriest,sargeras,1049,priest,holy,18,11,7
25883,Dotdotdead,earthen-ring,1049,priest,holy,18,11,7
25884,Soulhealer,shadowmoon,1048,priest,holy,24,13,11
25885,Swrvlol,emerald-dream,1045,priest,holy,18,11,7
25886,Dylirium,dathremar,1044,priest,holy,18,11,7
25887,Zumnb,quelthalas,1042,priest,holy,24,11,13
25888,Droneboy,moon-guard,1037,priest,holy,24,11,13
25889,Sanaconda,sargeras,1035,priest,holy,30,11,19
25890,Alicia,nazjatar,1032,priest,holy,18,13,5
25891,Celani,gilneas,1026,priest,holy,24,11,13
25892,Ninbará,stormrage,1023,priest,holy,26,12,14
25893,Hälø,moon-guard,1019,priest,holy,27,12,15
25894,Dreäveler,stormrage,1007,priest,holy,21,11,10
25895,Pandamila,azralon,1004,priest,holy,19,11,8
25896,Veltaxis,moon-guard,998,priest,holy,162,72,90
25897,Sybenela,proudmoore,994,priest,holy,61,28,33
25898,Yinaiteen,drakkari,985,priest,holy,64,33,31
25899,Priesttess,skullcrusher,981,priest,holy,23,11,12
25900,Seråphim,sargeras,979,priest,holy,66,36,30
25901,Souljourner,stormrage,976,priest,holy,59,26,33
25902,Vìxèn,zuljin,969,priest,holy,37,11,26
25903,Ragekiller,lothar,968,priest,holy,48,23,25
25904,Jameswarren,silvermoon,959,priest,holy,11,11,0
25905,Pèrona,tichondrius,959,priest,holy,24,10,14
25906,Trickyhobo,area-52,958,priest,holy,12,10,2
25907,Iaptop,tichondrius,958,priest,holy,18,10,8
25908,Folate,frostmourne,957,priest,holy,18,10,8
25909,Bugshott,tichondrius,956,priest,holy,32,10,22
25910,Noobepriest,thrall,955,priest,holy,18,10,8
25911,Priestybear,illidan,955,priest,holy,18,10,8
25912,Cappoo,tichondrius,955,priest,holy,36,10,26
25913,Snuffsnorter,kelthuzad,953,priest,holy,29,10,19
25914,Delthas,nagrand,952,priest,holy,124,60,64
25915,Dovoso,kargath,951,priest,holy,26,10,16
25916,Hycinamun,malganis,949,priest,holy,24,10,14
25917,Novous,area-52,944,priest,holy,30,10,20
25918,Holyfizzle,dethecus,936,priest,holy,30,14,16
25919,Taylorsmites,emerald-dream,931,priest,holy,42,18,24
25920,Eredwarraim,akama,930,priest,holy,36,13,23
25921,Jol,aggramar,928,priest,holy,24,10,14
25922,Dipanddøts,area-52,926,priest,holy,17,10,7
25923,Thisistragic,frostmourne,905,priest,holy,14,11,3
25924,Hpcando,frostmourne,905,priest,holy,20,12,8
25925,Artemix,azralon,903,priest,holy,119,48,71
25926,Veni,kiljaeden,885,priest,holy,23,10,13
25927,Teheleopapi,quelthalas,877,priest,holy,69,16,53
25928,Pharmacee,korgath,871,priest,holy,72,21,51
25929,Dadcantdeath,frostmourne,864,priest,holy,18,9,9
25930,Pej,emerald-dream,864,priest,holy,18,9,9
25931,Rustymvpfan,nagrand,864,priest,holy,18,9,9
25932,Holyxb,bleeding-hollow,863,priest,holy,18,9,9
25933,Amayå,kelthuzad,863,priest,holy,18,9,9
25934,Glöws,area-52,863,priest,holy,24,9,15
25935,Çummiñs,malganis,862,priest,holy,18,9,9
25936,Chaynal,proudmoore,859,priest,holy,18,9,9
25937,Sondrak,doomhammer,846,priest,holy,41,16,25
25938,Lieuwe,kelthuzad,846,priest,holy,24,9,15
25939,Hamburgle,blackrock,831,priest,holy,16,10,6
25940,Psïren,quelthalas,831,priest,holy,28,9,19
25941,Ascian,daggerspine,809,priest,holy,18,10,8
25942,Helgar,frostmourne,808,priest,holy,18,10,8
25943,Illooj,eonar,797,priest,holy,25,10,15
25944,Híkarí,windrunner,796,priest,holy,14,9,5
25945,Gbumy,tichondrius,784,priest,holy,13,9,4
25946,Fotmtrash,the-underbog,768,priest,holy,12,8,4
25947,Lightwell,blackrock,768,priest,holy,12,8,4
25948,Turnip,zuljin,768,priest,holy,12,8,4
25949,Pmos,sargeras,768,priest,holy,18,8,10
25950,Voidzx,tichondrius,768,priest,holy,18,8,10
25951,Khalesî,ragnaros,767,priest,holy,12,8,4
25952,Hynzor,barthilas,767,priest,holy,30,8,22
25953,Ofmanyfaces,illidan,766,priest,holy,12,8,4
25954,Prayzar,illidan,766,priest,holy,12,8,4
25955,Cyelena,quelthalas,766,priest,holy,24,8,16
25956,Kaelsgf,kaelthas,766,priest,holy,24,8,16
25957,Zeroo,maiev,765,priest,holy,12,8,4
25958,Gewbrr,malganis,765,priest,holy,12,8,4
25959,Manatea,moon-guard,765,priest,holy,18,8,10
25960,Zolpidem,quelthalas,765,priest,holy,18,8,10
25961,Olivinpain,malganis,765,priest,holy,30,8,22
25962,Lenlune,bloodscalp,763,priest,holy,18,8,10
25963,Laj,proudmoore,763,priest,holy,30,8,22
25964,Papergaruru,illidan,762,priest,holy,30,8,22
25965,Bienhechora,quelthalas,760,priest,holy,12,8,4
25966,Priestognic,azralon,759,priest,holy,16,9,7
25967,Ishtana,bleeding-hollow,734,priest,holy,14,9,5
25968,Fäñcÿ,tichondrius,734,priest,holy,17,8,9
25969,Rylance,burning-blade,720,priest,holy,21,8,13
25970,Bigmommyxo,whisperwind,718,priest,holy,21,9,12
25971,Msdash,tichondrius,717,priest,holy,15,8,7
25972,Saintfulsins,sargeras,716,priest,holy,15,8,7
25973,Titoj,tichondrius,708,priest,holy,15,9,6
25974,Jaytee,aggramar,703,priest,holy,14,9,5
25975,Humz,ragnaros,703,priest,holy,14,8,6
25976,Nwok,frostmourne,672,priest,holy,12,7,5
25977,Pevis,thrall,672,priest,holy,12,7,5
25978,Ímhotep,sargeras,672,priest,holy,12,7,5
25979,Canibumsmoke,illidan,672,priest,holy,12,7,5
25980,Lemmiewinkzx,sargeras,672,priest,holy,12,7,5
25981,Hehehealyou,emerald-dream,672,priest,holy,12,7,5
25982,Pgpriest,kelthuzad,672,priest,holy,12,7,5
25983,Beliana,boulderfist,672,priest,holy,16,8,8
25984,Nicksfury,stormrage,672,priest,holy,18,7,11
25985,Tylexus,tichondrius,672,priest,holy,18,7,11
25986,Sorrowful,mannoroth,672,priest,holy,18,7,11
25987,Drelia,jubeithos,672,priest,holy,24,7,17
25988,Yujawang,sargeras,671,priest,holy,12,7,5
25989,Bradythree,moon-guard,671,priest,holy,12,7,5
25990,Suppòrt,stormrage,671,priest,holy,12,7,5
25991,Xoraya,proudmoore,671,priest,holy,12,7,5
25992,Allaras,eldrethalas,671,priest,holy,12,7,5
25993,Jordandoesnt,tichondrius,671,priest,holy,12,7,5
25994,Deidre,illidan,671,priest,holy,16,8,8
25995,Braevera,wyrmrest-accord,671,priest,holy,18,7,11
25996,Dankpope,malganis,670,priest,holy,12,7,5
25997,Qelient,proudmoore,670,priest,holy,12,7,5
25998,Exlord,illidan,670,priest,holy,12,7,5
25999,Salaknib,frostmourne,670,priest,holy,15,7,8
26000,Arena,lothar,669,priest,holy,12,7,5
26001,Dëâth,ghostlands,669,priest,holy,21,8,13
26002,Uzakichan,arygos,669,priest,holy,24,7,17
26003,Klassa,thrall,668,priest,holy,17,8,9
26004,Kisstina,tichondrius,667,priest,holy,24,7,17
26005,Jesaminealbe,quelthalas,666,priest,holy,18,7,11
26006,Vichealer,firetree,660,priest,holy,12,7,5
26007,Releknosleep,frostwolf,634,priest,holy,17,7,10
26008,Yidra,illidan,623,priest,holy,17,7,10
26009,Blackprez,dathremar,613,priest,holy,17,7,10
26010,Punishing,illidan,606,priest,holy,16,7,9
26011,Papadarkness,tichondrius,603,priest,holy,14,7,7
26012,Pikachuwu,moon-guard,586,priest,holy,11,7,4
26013,Didntâsk,arthas,576,priest,holy,12,6,6
26014,Benedictiion,tichondrius,576,priest,holy,12,6,6
26015,Becrixx,thunderlord,576,priest,holy,12,6,6
26016,Runalor,zuljin,576,priest,holy,12,6,6
26017,Bootleg,crushridge,576,priest,holy,12,6,6
26018,Pics,emerald-dream,576,priest,holy,12,6,6
26019,Shockterror,area-52,576,priest,holy,12,6,6
26020,Hysteria,dalaran,576,priest,holy,12,6,6
26021,Unsubbedd,sargeras,576,priest,holy,12,6,6
26022,Feverx,tichondrius,576,priest,holy,12,6,6
26023,Estaria,the-forgotten-coast,576,priest,holy,12,6,6
26024,Praggy,proudmoore,576,priest,holy,12,6,6
26025,Sigx,area-52,576,priest,holy,12,6,6
26026,Linvial,moon-guard,576,priest,holy,12,6,6
26027,Calissy,proudmoore,576,priest,holy,12,6,6
26028,Valiann,lightbringer,576,priest,holy,12,6,6
26029,Sìnz,area-52,576,priest,holy,12,6,6
26030,Marïmba,azralon,576,priest,holy,12,6,6
26031,Îcarus,tichondrius,576,priest,holy,12,6,6
26032,Skylust,azralon,576,priest,holy,12,6,6
26033,Archaellia,area-52,576,priest,holy,12,6,6
26034,Jezebëll,nemesis,576,priest,holy,12,6,6
26035,Fearnfaith,zuljin,576,priest,holy,18,6,12
26036,Rdvark,stormrage,576,priest,holy,18,6,12
26037,Suirr,tichondrius,576,priest,holy,18,6,12
26038,Gustáv,sargeras,576,priest,holy,18,6,12
26039,Xhirra,quelthalas,576,priest,holy,18,6,12
26040,Mattkoster,mannoroth,575,priest,holy,12,6,6
26041,Meowforheals,sargeras,575,priest,holy,12,6,6
26042,Därkness,azralon,575,priest,holy,18,6,12
26043,Kephrek,eonar,575,priest,holy,18,6,12
26044,Sêtsunà,dalaran,575,priest,holy,36,6,30
26045,Cassíopeía,blackhand,574,priest,holy,12,6,6
26046,Aeoliana,laughing-skull,572,priest,holy,12,6,6
26047,Aldryth,lightbringer,571,priest,holy,12,6,6
26048,Zual,hakkar,569,priest,holy,12,6,6
26049,Altara,malygos,569,priest,holy,12,6,6
26050,Messra,dathremar,563,priest,holy,24,6,18
26051,París,mannoroth,559,priest,holy,17,6,11
26052,Satíva,dark-iron,543,priest,holy,11,6,5
26053,Jüdaspriest,gorefiend,522,priest,holy,23,7,16
26054,Trupriest,alleria,511,priest,holy,8,6,2
26055,Jâmïè,gurubashi,511,priest,holy,11,6,5
26056,Huxleypoo,boulderfist,480,priest,holy,6,5,1
26057,Onion,garona,480,priest,holy,6,5,1
26058,Jaaregis,area-52,480,priest,holy,6,5,1
26059,Toje,korgath,480,priest,holy,13,6,7
26060,Phatheals,proudmoore,480,priest,holy,12,5,7
26061,Gad,moon-guard,480,priest,holy,12,5,7
26062,Greytness,tichondrius,480,priest,holy,12,5,7
26063,Maelei,ragnaros,480,priest,holy,12,5,7
26064,Xeras,ravencrest,480,priest,holy,12,5,7
26065,Steve,drakthul,480,priest,holy,12,5,7
26066,Mëïsoön,quelthalas,480,priest,holy,12,5,7
26067,Rysie,winterhoof,480,priest,holy,12,5,7
26068,Snookp,kiljaeden,480,priest,holy,12,5,7
26069,Secrèt,tichondrius,480,priest,holy,12,5,7
26070,Selidri,proudmoore,480,priest,holy,12,5,7
26071,Psytrance,proudmoore,480,priest,holy,12,5,7
26072,Blackoss,sargeras,480,priest,holy,12,5,7
26073,Timbobaloo,thrall,480,priest,holy,12,5,7
26074,Írithyll,sargeras,480,priest,holy,12,5,7
26075,Bunnykinz,moon-guard,480,priest,holy,12,5,7
26076,Meehx,illidan,480,priest,holy,12,5,7
26077,Halfsorrow,tichondrius,480,priest,holy,18,5,13
26078,Holyharlot,sargeras,480,priest,holy,18,5,13
26079,Nancynibbler,bleeding-hollow,480,priest,holy,24,5,19
26080,Mythica,gurubashi,479,priest,holy,12,5,7
26081,Tranith,jubeithos,479,priest,holy,12,5,7
26082,Mímì,wyrmrest-accord,479,priest,holy,12,5,7
26083,Miganmarkle,sargeras,479,priest,holy,12,5,7
26084,Adjectives,nerzhul,479,priest,holy,12,5,7
26085,Pactru,ragnaros,479,priest,holy,18,5,13
26086,Unni,azralon,479,priest,holy,18,5,13
26087,Amunsu,stormrage,475,priest,holy,12,5,7
26088,Smellybox,area-52,463,priest,holy,13,6,7
26089,Shadowchárm,bleeding-hollow,447,priest,holy,11,5,6
26090,Lectra,firetree,447,priest,holy,11,5,6
26091,Holyphodays,sargeras,400,priest,holy,25,5,20
26092,Sizuré,frostmourne,399,priest,holy,5,5,0
26093,Drkwispers,stormrage,384,priest,holy,6,4,2
26094,Xusin,tichondrius,384,priest,holy,6,4,2
26095,Zallp,sargeras,384,priest,holy,6,4,2
26096,Halfdeath,sargeras,384,priest,holy,6,4,2
26097,Cuaiminator,ragnaros,384,priest,holy,6,4,2
26098,Yav,exodar,384,priest,holy,6,4,2
26099,Arcmage,malganis,384,priest,holy,6,4,2
26100,Schátten,spirestone,384,priest,holy,6,4,2
26101,Ticheals,tichondrius,384,priest,holy,6,4,2
26102,Patchyemoly,frostmourne,384,priest,holy,6,4,2
26103,Chanyt,azralon,384,priest,holy,6,4,2
26104,Morticiá,blackrock,384,priest,holy,6,4,2
26105,Dookieate,destromath,384,priest,holy,6,4,2
26106,Aurorias,burning-legion,384,priest,holy,6,4,2
26107,Döyöuliftbro,tichondrius,384,priest,holy,12,4,8
26108,Hoglet,moon-guard,384,priest,holy,12,4,8
26109,Darknuzs,sargeras,384,priest,holy,12,4,8
26110,Sätîvá,tichondrius,384,priest,holy,12,4,8
26111,Zapix,tichondrius,384,priest,holy,12,4,8
26112,Yumä,kiljaeden,384,priest,holy,12,4,8
26113,Frozencherry,elune,384,priest,holy,12,4,8
26114,Carti,bleeding-hollow,384,priest,holy,12,4,8
26115,Mellow,tichondrius,384,priest,holy,12,4,8
26116,Hazzang,tichondrius,384,priest,holy,12,4,8
26117,Depressednun,moon-guard,384,priest,holy,12,4,8
26118,Chambler,aegwynn,384,priest,holy,18,4,14
26119,Aeøns,sargeras,384,priest,holy,18,4,14
26120,Pavle,laughing-skull,384,priest,holy,19,4,15
26121,Dyianah,wyrmrest-accord,383,priest,holy,12,4,8
26122,Healia,tichondrius,383,priest,holy,12,4,8
26123,Conno,thunderlord,379,priest,holy,12,4,8
26124,Remixcandoit,malganis,379,priest,holy,12,4,8
26125,Stradey,tichondrius,367,priest,holy,11,4,7
26126,Sharkda,frostmourne,350,priest,holy,17,4,13
26127,Santamuerte,agamaggan,336,priest,holy,15,4,11
26128,Boogiedo,area-52,319,priest,holy,5,4,1
26129,Vandamnation,barthilas,319,priest,holy,8,4,4
26130,Kabutta,stormrage,318,priest,holy,14,4,10
26131,ßugsy,illidan,288,priest,holy,6,3,3
26132,Lullabya,tichondrius,288,priest,holy,6,3,3
26133,Whitewalls,moonrunner,288,priest,holy,6,3,3
26134,Dividëd,stormrage,288,priest,holy,6,3,3
26135,Duonaiameng,illidan,288,priest,holy,6,3,3
26136,Deeznuhh,tichondrius,288,priest,holy,6,3,3
26137,Vynlanesh,illidan,288,priest,holy,6,3,3
26138,Alwaystry,tichondrius,288,priest,holy,6,3,3
26139,Ärchangél,tichondrius,288,priest,holy,6,3,3
26140,Charbosan,gorgonnash,288,priest,holy,6,3,3
26141,Raphan,stormrage,288,priest,holy,6,3,3
26142,Healdog,thrall,288,priest,holy,6,3,3
26143,Calvisper,thunderlord,288,priest,holy,6,3,3
26144,Matiuca,stormrage,288,priest,holy,6,3,3
26145,Smiteyducks,stormrage,288,priest,holy,6,3,3
26146,Meatguzzler,tichondrius,288,priest,holy,6,3,3
26147,Aardyx,frostmourne,288,priest,holy,6,3,3
26148,Miamama,hydraxis,288,priest,holy,6,3,3
26149,Cessar,proudmoore,288,priest,holy,6,3,3
26150,Mucada,tichondrius,288,priest,holy,6,3,3
26151,Tseirpyeroc,area-52,288,priest,holy,6,3,3
26152,Whehaw,kelthuzad,288,priest,holy,6,3,3
26153,Justjoekingh,gurubashi,288,priest,holy,6,3,3
26154,Darkmoonsun,frostmourne,288,priest,holy,6,3,3
26155,Bagoheals,area-52,288,priest,holy,6,3,3
26156,Ñÿx,arthas,288,priest,holy,6,3,3
26157,Plánemo,azralon,288,priest,holy,6,3,3
26158,Madomie,bladefist,288,priest,holy,6,3,3
26159,Sagapriest,hyjal,288,priest,holy,6,3,3
26160,Xtcbtc,sargeras,288,priest,holy,6,3,3
26161,Rottigus,skullcrusher,288,priest,holy,6,3,3
26162,Smalltoad,lightnings-blade,288,priest,holy,6,3,3
26163,Crypthion,emerald-dream,288,priest,holy,6,3,3
26164,Nerfdisc,azralon,288,priest,holy,6,3,3
26165,Laurens,fenris,288,priest,holy,6,3,3
26166,Wubbi,blackrock,288,priest,holy,6,3,3
26167,Trying,ysera,288,priest,holy,6,3,3
26168,Zesho,firetree,288,priest,holy,6,3,3
26169,Greet,hyjal,288,priest,holy,6,3,3
26170,Discountay,burning-legion,288,priest,holy,6,3,3
26171,Orderic,ragnaros,288,priest,holy,6,3,3
26172,Grindr,ragnaros,288,priest,holy,6,3,3
26173,Purgeoften,sargeras,288,priest,holy,6,3,3
26174,Sarkozzlol,tichondrius,288,priest,holy,12,3,9
26175,Smitepie,malganis,288,priest,holy,12,3,9
26176,Hòwen,tichondrius,288,priest,holy,12,3,9
26177,Disperse,vashj,288,priest,holy,12,3,9
26178,Ísábella,ragnaros,288,priest,holy,12,3,9
26179,Swis,area-52,288,priest,holy,12,3,9
26180,Øliverxp,lightbringer,288,priest,holy,12,3,9
26181,Lalight,tichondrius,288,priest,holy,12,3,9
26182,Camedy,illidan,288,priest,holy,12,3,9
26183,Jezuz,aerie-peak,288,priest,holy,12,3,9
26184,Irilde,proudmoore,288,priest,holy,12,3,9
26185,Cataline,emerald-dream,288,priest,holy,12,3,9
26186,Healiûm,bleeding-hollow,288,priest,holy,12,3,9
26187,Pringlés,suramar,288,priest,holy,18,3,15
26188,Fertalize,maiev,288,priest,holy,18,3,15
26189,Fìngerbanger,lightnings-blade,287,priest,holy,6,3,3
26190,Korhíl,ragnaros,287,priest,holy,6,3,3
26191,Auradaluz,stormrage,287,priest,holy,12,3,9
26192,Meibuff,frostmourne,287,priest,holy,18,3,15
26193,Albina,kelthuzad,239,priest,holy,5,3,2
26194,Bofin,stormrage,234,priest,holy,16,4,12
26195,Ftheman,tichondrius,234,priest,holy,17,4,13
26196,Halö,doomhammer,223,priest,holy,14,3,11
26197,Damokek,tichondrius,192,priest,holy,9,3,6
26198,Mutedox,frostmourne,192,priest,holy,6,2,4
26199,Daddyhammer,area-52,192,priest,holy,6,2,4
26200,Nodorme,quelthalas,192,priest,holy,6,2,4
26201,Yuritzi,duskwood,192,priest,holy,6,2,4
26202,Faedre,smolderthorn,192,priest,holy,6,2,4
26203,Belfortx,tichondrius,192,priest,holy,6,2,4
26204,Pandap,dalaran,192,priest,holy,6,2,4
26205,Saenax,area-52,192,priest,holy,6,2,4
26206,Arodar,wyrmrest-accord,192,priest,holy,6,2,4
26207,Silentprayer,area-52,192,priest,holy,6,2,4
26208,Jonhey,tichondrius,192,priest,holy,6,2,4
26209,Context,mannoroth,192,priest,holy,6,2,4
26210,Visse,auchindoun,192,priest,holy,6,2,4
26211,Gusho,frostmourne,192,priest,holy,6,2,4
26212,Voltstein,dalaran,192,priest,holy,6,2,4
26213,Aethriem,bleeding-hollow,192,priest,holy,6,2,4
26214,Tuulipp,aegwynn,192,priest,holy,6,2,4
26215,Whitelabel,proudmoore,192,priest,holy,6,2,4
26216,Sensitive,eitrigg,192,priest,holy,6,2,4
26217,Wagnerr,jubeithos,192,priest,holy,6,2,4
26218,Gles,quelthalas,192,priest,holy,6,2,4
26219,Igotubrah,malganis,192,priest,holy,6,2,4
26220,Pûrplehaze,aegwynn,192,priest,holy,6,2,4
26221,Mindgoblin,terokkar,192,priest,holy,6,2,4
26222,Hypodontia,caelestrasz,192,priest,holy,6,2,4
26223,Shemhazai,ragnaros,192,priest,holy,6,2,4
26224,Mevix,firetree,192,priest,holy,6,2,4
26225,Jilt,aerie-peak,192,priest,holy,6,2,4
26226,Sinthe,stormrage,192,priest,holy,6,2,4
26227,Dchi,tichondrius,192,priest,holy,6,2,4
26228,Opas,rivendare,192,priest,holy,6,2,4
26229,Verboden,kelthuzad,192,priest,holy,6,2,4
26230,Felmnir,ragnaros,192,priest,holy,6,2,4
26231,Twodxo,kelthuzad,192,priest,holy,6,2,4
26232,ßræcher,black-dragonflight,192,priest,holy,6,2,4
26233,Mitras,moon-guard,192,priest,holy,6,2,4
26234,Mendx,tichondrius,192,priest,holy,6,2,4
26235,Prescella,sargeras,192,priest,holy,6,2,4
26236,Mommyafk,moon-guard,192,priest,holy,6,2,4
26237,Ôp,sargeras,192,priest,holy,6,2,4
26238,Speyside,medivh,192,priest,holy,6,2,4
26239,Löstský,azralon,192,priest,holy,7,2,5
26240,Saintguard,tichondrius,192,priest,holy,11,3,8
26241,Langyi,tichondrius,192,priest,holy,10,2,8
26242,Nevertelsp,malganis,192,priest,holy,12,2,10
26243,Excellency,tichondrius,192,priest,holy,12,2,10
26244,Pinoculus,illidan,192,priest,holy,12,2,10
26245,Althir,ragnaros,192,priest,holy,12,2,10
26246,Fraggydaddy,frostmourne,192,priest,holy,12,2,10
26247,Påticus,area-52,192,priest,holy,13,2,11
26248,Gillís,thrall,192,priest,holy,18,2,16
26249,Krishpriest,azshara,191,priest,holy,6,2,4
26250,Mikeliteo,blades-edge,190,priest,holy,12,2,10
26251,Sneaks,frostmourne,159,priest,holy,5,2,3
26252,Identìty,moon-guard,138,priest,holy,8,3,5
26253,Pumpss,area-52,138,priest,holy,11,3,8
26254,Bigvuqoffdam,area-52,138,priest,holy,16,3,13
26255,Plzhelp,cairne,136,priest,holy,9,3,6
26256,Exploded,moon-guard,96,priest,holy,6,1,5
26257,Lerien,thrall,96,priest,holy,6,1,5
26258,Thotsteal,lightbringer,96,priest,holy,6,1,5
26259,Faithmelter,stormrage,96,priest,holy,6,1,5
26260,Bloodcure,ysera,96,priest,holy,6,1,5
26261,Hüde,stormrage,96,priest,holy,6,1,5
26262,Bigboyadam,frostmourne,96,priest,holy,6,1,5
26263,Hubbabubble,wyrmrest-accord,96,priest,holy,6,1,5
26264,Alaskaa,moon-guard,96,priest,holy,6,1,5
26265,Sarïya,moon-guard,96,priest,holy,6,1,5
26266,Breathkeeper,proudmoore,96,priest,holy,6,1,5
26267,Burtier,zuljin,96,priest,holy,6,1,5
26268,Tammyone,emerald-dream,96,priest,holy,6,1,5
26269,Haedn,azralon,96,priest,holy,6,1,5
26270,Prayboy,aerie-peak,96,priest,holy,6,1,5
26271,Sukmysplooge,queldorei,96,priest,holy,6,1,5
26272,Qnarisha,tichondrius,96,priest,holy,6,1,5
26273,Novoul,stormrage,96,priest,holy,6,1,5
26274,Minamy,tichondrius,96,priest,holy,6,1,5
26275,Alëssana,illidan,96,priest,holy,6,1,5
26276,Rakel,nathrezim,96,priest,holy,6,1,5
26277,Olassi,stormrage,96,priest,holy,6,1,5
26278,Bunked,bleeding-hollow,96,priest,holy,6,1,5
26279,Kagura,dunemaul,96,priest,holy,6,1,5
26280,Lilpaprika,sargeras,96,priest,holy,6,1,5
26281,Tichealstwo,tichondrius,96,priest,holy,6,1,5
26282,Angelicduck,illidan,96,priest,holy,6,1,5
26283,Deryus,dalaran,96,priest,holy,6,1,5
26284,Majjic,proudmoore,96,priest,holy,6,1,5
26285,Janova,tichondrius,96,priest,holy,6,1,5
26286,Tuuros,wyrmrest-accord,96,priest,holy,6,1,5
26287,Missjules,illidan,96,priest,holy,6,1,5
26288,Shadyvoodoo,barthilas,96,priest,holy,6,1,5
26289,Yungsherm,tichondrius,96,priest,holy,6,1,5
26290,Bofuri,barthilas,96,priest,holy,6,1,5
26291,Kastwalker,earthen-ring,96,priest,holy,6,1,5
26292,Akami,tichondrius,96,priest,holy,6,1,5
26293,Lasaldra,quelthalas,96,priest,holy,6,1,5
26294,Hiroshikun,azshara,96,priest,holy,6,1,5
26295,Jerkingit,tichondrius,96,priest,holy,12,1,11
26296,Djriest,sargeras,96,priest,holy,12,1,11
26297,Barryp,wyrmrest-accord,96,priest,holy,12,1,11
26298,Gutrose,area-52,96,priest,holy,12,1,11
26299,Brownsnooter,sargeras,79,priest,holy,5,1,4
26300,Helorren,nagrand,79,priest,holy,11,1,10
26301,Wiralyn,nathrezim,79,priest,holy,11,1,10
26302,Undrcvr,sargeras,2273,priest,discipline,132,73,59
26303,Èfflux,sargeras,2252,priest,discipline,97,56,41
26304,Whammiez,tichondrius,2243,priest,discipline,84,50,34
26305,Strickmaney,nathrezim,2237,priest,discipline,258,139,119
26306,Gentlewoman,ragnaros,2174,priest,discipline,87,51,36
26307,Pesian,dalaran,2153,priest,discipline,233,121,112
26308,Yefri,ravencrest,2145,priest,discipline,177,102,75
26309,Reedyjrrtv,tichondrius,2145,priest,discipline,168,88,80
26310,Cinnamontage,illidan,2142,priest,discipline,114,64,50
26311,Castsmite,tichondrius,2141,priest,discipline,99,52,47
26312,Shikinomi,illidan,2133,priest,discipline,78,46,32
26313,Wcnmb,blackrock,2123,priest,discipline,72,46,26
26314,Jiangfeng,tichondrius,2120,priest,discipline,72,37,35
26315,Celestiah,kelthuzad,2119,priest,discipline,72,37,35
26316,Baldzx,sargeras,2116,priest,discipline,292,160,132
26317,Nusrah,tichondrius,2114,priest,discipline,87,45,42
26318,Frksake,area-52,2111,priest,discipline,192,114,78
26319,Kovulol,area-52,2107,priest,discipline,126,67,59
26320,Néylo,illidan,2106,priest,discipline,112,56,56
26321,Psyches,dalaran,2106,priest,discipline,109,50,59
26322,Amberturd,cenarius,2103,priest,discipline,102,48,54
26323,Woolp,frostmourne,2102,priest,discipline,100,58,42
26324,Changwongpk,kelthuzad,2101,priest,discipline,237,124,113
26325,Søryn,madoran,2100,priest,discipline,102,52,50
26326,Rukiyou,frostwolf,2098,priest,discipline,198,99,99
26327,Veivei,tichondrius,2095,priest,discipline,59,38,21
26328,Bholebender,tichondrius,2085,priest,discipline,89,47,42
26329,Ante,stonemaul,2075,priest,discipline,108,59,49
26330,Zxxkawaii,tichondrius,2075,priest,discipline,163,85,78
26331,Pancakeboi,tichondrius,2070,priest,discipline,131,64,67
26332,Rmpmeeper,kilrogg,2055,priest,discipline,72,42,30
26333,Classmaster,stormrage,2054,priest,discipline,183,100,83
26334,Kkelly,stormrage,2053,priest,discipline,250,126,124
26335,Esqueue,illidan,2044,priest,discipline,54,26,28
26336,Lemonmint,tichondrius,2040,priest,discipline,94,46,48
26337,Shazdo,illidan,2039,priest,discipline,60,39,21
26338,Sÿnpriest,illidan,2039,priest,discipline,408,202,206
26339,Mauvex,stormrage,2033,priest,discipline,546,270,276
26340,Instoway,illidan,2029,priest,discipline,150,89,61
26341,Oogs,tichondrius,2028,priest,discipline,161,75,86
26342,Crutched,blackhand,2022,priest,discipline,60,35,25
26343,Zámmy,area-52,2021,priest,discipline,65,44,21
26344,Redonkulos,shattered-hand,2021,priest,discipline,162,85,77
26345,Idkmyname,proudmoore,2018,priest,discipline,58,29,29
26346,Proxs,sargeras,2017,priest,discipline,213,108,105
26347,Blessxo,ragnaros,2016,priest,discipline,96,45,51
26348,Twocrshort,area-52,2013,priest,discipline,149,89,60
26349,Cosmicyiff,area-52,2010,priest,discipline,100,57,43
26350,Quaree,stormrage,2010,priest,discipline,536,278,258
26351,Clearclouds,tichondrius,2004,priest,discipline,210,113,97
26352,Reilacoste,moon-guard,2002,priest,discipline,83,41,42
26353,Xajen,illidan,1996,priest,discipline,84,39,45
26354,Nucypher,illidan,1993,priest,discipline,204,118,86
26355,Hectorz,zuljin,1992,priest,discipline,106,50,56
26356,Eluneslight,tichondrius,1990,priest,discipline,78,40,38
26357,Markers,spinebreaker,1989,priest,discipline,130,64,66
26358,Sonicboomsz,azralon,1985,priest,discipline,122,63,59
26359,Crabsp,illidan,1981,priest,discipline,132,68,64
26360,Smokezter,area-52,1981,priest,discipline,159,81,78
26361,Crutch,blackhand,1980,priest,discipline,54,30,24
26362,Praemal,tichondrius,1980,priest,discipline,96,42,54
26363,Etharass,illidan,1976,priest,discipline,84,36,48
26364,Dayx,malganis,1975,priest,discipline,102,51,51
26365,Amine,tichondrius,1970,priest,discipline,60,34,26
26366,Azzäm,tichondrius,1970,priest,discipline,90,48,42
26367,Astüty,illidan,1967,priest,discipline,66,37,29
26368,Supaflute,tichondrius,1967,priest,discipline,72,32,40
26369,Abepriest,zuljin,1964,priest,discipline,204,106,98
26370,Solecíto,ragnaros,1963,priest,discipline,89,60,29
26371,Klydasoreass,malganis,1963,priest,discipline,59,38,21
26372,Stepxo,sargeras,1963,priest,discipline,117,63,54
26373,Praitne,tichondrius,1963,priest,discipline,113,59,54
26374,Leorid,stormrage,1963,priest,discipline,148,71,77
26375,Praeyer,area-52,1961,priest,discipline,380,194,186
26376,Aratis,bleeding-hollow,1961,priest,discipline,90,44,46
26377,Fannyny,tichondrius,1958,priest,discipline,132,83,49
26378,Mimz,trollbane,1958,priest,discipline,65,37,28
26379,Hospetal,tichondrius,1955,priest,discipline,146,74,72
26380,Awàken,sargeras,1952,priest,discipline,57,35,22
26381,Iilmama,area-52,1948,priest,discipline,105,55,50
26382,Peruggia,tichondrius,1948,priest,discipline,72,36,36
26383,Poporeborn,tichondrius,1948,priest,discipline,200,98,102
26384,Gotdro,kelthuzad,1942,priest,discipline,68,36,32
26385,Boykoz,zuljin,1942,priest,discipline,115,58,57
26386,Mimikyú,tichondrius,1941,priest,discipline,96,41,55
26387,Gosharbg,tichondrius,1940,priest,discipline,34,24,10
26388,Devinere,tichondrius,1940,priest,discipline,515,276,239
26389,Sarkozzlol,tichondrius,1938,priest,discipline,84,43,41
26390,Goodlife,frostmourne,1936,priest,discipline,65,30,35
26391,Astroverse,tichondrius,1933,priest,discipline,82,45,37
26392,Plaedo,stormscale,1932,priest,discipline,52,28,24
26393,Fádé,illidan,1932,priest,discipline,97,48,49
26394,Namilol,tichondrius,1931,priest,discipline,54,30,24
26395,Diabloluckie,tichondrius,1928,priest,discipline,108,56,52
26396,Budings,tichondrius,1927,priest,discipline,143,77,66
26397,Velftrixi,sargeras,1927,priest,discipline,180,94,86
26398,Miamama,hydraxis,1926,priest,discipline,105,56,49
26399,Curachon,darkspear,1926,priest,discipline,93,42,51
26400,Invincible,ragnaros,1924,priest,discipline,80,45,35
26401,Balsak,zuljin,1924,priest,discipline,152,72,80
26402,Cklifer,tichondrius,1922,priest,discipline,46,26,20
26403,Lovelike,tichondrius,1922,priest,discipline,74,41,33
26404,Eyolo,tichondrius,1918,priest,discipline,78,40,38
26405,Vinnydiesel,tichondrius,1918,priest,discipline,66,32,34
26406,Fotmvark,stormrage,1916,priest,discipline,78,36,42
26407,Frostinal,illidan,1915,priest,discipline,126,69,57
26408,Høwtokill,azralon,1915,priest,discipline,89,36,53
26409,Thefiveoh,malganis,1914,priest,discipline,27,23,4
26410,Deathblind,kelthuzad,1912,priest,discipline,65,34,31
26411,Anasuzana,stormrage,1911,priest,discipline,66,38,28
26412,Muhfinx,tichondrius,1911,priest,discipline,53,30,23
26413,Artíst,sargeras,1911,priest,discipline,119,64,55
26414,Likethis,ragnaros,1911,priest,discipline,359,181,178
26415,Varenon,stormrage,1910,priest,discipline,159,90,69
26416,Evicereith,ragnaros,1910,priest,discipline,48,26,22
26417,Aitri,hakkar,1910,priest,discipline,151,73,78
26418,Penanceperry,bleeding-hollow,1910,priest,discipline,286,137,149
26419,Snackermz,tichondrius,1909,priest,discipline,112,48,64
26420,Chee,bleeding-hollow,1905,priest,discipline,60,34,26
26421,Omhz,tichondrius,1905,priest,discipline,96,49,47
26422,Ccgo,tichondrius,1902,priest,discipline,108,53,55
26423,Candyshack,area-52,1900,priest,discipline,111,64,47
26424,Riseandshine,illidan,1896,priest,discipline,54,38,16
26425,Pølupoker,illidan,1895,priest,discipline,59,27,32
26426,Boriz,frostmourne,1892,priest,discipline,79,44,35
26427,Zerorizz,tichondrius,1890,priest,discipline,42,20,22
26428,Ndzy,malganis,1890,priest,discipline,48,21,27
26429,Mumrah,antonidas,1889,priest,discipline,130,64,66
26430,Haunting,nerzhul,1886,priest,discipline,209,103,106
26431,Discopenguin,kelthuzad,1885,priest,discipline,60,34,26
26432,Khaoshealer,destromath,1884,priest,discipline,137,68,69
26433,Usefirstaid,sargeras,1883,priest,discipline,42,26,16
26434,Cupitan,tichondrius,1883,priest,discipline,62,27,35
26435,Grimacê,sargeras,1882,priest,discipline,98,49,49
26436,ßeyonder,tichondrius,1882,priest,discipline,122,58,64
26437,Abt,proudmoore,1882,priest,discipline,66,31,35
26438,Usedwrap,sargeras,1881,priest,discipline,78,43,35
26439,Capcana,tichondrius,1881,priest,discipline,114,61,53
26440,Jthealz,tichondrius,1881,priest,discipline,54,28,26
26441,Throatgoated,moon-guard,1881,priest,discipline,47,21,26
26442,Qipriest,tichondrius,1880,priest,discipline,66,28,38
26443,Cremona,tichondrius,1878,priest,discipline,84,39,45
26444,Breakmoon,tichondrius,1876,priest,discipline,78,33,45
26445,Sñ,illidan,1874,priest,discipline,48,27,21
26446,Rileymcgerr,tichondrius,1873,priest,discipline,42,24,18
26447,Exdric,kiljaeden,1873,priest,discipline,72,36,36
26448,Rawze,tichondrius,1873,priest,discipline,69,32,37
26449,Dellaptop,sargeras,1871,priest,discipline,88,51,37
26450,Nerfthedoc,blackrock,1869,priest,discipline,55,34,21
26451,Reydehaiti,ragnaros,1869,priest,discipline,54,31,23
26452,Montagehey,illidan,1868,priest,discipline,83,43,40
26453,Lidoradra,zuljin,1867,priest,discipline,77,36,41
26454,Notatk,tichondrius,1866,priest,discipline,221,99,122
26455,Tiestô,tichondrius,1864,priest,discipline,48,29,19
26456,Shallwedance,tichondrius,1864,priest,discipline,74,43,31
26457,Jerkingit,tichondrius,1864,priest,discipline,88,44,44
26458,Spoõks,darkspear,1862,priest,discipline,141,69,72
26459,Cokeheals,tichondrius,1861,priest,discipline,60,29,31
26460,Bubblekanush,tichondrius,1859,priest,discipline,36,22,14
26461,Reecepack,moon-guard,1859,priest,discipline,53,31,22
26462,Athênå,tichondrius,1859,priest,discipline,186,106,80
26463,Usebindwound,sargeras,1857,priest,discipline,108,65,43
26464,Highskrizzle,thrall,1857,priest,discipline,67,37,30
26465,Duw,icecrown,1857,priest,discipline,151,75,76
26466,Phludd,malganis,1856,priest,discipline,82,45,37
26467,Vizzy,stormrage,1856,priest,discipline,96,51,45
26468,Ravnica,kelthuzad,1856,priest,discipline,82,43,39
26469,Presence,blood-furnace,1855,priest,discipline,42,23,19
26470,Shadey,onyxia,1855,priest,discipline,54,26,28
26471,Nayzoh,darkspear,1855,priest,discipline,78,37,41
26472,Faeleath,emerald-dream,1855,priest,discipline,68,32,36
26473,Vidzar,area-52,1854,priest,discipline,42,28,14
26474,Drsquiddy,tichondrius,1854,priest,discipline,47,30,17
26475,Stayspooked,moon-guard,1852,priest,discipline,54,31,23
26476,Jtheals,illidan,1852,priest,discipline,35,20,15
26477,Centalinkxo,frostmourne,1851,priest,discipline,72,36,36
26478,Cardinaldave,frostmourne,1850,priest,discipline,48,26,22
26479,Shieldspamx,tichondrius,1850,priest,discipline,89,41,48
26480,Stinkiez,area-52,1849,priest,discipline,171,93,78
26481,Lumies,tichondrius,1848,priest,discipline,42,21,21
26482,Polarnight,zuljin,1848,priest,discipline,59,29,30
26483,Bigshieldlol,illidan,1847,priest,discipline,60,39,21
26484,Chromielol,tichondrius,1847,priest,discipline,54,31,23
26485,Tzïñåçåñ,tichondrius,1847,priest,discipline,54,29,25
26486,Voidnoodles,area-52,1846,priest,discipline,60,32,28
26487,Ultradumb,ragnaros,1846,priest,discipline,42,21,21
26488,Jmjeezy,tichondrius,1846,priest,discipline,48,22,26
26489,Fordranger,frostmourne,1845,priest,discipline,58,30,28
26490,Koalakazamzy,shadow-council,1845,priest,discipline,58,29,29
26491,Cavityx,illidan,1844,priest,discipline,52,30,22
26492,Steelcity,tichondrius,1843,priest,discipline,54,28,26
26493,Dacine,illidan,1843,priest,discipline,60,30,30
26494,Nickydamous,moon-guard,1843,priest,discipline,66,31,35
26495,Jiangfenglol,tichondrius,1843,priest,discipline,54,24,30
26496,Mcgg,tichondrius,1842,priest,discipline,158,76,82
26497,Zelená,trollbane,1841,priest,discipline,128,77,51
26498,Vampirê,tichondrius,1841,priest,discipline,66,35,31
26499,Kck,sentinels,1841,priest,discipline,95,44,51
26500,Meoveryou,stormrage,1840,priest,discipline,86,47,39
26501,Syliva,frostmourne,1840,priest,discipline,65,30,35
26502,Alisas,malganis,1840,priest,discipline,118,51,67
26503,Donutpriest,kelthuzad,1839,priest,discipline,78,44,34
26504,Koalakazamza,shadow-council,1839,priest,discipline,62,28,34
26505,Tistapriest,proudmoore,1837,priest,discipline,70,41,29
26506,Waggers,moon-guard,1837,priest,discipline,42,23,19
26507,Lotion,icecrown,1837,priest,discipline,48,25,23
26508,Katalad,wyrmrest-accord,1836,priest,discipline,48,31,17
26509,Tiernocookie,illidan,1836,priest,discipline,335,170,165
26510,Shamáng,tichondrius,1836,priest,discipline,80,39,41
26511,Binipriest,tichondrius,1835,priest,discipline,67,40,27
26512,Jamino,jubeithos,1835,priest,discipline,111,60,51
26513,Tmeugene,tichondrius,1835,priest,discipline,40,21,19
26514,Icychain,area-52,1835,priest,discipline,76,34,42
26515,Bugweeb,sargeras,1834,priest,discipline,87,56,31
26516,Layons,nemesis,1834,priest,discipline,134,86,48
26517,Twopiece,blackrock,1834,priest,discipline,54,31,23
26518,Rÿzo,tichondrius,1834,priest,discipline,111,63,48
26519,Thottsteal,queldorei,1834,priest,discipline,60,31,29
26520,Ameliarys,sargeras,1833,priest,discipline,103,51,52
26521,Sons,zuljin,1832,priest,discipline,54,29,25
26522,Meloxicamm,tichondrius,1832,priest,discipline,136,69,67
26523,Oghealz,lightnings-blade,1832,priest,discipline,54,27,27
26524,Oloriinn,stormrage,1831,priest,discipline,36,24,12
26525,Antagzy,bleeding-hollow,1830,priest,discipline,108,69,39
26526,Msai,tichondrius,1830,priest,discipline,114,68,46
26527,Pregnantmale,area-52,1830,priest,discipline,49,29,20
26528,Yotinha,stormrage,1830,priest,discipline,48,28,20
26529,Strvnge,malganis,1830,priest,discipline,60,28,32
26530,Xiaoqunzi,tichondrius,1830,priest,discipline,108,50,58
26531,Joezyxz,tichondrius,1829,priest,discipline,133,67,66
26532,Renfury,bleeding-hollow,1829,priest,discipline,48,22,26
26533,Cpks,tichondrius,1828,priest,discipline,76,48,28
26534,Baphomet,hyjal,1828,priest,discipline,88,53,35
26535,Misatomori,tichondrius,1828,priest,discipline,54,28,26
26536,Didy,dark-iron,1828,priest,discipline,58,27,31
26537,Epitoh,bleeding-hollow,1828,priest,discipline,78,36,42
26538,Sleetherp,barthilas,1827,priest,discipline,64,37,27
26539,Bkwhopper,emerald-dream,1827,priest,discipline,143,81,62
26540,Fracxured,sargeras,1827,priest,discipline,68,31,37
26541,Bloodyxx,bleeding-hollow,1825,priest,discipline,34,23,11
26542,Noted,aegwynn,1825,priest,discipline,104,70,34
26543,Buffle,zuluhed,1825,priest,discipline,66,38,28
26544,Yokuz,thunderlord,1825,priest,discipline,48,26,22
26545,Mackulate,tichondrius,1825,priest,discipline,65,34,31
26546,Cokeheals,kelthuzad,1825,priest,discipline,54,28,26
26547,Aprîl,quelthalas,1825,priest,discipline,72,37,35
26548,Däzzlë,quelthalas,1825,priest,discipline,72,35,37
26549,Pnsp,perenolde,1824,priest,discipline,42,30,12
26550,Xholyshietz,emerald-dream,1824,priest,discipline,71,48,23
26551,Pervysaged,sargeras,1824,priest,discipline,60,40,20
26552,Cya,deathwing,1824,priest,discipline,54,30,24
26553,Mancito,mannoroth,1824,priest,discipline,144,74,70
26554,Temérios,azralon,1824,priest,discipline,54,27,27
26555,Tuxen,wyrmrest-accord,1823,priest,discipline,48,29,19
26556,Swurvexo,bleeding-hollow,1823,priest,discipline,47,28,19
26557,Barthol,malygos,1823,priest,discipline,225,115,110
26558,Sprankels,bleeding-hollow,1823,priest,discipline,108,55,53
26559,Luhkx,stormrage,1823,priest,discipline,54,25,29
26560,Ohsop,chogall,1822,priest,discipline,49,33,16
26561,Dairy,the-underbog,1822,priest,discipline,49,29,20
26562,Lands,ragnaros,1822,priest,discipline,120,69,51
26563,Memoria,emerald-dream,1822,priest,discipline,117,60,57
26564,Bearfriend,malorne,1822,priest,discipline,47,24,23
26565,Zachon,sargeras,1822,priest,discipline,54,27,27
26566,Oohso,chogall,1821,priest,discipline,91,43,48
26567,Rerollpriest,firetree,1821,priest,discipline,53,25,28
26568,Chiot,tichondrius,1820,priest,discipline,61,48,13
26569,Ultrà,ragnaros,1820,priest,discipline,71,44,27
26570,Wreklol,tichondrius,1820,priest,discipline,60,34,26
26571,Mindseye,azgalor,1820,priest,discipline,114,58,56
26572,Dietcokee,stormrage,1820,priest,discipline,62,31,31
26573,Ujelin,kiljaeden,1820,priest,discipline,48,24,24
26574,Horzp,bleeding-hollow,1820,priest,discipline,66,31,35
26575,Tophr,illidan,1819,priest,discipline,41,24,17
26576,Wapriest,blades-edge,1819,priest,discipline,500,248,252
26577,Chk,moon-guard,1819,priest,discipline,136,65,71
26578,Soojwa,frostmourne,1819,priest,discipline,54,24,30
26579,Novel,moon-guard,1817,priest,discipline,30,24,6
26580,Despairx,tichondrius,1817,priest,discipline,102,66,36
26581,Gaudthree,tichondrius,1817,priest,discipline,46,25,21
26582,Akuzaki,illidan,1817,priest,discipline,54,25,29
26583,Sliktrik,area-52,1817,priest,discipline,65,29,36
26584,Dapp,barthilas,1817,priest,discipline,77,33,44
26585,Cynthus,dalvengyr,1816,priest,discipline,102,60,42
26586,Lichtschreit,zuljin,1816,priest,discipline,41,24,17
26587,Juicyturon,moon-guard,1816,priest,discipline,77,45,32
26588,Dispassion,dalaran,1816,priest,discipline,58,33,25
26589,Woodowl,tichondrius,1816,priest,discipline,46,25,21
26590,Bamboon,tanaris,1816,priest,discipline,102,55,47
26591,Jackski,nemesis,1816,priest,discipline,48,25,23
26592,Legendary,ragnaros,1816,priest,discipline,78,33,45
26593,Quèénstar,tichondrius,1816,priest,discipline,79,33,46
26594,Badrapture,sargeras,1815,priest,discipline,92,69,23
26595,Mødilon,nemesis,1815,priest,discipline,47,29,18
26596,Rythmzz,kiljaeden,1815,priest,discipline,108,59,49
26597,Engle,arathor,1815,priest,discipline,42,22,20
26598,Badnsweaty,sargeras,1815,priest,discipline,76,38,38
26599,Ousïa,quelthalas,1815,priest,discipline,164,81,83
26600,Mommyafk,moon-guard,1815,priest,discipline,54,25,29
26601,Psyjes,stormrage,1814,priest,discipline,111,69,42
26602,Diwara,ragnaros,1814,priest,discipline,60,37,23
26603,Fullmetals,azralon,1814,priest,discipline,53,30,23
26604,Zuwukey,kirin-tor,1814,priest,discipline,163,85,78
26605,Tanmo,illidan,1814,priest,discipline,96,50,46
26606,Syllè,area-52,1814,priest,discipline,48,24,24
26607,Adûnaic,frostmourne,1814,priest,discipline,380,185,195
26608,Fibbre,tichondrius,1814,priest,discipline,121,54,67
26609,Razdaz,twisting-nether,1814,priest,discipline,66,29,37
26610,Relicx,firetree,1813,priest,discipline,54,33,21
26611,Youhealme,area-52,1813,priest,discipline,90,54,36
26612,Hoonjojjyang,tichondrius,1813,priest,discipline,66,37,29
26613,Morboo,proudmoore,1813,priest,discipline,78,43,35
26614,Svzy,illidan,1813,priest,discipline,48,26,22
26615,Sasha,muradin,1813,priest,discipline,142,70,72
26616,Sixfourtank,tichondrius,1813,priest,discipline,53,26,27
26617,Falsity,kelthuzad,1813,priest,discipline,66,32,34
26618,Ahoy,sargeras,1812,priest,discipline,75,46,29
26619,Abstention,area-52,1812,priest,discipline,66,35,31
26620,Fatbellyx,sargeras,1812,priest,discipline,72,36,36
26621,Sabalonely,tichondrius,1812,priest,discipline,42,19,23
26622,Tyrrshadow,skywall,1811,priest,discipline,104,58,46
26623,Tallïa,stormrage,1811,priest,discipline,155,82,73
26624,Hungrybone,proudmoore,1811,priest,discipline,641,327,314
26625,Wübbie,emerald-dream,1810,priest,discipline,72,40,32
26626,Walterwhite,bleeding-hollow,1810,priest,discipline,42,19,23
26627,Paytin,illidan,1810,priest,discipline,71,32,39
26628,Arguseonp,proudmoore,1809,priest,discipline,54,37,17
26629,Ãbelladanger,area-52,1809,priest,discipline,65,43,22
26630,Jemine,tichondrius,1809,priest,discipline,108,64,44
26631,Thepumps,sargeras,1809,priest,discipline,73,43,30
26632,Paramour,laughing-skull,1809,priest,discipline,108,59,49
26633,Jaquels,sargeras,1809,priest,discipline,130,65,65
26634,Dabaojian,tichondrius,1809,priest,discipline,60,28,32
26635,Aube,frostmourne,1809,priest,discipline,51,23,28
26636,Nudithree,malganis,1808,priest,discipline,38,26,12
26637,Antts,tichondrius,1808,priest,discipline,48,31,17
26638,Vbear,dunemaul,1808,priest,discipline,71,39,32
26639,Pkkdestiny,archimonde,1808,priest,discipline,71,37,34
26640,Catbabyorz,tichondrius,1808,priest,discipline,84,41,43
26641,Pns,perenolde,1808,priest,discipline,66,32,34
26642,Buhroketwo,thrall,1807,priest,discipline,66,41,25
26643,Dopeypriest,area-52,1807,priest,discipline,120,68,52
26644,Indiglo,arthas,1807,priest,discipline,84,44,40
26645,Gices,area-52,1806,priest,discipline,36,24,12
26646,Exøtic,tichondrius,1806,priest,discipline,54,35,19
26647,Ayakashi,frostmourne,1806,priest,discipline,75,46,29
26648,Wormface,moon-guard,1806,priest,discipline,58,35,23
26649,Senzy,tichondrius,1806,priest,discipline,150,81,69
26650,Releriel,area-52,1806,priest,discipline,58,31,27
26651,Inthemix,stormreaver,1806,priest,discipline,376,197,179
26652,Yezhua,zuljin,1806,priest,discipline,84,44,40
26653,Scrollozaddy,illidan,1805,priest,discipline,258,157,101
26654,Purplebeauty,tichondrius,1805,priest,discipline,198,119,79
26655,Leapofdoubt,zuljin,1805,priest,discipline,250,132,118
26656,Rylla,illidan,1805,priest,discipline,66,34,32
26657,Maghobou,tichondrius,1805,priest,discipline,66,30,36
26658,Öxhö,tichondrius,1804,priest,discipline,44,31,13
26659,Ðsco,tichondrius,1804,priest,discipline,36,24,12
26660,Absorbs,stormrage,1804,priest,discipline,30,19,11
26661,Fearmen,tichondrius,1804,priest,discipline,59,33,26
26662,Selath,ragnaros,1804,priest,discipline,47,26,21
26663,Angelumlucis,frostmane,1804,priest,discipline,145,80,65
26664,Syrillia,wildhammer,1804,priest,discipline,142,78,64
26665,Cln,bleeding-hollow,1804,priest,discipline,65,32,33
26666,Taipriest,frostmourne,1804,priest,discipline,222,103,119
26667,Yeeseafood,tichondrius,1804,priest,discipline,64,27,37
26668,Thaldrum,tichondrius,1804,priest,discipline,79,30,49
26669,Curney,stormrage,1803,priest,discipline,65,46,19
26670,Jinais,zuluhed,1803,priest,discipline,48,33,15
26671,Phillthevoid,sargeras,1803,priest,discipline,45,29,16
26672,Applecare,illidan,1803,priest,discipline,102,60,42
26673,Tarlex,illidan,1803,priest,discipline,168,94,74
26674,Goldsunx,emerald-dream,1803,priest,discipline,152,85,67
26675,Tjphess,zuljin,1803,priest,discipline,240,130,110
26676,Luciuz,tichondrius,1803,priest,discipline,84,45,39
26677,Cbalnom,tichondrius,1803,priest,discipline,70,37,33
26678,Sußlime,frostwolf,1803,priest,discipline,90,47,43
26679,Hotgirlshiit,dalaran,1803,priest,discipline,298,145,153
26680,Manyhot,tichondrius,1802,priest,discipline,51,32,19
26681,Yrñwiotøø,illidan,1802,priest,discipline,54,33,21
26682,Reignen,tichondrius,1802,priest,discipline,183,101,82
26683,Seifong,frostmourne,1802,priest,discipline,125,68,57
26684,Deathallpoly,tichondrius,1802,priest,discipline,431,227,204
26685,Retardèr,tichondrius,1801,priest,discipline,97,68,29
26686,Reverendtun,area-52,1801,priest,discipline,83,55,28
26687,Vànhendrix,tichondrius,1801,priest,discipline,53,29,24
26688,Louisé,hydraxis,1801,priest,discipline,48,25,23
26689,Wânda,tichondrius,1801,priest,discipline,111,57,54
26690,Xtcbtc,sargeras,1801,priest,discipline,93,44,49
26691,Lípjju,tichondrius,1801,priest,discipline,54,24,30
26692,Geekynerd,frostmourne,1800,priest,discipline,151,98,53
26693,Bigmomcook,tichondrius,1800,priest,discipline,215,125,90
26694,Imissdave,dethecus,1800,priest,discipline,48,27,21
26695,Narakku,sargeras,1800,priest,discipline,108,59,49
26696,Bwgyx,area-52,1800,priest,discipline,42,22,20
26697,Bibleblak,stormrage,1800,priest,discipline,102,53,49
26698,Alola,illidan,1800,priest,discipline,135,69,66
26699,Shenanígans,malganis,1800,priest,discipline,42,19,23
26700,Anyra,stormrage,1799,priest,discipline,51,26,25
26701,Bomí,tichondrius,1799,priest,discipline,84,41,43
26702,Olark,durotan,1799,priest,discipline,286,139,147
26703,Fearinoculúm,bleeding-hollow,1798,priest,discipline,24,19,5
26704,Vaaynee,ragnaros,1797,priest,discipline,114,61,53
26705,Comebaack,stormrage,1797,priest,discipline,98,51,47
26706,Celestiah,illidan,1796,priest,discipline,54,28,26
26707,Impvp,tichondrius,1795,priest,discipline,89,49,40
26708,Zins,emerald-dream,1795,priest,discipline,90,44,46
26709,Änanti,tichondrius,1794,priest,discipline,83,45,38
26710,Niniua,tichondrius,1794,priest,discipline,36,19,17
26711,Cellestine,aggramar,1792,priest,discipline,133,67,66
26712,Selenitax,sargeras,1792,priest,discipline,92,45,47
26713,Wormclergy,tichondrius,1791,priest,discipline,80,39,41
26714,Shnozberry,tichondrius,1790,priest,discipline,102,43,59
26715,Bublehead,zuljin,1789,priest,discipline,114,56,58
26716,Ryno,cenarion-circle,1788,priest,discipline,74,40,34
26717,Summersetisl,tichondrius,1787,priest,discipline,66,29,37
26718,Euphorz,tichondrius,1786,priest,discipline,36,19,17
26719,Hadoka,ragnaros,1786,priest,discipline,54,23,31
26720,Priceléss,tichondrius,1784,priest,discipline,30,22,8
26721,Deathwisher,illidan,1784,priest,discipline,181,93,88
26722,Bellaelle,stormrage,1783,priest,discipline,57,29,28
26723,Myeryc,frostmourne,1782,priest,discipline,47,19,28
26724,Tmversace,tichondrius,1781,priest,discipline,112,56,56
26725,Usedmedkit,sargeras,1780,priest,discipline,47,28,19
26726,Ragretsxo,darkspear,1780,priest,discipline,96,51,45
26727,Discflips,dalaran,1779,priest,discipline,210,106,104
26728,Kóba,bleeding-hollow,1778,priest,discipline,48,33,15
26729,Ritzzx,ragnaros,1777,priest,discipline,101,51,50
26730,Ÿsk,tichondrius,1775,priest,discipline,138,80,58
26731,Deathlullaby,malganis,1775,priest,discipline,42,21,21
26732,Isilador,moon-guard,1775,priest,discipline,95,44,51
26733,Whalexo,kelthuzad,1774,priest,discipline,155,82,73
26734,Pesca,proudmoore,1774,priest,discipline,125,59,66
26735,Crøws,ragnaros,1773,priest,discipline,112,58,54
26736,Angelforcez,frostmourne,1773,priest,discipline,47,19,28
26737,Pnub,aggramar,1772,priest,discipline,105,52,53
26738,Zulazane,azralon,1769,priest,discipline,366,199,167
26739,Canibumsmoke,illidan,1769,priest,discipline,75,40,35
26740,Auxp,tichondrius,1769,priest,discipline,59,23,36
26741,Dannycarrier,tichondrius,1768,priest,discipline,30,21,9
26742,Kabugi,illidan,1768,priest,discipline,96,52,44
26743,Rlzpriest,tichondrius,1768,priest,discipline,107,56,51
26744,Írithyll,stormrage,1767,priest,discipline,59,33,26
26745,Barley,chogall,1767,priest,discipline,42,22,20
26746,Pibkac,stormrage,1767,priest,discipline,69,34,35
26747,Healum,nemesis,1765,priest,discipline,106,59,47
26748,Osis,rivendare,1764,priest,discipline,165,80,85
26749,Sebpriest,proudmoore,1764,priest,discipline,42,20,22
26750,Deathtones,barthilas,1763,priest,discipline,143,77,66
26751,Deadpriesst,arthas,1763,priest,discipline,72,36,36
26752,Hugemilkys,tichondrius,1762,priest,discipline,85,46,39
26753,Darbybean,bleeding-hollow,1762,priest,discipline,54,28,26
26754,Bonigan,sargeras,1761,priest,discipline,185,110,75
26755,Gochuxx,tichondrius,1761,priest,discipline,66,34,32
26756,Bloodyx,bleeding-hollow,1761,priest,discipline,172,88,84
26757,Barrenbuffet,zuljin,1761,priest,discipline,206,103,103
26758,Nearo,barthilas,1761,priest,discipline,60,26,34
26759,Raysx,stormrage,1759,priest,discipline,83,37,46
26760,Kaddy,mannoroth,1757,priest,discipline,130,60,70
26761,Compxx,barthilas,1756,priest,discipline,66,38,28
26762,Luciellis,sargeras,1755,priest,discipline,90,51,39
26763,Probs,frostmourne,1755,priest,discipline,135,69,66
26764,Papabrokuttv,sargeras,1755,priest,discipline,42,19,23
26765,Jaytee,aggramar,1754,priest,discipline,72,33,39
26766,Corvenna,zuljin,1751,priest,discipline,48,27,21
26767,Mautmaut,quelthalas,1750,priest,discipline,65,42,23
26768,Ukishizumi,tichondrius,1748,priest,discipline,143,75,68
26769,Nyluh,deathwing,1748,priest,discipline,74,38,36
26770,Raizy,stormrage,1748,priest,discipline,53,26,27
26771,Ferguss,ragnaros,1747,priest,discipline,79,42,37
26772,Fhinky,tichondrius,1746,priest,discipline,207,103,104
26773,Alarin,whisperwind,1745,priest,discipline,60,30,30
26774,Evilear,tichondrius,1745,priest,discipline,66,31,35
26775,Ninbara,tichondrius,1745,priest,discipline,59,27,32
26776,Onikûdaki,sargeras,1744,priest,discipline,53,24,29
26777,Hamstip,sargeras,1743,priest,discipline,98,58,40
26778,Moalboal,tichondrius,1743,priest,discipline,180,98,82
26779,Natoshi,illidan,1742,priest,discipline,48,25,23
26780,Demaholy,illidan,1742,priest,discipline,142,73,69
26781,Cursèlol,tichondrius,1742,priest,discipline,90,45,45
26782,Robdàwg,illidan,1742,priest,discipline,60,26,34
26783,Toastspriest,tichondrius,1741,priest,discipline,101,60,41
26784,Luwoona,tichondrius,1740,priest,discipline,90,41,49
26785,Bennito,moon-guard,1739,priest,discipline,138,65,73
26786,Aloxc,drakkari,1738,priest,discipline,36,19,17
26787,Shadheda,andorhal,1738,priest,discipline,56,26,30
26788,Jimmythedon,mugthol,1738,priest,discipline,72,33,39
26789,Paidtowin,frostmourne,1738,priest,discipline,56,21,35
26790,Trengodqt,destromath,1737,priest,discipline,205,110,95
26791,Pgpriest,kelthuzad,1737,priest,discipline,90,44,46
26792,Rigxy,arthas,1736,priest,discipline,123,76,47
26793,Orderic,ragnaros,1736,priest,discipline,57,32,25
26794,Marcìano,bleeding-hollow,1736,priest,discipline,64,35,29
26795,Kelthax,sargeras,1736,priest,discipline,54,23,31
26796,Niark,frostmourne,1736,priest,discipline,48,20,28
26797,Envio,moon-guard,1735,priest,discipline,36,26,10
26798,Maybedead,tichondrius,1734,priest,discipline,42,26,16
26799,Guerisser,hyjal,1734,priest,discipline,140,83,57
26800,Obscure,malygos,1734,priest,discipline,74,32,42
26801,Holyster,tichondrius,1733,priest,discipline,44,20,24
26802,Sinday,zuljin,1732,priest,discipline,60,29,31
26803,Skunkbishop,sargeras,1731,priest,discipline,204,98,106
26804,Saelom,frostmourne,1730,priest,discipline,78,49,29
26805,Justafkoutpr,gorefiend,1729,priest,discipline,48,34,14
26806,Murth,laughing-skull,1729,priest,discipline,47,30,17
26807,Johanna,tichondrius,1729,priest,discipline,41,26,15
26808,Hideonlight,barthilas,1729,priest,discipline,471,243,228
26809,Neverbeen,tichondrius,1728,priest,discipline,473,250,223
26810,Airelia,sargeras,1728,priest,discipline,54,28,26
26811,Blasphêmy,malganis,1727,priest,discipline,86,52,34
26812,Åpples,tichondrius,1727,priest,discipline,71,31,40
26813,Apoorstudent,tichondrius,1726,priest,discipline,116,72,44
26814,Mxfd,tichondrius,1726,priest,discipline,47,27,20
26815,Dévore,dalaran,1726,priest,discipline,46,25,21
26816,Analogxz,nemesis,1726,priest,discipline,168,81,87
26817,Conifer,emerald-dream,1725,priest,discipline,60,35,25
26818,Barthbelro,kiljaeden,1725,priest,discipline,87,49,38
26819,Holyhõ,stormrage,1725,priest,discipline,48,27,21
26820,Goneqt,illidan,1725,priest,discipline,60,29,31
26821,Jezebëll,nemesis,1724,priest,discipline,192,99,93
26822,Kebab,tichondrius,1723,priest,discipline,30,18,12
26823,Dontlineme,tichondrius,1723,priest,discipline,142,64,78
26824,Xidis,vashj,1723,priest,discipline,71,29,42
26825,Sobamian,tichondrius,1723,priest,discipline,90,36,54
26826,Mååxxee,zuljin,1722,priest,discipline,30,18,12
26827,Sylvphrena,stormrage,1722,priest,discipline,30,18,12
26828,Zaryx,wildhammer,1722,priest,discipline,42,24,18
26829,Vegetable,suramar,1722,priest,discipline,36,18,18
26830,Downturn,tichondrius,1722,priest,discipline,54,23,31
26831,Leonilcx,tichondrius,1721,priest,discipline,733,367,366
26832,Philmacrakn,stormrage,1721,priest,discipline,167,81,86
26833,Kostantina,kelthuzad,1721,priest,discipline,154,69,85
26834,Leticia,magtheridon,1719,priest,discipline,100,48,52
26835,Jexso,tichondrius,1719,priest,discipline,163,78,85
26836,Opriest,queldorei,1718,priest,discipline,54,27,27
26837,Ooit,tichondrius,1717,priest,discipline,24,22,2
26838,Wizpell,area-52,1717,priest,discipline,42,18,24
26839,Pissfeet,tichondrius,1716,priest,discipline,30,18,12
26840,Rotbaron,bleeding-hollow,1716,priest,discipline,108,48,60
26841,Cody,magtheridon,1715,priest,discipline,72,49,23
26842,Woobgasm,sargeras,1715,priest,discipline,72,46,26
26843,Kragenn,malganis,1713,priest,discipline,165,83,82
26844,Mygameslaggy,area-52,1713,priest,discipline,78,33,45
26845,Pastapizza,zuljin,1712,priest,discipline,24,22,2
26846,Rachell,emerald-dream,1712,priest,discipline,36,26,10
26847,Kastep,tichondrius,1712,priest,discipline,88,44,44
26848,Bakara,jubeithos,1712,priest,discipline,42,18,24
26849,Smitelytius,tichondrius,1711,priest,discipline,30,18,12
26850,Trebrooke,sargeras,1710,priest,discipline,161,88,73
26851,Touchrr,tichondrius,1710,priest,discipline,108,58,50
26852,Veejae,tichondrius,1710,priest,discipline,42,22,20
26853,Valothrian,area-52,1710,priest,discipline,172,86,86
26854,Dorgondra,wyrmrest-accord,1709,priest,discipline,48,26,22
26855,Dippyboi,whisperwind,1709,priest,discipline,48,25,23
26856,Meltmeltz,nerzhul,1708,priest,discipline,65,29,36
26857,Andreslol,sargeras,1707,priest,discipline,54,32,22
26858,Shiromar,tichondrius,1707,priest,discipline,66,38,28
26859,Asthenia,saurfang,1706,priest,discipline,120,59,61
26860,Sarïya,moon-guard,1706,priest,discipline,125,61,64
26861,Byck,tichondrius,1706,priest,discipline,54,23,31
26862,Sodezz,stormrage,1705,priest,discipline,36,21,15
26863,Inquisitionx,frostmourne,1705,priest,discipline,223,120,103
26864,Bfts,illidan,1705,priest,discipline,227,119,108
26865,Mellow,tichondrius,1705,priest,discipline,170,89,81
26866,Crypcanheal,sargeras,1705,priest,discipline,442,217,225
26867,Forti,sargeras,1705,priest,discipline,156,74,82
26868,Squaanchy,bleeding-hollow,1705,priest,discipline,129,61,68
26869,Staars,ragnaros,1704,priest,discipline,66,37,29
26870,Fancydisc,barthilas,1703,priest,discipline,30,18,12
26871,Gfayde,sargeras,1702,priest,discipline,36,20,16
26872,Nightcráwler,illidan,1702,priest,discipline,89,47,42
26873,Irenesome,tichondrius,1701,priest,discipline,45,21,24
26874,Ogneus,crushridge,1700,priest,discipline,51,22,29
26875,Tanzen,andorhal,1699,priest,discipline,36,21,15
26876,Beowulfy,stormrage,1699,priest,discipline,48,27,21
26877,Séxgodx,tichondrius,1698,priest,discipline,53,24,29
26878,Clydeington,illidan,1697,priest,discipline,49,29,20
26879,Cryptron,tichondrius,1697,priest,discipline,54,28,26
26880,Nancynibbler,bleeding-hollow,1697,priest,discipline,70,32,38
26881,Saviorlol,tichondrius,1697,priest,discipline,53,23,30
26882,Mixful,bleeding-hollow,1696,priest,discipline,40,27,13
26883,Obsolete,area-52,1696,priest,discipline,48,23,25
26884,Twêet,frostmourne,1696,priest,discipline,186,87,99
26885,Vcainyfairy,stormrage,1695,priest,discipline,489,247,242
26886,Nickzx,tichondrius,1694,priest,discipline,52,36,16
26887,Rmxx,illidan,1694,priest,discipline,143,80,63
26888,Geon,sargeras,1693,priest,discipline,107,53,54
26889,Veiveilol,tichondrius,1693,priest,discipline,59,24,35
26890,Acpriest,tichondrius,1692,priest,discipline,87,46,41
26891,Fullfear,lothar,1691,priest,discipline,42,26,16
26892,Bosspriest,tichondrius,1691,priest,discipline,48,23,25
26893,Drethor,saurfang,1691,priest,discipline,76,36,40
26894,Pigogo,tichondrius,1690,priest,discipline,45,26,19
26895,Highprofile,proudmoore,1690,priest,discipline,36,18,18
26896,Nxghtmares,tichondrius,1690,priest,discipline,360,175,185
26897,Catonement,moon-guard,1690,priest,discipline,475,230,245
26898,Slùm,barthilas,1689,priest,discipline,43,27,16
26899,Mastaspell,illidan,1689,priest,discipline,31,18,13
26900,Elybele,sargeras,1689,priest,discipline,114,61,53
26901,Yobell,tichondrius,1688,priest,discipline,36,23,13
26902,Argylemomo,emerald-dream,1688,priest,discipline,202,103,99
26903,Sweetnipsbro,tichondrius,1688,priest,discipline,71,35,36
26904,Wildsmite,hyjal,1688,priest,discipline,222,102,120
26905,Cayleey,stormrage,1688,priest,discipline,78,35,43
26906,Duubz,kelthuzad,1687,priest,discipline,96,51,45
26907,Oopsy,bleeding-hollow,1687,priest,discipline,60,31,29
26908,Prïestitute,zuljin,1686,priest,discipline,108,70,38
26909,Persimmons,lightbringer,1686,priest,discipline,113,61,52
26910,Andypr,illidan,1686,priest,discipline,66,25,41
26911,Heart,misha,1685,priest,discipline,132,70,62
26912,Salvation,tichondrius,1684,priest,discipline,60,27,33
26913,Turtlez,area-52,1684,priest,discipline,78,35,43
26914,Vandamnation,barthilas,1682,priest,discipline,128,61,67
26915,Onineko,bleeding-hollow,1681,priest,discipline,57,32,25
26916,Plaguebaby,stormrage,1681,priest,discipline,45,23,22
26917,Melforn,moon-guard,1681,priest,discipline,59,28,31
26918,Ieveling,skywall,1681,priest,discipline,65,30,35
26919,Kujox,tichondrius,1681,priest,discipline,70,31,39
26920,Lingdums,tichondrius,1680,priest,discipline,31,18,13
26921,Mintadnade,nemesis,1679,priest,discipline,163,81,82
26922,Poosydoodlez,malganis,1679,priest,discipline,105,48,57
26923,Qtasiangirl,emerald-dream,1679,priest,discipline,109,47,62
26924,Rámmstein,wyrmrest-accord,1678,priest,discipline,120,65,55
26925,Derpmodé,staghelm,1678,priest,discipline,54,28,26
26926,Nabukom,destromath,1678,priest,discipline,52,25,27
26927,Danceslol,area-52,1678,priest,discipline,42,20,22
26928,Charbosan,gorgonnash,1677,priest,discipline,638,332,306
26929,Melshiesty,stormrage,1677,priest,discipline,42,20,22
26930,Holyfall,sargeras,1676,priest,discipline,220,116,104
26931,Gurgs,emerald-dream,1676,priest,discipline,38,19,19
26932,Iyoui,tichondrius,1675,priest,discipline,30,20,10
26933,Narodiz,nemesis,1675,priest,discipline,48,26,22
26934,Bonehead,warsong,1675,priest,discipline,48,23,25
26935,Starpass,illidan,1673,priest,discipline,42,31,11
26936,Stoneflute,emerald-dream,1673,priest,discipline,153,87,66
26937,Jammeslight,quelthalas,1673,priest,discipline,124,67,57
26938,Holécriss,tichondrius,1672,priest,discipline,143,77,66
26939,Merit,emerald-dream,1672,priest,discipline,144,76,68
26940,Aco,tichondrius,1672,priest,discipline,150,79,71
26941,Scab,anetheron,1672,priest,discipline,130,62,68
26942,Claverr,stormrage,1670,priest,discipline,33,20,13
26943,Serakiki,nemesis,1670,priest,discipline,72,41,31
26944,Pawnza,tichondrius,1670,priest,discipline,102,50,52
26945,Dachenchen,tichondrius,1669,priest,discipline,36,27,9
26946,Kagemetsu,sargeras,1669,priest,discipline,152,74,78
26947,Boostedpi,tichondrius,1669,priest,discipline,44,21,23
26948,Jmlz,tichondrius,1668,priest,discipline,36,23,13
26949,Elilium,tichondrius,1668,priest,discipline,80,48,32
26950,Alomari,zuljin,1668,priest,discipline,32,19,13
26951,Milkkz,zuljin,1668,priest,discipline,54,30,24
26952,Trollpreist,tichondrius,1668,priest,discipline,136,70,66
26953,Klitarus,barthilas,1668,priest,discipline,48,23,25
26954,Mcfref,tichondrius,1667,priest,discipline,135,70,65
26955,Wonpaipri,frostmourne,1667,priest,discipline,65,31,34
26956,Clockwororan,tichondrius,1666,priest,discipline,36,21,15
26957,Muffingal,tichondrius,1666,priest,discipline,36,19,17
26958,Nelpesh,tichondrius,1666,priest,discipline,60,27,33
26959,Shrimpouh,illidan,1665,priest,discipline,72,39,33
26960,Purged,shadowmoon,1665,priest,discipline,367,198,169
26961,Góndhi,tichondrius,1664,priest,discipline,42,25,17
26962,Crysknife,korgath,1664,priest,discipline,35,20,15
26963,Swagraptor,stormreaver,1663,priest,discipline,138,76,62
26964,Størmy,kiljaeden,1663,priest,discipline,246,132,114
26965,Shocklol,stormrage,1662,priest,discipline,29,22,7
26966,Apathist,sargeras,1662,priest,discipline,66,44,22
26967,Eetsqt,barthilas,1662,priest,discipline,114,71,43
26968,Hallucinogen,kelthuzad,1662,priest,discipline,95,51,44
26969,Fisp,moon-guard,1661,priest,discipline,72,33,39
26970,Resisted,gorefiend,1660,priest,discipline,238,120,118
26971,Marejaynez,tichondrius,1659,priest,discipline,139,63,76
26972,Drtyror,area-52,1658,priest,discipline,54,34,20
26973,Muffinboy,illidan,1658,priest,discipline,54,20,34
26974,Yunnan,executus,1657,priest,discipline,78,43,35
26975,Caveron,tichondrius,1657,priest,discipline,42,23,19
26976,Chaner,scarlet-crusade,1657,priest,discipline,72,28,44
26977,Syo,dreadmaul,1656,priest,discipline,95,48,47
26978,Toopriestly,deathwing,1656,priest,discipline,65,32,33
26979,Yaz,emerald-dream,1656,priest,discipline,71,34,37
26980,Silkydeath,frostmourne,1655,priest,discipline,42,24,18
26981,Theravus,moon-guard,1655,priest,discipline,124,67,57
26982,Hermanmiller,frostmourne,1655,priest,discipline,48,25,23
26983,Dojacatx,frostmourne,1655,priest,discipline,66,32,34
26984,Naranjitá,ragnaros,1654,priest,discipline,66,42,24
26985,Tinyheal,sargeras,1654,priest,discipline,110,57,53
26986,Darknuz,sargeras,1654,priest,discipline,53,27,26
26987,Zãrrãlis,arthas,1654,priest,discipline,198,99,99
26988,Gibens,tichondrius,1654,priest,discipline,130,64,66
26989,Marython,tichondrius,1654,priest,discipline,76,34,42
26990,Perceptions,dalaran,1653,priest,discipline,36,23,13
26991,Kathere,tichondrius,1653,priest,discipline,42,23,19
26992,Caveria,emerald-dream,1653,priest,discipline,247,126,121
26993,Astroluma,illidan,1653,priest,discipline,46,23,23
26994,Zunitpriest,laughing-skull,1653,priest,discipline,36,18,18
26995,Sanddglokta,tichondrius,1653,priest,discipline,290,142,148
26996,Dpendant,frostmourne,1653,priest,discipline,66,31,35
26997,Vtp,frostmourne,1652,priest,discipline,70,40,30
26998,Dijkstracted,ragnaros,1652,priest,discipline,145,79,66
26999,Glassbirds,stormrage,1652,priest,discipline,48,25,23
27000,Opscurum,bleeding-hollow,1651,priest,discipline,48,28,20
27001,Aleana,ragnaros,1651,priest,discipline,42,23,19
27002,Brxddx,sargeras,1651,priest,discipline,113,59,54
27003,Vanderbeek,frostmourne,1651,priest,discipline,66,33,33
27004,Airalia,bleeding-hollow,1650,priest,discipline,36,23,13
27005,Sêlbus,stormrage,1650,priest,discipline,228,121,107
27006,Somefire,proudmoore,1650,priest,discipline,155,78,77
27007,Nomsayin,stormrage,1649,priest,discipline,36,23,13
27008,Hanley,tichondrius,1649,priest,discipline,85,48,37
27009,Shastea,crushridge,1649,priest,discipline,70,37,33
27010,Ixchelune,kelthuzad,1649,priest,discipline,237,119,118
27011,Larry,tichondrius,1649,priest,discipline,65,31,34
27012,Jatral,azralon,1649,priest,discipline,64,30,34
27013,Nopang,tichondrius,1649,priest,discipline,167,77,90
27014,Chañing,frostmourne,1649,priest,discipline,72,33,39
27015,Lanäthel,sargeras,1648,priest,discipline,28,19,9
27016,Wøo,area-52,1648,priest,discipline,81,48,33
27017,Tanthsondis,illidan,1648,priest,discipline,48,27,21
27018,Cixelpvp,area-52,1648,priest,discipline,47,22,25
27019,Deadpla,ragnaros,1648,priest,discipline,83,36,47
27020,Krewesin,ravencrest,1647,priest,discipline,43,22,21
27021,Lòthnalar,ragnaros,1647,priest,discipline,60,29,31
27022,Tryfekta,frostmourne,1647,priest,discipline,78,37,41
27023,Dorazòn,bleeding-hollow,1647,priest,discipline,54,25,29
27024,Liteztvp,tichondrius,1647,priest,discipline,156,72,84
27025,Synsparks,tichondrius,1647,priest,discipline,60,25,35
27026,Spx,frostmourne,1646,priest,discipline,48,30,18
27027,Bushybush,darkspear,1646,priest,discipline,53,32,21
27028,Twistynipple,malganis,1646,priest,discipline,42,25,17
27029,Klttzz,sargeras,1646,priest,discipline,60,32,28
27030,Khorium,stormrage,1646,priest,discipline,46,21,25
27031,Rosaparksxo,sargeras,1645,priest,discipline,70,35,35
27032,Cavatea,illidan,1645,priest,discipline,42,21,21
27033,Adrio,malorne,1645,priest,discipline,290,140,150
27034,Meepsw,stormrage,1644,priest,discipline,60,33,27
27035,Honeyduutch,black-dragonflight,1644,priest,discipline,72,37,35
27036,Itsmurphy,sargeras,1644,priest,discipline,120,57,63
27037,Beelzebul,illidan,1644,priest,discipline,60,26,34
27038,Toddmund,tichondrius,1644,priest,discipline,64,25,39
27039,Tonydatiger,the-forgotten-coast,1643,priest,discipline,36,21,15
27040,Kazuret,ragnaros,1643,priest,discipline,266,139,127
27041,Kuell,ragnaros,1642,priest,discipline,53,29,24
27042,Selfless,barthilas,1642,priest,discipline,60,26,34
27043,Reiae,malganis,1642,priest,discipline,70,27,43
27044,Haduth,area-52,1641,priest,discipline,154,82,72
27045,Shadzx,andorhal,1641,priest,discipline,47,22,25
27046,Googolplex,tichondrius,1640,priest,discipline,57,39,18
27047,Lolcrafthd,ragnaros,1640,priest,discipline,64,36,28
27048,Alguîen,ragnaros,1640,priest,discipline,115,61,54
27049,Akëla,nemesis,1640,priest,discipline,96,50,46
27050,Life,amanthul,1639,priest,discipline,143,84,59
27051,Auras,boulderfist,1639,priest,discipline,52,30,22
27052,Hypes,korgath,1639,priest,discipline,85,49,36
27053,Randompreest,stormrage,1639,priest,discipline,42,23,19
27054,Matin,frostmourne,1639,priest,discipline,39,21,18
27055,Mealmassttr,frostmourne,1639,priest,discipline,84,38,46
27056,Lunarina,hyjal,1638,priest,discipline,167,75,92
27057,Bacpack,area-52,1637,priest,discipline,131,67,64
27058,Evvylou,stormrage,1637,priest,discipline,42,19,23
27059,Choochang,sargeras,1636,priest,discipline,35,27,8
27060,Aethriem,bleeding-hollow,1636,priest,discipline,54,33,21
27061,Perothon,garrosh,1636,priest,discipline,123,65,58
27062,Ketapriest,frostmourne,1636,priest,discipline,136,67,69
27063,Döllyy,illidan,1636,priest,discipline,48,22,26
27064,Rmx,illidan,1635,priest,discipline,35,18,17
27065,Grizzlysmite,stormrage,1635,priest,discipline,343,168,175
27066,Batiatus,moon-guard,1635,priest,discipline,42,20,22
27067,Beeffdaddy,tichondrius,1635,priest,discipline,123,57,66
27068,Mangolatte,frostmourne,1634,priest,discipline,55,41,14
27069,Ngin,queldorei,1634,priest,discipline,36,21,15
27070,Beejaex,stormreaver,1634,priest,discipline,48,22,26
27071,Benedictiion,tichondrius,1634,priest,discipline,86,38,48
27072,Huxleypoo,boulderfist,1633,priest,discipline,42,22,20
27073,Mclyte,whisperwind,1633,priest,discipline,149,77,72
27074,Jâmïè,gurubashi,1632,priest,discipline,41,31,10
27075,Buhroke,thrall,1632,priest,discipline,62,29,33
27076,Jjmms,akama,1632,priest,discipline,270,126,144
27077,Discgoddess,proudmoore,1631,priest,discipline,103,54,49
27078,Chewey,tichondrius,1631,priest,discipline,48,23,25
27079,Varbirttok,sargeras,1631,priest,discipline,43,19,24
27080,Howiecakes,bloodhoof,1631,priest,discipline,57,25,32
27081,Gödtier,frostwolf,1631,priest,discipline,42,18,24
27082,Meip,illidan,1630,priest,discipline,24,17,7
27083,Skadín,stormrage,1630,priest,discipline,155,92,63
27084,Drully,moon-guard,1630,priest,discipline,113,62,51
27085,Tastyloads,illidan,1629,priest,discipline,42,25,17
27086,Samirah,arthas,1629,priest,discipline,42,23,19
27087,Bluecho,tichondrius,1629,priest,discipline,48,25,23
27088,Joeyslaps,frostwolf,1629,priest,discipline,58,30,28
27089,Szx,akama,1629,priest,discipline,50,24,26
27090,Powerwordwap,malganis,1629,priest,discipline,53,23,30
27091,Bustit,azgalor,1628,priest,discipline,52,28,24
27092,Stepsistér,ragnaros,1628,priest,discipline,36,19,17
27093,Kazgry,illidan,1628,priest,discipline,42,22,20
27094,Bhoyka,ragnaros,1628,priest,discipline,57,29,28
27095,Winsforgoldd,area-52,1628,priest,discipline,40,20,20
27096,Oesobagi,tichondrius,1627,priest,discipline,113,66,47
27097,Peelforheals,nordrassil,1627,priest,discipline,60,27,33
27098,Çammy,frostmourne,1626,priest,discipline,24,17,7
27099,Andrew,sargeras,1626,priest,discipline,30,20,10
27100,Discavow,bleeding-hollow,1626,priest,discipline,51,31,20
27101,Tonybanderas,shattered-halls,1626,priest,discipline,108,58,50
27102,Brothercarl,stormrage,1626,priest,discipline,95,51,44
27103,Arianagrande,garona,1626,priest,discipline,95,50,45
27104,Raxekk,stormrage,1626,priest,discipline,48,25,23
27105,Slickwilly,bloodhoof,1626,priest,discipline,257,125,132
27106,Mylo,azralon,1625,priest,discipline,48,28,20
27107,Psycozis,hyjal,1625,priest,discipline,262,138,124
27108,Kepp,korgath,1625,priest,discipline,51,23,28
27109,Linarindil,hyjal,1624,priest,discipline,126,63,63
27110,Vinvictus,tichondrius,1624,priest,discipline,225,108,117
27111,Momorabbit,tichondrius,1624,priest,discipline,36,17,19
27112,Ussmissouri,area-52,1624,priest,discipline,141,63,78
27113,Caesus,sargeras,1623,priest,discipline,124,70,54
27114,Illuminare,sargeras,1623,priest,discipline,154,82,72
27115,Bonoo,tichondrius,1623,priest,discipline,335,175,160
27116,Elbeefsteak,ragnaros,1622,priest,discipline,54,32,22
27117,Dream,kelthuzad,1622,priest,discipline,30,17,13
27118,Wickedpriest,malganis,1622,priest,discipline,54,25,29
27119,Kûrtt,azralon,1622,priest,discipline,42,19,23
27120,Spicer,eredar,1621,priest,discipline,41,25,16
27121,Tuniepope,sargeras,1621,priest,discipline,75,45,30
27122,Sätîvá,tichondrius,1621,priest,discipline,38,20,18
27123,Deathsmoke,ragnaros,1621,priest,discipline,112,55,57
27124,Vsat,illidan,1621,priest,discipline,48,23,25
27125,Lilbaldjosh,frostmourne,1621,priest,discipline,114,52,62
27126,Universe,spinebreaker,1620,priest,discipline,34,25,9
27127,Tammyone,emerald-dream,1620,priest,discipline,66,42,24
27128,Pigro,area-52,1620,priest,discipline,30,19,11
27129,Darknuzs,sargeras,1620,priest,discipline,42,21,21
27130,Halfcutt,tichondrius,1620,priest,discipline,48,23,25
27131,Surfgang,tichondrius,1620,priest,discipline,41,19,22
27132,Gosarix,tichondrius,1619,priest,discipline,24,17,7
27133,Zombiz,tichondrius,1619,priest,discipline,41,25,16
27134,Priestreto,zuljin,1619,priest,discipline,101,56,45
27135,Daburnz,bleeding-hollow,1619,priest,discipline,102,53,49
27136,Shesaidthat,stormrage,1619,priest,discipline,225,114,111
27137,Baddmachine,illidan,1619,priest,discipline,47,21,26
27138,Archìtects,wyrmrest-accord,1618,priest,discipline,42,25,17
27139,Timbobaloo,thrall,1618,priest,discipline,58,33,25
27140,Kälëy,ragnaros,1618,priest,discipline,172,96,76
27141,Syrul,tichondrius,1618,priest,discipline,63,34,29
27142,Nohéalforu,stormrage,1618,priest,discipline,48,25,23
27143,Sacrify,ragnaros,1618,priest,discipline,105,54,51
27144,Punisherror,area-52,1618,priest,discipline,52,22,30
27145,Astrøpriest,tichondrius,1618,priest,discipline,54,22,32
27146,Jmr,onyxia,1617,priest,discipline,24,17,7
27147,Cazuex,ragnaros,1617,priest,discipline,30,20,10
27148,Khathor,kargath,1617,priest,discipline,30,17,13
27149,Bingleboi,area-52,1617,priest,discipline,226,123,103
27150,Gurlyounasty,khazgoroth,1617,priest,discipline,103,55,48
27151,Pedobearx,ragnaros,1617,priest,discipline,148,74,74
27152,Cosenzza,tichondrius,1617,priest,discipline,48,20,28
27153,Jönsnow,ghostlands,1616,priest,discipline,54,29,25
27154,Prayussy,tichondrius,1616,priest,discipline,135,72,63
27155,Anahka,tichondrius,1616,priest,discipline,48,21,27
27156,Shaddäye,andorhal,1616,priest,discipline,48,20,28
27157,Kraamur,area-52,1615,priest,discipline,96,57,39
27158,Jîtters,silvermoon,1615,priest,discipline,84,45,39
27159,Myles,alexstrasza,1615,priest,discipline,134,68,66
27160,Bisholan,frostwolf,1615,priest,discipline,79,35,44
27161,Catbabyeah,tichondrius,1614,priest,discipline,36,26,10
27162,Buchöna,quelthalas,1614,priest,discipline,77,41,36
27163,Hottymcdotty,black-dragonflight,1614,priest,discipline,42,21,21
27164,Nanoboost,dark-iron,1614,priest,discipline,573,285,288
27165,Galandora,kelthuzad,1614,priest,discipline,48,23,25
27166,Iovedoctor,tichondrius,1614,priest,discipline,78,25,53
27167,Sâsh,stormrage,1613,priest,discipline,72,40,32
27168,Nolar,shadowmoon,1613,priest,discipline,36,20,16
27169,Mudshadow,tichondrius,1613,priest,discipline,97,53,44
27170,Trezz,hakkar,1613,priest,discipline,46,23,23
27171,Aåurøra,stormrage,1613,priest,discipline,46,23,23
27172,ßðßßÿ,area-52,1613,priest,discipline,42,21,21
27173,Judis,barthilas,1613,priest,discipline,72,35,37
27174,Alfié,kelthuzad,1612,priest,discipline,48,33,15
27175,Kks,tichondrius,1612,priest,discipline,90,46,44
27176,Gsek,nemesis,1611,priest,discipline,36,23,13
27177,Scruge,frostmourne,1611,priest,discipline,55,32,23
27178,Calientaeggs,drakkari,1611,priest,discipline,352,190,162
27179,Littleshower,illidan,1611,priest,discipline,43,23,20
27180,Vincejddp,zuljin,1611,priest,discipline,199,105,94
27181,Haill,quelthalas,1611,priest,discipline,76,38,38
27182,Shadoris,antonidas,1611,priest,discipline,48,23,25
27183,Cinsare,moon-guard,1610,priest,discipline,84,49,35
27184,Psychic,bladefist,1610,priest,discipline,124,72,52
27185,Yidra,illidan,1610,priest,discipline,36,19,17
27186,Swartzp,tichondrius,1610,priest,discipline,110,58,52
27187,Frenezyz,ragnaros,1610,priest,discipline,42,22,20
27188,Blathers,malganis,1610,priest,discipline,92,48,44
27189,Interworld,illidan,1610,priest,discipline,50,24,26
27190,Mortteus,agamaggan,1610,priest,discipline,60,28,32
27191,Pleasant,dathremar,1610,priest,discipline,123,52,71
27192,Dadcantdeath,frostmourne,1609,priest,discipline,44,23,21
27193,Fõrcedtowipe,tichondrius,1609,priest,discipline,180,93,87
27194,Krusheal,tichondrius,1609,priest,discipline,47,22,25
27195,Oyy,barthilas,1609,priest,discipline,60,27,33
27196,Gránd,emerald-dream,1609,priest,discipline,54,22,32
27197,Ksâh,bleeding-hollow,1608,priest,discipline,30,19,11
27198,Gsek,azralon,1608,priest,discipline,54,34,20
27199,Alcázardeyo,area-52,1608,priest,discipline,150,84,66
27200,Healbaby,illidan,1608,priest,discipline,193,99,94
27201,Wrekkit,area-52,1608,priest,discipline,84,42,42
27202,Dawgshiz,tichondrius,1608,priest,discipline,40,20,20
27203,Ivf,darrowmere,1608,priest,discipline,47,22,25
27204,Reginaa,nemesis,1608,priest,discipline,65,30,35
27205,Buttfive,illidan,1608,priest,discipline,58,24,34
27206,Supôrte,nemesis,1607,priest,discipline,65,37,28
27207,Jiñx,destromath,1607,priest,discipline,278,147,131
27208,Hootheals,illidan,1607,priest,discipline,46,24,22
27209,Darknus,sargeras,1607,priest,discipline,78,37,41
27210,Flagiddyflag,kelthuzad,1607,priest,discipline,36,17,19
27211,Ggsaurusrex,area-52,1607,priest,discipline,36,17,19
27212,Teewat,illidan,1606,priest,discipline,42,23,19
27213,Lovesy,burning-legion,1606,priest,discipline,60,30,30
27214,Darkispriest,tichondrius,1606,priest,discipline,36,17,19
27215,Powerwordqt,kalecgos,1606,priest,discipline,60,26,34
27216,Hoshx,sargeras,1605,priest,discipline,75,44,31
27217,Trojanphobia,bleeding-hollow,1605,priest,discipline,36,20,16
27218,Jennyle,sargeras,1605,priest,discipline,60,31,29
27219,Yoggismydad,emerald-dream,1605,priest,discipline,185,95,90
27220,Snakedoc,emerald-dream,1605,priest,discipline,66,33,33
27221,Míkò,sargeras,1604,priest,discipline,18,17,1
27222,Jagita,kelthuzad,1604,priest,discipline,31,20,11
27223,Hoglet,moon-guard,1604,priest,discipline,65,39,26
27224,Jzd,dreadmaul,1604,priest,discipline,54,29,25
27225,Priestass,bleeding-hollow,1604,priest,discipline,78,37,41
27226,Vern,laughing-skull,1604,priest,discipline,78,29,49
27227,Lines,sargeras,1603,priest,discipline,70,38,32
27228,Fukneasy,darkspear,1603,priest,discipline,37,20,17
27229,Feymuhsjr,black-dragonflight,1603,priest,discipline,54,29,25
27230,Iamgess,kilrogg,1603,priest,discipline,42,22,20
27231,Fäctor,bleeding-hollow,1603,priest,discipline,78,36,42
27232,Resortv,illidan,1602,priest,discipline,42,32,10
27233,Aetyn,tichondrius,1602,priest,discipline,61,33,28
27234,Arcalon,thrall,1602,priest,discipline,86,45,41
27235,Gromkekz,area-52,1602,priest,discipline,73,38,35
27236,Crizem,bleeding-hollow,1602,priest,discipline,242,119,123
27237,Ünagi,thrall,1602,priest,discipline,77,34,43
27238,Zymmie,moon-guard,1602,priest,discipline,102,45,57
27239,Invicta,frostwolf,1601,priest,discipline,27,18,9
27240,Fakechow,nathrezim,1601,priest,discipline,137,71,66
27241,Bistek,bleeding-hollow,1601,priest,discipline,166,83,83
27242,Jhivagosp,tichondrius,1600,priest,discipline,42,23,19
27243,Mepisth,sargeras,1600,priest,discipline,66,36,30
27244,Zarakonna,illidan,1600,priest,discipline,60,32,28
27245,Nijoral,tichondrius,1600,priest,discipline,368,194,174
27246,Eccentrixx,mannoroth,1600,priest,discipline,54,28,26
27247,Catpictures,stormrage,1599,priest,discipline,36,18,18
27248,Zunari,thrall,1599,priest,discipline,48,23,25
27249,Memoriesorz,tichondrius,1598,priest,discipline,419,217,202
27250,Bigsmart,tichondrius,1598,priest,discipline,56,25,31
27251,Dupaforted,stormrage,1598,priest,discipline,71,26,45
27252,Valeilah,illidan,1597,priest,discipline,126,80,46
27253,Razledazzled,grizzly-hills,1597,priest,discipline,109,54,55
27254,Pocserpriest,drakkari,1597,priest,discipline,44,21,23
27255,Emytoty,ragnaros,1596,priest,discipline,138,75,63
27256,Pettypriest,dalaran,1596,priest,discipline,79,39,40
27257,Ivorytiger,bleeding-hollow,1596,priest,discipline,42,19,23
27258,Serenewisp,tichondrius,1595,priest,discipline,101,48,53
27259,Onezor,frostmourne,1594,priest,discipline,78,39,39
27260,Gummachine,tichondrius,1594,priest,discipline,36,17,19
27261,Comana,frostmourne,1594,priest,discipline,53,25,28
27262,Luthiene,area-52,1593,priest,discipline,204,112,92
27263,Ariês,tichondrius,1593,priest,discipline,60,22,38
27264,Planchebois,zuljin,1592,priest,discipline,36,20,16
27265,Kavxo,sargeras,1592,priest,discipline,48,24,24
27266,Hm,the-scryers,1591,priest,discipline,30,21,9
27267,Astalail,emerald-dream,1591,priest,discipline,40,21,19
27268,Dellitor,illidan,1591,priest,discipline,65,33,32
27269,Isteri,thrall,1590,priest,discipline,52,26,26
27270,Woosanghong,tichondrius,1590,priest,discipline,90,44,46
27271,Emotionally,sargeras,1589,priest,discipline,30,20,10
27272,Daleyn,ragnaros,1588,priest,discipline,48,27,21
27273,Raffimilk,tichondrius,1588,priest,discipline,45,22,23
27274,Eggsdenny,illidan,1588,priest,discipline,36,17,19
27275,Primael,tichondrius,1587,priest,discipline,40,18,22
27276,Conezy,frostmourne,1586,priest,discipline,60,32,28
27277,Doritonails,tichondrius,1586,priest,discipline,244,124,120
27278,Rilad,icecrown,1586,priest,discipline,180,86,94
27279,Alaran,magtheridon,1584,priest,discipline,35,21,14
27280,Septmoon,tichondrius,1584,priest,discipline,36,20,16
27281,Säcrilege,drakkari,1584,priest,discipline,183,96,87
27282,Lovesthebox,frostmourne,1584,priest,discipline,108,47,61
27283,Zerokool,moonrunner,1583,priest,discipline,42,25,17
27284,Saintguard,tichondrius,1583,priest,discipline,85,44,41
27285,Dotsfortots,malfurion,1583,priest,discipline,41,21,20
27286,Indigojuly,sargeras,1582,priest,discipline,70,40,30
27287,Rómmul,azralon,1582,priest,discipline,65,33,32
27288,Maomaoangel,tichondrius,1581,priest,discipline,42,22,20
27289,Djc,tichondrius,1581,priest,discipline,84,42,42
27290,Shieldharder,stormrage,1581,priest,discipline,39,18,21
27291,Puttles,tichondrius,1581,priest,discipline,66,24,42
27292,Gus,the-venture-co,1580,priest,discipline,78,44,34
27293,Cringepriest,area-52,1579,priest,discipline,54,33,21
27294,Kaeda,drenden,1579,priest,discipline,60,31,29
27295,Piils,sargeras,1579,priest,discipline,36,18,18
27296,Bigwap,illidan,1579,priest,discipline,60,29,31
27297,Esciel,ragnaros,1579,priest,discipline,92,40,52
27298,Carti,bleeding-hollow,1578,priest,discipline,232,129,103
27299,Zizziz,tichondrius,1577,priest,discipline,66,33,33
27300,Weapestrong,tichondrius,1576,priest,discipline,42,21,21
27301,Knucklesandy,tichondrius,1576,priest,discipline,35,17,18
27302,Predolph,illidan,1575,priest,discipline,48,26,22
27303,Gamist,area-52,1575,priest,discipline,176,90,86
27304,Blindingstar,area-52,1574,priest,discipline,57,33,24
27305,Guccigriimes,tichondrius,1574,priest,discipline,45,24,21
27306,Brezi,azralon,1573,priest,discipline,53,32,21
27307,Gankdez,kelthuzad,1573,priest,discipline,111,58,53
27308,Endereth,skullcrusher,1573,priest,discipline,124,57,67
27309,Kihlupr,frostmourne,1573,priest,discipline,58,25,33
27310,Overpriest,ragnaros,1572,priest,discipline,40,22,18
27311,Bubblebuddí,tichondrius,1572,priest,discipline,68,37,31
27312,Tekneeq,barthilas,1572,priest,discipline,114,53,61
27313,Holymagetv,tichondrius,1572,priest,discipline,39,18,21
27314,Archeo,area-52,1572,priest,discipline,60,19,41
27315,Hasby,area-52,1571,priest,discipline,90,52,38
27316,Malpractíce,zuljin,1571,priest,discipline,95,50,45
27317,Tokaru,frostmourne,1571,priest,discipline,56,26,30
27318,Whitecaster,tichondrius,1570,priest,discipline,30,17,13
27319,Aleykz,illidan,1570,priest,discipline,89,50,39
27320,Valdurai,stormrage,1570,priest,discipline,41,23,18
27321,Chookspriest,tichondrius,1570,priest,discipline,165,80,85
27322,Badhabit,zuluhed,1570,priest,discipline,91,40,51
27323,Ppsp,azralon,1569,priest,discipline,42,25,17
27324,Ol,firetree,1569,priest,discipline,57,28,29
27325,Kimjongdots,illidan,1568,priest,discipline,50,28,22
27326,Itachî,ravencrest,1568,priest,discipline,36,19,17
27327,Safetyy,bleeding-hollow,1567,priest,discipline,44,24,20
27328,Feymuhs,blackrock,1567,priest,discipline,90,48,42
27329,Fairlightpp,zuljin,1567,priest,discipline,78,39,39
27330,Ayabae,illidan,1567,priest,discipline,680,331,349
27331,Besó,proudmoore,1566,priest,discipline,120,71,49
27332,Holyvoice,wyrmrest-accord,1566,priest,discipline,58,32,26
27333,Shádowman,thrall,1566,priest,discipline,72,35,37
27334,Ðiscipline,kelthuzad,1566,priest,discipline,117,56,61
27335,Alexsp,amanthul,1565,priest,discipline,76,45,31
27336,Incisions,moon-guard,1564,priest,discipline,96,52,44
27337,Scarabless,bleeding-hollow,1564,priest,discipline,138,62,76
27338,Soyul,tichondrius,1563,priest,discipline,47,19,28
27339,Deadnyx,tichondrius,1562,priest,discipline,36,20,16
27340,Hadtogothere,kelthuzad,1562,priest,discipline,209,103,106
27341,Zenobiai,hyjal,1561,priest,discipline,157,85,72
27342,Valyx,tichondrius,1561,priest,discipline,130,70,60
27343,Jylertason,kelthuzad,1561,priest,discipline,58,26,32
27344,Antifaithx,frostmourne,1560,priest,discipline,36,21,15
27345,Verna,dunemaul,1560,priest,discipline,85,47,38
27346,Tyksu,area-52,1560,priest,discipline,94,50,44
27347,Babirygen,khaz-modan,1560,priest,discipline,42,21,21
27348,Moustachío,stormrage,1559,priest,discipline,53,24,29
27349,Spliffs,tichondrius,1559,priest,discipline,77,29,48
27350,Melitele,magtheridon,1558,priest,discipline,36,21,15
27351,Highasf,sargeras,1558,priest,discipline,72,41,31
27352,Vanco,tichondrius,1558,priest,discipline,59,32,27
27353,Twistinfate,hyjal,1558,priest,discipline,119,58,61
27354,Qenq,tichondrius,1557,priest,discipline,30,17,13
27355,Gucciflops,tichondrius,1557,priest,discipline,48,25,23
27356,Sensaye,dalaran,1557,priest,discipline,75,37,38
27357,Ropriest,frostmourne,1557,priest,discipline,59,29,30
27358,Datdarnbéar,stormrage,1557,priest,discipline,54,25,29
27359,Approved,moon-guard,1556,priest,discipline,180,89,91
27360,Shadowgobbo,thrall,1556,priest,discipline,54,26,28
27361,Playsoon,illidan,1555,priest,discipline,124,68,56
27362,Zrn,bleeding-hollow,1555,priest,discipline,54,19,35
27363,Karebenniian,area-52,1554,priest,discipline,96,48,48
27364,Hiraa,frostmourne,1553,priest,discipline,36,23,13
27365,Elysiana,wyrmrest-accord,1553,priest,discipline,48,26,22
27366,Takethat,emerald-dream,1552,priest,discipline,72,47,25
27367,Meditåtion,tichondrius,1552,priest,discipline,186,97,89
27368,Gommacura,stormrage,1552,priest,discipline,190,99,91
27369,Gilthðniel,quelthalas,1552,priest,discipline,225,108,117
27370,Rexîfy,zuljin,1551,priest,discipline,41,25,16
27371,Mfynch,sargeras,1551,priest,discipline,66,40,26
27372,Grannieslove,sargeras,1551,priest,discipline,48,28,20
27373,Zachlol,area-52,1551,priest,discipline,90,52,38
27374,Leliane,tichondrius,1551,priest,discipline,66,35,31
27375,Pilixil,bleeding-hollow,1551,priest,discipline,42,21,21
27376,Nesx,azuremyst,1550,priest,discipline,42,28,14
27377,Sorrowful,mannoroth,1550,priest,discipline,30,19,11
27378,Sensitive,eitrigg,1550,priest,discipline,36,22,14
27379,Unisia,tichondrius,1550,priest,discipline,98,41,57
27380,Önagashøw,azralon,1549,priest,discipline,277,140,137
27381,Keyoshe,altar-of-storms,1549,priest,discipline,274,138,136
27382,Luhhx,sargeras,1549,priest,discipline,108,54,54
27383,Hennywhite,sargeras,1549,priest,discipline,102,48,54
27384,Fámóus,stormrage,1549,priest,discipline,83,30,53
27385,Nisagerx,tichondrius,1548,priest,discipline,33,19,14
27386,Azureslaps,tichondrius,1547,priest,discipline,212,106,106
27387,Sâishâ,proudmoore,1547,priest,discipline,188,84,104
27388,Mdibaxx,tichondrius,1547,priest,discipline,83,35,48
27389,Jugeumx,proudmoore,1547,priest,discipline,48,19,29
27390,Uriyel,quelthalas,1546,priest,discipline,119,62,57
27391,Sacredlight,malygos,1546,priest,discipline,99,51,48
27392,Rustypinball,bleeding-hollow,1545,priest,discipline,70,39,31
27393,Notkim,zuljin,1545,priest,discipline,65,33,32
27394,Shadöwtest,quelthalas,1545,priest,discipline,113,49,64
27395,Goo,boulderfist,1544,priest,discipline,36,22,14
27396,Lyrä,kiljaeden,1544,priest,discipline,79,44,35
27397,Androalis,thaurissan,1544,priest,discipline,72,38,34
27398,Rourk,medivh,1544,priest,discipline,131,65,66
27399,Bloodify,azralon,1544,priest,discipline,101,48,53
27400,Nutshotxx,skullcrusher,1544,priest,discipline,154,67,87
27401,Herder,zuljin,1543,priest,discipline,41,25,16
27402,Matics,tichondrius,1543,priest,discipline,62,33,29
27403,Rhima,tichondrius,1543,priest,discipline,115,59,56
27404,Played,dark-iron,1543,priest,discipline,62,24,38
27405,Justashadow,zangarmarsh,1542,priest,discipline,103,59,44
27406,Bigdaddios,dalaran,1542,priest,discipline,41,18,23
27407,Metick,illidan,1542,priest,discipline,48,18,30
27408,Benin,shattered-hand,1541,priest,discipline,36,22,14
27409,Zórg,stormrage,1541,priest,discipline,56,30,26
27410,Makuwu,area-52,1541,priest,discipline,93,49,44
27411,Winss,tichondrius,1541,priest,discipline,220,114,106
27412,Qmabayteckkl,tichondrius,1540,priest,discipline,42,23,19
27413,Ärchangél,tichondrius,1540,priest,discipline,60,29,31
27414,Alex,boulderfist,1540,priest,discipline,189,90,99
27415,Dawnsy,arygos,1540,priest,discipline,50,23,27
27416,Daddydoeet,zuljin,1539,priest,discipline,42,22,20
27417,Avis,illidan,1538,priest,discipline,50,33,17
27418,Life,thrall,1538,priest,discipline,101,50,51
27419,Slipzie,sargeras,1537,priest,discipline,89,52,37
27420,Shadowdaddy,barthilas,1537,priest,discipline,96,55,41
27421,Croissånt,illidan,1536,priest,discipline,30,18,12
27422,Luxah,bloodhoof,1536,priest,discipline,39,23,16
27423,Phasmaaxd,tichondrius,1536,priest,discipline,71,39,32
27424,Oiled,barthilas,1535,priest,discipline,59,38,21
27425,Erinzdern,quelthalas,1535,priest,discipline,64,33,31
27426,Wandynha,nemesis,1535,priest,discipline,81,39,42
27427,Santhiel,ragnaros,1535,priest,discipline,42,18,24
27428,Saxy,quelthalas,1534,priest,discipline,50,32,18
27429,Highmoon,kelthuzad,1534,priest,discipline,30,16,14
27430,Sevÿ,malygos,1534,priest,discipline,40,20,20
27431,Yanye,tichondrius,1534,priest,discipline,157,77,80
27432,Maid,demon-soul,1534,priest,discipline,63,28,35
27433,Anastasiá,barthilas,1534,priest,discipline,48,21,27
27434,Lolweedbro,illidan,1533,priest,discipline,70,43,27
27435,Faithmelter,stormrage,1533,priest,discipline,89,48,41
27436,Dëàthwîsh,tichondrius,1533,priest,discipline,30,16,14
27437,Priesmatco,area-52,1533,priest,discipline,81,40,41
27438,Suitoo,ragnaros,1533,priest,discipline,54,25,29
27439,Hairyleg,kelthuzad,1533,priest,discipline,36,16,20
27440,Soulcleave,dark-iron,1533,priest,discipline,48,18,30
27441,Yeyoz,tichondrius,1532,priest,discipline,106,54,52
27442,Cityboyy,tichondrius,1532,priest,discipline,37,17,20
27443,Wbu,frostmourne,1531,priest,discipline,28,17,11
27444,Pryst,bonechewer,1531,priest,discipline,54,28,26
27445,Bryelx,ragnaros,1531,priest,discipline,108,55,53
27446,Vañity,malganis,1531,priest,discipline,66,33,33
27447,Rubymisfit,sargeras,1531,priest,discipline,36,16,20
27448,Scræm,sargeras,1530,priest,discipline,97,44,53
27449,Anastasìá,barthilas,1530,priest,discipline,52,18,34
27450,Epijho,area-52,1529,priest,discipline,30,19,11
27451,Joktips,proudmoore,1529,priest,discipline,150,84,66
27452,Kaguyä,ragnaros,1529,priest,discipline,59,32,27
27453,Aríola,frostmourne,1529,priest,discipline,69,37,32
27454,Amayå,kelthuzad,1529,priest,discipline,48,19,29
27455,Nexp,tichondrius,1528,priest,discipline,53,38,15
27456,Vullena,moon-guard,1528,priest,discipline,84,43,41
27457,Truce,moon-guard,1528,priest,discipline,77,39,38
27458,Slippedadisc,kelthuzad,1527,priest,discipline,108,59,49
27459,Aralia,ragnaros,1527,priest,discipline,105,50,55
27460,Havocshadows,deathwing,1526,priest,discipline,180,111,69
27461,Alëssana,illidan,1526,priest,discipline,122,60,62
27462,Radackan,quelthalas,1525,priest,discipline,84,44,40
27463,Umbrous,ysera,1525,priest,discipline,42,18,24
27464,Marethelia,stonemaul,1524,priest,discipline,42,22,20
27465,Lydra,ragnaros,1524,priest,discipline,213,99,114
27466,Thedude,spirestone,1524,priest,discipline,36,16,20
27467,Holyphodays,sargeras,1523,priest,discipline,91,50,41
27468,Sonofbetch,emerald-dream,1523,priest,discipline,55,30,25
27469,Bloodytears,kiljaeden,1523,priest,discipline,138,65,73
27470,Zortkis,garithos,1523,priest,discipline,52,20,32
27471,Ricopri,frostmourne,1522,priest,discipline,36,23,13
27472,Madhairy,ragnaros,1522,priest,discipline,126,65,61
27473,Niurouchuan,tichondrius,1522,priest,discipline,123,60,63
27474,Triggaz,tichondrius,1521,priest,discipline,126,70,56
27475,Draxxankou,tanaris,1521,priest,discipline,73,40,33
27476,Pheener,stormreaver,1521,priest,discipline,198,97,101
27477,Magpul,arthas,1521,priest,discipline,36,16,20
27478,Jâldabaoth,area-52,1520,priest,discipline,48,29,19
27479,Ezzy,bleeding-hollow,1520,priest,discipline,48,24,24
27480,Voltstein,dalaran,1519,priest,discipline,116,61,55
27481,Hideyason,area-52,1519,priest,discipline,60,31,29
27482,Friendzonefw,illidan,1519,priest,discipline,144,71,73
27483,Dædrà,stormrage,1519,priest,discipline,76,37,39
27484,Blessrish,icecrown,1519,priest,discipline,66,31,35
27485,Bobelgum,emerald-dream,1517,priest,discipline,36,26,10
27486,Unholyhusky,sargeras,1517,priest,discipline,54,32,22
27487,Joní,malganis,1517,priest,discipline,41,18,23
27488,Swapsy,illidan,1516,priest,discipline,53,29,24
27489,Blodwell,illidan,1516,priest,discipline,125,66,59
27490,Bonnieron,frostmourne,1516,priest,discipline,77,39,38
27491,Triangle,draka,1516,priest,discipline,36,17,19
27492,Drupmonst,dalaran,1516,priest,discipline,60,26,34
27493,Cexcexyomi,tichondrius,1515,priest,discipline,88,47,41
27494,Weakwind,burning-blade,1514,priest,discipline,56,33,23
27495,Davinatrans,azralon,1514,priest,discipline,75,43,32
27496,Zenfromwish,frostmourne,1514,priest,discipline,68,37,31
27497,Thranduil,kiljaeden,1514,priest,discipline,136,72,64
27498,Tecnica,kelthuzad,1514,priest,discipline,155,75,80
27499,Marantbourge,frostmourne,1514,priest,discipline,122,57,65
27500,Arzaei,quelthalas,1513,priest,discipline,112,54,58
27501,Inssania,ragnaros,1513,priest,discipline,60,28,32
27502,Madpriest,blades-edge,1512,priest,discipline,30,16,14
27503,Gustáv,sargeras,1512,priest,discipline,72,37,35
27504,Absørptiøn,area-52,1511,priest,discipline,42,23,19
27505,Mse,eonar,1511,priest,discipline,48,26,22
27506,Galestick,illidan,1511,priest,discipline,30,16,14
27507,Ulzaar,nerzhul,1511,priest,discipline,89,37,52
27508,Luxury,blackrock,1510,priest,discipline,36,18,18
27509,Manascythe,illidan,1510,priest,discipline,46,22,24
27510,Zroheals,illidan,1510,priest,discipline,107,48,59
27511,Agraheals,barthilas,1509,priest,discipline,42,22,20
27512,Flatëarth,tichondrius,1509,priest,discipline,191,95,96
27513,Ballzach,ysera,1508,priest,discipline,197,102,95
27514,Luvenia,sargeras,1508,priest,discipline,120,60,60
27515,Mandymuze,barthilas,1508,priest,discipline,77,37,40
27516,Iinu,tichondrius,1507,priest,discipline,131,70,61
27517,Euphotic,tichondrius,1507,priest,discipline,55,29,26
27518,Hawtzp,stormrage,1506,priest,discipline,42,24,18
27519,Ndz202933,malganis,1506,priest,discipline,30,16,14
27520,Juckerr,tichondrius,1506,priest,discipline,209,107,102
27521,Zerola,sargeras,1506,priest,discipline,47,24,23
27522,Pinchevato,ragnaros,1506,priest,discipline,218,109,109
27523,Zinnar,dalaran,1506,priest,discipline,96,38,58
27524,Altarboy,agamaggan,1505,priest,discipline,62,30,32
27525,Legó,illidan,1504,priest,discipline,60,29,31
27526,Pootzy,malganis,1504,priest,discipline,87,36,51
27527,Artista,quelthalas,1501,priest,discipline,100,54,46
27528,Nerfdisc,azralon,1501,priest,discipline,142,75,67
27529,Yoozi,sargeras,1501,priest,discipline,126,63,63
27530,Ooft,tichondrius,1501,priest,discipline,34,17,17
27531,Spacecowboyz,stormrage,1501,priest,discipline,54,25,29
27532,Lelenia,tichondrius,1501,priest,discipline,49,22,27
27533,Bailez,malganis,1500,priest,discipline,49,27,22
27534,Djefe,tichondrius,1500,priest,discipline,102,52,50
27535,Valtres,tichondrius,1499,priest,discipline,30,16,14
27536,Shunio,illidan,1499,priest,discipline,60,25,35
27537,Jpray,bleeding-hollow,1498,priest,discipline,115,62,53
27538,Healther,firetree,1498,priest,discipline,30,16,14
27539,Inkders,detheroc,1498,priest,discipline,58,26,32
27540,Boundword,emerald-dream,1498,priest,discipline,54,22,32
27541,Yorp,tichondrius,1497,priest,discipline,72,36,36
27542,Thottee,bleeding-hollow,1497,priest,discipline,120,55,65
27543,Valixia,sargeras,1497,priest,discipline,90,41,49
27544,Prniss,tichondrius,1496,priest,discipline,41,25,16
27545,Tajee,area-52,1496,priest,discipline,107,57,50
27546,Namemetwo,malganis,1496,priest,discipline,48,23,25
27547,Doutoodou,tichondrius,1495,priest,discipline,94,55,39
27548,Amarexlol,stormrage,1495,priest,discipline,54,27,27
27549,Zivn,tichondrius,1494,priest,discipline,588,306,282
27550,Sgiath,alleria,1493,priest,discipline,42,30,12
27551,Sleezi,emerald-dream,1493,priest,discipline,60,34,26
27552,Healthreat,area-52,1493,priest,discipline,76,42,34
27553,Bradythree,moon-guard,1493,priest,discipline,38,20,18
27554,Weezyxo,tichondrius,1493,priest,discipline,46,19,27
27555,Idolize,proudmoore,1493,priest,discipline,50,20,30
27556,Zllik,illidan,1492,priest,discipline,95,48,47
27557,Dbod,tichondrius,1492,priest,discipline,251,126,125
27558,Bubblerwrapp,malganis,1492,priest,discipline,36,17,19
27559,Constin,doomhammer,1491,priest,discipline,36,20,16
27560,Delrey,sargeras,1491,priest,discipline,38,19,19
27561,Saiyana,frostmourne,1491,priest,discipline,148,72,76
27562,Frag,frostmourne,1490,priest,discipline,60,29,31
27563,Kalilol,tichondrius,1490,priest,discipline,132,61,71
27564,Alelith,quelthalas,1489,priest,discipline,59,27,32
27565,Akayayuelol,tichondrius,1488,priest,discipline,24,19,5
27566,Discobluntzz,tichondrius,1488,priest,discipline,54,31,23
27567,Priestmode,garona,1488,priest,discipline,60,27,33
27568,Labraidor,tichondrius,1488,priest,discipline,185,81,104
27569,Wisher,tichondrius,1488,priest,discipline,122,52,70
27570,Orzington,laughing-skull,1487,priest,discipline,74,40,34
27571,Watchemeyolo,tichondrius,1487,priest,discipline,66,35,31
27572,Luxyel,azralon,1487,priest,discipline,149,65,84
27573,Windroseh,proudmoore,1486,priest,discipline,60,32,28
27574,Blobble,tichondrius,1486,priest,discipline,102,45,57
27575,Tëmpting,moon-guard,1485,priest,discipline,50,25,25
27576,Zilah,ravencrest,1485,priest,discipline,72,33,39
27577,Aerdaras,illidan,1485,priest,discipline,80,36,44
27578,Ruminationz,stormrage,1485,priest,discipline,128,57,71
27579,Bater,mugthol,1484,priest,discipline,34,18,16
27580,Preacharóund,frostmourne,1484,priest,discipline,102,52,50
27581,Griddly,alterac-mountains,1483,priest,discipline,108,57,51
27582,Dingldangle,tichondrius,1483,priest,discipline,144,70,74
27583,Toxictampax,azjolnerub,1483,priest,discipline,82,39,43
27584,Nidüz,stormrage,1483,priest,discipline,144,68,76
27585,Blacklightz,korgath,1483,priest,discipline,91,42,49
27586,Prff,ragnaros,1483,priest,discipline,42,19,23
27587,Fashion,bleeding-hollow,1482,priest,discipline,48,30,18
27588,Rháényra,tichondrius,1482,priest,discipline,48,25,23
27589,Carcoz,emerald-dream,1482,priest,discipline,87,43,44
27590,Nottahealer,anvilmar,1482,priest,discipline,42,20,22
27591,Zaemyn,dalaran,1482,priest,discipline,44,20,24
27592,Tartapelle,zuljin,1481,priest,discipline,78,44,34
27593,Vemilli,tichondrius,1481,priest,discipline,40,20,20
27594,Aphrodìtë,tichondrius,1481,priest,discipline,127,62,65
27595,Holypuffs,burning-legion,1481,priest,discipline,59,27,32
27596,Aimeé,chromaggus,1481,priest,discipline,54,23,31
27597,Pipete,frostmourne,1480,priest,discipline,174,98,76
27598,Curemeste,illidan,1480,priest,discipline,126,66,60
27599,Merkinhealz,darkspear,1480,priest,discipline,76,39,37
27600,Blinxed,tichondrius,1480,priest,discipline,102,49,53
27601,Hysteria,dalaran,1480,priest,discipline,70,33,37
27602,Sstar,area-52,1479,priest,discipline,24,16,8
27603,Takomochi,sargeras,1479,priest,discipline,35,16,19
27604,Sibble,boulderfist,1479,priest,discipline,56,25,31
27605,Hårper,area-52,1479,priest,discipline,45,18,27
27606,Confesiional,area-52,1478,priest,discipline,68,31,37
27607,Jinxaleyster,ragnaros,1477,priest,discipline,143,81,62
27608,Klowdz,burning-blade,1477,priest,discipline,157,84,73
27609,Manryu,tichondrius,1477,priest,discipline,72,30,42
27610,Jjløver,tichondrius,1476,priest,discipline,24,16,8
27611,Rëckful,area-52,1476,priest,discipline,599,303,296
27612,Baìter,zuljin,1476,priest,discipline,82,41,41
27613,Thadino,nagrand,1476,priest,discipline,126,61,65
27614,Zsofi,rivendare,1476,priest,discipline,110,48,62
27615,Imcringing,illidan,1475,priest,discipline,48,30,18
27616,Luanwanx,tichondrius,1475,priest,discipline,91,51,40
27617,Mightydrëk,malganis,1475,priest,discipline,29,16,13
27618,Kflexx,hydraxis,1475,priest,discipline,128,46,82
27619,ßlest,stormrage,1474,priest,discipline,126,73,53
27620,Skillfull,chogall,1474,priest,discipline,240,128,112
27621,Haizsu,tichondrius,1474,priest,discipline,77,38,39
27622,Xîîaotong,tichondrius,1473,priest,discipline,37,23,14
27623,Basisc,frostmourne,1473,priest,discipline,207,116,91
27624,Ringofvalor,lightnings-blade,1473,priest,discipline,160,85,75
27625,Travoidicus,wyrmrest-accord,1473,priest,discipline,95,48,47
27626,Swagndragon,zuljin,1473,priest,discipline,86,42,44
27627,Jabreez,illidan,1472,priest,discipline,30,18,12
27628,Finnabustt,tichondrius,1472,priest,discipline,106,53,53
27629,Ricekak,haomarush,1471,priest,discipline,66,37,29
27630,Rufían,quelthalas,1471,priest,discipline,48,25,23
27631,Brian,lightnings-blade,1471,priest,discipline,52,27,25
27632,Feedya,tichondrius,1471,priest,discipline,375,184,191
27633,Bigtimeplay,tichondrius,1470,priest,discipline,42,25,17
27634,Yugewap,hyjal,1470,priest,discipline,102,60,42
27635,Lavenderism,moon-guard,1470,priest,discipline,90,45,45
27636,Emmelly,whisperwind,1470,priest,discipline,42,18,24
27637,Doesine,area-52,1469,priest,discipline,42,25,17
27638,Dorashadows,tichondrius,1467,priest,discipline,24,17,7
27639,Sandfire,thrall,1467,priest,discipline,30,16,14
27640,Stargoddess,illidan,1467,priest,discipline,168,84,84
27641,Kafarmer,frostmourne,1466,priest,discipline,107,62,45
27642,Famemolol,tichondrius,1466,priest,discipline,374,179,195
27643,Betterheals,tichondrius,1465,priest,discipline,157,84,73
27644,Azaradet,ragnaros,1465,priest,discipline,87,36,51
27645,Akåsha,zuljin,1465,priest,discipline,62,24,38
27646,Bobet,zuljin,1465,priest,discipline,61,23,38
27647,Cobjr,frostmourne,1464,priest,discipline,30,17,13
27648,Billymaays,azgalor,1464,priest,discipline,145,80,65
27649,Apâthy,area-52,1464,priest,discipline,69,32,37
27650,Dib,arathor,1463,priest,discipline,48,25,23
27651,Dontstopxo,lightbringer,1463,priest,discipline,52,24,28
27652,Frogfrompad,tichondrius,1462,priest,discipline,83,51,32
27653,Gðttlich,stormrage,1462,priest,discipline,38,19,19
27654,Fallenumbra,area-52,1461,priest,discipline,77,44,33
27655,Chainsalight,stormrage,1461,priest,discipline,156,81,75
27656,Priestsz,stormrage,1461,priest,discipline,151,78,73
27657,Ínfocus,area-52,1461,priest,discipline,132,63,69
27658,Forsakenz,jaedenar,1461,priest,discipline,66,30,36
27659,Propagàndhi,daggerspine,1460,priest,discipline,134,58,76
27660,Syfy,thrall,1460,priest,discipline,108,45,63
27661,Growth,fizzcrank,1460,priest,discipline,60,24,36
27662,Floratil,ragnaros,1459,priest,discipline,54,21,33
27663,Darenlor,tichondrius,1458,priest,discipline,93,40,53
27664,Fleshliight,area-52,1456,priest,discipline,51,31,20
27665,Shykaii,azralon,1456,priest,discipline,108,61,47
27666,Crashed,frostmourne,1456,priest,discipline,36,20,16
27667,Sadnez,illidan,1456,priest,discipline,121,67,54
27668,Sadistic,hyjal,1456,priest,discipline,118,59,59
27669,Akovob,tichondrius,1456,priest,discipline,50,25,25
27670,Sineater,zuljin,1456,priest,discipline,77,36,41
27671,Tiannatrump,stormrage,1455,priest,discipline,53,31,22
27672,Sappes,area-52,1455,priest,discipline,200,110,90
27673,Lethalrosé,thrall,1454,priest,discipline,30,17,13
27674,Huevos,blackwing-lair,1454,priest,discipline,144,76,68
27675,Giveheadpats,moon-guard,1454,priest,discipline,101,47,54
27676,Modotszilla,bleeding-hollow,1454,priest,discipline,36,16,20
27677,Hermeneutic,illidan,1454,priest,discipline,39,17,22
27678,Jaindoe,illidan,1453,priest,discipline,84,46,38
27679,Grimspriest,moon-guard,1453,priest,discipline,47,23,24
27680,Thoaxx,magtheridon,1453,priest,discipline,54,24,30
27681,Zerfen,azralon,1452,priest,discipline,28,16,12
27682,Ünarû,illidan,1452,priest,discipline,108,60,48
27683,Puddín,area-52,1452,priest,discipline,84,42,42
27684,Mistàclean,tichondrius,1452,priest,discipline,89,43,46
27685,Prayf,area-52,1452,priest,discipline,135,64,71
27686,Xeras,misha,1452,priest,discipline,47,21,26
27687,Seriosity,kelthuzad,1452,priest,discipline,42,16,26
27688,Sportsgloss,tichondrius,1451,priest,discipline,72,39,33
27689,Billzerian,nemesis,1451,priest,discipline,63,34,29
27690,Ems,dawnbringer,1451,priest,discipline,75,37,38
27691,Mannius,tichondrius,1451,priest,discipline,61,30,31
27692,Høllywood,nazgrel,1451,priest,discipline,57,28,29
27693,Spookynun,moon-guard,1450,priest,discipline,216,122,94
27694,Jubalie,guldan,1450,priest,discipline,52,27,25
27695,Faxingberlin,sargeras,1450,priest,discipline,40,17,23
27696,Bnn,arathor,1449,priest,discipline,23,16,7
27697,Descubra,stormrage,1449,priest,discipline,36,20,16
27698,Vampiric,laughing-skull,1449,priest,discipline,42,23,19
27699,Doggyy,tichondrius,1449,priest,discipline,166,88,78
27700,Eirua,proudmoore,1449,priest,discipline,78,35,43
27701,Notfandy,tichondrius,1449,priest,discipline,48,19,29
27702,Nek,malganis,1448,priest,discipline,103,61,42
27703,Priøst,tichondrius,1446,priest,discipline,63,38,25
27704,Newchaos,hakkar,1446,priest,discipline,40,24,16
27705,Zäelly,moon-guard,1446,priest,discipline,192,98,94
27706,Vezaxx,barthilas,1446,priest,discipline,132,67,65
27707,Eavin,laughing-skull,1446,priest,discipline,303,152,151
27708,Mileslol,azgalor,1446,priest,discipline,68,34,34
27709,Zeusqt,azralon,1445,priest,discipline,180,94,86
27710,Mamabless,quelthalas,1445,priest,discipline,460,238,222
27711,Augustrox,ragnaros,1445,priest,discipline,164,78,86
27712,Stynke,bleeding-hollow,1445,priest,discipline,54,16,38
27713,Specialed,wildhammer,1443,priest,discipline,71,39,32
27714,Cezure,stormrage,1443,priest,discipline,299,158,141
27715,Yótecuro,quelthalas,1443,priest,discipline,66,31,35
27716,Jeresh,sargeras,1443,priest,discipline,65,21,44
27717,Bandèl,tichondrius,1442,priest,discipline,42,27,15
27718,Rondrica,stormscale,1442,priest,discipline,30,17,13
27719,Raisonpriest,tichondrius,1442,priest,discipline,84,44,40
27720,Kiritomauti,ragnaros,1442,priest,discipline,42,18,24
27721,Easypriest,tichondrius,1441,priest,discipline,96,50,46
27722,Sreykalip,frostmourne,1441,priest,discipline,48,24,24
27723,Shadowblax,thrall,1441,priest,discipline,160,75,85
27724,Flatlining,illidan,1441,priest,discipline,48,22,26
27725,Docmcstufins,darkspear,1440,priest,discipline,65,31,34
27726,Kristyenna,boulderfist,1440,priest,discipline,42,20,22
27727,Josquin,illidan,1440,priest,discipline,70,30,40
27728,Goodvybes,tichondrius,1440,priest,discipline,54,23,31
27729,Zhatfko,illidan,1440,priest,discipline,78,31,47
27730,Tallshiraz,destromath,1439,priest,discipline,24,19,5
27731,Eshimä,quelthalas,1439,priest,discipline,86,50,36
27732,Cubski,darkspear,1439,priest,discipline,30,15,15
27733,Umadcüzubad,azralon,1439,priest,discipline,115,54,61
27734,Scrubx,malganis,1438,priest,discipline,18,15,3
27735,Disperse,vashj,1438,priest,discipline,138,62,76
27736,Rabbix,aggramar,1437,priest,discipline,30,19,11
27737,Mason,winterhoof,1437,priest,discipline,24,15,9
27738,Luffzie,barthilas,1437,priest,discipline,72,41,31
27739,Fotmtrash,the-underbog,1437,priest,discipline,30,15,15
27740,Lauretânia,nemesis,1437,priest,discipline,114,51,63
27741,Joesus,kelthuzad,1437,priest,discipline,38,17,21
27742,Arfaxad,quelthalas,1436,priest,discipline,18,15,3
27743,Vivián,tichondrius,1436,priest,discipline,115,63,52
27744,Compåctdisc,sargeras,1436,priest,discipline,36,18,18
27745,Jacob,shadowmoon,1436,priest,discipline,153,74,79
27746,Draazja,dalaran,1436,priest,discipline,126,60,66
27747,Amãnita,illidan,1436,priest,discipline,35,15,20
27748,Pphill,aegwynn,1436,priest,discipline,48,19,29
27749,Eudog,zuljin,1435,priest,discipline,18,15,3
27750,Madjak,lightnings-blade,1435,priest,discipline,102,58,44
27751,Smashhley,bleeding-hollow,1435,priest,discipline,92,51,41
27752,Murdock,the-forgotten-coast,1435,priest,discipline,56,31,25
27753,Bootycough,malganis,1435,priest,discipline,63,32,31
27754,Sliding,wyrmrest-accord,1435,priest,discipline,30,15,15
27755,Nasser,tichondrius,1435,priest,discipline,30,15,15
27756,Conorpriest,tichondrius,1435,priest,discipline,30,15,15
27757,Lonpriest,stormrage,1435,priest,discipline,210,99,111
27758,Miix,proudmoore,1434,priest,discipline,18,15,3
27759,Baali,moon-guard,1434,priest,discipline,41,27,14
27760,Evpray,area-52,1434,priest,discipline,54,35,19
27761,Luminous,moon-guard,1434,priest,discipline,137,73,64
27762,Detainedz,malganis,1434,priest,discipline,30,15,15
27763,Vineller,malganis,1434,priest,discipline,36,15,21
27764,Høðj,tichondrius,1433,priest,discipline,30,15,15
27765,Amorus,illidan,1432,priest,discipline,60,40,20
27766,Necrodiva,magtheridon,1432,priest,discipline,84,43,41
27767,Rôôk,kiljaeden,1432,priest,discipline,56,26,30
27768,Lullabya,tichondrius,1431,priest,discipline,24,15,9
27769,Napzz,sargeras,1431,priest,discipline,45,27,18
27770,Eridan,moon-guard,1429,priest,discipline,65,33,32
27771,Aexdawg,malganis,1429,priest,discipline,48,24,24
27772,Shadowglezy,area-52,1429,priest,discipline,36,18,18
27773,Kwaremont,sargeras,1429,priest,discipline,30,15,15
27774,Sacredmoon,dreadmaul,1429,priest,discipline,30,15,15
27775,Jilt,aerie-peak,1428,priest,discipline,90,53,37
27776,Tainna,quelthalas,1428,priest,discipline,78,44,34
27777,Elexy,tichondrius,1428,priest,discipline,72,37,35
27778,Axelrod,tichondrius,1428,priest,discipline,54,21,33
27779,Linkolln,sargeras,1427,priest,discipline,30,18,12
27780,Dominantz,khazgoroth,1427,priest,discipline,66,38,28
27781,Femìnazzi,ragnaros,1427,priest,discipline,70,38,32
27782,Minii,tichondrius,1427,priest,discipline,79,40,39
27783,Cherryfuzz,sargeras,1427,priest,discipline,89,45,44
27784,Braffuki,frostmourne,1427,priest,discipline,95,45,50
27785,Beefoverload,durotan,1427,priest,discipline,129,60,69
27786,Pumtootoot,tichondrius,1427,priest,discipline,36,15,21
27787,Dreadpriate,emerald-dream,1426,priest,discipline,104,52,52
27788,Aumsi,illidan,1426,priest,discipline,63,26,37
27789,Covnite,bloodscalp,1425,priest,discipline,48,26,22
27790,Voicekal,sargeras,1425,priest,discipline,77,41,36
27791,Teeds,stormrage,1425,priest,discipline,69,34,35
27792,Saentha,sargeras,1425,priest,discipline,54,25,29
27793,Halö,area-52,1425,priest,discipline,114,51,63
27794,Wíckéd,frostmourne,1425,priest,discipline,57,23,34
27795,Langyi,tichondrius,1424,priest,discipline,72,41,31
27796,Sauile,kelthuzad,1424,priest,discipline,114,64,50
27797,Staysmall,stormrage,1424,priest,discipline,30,15,15
27798,Shakky,queldorei,1423,priest,discipline,78,34,44
27799,Sinthe,stormrage,1422,priest,discipline,24,16,8
27800,Nolan,drakkari,1422,priest,discipline,47,27,20
27801,Zørb,area-52,1422,priest,discipline,54,31,23
27802,Ketaminè,tichondrius,1422,priest,discipline,48,25,23
27803,Miaria,chogall,1422,priest,discipline,126,63,63
27804,Wpj,barthilas,1422,priest,discipline,51,17,34
27805,Bloatie,zuljin,1421,priest,discipline,42,28,14
27806,Izikial,illidan,1421,priest,discipline,48,24,24
27807,Kurobankai,tichondrius,1421,priest,discipline,51,25,26
27808,Plumpkinn,kiljaeden,1421,priest,discipline,36,15,21
27809,Holycast,arygos,1420,priest,discipline,24,15,9
27810,Sackura,quelthalas,1420,priest,discipline,49,26,23
27811,Inmotion,tichondrius,1420,priest,discipline,30,15,15
27812,Machinecoach,stormrage,1419,priest,discipline,30,15,15
27813,Tidbitsy,malganis,1419,priest,discipline,30,15,15
27814,Brotatochip,andorhal,1419,priest,discipline,49,24,25
27815,Malavidax,malganis,1419,priest,discipline,108,45,63
27816,Yözsh,azralon,1419,priest,discipline,60,25,35
27817,Zjqf,akama,1418,priest,discipline,179,89,90
27818,Voyou,icecrown,1418,priest,discipline,106,48,58
27819,Holyish,proudmoore,1418,priest,discipline,42,19,23
27820,Vundead,tichondrius,1418,priest,discipline,36,16,20
27821,Ekros,illidan,1417,priest,discipline,40,23,17
27822,Spazmode,malganis,1417,priest,discipline,75,38,37
27823,Aubieheal,malygos,1416,priest,discipline,42,23,19
27824,Feorlar,tichondrius,1416,priest,discipline,90,43,47
27825,Mäí,ragnaros,1415,priest,discipline,84,51,33
27826,Shonkee,tichondrius,1415,priest,discipline,27,16,11
27827,Sungji,tichondrius,1415,priest,discipline,30,15,15
27828,Sasaberry,frostmourne,1415,priest,discipline,169,80,89
27829,Dtsgx,tichondrius,1414,priest,discipline,27,16,11
27830,Coldphobia,uldum,1414,priest,discipline,157,83,74
27831,Fearnought,stormrage,1414,priest,discipline,82,41,41
27832,Ankhxiety,area-52,1414,priest,discipline,71,33,38
27833,Faerline,kelthuzad,1414,priest,discipline,35,15,20
27834,Aubine,sargeras,1414,priest,discipline,41,15,26
27835,Ananiel,moon-guard,1413,priest,discipline,24,15,9
27836,Artiannaa,bleeding-hollow,1413,priest,discipline,42,24,18
27837,Clancygilroy,thrall,1413,priest,discipline,90,44,46
27838,Tbirdpriest,tichondrius,1413,priest,discipline,35,17,18
27839,Daluu,tichondrius,1413,priest,discipline,51,18,33
27840,Feløre,quelthalas,1412,priest,discipline,51,32,19
27841,Bakøo,tichondrius,1412,priest,discipline,31,19,12
27842,Accismus,khadgar,1412,priest,discipline,78,37,41
27843,Raileight,illidan,1412,priest,discipline,56,25,31
27844,Handyheals,frostmourne,1411,priest,discipline,113,62,51
27845,Posabilties,bleeding-hollow,1411,priest,discipline,42,20,22
27846,Karmatron,chogall,1411,priest,discipline,42,17,25
27847,Dokthekim,frostmourne,1410,priest,discipline,32,19,13
27848,Staywild,tichondrius,1410,priest,discipline,30,15,15
27849,Iivelaughluv,kiljaeden,1409,priest,discipline,51,29,22
27850,Buqisama,barthilas,1409,priest,discipline,72,29,43
27851,Shelak,frostmourne,1408,priest,discipline,62,33,29
27852,Eatmyfear,quelthalas,1408,priest,discipline,247,122,125
27853,Blavkata,area-52,1408,priest,discipline,50,23,27
27854,Midoopriest,proudmoore,1408,priest,discipline,36,15,21
27855,Verchou,shattered-hand,1408,priest,discipline,36,15,21
27856,Justanoutlaw,darkspear,1407,priest,discipline,36,21,15
27857,Kawin,goldrinn,1407,priest,discipline,101,54,47
27858,Sunenergy,tichondrius,1407,priest,discipline,78,41,37
27859,Amaranth,the-forgotten-coast,1407,priest,discipline,30,15,15
27860,Halliburton,illidan,1406,priest,discipline,176,92,84
27861,Sleepiest,wyrmrest-accord,1405,priest,discipline,24,15,9
27862,Seáoflions,aggramar,1405,priest,discipline,24,15,9
27863,Dmlx,frostmourne,1405,priest,discipline,156,90,66
27864,Creamedcorn,tichondrius,1405,priest,discipline,29,15,14
27865,Mangueroide,quelthalas,1405,priest,discipline,111,57,54
27866,Chimiechurro,proudmoore,1405,priest,discipline,90,45,45
27867,Tryst,the-underbog,1404,priest,discipline,60,37,23
27868,Kuriyasu,emerald-dream,1404,priest,discipline,149,78,71
27869,Itsmaám,moon-guard,1403,priest,discipline,42,25,17
27870,Pitayakiller,tichondrius,1403,priest,discipline,29,15,14
27871,Gwyneth,whisperwind,1403,priest,discipline,80,35,45
27872,Kjpriest,kelthuzad,1402,priest,discipline,54,34,20
27873,Nicety,skywall,1402,priest,discipline,50,22,28
27874,Jelzz,area-52,1401,priest,discipline,28,17,11
27875,Dipadre,azralon,1401,priest,discipline,42,25,17
27876,Trickyhobo,area-52,1401,priest,discipline,91,52,39
27877,Lexaprö,moon-guard,1401,priest,discipline,62,33,29
27878,Kaonn,frostmourne,1401,priest,discipline,251,133,118
27879,Bubbahotep,laughing-skull,1401,priest,discipline,52,25,27
27880,Whehaw,kelthuzad,1401,priest,discipline,132,63,69
27881,Yishaarj,tichondrius,1401,priest,discipline,53,24,29
27882,Khyonne,nemesis,1400,priest,discipline,68,37,31
27883,Hunanbeef,kiljaeden,1400,priest,discipline,88,45,43
27884,Peacewrench,moon-guard,1400,priest,discipline,30,15,15
27885,Angusb,sargeras,1400,priest,discipline,113,51,62
27886,Stormìst,korgath,1399,priest,discipline,30,18,12
27887,Welovan,sargeras,1399,priest,discipline,70,36,34
27888,Shnítzel,thrall,1399,priest,discipline,103,51,52
27889,Smegmancer,korgath,1399,priest,discipline,54,24,30
27890,Peristalsis,nesingwary,1399,priest,discipline,36,16,20
27891,Coldvbs,barthilas,1398,priest,discipline,46,26,20
27892,Palpitine,kiljaeden,1398,priest,discipline,60,33,27
27893,Fanatic,nemesis,1397,priest,discipline,226,117,109
27894,Diabiitus,stormrage,1396,priest,discipline,105,61,44
27895,Ðohko,ragnaros,1395,priest,discipline,36,20,16
27896,Karminha,azralon,1393,priest,discipline,24,17,7
27897,Freck,stormrage,1393,priest,discipline,42,25,17
27898,Icônz,malganis,1393,priest,discipline,59,31,28
27899,Kasiry,ragnaros,1393,priest,discipline,66,34,32
27900,Lilblackguys,stormrage,1393,priest,discipline,114,56,58
27901,Scriptz,frostwolf,1393,priest,discipline,66,30,36
27902,Raggasoca,malganis,1393,priest,discipline,99,44,55
27903,Macnabber,malganis,1392,priest,discipline,30,20,10
27904,Ðiplø,tichondrius,1392,priest,discipline,35,21,14
27905,Smirkinlive,illidan,1392,priest,discipline,38,22,16
27906,Donzorro,ragnaros,1392,priest,discipline,87,46,41
27907,Soméone,sargeras,1392,priest,discipline,164,86,78
27908,Tluoc,nemesis,1391,priest,discipline,47,25,22
27909,Smittën,barthilas,1390,priest,discipline,72,40,32
27910,Scortum,goldrinn,1390,priest,discipline,36,20,16
27911,Phayzz,area-52,1390,priest,discipline,123,63,60
27912,Jaeza,azralon,1390,priest,discipline,47,22,25
27913,Chofis,nathrezim,1389,priest,discipline,36,24,12
27914,Leviathanh,tichondrius,1389,priest,discipline,42,27,15
27915,Såge,chogall,1389,priest,discipline,219,120,99
27916,Shastyr,tichondrius,1389,priest,discipline,48,19,29
27917,Zygotes,tichondrius,1388,priest,discipline,27,16,11
27918,Xyló,area-52,1388,priest,discipline,118,65,53
27919,Cathêlay,bleeding-hollow,1388,priest,discipline,91,44,47
27920,Helibix,bleeding-hollow,1388,priest,discipline,114,53,61
27921,Krukam,sargeras,1386,priest,discipline,66,40,26
27922,Unholywizard,sargeras,1386,priest,discipline,66,37,29
27923,Strawson,quelthalas,1386,priest,discipline,105,50,55
27924,Kobayashy,ragnaros,1385,priest,discipline,48,29,19
27925,Holyninfo,quelthalas,1385,priest,discipline,60,36,24
27926,Vexyy,tichondrius,1385,priest,discipline,32,19,13
27927,Mursey,sargeras,1385,priest,discipline,111,51,60
27928,Laüren,ragnaros,1385,priest,discipline,103,46,57
27929,Oprawinfree,tichondrius,1384,priest,discipline,94,54,40
27930,Tungus,shadowsong,1384,priest,discipline,97,51,46
27931,Icetraygang,suramar,1383,priest,discipline,386,204,182
27932,Arkenes,dalaran,1383,priest,discipline,78,41,37
27933,Wholeness,kelthuzad,1383,priest,discipline,48,21,27
27934,Holykushed,tichondrius,1382,priest,discipline,38,19,19
27935,Shrax,emerald-dream,1382,priest,discipline,149,68,81
27936,Sukmysplooge,queldorei,1382,priest,discipline,66,28,38
27937,Tiskka,magtheridon,1382,priest,discipline,68,28,40
27938,Jamesxupttv,draenor,1381,priest,discipline,64,33,31
27939,Sílvia,durotan,1381,priest,discipline,60,28,32
27940,Therialjp,ragnaros,1380,priest,discipline,36,21,15
27941,Jinniu,azralon,1380,priest,discipline,42,17,25
27942,Helarix,malganis,1379,priest,discipline,127,58,69
27943,Drhutchinson,illidan,1377,priest,discipline,30,16,14
27944,Oldris,darkspear,1377,priest,discipline,47,25,22
27945,Lexinalis,stormrage,1376,priest,discipline,29,17,12
27946,Kallixprime,ragnaros,1376,priest,discipline,53,29,24
27947,Fádéd,tichondrius,1376,priest,discipline,29,15,14
27948,Sixfiggas,darkspear,1375,priest,discipline,24,17,7
27949,Aldrych,malganis,1375,priest,discipline,61,35,26
27950,Dlysexic,barthilas,1375,priest,discipline,66,35,31
27951,Sistamaggie,bleeding-hollow,1375,priest,discipline,66,33,33
27952,Drinkndrive,tichondrius,1374,priest,discipline,51,27,24
27953,Zombieheals,gundrak,1373,priest,discipline,53,27,26
27954,Halcyon,eonar,1372,priest,discipline,74,34,40
27955,Mauriel,proudmoore,1372,priest,discipline,42,19,23
27956,Karazhan,burning-legion,1371,priest,discipline,44,19,25
27957,Glauga,azralon,1371,priest,discipline,42,17,25
27958,Sinsuu,tichondrius,1370,priest,discipline,120,64,56
27959,Jìtters,silvermoon,1370,priest,discipline,36,17,19
27960,Devilwithin,moon-guard,1369,priest,discipline,47,28,19
27961,Kyoku,tanaris,1369,priest,discipline,47,27,20
27962,Aarei,stormrage,1369,priest,discipline,30,16,14
27963,Onjah,kiljaeden,1369,priest,discipline,60,25,35
27964,Rotass,hyjal,1368,priest,discipline,60,36,24
27965,Vacyle,azralon,1368,priest,discipline,42,23,19
27966,Pyta,frostmourne,1367,priest,discipline,62,32,30
27967,Unholyhand,moon-guard,1367,priest,discipline,60,27,33
27968,Solsano,stormrage,1365,priest,discipline,76,44,32
27969,Poefosho,stormrage,1365,priest,discipline,58,29,29
27970,Winnzhor,bonechewer,1364,priest,discipline,47,27,20
27971,Bøness,area-52,1364,priest,discipline,118,61,57
27972,Sermøn,azuremyst,1364,priest,discipline,135,67,68
27973,Armî,ragnaros,1364,priest,discipline,36,16,20
27974,Tazzi,chromaggus,1363,priest,discipline,36,20,16
27975,Halfyo,dragonmaw,1363,priest,discipline,90,49,41
27976,Füuzin,stormrage,1362,priest,discipline,66,34,32
27977,Thorzan,eredar,1362,priest,discipline,30,15,15
27978,Honypot,ysondre,1361,priest,discipline,60,34,26
27979,Angelicus,ragnaros,1361,priest,discipline,156,83,73
27980,Temkcalb,ragnaros,1361,priest,discipline,90,46,44
27981,Sinnertitanz,quelthalas,1361,priest,discipline,90,46,44
27982,Rakpriest,nerzhul,1360,priest,discipline,43,29,14
27983,Curasia,drakkari,1360,priest,discipline,57,37,20
27984,Happylonely,farstriders,1360,priest,discipline,27,15,12
27985,Trummp,tichondrius,1359,priest,discipline,75,40,35
27986,Powerwordzz,dragonmaw,1359,priest,discipline,72,36,36
27987,Huck,khazgoroth,1359,priest,discipline,36,18,18
27988,Itsme,quelthalas,1359,priest,discipline,71,32,39
27989,Crucïfïx,stormrage,1358,priest,discipline,70,41,29
27990,Nexoox,drakkari,1358,priest,discipline,42,23,19
27991,Tyszie,sargeras,1358,priest,discipline,30,15,15
27992,Tûbes,trollbane,1358,priest,discipline,101,42,59
27993,Replacednewb,chogall,1357,priest,discipline,51,27,24
27994,Eiju,proudmoore,1357,priest,discipline,42,19,23
27995,Aerdune,dalaran,1356,priest,discipline,68,36,32
27996,Empower,garrosh,1355,priest,discipline,45,29,16
27997,Vhexz,sargeras,1355,priest,discipline,56,36,20
27998,Saegusa,tichondrius,1354,priest,discipline,30,15,15
27999,Kymmei,warsong,1354,priest,discipline,30,15,15
28000,Msdash,tichondrius,1353,priest,discipline,42,23,19
28001,Srwilly,ragnaros,1353,priest,discipline,87,47,40
28002,Renews,azralon,1353,priest,discipline,52,28,24
28003,Swolequadz,elune,1353,priest,discipline,30,16,14
28004,Wtfamdoing,quelthalas,1353,priest,discipline,29,15,14
28005,Misfyt,emerald-dream,1353,priest,discipline,66,33,33
28006,Victrix,tichondrius,1353,priest,discipline,112,47,65
28007,Mateekie,malganis,1352,priest,discipline,43,24,19
28008,Chìbiusa,gurubashi,1352,priest,discipline,106,52,54
28009,Ggums,tichondrius,1352,priest,discipline,84,40,44
28010,Hootin,whisperwind,1351,priest,discipline,62,35,27
28011,Risedead,azralon,1351,priest,discipline,132,70,62
28012,Kantareller,tichondrius,1349,priest,discipline,99,60,39
28013,Pagän,illidan,1349,priest,discipline,45,25,20
28014,Aurajade,queldorei,1349,priest,discipline,30,15,15
28015,Yeshùa,drakkari,1349,priest,discipline,125,59,66
28016,Beñzi,sargeras,1348,priest,discipline,26,16,10
28017,Oomed,bonechewer,1348,priest,discipline,118,59,59
28018,Howdydoo,azshara,1348,priest,discipline,73,33,40
28019,Dxskadi,stormrage,1348,priest,discipline,156,68,88
28020,Zóe,eredar,1347,priest,discipline,58,32,26
28021,Revreal,thrall,1346,priest,discipline,48,25,23
28022,Helianna,whisperwind,1346,priest,discipline,114,50,64
28023,Benedictüs,tichondrius,1345,priest,discipline,154,77,77
28024,Pelagius,suramar,1345,priest,discipline,44,19,25
28025,ßræcher,black-dragonflight,1344,priest,discipline,36,24,12
28026,Hoppus,stormrage,1344,priest,discipline,90,44,46
28027,Scaloni,proudmoore,1343,priest,discipline,29,18,11
28028,Mthwz,tichondrius,1343,priest,discipline,24,14,10
28029,Bohomagz,tichondrius,1343,priest,discipline,24,14,10
28030,Magicßoy,magtheridon,1343,priest,discipline,152,79,73
28031,Fadewench,sargeras,1343,priest,discipline,41,21,20
28032,Lucsor,malganis,1343,priest,discipline,119,60,59
28033,Míssdank,tichondrius,1343,priest,discipline,36,18,18
28034,Jabberwolky,blackrock,1343,priest,discipline,36,14,22
28035,Crazykitsune,thaurissan,1342,priest,discipline,42,27,15
28036,Namî,barthilas,1342,priest,discipline,191,104,87
28037,Lawroade,tichondrius,1342,priest,discipline,67,36,31
28038,Notoriousmmä,illidan,1342,priest,discipline,30,15,15
28039,Mitoloshi,ragnaros,1342,priest,discipline,120,58,62
28040,Redcoolaid,moon-guard,1341,priest,discipline,24,14,10
28041,Tyreliy,eitrigg,1341,priest,discipline,175,90,85
28042,Zoap,stormrage,1341,priest,discipline,60,26,34
28043,Bobbyrich,sargeras,1340,priest,discipline,18,14,4
28044,Néy,illidan,1340,priest,discipline,18,14,4
28045,Saintpleb,sargeras,1340,priest,discipline,18,14,4
28046,Teiam,skullcrusher,1340,priest,discipline,24,14,10
28047,Bionix,stormrage,1340,priest,discipline,72,37,35
28048,Psÿçhë,stormrage,1340,priest,discipline,30,14,16
28049,Storylord,malganis,1340,priest,discipline,30,14,16
28050,Krindil,korgath,1339,priest,discipline,59,34,25
28051,Fleckyy,tichondrius,1339,priest,discipline,36,14,22
28052,Eddiethehead,zuljin,1338,priest,discipline,24,14,10
28053,Bugsbright,tichondrius,1338,priest,discipline,125,69,56
28054,Vehlind,quelthalas,1338,priest,discipline,101,52,49
28055,Haquin,malganis,1338,priest,discipline,30,14,16
28056,Knoskeezy,proudmoore,1337,priest,discipline,18,14,4
28057,Muuq,frostmourne,1337,priest,discipline,221,110,111
28058,Monâ,sargeras,1337,priest,discipline,30,14,16
28059,Foxspritques,area-52,1337,priest,discipline,58,16,42
28060,Lilazngirl,stormrage,1336,priest,discipline,30,19,11
28061,Xxqq,illidan,1335,priest,discipline,24,14,10
28062,Metagameswag,tichondrius,1335,priest,discipline,24,14,10
28063,Shadina,gorefiend,1335,priest,discipline,36,14,22
28064,Talbadontu,thrall,1334,priest,discipline,42,22,20
28065,Erossenin,proudmoore,1334,priest,discipline,30,15,15
28066,Slumpbusterx,bonechewer,1334,priest,discipline,169,75,94
28067,Dederpriest,stormrage,1333,priest,discipline,18,14,4
28068,Qoon,tichondrius,1333,priest,discipline,24,14,10
28069,Cäpriestsunn,thrall,1333,priest,discipline,24,14,10
28070,Rblood,emerald-dream,1332,priest,discipline,54,33,21
28071,Ilickdeadppl,sargeras,1331,priest,discipline,28,17,11
28072,Noveh,tichondrius,1331,priest,discipline,36,17,19
28073,Bigskill,proudmoore,1331,priest,discipline,48,21,27
28074,Lily,blackrock,1330,priest,discipline,18,14,4
28075,Matchakatt,tichondrius,1330,priest,discipline,59,37,22
28076,Pactosombrio,azralon,1330,priest,discipline,117,69,48
28077,Bathenape,bleeding-hollow,1330,priest,discipline,40,23,17
28078,Holyfromrmp,tichondrius,1330,priest,discipline,72,35,37
28079,Decline,balnazzar,1330,priest,discipline,30,14,16
28080,Náay,ragnaros,1329,priest,discipline,47,30,17
28081,Xuun,illidan,1329,priest,discipline,71,42,29
28082,Emotionless,bonechewer,1329,priest,discipline,140,75,65
28083,Themoon,tichondrius,1328,priest,discipline,24,14,10
28084,Jacksreturne,kelthuzad,1327,priest,discipline,413,207,206
28085,Raydz,altar-of-storms,1327,priest,discipline,266,127,139
28086,Nêrô,dalaran,1327,priest,discipline,66,29,37
28087,Danrien,azralon,1326,priest,discipline,34,20,14
28088,Aveil,bloodscalp,1326,priest,discipline,34,20,14
28089,Rickjames,laughing-skull,1326,priest,discipline,86,47,39
28090,Healmedaddyy,korgath,1326,priest,discipline,207,99,108
28091,Juliusceazer,skywall,1325,priest,discipline,128,73,55
28092,Zapix,tichondrius,1325,priest,discipline,36,15,21
28093,Blessedelf,tichondrius,1325,priest,discipline,66,26,40
28094,Edmust,black-dragonflight,1324,priest,discipline,24,14,10
28095,Köto,dalaran,1324,priest,discipline,53,29,24
28096,Rvxy,tichondrius,1324,priest,discipline,84,42,42
28097,Xerzosh,area-52,1323,priest,discipline,154,81,73
28098,Jaysontatum,gurubashi,1323,priest,discipline,33,17,16
28099,Heltor,sargeras,1323,priest,discipline,66,25,41
28100,Textmepls,barthilas,1322,priest,discipline,42,26,16
28101,Kaeshia,proudmoore,1322,priest,discipline,30,18,12
28102,Greif,garrosh,1322,priest,discipline,36,19,17
28103,Burroviejo,quelthalas,1322,priest,discipline,40,17,23
28104,Vandaley,tichondrius,1321,priest,discipline,24,17,7
28105,Javox,drakkari,1321,priest,discipline,24,14,10
28106,Warmth,moon-guard,1321,priest,discipline,45,26,19
28107,Xtty,thrall,1321,priest,discipline,31,15,16
28108,Sinnon,turalyon,1320,priest,discipline,30,17,13
28109,Mkowns,tichondrius,1319,priest,discipline,24,14,10
28110,Nadiaxo,moon-guard,1319,priest,discipline,65,35,30
28111,Nøzmonica,kelthuzad,1319,priest,discipline,32,15,17
28112,Ripscrew,area-52,1316,priest,discipline,24,14,10
28113,Malevolently,illidan,1316,priest,discipline,137,62,75
28114,Seniro,tichondrius,1315,priest,discipline,36,23,13
28115,Wöödy,area-52,1315,priest,discipline,34,18,16
28116,Chaøz,emerald-dream,1314,priest,discipline,41,24,17
28117,Elixia,maiev,1314,priest,discipline,54,31,23
28118,Thelondon,tichondrius,1314,priest,discipline,27,15,12
28119,Flab,tichondrius,1314,priest,discipline,30,15,15
28120,Haø,stormrage,1314,priest,discipline,278,137,141
28121,Darkquinn,boulderfist,1314,priest,discipline,272,126,146
28122,Blaydun,elune,1313,priest,discipline,114,66,48
28123,Moontearss,tichondrius,1313,priest,discipline,48,25,23
28124,Kms,sargeras,1313,priest,discipline,51,26,25
28125,Eirenth,bleeding-hollow,1312,priest,discipline,34,26,8
28126,Jsuschristix,zuljin,1311,priest,discipline,36,23,13
28127,Médic,guldan,1311,priest,discipline,30,17,13
28128,Goodwin,darkspear,1310,priest,discipline,48,29,19
28129,Chîna,hyjal,1310,priest,discipline,126,76,50
28130,Conney,mugthol,1310,priest,discipline,24,14,10
28131,Anymoon,tichondrius,1310,priest,discipline,78,42,36
28132,Leprêtre,hakkar,1310,priest,discipline,30,16,14
28133,Eclìpsè,barthilas,1310,priest,discipline,44,20,24
28134,Yürika,emerald-dream,1310,priest,discipline,60,21,39
28135,Jestiann,aegwynn,1309,priest,discipline,207,109,98
28136,Malarkie,sargeras,1309,priest,discipline,30,14,16
28137,Jaskil,skywall,1308,priest,discipline,78,42,36
28138,Booyâh,muradin,1308,priest,discipline,54,27,27
28139,Peavzian,kiljaeden,1308,priest,discipline,52,24,28
28140,Quinnx,tichondrius,1308,priest,discipline,36,16,20
28141,Majesticar,moon-guard,1307,priest,discipline,30,20,10
28142,Rompenepes,drakkari,1307,priest,discipline,24,14,10
28143,Médíc,dalaran,1307,priest,discipline,63,32,31
28144,Starshollow,ragnaros,1307,priest,discipline,75,38,37
28145,Dominie,area-52,1306,priest,discipline,18,14,4
28146,Aesudan,dalaran,1306,priest,discipline,51,27,24
28147,Priestgobrr,emerald-dream,1305,priest,discipline,50,30,20
28148,Ruthlèss,ragnaros,1305,priest,discipline,54,28,26
28149,Exploded,moon-guard,1305,priest,discipline,85,34,51
28150,Fairylìght,stormrage,1305,priest,discipline,61,22,39
28151,Dahrwin,thrall,1303,priest,discipline,42,24,18
28152,Paidessanto,azralon,1303,priest,discipline,98,55,43
28153,Plznokill,tichondrius,1303,priest,discipline,36,18,18
28154,ßoogey,tichondrius,1303,priest,discipline,47,22,25
28155,Gustavustus,barthilas,1303,priest,discipline,42,14,28
28156,Soaphia,kelthuzad,1302,priest,discipline,96,55,41
28157,Rêvelation,trollbane,1302,priest,discipline,78,41,37
28158,Poorass,sargeras,1301,priest,discipline,30,19,11
28159,Aedarelyn,ysera,1301,priest,discipline,42,22,20
28160,Evilnyllah,stormrage,1300,priest,discipline,32,20,12
28161,Gäindalt,tichondrius,1300,priest,discipline,30,18,12
28162,Atyourcervix,emerald-dream,1299,priest,discipline,26,15,11
28163,Tarny,tichondrius,1298,priest,discipline,46,29,17
28164,Krané,area-52,1298,priest,discipline,51,24,27
28165,Bandagebabe,sargeras,1298,priest,discipline,36,15,21
28166,Wildmanfrank,tichondrius,1297,priest,discipline,37,21,16
28167,Timeglass,kelthuzad,1297,priest,discipline,47,26,21
28168,Mechahomo,dalaran,1297,priest,discipline,52,28,24
28169,Penetron,tichondrius,1297,priest,discipline,53,22,31
28170,Volkova,quelthalas,1296,priest,discipline,48,26,22
28171,Dabbinton,chogall,1296,priest,discipline,52,26,26
28172,Hydramîst,ragnaros,1296,priest,discipline,36,15,21
28173,Fenian,frostmourne,1295,priest,discipline,123,60,63
28174,Yunganal,sargeras,1294,priest,discipline,24,14,10
28175,Rrain,proudmoore,1294,priest,discipline,35,15,20
28176,Moresex,azralon,1293,priest,discipline,36,20,16
28177,Theheal,ragnaros,1293,priest,discipline,57,19,38
28178,Dadthegreat,bonechewer,1292,priest,discipline,42,25,17
28179,Usmond,azralon,1292,priest,discipline,48,23,25
28180,Cyphrus,hyjal,1292,priest,discipline,35,15,20
28181,Gnralways,andorhal,1292,priest,discipline,69,29,40
28182,Unfriend,sargeras,1291,priest,discipline,48,22,26
28183,Rakket,moon-guard,1291,priest,discipline,36,16,20
28184,Soulclap,sargeras,1291,priest,discipline,35,14,21
28185,Lyxx,kelthuzad,1290,priest,discipline,22,15,7
28186,Rickitz,bleeding-hollow,1290,priest,discipline,36,17,19
28187,Tempgnome,stonemaul,1288,priest,discipline,97,51,46
28188,Troublmaker,illidan,1288,priest,discipline,46,24,22
28189,Cathiah,darkspear,1288,priest,discipline,152,77,75
28190,Xpera,dalaran,1288,priest,discipline,95,45,50
28191,Bibops,area-52,1288,priest,discipline,37,15,22
28192,Iwonthealu,senjin,1286,priest,discipline,30,16,14
28193,Novous,area-52,1286,priest,discipline,56,26,30
28194,Khaleth,suramar,1286,priest,discipline,48,20,28
28195,Brounly,drakkari,1285,priest,discipline,72,36,36
28196,Yayoo,exodar,1285,priest,discipline,33,16,17
28197,Nenemsis,drakkari,1285,priest,discipline,38,16,22
28198,Boibussy,tichondrius,1285,priest,discipline,36,15,21
28199,Goingserious,frostmourne,1284,priest,discipline,135,77,58
28200,Quickq,barthilas,1283,priest,discipline,36,22,14
28201,Penancepapi,stormrage,1283,priest,discipline,30,14,16
28202,Presto,kalecgos,1281,priest,discipline,24,19,5
28203,Dismybracket,tichondrius,1281,priest,discipline,42,20,22
28204,Lifeswap,area-52,1281,priest,discipline,54,21,33
28205,Briefs,stormrage,1278,priest,discipline,21,15,6
28206,Bloodsorrow,ragnaros,1278,priest,discipline,72,39,33
28207,Souriel,tichondrius,1278,priest,discipline,78,41,37
28208,Phonomena,malganis,1278,priest,discipline,102,53,49
28209,Kakao,stormreaver,1278,priest,discipline,120,51,69
28210,Lamont,archimonde,1277,priest,discipline,38,14,24
28211,Nanabritches,moon-guard,1276,priest,discipline,116,62,54
28212,Invocational,moon-guard,1276,priest,discipline,77,40,37
28213,Lowkii,malfurion,1275,priest,discipline,35,17,18
28214,Shaytyme,tichondrius,1275,priest,discipline,40,15,25
28215,Nylaza,kiljaeden,1274,priest,discipline,71,28,43
28216,Boocharni,wyrmrest-accord,1273,priest,discipline,48,28,20
28217,Sòraka,tichondrius,1273,priest,discipline,80,39,41
28218,Xavaat,nerzhul,1273,priest,discipline,60,26,34
28219,Rando,shattered-halls,1272,priest,discipline,35,18,17
28220,Discgolfsux,sargeras,1271,priest,discipline,50,19,31
28221,Healmegently,bonechewer,1271,priest,discipline,45,15,30
28222,Themøn,quelthalas,1270,priest,discipline,30,16,14
28223,Markspell,stormrage,1270,priest,discipline,145,77,68
28224,Derlanger,frostmourne,1270,priest,discipline,48,25,23
28225,Twotimechamp,azshara,1269,priest,discipline,50,26,24
28226,Phenic,aggramar,1269,priest,discipline,35,14,21
28227,Snekboy,hakkar,1268,priest,discipline,66,41,25
28228,Jjayleroux,hyjal,1268,priest,discipline,54,26,28
28229,Aggravating,mugthol,1267,priest,discipline,176,89,87
28230,Miraz,the-venture-co,1266,priest,discipline,53,29,24
28231,Ahane,wyrmrest-accord,1266,priest,discipline,36,15,21
28232,Sureno,muradin,1265,priest,discipline,30,18,12
28233,Penitentrowr,illidan,1265,priest,discipline,77,40,37
28234,Zenthaz,thrall,1264,priest,discipline,30,16,14
28235,Capricornio,nemesis,1264,priest,discipline,36,18,18
28236,Fumes,ghostlands,1264,priest,discipline,78,36,42
28237,Keskima,malganis,1263,priest,discipline,81,51,30
28238,Sheriff,lightbringer,1263,priest,discipline,54,33,21
28239,Rashad,proudmoore,1262,priest,discipline,59,34,25
28240,Wise,wildhammer,1262,priest,discipline,70,37,33
28241,Saràh,stormscale,1262,priest,discipline,94,43,51
28242,Reindharth,quelthalas,1262,priest,discipline,84,35,49
28243,Kristt,thrall,1262,priest,discipline,41,16,25
28244,Emlix,tichondrius,1262,priest,discipline,42,14,28
28245,Fesix,akama,1261,priest,discipline,30,17,13
28246,Aladelre,aerie-peak,1261,priest,discipline,56,26,30
28247,Hideyourkids,stormreaver,1261,priest,discipline,42,18,24
28248,Lìlí,tichondrius,1261,priest,discipline,42,17,25
28249,Pico,spirestone,1260,priest,discipline,36,20,16
28250,Hobbs,trollbane,1260,priest,discipline,42,22,20
28251,Pêrsephône,tichondrius,1259,priest,discipline,117,55,62
28252,Alawn,wyrmrest-accord,1259,priest,discipline,120,52,68
28253,Atelios,azralon,1258,priest,discipline,30,20,10
28254,Lildeen,area-52,1258,priest,discipline,26,15,11
28255,Kymosolop,sargeras,1258,priest,discipline,25,14,11
28256,Skall,kirin-tor,1258,priest,discipline,41,21,20
28257,Saadboii,thrall,1257,priest,discipline,61,31,30
28258,Dralaan,proudmoore,1257,priest,discipline,92,44,48
28259,Kenzao,nemesis,1257,priest,discipline,64,30,34
28260,Lge,kelthuzad,1257,priest,discipline,31,14,17
28261,Dartonya,thrall,1257,priest,discipline,36,15,21
28262,Xmasmiracle,korgath,1256,priest,discipline,94,54,40
28263,Nìght,trollbane,1256,priest,discipline,102,54,48
28264,Eleeira,zuljin,1256,priest,discipline,36,15,21
28265,Knifê,moon-guard,1255,priest,discipline,108,54,54
28266,Thotznprayrz,bleeding-hollow,1254,priest,discipline,36,23,13
28267,Snowinvan,tichondrius,1254,priest,discipline,24,15,9
28268,Mellerwine,azralon,1254,priest,discipline,312,160,152
28269,Inferis,ragnaros,1254,priest,discipline,375,188,187
28270,Nometh,emerald-dream,1254,priest,discipline,84,34,50
28271,Chavkoraken,stormrage,1254,priest,discipline,38,15,23
28272,Fatherßrian,draktharon,1253,priest,discipline,30,16,14
28273,Ezelra,frostmourne,1253,priest,discipline,29,14,15
28274,Kapriestun,tichondrius,1252,priest,discipline,60,35,25
28275,Masochist,barthilas,1252,priest,discipline,127,71,56
28276,Rbgeezus,lightnings-blade,1252,priest,discipline,113,57,56
28277,Këyglock,kelthuzad,1252,priest,discipline,252,111,141
28278,Boostvoid,terenas,1251,priest,discipline,72,42,30
28279,Finake,kelthuzad,1251,priest,discipline,73,41,32
28280,Dosarix,sargeras,1250,priest,discipline,40,23,17
28281,Burpees,dalaran,1250,priest,discipline,28,15,13
28282,Bröke,nemesis,1249,priest,discipline,90,48,42
28283,Frikapp,stormrage,1248,priest,discipline,24,13,11
28284,Lalaliza,kelthuzad,1248,priest,discipline,24,13,11
28285,Allhubris,stormrage,1248,priest,discipline,24,13,11
28286,Webbii,frostmourne,1248,priest,discipline,48,21,27
28287,Curiosities,kiljaeden,1248,priest,discipline,30,13,17
28288,Kayern,kelthuzad,1247,priest,discipline,18,13,5
28289,Mswatermelon,malganis,1247,priest,discipline,22,14,8
28290,Meatboxmoldy,blood-furnace,1247,priest,discipline,24,13,11
28291,Iatemykids,tichondrius,1247,priest,discipline,24,13,11
28292,Lvcia,thrall,1247,priest,discipline,70,35,35
28293,Mastahspell,illidan,1247,priest,discipline,30,13,17
28294,Criil,area-52,1247,priest,discipline,30,13,17
28295,Pce,korialstrasz,1247,priest,discipline,34,13,21
28296,Peacetreaty,bleeding-hollow,1246,priest,discipline,24,13,11
28297,Iol,spinebreaker,1246,priest,discipline,24,13,11
28298,Picurry,frostmourne,1246,priest,discipline,24,13,11
28299,Docbek,illidan,1246,priest,discipline,47,23,24
28300,Zumbaoqepdqt,quelthalas,1246,priest,discipline,48,21,27
28301,Madmilesstv,zuljin,1246,priest,discipline,30,13,17
28302,Akuhei,illidan,1245,priest,discipline,18,13,5
28303,Alphôn,bleeding-hollow,1245,priest,discipline,30,13,17
28304,Youaint,sargeras,1245,priest,discipline,30,13,17
28305,Mommyshere,vashj,1244,priest,discipline,54,30,24
28306,Lesx,tichondrius,1244,priest,discipline,24,13,11
28307,Seí,barthilas,1244,priest,discipline,30,13,17
28308,Bòngu,tichondrius,1244,priest,discipline,30,13,17
28309,Bingoreferee,kelthuzad,1243,priest,discipline,24,13,11
28310,Swaheally,frostmourne,1243,priest,discipline,24,13,11
28311,Haetas,zuljin,1243,priest,discipline,30,13,17
28312,Cyaja,moon-guard,1243,priest,discipline,31,13,18
28313,Meiev,quelthalas,1243,priest,discipline,36,13,23
28314,Velandrys,earthen-ring,1242,priest,discipline,24,13,11
28315,Fleshsack,area-52,1242,priest,discipline,24,13,11
28316,Toorshul,tichondrius,1242,priest,discipline,30,16,14
28317,Sofhya,ragnaros,1242,priest,discipline,112,58,54
28318,Grapës,jubeithos,1242,priest,discipline,48,23,25
28319,Cuddly,shandris,1242,priest,discipline,119,54,65
28320,Shrooks,frostmourne,1242,priest,discipline,30,13,17
28321,Kukion,uldum,1242,priest,discipline,30,13,17
28322,Tý,frostmourne,1242,priest,discipline,30,13,17
28323,Skvmbag,tichondrius,1241,priest,discipline,16,14,2
28324,Phaille,chromaggus,1241,priest,discipline,134,71,63
28325,Vancake,quelthalas,1241,priest,discipline,180,82,98
28326,Harborcoat,whisperwind,1241,priest,discipline,35,14,21
28327,Creòle,area-52,1240,priest,discipline,24,13,11
28328,Arodar,wyrmrest-accord,1240,priest,discipline,30,14,16
28329,Dagónet,sargeras,1240,priest,discipline,36,15,21
28330,Discobish,sargeras,1239,priest,discipline,30,13,17
28331,Dics,barthilas,1238,priest,discipline,18,13,5
28332,Cvstodia,tichondrius,1238,priest,discipline,30,16,14
28333,Misaosan,azralon,1238,priest,discipline,60,29,31
28334,Keliedeyn,emerald-dream,1238,priest,discipline,42,20,22
28335,Jesstor,frostmourne,1237,priest,discipline,24,13,11
28336,Karnival,aggramar,1237,priest,discipline,31,15,16
28337,Xuxao,azralon,1237,priest,discipline,35,15,20
28338,Tdmheals,zuluhed,1236,priest,discipline,36,25,11
28339,Whitesharks,tichondrius,1236,priest,discipline,24,13,11
28340,Holycoww,lightnings-blade,1236,priest,discipline,24,13,11
28341,Holyren,sargeras,1236,priest,discipline,105,55,50
28342,Cast,bronzebeard,1236,priest,discipline,48,22,26
28343,Digop,azralon,1236,priest,discipline,36,13,23
28344,Deadlydocc,illidan,1235,priest,discipline,39,23,16
28345,Voidathon,sargeras,1235,priest,discipline,24,13,11
28346,Muromsnel,proudmoore,1235,priest,discipline,24,13,11
28347,Bonkerwaffle,kelthuzad,1235,priest,discipline,54,29,25
28348,Betrthenadam,bleeding-hollow,1235,priest,discipline,66,32,34
28349,Orìsel,wyrmrest-accord,1235,priest,discipline,105,49,56
28350,Ickarus,anubarak,1233,priest,discipline,90,49,41
28351,Kinkypriest,tichondrius,1233,priest,discipline,24,13,11
28352,Scirzzy,tichondrius,1233,priest,discipline,24,13,11
28353,Dårc,tichondrius,1233,priest,discipline,113,58,55
28354,Anöa,emerald-dream,1233,priest,discipline,36,16,20
28355,Ktqt,moon-guard,1232,priest,discipline,202,99,103
28356,Chernota,kiljaeden,1232,priest,discipline,30,13,17
28357,Gurkorr,boulderfist,1232,priest,discipline,51,22,29
28358,Xora,frostmourne,1232,priest,discipline,36,13,23
28359,Kuroyanagi,ragnaros,1232,priest,discipline,36,13,23
28360,Theboogieman,magtheridon,1231,priest,discipline,54,25,29
28361,Holyxb,bleeding-hollow,1231,priest,discipline,36,13,23
28362,Shïtheals,frostmourne,1230,priest,discipline,42,25,17
28363,Ón,tichondrius,1230,priest,discipline,30,13,17
28364,Babino,illidan,1230,priest,discipline,60,25,35
28365,Ingladforx,azralon,1230,priest,discipline,36,13,23
28366,Tokoyo,sargeras,1229,priest,discipline,18,13,5
28367,Riotgearmd,sargeras,1229,priest,discipline,30,17,13
28368,Wanaatlarboy,dark-iron,1229,priest,discipline,41,23,18
28369,Lichae,ragnaros,1229,priest,discipline,48,24,24
28370,Eneco,alleria,1228,priest,discipline,204,113,91
28371,Kurtsheals,destromath,1228,priest,discipline,60,31,29
28372,Krypticus,tichondrius,1227,priest,discipline,48,28,20
28373,Aape,frostmourne,1227,priest,discipline,24,13,11
28374,Dispelbot,kelthuzad,1226,priest,discipline,124,71,53
28375,Gurbooz,tichondrius,1225,priest,discipline,77,35,42
28376,Bendoverbb,tichondrius,1225,priest,discipline,30,13,17
28377,Goseoa,tichondrius,1225,priest,discipline,30,13,17
28378,Somberr,dalaran,1223,priest,discipline,27,14,13
28379,Fearufaraway,tichondrius,1223,priest,discipline,36,13,23
28380,Ahitaro,ragnaros,1223,priest,discipline,60,18,42
28381,Kosiris,stormrage,1222,priest,discipline,102,41,61
28382,Hoffmanx,emerald-dream,1221,priest,discipline,24,13,11
28383,Aynone,blood-furnace,1221,priest,discipline,126,60,66
28384,Zadae,area-52,1220,priest,discipline,63,34,29
28385,Pòba,malganis,1220,priest,discipline,30,13,17
28386,Séraphin,proudmoore,1219,priest,discipline,37,16,21
28387,Jic,barthilas,1219,priest,discipline,66,25,41
28388,Nonamegame,sargeras,1218,priest,discipline,78,42,36
28389,Pyper,medivh,1218,priest,discipline,29,14,15
28390,Lanakill,hyjal,1218,priest,discipline,56,25,31
28391,Cajl,dathremar,1218,priest,discipline,127,56,71
28392,Yvága,ragnaros,1217,priest,discipline,48,27,21
28393,Pacopriest,tichondrius,1217,priest,discipline,24,13,11
28394,Methodist,proudmoore,1216,priest,discipline,67,24,43
28395,Göats,emerald-dream,1215,priest,discipline,24,13,11
28396,Aipata,stormrage,1215,priest,discipline,62,33,29
28397,Mythica,gurubashi,1215,priest,discipline,132,69,63
28398,Russbell,ragnaros,1215,priest,discipline,125,54,71
28399,Eîr,tichondrius,1215,priest,discipline,72,29,43
28400,Sojumike,proudmoore,1214,priest,discipline,36,18,18
28401,Holyrotape,nemesis,1214,priest,discipline,30,13,17
28402,Looneý,drakkari,1212,priest,discipline,73,42,31
28403,Armspriest,stormrage,1212,priest,discipline,47,24,23
28404,Nóin,tichondrius,1212,priest,discipline,72,33,39
28405,Näme,frostmourne,1212,priest,discipline,36,16,20
28406,Wísh,emerald-dream,1211,priest,discipline,60,35,25
28407,Dotersacer,quelthalas,1211,priest,discipline,31,15,16
28408,Abhu,quelthalas,1210,priest,discipline,71,38,33
28409,Deckardkane,stormrage,1209,priest,discipline,32,14,18
28410,Ariavish,area-52,1208,priest,discipline,48,25,23
28411,Kodaks,frostmourne,1208,priest,discipline,75,37,38
28412,Methodist,sargeras,1207,priest,discipline,24,13,11
28413,Pixa,tichondrius,1207,priest,discipline,72,33,39
28414,Kithlas,emerald-dream,1206,priest,discipline,18,13,5
28415,Defilex,tichondrius,1206,priest,discipline,22,15,7
28416,Nothinsexual,frostmourne,1206,priest,discipline,26,14,12
28417,Dpshealer,azralon,1206,priest,discipline,66,29,37
28418,Overshields,caelestrasz,1206,priest,discipline,40,13,27
28419,Svrite,area-52,1204,priest,discipline,29,15,14
28420,Visse,auchindoun,1204,priest,discipline,435,209,226
28421,Rowman,frostmourne,1204,priest,discipline,47,22,25
28422,Libationz,area-52,1204,priest,discipline,108,49,59
28423,Psychiatrist,darkspear,1204,priest,discipline,58,25,33
28424,Ithvedriel,moon-guard,1203,priest,discipline,67,32,35
28425,Vorazzun,quelthalas,1203,priest,discipline,32,14,18
28426,Ðelight,ragnaros,1202,priest,discipline,42,18,24
28427,Kyrabon,ragnaros,1201,priest,discipline,30,17,13
28428,Wrathchildd,azralon,1201,priest,discipline,84,42,42
28429,Testament,greymane,1201,priest,discipline,147,69,78
28430,Castnngcouch,tichondrius,1201,priest,discipline,205,96,109
28431,Healzyew,dragonmaw,1201,priest,discipline,73,28,45
28432,Moralism,moon-guard,1199,priest,discipline,44,26,18
28433,Zephxd,illidan,1199,priest,discipline,64,31,33
28434,Terenor,thrall,1199,priest,discipline,42,13,29
28435,Anakou,emerald-dream,1198,priest,discipline,29,17,12
28436,Jtewatch,zuljin,1197,priest,discipline,30,23,7
28437,Sasafras,feathermoon,1196,priest,discipline,78,39,39
28438,Fozil,area-52,1194,priest,discipline,62,33,29
28439,Ricksanchez,moonrunner,1193,priest,discipline,30,13,17
28440,Bladam,bleeding-hollow,1192,priest,discipline,27,13,14
28441,Mchinder,tanaris,1191,priest,discipline,55,32,23
28442,Tomseleck,frostmourne,1191,priest,discipline,29,13,16
28443,Healyoudead,draenor,1191,priest,discipline,41,15,26
28444,Rachia,barthilas,1190,priest,discipline,72,43,29
28445,Sanitater,frostmourne,1190,priest,discipline,102,47,55
28446,Dzpi,azralon,1190,priest,discipline,96,43,53
28447,Protega,illidan,1189,priest,discipline,22,14,8
28448,Holyycrit,kelthuzad,1189,priest,discipline,30,16,14
28449,Menorsita,tichondrius,1189,priest,discipline,120,57,63
28450,Karamapang,illidan,1189,priest,discipline,58,23,35
28451,Rinmaru,dark-iron,1188,priest,discipline,24,14,10
28452,Iltharaph,illidan,1188,priest,discipline,25,14,11
28453,Yukih,tichondrius,1188,priest,discipline,41,17,24
28454,Inarius,dragonblight,1188,priest,discipline,42,17,25
28455,Kruciphix,tichondrius,1187,priest,discipline,29,20,9
28456,Kaxleigh,emerald-dream,1187,priest,discipline,29,18,11
28457,Sëv,stormrage,1187,priest,discipline,29,14,15
28458,Zawi,zuljin,1185,priest,discipline,37,16,21
28459,Tesserak,tichondrius,1184,priest,discipline,105,49,56
28460,Unwòke,dalaran,1182,priest,discipline,24,14,10
28461,Happydot,stormrage,1182,priest,discipline,30,14,16
28462,Belletrael,wyrmrest-accord,1182,priest,discipline,70,32,38
28463,Kßnstuff,area-52,1182,priest,discipline,37,15,22
28464,Yea,shadow-council,1181,priest,discipline,21,13,8
28465,Ödin,tichondrius,1181,priest,discipline,46,24,22
28466,Doubtmyfaith,frostmourne,1181,priest,discipline,42,21,21
28467,Qbanota,drakkari,1181,priest,discipline,84,28,56
28468,Nadjika,moon-guard,1180,priest,discipline,45,20,25
28469,Omgpeeldude,akama,1179,priest,discipline,33,13,20
28470,Icyspicy,shadowsong,1177,priest,discipline,59,26,33
28471,Aerîs,magtheridon,1177,priest,discipline,40,16,24
28472,Iwillsaveyou,tichondrius,1177,priest,discipline,40,16,24
28473,Damoclexz,area-52,1176,priest,discipline,72,38,34
28474,Dittless,stormrage,1176,priest,discipline,36,16,20
28475,Jagelclam,gorefiend,1175,priest,discipline,47,22,25
28476,Kethseth,ragnaros,1175,priest,discipline,102,45,57
28477,Onef,quelthalas,1175,priest,discipline,35,15,20
28478,Hiheals,anvilmar,1174,priest,discipline,36,20,16
28479,Slewt,aggramar,1173,priest,discipline,24,13,11
28480,Súlfuro,quelthalas,1173,priest,discipline,89,41,48
28481,Mindlames,bleeding-hollow,1173,priest,discipline,68,30,38
28482,Minimelo,stormrage,1172,priest,discipline,23,13,10
28483,Spyzz,gilneas,1172,priest,discipline,36,18,18
28484,Aliciab,andorhal,1172,priest,discipline,78,36,42
28485,Psïcopata,gallywix,1171,priest,discipline,54,16,38
28486,Kerazul,sargeras,1169,priest,discipline,42,20,22
28487,Ttakayasu,bleeding-hollow,1165,priest,discipline,72,43,29
28488,Abalowpt,nemesis,1163,priest,discipline,48,22,26
28489,Kafzial,zuljin,1162,priest,discipline,74,43,31
28490,Priést,stormrage,1162,priest,discipline,36,13,23
28491,Radgars,frostmourne,1161,priest,discipline,31,17,14
28492,Goodbyekiss,illidan,1161,priest,discipline,83,41,42
28493,Heallarious,stormrage,1160,priest,discipline,52,30,22
28494,Tetha,fizzcrank,1160,priest,discipline,42,20,22
28495,Semirg,moon-guard,1158,priest,discipline,30,13,17
28496,Velinna,tichondrius,1158,priest,discipline,42,16,26
28497,Gobnik,illidan,1156,priest,discipline,24,16,8
28498,Toastanator,wyrmrest-accord,1156,priest,discipline,220,115,105
28499,Khallmir,goldrinn,1156,priest,discipline,36,15,21
28500,Xaerwolaeth,area-52,1155,priest,discipline,34,16,18
28501,Maraagsdad,tichondrius,1152,priest,discipline,18,12,6
28502,Fishondabeat,proudmoore,1152,priest,discipline,24,12,12
28503,Souvlaki,amanthul,1152,priest,discipline,24,12,12
28504,Teddyy,tichondrius,1152,priest,discipline,24,12,12
28505,Swagdemøn,kelthuzad,1152,priest,discipline,24,12,12
28506,Kalyndaxo,frostmourne,1152,priest,discipline,24,12,12
28507,Ømegagødx,illidan,1152,priest,discipline,30,12,18
28508,Addisonraee,tichondrius,1151,priest,discipline,12,12,0
28509,Smyted,tichondrius,1151,priest,discipline,18,12,6
28510,Faithbuild,emerald-dream,1151,priest,discipline,18,12,6
28511,Woolly,tichondrius,1151,priest,discipline,18,12,6
28512,Eluv,area-52,1151,priest,discipline,36,20,16
28513,Hyoeun,dragonmaw,1151,priest,discipline,24,12,12
28514,Randrimm,stormrage,1151,priest,discipline,24,12,12
28515,Kiriko,mannoroth,1151,priest,discipline,24,12,12
28516,Sshhaaddooww,tichondrius,1151,priest,discipline,24,12,12
28517,Pewwpew,malganis,1151,priest,discipline,24,12,12
28518,Marmintor,stormrage,1151,priest,discipline,24,12,12
28519,Kaztorz,tichondrius,1151,priest,discipline,28,12,16
28520,Yaksa,proudmoore,1151,priest,discipline,36,12,24
28521,Attenea,illidan,1151,priest,discipline,36,12,24
28522,Ilmx,illidan,1150,priest,discipline,12,12,0
28523,Meren,kelthuzad,1150,priest,discipline,18,12,6
28524,Aaff,tichondrius,1150,priest,discipline,18,12,6
28525,Chkashaa,emerald-dream,1150,priest,discipline,42,21,21
28526,Rhaist,sargeras,1150,priest,discipline,36,18,18
28527,Glöws,area-52,1150,priest,discipline,24,12,12
28528,Wartrix,bonechewer,1150,priest,discipline,24,12,12
28529,Ahealer,alterac-mountains,1150,priest,discipline,24,12,12
28530,Papafajita,area-52,1150,priest,discipline,24,12,12
28531,Icesnowli,tichondrius,1150,priest,discipline,24,12,12
28532,Crunchywater,stormrage,1150,priest,discipline,24,12,12
28533,Cenrtrix,stormrage,1150,priest,discipline,24,12,12
28534,Abercromby,malganis,1150,priest,discipline,25,12,13
28535,Penancedeez,moon-guard,1150,priest,discipline,35,15,20
28536,Maxximuss,bleeding-hollow,1150,priest,discipline,42,17,25
28537,Dayquills,illidan,1150,priest,discipline,30,12,18
28538,Troubler,tichondrius,1149,priest,discipline,18,12,6
28539,Profpepper,tichondrius,1149,priest,discipline,18,12,6
28540,Audacy,azuremyst,1149,priest,discipline,33,19,14
28541,Pakc,tichondrius,1149,priest,discipline,24,12,12
28542,Shadowchaos,malganis,1149,priest,discipline,24,12,12
28543,Nerfholyplz,illidan,1149,priest,discipline,24,12,12
28544,Kitenix,proudmoore,1149,priest,discipline,35,14,21
28545,Dènalí,area-52,1148,priest,discipline,24,12,12
28546,Gigaflex,sargeras,1148,priest,discipline,24,12,12
28547,Luminatio,quelthalas,1148,priest,discipline,76,36,40
28548,Fìngerbanger,lightnings-blade,1148,priest,discipline,117,53,64
28549,Cigarillõ,thrall,1147,priest,discipline,24,12,12
28550,Papergaruru,illidan,1147,priest,discipline,55,25,30
28551,Nutsin,tichondrius,1147,priest,discipline,30,12,18
28552,Scrubgames,garrosh,1146,priest,discipline,12,12,0
28553,Bakerstr,tichondrius,1146,priest,discipline,18,12,6
28554,Pushap,blood-furnace,1146,priest,discipline,102,56,46
28555,Mindkilla,area-52,1146,priest,discipline,184,95,89
28556,Smightful,garona,1146,priest,discipline,24,12,12
28557,Zyklonova,frostmourne,1146,priest,discipline,24,12,12
28558,Beansofdean,proudmoore,1145,priest,discipline,24,12,12
28559,Mashpotato,aerie-peak,1144,priest,discipline,24,13,11
28560,Hoochiemomma,kelthuzad,1144,priest,discipline,24,13,11
28561,Notskynet,tichondrius,1144,priest,discipline,24,12,12
28562,Nardhead,sargeras,1143,priest,discipline,42,24,18
28563,Depressedboy,wyrmrest-accord,1143,priest,discipline,24,12,12
28564,Mutilla,tichondrius,1142,priest,discipline,18,12,6
28565,Raivn,illidan,1142,priest,discipline,24,12,12
28566,Ferilla,illidan,1142,priest,discipline,24,12,12
28567,Supski,destromath,1141,priest,discipline,24,12,12
28568,Vanhealsing,tichondrius,1141,priest,discipline,24,12,12
28569,Voodooloa,tichondrius,1140,priest,discipline,30,12,18
28570,Jeffo,baelgun,1139,priest,discipline,36,17,19
28571,Osombra,azralon,1139,priest,discipline,36,17,19
28572,Kippin,frostmourne,1138,priest,discipline,18,12,6
28573,Draniev,azralon,1138,priest,discipline,83,44,39
28574,Elvspriesly,doomhammer,1138,priest,discipline,104,51,53
28575,Drywàter,tichondrius,1137,priest,discipline,81,45,36
28576,Lynnar,stormrage,1137,priest,discipline,81,44,37
28577,Feelmyheels,frostmourne,1137,priest,discipline,48,24,24
28578,Hanuroa,tichondrius,1136,priest,discipline,184,92,92
28579,Brotherheals,nagrand,1136,priest,discipline,66,33,33
28580,Holyhog,whisperwind,1136,priest,discipline,51,23,28
28581,Sprinkling,sargeras,1136,priest,discipline,34,15,19
28582,Inot,nemesis,1136,priest,discipline,41,12,29
28583,Blessings,aerie-peak,1135,priest,discipline,66,34,32
28584,Calliah,moknathal,1134,priest,discipline,35,19,16
28585,Senumbra,tichondrius,1134,priest,discipline,24,12,12
28586,Saviorsélf,tichondrius,1133,priest,discipline,126,55,71
28587,Ayakoji,proudmoore,1132,priest,discipline,30,12,18
28588,Ihealyoudeal,korgath,1130,priest,discipline,18,12,6
28589,Melithor,frostmourne,1130,priest,discipline,24,12,12
28590,Charybdis,bonechewer,1129,priest,discipline,92,56,36
28591,Makkima,area-52,1129,priest,discipline,48,20,28
28592,Corthien,thrall,1129,priest,discipline,30,12,18
28593,Kerahk,drakkari,1129,priest,discipline,32,12,20
28594,Hëstia,darkspear,1128,priest,discipline,30,18,12
28595,Mäy,greymane,1128,priest,discipline,30,12,18
28596,Cyrilien,tichondrius,1127,priest,discipline,52,29,23
28597,Ragnarøk,warsong,1127,priest,discipline,30,12,18
28598,Killían,darkspear,1126,priest,discipline,61,31,30
28599,Zolibeth,azshara,1124,priest,discipline,24,15,9
28600,Weregonnadie,stormrage,1123,priest,discipline,24,12,12
28601,Yddwin,quelthalas,1122,priest,discipline,30,16,14
28602,Voidwyrm,tichondrius,1122,priest,discipline,96,50,46
28603,Ðåmìéñ,tichondrius,1122,priest,discipline,24,12,12
28604,Fulldesire,dalaran,1121,priest,discipline,63,38,25
28605,Londog,vashj,1121,priest,discipline,78,36,42
28606,Primeevil,black-dragonflight,1119,priest,discipline,24,14,10
28607,Priestøuchme,tichondrius,1119,priest,discipline,23,13,10
28608,Deehilie,illidan,1119,priest,discipline,49,25,24
28609,Tkawesome,area-52,1119,priest,discipline,36,13,23
28610,Xinnie,illidan,1117,priest,discipline,90,37,53
28611,Barrysanders,zuljin,1115,priest,discipline,30,17,13
28612,Abbot,zangarmarsh,1115,priest,discipline,149,70,79
28613,Sinnskløft,tichondrius,1115,priest,discipline,31,13,18
28614,Puralux,balnazzar,1114,priest,discipline,36,22,14
28615,Vitalizes,nagrand,1114,priest,discipline,30,13,17
28616,Sadury,tichondrius,1113,priest,discipline,135,76,59
28617,Celf,ragnaros,1113,priest,discipline,30,12,18
28618,Deadäss,sargeras,1113,priest,discipline,54,14,40
28619,Sístermary,stormrage,1112,priest,discipline,24,16,8
28620,Steezyy,black-dragonflight,1112,priest,discipline,71,33,38
28621,Foxyy,wildhammer,1112,priest,discipline,35,14,21
28622,Ghostchant,thrall,1111,priest,discipline,29,12,17
28623,Steck,illidan,1110,priest,discipline,45,22,23
28624,Chroly,stormrage,1110,priest,discipline,59,27,32
28625,Bedläm,kilrogg,1110,priest,discipline,36,12,24
28626,Skeepsi,area-52,1109,priest,discipline,48,27,21
28627,Rhayzel,ragnaros,1108,priest,discipline,30,15,15
28628,Fushia,emerald-dream,1107,priest,discipline,45,16,29
28629,Optîmuskrayt,tichondrius,1106,priest,discipline,83,40,43
28630,Tootsieroll,dark-iron,1106,priest,discipline,53,25,28
28631,Opri,andorhal,1104,priest,discipline,48,20,28
28632,Mosher,zuluhed,1103,priest,discipline,18,12,6
28633,Ataraksija,sargeras,1103,priest,discipline,21,13,8
28634,Kloudypriest,moon-guard,1103,priest,discipline,47,24,23
28635,Averli,moon-guard,1103,priest,discipline,42,18,24
28636,Lytherina,aegwynn,1101,priest,discipline,24,15,9
28637,Gumiho,drakkari,1100,priest,discipline,25,12,13
28638,Khamata,kelthuzad,1100,priest,discipline,30,12,18
28639,Wheresmyvape,tichondrius,1098,priest,discipline,20,13,7
28640,Vákc,quelthalas,1096,priest,discipline,23,12,11
28641,Darkxrp,bleeding-hollow,1096,priest,discipline,30,13,17
28642,Draiger,quelthalas,1096,priest,discipline,36,14,22
28643,Fistavert,stormreaver,1095,priest,discipline,24,12,12
28644,Mcdizzle,bloodscalp,1093,priest,discipline,90,41,49
28645,Annaphilaxis,sargeras,1090,priest,discipline,38,18,20
28646,Valonar,emerald-dream,1090,priest,discipline,29,13,16
28647,Zacksnotcool,sargeras,1090,priest,discipline,33,13,20
28648,Benmem,illidan,1089,priest,discipline,64,30,34
28649,Thinmintt,wyrmrest-accord,1089,priest,discipline,108,47,61
28650,Bigdaddyku,hyjal,1088,priest,discipline,34,20,14
28651,Holysmokesx,tichondrius,1087,priest,discipline,22,12,10
28652,Antiraus,aerie-peak,1086,priest,discipline,24,13,11
28653,Alizeë,illidan,1086,priest,discipline,119,63,56
28654,Fatherfilth,frostwolf,1086,priest,discipline,30,14,16
28655,Solkadp,tichondrius,1085,priest,discipline,28,12,16
28656,Quavö,tichondrius,1085,priest,discipline,68,29,39
28657,Kidha,stormrage,1085,priest,discipline,60,19,41
28658,Todrecas,ragnaros,1084,priest,discipline,24,13,11
28659,Painpaws,moon-guard,1084,priest,discipline,28,12,16
28660,Enkognito,tichondrius,1083,priest,discipline,34,23,11
28661,Vaddaru,kirin-tor,1083,priest,discipline,66,38,28
28662,Cypress,dreadmaul,1082,priest,discipline,140,70,70
28663,Spellpower,azralon,1081,priest,discipline,29,13,16
28664,Zatroux,ragnaros,1081,priest,discipline,36,13,23
28665,Synes,bleeding-hollow,1080,priest,discipline,34,12,22
28666,Tmpriest,tichondrius,1080,priest,discipline,48,12,36
28667,Fregè,ysera,1078,priest,discipline,30,12,18
28668,Novoc,blackhand,1076,priest,discipline,36,17,19
28669,Redchord,kiljaeden,1072,priest,discipline,33,13,20
28670,Psïren,quelthalas,1070,priest,discipline,24,13,11
28671,Berzap,frostmourne,1068,priest,discipline,30,18,12
28672,Tricklee,tichondrius,1068,priest,discipline,23,12,11
28673,Zhaann,kelthuzad,1067,priest,discipline,30,14,16
28674,Twinkmuncher,proudmoore,1065,priest,discipline,25,12,13
28675,Anäster,ragnaros,1064,priest,discipline,53,26,27
28676,Mtito,drakkari,1063,priest,discipline,25,13,12
28677,Vahlen,azralon,1062,priest,discipline,23,12,11
28678,Chickadies,barthilas,1059,priest,discipline,18,12,6
28679,Undevout,tichondrius,1056,priest,discipline,18,11,7
28680,Trustheals,tichondrius,1056,priest,discipline,60,32,28
28681,Lespaula,ragnaros,1056,priest,discipline,24,12,12
28682,Seleniax,sargeras,1056,priest,discipline,24,11,13
28683,Mattgarska,tichondrius,1056,priest,discipline,30,11,19
28684,Lilbabynaga,stormrage,1056,priest,discipline,75,27,48
28685,Naelsaze,tichondrius,1055,priest,discipline,12,11,1
28686,Crucifer,proudmoore,1055,priest,discipline,12,11,1
28687,Piftw,illidan,1055,priest,discipline,18,11,7
28688,Ròen,tichondrius,1055,priest,discipline,18,11,7
28689,Chawp,kelthuzad,1055,priest,discipline,18,11,7
28690,Vehex,malganis,1055,priest,discipline,18,11,7
28691,Rúbybest,tichondrius,1055,priest,discipline,24,11,13
28692,Okiin,malganis,1055,priest,discipline,24,11,13
28693,Jonesypriest,tichondrius,1055,priest,discipline,24,11,13
28694,Ffej,bleeding-hollow,1055,priest,discipline,24,11,13
28695,Tooziq,stormrage,1055,priest,discipline,24,11,13
28696,Wintrow,sargeras,1055,priest,discipline,30,11,19
28697,Lampvpgerl,illidan,1055,priest,discipline,36,11,25
28698,Turrec,illidan,1054,priest,discipline,12,11,1
28699,Aiss,malganis,1054,priest,discipline,16,12,4
28700,Anneyann,fenris,1054,priest,discipline,30,19,11
28701,Missyoung,tichondrius,1054,priest,discipline,18,11,7
28702,Honeyweiss,cairne,1054,priest,discipline,24,12,12
28703,Sentactic,illidan,1054,priest,discipline,27,13,14
28704,Dpsmercy,sargeras,1054,priest,discipline,24,11,13
28705,Abbydaddy,illidan,1054,priest,discipline,30,11,19
28706,Velzirya,zuljin,1054,priest,discipline,30,11,19
28707,Doubt,eredar,1053,priest,discipline,18,11,7
28708,Whitepigogo,tichondrius,1053,priest,discipline,18,11,7
28709,Lavazzå,tichondrius,1053,priest,discipline,18,11,7
28710,Ayezex,tichondrius,1053,priest,discipline,48,21,27
28711,Rezy,darkspear,1053,priest,discipline,30,11,19
28712,Slavoj,gurubashi,1052,priest,discipline,41,19,22
28713,Howdaw,tichondrius,1052,priest,discipline,24,11,13
28714,ßlackøut,sargeras,1052,priest,discipline,24,11,13
28715,Buffhpriest,tichondrius,1052,priest,discipline,24,11,13
28716,Xävier,farstriders,1052,priest,discipline,30,11,19
28717,Kerith,ragnaros,1051,priest,discipline,34,24,10
28718,Cella,frostmourne,1051,priest,discipline,18,11,7
28719,Efrem,tichondrius,1051,priest,discipline,63,30,33
28720,Darkills,tichondrius,1051,priest,discipline,24,11,13
28721,Saviorr,dalaran,1051,priest,discipline,30,11,19
28722,Lumia,quelthalas,1051,priest,discipline,30,11,19
28723,Moopha,zuljin,1050,priest,discipline,12,11,1
28724,Zarfel,ragnaros,1050,priest,discipline,18,11,7
28725,Silnetlee,tichondrius,1050,priest,discipline,18,11,7
28726,Healdog,thrall,1050,priest,discipline,18,11,7
28727,Darkmoonsun,frostmourne,1050,priest,discipline,24,11,13
28728,Lalight,tichondrius,1050,priest,discipline,30,11,19
28729,Alyndral,illidan,1049,priest,discipline,20,11,9
28730,Inmortar,dalaran,1049,priest,discipline,30,11,19
28731,Sajahsa,moon-guard,1048,priest,discipline,25,15,10
28732,Nooice,dalaran,1048,priest,discipline,24,11,13
28733,Jackflashh,hakkar,1047,priest,discipline,78,35,43
28734,Feff,shuhalo,1046,priest,discipline,30,11,19
28735,Aud,kiljaeden,1045,priest,discipline,12,11,1
28736,Chastised,moon-guard,1043,priest,discipline,354,165,189
28737,Lilbabe,stormrage,1043,priest,discipline,24,11,13
28738,Panelopie,maiev,1042,priest,discipline,18,11,7
28739,Barrieroflig,tichondrius,1042,priest,discipline,27,13,14
28740,Flexeggette,illidan,1042,priest,discipline,31,14,17
28741,Dottinu,area-52,1040,priest,discipline,12,11,1
28742,Notdavido,illidan,1040,priest,discipline,18,11,7
28743,Deeznuhh,tichondrius,1039,priest,discipline,29,11,18
28744,Sendia,hydraxis,1038,priest,discipline,66,31,35
28745,Dalowks,area-52,1038,priest,discipline,30,11,19
28746,Haidees,akama,1037,priest,discipline,28,16,12
28747,Gungagingong,queldorei,1035,priest,discipline,18,11,7
28748,Saviorkaï,barthilas,1035,priest,discipline,27,12,15
28749,Gongá,moon-guard,1035,priest,discipline,108,43,65
28750,Shinomiko,frostmourne,1035,priest,discipline,114,35,79
28751,Classifiedcc,illidan,1034,priest,discipline,109,59,50
28752,Uljinoo,blackwing-lair,1034,priest,discipline,44,19,25
28753,Donoras,ursin,1033,priest,discipline,18,11,7
28754,Uchihalol,tichondrius,1032,priest,discipline,24,11,13
28755,Geulis,illidan,1030,priest,discipline,65,30,35
28756,Discotecno,tichondrius,1030,priest,discipline,24,11,13
28757,Erelim,durotan,1029,priest,discipline,89,36,53
28758,Egraner,drakkari,1027,priest,discipline,24,11,13
28759,Chêrubim,arthas,1025,priest,discipline,24,11,13
28760,Ketone,malganis,1024,priest,discipline,113,57,56
28761,Elomszz,tichondrius,1024,priest,discipline,22,11,11
28762,Naxiest,stormrage,1024,priest,discipline,29,11,18
28763,Bakharftw,nemesis,1023,priest,discipline,28,17,11
28764,Taedrid,stormrage,1023,priest,discipline,71,28,43
28765,Touchmylight,suramar,1022,priest,discipline,12,11,1
28766,Stunsilence,malganis,1022,priest,discipline,20,12,8
28767,Watdahealydo,darkspear,1021,priest,discipline,18,11,7
28768,Mxd,bleeding-hollow,1021,priest,discipline,20,12,8
28769,Mgfoxxie,scarlet-crusade,1020,priest,discipline,30,12,18
28770,Thadan,uldaman,1019,priest,discipline,24,11,13
28771,Sofluffy,burning-blade,1018,priest,discipline,23,11,12
28772,Sév,frostmane,1017,priest,discipline,190,89,101
28773,Nightmxres,zuljin,1016,priest,discipline,30,11,19
28774,Jèf,stormrage,1015,priest,discipline,23,11,12
28775,Shaydeep,nagrand,1015,priest,discipline,28,12,16
28776,Leoi,fenris,1014,priest,discipline,39,23,16
28777,Profît,stormrage,1014,priest,discipline,24,12,12
28778,Sublety,aerie-peak,1011,priest,discipline,36,17,19
28779,Jeanmarc,aerie-peak,1011,priest,discipline,42,17,25
28780,Bubblebuster,lightbringer,1010,priest,discipline,43,19,24
28781,Drãith,magtheridon,1009,priest,discipline,24,12,12
28782,Dynopriest,kelthuzad,1007,priest,discipline,29,11,18
28783,Lesserfaith,sargeras,1006,priest,discipline,21,11,10
28784,Clergy,arthas,1005,priest,discipline,18,11,7
28785,Ioudas,ragnaros,1004,priest,discipline,35,11,24
28786,Lördgrim,stormrage,1002,priest,discipline,25,13,12
28787,Tikel,ragnaros,1001,priest,discipline,21,11,10
28788,Stinkyfingr,frostmourne,1000,priest,discipline,42,15,27
28789,Sharayu,madoran,999,priest,discipline,42,22,20
28790,Deusthanatos,medivh,998,priest,discipline,64,32,32
28791,Linarelitha,area-52,997,priest,discipline,50,22,28
28792,Bårriër,darkspear,996,priest,discipline,23,12,11
28793,Mottsarella,mugthol,994,priest,discipline,78,42,36
28794,Robertsmurda,emerald-dream,992,priest,discipline,22,11,11
28795,Norastanne,moon-guard,992,priest,discipline,27,12,15
28796,Cilpri,emerald-dream,991,priest,discipline,16,11,5
28797,Thrudarkness,thrall,990,priest,discipline,21,12,9
28798,Carbonated,zuljin,986,priest,discipline,17,11,6
28799,Diamontie,tichondrius,977,priest,discipline,26,16,10
28800,Alurand,bleeding-hollow,976,priest,discipline,18,11,7
28801,Hèáls,tichondrius,975,priest,discipline,66,29,37
28802,Exsufficate,frostmourne,974,priest,discipline,22,12,10
28803,Sölemn,barthilas,971,priest,discipline,53,21,32
28804,Mikkik,zuljin,970,priest,discipline,30,18,12
28805,Prlest,proudmoore,970,priest,discipline,36,15,21
28806,Throwinshadê,stormrage,967,priest,discipline,108,56,52
28807,Sharkda,frostmourne,965,priest,discipline,45,24,21
28808,Moomagic,sargeras,964,priest,discipline,54,24,30
28809,Cravex,stormrage,963,priest,discipline,36,18,18
28810,Åphrødite,bonechewer,961,priest,discipline,22,12,10
28811,Åz,quelthalas,961,priest,discipline,24,12,12
28812,Cezanne,tichondrius,961,priest,discipline,125,52,73
28813,Swaggie,skullcrusher,960,priest,discipline,12,10,2
28814,Odealp,stormscale,960,priest,discipline,12,10,2
28815,Charón,tichondrius,960,priest,discipline,12,10,2
28816,Mxchsm,stormrage,960,priest,discipline,12,10,2
28817,Harlei,tichondrius,960,priest,discipline,18,11,7
28818,Ishyeboi,stormrage,960,priest,discipline,18,10,8
28819,Likehisname,tichondrius,960,priest,discipline,18,10,8
28820,Ggwizkaboo,tichondrius,960,priest,discipline,18,10,8
28821,Epicp,sargeras,960,priest,discipline,18,10,8
28822,Testzpriests,dalaran,960,priest,discipline,18,10,8
28823,Bswagxx,illidan,960,priest,discipline,18,10,8
28824,Belielosong,moon-guard,960,priest,discipline,57,29,28
28825,Metaverse,lightbringer,960,priest,discipline,21,10,11
28826,Fyne,kelthuzad,960,priest,discipline,21,10,11
28827,Ajxoz,thrall,960,priest,discipline,24,10,14
28828,Nobodystarx,steamwheedle-cartel,960,priest,discipline,24,10,14
28829,Futuuncle,tichondrius,960,priest,discipline,30,10,20
28830,Henchwoman,stormrage,959,priest,discipline,12,10,2
28831,Kk,fizzcrank,959,priest,discipline,12,10,2
28832,Jinforever,tichondrius,959,priest,discipline,12,10,2
28833,Elimix,frostmourne,959,priest,discipline,12,10,2
28834,Stickypriest,dreadmaul,959,priest,discipline,12,10,2
28835,Krupticus,tichondrius,959,priest,discipline,16,11,5
28836,Cigma,magtheridon,959,priest,discipline,18,10,8
28837,Hundski,darkspear,959,priest,discipline,18,10,8
28838,Tamzy,eredar,959,priest,discipline,18,10,8
28839,Pocket,alleria,959,priest,discipline,18,10,8
28840,Gutrìck,tichondrius,959,priest,discipline,18,10,8
28841,Budlyy,dalaran,959,priest,discipline,18,10,8
28842,Discs,detheroc,959,priest,discipline,18,10,8
28843,Csjy,illidan,959,priest,discipline,18,10,8
28844,Gamepass,tichondrius,959,priest,discipline,18,10,8
28845,Oduum,tichondrius,959,priest,discipline,18,10,8
28846,Azrïel,mannoroth,959,priest,discipline,29,16,13
28847,Johadorr,shadowsong,959,priest,discipline,24,10,14
28848,Feivalentine,illidan,959,priest,discipline,24,10,14
28849,Tshik,ragnaros,959,priest,discipline,24,10,14
28850,Stylébender,tichondrius,959,priest,discipline,24,10,14
28851,Mosquito,tichondrius,959,priest,discipline,24,10,14
28852,Tamtwo,the-forgotten-coast,959,priest,discipline,24,10,14
28853,Lindsanp,illidan,959,priest,discipline,24,10,14
28854,Grimoz,illidan,959,priest,discipline,36,10,26
28855,Rebzyyx,tichondrius,958,priest,discipline,12,10,2
28856,Janna,jubeithos,958,priest,discipline,18,10,8
28857,Bombdevil,quelthalas,958,priest,discipline,18,10,8
28858,Plasmax,ragnaros,958,priest,discipline,18,10,8
28859,Phrìke,illidan,958,priest,discipline,18,10,8
28860,Compromise,the-scryers,958,priest,discipline,18,10,8
28861,Glitterballs,khazgoroth,958,priest,discipline,18,10,8
28862,Tîg,nemesis,958,priest,discipline,21,10,11
28863,Rhennythal,tichondrius,958,priest,discipline,24,10,14
28864,Whateverbrah,tichondrius,958,priest,discipline,27,11,16
28865,Falsegodxd,tichondrius,958,priest,discipline,30,10,20
28866,Senpriest,ragnaros,957,priest,discipline,18,10,8
28867,Bigchalupaz,sargeras,957,priest,discipline,18,10,8
28868,Bubblebeasst,area-52,957,priest,discipline,18,10,8
28869,Akkassha,zuljin,957,priest,discipline,18,10,8
28870,Wilburre,sargeras,957,priest,discipline,18,10,8
28871,Rescueherø,tichondrius,957,priest,discipline,38,20,18
28872,Rellington,frostwolf,957,priest,discipline,24,10,14
28873,Chanyt,azralon,956,priest,discipline,12,10,2
28874,Rigityrekt,aggramar,956,priest,discipline,18,13,5
28875,Alphe,sargeras,956,priest,discipline,18,10,8
28876,Kissmyvoìd,frostmourne,956,priest,discipline,24,10,14
28877,Galaxypepe,medivh,955,priest,discipline,23,10,13
28878,Çõrlëøñè,illidan,955,priest,discipline,24,10,14
28879,Bachaterah,skullcrusher,955,priest,discipline,24,10,14
28880,Kauldër,illidan,955,priest,discipline,32,12,20
28881,Felmnir,ragnaros,955,priest,discipline,30,10,20
28882,Fidalus,stormrage,955,priest,discipline,38,10,28
28883,Zènó,bleeding-hollow,954,priest,discipline,18,10,8
28884,Hanklin,lightnings-blade,954,priest,discipline,18,10,8
28885,Judgejudyx,tichondrius,954,priest,discipline,24,10,14
28886,Acésnóf,stormrage,954,priest,discipline,24,10,14
28887,Chinsta,tichondrius,954,priest,discipline,24,10,14
28888,Piskel,vashj,954,priest,discipline,30,10,20
28889,Discjuice,tichondrius,954,priest,discipline,36,10,26
28890,Kajagoogoö,emerald-dream,953,priest,discipline,18,10,8
28891,Anthoras,stormrage,953,priest,discipline,18,10,8
28892,Lusch,stormscale,953,priest,discipline,70,37,33
28893,Spõt,stormrage,953,priest,discipline,24,10,14
28894,Flagged,azgalor,953,priest,discipline,24,10,14
28895,Xenonfaith,bleeding-hollow,952,priest,discipline,17,12,5
28896,Stennic,emerald-dream,952,priest,discipline,18,10,8
28897,Worthy,runetotem,952,priest,discipline,18,10,8
28898,Unholyio,barthilas,952,priest,discipline,18,10,8
28899,Jessicä,malganis,952,priest,discipline,18,10,8
28900,Bellack,emerald-dream,952,priest,discipline,61,27,34
28901,Xiöm,quelthalas,952,priest,discipline,24,10,14
28902,Daijoubu,lightnings-blade,951,priest,discipline,24,10,14
28903,Ppinmuhbutt,tichondrius,951,priest,discipline,36,10,26
28904,Discbubbles,moonrunner,950,priest,discipline,18,10,8
28905,Artmend,malganis,950,priest,discipline,24,10,14
28906,Zeas,moon-guard,950,priest,discipline,66,23,43
28907,Senliastra,medivh,949,priest,discipline,18,10,8
28908,Threlad,elune,949,priest,discipline,18,10,8
28909,Zhadowbolts,thrall,949,priest,discipline,18,10,8
28910,Dreamskull,aegwynn,949,priest,discipline,26,11,15
28911,Filterz,korgath,948,priest,discipline,24,10,14
28912,Samsunglions,tichondrius,947,priest,discipline,18,10,8
28913,Whitezz,frostmourne,945,priest,discipline,18,10,8
28914,Tapel,khazgoroth,943,priest,discipline,24,13,11
28915,Emmarîl,sargeras,943,priest,discipline,29,10,19
28916,Praiz,tichondrius,942,priest,discipline,24,15,9
28917,Discyple,ysera,941,priest,discipline,24,10,14
28918,Icemeilarda,illidan,940,priest,discipline,81,32,49
28919,Sisterdeáth,area-52,938,priest,discipline,24,11,13
28920,Neehow,hyjal,936,priest,discipline,12,10,2
28921,Boosserbro,dawnbringer,936,priest,discipline,42,21,21
28922,Macoa,zuljin,936,priest,discipline,66,29,37
28923,Miel,kargath,935,priest,discipline,60,22,38
28924,Preezoo,tichondrius,932,priest,discipline,30,10,20
28925,Alexz,area-52,927,priest,discipline,14,11,3
28926,Toastedheal,stormreaver,927,priest,discipline,20,11,9
28927,Biggunsaint,icecrown,927,priest,discipline,20,11,9
28928,Unholydomina,zuljin,927,priest,discipline,60,28,32
28929,Lawbster,jubeithos,926,priest,discipline,22,10,12
28930,Fenders,stormrage,926,priest,discipline,23,10,13
28931,Serana,maelstrom,924,priest,discipline,112,60,52
28932,Voidwulf,azgalor,924,priest,discipline,107,52,55
28933,Shemhazai,ragnaros,921,priest,discipline,20,11,9
28934,Rymzxx,ragnaros,918,priest,discipline,19,11,8
28935,Thekingheals,draenor,918,priest,discipline,28,14,14
28936,Matafuka,ragnaros,913,priest,discipline,22,11,11
28937,Twistedead,illidan,911,priest,discipline,21,11,10
28938,Priestrix,frostmourne,910,priest,discipline,55,22,33
28939,Holdentudikz,area-52,909,priest,discipline,23,10,13
28940,Brock,lightbringer,905,priest,discipline,27,11,16
28941,Poilu,laughing-skull,904,priest,discipline,19,12,7
28942,Ðanté,the-venture-co,904,priest,discipline,22,13,9
28943,Eluko,tichondrius,904,priest,discipline,21,11,10
28944,Ohashi,ragnaros,902,priest,discipline,18,11,7
28945,Knez,ragnaros,895,priest,discipline,19,11,8
28946,Plaedito,stormscale,895,priest,discipline,23,10,13
28947,Blakalicious,illidan,894,priest,discipline,21,12,9
28948,Fujinpriest,azralon,894,priest,discipline,28,10,18
28949,Aladdinlol,tichondrius,894,priest,discipline,34,10,24
28950,Chapitä,drakkari,893,priest,discipline,16,10,6
28951,Malhotra,amanthul,892,priest,discipline,21,12,9
28952,Kaizzen,gorgonnash,891,priest,discipline,17,10,7
28953,Tezcatyo,area-52,891,priest,discipline,17,10,7
28954,Pegwraith,sargeras,890,priest,discipline,17,10,7
28955,Lunett,area-52,887,priest,discipline,34,10,24
28956,Partypack,stormrage,878,priest,discipline,19,11,8
28957,Gdessairmed,exodar,871,priest,discipline,25,10,15
28958,Wingchick,azshara,865,priest,discipline,48,20,28
28959,Märzy,thrall,864,priest,discipline,12,9,3
28960,Náñí,area-52,864,priest,discipline,12,9,3
28961,Gillette,thunderlord,864,priest,discipline,12,9,3
28962,Trinaty,senjin,864,priest,discipline,12,9,3
28963,Squiddyjr,tichondrius,864,priest,discipline,12,9,3
28964,Photic,malganis,864,priest,discipline,12,9,3
28965,Marcalus,garrosh,864,priest,discipline,15,9,6
28966,June,dragonmaw,864,priest,discipline,18,9,9
28967,Toteme,proudmoore,864,priest,discipline,18,9,9
28968,Drbønghitmd,tichondrius,864,priest,discipline,18,9,9
28969,Makdaddy,skullcrusher,864,priest,discipline,18,9,9
28970,Norikoo,malganis,864,priest,discipline,18,9,9
28971,Cinnalite,darkspear,864,priest,discipline,18,9,9
28972,Shadooe,tichondrius,864,priest,discipline,18,9,9
28973,Omgnerfz,zuljin,864,priest,discipline,18,9,9
28974,Healthyadult,zuluhed,864,priest,discipline,18,9,9
28975,Wv,kelthuzad,864,priest,discipline,18,9,9
28976,Zlowbly,ragnaros,864,priest,discipline,18,9,9
28977,Gekko,azgalor,864,priest,discipline,18,9,9
28978,Arcmage,malganis,864,priest,discipline,18,9,9
28979,Kencyx,tichondrius,864,priest,discipline,18,9,9
28980,Challengerz,suramar,864,priest,discipline,18,9,9
28981,Ilovedailies,frostmourne,864,priest,discipline,18,9,9
28982,Rima,stormscale,864,priest,discipline,18,9,9
28983,Phurbosjr,sargeras,864,priest,discipline,18,9,9
28984,Easywins,sargeras,864,priest,discipline,24,9,15
28985,Skylark,bronzebeard,864,priest,discipline,24,9,15
28986,Physics,frostmane,864,priest,discipline,24,9,15
28987,Dasaq,sargeras,864,priest,discipline,24,9,15
28988,Rafers,tichondrius,864,priest,discipline,24,9,15
28989,Voidgames,area-52,864,priest,discipline,24,9,15
28990,Ninbará,stormrage,864,priest,discipline,24,9,15
28991,Marminator,stormrage,864,priest,discipline,24,9,15
28992,Lostmind,malganis,864,priest,discipline,24,9,15
28993,Dakp,sargeras,864,priest,discipline,24,9,15
28994,Hairypenance,sargeras,864,priest,discipline,30,9,21
28995,Djxkidrock,moon-guard,863,priest,discipline,12,9,3
28996,Neuro,barthilas,863,priest,discipline,12,9,3
28997,Helleamh,tichondrius,863,priest,discipline,12,9,3
28998,Boycrazy,nerzhul,863,priest,discipline,12,9,3
28999,Thirdplace,tichondrius,863,priest,discipline,12,9,3
29000,Maleklek,azralon,863,priest,discipline,12,9,3
29001,Tigop,alleria,863,priest,discipline,12,9,3
29002,Stroserous,hyjal,863,priest,discipline,12,9,3
29003,Softqt,tichondrius,863,priest,discipline,12,9,3
29004,Lemmiewinkzx,sargeras,863,priest,discipline,18,9,9
29005,Frotters,kiljaeden,863,priest,discipline,18,9,9
29006,Fugazy,barthilas,863,priest,discipline,18,9,9
29007,Oprst,tichondrius,863,priest,discipline,18,9,9
29008,Tarlonypp,malganis,863,priest,discipline,18,9,9
29009,Iamrisen,tichondrius,863,priest,discipline,18,9,9
29010,Marshpillow,barthilas,863,priest,discipline,24,9,15
29011,Mindblasterx,kelthuzad,863,priest,discipline,24,9,15
29012,Mäe,nemesis,863,priest,discipline,24,9,15
29013,Mudbuttman,kelthuzad,863,priest,discipline,24,9,15
29014,Bubblerenew,altar-of-storms,863,priest,discipline,24,9,15
29015,Bugshott,tichondrius,863,priest,discipline,31,9,22
29016,Mothra,ragnaros,862,priest,discipline,12,9,3
29017,Gäindalf,tichondrius,862,priest,discipline,16,10,6
29018,Drerrdaytv,kelthuzad,862,priest,discipline,18,9,9
29019,Lacerating,illidan,862,priest,discipline,18,9,9
29020,Redclover,tichondrius,862,priest,discipline,18,9,9
29021,Sumrand,frostmourne,862,priest,discipline,18,9,9
29022,Tyrea,kiljaeden,862,priest,discipline,18,9,9
29023,Ppomx,tichondrius,862,priest,discipline,18,9,9
29024,Neuroflex,proudmoore,862,priest,discipline,18,9,9
29025,Satanshealer,terokkar,862,priest,discipline,18,9,9
29026,Releknosleep,frostwolf,862,priest,discipline,19,9,10
29027,Heelznfeelz,tichondrius,862,priest,discipline,21,9,12
29028,Padragon,tichondrius,862,priest,discipline,24,9,15
29029,Zil,spinebreaker,861,priest,discipline,12,9,3
29030,Cremexo,tichondrius,861,priest,discipline,16,9,7
29031,Discountay,burning-legion,861,priest,discipline,18,9,9
29032,Ohgiddy,dalaran,861,priest,discipline,24,9,15
29033,Pahdre,tichondrius,860,priest,discipline,12,9,3
29034,Stusy,tichondrius,860,priest,discipline,12,9,3
29035,Jeraphìm,tichondrius,860,priest,discipline,18,9,9
29036,Mawlaana,frostmourne,860,priest,discipline,18,9,9
29037,Discalaneous,tichondrius,860,priest,discipline,27,9,18
29038,Griggleslol,tichondrius,859,priest,discipline,12,9,3
29039,Forestpriest,area-52,859,priest,discipline,18,9,9
29040,Moresbo,frostmourne,859,priest,discipline,18,9,9
29041,Notahero,tichondrius,858,priest,discipline,12,9,3
29042,Preachermang,laughing-skull,858,priest,discipline,18,9,9
29043,Divinity,hellscream,858,priest,discipline,24,9,15
29044,Ricflayer,lothar,858,priest,discipline,24,9,15
29045,Mando,area-52,857,priest,discipline,62,31,31
29046,Rugaru,emerald-dream,857,priest,discipline,21,10,11
29047,Sipmemaster,tichondrius,856,priest,discipline,24,9,15
29048,Caiitlynn,quelthalas,856,priest,discipline,24,9,15
29049,Anddori,moknathal,855,priest,discipline,18,9,9
29050,Jebadiia,tichondrius,855,priest,discipline,31,12,19
29051,Amäo,illidan,855,priest,discipline,24,9,15
29052,Maiyennefer,proudmoore,855,priest,discipline,24,9,15
29053,Igotdots,scilla,854,priest,discipline,42,18,24
29054,Coachbombae,tichondrius,853,priest,discipline,12,9,3
29055,Sunayriah,illidan,853,priest,discipline,12,9,3
29056,Mangoes,scilla,853,priest,discipline,20,9,11
29057,Zathanel,ragnaros,852,priest,discipline,24,9,15
29058,Whitegirlirl,blackrock,850,priest,discipline,12,9,3
29059,Brahskeet,illidan,841,priest,discipline,30,9,21
29060,Kiilltic,sargeras,838,priest,discipline,30,9,21
29061,Thelonioüs,tichondrius,832,priest,discipline,55,20,35
29062,Rockrock,zuljin,831,priest,discipline,14,11,3
29063,Swu,tichondrius,830,priest,discipline,26,10,16
29064,Lîghtsaber,illidan,829,priest,discipline,26,9,17
29065,Delithara,tichondrius,826,priest,discipline,18,9,9
29066,Holyshield,jubeithos,825,priest,discipline,19,10,9
29067,Naniwa,ragnaros,825,priest,discipline,27,10,17
29068,Mydranol,tichondrius,824,priest,discipline,29,9,20
29069,Khinthazin,barthilas,815,priest,discipline,48,20,28
29070,Arizztocrat,tichondrius,814,priest,discipline,17,9,8
29071,Såx,stormreaver,814,priest,discipline,21,9,12
29072,Eblis,the-underbog,814,priest,discipline,21,9,12
29073,Nuvea,tichondrius,814,priest,discipline,21,9,12
29074,Ipód,tichondrius,813,priest,discipline,15,10,5
29075,Shadowdeathx,bleeding-hollow,813,priest,discipline,17,9,8
29076,Wodturbo,bleeding-hollow,809,priest,discipline,19,10,9
29077,Arianthe,darrowmere,809,priest,discipline,20,10,10
29078,Wellheeled,norgannon,806,priest,discipline,21,9,12
29079,Nepy,stormrage,805,priest,discipline,22,10,12
29080,Slaac,malfurion,799,priest,discipline,17,9,8
29081,Goldenfatty,blackrock,798,priest,discipline,20,9,11
29082,Ðrip,burning-legion,796,priest,discipline,16,9,7
29083,Jessikal,quelthalas,784,priest,discipline,19,9,10
29084,Winston,tichondrius,784,priest,discipline,19,9,10
29085,Fátima,tichondrius,783,priest,discipline,11,9,2
29086,Nvroom,illidan,783,priest,discipline,13,9,4
29087,Aupascamarad,tichondrius,783,priest,discipline,17,9,8
29088,Caz,sargeras,775,priest,discipline,24,12,12
29089,Xzliak,area-52,768,priest,discipline,12,8,4
29090,Müsic,stormrage,768,priest,discipline,12,8,4
29091,Fathersean,sargeras,768,priest,discipline,12,8,4
29092,Ñightelf,area-52,768,priest,discipline,12,8,4
29093,Discipline,the-scryers,768,priest,discipline,12,8,4
29094,Fzz,queldorei,768,priest,discipline,12,8,4
29095,Rdson,malganis,768,priest,discipline,12,8,4
29096,Zeepew,tichondrius,768,priest,discipline,12,8,4
29097,Chocopp,illidan,768,priest,discipline,12,8,4
29098,Yansuanmu,tichondrius,768,priest,discipline,12,8,4
29099,Criiltwo,area-52,768,priest,discipline,12,8,4
29100,Nydrosia,frostmourne,768,priest,discipline,12,8,4
29101,Blesstwo,ragnaros,768,priest,discipline,12,8,4
29102,Censyz,tichondrius,768,priest,discipline,12,8,4
29103,Heeka,kelthuzad,768,priest,discipline,12,8,4
29104,Dabû,tichondrius,768,priest,discipline,12,8,4
29105,Qohoo,tichondrius,768,priest,discipline,12,8,4
29106,Myòvó,tichondrius,768,priest,discipline,12,8,4
29107,Evèlyn,dathremar,768,priest,discipline,12,8,4
29108,Voltekkeh,tichondrius,768,priest,discipline,12,8,4
29109,Spriestbro,emerald-dream,768,priest,discipline,12,8,4
29110,Vonpaolo,emerald-dream,768,priest,discipline,12,8,4
29111,Sìkarìa,illidan,768,priest,discipline,12,8,4
29112,Slpox,sargeras,768,priest,discipline,12,8,4
29113,Bananass,sargeras,768,priest,discipline,12,8,4
29114,Zenelu,tichondrius,768,priest,discipline,12,8,4
29115,Soloqqt,tichondrius,768,priest,discipline,12,8,4
29116,Bubbliez,frostmourne,768,priest,discipline,12,8,4
29117,Soupbean,zuljin,768,priest,discipline,12,8,4
29118,Sontïx,sargeras,768,priest,discipline,18,8,10
29119,Sussywussy,stormrage,768,priest,discipline,18,8,10
29120,Smiliebomb,tichondrius,768,priest,discipline,18,8,10
29121,Aikinorz,tichondrius,768,priest,discipline,18,8,10
29122,Melielectra,tichondrius,768,priest,discipline,18,8,10
29123,Yosps,tichondrius,768,priest,discipline,18,8,10
29124,Robinophelia,sargeras,768,priest,discipline,18,8,10
29125,Troja,malganis,768,priest,discipline,18,8,10
29126,Alcoric,illidan,768,priest,discipline,18,8,10
29127,Tooeasy,vashj,768,priest,discipline,18,8,10
29128,Jodaa,sargeras,768,priest,discipline,18,8,10
29129,Abbyy,barthilas,768,priest,discipline,18,8,10
29130,Jangma,tichondrius,768,priest,discipline,18,8,10
29131,Dehf,bleeding-hollow,768,priest,discipline,18,8,10
29132,Jacqueline,tichondrius,768,priest,discipline,18,8,10
29133,Sotore,bleeding-hollow,768,priest,discipline,18,8,10
29134,Manbelow,bleeding-hollow,768,priest,discipline,27,9,18
29135,Hugeshield,stormrage,768,priest,discipline,24,8,16
29136,Voidrisu,sargeras,768,priest,discipline,24,8,16
29137,Minyeong,tichondrius,768,priest,discipline,24,8,16
29138,Mavalie,zuljin,768,priest,discipline,24,8,16
29139,Avipriest,area-52,768,priest,discipline,24,8,16
29140,Dylan,shuhalo,768,priest,discipline,24,8,16
29141,Chinstrap,zuljin,767,priest,discipline,12,8,4
29142,Powerranger,senjin,767,priest,discipline,12,8,4
29143,Urgetopurge,dunemaul,767,priest,discipline,12,8,4
29144,Daegal,malfurion,767,priest,discipline,12,8,4
29145,Piusxll,tichondrius,767,priest,discipline,12,8,4
29146,Rainny,proudmoore,767,priest,discipline,12,8,4
29147,Kencyy,tichondrius,767,priest,discipline,12,8,4
29148,Iulu,doomhammer,767,priest,discipline,12,8,4
29149,Ryuuka,sargeras,767,priest,discipline,12,8,4
29150,Gawlas,azshara,767,priest,discipline,12,8,4
29151,Elkies,area-52,767,priest,discipline,12,8,4
29152,Cassiuss,kelthuzad,767,priest,discipline,12,8,4
29153,Lucènt,frostmourne,767,priest,discipline,12,8,4
29154,Yotinha,nemesis,767,priest,discipline,12,8,4
29155,Spicey,korgath,767,priest,discipline,12,8,4
29156,Alarisa,chogall,767,priest,discipline,12,8,4
29157,Lelyna,stormrage,767,priest,discipline,12,8,4
29158,Mariels,quelthalas,767,priest,discipline,12,8,4
29159,Shinemyhead,stormrage,767,priest,discipline,12,8,4
29160,Kynsias,stormrage,767,priest,discipline,15,8,7
29161,Morningzz,tichondrius,767,priest,discipline,18,8,10
29162,Grotti,ragnaros,767,priest,discipline,18,8,10
29163,Hesus,deathwing,767,priest,discipline,18,8,10
29164,Brakála,ragnaros,767,priest,discipline,18,8,10
29165,Analiesa,moon-guard,767,priest,discipline,18,8,10
29166,Hellsembrace,lightbringer,767,priest,discipline,18,8,10
29167,Suekmydisc,frostmourne,767,priest,discipline,18,8,10
29168,Datspice,stormrage,767,priest,discipline,18,8,10
29169,Phobe,windrunner,767,priest,discipline,18,8,10
29170,Jùdas,ravencrest,767,priest,discipline,18,8,10
29171,Holyslap,nerzhul,767,priest,discipline,18,8,10
29172,Fatherdan,blackrock,767,priest,discipline,24,8,16
29173,Èuneekz,thrall,767,priest,discipline,24,8,16
29174,Providennce,tichondrius,767,priest,discipline,24,8,16
29175,Dawnside,wyrmrest-accord,767,priest,discipline,24,8,16
29176,Oniizanagi,thrall,767,priest,discipline,24,8,16
29177,Hl,dalaran,767,priest,discipline,24,8,16
29178,Showakoi,ragnaros,767,priest,discipline,28,9,19
29179,Snoog,tichondrius,767,priest,discipline,30,8,22
29180,Shirley,skywall,767,priest,discipline,30,8,22
29181,Mineral,sargeras,766,priest,discipline,12,8,4
29182,Claireredfld,lightbringer,766,priest,discipline,12,8,4
29183,Payperbuff,tichondrius,766,priest,discipline,12,8,4
29184,Juniorfloyd,tichondrius,766,priest,discipline,12,8,4
29185,Abzorbed,stormrage,766,priest,discipline,12,8,4
29186,Moonarie,draka,766,priest,discipline,12,8,4
29187,Kynnen,mannoroth,766,priest,discipline,12,8,4
29188,Grizzblessed,sargeras,766,priest,discipline,12,8,4
29189,Dorós,coilfang,766,priest,discipline,12,8,4
29190,Spitefuldirk,dalaran,766,priest,discipline,12,8,4
29191,Jerserra,emerald-dream,766,priest,discipline,12,8,4
29192,Xhaajyh,area-52,766,priest,discipline,12,8,4
29193,Shaerel,dalaran,766,priest,discipline,18,8,10
29194,Invisapowa,hyjal,766,priest,discipline,18,8,10
29195,Spriest,kul-tiras,766,priest,discipline,18,8,10
29196,Gõd,zuluhed,766,priest,discipline,18,8,10
29197,Via,chogall,766,priest,discipline,18,8,10
29198,Pollyphia,kiljaeden,765,priest,discipline,12,8,4
29199,Bandaidvibes,tichondrius,765,priest,discipline,12,8,4
29200,Lasslìn,bonechewer,765,priest,discipline,12,8,4
29201,Fhelurian,quelthalas,765,priest,discipline,18,8,10
29202,Sahray,quelthalas,765,priest,discipline,18,8,10
29203,Aybaby,kiljaeden,765,priest,discipline,18,8,10
29204,Darrong,darkspear,764,priest,discipline,18,8,10
29205,Healrat,thrall,764,priest,discipline,18,8,10
29206,Itchybubble,emerald-dream,763,priest,discipline,12,8,4
29207,Taiji,whisperwind,763,priest,discipline,12,8,4
29208,Breeannà,doomhammer,763,priest,discipline,16,9,7
29209,Lätöxïkä,alleria,763,priest,discipline,17,8,9
29210,Yusarin,garona,763,priest,discipline,18,8,10
29211,Rókue,silvermoon,763,priest,discipline,18,8,10
29212,Ashlìe,moon-guard,763,priest,discipline,18,8,10
29213,Deadheadfred,bonechewer,763,priest,discipline,18,8,10
29214,Squatrack,tichondrius,763,priest,discipline,24,8,16
29215,Nuell,malganis,762,priest,discipline,12,8,4
29216,Badazzfrank,tichondrius,762,priest,discipline,18,8,10
29217,Yamahaz,lethon,762,priest,discipline,18,8,10
29218,Sunael,quelthalas,760,priest,discipline,12,8,4
29219,Fluxus,sargeras,760,priest,discipline,12,8,4
29220,Oniyuri,dark-iron,760,priest,discipline,12,8,4
29221,Runemidgard,illidan,760,priest,discipline,18,8,10
29222,Cheuksin,korgath,759,priest,discipline,12,8,4
29223,Mynigajeff,zuljin,757,priest,discipline,26,10,16
29224,Kasamm,nazjatar,756,priest,discipline,18,8,10
29225,Theleena,malorne,755,priest,discipline,24,8,16
29226,Flannigan,veknilash,753,priest,discipline,12,8,4
29227,Whitepi,tichondrius,751,priest,discipline,21,9,12
29228,Peacebewithu,echo-isles,749,priest,discipline,12,8,4
29229,Healloween,stormrage,749,priest,discipline,12,8,4
29230,Jahsheer,kiljaeden,748,priest,discipline,14,10,4
29231,Iseeyoulookn,stormrage,743,priest,discipline,23,10,13
29232,Braxxten,tichondrius,741,priest,discipline,24,8,16
29233,Valith,bleeding-hollow,735,priest,discipline,16,9,7
29234,Pokebox,frostmourne,735,priest,discipline,16,8,8
29235,Unholyshield,frostmourne,734,priest,discipline,17,8,9
29236,Itssehctap,chogall,732,priest,discipline,14,9,5
29237,Aloragon,tichondrius,732,priest,discipline,17,8,9
29238,Pochis,bleeding-hollow,728,priest,discipline,20,9,11
29239,Alterboy,garrosh,724,priest,discipline,18,8,10
29240,Itxo,quelthalas,723,priest,discipline,16,9,7
29241,Invoice,bloodscalp,719,priest,discipline,17,8,9
29242,Pðpë,area-52,718,priest,discipline,11,8,3
29243,Clarity,arthas,718,priest,discipline,15,9,6
29244,Inmøthep,ragnaros,713,priest,discipline,22,9,13
29245,Nås,elune,711,priest,discipline,22,10,12
29246,Trashdiscx,stormrage,707,priest,discipline,25,11,14
29247,Aenbubble,tichondrius,703,priest,discipline,14,8,6
29248,Lilflexi,lightbringer,703,priest,discipline,16,8,8
29249,Mutedox,frostmourne,703,priest,discipline,17,8,9
29250,Styléßéndérx,illidan,687,priest,discipline,11,8,3
29251,Läsombra,area-52,684,priest,discipline,17,9,8
29252,Termiina,hyjal,684,priest,discipline,25,8,17
29253,Eneldz,quelthalas,672,priest,discipline,12,7,5
29254,Giomoreno,tichondrius,672,priest,discipline,12,7,5
29255,Kiloe,tichondrius,672,priest,discipline,12,7,5
29256,Carboload,thrall,672,priest,discipline,12,7,5
29257,Skcits,sargeras,672,priest,discipline,12,7,5
29258,Xsy,stormrage,672,priest,discipline,12,7,5
29259,Dances,emerald-dream,672,priest,discipline,12,7,5
29260,Sùlyvahñ,tichondrius,672,priest,discipline,12,7,5
29261,Thewaker,tichondrius,672,priest,discipline,12,7,5
29262,Priesticules,illidan,672,priest,discipline,12,7,5
29263,Jnglpriestx,thrall,672,priest,discipline,12,7,5
29264,Marejayne,tichondrius,672,priest,discipline,12,7,5
29265,Niik,tichondrius,672,priest,discipline,12,7,5
29266,Omsi,emerald-dream,672,priest,discipline,12,7,5
29267,Afflickzz,kelthuzad,672,priest,discipline,12,7,5
29268,Secondes,azralon,672,priest,discipline,12,7,5
29269,Yodud,tichondrius,672,priest,discipline,12,7,5
29270,Littlehcl,tichondrius,672,priest,discipline,12,7,5
29271,Healaryduff,skullcrusher,672,priest,discipline,12,7,5
29272,Kencys,tichondrius,672,priest,discipline,12,7,5
29273,Holyhand,auchindoun,672,priest,discipline,12,7,5
29274,Vaticly,hyjal,672,priest,discipline,12,7,5
29275,Aethestan,zuljin,672,priest,discipline,12,7,5
29276,Carlita,ravenholdt,672,priest,discipline,12,7,5
29277,Fäÿë,tichondrius,672,priest,discipline,12,7,5
29278,Dráugr,ragnaros,672,priest,discipline,12,7,5
29279,Deagled,tichondrius,672,priest,discipline,12,7,5
29280,Anmu,illidan,672,priest,discipline,12,7,5
29281,Sadsadge,sargeras,672,priest,discipline,12,7,5
29282,Pavesarii,proudmoore,672,priest,discipline,12,7,5
29283,Fialiadia,illidan,672,priest,discipline,12,7,5
29284,Aeyde,proudmoore,672,priest,discipline,12,7,5
29285,Greyx,moon-guard,672,priest,discipline,12,7,5
29286,Bigolbush,moon-guard,672,priest,discipline,12,7,5
29287,Whataday,tichondrius,672,priest,discipline,12,7,5
29288,Tslacalls,malganis,672,priest,discipline,12,7,5
29289,Wâtermelon,stormrage,672,priest,discipline,12,7,5
29290,Washdp,frostmourne,672,priest,discipline,12,7,5
29291,Scandi,tichondrius,672,priest,discipline,12,7,5
29292,Meemó,area-52,672,priest,discipline,12,7,5
29293,Holyshiiet,area-52,672,priest,discipline,12,7,5
29294,Dirtydebbie,lightnings-blade,672,priest,discipline,12,7,5
29295,Nerfdisc,elune,672,priest,discipline,12,7,5
29296,Brehzy,zuljin,672,priest,discipline,12,7,5
29297,Tòodles,stormrage,672,priest,discipline,12,7,5
29298,Jenhawkinsx,frostmourne,672,priest,discipline,12,7,5
29299,Artirie,darkspear,672,priest,discipline,12,7,5
29300,Kymomeh,sargeras,672,priest,discipline,12,7,5
29301,Taboogie,tichondrius,672,priest,discipline,12,7,5
29302,Dudebanger,sargeras,672,priest,discipline,12,7,5
29303,Vels,blackrock,672,priest,discipline,12,7,5
29304,Walpurgis,skywall,672,priest,discipline,12,7,5
29305,Clevelandboy,blackrock,672,priest,discipline,12,7,5
29306,Interacts,darkspear,672,priest,discipline,12,7,5
29307,Natahlia,area-52,672,priest,discipline,12,7,5
29308,Celerisp,malganis,672,priest,discipline,12,7,5
29309,Sentenel,duskwood,672,priest,discipline,12,7,5
29310,Absorbn,barthilas,672,priest,discipline,12,7,5
29311,Chknhealer,darkspear,672,priest,discipline,12,7,5
29312,Ninielly,stormrage,672,priest,discipline,14,8,6
29313,Siddhar,illidan,672,priest,discipline,13,7,6
29314,Photicz,thrall,672,priest,discipline,17,8,9
29315,Lidole,barthilas,672,priest,discipline,18,7,11
29316,Tubrisildris,zuljin,672,priest,discipline,18,7,11
29317,Tyzrapture,illidan,672,priest,discipline,18,7,11
29318,Dxs,hydraxis,672,priest,discipline,18,7,11
29319,Aryeinna,illidan,672,priest,discipline,18,7,11
29320,Dingledot,sargeras,672,priest,discipline,18,7,11
29321,Rigotakx,illidan,672,priest,discipline,18,7,11
29322,Criminalsp,frostmourne,672,priest,discipline,18,7,11
29323,Someonesxy,aggramar,672,priest,discipline,18,7,11
29324,Burkett,sargeras,672,priest,discipline,18,7,11
29325,Jagsp,area-52,672,priest,discipline,18,7,11
29326,Manbooty,illidan,672,priest,discipline,18,7,11
29327,Iwillrezguys,tichondrius,672,priest,discipline,18,7,11
29328,Xayda,area-52,672,priest,discipline,18,7,11
29329,Joeybats,frostwolf,672,priest,discipline,18,7,11
29330,Döyöuliftbro,tichondrius,672,priest,discipline,18,7,11
29331,Jugeum,proudmoore,672,priest,discipline,18,7,11
29332,Løøtgoblin,skullcrusher,672,priest,discipline,18,7,11
29333,Xalty,emerald-dream,672,priest,discipline,21,8,13
29334,Diebetus,zuljin,672,priest,discipline,24,7,17
29335,Gonchar,bleeding-hollow,672,priest,discipline,24,7,17
29336,Remusha,dalaran,672,priest,discipline,24,7,17
29337,Stríkes,emerald-dream,672,priest,discipline,24,7,17
29338,Babymieo,illidan,672,priest,discipline,24,7,17
29339,Polyesterp,frostmourne,672,priest,discipline,24,7,17
29340,Pïque,proudmoore,672,priest,discipline,24,7,17
29341,Zortroz,tichondrius,671,priest,discipline,10,8,2
29342,Thalladori,area-52,671,priest,discipline,16,10,6
29343,Skgangmm,tichondrius,671,priest,discipline,12,7,5
29344,Debigheal,stormrage,671,priest,discipline,12,7,5
29345,Popeofdope,queldorei,671,priest,discipline,12,7,5
29346,Bombinburbon,durotan,671,priest,discipline,12,7,5
29347,Fatherleem,tichondrius,671,priest,discipline,12,7,5
29348,Demonwizard,sargeras,671,priest,discipline,12,7,5
29349,Kaldric,korgath,671,priest,discipline,12,7,5
29350,Clerkbum,emerald-dream,671,priest,discipline,12,7,5
29351,Tassadaraiur,tichondrius,671,priest,discipline,12,7,5
29352,Mahelet,drakkari,671,priest,discipline,12,7,5
29353,Fatherjerry,kiljaeden,671,priest,discipline,12,7,5
29354,Jeremey,darkspear,671,priest,discipline,12,7,5
29355,Danílo,quelthalas,671,priest,discipline,12,7,5
29356,Linlight,stormrage,671,priest,discipline,12,7,5
29357,Saphet,draktharon,671,priest,discipline,12,7,5
29358,Lightschosen,malganis,671,priest,discipline,12,7,5
29359,Maenard,emerald-dream,671,priest,discipline,12,7,5
29360,Travakel,proudmoore,671,priest,discipline,12,7,5
29361,Dreaminz,tichondrius,671,priest,discipline,12,7,5
29362,Esohpr,frostmourne,671,priest,discipline,12,7,5
29363,Beocca,nerzhul,671,priest,discipline,12,7,5
29364,Lumyra,malganis,671,priest,discipline,12,7,5
29365,Zarfs,burning-blade,671,priest,discipline,12,7,5
29366,Trinidy,illidan,671,priest,discipline,12,7,5
29367,Epik,moknathal,671,priest,discipline,15,8,7
29368,Steefe,arygos,671,priest,discipline,18,7,11
29369,Hopanda,tichondrius,671,priest,discipline,18,7,11
29370,Vania,tortheldrin,671,priest,discipline,18,7,11
29371,Healznfeel,tichondrius,671,priest,discipline,18,7,11
29372,Ganelm,vashj,671,priest,discipline,18,7,11
29373,Mottomami,nemesis,671,priest,discipline,18,7,11
29374,Randomheal,dunemaul,671,priest,discipline,18,7,11
29375,Adofthealer,illidan,671,priest,discipline,18,7,11
29376,Canharm,tichondrius,671,priest,discipline,18,7,11
29377,Caeda,icecrown,671,priest,discipline,24,7,17
29378,Malansuo,wyrmrest-accord,671,priest,discipline,30,7,23
29379,Crackneesha,tichondrius,670,priest,discipline,12,7,5
29380,Antìdote,tichondrius,670,priest,discipline,12,7,5
29381,Susannahh,goldrinn,670,priest,discipline,12,7,5
29382,Madskills,shadow-council,670,priest,discipline,12,7,5
29383,Xð,jubeithos,670,priest,discipline,12,7,5
29384,Lavvari,durotan,670,priest,discipline,12,7,5
29385,Mortïmer,alleria,670,priest,discipline,12,7,5
29386,Angelicduck,illidan,670,priest,discipline,12,7,5
29387,Mitras,moon-guard,670,priest,discipline,12,7,5
29388,Fatherhands,illidan,670,priest,discipline,12,7,5
29389,Cromagnøn,dalaran,670,priest,discipline,12,7,5
29390,Kastwalker,earthen-ring,670,priest,discipline,12,7,5
29391,Hypnogypsy,malganis,670,priest,discipline,12,7,5
29392,Donus,frostmane,670,priest,discipline,12,7,5
29393,Jivita,lightbringer,670,priest,discipline,12,7,5
29394,Spiceenjoyer,emerald-dream,670,priest,discipline,15,8,7
29395,Xeras,ravencrest,670,priest,discipline,18,7,11
29396,Râku,area-52,670,priest,discipline,18,7,11
29397,Zgzz,stormrage,670,priest,discipline,24,7,17
29398,Kerfos,azralon,669,priest,discipline,10,8,2
29399,Dorst,bonechewer,669,priest,discipline,18,7,11
29400,Gabryanna,emerald-dream,669,priest,discipline,18,7,11
29401,Boojanglez,exodar,669,priest,discipline,18,7,11
29402,Evelien,kiljaeden,669,priest,discipline,24,7,17
29403,Jikoguu,stormscale,669,priest,discipline,24,7,17
29404,Nielic,arygos,668,priest,discipline,12,7,5
29405,Bubbleyo,shandris,668,priest,discipline,12,7,5
29406,Meddyglyn,area-52,668,priest,discipline,12,7,5
29407,Butterflyblu,ragnaros,668,priest,discipline,13,7,6
29408,Albertth,ragnaros,668,priest,discipline,18,7,11
29409,Butterblessr,thunderlord,668,priest,discipline,19,7,12
29410,Tassik,dalaran,667,priest,discipline,18,7,11
29411,Mortecraft,sargeras,666,priest,discipline,12,7,5
29412,Glisserin,zuljin,666,priest,discipline,12,7,5
29413,Tenet,stormscale,666,priest,discipline,18,7,11
29414,Grapedraankk,kelthuzad,664,priest,discipline,12,7,5
29415,Crossblesser,alleria,663,priest,discipline,12,7,5
29416,Nikkazul,drakkari,659,priest,discipline,24,11,13
29417,Terric,shattered-hand,658,priest,discipline,18,7,11
29418,Neutrino,quelthalas,655,priest,discipline,17,7,10
29419,Megz,zuljin,655,priest,discipline,17,7,10
29420,Rcx,sargeras,655,priest,discipline,17,7,10
29421,Sezyks,stormrage,655,priest,discipline,17,7,10
29422,Plasticbag,frostmourne,654,priest,discipline,17,7,10
29423,Oneinurdome,moknathal,648,priest,discipline,31,10,21
29424,Ibangedaqt,malganis,647,priest,discipline,26,11,15
29425,Youngboys,stormreaver,642,priest,discipline,36,18,18
29426,Pridesp,tichondrius,639,priest,discipline,14,8,6
29427,Gankchange,tichondrius,639,priest,discipline,14,8,6
29428,Lalo,bleeding-hollow,638,priest,discipline,23,7,16
29429,Rôxxy,thrall,636,priest,discipline,16,8,8
29430,Futatsi,zuljin,634,priest,discipline,23,7,16
29431,Swagacious,malganis,624,priest,discipline,13,8,5
29432,Xhadow,sargeras,624,priest,discipline,15,8,7
29433,Holysmegma,dreadmaul,623,priest,discipline,11,7,4
29434,Ezpríest,kelthuzad,623,priest,discipline,11,7,4
29435,Archcerion,stormreaver,621,priest,discipline,15,8,7
29436,Mylkshakez,emerald-dream,621,priest,discipline,19,8,11
29437,Càipirinha,tichondrius,608,priest,discipline,10,7,3
29438,Elevatez,stormrage,608,priest,discipline,10,7,3
29439,Meatguzzler,tichondrius,607,priest,discipline,11,7,4
29440,Åffliction,sargeras,607,priest,discipline,11,7,4
29441,Tigrania,proudmoore,607,priest,discipline,11,7,4
29442,Coolzo,dethecus,607,priest,discipline,14,8,6
29443,Jimyo,tichondrius,607,priest,discipline,15,7,8
29444,Codiroli,tichondrius,606,priest,discipline,14,7,7
29445,Forprophet,proudmoore,606,priest,discipline,22,7,15
29446,Athzziry,ragnaros,599,priest,discipline,21,7,14
29447,Hpalisdawg,malorne,592,priest,discipline,13,7,6
29448,Blacklog,darkspear,592,priest,discipline,19,7,12
29449,Syndrox,kelthuzad,576,priest,discipline,6,6,0
29450,Porffy,malygos,576,priest,discipline,6,6,0
29451,Pearl,chogall,576,priest,discipline,6,6,0
29452,Càptain,moon-guard,576,priest,discipline,6,6,0
29453,Eldoras,zuljin,576,priest,discipline,6,6,0
29454,Healia,tichondrius,576,priest,discipline,6,6,0
29455,Wizeau,dalaran,576,priest,discipline,6,6,0
29456,Jerome,tichondrius,576,priest,discipline,6,6,0
29457,Illmatíc,malganis,576,priest,discipline,6,6,0
29458,Thirddps,illidan,576,priest,discipline,6,6,0
29459,Delai,dalaran,576,priest,discipline,6,6,0
29460,Yannigirl,area-52,576,priest,discipline,12,6,6
29461,Bumps,zuljin,576,priest,discipline,12,6,6
29462,Frankoizz,quelthalas,576,priest,discipline,12,6,6
29463,Saelomism,frostmourne,576,priest,discipline,12,6,6
29464,Ilovemia,zuljin,576,priest,discipline,12,6,6
29465,Imfresh,illidan,576,priest,discipline,12,6,6
29466,Dimebahg,mugthol,576,priest,discipline,12,6,6
29467,Prostrat,deathwing,576,priest,discipline,12,6,6
29468,Punchyxz,illidan,576,priest,discipline,12,6,6
29469,Johnnysyns,frostmourne,576,priest,discipline,12,6,6
29470,Chaotikx,kelthuzad,576,priest,discipline,12,6,6
29471,Celypriest,moon-guard,576,priest,discipline,12,6,6
29472,Scripture,stormreaver,576,priest,discipline,12,6,6
29473,Bigsàd,proudmoore,576,priest,discipline,12,6,6
29474,Shoepooper,kelthuzad,576,priest,discipline,12,6,6
29475,Jackski,aerie-peak,576,priest,discipline,12,6,6
29476,Skiza,stormrage,576,priest,discipline,12,6,6
29477,Raichu,blackrock,576,priest,discipline,12,6,6
29478,Nokzo,dalaran,576,priest,discipline,12,6,6
29479,Syncope,garona,576,priest,discipline,12,6,6
29480,Jakemies,arathor,576,priest,discipline,12,6,6
29481,Degenerates,blood-furnace,576,priest,discipline,12,6,6
29482,Fatherjohnny,azuremyst,576,priest,discipline,12,6,6
29483,Keldrii,sentinels,576,priest,discipline,12,6,6
29484,Nelfpriest,khadgar,576,priest,discipline,12,6,6
29485,Napr,proudmoore,576,priest,discipline,12,6,6
29486,Stankychimpo,malganis,576,priest,discipline,12,6,6
29487,Metius,smolderthorn,576,priest,discipline,12,6,6
29488,Lightsight,burning-blade,576,priest,discipline,12,6,6
29489,Redkiwi,illidan,576,priest,discipline,12,6,6
29490,Owlchubz,mannoroth,576,priest,discipline,12,6,6
29491,Elfgasmic,blackwater-raiders,576,priest,discipline,12,6,6
29492,Decades,moon-guard,576,priest,discipline,12,6,6
29493,Joanoarc,destromath,576,priest,discipline,12,6,6
29494,Hereges,azralon,576,priest,discipline,12,6,6
29495,Treri,bleeding-hollow,576,priest,discipline,12,6,6
29496,Shwayp,zuljin,576,priest,discipline,12,6,6
29497,Pennumbra,barthilas,576,priest,discipline,12,6,6
29498,Jopocket,bleeding-hollow,576,priest,discipline,12,6,6
29499,Photicz,malganis,576,priest,discipline,12,6,6
29500,Flarkyllama,area-52,576,priest,discipline,12,6,6
29501,Datwunguy,sargeras,576,priest,discipline,12,6,6
29502,Tcfx,bleeding-hollow,576,priest,discipline,12,6,6
29503,Thelastfight,frostmourne,576,priest,discipline,12,6,6
29504,Neep,turalyon,576,priest,discipline,12,6,6
29505,Meshuggah,archimonde,576,priest,discipline,12,6,6
29506,Moselol,tichondrius,576,priest,discipline,12,6,6
29507,Kzo,gnomeregan,576,priest,discipline,12,6,6
29508,Tranquilty,tichondrius,576,priest,discipline,12,6,6
29509,Kawasakix,tichondrius,576,priest,discipline,12,6,6
29510,Rin,ghostlands,576,priest,discipline,12,6,6
29511,Ifortalot,lothar,576,priest,discipline,12,6,6
29512,Moqoro,azralon,576,priest,discipline,12,6,6
29513,Chicoryx,illidan,576,priest,discipline,12,6,6
29514,Bloodfaith,stormrage,576,priest,discipline,12,6,6
29515,Bernietopper,tichondrius,576,priest,discipline,12,6,6
29516,Slobmygnob,illidan,576,priest,discipline,12,6,6
29517,Irar,tichondrius,576,priest,discipline,12,6,6
29518,Saintjpii,tichondrius,576,priest,discipline,12,6,6
29519,Jpgpng,tichondrius,576,priest,discipline,12,6,6
29520,Nethir,moon-guard,576,priest,discipline,12,6,6
29521,Azurestorm,tichondrius,576,priest,discipline,12,6,6
29522,Darkinfusion,illidan,576,priest,discipline,12,6,6
29523,Ruinr,illidan,576,priest,discipline,12,6,6
29524,Panikâ,thrall,576,priest,discipline,12,6,6
29525,Brahp,frostmourne,576,priest,discipline,12,6,6
29526,Bohomag,tichondrius,576,priest,discipline,12,6,6
29527,Inukimi,sargeras,576,priest,discipline,12,6,6
29528,Ariste,tichondrius,576,priest,discipline,12,6,6
29529,Wodpriestx,stormrage,576,priest,discipline,12,6,6
29530,Nineoneoneh,stormrage,576,priest,discipline,12,6,6
29531,Padrë,tichondrius,576,priest,discipline,12,6,6
29532,Wøah,stormrage,576,priest,discipline,12,6,6
29533,Guccísandals,emerald-dream,576,priest,discipline,12,6,6
29534,Seléne,tichondrius,576,priest,discipline,12,6,6
29535,Boppdot,tichondrius,576,priest,discipline,12,6,6
29536,Purpskurp,stormrage,576,priest,discipline,12,6,6
29537,Cency,tichondrius,576,priest,discipline,12,6,6
29538,Randyortonn,tichondrius,576,priest,discipline,12,6,6
29539,Instaboned,sargeras,576,priest,discipline,12,6,6
29540,Johnio,tichondrius,576,priest,discipline,12,6,6
29541,Obstetrician,tichondrius,576,priest,discipline,12,6,6
29542,Wabie,illidan,576,priest,discipline,12,6,6
29543,Xiaochenchen,tichondrius,576,priest,discipline,12,6,6
29544,Mediterranee,tichondrius,576,priest,discipline,12,6,6
29545,Ahnassi,stormrage,576,priest,discipline,12,6,6
29546,Lisau,tichondrius,576,priest,discipline,12,6,6
29547,Kiddonia,whisperwind,576,priest,discipline,15,7,8
29548,Bigfirebet,tichondrius,576,priest,discipline,15,7,8
29549,Preyforme,tichondrius,576,priest,discipline,13,6,7
29550,Peaky,moonrunner,576,priest,discipline,18,6,12
29551,Çørrúptíøñz,tichondrius,576,priest,discipline,18,6,12
29552,Jazmiine,ragnaros,576,priest,discipline,18,6,12
29553,Scpzi,frostmourne,576,priest,discipline,18,6,12
29554,Keepsleepin,stormrage,576,priest,discipline,18,6,12
29555,Repriest,malganis,576,priest,discipline,18,6,12
29556,Sandelios,aggramar,576,priest,discipline,18,6,12
29557,Synaptikk,proudmoore,576,priest,discipline,18,6,12
29558,Plztrainme,spinebreaker,576,priest,discipline,18,6,12
29559,Giannis,garrosh,576,priest,discipline,18,6,12
29560,Dgpriest,tichondrius,576,priest,discipline,18,6,12
29561,Ershackleton,illidan,576,priest,discipline,18,6,12
29562,Ancilx,area-52,576,priest,discipline,18,6,12
29563,Lildes,tichondrius,576,priest,discipline,18,6,12
29564,Komicks,tichondrius,576,priest,discipline,18,6,12
29565,Shadlo,chogall,576,priest,discipline,18,6,12
29566,Jiedx,tichondrius,576,priest,discipline,18,6,12
29567,Fadedhalo,magtheridon,576,priest,discipline,18,6,12
29568,Asmødeus,bleeding-hollow,576,priest,discipline,18,6,12
29569,Starp,tichondrius,576,priest,discipline,18,6,12
29570,Slthrysnake,area-52,576,priest,discipline,18,6,12
29571,Fartnutts,dalaran,576,priest,discipline,18,6,12
29572,Priestmass,dalaran,576,priest,discipline,18,6,12
29573,Jarzo,thunderhorn,576,priest,discipline,18,6,12
29574,Dots,tichondrius,576,priest,discipline,18,6,12
29575,Vicara,moon-guard,576,priest,discipline,18,6,12
29576,Junethegreat,tichondrius,576,priest,discipline,18,6,12
29577,Oymay,illidan,576,priest,discipline,18,6,12
29578,Mylà,ragnaros,576,priest,discipline,20,6,14
29579,Cûrry,bleeding-hollow,576,priest,discipline,24,6,18
29580,Drupith,dalaran,576,priest,discipline,24,6,18
29581,Felixfire,moon-guard,576,priest,discipline,24,6,18
29582,Nachòs,wildhammer,575,priest,discipline,6,6,0
29583,Kephrek,eonar,575,priest,discipline,6,6,0
29584,Astrìx,tichondrius,575,priest,discipline,6,6,0
29585,Galastine,emerald-dream,575,priest,discipline,12,6,6
29586,Lúçíd,sargeras,575,priest,discipline,12,6,6
29587,Aanora,illidan,575,priest,discipline,12,6,6
29588,Demimo,frostwolf,575,priest,discipline,12,6,6
29589,Silveri,thrall,575,priest,discipline,12,6,6
29590,Pulso,area-52,575,priest,discipline,12,6,6
29591,Imhotap,illidan,575,priest,discipline,12,6,6
29592,Pinaybebe,kiljaeden,575,priest,discipline,12,6,6
29593,Moarhaste,kelthuzad,575,priest,discipline,12,6,6
29594,Exanthrope,stormrage,575,priest,discipline,12,6,6
29595,Nineoneone,kilrogg,575,priest,discipline,12,6,6
29596,Chloangel,frostmourne,575,priest,discipline,12,6,6
29597,What,moon-guard,575,priest,discipline,12,6,6
29598,Mcfluffin,aggramar,575,priest,discipline,12,6,6
29599,Gdrf,sargeras,575,priest,discipline,12,6,6
29600,Wickedmoon,emerald-dream,575,priest,discipline,12,6,6
29601,Gudnewsevone,illidan,575,priest,discipline,12,6,6
29602,Sinzex,tichondrius,575,priest,discipline,12,6,6
29603,Uncensøred,tichondrius,575,priest,discipline,12,6,6
29604,Lobstersock,malganis,575,priest,discipline,12,6,6
29605,Nevertelsp,malganis,575,priest,discipline,12,6,6
29606,Mpshield,kiljaeden,575,priest,discipline,12,6,6
29607,Brahmin,nazjatar,575,priest,discipline,12,6,6
29608,Kreon,tichondrius,575,priest,discipline,12,6,6
29609,Khaibit,stormrage,575,priest,discipline,12,6,6
29610,Actiop,stormrage,575,priest,discipline,12,6,6
29611,Forroc,stormrage,575,priest,discipline,12,6,6
29612,Herzattacken,malganis,575,priest,discipline,12,6,6
29613,Nejisaiyan,sargeras,575,priest,discipline,12,6,6
29614,Swaptohealer,misha,575,priest,discipline,12,6,6
29615,Peeinbottles,stormrage,575,priest,discipline,16,7,9
29616,Biltpeter,tichondrius,575,priest,discipline,15,6,9
29617,Runecarver,anvilmar,575,priest,discipline,18,6,12
29618,Prelate,moon-guard,575,priest,discipline,18,6,12
29619,Flexxwzkaboo,thrall,575,priest,discipline,18,6,12
29620,Villageidiot,lightbringer,575,priest,discipline,18,6,12
29621,Voidmaker,area-52,575,priest,discipline,18,6,12
29622,Mortaroth,doomhammer,575,priest,discipline,18,6,12
29623,Xyberius,barthilas,575,priest,discipline,18,6,12
29624,Baldpate,tichondrius,575,priest,discipline,24,6,18
29625,Mikol,eredar,574,priest,discipline,12,6,6
29626,Mezervescent,thrall,574,priest,discipline,24,6,18
29627,Papadarkness,tichondrius,574,priest,discipline,24,6,18
29628,Ságrádá,area-52,573,priest,discipline,12,6,6
29629,Reilean,sargeras,573,priest,discipline,12,6,6
29630,Prebruisz,baelgun,573,priest,discipline,12,6,6
29631,Pharaoh,deathwing,573,priest,discipline,12,6,6
29632,Lookfig,frostmourne,573,priest,discipline,18,6,12
29633,Bigchip,sargeras,573,priest,discipline,24,6,18
29634,Aragingclue,burning-legion,572,priest,discipline,12,6,6
29635,Dirtyone,dark-iron,572,priest,discipline,18,6,12
29636,Marpi,quelthalas,572,priest,discipline,24,6,18
29637,Voidlordd,kelthuzad,571,priest,discipline,12,6,6
29638,Grandraf,dreadmaul,570,priest,discipline,12,6,6
29639,Thøt,malganis,570,priest,discipline,12,6,6
29640,Jaster,proudmoore,570,priest,discipline,14,6,8
29641,Antipreist,bonechewer,567,priest,discipline,12,6,6
29642,Crossbones,cenarion-circle,566,priest,discipline,12,6,6
29643,Zerolyn,tichondrius,559,priest,discipline,17,6,11
29644,Justfaith,barthilas,558,priest,discipline,17,6,11
29645,Zeno,haomarush,557,priest,discipline,11,6,5
29646,Gringotaco,tichondrius,554,priest,discipline,26,9,17
29647,Preeste,stormrage,543,priest,discipline,14,7,7
29648,Earface,blades-edge,543,priest,discipline,14,7,7
29649,Awaken,nerzhul,543,priest,discipline,17,6,11
29650,Mørbol,tichondrius,541,priest,discipline,14,7,7
29651,Moonlightx,destromath,528,priest,discipline,9,7,2
29652,Xiaz,lightbringer,528,priest,discipline,12,8,4
29653,Randomprist,area-52,528,priest,discipline,15,6,9
29654,Tealien,dalaran,527,priest,discipline,11,6,5
29655,Azaleth,sargeras,527,priest,discipline,11,6,5
29656,Pasquell,emerald-dream,526,priest,discipline,11,6,5
29657,Nosgoróth,quelthalas,522,priest,discipline,13,7,6
29658,Dotdotdead,earthen-ring,522,priest,discipline,16,7,9
29659,Twistèr,zuljin,522,priest,discipline,26,7,19
29660,Onahaihu,tichondrius,521,priest,discipline,20,7,13
29661,Identìty,moon-guard,521,priest,discipline,28,7,21
29662,Øçñæøæçñøñçæ,sargeras,520,priest,discipline,12,7,5
29663,Ethari,crushridge,520,priest,discipline,21,7,14
29664,Iamjakehill,area-52,511,priest,discipline,8,6,2
29665,Enphý,quelthalas,511,priest,discipline,11,6,5
29666,Bigtang,kiljaeden,511,priest,discipline,14,6,8
29667,Lilmad,stormrage,511,priest,discipline,20,6,14
29668,Moneymurph,blackrock,511,priest,discipline,26,6,20
29669,Pavarotti,laughing-skull,510,priest,discipline,20,6,14
29670,Aquandrelea,aegwynn,495,priest,discipline,7,6,1
29671,Yait,tichondrius,495,priest,discipline,14,7,7
29672,Silverspöön,bleeding-hollow,495,priest,discipline,13,6,7
29673,Danawhitex,thrall,480,priest,discipline,6,5,1
29674,Bulleitrye,emerald-dream,480,priest,discipline,6,5,1
29675,Mercedés,alleria,480,priest,discipline,6,5,1
29676,Sharkbones,tichondrius,480,priest,discipline,6,5,1
29677,Hateutoo,sargeras,480,priest,discipline,6,5,1
29678,Nawtyforever,tichondrius,480,priest,discipline,6,5,1
29679,Dzikuss,aegwynn,480,priest,discipline,6,5,1
29680,Xøspëélls,ragnaros,480,priest,discipline,6,5,1
29681,Noite,azralon,480,priest,discipline,6,5,1
29682,Uncletouchy,illidan,480,priest,discipline,6,5,1
29683,Azari,illidan,480,priest,discipline,6,5,1
29684,Laggytwodope,tichondrius,480,priest,discipline,6,5,1
29685,Thugliffe,frostmourne,480,priest,discipline,6,5,1
29686,Clerkpriest,dragonmaw,480,priest,discipline,6,5,1
29687,Sixnoh,moonrunner,480,priest,discipline,6,5,1
29688,Azuremissile,tichondrius,480,priest,discipline,6,5,1
29689,Drée,zuljin,480,priest,discipline,6,5,1
29690,Phantømz,zuljin,480,priest,discipline,6,5,1
29691,Tegridyfarm,malganis,480,priest,discipline,6,5,1
29692,Cxmplex,malganis,480,priest,discipline,6,5,1
29693,Corov,korgath,480,priest,discipline,6,5,1
29694,Mxst,frostmourne,480,priest,discipline,6,5,1
29695,Stegp,kelthuzad,480,priest,discipline,6,5,1
29696,Gäüge,burning-legion,480,priest,discipline,6,5,1
29697,Kardinalkeso,frostmourne,480,priest,discipline,6,5,1
29698,Káldorei,proudmoore,480,priest,discipline,6,5,1
29699,Saviorsëlf,tichondrius,480,priest,discipline,6,5,1
29700,Deacoderx,area-52,480,priest,discipline,6,5,1
29701,Sierrastorms,moon-guard,480,priest,discipline,6,5,1
29702,Velastirra,saurfang,480,priest,discipline,6,5,1
29703,Lildubs,bloodhoof,480,priest,discipline,6,5,1
29704,Hölymöly,moon-guard,480,priest,discipline,6,5,1
29705,Alimony,chogall,480,priest,discipline,6,5,1
29706,Aetonyx,anvilmar,480,priest,discipline,6,5,1
29707,Xorriz,bleeding-hollow,480,priest,discipline,6,5,1
29708,Dirtydickdan,sargeras,480,priest,discipline,6,5,1
29709,Djd,frostmourne,480,priest,discipline,6,5,1
29710,Çøçø,tichondrius,480,priest,discipline,6,5,1
29711,Privx,bleeding-hollow,480,priest,discipline,6,5,1
29712,Imwithham,tichondrius,480,priest,discipline,10,6,4
29713,Alpacasama,illidan,480,priest,discipline,12,5,7
29714,Yaheals,gorefiend,480,priest,discipline,12,5,7
29715,Cw,wildhammer,480,priest,discipline,12,5,7
29716,Feyns,illidan,480,priest,discipline,12,5,7
29717,Ayani,khadgar,480,priest,discipline,12,5,7
29718,Skwishee,illidan,480,priest,discipline,12,5,7
29719,Nursébeardy,whisperwind,480,priest,discipline,12,5,7
29720,Spîteful,illidan,480,priest,discipline,12,5,7
29721,Xpenance,ragnaros,480,priest,discipline,12,5,7
29722,Scyndar,bonechewer,480,priest,discipline,12,5,7
29723,Tòxìç,stormrage,480,priest,discipline,12,5,7
29724,Sabela,moon-guard,480,priest,discipline,12,5,7
29725,Whosjoe,tichondrius,480,priest,discipline,12,5,7
29726,Pumice,destromath,480,priest,discipline,12,5,7
29727,Altaeres,tichondrius,480,priest,discipline,12,5,7
29728,Alleeyy,tichondrius,480,priest,discipline,12,5,7
29729,Canswersp,sargeras,480,priest,discipline,12,5,7
29730,Drmattydubz,tichondrius,480,priest,discipline,12,5,7
29731,Letkidscome,archimonde,480,priest,discipline,12,5,7
29732,Deeply,tichondrius,480,priest,discipline,12,5,7
29733,Takosoufflé,emerald-dream,480,priest,discipline,12,5,7
29734,Wreklol,sargeras,480,priest,discipline,12,5,7
29735,Drzz,tichondrius,480,priest,discipline,12,5,7
29736,Lchcl,tichondrius,480,priest,discipline,12,5,7
29737,Lourrdz,tichondrius,480,priest,discipline,12,5,7
29738,Shädyönë,tichondrius,480,priest,discipline,12,5,7
29739,Krazyapollo,tichondrius,480,priest,discipline,12,5,7
29740,Kelelin,frostwolf,480,priest,discipline,12,5,7
29741,Goonie,spirestone,480,priest,discipline,12,5,7
29742,Piffbadar,tichondrius,480,priest,discipline,12,5,7
29743,Htx,dunemaul,480,priest,discipline,12,5,7
29744,Bluffzp,boulderfist,480,priest,discipline,12,5,7
29745,Ptam,tichondrius,480,priest,discipline,12,5,7
29746,Azngød,tichondrius,480,priest,discipline,12,5,7
29747,Stambuff,tichondrius,480,priest,discipline,12,5,7
29748,Justgoon,tichondrius,480,priest,discipline,12,5,7
29749,Taikosqt,azralon,480,priest,discipline,12,5,7
29750,Kovie,twisting-nether,480,priest,discipline,12,5,7
29751,Äpriest,sargeras,480,priest,discipline,12,5,7
29752,Vérse,stormrage,480,priest,discipline,12,5,7
29753,Jmanhealz,stormrage,480,priest,discipline,12,5,7
29754,Shayylii,stormrage,480,priest,discipline,12,5,7
29755,Voidquil,bonechewer,480,priest,discipline,12,5,7
29756,Raslin,bonechewer,480,priest,discipline,12,5,7
29757,Rofrofmu,aegwynn,480,priest,discipline,12,5,7
29758,Augus,velen,480,priest,discipline,12,5,7
29759,Hotlink,daggerspine,480,priest,discipline,12,5,7
29760,Robbailey,dalvengyr,480,priest,discipline,12,5,7
29761,Lingt,drakkari,480,priest,discipline,12,5,7
29762,Arcosis,turalyon,480,priest,discipline,12,5,7
29763,Ophiuchus,jubeithos,480,priest,discipline,12,5,7
29764,Dweem,stormrage,480,priest,discipline,12,5,7
29765,Derisha,ragnaros,480,priest,discipline,12,5,7
29766,Kideater,quelthalas,480,priest,discipline,12,5,7
29767,Apbrady,sargeras,480,priest,discipline,12,5,7
29768,Doublesix,malganis,480,priest,discipline,12,5,7
29769,Câstiêl,malganis,480,priest,discipline,12,5,7
29770,Mywifesaidno,sargeras,480,priest,discipline,12,5,7
29771,Blackdeathx,tichondrius,480,priest,discipline,12,5,7
29772,Inflate,frostmourne,480,priest,discipline,12,5,7
29773,Soulbane,frostmourne,480,priest,discipline,12,5,7
29774,Shôta,kelthuzad,480,priest,discipline,12,5,7
29775,Amperx,wyrmrest-accord,480,priest,discipline,12,5,7
29776,Zælya,stormrage,480,priest,discipline,12,5,7
29777,Jackymv,kelthuzad,480,priest,discipline,12,5,7
29778,Discogs,frostmourne,480,priest,discipline,12,5,7
29779,Yujawang,sargeras,480,priest,discipline,12,5,7
29780,Starzard,kelthuzad,480,priest,discipline,12,5,7
29781,Vikks,tichondrius,480,priest,discipline,12,5,7
29782,Humblemumble,barthilas,480,priest,discipline,12,5,7
29783,Elexianpi,stormrage,480,priest,discipline,12,5,7
29784,Vyrah,area-52,480,priest,discipline,12,5,7
29785,Upsahl,area-52,480,priest,discipline,12,5,7
29786,Aheneas,quelthalas,480,priest,discipline,12,5,7
29787,Anellas,sargeras,480,priest,discipline,12,5,7
29788,Icarryozz,darkspear,480,priest,discipline,12,5,7
29789,Nars,draka,480,priest,discipline,12,5,7
29790,Lastbubble,area-52,480,priest,discipline,12,5,7
29791,Stubby,shadowsong,480,priest,discipline,12,5,7
29792,Goosemongler,bleeding-hollow,480,priest,discipline,12,5,7
29793,Nißirøux,sargeras,480,priest,discipline,12,5,7
29794,Whiterhino,spirestone,480,priest,discipline,12,5,7
29795,Supernamp,sargeras,480,priest,discipline,12,5,7
29796,Healryyduff,barthilas,480,priest,discipline,12,5,7
29797,Ajazz,zuljin,480,priest,discipline,12,5,7
29798,Merxy,bleeding-hollow,480,priest,discipline,12,5,7
29799,Shadowcrash,zuljin,480,priest,discipline,12,5,7
29800,Makeshiftz,zuljin,480,priest,discipline,12,5,7
29801,Giraffebaitt,zuljin,480,priest,discipline,12,5,7
29802,Somethingkoo,sargeras,480,priest,discipline,17,7,10
29803,Gatty,kiljaeden,480,priest,discipline,13,5,8
29804,Cheekypriest,stormrage,480,priest,discipline,18,5,13
29805,Sypii,stormrage,480,priest,discipline,18,5,13
29806,Nuditwo,malganis,480,priest,discipline,18,5,13
29807,Pasher,sargeras,480,priest,discipline,18,5,13
29808,Kark,tichondrius,480,priest,discipline,18,5,13
29809,Mangshadoom,silvermoon,480,priest,discipline,18,5,13
29810,Fréákk,ragnaros,480,priest,discipline,18,5,13
29811,Discpriestxo,malganis,480,priest,discipline,18,5,13
29812,Ticheals,tichondrius,480,priest,discipline,18,5,13
29813,Levingurt,darkspear,480,priest,discipline,18,5,13
29814,Bebe,fizzcrank,480,priest,discipline,18,5,13
29815,Aguadejamica,tichondrius,480,priest,discipline,18,5,13
29816,Autogenic,malganis,480,priest,discipline,18,5,13
29817,Vetisrx,thrall,480,priest,discipline,18,5,13
29818,Healiesuwu,kiljaeden,480,priest,discipline,18,5,13
29819,Klerick,kiljaeden,480,priest,discipline,18,5,13
29820,Moc,jubeithos,480,priest,discipline,24,5,19
29821,Georgepells,barthilas,480,priest,discipline,24,5,19
29822,Ghettobarbie,kelthuzad,479,priest,discipline,6,5,1
29823,Tonymòntana,area-52,479,priest,discipline,6,5,1
29824,Sevioletté,wyrmrest-accord,479,priest,discipline,6,5,1
29825,Remixcandoit,malganis,479,priest,discipline,6,5,1
29826,Pretzah,barthilas,479,priest,discipline,6,5,1
29827,Krisdavra,thrall,479,priest,discipline,6,5,1
29828,Xojelas,quelthalas,479,priest,discipline,6,5,1
29829,Viehweg,azralon,479,priest,discipline,12,5,7
29830,Healzutwo,tichondrius,479,priest,discipline,12,5,7
29831,Chadlyfe,tichondrius,479,priest,discipline,12,5,7
29832,Chopstix,senjin,479,priest,discipline,12,5,7
29833,Blackbubba,tichondrius,479,priest,discipline,12,5,7
29834,Gaaq,stormrage,479,priest,discipline,12,5,7
29835,Atheíst,tichondrius,479,priest,discipline,12,5,7
29836,Xenedart,quelthalas,479,priest,discipline,12,5,7
29837,Ibuyfeetpics,tichondrius,479,priest,discipline,12,5,7
29838,Frazzysparks,stormrage,479,priest,discipline,12,5,7
29839,Sublîme,sargeras,479,priest,discipline,12,5,7
29840,Krynoobz,senjin,479,priest,discipline,12,5,7
29841,Tubelight,sargeras,479,priest,discipline,12,5,7
29842,Aalicya,tanaris,479,priest,discipline,12,5,7
29843,Techninë,chogall,479,priest,discipline,12,5,7
29844,Demished,zuljin,479,priest,discipline,12,5,7
29845,Selea,frostwolf,479,priest,discipline,12,5,7
29846,Wort,cairne,479,priest,discipline,12,5,7
29847,Drayen,korgath,479,priest,discipline,12,5,7
29848,Derowent,emerald-dream,479,priest,discipline,12,5,7
29849,Goodboyyoshi,tichondrius,479,priest,discipline,15,5,10
29850,Cxview,sargeras,479,priest,discipline,18,5,13
29851,Crusifixx,tichondrius,479,priest,discipline,18,5,13
29852,Healtomuch,nagrand,479,priest,discipline,18,5,13
29853,Kaladaz,destromath,478,priest,discipline,12,5,7
29854,Eumalfa,dalaran,477,priest,discipline,6,5,1
29855,Pingleangel,tichondrius,477,priest,discipline,12,5,7
29856,Goldenlilly,moon-guard,477,priest,discipline,18,5,13
29857,Hazzang,tichondrius,476,priest,discipline,78,37,41
29858,Lotzofhealz,wyrmrest-accord,476,priest,discipline,12,5,7
29859,Forober,queldorei,466,priest,discipline,39,14,25
29860,Shadowkr,tichondrius,447,priest,discipline,11,5,6
29861,Hungzilla,malganis,447,priest,discipline,11,5,6
29862,Faíthless,sargeras,447,priest,discipline,11,5,6
29863,Darkascended,arthas,447,priest,discipline,14,6,8
29864,Gnepe,sargeras,441,priest,discipline,17,7,10
29865,Agrotothemax,tichondrius,432,priest,discipline,15,5,10
29866,Fxxkdamn,tichondrius,432,priest,discipline,21,6,15
29867,Nefastó,ragnaros,431,priest,discipline,12,6,6
29868,Frenchfries,sargeras,431,priest,discipline,11,5,6
29869,Texmix,stormrage,431,priest,discipline,21,6,15
29870,Holyshart,stonemaul,430,priest,discipline,11,5,6
29871,Leejungjae,tichondrius,426,priest,discipline,15,6,9
29872,Discshady,tichondrius,416,priest,discipline,10,5,5
29873,Mooray,thrall,415,priest,discipline,14,5,9
29874,Melsebek,stormrage,415,priest,discipline,20,5,15
29875,Elbowbeans,tichondrius,414,priest,discipline,16,5,11
29876,Esredarksun,sargeras,412,priest,discipline,16,5,11
29877,Whodatpriest,blackhand,399,priest,discipline,5,5,0
29878,Normill,bonechewer,399,priest,discipline,7,5,2
29879,Bunked,bleeding-hollow,392,priest,discipline,23,7,16
29880,Gdlsheretic,sargeras,384,priest,discipline,6,4,2
29881,Kàobeini,tichondrius,384,priest,discipline,6,4,2
29882,Zaperama,tichondrius,384,priest,discipline,6,4,2
29883,Feminizm,tichondrius,384,priest,discipline,6,4,2
29884,Jjojae,illidan,384,priest,discipline,6,4,2
29885,Sip,sargeras,384,priest,discipline,6,4,2
29886,Merçy,zuljin,384,priest,discipline,6,4,2
29887,Calamithus,illidan,384,priest,discipline,6,4,2
29888,Soupbeanx,zuljin,384,priest,discipline,6,4,2
29889,Dredgeflay,thrall,384,priest,discipline,6,4,2
29890,Yunggawd,illidan,384,priest,discipline,6,4,2
29891,Pprriieesst,tichondrius,384,priest,discipline,6,4,2
29892,Granger,senjin,384,priest,discipline,6,4,2
29893,Deathrina,moon-guard,384,priest,discipline,6,4,2
29894,Leebow,tichondrius,384,priest,discipline,6,4,2
29895,Miniambá,tichondrius,384,priest,discipline,6,4,2
29896,Ranthrough,tichondrius,384,priest,discipline,6,4,2
29897,Acenthe,sargeras,384,priest,discipline,6,4,2
29898,Chü,dalaran,384,priest,discipline,6,4,2
29899,Rillding,tichondrius,384,priest,discipline,6,4,2
29900,Fûsoya,zuljin,384,priest,discipline,6,4,2
29901,Dimedaddy,tichondrius,384,priest,discipline,6,4,2
29902,Béépboop,tichondrius,384,priest,discipline,6,4,2
29903,Sevros,moon-guard,384,priest,discipline,6,4,2
29904,Tomp,tichondrius,384,priest,discipline,6,4,2
29905,Vyndïllïn,tichondrius,384,priest,discipline,6,4,2
29906,Vladlèna,moon-guard,384,priest,discipline,6,4,2
29907,Scalpell,tichondrius,384,priest,discipline,6,4,2
29908,Gardiancloun,sargeras,384,priest,discipline,6,4,2
29909,Nightheals,sargeras,384,priest,discipline,6,4,2
29910,Dioecesis,moon-guard,384,priest,discipline,6,4,2
29911,Goobiesz,tichondrius,384,priest,discipline,6,4,2
29912,Myds,sargeras,384,priest,discipline,6,4,2
29913,Lavigne,tichondrius,384,priest,discipline,6,4,2
29914,Crode,bleeding-hollow,384,priest,discipline,6,4,2
29915,Nordheal,stormrage,384,priest,discipline,6,4,2
29916,Babygsuss,tichondrius,384,priest,discipline,6,4,2
29917,Remuni,tichondrius,384,priest,discipline,6,4,2
29918,Jaxthree,illidan,384,priest,discipline,6,4,2
29919,Discotec,stormrage,384,priest,discipline,6,4,2
29920,Fadedyourgo,tichondrius,384,priest,discipline,6,4,2
29921,Pillböx,tichondrius,384,priest,discipline,6,4,2
29922,Orisons,bleeding-hollow,384,priest,discipline,6,4,2
29923,Monkeyp,barthilas,384,priest,discipline,6,4,2
29924,Brácho,ragnaros,384,priest,discipline,6,4,2
29925,Rahmynpriest,tichondrius,384,priest,discipline,6,4,2
29926,Djchickpea,chogall,384,priest,discipline,6,4,2
29927,Altari,whisperwind,384,priest,discipline,6,4,2
29928,Subscribe,khazgoroth,384,priest,discipline,6,4,2
29929,Chemdawwg,aerie-peak,384,priest,discipline,6,4,2
29930,Crueldotz,illidan,384,priest,discipline,6,4,2
29931,Uglydiego,quelthalas,384,priest,discipline,6,4,2
29932,Celanea,bleeding-hollow,384,priest,discipline,6,4,2
29933,Bubbleboi,malganis,384,priest,discipline,6,4,2
29934,Lithelin,frostmourne,384,priest,discipline,6,4,2
29935,Goatedpriest,kelthuzad,384,priest,discipline,6,4,2
29936,Frymii,frostmourne,384,priest,discipline,6,4,2
29937,Batface,frostmourne,384,priest,discipline,6,4,2
29938,Lebanese,frostmourne,384,priest,discipline,6,4,2
29939,Onipapae,frostmourne,384,priest,discipline,6,4,2
29940,Optimism,frostmane,384,priest,discipline,6,4,2
29941,Packa,khaz-modan,384,priest,discipline,6,4,2
29942,Gomer,stormrage,384,priest,discipline,6,4,2
29943,Tristanp,frostmourne,384,priest,discipline,6,4,2
29944,Celani,gilneas,384,priest,discipline,6,4,2
29945,Febronia,aerie-peak,384,priest,discipline,6,4,2
29946,Blzy,area-52,384,priest,discipline,6,4,2
29947,Zhanay,ragnaros,384,priest,discipline,6,4,2
29948,Metéora,nemesis,384,priest,discipline,6,4,2
29949,Ðyluxx,blackwater-raiders,384,priest,discipline,6,4,2
29950,Goyqqp,illidan,384,priest,discipline,6,4,2
29951,Papaheal,runetotem,384,priest,discipline,6,4,2
29952,Rïshloo,ragnaros,384,priest,discipline,6,4,2
29953,Gnomelester,kiljaeden,384,priest,discipline,6,4,2
29954,Rmpenjoyerx,area-52,384,priest,discipline,6,4,2
29955,Dinar,tichondrius,384,priest,discipline,6,4,2
29956,Spyderco,mugthol,384,priest,discipline,6,4,2
29957,Noopnoop,burning-blade,384,priest,discipline,6,4,2
29958,Faithx,frostmourne,384,priest,discipline,6,4,2
29959,Chambler,aegwynn,384,priest,discipline,6,4,2
29960,Hiphopanomis,arthas,384,priest,discipline,6,4,2
29961,Flaytality,shadowsong,384,priest,discipline,6,4,2
29962,Ruems,area-52,384,priest,discipline,6,4,2
29963,Demongodtren,blackrock,384,priest,discipline,6,4,2
29964,Tosbanned,barthilas,384,priest,discipline,6,4,2
29965,Balikina,stormrage,384,priest,discipline,6,4,2
29966,Ritalyn,korgath,384,priest,discipline,6,4,2
29967,Äni,sargeras,384,priest,discipline,6,4,2
29968,Gregorovich,ragnaros,384,priest,discipline,6,4,2
29969,Popeachini,sargeras,384,priest,discipline,6,4,2
29970,Stepbrohelp,barthilas,384,priest,discipline,6,4,2
29971,Potatopriest,frostmourne,384,priest,discipline,6,4,2
29972,Jixxersp,malganis,384,priest,discipline,6,4,2
29973,Mettypws,tichondrius,384,priest,discipline,6,4,2
29974,Aguavenditaa,quelthalas,384,priest,discipline,6,4,2
29975,Runnow,area-52,384,priest,discipline,6,4,2
29976,Wilita,drakkari,384,priest,discipline,6,4,2
29977,Pandaniaco,drakkari,384,priest,discipline,6,4,2
29978,Kwazshell,area-52,384,priest,discipline,7,4,3
29979,Shadp,tichondrius,384,priest,discipline,9,5,4
29980,Cruces,malorne,384,priest,discipline,9,4,5
29981,Brodel,dark-iron,384,priest,discipline,9,4,5
29982,Poonanixo,gundrak,384,priest,discipline,10,4,6
29983,Nvøsuperstar,zuljin,384,priest,discipline,15,5,10
29984,Srazul,azralon,384,priest,discipline,12,4,8
29985,Ollarlamente,zuljin,384,priest,discipline,12,4,8
29986,Eilana,tichondrius,384,priest,discipline,12,4,8
29987,Valzzdor,zuljin,384,priest,discipline,12,4,8
29988,Jonahas,sargeras,384,priest,discipline,12,4,8
29989,Seyler,barthilas,384,priest,discipline,12,4,8
29990,Akewnón,stormrage,384,priest,discipline,12,4,8
29991,Lankyschlong,frostmourne,384,priest,discipline,12,4,8
29992,Ophailea,thrall,384,priest,discipline,12,4,8
29993,Suzono,hyjal,384,priest,discipline,12,4,8
29994,Dirtydogma,zuljin,384,priest,discipline,12,4,8
29995,Ranksix,area-52,384,priest,discipline,12,4,8
29996,Larisa,moon-guard,384,priest,discipline,12,4,8
29997,Covfefe,draka,384,priest,discipline,12,4,8
29998,Barclan,destromath,384,priest,discipline,12,4,8
29999,Exisa,stormrage,384,priest,discipline,12,4,8
30000,Billiard,stormrage,384,priest,discipline,12,4,8
30001,Vyvivienx,tichondrius,384,priest,discipline,12,4,8
30002,Lucet,aegwynn,384,priest,discipline,12,4,8
30003,Chaxiubao,stormrage,384,priest,discipline,12,4,8
30004,Zaylahh,blackrock,384,priest,discipline,12,4,8
30005,Danceofpales,bleeding-hollow,384,priest,discipline,12,4,8
30006,Ritzien,jubeithos,384,priest,discipline,12,4,8
30007,Thotsteal,lightbringer,384,priest,discipline,12,4,8
30008,Echoos,proudmoore,384,priest,discipline,12,4,8
30009,Killä,area-52,384,priest,discipline,12,4,8
30010,Kuppel,tichondrius,384,priest,discipline,12,4,8
30011,Stonemonkeyp,sargeras,384,priest,discipline,12,4,8
30012,Spøokz,stormreaver,384,priest,discipline,12,4,8
30013,Touchèr,sargeras,384,priest,discipline,12,4,8
30014,Haruspex,azralon,384,priest,discipline,12,4,8
30015,Jejer,moon-guard,384,priest,discipline,12,4,8
30016,Revolki,azralon,384,priest,discipline,12,4,8
30017,Nokhoron,eldrethalas,384,priest,discipline,12,4,8
30018,Littlean,frostmourne,384,priest,discipline,12,4,8
30019,Zaphfkiel,ragnaros,384,priest,discipline,12,4,8
30020,Pearlwing,area-52,384,priest,discipline,12,4,8
30021,Gothmidget,illidan,384,priest,discipline,12,4,8
30022,Ludens,bleeding-hollow,384,priest,discipline,12,4,8
30023,Holynova,nerzhul,384,priest,discipline,12,4,8
30024,Disperse,sargeras,384,priest,discipline,12,4,8
30025,Tangykiwi,dalaran,384,priest,discipline,12,4,8
30026,Kikyo,antonidas,384,priest,discipline,12,4,8
30027,Amys,kargath,384,priest,discipline,12,4,8
30028,Mosarra,agamaggan,384,priest,discipline,12,4,8
30029,Healbilli,archimonde,384,priest,discipline,12,4,8
30030,Darkspearr,tichondrius,384,priest,discipline,12,4,8
30031,Stilgeist,proudmoore,384,priest,discipline,12,4,8
30032,Butdidudied,sargeras,384,priest,discipline,12,4,8
30033,Auttø,area-52,384,priest,discipline,12,4,8
30034,Gooseundead,tichondrius,384,priest,discipline,12,4,8
30035,Holyshiitzz,illidan,384,priest,discipline,12,4,8
30036,Kepptwo,korgath,384,priest,discipline,12,4,8
30037,Laqqet,sargeras,384,priest,discipline,12,4,8
30038,Wìd,khazgoroth,384,priest,discipline,12,4,8
30039,Slenden,illidan,384,priest,discipline,12,4,8
30040,Daryldeath,tichondrius,384,priest,discipline,12,4,8
30041,Pontiffvelen,area-52,384,priest,discipline,12,4,8
30042,Sìrena,tichondrius,384,priest,discipline,12,4,8
30043,Biop,burning-blade,384,priest,discipline,12,4,8
30044,Skydemons,malganis,384,priest,discipline,12,4,8
30045,Plebiss,burning-blade,384,priest,discipline,12,4,8
30046,Dabrat,darkspear,384,priest,discipline,12,4,8
30047,Karmapi,malganis,384,priest,discipline,12,4,8
30048,Vampriest,frostmourne,384,priest,discipline,13,4,9
30049,Discpi,illidan,384,priest,discipline,13,4,9
30050,Kibariyb,drakkari,384,priest,discipline,18,4,14
30051,Kymohek,sargeras,384,priest,discipline,18,4,14
30052,Mucgib,frostmourne,384,priest,discipline,18,4,14
30053,Polythis,kelthuzad,384,priest,discipline,18,4,14
30054,Rainms,sargeras,384,priest,discipline,18,4,14
30055,Xiaozhui,tichondrius,384,priest,discipline,18,4,14
30056,Disçxrespeçt,cairne,384,priest,discipline,18,4,14
30057,Vikingkøng,ragnaros,384,priest,discipline,18,4,14
30058,Shadowdroid,tichondrius,384,priest,discipline,18,4,14
30059,Heilige,uldum,384,priest,discipline,24,4,20
30060,Jonnycanuckz,duskwood,383,priest,discipline,6,4,2
30061,Gabrieleron,quelthalas,383,priest,discipline,6,4,2
30062,Fanaeth,arathor,383,priest,discipline,6,4,2
30063,Discodork,bleeding-hollow,383,priest,discipline,6,4,2
30064,Mirex,tichondrius,383,priest,discipline,6,4,2
30065,Lifesavér,tichondrius,383,priest,discipline,6,4,2
30066,Needalung,stormrage,383,priest,discipline,6,4,2
30067,Darthvalak,illidan,383,priest,discipline,6,4,2
30068,Coorslite,proudmoore,383,priest,discipline,6,4,2
30069,Shén,barthilas,383,priest,discipline,6,4,2
30070,Sybal,suramar,383,priest,discipline,12,4,8
30071,Mangaloochi,amanthul,383,priest,discipline,12,4,8
30072,Whatisholy,bleeding-hollow,383,priest,discipline,12,4,8
30073,Cyberpriest,stormrage,383,priest,discipline,12,4,8
30074,Sihua,illidan,383,priest,discipline,12,4,8
30075,Fathergrey,emerald-dream,383,priest,discipline,12,4,8
30076,Nikasaur,azgalor,383,priest,discipline,12,4,8
30077,Uckuck,illidan,383,priest,discipline,12,4,8
30078,Anoxic,kiljaeden,383,priest,discipline,12,4,8
30079,Nocturnimal,grizzly-hills,382,priest,discipline,12,4,8
30080,Väin,proudmoore,381,priest,discipline,12,4,8
30081,Bunnychloe,sargeras,381,priest,discipline,12,4,8
30082,Touchedbygud,frostmourne,381,priest,discipline,12,4,8
30083,Divinebones,gurubashi,381,priest,discipline,12,4,8
30084,Primela,sargeras,381,priest,discipline,12,4,8
30085,Shenanigans,illidan,367,priest,discipline,11,4,7
30086,Burtier,zuljin,367,priest,discipline,11,4,7
30087,Llaarrkkss,tichondrius,351,priest,discipline,11,4,7
30088,Scrïpt,thaurissan,351,priest,discipline,11,4,7
30089,Kuwapre,proudmoore,336,priest,discipline,9,5,4
30090,Proftimothy,tichondrius,336,priest,discipline,9,5,4
30091,Elliepls,tichondrius,336,priest,discipline,9,4,5
30092,Rosabell,ragnaros,336,priest,discipline,21,4,17
30093,Grianné,mannoroth,335,priest,discipline,9,4,5
30094,Causeoflife,eitrigg,335,priest,discipline,11,4,7
30095,Siobhin,wyrmrest-accord,335,priest,discipline,11,4,7
30096,Subvert,zuljin,330,priest,discipline,7,5,2
30097,Tmnaarcanttv,tichondrius,330,priest,discipline,7,5,2
30098,Lolkwtf,sargeras,330,priest,discipline,14,6,8
30099,Prayanmantis,tichondrius,330,priest,discipline,14,5,9
30100,Xiangjiao,tichondrius,330,priest,discipline,17,6,11
30101,Takedisdisc,tichondrius,330,priest,discipline,17,6,11
30102,Lilgeek,kelthuzad,330,priest,discipline,21,5,16
30103,Maccten,tichondrius,319,priest,discipline,9,5,4
30104,Smarttakka,emerald-dream,319,priest,discipline,8,4,4
30105,Leviosa,bleeding-hollow,319,priest,discipline,8,4,4
30106,Manachai,the-forgotten-coast,319,priest,discipline,14,4,10
30107,Klizzy,tichondrius,319,priest,discipline,14,4,10
30108,Rancidcookie,tichondrius,304,priest,discipline,13,4,9
30109,Educated,tichondrius,303,priest,discipline,20,4,16
30110,Unagidrop,malganis,288,priest,discipline,6,3,3
30111,Numinous,wyrmrest-accord,288,priest,discipline,6,3,3
30112,Krewed,ravencrest,288,priest,discipline,6,3,3
30113,Madalôn,nemesis,288,priest,discipline,6,3,3
30114,Mesuki,malganis,288,priest,discipline,6,3,3
30115,Bestworldxz,illidan,288,priest,discipline,6,3,3
30116,Zaradomin,kelthuzad,288,priest,discipline,6,3,3
30117,Mks,barthilas,288,priest,discipline,6,3,3
30118,Fure,mannoroth,288,priest,discipline,6,3,3
30119,Îcecube,sargeras,288,priest,discipline,6,3,3
30120,Killduran,hellscream,288,priest,discipline,6,3,3
30121,Seyvyur,black-dragonflight,288,priest,discipline,6,3,3
30122,Laneska,stormrage,288,priest,discipline,6,3,3
30123,Anzulupriest,alexstrasza,288,priest,discipline,6,3,3
30124,Synthas,tichondrius,288,priest,discipline,6,3,3
30125,Kaiah,gorefiend,288,priest,discipline,6,3,3
30126,Lovetotouch,malganis,288,priest,discipline,6,3,3
30127,Merylstreepz,illidan,288,priest,discipline,6,3,3
30128,Dudurr,zuluhed,288,priest,discipline,6,3,3
30129,Nokizzgrizz,sargeras,288,priest,discipline,6,3,3
30130,Eiricka,kelthuzad,288,priest,discipline,6,3,3
30131,Damushi,frostmourne,288,priest,discipline,6,3,3
30132,Alleviate,frostmourne,288,priest,discipline,6,3,3
30133,Barackhobama,malganis,288,priest,discipline,6,3,3
30134,Healyhaney,stormrage,288,priest,discipline,6,3,3
30135,Kabutta,stormrage,288,priest,discipline,6,3,3
30136,Mellisonant,stormrage,288,priest,discipline,6,3,3
30137,Quefase,proudmoore,288,priest,discipline,6,3,3
30138,Magicbus,blackrock,288,priest,discipline,6,3,3
30139,Pwrwordthicc,illidan,288,priest,discipline,6,3,3
30140,Skyfury,darkspear,288,priest,discipline,6,3,3
30141,Illiteratex,sargeras,288,priest,discipline,6,3,3
30142,Kleiâ,tichondrius,288,priest,discipline,6,3,3
30143,Nikci,tichondrius,288,priest,discipline,6,3,3
30144,Drewsies,anvilmar,288,priest,discipline,6,3,3
30145,Kelody,zuljin,288,priest,discipline,6,3,3
30146,Frye,bleeding-hollow,288,priest,discipline,6,3,3
30147,Durgen,stormreaver,288,priest,discipline,6,3,3
30148,Edmen,stormrage,288,priest,discipline,6,3,3
30149,Heratic,malganis,288,priest,discipline,6,3,3
30150,Grafîx,frostmourne,288,priest,discipline,6,3,3
30151,Drrunk,bleeding-hollow,288,priest,discipline,6,3,3
30152,Kirigäya,quelthalas,288,priest,discipline,6,3,3
30153,Sölei,tichondrius,288,priest,discipline,6,3,3
30154,Kaldoon,azjolnerub,288,priest,discipline,6,3,3
30155,Diskope,kelthuzad,288,priest,discipline,6,3,3
30156,Imagees,stormscale,288,priest,discipline,6,3,3
30157,Oofx,darkspear,288,priest,discipline,6,3,3
30158,Xuxu,frostmourne,288,priest,discipline,6,3,3
30159,Germanica,area-52,288,priest,discipline,6,3,3
30160,Iamsatan,illidan,288,priest,discipline,6,3,3
30161,Tarwow,moon-guard,288,priest,discipline,6,3,3
30162,Bambi,dunemaul,288,priest,discipline,6,3,3
30163,Ayoheals,zuljin,288,priest,discipline,6,3,3
30164,Ææae,nemesis,288,priest,discipline,6,3,3
30165,Animityz,illidan,288,priest,discipline,6,3,3
30166,Oxicontin,sargeras,288,priest,discipline,6,3,3
30167,Popeofhope,queldorei,288,priest,discipline,6,3,3
30168,Strokingmydx,illidan,288,priest,discipline,6,3,3
30169,Vìxèn,zuljin,288,priest,discipline,6,3,3
30170,Midget,darkspear,288,priest,discipline,6,3,3
30171,Powerchucha,area-52,288,priest,discipline,6,3,3
30172,Mongatzuya,illidan,288,priest,discipline,6,3,3
30173,Triazolam,illidan,288,priest,discipline,6,3,3
30174,Yogosun,dalaran,288,priest,discipline,6,3,3
30175,Bigpoppapwn,darkspear,288,priest,discipline,6,3,3
30176,Hopenä,dragonmaw,288,priest,discipline,6,3,3
30177,Wakandafev,frostmourne,288,priest,discipline,6,3,3
30178,Relianth,stormrage,288,priest,discipline,6,3,3
30179,Thattpriest,thrall,288,priest,discipline,6,3,3
30180,Calcifer,drakkari,288,priest,discipline,6,3,3
30181,Xusin,tichondrius,288,priest,discipline,6,3,3
30182,Zugzugheal,bleeding-hollow,288,priest,discipline,6,3,3
30183,Ellipsiz,area-52,288,priest,discipline,6,3,3
30184,Zuuji,frostmourne,288,priest,discipline,6,3,3
30185,Tmall,tichondrius,288,priest,discipline,6,3,3
30186,Kelime,azralon,288,priest,discipline,6,3,3
30187,Kallenk,proudmoore,288,priest,discipline,6,3,3
30188,Justinagnpr,tichondrius,288,priest,discipline,6,3,3
30189,Idhealthat,tichondrius,288,priest,discipline,6,3,3
30190,Spiritbear,thrall,288,priest,discipline,6,3,3
30191,Kakera,tichondrius,288,priest,discipline,6,3,3
30192,Illegalkill,tichondrius,288,priest,discipline,6,3,3
30193,Éxploït,tichondrius,288,priest,discipline,6,3,3
30194,Namecusein,ragnaros,288,priest,discipline,6,3,3
30195,Dradinx,illidan,288,priest,discipline,6,3,3
30196,Nutdrip,tichondrius,288,priest,discipline,6,3,3
30197,Hellokuti,silvermoon,288,priest,discipline,6,3,3
30198,Serenderpity,moon-guard,288,priest,discipline,6,3,3
30199,Psyfriend,area-52,288,priest,discipline,6,3,3
30200,Àneres,illidan,288,priest,discipline,6,3,3
30201,Wiseguise,illidan,288,priest,discipline,6,3,3
30202,Babburger,tichondrius,288,priest,discipline,6,3,3
30203,Tempname,thunderhorn,288,priest,discipline,6,3,3
30204,Buc,barthilas,288,priest,discipline,6,3,3
30205,Nyxvoid,ragnaros,288,priest,discipline,6,3,3
30206,Lyriczx,kelthuzad,288,priest,discipline,6,3,3
30207,Banepriest,sargeras,288,priest,discipline,6,3,3
30208,Adelda,nazjatar,288,priest,discipline,6,3,3
30209,Puritykitty,zuljin,288,priest,discipline,6,3,3
30210,Jinzp,area-52,288,priest,discipline,6,3,3
30211,Nellìel,whisperwind,288,priest,discipline,6,3,3
30212,Kiazma,zuljin,288,priest,discipline,6,3,3
30213,Sabene,greymane,288,priest,discipline,6,3,3
30214,Khaospriest,proudmoore,288,priest,discipline,6,3,3
30215,Nevermyndz,bleeding-hollow,288,priest,discipline,6,3,3
30216,Dredre,aggramar,288,priest,discipline,6,3,3
30217,Ìdiot,saurfang,288,priest,discipline,6,3,3
30218,Amoureuxz,bleeding-hollow,288,priest,discipline,6,3,3
30219,Lostnthought,aggramar,288,priest,discipline,6,3,3
30220,Swinee,tichondrius,288,priest,discipline,6,3,3
30221,Paradoxbot,kelthuzad,288,priest,discipline,6,3,3
30222,Awesomeguyx,tichondrius,288,priest,discipline,6,3,3
30223,Hükk,kalecgos,288,priest,discipline,6,3,3
30224,Kujoh,tichondrius,288,priest,discipline,6,3,3
30225,Eirana,skywall,288,priest,discipline,6,3,3
30226,Bgundy,sargeras,288,priest,discipline,6,3,3
30227,Sivamint,aerie-peak,288,priest,discipline,6,3,3
30228,Empyreanlite,dalaran,288,priest,discipline,6,3,3
30229,Alladys,shattered-hand,288,priest,discipline,6,3,3
30230,Pzx,zuljin,288,priest,discipline,6,3,3
30231,Alucardibee,turalyon,288,priest,discipline,6,3,3
30232,Burgersl,illidan,288,priest,discipline,6,3,3
30233,Imb,nagrand,288,priest,discipline,6,3,3
30234,Nazgúl,lothar,288,priest,discipline,6,3,3
30235,Bessias,area-52,288,priest,discipline,6,3,3
30236,Humps,sargeras,288,priest,discipline,6,3,3
30237,Umbramortìs,tichondrius,288,priest,discipline,6,3,3
30238,Magazíne,tichondrius,288,priest,discipline,6,3,3
30239,Boogiê,illidan,288,priest,discipline,6,3,3
30240,Sterycraiied,stormreaver,288,priest,discipline,6,3,3
30241,Huckdaddy,tichondrius,288,priest,discipline,6,3,3
30242,Swollenarms,kiljaeden,288,priest,discipline,6,3,3
30243,Chowdä,kiljaeden,288,priest,discipline,6,3,3
30244,Diamondz,emerald-dream,288,priest,discipline,6,3,3
30245,Moirâ,silvermoon,288,priest,discipline,6,3,3
30246,Mindmelts,gallywix,288,priest,discipline,6,3,3
30247,Trezz,aegwynn,288,priest,discipline,6,3,3
30248,Aspéct,aegwynn,288,priest,discipline,6,3,3
30249,Dìngobaby,stormrage,288,priest,discipline,6,3,3
30250,Sassygayboyx,bleeding-hollow,288,priest,discipline,6,3,3
30251,Sæýfír,illidan,288,priest,discipline,6,3,3
30252,Asleep,sargeras,288,priest,discipline,6,3,3
30253,Kefkå,sargeras,288,priest,discipline,6,3,3
30254,Liminality,illidan,288,priest,discipline,6,3,3
30255,Haedn,azralon,288,priest,discipline,6,3,3
30256,Filthmaster,moon-guard,288,priest,discipline,6,3,3
30257,Sandreth,bonechewer,288,priest,discipline,6,3,3
30258,Minzyx,tichondrius,288,priest,discipline,6,3,3
30259,Pics,emerald-dream,288,priest,discipline,6,3,3
30260,Wale,akama,288,priest,discipline,6,3,3
30261,Sophistdew,proudmoore,288,priest,discipline,6,3,3
30262,Dorlala,tichondrius,288,priest,discipline,6,3,3
30263,Thenamesnorm,tichondrius,288,priest,discipline,6,3,3
30264,Roseriela,moon-guard,288,priest,discipline,6,3,3
30265,Ichheilen,thrall,288,priest,discipline,6,3,3
30266,Havefaith,whisperwind,288,priest,discipline,6,3,3
30267,Deezdotz,alterac-mountains,288,priest,discipline,6,3,3
30268,Lifeswaplol,kelthuzad,288,priest,discipline,6,3,3
30269,Shelfedelf,gurubashi,288,priest,discipline,6,3,3
30270,Pumpkinpino,stormrage,288,priest,discipline,6,3,3
30271,Callèèn,stormrage,288,priest,discipline,6,3,3
30272,Rotnn,thrall,288,priest,discipline,6,3,3
30273,Vanzera,thrall,288,priest,discipline,6,3,3
30274,Zzavidwong,tichondrius,288,priest,discipline,6,3,3
30275,Shadowform,illidan,288,priest,discipline,6,3,3
30276,Elise,ravenholdt,288,priest,discipline,6,3,3
30277,Decastro,silvermoon,288,priest,discipline,6,3,3
30278,Furydos,zuljin,288,priest,discipline,6,3,3
30279,Tubshark,moon-guard,288,priest,discipline,6,3,3
30280,Crazyfinley,dalaran,288,priest,discipline,6,3,3
30281,Fausto,kiljaeden,288,priest,discipline,6,3,3
30282,Ashidox,proudmoore,288,priest,discipline,6,3,3
30283,Keyohh,tichondrius,288,priest,discipline,6,3,3
30284,Methandrial,hyjal,288,priest,discipline,6,3,3
30285,Donkeycube,tichondrius,288,priest,discipline,6,3,3
30286,Fouroneo,tichondrius,288,priest,discipline,6,3,3
30287,Sasagui,bloodscalp,288,priest,discipline,6,3,3
30288,Fackinheals,kelthuzad,288,priest,discipline,6,3,3
30289,Ìhatermp,tichondrius,288,priest,discipline,6,3,3
30290,Poøpoopeepee,tichondrius,288,priest,discipline,6,3,3
30291,Zegron,rexxar,288,priest,discipline,6,3,3
30292,Kawesha,emerald-dream,288,priest,discipline,6,3,3
30293,Aia,frostwolf,288,priest,discipline,6,3,3
30294,Mindgamez,stormreaver,288,priest,discipline,6,3,3
30295,Dumbthott,illidan,288,priest,discipline,6,3,3
30296,Maniacx,stormrage,288,priest,discipline,6,3,3
30297,Chervz,chogall,288,priest,discipline,6,3,3
30298,Bubblejunkie,lethon,288,priest,discipline,9,4,5
30299,Whackagnome,kelthuzad,288,priest,discipline,9,4,5
30300,Waterßoÿ,emerald-dream,288,priest,discipline,9,4,5
30301,Onegil,tichondrius,288,priest,discipline,7,3,4
30302,Catboynahj,dalaran,288,priest,discipline,8,3,5
30303,Atheistbtw,sargeras,288,priest,discipline,16,5,11
30304,Zodiá,dentarg,288,priest,discipline,14,4,10
30305,Nogetget,frostmourne,288,priest,discipline,12,3,9
30306,Quartzolio,azralon,288,priest,discipline,12,3,9
30307,Phantoms,moon-guard,288,priest,discipline,12,3,9
30308,Kustem,tichondrius,288,priest,discipline,12,3,9
30309,Die,crushridge,288,priest,discipline,12,3,9
30310,Toppers,bladefist,288,priest,discipline,12,3,9
30311,Jahratu,tichondrius,288,priest,discipline,12,3,9
30312,Disconelf,barthilas,288,priest,discipline,12,3,9
30313,Lavéy,ragnaros,288,priest,discipline,12,3,9
30314,Paztech,arthas,288,priest,discipline,12,3,9
30315,Pedialyte,kiljaeden,288,priest,discipline,12,3,9
30316,Devili,wyrmrest-accord,288,priest,discipline,12,3,9
30317,Dumplolz,quelthalas,288,priest,discipline,12,3,9
30318,Snupyfangirl,area-52,288,priest,discipline,12,3,9
30319,Gwenoviere,whisperwind,288,priest,discipline,12,3,9
30320,Bree,area-52,288,priest,discipline,12,3,9
30321,Abefromann,sargeras,288,priest,discipline,12,3,9
30322,Doomageddon,thorium-brotherhood,288,priest,discipline,12,3,9
30323,Aaxahfon,moon-guard,288,priest,discipline,12,3,9
30324,Manaburnout,blackhand,288,priest,discipline,12,3,9
30325,Twohpriest,aerie-peak,288,priest,discipline,12,3,9
30326,Zemms,tichondrius,288,priest,discipline,12,3,9
30327,Spampws,aerie-peak,288,priest,discipline,12,3,9
30328,Arkathus,stormrage,288,priest,discipline,12,3,9
30329,Bewbeez,fizzcrank,288,priest,discipline,12,3,9
30330,Shattgreen,malganis,288,priest,discipline,12,3,9
30331,Virydian,stormrage,288,priest,discipline,12,3,9
30332,Xìdís,vashj,288,priest,discipline,12,3,9
30333,Hail,kaelthas,288,priest,discipline,12,3,9
30334,Vandi,moon-guard,288,priest,discipline,12,3,9
30335,Phillyrivers,area-52,288,priest,discipline,12,3,9
30336,Bån,ragnaros,288,priest,discipline,12,3,9
30337,Willica,stormrage,288,priest,discipline,12,3,9
30338,Nsquared,illidan,288,priest,discipline,12,3,9
30339,Aoeprophet,area-52,288,priest,discipline,12,3,9
30340,Realheal,tichondrius,288,priest,discipline,12,3,9
30341,Xalatath,stormrage,288,priest,discipline,12,3,9
30342,Hokon,tortheldrin,288,priest,discipline,12,3,9
30343,Lovebbw,sargeras,288,priest,discipline,12,3,9
30344,Fitzop,frostmourne,288,priest,discipline,12,3,9
30345,Lightshizzle,illidan,288,priest,discipline,12,3,9
30346,Awøaqexs,area-52,288,priest,discipline,12,3,9
30347,Chaddadbod,emerald-dream,288,priest,discipline,12,3,9
30348,Asmitä,stormrage,288,priest,discipline,12,3,9
30349,Itha,illidan,288,priest,discipline,12,3,9
30350,Soleyxo,frostmourne,288,priest,discipline,12,3,9
30351,Googus,bleeding-hollow,288,priest,discipline,12,3,9
30352,Gloomswrath,illidan,288,priest,discipline,12,3,9
30353,Ricxaw,frostmourne,288,priest,discipline,12,3,9
30354,Skimpdubs,bleeding-hollow,288,priest,discipline,12,3,9
30355,Slackinhealz,thrall,288,priest,discipline,12,3,9
30356,Kurnak,arthas,288,priest,discipline,12,3,9
30357,Muriaticacid,tichondrius,288,priest,discipline,12,3,9
30358,Km,zuljin,288,priest,discipline,12,3,9
30359,Decokim,tichondrius,288,priest,discipline,12,3,9
30360,Ophindrip,zuljin,288,priest,discipline,12,3,9
30361,Phantøms,zuljin,288,priest,discipline,12,3,9
30362,Krewtoo,illidan,288,priest,discipline,12,3,9
30363,Solestro,malganis,288,priest,discipline,12,3,9
30364,Chirho,malganis,288,priest,discipline,18,3,15
30365,Pravant,illidan,288,priest,discipline,18,3,15
30366,Selson,stormrage,288,priest,discipline,18,3,15
30367,Imgold,emerald-dream,287,priest,discipline,6,3,3
30368,Wobbleskank,tichondrius,287,priest,discipline,6,3,3
30369,Solzal,korgath,287,priest,discipline,6,3,3
30370,Kagayaku,aegwynn,287,priest,discipline,12,3,9
30371,Zarakih,azralon,287,priest,discipline,12,3,9
30372,Priestkofwa,tichondrius,287,priest,discipline,12,3,9
30373,Dorkulous,wyrmrest-accord,287,priest,discipline,12,3,9
30374,Zanyp,akama,287,priest,discipline,12,3,9
30375,Celticó,quelthalas,287,priest,discipline,12,3,9
30376,Zeun,spinebreaker,287,priest,discipline,18,3,15
30377,Sorros,cenarion-circle,286,priest,discipline,6,3,3
30378,Kataró,tichondrius,286,priest,discipline,12,3,9
30379,Álûcard,illidan,256,priest,discipline,7,4,3
30380,Kagura,dunemaul,256,priest,discipline,22,3,19
30381,Poodledad,wyrmrest-accord,255,priest,discipline,8,4,4
30382,Priestcarry,tichondrius,255,priest,discipline,8,4,4
30383,Toddo,trollbane,255,priest,discipline,8,4,4
30384,Plaguepumper,sargeras,255,priest,discipline,11,3,8
30385,Stormlighter,proudmoore,255,priest,discipline,11,3,8
30386,Prèèst,proudmoore,255,priest,discipline,11,3,8
30387,Imamu,tichondrius,251,priest,discipline,35,16,19
30388,Fenty,nemesis,250,priest,discipline,12,5,7
30389,Holycwap,stormrage,240,priest,discipline,9,3,6
30390,Snevini,azralon,240,priest,discipline,15,3,12
30391,Skruffles,black-dragonflight,239,priest,discipline,5,3,2
30392,Canô,quelthalas,239,priest,discipline,5,3,2
30393,Pohky,area-52,239,priest,discipline,5,3,2
30394,Taram,ragnaros,239,priest,discipline,5,3,2
30395,Murillio,moon-guard,239,priest,discipline,5,3,2
30396,Mawwt,moon-guard,239,priest,discipline,5,3,2
30397,Yumä,kiljaeden,239,priest,discipline,5,3,2
30398,Sigurdr,muradin,234,priest,discipline,10,6,4
30399,Johnnweedd,ragnaros,234,priest,discipline,8,4,4
30400,Priêsty,stormrage,234,priest,discipline,9,4,5
30401,Gloomyspp,illidan,234,priest,discipline,14,4,10
30402,Islada,illidan,233,priest,discipline,18,4,14
30403,Hycinamun,malganis,223,priest,discipline,8,3,5
30404,Wagonss,stormrage,222,priest,discipline,25,7,18
30405,Reâpêr,kelthuzad,201,priest,discipline,13,4,9
30406,Cruxave,aegwynn,201,priest,discipline,14,4,10
30407,Berzum,chogall,192,priest,discipline,4,3,1
30408,Jedrick,malganis,192,priest,discipline,4,3,1
30409,Deckx,khazgoroth,192,priest,discipline,6,4,2
30410,Notthebappo,malganis,192,priest,discipline,11,4,7
30411,Tedesq,stormrage,192,priest,discipline,9,3,6
30412,Adeston,aggramar,192,priest,discipline,9,3,6
30413,Cryptoccocus,zuljin,192,priest,discipline,6,2,4
30414,Murkqz,azralon,192,priest,discipline,6,2,4
30415,Victordaddy,illidan,192,priest,discipline,6,2,4
30416,Jpandha,azralon,192,priest,discipline,6,2,4
30417,Frojasensei,tichondrius,192,priest,discipline,6,2,4
30418,Haushauha,azralon,192,priest,discipline,6,2,4
30419,Corpsen,frostmourne,192,priest,discipline,6,2,4
30420,Tulip,frostmourne,192,priest,discipline,6,2,4
30421,Stepbroplzno,barthilas,192,priest,discipline,6,2,4
30422,Liljunky,zuljin,192,priest,discipline,6,2,4
30423,Meaning,tichondrius,192,priest,discipline,6,2,4
30424,Goatedhp,dalaran,192,priest,discipline,6,2,4
30425,Viictorea,barthilas,192,priest,discipline,6,2,4
30426,Trienolone,emerald-dream,192,priest,discipline,6,2,4
30427,Heartsblood,whisperwind,192,priest,discipline,6,2,4
30428,Keepfit,proudmoore,192,priest,discipline,6,2,4
30429,Aelap,malganis,192,priest,discipline,6,2,4
30430,Novakaynersj,anetheron,192,priest,discipline,6,2,4
30431,Hotdice,bleeding-hollow,192,priest,discipline,6,2,4
30432,Mayzal,emerald-dream,192,priest,discipline,6,2,4
30433,Jaq,altar-of-storms,192,priest,discipline,6,2,4
30434,Holyshafted,kelthuzad,192,priest,discipline,6,2,4
30435,Irixus,zuljin,192,priest,discipline,6,2,4
30436,Davedawg,emerald-dream,192,priest,discipline,6,2,4
30437,Mindgoblin,terokkar,192,priest,discipline,6,2,4
30438,Wiccano,stormrage,192,priest,discipline,6,2,4
30439,Mevix,firetree,192,priest,discipline,6,2,4
30440,Zonozan,lightnings-blade,192,priest,discipline,6,2,4
30441,Baldy,arthas,192,priest,discipline,6,2,4
30442,Verboden,kelthuzad,192,priest,discipline,6,2,4
30443,Penicilin,terokkar,192,priest,discipline,6,2,4
30444,Bigmommyxo,whisperwind,192,priest,discipline,6,2,4
30445,Faedre,smolderthorn,192,priest,discipline,6,2,4
30446,Xeroxlivee,tichondrius,192,priest,discipline,6,2,4
30447,Issaley,tichondrius,192,priest,discipline,6,2,4
30448,Kaeruz,stormrage,192,priest,discipline,6,2,4
30449,Qtpriestx,tichondrius,192,priest,discipline,6,2,4
30450,Ansgar,eonar,192,priest,discipline,6,2,4
30451,Evenly,tichondrius,192,priest,discipline,6,2,4
30452,Plaguesus,dalaran,192,priest,discipline,6,2,4
30453,Emptybody,tichondrius,192,priest,discipline,6,2,4
30454,Mattkoster,mannoroth,192,priest,discipline,6,2,4
30455,Redzwhotwo,kelthuzad,192,priest,discipline,6,2,4
30456,Roivas,bleeding-hollow,192,priest,discipline,6,2,4
30457,Ganapati,the-underbog,192,priest,discipline,6,2,4
30458,Hankspank,hakkar,192,priest,discipline,6,2,4
30459,Ocxpriest,azralon,192,priest,discipline,6,2,4
30460,Benjamints,thrall,192,priest,discipline,6,2,4
30461,Feelmydisc,bonechewer,192,priest,discipline,6,2,4
30462,Tygrr,kelthuzad,192,priest,discipline,6,2,4
30463,Infecte,illidan,192,priest,discipline,6,2,4
30464,Rbmxp,barthilas,192,priest,discipline,6,2,4
30465,Coldstone,bloodhoof,192,priest,discipline,6,2,4
30466,Stilla,kelthuzad,192,priest,discipline,6,2,4
30467,Mentiroso,kaelthas,192,priest,discipline,6,2,4
30468,Gwenholy,hakkar,192,priest,discipline,6,2,4
30469,Phatheals,norgannon,192,priest,discipline,6,2,4
30470,Hrathren,caelestrasz,192,priest,discipline,6,2,4
30471,Helorren,nagrand,192,priest,discipline,6,2,4
30472,Halloweenx,area-52,192,priest,discipline,6,2,4
30473,Dimanche,thunderlord,192,priest,discipline,6,2,4
30474,Invain,executus,192,priest,discipline,6,2,4
30475,Radikel,aerie-peak,192,priest,discipline,6,2,4
30476,Lunarras,aggramar,192,priest,discipline,6,2,4
30477,Genevieve,aggramar,192,priest,discipline,6,2,4
30478,Gstvsrrn,tichondrius,192,priest,discipline,6,2,4
30479,Zereht,ragnaros,192,priest,discipline,6,2,4
30480,Pmsñ,tichondrius,192,priest,discipline,6,2,4
30481,Anttila,ragnaros,192,priest,discipline,6,2,4
30482,Keygodx,illidan,192,priest,discipline,6,2,4
30483,Shalther,thrall,192,priest,discipline,6,2,4
30484,Noobepriest,thrall,192,priest,discipline,6,2,4
30485,Halfsorrow,tichondrius,192,priest,discipline,6,2,4
30486,Ligthsoul,ragnaros,192,priest,discipline,6,2,4
30487,Chazzwizz,area-52,192,priest,discipline,6,2,4
30488,Mindfak,bleeding-hollow,192,priest,discipline,6,2,4
30489,Apparìtions,khazgoroth,192,priest,discipline,6,2,4
30490,Vivø,nemesis,192,priest,discipline,6,2,4
30491,Shadowpáin,ragnaros,192,priest,discipline,6,2,4
30492,Xedus,mannoroth,192,priest,discipline,6,2,4
30493,Quasenada,stormrage,192,priest,discipline,6,2,4
30494,Qnarisha,tichondrius,192,priest,discipline,6,2,4
30495,Visìons,tichondrius,192,priest,discipline,6,2,4
30496,Dinkk,stormrage,192,priest,discipline,6,2,4
30497,Dontpvponme,illidan,192,priest,discipline,6,2,4
30498,Patagoniabae,kelthuzad,192,priest,discipline,6,2,4
30499,Brazen,emerald-dream,192,priest,discipline,6,2,4
30500,Darkhel,stormrage,192,priest,discipline,6,2,4
30501,Stiffmeister,bleeding-hollow,192,priest,discipline,6,2,4
30502,Holytipz,stormrage,192,priest,discipline,6,2,4
30503,Budheals,spirestone,192,priest,discipline,6,2,4
30504,Saenax,area-52,192,priest,discipline,6,2,4
30505,Aurilain,emerald-dream,192,priest,discipline,6,2,4
30506,Kimbeloria,bleeding-hollow,192,priest,discipline,6,2,4
30507,Skellieman,malorne,192,priest,discipline,6,2,4
30508,Qmine,tichondrius,192,priest,discipline,6,2,4
30509,Mordaren,arthas,192,priest,discipline,6,2,4
30510,Disc,haomarush,192,priest,discipline,6,2,4
30511,Thangthangin,icecrown,192,priest,discipline,6,2,4
30512,Dilonpi,area-52,192,priest,discipline,6,2,4
30513,Zanyxx,tichondrius,192,priest,discipline,6,2,4
30514,Linaelinatia,area-52,192,priest,discipline,6,2,4
30515,Keaina,malganis,192,priest,discipline,6,2,4
30516,Riztwo,moon-guard,192,priest,discipline,6,2,4
30517,Kharahealer,scilla,192,priest,discipline,6,2,4
30518,Imcutejk,malganis,192,priest,discipline,6,2,4
30519,Çherished,stormrage,192,priest,discipline,6,2,4
30520,Psychonauts,arthas,192,priest,discipline,6,2,4
30521,Amphion,skullcrusher,192,priest,discipline,6,2,4
30522,Anthuss,illidan,192,priest,discipline,6,2,4
30523,Stinkypinkÿ,bleeding-hollow,192,priest,discipline,6,2,4
30524,Yoxxoo,tichondrius,192,priest,discipline,6,2,4
30525,Jàxx,dawnbringer,192,priest,discipline,6,2,4
30526,Skêptic,tichondrius,192,priest,discipline,6,2,4
30527,Kìttý,cenarius,192,priest,discipline,6,2,4
30528,Rickmason,frostmane,192,priest,discipline,6,2,4
30529,Snowlily,illidan,192,priest,discipline,6,2,4
30530,Insomnya,sargeras,192,priest,discipline,6,2,4
30531,Halfdeath,sargeras,192,priest,discipline,6,2,4
30532,Smallz,silvermoon,192,priest,discipline,6,2,4
30533,Bmox,borean-tundra,192,priest,discipline,6,2,4
30534,Downbadbrick,moon-guard,192,priest,discipline,6,2,4
30535,Gwendalynne,tichondrius,192,priest,discipline,6,2,4
30536,Soçks,proudmoore,192,priest,discipline,6,2,4
30537,Roshank,illidan,192,priest,discipline,6,2,4
30538,Rèvrin,sargeras,192,priest,discipline,6,2,4
30539,Járngreipr,nerzhul,192,priest,discipline,6,2,4
30540,Djratlordx,thrall,192,priest,discipline,6,2,4
30541,Krossvoid,thrall,192,priest,discipline,6,2,4
30542,Coffeek,sargeras,192,priest,discipline,6,2,4
30543,Pimeharder,tichondrius,192,priest,discipline,6,2,4
30544,Beymaxll,moon-guard,192,priest,discipline,6,2,4
30545,Templár,dalaran,192,priest,discipline,6,2,4
30546,Railly,skywall,192,priest,discipline,6,2,4
30547,Holydrop,sargeras,192,priest,discipline,6,2,4
30548,Nizama,moon-guard,192,priest,discipline,6,2,4
30549,Meowforheals,sargeras,192,priest,discipline,6,2,4
30550,Krevs,proudmoore,192,priest,discipline,6,2,4
30551,Bestwizardx,tichondrius,192,priest,discipline,6,2,4
30552,Cub,darkspear,192,priest,discipline,6,2,4
30553,Dadin,nerzhul,192,priest,discipline,6,2,4
30554,Fathersins,malganis,192,priest,discipline,6,2,4
30555,Kaldrbock,sargeras,192,priest,discipline,6,2,4
30556,Râven,proudmoore,192,priest,discipline,6,2,4
30557,Machiomora,dunemaul,192,priest,discipline,6,2,4
30558,Mhanaburn,nerzhul,192,priest,discipline,6,2,4
30559,Schadên,wyrmrest-accord,192,priest,discipline,6,2,4
30560,Djwienerbum,darkspear,192,priest,discipline,6,2,4
30561,Castholy,nordrassil,192,priest,discipline,6,2,4
30562,Bubblewrap,wyrmrest-accord,192,priest,discipline,6,2,4
30563,Príest,nordrassil,192,priest,discipline,6,2,4
30564,Ubbzy,illidan,192,priest,discipline,6,2,4
30565,Ucksy,blackrock,192,priest,discipline,6,2,4
30566,Trialla,medivh,192,priest,discipline,6,2,4
30567,Noteenurse,blackrock,192,priest,discipline,6,2,4
30568,Ôp,sargeras,192,priest,discipline,6,2,4
30569,Brokennurse,area-52,192,priest,discipline,7,2,5
30570,Lightski,thunderlord,192,priest,discipline,7,2,5
30571,Patchyemoly,frostmourne,192,priest,discipline,8,2,6
30572,Pragus,emerald-dream,192,priest,discipline,14,3,11
30573,Bolognypony,norgannon,192,priest,discipline,12,2,10
30574,Purpskuurp,malganis,192,priest,discipline,12,2,10
30575,Nudibranch,malganis,192,priest,discipline,12,2,10
30576,Deadmoron,illidan,192,priest,discipline,12,2,10
30577,Vyvanse,azuremyst,192,priest,discipline,12,2,10
30578,Sativacuity,malganis,192,priest,discipline,12,2,10
30579,Meatbaoo,tichondrius,192,priest,discipline,12,2,10
30580,Fiéstah,illidan,192,priest,discipline,12,2,10
30581,Lûdløw,kelthuzad,192,priest,discipline,12,2,10
30582,Grâfix,barthilas,192,priest,discipline,12,2,10
30583,Kuazi,frostmourne,192,priest,discipline,12,2,10
30584,Canyounaut,kelthuzad,192,priest,discipline,12,2,10
30585,Ularim,tichondrius,192,priest,discipline,12,2,10
30586,Theryan,ragnaros,192,priest,discipline,12,2,10
30587,Häle,bloodscalp,192,priest,discipline,12,2,10
30588,Skokie,area-52,192,priest,discipline,12,2,10
30589,Capixaba,stormrage,192,priest,discipline,12,2,10
30590,Toguol,stormrage,192,priest,discipline,12,2,10
30591,Weston,bleeding-hollow,192,priest,discipline,12,2,10
30592,Majiinbuu,maelstrom,192,priest,discipline,12,2,10
30593,Rewena,silver-hand,192,priest,discipline,12,2,10
30594,Jazminee,quelthalas,192,priest,discipline,12,2,10
30595,Sukora,blades-edge,192,priest,discipline,12,2,10
30596,Prilance,hyjal,192,priest,discipline,12,2,10
30597,Bilian,dalvengyr,192,priest,discipline,12,2,10
30598,Jordiest,dalaran,192,priest,discipline,12,2,10
30599,Fearward,silvermoon,192,priest,discipline,12,2,10
30600,Ergoproxy,barthilas,192,priest,discipline,18,2,16
30601,Serraphinaa,tichondrius,191,priest,discipline,6,2,4
30602,Charlie,azshara,191,priest,discipline,6,2,4
30603,Myobi,tichondrius,191,priest,discipline,6,2,4
30604,Frothyfran,icecrown,191,priest,discipline,12,2,10
30605,Gabuncher,barthilas,175,priest,discipline,11,2,9
30606,Rektinfull,bladefist,159,priest,discipline,5,2,3
30607,Azrothlol,kul-tiras,159,priest,discipline,5,2,3
30608,Priestmain,thrall,159,priest,discipline,5,2,3
30609,Venzd,illidan,159,priest,discipline,5,2,3
30610,Hotpockets,detheroc,159,priest,discipline,5,2,3
30611,Pugadin,bleeding-hollow,159,priest,discipline,5,2,3
30612,Strict,the-forgotten-coast,159,priest,discipline,5,2,3
30613,Dinogingy,lightbringer,159,priest,discipline,5,2,3
30614,Kloevu,stormrage,159,priest,discipline,5,2,3
30615,Greybearded,korgath,159,priest,discipline,5,2,3
30616,Yuhstin,sargeras,159,priest,discipline,8,3,5
30617,ßßxßß,tichondrius,144,priest,discipline,3,3,0
30618,Franku,quelthalas,143,priest,discipline,3,3,0
30619,Mesiausx,stormrage,138,priest,discipline,8,3,5
30620,Jjaeminkim,area-52,138,priest,discipline,11,4,7
30621,Dreadxshadow,stormrage,138,priest,discipline,11,4,7
30622,Desiree,emerald-dream,138,priest,discipline,13,4,9
30623,Tylennin,hyjal,138,priest,discipline,13,4,9
30624,Ariadneminos,illidan,138,priest,discipline,11,3,8
30625,Theophobe,illidan,138,priest,discipline,19,5,14
30626,Fadinglol,tichondrius,128,priest,discipline,4,2,2
30627,Dangerhealz,frostmourne,128,priest,discipline,4,2,2
30628,Strepsis,icecrown,128,priest,discipline,4,2,2
30629,Voif,proudmoore,128,priest,discipline,4,2,2
30630,Krathe,azralon,128,priest,discipline,4,2,2
30631,Holyfieldx,stormrage,127,priest,discipline,8,2,6
30632,Rustydisc,area-52,127,priest,discipline,8,2,6
30633,Allaurah,thrall,96,priest,discipline,3,2,1
30634,Juvell,illidan,96,priest,discipline,3,2,1
30635,Standback,wyrmrest-accord,96,priest,discipline,3,2,1
30636,Tmspongwo,tichondrius,96,priest,discipline,3,2,1
30637,Fades,hellscream,96,priest,discipline,6,1,5
30638,Radiance,aggramar,96,priest,discipline,6,1,5
30639,Dchi,tichondrius,96,priest,discipline,6,1,5
30640,Breathkeeper,proudmoore,96,priest,discipline,6,1,5
30641,Atzuru,ragnaros,96,priest,discipline,6,1,5
30642,Rahna,azralon,96,priest,discipline,6,1,5
30643,Dirtysline,ragnaros,96,priest,discipline,6,1,5
30644,Beanerall,quelthalas,96,priest,discipline,6,1,5
30645,Drmuhammad,sargeras,96,priest,discipline,6,1,5
30646,Tisifone,ragnaros,96,priest,discipline,6,1,5
30647,Lifejuice,tichondrius,96,priest,discipline,6,1,5
30648,Ugamie,proudmoore,96,priest,discipline,6,1,5
30649,Lzzp,azralon,96,priest,discipline,6,1,5
30650,Floofball,medivh,96,priest,discipline,6,1,5
30651,Doobzy,proudmoore,96,priest,discipline,6,1,5
30652,Halfcab,runetotem,96,priest,discipline,6,1,5
30653,Worstpriest,stormscale,96,priest,discipline,6,1,5
30654,Xiffs,malganis,96,priest,discipline,6,1,5
30655,Stunsilence,tichondrius,96,priest,discipline,6,1,5
30656,Nickerbocker,nazgrel,96,priest,discipline,6,1,5
30657,Löstský,azralon,96,priest,discipline,6,1,5
30658,Iggyp,hyjal,96,priest,discipline,6,1,5
30659,Tabzorbing,illidan,96,priest,discipline,6,1,5
30660,Kunof,ragnaros,96,priest,discipline,6,1,5
30661,Spspsp,illidan,96,priest,discipline,6,1,5
30662,Kireepilef,ragnaros,96,priest,discipline,6,1,5
30663,Ivermectin,eredar,96,priest,discipline,6,1,5
30664,Payforheals,malganis,96,priest,discipline,6,1,5
30665,Nekkz,sargeras,96,priest,discipline,6,1,5
30666,Kimmie,kelthuzad,96,priest,discipline,6,1,5
30667,Necroshine,vashj,96,priest,discipline,6,1,5
30668,Trupriest,alleria,96,priest,discipline,6,1,5
30669,Keynnish,sargeras,96,priest,discipline,6,1,5
30670,Raihn,garrosh,96,priest,discipline,6,1,5
30671,Shaylari,kelthuzad,96,priest,discipline,6,1,5
30672,Yogirabbit,kiljaeden,96,priest,discipline,6,1,5
30673,Mykillakilla,wyrmrest-accord,96,priest,discipline,6,1,5
30674,Religions,wyrmrest-accord,96,priest,discipline,6,1,5
30675,Kalakbar,tichondrius,96,priest,discipline,6,1,5
30676,Vayr,thrall,96,priest,discipline,6,1,5
30677,Lenigrast,blackrock,96,priest,discipline,6,1,5
30678,Prayforhealz,tichondrius,96,priest,discipline,6,1,5
30679,Orethon,thrall,96,priest,discipline,6,1,5
30680,Jaseyrae,emerald-dream,96,priest,discipline,6,1,5
30681,Prayboy,aerie-peak,96,priest,discipline,6,1,5
30682,Shåde,skullcrusher,96,priest,discipline,6,1,5
30683,Baerybonds,kiljaeden,96,priest,discipline,6,1,5
30684,Aeøns,sargeras,96,priest,discipline,6,1,5
30685,Mistnamed,emerald-dream,96,priest,discipline,6,1,5
30686,Gódriç,emerald-dream,96,priest,discipline,6,1,5
30687,Drkwingduckz,area-52,96,priest,discipline,6,1,5
30688,Ayzen,emerald-dream,96,priest,discipline,6,1,5
30689,Aneresxo,illidan,96,priest,discipline,6,1,5
30690,Spêc,frostmourne,96,priest,discipline,6,1,5
30691,Djriest,sargeras,96,priest,discipline,6,1,5
30692,Leach,darkspear,96,priest,discipline,6,1,5
30693,Holddacheese,area-52,96,priest,discipline,6,1,5
30694,Mynaevis,malganis,96,priest,discipline,6,1,5
30695,Púrg,frostmourne,96,priest,discipline,6,1,5
30696,Ripchadman,tichondrius,96,priest,discipline,6,1,5
30697,Mïsstres,area-52,96,priest,discipline,6,1,5
30698,Wilcarfegus,draka,96,priest,discipline,6,1,5
30699,Thh,emerald-dream,96,priest,discipline,6,1,5
30700,Trixor,area-52,96,priest,discipline,6,1,5
30701,Blosinrosin,lightbringer,96,priest,discipline,6,1,5
30702,Snotanygood,alleria,96,priest,discipline,6,1,5
30703,Soliidsnake,area-52,96,priest,discipline,6,1,5
30704,Rookieone,thrall,96,priest,discipline,6,1,5
30705,Dáhealz,tichondrius,96,priest,discipline,6,1,5
30706,Beeds,sargeras,96,priest,discipline,6,1,5
30707,Pétt,amanthul,96,priest,discipline,6,1,5
30708,Mêatpuppet,kiljaeden,96,priest,discipline,6,1,5
30709,Sukeena,malganis,96,priest,discipline,6,1,5
30710,Canklez,stormscale,96,priest,discipline,6,1,5
30711,Galice,archimonde,96,priest,discipline,6,1,5
30712,Clárke,tichondrius,96,priest,discipline,6,1,5
30713,Shadeven,nagrand,96,priest,discipline,6,1,5
30714,Cenzlyor,arthas,96,priest,discipline,6,1,5
30715,Tooflyy,sargeras,96,priest,discipline,6,1,5
30716,Common,tichondrius,96,priest,discipline,6,1,5
30717,Ilikis,tichondrius,96,priest,discipline,6,1,5
30718,Battlemage,magtheridon,96,priest,discipline,6,1,5
30719,Minamy,tichondrius,96,priest,discipline,6,1,5
30720,Saltedaddy,tichondrius,96,priest,discipline,6,1,5
30721,Payan,barthilas,96,priest,discipline,6,1,5
30722,Hordehealin,laughing-skull,96,priest,discipline,6,1,5
30723,Billyscousin,chogall,96,priest,discipline,6,1,5
30724,Notgoodatsp,bleeding-hollow,96,priest,discipline,6,1,5
30725,Barelylegalx,tichondrius,96,priest,discipline,6,1,5
30726,Terripriest,sargeras,96,priest,discipline,6,1,5
30727,Skingraft,bleeding-hollow,96,priest,discipline,6,1,5
30728,Mannybtuggin,kelthuzad,96,priest,discipline,6,1,5
30729,Applekrisp,sargeras,96,priest,discipline,6,1,5
30730,Shelleypin,bleeding-hollow,96,priest,discipline,6,1,5
30731,Tichealstwo,tichondrius,96,priest,discipline,6,1,5
30732,Hionlife,tichondrius,96,priest,discipline,6,1,5
30733,Pastortee,sargeras,96,priest,discipline,6,1,5
30734,Escence,jubeithos,96,priest,discipline,6,1,5
30735,Shadowbuzz,barthilas,96,priest,discipline,6,1,5
30736,Scenekîd,moon-guard,96,priest,discipline,6,1,5
30737,Fatherwyatt,bleeding-hollow,96,priest,discipline,6,1,5
30738,Holnderoth,malganis,96,priest,discipline,6,1,5
30739,Legitgayirl,zuljin,96,priest,discipline,6,1,5
30740,Moonideli,moon-guard,96,priest,discipline,6,1,5
30741,Kryoff,illidan,96,priest,discipline,6,1,5
30742,Commotion,dalaran,96,priest,discipline,6,1,5
30743,Yarock,kelthuzad,96,priest,discipline,6,1,5
30744,Pinoculus,illidan,96,priest,discipline,6,1,5
30745,Edessa,lothar,96,priest,discipline,6,1,5
30746,Hangingmeat,jubeithos,96,priest,discipline,6,1,5
30747,Tatereh,illidan,96,priest,discipline,6,1,5
30748,Nonbinary,trollbane,96,priest,discipline,6,1,5
30749,Dwennalous,stormrage,96,priest,discipline,6,1,5
30750,Throwshade,moon-guard,96,priest,discipline,6,1,5
30751,Yessír,stormrage,96,priest,discipline,6,1,5
30752,Priestmika,illidan,96,priest,discipline,6,1,5
30753,Regzi,stormrage,96,priest,discipline,6,1,5
30754,Hampy,illidan,96,priest,discipline,6,1,5
30755,Thasar,azgalor,96,priest,discipline,6,1,5
30756,Mêga,illidan,96,priest,discipline,6,1,5
30757,Råd,illidan,96,priest,discipline,6,1,5
30758,Torgasm,frostmourne,96,priest,discipline,12,1,11
30759,Mallzahar,darkspear,96,priest,discipline,12,1,11
30760,Touchoflife,dragonblight,96,priest,discipline,12,1,11
30761,Chewboppa,zuljin,96,priest,discipline,12,1,11
30762,Erinyn,area-52,96,priest,discipline,12,1,11
30763,Sevenlions,stormrage,96,priest,discipline,12,1,11
30764,Gusgp,tichondrius,96,priest,discipline,12,1,11
30765,Invisibler,tichondrius,96,priest,discipline,12,1,11
30766,Zathog,earthen-ring,96,priest,discipline,12,1,11
30767,Punkndrublic,sargeras,96,priest,discipline,12,1,11
30768,Sifts,proudmoore,96,priest,discipline,12,1,11
30769,Ssmushi,tichondrius,96,priest,discipline,12,1,11
30770,Timéo,zuljin,96,priest,discipline,18,1,17
30771,Õdinson,sargeras,96,priest,discipline,30,1,29
30772,Mixxd,shuhalo,95,priest,discipline,6,1,5
30773,Sáito,area-52,79,priest,discipline,5,1,4
30774,Oldmanlou,spirestone,63,priest,discipline,14,2,12
30775,Wyldpiece,frostmourne,42,priest,discipline,7,3,4
30776,Jqueryy,tichondrius,42,priest,discipline,11,3,8
30777,Bigpimpnz,wildhammer,42,priest,discipline,14,3,11
30778,Tamilu,terenas,42,priest,discipline,10,2,8
30779,Küno,kelthuzad,42,priest,discipline,10,2,8
30780,Londy,area-52,42,priest,discipline,16,3,13
30781,Germies,moon-guard,42,priest,discipline,14,2,12
30782,Alathan,sargeras,31,priest,discipline,2,1,1
30783,Orchidp,tichondrius,2334,priest,shadow,300,185,115
30784,Jennaôrtega,tichondrius,2312,priest,shadow,84,54,30
30785,Yeazy,stormrage,2296,priest,shadow,108,62,46
30786,Pboo,tichondrius,2281,priest,shadow,72,45,27
30787,Ejr,altar-of-storms,2247,priest,shadow,103,55,48
30788,Kishoengi,sargeras,2239,priest,shadow,90,56,34
30789,Disembly,illidan,2223,priest,shadow,87,50,37
30790,Edd,tichondrius,2215,priest,shadow,158,84,74
30791,Yeona,tichondrius,2195,priest,shadow,101,60,41
30792,Mearas,kelthuzad,2189,priest,shadow,88,52,36
30793,Disemble,illidan,2186,priest,shadow,78,44,34
30794,Techbadar,tichondrius,2185,priest,shadow,125,65,60
30795,Eradication,frostmourne,2168,priest,shadow,99,64,35
30796,Zçythe,tichondrius,2158,priest,shadow,84,51,33
30797,Strwbrynaner,sargeras,2153,priest,shadow,180,96,84
30798,Geovanni,barthilas,2147,priest,shadow,89,47,42
30799,Amyyds,illidan,2143,priest,shadow,143,93,50
30800,Moraver,kelthuzad,2141,priest,shadow,74,39,35
30801,Targora,lightninghoof,2138,priest,shadow,96,56,40
30802,Healingstats,tichondrius,2137,priest,shadow,71,38,33
30803,Zyrith,sargeras,2137,priest,shadow,111,58,53
30804,Welplayedman,emerald-dream,2130,priest,shadow,88,53,35
30805,Apbrady,sargeras,2128,priest,shadow,96,52,44
30806,Zlipz,frostmourne,2125,priest,shadow,66,42,24
30807,Oohhmágáá,azralon,2120,priest,shadow,78,56,22
30808,Scandi,tichondrius,2111,priest,shadow,66,39,27
30809,Kottun,stormrage,2110,priest,shadow,66,38,28
30810,Lìám,frostmourne,2110,priest,shadow,187,102,85
30811,Pdfileclass,tichondrius,2106,priest,shadow,72,47,25
30812,Bayter,frostmourne,2105,priest,shadow,181,97,84
30813,Yenïza,illidan,2104,priest,shadow,178,96,82
30814,Cozies,stormreaver,2092,priest,shadow,72,45,27
30815,Dyrr,barthilas,2074,priest,shadow,155,79,76
30816,Dream,tichondrius,2066,priest,shadow,150,73,77
30817,Eunu,tichondrius,2058,priest,shadow,198,99,99
30818,Vtp,frostmourne,2052,priest,shadow,116,66,50
30819,Nekroscream,queldorei,2050,priest,shadow,95,53,42
30820,Xiaozhui,tichondrius,2046,priest,shadow,75,41,34
30821,Spamndam,tichondrius,2045,priest,shadow,54,32,22
30822,Laundryday,korgath,2043,priest,shadow,96,51,45
30823,Criminalsp,frostmourne,2041,priest,shadow,78,39,39
30824,Omenx,emerald-dream,2034,priest,shadow,54,31,23
30825,Shibuu,moon-guard,2024,priest,shadow,82,46,36
30826,Heheheg,tichondrius,2017,priest,shadow,105,56,49
30827,Expr,area-52,2016,priest,shadow,102,56,46
30828,Knowknow,tichondrius,2013,priest,shadow,108,57,51
30829,Maskali,tichondrius,2010,priest,shadow,226,110,116
30830,Palumorp,deathwing,2008,priest,shadow,60,38,22
30831,Zlips,frostmourne,2006,priest,shadow,75,37,38
30832,Gâdzêd,kelthuzad,2003,priest,shadow,62,38,24
30833,Sin,guldan,1999,priest,shadow,302,163,139
30834,Alisasa,tichondrius,1998,priest,shadow,60,35,25
30835,Babyh,tichondrius,1994,priest,shadow,77,41,36
30836,Keygodx,illidan,1977,priest,shadow,59,36,23
30837,Kiriko,mannoroth,1977,priest,shadow,101,56,45
30838,Viyana,stormrage,1977,priest,shadow,204,104,100
30839,Arobahn,tichondrius,1975,priest,shadow,118,62,56
30840,Talbadar,tichondrius,1973,priest,shadow,66,42,24
30841,Blax,stormscale,1972,priest,shadow,78,43,35
30842,Stinkiez,area-52,1972,priest,shadow,259,137,122
30843,Aro,tichondrius,1966,priest,shadow,60,32,28
30844,Mamísonga,ragnaros,1965,priest,shadow,71,35,36
30845,Ombravuota,blades-edge,1964,priest,shadow,207,106,101
30846,Urelz,illidan,1956,priest,shadow,30,21,9
30847,Soapee,illidan,1955,priest,shadow,221,113,108
30848,Gromkekz,area-52,1953,priest,shadow,125,63,62
30849,Greaterfade,stormrage,1952,priest,shadow,60,34,26
30850,Maìden,sargeras,1950,priest,shadow,66,36,30
30851,Louloudots,malganis,1950,priest,shadow,78,41,37
30852,Metasp,sargeras,1947,priest,shadow,84,43,41
30853,Luvkak,tichondrius,1942,priest,shadow,47,27,20
30854,Helmsman,tichondrius,1942,priest,shadow,182,96,86
30855,Yoggsarodney,tichondrius,1941,priest,shadow,43,30,13
30856,Blackoss,sargeras,1933,priest,shadow,75,40,35
30857,Ysuran,moon-guard,1930,priest,shadow,184,106,78
30858,Katallyst,tichondrius,1926,priest,shadow,77,36,41
30859,Kuraga,bleeding-hollow,1923,priest,shadow,338,180,158
30860,Holydose,moon-guard,1921,priest,shadow,114,51,63
30861,Ensanity,stormrage,1920,priest,shadow,126,66,60
30862,Cheesëburg,illidan,1915,priest,shadow,54,28,26
30863,Pbxx,tichondrius,1914,priest,shadow,52,31,21
30864,Remixsp,malganis,1913,priest,shadow,48,28,20
30865,Missyoung,tichondrius,1912,priest,shadow,73,42,31
30866,Bibleblak,stormrage,1907,priest,shadow,84,48,36
30867,Delasoul,malganis,1906,priest,shadow,69,41,28
30868,Ousïa,quelthalas,1905,priest,shadow,88,44,44
30869,Erebusz,tichondrius,1904,priest,shadow,102,51,51
30870,Niark,frostmourne,1893,priest,shadow,52,27,25
30871,Taylorsp,tichondrius,1892,priest,shadow,82,46,36
30872,Meehx,illidan,1886,priest,shadow,102,65,37
30873,Netheerix,tichondrius,1879,priest,shadow,51,30,21
30874,Sênju,thrall,1875,priest,shadow,65,35,30
30875,Marfas,illidan,1873,priest,shadow,74,34,40
30876,Mythsnake,ragnaros,1872,priest,shadow,49,29,20
30877,Soar,ravencrest,1872,priest,shadow,47,26,21
30878,Stresscube,tichondrius,1871,priest,shadow,40,25,15
30879,Emopriestqt,tichondrius,1871,priest,shadow,120,72,48
30880,Atarri,illidan,1868,priest,shadow,54,31,23
30881,Esteedees,bonechewer,1864,priest,shadow,96,55,41
30882,Creapture,zuluhed,1864,priest,shadow,42,24,18
30883,Xayp,kelthuzad,1863,priest,shadow,101,73,28
30884,Keliarc,sargeras,1863,priest,shadow,60,34,26
30885,Voidkay,tichondrius,1862,priest,shadow,42,35,7
30886,Wizkxjwap,tichondrius,1862,priest,shadow,36,24,12
30887,Puppyboyx,moon-guard,1861,priest,shadow,62,31,31
30888,Christmasgal,uldum,1859,priest,shadow,30,27,3
30889,Fungame,malganis,1855,priest,shadow,50,35,15
30890,Evenly,tichondrius,1855,priest,shadow,138,76,62
30891,Itkev,area-52,1854,priest,shadow,35,27,8
30892,Ericzssp,tichondrius,1854,priest,shadow,63,36,27
30893,Couldntbeme,sargeras,1852,priest,shadow,54,31,23
30894,Yberisa,zuljin,1852,priest,shadow,107,54,53
30895,Kattallyst,tichondrius,1851,priest,shadow,42,24,18
30896,Asmødeus,bleeding-hollow,1851,priest,shadow,77,40,37
30897,Echoos,proudmoore,1849,priest,shadow,42,28,14
30898,Yoggismydad,emerald-dream,1847,priest,shadow,48,29,19
30899,Wafflezsp,frostmourne,1847,priest,shadow,120,62,58
30900,Sapoopettas,quelthalas,1845,priest,shadow,54,26,28
30901,Griffsp,sargeras,1844,priest,shadow,203,101,102
30902,Jugeumx,proudmoore,1838,priest,shadow,42,25,17
30903,Soyul,tichondrius,1838,priest,shadow,114,64,50
30904,Drmuhammad,sargeras,1837,priest,shadow,42,25,17
30905,Stankychimpo,malganis,1834,priest,shadow,54,32,22
30906,Estéve,wyrmrest-accord,1834,priest,shadow,113,58,55
30907,Niurouchuan,tichondrius,1834,priest,shadow,62,31,31
30908,Furbog,area-52,1833,priest,shadow,42,31,11
30909,Phubar,stormreaver,1831,priest,shadow,78,34,44
30910,Remedio,emerald-dream,1830,priest,shadow,33,21,12
30911,Jojotwo,illidan,1830,priest,shadow,78,41,37
30912,Cøtt,emerald-dream,1829,priest,shadow,48,30,18
30913,Doma,malganis,1829,priest,shadow,43,26,17
30914,Yb,kelthuzad,1829,priest,shadow,54,32,22
30915,Auttø,area-52,1829,priest,shadow,45,26,19
30916,Kalantris,ragnaros,1828,priest,shadow,64,41,23
30917,Throwshade,moon-guard,1828,priest,shadow,89,56,33
30918,Giriosp,thrall,1827,priest,shadow,31,22,9
30919,Ilovevivien,spirestone,1826,priest,shadow,48,26,22
30920,Celypriest,moon-guard,1825,priest,shadow,30,25,5
30921,What,drakthul,1825,priest,shadow,54,35,19
30922,Ptam,tichondrius,1825,priest,shadow,47,26,21
30923,Silero,dalaran,1824,priest,shadow,116,76,40
30924,Psyfiend,alterac-mountains,1824,priest,shadow,57,31,26
30925,Idiotgarbage,moon-guard,1824,priest,shadow,48,26,22
30926,Insanity,azuremyst,1823,priest,shadow,137,77,60
30927,Snozberry,malganis,1822,priest,shadow,66,36,30
30928,Samsypriest,frostmourne,1821,priest,shadow,64,38,26
30929,Mindslips,tichondrius,1821,priest,shadow,144,82,62
30930,Sodíum,wyrmrest-accord,1821,priest,shadow,65,33,32
30931,Bearoom,frostmourne,1820,priest,shadow,66,39,27
30932,Kydraah,ragnaros,1820,priest,shadow,47,27,20
30933,Plaguesus,dalaran,1820,priest,shadow,64,35,29
30934,Vil,lightnings-blade,1819,priest,shadow,90,50,40
30935,Nevertelsp,malganis,1818,priest,shadow,122,79,43
30936,Disxlyec,barthilas,1817,priest,shadow,142,79,63
30937,Derisha,ragnaros,1817,priest,shadow,110,61,49
30938,Dots,tichondrius,1816,priest,shadow,53,33,20
30939,Katarot,area-52,1816,priest,shadow,51,30,21
30940,Discipline,chogall,1816,priest,shadow,48,26,22
30941,Hollister,illidan,1816,priest,shadow,246,132,114
30942,Blissily,sargeras,1814,priest,shadow,75,47,28
30943,Irasponsible,stormrage,1814,priest,shadow,42,23,19
30944,Holytalk,tichondrius,1814,priest,shadow,60,30,30
30945,Drupith,dalaran,1814,priest,shadow,54,27,27
30946,Nawzyh,emerald-dream,1813,priest,shadow,48,26,22
30947,Melonsoda,stormrage,1813,priest,shadow,48,26,22
30948,Resonator,laughing-skull,1813,priest,shadow,46,22,24
30949,Invain,executus,1812,priest,shadow,30,24,6
30950,Brokenspc,tichondrius,1811,priest,shadow,118,65,53
30951,Ðantex,thrall,1811,priest,shadow,296,155,141
30952,Xannè,tichondrius,1811,priest,shadow,60,30,30
30953,Vamp,proudmoore,1810,priest,shadow,52,34,18
30954,Tomcruisé,zuljin,1810,priest,shadow,54,31,23
30955,Llamabush,malganis,1809,priest,shadow,39,26,13
30956,Doublesix,malganis,1809,priest,shadow,72,43,29
30957,Krelaeren,tichondrius,1809,priest,shadow,65,33,32
30958,Cixelpvp,area-52,1809,priest,shadow,54,26,28
30959,Arthrix,sargeras,1807,priest,shadow,72,46,26
30960,Bumps,zuljin,1807,priest,shadow,76,43,33
30961,Inflate,frostmourne,1807,priest,shadow,114,62,52
30962,Ussmissouri,area-52,1807,priest,shadow,200,107,93
30963,Ericxd,area-52,1807,priest,shadow,77,38,39
30964,Edai,malganis,1806,priest,shadow,229,124,105
30965,Exoticfather,area-52,1806,priest,shadow,66,33,33
30966,Ghostz,alleria,1805,priest,shadow,60,39,21
30967,Jomm,area-52,1805,priest,shadow,69,37,32
30968,Snookp,kiljaeden,1805,priest,shadow,255,132,123
30969,Brickzyhehe,dalaran,1805,priest,shadow,113,58,55
30970,Panndaz,tichondrius,1803,priest,shadow,30,19,11
30971,Inmotion,tichondrius,1803,priest,shadow,30,19,11
30972,Metricdotem,terenas,1803,priest,shadow,42,26,16
30973,Euthanasìa,deathwing,1803,priest,shadow,70,31,39
30974,Korrà,turalyon,1802,priest,shadow,30,19,11
30975,Eclipsë,malganis,1800,priest,shadow,24,19,5
30976,Garpd,tichondrius,1799,priest,shadow,102,57,45
30977,Hástür,quelthalas,1797,priest,shadow,145,79,66
30978,Snoog,tichondrius,1796,priest,shadow,48,25,23
30979,Axelrod,tichondrius,1792,priest,shadow,48,29,19
30980,Jthreetx,kelthuzad,1788,priest,shadow,40,23,17
30981,Zhiwanam,tichondrius,1786,priest,shadow,59,34,25
30982,Lillyp,malganis,1786,priest,shadow,42,21,21
30983,Sleepynuj,stormrage,1784,priest,shadow,72,45,27
30984,Jydge,tichondrius,1780,priest,shadow,39,22,17
30985,Almycn,tichondrius,1776,priest,shadow,56,30,26
30986,Plztrainme,spinebreaker,1776,priest,shadow,124,65,59
30987,Zlowbly,ragnaros,1775,priest,shadow,94,49,45
30988,Saintpleb,sargeras,1772,priest,shadow,113,73,40
30989,Shadowforsho,sargeras,1771,priest,shadow,64,30,34
30990,Tamajka,the-forgotten-coast,1769,priest,shadow,111,55,56
30991,Mindgoblin,terokkar,1768,priest,shadow,60,29,31
30992,Voidgodtko,tichondrius,1763,priest,shadow,36,21,15
30993,Pengwinxl,agamaggan,1761,priest,shadow,42,24,18
30994,Orgasmiq,frostmourne,1755,priest,shadow,84,45,39
30995,Lauretânia,nemesis,1754,priest,shadow,66,35,31
30996,Afromon,suramar,1750,priest,shadow,72,45,27
30997,Mepisth,sargeras,1748,priest,shadow,72,46,26
30998,Impérial,stormrage,1744,priest,shadow,179,107,72
30999,Mindburn,nemesis,1742,priest,shadow,84,38,46
31000,Krytical,illidan,1739,priest,shadow,160,95,65
31001,Ticklefingrs,malganis,1734,priest,shadow,60,35,25
31002,Laokele,tichondrius,1731,priest,shadow,48,29,19
31003,Holyxb,bleeding-hollow,1730,priest,shadow,90,54,36
31004,Dildocrates,darkspear,1730,priest,shadow,48,28,20
31005,Felrynpr,malganis,1729,priest,shadow,41,24,17
31006,Aristedes,thrall,1729,priest,shadow,35,20,15
31007,Xmewo,sargeras,1728,priest,shadow,41,25,16
31008,Lebronjâmes,tichondrius,1726,priest,shadow,42,25,17
31009,Mscleo,lothar,1725,priest,shadow,66,29,37
31010,Milan,dalaran,1724,priest,shadow,81,49,32
31011,Bornagain,gundrak,1723,priest,shadow,41,19,22
31012,Pesca,proudmoore,1721,priest,shadow,90,47,43
31013,Nozp,stormrage,1720,priest,shadow,36,18,18
31014,Voiders,area-52,1718,priest,shadow,187,109,78
31015,Peggable,moon-guard,1718,priest,shadow,42,23,19
31016,Brokentrojan,moon-guard,1718,priest,shadow,48,23,25
31017,Crbandit,moon-guard,1716,priest,shadow,85,54,31
31018,Saevita,area-52,1716,priest,shadow,42,24,18
31019,Soný,stormrage,1715,priest,shadow,69,38,31
31020,Girthed,bloodscalp,1713,priest,shadow,74,40,34
31021,Naosoupriest,azralon,1711,priest,shadow,41,31,10
31022,Bagjoe,illidan,1708,priest,shadow,141,72,69
31023,Royx,stormreaver,1708,priest,shadow,36,18,18
31024,Nishishabi,tichondrius,1707,priest,shadow,48,24,24
31025,Ðemi,zuljin,1706,priest,shadow,78,42,36
31026,Shwayp,zuljin,1702,priest,shadow,36,22,14
31027,Invincible,ragnaros,1701,priest,shadow,48,28,20
31028,Twoboo,bleeding-hollow,1701,priest,shadow,72,40,32
31029,Aformoflove,tichondrius,1700,priest,shadow,41,21,20
31030,Darkenside,moon-guard,1699,priest,shadow,48,28,20
31031,Palmerin,ravencrest,1697,priest,shadow,102,53,49
31032,Shadowblastx,sargeras,1696,priest,shadow,48,29,19
31033,Cavaliersr,ragnaros,1696,priest,shadow,90,53,37
31034,Nvøsuperstar,zuljin,1694,priest,shadow,54,28,26
31035,Álvarez,tichondrius,1689,priest,shadow,98,49,49
31036,Jeseck,quelthalas,1689,priest,shadow,64,31,33
31037,Giveheadpats,moon-guard,1683,priest,shadow,216,118,98
31038,Finfangfoom,laughing-skull,1681,priest,shadow,48,23,25
31039,Himikko,illidan,1680,priest,shadow,40,19,21
31040,Woodney,ragnaros,1676,priest,shadow,30,19,11
31041,Littlewench,sargeras,1676,priest,shadow,86,49,37
31042,Darkvagician,malganis,1676,priest,shadow,36,19,17
31043,Crayon,stormrage,1676,priest,shadow,48,25,23
31044,Cmg,sargeras,1673,priest,shadow,42,22,20
31045,Evx,demon-soul,1673,priest,shadow,96,50,46
31046,Clownface,tichondrius,1671,priest,shadow,42,24,18
31047,Manic,skywall,1671,priest,shadow,144,79,65
31048,Desaros,tichondrius,1668,priest,shadow,102,52,50
31049,Griddly,alterac-mountains,1667,priest,shadow,54,32,22
31050,Kovie,twisting-nether,1667,priest,shadow,194,110,84
31051,Slasheal,caelestrasz,1666,priest,shadow,90,47,43
31052,Nuggs,mannoroth,1665,priest,shadow,42,21,21
31053,Ellindria,spinebreaker,1664,priest,shadow,71,39,32
31054,Xdipi,proudmoore,1662,priest,shadow,44,25,19
31055,Saintjudys,tichondrius,1661,priest,shadow,30,19,11
31056,Dxsc,tichondrius,1661,priest,shadow,30,19,11
31057,Swaggylee,tichondrius,1661,priest,shadow,40,22,18
31058,Zachlol,area-52,1658,priest,shadow,66,36,30
31059,Deadsp,thrall,1657,priest,shadow,115,58,57
31060,Shadowkr,tichondrius,1656,priest,shadow,42,26,16
31061,Uploading,moon-guard,1655,priest,shadow,30,19,11
31062,Pluse,bonechewer,1655,priest,shadow,52,31,21
31063,Ranthrough,tichondrius,1654,priest,shadow,72,47,25
31064,Moonideli,moon-guard,1654,priest,shadow,30,19,11
31065,Ilovealina,gorefiend,1653,priest,shadow,30,21,9
31066,Ulqüiorra,azralon,1652,priest,shadow,30,21,9
31067,Djcyrus,barthilas,1652,priest,shadow,54,28,26
31068,Ayumihamaski,tichondrius,1650,priest,shadow,35,25,10
31069,Nevermôre,area-52,1650,priest,shadow,54,36,18
31070,Vaporachi,emerald-dream,1650,priest,shadow,42,28,14
31071,Dovoso,kargath,1650,priest,shadow,54,30,24
31072,Skrillô,emerald-dream,1650,priest,shadow,53,27,26
31073,Caricius,ravenholdt,1649,priest,shadow,36,20,16
31074,Iceveins,illidan,1649,priest,shadow,36,20,16
31075,Tsmc,moon-guard,1648,priest,shadow,60,32,28
31076,Moralism,moon-guard,1647,priest,shadow,229,129,100
31077,Kultil,dalaran,1646,priest,shadow,72,42,30
31078,Vicara,moon-guard,1646,priest,shadow,42,24,18
31079,Madcaddies,bonechewer,1646,priest,shadow,48,22,26
31080,Painful,malganis,1645,priest,shadow,62,36,26
31081,Amarexlol,stormrage,1645,priest,shadow,60,34,26
31082,Nexumbra,dunemaul,1644,priest,shadow,102,57,45
31083,Sigx,area-52,1643,priest,shadow,30,21,9
31084,Swungzebra,stormrage,1642,priest,shadow,140,83,57
31085,Fantasía,moon-guard,1642,priest,shadow,108,50,58
31086,Destta,stormrage,1641,priest,shadow,34,19,15
31087,Voidazepam,zuljin,1641,priest,shadow,96,53,43
31088,Trenbologni,illidan,1637,priest,shadow,156,90,66
31089,Nullreferenc,frostmourne,1637,priest,shadow,75,42,33
31090,Partypriest,tichondrius,1637,priest,shadow,66,36,30
31091,Scarabless,bleeding-hollow,1637,priest,shadow,90,47,43
31092,Dillydackx,sargeras,1634,priest,shadow,108,60,48
31093,Priestine,dreadmaul,1634,priest,shadow,156,81,75
31094,Alip,tichondrius,1633,priest,shadow,64,41,23
31095,Dispèrsion,darkspear,1633,priest,shadow,52,23,29
31096,Grimdox,tichondrius,1631,priest,shadow,48,36,12
31097,Healingstat,tichondrius,1631,priest,shadow,24,17,7
31098,Cixelp,area-52,1631,priest,shadow,42,23,19
31099,Mushill,tichondrius,1631,priest,shadow,96,48,48
31100,Safe,illidan,1629,priest,shadow,97,51,46
31101,Sarâda,moon-guard,1626,priest,shadow,177,95,82
31102,Fireballingg,tichondrius,1625,priest,shadow,30,18,12
31103,Whysoserious,duskwood,1624,priest,shadow,30,17,13
31104,Chazzwizz,area-52,1624,priest,shadow,36,17,19
31105,Snuffp,sargeras,1623,priest,shadow,108,70,38
31106,Shalla,blackrock,1623,priest,shadow,72,37,35
31107,Bobbyvagene,area-52,1622,priest,shadow,36,17,19
31108,Mêdúsa,area-52,1621,priest,shadow,58,30,28
31109,Rhick,azralon,1619,priest,shadow,83,52,31
31110,Dirtyysanta,tichondrius,1619,priest,shadow,29,18,11
31111,Solstunn,moon-guard,1619,priest,shadow,48,24,24
31112,Ilostmybible,quelthalas,1619,priest,shadow,46,23,23
31113,Iogical,kelthuzad,1618,priest,shadow,116,70,46
31114,Antìdote,tichondrius,1618,priest,shadow,134,77,57
31115,Sînkaî,demon-soul,1617,priest,shadow,118,70,48
31116,Dustnbonez,area-52,1617,priest,shadow,36,20,16
31117,Drossv,shadowmoon,1614,priest,shadow,42,20,22
31118,Scalpell,tichondrius,1613,priest,shadow,191,99,92
31119,Vallfiresp,malganis,1612,priest,shadow,40,22,18
31120,Cxrsed,illidan,1610,priest,shadow,42,22,20
31121,Fxxkdamn,tichondrius,1609,priest,shadow,29,20,9
31122,Sukes,korgath,1609,priest,shadow,49,27,22
31123,Kwõnc,tichondrius,1609,priest,shadow,50,26,24
31124,Adopted,wyrmrest-accord,1608,priest,shadow,66,37,29
31125,Wenger,crushridge,1608,priest,shadow,138,70,68
31126,Dí,illidan,1606,priest,shadow,30,17,13
31127,Bandages,stormreaver,1606,priest,shadow,104,57,47
31128,Shmage,malganis,1606,priest,shadow,54,28,26
31129,Deuz,quelthalas,1606,priest,shadow,84,37,47
31130,Manofmystery,dalaran,1605,priest,shadow,30,19,11
31131,Moc,jubeithos,1605,priest,shadow,36,22,14
31132,Fight,icecrown,1605,priest,shadow,60,33,27
31133,Shadowdurps,area-52,1604,priest,shadow,66,36,30
31134,Murkqz,stormrage,1604,priest,shadow,54,29,25
31135,Clamchowdy,kiljaeden,1603,priest,shadow,27,18,9
31136,Pumpss,area-52,1603,priest,shadow,49,28,21
31137,Perfectz,stormrage,1603,priest,shadow,36,19,17
31138,Shadork,area-52,1602,priest,shadow,49,31,18
31139,Cloax,azgalor,1602,priest,shadow,48,29,19
31140,Aspéct,aegwynn,1602,priest,shadow,30,17,13
31141,Shelize,kirin-tor,1601,priest,shadow,205,100,105
31142,Hotphoyou,moon-guard,1600,priest,shadow,60,39,21
31143,Manifestor,illidan,1600,priest,shadow,86,51,35
31144,Machinecoach,stormrage,1600,priest,shadow,40,20,20
31145,Vyabl,thrall,1599,priest,shadow,42,24,18
31146,Gusho,frostmourne,1599,priest,shadow,175,88,87
31147,Wifegrip,tichondrius,1598,priest,shadow,42,19,23
31148,Radicional,azralon,1596,priest,shadow,36,20,16
31149,Minamy,tichondrius,1593,priest,shadow,30,17,13
31150,Toddmund,tichondrius,1593,priest,shadow,119,62,57
31151,Graviton,tichondrius,1591,priest,shadow,72,40,32
31152,Thaumaturgy,chogall,1590,priest,shadow,36,19,17
31153,Vashrapani,stormrage,1590,priest,shadow,243,124,119
31154,Ayooblitz,guldan,1588,priest,shadow,36,22,14
31155,Fenix,bloodhoof,1588,priest,shadow,40,21,19
31156,Badbwoi,frostmourne,1588,priest,shadow,45,21,24
31157,Ventusp,azralon,1586,priest,shadow,35,21,14
31158,Healzium,blackwater-raiders,1585,priest,shadow,38,18,20
31159,Occult,bloodscalp,1584,priest,shadow,99,48,51
31160,Fâêlyn,wyrmrest-accord,1583,priest,shadow,70,33,37
31161,Deeaann,tichondrius,1582,priest,shadow,251,133,118
31162,Relicsa,proudmoore,1581,priest,shadow,35,20,15
31163,Gineska,tichondrius,1580,priest,shadow,30,18,12
31164,Folesian,tichondrius,1580,priest,shadow,36,20,16
31165,Vaala,jubeithos,1580,priest,shadow,60,30,30
31166,Nodoubt,barthilas,1580,priest,shadow,52,22,30
31167,Ajazz,zuljin,1578,priest,shadow,36,22,14
31168,Nizeurflayzz,tichondrius,1577,priest,shadow,44,26,18
31169,Milkgrabber,bleeding-hollow,1577,priest,shadow,133,71,62
31170,Akuvurá,nemesis,1576,priest,shadow,71,40,31
31171,Brothercarl,stormrage,1576,priest,shadow,48,24,24
31172,Çummiñs,malganis,1575,priest,shadow,36,21,15
31173,Aqurielen,turalyon,1574,priest,shadow,47,31,16
31174,Benjamints,thrall,1574,priest,shadow,66,41,25
31175,Heàvenly,moon-guard,1573,priest,shadow,36,21,15
31176,Raptorjésus,azjolnerub,1573,priest,shadow,36,18,18
31177,Ratleen,malganis,1570,priest,shadow,212,103,109
31178,Greyyan,wyrmrest-accord,1569,priest,shadow,202,113,89
31179,Fancycorpse,tichondrius,1569,priest,shadow,48,19,29
31180,Whitehandpr,tichondrius,1568,priest,shadow,284,144,140
31181,Ddark,tichondrius,1566,priest,shadow,30,19,11
31182,Marantbourge,frostmourne,1566,priest,shadow,75,45,30
31183,Sorrentin,ragnaros,1566,priest,shadow,58,31,27
31184,Pepps,proudmoore,1566,priest,shadow,363,189,174
31185,Crazyherb,azralon,1565,priest,shadow,83,47,36
31186,Iuka,emerald-dream,1565,priest,shadow,153,77,76
31187,Delbringer,moon-guard,1562,priest,shadow,43,26,17
31188,Iminyou,kelthuzad,1561,priest,shadow,84,50,34
31189,Methandrial,hyjal,1561,priest,shadow,99,53,46
31190,Chillypriest,azjolnerub,1560,priest,shadow,36,20,16
31191,Imabeast,stormrage,1560,priest,shadow,58,30,28
31192,Ethandryl,kelthuzad,1558,priest,shadow,39,23,16
31193,Dahliá,frostmourne,1558,priest,shadow,83,45,38
31194,Jojoxxz,illidan,1557,priest,shadow,43,25,18
31195,Alex,boulderfist,1557,priest,shadow,54,31,23
31196,Jeanbi,ragnaros,1556,priest,shadow,138,78,60
31197,Sìnz,area-52,1555,priest,shadow,36,26,10
31198,Hieken,nemesis,1555,priest,shadow,64,38,26
31199,Pnub,aggramar,1555,priest,shadow,35,18,17
31200,Fig,nazgrel,1554,priest,shadow,84,42,42
31201,Nightcráwler,illidan,1553,priest,shadow,42,25,17
31202,Seedisc,kelthuzad,1552,priest,shadow,36,23,13
31203,Tënëbrë,nemesis,1552,priest,shadow,73,43,30
31204,Krazé,tichondrius,1552,priest,shadow,78,39,39
31205,Volkova,quelthalas,1549,priest,shadow,30,19,11
31206,Softs,area-52,1549,priest,shadow,83,42,41
31207,Cyanovoid,thrall,1549,priest,shadow,36,18,18
31208,Dikdik,tichondrius,1547,priest,shadow,30,20,10
31209,Dorraheals,tichondrius,1546,priest,shadow,35,18,17
31210,Boogiê,illidan,1545,priest,shadow,84,48,36
31211,Nøfaith,area-52,1544,priest,shadow,112,50,62
31212,Khelleya,moon-guard,1543,priest,shadow,48,26,22
31213,Suery,hyjal,1542,priest,shadow,84,37,47
31214,Abientot,tichondrius,1539,priest,shadow,84,47,37
31215,Stepho,dalaran,1539,priest,shadow,42,19,23
31216,Bigboyadam,frostmourne,1538,priest,shadow,88,55,33
31217,Púrg,frostmourne,1537,priest,shadow,30,19,11
31218,Lilithice,moon-guard,1537,priest,shadow,48,25,23
31219,Faeinia,elune,1534,priest,shadow,105,61,44
31220,Csheweishan,aerie-peak,1533,priest,shadow,72,39,33
31221,Aethestan,zuljin,1533,priest,shadow,83,37,46
31222,Thenamesnorm,tichondrius,1532,priest,shadow,35,21,14
31223,Dotdotwin,illidan,1531,priest,shadow,71,43,28
31224,Jessticalz,frostmourne,1531,priest,shadow,30,16,14
31225,Mealmassttr,frostmourne,1531,priest,shadow,36,18,18
31226,Vtplz,bleeding-hollow,1530,priest,shadow,29,17,12
31227,Nonamegame,sargeras,1527,priest,shadow,79,41,38
31228,Voidshift,tichondrius,1527,priest,shadow,324,164,160
31229,Sochron,stormrage,1526,priest,shadow,62,28,34
31230,Purpskurp,stormrage,1525,priest,shadow,42,20,22
31231,Ravinny,nemesis,1524,priest,shadow,40,20,20
31232,Mellow,tichondrius,1523,priest,shadow,44,24,20
31233,Beckðn,tichondrius,1523,priest,shadow,94,50,44
31234,Creedence,jubeithos,1521,priest,shadow,53,28,25
31235,Márceline,stormrage,1520,priest,shadow,64,40,24
31236,Xannis,thrall,1517,priest,shadow,68,38,30
31237,Elogant,frostmourne,1516,priest,shadow,48,20,28
31238,Keepitlegal,sargeras,1515,priest,shadow,30,16,14
31239,Èvil,tichondrius,1514,priest,shadow,24,16,8
31240,Pettypriest,dalaran,1514,priest,shadow,60,29,31
31241,Warklaw,frostmourne,1514,priest,shadow,49,20,29
31242,Hurtfeet,sargeras,1507,priest,shadow,44,19,25
31243,Amideus,dunemaul,1507,priest,shadow,42,18,24
31244,Lowkii,malfurion,1505,priest,shadow,63,41,22
31245,Wobbleskank,tichondrius,1505,priest,shadow,84,50,34
31246,Shadylotion,stormrage,1505,priest,shadow,30,16,14
31247,Krythe,laughing-skull,1505,priest,shadow,41,19,22
31248,Ikillfast,tichondrius,1504,priest,shadow,60,34,26
31249,Justfaith,barthilas,1504,priest,shadow,73,35,38
31250,Shadowhazed,tichondrius,1503,priest,shadow,42,23,19
31251,Iuvrainee,area-52,1503,priest,shadow,78,40,38
31252,Frankeebutt,stormrage,1501,priest,shadow,36,22,14
31253,Danoc,tichondrius,1500,priest,shadow,108,53,55
31254,Emlix,tichondrius,1499,priest,shadow,62,33,29
31255,Carniosso,azralon,1498,priest,shadow,116,58,58
31256,Bullma,boulderfist,1494,priest,shadow,22,17,5
31257,Agraciada,illidan,1493,priest,shadow,42,27,15
31258,Dischaffy,shadowmoon,1491,priest,shadow,42,29,13
31259,Azheel,stormrage,1490,priest,shadow,65,26,39
31260,Teeprie,drakthul,1488,priest,shadow,42,27,15
31261,Muurielle,quelthalas,1488,priest,shadow,93,52,41
31262,Rhoku,nesingwary,1488,priest,shadow,42,23,19
31263,Fïo,proudmoore,1488,priest,shadow,72,35,37
31264,Ezrashade,tichondrius,1488,priest,shadow,83,40,43
31265,Vynlanesh,illidan,1486,priest,shadow,102,48,54
31266,Shadelink,tichondrius,1484,priest,shadow,36,16,20
31267,Mockr,kiljaeden,1483,priest,shadow,30,16,14
31268,Plebcakès,sargeras,1482,priest,shadow,49,26,23
31269,Azagthøth,ravenholdt,1478,priest,shadow,239,122,117
31270,Brothofnzoth,emerald-dream,1478,priest,shadow,53,25,28
31271,Swp,sargeras,1476,priest,shadow,48,29,19
31272,Lucael,durotan,1476,priest,shadow,42,23,19
31273,Astoshan,moon-guard,1475,priest,shadow,125,73,52
31274,Pestee,quelthalas,1475,priest,shadow,150,86,64
31275,Rida,zuljin,1467,priest,shadow,50,31,19
31276,Allsmite,aerie-peak,1467,priest,shadow,54,29,25
31277,Flickmybick,sargeras,1466,priest,shadow,81,40,41
31278,Londy,area-52,1464,priest,shadow,272,136,136
31279,Cuaiminator,ragnaros,1463,priest,shadow,87,47,40
31280,Shadeven,nagrand,1463,priest,shadow,39,18,21
31281,Plzdontlos,hyjal,1461,priest,shadow,36,22,14
31282,Xæl,tichondrius,1457,priest,shadow,58,35,23
31283,Terranle,tichondrius,1457,priest,shadow,64,30,34
31284,Fritzi,shattered-hand,1456,priest,shadow,30,17,13
31285,Numinous,wyrmrest-accord,1456,priest,shadow,68,35,33
31286,ßarracuda,illidan,1455,priest,shadow,54,36,18
31287,Lelyna,stormrage,1454,priest,shadow,36,22,14
31288,Øbara,frostmourne,1454,priest,shadow,52,29,23
31289,Supremezx,frostmourne,1453,priest,shadow,30,19,11
31290,Suicider,emerald-dream,1452,priest,shadow,141,67,74
31291,Thelordx,barthilas,1450,priest,shadow,48,23,25
31292,Spoõks,darkspear,1449,priest,shadow,50,21,29
31293,Cpoppa,sargeras,1446,priest,shadow,36,19,17
31294,Kilal,sargeras,1445,priest,shadow,36,24,12
31295,Grizzlysmite,stormrage,1445,priest,shadow,37,17,20
31296,Sezyks,stormrage,1444,priest,shadow,30,23,7
31297,Kadralin,illidan,1443,priest,shadow,72,36,36
31298,Kokai,area-52,1440,priest,shadow,18,15,3
31299,Mentalprison,khazgoroth,1439,priest,shadow,30,15,15
31300,Teddipriest,tichondrius,1438,priest,shadow,24,15,9
31301,Secrèt,tichondrius,1438,priest,shadow,24,15,9
31302,Pastortee,sargeras,1437,priest,shadow,59,33,26
31303,Nüt,malganis,1437,priest,shadow,53,29,24
31304,Hypochondria,moon-guard,1436,priest,shadow,33,20,13
31305,Onegil,tichondrius,1436,priest,shadow,75,38,37
31306,Gershwinner,daggerspine,1436,priest,shadow,30,15,15
31307,Alvorr,ragnaros,1435,priest,shadow,59,36,23
31308,Cathery,tichondrius,1435,priest,shadow,30,15,15
31309,Powerwordcry,stormrage,1434,priest,shadow,48,22,26
31310,Cloribestmom,tichondrius,1433,priest,shadow,24,15,9
31311,Painpaws,moon-guard,1433,priest,shadow,30,15,15
31312,Bbeaie,tichondrius,1433,priest,shadow,30,15,15
31313,Ciem,tichondrius,1431,priest,shadow,24,15,9
31314,Covidchamp,proudmoore,1431,priest,shadow,24,15,9
31315,ßroßraßroski,sargeras,1431,priest,shadow,36,22,14
31316,Sheiizy,azralon,1430,priest,shadow,24,15,9
31317,Nightelffeet,stormrage,1428,priest,shadow,24,15,9
31318,Sandrö,sargeras,1427,priest,shadow,24,15,9
31319,Aguitardient,ragnaros,1426,priest,shadow,33,19,14
31320,Theodorous,frostmourne,1426,priest,shadow,40,22,18
31321,Stusy,tichondrius,1425,priest,shadow,71,44,27
31322,Aedaki,garona,1424,priest,shadow,148,83,65
31323,Mitoloshi,ragnaros,1424,priest,shadow,42,19,23
31324,Corthien,thrall,1422,priest,shadow,18,15,3
31325,Shadowzypher,wyrmrest-accord,1419,priest,shadow,24,15,9
31326,Bigmollet,tichondrius,1418,priest,shadow,77,32,45
31327,Lilmix,hydraxis,1417,priest,shadow,41,26,15
31328,Bûdussy,bonechewer,1417,priest,shadow,31,17,14
31329,Proudigy,lightninghoof,1413,priest,shadow,51,29,22
31330,Strokkerx,azralon,1413,priest,shadow,89,48,41
31331,Showakoi,ragnaros,1412,priest,shadow,54,29,25
31332,Wongÿ,tichondrius,1408,priest,shadow,30,24,6
31333,Sandelios,aggramar,1408,priest,shadow,42,28,14
31334,Imhðtep,ragnaros,1408,priest,shadow,54,26,28
31335,Voidscrypt,thrall,1406,priest,shadow,100,60,40
31336,Chewthefat,darkspear,1406,priest,shadow,29,15,14
31337,Anrop,illidan,1405,priest,shadow,24,16,8
31338,Younext,sargeras,1404,priest,shadow,51,17,34
31339,Bastét,skullcrusher,1402,priest,shadow,108,60,48
31340,Shirubamoya,gurubashi,1401,priest,shadow,41,23,18
31341,Frorgnence,stormrage,1400,priest,shadow,30,22,8
31342,Mindboink,malganis,1399,priest,shadow,76,41,35
31343,Wowgreatgame,tichondrius,1399,priest,shadow,53,27,26
31344,Aghorï,sargeras,1399,priest,shadow,62,28,34
31345,Kuazi,khazgoroth,1398,priest,shadow,125,59,66
31346,Daysgone,bleeding-hollow,1397,priest,shadow,133,74,59
31347,Malikeht,drakkari,1394,priest,shadow,48,25,23
31348,Haø,stormrage,1393,priest,shadow,98,50,48
31349,Ashtahius,ragnaros,1392,priest,shadow,113,65,48
31350,Habann,frostmourne,1392,priest,shadow,140,71,69
31351,Theorym,tichondrius,1391,priest,shadow,22,17,5
31352,Dawnkìn,bleeding-hollow,1390,priest,shadow,132,67,65
31353,Dipírex,azralon,1389,priest,shadow,84,40,44
31354,Mindeas,the-forgotten-coast,1387,priest,shadow,32,15,17
31355,Fäÿë,tichondrius,1386,priest,shadow,54,26,28
31356,Vinasky,moon-guard,1386,priest,shadow,38,16,22
31357,Achíllesheal,stormrage,1385,priest,shadow,101,53,48
31358,Bloodify,azralon,1385,priest,shadow,53,26,27
31359,Juicymist,moon-guard,1382,priest,shadow,196,106,90
31360,Wdnmmd,proudmoore,1382,priest,shadow,91,41,50
31361,Healztonic,dalaran,1380,priest,shadow,72,32,40
31362,Shén,barthilas,1378,priest,shadow,89,59,30
31363,Maynard,ragnaros,1378,priest,shadow,66,35,31
31364,Tye,medivh,1378,priest,shadow,30,15,15
31365,Lawgiva,thrall,1377,priest,shadow,30,19,11
31366,Jadon,sargeras,1377,priest,shadow,38,22,16
31367,Xammys,malganis,1376,priest,shadow,24,16,8
31368,Tjxx,zuljin,1376,priest,shadow,48,28,20
31369,Miniimenx,azralon,1375,priest,shadow,41,29,12
31370,Ssupasonic,tichondrius,1372,priest,shadow,33,16,17
31371,Deadcode,frostmane,1372,priest,shadow,39,16,23
31372,Urspareparts,sargeras,1370,priest,shadow,89,48,41
31373,Spõõky,illidan,1368,priest,shadow,26,15,11
31374,Tyisanity,tichondrius,1368,priest,shadow,68,32,36
31375,Whorticiå,area-52,1366,priest,shadow,101,43,58
31376,Saphet,draktharon,1365,priest,shadow,88,55,33
31377,Aránhell,ragnaros,1365,priest,shadow,48,28,20
31378,Papadoll,malganis,1365,priest,shadow,32,16,16
31379,Lolcrafthd,ragnaros,1364,priest,shadow,30,16,14
31380,Heihunüwang,kargath,1363,priest,shadow,26,15,11
31381,Niias,hyjal,1361,priest,shadow,66,37,29
31382,Scadie,goldrinn,1360,priest,shadow,30,15,15
31383,Duckdemon,ragnaros,1358,priest,shadow,35,16,19
31384,Littlebagel,nesingwary,1357,priest,shadow,24,16,8
31385,Bugsbright,tichondrius,1351,priest,shadow,75,36,39
31386,Poague,area-52,1343,priest,shadow,24,14,10
31387,Task,korgath,1343,priest,shadow,41,18,23
31388,Ukishizumi,tichondrius,1342,priest,shadow,18,14,4
31389,Flay,dragonmaw,1342,priest,shadow,18,14,4
31390,Cixelp,tichondrius,1342,priest,shadow,30,14,16
31391,Verbeka,nemesis,1338,priest,shadow,18,14,4
31392,Aeonar,alleria,1338,priest,shadow,30,16,14
31393,Xionys,sargeras,1336,priest,shadow,42,19,23
31394,Cheez,tichondrius,1336,priest,shadow,64,28,36
31395,Tidals,sargeras,1335,priest,shadow,24,14,10
31396,Nobutter,archimonde,1335,priest,shadow,24,14,10
31397,Scriptö,fizzcrank,1334,priest,shadow,66,44,22
31398,Grianné,mannoroth,1334,priest,shadow,24,16,8
31399,Hüde,stormrage,1334,priest,shadow,102,53,49
31400,Boogle,frostmourne,1333,priest,shadow,59,26,33
31401,Chenny,darkspear,1332,priest,shadow,72,40,32
31402,Dreaminz,tichondrius,1331,priest,shadow,24,14,10
31403,Shadyvoodoo,barthilas,1331,priest,shadow,80,42,38
31404,Likesshadows,tichondrius,1330,priest,shadow,24,17,7
31405,Leach,darkspear,1330,priest,shadow,71,30,41
31406,Labraidor,tichondrius,1329,priest,shadow,77,30,47
31407,Lirien,kelthuzad,1328,priest,shadow,42,15,27
31408,Faedyspriest,sargeras,1327,priest,shadow,24,14,10
31409,Voidork,tichondrius,1323,priest,shadow,24,14,10
31410,Pandarue,tichondrius,1318,priest,shadow,57,30,27
31411,Elam,ragnaros,1318,priest,shadow,42,17,25
31412,Synkiz,darkspear,1316,priest,shadow,39,19,20
31413,Chádeervas,nemesis,1315,priest,shadow,39,24,15
31414,Rammstèin,sargeras,1314,priest,shadow,30,14,16
31415,Phantomz,malganis,1311,priest,shadow,41,25,16
31416,Timreaper,barthilas,1311,priest,shadow,35,21,14
31417,Goodvybz,illidan,1310,priest,shadow,35,15,20
31418,Alisaie,dalvengyr,1308,priest,shadow,52,27,25
31419,Locjawbe,area-52,1307,priest,shadow,35,18,17
31420,Uncletouches,thrall,1303,priest,shadow,30,14,16
31421,Ed,crushridge,1299,priest,shadow,30,16,14
31422,Sekhen,area-52,1298,priest,shadow,49,23,26
31423,Bustmybubble,tichondrius,1297,priest,shadow,50,34,16
31424,Mamofwar,arthas,1296,priest,shadow,66,29,37
31425,Bobbeans,area-52,1295,priest,shadow,30,18,12
31426,Onipapae,frostmourne,1295,priest,shadow,76,39,37
31427,Øvøxø,emerald-dream,1295,priest,shadow,33,15,18
31428,Beautifulgir,illidan,1294,priest,shadow,30,18,12
31429,Reos,jubeithos,1294,priest,shadow,54,32,22
31430,Ampela,dalaran,1293,priest,shadow,37,17,20
31431,Xaneo,kelthuzad,1290,priest,shadow,23,14,9
31432,Ancene,illidan,1290,priest,shadow,42,24,18
31433,Àx,draka,1290,priest,shadow,32,18,14
31434,Hervert,area-52,1289,priest,shadow,36,19,17
31435,Nóin,tichondrius,1289,priest,shadow,65,27,38
31436,Thotsndots,blood-furnace,1288,priest,shadow,26,15,11
31437,Wetleaftx,chogall,1286,priest,shadow,24,15,9
31438,Zeromisx,proudmoore,1279,priest,shadow,28,14,14
31439,Valloren,kalecgos,1278,priest,shadow,26,15,11
31440,Eklunð,proudmoore,1277,priest,shadow,23,14,9
31441,Estelars,aggramar,1276,priest,shadow,115,61,54
31442,Furìøns,nemesis,1275,priest,shadow,24,15,9
31443,Marni,akama,1272,priest,shadow,91,42,49
31444,Healixd,area-52,1271,priest,shadow,36,14,22
31445,Layrissa,whisperwind,1266,priest,shadow,24,15,9
31446,Puerquirri,quelthalas,1266,priest,shadow,30,16,14
31447,Pozcas,blood-furnace,1265,priest,shadow,24,14,10
31448,Shinyspriest,tichondrius,1265,priest,shadow,83,43,40
31449,Lyriczx,kelthuzad,1265,priest,shadow,42,18,24
31450,Festær,area-52,1258,priest,shadow,64,34,30
31451,Shadøwheal,stormrage,1257,priest,shadow,24,16,8
31452,Beneficium,nazjatar,1254,priest,shadow,30,20,10
31453,Synergize,korgath,1254,priest,shadow,60,30,30
31454,Lilpika,illidan,1254,priest,shadow,42,18,24
31455,Stankylegz,tichondrius,1251,priest,shadow,30,16,14
31456,Zolgeta,exodar,1250,priest,shadow,47,31,16
31457,Badnfluence,kiljaeden,1250,priest,shadow,24,14,10
31458,Ketchuslipin,illidan,1249,priest,shadow,34,15,19
31459,Jwx,malganis,1248,priest,shadow,18,13,5
31460,Shadowtreta,azralon,1248,priest,shadow,36,21,15
31461,Madcuzyaknow,bleeding-hollow,1248,priest,shadow,24,13,11
31462,Envyion,sargeras,1248,priest,shadow,24,13,11
31463,Stellur,kelthuzad,1247,priest,shadow,23,14,9
31464,Originull,emerald-dream,1247,priest,shadow,24,13,11
31465,Carbsauce,tichondrius,1246,priest,shadow,18,13,5
31466,Gelato,velen,1246,priest,shadow,24,13,11
31467,Headbrake,malganis,1246,priest,shadow,24,13,11
31468,Avraf,sargeras,1246,priest,shadow,24,13,11
31469,Bubblepop,blackhand,1245,priest,shadow,18,13,5
31470,Fanfansp,tichondrius,1244,priest,shadow,18,13,5
31471,Goodlife,frostmourne,1244,priest,shadow,24,13,11
31472,Yayonaise,tichondrius,1244,priest,shadow,24,13,11
31473,Sakuraginero,illidan,1243,priest,shadow,24,13,11
31474,Shadowjisha,emerald-dream,1243,priest,shadow,33,14,19
31475,Pri,jubeithos,1242,priest,shadow,18,13,5
31476,Amentia,area-52,1242,priest,shadow,24,13,11
31477,Ashidox,proudmoore,1242,priest,shadow,27,14,13
31478,Houzz,frostmourne,1241,priest,shadow,18,13,5
31479,Xedus,mannoroth,1240,priest,shadow,74,37,37
31480,Etan,thrall,1240,priest,shadow,30,15,15
31481,Ascian,daggerspine,1239,priest,shadow,30,13,17
31482,Dilly,tichondrius,1238,priest,shadow,21,14,7
31483,Harisleidy,quelthalas,1237,priest,shadow,32,14,18
31484,Nums,tichondrius,1236,priest,shadow,48,25,23
31485,Chinchillin,demon-soul,1235,priest,shadow,126,67,59
31486,Shadowyeti,illidan,1233,priest,shadow,18,13,5
31487,Cykle,blackrock,1233,priest,shadow,42,13,29
31488,Dockavok,bloodhoof,1232,priest,shadow,18,13,5
31489,Jiedx,tichondrius,1230,priest,shadow,35,14,21
31490,Vanisa,hellscream,1228,priest,shadow,41,20,21
31491,Sempiternus,barthilas,1228,priest,shadow,34,16,18
31492,Kaermor,stormrage,1227,priest,shadow,66,28,38
31493,Simplyfaded,black-dragonflight,1226,priest,shadow,24,13,11
31494,Pfl,area-52,1226,priest,shadow,113,55,58
31495,Jeffgordo,tichondrius,1223,priest,shadow,24,13,11
31496,Antoz,kelthuzad,1222,priest,shadow,49,28,21
31497,Payan,barthilas,1222,priest,shadow,48,24,24
31498,Vílja,moon-guard,1219,priest,shadow,94,41,53
31499,Hephiron,area-52,1219,priest,shadow,59,22,37
31500,Roylwcheese,illidan,1218,priest,shadow,18,13,5
31501,Ramaven,arygos,1213,priest,shadow,36,14,22
31502,Sorrowful,mannoroth,1208,priest,shadow,29,13,16
31503,Zyræl,stormrage,1208,priest,shadow,95,41,54
31504,Castnngcouch,tichondrius,1207,priest,shadow,42,21,21
31505,Demples,darkspear,1202,priest,shadow,24,16,8
31506,Discpi,illidan,1202,priest,shadow,78,34,44
31507,Likeleela,azshara,1201,priest,shadow,33,14,19
31508,Senumbra,tichondrius,1200,priest,shadow,36,16,20
31509,Sècret,tichondrius,1199,priest,shadow,23,13,10
31510,Irangara,gorefiend,1199,priest,shadow,32,14,18
31511,Halselin,senjin,1197,priest,shadow,55,30,25
31512,Messiahp,illidan,1195,priest,shadow,35,13,22
31513,Dockani,sargeras,1192,priest,shadow,54,25,29
31514,Holydarkness,quelthalas,1190,priest,shadow,47,17,30
31515,Foli,zuljin,1187,priest,shadow,22,14,8
31516,Aflstan,frostmourne,1185,priest,shadow,57,34,23
31517,Saltheril,burning-blade,1183,priest,shadow,29,13,16
31518,Pristoleiro,azralon,1182,priest,shadow,17,13,4
31519,Mimósa,quelthalas,1181,priest,shadow,25,14,11
31520,Fullfear,lothar,1178,priest,shadow,26,13,13
31521,Darksheals,barthilas,1176,priest,shadow,30,22,8
31522,Healtheze,kelthuzad,1175,priest,shadow,20,13,7
31523,Abolita,korgath,1171,priest,shadow,84,43,41
31524,Urmorphine,area-52,1168,priest,shadow,197,104,93
31525,Slogger,illidan,1164,priest,shadow,29,13,16
31526,Maricotä,azralon,1161,priest,shadow,24,13,11
31527,Trollypriest,darkspear,1157,priest,shadow,94,44,50
31528,Snakklè,illidan,1152,priest,shadow,18,13,5
31529,Nadrii,illidan,1152,priest,shadow,34,15,19
31530,Bubbyflay,area-52,1151,priest,shadow,18,12,6
31531,Qadris,tichondrius,1150,priest,shadow,30,12,18
31532,Bubbzy,daggerspine,1149,priest,shadow,18,12,6
31533,Nucypher,illidan,1149,priest,shadow,24,12,12
31534,Teccalil,tichondrius,1146,priest,shadow,24,12,12
31535,Dayquills,illidan,1145,priest,shadow,24,12,12
31536,Lidole,barthilas,1145,priest,shadow,30,12,18
31537,Omnivoîd,tichondrius,1144,priest,shadow,24,12,12
31538,Luokni,illidan,1143,priest,shadow,18,12,6
31539,Îcecube,sargeras,1142,priest,shadow,24,12,12
31540,Knglizward,stormrage,1140,priest,shadow,59,33,26
31541,Icytaken,frostmourne,1139,priest,shadow,24,12,12
31542,Kibariyb,drakkari,1139,priest,shadow,30,12,18
31543,Uvebeendead,the-forgotten-coast,1137,priest,shadow,36,18,18
31544,Stellaryn,moon-guard,1137,priest,shadow,30,12,18
31545,Overcastedxo,kelthuzad,1135,priest,shadow,50,28,22
31546,Unholyreáper,magtheridon,1132,priest,shadow,24,12,12
31547,Bestwizardx,tichondrius,1131,priest,shadow,21,13,8
31548,Anathamaz,stormrage,1131,priest,shadow,30,12,18
31549,Faithhealing,zuljin,1128,priest,shadow,50,24,26
31550,Vvti,quelthalas,1125,priest,shadow,28,15,13
31551,Aeingel,amanthul,1124,priest,shadow,36,12,24
31552,Alphawon,area-52,1111,priest,shadow,30,12,18
31553,Võid,tichondrius,1103,priest,shadow,23,12,11
31554,Dernièreplac,blackrock,1098,priest,shadow,21,13,8
31555,Brownie,blackrock,1097,priest,shadow,23,14,9
31556,Misslost,nerzhul,1081,priest,shadow,23,12,11
31557,Scormm,runetotem,1073,priest,shadow,24,13,11
31558,Manofmystery,drenden,1071,priest,shadow,17,12,5
31559,Creata,frostmourne,1071,priest,shadow,19,12,7
31560,Galice,archimonde,1065,priest,shadow,60,30,30
31561,Khaibit,stormrage,1064,priest,shadow,24,15,9
31562,Valeknun,stormrage,1060,priest,shadow,30,21,9
31563,Freebolte,frostmourne,1056,priest,shadow,12,11,1
31564,Lastbubble,area-52,1056,priest,shadow,24,11,13
31565,Patagoniabae,kelthuzad,1055,priest,shadow,12,11,1
31566,Pwrwordsquee,lightbringer,1055,priest,shadow,18,11,7
31567,Spacethug,illidan,1055,priest,shadow,18,11,7
31568,Eskettit,korgath,1054,priest,shadow,12,11,1
31569,Sleezi,emerald-dream,1054,priest,shadow,18,11,7
31570,Fouroneo,tichondrius,1054,priest,shadow,18,11,7
31571,Büd,sargeras,1054,priest,shadow,18,11,7
31572,Plenipotent,moon-guard,1054,priest,shadow,26,15,11
31573,Voltétt,tichondrius,1053,priest,shadow,18,11,7
31574,Eatmyspells,malganis,1053,priest,shadow,24,11,13
31575,Darkshadows,ravenholdt,1052,priest,shadow,18,11,7
31576,Bhruno,proudmoore,1052,priest,shadow,18,11,7
31577,Tydïus,illidan,1052,priest,shadow,18,11,7
31578,Féarlust,demon-soul,1051,priest,shadow,18,11,7
31579,Shadowbee,kargath,1051,priest,shadow,18,11,7
31580,Ivyslays,area-52,1050,priest,shadow,18,11,7
31581,Semillion,tichondrius,1049,priest,shadow,24,11,13
31582,Beeds,sargeras,1048,priest,shadow,66,29,37
31583,Tinypuppyy,sargeras,1047,priest,shadow,37,14,23
31584,Coors,lightnings-blade,1046,priest,shadow,24,11,13
31585,Nocturnalx,moon-guard,1045,priest,shadow,18,11,7
31586,Zeas,moon-guard,1044,priest,shadow,18,11,7
31587,Kàiju,zuljin,1027,priest,shadow,30,11,19
31588,Alzu,ragnaros,1023,priest,shadow,23,11,12
31589,Shämus,dalaran,1014,priest,shadow,24,11,13
31590,Oglilptown,thunderlord,1005,priest,shadow,60,33,27
31591,Ipse,azshara,1002,priest,shadow,66,36,30
31592,Sinkz,ragnaros,992,priest,shadow,16,11,5
31593,Pocket,alleria,991,priest,shadow,22,11,11
31594,Coolbie,korgath,990,priest,shadow,26,11,15
31595,Jhivagosp,tichondrius,988,priest,shadow,22,11,11
31596,Shadowlife,bonechewer,974,priest,shadow,20,11,9
31597,Daemoon,deathwing,973,priest,shadow,20,12,8
31598,Fedodesubaco,gallywix,973,priest,shadow,33,17,16
31599,Discountay,burning-legion,965,priest,shadow,20,11,9
31600,Insindious,sargeras,963,priest,shadow,15,12,3
31601,Mmrassassin,stormrage,960,priest,shadow,12,10,2
31602,Icarryozz,darkspear,960,priest,shadow,12,10,2
31603,Yuhstin,sargeras,960,priest,shadow,12,10,2
31604,Claudiosip,tichondrius,960,priest,shadow,12,10,2
31605,Jugeum,proudmoore,960,priest,shadow,18,10,8
31606,Evilgeniusx,area-52,960,priest,shadow,18,10,8
31607,Anoumenon,tichondrius,960,priest,shadow,18,10,8
31608,Kissmyvoìd,frostmourne,960,priest,shadow,18,10,8
31609,Pèrona,tichondrius,960,priest,shadow,18,10,8
31610,Míslead,kelthuzad,959,priest,shadow,12,10,2
31611,Synergia,drakkari,959,priest,shadow,12,10,2
31612,Rhima,tichondrius,959,priest,shadow,12,10,2
31613,Inflìctìøn,frostmourne,959,priest,shadow,12,10,2
31614,Bestpimp,frostmane,959,priest,shadow,18,10,8
31615,Philmacrakn,stormrage,959,priest,shadow,18,10,8
31616,Delai,dalaran,959,priest,shadow,18,10,8
31617,Xtradotz,tichondrius,959,priest,shadow,18,10,8
31618,Ayzen,emerald-dream,959,priest,shadow,18,10,8
31619,Keepsleepin,stormrage,959,priest,shadow,24,10,14
31620,Terý,dalaran,959,priest,shadow,24,10,14
31621,Ightdoe,zuljin,958,priest,shadow,12,10,2
31622,Vikingkøng,ragnaros,958,priest,shadow,12,10,2
31623,Eraseme,bleeding-hollow,958,priest,shadow,18,10,8
31624,Tatzis,frostmourne,958,priest,shadow,18,10,8
31625,Fathersmits,area-52,958,priest,shadow,18,10,8
31626,Porffy,malygos,958,priest,shadow,18,10,8
31627,Exigyo,quelthalas,957,priest,shadow,23,13,10
31628,Andso,azralon,957,priest,shadow,18,10,8
31629,Maniwa,dentarg,957,priest,shadow,24,10,14
31630,Prickled,zuljin,957,priest,shadow,24,10,14
31631,Rizzle,emerald-dream,956,priest,shadow,18,10,8
31632,Mortivore,azralon,956,priest,shadow,24,10,14
31633,Gankdalf,draktharon,955,priest,shadow,18,10,8
31634,Ralphiez,tichondrius,954,priest,shadow,24,10,14
31635,Ragnálodbrok,ragnaros,953,priest,shadow,18,10,8
31636,Xora,frostmourne,952,priest,shadow,18,10,8
31637,Kflexx,hydraxis,948,priest,shadow,18,10,8
31638,Eslaughter,twisting-nether,945,priest,shadow,18,11,7
31639,Cymin,dalaran,943,priest,shadow,25,12,13
31640,Farnkxd,bleeding-hollow,925,priest,shadow,32,11,21
31641,Hairypenance,sargeras,910,priest,shadow,17,10,7
31642,Thrageqt,sargeras,908,priest,shadow,20,11,9
31643,Amestroada,nemesis,904,priest,shadow,21,11,10
31644,Silmeriá,darkspear,904,priest,shadow,29,11,18
31645,Ràvn,emerald-dream,903,priest,shadow,16,12,4
31646,Ayniah,tichondrius,895,priest,shadow,17,10,7
31647,Exen,moon-guard,894,priest,shadow,18,11,7
31648,Romero,blood-furnace,885,priest,shadow,60,24,36
31649,Berixa,stormscale,883,priest,shadow,11,10,1
31650,Pootzy,malganis,880,priest,shadow,19,10,9
31651,Csonka,stormrage,868,priest,shadow,38,13,25
31652,Æë,area-52,864,priest,shadow,12,9,3
31653,Mudkrab,gundrak,864,priest,shadow,12,9,3
31654,Voidcult,area-52,864,priest,shadow,12,9,3
31655,Taxzury,tichondrius,864,priest,shadow,12,9,3
31656,Ellipses,bleeding-hollow,864,priest,shadow,12,9,3
31657,Kurindrize,illidan,864,priest,shadow,12,9,3
31658,Feverx,tichondrius,864,priest,shadow,12,9,3
31659,Silkyx,tichondrius,864,priest,shadow,18,9,9
31660,Tiernocookie,illidan,864,priest,shadow,18,9,9
31661,Slimfo,sargeras,864,priest,shadow,18,9,9
31662,Wololo,emerald-dream,864,priest,shadow,18,9,9
31663,Stunsilence,sargeras,864,priest,shadow,18,9,9
31664,Swurvexo,bleeding-hollow,864,priest,shadow,24,9,15
31665,Plushys,emerald-dream,863,priest,shadow,12,9,3
31666,Charity,maelstrom,863,priest,shadow,12,9,3
31667,Abednego,area-52,863,priest,shadow,12,9,3
31668,Beloriath,ragnaros,863,priest,shadow,12,9,3
31669,Delrey,sargeras,863,priest,shadow,18,9,9
31670,Küno,kelthuzad,863,priest,shadow,18,9,9
31671,Woosanghong,tichondrius,863,priest,shadow,18,9,9
31672,Ðecease,thrall,863,priest,shadow,18,9,9
31673,Vizioz,tichondrius,863,priest,shadow,18,9,9
31674,Xijinping,chogall,863,priest,shadow,18,9,9
31675,Xiphoidz,frostmourne,863,priest,shadow,18,9,9
31676,Xtcbtc,sargeras,863,priest,shadow,18,9,9
31677,Efxsp,sargeras,863,priest,shadow,24,9,15
31678,Shadhoee,sargeras,863,priest,shadow,30,9,21
31679,ßluedreamx,tichondrius,862,priest,shadow,12,9,3
31680,Everblack,executus,862,priest,shadow,12,9,3
31681,Fadedvoid,malorne,862,priest,shadow,12,9,3
31682,Suirr,tichondrius,862,priest,shadow,12,9,3
31683,Constentien,tichondrius,862,priest,shadow,18,9,9
31684,Vzell,kiljaeden,862,priest,shadow,18,9,9
31685,Dóctóre,thrall,862,priest,shadow,18,9,9
31686,Touchypriest,jaedenar,862,priest,shadow,18,9,9
31687,Arzeuz,ragnaros,862,priest,shadow,18,9,9
31688,Shadowflux,thunderlord,862,priest,shadow,30,9,21
31689,Nekkz,sargeras,861,priest,shadow,12,9,3
31690,Melas,stormrage,861,priest,shadow,24,9,15
31691,Viejiyoh,ragnaros,860,priest,shadow,18,9,9
31692,Wankenobi,stormrage,859,priest,shadow,18,9,9
31693,Methodist,sargeras,859,priest,shadow,24,9,15
31694,Sacerthu,goldrinn,858,priest,shadow,18,9,9
31695,Beansontoast,wyrmrest-accord,857,priest,shadow,12,9,3
31696,Lilmermaid,laughing-skull,857,priest,shadow,18,9,9
31697,Zaxine,moon-guard,854,priest,shadow,30,9,21
31698,Mazahr,stormrage,852,priest,shadow,12,9,3
31699,Hibot,illidan,849,priest,shadow,24,9,15
31700,Lightbanter,emerald-dream,846,priest,shadow,24,9,15
31701,Kagamì,frostmane,843,priest,shadow,31,9,22
31702,Pipiwiwi,tichondrius,831,priest,shadow,16,9,7
31703,Maldicius,emerald-dream,830,priest,shadow,23,9,14
31704,Mortemus,drenden,828,priest,shadow,14,10,4
31705,Blonkie,azgalor,821,priest,shadow,24,10,14
31706,Jeängrey,tichondrius,815,priest,shadow,15,10,5
31707,Stylonious,hyjal,815,priest,shadow,15,9,6
31708,Buc,barthilas,813,priest,shadow,15,9,6
31709,Bobe,sisters-of-elune,810,priest,shadow,17,9,8
31710,Fledgeling,frostmourne,799,priest,shadow,14,9,5
31711,Dazull,bleeding-hollow,768,priest,shadow,12,8,4
31712,Mindfulness,tichondrius,768,priest,shadow,12,8,4
31713,Silentólògy,malganis,768,priest,shadow,12,8,4
31714,Púrplenurple,area-52,768,priest,shadow,12,8,4
31715,Oxycodex,thrall,768,priest,shadow,12,8,4
31716,Voidariah,tichondrius,768,priest,shadow,12,8,4
31717,Mitogen,malganis,768,priest,shadow,12,8,4
31718,Stungods,frostmourne,768,priest,shadow,12,8,4
31719,Nohealerhere,frostmourne,768,priest,shadow,12,8,4
31720,Ruzhi,moon-guard,768,priest,shadow,12,8,4
31721,Skraitbussin,tichondrius,768,priest,shadow,12,8,4
31722,Snackabre,moon-guard,768,priest,shadow,12,8,4
31723,Nutdrip,tichondrius,768,priest,shadow,12,8,4
31724,Àústîn,moon-guard,768,priest,shadow,18,8,10
31725,Enchantrez,frostmourne,768,priest,shadow,18,8,10
31726,Ripchadman,tichondrius,768,priest,shadow,18,8,10
31727,Skepix,lightbringer,768,priest,shadow,18,8,10
31728,Madmelter,emerald-dream,768,priest,shadow,18,8,10
31729,Deacoderx,area-52,768,priest,shadow,18,8,10
31730,Heàl,akama,768,priest,shadow,18,8,10
31731,Drosslolz,illidan,768,priest,shadow,18,8,10
31732,Mydixi,stormrage,768,priest,shadow,18,8,10
31733,Iluvwizkx,malganis,768,priest,shadow,18,8,10
31734,Alucardibee,turalyon,768,priest,shadow,24,8,16
31735,Viq,stormrage,767,priest,shadow,12,8,4
31736,Shadowlords,emerald-dream,767,priest,shadow,12,8,4
31737,Skgangmm,tichondrius,767,priest,shadow,12,8,4
31738,Rogspriest,sargeras,767,priest,shadow,12,8,4
31739,Mugiwarà,stormrage,767,priest,shadow,12,8,4
31740,Sinning,kelthuzad,767,priest,shadow,12,8,4
31741,Hairyboxx,frostmourne,767,priest,shadow,12,8,4
31742,Dyé,hydraxis,767,priest,shadow,12,8,4
31743,Tungus,shadowsong,767,priest,shadow,12,8,4
31744,Oldmanlou,spirestone,767,priest,shadow,12,8,4
31745,Sgssg,illidan,767,priest,shadow,12,8,4
31746,Homonid,moon-guard,767,priest,shadow,12,8,4
31747,Faithplusone,zuljin,767,priest,shadow,12,8,4
31748,Easyrevenge,kelthuzad,767,priest,shadow,12,8,4
31749,Priestzerath,azralon,767,priest,shadow,18,8,10
31750,Valothrian,area-52,767,priest,shadow,18,8,10
31751,Smitepie,malganis,767,priest,shadow,18,8,10
31752,Badxjuju,frostmourne,767,priest,shadow,18,8,10
31753,Twistedtéa,garrosh,767,priest,shadow,18,8,10
31754,Barelylegalx,tichondrius,767,priest,shadow,18,8,10
31755,Sãoleozinho,azralon,766,priest,shadow,12,8,4
31756,Krypts,shadow-council,766,priest,shadow,12,8,4
31757,Solrina,khazgoroth,766,priest,shadow,12,8,4
31758,Jinzan,stormrage,766,priest,shadow,18,8,10
31759,Chroma,amanthul,766,priest,shadow,18,8,10
31760,Sadinho,azralon,766,priest,shadow,24,8,16
31761,Floofball,medivh,765,priest,shadow,12,8,4
31762,Rustinheber,stormscale,765,priest,shadow,12,8,4
31763,Kumojorno,gilneas,765,priest,shadow,18,8,10
31764,Bmô,stormrage,765,priest,shadow,18,8,10
31765,Pactosombrio,azralon,763,priest,shadow,24,8,16
31766,Drkwispers,stormrage,762,priest,shadow,18,8,10
31767,Speckilz,area-52,762,priest,shadow,26,8,18
31768,Sôuljah,skywall,760,priest,shadow,26,10,16
31769,Battlepope,the-scryers,755,priest,shadow,20,9,11
31770,Datcuban,illidan,752,priest,shadow,12,8,4
31771,Memoria,emerald-dream,751,priest,shadow,15,9,6
31772,Gedtemanager,dalaran,749,priest,shadow,12,8,4
31773,Shadzie,sargeras,732,priest,shadow,22,8,14
31774,Strazloraz,baelgun,719,priest,shadow,11,8,3
31775,Meegoshy,azuremyst,718,priest,shadow,17,8,9
31776,Mikó,dawnbringer,714,priest,shadow,29,10,19
31777,Yrrep,kelthuzad,703,priest,shadow,16,8,8
31778,Lucsor,malganis,688,priest,shadow,13,8,5
31779,Bucksp,zuljin,672,priest,shadow,12,7,5
31780,Diddlur,black-dragonflight,672,priest,shadow,12,7,5
31781,Twítch,bonechewer,672,priest,shadow,12,7,5
31782,Blackaries,frostmourne,672,priest,shadow,12,7,5
31783,Didy,dark-iron,672,priest,shadow,12,7,5
31784,Aeøns,sargeras,672,priest,shadow,12,7,5
31785,Deawalker,khaz-modan,672,priest,shadow,12,7,5
31786,Bugweeb,sargeras,672,priest,shadow,12,7,5
31787,Naùtilus,icecrown,672,priest,shadow,12,7,5
31788,Hårper,area-52,672,priest,shadow,12,7,5
31789,Zuuji,frostmourne,672,priest,shadow,12,7,5
31790,Kastwalker,earthen-ring,672,priest,shadow,12,7,5
31791,Scøøb,malganis,672,priest,shadow,12,7,5
31792,Fatzoid,the-forgotten-coast,672,priest,shadow,12,7,5
31793,Jah,frostmourne,672,priest,shadow,12,7,5
31794,Phéonìx,zuljin,672,priest,shadow,12,7,5
31795,Airil,mugthol,672,priest,shadow,12,7,5
31796,Chicoryx,illidan,672,priest,shadow,12,7,5
31797,Duhpriest,frostmourne,672,priest,shadow,12,7,5
31798,Wodturbo,bleeding-hollow,672,priest,shadow,12,7,5
31799,Kwiksi,arthas,672,priest,shadow,12,7,5
31800,Lontra,zangarmarsh,672,priest,shadow,12,7,5
31801,Grëýmåttèr,moon-guard,672,priest,shadow,12,7,5
31802,Mmys,tichondrius,672,priest,shadow,12,7,5
31803,Såx,stormreaver,672,priest,shadow,12,7,5
31804,Moonlightx,destromath,672,priest,shadow,12,7,5
31805,Nazgúl,lothar,672,priest,shadow,12,7,5
31806,Pikeysplol,illidan,672,priest,shadow,12,7,5
31807,Gles,quelthalas,672,priest,shadow,13,7,6
31808,Mòrbídìtý,area-52,672,priest,shadow,13,7,6
31809,Nightious,malganis,672,priest,shadow,18,7,11
31810,Fluttershÿ,ragnaros,672,priest,shadow,18,7,11
31811,Tanzen,andorhal,672,priest,shadow,18,7,11
31812,Synesis,bladefist,672,priest,shadow,18,7,11
31813,Acpriest,tichondrius,672,priest,shadow,18,7,11
31814,Evelën,azralon,672,priest,shadow,18,7,11
31815,Aurilain,emerald-dream,672,priest,shadow,18,7,11
31816,Veressà,quelthalas,672,priest,shadow,22,8,14
31817,Chês,tichondrius,672,priest,shadow,24,7,17
31818,Nastyyshadow,aegwynn,671,priest,shadow,12,7,5
31819,Gaho,tichondrius,671,priest,shadow,12,7,5
31820,Clayphace,darkspear,671,priest,shadow,12,7,5
31821,Voltstein,dalaran,671,priest,shadow,12,7,5
31822,Darkrics,barthilas,671,priest,shadow,12,7,5
31823,Spshady,aegwynn,671,priest,shadow,12,7,5
31824,Preyforme,tichondrius,671,priest,shadow,12,7,5
31825,Ghedeloco,tichondrius,671,priest,shadow,12,7,5
31826,Moonpenance,windrunner,671,priest,shadow,12,7,5
31827,Deffaultz,turalyon,671,priest,shadow,18,7,11
31828,Pottime,tichondrius,671,priest,shadow,18,7,11
31829,Nachòs,wildhammer,671,priest,shadow,18,7,11
31830,Pokeyoobutt,hydraxis,671,priest,shadow,18,7,11
31831,Shimz,andorhal,671,priest,shadow,18,7,11
31832,Heion,detheroc,671,priest,shadow,18,7,11
31833,Torangi,tichondrius,671,priest,shadow,18,7,11
31834,Havefaith,whisperwind,671,priest,shadow,18,7,11
31835,Tonybromoo,kelthuzad,670,priest,shadow,12,7,5
31836,Montcrief,tichondrius,670,priest,shadow,12,7,5
31837,Nerfdisc,azralon,670,priest,shadow,12,7,5
31838,Matafuka,ragnaros,670,priest,shadow,12,7,5
31839,Iseeyoulookn,stormrage,670,priest,shadow,16,8,8
31840,Lyxorr,area-52,670,priest,shadow,18,7,11
31841,Demoñ,deathwing,669,priest,shadow,18,7,11
31842,Gabryanna,emerald-dream,669,priest,shadow,24,7,17
31843,Bellalugosi,auchindoun,667,priest,shadow,12,7,5
31844,Lõkî,malganis,667,priest,shadow,12,7,5
31845,Angro,ragnaros,665,priest,shadow,12,7,5
31846,Lampshayd,sargeras,665,priest,shadow,12,7,5
31847,Crashed,frostmourne,654,priest,shadow,17,7,10
31848,Popejack,stormrage,654,priest,shadow,17,7,10
31849,Metaila,aerie-peak,639,priest,shadow,11,7,4
31850,Lucifena,darkspear,639,priest,shadow,11,7,4
31851,Emmitson,scarlet-crusade,638,priest,shadow,28,7,21
31852,Chiliy,frostmourne,623,priest,shadow,11,7,4
31853,Lzzp,azralon,623,priest,shadow,17,7,10
31854,Ëlliot,stormrage,620,priest,shadow,15,7,8
31855,Kundalini,boulderfist,620,priest,shadow,17,7,10
31856,Rigotakx,illidan,616,priest,shadow,21,8,13
31857,Glek,tichondrius,608,priest,shadow,16,7,9
31858,Propumper,dalaran,607,priest,shadow,11,7,4
31859,Hölyfury,illidan,607,priest,shadow,17,7,10
31860,Seniorpickle,emerald-dream,606,priest,shadow,14,7,7
31861,Flowerpetals,emerald-dream,599,priest,shadow,21,7,14
31862,Nylaza,kiljaeden,592,priest,shadow,19,7,12
31863,Mastahmind,illidan,591,priest,shadow,13,7,6
31864,Ìforted,zuljin,587,priest,shadow,19,7,12
31865,Nayzarh,darkspear,576,priest,shadow,6,6,0
31866,Blindingstar,area-52,576,priest,shadow,6,6,0
31867,Holyfüry,ragnaros,576,priest,shadow,6,6,0
31868,Applepiezz,tichondrius,576,priest,shadow,6,6,0
31869,Sydgames,area-52,576,priest,shadow,6,6,0
31870,Henrywhopper,fizzcrank,576,priest,shadow,6,6,0
31871,Iamjakehill,area-52,576,priest,shadow,6,6,0
31872,Innovate,dragonmaw,576,priest,shadow,6,6,0
31873,Stromile,tichondrius,576,priest,shadow,6,6,0
31874,Moonwald,moon-guard,576,priest,shadow,6,6,0
31875,Zhadowbolts,thrall,576,priest,shadow,6,6,0
31876,Deckx,khazgoroth,576,priest,shadow,10,7,3
31877,Sacerdotick,gallywix,576,priest,shadow,12,6,6
31878,Yeeko,kiljaeden,576,priest,shadow,12,6,6
31879,Slpox,sargeras,576,priest,shadow,12,6,6
31880,Saitii,dalaran,576,priest,shadow,12,6,6
31881,Lostnlight,aggramar,576,priest,shadow,12,6,6
31882,Whosjoe,tichondrius,576,priest,shadow,12,6,6
31883,Rebdomine,magtheridon,576,priest,shadow,12,6,6
31884,Tmspongwo,tichondrius,576,priest,shadow,12,6,6
31885,Bipölar,area-52,576,priest,shadow,12,6,6
31886,Luzira,stormrage,576,priest,shadow,12,6,6
31887,Kk,fizzcrank,576,priest,shadow,12,6,6
31888,Virsyti,area-52,576,priest,shadow,12,6,6
31889,Rachelstarrx,hyjal,576,priest,shadow,12,6,6
31890,Drognar,lightbringer,576,priest,shadow,12,6,6
31891,Peedofile,frostmourne,576,priest,shadow,12,6,6
31892,Imshadow,azralon,576,priest,shadow,12,6,6
31893,Zonozan,lightnings-blade,576,priest,shadow,12,6,6
31894,Faenzal,area-52,576,priest,shadow,12,6,6
31895,Fitchbucker,sargeras,576,priest,shadow,12,6,6
31896,Wheelson,wildhammer,576,priest,shadow,12,6,6
31897,Kessavannell,frostwolf,576,priest,shadow,12,6,6
31898,Valerift,moon-guard,576,priest,shadow,12,6,6
31899,Mks,barthilas,576,priest,shadow,12,6,6
31900,Jmanhealz,stormrage,576,priest,shadow,12,6,6
31901,Bearuwu,frostmourne,576,priest,shadow,12,6,6
31902,Jeremyissped,proudmoore,576,priest,shadow,12,6,6
31903,Studiosxz,tichondrius,576,priest,shadow,12,6,6
31904,Verbane,frostmourne,576,priest,shadow,12,6,6
31905,Frúdgé,illidan,576,priest,shadow,12,6,6
31906,Spookyman,malganis,576,priest,shadow,12,6,6
31907,Froackey,agamaggan,576,priest,shadow,12,6,6
31908,Ershackleton,illidan,576,priest,shadow,12,6,6
31909,Rahtals,malganis,576,priest,shadow,12,6,6
31910,Coral,stormscale,576,priest,shadow,12,6,6
31911,Pønt,sargeras,576,priest,shadow,12,6,6
31912,Ôverweight,sargeras,576,priest,shadow,12,6,6
31913,Spriestbro,emerald-dream,576,priest,shadow,12,6,6
31914,Voidhearted,tichondrius,576,priest,shadow,12,6,6
31915,Yungjim,the-forgotten-coast,576,priest,shadow,12,6,6
31916,Sped,saurfang,576,priest,shadow,12,6,6
31917,Evansong,frostmane,576,priest,shadow,12,6,6
31918,Toddo,trollbane,576,priest,shadow,12,6,6
31919,Catmasters,area-52,576,priest,shadow,13,6,7
31920,Fruitjuice,arthas,576,priest,shadow,18,6,12
31921,Caeda,icecrown,576,priest,shadow,18,6,12
31922,Osmatspriest,firetree,576,priest,shadow,18,6,12
31923,Soulrulerx,tichondrius,576,priest,shadow,18,6,12
31924,Mindgamez,stormreaver,576,priest,shadow,18,6,12
31925,Jexso,tichondrius,576,priest,shadow,19,6,13
31926,Xð,jubeithos,575,priest,shadow,12,6,6
31927,Grympriest,wyrmrest-accord,575,priest,shadow,12,6,6
31928,Xinthra,stormrage,575,priest,shadow,12,6,6
31929,Debbie,cairne,575,priest,shadow,12,6,6
31930,Drsonny,proudmoore,575,priest,shadow,12,6,6
31931,Krooked,kelthuzad,575,priest,shadow,12,6,6
31932,Mìdnìght,ragnaros,575,priest,shadow,12,6,6
31933,Çovidònenine,tichondrius,575,priest,shadow,12,6,6
31934,Thrilas,silver-hand,575,priest,shadow,12,6,6
31935,Ricksanchez,moonrunner,575,priest,shadow,12,6,6
31936,Unclelively,dragonmaw,575,priest,shadow,12,6,6
31937,Luminous,moon-guard,575,priest,shadow,12,6,6
31938,Vashyy,stormrage,575,priest,shadow,12,6,6
31939,Nyktøs,quelthalas,575,priest,shadow,18,6,12
31940,Vynardis,arygos,575,priest,shadow,18,6,12
31941,Ðaddÿ,bleeding-hollow,574,priest,shadow,12,6,6
31942,Moon,moonrunner,574,priest,shadow,12,6,6
31943,Duhk,moon-guard,574,priest,shadow,12,6,6
31944,Drkvagician,tichondrius,574,priest,shadow,18,6,12
31945,Dhader,area-52,574,priest,shadow,20,6,14
31946,Jamashud,mannoroth,571,priest,shadow,12,6,6
31947,Raelintha,kelthuzad,571,priest,shadow,15,7,8
31948,Shadowbishop,barthilas,570,priest,shadow,12,6,6
31949,Holysheht,icecrown,566,priest,shadow,12,6,6
31950,Rotass,hyjal,559,priest,shadow,11,6,5
31951,Sarkozzlol,tichondrius,543,priest,shadow,8,7,1
31952,Holydestroyr,dentarg,527,priest,shadow,21,6,15
31953,Totorostarp,tichondrius,521,priest,shadow,22,8,14
31954,Ceoofvoid,moon-guard,511,priest,shadow,8,6,2
31955,Hoshx,sargeras,496,priest,shadow,13,6,7
31956,Reignsp,malganis,496,priest,shadow,13,6,7
31957,Nawtyforever,tichondrius,480,priest,shadow,6,5,1
31958,Commotion,dalaran,480,priest,shadow,6,5,1
31959,Rattyp,barthilas,480,priest,shadow,6,5,1
31960,Rykispriest,tichondrius,480,priest,shadow,6,5,1
31961,Jezebëll,nemesis,480,priest,shadow,6,5,1
31962,Potatopriest,stormrage,480,priest,shadow,6,5,1
31963,Kaidow,wyrmrest-accord,480,priest,shadow,6,5,1
31964,Death,firetree,480,priest,shadow,6,5,1
31965,Myòvó,tichondrius,480,priest,shadow,6,5,1
31966,Gaymalenurse,sargeras,480,priest,shadow,6,5,1
31967,Polarnight,zuljin,480,priest,shadow,6,5,1
31968,Ahleven,tichondrius,480,priest,shadow,6,5,1
31969,Bradythree,moon-guard,480,priest,shadow,6,5,1
31970,Jâmïè,gurubashi,480,priest,shadow,6,5,1
31971,Likelydapper,tichondrius,480,priest,shadow,6,5,1
31972,Drteabaghaam,zuljin,480,priest,shadow,6,5,1
31973,Flynni,bleeding-hollow,480,priest,shadow,6,5,1
31974,Tensorflow,tichondrius,480,priest,shadow,6,5,1
31975,Lillyspr,malganis,480,priest,shadow,6,5,1
31976,Plaguepumper,sargeras,480,priest,shadow,6,5,1
31977,Fiéstah,illidan,480,priest,shadow,6,5,1
31978,Altera,drakkari,480,priest,shadow,6,5,1
31979,Megamind,elune,480,priest,shadow,6,5,1
31980,Chervz,chogall,480,priest,shadow,6,5,1
31981,Komy,tichondrius,480,priest,shadow,6,5,1
31982,Hadoka,ragnaros,480,priest,shadow,6,5,1
31983,Diyel,area-52,480,priest,shadow,6,5,1
31984,Ãbelladanger,area-52,480,priest,shadow,6,5,1
31985,Spriesto,frostmourne,480,priest,shadow,6,5,1
31986,Talkura,tichondrius,480,priest,shadow,6,5,1
31987,Seanuts,emerald-dream,480,priest,shadow,6,5,1
31988,Nås,elune,480,priest,shadow,12,5,7
31989,Mookelina,stormrage,480,priest,shadow,12,5,7
31990,Soulistic,arygos,480,priest,shadow,12,5,7
31991,Senadori,azjolnerub,480,priest,shadow,12,5,7
31992,Orderic,ragnaros,480,priest,shadow,12,5,7
31993,Spriest,kul-tiras,480,priest,shadow,12,5,7
31994,Lucariö,area-52,480,priest,shadow,12,5,7
31995,Arataxx,area-52,480,priest,shadow,12,5,7
31996,Moä,nemesis,480,priest,shadow,12,5,7
31997,Littledog,velen,480,priest,shadow,12,5,7
31998,Jenastreaux,wyrmrest-accord,480,priest,shadow,12,5,7
31999,Flukex,tichondrius,480,priest,shadow,12,5,7
32000,Hygeïa,lightbringer,480,priest,shadow,12,5,7
32001,Minnowhead,kelthuzad,480,priest,shadow,12,5,7
32002,Posest,darkspear,480,priest,shadow,12,5,7
32003,Helleamh,tichondrius,480,priest,shadow,12,5,7
32004,Holliebell,zuljin,480,priest,shadow,12,5,7
32005,Kristt,thrall,480,priest,shadow,12,5,7
32006,Optimism,frostmane,480,priest,shadow,12,5,7
32007,Onizukakeiji,hyjal,480,priest,shadow,12,5,7
32008,Haracka,quelthalas,480,priest,shadow,12,5,7
32009,Goblindruid,bleeding-hollow,480,priest,shadow,12,5,7
32010,Bunked,bleeding-hollow,480,priest,shadow,12,5,7
32011,Fatzzbtw,illidan,480,priest,shadow,12,5,7
32012,Yddwin,quelthalas,480,priest,shadow,12,5,7
32013,Shádôws,blackhand,480,priest,shadow,12,5,7
32014,Mdt,tichondrius,480,priest,shadow,12,5,7
32015,Hriest,tichondrius,480,priest,shadow,12,5,7
32016,Zhangtanchi,moon-guard,480,priest,shadow,12,5,7
32017,Salvate,tichondrius,480,priest,shadow,12,5,7
32018,Seraphims,moon-guard,480,priest,shadow,12,5,7
32019,Cryptron,tichondrius,480,priest,shadow,12,5,7
32020,Priestology,echo-isles,480,priest,shadow,12,5,7
32021,Sársaukis,illidan,480,priest,shadow,12,5,7
32022,Sohalexs,tichondrius,480,priest,shadow,12,5,7
32023,Gorebones,emerald-dream,480,priest,shadow,12,5,7
32024,Faydes,arthas,480,priest,shadow,13,5,8
32025,Zerohoür,emerald-dream,480,priest,shadow,16,6,10
32026,Stillmatick,tichondrius,480,priest,shadow,16,6,10
32027,Nedajoon,tichondrius,480,priest,shadow,17,6,11
32028,Astari,illidan,480,priest,shadow,18,5,13
32029,Azrothlol,kul-tiras,480,priest,shadow,18,5,13
32030,Drakracs,doomhammer,480,priest,shadow,18,5,13
32031,Sybal,suramar,480,priest,shadow,19,5,14
32032,Merlynaah,azralon,479,priest,shadow,6,5,1
32033,Paradoxbot,kelthuzad,479,priest,shadow,6,5,1
32034,Cptnrockwèll,dalaran,479,priest,shadow,12,5,7
32035,Wolfeclipse,sargeras,479,priest,shadow,12,5,7
32036,Knoxy,fizzcrank,479,priest,shadow,12,5,7
32037,Rippmmr,frostmourne,479,priest,shadow,18,5,13
32038,Noodloctopus,area-52,478,priest,shadow,10,6,4
32039,Antiraus,aerie-peak,478,priest,shadow,12,5,7
32040,Soonya,arygos,478,priest,shadow,15,5,10
32041,Anttila,ragnaros,447,priest,shadow,11,5,6
32042,Wiiuwiiu,malganis,447,priest,shadow,11,5,6
32043,Forober,queldorei,446,priest,shadow,10,6,4
32044,Aerena,anvilmar,442,priest,shadow,21,7,14
32045,Ryanrealz,tichondrius,432,priest,shadow,9,6,3
32046,Bernhard,azralon,431,priest,shadow,11,5,6
32047,Sohalex,tichondrius,431,priest,shadow,11,5,6
32048,Shietamazon,tichondrius,426,priest,shadow,16,6,10
32049,Dioscura,malganis,416,priest,shadow,10,5,5
32050,Shaurana,stormrage,412,priest,shadow,18,6,12
32051,Nizr,bleeding-hollow,399,priest,shadow,5,5,0
32052,Zeacho,proudmoore,384,priest,shadow,6,4,2
32053,Comoli,tichondrius,384,priest,shadow,6,4,2
32054,Adíos,malganis,384,priest,shadow,6,4,2
32055,Shieldspamx,tichondrius,384,priest,shadow,6,4,2
32056,Quartzolio,azralon,384,priest,shadow,6,4,2
32057,Valtres,tichondrius,384,priest,shadow,6,4,2
32058,Vengep,sargeras,384,priest,shadow,6,4,2
32059,Balverix,tichondrius,384,priest,shadow,6,4,2
32060,Schelleyyuki,tichondrius,384,priest,shadow,6,4,2
32061,Mindflay,tichondrius,384,priest,shadow,6,4,2
32062,Voidathon,sargeras,384,priest,shadow,6,4,2
32063,Minarhy,moon-guard,384,priest,shadow,6,4,2
32064,Iifa,medivh,384,priest,shadow,6,4,2
32065,Shiikari,terenas,384,priest,shadow,6,4,2
32066,Spôoky,illidan,384,priest,shadow,6,4,2
32067,Haedn,azralon,384,priest,shadow,6,4,2
32068,Kks,tichondrius,384,priest,shadow,6,4,2
32069,Despairx,tichondrius,384,priest,shadow,6,4,2
32070,Guillotine,azralon,384,priest,shadow,6,4,2
32071,Chapyh,malganis,384,priest,shadow,6,4,2
32072,Carosene,thrall,384,priest,shadow,6,4,2
32073,Cheach,echo-isles,384,priest,shadow,6,4,2
32074,Feminizm,tichondrius,384,priest,shadow,6,4,2
32075,Dnn,malganis,384,priest,shadow,6,4,2
32076,Ilumus,lightnings-blade,384,priest,shadow,6,4,2
32077,Yuricksus,malganis,384,priest,shadow,6,4,2
32078,Kynyssaelz,proudmoore,384,priest,shadow,6,4,2
32079,Ðrip,burning-legion,384,priest,shadow,6,4,2
32080,Killían,darkspear,384,priest,shadow,6,4,2
32081,Ydonburi,tichondrius,384,priest,shadow,6,4,2
32082,Píty,ragnaros,384,priest,shadow,6,4,2
32083,Itha,illidan,384,priest,shadow,6,4,2
32084,Káldorei,proudmoore,384,priest,shadow,6,4,2
32085,Mygameslaggy,area-52,384,priest,shadow,6,4,2
32086,Unclecam,tichondrius,384,priest,shadow,6,4,2
32087,Rôss,tichondrius,384,priest,shadow,6,4,2
32088,Didittouchme,sargeras,384,priest,shadow,6,4,2
32089,Iemon,vashj,384,priest,shadow,6,4,2
32090,Specter,duskwood,384,priest,shadow,6,4,2
32091,Shådøw,destromath,384,priest,shadow,6,4,2
32092,Ikiteforhash,zuljin,384,priest,shadow,6,4,2
32093,Prostrat,deathwing,384,priest,shadow,6,4,2
32094,Pootang,hyjal,384,priest,shadow,6,4,2
32095,Mutedox,frostmourne,384,priest,shadow,6,4,2
32096,Sungsh,zuljin,384,priest,shadow,6,4,2
32097,Äni,sargeras,384,priest,shadow,6,4,2
32098,Devinere,tichondrius,384,priest,shadow,6,4,2
32099,Rustydisc,area-52,384,priest,shadow,6,4,2
32100,Salanzosp,bleeding-hollow,384,priest,shadow,6,4,2
32101,Diskordia,stormrage,384,priest,shadow,6,4,2
32102,Bigskill,proudmoore,384,priest,shadow,6,4,2
32103,Bax,kilrogg,384,priest,shadow,6,4,2
32104,Shutkap,sargeras,384,priest,shadow,6,4,2
32105,Härpocrates,area-52,384,priest,shadow,6,4,2
32106,Judgejudyx,tichondrius,384,priest,shadow,6,4,2
32107,Prydas,tichondrius,384,priest,shadow,6,4,2
32108,Robertlee,stormrage,384,priest,shadow,6,4,2
32109,Dzikuss,aegwynn,384,priest,shadow,6,4,2
32110,Tethy,saurfang,384,priest,shadow,6,4,2
32111,Tiinkerbell,moon-guard,384,priest,shadow,6,4,2
32112,Mfn,deathwing,384,priest,shadow,11,4,7
32113,Mïndgames,kelthuzad,384,priest,shadow,12,4,8
32114,Mìçah,fizzcrank,384,priest,shadow,12,4,8
32115,Grimmyreap,malygos,384,priest,shadow,12,4,8
32116,Vaeryl,stormrage,384,priest,shadow,12,4,8
32117,Junethegreat,tichondrius,384,priest,shadow,12,4,8
32118,Tuggyp,tichondrius,384,priest,shadow,12,4,8
32119,Influencing,moon-guard,384,priest,shadow,12,4,8
32120,Aerith,barthilas,384,priest,shadow,12,4,8
32121,Dipidorko,proudmoore,384,priest,shadow,12,4,8
32122,Fhelurian,quelthalas,384,priest,shadow,12,4,8
32123,Aliciari,illidan,384,priest,shadow,12,4,8
32124,Brickzy,dalaran,384,priest,shadow,12,4,8
32125,Holydrop,sargeras,384,priest,shadow,12,4,8
32126,Nonbinary,trollbane,384,priest,shadow,12,4,8
32127,Deathbyhot,gorefiend,384,priest,shadow,12,4,8
32128,Nôtthehealer,sargeras,384,priest,shadow,12,4,8
32129,Jxkep,frostmourne,384,priest,shadow,12,4,8
32130,Lätöxïkä,alleria,384,priest,shadow,12,4,8
32131,Reverendpope,tichondrius,384,priest,shadow,12,4,8
32132,Fatäl,moon-guard,384,priest,shadow,12,4,8
32133,Dialis,frostmourne,384,priest,shadow,12,4,8
32134,Jikoguu,stormscale,384,priest,shadow,12,4,8
32135,Oligan,quelthalas,384,priest,shadow,12,4,8
32136,Tidbitsy,malganis,384,priest,shadow,12,4,8
32137,Fáll,bleeding-hollow,384,priest,shadow,12,4,8
32138,Mannyelf,ragnaros,384,priest,shadow,12,4,8
32139,Aexdawg,malganis,384,priest,shadow,12,4,8
32140,Tokaru,frostmourne,384,priest,shadow,12,4,8
32141,Tenaebreu,tichondrius,384,priest,shadow,13,4,9
32142,Temnah,sargeras,384,priest,shadow,18,4,14
32143,Arca,cenarion-circle,384,priest,shadow,18,4,14
32144,Skky,nagrand,383,priest,shadow,6,4,2
32145,Khenshin,ragnaros,383,priest,shadow,6,4,2
32146,Lùcìd,dalaran,383,priest,shadow,6,4,2
32147,Unfriend,sargeras,383,priest,shadow,12,4,8
32148,Rijonkulous,area-52,383,priest,shadow,12,4,8
32149,Jammý,burning-legion,383,priest,shadow,12,4,8
32150,Whisper,zuljin,383,priest,shadow,12,4,8
32151,Hermïs,stormrage,383,priest,shadow,12,4,8
32152,Zyte,stormrage,383,priest,shadow,14,4,10
32153,Nocappappy,tichondrius,383,priest,shadow,18,4,14
32154,Kkpriest,frostmourne,382,priest,shadow,6,4,2
32155,Daisydux,emerald-dream,382,priest,shadow,6,4,2
32156,Geulis,illidan,382,priest,shadow,12,4,8
32157,Bwansandi,blackrock,370,priest,shadow,38,8,30
32158,Sgiath,alleria,330,priest,shadow,15,6,9
32159,Libationz,area-52,329,priest,shadow,19,7,12
32160,Dtbündertree,nordrassil,319,priest,shadow,5,4,1
32161,Peazyqt,tichondrius,304,priest,shadow,7,4,3
32162,Oxytoxin,sargeras,304,priest,shadow,7,4,3
32163,ßoy,amanthul,288,priest,shadow,6,3,3
32164,Chewit,kargath,288,priest,shadow,6,3,3
32165,Enaan,proudmoore,288,priest,shadow,6,3,3
32166,Quantumgoat,tichondrius,288,priest,shadow,6,3,3
32167,Sumrand,frostmourne,288,priest,shadow,6,3,3
32168,Spspsp,illidan,288,priest,shadow,6,3,3
32169,Menorsita,tichondrius,288,priest,shadow,6,3,3
32170,Mhorkarion,quelthalas,288,priest,shadow,6,3,3
32171,Eddysmokes,tichondrius,288,priest,shadow,6,3,3
32172,Caiitlynn,quelthalas,288,priest,shadow,6,3,3
32173,Xandir,kaelthas,288,priest,shadow,6,3,3
32174,Alykus,emerald-dream,288,priest,shadow,6,3,3
32175,Roommatethor,thaurissan,288,priest,shadow,6,3,3
32176,Lucènt,frostmourne,288,priest,shadow,6,3,3
32177,Shakarot,illidan,288,priest,shadow,6,3,3
32178,Achllia,proudmoore,288,priest,shadow,6,3,3
32179,Spõt,stormrage,288,priest,shadow,6,3,3
32180,Oxxymoron,malganis,288,priest,shadow,6,3,3
32181,Intheway,bleeding-hollow,288,priest,shadow,6,3,3
32182,Evaldi,proudmoore,288,priest,shadow,6,3,3
32183,Jaliera,malganis,288,priest,shadow,6,3,3
32184,Exploded,moon-guard,288,priest,shadow,6,3,3
32185,Lolsodacans,malganis,288,priest,shadow,6,3,3
32186,Healiûm,bleeding-hollow,288,priest,shadow,6,3,3
32187,Beibeihang,tichondrius,288,priest,shadow,6,3,3
32188,Kellsyo,hyjal,288,priest,shadow,6,3,3
32189,Monytrain,emerald-dream,288,priest,shadow,6,3,3
32190,Pezziate,tichondrius,288,priest,shadow,6,3,3
32191,Mallox,quelthalas,288,priest,shadow,6,3,3
32192,Shaðows,malganis,288,priest,shadow,6,3,3
32193,Ozzx,stormrage,288,priest,shadow,6,3,3
32194,Toxictampax,azjolnerub,288,priest,shadow,6,3,3
32195,Mightyp,malganis,288,priest,shadow,6,3,3
32196,Vullena,moon-guard,288,priest,shadow,6,3,3
32197,Moselol,tichondrius,288,priest,shadow,6,3,3
32198,Egraner,drakkari,288,priest,shadow,6,3,3
32199,Dispersed,thrall,288,priest,shadow,6,3,3
32200,Runakk,stonemaul,288,priest,shadow,6,3,3
32201,Ej,altar-of-storms,288,priest,shadow,6,3,3
32202,Banmi,tichondrius,288,priest,shadow,6,3,3
32203,Xxmewo,sargeras,288,priest,shadow,6,3,3
32204,Ibringgears,tichondrius,288,priest,shadow,6,3,3
32205,Darkascended,arthas,288,priest,shadow,6,3,3
32206,Pics,emerald-dream,288,priest,shadow,6,3,3
32207,Limèria,emerald-dream,288,priest,shadow,6,3,3
32208,Valsong,argent-dawn,288,priest,shadow,6,3,3
32209,Osarin,sargeras,288,priest,shadow,6,3,3
32210,Nuclease,turalyon,288,priest,shadow,6,3,3
32211,Dontpvponme,illidan,288,priest,shadow,6,3,3
32212,Dumpesitwo,frostmourne,288,priest,shadow,6,3,3
32213,Suki,alleria,288,priest,shadow,6,3,3
32214,Judeath,area-52,288,priest,shadow,6,3,3
32215,Elitë,frostmourne,288,priest,shadow,6,3,3
32216,Soloqqt,tichondrius,288,priest,shadow,6,3,3
32217,Worldhealer,area-52,288,priest,shadow,6,3,3
32218,Aliciab,andorhal,288,priest,shadow,6,3,3
32219,Müyrica,ragnaros,288,priest,shadow,6,3,3
32220,Whalexo,kelthuzad,288,priest,shadow,6,3,3
32221,Voidballs,tichondrius,288,priest,shadow,6,3,3
32222,Xuxu,frostmourne,288,priest,shadow,6,3,3
32223,Samio,area-52,288,priest,shadow,6,3,3
32224,Reâpêr,kelthuzad,288,priest,shadow,6,3,3
32225,Pengwu,moon-guard,288,priest,shadow,6,3,3
32226,Nzuth,dalaran,288,priest,shadow,6,3,3
32227,Russbell,ragnaros,288,priest,shadow,6,3,3
32228,ßìrth,kelthuzad,288,priest,shadow,6,3,3
32229,Ossirus,emerald-dream,288,priest,shadow,6,3,3
32230,Scaadoosh,dalaran,288,priest,shadow,6,3,3
32231,Deathzpirit,kiljaeden,288,priest,shadow,6,3,3
32232,Auras,boulderfist,288,priest,shadow,6,3,3
32233,Halleßerry,illidan,288,priest,shadow,6,3,3
32234,Whittysp,tichondrius,288,priest,shadow,6,3,3
32235,Empyreanlite,dalaran,288,priest,shadow,6,3,3
32236,Bomanic,sargeras,288,priest,shadow,6,3,3
32237,Drelia,jubeithos,288,priest,shadow,6,3,3
32238,Crazchinkin,tichondrius,288,priest,shadow,6,3,3
32239,Randyortonn,tichondrius,288,priest,shadow,6,3,3
32240,Lnoh,area-52,288,priest,shadow,6,3,3
32241,Studpriest,tichondrius,288,priest,shadow,6,3,3
32242,Plumpkinn,kiljaeden,288,priest,shadow,6,3,3
32243,Cappoo,tichondrius,288,priest,shadow,6,3,3
32244,Caramelos,moon-guard,288,priest,shadow,6,3,3
32245,Cerriôus,baelgun,288,priest,shadow,6,3,3
32246,Wrathhealer,hellscream,288,priest,shadow,6,3,3
32247,Sealife,kelthuzad,288,priest,shadow,6,3,3
32248,Shadowp,shattered-halls,288,priest,shadow,6,3,3
32249,Bubbleguppyx,tichondrius,288,priest,shadow,6,3,3
32250,Webba,azshara,288,priest,shadow,6,3,3
32251,Lisau,tichondrius,288,priest,shadow,6,3,3
32252,Haransimongo,area-52,288,priest,shadow,6,3,3
32253,Reginaa,nemesis,288,priest,shadow,6,3,3
32254,Issaley,tichondrius,288,priest,shadow,6,3,3
32255,Avadrah,tichondrius,288,priest,shadow,6,3,3
32256,Lotros,area-52,288,priest,shadow,6,3,3
32257,Synisteria,sargeras,288,priest,shadow,6,3,3
32258,Lemmecastpls,sargeras,288,priest,shadow,6,3,3
32259,Shadowpáin,ragnaros,288,priest,shadow,6,3,3
32260,Earebus,dalaran,288,priest,shadow,6,3,3
32261,Strokkerzin,azralon,288,priest,shadow,6,3,3
32262,Döllyy,illidan,288,priest,shadow,6,3,3
32263,Adelen,illidan,288,priest,shadow,6,3,3
32264,Nizanz,illidan,288,priest,shadow,6,3,3
32265,Mlkchocolate,kelthuzad,288,priest,shadow,6,3,3
32266,Pogchamp,alterac-mountains,288,priest,shadow,6,3,3
32267,Etherrion,area-52,288,priest,shadow,6,3,3
32268,Leyspring,moon-guard,288,priest,shadow,6,3,3
32269,Nellìel,whisperwind,288,priest,shadow,6,3,3
32270,Mynameis,dethecus,288,priest,shadow,6,3,3
32271,Halîth,terenas,288,priest,shadow,6,3,3
32272,Kindyx,ragnaros,288,priest,shadow,6,3,3
32273,Sìkarìa,illidan,288,priest,shadow,6,3,3
32274,Onahaihu,tichondrius,288,priest,shadow,9,4,5
32275,Juícifer,illidan,288,priest,shadow,12,3,9
32276,Poppyp,stormrage,288,priest,shadow,12,3,9
32277,Scaryspise,nathrezim,288,priest,shadow,12,3,9
32278,Shadøwbølt,tichondrius,288,priest,shadow,12,3,9
32279,Dunnbledore,area-52,288,priest,shadow,12,3,9
32280,Mistmare,dalaran,288,priest,shadow,12,3,9
32281,Tylored,zuljin,288,priest,shadow,12,3,9
32282,Xeras,ravencrest,288,priest,shadow,12,3,9
32283,Stantz,burning-legion,288,priest,shadow,12,3,9
32284,Giantqid,malganis,288,priest,shadow,12,3,9
32285,Sybenela,proudmoore,288,priest,shadow,12,3,9
32286,Valuations,tichondrius,288,priest,shadow,12,3,9
32287,Shadowpain,the-underbog,288,priest,shadow,12,3,9
32288,Shadynasti,azshara,287,priest,shadow,6,3,3
32289,Midboss,illidan,287,priest,shadow,6,3,3
32290,Grímmz,veknilash,287,priest,shadow,7,3,4
32291,Telamorstus,illidan,287,priest,shadow,12,3,9
32292,Runswithrain,lethon,271,priest,shadow,17,3,14
32293,Griffsp,stormrage,239,priest,shadow,5,3,2
32294,Actiop,stormrage,223,priest,shadow,8,3,5
32295,Donkeycube,tichondrius,192,priest,shadow,4,3,1
32296,Holyhand,auchindoun,192,priest,shadow,4,3,1
32297,Shadowblax,thrall,192,priest,shadow,4,3,1
32298,Dagaen,thunderlord,192,priest,shadow,6,2,4
32299,Jdcii,tichondrius,192,priest,shadow,6,2,4
32300,Apâthy,area-52,192,priest,shadow,6,2,4
32301,Slctivhealng,area-52,192,priest,shadow,6,2,4
32302,Anxìetý,area-52,192,priest,shadow,6,2,4
32303,Layons,nemesis,192,priest,shadow,6,2,4
32304,Lolsithlord,tichondrius,192,priest,shadow,6,2,4
32305,Vinatt,illidan,192,priest,shadow,6,2,4
32306,Fleshliight,area-52,192,priest,shadow,6,2,4
32307,Quinnx,tichondrius,192,priest,shadow,6,2,4
32308,Bumbleedot,azralon,192,priest,shadow,6,2,4
32309,Psychohazard,area-52,192,priest,shadow,6,2,4
32310,Aliorixa,stormrage,192,priest,shadow,6,2,4
32311,Alukel,moon-guard,192,priest,shadow,6,2,4
32312,Ptheld,tichondrius,192,priest,shadow,6,2,4
32313,Kabutta,stormrage,192,priest,shadow,6,2,4
32314,Selspriest,kelthuzad,192,priest,shadow,6,2,4
32315,Midget,darkspear,192,priest,shadow,6,2,4
32316,Jjaeminkim,area-52,192,priest,shadow,6,2,4
32317,Murkqz,azralon,192,priest,shadow,6,2,4
32318,Clairvoyantt,tichondrius,192,priest,shadow,6,2,4
32319,Voidnoodles,area-52,192,priest,shadow,6,2,4
32320,Ateras,emerald-dream,192,priest,shadow,6,2,4
32321,Nickdeath,tichondrius,192,priest,shadow,6,2,4
32322,Onlyphantoms,kelthuzad,192,priest,shadow,6,2,4
32323,Chellelia,stormrage,192,priest,shadow,6,2,4
32324,Juliusceazer,skywall,192,priest,shadow,6,2,4
32325,Pandiwoodney,ragnaros,192,priest,shadow,6,2,4
32326,Sâltý,stormrage,192,priest,shadow,6,2,4
32327,Detainedz,malganis,192,priest,shadow,6,2,4
32328,Melithor,frostmourne,192,priest,shadow,6,2,4
32329,Lifejuice,tichondrius,192,priest,shadow,6,2,4
32330,Ariellie,area-52,192,priest,shadow,6,2,4
32331,Vanzera,thrall,192,priest,shadow,6,2,4
32332,Orethon,thrall,192,priest,shadow,6,2,4
32333,Kälashnikova,ragnaros,192,priest,shadow,6,2,4
32334,Löstský,azralon,192,priest,shadow,6,2,4
32335,Horsegirls,kelthuzad,192,priest,shadow,6,2,4
32336,Fatherleem,tichondrius,192,priest,shadow,6,2,4
32337,Pugsmugglerr,icecrown,192,priest,shadow,6,2,4
32338,Brounly,drakkari,192,priest,shadow,6,2,4
32339,Rätcömpx,bleeding-hollow,192,priest,shadow,6,2,4
32340,Aape,frostmourne,192,priest,shadow,6,2,4
32341,Nodorme,quelthalas,192,priest,shadow,6,2,4
32342,Notgoodatsp,bleeding-hollow,192,priest,shadow,6,2,4
32343,Enochian,hyjal,192,priest,shadow,6,2,4
32344,Geoat,barthilas,192,priest,shadow,6,2,4
32345,Priést,stormrage,192,priest,shadow,6,2,4
32346,Shrax,emerald-dream,192,priest,shadow,6,2,4
32347,Rucati,cenarius,192,priest,shadow,6,2,4
32348,Judis,barthilas,192,priest,shadow,6,2,4
32349,Dotdotdead,earthen-ring,192,priest,shadow,6,2,4
32350,Sâishâ,proudmoore,192,priest,shadow,6,2,4
32351,Uikaren,tichondrius,192,priest,shadow,6,2,4
32352,Scenekîd,moon-guard,192,priest,shadow,6,2,4
32353,Legitgayirl,zuljin,192,priest,shadow,6,2,4
32354,Sashatwo,proudmoore,192,priest,shadow,6,2,4
32355,Cryptoccocus,zuljin,192,priest,shadow,6,2,4
32356,Kryoff,illidan,192,priest,shadow,6,2,4
32357,Sorojín,zuljin,192,priest,shadow,6,2,4
32358,Beertriarch,frostmourne,192,priest,shadow,6,2,4
32359,Hrathren,caelestrasz,192,priest,shadow,6,2,4
32360,Innergee,aegwynn,192,priest,shadow,6,2,4
32361,Purrpleelff,saurfang,192,priest,shadow,6,2,4
32362,Furryoflife,suramar,192,priest,shadow,6,2,4
32363,Avanise,blackrock,192,priest,shadow,6,2,4
32364,Fruitbasketz,malganis,192,priest,shadow,6,2,4
32365,Byungsik,terenas,192,priest,shadow,6,2,4
32366,Laq,proudmoore,192,priest,shadow,6,2,4
32367,Projectalice,ravencrest,192,priest,shadow,6,2,4
32368,Hevnlyst,proudmoore,192,priest,shadow,6,2,4
32369,Pipete,frostmourne,192,priest,shadow,6,2,4
32370,Clistyn,quelthalas,192,priest,shadow,6,2,4
32371,Hail,kaelthas,192,priest,shadow,6,2,4
32372,Dogfrompark,illidan,192,priest,shadow,6,2,4
32373,Apparìtions,khazgoroth,192,priest,shadow,6,2,4
32374,Sshhaaddooww,tichondrius,192,priest,shadow,6,2,4
32375,Cxmplex,malganis,192,priest,shadow,6,2,4
32376,Shmmoie,frostmourne,192,priest,shadow,6,2,4
32377,Dippyzs,alterac-mountains,192,priest,shadow,6,2,4
32378,Clickbait,spirestone,192,priest,shadow,6,2,4
32379,Tomriddlle,sargeras,192,priest,shadow,6,2,4
32380,Prescella,sargeras,192,priest,shadow,6,2,4
32381,Lemmiewinkzx,sargeras,192,priest,shadow,6,2,4
32382,Kapriestsun,sargeras,192,priest,shadow,6,2,4
32383,Ozztwo,tichondrius,192,priest,shadow,12,2,10
32384,Alizhe,ragnaros,192,priest,shadow,12,2,10
32385,Caristae,kelthuzad,192,priest,shadow,12,2,10
32386,Kulrig,shuhalo,192,priest,shadow,12,2,10
32387,Tmpriest,tichondrius,175,priest,shadow,11,2,9
32388,Chü,dalaran,169,priest,shadow,12,5,7
32389,Vorial,cenarion-circle,159,priest,shadow,5,2,3
32390,Keser,kelthuzad,159,priest,shadow,5,2,3
32391,Dekomori,quelthalas,159,priest,shadow,5,2,3
32392,Tiizz,malganis,159,priest,shadow,5,2,3
32393,Pugadin,bleeding-hollow,159,priest,shadow,5,2,3
32394,Gobananas,bleeding-hollow,159,priest,shadow,5,2,3
32395,Myndz,stormrage,159,priest,shadow,5,2,3
32396,Gaeira,azralon,159,priest,shadow,11,2,9
32397,Winss,tichondrius,128,priest,shadow,4,2,2
32398,Cravex,stormrage,128,priest,shadow,4,2,2
32399,Tanthdrel,proudmoore,128,priest,shadow,6,2,4
32400,Omenous,area-52,128,priest,shadow,10,2,8
32401,Sätîvá,tichondrius,96,priest,shadow,3,2,1
32402,Priestthingz,area-52,96,priest,shadow,8,2,6
32403,Shadowreck,malganis,96,priest,shadow,6,1,5
32404,Shadowftw,illidan,96,priest,shadow,6,1,5
32405,Powerwordwap,malganis,96,priest,shadow,6,1,5
32406,Mangemoélqc,darkspear,96,priest,shadow,6,1,5
32407,Voidrisu,sargeras,96,priest,shadow,6,1,5
32408,Syrillia,wildhammer,96,priest,shadow,6,1,5
32409,Wrinkletink,whisperwind,96,priest,shadow,6,1,5
32410,Fámóus,stormrage,96,priest,shadow,6,1,5
32411,Ibangedaqt,malganis,96,priest,shadow,6,1,5
32412,Asmitä,stormrage,96,priest,shadow,6,1,5
32413,Zymmie,moon-guard,96,priest,shadow,6,1,5
32414,Jèf,stormrage,96,priest,shadow,6,1,5
32415,Sprinkling,sargeras,96,priest,shadow,6,1,5
32416,Icespice,anvilmar,96,priest,shadow,6,1,5
32417,Galestick,illidan,96,priest,shadow,6,1,5
32418,Cärdi,frostmourne,96,priest,shadow,6,1,5
32419,Dadsalad,zuljin,96,priest,shadow,6,1,5
32420,Kelody,zuljin,96,priest,shadow,6,1,5
32421,Mandisa,skywall,96,priest,shadow,6,1,5
32422,Nancynibbler,bleeding-hollow,96,priest,shadow,6,1,5
32423,Oxyy,aerie-peak,96,priest,shadow,6,1,5
32424,Vdip,illidan,96,priest,shadow,6,1,5
32425,Sadury,tichondrius,96,priest,shadow,6,1,5
32426,Tiskka,magtheridon,96,priest,shadow,6,1,5
32427,Shädë,emerald-dream,96,priest,shadow,6,1,5
32428,Rays,drakkari,96,priest,shadow,6,1,5
32429,Baerybonds,kiljaeden,96,priest,shadow,6,1,5
32430,Milliyakk,area-52,96,priest,shadow,6,1,5
32431,Mauriel,proudmoore,96,priest,shadow,6,1,5
32432,Fancyspork,illidan,96,priest,shadow,6,1,5
32433,Releknosleep,frostwolf,96,priest,shadow,6,1,5
32434,Tusket,black-dragonflight,96,priest,shadow,6,1,5
32435,Lilskizz,dalaran,96,priest,shadow,6,1,5
32436,Whatsittoya,tichondrius,96,priest,shadow,6,1,5
32437,Irilde,proudmoore,96,priest,shadow,6,1,5
32438,Bigdaddios,dalaran,96,priest,shadow,6,1,5
32439,Amikam,barthilas,96,priest,shadow,6,1,5
32440,Shadolord,illidan,96,priest,shadow,6,1,5
32441,Dazzlems,tichondrius,96,priest,shadow,6,1,5
32442,Vineller,malganis,96,priest,shadow,6,1,5
32443,Lukaspriest,proudmoore,96,priest,shadow,6,1,5
32444,Lôvecraft,frostmourne,96,priest,shadow,6,1,5
32445,Voidlordx,jubeithos,96,priest,shadow,6,1,5
32446,Omygawd,tichondrius,96,priest,shadow,6,1,5
32447,Psyward,tichondrius,96,priest,shadow,6,1,5
32448,Beliál,ragnaros,96,priest,shadow,6,1,5
32449,Nightboxer,tichondrius,96,priest,shadow,6,1,5
32450,Cultists,tichondrius,96,priest,shadow,6,1,5
32451,Dmlx,frostmourne,96,priest,shadow,6,1,5
32452,Jaquels,sargeras,96,priest,shadow,6,1,5
32453,Paingivër,drakkari,96,priest,shadow,6,1,5
32454,Kodaks,frostmourne,96,priest,shadow,6,1,5
32455,Óst,tichondrius,96,priest,shadow,6,1,5
32456,Slspookyx,tichondrius,96,priest,shadow,6,1,5
32457,Zway,moon-guard,96,priest,shadow,6,1,5
32458,Leliane,tichondrius,96,priest,shadow,6,1,5
32459,Stunsilence,tichondrius,96,priest,shadow,6,1,5
32460,Althlon,emerald-dream,96,priest,shadow,6,1,5
32461,Vyndictus,shattered-hand,96,priest,shadow,6,1,5
32462,Manryu,tichondrius,96,priest,shadow,6,1,5
32463,Lleak,tichondrius,96,priest,shadow,6,1,5
32464,Dawnbréaker,azralon,96,priest,shadow,6,1,5
32465,Jpray,bleeding-hollow,96,priest,shadow,12,1,11
32466,ßugsy,illidan,96,priest,shadow,12,1,11
32467,Murdangus,moon-guard,96,priest,shadow,12,1,11
32468,Bublethenrun,cenarius,79,priest,shadow,5,2,3
32469,Estarì,proudmoore,79,priest,shadow,5,1,4
32470,Xic,thrall,79,priest,shadow,5,1,4
32471,Kunof,ragnaros,79,priest,shadow,5,1,4
32472,Gorry,ragnaros,48,priest,shadow,6,2,4
32473,Fadehojx,illidan,42,priest,shadow,9,2,7
32474,Drpopepurp,tichondrius,31,priest,shadow,2,1,1
32475,Pilixil,bleeding-hollow,16,priest,shadow,1,1,0
32476,Trågédy,azjolnerub,16,priest,shadow,1,1,0
32477,Yellowrose,kelthuzad,2108,rogue,outlaw,121,69,52
32478,Weran,tichondrius,1890,rogue,outlaw,54,28,26
32479,Dvn,stormrage,1844,rogue,outlaw,54,32,22
32480,Welinth,thunderlord,1834,rogue,outlaw,426,219,207
32481,Sadiator,illidan,1810,rogue,outlaw,59,31,28
32482,Millspec,tichondrius,1762,rogue,outlaw,117,58,59
32483,Millspec,zuljin,1730,rogue,outlaw,42,25,17
32484,Dennerdz,tichondrius,1688,rogue,outlaw,47,19,28
32485,Arena,uldum,1665,rogue,outlaw,59,27,32
32486,Lycanthropî,illidan,1655,rogue,outlaw,80,37,43
32487,Gothamzzing,tichondrius,1648,rogue,outlaw,37,20,17
32488,Lardiconn,thrall,1628,rogue,outlaw,42,30,12
32489,Deadracer,moon-guard,1627,rogue,outlaw,60,32,28
32490,Lazeestab,sargeras,1618,rogue,outlaw,172,95,77
32491,Supherr,sargeras,1608,rogue,outlaw,41,20,21
32492,Càgil,stormrage,1607,rogue,outlaw,34,19,15
32493,Jmaxx,tichondrius,1603,rogue,outlaw,51,32,19
32494,Gnøver,ragnaros,1585,rogue,outlaw,88,45,43
32495,Xylvána,kiljaeden,1584,rogue,outlaw,72,32,40
32496,Swingonya,stormrage,1571,rogue,outlaw,36,18,18
32497,Supine,illidan,1539,rogue,outlaw,109,58,51
32498,Mirâge,illidan,1533,rogue,outlaw,50,28,22
32499,Omnïslash,stormrage,1519,rogue,outlaw,48,22,26
32500,Kentaki,tichondrius,1515,rogue,outlaw,60,33,27
32501,Karambit,frostmourne,1486,rogue,outlaw,120,54,66
32502,Blackmont,bleeding-hollow,1483,rogue,outlaw,53,32,21
32503,Velskud,area-52,1456,rogue,outlaw,76,39,37
32504,Jenaki,gurubashi,1442,rogue,outlaw,62,32,30
32505,Jolly,frostmourne,1440,rogue,outlaw,53,22,31
32506,Combo,norgannon,1426,rogue,outlaw,108,62,46
32507,Mgzx,tichondrius,1424,rogue,outlaw,108,60,48
32508,Trêl,velen,1416,rogue,outlaw,99,46,53
32509,Gotosor,quelthalas,1415,rogue,outlaw,144,73,71
32510,Shadowstryfe,tichondrius,1409,rogue,outlaw,47,22,25
32511,Disrawen,ragnaros,1406,rogue,outlaw,359,174,185
32512,Shindeiru,area-52,1399,rogue,outlaw,43,30,13
32513,Luolan,kargath,1378,rogue,outlaw,44,16,28
32514,Bleaklord,emerald-dream,1373,rogue,outlaw,48,17,31
32515,Itsuksiko,quelthalas,1368,rogue,outlaw,63,30,33
32516,Snakeblisken,emerald-dream,1352,rogue,outlaw,36,15,21
32517,Hobblefoot,proudmoore,1340,rogue,outlaw,46,24,22
32518,Dogeggs,area-52,1331,rogue,outlaw,30,14,16
32519,Trillkage,tichondrius,1330,rogue,outlaw,24,14,10
32520,Dross,shadowmoon,1325,rogue,outlaw,30,14,16
32521,Chrisdorner,area-52,1316,rogue,outlaw,25,14,11
32522,Jakamungo,area-52,1315,rogue,outlaw,46,22,24
32523,Reyskywalker,kelthuzad,1303,rogue,outlaw,24,15,9
32524,Shyzuku,drakkari,1303,rogue,outlaw,44,20,24
32525,Ntrfighter,tichondrius,1258,rogue,outlaw,71,36,35
32526,Wátchyoúrbák,wyrmrest-accord,1247,rogue,outlaw,30,14,16
32527,Straite,area-52,1244,rogue,outlaw,24,13,11
32528,Redimído,quelthalas,1244,rogue,outlaw,27,14,13
32529,Houlton,moon-guard,1234,rogue,outlaw,24,13,11
32530,Rynica,illidan,1197,rogue,outlaw,30,17,13
32531,Corevis,moon-guard,1149,rogue,outlaw,24,12,12
32532,Fastblast,wyrmrest-accord,1146,rogue,outlaw,24,12,12
32533,Mabushi,sargeras,1135,rogue,outlaw,42,15,27
32534,Cheddery,dalaran,1130,rogue,outlaw,63,30,33
32535,Zogbu,stormrage,1128,rogue,outlaw,42,17,25
32536,Vanorn,aerie-peak,1108,rogue,outlaw,54,17,37
32537,Adevoir,hakkar,1095,rogue,outlaw,60,31,29
32538,Zarthrox,bladefist,1086,rogue,outlaw,36,18,18
32539,Johnnyelbows,tichondrius,1078,rogue,outlaw,27,13,14
32540,Azarha,zuljin,1060,rogue,outlaw,66,34,32
32541,Tanadoril,wyrmrest-accord,1051,rogue,outlaw,24,11,13
32542,Wujn,tichondrius,1050,rogue,outlaw,24,11,13
32543,Lumifer,quelthalas,1050,rogue,outlaw,54,18,36
32544,Xyleth,azgalor,1048,rogue,outlaw,53,20,33
32545,Thèory,sargeras,1044,rogue,outlaw,24,11,13
32546,Valefarr,emerald-dream,1043,rogue,outlaw,29,13,16
32547,Mechamind,draka,1034,rogue,outlaw,18,11,7
32548,Slitherex,thunderlord,1031,rogue,outlaw,27,12,15
32549,Fryphilip,dalaran,1023,rogue,outlaw,28,11,17
32550,Abatoire,wyrmrest-accord,1020,rogue,outlaw,48,22,26
32551,Thuganomics,dark-iron,1008,rogue,outlaw,27,12,15
32552,Itricku,tichondrius,1008,rogue,outlaw,54,18,36
32553,Lawyergamer,bonechewer,1005,rogue,outlaw,38,16,22
32554,Emoond,ragnaros,989,rogue,outlaw,27,13,14
32555,Farstrider,tichondrius,974,rogue,outlaw,84,33,51
32556,Inhume,eredar,960,rogue,outlaw,24,10,14
32557,Larmx,tichondrius,960,rogue,outlaw,24,10,14
32558,Quapi,tichondrius,959,rogue,outlaw,18,10,8
32559,Preceptor,azralon,956,rogue,outlaw,24,10,14
32560,Nitroxy,quelthalas,950,rogue,outlaw,24,10,14
32561,Badpatatas,proudmoore,913,rogue,outlaw,42,10,32
32562,Shninzy,senjin,910,rogue,outlaw,31,11,20
32563,Zeed,ragnaros,866,rogue,outlaw,66,30,36
32564,Peteylee,stormrage,864,rogue,outlaw,18,9,9
32565,Asdestroyerr,tichondrius,863,rogue,outlaw,18,9,9
32566,Stabbythorus,stormrage,862,rogue,outlaw,18,9,9
32567,Bebesita,sisters-of-elune,860,rogue,outlaw,18,9,9
32568,Phraze,silvermoon,859,rogue,outlaw,30,14,16
32569,Vîllâîn,tichondrius,859,rogue,outlaw,24,9,15
32570,Coalie,tichondrius,816,rogue,outlaw,15,9,6
32571,Deepsyo,frostmourne,768,rogue,outlaw,12,8,4
32572,Lesty,kelthuzad,768,rogue,outlaw,12,8,4
32573,Airi,darkspear,768,rogue,outlaw,18,8,10
32574,Synj,frostmourne,767,rogue,outlaw,12,8,4
32575,Tarnished,ravenholdt,766,rogue,outlaw,24,8,16
32576,Thompson,bloodscalp,672,rogue,outlaw,12,7,5
32577,Minuss,rivendare,671,rogue,outlaw,12,7,5
32578,Drsinz,tichondrius,671,rogue,outlaw,18,7,11
32579,Slowtime,quelthalas,671,rogue,outlaw,18,7,11
32580,Evilkoreanz,tichondrius,670,rogue,outlaw,12,7,5
32581,Cosmicò,trollbane,670,rogue,outlaw,12,7,5
32582,Mhdz,tichondrius,669,rogue,outlaw,12,7,5
32583,Jamesallen,silvermoon,659,rogue,outlaw,12,7,5
32584,Fennick,tanaris,638,rogue,outlaw,25,7,18
32585,Roxy,ghostlands,623,rogue,outlaw,17,7,10
32586,Esky,tichondrius,576,rogue,outlaw,12,6,6
32587,Cathat,area-52,576,rogue,outlaw,12,6,6
32588,Deeppockets,sargeras,576,rogue,outlaw,12,6,6
32589,Cidi,moon-guard,576,rogue,outlaw,18,6,12
32590,Heliopolis,bleeding-hollow,576,rogue,outlaw,18,6,12
32591,Zanith,wyrmrest-accord,575,rogue,outlaw,12,6,6
32592,Sprork,kiljaeden,575,rogue,outlaw,18,6,12
32593,Drakariano,ragnaros,575,rogue,outlaw,18,6,12
32594,Deddyy,zuljin,574,rogue,outlaw,18,6,12
32595,Bonizzi,stormrage,573,rogue,outlaw,12,6,6
32596,Marraya,area-52,573,rogue,outlaw,12,6,6
32597,Listrew,stormrage,571,rogue,outlaw,12,6,6
32598,Maglove,nemesis,571,rogue,outlaw,12,6,6
32599,Hokagesasuke,bleeding-hollow,570,rogue,outlaw,24,6,18
32600,Furrykneecap,hyjal,567,rogue,outlaw,9,7,2
32601,Tmpikaboo,tichondrius,480,rogue,outlaw,6,5,1
32602,Sotypical,area-52,480,rogue,outlaw,6,5,1
32603,Tsubamë,tichondrius,480,rogue,outlaw,6,5,1
32604,Alexyy,blades-edge,480,rogue,outlaw,12,5,7
32605,Galfuran,burning-legion,480,rogue,outlaw,12,5,7
32606,Steviekìcks,frostmourne,480,rogue,outlaw,12,5,7
32607,Bootypie,hyjal,480,rogue,outlaw,12,5,7
32608,Sekkelx,moon-guard,480,rogue,outlaw,12,5,7
32609,Dultz,tichondrius,480,rogue,outlaw,12,5,7
32610,Spikiera,silvermoon,480,rogue,outlaw,18,5,13
32611,Earthinhorn,frostmourne,480,rogue,outlaw,18,5,13
32612,Kasharo,tichondrius,479,rogue,outlaw,12,5,7
32613,Sasskei,malganis,479,rogue,outlaw,12,5,7
32614,Stabbymcgee,duskwood,478,rogue,outlaw,12,5,7
32615,Xzarfi,moon-guard,478,rogue,outlaw,30,5,25
32616,Yerehmi,quelthalas,477,rogue,outlaw,6,5,1
32617,Alerana,dathremar,474,rogue,outlaw,12,5,7
32618,Darthkelso,arathor,465,rogue,outlaw,24,5,19
32619,Flashmob,zuljin,384,rogue,outlaw,6,4,2
32620,Xavar,malganis,384,rogue,outlaw,6,4,2
32621,Krypticstab,malganis,384,rogue,outlaw,6,4,2
32622,Xylvana,kiljaeden,384,rogue,outlaw,6,4,2
32623,Cireene,proudmoore,384,rogue,outlaw,6,4,2
32624,Uzell,sargeras,384,rogue,outlaw,6,4,2
32625,Kents,tichondrius,384,rogue,outlaw,6,4,2
32626,Alandoril,tichondrius,384,rogue,outlaw,6,4,2
32627,Gnòme,frostmourne,384,rogue,outlaw,6,4,2
32628,Shmoked,moon-guard,384,rogue,outlaw,12,4,8
32629,Sazor,ysera,384,rogue,outlaw,12,4,8
32630,Dayvanie,area-52,384,rogue,outlaw,12,4,8
32631,Nestha,quelthalas,384,rogue,outlaw,12,4,8
32632,Showclass,stormrage,384,rogue,outlaw,12,4,8
32633,Blingtronx,malganis,384,rogue,outlaw,12,4,8
32634,Subnini,kelthuzad,384,rogue,outlaw,18,4,14
32635,Gheez,quelthalas,383,rogue,outlaw,6,4,2
32636,Katanië,moon-guard,383,rogue,outlaw,12,4,8
32637,Daftjack,bleeding-hollow,381,rogue,outlaw,12,4,8
32638,Houdinilogic,skullcrusher,381,rogue,outlaw,12,4,8
32639,Ningaturtle,korgath,376,rogue,outlaw,18,4,14
32640,Siamés,quelthalas,319,rogue,outlaw,14,4,10
32641,Nello,runetotem,288,rogue,outlaw,6,3,3
32642,Twnk,stormrage,288,rogue,outlaw,6,3,3
32643,Karmagoodttv,stormrage,288,rogue,outlaw,6,3,3
32644,Instructor,area-52,288,rogue,outlaw,6,3,3
32645,Homeschoolx,moon-guard,288,rogue,outlaw,6,3,3
32646,Movze,area-52,288,rogue,outlaw,6,3,3
32647,Bàndit,wyrmrest-accord,288,rogue,outlaw,6,3,3
32648,Lacero,bonechewer,288,rogue,outlaw,6,3,3
32649,Alexdelion,tichondrius,288,rogue,outlaw,6,3,3
32650,Dookienotop,thunderhorn,288,rogue,outlaw,6,3,3
32651,Skoalr,thrall,288,rogue,outlaw,6,3,3
32652,Daehyun,moknathal,288,rogue,outlaw,6,3,3
32653,Bigcolumn,tichondrius,288,rogue,outlaw,6,3,3
32654,Hepatocyte,anvilmar,288,rogue,outlaw,6,3,3
32655,Dicenslice,proudmoore,288,rogue,outlaw,6,3,3
32656,Ghøstfäce,tichondrius,288,rogue,outlaw,6,3,3
32657,Machos,azralon,288,rogue,outlaw,6,3,3
32658,Rujkah,archimonde,288,rogue,outlaw,6,3,3
32659,Pikartz,stormrage,288,rogue,outlaw,6,3,3
32660,Hedillyan,azralon,288,rogue,outlaw,6,3,3
32661,Whaazz,emerald-dream,288,rogue,outlaw,6,3,3
32662,Amorfirion,frostmourne,288,rogue,outlaw,6,3,3
32663,Drpibb,ghostlands,288,rogue,outlaw,12,3,9
32664,Stabyou,sentinels,287,rogue,outlaw,6,3,3
32665,Grimthorn,icecrown,285,rogue,outlaw,12,3,9
32666,Hotboxthefox,illidan,253,rogue,outlaw,11,3,8
32667,Sabbathe,kargath,206,rogue,outlaw,8,3,5
32668,Creamcakepop,stormrage,192,rogue,outlaw,6,2,4
32669,Riprorin,stormrage,192,rogue,outlaw,6,2,4
32670,Violetrose,kelthuzad,192,rogue,outlaw,6,2,4
32671,Mud,saurfang,192,rogue,outlaw,6,2,4
32672,Nippsy,aerie-peak,192,rogue,outlaw,6,2,4
32673,Slobernocker,stormrage,192,rogue,outlaw,6,2,4
32674,Prisonshank,arthas,192,rogue,outlaw,6,2,4
32675,Touchthetip,bleeding-hollow,192,rogue,outlaw,6,2,4
32676,Kpr,sargeras,192,rogue,outlaw,6,2,4
32677,Jebubs,tichondrius,192,rogue,outlaw,6,2,4
32678,Nïck,korialstrasz,192,rogue,outlaw,6,2,4
32679,Dillwilly,moon-guard,192,rogue,outlaw,6,2,4
32680,ßuu,sargeras,192,rogue,outlaw,6,2,4
32681,Remonezero,moon-guard,192,rogue,outlaw,6,2,4
32682,Duskeron,cenarius,192,rogue,outlaw,6,2,4
32683,Jsyn,kiljaeden,192,rogue,outlaw,6,2,4
32684,Sxs,kiljaeden,192,rogue,outlaw,12,2,10
32685,Nikosneako,tichondrius,192,rogue,outlaw,12,2,10
32686,Òklahomie,frostwolf,191,rogue,outlaw,6,2,4
32687,Landrik,trollbane,191,rogue,outlaw,6,2,4
32688,Philliamson,azgalor,190,rogue,outlaw,12,2,10
32689,Lu,lethon,96,rogue,outlaw,6,1,5
32690,Dessenia,illidan,96,rogue,outlaw,6,1,5
32691,Rinestiria,arthas,96,rogue,outlaw,6,1,5
32692,Reginageorge,azuremyst,96,rogue,outlaw,6,1,5
32693,Walyo,stormrage,96,rogue,outlaw,6,1,5
32694,Fateapocryph,azralon,96,rogue,outlaw,6,1,5
32695,Sindor,azralon,96,rogue,outlaw,6,1,5
32696,Raimondo,frostmourne,96,rogue,outlaw,6,1,5
32697,Downsix,sargeras,96,rogue,outlaw,6,1,5
32698,Happyslice,stormrage,96,rogue,outlaw,6,1,5
32699,Xm,sargeras,96,rogue,outlaw,6,1,5
32700,Neilyo,barthilas,96,rogue,outlaw,6,1,5
32701,Whatsåpp,gallywix,96,rogue,outlaw,6,1,5
32702,Madge,area-52,96,rogue,outlaw,6,1,5
32703,Hîzzÿ,ghostlands,96,rogue,outlaw,12,1,11
32704,Culpera,undermine,95,rogue,outlaw,6,1,5
32705,Aliasfaker,stormrage,16,rogue,outlaw,1,1,0
32706,Erebüs,thunderlord,2312,rogue,subtlety,96,62,34
32707,Alexdelion,tichondrius,2142,rogue,subtlety,90,47,43
32708,Ymxxworld,tichondrius,2107,rogue,subtlety,96,49,47
32709,Røgüë,malganis,2100,rogue,subtlety,96,53,43
32710,Battzii,wyrmrest-accord,2032,rogue,subtlety,630,319,311
32711,Lies,dalaran,2010,rogue,subtlety,87,43,44
32712,Flashmob,zuljin,1991,rogue,subtlety,62,31,31
32713,Ajl,drenden,1966,rogue,subtlety,130,67,63
32714,Danrathm,sargeras,1955,rogue,subtlety,97,52,45
32715,Fotg,tichondrius,1944,rogue,subtlety,54,31,23
32716,Yázim,tichondrius,1935,rogue,subtlety,79,48,31
32717,Vendettita,quelthalas,1924,rogue,subtlety,78,42,36
32718,Stealthypoop,kelthuzad,1920,rogue,subtlety,95,49,46
32719,Roguesparrow,illidan,1896,rogue,subtlety,152,84,68
32720,Rangoons,tichondrius,1894,rogue,subtlety,60,36,24
32721,Norbury,tichondrius,1893,rogue,subtlety,83,40,43
32722,Wazowskiy,tichondrius,1886,rogue,subtlety,110,54,56
32723,Cydonian,ragnaros,1885,rogue,subtlety,126,71,55
32724,Slashthunder,blades-edge,1876,rogue,subtlety,54,29,25
32725,Antoninez,tichondrius,1871,rogue,subtlety,48,28,20
32726,Needbuff,tichondrius,1865,rogue,subtlety,54,25,29
32727,Ulley,sargeras,1857,rogue,subtlety,126,71,55
32728,Coopi,tichondrius,1853,rogue,subtlety,115,60,55
32729,Scuffedjr,tichondrius,1852,rogue,subtlety,84,37,47
32730,Kenpàchi,kelthuzad,1851,rogue,subtlety,104,56,48
32731,Himitu,tichondrius,1849,rogue,subtlety,89,46,43
32732,Wetit,illidan,1847,rogue,subtlety,84,56,28
32733,Coregx,tichondrius,1842,rogue,subtlety,36,24,12
32734,Wizlysnipz,tichondrius,1837,rogue,subtlety,66,39,27
32735,Rõý,area-52,1837,rogue,subtlety,42,23,19
32736,Shinigâmì,tichondrius,1836,rogue,subtlety,96,64,32
32737,Stunsofpuns,sargeras,1833,rogue,subtlety,60,33,27
32738,Æsshayádlay,tichondrius,1832,rogue,subtlety,46,23,23
32739,Brucerogue,tichondrius,1830,rogue,subtlety,236,125,111
32740,Maulline,tichondrius,1828,rogue,subtlety,42,20,22
32741,Fátálíty,tichondrius,1827,rogue,subtlety,60,30,30
32742,Smkgpvp,stormrage,1823,rogue,subtlety,68,43,25
32743,Howton,kelthuzad,1822,rogue,subtlety,24,19,5
32744,Clern,emerald-dream,1818,rogue,subtlety,65,35,30
32745,Ðèãth,area-52,1818,rogue,subtlety,36,19,17
32746,Celèphaïs,tichondrius,1817,rogue,subtlety,63,30,33
32747,Okaylmao,tichondrius,1816,rogue,subtlety,68,39,29
32748,Zerogh,tichondrius,1811,rogue,subtlety,129,75,54
32749,Ideology,azgalor,1811,rogue,subtlety,52,26,26
32750,Bigpump,lothar,1809,rogue,subtlety,60,33,27
32751,Bruítzy,barthilas,1809,rogue,subtlety,156,82,74
32752,Kellenx,moon-guard,1809,rogue,subtlety,139,71,68
32753,Díor,azralon,1807,rogue,subtlety,124,70,54
32754,Turtlespeed,thrall,1803,rogue,subtlety,123,74,49
32755,Stabem,moon-guard,1800,rogue,subtlety,63,39,24
32756,Yunggodmalik,whisperwind,1799,rogue,subtlety,48,19,29
32757,Minaciki,tichondrius,1798,rogue,subtlety,60,32,28
32758,Scuffedsr,tichondrius,1785,rogue,subtlety,36,19,17
32759,Silentkush,arthas,1774,rogue,subtlety,48,28,20
32760,Dvin,stormrage,1770,rogue,subtlety,54,30,24
32761,Gyokkó,sargeras,1770,rogue,subtlety,36,20,16
32762,Greyyfox,illidan,1754,rogue,subtlety,69,33,36
32763,Kidcutti,proudmoore,1749,rogue,subtlety,62,29,33
32764,Sasugay,sargeras,1748,rogue,subtlety,80,50,30
32765,Aaronjlol,tichondrius,1747,rogue,subtlety,36,23,13
32766,Assassìn,moon-guard,1746,rogue,subtlety,169,93,76
32767,Esky,tichondrius,1742,rogue,subtlety,57,28,29
32768,Lxw,frostmourne,1739,rogue,subtlety,61,29,32
32769,Axtually,proudmoore,1727,rogue,subtlety,102,57,45
32770,Baeruto,thunderlord,1726,rogue,subtlety,24,18,6
32771,Ganknvanish,tichondrius,1725,rogue,subtlety,168,82,86
32772,Bezeta,azralon,1724,rogue,subtlety,251,137,114
32773,Saprìse,darkspear,1710,rogue,subtlety,48,32,16
32774,Hiyõ,tichondrius,1705,rogue,subtlety,71,36,35
32775,Pxb,sargeras,1705,rogue,subtlety,88,40,48
32776,Poizzon,emerald-dream,1704,rogue,subtlety,67,37,30
32777,Majk,eldrethalas,1703,rogue,subtlety,76,37,39
32778,Whoox,khazgoroth,1695,rogue,subtlety,42,29,13
32779,Beanlord,spinebreaker,1693,rogue,subtlety,69,39,30
32780,Xiaozhi,tichondrius,1692,rogue,subtlety,52,26,26
32781,Siyeong,tichondrius,1688,rogue,subtlety,48,33,15
32782,Bobsaget,kiljaeden,1684,rogue,subtlety,94,48,46
32783,Yesua,ragnaros,1674,rogue,subtlety,229,116,113
32784,Dysxliec,dalaran,1672,rogue,subtlety,57,28,29
32785,Jaos,tichondrius,1667,rogue,subtlety,42,22,20
32786,Themosk,malganis,1656,rogue,subtlety,42,21,21
32787,Camlaw,area-52,1655,rogue,subtlety,90,52,38
32788,Zeiss,tichondrius,1652,rogue,subtlety,48,24,24
32789,Blakezilla,tichondrius,1648,rogue,subtlety,48,29,19
32790,Zipperx,tichondrius,1641,rogue,subtlety,65,34,31
32791,Cuizhudi,tichondrius,1639,rogue,subtlety,32,23,9
32792,Eekz,illidan,1638,rogue,subtlety,262,146,116
32793,Steef,arygos,1636,rogue,subtlety,92,54,38
32794,Îzu,ysera,1636,rogue,subtlety,63,36,27
32795,Furt,frostmourne,1633,rogue,subtlety,44,25,19
32796,Frusciante,nemesis,1630,rogue,subtlety,90,52,38
32797,Haiev,tichondrius,1630,rogue,subtlety,72,36,36
32798,Antos,tichondrius,1628,rogue,subtlety,24,17,7
32799,Shreddér,tichondrius,1628,rogue,subtlety,41,20,21
32800,Thèllè,sargeras,1625,rogue,subtlety,30,17,13
32801,Swadeecup,nagrand,1624,rogue,subtlety,36,17,19
32802,Vyrenn,destromath,1623,rogue,subtlety,87,43,44
32803,Bruitzygg,barthilas,1619,rogue,subtlety,44,20,24
32804,Preceptor,azralon,1614,rogue,subtlety,86,44,42
32805,Kyubïx,ragnaros,1609,rogue,subtlety,78,48,30
32806,Piscís,sargeras,1606,rogue,subtlety,60,31,29
32807,Skoalr,thrall,1604,rogue,subtlety,64,43,21
32808,Klawz,norgannon,1604,rogue,subtlety,48,29,19
32809,Taidath,area-52,1603,rogue,subtlety,42,20,22
32810,Runakó,kelthuzad,1603,rogue,subtlety,48,21,27
32811,Techie,frostmane,1600,rogue,subtlety,68,38,30
32812,Cahlee,sargeras,1600,rogue,subtlety,88,40,48
32813,Trc,illidan,1599,rogue,subtlety,30,17,13
32814,Hayzarc,malfurion,1598,rogue,subtlety,42,21,21
32815,Kalvish,dalaran,1597,rogue,subtlety,29,17,12
32816,Unshut,tichondrius,1588,rogue,subtlety,30,19,11
32817,Gnøver,ragnaros,1587,rogue,subtlety,160,93,67
32818,Wowamaze,aegwynn,1587,rogue,subtlety,82,46,36
32819,Tarny,illidan,1579,rogue,subtlety,58,25,33
32820,Plado,tichondrius,1574,rogue,subtlety,47,27,20
32821,Revelationzz,turalyon,1572,rogue,subtlety,70,37,33
32822,Chitovera,tichondrius,1566,rogue,subtlety,30,19,11
32823,Trizin,frostmourne,1563,rogue,subtlety,84,45,39
32824,Eekz,sargeras,1561,rogue,subtlety,167,84,83
32825,Grelinho,stormrage,1554,rogue,subtlety,66,26,40
32826,Kinbaal,bleeding-hollow,1544,rogue,subtlety,42,26,16
32827,Eviscerator,moon-guard,1544,rogue,subtlety,66,28,38
32828,Mirâge,illidan,1538,rogue,subtlety,39,23,16
32829,Prrey,hydraxis,1538,rogue,subtlety,49,19,30
32830,Dogpaws,moon-guard,1537,rogue,subtlety,34,22,12
32831,Mayhemghost,rexxar,1535,rogue,subtlety,72,40,32
32832,Mitsurí,sargeras,1534,rogue,subtlety,24,16,8
32833,Fela,crushridge,1531,rogue,subtlety,132,67,65
32834,Roguetrix,stormrage,1531,rogue,subtlety,120,54,66
32835,Rosoma,kelthuzad,1530,rogue,subtlety,40,23,17
32836,Asoj,tichondrius,1529,rogue,subtlety,36,16,20
32837,Notty,kelthuzad,1528,rogue,subtlety,36,22,14
32838,ßeep,windrunner,1525,rogue,subtlety,48,24,24
32839,Åer,dalaran,1524,rogue,subtlety,105,54,51
32840,Cut,ragnaros,1524,rogue,subtlety,100,50,50
32841,Dissociated,stormrage,1523,rogue,subtlety,47,17,30
32842,Acid,warsong,1520,rogue,subtlety,24,17,7
32843,Worrglaive,dalaran,1517,rogue,subtlety,104,58,46
32844,Killmebaby,lightnings-blade,1514,rogue,subtlety,48,26,22
32845,Kainm,stormrage,1514,rogue,subtlety,248,130,118
32846,Weenies,illidan,1513,rogue,subtlety,35,21,14
32847,Neonjk,ragnaros,1508,rogue,subtlety,24,16,8
32848,Mtvcribs,emerald-dream,1505,rogue,subtlety,24,16,8
32849,Illmatíc,kelthuzad,1502,rogue,subtlety,29,16,13
32850,Galaxybrain,icecrown,1498,rogue,subtlety,120,76,44
32851,Sit,frostwolf,1492,rogue,subtlety,64,36,28
32852,Rufian,ursin,1489,rogue,subtlety,54,28,26
32853,Axiy,stormrage,1482,rogue,subtlety,42,24,18
32854,Swanl,stormrage,1482,rogue,subtlety,59,33,26
32855,Tigerinu,stormreaver,1479,rogue,subtlety,37,21,16
32856,Jinglez,frostmourne,1478,rogue,subtlety,36,22,14
32857,Pince,black-dragonflight,1475,rogue,subtlety,36,21,15
32858,Lurios,rivendare,1475,rogue,subtlety,76,39,37
32859,Mosedz,tichondrius,1474,rogue,subtlety,48,28,20
32860,Brangs,ragnaros,1473,rogue,subtlety,42,23,19
32861,Saraelith,moon-guard,1472,rogue,subtlety,33,20,13
32862,Xleo,drakkari,1470,rogue,subtlety,149,75,74
32863,Bombman,tichondrius,1470,rogue,subtlety,77,34,43
32864,Pikabuu,bleeding-hollow,1468,rogue,subtlety,57,26,31
32865,Nightcloud,tichondrius,1466,rogue,subtlety,29,16,13
32866,Luradfate,dalaran,1464,rogue,subtlety,269,139,130
32867,Tulis,frostmourne,1462,rogue,subtlety,164,96,68
32868,Clownboots,tichondrius,1462,rogue,subtlety,53,23,30
32869,Stankyx,bleeding-hollow,1460,rogue,subtlety,66,37,29
32870,Vigílant,proudmoore,1460,rogue,subtlety,78,38,40
32871,Toxsith,tichondrius,1459,rogue,subtlety,74,43,31
32872,Kaliasteddin,area-52,1457,rogue,subtlety,70,34,36
32873,Scenna,stormrage,1457,rogue,subtlety,72,30,42
32874,Garrotte,tichondrius,1453,rogue,subtlety,86,33,53
32875,Vyll,stormrage,1452,rogue,subtlety,31,16,15
32876,Bugser,tichondrius,1451,rogue,subtlety,66,35,31
32877,Pichichi,frostmourne,1450,rogue,subtlety,57,34,23
32878,Trucidovaco,daggerspine,1449,rogue,subtlety,88,40,48
32879,Murked,barthilas,1447,rogue,subtlety,42,25,17
32880,Géminis,sargeras,1444,rogue,subtlety,30,17,13
32881,Rougething,bleeding-hollow,1443,rogue,subtlety,72,35,37
32882,ßaltø,bleeding-hollow,1437,rogue,subtlety,36,15,21
32883,Calebrogue,illidan,1436,rogue,subtlety,24,15,9
32884,Ricros,bleeding-hollow,1435,rogue,subtlety,43,20,23
32885,Errorless,moon-guard,1434,rogue,subtlety,60,29,31
32886,Smormu,bonechewer,1432,rogue,subtlety,36,17,19
32887,Epipenqt,dark-iron,1431,rogue,subtlety,42,26,16
32888,Hunchó,area-52,1431,rogue,subtlety,65,38,27
32889,Chãlons,tichondrius,1431,rogue,subtlety,84,42,42
32890,Brrant,tichondrius,1430,rogue,subtlety,24,15,9
32891,Yoskit,tichondrius,1429,rogue,subtlety,24,15,9
32892,Skitsöu,tichondrius,1429,rogue,subtlety,30,15,15
32893,Greasybbsea,illidan,1428,rogue,subtlety,78,36,42
32894,Gotto,icecrown,1424,rogue,subtlety,30,15,15
32895,Kibbs,korgath,1422,rogue,subtlety,60,30,30
32896,Eridian,tichondrius,1420,rogue,subtlety,85,40,45
32897,Tolthe,hyjal,1418,rogue,subtlety,80,40,40
32898,Jibdorf,destromath,1414,rogue,subtlety,18,15,3
32899,Axerax,draka,1412,rogue,subtlety,30,15,15
32900,Secrettecbot,barthilas,1411,rogue,subtlety,30,18,12
32901,Fulkrem,wyrmrest-accord,1410,rogue,subtlety,74,34,40
32902,Huskyi,dalaran,1408,rogue,subtlety,30,15,15
32903,Cv,proudmoore,1404,rogue,subtlety,42,23,19
32904,Quinity,wyrmrest-accord,1401,rogue,subtlety,186,94,92
32905,Arakine,uldaman,1398,rogue,subtlety,38,27,11
32906,Vaith,wyrmrest-accord,1398,rogue,subtlety,36,17,19
32907,Fofree,hyjal,1396,rogue,subtlety,46,26,20
32908,Seaki,illidan,1395,rogue,subtlety,23,15,8
32909,Yanh,tichondrius,1395,rogue,subtlety,36,16,20
32910,Superharry,tichondrius,1394,rogue,subtlety,42,22,20
32911,Abacura,moon-guard,1392,rogue,subtlety,106,58,48
32912,Speedboi,skullcrusher,1391,rogue,subtlety,110,65,45
32913,Sapyalater,thrall,1390,rogue,subtlety,186,96,90
32914,Bakedpotato,garithos,1390,rogue,subtlety,42,20,22
32915,Klâng,tichondrius,1389,rogue,subtlety,49,22,27
32916,Mistnazgul,quelthalas,1386,rogue,subtlety,94,53,41
32917,Neuschurke,warsong,1386,rogue,subtlety,42,23,19
32918,Sgtbuttfat,dalaran,1385,rogue,subtlety,41,20,21
32919,Saintt,khaz-modan,1384,rogue,subtlety,24,16,8
32920,Najohn,tichondrius,1384,rogue,subtlety,42,20,22
32921,Usernameqtxo,kelthuzad,1376,rogue,subtlety,63,27,36
32922,Ojibwe,tichondrius,1373,rogue,subtlety,28,15,13
32923,Kolander,tichondrius,1373,rogue,subtlety,58,29,29
32924,Ironfistofcn,tichondrius,1364,rogue,subtlety,60,32,28
32925,Tapwaterx,illidan,1361,rogue,subtlety,66,26,40
32926,Loquen,ragnaros,1358,rogue,subtlety,42,23,19
32927,Fkrueger,thrall,1358,rogue,subtlety,48,24,24
32928,Raymga,tichondrius,1355,rogue,subtlety,48,29,19
32929,Søprøle,ragnaros,1355,rogue,subtlety,86,50,36
32930,Emrogr,tichondrius,1354,rogue,subtlety,72,39,33
32931,Toestumper,sargeras,1354,rogue,subtlety,33,15,18
32932,Narcoleptic,dalaran,1346,rogue,subtlety,84,40,44
32933,Deadguys,tichondrius,1344,rogue,subtlety,54,25,29
32934,Corrier,tichondrius,1340,rogue,subtlety,24,14,10
32935,Onîkudaki,sargeras,1340,rogue,subtlety,36,14,22
32936,Lyfallah,proudmoore,1338,rogue,subtlety,121,66,55
32937,Spacebase,illidan,1337,rogue,subtlety,24,14,10
32938,Saltypwncake,illidan,1331,rogue,subtlety,30,14,16
32939,Jawnrogue,tichondrius,1328,rogue,subtlety,18,14,4
32940,Genève,dreadmaul,1327,rogue,subtlety,24,14,10
32941,Dustt,stormrage,1322,rogue,subtlety,30,21,9
32942,Gankolicious,nerzhul,1317,rogue,subtlety,18,14,4
32943,Lagault,muradin,1316,rogue,subtlety,66,38,28
32944,Tamsy,the-forgotten-coast,1315,rogue,subtlety,21,15,6
32945,Pleodonis,tichondrius,1314,rogue,subtlety,59,27,32
32946,Nicoaa,tichondrius,1312,rogue,subtlety,146,73,73
32947,Pegglerogue,fizzcrank,1311,rogue,subtlety,106,50,56
32948,Threeplates,silvermoon,1310,rogue,subtlety,30,14,16
32949,Lisnp,tichondrius,1304,rogue,subtlety,206,98,108
32950,Odelöt,drakkari,1302,rogue,subtlety,96,50,46
32951,Khorgan,mugthol,1301,rogue,subtlety,36,18,18
32952,Pocketman,barthilas,1299,rogue,subtlety,59,24,35
32953,Vanvanlords,azralon,1291,rogue,subtlety,32,15,17
32954,Turec,illidan,1290,rogue,subtlety,29,14,15
32955,Nooz,thrall,1282,rogue,subtlety,54,32,22
32956,Liryth,lightninghoof,1281,rogue,subtlety,51,29,22
32957,Ikmagine,icecrown,1281,rogue,subtlety,42,17,25
32958,Täy,thrall,1280,rogue,subtlety,47,23,24
32959,Thugspice,stormrage,1279,rogue,subtlety,53,26,27
32960,Flockavelli,zuljin,1275,rogue,subtlety,30,15,15
32961,Ikerz,tichondrius,1272,rogue,subtlety,27,14,13
32962,Pargo,quelthalas,1266,rogue,subtlety,67,30,37
32963,Pinksleep,sargeras,1266,rogue,subtlety,48,20,28
32964,Hollfex,nemesis,1265,rogue,subtlety,44,22,22
32965,Orangez,malfurion,1260,rogue,subtlety,30,17,13
32966,Lefteex,tichondrius,1260,rogue,subtlety,45,25,20
32967,Kawagreen,tichondrius,1260,rogue,subtlety,51,27,24
32968,Gothblade,malganis,1258,rogue,subtlety,30,15,15
32969,Xoltin,tichondrius,1258,rogue,subtlety,80,36,44
32970,Bloodraina,hyjal,1258,rogue,subtlety,52,23,29
32971,Dionavelynn,area-52,1255,rogue,subtlety,30,14,16
32972,Mcromance,khadgar,1253,rogue,subtlety,57,25,32
32973,Hiarolson,stormrage,1250,rogue,subtlety,33,17,16
32974,Twotimed,magtheridon,1250,rogue,subtlety,30,14,16
32975,Arbitér,moonrunner,1250,rogue,subtlety,64,25,39
32976,Tmpikaboo,tichondrius,1248,rogue,subtlety,18,13,5
32977,Lxke,stormrage,1247,rogue,subtlety,18,13,5
32978,Zurza,proudmoore,1247,rogue,subtlety,36,13,23
32979,Notxerian,stormrage,1246,rogue,subtlety,18,13,5
32980,Mirajoo,tichondrius,1245,rogue,subtlety,88,42,46
32981,Mylovejunex,tichondrius,1244,rogue,subtlety,18,13,5
32982,Termkilledu,moon-guard,1244,rogue,subtlety,36,21,15
32983,Endlesswaltz,zuljin,1243,rogue,subtlety,30,13,17
32984,Towncar,kelthuzad,1242,rogue,subtlety,24,13,11
32985,Vlone,icecrown,1240,rogue,subtlety,24,13,11
32986,Guiguzidr,illidan,1238,rogue,subtlety,64,35,29
32987,Stealthkid,tichondrius,1237,rogue,subtlety,24,13,11
32988,Lululee,tichondrius,1237,rogue,subtlety,36,13,23
32989,Bríng,illidan,1235,rogue,subtlety,24,16,8
32990,Variat,azralon,1235,rogue,subtlety,54,25,29
32991,Oddblade,stormrage,1232,rogue,subtlety,24,14,10
32992,Neilyo,barthilas,1230,rogue,subtlety,24,13,11
32993,Sapùwú,stormrage,1224,rogue,subtlety,93,49,44
32994,Gøblìn,tichondrius,1224,rogue,subtlety,33,14,19
32995,Harlyfknquin,jubeithos,1223,rogue,subtlety,50,24,26
32996,Noxik,blackrock,1217,rogue,subtlety,34,19,15
32997,Drsinz,tichondrius,1217,rogue,subtlety,67,28,39
32998,Frèyjä,bleeding-hollow,1216,rogue,subtlety,84,43,41
32999,Trâshy,stormrage,1215,rogue,subtlety,25,14,11
33000,Stanley,mugthol,1212,rogue,subtlety,24,13,11
33001,Suñg,tichondrius,1211,rogue,subtlety,30,14,16
33002,Dessenia,illidan,1208,rogue,subtlety,79,47,32
33003,Quickxsilver,tichondrius,1204,rogue,subtlety,42,18,24
33004,Maløkeirø,stormrage,1202,rogue,subtlety,67,29,38
33005,Abatoire,wyrmrest-accord,1201,rogue,subtlety,36,18,18
33006,Kylerxius,korgath,1192,rogue,subtlety,36,21,15
33007,Shellby,tichondrius,1192,rogue,subtlety,68,34,34
33008,Lilstab,hakkar,1191,rogue,subtlety,104,50,54
33009,Hattrìck,area-52,1185,rogue,subtlety,44,21,23
33010,Elmabrox,quelthalas,1183,rogue,subtlety,45,20,25
33011,Roxeni,tichondrius,1181,rogue,subtlety,28,13,15
33012,Eraticrogue,illidan,1178,rogue,subtlety,29,13,16
33013,Linkzq,frostmourne,1173,rogue,subtlety,35,13,22
33014,Abogansterr,ragnaros,1172,rogue,subtlety,122,65,57
33015,Wokemeup,bleeding-hollow,1168,rogue,subtlety,30,15,15
33016,Poohpants,frostmourne,1168,rogue,subtlety,75,36,39
33017,Zarkans,proudmoore,1162,rogue,subtlety,66,34,32
33018,Sabedoria,barthilas,1162,rogue,subtlety,84,43,41
33019,Ambushr,tichondrius,1161,rogue,subtlety,30,16,14
33020,Mendiant,azralon,1159,rogue,subtlety,59,26,33
33021,Gyrfalcon,spirestone,1156,rogue,subtlety,154,72,82
33022,Paulpitation,blood-furnace,1155,rogue,subtlety,39,15,24
33023,Håkünämãtåtä,stormrage,1152,rogue,subtlety,18,12,6
33024,Bèstworld,dalaran,1152,rogue,subtlety,24,12,12
33025,Airi,darkspear,1150,rogue,subtlety,24,12,12
33026,Gatõ,quelthalas,1150,rogue,subtlety,54,20,34
33027,Stealthyxd,arthas,1150,rogue,subtlety,36,12,24
33028,Itskanashi,frostmourne,1148,rogue,subtlety,75,33,42
33029,Yurasick,lightbringer,1147,rogue,subtlety,24,12,12
33030,Kaminokage,barthilas,1144,rogue,subtlety,45,15,30
33031,Staba,tichondrius,1143,rogue,subtlety,34,19,15
33032,Oilydaimon,tichondrius,1143,rogue,subtlety,61,29,32
33033,Draculà,wyrmrest-accord,1142,rogue,subtlety,48,26,22
33034,Hattorikun,proudmoore,1142,rogue,subtlety,24,12,12
33035,Smokepipe,nerzhul,1139,rogue,subtlety,24,14,10
33036,Rigotak,illidan,1139,rogue,subtlety,24,12,12
33037,Smashol,barthilas,1136,rogue,subtlety,54,23,31
33038,Imgunnacrumb,malganis,1131,rogue,subtlety,161,78,83
33039,Lozion,malganis,1131,rogue,subtlety,30,12,18
33040,Micromoon,windrunner,1131,rogue,subtlety,36,13,23
33041,Vangroen,quelthalas,1129,rogue,subtlety,24,14,10
33042,Hypermix,tichondrius,1129,rogue,subtlety,24,12,12
33043,Ninjadoo,tichondrius,1128,rogue,subtlety,18,12,6
33044,Miraclesap,stormrage,1127,rogue,subtlety,88,51,37
33045,Meer,balnazzar,1125,rogue,subtlety,34,24,10
33046,Studders,kiljaeden,1123,rogue,subtlety,24,12,12
33047,Doklim,spinebreaker,1122,rogue,subtlety,74,42,32
33048,Cutthroat,aegwynn,1121,rogue,subtlety,45,20,25
33049,Ctrlfreak,hellscream,1120,rogue,subtlety,24,12,12
33050,Winze,scilla,1115,rogue,subtlety,30,19,11
33051,Jeri,gundrak,1113,rogue,subtlety,30,17,13
33052,Harkknight,sargeras,1110,rogue,subtlety,204,108,96
33053,Humphugull,skullcrusher,1108,rogue,subtlety,35,12,23
33054,Stêf,zuljin,1107,rogue,subtlety,22,15,7
33055,Venace,agamaggan,1104,rogue,subtlety,23,12,11
33056,Jadier,emerald-dream,1103,rogue,subtlety,23,12,11
33057,Sahima,tichondrius,1101,rogue,subtlety,161,78,83
33058,Prisonshank,arthas,1093,rogue,subtlety,61,36,25
33059,Shadownibba,illidan,1091,rogue,subtlety,48,26,22
33060,Noriel,dathremar,1085,rogue,subtlety,30,13,17
33061,Jaanmonty,frostmourne,1081,rogue,subtlety,24,12,12
33062,Drapezz,kelthuzad,1077,rogue,subtlety,35,18,17
33063,Hotcarl,kiljaeden,1077,rogue,subtlety,28,14,14
33064,Riskgo,frostwolf,1071,rogue,subtlety,24,12,12
33065,Aynrand,drakkari,1070,rogue,subtlety,39,14,25
33066,Hahaurblind,perenolde,1068,rogue,subtlety,28,12,16
33067,Vanishman,ragnaros,1063,rogue,subtlety,24,12,12
33068,Larmx,tichondrius,1056,rogue,subtlety,12,11,1
33069,Sixcombopts,area-52,1056,rogue,subtlety,18,11,7
33070,Queuethunder,blades-edge,1055,rogue,subtlety,12,11,1
33071,Ozzinton,kelthuzad,1055,rogue,subtlety,18,11,7
33072,Tootsio,tichondrius,1054,rogue,subtlety,18,11,7
33073,Esmeraldas,frostmourne,1054,rogue,subtlety,18,11,7
33074,Danielsylerr,drakkari,1054,rogue,subtlety,24,11,13
33075,Rabe,nagrand,1053,rogue,subtlety,24,11,13
33076,Ninetaildfox,arthas,1051,rogue,subtlety,18,11,7
33077,Xvds,tichondrius,1051,rogue,subtlety,24,11,13
33078,Distract,quelthalas,1050,rogue,subtlety,18,11,7
33079,Corntens,area-52,1050,rogue,subtlety,20,11,9
33080,Cerut,illidan,1050,rogue,subtlety,24,11,13
33081,Faxingberlin,skullcrusher,1049,rogue,subtlety,24,11,13
33082,Hakuchi,tichondrius,1049,rogue,subtlety,24,11,13
33083,Négrá,ragnaros,1048,rogue,subtlety,18,11,7
33084,Nadari,cenarius,1048,rogue,subtlety,66,31,35
33085,Mermm,burning-blade,1048,rogue,subtlety,24,11,13
33086,Trolladrão,goldrinn,1048,rogue,subtlety,24,11,13
33087,Ðarkrøøxs,stormrage,1048,rogue,subtlety,24,11,13
33088,Santyno,ragnaros,1047,rogue,subtlety,120,56,64
33089,Laotrec,nemesis,1045,rogue,subtlety,33,12,21
33090,Olg,arathor,1043,rogue,subtlety,71,36,35
33091,Hyperdexia,stormrage,1042,rogue,subtlety,88,47,41
33092,Soulvex,barthilas,1040,rogue,subtlety,18,11,7
33093,Allirra,ragnaros,1037,rogue,subtlety,30,19,11
33094,Abaløne,tichondrius,1037,rogue,subtlety,55,22,33
33095,Eryx,mugthol,1033,rogue,subtlety,18,11,7
33096,Kachimodo,illidan,1029,rogue,subtlety,42,20,22
33097,Topapple,mugthol,1021,rogue,subtlety,30,14,16
33098,Esker,dragonmaw,1021,rogue,subtlety,30,12,18
33099,Rarkalth,azralon,1020,rogue,subtlety,41,13,28
33100,Maewyn,aerie-peak,1019,rogue,subtlety,25,11,14
33101,Sneakyshots,emerald-dream,1017,rogue,subtlety,13,11,2
33102,Slackness,bleeding-hollow,1015,rogue,subtlety,61,35,26
33103,Fateapocryph,azralon,1014,rogue,subtlety,26,13,13
33104,Indivisible,thunderlord,1009,rogue,subtlety,30,13,17
33105,Korviz,area-52,1008,rogue,subtlety,60,30,30
33106,Bloodwish,tichondrius,1007,rogue,subtlety,23,11,12
33107,Ghost,shattered-halls,1006,rogue,subtlety,68,27,41
33108,Log,blackhand,1004,rogue,subtlety,36,18,18
33109,Onara,quelthalas,1003,rogue,subtlety,30,18,12
33110,Relidria,thrall,1002,rogue,subtlety,30,18,12
33111,Feragho,tichondrius,992,rogue,subtlety,34,11,23
33112,Sadtears,thrall,990,rogue,subtlety,16,11,5
33113,Oldgate,azralon,988,rogue,subtlety,17,11,6
33114,Jalaroot,frostmourne,985,rogue,subtlety,23,13,10
33115,Bubblesr,whisperwind,980,rogue,subtlety,48,22,26
33116,Mcghanhain,aegwynn,971,rogue,subtlety,24,11,13
33117,Lesliechow,sargeras,967,rogue,subtlety,52,28,24
33118,Ascherx,veknilash,960,rogue,subtlety,12,10,2
33119,ßuu,sargeras,960,rogue,subtlety,12,10,2
33120,Spaca,kelthuzad,959,rogue,subtlety,18,10,8
33121,Eazyg,tichondrius,959,rogue,subtlety,18,10,8
33122,Caldø,tichondrius,958,rogue,subtlety,12,10,2
33123,Zaszune,stormrage,958,rogue,subtlety,18,10,8
33124,Lucki,tichondrius,958,rogue,subtlety,18,10,8
33125,Aszombie,tichondrius,957,rogue,subtlety,12,10,2
33126,Vavnmusic,illidan,957,rogue,subtlety,18,10,8
33127,Rooke,draktharon,957,rogue,subtlety,24,10,14
33128,Stuntedscamp,bleeding-hollow,957,rogue,subtlety,24,10,14
33129,Shilaya,dreadmaul,957,rogue,subtlety,24,10,14
33130,Reclusivexo,tichondrius,956,rogue,subtlety,24,10,14
33131,Merkules,dalaran,955,rogue,subtlety,16,11,5
33132,Înfêrnô,emerald-dream,955,rogue,subtlety,24,10,14
33133,Poogodx,proudmoore,954,rogue,subtlety,12,10,2
33134,Kilrogga,azshara,953,rogue,subtlety,24,12,12
33135,Moufwash,sargeras,952,rogue,subtlety,24,10,14
33136,Kahlx,azralon,952,rogue,subtlety,24,10,14
33137,Uchihaputin,tichondrius,951,rogue,subtlety,24,10,14
33138,Arwy,stormrage,948,rogue,subtlety,19,11,8
33139,Definitioni,area-52,945,rogue,subtlety,19,10,9
33140,Alrynik,stormrage,939,rogue,subtlety,18,10,8
33141,Sildin,sargeras,938,rogue,subtlety,18,10,8
33142,Undreas,kiljaeden,935,rogue,subtlety,243,118,125
33143,Degrok,quelthalas,926,rogue,subtlety,35,18,17
33144,Swayo,tichondrius,920,rogue,subtlety,18,10,8
33145,Macsap,frostmourne,918,rogue,subtlety,30,10,20
33146,Toe,boulderfist,912,rogue,subtlety,27,13,14
33147,Misthios,chogall,911,rogue,subtlety,23,10,13
33148,Kidcudi,bonechewer,905,rogue,subtlety,30,10,20
33149,Silentmoralz,tichondrius,903,rogue,subtlety,35,10,25
33150,Skallywagg,emerald-dream,902,rogue,subtlety,46,18,28
33151,Ninjamf,bleeding-hollow,894,rogue,subtlety,14,10,4
33152,Mhün,malganis,891,rogue,subtlety,22,10,12
33153,Sxs,kiljaeden,878,rogue,subtlety,23,10,13
33154,Bimbogirl,dalaran,865,rogue,subtlety,22,11,11
33155,Votekanye,bleeding-hollow,864,rogue,subtlety,12,9,3
33156,Yodiegang,tichondrius,864,rogue,subtlety,12,9,3
33157,Chainsarogue,stormrage,864,rogue,subtlety,12,9,3
33158,Ðankbud,barthilas,864,rogue,subtlety,21,10,11
33159,Aghanaar,burning-legion,863,rogue,subtlety,18,9,9
33160,Illoo,frostmourne,863,rogue,subtlety,24,9,15
33161,Proddivus,stormrage,863,rogue,subtlety,30,9,21
33162,Poolover,barthilas,862,rogue,subtlety,18,9,9
33163,Cosmicò,trollbane,861,rogue,subtlety,12,9,3
33164,Blitzree,thrall,861,rogue,subtlety,12,9,3
33165,Filid,frostmourne,861,rogue,subtlety,18,9,9
33166,Lanres,stormrage,860,rogue,subtlety,12,9,3
33167,Biggisdiggis,tichondrius,860,rogue,subtlety,12,9,3
33168,Woollord,frostmourne,860,rogue,subtlety,18,9,9
33169,Larceny,emerald-dream,860,rogue,subtlety,24,9,15
33170,Raqed,eredar,860,rogue,subtlety,24,9,15
33171,Overzz,azralon,859,rogue,subtlety,21,9,12
33172,Gannjalord,frostmane,858,rogue,subtlety,22,10,12
33173,Krolczz,tichondrius,857,rogue,subtlety,18,9,9
33174,Jhors,tichondrius,856,rogue,subtlety,18,9,9
33175,Dizzm,area-52,847,rogue,subtlety,12,9,3
33176,Aelnoor,ragnaros,846,rogue,subtlety,24,9,15
33177,Ayo,exodar,845,rogue,subtlety,18,9,9
33178,Cutindle,illidan,842,rogue,subtlety,18,9,9
33179,Samllnuts,area-52,837,rogue,subtlety,24,11,13
33180,Elßronkas,quelthalas,836,rogue,subtlety,48,21,27
33181,Zamji,tichondrius,834,rogue,subtlety,20,9,11
33182,Yellowdeep,tichondrius,831,rogue,subtlety,14,10,4
33183,Alexon,wyrmrest-accord,828,rogue,subtlety,84,35,49
33184,Trillkage,tichondrius,797,rogue,subtlety,26,9,17
33185,Zelthy,frostmourne,790,rogue,subtlety,17,9,8
33186,Redtvco,blackrock,789,rogue,subtlety,17,9,8
33187,Astutý,illidan,768,rogue,subtlety,12,8,4
33188,Tyrrantxo,agamaggan,768,rogue,subtlety,12,8,4
33189,Wîzz,bleeding-hollow,768,rogue,subtlety,12,8,4
33190,Lesty,kelthuzad,768,rogue,subtlety,12,8,4
33191,Nicørøbin,tichondrius,768,rogue,subtlety,12,8,4
33192,Czd,frostmourne,768,rogue,subtlety,12,8,4
33193,Originalfake,sargeras,768,rogue,subtlety,12,8,4
33194,Adept,whisperwind,768,rogue,subtlety,12,8,4
33195,Decóm,zuljin,768,rogue,subtlety,16,9,7
33196,Köfy,quelthalas,768,rogue,subtlety,17,8,9
33197,Wowcode,tichondrius,768,rogue,subtlety,18,8,10
33198,Zefeckz,tichondrius,768,rogue,subtlety,18,8,10
33199,Heegawn,proudmoore,768,rogue,subtlety,18,8,10
33200,Bungou,tichondrius,768,rogue,subtlety,18,8,10
33201,Getfkdkid,tichondrius,768,rogue,subtlety,24,8,16
33202,Donnice,area-52,767,rogue,subtlety,12,8,4
33203,Kiingspade,tichondrius,767,rogue,subtlety,12,8,4
33204,Gankbang,mugthol,767,rogue,subtlety,12,8,4
33205,Writhes,sargeras,767,rogue,subtlety,12,8,4
33206,Fence,moon-guard,767,rogue,subtlety,18,8,10
33207,Ilesire,frostmourne,767,rogue,subtlety,18,8,10
33208,Nítzy,quelthalas,767,rogue,subtlety,24,8,16
33209,Chancelör,illidan,766,rogue,subtlety,12,8,4
33210,Razmir,malfurion,766,rogue,subtlety,18,8,10
33211,Ntshaav,illidan,766,rogue,subtlety,18,8,10
33212,Glíz,bloodscalp,765,rogue,subtlety,18,8,10
33213,Yato,mugthol,764,rogue,subtlety,12,8,4
33214,Subtlepuddle,bleeding-hollow,764,rogue,subtlety,24,8,16
33215,Vexyz,tichondrius,763,rogue,subtlety,18,8,10
33216,Defaces,illidan,762,rogue,subtlety,12,8,4
33217,Wolfmans,trollbane,762,rogue,subtlety,12,8,4
33218,Shivlightnin,tichondrius,762,rogue,subtlety,24,8,16
33219,Deathben,tichondrius,761,rogue,subtlety,30,8,22
33220,Mhasto,azralon,759,rogue,subtlety,18,8,10
33221,Kerimoynihan,barthilas,757,rogue,subtlety,28,11,17
33222,Nijanari,wyrmrest-accord,754,rogue,subtlety,24,8,16
33223,Nuff,emerald-dream,736,rogue,subtlety,16,8,8
33224,Stunjunky,area-52,733,rogue,subtlety,17,8,9
33225,Bladefang,quelthalas,732,rogue,subtlety,17,10,7
33226,Fearnomore,destromath,729,rogue,subtlety,72,24,48
33227,Brocolini,zuljin,706,rogue,subtlety,21,10,11
33228,Syxs,sargeras,672,rogue,subtlety,12,7,5
33229,Whoô,khazgoroth,672,rogue,subtlety,12,7,5
33230,Yangsol,stormrage,672,rogue,subtlety,12,7,5
33231,Coughsyrup,sargeras,672,rogue,subtlety,12,7,5
33232,Joeyzord,stormrage,672,rogue,subtlety,12,7,5
33233,Frooty,stormrage,672,rogue,subtlety,12,7,5
33234,Sandorroguee,stormrage,672,rogue,subtlety,12,7,5
33235,Bloodyhairy,area-52,672,rogue,subtlety,12,7,5
33236,Nines,icecrown,672,rogue,subtlety,12,7,5
33237,Feyahni,wyrmrest-accord,672,rogue,subtlety,12,7,5
33238,Smang,mugthol,672,rogue,subtlety,12,7,5
33239,Ythgie,altar-of-storms,672,rogue,subtlety,12,7,5
33240,Bobfoonk,tichondrius,672,rogue,subtlety,12,7,5
33241,Mesqeets,kelthuzad,672,rogue,subtlety,12,7,5
33242,Wimpz,hyjal,672,rogue,subtlety,12,7,5
33243,Flaremagnet,whisperwind,672,rogue,subtlety,12,7,5
33244,Wowtheskill,illidan,672,rogue,subtlety,12,7,5
33245,Àsgà,area-52,672,rogue,subtlety,12,7,5
33246,Qq,doomhammer,672,rogue,subtlety,12,7,5
33247,Memoríst,frostmourne,672,rogue,subtlety,18,7,11
33248,Clicksbtns,area-52,672,rogue,subtlety,18,7,11
33249,Jexy,barthilas,672,rogue,subtlety,18,7,11
33250,Spytes,kiljaeden,672,rogue,subtlety,18,7,11
33251,Niwbor,azralon,672,rogue,subtlety,24,7,17
33252,Liquidmojo,tichondrius,671,rogue,subtlety,12,7,5
33253,Christiaan,area-52,671,rogue,subtlety,12,7,5
33254,Darkìs,tichondrius,671,rogue,subtlety,12,7,5
33255,Keepitshadow,frostmourne,671,rogue,subtlety,12,7,5
33256,Bloodylegend,altar-of-storms,671,rogue,subtlety,12,7,5
33257,Xemnxnt,stormrage,671,rogue,subtlety,12,7,5
33258,Kazzo,tichondrius,671,rogue,subtlety,12,7,5
33259,Yurkarogue,tichondrius,671,rogue,subtlety,12,7,5
33260,Salätzar,quelthalas,671,rogue,subtlety,15,8,7
33261,Sapzz,tichondrius,671,rogue,subtlety,18,7,11
33262,Nezumikami,malganis,671,rogue,subtlety,18,7,11
33263,Calimari,frostmourne,671,rogue,subtlety,18,7,11
33264,ßecomeðeath,tichondrius,671,rogue,subtlety,18,7,11
33265,Brilliance,skywall,671,rogue,subtlety,18,7,11
33266,Felistrien,wyrmrest-accord,671,rogue,subtlety,18,7,11
33267,Vex,durotan,671,rogue,subtlety,24,7,17
33268,Jdmg,azralon,670,rogue,subtlety,12,7,5
33269,Burningfury,arthas,670,rogue,subtlety,18,7,11
33270,Takamoto,windrunner,670,rogue,subtlety,18,7,11
33271,Yunaka,grizzly-hills,670,rogue,subtlety,24,7,17
33272,Rykojin,sargeras,669,rogue,subtlety,12,7,5
33273,Anteccessor,tichondrius,669,rogue,subtlety,18,7,11
33274,Jagó,malganis,667,rogue,subtlety,12,7,5
33275,Chompycat,tichondrius,667,rogue,subtlety,18,7,11
33276,Srmazakre,ragnaros,667,rogue,subtlety,18,7,11
33277,Mercaderps,frostmourne,667,rogue,subtlety,24,7,17
33278,Zapersapp,malygos,666,rogue,subtlety,24,7,17
33279,Dogedealer,ragnaros,665,rogue,subtlety,12,7,5
33280,Kody,dalaran,639,rogue,subtlety,17,7,10
33281,Carpe,barthilas,618,rogue,subtlety,24,8,16
33282,Lilshanker,tichondrius,617,rogue,subtlety,22,8,14
33283,Lerosi,malganis,615,rogue,subtlety,29,7,22
33284,Gptcodeplay,tichondrius,576,rogue,subtlety,6,6,0
33285,Donçorleone,stormrage,576,rogue,subtlety,6,6,0
33286,Manersi,akama,576,rogue,subtlety,6,6,0
33287,Deadshank,bleeding-hollow,576,rogue,subtlety,6,6,0
33288,Homarx,quelthalas,576,rogue,subtlety,10,7,3
33289,Avelmire,sargeras,576,rogue,subtlety,12,6,6
33290,Aleh,exodar,576,rogue,subtlety,12,6,6
33291,Ãnimefãnx,moon-guard,576,rogue,subtlety,12,6,6
33292,Popss,whisperwind,576,rogue,subtlety,12,6,6
33293,Delphyax,azralon,576,rogue,subtlety,12,6,6
33294,Tmpikaboo,mugthol,576,rogue,subtlety,12,6,6
33295,Fkq,emerald-dream,576,rogue,subtlety,12,6,6
33296,Topfloorboss,illidan,576,rogue,subtlety,12,6,6
33297,Littlescrub,frostmourne,576,rogue,subtlety,12,6,6
33298,Pamaaj,sargeras,576,rogue,subtlety,12,6,6
33299,Nemoye,tichondrius,576,rogue,subtlety,12,6,6
33300,Shadxr,tichondrius,576,rogue,subtlety,12,6,6
33301,Unholydood,bonechewer,576,rogue,subtlety,12,6,6
33302,Kindasorry,illidan,576,rogue,subtlety,12,6,6
33303,Hykoo,tichondrius,576,rogue,subtlety,12,6,6
33304,Pokekek,stormrage,576,rogue,subtlety,12,6,6
33305,Dërpt,tichondrius,576,rogue,subtlety,12,6,6
33306,Palumor,deathwing,576,rogue,subtlety,12,6,6
33307,Lymon,azralon,576,rogue,subtlety,12,6,6
33308,Jannie,rexxar,576,rogue,subtlety,12,6,6
33309,Draiygo,nerzhul,576,rogue,subtlety,12,6,6
33310,Lunatixz,emerald-dream,576,rogue,subtlety,12,6,6
33311,Revila,bleeding-hollow,576,rogue,subtlety,12,6,6
33312,Xedi,illidan,576,rogue,subtlety,12,6,6
33313,Candren,area-52,576,rogue,subtlety,12,6,6
33314,Cinnashank,darkspear,576,rogue,subtlety,18,6,12
33315,Kents,tichondrius,576,rogue,subtlety,18,6,12
33316,Saltymann,bleeding-hollow,576,rogue,subtlety,18,6,12
33317,Swippz,tichondrius,576,rogue,subtlety,18,6,12
33318,Drakariano,ragnaros,576,rogue,subtlety,18,6,12
33319,Nihue,terenas,576,rogue,subtlety,18,6,12
33320,Goopthicc,sargeras,576,rogue,subtlety,18,6,12
33321,Jácket,area-52,576,rogue,subtlety,24,6,18
33322,Struggle,sargeras,576,rogue,subtlety,24,6,18
33323,Aitormenta,ragnaros,575,rogue,subtlety,6,6,0
33324,Calvin,moon-guard,575,rogue,subtlety,12,6,6
33325,Jinxkiller,tichondrius,575,rogue,subtlety,12,6,6
33326,Maulgryve,frostwolf,575,rogue,subtlety,12,6,6
33327,Mcnastier,dunemaul,575,rogue,subtlety,12,6,6
33328,Azanax,area-52,575,rogue,subtlety,12,6,6
33329,Gank,jubeithos,575,rogue,subtlety,12,6,6
33330,Boredomkills,frostmane,575,rogue,subtlety,12,6,6
33331,Whothekilla,tichondrius,575,rogue,subtlety,12,6,6
33332,Dreamcatcher,azralon,575,rogue,subtlety,18,6,12
33333,Ballflicker,malganis,575,rogue,subtlety,18,6,12
33334,Zogbu,stormrage,575,rogue,subtlety,18,6,12
33335,Poofus,vashj,575,rogue,subtlety,18,6,12
33336,Píxíedúst,black-dragonflight,574,rogue,subtlety,18,6,12
33337,Alttee,proudmoore,573,rogue,subtlety,12,6,6
33338,Iapologize,area-52,572,rogue,subtlety,12,6,6
33339,Supminty,stormrage,571,rogue,subtlety,12,6,6
33340,Xylow,garona,571,rogue,subtlety,27,6,21
33341,Confianzudo,ragnaros,567,rogue,subtlety,18,6,12
33342,Hmmkek,frostmourne,527,rogue,subtlety,11,6,5
33343,Cheapdeal,frostmourne,512,rogue,subtlety,10,6,4
33344,Kwins,cenarion-circle,480,rogue,subtlety,6,5,1
33345,Lowkn,tichondrius,480,rogue,subtlety,6,5,1
33346,Ghoarie,sargeras,480,rogue,subtlety,6,5,1
33347,Oceboomer,frostmourne,480,rogue,subtlety,6,5,1
33348,Chakal,illidan,480,rogue,subtlety,6,5,1
33349,Poonqtxo,frostmourne,480,rogue,subtlety,6,5,1
33350,Feinting,moon-guard,480,rogue,subtlety,6,5,1
33351,Scythix,firetree,480,rogue,subtlety,6,5,1
33352,Deepsyo,frostmourne,480,rogue,subtlety,6,5,1
33353,Natalya,stormreaver,480,rogue,subtlety,6,5,1
33354,Nodeßurglar,kelthuzad,480,rogue,subtlety,6,5,1
33355,Tmskitsou,tichondrius,480,rogue,subtlety,10,6,4
33356,Liqwid,stormrage,480,rogue,subtlety,12,5,7
33357,Scrubzz,barthilas,480,rogue,subtlety,12,5,7
33358,Xandroesh,darkspear,480,rogue,subtlety,12,5,7
33359,Tiladar,tichondrius,480,rogue,subtlety,12,5,7
33360,Killdrunk,stormrage,480,rogue,subtlety,12,5,7
33361,Aldessa,draka,480,rogue,subtlety,12,5,7
33362,Dawkx,thrall,480,rogue,subtlety,12,5,7
33363,Grinjuk,area-52,480,rogue,subtlety,12,5,7
33364,Defthands,tichondrius,480,rogue,subtlety,12,5,7
33365,Clayton,frostmourne,480,rogue,subtlety,12,5,7
33366,Blakezillax,tichondrius,480,rogue,subtlety,12,5,7
33367,Milafortnite,tichondrius,480,rogue,subtlety,12,5,7
33368,Brendantko,arthas,480,rogue,subtlety,12,5,7
33369,Drunknchaos,bleeding-hollow,480,rogue,subtlety,12,5,7
33370,Wooluncle,tichondrius,480,rogue,subtlety,12,5,7
33371,Jon,the-venture-co,480,rogue,subtlety,12,5,7
33372,Söda,emerald-dream,480,rogue,subtlety,12,5,7
33373,Chimpo,ravencrest,480,rogue,subtlety,12,5,7
33374,Monkeykongr,lightnings-blade,480,rogue,subtlety,12,5,7
33375,Shizz,tichondrius,480,rogue,subtlety,12,5,7
33376,Orihimesz,azralon,480,rogue,subtlety,12,5,7
33377,Pwnsauce,frostmourne,480,rogue,subtlety,12,5,7
33378,Henya,magtheridon,480,rogue,subtlety,12,5,7
33379,Glatzkaus,shattered-hand,480,rogue,subtlety,12,5,7
33380,Pjh,sargeras,480,rogue,subtlety,12,5,7
33381,Atulano,wyrmrest-accord,480,rogue,subtlety,12,5,7
33382,Shadonas,maelstrom,480,rogue,subtlety,12,5,7
33383,Twnice,tichondrius,480,rogue,subtlety,12,5,7
33384,Blinky,blades-edge,480,rogue,subtlety,12,5,7
33385,Arsènè,whisperwind,480,rogue,subtlety,13,5,8
33386,Faelanna,stormrage,480,rogue,subtlety,13,5,8
33387,Psychostabby,tichondrius,480,rogue,subtlety,18,5,13
33388,Greasymario,kelthuzad,480,rogue,subtlety,18,5,13
33389,Reinaldojr,azralon,480,rogue,subtlety,18,5,13
33390,Tekrul,area-52,480,rogue,subtlety,24,5,19
33391,Zitihait,amanthul,479,rogue,subtlety,6,5,1
33392,Leprocy,tichondrius,479,rogue,subtlety,10,6,4
33393,Qlog,tichondrius,479,rogue,subtlety,12,5,7
33394,Deathbeacøn,sargeras,479,rogue,subtlety,12,5,7
33395,Catoline,bleeding-hollow,479,rogue,subtlety,12,5,7
33396,Toodlles,stormrage,479,rogue,subtlety,12,5,7
33397,Arÿaa,azralon,479,rogue,subtlety,12,5,7
33398,Kekdasneak,dragonmaw,479,rogue,subtlety,18,5,13
33399,Stelarstop,drakkari,479,rogue,subtlety,18,5,13
33400,Abdullahh,tichondrius,478,rogue,subtlety,12,5,7
33401,Falra,wyrmrest-accord,478,rogue,subtlety,18,5,13
33402,Muffens,alterac-mountains,476,rogue,subtlety,12,5,7
33403,Liamoz,amanthul,475,rogue,subtlety,12,5,7
33404,Backtoch,sargeras,447,rogue,subtlety,11,5,6
33405,Fingolfin,terenas,447,rogue,subtlety,11,5,6
33406,Notlim,azralon,432,rogue,subtlety,15,5,10
33407,Akhila,stormrage,431,rogue,subtlety,11,5,6
33408,Pangppy,tichondrius,431,rogue,subtlety,11,5,6
33409,Sketchyweas,sargeras,426,rogue,subtlety,14,6,8
33410,Vandalyze,sargeras,425,rogue,subtlety,13,6,7
33411,Cayladin,tichondrius,416,rogue,subtlety,10,5,5
33412,Luriél,stormrage,415,rogue,subtlety,10,5,5
33413,Prepcoin,malganis,384,rogue,subtlety,6,4,2
33414,Ateabug,wyrmrest-accord,384,rogue,subtlety,6,4,2
33415,Coldkill,bleeding-hollow,384,rogue,subtlety,6,4,2
33416,Sapntapx,malganis,384,rogue,subtlety,6,4,2
33417,Suggmadi,stormrage,384,rogue,subtlety,6,4,2
33418,Dåve,tichondrius,384,rogue,subtlety,6,4,2
33419,Zapstr,bleeding-hollow,384,rogue,subtlety,6,4,2
33420,Foreverioi,tichondrius,384,rogue,subtlety,6,4,2
33421,Exacerbatê,mannoroth,384,rogue,subtlety,6,4,2
33422,Nichala,tichondrius,384,rogue,subtlety,6,4,2
33423,ßackshots,kelthuzad,384,rogue,subtlety,6,4,2
33424,Djsyn,bleeding-hollow,384,rogue,subtlety,6,4,2
33425,Chauva,zuljin,384,rogue,subtlety,6,4,2
33426,Emvee,kelthuzad,384,rogue,subtlety,6,4,2
33427,Invokesap,area-52,384,rogue,subtlety,6,4,2
33428,Evasionx,tichondrius,384,rogue,subtlety,6,4,2
33429,Deadopps,stormrage,384,rogue,subtlety,6,4,2
33430,Sinary,cenarion-circle,384,rogue,subtlety,6,4,2
33431,Dismayx,tichondrius,384,rogue,subtlety,6,4,2
33432,Bilbobagginz,malganis,384,rogue,subtlety,6,4,2
33433,Bootimus,illidan,384,rogue,subtlety,6,4,2
33434,Unoshade,illidan,384,rogue,subtlety,6,4,2
33435,Malgoria,tichondrius,384,rogue,subtlety,6,4,2
33436,Pressuret,frostmourne,384,rogue,subtlety,6,4,2
33437,Wrldstars,illidan,384,rogue,subtlety,6,4,2
33438,Donpeon,hellscream,384,rogue,subtlety,6,4,2
33439,Eversincee,illidan,384,rogue,subtlety,6,4,2
33440,Memnõch,emerald-dream,384,rogue,subtlety,6,4,2
33441,Altaureen,thrall,384,rogue,subtlety,6,4,2
33442,Ghosted,thrall,384,rogue,subtlety,6,4,2
33443,Asneakyfox,thunderlord,384,rogue,subtlety,12,4,8
33444,Dions,ragnaros,384,rogue,subtlety,12,4,8
33445,Seerenai,moon-guard,384,rogue,subtlety,12,4,8
33446,Nevermoon,gallywix,384,rogue,subtlety,12,4,8
33447,Tomas,bloodscalp,384,rogue,subtlety,12,4,8
33448,Lazaruslong,stormrage,384,rogue,subtlety,12,4,8
33449,Zzffqsm,tichondrius,384,rogue,subtlety,12,4,8
33450,Morpheûs,tichondrius,384,rogue,subtlety,12,4,8
33451,Denoms,area-52,384,rogue,subtlety,12,4,8
33452,Restinpeacex,bleeding-hollow,384,rogue,subtlety,12,4,8
33453,Miamiganster,lothar,384,rogue,subtlety,12,4,8
33454,Muggzy,emerald-dream,384,rogue,subtlety,12,4,8
33455,Dezly,tichondrius,384,rogue,subtlety,12,4,8
33456,Blackstabyth,thrall,384,rogue,subtlety,12,4,8
33457,Freshcakes,darkspear,384,rogue,subtlety,12,4,8
33458,Flankks,sargeras,384,rogue,subtlety,12,4,8
33459,Tàlion,emerald-dream,384,rogue,subtlety,12,4,8
33460,Lolgoturbase,hyjal,384,rogue,subtlety,12,4,8
33461,Seutobinhaa,stormrage,384,rogue,subtlety,12,4,8
33462,Elishadowed,proudmoore,384,rogue,subtlety,12,4,8
33463,Oksanaastan,tichondrius,384,rogue,subtlety,18,4,14
33464,Gentlesaop,blackrock,383,rogue,subtlety,6,4,2
33465,Freego,quelthalas,383,rogue,subtlety,6,4,2
33466,Schnozz,lightbringer,383,rogue,subtlety,6,4,2
33467,Suffêr,dalaran,383,rogue,subtlety,6,4,2
33468,Morphina,gilneas,383,rogue,subtlety,6,4,2
33469,Swisha,dathremar,383,rogue,subtlety,12,4,8
33470,Betrayerz,darkspear,383,rogue,subtlety,12,4,8
33471,Majimae,sargeras,383,rogue,subtlety,12,4,8
33472,Ràinê,dalaran,383,rogue,subtlety,12,4,8
33473,Blindedu,dalaran,383,rogue,subtlety,12,4,8
33474,Hènnéssy,frostmourne,383,rogue,subtlety,12,4,8
33475,Toxiccarnage,ghostlands,383,rogue,subtlety,14,4,10
33476,Shadowpunx,nemesis,382,rogue,subtlety,6,4,2
33477,Raylo,blackhand,382,rogue,subtlety,6,4,2
33478,Knife,moon-guard,381,rogue,subtlety,12,4,8
33479,Jjp,tichondrius,367,rogue,subtlety,11,4,7
33480,Sinice,draka,351,rogue,subtlety,8,5,3
33481,Samuraii,zuljin,335,rogue,subtlety,11,4,7
33482,Idsapdat,illidan,330,rogue,subtlety,9,6,3
33483,Peeryl,daggerspine,327,rogue,subtlety,15,5,10
33484,Rawdawged,illidan,320,rogue,subtlety,16,4,12
33485,Zaghat,ragnaros,320,rogue,subtlety,16,4,12
33486,Grima,azralon,319,rogue,subtlety,14,4,10
33487,Papiplunders,sargeras,304,rogue,subtlety,7,4,3
33488,Junemylove,tichondrius,288,rogue,subtlety,6,3,3
33489,Castsequence,khaz-modan,288,rogue,subtlety,6,3,3
33490,Roguish,kiljaeden,288,rogue,subtlety,6,3,3
33491,Jackcurtis,kelthuzad,288,rogue,subtlety,6,3,3
33492,Lagula,ragnaros,288,rogue,subtlety,6,3,3
33493,Snackable,tichondrius,288,rogue,subtlety,6,3,3
33494,Leftyleaf,proudmoore,288,rogue,subtlety,6,3,3
33495,Zarrth,malganis,288,rogue,subtlety,6,3,3
33496,Horyx,zuljin,288,rogue,subtlety,6,3,3
33497,Gongarn,thrall,288,rogue,subtlety,6,3,3
33498,Isonlydosex,tichondrius,288,rogue,subtlety,6,3,3
33499,Amatoxin,tichondrius,288,rogue,subtlety,6,3,3
33500,Pingwii,ragnaros,288,rogue,subtlety,6,3,3
33501,Projectx,tichondrius,288,rogue,subtlety,6,3,3
33502,Saulgoodz,tichondrius,288,rogue,subtlety,6,3,3
33503,Whispx,malganis,288,rogue,subtlety,6,3,3
33504,Metalz,exodar,288,rogue,subtlety,6,3,3
33505,Ralæriel,wyrmrest-accord,288,rogue,subtlety,6,3,3
33506,Reverel,tichondrius,288,rogue,subtlety,6,3,3
33507,Hemorrhages,tichondrius,288,rogue,subtlety,6,3,3
33508,Valaq,tichondrius,288,rogue,subtlety,6,3,3
33509,Dìngapoof,tichondrius,288,rogue,subtlety,6,3,3
33510,Støné,azjolnerub,288,rogue,subtlety,6,3,3
33511,Screwzx,tichondrius,288,rogue,subtlety,6,3,3
33512,Sinfate,bleeding-hollow,288,rogue,subtlety,6,3,3
33513,Athletik,tichondrius,288,rogue,subtlety,6,3,3
33514,Schneric,stormrage,288,rogue,subtlety,6,3,3
33515,Raidei,elune,288,rogue,subtlety,6,3,3
33516,Antijax,stormrage,288,rogue,subtlety,6,3,3
33517,Garnoghan,stormrage,288,rogue,subtlety,6,3,3
33518,Seshtime,tichondrius,288,rogue,subtlety,6,3,3
33519,Woundzx,tichondrius,288,rogue,subtlety,6,3,3
33520,Gotkick,stormrage,288,rogue,subtlety,6,3,3
33521,Commodore,arthas,288,rogue,subtlety,6,3,3
33522,Dödoubleg,stormrage,288,rogue,subtlety,6,3,3
33523,Creayuncle,area-52,288,rogue,subtlety,6,3,3
33524,Thargal,tichondrius,288,rogue,subtlety,6,3,3
33525,Beretta,nemesis,288,rogue,subtlety,6,3,3
33526,Kidkillz,tichondrius,288,rogue,subtlety,6,3,3
33527,Cron,arygos,288,rogue,subtlety,6,3,3
33528,Tonjuras,uther,288,rogue,subtlety,6,3,3
33529,Bumboklaat,bleeding-hollow,288,rogue,subtlety,6,3,3
33530,Anbuartist,dalaran,288,rogue,subtlety,6,3,3
33531,Bøbinette,sargeras,288,rogue,subtlety,6,3,3
33532,Slilsp,sargeras,288,rogue,subtlety,6,3,3
33533,Haeqn,azralon,288,rogue,subtlety,6,3,3
33534,Gåñðøñ,stormscale,288,rogue,subtlety,6,3,3
33535,Luolan,kargath,288,rogue,subtlety,6,3,3
33536,Timat,emerald-dream,288,rogue,subtlety,6,3,3
33537,Ricosap,frostmourne,288,rogue,subtlety,6,3,3
33538,Shadowreapz,barthilas,288,rogue,subtlety,6,3,3
33539,Vellkann,azralon,288,rogue,subtlety,6,3,3
33540,Taraminkadot,sargeras,288,rogue,subtlety,9,4,5
33541,Siniel,scarlet-crusade,288,rogue,subtlety,9,4,5
33542,Ünaru,sargeras,288,rogue,subtlety,7,3,4
33543,ßutthead,malganis,288,rogue,subtlety,7,3,4
33544,Tigbits,frostmourne,288,rogue,subtlety,15,4,11
33545,Corchô,moon-guard,288,rogue,subtlety,12,3,9
33546,Kelelor,kelthuzad,288,rogue,subtlety,12,3,9
33547,Miloandotis,malganis,288,rogue,subtlety,12,3,9
33548,Veterån,tichondrius,288,rogue,subtlety,12,3,9
33549,Yülia,skywall,288,rogue,subtlety,12,3,9
33550,Foofz,kelthuzad,288,rogue,subtlety,12,3,9
33551,Veatrix,zuljin,288,rogue,subtlety,12,3,9
33552,Grinz,sargeras,288,rogue,subtlety,12,3,9
33553,Zeetwntyeght,stormrage,288,rogue,subtlety,12,3,9
33554,Hogstradamus,malganis,288,rogue,subtlety,12,3,9
33555,Yottsu,proudmoore,288,rogue,subtlety,12,3,9
33556,Yamillpgk,ragnaros,288,rogue,subtlety,12,3,9
33557,Bumpamoose,aggramar,288,rogue,subtlety,12,3,9
33558,Terala,perenolde,288,rogue,subtlety,12,3,9
33559,Imbe,nagrand,288,rogue,subtlety,12,3,9
33560,Relaxsingh,tichondrius,288,rogue,subtlety,18,3,15
33561,Xsneakski,jubeithos,287,rogue,subtlety,6,3,3
33562,Framsteg,kelthuzad,287,rogue,subtlety,6,3,3
33563,Darkpaths,hyjal,287,rogue,subtlety,6,3,3
33564,Urukzog,ragnaros,287,rogue,subtlety,6,3,3
33565,Witherblade,area-52,287,rogue,subtlety,6,3,3
33566,Heserth,ragnaros,287,rogue,subtlety,6,3,3
33567,Bajeebus,azshara,287,rogue,subtlety,6,3,3
33568,Namiic,thrall,287,rogue,subtlety,12,3,9
33569,Minnicent,amanthul,287,rogue,subtlety,18,3,15
33570,Teach,illidan,287,rogue,subtlety,18,3,15
33571,Cerebrian,malygos,286,rogue,subtlety,6,3,3
33572,Sodomh,aegwynn,286,rogue,subtlety,6,3,3
33573,Tareduwu,area-52,286,rogue,subtlety,18,3,15
33574,Uchihà,sargeras,284,rogue,subtlety,12,3,9
33575,Uncleblinker,proudmoore,239,rogue,subtlety,5,3,2
33576,Youngdraco,tichondrius,239,rogue,subtlety,5,3,2
33577,Wulfcrest,moon-guard,239,rogue,subtlety,5,3,2
33578,Radagon,fenris,234,rogue,subtlety,9,4,5
33579,Twinkasz,nemesis,234,rogue,subtlety,16,5,11
33580,Dillwilly,moon-guard,192,rogue,subtlety,6,2,4
33581,Tìlt,whisperwind,192,rogue,subtlety,6,2,4
33582,Swingonya,stormrage,192,rogue,subtlety,6,2,4
33583,Elvesnknives,stormrage,192,rogue,subtlety,6,2,4
33584,Buddymelon,thrall,192,rogue,subtlety,6,2,4
33585,Anímosity,darkspear,192,rogue,subtlety,6,2,4
33586,Åaron,thrall,192,rogue,subtlety,6,2,4
33587,Chêckmatê,darkspear,192,rogue,subtlety,6,2,4
33588,Stateless,kelthuzad,192,rogue,subtlety,6,2,4
33589,Runescape,frostmourne,192,rogue,subtlety,6,2,4
33590,Smertin,area-52,192,rogue,subtlety,6,2,4
33591,Jsnlol,zuljin,192,rogue,subtlety,6,2,4
33592,Sathrion,zuljin,192,rogue,subtlety,6,2,4
33593,Coalie,tichondrius,192,rogue,subtlety,6,2,4
33594,Terrorstrike,tichondrius,192,rogue,subtlety,6,2,4
33595,Skorsh,wyrmrest-accord,192,rogue,subtlety,6,2,4
33596,Meadview,bleeding-hollow,192,rogue,subtlety,6,2,4
33597,Gzl,frostmourne,192,rogue,subtlety,6,2,4
33598,Jeezy,shadowmoon,192,rogue,subtlety,6,2,4
33599,Xyltann,bleeding-hollow,192,rogue,subtlety,6,2,4
33600,Antmang,bleeding-hollow,192,rogue,subtlety,6,2,4
33601,Shankmcganks,chogall,192,rogue,subtlety,6,2,4
33602,Smakkey,tichondrius,192,rogue,subtlety,6,2,4
33603,Chuckydoll,sargeras,192,rogue,subtlety,6,2,4
33604,Lmorningstar,altar-of-storms,192,rogue,subtlety,6,2,4
33605,Astroz,sargeras,192,rogue,subtlety,6,2,4
33606,Mãtthew,tichondrius,192,rogue,subtlety,6,2,4
33607,Slíçk,tichondrius,192,rogue,subtlety,6,2,4
33608,Teribád,area-52,192,rogue,subtlety,6,2,4
33609,Surplus,stormscale,192,rogue,subtlety,6,2,4
33610,Icantsleep,tichondrius,192,rogue,subtlety,6,2,4
33611,Rehze,area-52,192,rogue,subtlety,6,2,4
33612,Vanishcdc,area-52,192,rogue,subtlety,6,2,4
33613,Lennysnephew,tichondrius,192,rogue,subtlety,6,2,4
33614,Joegamer,sargeras,192,rogue,subtlety,6,2,4
33615,Grue,gundrak,192,rogue,subtlety,6,2,4
33616,Sneakyt,shadow-council,192,rogue,subtlety,6,2,4
33617,Wyyre,hyjal,192,rogue,subtlety,6,2,4
33618,Jujudaddy,sargeras,192,rogue,subtlety,6,2,4
33619,Tothegravetv,sargeras,192,rogue,subtlety,6,2,4
33620,Nubes,illidan,192,rogue,subtlety,6,2,4
33621,Macklittle,area-52,192,rogue,subtlety,6,2,4
33622,Zôliath,tichondrius,192,rogue,subtlety,6,2,4
33623,Bambooßobby,area-52,192,rogue,subtlety,6,2,4
33624,ßroke,emerald-dream,192,rogue,subtlety,6,2,4
33625,Lenik,azuremyst,192,rogue,subtlety,6,2,4
33626,Wètdream,sargeras,192,rogue,subtlety,6,2,4
33627,Shadowstryfe,tichondrius,192,rogue,subtlety,6,2,4
33628,Pootymunchin,daggerspine,192,rogue,subtlety,6,2,4
33629,Ghostdragons,tichondrius,192,rogue,subtlety,6,2,4
33630,Yourhomieaj,tichondrius,192,rogue,subtlety,6,2,4
33631,Taliwis,burning-blade,192,rogue,subtlety,6,2,4
33632,Kami,kelthuzad,192,rogue,subtlety,6,2,4
33633,Smolblade,nordrassil,192,rogue,subtlety,6,2,4
33634,Rogsky,tichondrius,192,rogue,subtlety,6,2,4
33635,Rujkah,archimonde,192,rogue,subtlety,6,2,4
33636,Brustent,icecrown,192,rogue,subtlety,6,2,4
33637,Badonka,aggramar,192,rogue,subtlety,6,2,4
33638,Slycndice,tortheldrin,192,rogue,subtlety,6,2,4
33639,Nlynn,veknilash,192,rogue,subtlety,6,2,4
33640,Letsgobranon,sargeras,192,rogue,subtlety,6,2,4
33641,Jâm,nerzhul,192,rogue,subtlety,6,2,4
33642,Zzu,azralon,192,rogue,subtlety,6,2,4
33643,Draef,illidan,192,rogue,subtlety,6,2,4
33644,Picaropanda,quelthalas,192,rogue,subtlety,6,2,4
33645,Harasna,emerald-dream,192,rogue,subtlety,6,2,4
33646,Reflexiv,malganis,192,rogue,subtlety,6,2,4
33647,Toomuchcap,aggramar,192,rogue,subtlety,6,2,4
33648,Happyunhappy,illidan,192,rogue,subtlety,6,2,4
33649,Bâerâ,bloodscalp,192,rogue,subtlety,8,2,6
33650,Xenitech,bleeding-hollow,192,rogue,subtlety,8,2,6
33651,Soupline,area-52,192,rogue,subtlety,12,2,10
33652,Brickjohnson,illidan,192,rogue,subtlety,12,2,10
33653,Flèè,illidan,192,rogue,subtlety,12,2,10
33654,Ezmate,frostmourne,192,rogue,subtlety,12,2,10
33655,Zabava,malganis,192,rogue,subtlety,12,2,10
33656,Barmiah,stormrage,192,rogue,subtlety,12,2,10
33657,Cerel,baelgun,192,rogue,subtlety,12,2,10
33658,Trinktick,doomhammer,192,rogue,subtlety,12,2,10
33659,Kestor,barthilas,192,rogue,subtlety,12,2,10
33660,Onulyo,tichondrius,192,rogue,subtlety,12,2,10
33661,Mitchrogue,barthilas,192,rogue,subtlety,12,2,10
33662,Zeriek,stormrage,192,rogue,subtlety,12,2,10
33663,Myhandisfull,tichondrius,192,rogue,subtlety,12,2,10
33664,Krius,blood-furnace,192,rogue,subtlety,12,2,10
33665,Jashyy,tichondrius,192,rogue,subtlety,12,2,10
33666,Pouet,caelestrasz,192,rogue,subtlety,12,2,10
33667,Diabsoule,amanthul,192,rogue,subtlety,12,2,10
33668,Lancarlorïus,ragnaros,191,rogue,subtlety,6,2,4
33669,Hayatö,ragnaros,191,rogue,subtlety,6,2,4
33670,Mccarter,bonechewer,191,rogue,subtlety,12,2,10
33671,Sheiv,shadow-council,190,rogue,subtlety,4,3,1
33672,Eliasael,moon-guard,159,rogue,subtlety,5,2,3
33673,Suhwooh,area-52,159,rogue,subtlety,5,2,3
33674,Koobbo,tichondrius,159,rogue,subtlety,5,2,3
33675,Opensap,tichondrius,159,rogue,subtlety,5,2,3
33676,Khrezin,stonemaul,159,rogue,subtlety,5,2,3
33677,Ganksterqt,dentarg,138,rogue,subtlety,10,3,7
33678,Uhtrred,ragnaros,137,rogue,subtlety,10,3,7
33679,Fadedx,darkspear,128,rogue,subtlety,4,2,2
33680,Namig,cenarion-circle,128,rogue,subtlety,4,2,2
33681,Mdrogue,sargeras,128,rogue,subtlety,4,2,2
33682,Earthinhorn,frostmourne,127,rogue,subtlety,8,2,6
33683,Swickwockdus,azralon,112,rogue,subtlety,7,2,5
33684,Amonn,arthas,96,rogue,subtlety,3,2,1
33685,Jasam,daggerspine,96,rogue,subtlety,3,2,1
33686,Lásko,area-52,96,rogue,subtlety,3,2,1
33687,Treasy,malganis,96,rogue,subtlety,6,1,5
33688,Eimr,stormrage,96,rogue,subtlety,6,1,5
33689,Bloodyblades,blackhand,96,rogue,subtlety,6,1,5
33690,Cotuffa,drakkari,96,rogue,subtlety,6,1,5
33691,Nevatell,malganis,96,rogue,subtlety,6,1,5
33692,Crypblade,sargeras,96,rogue,subtlety,6,1,5
33693,Sapstick,kiljaeden,96,rogue,subtlety,6,1,5
33694,Wrin,sargeras,96,rogue,subtlety,6,1,5
33695,Sawred,bonechewer,96,rogue,subtlety,6,1,5
33696,Anadrol,sargeras,96,rogue,subtlety,6,1,5
33697,Reurog,garrosh,96,rogue,subtlety,6,1,5
33698,Valekk,stormscale,96,rogue,subtlety,6,1,5
33699,Originkorean,terenas,96,rogue,subtlety,6,1,5
33700,Bonizzi,stormrage,96,rogue,subtlety,6,1,5
33701,Kidneyisntop,illidan,96,rogue,subtlety,6,1,5
33702,Dragosha,antonidas,96,rogue,subtlety,6,1,5
33703,Caalo,quelthalas,96,rogue,subtlety,6,1,5
33704,Mídnìght,aegwynn,96,rogue,subtlety,6,1,5
33705,Bubblesrr,whisperwind,96,rogue,subtlety,6,1,5
33706,Páige,ragnaros,96,rogue,subtlety,6,1,5
33707,Kizakuo,moon-guard,96,rogue,subtlety,6,1,5
33708,Satanicrizz,tichondrius,96,rogue,subtlety,6,1,5
33709,Bloodbrawl,caelestrasz,96,rogue,subtlety,6,1,5
33710,Macc,khazgoroth,96,rogue,subtlety,6,1,5
33711,Quackerjacks,lightnings-blade,96,rogue,subtlety,6,1,5
33712,Zelzaramor,ravenholdt,96,rogue,subtlety,6,1,5
33713,Jokerr,proudmoore,96,rogue,subtlety,6,1,5
33714,Frootylol,stormrage,96,rogue,subtlety,6,1,5
33715,Ivanapavlov,kelthuzad,96,rogue,subtlety,6,1,5
33716,Anistreya,wyrmrest-accord,96,rogue,subtlety,6,1,5
33717,Ironrod,shadowmoon,96,rogue,subtlety,6,1,5
33718,Dedrater,shadowmoon,96,rogue,subtlety,6,1,5
33719,Spöke,dalvengyr,96,rogue,subtlety,6,1,5
33720,Illidin,executus,96,rogue,subtlety,6,1,5
33721,Docheatt,dalaran,96,rogue,subtlety,6,1,5
33722,Lawyergamer,bonechewer,96,rogue,subtlety,6,1,5
33723,Slobernocker,stormrage,96,rogue,subtlety,6,1,5
33724,Heimlichkeit,tichondrius,96,rogue,subtlety,6,1,5
33725,Steffmaister,tichondrius,96,rogue,subtlety,6,1,5
33726,Twinkrogue,firetree,96,rogue,subtlety,6,1,5
33727,Penguineater,tichondrius,96,rogue,subtlety,6,1,5
33728,Deepcutz,barthilas,96,rogue,subtlety,6,1,5
33729,Rotbreath,bleeding-hollow,96,rogue,subtlety,6,1,5
33730,Rolomon,tichondrius,96,rogue,subtlety,6,1,5
33731,Dabrat,frostwolf,96,rogue,subtlety,6,1,5
33732,Onetwostep,tichondrius,96,rogue,subtlety,6,1,5
33733,Skinnymayne,laughing-skull,96,rogue,subtlety,6,1,5
33734,Yoodoo,nemesis,96,rogue,subtlety,6,1,5
33735,Flelfo,quelthalas,96,rogue,subtlety,12,1,11
33736,Soultakerr,whisperwind,79,rogue,subtlety,5,1,4
33737,Vùdõõ,area-52,64,rogue,subtlety,4,1,3
33738,Drpibb,ghostlands,63,rogue,subtlety,2,2,0
33739,Swøøpy,stormrage,48,rogue,subtlety,3,1,2
33740,Rocanról,quelthalas,42,rogue,subtlety,6,2,4
33741,Thenelis,dalaran,42,rogue,subtlety,11,2,9
33742,Archazx,sargeras,42,rogue,subtlety,12,2,10
33743,Betakong,quelthalas,31,rogue,subtlety,2,1,1
33744,Traumashears,proudmoore,31,rogue,subtlety,2,1,1
33745,Demonioverde,ragnaros,31,rogue,subtlety,2,1,1
33746,Mirrorx,tichondrius,2229,rogue,assassination,174,90,84
33747,Zarkk,kelthuzad,2219,rogue,assassination,168,88,80
33748,Sllabymkcus,sargeras,2126,rogue,assassination,72,37,35
33749,Larmx,tichondrius,2111,rogue,assassination,78,40,38
33750,Ånko,tichondrius,2110,rogue,assassination,95,47,48
33751,Xiaochulol,tichondrius,2097,rogue,assassination,96,51,45
33752,Alethal,tichondrius,1971,rogue,assassination,78,42,36
33753,Snortedgfuel,drenden,1871,rogue,assassination,48,23,25
33754,Lemon,arygos,1851,rogue,assassination,47,20,27
33755,Poonanixo,frostmourne,1846,rogue,assassination,78,38,40
33756,Alterfate,wyrmrest-accord,1839,rogue,assassination,66,33,33
33757,Feinting,moon-guard,1839,rogue,assassination,76,35,41
33758,Jon,the-venture-co,1838,rogue,assassination,54,27,27
33759,Sio,bleeding-hollow,1837,rogue,assassination,60,30,30
33760,Köfy,quelthalas,1835,rogue,assassination,81,39,42
33761,Ajúmma,tichondrius,1831,rogue,assassination,57,23,34
33762,Jjp,tichondrius,1827,rogue,assassination,65,33,32
33763,Niarzz,tichondrius,1808,rogue,assassination,74,45,29
33764,Relän,ragnaros,1805,rogue,assassination,59,33,26
33765,Sairak,tichondrius,1804,rogue,assassination,101,49,52
33766,Plumblossomx,tichondrius,1803,rogue,assassination,54,24,30
33767,Slickyo,malganis,1792,rogue,assassination,30,20,10
33768,Bloodlessftw,azralon,1783,rogue,assassination,75,33,42
33769,Thargal,tichondrius,1774,rogue,assassination,71,38,33
33770,Beaconlight,tichondrius,1759,rogue,assassination,72,27,45
33771,Stealthdeath,quelthalas,1728,rogue,assassination,42,24,18
33772,Pkkrevolt,archimonde,1724,rogue,assassination,76,39,37
33773,Omnìslash,area-52,1722,rogue,assassination,32,20,12
33774,Ybby,tichondrius,1714,rogue,assassination,68,34,34
33775,Bellamor,tichondrius,1710,rogue,assassination,90,54,36
33776,Lunatixz,emerald-dream,1692,rogue,assassination,53,26,27
33777,Vmoney,draenor,1685,rogue,assassination,30,18,12
33778,Bukaboo,tichondrius,1681,rogue,assassination,42,33,9
33779,Vél,blackrock,1674,rogue,assassination,42,22,20
33780,Whooxx,khazgoroth,1673,rogue,assassination,66,29,37
33781,Viicky,ghostlands,1668,rogue,assassination,48,20,28
33782,Doraz,tichondrius,1664,rogue,assassination,108,55,53
33783,Cutercarver,proudmoore,1662,rogue,assassination,75,33,42
33784,Johnnycryp,barthilas,1652,rogue,assassination,53,27,26
33785,Bellicoses,tichondrius,1651,rogue,assassination,155,84,71
33786,Ivanrah,zuljin,1648,rogue,assassination,45,20,25
33787,Shyzuku,drakkari,1644,rogue,assassination,36,18,18
33788,Purplechil,garrosh,1643,rogue,assassination,126,63,63
33789,Riventrix,zuljin,1640,rogue,assassination,101,47,54
33790,Katovo,tichondrius,1638,rogue,assassination,42,25,17
33791,Rapcher,illidan,1632,rogue,assassination,148,75,73
33792,Josex,lightbringer,1632,rogue,assassination,48,20,28
33793,Gyutaro,black-dragonflight,1629,rogue,assassination,288,146,142
33794,Sheerlol,stormrage,1626,rogue,assassination,49,24,25
33795,Impkasn,tichondrius,1623,rogue,assassination,72,24,48
33796,Quefist,sargeras,1620,rogue,assassination,74,36,38
33797,Assassìn,moon-guard,1618,rogue,assassination,48,27,21
33798,Ultranumb,sargeras,1618,rogue,assassination,51,27,24
33799,Isàputàp,tichondrius,1614,rogue,assassination,60,34,26
33800,Osuba,proudmoore,1604,rogue,assassination,78,36,42
33801,Foreverioi,tichondrius,1603,rogue,assassination,54,31,23
33802,Elinarra,sargeras,1603,rogue,assassination,42,21,21
33803,Nsns,drenden,1603,rogue,assassination,179,89,90
33804,Katmira,tichondrius,1602,rogue,assassination,42,17,25
33805,Sinepymkcus,illidan,1600,rogue,assassination,42,19,23
33806,Replayz,stormrage,1595,rogue,assassination,84,39,45
33807,Lucidstorm,tichondrius,1593,rogue,assassination,30,17,13
33808,Seroth,tichondrius,1590,rogue,assassination,24,17,7
33809,Sparqxx,tichondrius,1589,rogue,assassination,199,100,99
33810,Chêckmatê,darkspear,1589,rogue,assassination,54,25,29
33811,Devstrike,sargeras,1587,rogue,assassination,53,25,28
33812,Htez,frostmourne,1580,rogue,assassination,42,22,20
33813,Xagreth,illidan,1579,rogue,assassination,40,20,20
33814,Ãnimefãnx,moon-guard,1574,rogue,assassination,165,81,84
33815,Dairykeen,misha,1573,rogue,assassination,41,21,20
33816,Nightdelphya,azralon,1572,rogue,assassination,48,19,29
33817,Nhic,tichondrius,1569,rogue,assassination,45,20,25
33818,Wxvi,tichondrius,1563,rogue,assassination,54,30,24
33819,Zirkir,mannoroth,1558,rogue,assassination,44,22,22
33820,Ulley,sargeras,1555,rogue,assassination,56,29,27
33821,Vasherr,zuljin,1554,rogue,assassination,37,22,15
33822,Miamiganster,lothar,1550,rogue,assassination,120,54,66
33823,Kenyel,frostmourne,1543,rogue,assassination,90,40,50
33824,Olé,azralon,1541,rogue,assassination,42,18,24
33825,Nayle,dalaran,1535,rogue,assassination,47,20,27
33826,Kidneyshiv,stormrage,1531,rogue,assassination,36,20,16
33827,Ymxxlolz,tichondrius,1531,rogue,assassination,30,16,14
33828,Yanhuaa,illidan,1524,rogue,assassination,103,56,47
33829,Notjawn,arthas,1524,rogue,assassination,154,83,71
33830,Garrotte,tichondrius,1519,rogue,assassination,187,87,100
33831,Hickery,frostmourne,1518,rogue,assassination,96,42,54
33832,Skeezy,vashj,1517,rogue,assassination,66,25,41
33833,Spikiera,silvermoon,1513,rogue,assassination,63,31,32
33834,Tryedge,moon-guard,1512,rogue,assassination,36,19,17
33835,Bladä,area-52,1502,rogue,assassination,34,17,17
33836,Xilorio,skullcrusher,1496,rogue,assassination,48,24,24
33837,Valaq,tichondrius,1496,rogue,assassination,88,41,47
33838,Staabzz,thrall,1493,rogue,assassination,71,29,42
33839,Onetwostep,tichondrius,1492,rogue,assassination,39,17,22
33840,Stabem,moon-guard,1487,rogue,assassination,153,82,71
33841,Kiosh,tichondrius,1485,rogue,assassination,78,36,42
33842,Paraisbae,tichondrius,1484,rogue,assassination,42,23,19
33843,Sizka,sargeras,1483,rogue,assassination,102,48,54
33844,Camlaw,area-52,1477,rogue,assassination,55,26,29
33845,Gøblìn,tichondrius,1469,rogue,assassination,91,40,51
33846,Coquìn,proudmoore,1460,rogue,assassination,86,43,43
33847,Smkgpvp,stormrage,1456,rogue,assassination,29,16,13
33848,Blackmont,bleeding-hollow,1456,rogue,assassination,60,26,34
33849,Dianiss,ragnaros,1452,rogue,assassination,30,17,13
33850,Creamypeach,stormrage,1450,rogue,assassination,63,29,34
33851,Ezmate,frostmourne,1443,rogue,assassination,107,48,59
33852,Shankeez,tichondrius,1437,rogue,assassination,36,17,19
33853,Øsi,icecrown,1433,rogue,assassination,36,15,21
33854,Cleam,darkspear,1432,rogue,assassination,36,19,17
33855,Pirrow,moon-guard,1429,rogue,assassination,52,28,24
33856,Wujn,tichondrius,1429,rogue,assassination,156,76,80
33857,Leônhart,thrall,1428,rogue,assassination,54,25,29
33858,Hypnothot,tichondrius,1425,rogue,assassination,108,36,72
33859,Madge,area-52,1421,rogue,assassination,72,33,39
33860,Happyslice,stormrage,1415,rogue,assassination,27,16,11
33861,Youwho,kiljaeden,1410,rogue,assassination,87,42,45
33862,Vendëttä,quelthalas,1399,rogue,assassination,48,27,21
33863,Playmaker,frostwolf,1396,rogue,assassination,156,82,74
33864,Pandrogue,shadowsong,1396,rogue,assassination,48,24,24
33865,Galaily,proudmoore,1387,rogue,assassination,90,44,46
33866,Lcl,proudmoore,1384,rogue,assassination,244,123,121
33867,Itokuri,ysera,1379,rogue,assassination,42,19,23
33868,Páïgèvêntürã,bleeding-hollow,1367,rogue,assassination,32,15,17
33869,Boonee,frostmourne,1363,rogue,assassination,71,33,38
33870,Apocalipto,barthilas,1362,rogue,assassination,65,28,37
33871,Valråvn,bloodscalp,1359,rogue,assassination,23,15,8
33872,Hiddencosts,proudmoore,1345,rogue,assassination,123,63,60
33873,Wansuiye,tichondrius,1340,rogue,assassination,42,14,28
33874,Strîkér,tichondrius,1339,rogue,assassination,31,15,16
33875,Swexee,area-52,1339,rogue,assassination,60,26,34
33876,Røgüë,malganis,1338,rogue,assassination,30,14,16
33877,Kahlx,azralon,1335,rogue,assassination,95,45,50
33878,Urukzog,ragnaros,1334,rogue,assassination,60,31,29
33879,Wxva,tichondrius,1331,rogue,assassination,30,14,16
33880,Driprat,area-52,1316,rogue,assassination,24,14,10
33881,Rêdrum,illidan,1313,rogue,assassination,108,39,69
33882,Vimit,tichondrius,1310,rogue,assassination,66,29,37
33883,Powerjuicer,tichondrius,1300,rogue,assassination,66,31,35
33884,Greenlemons,lightnings-blade,1297,rogue,assassination,54,30,24
33885,Kindasorry,illidan,1290,rogue,assassination,54,23,31
33886,Gorgdrake,illidan,1283,rogue,assassination,78,39,39
33887,Aynrand,drakkari,1281,rogue,assassination,36,16,20
33888,Morgoophh,azralon,1279,rogue,assassination,140,74,66
33889,Keepitshadow,frostmourne,1279,rogue,assassination,89,45,44
33890,Harlyquinn,barthilas,1279,rogue,assassination,90,45,45
33891,Grasiel,tichondrius,1277,rogue,assassination,62,27,35
33892,Doomcore,barthilas,1276,rogue,assassination,41,21,20
33893,Blindfun,emerald-dream,1275,rogue,assassination,33,19,14
33894,Vannisshh,shattered-halls,1267,rogue,assassination,147,68,79
33895,Keylâ,thrall,1264,rogue,assassination,62,33,29
33896,Seengivenchy,zuljin,1262,rogue,assassination,26,14,12
33897,Engels,quelthalas,1262,rogue,assassination,72,33,39
33898,Ninjadoo,tichondrius,1262,rogue,assassination,62,24,38
33899,Sinnister,queldorei,1259,rogue,assassination,47,20,27
33900,Regios,shadowmoon,1255,rogue,assassination,71,31,40
33901,Lemonlemon,arygos,1247,rogue,assassination,24,13,11
33902,Sênorita,tichondrius,1246,rogue,assassination,36,13,23
33903,Lakeshark,stormrage,1246,rogue,assassination,36,13,23
33904,Helecho,tichondrius,1244,rogue,assassination,30,13,17
33905,Lyapunov,tichondrius,1242,rogue,assassination,24,13,11
33906,Enyr,frostmourne,1241,rogue,assassination,54,23,31
33907,Worm,demon-soul,1240,rogue,assassination,36,16,20
33908,Roollz,nemesis,1240,rogue,assassination,33,14,19
33909,Shninzy,senjin,1239,rogue,assassination,24,13,11
33910,Spooky,bleeding-hollow,1229,rogue,assassination,100,48,52
33911,Raskapashan,moon-guard,1229,rogue,assassination,36,13,23
33912,Pst,spirestone,1227,rogue,assassination,24,14,10
33913,Jarcus,aggramar,1225,rogue,assassination,36,13,23
33914,Shinobick,kelthuzad,1222,rogue,assassination,30,15,15
33915,Dismayx,tichondrius,1198,rogue,assassination,47,20,27
33916,Zxytox,hyjal,1191,rogue,assassination,33,17,16
33917,Jeshka,wyrmrest-accord,1189,rogue,assassination,42,20,22
33918,Lórdx,illidan,1189,rogue,assassination,56,25,31
33919,Fakie,quelthalas,1176,rogue,assassination,37,21,16
33920,Riggie,turalyon,1170,rogue,assassination,29,14,15
33921,Mìtsuru,proudmoore,1165,rogue,assassination,36,20,16
33922,Evilsanta,sargeras,1164,rogue,assassination,34,14,20
33923,Lycanthropì,illidan,1151,rogue,assassination,18,12,6
33924,Peaches,akama,1151,rogue,assassination,24,12,12
33925,Kenteenx,tichondrius,1151,rogue,assassination,30,12,18
33926,Kriszov,moon-guard,1149,rogue,assassination,142,71,71
33927,Lesentixd,stormrage,1149,rogue,assassination,30,12,18
33928,Slycndice,tortheldrin,1148,rogue,assassination,78,45,33
33929,Poisonous,emerald-dream,1147,rogue,assassination,30,12,18
33930,Khrezin,stonemaul,1147,rogue,assassination,30,12,18
33931,Odetodindel,nerzhul,1146,rogue,assassination,60,32,28
33932,Sergioz,quelthalas,1143,rogue,assassination,54,23,31
33933,Ixìa,vashj,1135,rogue,assassination,30,12,18
33934,Peeryl,daggerspine,1129,rogue,assassination,130,74,56
33935,Chakarr,stormrage,1127,rogue,assassination,18,12,6
33936,Laotrec,nemesis,1126,rogue,assassination,24,12,12
33937,Dothras,stormrage,1119,rogue,assassination,87,43,44
33938,Copler,tichondrius,1110,rogue,assassination,48,17,31
33939,Roguepvp,stormrage,1108,rogue,assassination,64,35,29
33940,Nikhlaus,ragnaros,1107,rogue,assassination,24,13,11
33941,Rodanheim,burning-blade,1107,rogue,assassination,54,24,30
33942,Indivisible,thunderlord,1104,rogue,assassination,66,33,33
33943,Altarys,ragnaros,1103,rogue,assassination,27,15,12
33944,Chingado,kaelthas,1102,rogue,assassination,30,12,18
33945,Dysxliec,dalaran,1101,rogue,assassination,35,12,23
33946,Beedie,malganis,1096,rogue,assassination,87,38,49
33947,Smoketoad,tichondrius,1081,rogue,assassination,30,15,15
33948,Lilgoosie,korgath,1062,rogue,assassination,36,14,22
33949,Osiriko,thunderlord,1061,rogue,assassination,114,61,53
33950,Cashbigknife,area-52,1061,rogue,assassination,70,28,42
33951,Aiden,burning-legion,1056,rogue,assassination,18,11,7
33952,Lycanthropî,illidan,1056,rogue,assassination,24,11,13
33953,Frez,amanthul,1056,rogue,assassination,30,11,19
33954,Turec,illidan,1056,rogue,assassination,36,11,25
33955,Ziggee,sargeras,1055,rogue,assassination,50,25,25
33956,Grafting,tichondrius,1055,rogue,assassination,24,11,13
33957,Wongcha,darkspear,1055,rogue,assassination,24,11,13
33958,Vastørogue,azralon,1053,rogue,assassination,55,29,26
33959,Zipperx,tichondrius,1053,rogue,assassination,30,11,19
33960,Stuns,azshara,1052,rogue,assassination,18,11,7
33961,Kazzo,tichondrius,1050,rogue,assassination,18,11,7
33962,Torshe,sargeras,1046,rogue,assassination,18,11,7
33963,Looprevil,andorhal,1043,rogue,assassination,24,14,10
33964,Adrianstab,dalaran,1033,rogue,assassination,60,30,30
33965,Oddblade,stormrage,1025,rogue,assassination,36,11,25
33966,Tortador,quelthalas,1013,rogue,assassination,62,28,34
33967,Snoopdrogado,sargeras,1010,rogue,assassination,52,27,25
33968,Lambs,blackhand,1000,rogue,assassination,29,11,18
33969,Sheinnér,ragnaros,998,rogue,assassination,25,12,13
33970,Roguecity,tichondrius,995,rogue,assassination,130,52,78
33971,Girio,thrall,991,rogue,assassination,23,11,12
33972,Karing,onyxia,977,rogue,assassination,22,11,11
33973,Pegglerogue,fizzcrank,977,rogue,assassination,84,37,47
33974,Wolgan,nemesis,975,rogue,assassination,61,30,31
33975,Headless,dragonmaw,968,rogue,assassination,70,36,34
33976,Daggerback,bleeding-hollow,960,rogue,assassination,23,13,10
33977,Jonuts,bleeding-hollow,960,rogue,assassination,18,10,8
33978,Lakeshark,tichondrius,960,rogue,assassination,18,10,8
33979,Gogothirteen,kiljaeden,960,rogue,assassination,32,15,17
33980,Kents,tichondrius,960,rogue,assassination,24,10,14
33981,Dizzymoods,stormrage,960,rogue,assassination,24,10,14
33982,Shigoo,sargeras,958,rogue,assassination,18,10,8
33983,Cerut,illidan,957,rogue,assassination,18,10,8
33984,Vindzl,azralon,957,rogue,assassination,24,10,14
33985,Average,burning-blade,954,rogue,assassination,27,10,17
33986,Sangreale,nemesis,953,rogue,assassination,18,10,8
33987,Pál,quelthalas,950,rogue,assassination,18,10,8
33988,Ràinê,dalaran,949,rogue,assassination,18,10,8
33989,Problemchild,rexxar,949,rogue,assassination,24,10,14
33990,Vozzy,proudmoore,947,rogue,assassination,30,17,13
33991,Xalsathoth,sargeras,946,rogue,assassination,36,10,26
33992,Elithr,nemesis,944,rogue,assassination,18,10,8
33993,Skoorbals,tichondrius,938,rogue,assassination,22,11,11
33994,Atomicgoat,tichondrius,928,rogue,assassination,33,12,21
33995,Peepoclown,illidan,927,rogue,assassination,22,10,12
33996,Papadopolous,zuluhed,917,rogue,assassination,26,11,15
33997,Endlesswaltz,zuljin,912,rogue,assassination,27,10,17
33998,Kk,dalaran,904,rogue,assassination,20,13,7
33999,Thenelis,dalaran,897,rogue,assassination,43,10,33
34000,Criptoniø,azralon,883,rogue,assassination,28,13,15
34001,Skigskag,shadowsong,883,rogue,assassination,109,47,62
34002,Cjayy,bleeding-hollow,876,rogue,assassination,31,11,20
34003,Unlucký,sargeras,864,rogue,assassination,12,9,3
34004,Ahjii,malganis,864,rogue,assassination,30,9,21
34005,Hookahrogue,area-52,863,rogue,assassination,18,9,9
34006,Brendantko,arthas,863,rogue,assassination,18,9,9
34007,Entropyphi,daggerspine,863,rogue,assassination,24,9,15
34008,Whoox,khazgoroth,863,rogue,assassination,30,9,21
34009,Mcskipa,sargeras,862,rogue,assassination,12,9,3
34010,Stillsol,stormrage,861,rogue,assassination,12,9,3
34011,Ballflicker,malganis,857,rogue,assassination,30,9,21
34012,Wreatus,moon-guard,854,rogue,assassination,84,33,51
34013,Teach,illidan,849,rogue,assassination,102,37,65
34014,Luckycrit,frostwolf,840,rogue,assassination,30,13,17
34015,Yenrab,illidan,831,rogue,assassination,23,9,14
34016,Slickdude,stormrage,828,rogue,assassination,54,13,41
34017,Píxíedúst,black-dragonflight,812,rogue,assassination,34,10,24
34018,Chersy,tichondrius,810,rogue,assassination,32,10,22
34019,Zamorant,emerald-dream,806,rogue,assassination,53,11,42
34020,Zapersapp,malygos,803,rogue,assassination,28,10,18
34021,Thepitt,stormrage,774,rogue,assassination,31,9,22
34022,Ôñéèýèdkíñg,stormrage,768,rogue,assassination,12,8,4
34023,Rîa,area-52,768,rogue,assassination,18,8,10
34024,Downsix,sargeras,768,rogue,assassination,18,8,10
34025,Clairered,tichondrius,768,rogue,assassination,18,8,10
34026,Snakegødx,sargeras,768,rogue,assassination,21,9,12
34027,Atulano,wyrmrest-accord,768,rogue,assassination,24,8,16
34028,Kzx,illidan,767,rogue,assassination,12,8,4
34029,Lyliym,frostmourne,767,rogue,assassination,12,8,4
34030,Exeg,tichondrius,767,rogue,assassination,12,8,4
34031,Dockside,stormrage,767,rogue,assassination,12,8,4
34032,Gøblìn,stormrage,767,rogue,assassination,15,9,6
34033,Darkdessoft,ragnaros,767,rogue,assassination,18,8,10
34034,Shiddlesz,area-52,767,rogue,assassination,18,8,10
34035,Sagatha,bleeding-hollow,767,rogue,assassination,18,8,10
34036,Zetéra,ragnaros,767,rogue,assassination,18,8,10
34037,Xshadowt,ragnaros,767,rogue,assassination,24,8,16
34038,Sindor,azralon,767,rogue,assassination,30,8,22
34039,Mylovejunex,tichondrius,766,rogue,assassination,12,8,4
34040,ßackshots,kelthuzad,766,rogue,assassination,18,8,10
34041,Lakki,chromaggus,766,rogue,assassination,18,8,10
34042,Velsad,sargeras,764,rogue,assassination,23,8,15
34043,Manersi,akama,764,rogue,assassination,24,8,16
34044,Turyx,azralon,764,rogue,assassination,30,8,22
34045,Hattrìck,area-52,763,rogue,assassination,24,8,16
34046,Picaroxp,drakkari,762,rogue,assassination,12,8,4
34047,Stepper,aegwynn,762,rogue,assassination,18,8,10
34048,Zropi,quelthalas,762,rogue,assassination,24,8,16
34049,Pikacuulo,ragnaros,760,rogue,assassination,31,9,22
34050,Núm,tichondrius,756,rogue,assassination,32,12,20
34051,Snoor,nemesis,753,rogue,assassination,21,9,12
34052,Killua,dalaran,752,rogue,assassination,18,8,10
34053,Ñovä,tichondrius,750,rogue,assassination,18,8,10
34054,Anyiele,stormrage,747,rogue,assassination,18,8,10
34055,Moardner,dalaran,739,rogue,assassination,42,10,32
34056,Loligotyou,stormrage,725,rogue,assassination,34,8,26
34057,Cruelworld,stormrage,713,rogue,assassination,30,10,20
34058,Snub,aerie-peak,713,rogue,assassination,28,8,20
34059,Alkal,stormreaver,712,rogue,assassination,22,10,12
34060,Ghoulzer,tichondrius,704,rogue,assassination,10,8,2
34061,Inaniss,tichondrius,703,rogue,assassination,14,8,6
34062,Superharry,tichondrius,702,rogue,assassination,22,8,14
34063,Lxw,frostmourne,672,rogue,assassination,12,7,5
34064,Jaganz,stormrage,672,rogue,assassination,12,7,5
34065,Sotypical,area-52,672,rogue,assassination,12,7,5
34066,Skitsöu,tichondrius,672,rogue,assassination,12,7,5
34067,Chriseanrock,illidan,672,rogue,assassination,12,7,5
34068,Toxicplyer,malganis,672,rogue,assassination,12,7,5
34069,Dzd,stormrage,672,rogue,assassination,12,7,5
34070,Elwynë,tichondrius,672,rogue,assassination,18,7,11
34071,Mydearest,tichondrius,672,rogue,assassination,18,7,11
34072,Zaszune,stormrage,672,rogue,assassination,18,7,11
34073,Sanozü,azralon,672,rogue,assassination,18,7,11
34074,Nogodplsno,stormrage,672,rogue,assassination,18,7,11
34075,Løgîc,tichondrius,671,rogue,assassination,12,7,5
34076,Ambushr,tichondrius,671,rogue,assassination,12,7,5
34077,Deepman,gorefiend,671,rogue,assassination,12,7,5
34078,Gucciboo,sargeras,671,rogue,assassination,12,7,5
34079,Slizard,boulderfist,671,rogue,assassination,12,7,5
34080,Alizashea,stormrage,671,rogue,assassination,12,7,5
34081,Johnthefum,malganis,671,rogue,assassination,18,7,11
34082,Showclass,stormrage,671,rogue,assassination,18,7,11
34083,Ezzdeath,tichondrius,671,rogue,assassination,18,7,11
34084,Tìnkerton,wyrmrest-accord,671,rogue,assassination,24,7,17
34085,Andreals,ragnaros,670,rogue,assassination,12,7,5
34086,Habock,ragnaros,670,rogue,assassination,17,7,10
34087,Timat,emerald-dream,670,rogue,assassination,18,7,11
34088,Sap,garrosh,670,rogue,assassination,18,7,11
34089,Anyiel,stormrage,670,rogue,assassination,24,7,17
34090,Jagó,malganis,669,rogue,assassination,18,7,11
34091,Sinistro,bleeding-hollow,667,rogue,assassination,12,7,5
34092,Jakkov,blackrock,666,rogue,assassination,18,7,11
34093,Kiorz,tichondrius,665,rogue,assassination,12,7,5
34094,Orcwarhammer,tichondrius,662,rogue,assassination,12,7,5
34095,Slootslayer,azshara,662,rogue,assassination,18,7,11
34096,Muffens,alterac-mountains,662,rogue,assassination,18,7,11
34097,Nikjawar,illidan,660,rogue,assassination,18,7,11
34098,Tiptoez,bleeding-hollow,637,rogue,assassination,15,8,7
34099,Runakó,kelthuzad,623,rogue,assassination,11,7,4
34100,Pochomän,ragnaros,618,rogue,assassination,16,9,7
34101,Onulyo,tichondrius,618,rogue,assassination,16,8,8
34102,Twoheaded,frostmourne,576,rogue,assassination,12,6,6
34103,Kayriss,antonidas,576,rogue,assassination,12,6,6
34104,Nicknasty,kelthuzad,576,rogue,assassination,12,6,6
34105,Cmòón,tichondrius,576,rogue,assassination,12,6,6
34106,Mosedz,tichondrius,576,rogue,assassination,12,6,6
34107,Stabasaurus,blood-furnace,576,rogue,assassination,12,6,6
34108,Jaywas,tichondrius,576,rogue,assassination,12,6,6
34109,Chipetan,hyjal,576,rogue,assassination,12,6,6
34110,Luriél,stormrage,576,rogue,assassination,12,6,6
34111,Bloodygoat,area-52,576,rogue,assassination,12,6,6
34112,Tri,the-underbog,576,rogue,assassination,18,6,12
34113,Slipperydog,jubeithos,576,rogue,assassination,18,6,12
34114,Çõvìd,malganis,576,rogue,assassination,30,6,24
34115,Cox,bleeding-hollow,575,rogue,assassination,6,6,0
34116,Blaçkout,thrall,575,rogue,assassination,12,6,6
34117,Theblindsap,dalaran,575,rogue,assassination,12,6,6
34118,Robinsony,tichondrius,575,rogue,assassination,12,6,6
34119,Arlom,daggerspine,575,rogue,assassination,12,6,6
34120,Slain,dark-iron,575,rogue,assassination,15,6,9
34121,Ethaniel,bronzebeard,575,rogue,assassination,15,6,9
34122,Sgnome,quelthalas,575,rogue,assassination,18,6,12
34123,Eldan,moon-guard,575,rogue,assassination,24,6,18
34124,Aurrora,kiljaeden,574,rogue,assassination,17,6,11
34125,Mcvillain,kelthuzad,573,rogue,assassination,12,6,6
34126,Vegettaa,azralon,573,rogue,assassination,18,6,12
34127,Escape,elune,571,rogue,assassination,12,6,6
34128,Akalio,laughing-skull,571,rogue,assassination,18,6,12
34129,Addvilpm,wyrmrest-accord,570,rogue,assassination,12,6,6
34130,Annastasiya,moon-guard,568,rogue,assassination,18,6,12
34131,Vitalz,bloodscalp,568,rogue,assassination,18,6,12
34132,Euweu,azralon,567,rogue,assassination,18,6,12
34133,Hellwolf,azgalor,565,rogue,assassination,13,6,7
34134,Drpepzi,tichondrius,565,rogue,assassination,24,6,18
34135,Sneakyfoot,gorgonnash,535,rogue,assassination,35,7,28
34136,Genève,dreadmaul,526,rogue,assassination,11,6,5
34137,Respia,proudmoore,518,rogue,assassination,22,8,14
34138,Sìcarìus,tichondrius,512,rogue,assassination,22,6,16
34139,Entrerí,illidan,480,rogue,assassination,6,5,1
34140,Purcius,moon-guard,480,rogue,assassination,6,5,1
34141,Mayyhem,caelestrasz,480,rogue,assassination,6,5,1
34142,Lvx,frostmourne,480,rogue,assassination,6,5,1
34143,Pwnsauce,frostmourne,480,rogue,assassination,7,5,2
34144,Ahji,malganis,480,rogue,assassination,12,5,7
34145,Ppdx,malganis,480,rogue,assassination,12,5,7
34146,Vlayd,ragnaros,480,rogue,assassination,12,5,7
34147,Bloore,fizzcrank,480,rogue,assassination,12,5,7
34148,Fuzzyslow,stormrage,480,rogue,assassination,12,5,7
34149,Depressedx,illidan,480,rogue,assassination,12,5,7
34150,Tberg,emerald-dream,480,rogue,assassination,12,5,7
34151,Gomma,stormrage,480,rogue,assassination,12,5,7
34152,Surprises,azralon,480,rogue,assassination,12,5,7
34153,Breakxcvii,bleeding-hollow,480,rogue,assassination,12,5,7
34154,Kidneyisntop,illidan,480,rogue,assassination,12,5,7
34155,Xm,sargeras,480,rogue,assassination,18,5,13
34156,Yellowdawt,stormrage,480,rogue,assassination,18,5,13
34157,Beartøøth,stormrage,479,rogue,assassination,6,5,1
34158,Paradise,smolderthorn,479,rogue,assassination,6,5,1
34159,Poofhottie,lightbringer,479,rogue,assassination,12,5,7
34160,Mashad,moon-guard,479,rogue,assassination,12,5,7
34161,Bigcolumn,tichondrius,479,rogue,assassination,12,5,7
34162,Slayersama,ragnaros,479,rogue,assassination,12,5,7
34163,Scarrog,wyrmrest-accord,479,rogue,assassination,12,5,7
34164,Møfshanks,sargeras,479,rogue,assassination,12,5,7
34165,Meilh,emerald-dream,479,rogue,assassination,12,5,7
34166,Senpaifuta,proudmoore,479,rogue,assassination,12,5,7
34167,Dessenia,illidan,479,rogue,assassination,12,5,7
34168,Eliasael,moon-guard,479,rogue,assassination,15,6,9
34169,Cynalia,sargeras,479,rogue,assassination,15,5,10
34170,Rinestiria,arthas,479,rogue,assassination,18,5,13
34171,Artymesia,medivh,478,rogue,assassination,6,5,1
34172,Villainrogue,stormrage,478,rogue,assassination,12,5,7
34173,Bonizzi,stormrage,478,rogue,assassination,12,5,7
34174,Maison,ragnaros,478,rogue,assassination,12,5,7
34175,Lethalist,whisperwind,476,rogue,assassination,12,5,7
34176,Wìndrunner,dalaran,474,rogue,assassination,12,5,7
34177,Killdead,warsong,473,rogue,assassination,12,5,7
34178,Savagedeeps,stormreaver,472,rogue,assassination,12,5,7
34179,Donamarillo,sargeras,462,rogue,assassination,11,5,6
34180,Julius,malganis,447,rogue,assassination,8,6,2
34181,Shizz,tichondrius,447,rogue,assassination,14,6,8
34182,Minnicent,amanthul,413,rogue,assassination,10,5,5
34183,Jxxs,zuljin,384,rogue,assassination,6,4,2
34184,Fofree,hyjal,384,rogue,assassination,6,4,2
34185,Elixera,sargeras,384,rogue,assassination,6,4,2
34186,Schleazy,emerald-dream,384,rogue,assassination,6,4,2
34187,Alavennian,tichondrius,384,rogue,assassination,6,4,2
34188,Tmpikaboo,tichondrius,384,rogue,assassination,6,4,2
34189,Betakong,quelthalas,384,rogue,assassination,6,4,2
34190,Taessin,kelthuzad,384,rogue,assassination,6,4,2
34191,Csguixuan,aerie-peak,384,rogue,assassination,6,4,2
34192,Shaisty,malganis,384,rogue,assassination,6,4,2
34193,Chokonet,gurubashi,384,rogue,assassination,6,4,2
34194,Buckbreaker,stormrage,384,rogue,assassination,6,4,2
34195,Colom,moon-guard,384,rogue,assassination,6,4,2
34196,Venomsnáke,tichondrius,384,rogue,assassination,6,4,2
34197,Sapmepapi,illidan,384,rogue,assassination,6,4,2
34198,Brobrando,tichondrius,384,rogue,assassination,6,4,2
34199,Kágé,ragnaros,384,rogue,assassination,6,4,2
34200,Hollowtipzz,tichondrius,384,rogue,assassination,6,4,2
34201,Pike,barthilas,384,rogue,assassination,6,4,2
34202,Grima,azralon,384,rogue,assassination,6,4,2
34203,Yurkarogue,tichondrius,384,rogue,assassination,6,4,2
34204,Arcess,ragnaros,384,rogue,assassination,6,4,2
34205,Kargargar,thrall,384,rogue,assassination,12,4,8
34206,Sillikitti,tichondrius,384,rogue,assassination,12,4,8
34207,Wolfsire,queldorei,384,rogue,assassination,12,4,8
34208,Celèphaïs,tichondrius,384,rogue,assassination,12,4,8
34209,Mansa,zangarmarsh,384,rogue,assassination,12,4,8
34210,Gridisx,wyrmrest-accord,384,rogue,assassination,12,4,8
34211,Shadøw,the-forgotten-coast,384,rogue,assassination,12,4,8
34212,Ninjamf,bleeding-hollow,384,rogue,assassination,12,4,8
34213,Stabbyboy,malganis,384,rogue,assassination,12,4,8
34214,Cryoph,illidan,384,rogue,assassination,12,4,8
34215,Cv,proudmoore,384,rogue,assassination,12,4,8
34216,Sellers,tichondrius,384,rogue,assassination,12,4,8
34217,Saiine,drenden,384,rogue,assassination,12,4,8
34218,Mirâge,illidan,384,rogue,assassination,12,4,8
34219,Drakariano,ragnaros,384,rogue,assassination,12,4,8
34220,Psilocin,sargeras,384,rogue,assassination,12,4,8
34221,Wowslayer,bleeding-hollow,384,rogue,assassination,12,4,8
34222,Hirian,misha,384,rogue,assassination,12,4,8
34223,Ðisappéar,ragnaros,384,rogue,assassination,17,4,13
34224,Denoms,area-52,384,rogue,assassination,18,4,14
34225,Kdrx,thrall,384,rogue,assassination,18,4,14
34226,Skinnymayne,laughing-skull,384,rogue,assassination,18,4,14
34227,Escurecer,azralon,384,rogue,assassination,18,4,14
34228,Ssigma,tichondrius,384,rogue,assassination,18,4,14
34229,Gladlol,stormrage,384,rogue,assassination,18,4,14
34230,Azrek,sargeras,384,rogue,assassination,18,4,14
34231,Bityellow,tichondrius,383,rogue,assassination,6,4,2
34232,Steeldiesel,sargeras,383,rogue,assassination,12,4,8
34233,Ñinjå,alleria,383,rogue,assassination,12,4,8
34234,Corteleve,nemesis,383,rogue,assassination,12,4,8
34235,Jestertyv,hyjal,383,rogue,assassination,12,4,8
34236,Setsu,sargeras,383,rogue,assassination,13,4,9
34237,Wrinklevoss,proudmoore,382,rogue,assassination,12,4,8
34238,Tralisong,azshara,382,rogue,assassination,12,4,8
34239,Hésta,moon-guard,382,rogue,assassination,12,4,8
34240,Kalandar,moon-guard,382,rogue,assassination,12,4,8
34241,Slobernocker,stormrage,381,rogue,assassination,12,4,8
34242,Fllokii,arygos,381,rogue,assassination,12,4,8
34243,Dragoonz,nemesis,351,rogue,assassination,11,4,7
34244,Tolthe,hyjal,351,rogue,assassination,11,4,7
34245,Siniel,scarlet-crusade,336,rogue,assassination,9,4,5
34246,Gersonq,moon-guard,328,rogue,assassination,13,6,7
34247,Whatsåpp,gallywix,320,rogue,assassination,10,4,6
34248,Coopi,tichondrius,320,rogue,assassination,10,4,6
34249,Pícáróóná,ragnaros,320,rogue,assassination,16,4,12
34250,Suffêr,dalaran,319,rogue,assassination,8,4,4
34251,Xvds,tichondrius,319,rogue,assassination,14,4,10
34252,Ziedrich,frostmourne,318,rogue,assassination,10,4,6
34253,Greasybbsea,illidan,288,rogue,assassination,6,3,3
34254,Rýuu,bleeding-hollow,288,rogue,assassination,6,3,3
34255,Cron,arygos,288,rogue,assassination,6,3,3
34256,Uxaen,tichondrius,288,rogue,assassination,6,3,3
34257,Inunofun,stormrage,288,rogue,assassination,6,3,3
34258,Outsap,tichondrius,288,rogue,assassination,6,3,3
34259,Jannie,rexxar,288,rogue,assassination,6,3,3
34260,Mügi,ragnaros,288,rogue,assassination,6,3,3
34261,Raj,blood-furnace,288,rogue,assassination,6,3,3
34262,Brlsels,azralon,288,rogue,assassination,6,3,3
34263,Alithileria,moon-guard,288,rogue,assassination,6,3,3
34264,Skîttlês,kul-tiras,288,rogue,assassination,6,3,3
34265,Wowamaze,aegwynn,288,rogue,assassination,6,3,3
34266,Twinkasz,nemesis,288,rogue,assassination,6,3,3
34267,Dïeb,zuljin,288,rogue,assassination,6,3,3
34268,Esraxo,frostmourne,288,rogue,assassination,6,3,3
34269,Saltypwncake,illidan,288,rogue,assassination,6,3,3
34270,Steffmaister,tichondrius,288,rogue,assassination,6,3,3
34271,Anímosity,darkspear,288,rogue,assassination,6,3,3
34272,Maciota,area-52,288,rogue,assassination,6,3,3
34273,Pusufox,tichondrius,288,rogue,assassination,6,3,3
34274,Kehkoa,thrall,288,rogue,assassination,6,3,3
34275,Ncb,bleeding-hollow,288,rogue,assassination,6,3,3
34276,Drapezz,kelthuzad,288,rogue,assassination,6,3,3
34277,Thâïßòÿgøóñ,jubeithos,288,rogue,assassination,6,3,3
34278,Corrier,tichondrius,288,rogue,assassination,6,3,3
34279,Sonymf,frostmourne,288,rogue,assassination,6,3,3
34280,Akayod,tichondrius,288,rogue,assassination,6,3,3
34281,Mcjagerx,darkspear,288,rogue,assassination,6,3,3
34282,Prodixybn,illidan,288,rogue,assassination,6,3,3
34283,Gulvzer,tichondrius,288,rogue,assassination,6,3,3
34284,Deeshdosh,illidan,288,rogue,assassination,6,3,3
34285,Syxs,sargeras,288,rogue,assassination,6,3,3
34286,Calebrogue,illidan,288,rogue,assassination,6,3,3
34287,Punkyass,azralon,288,rogue,assassination,6,3,3
34288,Åmg,tichondrius,288,rogue,assassination,6,3,3
34289,Emvee,kelthuzad,288,rogue,assassination,6,3,3
34290,Bigtengu,tichondrius,288,rogue,assassination,6,3,3
34291,Redlïne,tichondrius,288,rogue,assassination,12,3,9
34292,Pintofwoc,area-52,288,rogue,assassination,12,3,9
34293,Axm,azralon,288,rogue,assassination,12,3,9
34294,Brudashmurda,tichondrius,288,rogue,assassination,12,3,9
34295,Shortcut,khadgar,288,rogue,assassination,12,3,9
34296,Arïa,drakkari,288,rogue,assassination,12,3,9
34297,Finlander,area-52,288,rogue,assassination,12,3,9
34298,Karmagoodttv,stormrage,288,rogue,assassination,12,3,9
34299,Aevaela,duskwood,288,rogue,assassination,12,3,9
34300,Bubbski,area-52,288,rogue,assassination,12,3,9
34301,Flattsr,tichondrius,288,rogue,assassination,12,3,9
34302,Joeyzord,stormrage,288,rogue,assassination,12,3,9
34303,Tìlt,whisperwind,288,rogue,assassination,12,3,9
34304,Cydonian,ragnaros,288,rogue,assassination,12,3,9
34305,Benielfman,illidan,288,rogue,assassination,12,3,9
34306,Elevorra,frostmourne,288,rogue,assassination,12,3,9
34307,Brianä,quelthalas,288,rogue,assassination,12,3,9
34308,Alttee,proudmoore,288,rogue,assassination,12,3,9
34309,Trinktick,doomhammer,288,rogue,assassination,12,3,9
34310,Sunshinezx,frostmourne,288,rogue,assassination,12,3,9
34311,Ereshkigall,ragnaros,288,rogue,assassination,18,3,15
34312,Diamondiâ,moon-guard,288,rogue,assassination,18,3,15
34313,Revozy,azralon,287,rogue,assassination,6,3,3
34314,Gilhela,bloodhoof,287,rogue,assassination,6,3,3
34315,Shadownibba,illidan,287,rogue,assassination,6,3,3
34316,Clipp,wildhammer,287,rogue,assassination,6,3,3
34317,Stunedya,destromath,287,rogue,assassination,6,3,3
34318,Moridra,demon-soul,287,rogue,assassination,6,3,3
34319,Talinô,moknathal,287,rogue,assassination,12,3,9
34320,Tracemakerr,emerald-dream,287,rogue,assassination,12,3,9
34321,Lyndra,thunderlord,287,rogue,assassination,12,3,9
34322,Chïdaruma,azralon,287,rogue,assassination,12,3,9
34323,Anarusekkusu,wyrmrest-accord,287,rogue,assassination,12,3,9
34324,Olg,arathor,287,rogue,assassination,12,3,9
34325,Cricketts,kalecgos,287,rogue,assassination,16,3,13
34326,Emrogue,ragnaros,286,rogue,assassination,6,3,3
34327,Clothies,zuljin,285,rogue,assassination,12,3,9
34328,Sanguinnar,nemesis,285,rogue,assassination,12,3,9
34329,Synesh,moon-guard,255,rogue,assassination,11,3,8
34330,Sneakoh,illidan,255,rogue,assassination,17,3,14
34331,Thoxic,barthilas,239,rogue,assassination,5,3,2
34332,Tamsy,the-forgotten-coast,239,rogue,assassination,5,3,2
34333,Pitfirex,area-52,239,rogue,assassination,5,3,2
34334,Walnutrog,area-52,234,rogue,assassination,11,5,6
34335,Pãndã,stormrage,234,rogue,assassination,13,4,9
34336,Skairipa,agamaggan,232,rogue,assassination,7,4,3
34337,Gygáx,terenas,206,rogue,assassination,7,3,4
34338,Roguegirl,alexstrasza,202,rogue,assassination,18,4,14
34339,Dtelkham,tichondrius,192,rogue,assassination,4,3,1
34340,Salätzar,quelthalas,192,rogue,assassination,6,2,4
34341,Tagerung,malganis,192,rogue,assassination,6,2,4
34342,Haeqn,nemesis,192,rogue,assassination,6,2,4
34343,Swingonya,stormrage,192,rogue,assassination,6,2,4
34344,Yoodoo,nemesis,192,rogue,assassination,6,2,4
34345,Slashinsteev,dalaran,192,rogue,assassination,6,2,4
34346,Historymaker,tichondrius,192,rogue,assassination,6,2,4
34347,Novarra,tichondrius,192,rogue,assassination,6,2,4
34348,Kazúmi,stormrage,192,rogue,assassination,6,2,4
34349,Mermm,burning-blade,192,rogue,assassination,6,2,4
34350,Märlboro,ragnaros,192,rogue,assassination,6,2,4
34351,Gilbertgr,boulderfist,192,rogue,assassination,6,2,4
34352,Kellthzard,goldrinn,192,rogue,assassination,6,2,4
34353,Roguemain,smolderthorn,192,rogue,assassination,6,2,4
34354,Karmakula,wildhammer,192,rogue,assassination,6,2,4
34355,Zogbu,stormrage,192,rogue,assassination,6,2,4
34356,Streetjesuz,barthilas,192,rogue,assassination,6,2,4
34357,Yanh,tichondrius,192,rogue,assassination,6,2,4
34358,Cktko,stormrage,192,rogue,assassination,6,2,4
34359,Miloandotis,malganis,192,rogue,assassination,6,2,4
34360,Heimlichkeit,tichondrius,192,rogue,assassination,6,2,4
34361,Knav,destromath,192,rogue,assassination,6,2,4
34362,Baalos,medivh,192,rogue,assassination,6,2,4
34363,Lesty,kelthuzad,192,rogue,assassination,6,2,4
34364,Apssal,tichondrius,192,rogue,assassination,6,2,4
34365,Deathben,tichondrius,192,rogue,assassination,6,2,4
34366,Shini,malganis,192,rogue,assassination,6,2,4
34367,Poohkié,malganis,192,rogue,assassination,6,2,4
34368,Quickflash,bloodhoof,192,rogue,assassination,6,2,4
34369,Happyunhappy,illidan,192,rogue,assassination,6,2,4
34370,Ryoushei,ragnaros,192,rogue,assassination,6,2,4
34371,Poolover,barthilas,192,rogue,assassination,6,2,4
34372,Someone,ravencrest,192,rogue,assassination,6,2,4
34373,Vanishcdc,area-52,192,rogue,assassination,6,2,4
34374,Ilesire,frostmourne,192,rogue,assassination,6,2,4
34375,Kwins,cenarion-circle,192,rogue,assassination,6,2,4
34376,Soizhiro,ragnaros,192,rogue,assassination,6,2,4
34377,Støné,azjolnerub,192,rogue,assassination,6,2,4
34378,Ganksterqt,dentarg,192,rogue,assassination,6,2,4
34379,Sneakysharky,frostmourne,192,rogue,assassination,6,2,4
34380,Itskanashi,frostmourne,192,rogue,assassination,6,2,4
34381,Zaozaa,frostmourne,192,rogue,assassination,6,2,4
34382,Corchô,moon-guard,192,rogue,assassination,6,2,4
34383,Combo,norgannon,192,rogue,assassination,6,2,4
34384,Thianir,emerald-dream,192,rogue,assassination,6,2,4
34385,Jaanmonty,frostmourne,192,rogue,assassination,6,2,4
34386,Swickwockdus,azralon,192,rogue,assassination,6,2,4
34387,Ssjseem,sargeras,192,rogue,assassination,6,2,4
34388,Gentlesaop,blackrock,192,rogue,assassination,6,2,4
34389,Amysix,antonidas,192,rogue,assassination,6,2,4
34390,Toestumper,sargeras,192,rogue,assassination,6,2,4
34391,Darkfalleng,azralon,192,rogue,assassination,6,2,4
34392,Frostheartyy,azralon,192,rogue,assassination,6,2,4
34393,Karlemagne,blackrock,192,rogue,assassination,6,2,4
34394,Ennmaa,azralon,192,rogue,assassination,6,2,4
34395,Gabrielgray,firetree,192,rogue,assassination,6,2,4
34396,Youngtugger,daggerspine,192,rogue,assassination,11,2,9
34397,Liridor,quelthalas,192,rogue,assassination,11,2,9
34398,Bloodwish,tichondrius,192,rogue,assassination,12,2,10
34399,Slowtime,quelthalas,192,rogue,assassination,12,2,10
34400,Nines,icecrown,192,rogue,assassination,12,2,10
34401,Geradyn,stormrage,192,rogue,assassination,12,2,10
34402,Alts,tichondrius,192,rogue,assassination,12,2,10
34403,Nikosneako,tichondrius,192,rogue,assassination,12,2,10
34404,Seltzie,bleeding-hollow,192,rogue,assassination,12,2,10
34405,Subculture,emerald-dream,192,rogue,assassination,12,2,10
34406,Triarc,area-52,192,rogue,assassination,12,2,10
34407,Stabsmcslice,laughing-skull,192,rogue,assassination,12,2,10
34408,Aghanaar,burning-legion,192,rogue,assassination,12,2,10
34409,Pleodonis,tichondrius,192,rogue,assassination,12,2,10
34410,Swiftbones,burning-blade,191,rogue,assassination,6,2,4
34411,Diatonic,illidan,191,rogue,assassination,6,2,4
34412,Chizza,frostmourne,191,rogue,assassination,6,2,4
34413,Cretos,jaedenar,191,rogue,assassination,6,2,4
34414,Cryptixx,blades-edge,191,rogue,assassination,6,2,4
34415,Dabrat,frostwolf,191,rogue,assassination,12,2,10
34416,Donpablò,area-52,175,rogue,assassination,11,2,9
34417,ßalto,bleeding-hollow,160,rogue,assassination,10,2,8
34418,Xavar,malganis,159,rogue,assassination,5,2,3
34419,Gnaark,bleeding-hollow,159,rogue,assassination,5,2,3
34420,Vandalyze,sargeras,159,rogue,assassination,5,2,3
34421,Stâbitha,bloodscalp,138,rogue,assassination,20,4,16
34422,Icantsleep,tichondrius,96,rogue,assassination,6,1,5
34423,Wuzi,azralon,96,rogue,assassination,6,1,5
34424,Scylas,stormrage,96,rogue,assassination,6,1,5
34425,Ntshaav,illidan,96,rogue,assassination,6,1,5
34426,Kiskapolyus,thrall,96,rogue,assassination,6,1,5
34427,Flinchyy,dalaran,96,rogue,assassination,6,1,5
34428,Assakiller,azralon,96,rogue,assassination,6,1,5
34429,Rafikaa,ragnaros,96,rogue,assassination,6,1,5
34430,Docheatt,dalaran,96,rogue,assassination,6,1,5
34431,Combøz,tichondrius,96,rogue,assassination,6,1,5
34432,Lululee,tichondrius,96,rogue,assassination,6,1,5
34433,Slycraft,gorgonnash,96,rogue,assassination,6,1,5
34434,Stêf,zuljin,96,rogue,assassination,6,1,5
34435,Panamarojo,tichondrius,96,rogue,assassination,6,1,5
34436,Bourrasque,frostmourne,96,rogue,assassination,6,1,5
34437,Nebiroth,illidan,96,rogue,assassination,6,1,5
34438,Khlapncheeks,emerald-dream,96,rogue,assassination,6,1,5
34439,Deathxx,destromath,96,rogue,assassination,6,1,5
34440,Lu,lethon,96,rogue,assassination,6,1,5
34441,Canesuckr,stormrage,96,rogue,assassination,6,1,5
34442,Zitihait,amanthul,96,rogue,assassination,6,1,5
34443,Mõtaru,stormrage,96,rogue,assassination,6,1,5
34444,Saintjon,bleeding-hollow,96,rogue,assassination,6,1,5
34445,Rokkhan,blackrock,96,rogue,assassination,6,1,5
34446,Nightmarës,frostmourne,96,rogue,assassination,6,1,5
34447,Nubes,illidan,96,rogue,assassination,6,1,5
34448,Twotimed,magtheridon,96,rogue,assassination,6,1,5
34449,Greased,arthas,96,rogue,assassination,6,1,5
34450,Vùdõõ,area-52,96,rogue,assassination,6,1,5
34451,Sevrow,wyrmrest-accord,96,rogue,assassination,6,1,5
34452,Preceptor,azralon,96,rogue,assassination,6,1,5
34453,Clicksbtns,area-52,96,rogue,assassination,6,1,5
34454,Touchthetip,bleeding-hollow,96,rogue,assassination,6,1,5
34455,Buhuhbles,area-52,96,rogue,assassination,6,1,5
34456,Diser,quelthalas,96,rogue,assassination,6,1,5
34457,Sømeøne,malygos,96,rogue,assassination,6,1,5
34458,Elbryán,ragnaros,96,rogue,assassination,6,1,5
34459,Tmterminel,moon-guard,96,rogue,assassination,6,1,5
34460,Moiatropos,ragnaros,96,rogue,assassination,6,1,5
34461,Zeth,frostmourne,96,rogue,assassination,6,1,5
34462,Burtonee,aegwynn,96,rogue,assassination,6,1,5
34463,Twinkrogue,firetree,96,rogue,assassination,6,1,5
34464,Deejey,frostmourne,96,rogue,assassination,6,1,5
34465,Watto,ragnaros,96,rogue,assassination,6,1,5
34466,Meritra,ragnaros,96,rogue,assassination,6,1,5
34467,Yohigo,quelthalas,96,rogue,assassination,6,1,5
34468,Rykojin,sargeras,96,rogue,assassination,6,1,5
34469,Liesmith,kelthuzad,96,rogue,assassination,6,1,5
34470,Tzs,sargeras,96,rogue,assassination,6,1,5
34471,Xô,lothar,96,rogue,assassination,12,1,11
34472,Voidbrain,area-52,96,rogue,assassination,12,1,11
34473,Keljadian,black-dragonflight,96,rogue,assassination,12,1,11
34474,Karparog,ragnaros,96,rogue,assassination,12,1,11
34475,Vladtsepesh,stormrage,96,rogue,assassination,12,1,11
34476,Véndéttá,area-52,96,rogue,assassination,12,1,11
34477,Kistef,tichondrius,96,rogue,assassination,12,1,11
34478,Rabidlynsane,deathwing,96,rogue,assassination,12,1,11
34479,Irotanin,thrall,95,rogue,assassination,6,1,5
34480,Averagepimpn,tichondrius,79,rogue,assassination,5,1,4
34481,Radiantrogue,nordrassil,79,rogue,assassination,5,1,4
34482,Botches,bonechewer,48,rogue,assassination,3,1,2
34483,Stabbindude,illidan,48,rogue,assassination,3,1,2
34484,Sûshì,tichondrius,48,rogue,assassination,9,1,8
34485,Naoyuki,stormrage,42,rogue,assassination,7,2,5
34486,Jerzs,tichondrius,42,rogue,assassination,11,2,9
34487,Ajy,tichondrius,31,rogue,assassination,2,1,1
34488,Najmoiran,area-52,31,rogue,assassination,2,1,1
34489,Ascherx,illidan,16,rogue,assassination,1,1,0
34490,Samyeh,tichondrius,2252,shaman,restoration,83,55,28
34491,Orochisháman,stormrage,2222,shaman,restoration,96,55,41
34492,Yooseafood,tichondrius,2219,shaman,restoration,83,51,32
34493,Dyllbar,tichondrius,2215,shaman,restoration,127,68,59
34494,Xtremeorc,area-52,2159,shaman,restoration,66,39,27
34495,Plewt,zuljin,2150,shaman,restoration,142,76,66
34496,Spagetje,tichondrius,2150,shaman,restoration,245,130,115
34497,Aameng,tichondrius,2140,shaman,restoration,120,64,56
34498,Tréway,area-52,2135,shaman,restoration,66,41,25
34499,Skipperx,thrall,2134,shaman,restoration,72,43,29
34500,Restobyte,moon-guard,2124,shaman,restoration,72,44,28
34501,Svanteson,wyrmrest-accord,2110,shaman,restoration,126,67,59
34502,Shamaen,kelthuzad,2107,shaman,restoration,86,51,35
34503,Selketh,area-52,2107,shaman,restoration,79,46,33
34504,Iissham,darkspear,2101,shaman,restoration,176,97,79
34505,Madoka,llane,2100,shaman,restoration,78,44,34
34506,Akwesy,stormrage,2092,shaman,restoration,107,59,48
34507,Ttvfoxyllama,tichondrius,2083,shaman,restoration,64,31,33
34508,Vicioushands,illidan,2047,shaman,restoration,66,37,29
34509,Timpossible,tichondrius,2036,shaman,restoration,362,185,177
34510,Jîneth,tichondrius,2035,shaman,restoration,66,38,28
34511,Kantok,quelthalas,2031,shaman,restoration,77,48,29
34512,Lötus,tichondrius,2010,shaman,restoration,110,61,49
34513,Itsallgoodx,tichondrius,2008,shaman,restoration,114,55,59
34514,Smlz,garrosh,1998,shaman,restoration,68,38,30
34515,Sizure,frostmourne,1998,shaman,restoration,124,64,60
34516,Bigbadsac,frostmourne,1997,shaman,restoration,173,91,82
34517,Zavoky,tichondrius,1993,shaman,restoration,156,82,74
34518,Boyfromhell,stormrage,1985,shaman,restoration,103,50,53
34519,Nemix,barthilas,1984,shaman,restoration,54,34,20
34520,Corianderism,tichondrius,1982,shaman,restoration,77,40,37
34521,Ravaburst,sargeras,1975,shaman,restoration,72,36,36
34522,Berquon,tichondrius,1974,shaman,restoration,78,40,38
34523,Abovesky,proudmoore,1970,shaman,restoration,156,76,80
34524,Üchihamadarâ,tichondrius,1968,shaman,restoration,67,37,30
34525,Breuer,tichondrius,1966,shaman,restoration,128,64,64
34526,Kurtcx,tichondrius,1943,shaman,restoration,186,95,91
34527,Cruv,thrall,1936,shaman,restoration,96,47,49
34528,Jangbi,malganis,1934,shaman,restoration,246,129,117
34529,Ilavayoualot,malganis,1925,shaman,restoration,142,64,78
34530,Menc,frostmourne,1924,shaman,restoration,114,56,58
34531,Terapatrik,area-52,1921,shaman,restoration,164,84,80
34532,Slimdavey,tichondrius,1916,shaman,restoration,155,86,69
34533,Chairstain,kelthuzad,1912,shaman,restoration,97,56,41
34534,Oryxx,kiljaeden,1912,shaman,restoration,78,36,42
34535,Ogctkoy,illidan,1911,shaman,restoration,156,80,76
34536,Plorenz,illidan,1905,shaman,restoration,54,34,20
34537,Peyn,shadowsong,1905,shaman,restoration,72,34,38
34538,Shamanese,emerald-dream,1901,shaman,restoration,42,20,22
34539,Coreygunz,illidan,1897,shaman,restoration,48,26,22
34540,Yungtooth,emerald-dream,1891,shaman,restoration,59,32,27
34541,Nepos,dragonmaw,1891,shaman,restoration,66,34,32
34542,Erwin,bonechewer,1887,shaman,restoration,166,98,68
34543,Däbü,tichondrius,1887,shaman,restoration,84,40,44
34544,Mandleman,tichondrius,1884,shaman,restoration,140,85,55
34545,Smrtdeath,zuljin,1884,shaman,restoration,53,30,23
34546,Stormtitan,malganis,1881,shaman,restoration,86,42,44
34547,Tisaa,illidan,1876,shaman,restoration,30,20,10
34548,Gragomga,area-52,1876,shaman,restoration,120,60,60
34549,Esqueue,sargeras,1871,shaman,restoration,48,29,19
34550,Hulan,tichondrius,1865,shaman,restoration,36,20,16
34551,Kellogsz,malganis,1864,shaman,restoration,96,43,53
34552,Ratedpvp,thrall,1862,shaman,restoration,165,96,69
34553,Bômi,tichondrius,1861,shaman,restoration,184,96,88
34554,Laydboiyo,tichondrius,1861,shaman,restoration,66,32,34
34555,Badshock,tichondrius,1859,shaman,restoration,48,35,13
34556,Hódoong,tichondrius,1857,shaman,restoration,46,24,22
34557,Haedodae,tichondrius,1857,shaman,restoration,81,32,49
34558,Cardïß,tichondrius,1854,shaman,restoration,48,26,22
34559,Moistbeans,tichondrius,1854,shaman,restoration,48,26,22
34560,Oridean,area-52,1854,shaman,restoration,42,22,20
34561,Baodan,azshara,1847,shaman,restoration,83,42,41
34562,Moldymeatbox,emerald-dream,1847,shaman,restoration,96,47,49
34563,Bozzyy,illidan,1846,shaman,restoration,78,42,36
34564,Helga,hellscream,1845,shaman,restoration,48,29,19
34565,Upyourtotem,illidan,1842,shaman,restoration,30,22,8
34566,Shamcena,the-scryers,1842,shaman,restoration,51,28,23
34567,Shamanbini,tichondrius,1839,shaman,restoration,47,26,21
34568,Chocopuff,bleeding-hollow,1838,shaman,restoration,66,33,33
34569,Crazyshamañ,akama,1837,shaman,restoration,53,27,26
34570,Conjunction,azjolnerub,1837,shaman,restoration,65,29,36
34571,Caibeeshammy,tichondrius,1835,shaman,restoration,162,77,85
34572,Muscleyuan,tichondrius,1835,shaman,restoration,53,25,28
34573,Stylesp,tichondrius,1833,shaman,restoration,60,32,28
34574,Splashz,illidan,1833,shaman,restoration,71,36,35
34575,Kimflo,tichondrius,1833,shaman,restoration,309,152,157
34576,Wanghaisham,kelthuzad,1830,shaman,restoration,123,63,60
34577,Papatooties,tichondrius,1830,shaman,restoration,257,124,133
34578,Chobawn,tichondrius,1829,shaman,restoration,60,32,28
34579,Bluekid,barthilas,1828,shaman,restoration,54,30,24
34580,Beyoncé,lethon,1826,shaman,restoration,53,30,23
34581,Hathul,bleeding-hollow,1826,shaman,restoration,60,33,27
34582,Vlly,tichondrius,1826,shaman,restoration,59,27,32
34583,Tuskcrusher,dalaran,1825,shaman,restoration,72,30,42
34584,Gjök,nemesis,1824,shaman,restoration,54,22,32
34585,Dehsaw,illidan,1821,shaman,restoration,108,54,54
34586,Cryochemist,tichondrius,1819,shaman,restoration,29,23,6
34587,Bigspaghetti,thrall,1818,shaman,restoration,66,31,35
34588,Totempack,stormrage,1817,shaman,restoration,54,26,28
34589,Eboy,thrall,1816,shaman,restoration,67,33,34
34590,Ogran,stormscale,1815,shaman,restoration,54,25,29
34591,Immabòt,tichondrius,1813,shaman,restoration,59,36,23
34592,Dadidun,tichondrius,1813,shaman,restoration,48,25,23
34593,Ericzlassoz,tichondrius,1812,shaman,restoration,66,42,24
34594,Dantheman,twisting-nether,1810,shaman,restoration,42,23,19
34595,Waterbro,tichondrius,1809,shaman,restoration,101,57,44
34596,Annte,stonemaul,1809,shaman,restoration,64,32,32
34597,Meatballs,kirin-tor,1809,shaman,restoration,62,31,31
34598,Desee,bleeding-hollow,1809,shaman,restoration,54,27,27
34599,Ookmetide,bleeding-hollow,1807,shaman,restoration,52,29,23
34600,Willy,icecrown,1807,shaman,restoration,87,44,43
34601,Nediar,tichondrius,1805,shaman,restoration,30,23,7
34602,Totemgripper,moon-guard,1804,shaman,restoration,65,39,26
34603,Hydrocheck,tichondrius,1804,shaman,restoration,94,54,40
34604,Astrøcyte,tichondrius,1804,shaman,restoration,96,46,50
34605,Nanosec,tichondrius,1803,shaman,restoration,36,23,13
34606,Cmsi,tichondrius,1803,shaman,restoration,42,23,19
34607,Tolík,ragnaros,1803,shaman,restoration,54,26,28
34608,Zoeyzour,illidan,1802,shaman,restoration,274,149,125
34609,Oceangrown,emerald-dream,1802,shaman,restoration,51,22,29
34610,Waymond,khadgar,1801,shaman,restoration,152,78,74
34611,Nktx,tichondrius,1800,shaman,restoration,118,66,52
34612,Holdmytotum,tichondrius,1800,shaman,restoration,52,29,23
34613,Zaapi,dalaran,1800,shaman,restoration,108,60,48
34614,Nazugresha,bleeding-hollow,1800,shaman,restoration,42,23,19
34615,Baseballcap,sargeras,1800,shaman,restoration,78,37,41
34616,Shockmematty,tichondrius,1798,shaman,restoration,36,25,11
34617,Inmø,ragnaros,1797,shaman,restoration,36,19,17
34618,Hodoongs,tichondrius,1797,shaman,restoration,49,23,26
34619,Ghomragar,antonidas,1796,shaman,restoration,47,25,22
34620,Cigaretter,tichondrius,1793,shaman,restoration,56,25,31
34621,Mybbro,kiljaeden,1792,shaman,restoration,87,42,45
34622,Fierymoo,frostmourne,1790,shaman,restoration,42,20,22
34623,Qksilverz,nemesis,1789,shaman,restoration,47,32,15
34624,Fluxxy,tichondrius,1787,shaman,restoration,66,27,39
34625,Rollintotems,bleeding-hollow,1785,shaman,restoration,84,39,45
34626,Chomang,stormreaver,1784,shaman,restoration,114,54,60
34627,Kurtxc,tichondrius,1782,shaman,restoration,30,23,7
34628,Booramqt,tichondrius,1780,shaman,restoration,47,27,20
34629,Boxfour,tichondrius,1777,shaman,restoration,84,39,45
34630,Blazingtotem,dunemaul,1775,shaman,restoration,125,64,61
34631,Ryuubi,illidan,1774,shaman,restoration,48,31,17
34632,Petzah,barthilas,1774,shaman,restoration,54,25,29
34633,Suzhixie,akama,1771,shaman,restoration,118,51,67
34634,Shanasty,bleeding-hollow,1769,shaman,restoration,60,31,29
34635,Aureal,malganis,1767,shaman,restoration,93,60,33
34636,Stórmstruck,area-52,1767,shaman,restoration,48,29,19
34637,Blackpïnk,tichondrius,1764,shaman,restoration,173,88,85
34638,Semtechs,tichondrius,1764,shaman,restoration,282,135,147
34639,Gratiens,zuljin,1764,shaman,restoration,60,27,33
34640,Julíp,tichondrius,1760,shaman,restoration,58,23,35
34641,Itsyabøiwill,area-52,1759,shaman,restoration,54,35,19
34642,Ðno,frostmourne,1754,shaman,restoration,81,41,40
34643,Bobbybigdam,tichondrius,1752,shaman,restoration,93,50,43
34644,Shawmen,zuljin,1748,shaman,restoration,208,110,98
34645,Magma,spirestone,1747,shaman,restoration,96,61,35
34646,Lavalavalava,eonar,1747,shaman,restoration,48,21,27
34647,Gatorwavez,bleeding-hollow,1746,shaman,restoration,89,51,38
34648,Warríed,sargeras,1746,shaman,restoration,59,29,30
34649,Toazty,stormscale,1745,shaman,restoration,75,44,31
34650,Mastashamsta,illidan,1745,shaman,restoration,48,25,23
34651,Blackfancy,thrall,1744,shaman,restoration,56,32,24
34652,Chonchastic,darkspear,1741,shaman,restoration,54,27,27
34653,Chessyc,ragnaros,1739,shaman,restoration,48,21,27
34654,Pookiexo,illidan,1736,shaman,restoration,41,25,16
34655,Zeonard,ragnaros,1736,shaman,restoration,166,91,75
34656,Illiteratex,tichondrius,1733,shaman,restoration,38,21,17
34657,Rantòn,bleeding-hollow,1733,shaman,restoration,59,27,32
34658,Cpplol,tichondrius,1726,shaman,restoration,47,27,20
34659,Krazyc,sargeras,1726,shaman,restoration,90,47,43
34660,Phxhouse,illidan,1722,shaman,restoration,324,159,165
34661,Patzog,area-52,1718,shaman,restoration,30,18,12
34662,Nayro,bleeding-hollow,1718,shaman,restoration,396,212,184
34663,Epicthesloth,sargeras,1716,shaman,restoration,47,23,24
34664,Inpantsment,barthilas,1714,shaman,restoration,151,78,73
34665,Bizzarro,azgalor,1713,shaman,restoration,79,40,39
34666,Fkwithme,burning-blade,1711,shaman,restoration,66,30,36
34667,Duregar,tichondrius,1709,shaman,restoration,60,35,25
34668,Gyrogg,scilla,1709,shaman,restoration,489,255,234
34669,Chontastic,darkspear,1707,shaman,restoration,36,18,18
34670,Shacewoman,altar-of-storms,1706,shaman,restoration,168,77,91
34671,Sìxnìne,tichondrius,1706,shaman,restoration,62,28,34
34672,Pèpé,sargeras,1705,shaman,restoration,38,23,15
34673,Tobírama,bleeding-hollow,1705,shaman,restoration,54,23,31
34674,Slm,bleeding-hollow,1704,shaman,restoration,24,18,6
34675,Hustlenflow,tichondrius,1704,shaman,restoration,60,32,28
34676,Kafkaesk,tichondrius,1704,shaman,restoration,54,21,33
34677,Elementz,tichondrius,1703,shaman,restoration,222,116,106
34678,Erbicklet,ragnaros,1701,shaman,restoration,154,80,74
34679,Laji,cairne,1700,shaman,restoration,191,98,93
34680,Groundingtot,hydraxis,1699,shaman,restoration,42,25,17
34681,Uncleilli,tichondrius,1699,shaman,restoration,53,20,33
34682,Renghostwolf,illidan,1698,shaman,restoration,36,18,18
34683,Lingduacn,tichondrius,1698,shaman,restoration,36,18,18
34684,Angelbie,tichondrius,1698,shaman,restoration,44,21,23
34685,Bubbacheeks,area-52,1697,shaman,restoration,60,34,26
34686,Vayces,barthilas,1697,shaman,restoration,193,101,92
34687,Wtbtotem,tichondrius,1697,shaman,restoration,48,24,24
34688,Xoweeknd,bleeding-hollow,1697,shaman,restoration,42,19,23
34689,Mitchestic,illidan,1697,shaman,restoration,95,37,58
34690,Wraethy,illidan,1695,shaman,restoration,109,60,49
34691,Montageb,illidan,1694,shaman,restoration,39,29,10
34692,Raeoki,area-52,1694,shaman,restoration,95,50,45
34693,Trouvaille,tichondrius,1693,shaman,restoration,47,23,24
34694,Ribbeye,tichondrius,1692,shaman,restoration,154,76,78
34695,Vrom,whisperwind,1691,shaman,restoration,72,42,30
34696,Texmawave,moon-guard,1690,shaman,restoration,113,68,45
34697,Horizonsham,stormrage,1690,shaman,restoration,42,25,17
34698,Xruok,kelthuzad,1689,shaman,restoration,39,24,15
34699,Ittøki,tichondrius,1689,shaman,restoration,41,24,17
34700,Sewerperson,zuljin,1689,shaman,restoration,42,23,19
34701,Lilgeeh,kelthuzad,1689,shaman,restoration,46,24,22
34702,Shamix,area-52,1688,shaman,restoration,42,23,19
34703,Baern,thrall,1688,shaman,restoration,74,38,36
34704,Kromgul,malfurion,1688,shaman,restoration,54,25,29
34705,Rockzoa,tichondrius,1688,shaman,restoration,60,27,33
34706,Bacon,lightninghoof,1687,shaman,restoration,108,45,63
34707,Ozmats,malganis,1686,shaman,restoration,76,35,41
34708,Hairyrichard,zuljin,1685,shaman,restoration,760,397,363
34709,Suyy,tichondrius,1685,shaman,restoration,48,23,25
34710,Solidhomme,tichondrius,1684,shaman,restoration,42,23,19
34711,Bizzarra,azshara,1681,shaman,restoration,39,26,13
34712,Ibreakanklez,bleeding-hollow,1681,shaman,restoration,42,20,22
34713,Bogz,korgath,1679,shaman,restoration,119,54,65
34714,Tanta,gurubashi,1678,shaman,restoration,57,25,32
34715,Raywhiter,tichondrius,1676,shaman,restoration,62,29,33
34716,Spiritry,tichondrius,1675,shaman,restoration,90,51,39
34717,Nethyxsoy,frostmourne,1673,shaman,restoration,48,33,15
34718,Urga,hyjal,1672,shaman,restoration,36,20,16
34719,Namso,tichondrius,1671,shaman,restoration,36,22,14
34720,Dingfu,sargeras,1670,shaman,restoration,187,108,79
34721,Grymn,sargeras,1670,shaman,restoration,228,109,119
34722,Tpokes,sargeras,1669,shaman,restoration,42,22,20
34723,Mkyz,tichondrius,1667,shaman,restoration,94,51,43
34724,Tokuma,illidan,1667,shaman,restoration,58,26,32
34725,Drekkhal,area-52,1666,shaman,restoration,178,104,74
34726,Scroogz,emerald-dream,1665,shaman,restoration,102,50,52
34727,Sasgöb,illidan,1665,shaman,restoration,83,36,47
34728,Isagii,stormrage,1664,shaman,restoration,48,29,19
34729,Toxidizetkö,azralon,1664,shaman,restoration,48,26,22
34730,Semnicktotem,area-52,1663,shaman,restoration,66,33,33
34731,Reppinsix,sargeras,1662,shaman,restoration,58,24,34
34732,Chazzwozza,area-52,1660,shaman,restoration,41,22,19
34733,Bluepigo,tichondrius,1660,shaman,restoration,59,24,35
34734,Diulama,tichondrius,1659,shaman,restoration,45,30,15
34735,Belarix,emerald-dream,1659,shaman,restoration,205,96,109
34736,Pingatronx,ragnaros,1659,shaman,restoration,42,19,23
34737,Exshocks,tichondrius,1658,shaman,restoration,54,30,24
34738,Imd,tichondrius,1658,shaman,restoration,42,21,21
34739,Moocatpie,illidan,1657,shaman,restoration,82,46,36
34740,Lingdusm,tichondrius,1657,shaman,restoration,36,20,16
34741,Zuescannon,kelthuzad,1656,shaman,restoration,84,39,45
34742,Meskthemage,barthilas,1654,shaman,restoration,47,23,24
34743,Novoz,tichondrius,1653,shaman,restoration,42,24,18
34744,Whameradetu,suramar,1653,shaman,restoration,71,31,40
34745,Svondo,illidan,1652,shaman,restoration,31,21,10
34746,Goobie,crushridge,1651,shaman,restoration,68,43,25
34747,Win,blackwing-lair,1651,shaman,restoration,36,21,15
34748,Devastaterr,bleeding-hollow,1650,shaman,restoration,90,46,44
34749,Deephole,illidan,1649,shaman,restoration,85,37,48
34750,Bolteon,malganis,1648,shaman,restoration,30,21,9
34751,Jsell,zuljin,1646,shaman,restoration,56,28,28
34752,Amdshaman,thrall,1645,shaman,restoration,67,37,30
34753,Héadshot,bleeding-hollow,1645,shaman,restoration,83,38,45
34754,Bigmontana,tichondrius,1644,shaman,restoration,36,21,15
34755,Gabant,azralon,1644,shaman,restoration,42,19,23
34756,Skipler,stormrage,1643,shaman,restoration,54,29,25
34757,Weoo,doomhammer,1642,shaman,restoration,48,23,25
34758,Ekss,tichondrius,1642,shaman,restoration,48,19,29
34759,Thunderspark,tichondrius,1641,shaman,restoration,36,24,12
34760,Gordonramsai,sargeras,1641,shaman,restoration,272,148,124
34761,Singleorigin,tichondrius,1641,shaman,restoration,105,41,64
34762,Akheeta,tichondrius,1639,shaman,restoration,63,44,19
34763,Hoshwear,azralon,1639,shaman,restoration,48,31,17
34764,Ethikas,tichondrius,1638,shaman,restoration,42,24,18
34765,Beastofmagic,illidan,1638,shaman,restoration,125,68,57
34766,Cheddaman,kiljaeden,1637,shaman,restoration,48,21,27
34767,Krilick,blackrock,1635,shaman,restoration,104,57,47
34768,Daddybeaarr,thrall,1635,shaman,restoration,55,25,30
34769,Gjok,nemesis,1634,shaman,restoration,59,20,39
34770,Quitnectar,aggramar,1633,shaman,restoration,48,24,24
34771,Shortbusqt,hyjal,1631,shaman,restoration,42,23,19
34772,Wawsham,tichondrius,1631,shaman,restoration,48,19,29
34773,Worldx,barthilas,1630,shaman,restoration,108,57,51
34774,Hamrok,moon-guard,1630,shaman,restoration,36,18,18
34775,Flappygooch,illidan,1629,shaman,restoration,102,43,59
34776,Lacid,tichondrius,1627,shaman,restoration,62,40,22
34777,Lemmehex,illidan,1626,shaman,restoration,40,23,17
34778,Grizze,bonechewer,1626,shaman,restoration,90,41,49
34779,Goranzo,emerald-dream,1626,shaman,restoration,54,24,30
34780,Peegee,zuluhed,1626,shaman,restoration,60,24,36
34781,Sin,bleeding-hollow,1625,shaman,restoration,30,17,13
34782,Drfentanylx,emerald-dream,1623,shaman,restoration,30,17,13
34783,Oldguy,ragnaros,1623,shaman,restoration,119,60,59
34784,Youliuhua,tichondrius,1622,shaman,restoration,30,17,13
34785,Onagi,frostmourne,1621,shaman,restoration,30,22,8
34786,Vanella,malganis,1621,shaman,restoration,42,25,17
34787,Restosêxual,tichondrius,1621,shaman,restoration,36,18,18
34788,Thuntard,bleeding-hollow,1621,shaman,restoration,48,23,25
34789,Joyrex,spinebreaker,1620,shaman,restoration,45,20,25
34790,Bigamez,azuremyst,1616,shaman,restoration,158,88,70
34791,Durogh,darkspear,1616,shaman,restoration,60,23,37
34792,Animus,dark-iron,1615,shaman,restoration,30,19,11
34793,Sunyang,tichondrius,1615,shaman,restoration,36,17,19
34794,Skoobasteeve,sargeras,1614,shaman,restoration,69,39,30
34795,World,frostmourne,1614,shaman,restoration,47,25,22
34796,Quendella,aggramar,1613,shaman,restoration,42,25,17
34797,Harth,zuljin,1613,shaman,restoration,110,65,45
34798,Polared,hyjal,1613,shaman,restoration,52,25,27
34799,Yeamn,saurfang,1612,shaman,restoration,141,86,55
34800,Harigomi,tichondrius,1611,shaman,restoration,243,128,115
34801,Gunrose,proudmoore,1610,shaman,restoration,67,36,31
34802,Ränton,bleeding-hollow,1610,shaman,restoration,42,20,22
34803,Drammah,malganis,1610,shaman,restoration,48,19,29
34804,Redds,tichondrius,1608,shaman,restoration,66,48,18
34805,Ðoomed,kiljaeden,1608,shaman,restoration,30,19,11
34806,Alett,arathor,1608,shaman,restoration,60,29,31
34807,Plzdontlos,illidan,1607,shaman,restoration,113,69,44
34808,Rainingheals,auchindoun,1607,shaman,restoration,44,19,25
34809,Randomshammy,area-52,1606,shaman,restoration,30,17,13
34810,Astrauk,nemesis,1606,shaman,restoration,76,43,33
34811,Fujiyama,dark-iron,1606,shaman,restoration,120,65,55
34812,Raxshock,stormrage,1606,shaman,restoration,42,22,20
34813,Prêttylights,bleeding-hollow,1605,shaman,restoration,30,17,13
34814,Hexrz,area-52,1605,shaman,restoration,42,21,21
34815,Luckyscatter,frostmourne,1605,shaman,restoration,36,18,18
34816,Sliditin,tichondrius,1604,shaman,restoration,36,25,11
34817,Oninobu,sargeras,1604,shaman,restoration,28,18,10
34818,Hurú,azralon,1604,shaman,restoration,36,21,15
34819,Spampurge,blackwing-lair,1604,shaman,restoration,37,19,18
34820,Polarities,malganis,1604,shaman,restoration,54,21,33
34821,Kratór,kelthuzad,1603,shaman,restoration,47,31,16
34822,Kimchimi,tichondrius,1603,shaman,restoration,144,85,59
34823,Fernetbrança,ragnaros,1603,shaman,restoration,48,26,22
34824,Mutaishammy,barthilas,1602,shaman,restoration,30,19,11
34825,Telchar,quelthalas,1602,shaman,restoration,102,62,40
34826,Asnalda,emerald-dream,1602,shaman,restoration,51,30,21
34827,Purgebotx,bleeding-hollow,1601,shaman,restoration,114,70,44
34828,Gweemextreme,tichondrius,1601,shaman,restoration,36,18,18
34829,Belshiro,sargeras,1601,shaman,restoration,108,51,57
34830,Huáxià,tichondrius,1601,shaman,restoration,77,36,41
34831,Tzyorz,illidan,1600,shaman,restoration,72,40,32
34832,Shocksauce,tichondrius,1600,shaman,restoration,94,51,43
34833,Succmytotems,tichondrius,1600,shaman,restoration,93,47,46
34834,Foilcap,bonechewer,1600,shaman,restoration,296,144,152
34835,Ddogz,illidan,1600,shaman,restoration,48,21,27
34836,Gulmuwu,zuljin,1599,shaman,restoration,38,22,16
34837,Mastlau,tichondrius,1599,shaman,restoration,30,17,13
34838,Tevya,dalvengyr,1598,shaman,restoration,83,47,36
34839,Tideoverdose,tichondrius,1594,shaman,restoration,36,19,17
34840,Dgshaman,tichondrius,1593,shaman,restoration,24,17,7
34841,Charlesby,tichondrius,1593,shaman,restoration,126,73,53
34842,Yehbeen,tichondrius,1590,shaman,restoration,30,18,12
34843,Shamanceylol,barthilas,1590,shaman,restoration,57,30,27
34844,Xzxz,sargeras,1588,shaman,restoration,115,63,52
34845,Naweiv,caelestrasz,1586,shaman,restoration,36,19,17
34846,Besylate,illidan,1586,shaman,restoration,80,39,41
34847,Shamsom,tichondrius,1586,shaman,restoration,104,49,55
34848,Kolanji,akama,1585,shaman,restoration,41,22,19
34849,Muggz,sargeras,1585,shaman,restoration,42,19,23
34850,Eletius,tichondrius,1583,shaman,restoration,23,20,3
34851,Møp,spirestone,1583,shaman,restoration,119,61,58
34852,Improvedx,akama,1583,shaman,restoration,41,21,20
34853,Totesmcgoatz,arthas,1582,shaman,restoration,33,20,13
34854,Bigdictuna,sargeras,1582,shaman,restoration,182,98,84
34855,Miroen,tichondrius,1580,shaman,restoration,48,24,24
34856,Turborundat,area-52,1579,shaman,restoration,201,115,86
34857,Rugmat,tichondrius,1578,shaman,restoration,60,29,31
34858,Pkx,eitrigg,1578,shaman,restoration,47,20,27
34859,Colterr,thunderhorn,1577,shaman,restoration,36,20,16
34860,Dduddaddu,tichondrius,1577,shaman,restoration,48,25,23
34861,Prowdt,azralon,1577,shaman,restoration,394,203,191
34862,Rynoh,dalaran,1575,shaman,restoration,109,54,55
34863,Rainz,aggramar,1574,shaman,restoration,42,22,20
34864,Arkerus,emerald-dream,1573,shaman,restoration,36,22,14
34865,Dawnyshock,arygos,1573,shaman,restoration,41,19,22
34866,Strives,icecrown,1573,shaman,restoration,48,21,27
34867,Improvize,malganis,1571,shaman,restoration,53,25,28
34868,Rogrim,malganis,1570,shaman,restoration,48,24,24
34869,Brongar,bleeding-hollow,1569,shaman,restoration,66,26,40
34870,Sikotics,area-52,1568,shaman,restoration,111,58,53
34871,Moosk,zuluhed,1567,shaman,restoration,51,27,24
34872,Funkesapien,tichondrius,1565,shaman,restoration,36,18,18
34873,Foragorn,stormrage,1565,shaman,restoration,199,98,101
34874,Spurske,emerald-dream,1564,shaman,restoration,78,32,46
34875,Dreadxtotems,illidan,1563,shaman,restoration,59,31,28
34876,Bigdampurge,illidan,1563,shaman,restoration,95,49,46
34877,Waater,lightbringer,1562,shaman,restoration,86,49,37
34878,Intruzionall,barthilas,1562,shaman,restoration,213,113,100
34879,Gki,tichondrius,1560,shaman,restoration,37,26,11
34880,Wilmar,ragnaros,1560,shaman,restoration,66,33,33
34881,Stonetides,tichondrius,1560,shaman,restoration,78,33,45
34882,Rulf,proudmoore,1558,shaman,restoration,90,34,56
34883,Flamehorns,malganis,1555,shaman,restoration,30,20,10
34884,Kayadee,stormrage,1554,shaman,restoration,75,37,38
34885,Yoshìmìtsu,illidan,1554,shaman,restoration,71,35,36
34886,Thunderphury,proudmoore,1554,shaman,restoration,59,25,34
34887,Goatedsham,dalaran,1553,shaman,restoration,65,36,29
34888,Eatmymeatbal,illidan,1551,shaman,restoration,65,26,39
34889,Draidosh,area-52,1550,shaman,restoration,59,37,22
34890,Pherolex,tichondrius,1550,shaman,restoration,42,23,19
34891,Totemslol,ysera,1550,shaman,restoration,36,18,18
34892,Hwyl,frostmourne,1549,shaman,restoration,72,33,39
34893,Lanzero,chogall,1547,shaman,restoration,42,30,12
34894,Mistarklean,malganis,1546,shaman,restoration,111,49,62
34895,Steveyy,frostmourne,1544,shaman,restoration,27,17,10
34896,Tyar,area-52,1543,shaman,restoration,137,64,73
34897,Chainstuff,area-52,1541,shaman,restoration,29,17,12
34898,Wolfsokar,emerald-dream,1537,shaman,restoration,102,39,63
34899,Akubai,kelthuzad,1535,shaman,restoration,78,39,39
34900,Bighaircut,darkspear,1534,shaman,restoration,78,35,43
34901,Shocknrot,maelstrom,1533,shaman,restoration,26,17,9
34902,Aguinha,azralon,1533,shaman,restoration,60,33,27
34903,Bluedynamite,tichondrius,1533,shaman,restoration,60,30,30
34904,Tides,skullcrusher,1533,shaman,restoration,42,18,24
34905,Ftp,kelthuzad,1531,shaman,restoration,24,16,8
34906,Purgenx,tichondrius,1531,shaman,restoration,30,18,12
34907,Spongemama,tichondrius,1530,shaman,restoration,47,25,22
34908,Rookieshaman,tichondrius,1528,shaman,restoration,24,16,8
34909,Chacham,tichondrius,1528,shaman,restoration,36,22,14
34910,Tarròò,bleeding-hollow,1526,shaman,restoration,24,16,8
34911,Unbreakable,illidan,1525,shaman,restoration,55,21,34
34912,Flubydont,icecrown,1524,shaman,restoration,66,32,34
34913,Platewalrus,illidan,1523,shaman,restoration,30,16,14
34914,Repang,tichondrius,1523,shaman,restoration,36,19,17
34915,Hehew,kelthuzad,1523,shaman,restoration,122,61,61
34916,Vexxs,shadowmoon,1522,shaman,restoration,30,16,14
34917,Riptideafk,sargeras,1521,shaman,restoration,66,34,32
34918,Kaytahn,proudmoore,1520,shaman,restoration,66,36,30
34919,Dogecoincäsh,sargeras,1520,shaman,restoration,54,29,25
34920,Rocyt,sargeras,1520,shaman,restoration,66,35,31
34921,Aleforj,quelthalas,1519,shaman,restoration,55,27,28
34922,Záheer,arthas,1517,shaman,restoration,75,38,37
34923,Vywolf,frostmourne,1516,shaman,restoration,45,25,20
34924,Freesolo,barthilas,1516,shaman,restoration,152,76,76
34925,Zuralah,nemesis,1515,shaman,restoration,46,25,21
34926,Jbalvi,ragnaros,1513,shaman,restoration,105,59,46
34927,Killercam,maiev,1513,shaman,restoration,219,108,111
34928,Draüguss,azralon,1513,shaman,restoration,131,64,67
34929,Stylebenderx,frostmourne,1512,shaman,restoration,30,16,14
34930,Heniu,tichondrius,1511,shaman,restoration,36,16,20
34931,Shamansrock,tichondrius,1509,shaman,restoration,36,16,20
34932,Gemoz,tichondrius,1508,shaman,restoration,24,16,8
34933,Shamxrob,sargeras,1507,shaman,restoration,72,42,30
34934,Plâto,stormrage,1507,shaman,restoration,30,16,14
34935,Gattious,illidan,1507,shaman,restoration,48,25,23
34936,Cultsulyvahn,tichondrius,1507,shaman,restoration,73,37,36
34937,Trapghost,cenarius,1506,shaman,restoration,87,41,46
34938,Thegil,tichondrius,1506,shaman,restoration,78,36,42
34939,Shamankïng,proudmoore,1505,shaman,restoration,89,46,43
34940,Packspiritqt,tichondrius,1505,shaman,restoration,42,21,21
34941,Shulace,area-52,1505,shaman,restoration,36,17,19
34942,Randomshammy,stormrage,1504,shaman,restoration,54,27,27
34943,Pawbed,aegwynn,1503,shaman,restoration,117,64,53
34944,Cokehealsx,tichondrius,1503,shaman,restoration,30,16,14
34945,Agharn,moon-guard,1503,shaman,restoration,51,26,25
34946,Papatreb,haomarush,1503,shaman,restoration,78,39,39
34947,Shadowz,alexstrasza,1502,shaman,restoration,30,18,12
34948,Ballistíc,boulderfist,1502,shaman,restoration,66,38,28
34949,Voluptuous,mannoroth,1502,shaman,restoration,376,193,183
34950,Rsdyxjh,tichondrius,1502,shaman,restoration,45,19,26
34951,Ban,blackrock,1498,shaman,restoration,39,21,18
34952,Yarl,ragnaros,1497,shaman,restoration,30,19,11
34953,Lengin,bleeding-hollow,1497,shaman,restoration,36,21,15
34954,Glocksitotem,malganis,1497,shaman,restoration,111,64,47
34955,Sbrinz,thrall,1497,shaman,restoration,36,19,17
34956,Elementàlius,quelthalas,1497,shaman,restoration,71,32,39
34957,Ärtful,illidan,1496,shaman,restoration,60,34,26
34958,Doubletåp,emerald-dream,1495,shaman,restoration,35,16,19
34959,Køtømine,ragnaros,1491,shaman,restoration,106,67,39
34960,Redek,sargeras,1491,shaman,restoration,196,105,91
34961,Bwinthewomb,stormrage,1491,shaman,restoration,148,77,71
34962,Vanklayser,ragnaros,1491,shaman,restoration,108,54,54
34963,Mentyb,emerald-dream,1491,shaman,restoration,42,16,26
34964,Koomrog,frostmourne,1489,shaman,restoration,32,21,11
34965,Hexxercise,area-52,1488,shaman,restoration,41,31,10
34966,Hyonkh,tichondrius,1487,shaman,restoration,77,45,32
34967,Kaaying,tichondrius,1487,shaman,restoration,43,17,26
34968,Chlckenx,tichondrius,1485,shaman,restoration,99,44,55
34969,Jizzlewizwiz,tichondrius,1484,shaman,restoration,181,89,92
34970,Sittinn,malganis,1484,shaman,restoration,66,31,35
34971,ßread,illidan,1484,shaman,restoration,80,33,47
34972,Benjaminx,tichondrius,1483,shaman,restoration,32,22,10
34973,Mlpz,black-dragonflight,1482,shaman,restoration,66,38,28
34974,Hachikø,frostmourne,1482,shaman,restoration,90,42,48
34975,Trenhance,stormrage,1481,shaman,restoration,30,23,7
34976,Krewesham,uldaman,1481,shaman,restoration,28,17,11
34977,Abellone,tichondrius,1480,shaman,restoration,33,17,16
34978,Sarkhanvol,aggramar,1478,shaman,restoration,30,22,8
34979,Ryukims,tichondrius,1477,shaman,restoration,35,17,18
34980,Ellgric,emerald-dream,1476,shaman,restoration,48,21,27
34981,Defac,proudmoore,1475,shaman,restoration,72,42,30
34982,Maxchungie,azshara,1475,shaman,restoration,30,16,14
34983,Angelabaaby,proudmoore,1475,shaman,restoration,60,28,32
34984,Yossarabi,bleeding-hollow,1475,shaman,restoration,54,23,31
34985,Orkshammy,illidan,1474,shaman,restoration,28,19,9
34986,Vewdew,guldan,1473,shaman,restoration,78,47,31
34987,Brainal,sargeras,1472,shaman,restoration,60,25,35
34988,Pissticles,bleeding-hollow,1471,shaman,restoration,150,75,75
34989,Heebeegeebee,stormrage,1470,shaman,restoration,51,31,20
34990,Neosham,frostwolf,1470,shaman,restoration,42,16,26
34991,Szeav,tichondrius,1467,shaman,restoration,36,18,18
34992,Keenie,shadow-council,1467,shaman,restoration,35,17,18
34993,Gangzmmsk,tichondrius,1466,shaman,restoration,24,18,6
34994,Philbert,boulderfist,1466,shaman,restoration,54,31,23
34995,Ottoman,eredar,1466,shaman,restoration,45,21,24
34996,Shockszz,onyxia,1466,shaman,restoration,108,50,58
34997,Ãrthor,stormrage,1464,shaman,restoration,66,37,29
34998,Damoclez,jubeithos,1464,shaman,restoration,39,17,22
34999,Allcatraz,zuljin,1464,shaman,restoration,40,17,23
35000,Santiagodx,ragnaros,1462,shaman,restoration,253,125,128
35001,Hirah,frostmourne,1460,shaman,restoration,23,16,7
35002,Smartakkar,emerald-dream,1460,shaman,restoration,57,36,21
35003,Snakesoul,area-52,1460,shaman,restoration,54,26,28
35004,Benta,zuljin,1459,shaman,restoration,72,36,36
35005,Nilstorm,quelthalas,1458,shaman,restoration,72,38,34
35006,Shocksfuker,stormrage,1458,shaman,restoration,38,19,19
35007,Paoran,sargeras,1457,shaman,restoration,26,16,10
35008,Hooldcool,tichondrius,1457,shaman,restoration,147,86,61
35009,Kwzy,stormrage,1457,shaman,restoration,51,26,25
35010,Goatpornbad,sargeras,1457,shaman,restoration,96,44,52
35011,Tizz,quelthalas,1456,shaman,restoration,112,54,58
35012,Totemgoddess,nemesis,1456,shaman,restoration,54,26,28
35013,Whoshealing,lightninghoof,1455,shaman,restoration,66,35,31
35014,Furrytotems,darkspear,1455,shaman,restoration,126,56,70
35015,Wuruizec,illidan,1454,shaman,restoration,59,28,31
35016,Ssaotizi,tichondrius,1454,shaman,restoration,196,91,105
35017,Rinnan,malganis,1453,shaman,restoration,103,48,55
35018,Carltonbanks,aggramar,1452,shaman,restoration,36,18,18
35019,Splonkydonky,stonemaul,1450,shaman,restoration,30,18,12
35020,Tidalstorm,ragnaros,1450,shaman,restoration,90,52,38
35021,Onepunchsham,illidan,1450,shaman,restoration,93,45,48
35022,Enalen,argent-dawn,1449,shaman,restoration,57,34,23
35023,Buffduude,shadowsong,1449,shaman,restoration,48,22,26
35024,Chitoss,gorgonnash,1448,shaman,restoration,122,59,63
35025,Blowurbubble,tichondrius,1447,shaman,restoration,42,24,18
35026,Circuits,malganis,1446,shaman,restoration,58,30,28
35027,Erthshawk,wildhammer,1446,shaman,restoration,78,40,38
35028,Joltik,area-52,1444,shaman,restoration,173,84,89
35029,Rumkin,malganis,1443,shaman,restoration,72,40,32
35030,Vzla,ragnaros,1443,shaman,restoration,78,41,37
35031,Milkkshake,illidan,1443,shaman,restoration,250,116,134
35032,Hruggol,bleeding-hollow,1442,shaman,restoration,48,22,26
35033,Halfinha,nemesis,1441,shaman,restoration,187,92,95
35034,Wuargh,area-52,1440,shaman,restoration,220,118,102
35035,Tenyks,tichondrius,1439,shaman,restoration,57,29,28
35036,Breadx,khaz-modan,1439,shaman,restoration,30,15,15
35037,Praxis,tichondrius,1437,shaman,restoration,154,79,75
35038,Miketheseal,bleeding-hollow,1437,shaman,restoration,36,15,21
35039,Creatine,area-52,1436,shaman,restoration,71,37,34
35040,Lustlolol,korgath,1435,shaman,restoration,111,51,60
35041,Dawny,arygos,1435,shaman,restoration,36,15,21
35042,Siyusm,illidan,1435,shaman,restoration,60,21,39
35043,Wardruna,andorhal,1434,shaman,restoration,24,15,9
35044,Geser,silvermoon,1432,shaman,restoration,44,26,18
35045,Thormør,tichondrius,1432,shaman,restoration,31,15,16
35046,Insertyzs,azralon,1431,shaman,restoration,66,36,30
35047,Kabasan,illidan,1431,shaman,restoration,60,27,33
35048,Totem,burning-legion,1431,shaman,restoration,36,16,20
35049,Hugebrain,proudmoore,1431,shaman,restoration,124,50,74
35050,Fatherrtime,illidan,1430,shaman,restoration,48,26,22
35051,Totembarx,illidan,1428,shaman,restoration,42,29,13
35052,Nanishock,area-52,1426,shaman,restoration,45,24,21
35053,Xiwg,tichondrius,1425,shaman,restoration,60,23,37
35054,Crittingbull,veknilash,1424,shaman,restoration,204,105,99
35055,Torric,kalecgos,1424,shaman,restoration,66,31,35
35056,Kelta,kelthuzad,1423,shaman,restoration,30,15,15
35057,Kephax,eonar,1421,shaman,restoration,117,59,58
35058,Reuxxe,area-52,1421,shaman,restoration,179,88,91
35059,Boonno,tichondrius,1421,shaman,restoration,36,15,21
35060,Samanl,tichondrius,1420,shaman,restoration,77,44,33
35061,Cinematticz,tichondrius,1420,shaman,restoration,101,51,50
35062,Pýe,bleeding-hollow,1420,shaman,restoration,42,21,21
35063,Slothstorm,barthilas,1419,shaman,restoration,59,31,28
35064,Kandshamy,azralon,1419,shaman,restoration,30,15,15
35065,Skelesham,zuljin,1418,shaman,restoration,42,28,14
35066,Edhance,area-52,1418,shaman,restoration,78,48,30
35067,Mcwindyfists,zuljin,1418,shaman,restoration,36,15,21
35068,Springtide,thrall,1417,shaman,restoration,59,29,30
35069,Latorius,frostmourne,1416,shaman,restoration,61,38,23
35070,Roostershama,tichondrius,1416,shaman,restoration,68,30,38
35071,Psiexrcst,tichondrius,1415,shaman,restoration,54,22,32
35072,Djshammy,barthilas,1414,shaman,restoration,80,42,38
35073,Bearmanshrek,tichondrius,1414,shaman,restoration,72,26,46
35074,Bitxxnumber,tichondrius,1412,shaman,restoration,229,124,105
35075,Tawahka,hyjal,1412,shaman,restoration,179,87,92
35076,Azumaa,tichondrius,1412,shaman,restoration,101,44,57
35077,Subnôize,bleeding-hollow,1411,shaman,restoration,74,44,30
35078,Alexustexas,tichondrius,1411,shaman,restoration,66,37,29
35079,Enflexi,lightbringer,1411,shaman,restoration,53,26,27
35080,Orkwa,bleeding-hollow,1410,shaman,restoration,68,32,36
35081,Catchclause,eonar,1409,shaman,restoration,30,15,15
35082,Xaltas,moon-guard,1407,shaman,restoration,52,33,19
35083,Bazinguinha,azralon,1407,shaman,restoration,82,41,41
35084,Fuzzymuzzy,illidan,1407,shaman,restoration,30,15,15
35085,Zizö,barthilas,1404,shaman,restoration,42,19,23
35086,Supdaug,vashj,1402,shaman,restoration,66,32,34
35087,Buffdestru,azralon,1401,shaman,restoration,95,55,40
35088,Sploosh,norgannon,1401,shaman,restoration,36,20,16
35089,Bluetooth,stormrage,1401,shaman,restoration,89,39,50
35090,Mäjorlazer,lightbringer,1400,shaman,restoration,24,15,9
35091,Ironcrag,moon-guard,1398,shaman,restoration,200,102,98
35092,Stylesp,area-52,1396,shaman,restoration,125,58,67
35093,Drinkharder,stormrage,1395,shaman,restoration,34,16,18
35094,Arginine,tichondrius,1395,shaman,restoration,42,15,27
35095,Kakiscala,proudmoore,1393,shaman,restoration,30,16,14
35096,ßøvîn,thrall,1393,shaman,restoration,71,36,35
35097,Eggrollninja,illidan,1392,shaman,restoration,24,17,7
35098,Windfrenzy,thrall,1392,shaman,restoration,36,15,21
35099,Totemrack,tichondrius,1391,shaman,restoration,24,15,9
35100,Largeshaman,zuljin,1391,shaman,restoration,30,15,15
35101,Rizam,malganis,1389,shaman,restoration,42,33,9
35102,Dazu,drakkari,1389,shaman,restoration,24,15,9
35103,Shaquillius,tichondrius,1389,shaman,restoration,36,17,19
35104,Kirawindu,zuljin,1387,shaman,restoration,69,39,30
35105,Halloweenz,area-52,1387,shaman,restoration,30,16,14
35106,Shämwow,agamaggan,1387,shaman,restoration,793,398,395
35107,Soowecide,tichondrius,1387,shaman,restoration,60,23,37
35108,Shazik,spirestone,1386,shaman,restoration,54,21,33
35109,Kandin,icecrown,1385,shaman,restoration,82,42,40
35110,Fungus,firetree,1384,shaman,restoration,42,23,19
35111,Fishman,exodar,1382,shaman,restoration,101,45,56
35112,Brosidan,anvilmar,1381,shaman,restoration,44,32,12
35113,Çruces,illidan,1381,shaman,restoration,36,17,19
35114,Thenextcdew,illidan,1380,shaman,restoration,36,20,16
35115,Kaili,illidan,1379,shaman,restoration,47,28,19
35116,Lanuur,moon-guard,1379,shaman,restoration,54,31,23
35117,Mudlùst,moon-guard,1378,shaman,restoration,67,36,31
35118,Hannamayzing,arathor,1377,shaman,restoration,36,16,20
35119,Roxzid,area-52,1374,shaman,restoration,57,33,24
35120,Hicys,azralon,1374,shaman,restoration,85,48,37
35121,Jensenx,proudmoore,1374,shaman,restoration,82,38,44
35122,Graymatterz,ysondre,1372,shaman,restoration,36,15,21
35123,Blackoutsx,stormreaver,1369,shaman,restoration,28,15,13
35124,Gromgrai,bleeding-hollow,1368,shaman,restoration,53,30,23
35125,Amperage,spirestone,1366,shaman,restoration,52,24,28
35126,Krevsham,proudmoore,1364,shaman,restoration,56,23,33
35127,Ralinta,tichondrius,1364,shaman,restoration,77,27,50
35128,Charmize,azralon,1363,shaman,restoration,91,47,44
35129,Shamkack,kelthuzad,1363,shaman,restoration,53,24,29
35130,Ryùko,proudmoore,1363,shaman,restoration,60,19,41
35131,Unchaman,ragnaros,1362,shaman,restoration,104,47,57
35132,Fwwrs,illidan,1359,shaman,restoration,25,16,9
35133,Vibration,akama,1359,shaman,restoration,123,67,56
35134,Sàuron,tichondrius,1359,shaman,restoration,37,20,17
35135,Wyått,emerald-dream,1359,shaman,restoration,95,43,52
35136,Kiojin,ragnaros,1357,shaman,restoration,186,99,87
35137,Wooskier,tichondrius,1355,shaman,restoration,60,32,28
35138,Libragirl,tichondrius,1354,shaman,restoration,54,25,29
35139,Prøduce,tichondrius,1353,shaman,restoration,54,30,24
35140,Atnaz,drakkari,1352,shaman,restoration,42,24,18
35141,Tumble,frostmourne,1352,shaman,restoration,105,51,54
35142,Noobcrits,tichondrius,1350,shaman,restoration,42,25,17
35143,Fencepost,bleeding-hollow,1350,shaman,restoration,72,42,30
35144,Nyathera,barthilas,1349,shaman,restoration,66,37,29
35145,Chandye,proudmoore,1348,shaman,restoration,72,27,45
35146,Orjamba,barthilas,1347,shaman,restoration,29,17,12
35147,Daddyk,gnomeregan,1347,shaman,restoration,53,30,23
35148,Lildunny,tichondrius,1346,shaman,restoration,36,15,21
35149,Fàrrò,thrall,1345,shaman,restoration,66,39,27
35150,Xajsham,tichondrius,1344,shaman,restoration,102,54,48
35151,Kultirio,quelthalas,1344,shaman,restoration,61,32,29
35152,Elemen,quelthalas,1344,shaman,restoration,97,48,49
35153,Smniss,tichondrius,1344,shaman,restoration,49,23,26
35154,Orochishaman,stormrage,1343,shaman,restoration,24,14,10
35155,Squimbert,tichondrius,1343,shaman,restoration,30,14,16
35156,Dwârf,tichondrius,1342,shaman,restoration,24,14,10
35157,Bombadil,korgath,1342,shaman,restoration,30,14,16
35158,Camer,sargeras,1341,shaman,restoration,18,14,4
35159,Shockpanda,zuljin,1340,shaman,restoration,18,14,4
35160,Fallhazard,malganis,1340,shaman,restoration,40,24,16
35161,Kachupinsito,ragnaros,1339,shaman,restoration,91,45,46
35162,Multiduelist,bleeding-hollow,1338,shaman,restoration,18,14,4
35163,Orbys,illidan,1335,shaman,restoration,24,14,10
35164,Shakrakhan,tichondrius,1335,shaman,restoration,30,14,16
35165,Satrixss,ragnaros,1334,shaman,restoration,79,44,35
35166,Aseew,drakkari,1334,shaman,restoration,66,31,35
35167,Nerfmytotemz,frostmourne,1333,shaman,restoration,30,14,16
35168,Zinns,dalaran,1332,shaman,restoration,30,15,15
35169,Alátreon,azralon,1332,shaman,restoration,66,30,36
35170,Ryeqt,illidan,1331,shaman,restoration,30,14,16
35171,Edisto,darkspear,1331,shaman,restoration,30,14,16
35172,Jazzlightnin,tichondrius,1331,shaman,restoration,36,14,22
35173,Elementgodx,skullcrusher,1330,shaman,restoration,48,23,25
35174,Tampíco,ragnaros,1330,shaman,restoration,36,14,22
35175,Angron,barthilas,1328,shaman,restoration,34,21,13
35176,Huroth,proudmoore,1328,shaman,restoration,42,14,28
35177,Targhal,tichondrius,1326,shaman,restoration,29,15,14
35178,Barbosina,stormrage,1326,shaman,restoration,226,116,110
35179,Azhen,ragnaros,1326,shaman,restoration,138,69,69
35180,Tchaishammy,tichondrius,1326,shaman,restoration,29,14,15
35181,Meatballer,queldorei,1325,shaman,restoration,77,42,35
35182,Ginkuma,illidan,1325,shaman,restoration,30,14,16
35183,Afgoox,tichondrius,1324,shaman,restoration,84,47,37
35184,Zuljiba,illidan,1322,shaman,restoration,60,35,25
35185,Restosud,crushridge,1320,shaman,restoration,30,18,12
35186,Infsham,hyjal,1320,shaman,restoration,60,27,33
35187,Kisimi,proudmoore,1319,shaman,restoration,30,18,12
35188,Cleanfossil,stormrage,1319,shaman,restoration,41,24,17
35189,Eekumbokum,bleeding-hollow,1318,shaman,restoration,50,29,21
35190,Bearlysober,draka,1318,shaman,restoration,56,30,26
35191,Boggins,dalaran,1318,shaman,restoration,52,25,27
35192,Clutchinbuds,malganis,1318,shaman,restoration,54,24,30
35193,Badião,azralon,1318,shaman,restoration,131,58,73
35194,Latosos,dalaran,1317,shaman,restoration,36,15,21
35195,Yamazakì,nemesis,1317,shaman,restoration,36,14,22
35196,Macdab,malganis,1316,shaman,restoration,30,15,15
35197,Bluebones,frostmane,1314,shaman,restoration,24,14,10
35198,Phtalid,dalaran,1314,shaman,restoration,82,42,40
35199,Crazytotems,dalaran,1312,shaman,restoration,114,58,56
35200,Elementorx,stormrage,1311,shaman,restoration,36,14,22
35201,Ithappens,senjin,1310,shaman,restoration,30,16,14
35202,Orlá,moon-guard,1310,shaman,restoration,54,18,36
35203,Hefestos,nemesis,1309,shaman,restoration,30,14,16
35204,Absorblife,barthilas,1309,shaman,restoration,69,31,38
35205,Aelwydx,quelthalas,1307,shaman,restoration,239,124,115
35206,Youneverknow,frostmourne,1307,shaman,restoration,161,81,80
35207,Sparks,ragnaros,1306,shaman,restoration,89,41,48
35208,Toteapole,malganis,1305,shaman,restoration,94,51,43
35209,Torgah,tichondrius,1305,shaman,restoration,90,44,46
35210,Fíxer,tichondrius,1304,shaman,restoration,85,44,41
35211,Genjuu,proudmoore,1304,shaman,restoration,42,20,22
35212,Leca,tichondrius,1304,shaman,restoration,84,36,48
35213,Truemooin,wyrmrest-accord,1303,shaman,restoration,303,154,149
35214,Wunderwaffe,the-underbog,1303,shaman,restoration,46,22,24
35215,Hüsky,dalaran,1303,shaman,restoration,42,14,28
35216,Tumble,barthilas,1302,shaman,restoration,52,26,26
35217,Solaraa,proudmoore,1301,shaman,restoration,46,22,24
35218,Badgeshock,area-52,1301,shaman,restoration,108,48,60
35219,Cæl,azralon,1300,shaman,restoration,35,20,15
35220,Tacho,bleeding-hollow,1300,shaman,restoration,96,48,48
35221,Tedmosbe,tichondrius,1300,shaman,restoration,84,37,47
35222,Yarockheal,malganis,1298,shaman,restoration,54,27,27
35223,Joocer,emerald-dream,1297,shaman,restoration,72,35,37
35224,Bigtoy,frostmane,1296,shaman,restoration,42,14,28
35225,Uhd,malganis,1294,shaman,restoration,38,17,21
35226,Defnotheals,kelthuzad,1293,shaman,restoration,90,42,48
35227,Thunderborn,laughing-skull,1292,shaman,restoration,30,14,16
35228,Slaggdaddy,durotan,1292,shaman,restoration,30,14,16
35229,Murata,tichondrius,1291,shaman,restoration,30,16,14
35230,Aceshamm,kelthuzad,1289,shaman,restoration,60,30,30
35231,Graveman,illidan,1289,shaman,restoration,75,37,38
35232,Mengemort,crushridge,1288,shaman,restoration,35,19,16
35233,Aviator,muradin,1288,shaman,restoration,36,19,17
35234,Belgrom,tichondrius,1287,shaman,restoration,42,23,19
35235,Drazic,area-52,1286,shaman,restoration,49,28,21
35236,Pushaheal,tichondrius,1285,shaman,restoration,48,27,21
35237,Mynigabob,zuljin,1285,shaman,restoration,148,83,65
35238,Shamorrhoids,frostmourne,1285,shaman,restoration,137,70,67
35239,Nezzuk,quelthalas,1285,shaman,restoration,96,42,54
35240,Ketaminedrip,illidan,1284,shaman,restoration,42,22,20
35241,Stargun,korgath,1284,shaman,restoration,147,76,71
35242,Feldstar,stormrage,1284,shaman,restoration,103,47,56
35243,Sukthistotem,kelthuzad,1282,shaman,restoration,24,16,8
35244,Alraxion,ragnaros,1281,shaman,restoration,84,41,43
35245,Ulala,azshara,1280,shaman,restoration,72,31,41
35246,Hasselshock,area-52,1280,shaman,restoration,94,40,54
35247,Aemi,tichondrius,1279,shaman,restoration,102,45,57
35248,Mudeng,tichondrius,1276,shaman,restoration,60,30,30
35249,Klaital,boulderfist,1274,shaman,restoration,30,21,9
35250,Trúnks,magtheridon,1273,shaman,restoration,102,48,54
35251,Retgarr,tichondrius,1272,shaman,restoration,30,17,13
35252,Foodlust,sargeras,1272,shaman,restoration,108,57,51
35253,Sharmut,bleeding-hollow,1272,shaman,restoration,130,67,63
35254,Tákhisis,darkspear,1271,shaman,restoration,72,33,39
35255,Angelicrain,stormrage,1269,shaman,restoration,30,16,14
35256,Derkx,thrall,1268,shaman,restoration,30,22,8
35257,Thomastides,tichondrius,1268,shaman,restoration,78,36,42
35258,Killdeaderer,barthilas,1266,shaman,restoration,136,79,57
35259,Tundertotem,tichondrius,1266,shaman,restoration,74,42,32
35260,Shiestys,tichondrius,1264,shaman,restoration,33,23,10
35261,Shohzegky,azralon,1264,shaman,restoration,91,40,51
35262,Êdge,quelthalas,1263,shaman,restoration,57,28,29
35263,Lüca,wyrmrest-accord,1261,shaman,restoration,333,177,156
35264,Kunio,proudmoore,1261,shaman,restoration,42,22,20
35265,Menah,moon-guard,1260,shaman,restoration,36,20,16
35266,Hauby,zuljin,1259,shaman,restoration,48,15,33
35267,Sindury,tichondrius,1257,shaman,restoration,66,35,31
35268,Woodrose,frostmourne,1257,shaman,restoration,52,24,28
35269,Jru,tichondrius,1257,shaman,restoration,31,14,17
35270,Massif,emerald-dream,1256,shaman,restoration,31,14,17
35271,Ragerax,trollbane,1254,shaman,restoration,23,16,7
35272,Ironcaulk,kelthuzad,1252,shaman,restoration,54,26,28
35273,Luto,tichondrius,1251,shaman,restoration,130,71,59
35274,Freyttreyn,garrosh,1251,shaman,restoration,54,29,25
35275,Blodbar,kiljaeden,1249,shaman,restoration,36,24,12
35276,Peppito,illidan,1249,shaman,restoration,45,27,18
35277,Watchmytrem,ragnaros,1249,shaman,restoration,60,20,40
35278,Evilabev,bonechewer,1248,shaman,restoration,24,13,11
35279,Toroph,azralon,1248,shaman,restoration,30,16,14
35280,Bigwave,zuluhed,1248,shaman,restoration,30,15,15
35281,Tôôz,stormrage,1247,shaman,restoration,18,13,5
35282,Hiermy,tichondrius,1247,shaman,restoration,24,13,11
35283,Moorgl,tichondrius,1246,shaman,restoration,24,13,11
35284,Momolagbbit,tichondrius,1246,shaman,restoration,24,13,11
35285,Cónò,tichondrius,1246,shaman,restoration,84,39,45
35286,Tays,tichondrius,1245,shaman,restoration,18,13,5
35287,Tayictwo,tichondrius,1244,shaman,restoration,24,13,11
35288,Nyf,khazgoroth,1243,shaman,restoration,24,13,11
35289,Shoxx,wyrmrest-accord,1243,shaman,restoration,24,13,11
35290,Jsoto,ghostlands,1243,shaman,restoration,30,13,17
35291,Zetli,tichondrius,1243,shaman,restoration,54,19,35
35292,Darkn,cenarion-circle,1242,shaman,restoration,36,18,18
35293,Óompaloompa,frostmourne,1242,shaman,restoration,30,13,17
35294,Chenguanxi,tichondrius,1240,shaman,restoration,18,13,5
35295,Harbert,black-dragonflight,1240,shaman,restoration,36,17,19
35296,Keekballx,tichondrius,1240,shaman,restoration,30,13,17
35297,Nomediocur,moknathal,1240,shaman,restoration,61,24,37
35298,Jnzz,area-52,1239,shaman,restoration,24,13,11
35299,Shamfold,illidan,1239,shaman,restoration,24,13,11
35300,Jaandar,saurfang,1239,shaman,restoration,98,48,50
35301,Battleobobby,medivh,1239,shaman,restoration,41,13,28
35302,Furiousnick,stormrage,1238,shaman,restoration,24,13,11
35303,Beefstocks,area-52,1238,shaman,restoration,66,32,34
35304,Mixxt,illidan,1238,shaman,restoration,30,13,17
35305,Entropey,daggerspine,1238,shaman,restoration,65,28,37
35306,Lastdwarf,tichondrius,1237,shaman,restoration,18,13,5
35307,Milkmeforhp,frostmourne,1237,shaman,restoration,69,36,33
35308,Quequin,quelthalas,1237,shaman,restoration,30,14,16
35309,Shamakazi,tichondrius,1237,shaman,restoration,31,14,17
35310,Sleepysham,kelthuzad,1237,shaman,restoration,36,13,23
35311,Deathwards,frostmane,1236,shaman,restoration,36,13,23
35312,Elex,frostmourne,1236,shaman,restoration,45,16,29
35313,Chingobling,illidan,1234,shaman,restoration,24,13,11
35314,Krolii,tichondrius,1234,shaman,restoration,80,33,47
35315,Shimansham,aegwynn,1233,shaman,restoration,167,79,88
35316,Shamicare,stormrage,1232,shaman,restoration,136,75,61
35317,Kinjin,dragonmaw,1232,shaman,restoration,30,13,17
35318,Quakess,zuljin,1232,shaman,restoration,36,13,23
35319,Fênrisulfer,area-52,1231,shaman,restoration,89,37,52
35320,Kikkóman,malganis,1230,shaman,restoration,48,25,23
35321,Edemental,area-52,1229,shaman,restoration,129,61,68
35322,Lhost,tanaris,1228,shaman,restoration,30,17,13
35323,Krishshammy,azshara,1228,shaman,restoration,148,72,76
35324,Dogood,tichondrius,1228,shaman,restoration,36,13,23
35325,Terdsammich,malganis,1227,shaman,restoration,51,27,24
35326,Ozzai,ragnaros,1225,shaman,restoration,42,15,27
35327,Ogtrippleog,blackwing-lair,1224,shaman,restoration,30,13,17
35328,Mishalla,tichondrius,1224,shaman,restoration,72,27,45
35329,Ndz,anubarak,1220,shaman,restoration,48,24,24
35330,Hammerme,barthilas,1220,shaman,restoration,107,40,67
35331,Hoong,garrosh,1219,shaman,restoration,32,17,15
35332,Thizzasta,blackhand,1219,shaman,restoration,40,18,22
35333,Donmills,tichondrius,1218,shaman,restoration,54,23,31
35334,Lavablurst,stormrage,1218,shaman,restoration,59,23,36
35335,Exportgold,barthilas,1218,shaman,restoration,42,16,26
35336,Vajoku,proudmoore,1217,shaman,restoration,37,17,20
35337,Babytiramisu,stormrage,1217,shaman,restoration,36,16,20
35338,Desgarcon,zuljin,1216,shaman,restoration,47,23,24
35339,Ekuku,tichondrius,1215,shaman,restoration,40,19,21
35340,Smashtheface,nagrand,1211,shaman,restoration,54,27,27
35341,Klausnomi,jaedenar,1211,shaman,restoration,30,13,17
35342,Dabmarinø,tichondrius,1209,shaman,restoration,30,18,12
35343,Certz,dark-iron,1209,shaman,restoration,39,15,24
35344,Voodoototems,frostmourne,1207,shaman,restoration,51,25,26
35345,Kinshaman,lightnings-blade,1206,shaman,restoration,73,33,40
35346,Paratroop,bonechewer,1206,shaman,restoration,63,27,36
35347,Patoron,proudmoore,1204,shaman,restoration,34,17,17
35348,Bluffin,stormrage,1200,shaman,restoration,18,14,4
35349,Magnethor,frostmourne,1200,shaman,restoration,42,24,18
35350,Thräll,shuhalo,1200,shaman,restoration,202,103,99
35351,Redbulls,azralon,1198,shaman,restoration,96,54,42
35352,Cruelface,sargeras,1196,shaman,restoration,26,14,12
35353,Synkrona,tichondrius,1191,shaman,restoration,38,16,22
35354,Furti,daggerspine,1190,shaman,restoration,34,16,18
35355,Babibolo,duskwood,1187,shaman,restoration,24,13,11
35356,Brislin,sargeras,1185,shaman,restoration,151,71,80
35357,Lokhtar,zuljin,1184,shaman,restoration,36,17,19
35358,Getwetand,quelthalas,1182,shaman,restoration,103,51,52
35359,Stabix,tichondrius,1181,shaman,restoration,66,31,35
35360,Rimmington,frostmourne,1179,shaman,restoration,54,24,30
35361,Dcãicer,quelthalas,1178,shaman,restoration,25,15,10
35362,Rajin,sentinels,1178,shaman,restoration,36,18,18
35363,Churgarm,zuljin,1177,shaman,restoration,30,18,12
35364,Mandinga,warsong,1177,shaman,restoration,71,33,38
35365,Pedren,thrall,1176,shaman,restoration,21,14,7
35366,Flametide,proudmoore,1176,shaman,restoration,35,20,15
35367,Vanty,proudmoore,1170,shaman,restoration,29,13,16
35368,Shammimane,tichondrius,1169,shaman,restoration,107,53,54
35369,Hedbang,kiljaeden,1169,shaman,restoration,60,24,36
35370,Wazöö,sargeras,1168,shaman,restoration,63,28,35
35371,Oomshamm,area-52,1167,shaman,restoration,130,68,62
35372,Shazikial,illidan,1167,shaman,restoration,38,18,20
35373,Delíta,quelthalas,1167,shaman,restoration,36,13,23
35374,Shaokhang,emerald-dream,1167,shaman,restoration,64,23,41
35375,Restoramen,frostmourne,1166,shaman,restoration,24,13,11
35376,Senzxlolxz,lightbringer,1165,shaman,restoration,45,29,16
35377,Onpoint,frostmourne,1165,shaman,restoration,23,13,10
35378,Grakkah,thrall,1162,shaman,restoration,30,13,17
35379,Stahlman,blackhand,1160,shaman,restoration,48,17,31
35380,Turblix,tichondrius,1155,shaman,restoration,34,21,13
35381,Balsonz,zuljin,1155,shaman,restoration,25,13,12
35382,Drboidzerg,tichondrius,1154,shaman,restoration,32,20,12
35383,Yamishka,dalaran,1154,shaman,restoration,42,15,27
35384,Dahmerjr,area-52,1153,shaman,restoration,78,43,35
35385,Twinkolava,nemesis,1152,shaman,restoration,25,14,11
35386,Dbmx,tichondrius,1152,shaman,restoration,24,12,12
35387,Badjojò,ragnaros,1152,shaman,restoration,24,12,12
35388,Rawdòggin,emerald-dream,1152,shaman,restoration,33,13,20
35389,Owtyobwol,area-52,1151,shaman,restoration,18,12,6
35390,Booramz,tichondrius,1151,shaman,restoration,18,12,6
35391,Ruupaul,kiljaeden,1151,shaman,restoration,18,12,6
35392,Lignipzyo,doomhammer,1151,shaman,restoration,24,12,12
35393,Hoatboiz,magtheridon,1151,shaman,restoration,54,14,40
35394,Gödöfbüdå,tichondrius,1150,shaman,restoration,18,12,6
35395,Uglybastrd,stormrage,1150,shaman,restoration,24,12,12
35396,Ixis,bleeding-hollow,1149,shaman,restoration,18,12,6
35397,Noolube,barthilas,1148,shaman,restoration,24,12,12
35398,Qitian,tichondrius,1148,shaman,restoration,24,12,12
35399,Jineluki,emerald-dream,1148,shaman,restoration,53,23,30
35400,Xiaoxiboy,tichondrius,1147,shaman,restoration,24,12,12
35401,Ricn,tichondrius,1147,shaman,restoration,24,12,12
35402,Tesle,illidan,1147,shaman,restoration,30,12,18
35403,Branasou,emerald-dream,1147,shaman,restoration,30,12,18
35404,Bitruff,tichondrius,1146,shaman,restoration,24,12,12
35405,Yeeraldyn,quelthalas,1146,shaman,restoration,30,12,18
35406,Nobiggy,tichondrius,1146,shaman,restoration,30,12,18
35407,Orcstain,moknathal,1146,shaman,restoration,94,30,64
35408,Boltadeez,tichondrius,1144,shaman,restoration,24,12,12
35409,Lleonardo,tichondrius,1140,shaman,restoration,24,12,12
35410,Laterallus,nagrand,1138,shaman,restoration,85,43,42
35411,Peanutto,illidan,1136,shaman,restoration,125,67,58
35412,Smooths,bloodscalp,1131,shaman,restoration,30,16,14
35413,Meanbetty,illidan,1131,shaman,restoration,24,12,12
35414,Lechaman,hakkar,1131,shaman,restoration,66,22,44
35415,Cameltotêm,frostmourne,1130,shaman,restoration,30,17,13
35416,Darrann,kiljaeden,1126,shaman,restoration,18,12,6
35417,Dinaliia,lothar,1126,shaman,restoration,36,16,20
35418,Käck,tichondrius,1122,shaman,restoration,62,28,34
35419,Sephyros,ragnaros,1121,shaman,restoration,24,12,12
35420,Bóòchainz,tichondrius,1120,shaman,restoration,22,13,9
35421,Rocksteddy,area-52,1120,shaman,restoration,24,12,12
35422,Twoflower,frostmourne,1120,shaman,restoration,136,63,73
35423,Saxaboom,tichondrius,1115,shaman,restoration,30,12,18
35424,Etherys,frostmourne,1114,shaman,restoration,36,21,15
35425,Tartar,lightbringer,1112,shaman,restoration,29,18,11
35426,Zhyrouvstorm,stormrage,1110,shaman,restoration,42,20,22
35427,Taò,tichondrius,1109,shaman,restoration,84,38,46
35428,Saicey,zuljin,1107,shaman,restoration,72,35,37
35429,Shammyguy,stormreaver,1103,shaman,restoration,50,23,27
35430,Ttass,dalaran,1102,shaman,restoration,35,13,22
35431,Totemist,tichondrius,1100,shaman,restoration,36,12,24
35432,Qüickeze,khazgoroth,1097,shaman,restoration,22,15,7
35433,Chablez,shattered-hand,1096,shaman,restoration,30,13,17
35434,Stormburst,sargeras,1092,shaman,restoration,42,20,22
35435,Tremór,frostmourne,1091,shaman,restoration,24,14,10
35436,Phira,tichondrius,1090,shaman,restoration,54,27,27
35437,Gsync,tichondrius,1089,shaman,restoration,47,28,19
35438,Taquitho,quelthalas,1088,shaman,restoration,75,32,43
35439,Mikeisbadwow,tichondrius,1086,shaman,restoration,16,12,4
35440,Grimmzhul,daggerspine,1077,shaman,restoration,90,43,47
35441,Delayy,destromath,1075,shaman,restoration,77,32,45
35442,Turbluscious,frostmourne,1074,shaman,restoration,49,26,23
35443,Elharm,ragnaros,1072,shaman,restoration,36,13,23
35444,Belínski,azralon,1070,shaman,restoration,30,16,14
35445,Narikó,aggramar,1069,shaman,restoration,94,53,41
35446,Hazorele,nagrand,1069,shaman,restoration,48,23,25
35447,Maserati,korialstrasz,1067,shaman,restoration,58,24,34
35448,Grullander,hakkar,1063,shaman,restoration,36,20,16
35449,Eleshortal,azuremyst,1062,shaman,restoration,39,16,23
35450,Sekkuo,kiljaeden,1061,shaman,restoration,60,28,32
35451,Littledream,quelthalas,1061,shaman,restoration,58,26,32
35452,Nickwoper,emerald-dream,1056,shaman,restoration,18,11,7
35453,Lfgzookeeper,malganis,1056,shaman,restoration,18,11,7
35454,Fàlc,stormrage,1056,shaman,restoration,18,11,7
35455,Biofly,thrall,1056,shaman,restoration,18,11,7
35456,Handzum,blades-edge,1056,shaman,restoration,18,11,7
35457,Brocules,aerie-peak,1056,shaman,restoration,24,11,13
35458,Censyzz,tichondrius,1056,shaman,restoration,24,11,13
35459,Wegoagain,tichondrius,1056,shaman,restoration,24,11,13
35460,Jukedlawl,illidan,1056,shaman,restoration,30,11,19
35461,Specifyz,arathor,1055,shaman,restoration,18,11,7
35462,Localxhero,stormrage,1055,shaman,restoration,24,11,13
35463,Pericazo,sargeras,1055,shaman,restoration,24,11,13
35464,Jtrxs,tichondrius,1055,shaman,restoration,24,11,13
35465,Haard,area-52,1055,shaman,restoration,24,11,13
35466,Sweetpotatoe,malganis,1055,shaman,restoration,24,11,13
35467,Fluiid,tichondrius,1055,shaman,restoration,24,11,13
35468,Mindgooblin,sargeras,1055,shaman,restoration,36,11,25
35469,Sipo,tichondrius,1054,shaman,restoration,18,11,7
35470,Ituma,tichondrius,1054,shaman,restoration,18,11,7
35471,Earthfirex,ragnaros,1054,shaman,restoration,18,11,7
35472,Keybordternr,tichondrius,1054,shaman,restoration,24,11,13
35473,Vixeen,kelthuzad,1054,shaman,restoration,24,11,13
35474,Nosekandyz,chogall,1054,shaman,restoration,24,11,13
35475,Gorillox,chogall,1054,shaman,restoration,24,11,13
35476,Elmonkeyloco,bleeding-hollow,1053,shaman,restoration,18,11,7
35477,Murm,burning-blade,1053,shaman,restoration,24,11,13
35478,Velesa,kiljaeden,1052,shaman,restoration,30,11,19
35479,Urin,emerald-dream,1051,shaman,restoration,21,11,10
35480,Tamzlol,the-forgotten-coast,1051,shaman,restoration,24,11,13
35481,Glark,tichondrius,1051,shaman,restoration,24,11,13
35482,Choochette,illidan,1051,shaman,restoration,30,11,19
35483,Exussh,tichondrius,1050,shaman,restoration,12,11,1
35484,Dragum,blackrock,1050,shaman,restoration,30,11,19
35485,Paradigm,sargeras,1049,shaman,restoration,18,11,7
35486,Groundded,tichondrius,1049,shaman,restoration,29,11,18
35487,Galeswind,sargeras,1048,shaman,restoration,24,11,13
35488,Ryuukas,illidan,1047,shaman,restoration,18,11,7
35489,Mcstop,tanaris,1046,shaman,restoration,36,15,21
35490,Zoodoo,nagrand,1046,shaman,restoration,48,16,32
35491,Tràuma,caelestrasz,1045,shaman,restoration,45,13,32
35492,Leogi,daggerspine,1044,shaman,restoration,27,11,16
35493,Gl,nordrassil,1043,shaman,restoration,18,11,7
35494,Fio,nerzhul,1043,shaman,restoration,194,92,102
35495,Saraguthix,dalaran,1043,shaman,restoration,30,11,19
35496,Mvpstorm,darkspear,1041,shaman,restoration,24,11,13
35497,Pootergash,shadowmoon,1041,shaman,restoration,24,11,13
35498,Zugzugthug,moon-guard,1040,shaman,restoration,84,33,51
35499,Plop,tichondrius,1024,shaman,restoration,16,12,4
35500,Anttoekneeoh,thrall,1024,shaman,restoration,24,12,12
35501,Blaiserpub,tichondrius,1023,shaman,restoration,23,11,12
35502,Mastrionilol,stormrage,1023,shaman,restoration,34,11,23
35503,Slëvin,frostmourne,1023,shaman,restoration,42,13,29
35504,Frizzie,barthilas,1023,shaman,restoration,71,14,57
35505,Kulgur,ravenholdt,1022,shaman,restoration,24,16,8
35506,Jìmmybuckets,tichondrius,1022,shaman,restoration,17,11,6
35507,Dextex,azralon,1022,shaman,restoration,47,26,21
35508,Lavatotem,stormrage,1021,shaman,restoration,41,20,21
35509,Zonsham,drakkari,1017,shaman,restoration,24,11,13
35510,Castte,ragnaros,1013,shaman,restoration,54,24,30
35511,Nupi,thaurissan,1013,shaman,restoration,59,26,33
35512,Lazi,frostmourne,1008,shaman,restoration,27,12,15
35513,Volsdeep,illidan,1007,shaman,restoration,21,11,10
35514,Centalinkxox,frostmourne,1006,shaman,restoration,27,11,16
35515,Illeh,illidan,1005,shaman,restoration,42,19,23
35516,Speedranger,stormrage,1004,shaman,restoration,42,15,27
35517,Hoghlinn,stormrage,1003,shaman,restoration,14,12,2
35518,Baygone,tichondrius,1002,shaman,restoration,24,11,13
35519,Shamankie,tichondrius,999,shaman,restoration,40,13,27
35520,Hentaistorm,kiljaeden,998,shaman,restoration,80,41,39
35521,Woof,agamaggan,994,shaman,restoration,41,12,29
35522,Wâgu,moon-guard,992,shaman,restoration,28,11,17
35523,Kencyzz,tichondrius,991,shaman,restoration,17,11,6
35524,Vogaz,ragnaros,991,shaman,restoration,28,11,17
35525,Nottrhall,azralon,990,shaman,restoration,14,11,3
35526,Teardrinker,korgath,988,shaman,restoration,30,11,19
35527,Faegle,area-52,984,shaman,restoration,24,11,13
35528,Doomgodx,tichondrius,983,shaman,restoration,36,16,20
35529,Banterx,emerald-dream,979,shaman,restoration,35,12,23
35530,Superchunk,shattered-hand,977,shaman,restoration,108,56,52
35531,Andrastia,thrall,976,shaman,restoration,24,15,9
35532,Shamadran,hyjal,971,shaman,restoration,23,11,12
35533,Njjshamm,thrall,969,shaman,restoration,36,16,20
35534,Tharapita,bleeding-hollow,968,shaman,restoration,33,12,21
35535,Robis,thrall,966,shaman,restoration,125,61,64
35536,Sagester,illidan,960,shaman,restoration,16,11,5
35537,Dadbar,tichondrius,960,shaman,restoration,18,10,8
35538,Burstekka,tichondrius,960,shaman,restoration,18,10,8
35539,Hst,barthilas,960,shaman,restoration,18,10,8
35540,Paperbot,barthilas,960,shaman,restoration,18,10,8
35541,Yunotho,sargeras,960,shaman,restoration,18,10,8
35542,Naisayyds,tichondrius,960,shaman,restoration,18,10,8
35543,Freerath,tichondrius,960,shaman,restoration,22,10,12
35544,Nisthesham,tichondrius,960,shaman,restoration,24,10,14
35545,Enhancex,frostwolf,960,shaman,restoration,24,10,14
35546,Terrasham,barthilas,960,shaman,restoration,29,10,19
35547,Farfar,tichondrius,959,shaman,restoration,12,10,2
35548,Service,llane,959,shaman,restoration,18,10,8
35549,Lodekimm,tichondrius,959,shaman,restoration,18,10,8
35550,Esoterikk,malganis,959,shaman,restoration,18,10,8
35551,Zensarg,tichondrius,959,shaman,restoration,18,10,8
35552,Valcn,moon-guard,959,shaman,restoration,24,10,14
35553,Eccentrix,mannoroth,959,shaman,restoration,24,10,14
35554,Matzuga,bleeding-hollow,959,shaman,restoration,24,10,14
35555,Forcè,bleeding-hollow,959,shaman,restoration,24,10,14
35556,Jisthexx,senjin,959,shaman,restoration,24,10,14
35557,Cosmô,sargeras,959,shaman,restoration,30,10,20
35558,Ggoong,tichondrius,959,shaman,restoration,36,10,26
35559,Vinceshamwow,lightbringer,958,shaman,restoration,12,10,2
35560,Shyva,frostmourne,958,shaman,restoration,18,10,8
35561,Zechary,proudmoore,958,shaman,restoration,18,10,8
35562,Kacham,nerzhul,958,shaman,restoration,18,10,8
35563,Thundershade,deathwing,958,shaman,restoration,24,10,14
35564,Lawlsham,korgath,957,shaman,restoration,12,10,2
35565,Humpvack,tichondrius,957,shaman,restoration,18,10,8
35566,Athayis,malorne,957,shaman,restoration,59,31,28
35567,Maakasarg,tichondrius,956,shaman,restoration,24,10,14
35568,Karaaka,ysera,956,shaman,restoration,30,10,20
35569,Cameltótém,sargeras,955,shaman,restoration,18,10,8
35570,Oohkillemm,silvermoon,955,shaman,restoration,18,10,8
35571,Shammystic,quelthalas,955,shaman,restoration,54,19,35
35572,Johnnyblue,frostmourne,954,shaman,restoration,30,10,20
35573,Mythshaman,tichondrius,953,shaman,restoration,30,10,20
35574,Raininwishes,aegwynn,952,shaman,restoration,18,10,8
35575,Tequíla,quelthalas,952,shaman,restoration,18,10,8
35576,Mikeyodinson,area-52,952,shaman,restoration,24,10,14
35577,Uhfishuhl,bleeding-hollow,951,shaman,restoration,18,10,8
35578,Bruhh,stormscale,951,shaman,restoration,18,10,8
35579,Soulmiracle,tichondrius,951,shaman,restoration,24,10,14
35580,Romcomx,tichondrius,951,shaman,restoration,24,10,14
35581,Overcåst,barthilas,951,shaman,restoration,36,10,26
35582,Problamatic,tichondrius,949,shaman,restoration,24,10,14
35583,Tabby,emerald-dream,948,shaman,restoration,24,10,14
35584,Daxetan,area-52,947,shaman,restoration,18,10,8
35585,Recyclicrab,skullcrusher,945,shaman,restoration,12,10,2
35586,Skippe,hyjal,943,shaman,restoration,18,10,8
35587,Alphamael,lightbringer,941,shaman,restoration,31,10,21
35588,Hatethetotem,bleeding-hollow,937,shaman,restoration,26,11,15
35589,Boppshock,tichondrius,928,shaman,restoration,16,11,5
35590,Mikeoxxgigg,kelthuzad,927,shaman,restoration,51,28,23
35591,Haether,madoran,926,shaman,restoration,101,50,51
35592,Colberton,dalaran,926,shaman,restoration,23,10,13
35593,Rastablaze,darkspear,926,shaman,restoration,70,27,43
35594,Artsha,tol-barad,925,shaman,restoration,18,11,7
35595,Psilocypher,nazjatar,923,shaman,restoration,18,11,7
35596,Mikeyshockus,hydraxis,922,shaman,restoration,47,19,28
35597,Klev,frostmourne,921,shaman,restoration,33,12,21
35598,Jorko,dathremar,918,shaman,restoration,26,16,10
35599,Malløry,mugthol,917,shaman,restoration,30,12,18
35600,Flexexpress,stormrage,911,shaman,restoration,17,10,7
35601,Privxd,bleeding-hollow,910,shaman,restoration,17,10,7
35602,Mainstreamx,sargeras,908,shaman,restoration,33,10,23
35603,Bitflip,jubeithos,907,shaman,restoration,21,10,11
35604,Jessestevens,kiljaeden,905,shaman,restoration,17,10,7
35605,Alestorm,nemesis,899,shaman,restoration,28,12,16
35606,Booz,caelestrasz,895,shaman,restoration,30,10,20
35607,Imperiumrum,azuremyst,887,shaman,restoration,77,41,36
35608,Jenniferlynn,tichondrius,886,shaman,restoration,48,15,33
35609,Swifteyy,area-52,883,shaman,restoration,22,10,12
35610,Astàròth,malganis,880,shaman,restoration,13,10,3
35611,Washedupty,illidan,864,shaman,restoration,12,9,3
35612,Luckalicious,proudmoore,864,shaman,restoration,12,9,3
35613,Èmaxx,barthilas,864,shaman,restoration,12,9,3
35614,Bakenquake,tichondrius,864,shaman,restoration,12,9,3
35615,ßonevoyage,malganis,864,shaman,restoration,12,9,3
35616,Seiunsky,area-52,864,shaman,restoration,12,9,3
35617,Iadyboi,kiljaeden,864,shaman,restoration,12,9,3
35618,Medullarum,suramar,864,shaman,restoration,18,9,9
35619,Jhakrï,tichondrius,864,shaman,restoration,18,9,9
35620,Flatt,uther,864,shaman,restoration,18,9,9
35621,Spampurge,emerald-dream,864,shaman,restoration,18,9,9
35622,Kirschblute,proudmoore,864,shaman,restoration,18,9,9
35623,Hexcalibur,laughing-skull,864,shaman,restoration,18,9,9
35624,Awyiss,dreadmaul,864,shaman,restoration,18,9,9
35625,Neviahz,illidan,864,shaman,restoration,18,9,9
35626,Wildmaster,ragnaros,864,shaman,restoration,30,9,21
35627,Deosculation,tichondrius,863,shaman,restoration,12,9,3
35628,Køre,tichondrius,863,shaman,restoration,12,9,3
35629,Jaegertotem,stormrage,863,shaman,restoration,12,9,3
35630,Kzxs,illidan,863,shaman,restoration,12,9,3
35631,Darcheros,quelthalas,863,shaman,restoration,18,9,9
35632,Snoff,burning-blade,863,shaman,restoration,18,9,9
35633,Murica,area-52,863,shaman,restoration,18,9,9
35634,Hoofpics,dalaran,863,shaman,restoration,18,9,9
35635,Bakayarøu,tichondrius,863,shaman,restoration,18,9,9
35636,Multran,stormscale,863,shaman,restoration,18,9,9
35637,Mastrionilol,dragonmaw,863,shaman,restoration,24,9,15
35638,Udungoofedd,the-underbog,862,shaman,restoration,12,9,3
35639,Turtleinmud,frostmourne,862,shaman,restoration,18,9,9
35640,Drünk,hyjal,862,shaman,restoration,18,9,9
35641,Obrahma,burning-legion,862,shaman,restoration,18,9,9
35642,Dùffman,jubeithos,862,shaman,restoration,22,10,12
35643,Adventstrike,tichondrius,862,shaman,restoration,24,9,15
35644,Soppin,bleeding-hollow,861,shaman,restoration,18,9,9
35645,Milkstress,whisperwind,861,shaman,restoration,24,9,15
35646,Esanim,tichondrius,860,shaman,restoration,18,9,9
35647,Bacnbitz,hellscream,860,shaman,restoration,24,9,15
35648,Wagesisdeath,illidan,859,shaman,restoration,24,9,15
35649,Aargonos,tichondrius,858,shaman,restoration,12,9,3
35650,Ironfart,destromath,858,shaman,restoration,18,9,9
35651,Shockburst,dalaran,858,shaman,restoration,18,9,9
35652,Blois,thunderlord,857,shaman,restoration,18,9,9
35653,Chungie,laughing-skull,855,shaman,restoration,18,9,9
35654,Yakella,trollbane,854,shaman,restoration,12,9,3
35655,Siksika,bloodscalp,854,shaman,restoration,94,43,51
35656,Mtnju,eredar,852,shaman,restoration,18,9,9
35657,Çatastrophe,dalaran,849,shaman,restoration,18,9,9
35658,Ayahuassca,illidan,847,shaman,restoration,44,19,25
35659,Scrototëm,azralon,833,shaman,restoration,24,9,15
35660,Deadlyshocks,gilneas,827,shaman,restoration,35,17,18
35661,Sittingwolf,stormreaver,825,shaman,restoration,17,9,8
35662,Aimiréal,nagrand,823,shaman,restoration,18,9,9
35663,Insidetrader,illidan,815,shaman,restoration,15,10,5
35664,Maloran,zuljin,815,shaman,restoration,23,9,14
35665,Htsu,quelthalas,809,shaman,restoration,22,10,12
35666,Shamjam,moon-guard,768,shaman,restoration,12,8,4
35667,Stormlashx,sargeras,768,shaman,restoration,12,8,4
35668,Xbk,tichondrius,768,shaman,restoration,12,8,4
35669,Hexistential,tichondrius,768,shaman,restoration,12,8,4
35670,Plznostepmom,tichondrius,768,shaman,restoration,12,8,4
35671,Touchmytotmm,tichondrius,768,shaman,restoration,12,8,4
35672,Longlivecrit,exodar,768,shaman,restoration,12,8,4
35673,Hoonjojjyans,tichondrius,768,shaman,restoration,12,8,4
35674,Ophitotem,zuljin,768,shaman,restoration,12,8,4
35675,Shxl,zuljin,768,shaman,restoration,12,8,4
35676,Lavamon,illidan,768,shaman,restoration,12,8,4
35677,Xiaoshaman,frostmourne,768,shaman,restoration,12,8,4
35678,Xiaoshaman,tichondrius,768,shaman,restoration,12,8,4
35679,Vernzi,laughing-skull,768,shaman,restoration,12,8,4
35680,Xannysnapper,zuljin,768,shaman,restoration,12,8,4
35681,Steverz,daggerspine,768,shaman,restoration,12,8,4
35682,Ggdumpy,tichondrius,768,shaman,restoration,12,8,4
35683,Kensyz,tichondrius,768,shaman,restoration,12,8,4
35684,Sgtsosix,zuljin,768,shaman,restoration,18,8,10
35685,Taronì,zuljin,768,shaman,restoration,18,8,10
35686,Songo,frostmane,768,shaman,restoration,18,8,10
35687,Kaddya,mannoroth,768,shaman,restoration,18,8,10
35688,Toastjr,frostmourne,768,shaman,restoration,18,8,10
35689,Traumateam,tichondrius,768,shaman,restoration,18,8,10
35690,Ändiroba,azralon,768,shaman,restoration,18,8,10
35691,Fyc,wyrmrest-accord,768,shaman,restoration,18,8,10
35692,Girthquake,agamaggan,768,shaman,restoration,18,8,10
35693,Kwesy,tichondrius,768,shaman,restoration,18,8,10
35694,Wolvez,tichondrius,768,shaman,restoration,18,8,10
35695,Laodo,tichondrius,768,shaman,restoration,22,9,13
35696,Earthuncle,illidan,768,shaman,restoration,24,8,16
35697,Sokta,azgalor,768,shaman,restoration,24,8,16
35698,Mymojo,tichondrius,767,shaman,restoration,12,8,4
35699,Vernacks,area-52,767,shaman,restoration,12,8,4
35700,Iarepotato,tichondrius,767,shaman,restoration,12,8,4
35701,Squirtrussel,boulderfist,767,shaman,restoration,12,8,4
35702,Maheva,ragnaros,767,shaman,restoration,12,8,4
35703,Veeve,kelthuzad,767,shaman,restoration,12,8,4
35704,Totemism,warsong,767,shaman,restoration,12,8,4
35705,Vazlah,tichondrius,767,shaman,restoration,12,8,4
35706,Klimax,tichondrius,767,shaman,restoration,12,8,4
35707,Lepoow,illidan,767,shaman,restoration,12,8,4
35708,Earthentotem,tichondrius,767,shaman,restoration,18,8,10
35709,Zombaschamy,ragnaros,767,shaman,restoration,18,8,10
35710,Zad,spinebreaker,767,shaman,restoration,18,8,10
35711,Treasonreno,area-52,767,shaman,restoration,18,8,10
35712,Nehpets,kiljaeden,767,shaman,restoration,18,8,10
35713,Volzuna,wyrmrest-accord,767,shaman,restoration,18,8,10
35714,Chrigshock,black-dragonflight,767,shaman,restoration,18,8,10
35715,Thunderfucj,tichondrius,767,shaman,restoration,24,8,16
35716,Agrîm,tichondrius,767,shaman,restoration,24,8,16
35717,Karmatide,malganis,766,shaman,restoration,12,8,4
35718,Plausibility,moon-guard,766,shaman,restoration,12,8,4
35719,Skylet,azralon,766,shaman,restoration,18,8,10
35720,Rapwnzel,tichondrius,766,shaman,restoration,18,8,10
35721,Totemlord,lightnings-blade,766,shaman,restoration,18,8,10
35722,Pickledegg,tichondrius,766,shaman,restoration,21,9,12
35723,Santral,ragnaros,766,shaman,restoration,19,8,11
35724,Nooch,malganis,766,shaman,restoration,27,9,18
35725,Magatotem,sargeras,766,shaman,restoration,24,8,16
35726,Bubbert,illidan,765,shaman,restoration,24,8,16
35727,Zqshaman,tichondrius,764,shaman,restoration,18,8,10
35728,Mochiko,frostmourne,764,shaman,restoration,18,8,10
35729,Vulcanik,quelthalas,764,shaman,restoration,24,8,16
35730,Tym,sargeras,763,shaman,restoration,18,8,10
35731,Vínnie,tichondrius,763,shaman,restoration,18,8,10
35732,Furbiddên,area-52,763,shaman,restoration,24,8,16
35733,ßøn,altar-of-storms,762,shaman,restoration,12,8,4
35734,Shamnnoodlez,area-52,762,shaman,restoration,18,8,10
35735,Cremecheese,crushridge,760,shaman,restoration,12,8,4
35736,Geoleo,stormrage,758,shaman,restoration,18,8,10
35737,Shamanlesa,azralon,757,shaman,restoration,18,8,10
35738,Kordir,kiljaeden,756,shaman,restoration,24,8,16
35739,Smolder,magtheridon,753,shaman,restoration,12,8,4
35740,Amonamarth,tichondrius,753,shaman,restoration,18,8,10
35741,Getpurged,thrall,751,shaman,restoration,17,8,9
35742,Shubba,thrall,747,shaman,restoration,12,8,4
35743,Msooli,tichondrius,745,shaman,restoration,15,10,5
35744,Kawixxi,ysondre,740,shaman,restoration,35,16,19
35745,Ryforges,frostmourne,734,shaman,restoration,14,9,5
35746,Interwebzz,tichondrius,734,shaman,restoration,66,17,49
35747,Treris,bleeding-hollow,719,shaman,restoration,11,8,3
35748,Jakjohnson,stormrage,719,shaman,restoration,15,8,7
35749,Notragii,kelthuzad,719,shaman,restoration,17,8,9
35750,Luxiaa,tichondrius,714,shaman,restoration,23,9,14
35751,Kencysz,tichondrius,714,shaman,restoration,23,9,14
35752,Kenithwest,tichondrius,703,shaman,restoration,11,8,3
35753,Xinz,guldan,703,shaman,restoration,11,8,3
35754,Purgelordx,proudmoore,703,shaman,restoration,11,8,3
35755,Wasuwant,frostmourne,703,shaman,restoration,14,8,6
35756,Garbagedump,burning-legion,703,shaman,restoration,14,8,6
35757,Kikahna,stormreaver,683,shaman,restoration,22,9,13
35758,Xueticsham,tichondrius,672,shaman,restoration,12,7,5
35759,Symbox,tichondrius,672,shaman,restoration,12,7,5
35760,Heckinpurges,area-52,672,shaman,restoration,12,7,5
35761,Elîas,tichondrius,672,shaman,restoration,12,7,5
35762,Kyma,black-dragonflight,672,shaman,restoration,12,7,5
35763,Macksimas,tichondrius,672,shaman,restoration,12,7,5
35764,Hexmix,muradin,672,shaman,restoration,12,7,5
35765,Wumx,tichondrius,672,shaman,restoration,12,7,5
35766,Dizzyswift,tichondrius,672,shaman,restoration,12,7,5
35767,Joè,bleeding-hollow,672,shaman,restoration,12,7,5
35768,Invokeesorin,area-52,672,shaman,restoration,12,7,5
35769,Paaman,proudmoore,672,shaman,restoration,12,7,5
35770,Crakmane,kelthuzad,672,shaman,restoration,12,7,5
35771,Yusbe,ragnaros,672,shaman,restoration,12,7,5
35772,Kencyi,tichondrius,672,shaman,restoration,12,7,5
35773,Viprus,nerzhul,672,shaman,restoration,12,7,5
35774,Zerwyn,senjin,672,shaman,restoration,12,7,5
35775,Envy,korialstrasz,672,shaman,restoration,12,7,5
35776,Boltekka,tichondrius,672,shaman,restoration,12,7,5
35777,Dektide,zuljin,672,shaman,restoration,12,7,5
35778,Sorgal,area-52,672,shaman,restoration,12,7,5
35779,Daxotv,sargeras,672,shaman,restoration,12,7,5
35780,Strykked,illidan,672,shaman,restoration,12,7,5
35781,Flõp,dalaran,672,shaman,restoration,12,7,5
35782,Bloodlustxo,frostmourne,672,shaman,restoration,12,7,5
35783,Iliillililli,tichondrius,672,shaman,restoration,12,7,5
35784,Gornu,nemesis,672,shaman,restoration,12,7,5
35785,Abulailah,sargeras,672,shaman,restoration,12,7,5
35786,Zrosurge,stormrage,672,shaman,restoration,14,7,7
35787,Macavell,tichondrius,672,shaman,restoration,18,7,11
35788,Hardlyfe,frostmourne,672,shaman,restoration,18,7,11
35789,Trippzs,barthilas,672,shaman,restoration,18,7,11
35790,Smeagles,ragnaros,672,shaman,restoration,18,7,11
35791,Aromental,sargeras,672,shaman,restoration,18,7,11
35792,Pjtremblay,frostmourne,672,shaman,restoration,18,7,11
35793,Morphose,tichondrius,672,shaman,restoration,18,7,11
35794,Juvîa,emerald-dream,672,shaman,restoration,18,7,11
35795,Lindsanx,illidan,672,shaman,restoration,18,7,11
35796,Weirdboi,area-52,672,shaman,restoration,18,7,11
35797,Pakdis,sargeras,671,shaman,restoration,12,7,5
35798,Thormodin,destromath,671,shaman,restoration,12,7,5
35799,Winchi,stormrage,671,shaman,restoration,12,7,5
35800,Shamiggels,sargeras,671,shaman,restoration,12,7,5
35801,Arkilios,tichondrius,671,shaman,restoration,12,7,5
35802,Lurue,tichondrius,671,shaman,restoration,12,7,5
35803,Rokvahn,illidan,671,shaman,restoration,12,7,5
35804,Chebbs,bleeding-hollow,671,shaman,restoration,12,7,5
35805,Flekzs,blackhand,671,shaman,restoration,12,7,5
35806,Otem,frostmourne,671,shaman,restoration,16,7,9
35807,Dochavoc,tichondrius,671,shaman,restoration,18,7,11
35808,Cheeziee,thrall,671,shaman,restoration,18,7,11
35809,Hamshamwitch,shadowmoon,671,shaman,restoration,18,7,11
35810,Lvcianrs,thrall,671,shaman,restoration,18,7,11
35811,Caobuloso,azralon,671,shaman,restoration,18,7,11
35812,Sphaerus,tichondrius,671,shaman,restoration,18,7,11
35813,Stormcallerr,sargeras,670,shaman,restoration,12,7,5
35814,Totori,stormscale,670,shaman,restoration,12,7,5
35815,Shamanastic,tichondrius,670,shaman,restoration,12,7,5
35816,Crynoobs,senjin,670,shaman,restoration,12,7,5
35817,Bethorá,suramar,670,shaman,restoration,12,7,5
35818,Shammysham,zuljin,670,shaman,restoration,18,7,11
35819,Karrydoskftw,ragnaros,670,shaman,restoration,18,7,11
35820,Víì,tichondrius,670,shaman,restoration,24,7,17
35821,Toedims,bonechewer,669,shaman,restoration,12,7,5
35822,Vulkova,illidan,669,shaman,restoration,18,7,11
35823,Thordan,lothar,669,shaman,restoration,18,7,11
35824,Cheliz,thrall,669,shaman,restoration,24,7,17
35825,Evilraven,tichondrius,668,shaman,restoration,18,7,11
35826,Waterspinach,tichondrius,668,shaman,restoration,18,7,11
35827,Detropolis,illidan,668,shaman,restoration,48,7,41
35828,Youngneal,sargeras,667,shaman,restoration,18,7,11
35829,Elementium,azshara,667,shaman,restoration,23,7,16
35830,Dennwoop,sargeras,666,shaman,restoration,22,8,14
35831,PlayerHLFJNY,moon-guard,665,shaman,restoration,11,9,2
35832,Ruadhri,moon-guard,665,shaman,restoration,12,7,5
35833,Lamente,ragnaros,655,shaman,restoration,17,7,10
35834,Mâyo,thrall,654,shaman,restoration,17,7,10
35835,Slimcube,illidan,649,shaman,restoration,24,8,16
35836,Stormsurgë,bleeding-hollow,640,shaman,restoration,10,8,2
35837,Deacoderz,area-52,618,shaman,restoration,14,8,6
35838,Royblue,illidan,618,shaman,restoration,14,8,6
35839,Îvôry,bloodhoof,618,shaman,restoration,22,10,12
35840,Mythruxx,sargeras,617,shaman,restoration,20,8,12
35841,Tolvashoc,emerald-dream,608,shaman,restoration,16,7,9
35842,Bigbrenx,tichondrius,607,shaman,restoration,14,7,7
35843,Drfate,kargath,604,shaman,restoration,16,7,9
35844,Matrìx,sargeras,594,shaman,restoration,26,8,18
35845,Vaderung,emerald-dream,592,shaman,restoration,13,7,6
35846,Jimmyapple,illidan,576,shaman,restoration,6,6,0
35847,Creativemind,arathor,576,shaman,restoration,6,6,0
35848,Pangniu,illidan,576,shaman,restoration,6,6,0
35849,Vrangr,uther,576,shaman,restoration,6,6,0
35850,Kassix,illidan,576,shaman,restoration,6,6,0
35851,Jordnöt,moon-guard,576,shaman,restoration,9,6,3
35852,Millionvoltz,tichondrius,576,shaman,restoration,12,6,6
35853,Trewlolz,sargeras,576,shaman,restoration,12,6,6
35854,Lunds,tichondrius,576,shaman,restoration,12,6,6
35855,Joeschhmoe,tichondrius,576,shaman,restoration,12,6,6
35856,Ataia,tichondrius,576,shaman,restoration,12,6,6
35857,Sweatshirtz,tanaris,576,shaman,restoration,12,6,6
35858,Ccmeifbald,moon-guard,576,shaman,restoration,12,6,6
35859,Subhealth,tichondrius,576,shaman,restoration,12,6,6
35860,Hhex,tichondrius,576,shaman,restoration,12,6,6
35861,Nymrose,stormrage,576,shaman,restoration,12,6,6
35862,Apathcat,the-forgotten-coast,576,shaman,restoration,12,6,6
35863,Caprise,tichondrius,576,shaman,restoration,12,6,6
35864,Cencyzz,tichondrius,576,shaman,restoration,12,6,6
35865,Fatdixb,illidan,576,shaman,restoration,12,6,6
35866,Vyy,perenolde,576,shaman,restoration,12,6,6
35867,Biased,sargeras,576,shaman,restoration,12,6,6
35868,Mazekheen,barthilas,576,shaman,restoration,12,6,6
35869,Scadouche,korgath,576,shaman,restoration,12,6,6
35870,Atsukaia,tichondrius,576,shaman,restoration,12,6,6
35871,Abev,bonechewer,576,shaman,restoration,12,6,6
35872,Rawdogginit,malfurion,576,shaman,restoration,12,6,6
35873,Pex,sargeras,576,shaman,restoration,12,6,6
35874,Aespeon,stormrage,576,shaman,restoration,12,6,6
35875,Bravezf,tichondrius,576,shaman,restoration,12,6,6
35876,Weqeqwqwqex,ragnaros,576,shaman,restoration,12,6,6
35877,Mariansaurus,ragnaros,576,shaman,restoration,12,6,6
35878,Tcurts,stormrage,576,shaman,restoration,12,6,6
35879,Iamg,kilrogg,576,shaman,restoration,12,6,6
35880,Xenvale,illidan,576,shaman,restoration,12,6,6
35881,Motatos,malganis,576,shaman,restoration,12,6,6
35882,Akamâ,stormrage,576,shaman,restoration,12,6,6
35883,Gargrax,malganis,576,shaman,restoration,12,6,6
35884,Chogramm,illidan,576,shaman,restoration,12,6,6
35885,Fevolution,dreadmaul,576,shaman,restoration,12,6,6
35886,Lindnerx,malganis,576,shaman,restoration,12,6,6
35887,Todayqt,malganis,576,shaman,restoration,12,6,6
35888,Tigs,alleria,576,shaman,restoration,12,6,6
35889,Kuhdos,caelestrasz,576,shaman,restoration,12,6,6
35890,Gullirachad,stormrage,576,shaman,restoration,12,6,6
35891,Ajj,thrall,576,shaman,restoration,12,6,6
35892,Icehole,kelthuzad,576,shaman,restoration,12,6,6
35893,Potf,illidan,576,shaman,restoration,12,6,6
35894,Pikapiko,tichondrius,576,shaman,restoration,12,6,6
35895,Oppaswag,tichondrius,576,shaman,restoration,12,6,6
35896,Earthside,ragnaros,576,shaman,restoration,12,6,6
35897,Spiritbb,area-52,576,shaman,restoration,12,6,6
35898,Oscer,tichondrius,576,shaman,restoration,18,6,12
35899,Kÿlé,darkspear,576,shaman,restoration,18,6,12
35900,Rubmytiki,skywall,576,shaman,restoration,18,6,12
35901,Greensween,thrall,576,shaman,restoration,19,6,13
35902,Blck,malorne,576,shaman,restoration,23,7,16
35903,Shampowl,jaedenar,576,shaman,restoration,20,6,14
35904,Slowpo,illidan,576,shaman,restoration,24,6,18
35905,Anußis,stormrage,576,shaman,restoration,24,6,18
35906,Sizbo,thrall,575,shaman,restoration,6,6,0
35907,Donojo,zuljin,575,shaman,restoration,12,6,6
35908,Todem,stormrage,575,shaman,restoration,12,6,6
35909,Xhod,zuljin,575,shaman,restoration,12,6,6
35910,Powerpress,thunderlord,575,shaman,restoration,12,6,6
35911,Cùìó,barthilas,575,shaman,restoration,12,6,6
35912,Ondra,frostmourne,575,shaman,restoration,12,6,6
35913,Sarevoc,sargeras,575,shaman,restoration,12,6,6
35914,Thuggliife,frostmourne,575,shaman,restoration,12,6,6
35915,Väsain,wyrmrest-accord,575,shaman,restoration,12,6,6
35916,Tagliatelle,kelthuzad,575,shaman,restoration,15,7,8
35917,Numbreseven,frostmourne,575,shaman,restoration,14,6,8
35918,Ragnarüz,ragnaros,575,shaman,restoration,19,7,12
35919,Girafasuarx,korgath,575,shaman,restoration,18,6,12
35920,Jetstream,shadow-council,575,shaman,restoration,18,6,12
35921,Spiritwler,tichondrius,575,shaman,restoration,18,6,12
35922,Stormblast,stormrage,575,shaman,restoration,24,6,18
35923,Luciuzz,tichondrius,574,shaman,restoration,12,6,6
35924,Shyeahmon,drenden,574,shaman,restoration,12,6,6
35925,Killerphreak,mannoroth,574,shaman,restoration,12,6,6
35926,Dodirt,laughing-skull,574,shaman,restoration,12,6,6
35927,Kunshíí,bleeding-hollow,574,shaman,restoration,15,6,9
35928,Wugmuk,illidan,573,shaman,restoration,18,6,12
35929,Bombsb,tichondrius,572,shaman,restoration,18,6,12
35930,Racsors,ragnaros,571,shaman,restoration,12,6,6
35931,Gimlyman,madoran,567,shaman,restoration,12,6,6
35932,Trustfall,rexxar,566,shaman,restoration,12,6,6
35933,Bloodmoôn,frostmourne,566,shaman,restoration,18,6,12
35934,Reddleman,stormrage,544,shaman,restoration,22,6,16
35935,Earthnsky,bleeding-hollow,543,shaman,restoration,11,6,5
35936,Saviørkai,barthilas,543,shaman,restoration,14,7,7
35937,Tsunamic,sargeras,528,shaman,restoration,15,6,9
35938,Galaxiya,blackhand,525,shaman,restoration,21,7,14
35939,Shamyshame,quelthalas,522,shaman,restoration,12,7,5
35940,Yeetle,gorefiend,521,shaman,restoration,16,7,9
35941,Señordoge,malganis,511,shaman,restoration,14,6,8
35942,Rikswordfire,wyrmrest-accord,509,shaman,restoration,16,6,10
35943,Tigrains,proudmoore,495,shaman,restoration,11,7,4
35944,Nuggsfxce,frostmourne,480,shaman,restoration,6,5,1
35945,Esterosa,tichondrius,480,shaman,restoration,6,5,1
35946,Cheddatotz,illidan,480,shaman,restoration,6,5,1
35947,Msool,tichondrius,480,shaman,restoration,6,5,1
35948,Oopy,icecrown,480,shaman,restoration,6,5,1
35949,Scamgame,tichondrius,480,shaman,restoration,6,5,1
35950,Biguaga,tichondrius,480,shaman,restoration,6,5,1
35951,Binishaman,tichondrius,480,shaman,restoration,6,5,1
35952,Elamentz,bleeding-hollow,480,shaman,restoration,6,5,1
35953,Cantshear,zuljin,480,shaman,restoration,6,5,1
35954,Boogiefever,area-52,480,shaman,restoration,6,5,1
35955,Lazie,perenolde,480,shaman,restoration,6,5,1
35956,Spekgawd,emerald-dream,480,shaman,restoration,6,5,1
35957,Çhïcagø,aegwynn,480,shaman,restoration,6,5,1
35958,Fastaslight,bleeding-hollow,480,shaman,restoration,6,5,1
35959,Mahevagodx,ragnaros,480,shaman,restoration,6,5,1
35960,Oprawinfuryy,thrall,480,shaman,restoration,6,5,1
35961,Hexgodx,illidan,480,shaman,restoration,6,5,1
35962,Shamamsx,illidan,480,shaman,restoration,6,5,1
35963,Blueclass,akama,480,shaman,restoration,6,5,1
35964,Dankestmemes,illidan,480,shaman,restoration,6,5,1
35965,Azrlol,illidan,480,shaman,restoration,12,5,7
35966,Daintydan,illidan,480,shaman,restoration,12,5,7
35967,Chiggys,area-52,480,shaman,restoration,12,5,7
35968,Nøzurbo,area-52,480,shaman,restoration,12,5,7
35969,Dyllbat,illidan,480,shaman,restoration,12,5,7
35970,Teftx,area-52,480,shaman,restoration,12,5,7
35971,Ponyi,frostmourne,480,shaman,restoration,12,5,7
35972,Hitchsláp,tichondrius,480,shaman,restoration,12,5,7
35973,Devipersham,frostmourne,480,shaman,restoration,12,5,7
35974,Totemfizzle,spirestone,480,shaman,restoration,12,5,7
35975,Drcopafeel,stormrage,480,shaman,restoration,12,5,7
35976,Juked,aegwynn,480,shaman,restoration,12,5,7
35977,Specify,arathor,480,shaman,restoration,12,5,7
35978,Elmoss,thrall,480,shaman,restoration,12,5,7
35979,Derbain,caelestrasz,480,shaman,restoration,12,5,7
35980,Weebzealot,kelthuzad,480,shaman,restoration,12,5,7
35981,Cherryboy,illidan,480,shaman,restoration,12,5,7
35982,Trizzeh,moon-guard,480,shaman,restoration,12,5,7
35983,Juicypork,moon-guard,480,shaman,restoration,12,5,7
35984,Baltarian,emerald-dream,480,shaman,restoration,12,5,7
35985,Shämpäin,moon-guard,480,shaman,restoration,12,5,7
35986,Sixtyninelol,thunderlord,480,shaman,restoration,12,5,7
35987,Tmkaldärýs,tichondrius,480,shaman,restoration,12,5,7
35988,Oriyani,sargeras,480,shaman,restoration,12,5,7
35989,Boryndor,stormrage,480,shaman,restoration,12,5,7
35990,Pohtayto,darkspear,480,shaman,restoration,12,5,7
35991,Thonty,sargeras,480,shaman,restoration,12,5,7
35992,Fidelityfx,sargeras,480,shaman,restoration,12,5,7
35993,Hijodelrayo,drakkari,480,shaman,restoration,12,5,7
35994,Sâxman,stormreaver,480,shaman,restoration,12,5,7
35995,Astotems,tichondrius,480,shaman,restoration,12,5,7
35996,Plotwave,bleeding-hollow,480,shaman,restoration,12,5,7
35997,Huulu,blades-edge,480,shaman,restoration,12,5,7
35998,Nøir,drakkari,480,shaman,restoration,12,5,7
35999,Doop,kiljaeden,480,shaman,restoration,12,5,7
36000,Shäman,anetheron,480,shaman,restoration,12,5,7
36001,Flaggedname,frostmane,480,shaman,restoration,12,5,7
36002,Devastian,quelthalas,480,shaman,restoration,12,5,7
36003,Nagish,alexstrasza,480,shaman,restoration,12,5,7
36004,Strohz,undermine,480,shaman,restoration,12,5,7
36005,Victusk,tichondrius,480,shaman,restoration,12,5,7
36006,Tingletotem,tichondrius,480,shaman,restoration,12,5,7
36007,Goresx,tichondrius,480,shaman,restoration,12,5,7
36008,Bröxigâr,tichondrius,480,shaman,restoration,12,5,7
36009,Dókki,tichondrius,480,shaman,restoration,12,5,7
36010,Enzÿte,tichondrius,480,shaman,restoration,12,5,7
36011,Synkronaqt,tichondrius,480,shaman,restoration,12,5,7
36012,Kupnicki,zuljin,480,shaman,restoration,12,5,7
36013,Zingysham,tichondrius,480,shaman,restoration,12,5,7
36014,Krupto,tichondrius,480,shaman,restoration,12,5,7
36015,Larvabust,azralon,480,shaman,restoration,12,5,7
36016,Bignutters,bleeding-hollow,480,shaman,restoration,12,5,7
36017,Vegaslights,tichondrius,480,shaman,restoration,12,5,7
36018,Deyodin,illidan,480,shaman,restoration,12,5,7
36019,Trickyjf,dalaran,480,shaman,restoration,12,5,7
36020,Stumpyjoe,terokkar,480,shaman,restoration,13,5,8
36021,Elecpod,frostmourne,480,shaman,restoration,14,5,9
36022,Yoloswage,tichondrius,480,shaman,restoration,21,6,15
36023,Krisu,kelthuzad,480,shaman,restoration,18,5,13
36024,Animac,bleeding-hollow,480,shaman,restoration,18,5,13
36025,Oilburner,malganis,480,shaman,restoration,18,5,13
36026,Rekashaki,illidan,480,shaman,restoration,18,5,13
36027,Greenberry,bonechewer,479,shaman,restoration,10,6,4
36028,Gagonmatotem,skullcrusher,479,shaman,restoration,9,5,4
36029,Fläkky,tichondrius,479,shaman,restoration,12,5,7
36030,Tattoö,elune,479,shaman,restoration,12,5,7
36031,Bobaflexqt,korgath,479,shaman,restoration,12,5,7
36032,Aimsely,area-52,479,shaman,restoration,12,5,7
36033,Blkpowerfist,malganis,479,shaman,restoration,12,5,7
36034,Sâvage,zuljin,479,shaman,restoration,12,5,7
36035,Sannyasin,azralon,479,shaman,restoration,12,5,7
36036,Highmountain,tichondrius,479,shaman,restoration,12,5,7
36037,Arastour,bronzebeard,479,shaman,restoration,12,5,7
36038,Josiahsham,kelthuzad,479,shaman,restoration,12,5,7
36039,Monspiett,azralon,479,shaman,restoration,12,5,7
36040,Killonsight,tichondrius,479,shaman,restoration,12,5,7
36041,Beardedone,durotan,479,shaman,restoration,12,5,7
36042,Turksham,tichondrius,479,shaman,restoration,12,5,7
36043,Dragonsauce,grizzly-hills,479,shaman,restoration,18,5,13
36044,Smearedbeard,bleeding-hollow,479,shaman,restoration,18,5,13
36045,Nytestalker,sargeras,479,shaman,restoration,18,5,13
36046,Ahaw,area-52,479,shaman,restoration,18,5,13
36047,Typo,skullcrusher,478,shaman,restoration,6,5,1
36048,Vaginix,tichondrius,478,shaman,restoration,18,5,13
36049,Stahlye,proudmoore,477,shaman,restoration,6,5,1
36050,Allegrata,sargeras,477,shaman,restoration,12,5,7
36051,Timprecu,azralon,477,shaman,restoration,12,5,7
36052,Pileef,thrall,473,shaman,restoration,13,7,6
36053,Uderlol,tichondrius,448,shaman,restoration,10,5,5
36054,Danil,emerald-dream,447,shaman,restoration,11,5,6
36055,Brocklee,farstriders,447,shaman,restoration,16,5,11
36056,Akhae,duskwood,445,shaman,restoration,14,6,8
36057,Sidnii,tichondrius,432,shaman,restoration,9,5,4
36058,Lampstand,wildhammer,431,shaman,restoration,11,5,6
36059,Zelzus,moon-guard,431,shaman,restoration,11,5,6
36060,Swampy,tanaris,426,shaman,restoration,15,6,9
36061,Littleshasha,tichondrius,426,shaman,restoration,15,6,9
36062,Ggezlmao,bleeding-hollow,426,shaman,restoration,16,6,10
36063,Zio,akama,425,shaman,restoration,14,6,8
36064,Wragnus,tichondrius,425,shaman,restoration,15,6,9
36065,Hannibol,tichondrius,416,shaman,restoration,10,5,5
36066,Lebs,barthilas,415,shaman,restoration,8,5,3
36067,Shockjoy,malganis,415,shaman,restoration,11,5,6
36068,Chûnk,tichondrius,400,shaman,restoration,13,5,8
36069,Clapton,darkspear,400,shaman,restoration,19,5,14
36070,Príde,ragnaros,384,shaman,restoration,6,4,2
36071,Resonence,bleeding-hollow,384,shaman,restoration,6,4,2
36072,Gotmolk,illidan,384,shaman,restoration,6,4,2
36073,Zanderpla,kelthuzad,384,shaman,restoration,6,4,2
36074,Kìttý,malganis,384,shaman,restoration,6,4,2
36075,Idowhatcdont,kelthuzad,384,shaman,restoration,6,4,2
36076,Kaîowas,malganis,384,shaman,restoration,6,4,2
36077,Bigboorst,kelthuzad,384,shaman,restoration,6,4,2
36078,Ârtík,tichondrius,384,shaman,restoration,6,4,2
36079,Excaliburumb,tichondrius,384,shaman,restoration,6,4,2
36080,Tisaa,tichondrius,384,shaman,restoration,6,4,2
36081,Nepshock,stormrage,384,shaman,restoration,6,4,2
36082,Omegalmao,sargeras,384,shaman,restoration,6,4,2
36083,Xiaoya,tichondrius,384,shaman,restoration,6,4,2
36084,Xillicit,sargeras,384,shaman,restoration,6,4,2
36085,Foray,barthilas,384,shaman,restoration,6,4,2
36086,Smeeza,frostmourne,384,shaman,restoration,6,4,2
36087,Bhann,tichondrius,384,shaman,restoration,6,4,2
36088,Jimmymaclroy,frostmourne,384,shaman,restoration,6,4,2
36089,Cháningtotem,frostmourne,384,shaman,restoration,6,4,2
36090,Éarl,sargeras,384,shaman,restoration,6,4,2
36091,Acdc,zuljin,384,shaman,restoration,6,4,2
36092,Telnos,emerald-dream,384,shaman,restoration,6,4,2
36093,Weathersmell,sargeras,384,shaman,restoration,6,4,2
36094,Hordeoeuvre,zuljin,384,shaman,restoration,6,4,2
36095,Curador,nemesis,384,shaman,restoration,6,4,2
36096,Castia,sargeras,384,shaman,restoration,6,4,2
36097,Shamankofwa,tichondrius,384,shaman,restoration,6,4,2
36098,Sylicious,barthilas,384,shaman,restoration,6,4,2
36099,Winry,korgath,384,shaman,restoration,6,4,2
36100,Kustum,tichondrius,384,shaman,restoration,6,4,2
36101,Intravz,tichondrius,384,shaman,restoration,6,4,2
36102,Freakytiki,azshara,384,shaman,restoration,6,4,2
36103,Aletcheoddox,sargeras,384,shaman,restoration,6,4,2
36104,Aeølus,tichondrius,384,shaman,restoration,6,4,2
36105,Shåmwiches,tichondrius,384,shaman,restoration,6,4,2
36106,Joryu,tichondrius,384,shaman,restoration,6,4,2
36107,Piaopiao,skywall,384,shaman,restoration,6,4,2
36108,Gumballin,sargeras,384,shaman,restoration,8,4,4
36109,Shâmbulance,hyjal,384,shaman,restoration,12,4,8
36110,Smashyz,nerzhul,384,shaman,restoration,12,4,8
36111,Sheeno,blackrock,384,shaman,restoration,12,4,8
36112,Boyyo,maiev,384,shaman,restoration,12,4,8
36113,Ngentotem,frostmourne,384,shaman,restoration,12,4,8
36114,Cgq,tichondrius,384,shaman,restoration,12,4,8
36115,Misakism,sargeras,384,shaman,restoration,12,4,8
36116,Lollzerz,the-forgotten-coast,384,shaman,restoration,12,4,8
36117,Bayslaps,tichondrius,384,shaman,restoration,12,4,8
36118,Haymaker,bleeding-hollow,384,shaman,restoration,12,4,8
36119,Toobeastly,deathwing,384,shaman,restoration,12,4,8
36120,Stackinheals,thrall,384,shaman,restoration,12,4,8
36121,Celements,malganis,384,shaman,restoration,12,4,8
36122,Xändra,ragnaros,384,shaman,restoration,12,4,8
36123,Kobecoopper,sargeras,384,shaman,restoration,12,4,8
36124,Healswin,sargeras,384,shaman,restoration,12,4,8
36125,Saksa,garrosh,384,shaman,restoration,12,4,8
36126,Hateshifter,kul-tiras,384,shaman,restoration,12,4,8
36127,Pümba,azralon,384,shaman,restoration,12,4,8
36128,Ayev,illidan,384,shaman,restoration,12,4,8
36129,Naturasol,quelthalas,384,shaman,restoration,12,4,8
36130,Bäsedgód,tichondrius,384,shaman,restoration,12,4,8
36131,Porkbrains,emerald-dream,384,shaman,restoration,16,5,11
36132,Kermut,frostmourne,384,shaman,restoration,18,4,14
36133,Conductivity,frostmourne,384,shaman,restoration,18,4,14
36134,Dukaman,malganis,384,shaman,restoration,18,4,14
36135,Bøx,ragnaros,383,shaman,restoration,6,4,2
36136,Rockyisback,illidan,383,shaman,restoration,6,4,2
36137,Hexnation,frostmourne,383,shaman,restoration,6,4,2
36138,Ctrlaltelite,burning-blade,383,shaman,restoration,12,4,8
36139,Foogus,tichondrius,383,shaman,restoration,12,4,8
36140,Huugsnkissez,sargeras,383,shaman,restoration,12,4,8
36141,Sndtome,stormrage,383,shaman,restoration,12,4,8
36142,Madvillainny,thrall,383,shaman,restoration,12,4,8
36143,Tandarin,burning-legion,383,shaman,restoration,12,4,8
36144,Ânûbis,sargeras,383,shaman,restoration,12,4,8
36145,Galarix,nerzhul,383,shaman,restoration,30,4,26
36146,Turbö,hyjal,382,shaman,restoration,12,4,8
36147,Shockshow,zuljin,382,shaman,restoration,12,4,8
36148,Huukron,emerald-dream,382,shaman,restoration,12,4,8
36149,Caulkshock,tichondrius,382,shaman,restoration,12,4,8
36150,Laveidem,frostmourne,382,shaman,restoration,18,4,14
36151,Uggbootz,amanthul,379,shaman,restoration,25,4,21
36152,Alwinaa,kiljaeden,367,shaman,restoration,11,4,7
36153,Pche,tichondrius,367,shaman,restoration,11,4,7
36154,Shamanakin,emerald-dream,351,shaman,restoration,8,5,3
36155,Tineer,tichondrius,336,shaman,restoration,9,4,5
36156,Avidas,malganis,331,shaman,restoration,15,4,11
36157,Vudu,terokkar,330,shaman,restoration,13,5,8
36158,Purgedubx,tichondrius,330,shaman,restoration,15,5,10
36159,Stitchez,illidan,330,shaman,restoration,21,5,16
36160,Intress,moon-guard,329,shaman,restoration,10,6,4
36161,Elevatezxo,stormrage,304,shaman,restoration,7,4,3
36162,Totumstroker,thrall,288,shaman,restoration,6,3,3
36163,Sumyl,ragnaros,288,shaman,restoration,6,3,3
36164,Chocothicc,bleeding-hollow,288,shaman,restoration,6,3,3
36165,Illmental,kelthuzad,288,shaman,restoration,6,3,3
36166,Bigbadpercy,frostmourne,288,shaman,restoration,6,3,3
36167,Skrubbles,bleeding-hollow,288,shaman,restoration,6,3,3
36168,Akupapu,illidan,288,shaman,restoration,6,3,3
36169,Cloudsh,silvermoon,288,shaman,restoration,6,3,3
36170,Taproots,ursin,288,shaman,restoration,6,3,3
36171,Solitarysham,moon-guard,288,shaman,restoration,6,3,3
36172,Digglr,tichondrius,288,shaman,restoration,6,3,3
36173,Phinoi,tichondrius,288,shaman,restoration,6,3,3
36174,Asskrap,daggerspine,288,shaman,restoration,6,3,3
36175,Maana,dragonmaw,288,shaman,restoration,6,3,3
36176,Thetotemtaco,tichondrius,288,shaman,restoration,6,3,3
36177,Snowkingx,illidan,288,shaman,restoration,6,3,3
36178,Rsham,dragonmaw,288,shaman,restoration,6,3,3
36179,Teladoy,kelthuzad,288,shaman,restoration,6,3,3
36180,Juicedbydad,kelthuzad,288,shaman,restoration,6,3,3
36181,Restoele,tichondrius,288,shaman,restoration,6,3,3
36182,Youngie,dathremar,288,shaman,restoration,6,3,3
36183,Ghiscar,tichondrius,288,shaman,restoration,6,3,3
36184,Spencêrf,illidan,288,shaman,restoration,6,3,3
36185,Zoltide,sargeras,288,shaman,restoration,6,3,3
36186,Puntress,barthilas,288,shaman,restoration,6,3,3
36187,Betterthanya,tichondrius,288,shaman,restoration,6,3,3
36188,Sonsii,tichondrius,288,shaman,restoration,6,3,3
36189,Clytiae,arthas,288,shaman,restoration,6,3,3
36190,Kazino,stormrage,288,shaman,restoration,6,3,3
36191,Wulfey,sargeras,288,shaman,restoration,6,3,3
36192,Curtrex,amanthul,288,shaman,restoration,6,3,3
36193,Kanntok,quelthalas,288,shaman,restoration,6,3,3
36194,Dylie,tichondrius,288,shaman,restoration,6,3,3
36195,Dimitrio,azralon,288,shaman,restoration,6,3,3
36196,Kamehamekazi,blackhand,288,shaman,restoration,6,3,3
36197,Smackzs,sargeras,288,shaman,restoration,6,3,3
36198,Stormsanta,emerald-dream,288,shaman,restoration,6,3,3
36199,Megadabs,malganis,288,shaman,restoration,6,3,3
36200,Pressyocds,darkspear,288,shaman,restoration,6,3,3
36201,Eleresto,tichondrius,288,shaman,restoration,6,3,3
36202,Gunx,darkspear,288,shaman,restoration,6,3,3
36203,Sreve,malganis,288,shaman,restoration,6,3,3
36204,Herpeaz,kelthuzad,288,shaman,restoration,6,3,3
36205,Fruityrudyy,area-52,288,shaman,restoration,6,3,3
36206,Rakkasham,blackrock,288,shaman,restoration,6,3,3
36207,Cloudycloud,tichondrius,288,shaman,restoration,6,3,3
36208,Siox,zuljin,288,shaman,restoration,6,3,3
36209,Voron,kiljaeden,288,shaman,restoration,6,3,3
36210,Gucciblunts,sargeras,288,shaman,restoration,6,3,3
36211,Uwuxdlol,tichondrius,288,shaman,restoration,6,3,3
36212,Danyax,malganis,288,shaman,restoration,6,3,3
36213,Drwaters,lightnings-blade,288,shaman,restoration,6,3,3
36214,Samac,ravencrest,288,shaman,restoration,6,3,3
36215,Rollînçoàl,malganis,288,shaman,restoration,6,3,3
36216,Nyroh,zuljin,288,shaman,restoration,6,3,3
36217,Forloren,zuljin,288,shaman,restoration,6,3,3
36218,Mudtide,tichondrius,288,shaman,restoration,6,3,3
36219,Shearx,illidan,288,shaman,restoration,6,3,3
36220,Drathos,azralon,288,shaman,restoration,6,3,3
36221,Totemtots,illidan,288,shaman,restoration,6,3,3
36222,Ñoobshaman,tichondrius,288,shaman,restoration,6,3,3
36223,Sumdumshaman,illidan,288,shaman,restoration,6,3,3
36224,Wreckaholic,alterac-mountains,288,shaman,restoration,6,3,3
36225,Catnïp,maelstrom,288,shaman,restoration,6,3,3
36226,Goongoon,zuljin,288,shaman,restoration,6,3,3
36227,Wastedlink,tichondrius,288,shaman,restoration,6,3,3
36228,Yunqboichay,kelthuzad,288,shaman,restoration,6,3,3
36229,Daggonet,sargeras,288,shaman,restoration,6,3,3
36230,Laucian,malganis,288,shaman,restoration,6,3,3
36231,Squidazzle,tichondrius,288,shaman,restoration,8,3,5
36232,Ðrunkentotem,tichondrius,288,shaman,restoration,11,4,7
36233,Rebelutioni,lothar,288,shaman,restoration,11,3,8
36234,Calliope,burning-legion,288,shaman,restoration,12,3,9
36235,Loanomi,zuljin,288,shaman,restoration,12,3,9
36236,Mondaymood,illidan,288,shaman,restoration,12,3,9
36237,Sooweecide,tichondrius,288,shaman,restoration,12,3,9
36238,Equinsuochha,silvermoon,288,shaman,restoration,12,3,9
36239,Trysts,wyrmrest-accord,288,shaman,restoration,12,3,9
36240,Chocobomb,burning-blade,288,shaman,restoration,12,3,9
36241,Zéwel,tichondrius,288,shaman,restoration,12,3,9
36242,Paniczone,madoran,288,shaman,restoration,12,3,9
36243,Strawberryz,sargeras,288,shaman,restoration,12,3,9
36244,Watoos,area-52,288,shaman,restoration,12,3,9
36245,Sliccricc,doomhammer,288,shaman,restoration,12,3,9
36246,Mochomò,ragnaros,288,shaman,restoration,12,3,9
36247,Shamonalisa,altar-of-storms,288,shaman,restoration,12,3,9
36248,Possessing,illidan,288,shaman,restoration,12,3,9
36249,Makogo,earthen-ring,288,shaman,restoration,12,3,9
36250,Sheariously,sargeras,288,shaman,restoration,12,3,9
36251,Meatyball,tichondrius,288,shaman,restoration,12,3,9
36252,Showkinho,azralon,288,shaman,restoration,12,3,9
36253,Oomme,area-52,288,shaman,restoration,12,3,9
36254,Scion,thaurissan,288,shaman,restoration,12,3,9
36255,Bovinefever,kiljaeden,288,shaman,restoration,12,3,9
36256,Oprawindfuri,whisperwind,288,shaman,restoration,12,3,9
36257,Cositax,tichondrius,287,shaman,restoration,6,3,3
36258,Trovac,azralon,287,shaman,restoration,6,3,3
36259,Altryn,shuhalo,287,shaman,restoration,6,3,3
36260,Valien,kiljaeden,287,shaman,restoration,6,3,3
36261,Nottoshammy,dalaran,287,shaman,restoration,12,3,9
36262,Garurt,daggerspine,286,shaman,restoration,12,6,6
36263,Kider,drakkari,286,shaman,restoration,6,3,3
36264,Donkeydrill,elune,286,shaman,restoration,6,3,3
36265,Ranek,shuhalo,286,shaman,restoration,6,3,3
36266,Tarlonygg,malganis,281,shaman,restoration,15,6,9
36267,Eloquent,emerald-dream,273,shaman,restoration,19,6,13
36268,Hilung,lightnings-blade,255,shaman,restoration,11,3,8
36269,Shamanship,haomarush,239,shaman,restoration,5,3,2
36270,Lickerman,stormreaver,239,shaman,restoration,5,3,2
36271,Tyrión,aggramar,234,shaman,restoration,15,5,10
36272,Succies,emerald-dream,234,shaman,restoration,16,4,12
36273,Bigripnow,sargeras,234,shaman,restoration,20,4,16
36274,Tokelahoma,stormrage,234,shaman,restoration,22,4,18
36275,Keldara,aerie-peak,192,shaman,restoration,6,2,4
36276,Dallìa,tichondrius,192,shaman,restoration,6,2,4
36277,Raxxom,tichondrius,192,shaman,restoration,6,2,4
36278,Aishel,area-52,192,shaman,restoration,6,2,4
36279,Jamarcuss,tichondrius,192,shaman,restoration,6,2,4
36280,Juraf,malganis,192,shaman,restoration,6,2,4
36281,Oprawîndfury,tichondrius,192,shaman,restoration,6,2,4
36282,Xlash,zuljin,192,shaman,restoration,6,2,4
36283,Hottesthands,barthilas,192,shaman,restoration,6,2,4
36284,Esqueue,tichondrius,192,shaman,restoration,6,2,4
36285,Sid,frostmourne,192,shaman,restoration,6,2,4
36286,Pandl,frostmourne,192,shaman,restoration,6,2,4
36287,Birdizdawerd,shuhalo,192,shaman,restoration,6,2,4
36288,Plutoshaker,tichondrius,192,shaman,restoration,6,2,4
36289,Karnnages,cenarion-circle,192,shaman,restoration,6,2,4
36290,Bekrogh,azralon,192,shaman,restoration,6,2,4
36291,Yngvii,tichondrius,192,shaman,restoration,6,2,4
36292,Ara,zuljin,192,shaman,restoration,6,2,4
36293,Mangeegee,malganis,192,shaman,restoration,6,2,4
36294,Mjxholland,aegwynn,192,shaman,restoration,6,2,4
36295,Snapertun,tichondrius,192,shaman,restoration,6,2,4
36296,Notviscent,illidan,192,shaman,restoration,6,2,4
36297,Killuminatti,nathrezim,192,shaman,restoration,6,2,4
36298,Nbax,tichondrius,192,shaman,restoration,6,2,4
36299,Halfzugzug,sargeras,192,shaman,restoration,6,2,4
36300,Shinydiglett,area-52,192,shaman,restoration,6,2,4
36301,Nxboy,proudmoore,192,shaman,restoration,6,2,4
36302,Lakeshow,tichondrius,192,shaman,restoration,6,2,4
36303,Magwølfe,area-52,192,shaman,restoration,6,2,4
36304,Chainandrain,frostmourne,192,shaman,restoration,6,2,4
36305,Cheesepufs,illidan,192,shaman,restoration,6,2,4
36306,Lolcàt,tichondrius,192,shaman,restoration,6,2,4
36307,Zhangyider,illidan,192,shaman,restoration,6,2,4
36308,Rykkar,kiljaeden,192,shaman,restoration,6,2,4
36309,Cpkzlol,tichondrius,192,shaman,restoration,6,2,4
36310,Duality,shattered-halls,192,shaman,restoration,6,2,4
36311,Dabrat,lightnings-blade,192,shaman,restoration,6,2,4
36312,Jimmybutler,tichondrius,192,shaman,restoration,6,2,4
36313,Zugzugpurge,thrall,192,shaman,restoration,6,2,4
36314,Torrentzx,sargeras,192,shaman,restoration,6,2,4
36315,Aderra,garrosh,192,shaman,restoration,6,2,4
36316,Thefurrybox,tichondrius,192,shaman,restoration,6,2,4
36317,Gbe,tichondrius,192,shaman,restoration,6,2,4
36318,Relâx,icecrown,192,shaman,restoration,6,2,4
36319,Twistër,illidan,192,shaman,restoration,6,2,4
36320,Hughwang,kelthuzad,192,shaman,restoration,6,2,4
36321,Linkandwink,nerzhul,192,shaman,restoration,6,2,4
36322,Ezeya,area-52,192,shaman,restoration,6,2,4
36323,Konga,korialstrasz,192,shaman,restoration,6,2,4
36324,Ioki,spirestone,192,shaman,restoration,6,2,4
36325,Eternaltotem,darkspear,192,shaman,restoration,6,2,4
36326,Lequandarius,sargeras,192,shaman,restoration,6,2,4
36327,Gwenstifani,sargeras,192,shaman,restoration,6,2,4
36328,Chungxs,illidan,192,shaman,restoration,6,2,4
36329,Cawlin,stormrage,192,shaman,restoration,6,2,4
36330,Firesurge,sargeras,192,shaman,restoration,6,2,4
36331,Umadilia,area-52,192,shaman,restoration,6,2,4
36332,Thundertusks,norgannon,192,shaman,restoration,6,2,4
36333,Dhalishama,thrall,192,shaman,restoration,6,2,4
36334,Zâppý,stormrage,192,shaman,restoration,6,2,4
36335,Timbosteve,thrall,192,shaman,restoration,6,2,4
36336,Mauiiei,sargeras,192,shaman,restoration,6,2,4
36337,Shozen,bonechewer,192,shaman,restoration,6,2,4
36338,Shamansz,stormrage,192,shaman,restoration,6,2,4
36339,Purpose,nerzhul,192,shaman,restoration,6,2,4
36340,Suspend,gorgonnash,192,shaman,restoration,9,2,7
36341,Kitanoo,kiljaeden,192,shaman,restoration,12,2,10
36342,Aoiiro,dentarg,192,shaman,restoration,12,2,10
36343,Wasiri,illidan,192,shaman,restoration,12,2,10
36344,Rhaksh,sargeras,192,shaman,restoration,12,2,10
36345,Rueem,area-52,192,shaman,restoration,12,2,10
36346,Actios,stormrage,192,shaman,restoration,12,2,10
36347,Bizzy,black-dragonflight,192,shaman,restoration,12,2,10
36348,Awool,lightbringer,192,shaman,restoration,12,2,10
36349,Lomínark,stormrage,192,shaman,restoration,12,2,10
36350,Soomer,frostmourne,192,shaman,restoration,12,2,10
36351,Monchsham,area-52,192,shaman,restoration,13,2,11
36352,Shockbot,stormscale,192,shaman,restoration,18,2,16
36353,Bootsix,area-52,192,shaman,restoration,18,2,16
36354,Kicksave,illidan,192,shaman,restoration,18,2,16
36355,Doctermoo,daggerspine,192,shaman,restoration,28,3,25
36356,Roogys,emerald-dream,192,shaman,restoration,22,2,20
36357,Malsturm,stormrage,191,shaman,restoration,6,2,4
36358,Fóurelements,malganis,191,shaman,restoration,6,2,4
36359,Donix,destromath,191,shaman,restoration,6,2,4
36360,Healcacatoi,zuljin,191,shaman,restoration,6,2,4
36361,Vazan,arthas,191,shaman,restoration,6,2,4
36362,Machalo,sargeras,191,shaman,restoration,6,2,4
36363,Jammylol,frostmourne,180,shaman,restoration,21,6,15
36364,Ambevsulfr,tichondrius,175,shaman,restoration,11,2,9
36365,Nolij,sargeras,159,shaman,restoration,5,2,3
36366,Restomilk,tichondrius,159,shaman,restoration,5,2,3
36367,Llgll,tichondrius,159,shaman,restoration,5,2,3
36368,Drowsbad,tichondrius,138,shaman,restoration,10,4,6
36369,Uggerz,barthilas,138,shaman,restoration,9,3,6
36370,Bigdaddyion,thrall,138,shaman,restoration,9,3,6
36371,Ganvitchenko,illidan,138,shaman,restoration,13,4,9
36372,Thelôpen,tichondrius,138,shaman,restoration,17,4,13
36373,Bigbøss,stormrage,138,shaman,restoration,20,3,17
36374,Aricer,proudmoore,112,shaman,restoration,13,2,11
36375,Hueymagoo,firetree,112,shaman,restoration,13,2,11
36376,Jbahr,hyjal,96,shaman,restoration,3,2,1
36377,Shamtoots,aerie-peak,96,shaman,restoration,9,2,7
36378,Cyberheler,quelthalas,96,shaman,restoration,6,1,5
36379,Finnaburstt,tichondrius,96,shaman,restoration,6,1,5
36380,Twizzhurp,bleeding-hollow,96,shaman,restoration,6,1,5
36381,Restorates,tichondrius,96,shaman,restoration,6,1,5
36382,Kwaztotem,area-52,96,shaman,restoration,6,1,5
36383,Galiffa,area-52,96,shaman,restoration,6,1,5
36384,Shamoover,kelthuzad,96,shaman,restoration,6,1,5
36385,Meshugga,scarlet-crusade,96,shaman,restoration,6,1,5
36386,Muruaic,dentarg,96,shaman,restoration,6,1,5
36387,Tchamí,blackrock,96,shaman,restoration,6,1,5
36388,Daku,tichondrius,96,shaman,restoration,6,1,5
36389,Eleshamanz,tichondrius,96,shaman,restoration,6,1,5
36390,Meattoilet,tichondrius,96,shaman,restoration,6,1,5
36391,Mufflër,the-venture-co,96,shaman,restoration,6,1,5
36392,Dodey,malganis,96,shaman,restoration,6,1,5
36393,Hadèes,zuljin,96,shaman,restoration,6,1,5
36394,Movemaker,shattered-hand,96,shaman,restoration,6,1,5
36395,Sshhammann,tichondrius,96,shaman,restoration,6,1,5
36396,Zorg,area-52,96,shaman,restoration,6,1,5
36397,Camdoc,destromath,96,shaman,restoration,6,1,5
36398,Billydreams,drakkari,96,shaman,restoration,6,1,5
36399,Liltex,malganis,96,shaman,restoration,6,1,5
36400,Meramin,illidan,96,shaman,restoration,6,1,5
36401,Babehmakr,lightnings-blade,96,shaman,restoration,6,1,5
36402,Asanako,illidan,96,shaman,restoration,6,1,5
36403,Daiablo,barthilas,96,shaman,restoration,6,1,5
36404,Knockedup,tichondrius,96,shaman,restoration,6,1,5
36405,Statikrage,eonar,96,shaman,restoration,6,1,5
36406,Nøtørious,thrall,96,shaman,restoration,6,1,5
36407,Célty,moon-guard,96,shaman,restoration,6,1,5
36408,Stickshaman,sargeras,96,shaman,restoration,6,1,5
36409,Totempixie,barthilas,96,shaman,restoration,6,1,5
36410,Cluffatty,tichondrius,96,shaman,restoration,6,1,5
36411,Ogeez,area-52,96,shaman,restoration,6,1,5
36412,Drmundo,icecrown,96,shaman,restoration,6,1,5
36413,Ashamanist,barthilas,96,shaman,restoration,6,1,5
36414,Sleepysham,anubarak,96,shaman,restoration,6,1,5
36415,Slacken,kiljaeden,96,shaman,restoration,6,1,5
36416,Thenewsherek,maelstrom,96,shaman,restoration,6,1,5
36417,Average,bonechewer,96,shaman,restoration,6,1,5
36418,Restoz,thrall,96,shaman,restoration,6,1,5
36419,Iightning,frostwolf,96,shaman,restoration,6,1,5
36420,Wannabecdeww,kelthuzad,96,shaman,restoration,6,1,5
36421,Swartzqt,tichondrius,96,shaman,restoration,6,1,5
36422,Churdoodle,area-52,96,shaman,restoration,6,1,5
36423,Toyletpaper,mugthol,96,shaman,restoration,6,1,5
36424,Schmutz,emerald-dream,96,shaman,restoration,6,1,5
36425,Cavolt,stormrage,96,shaman,restoration,6,1,5
36426,Dasckisham,area-52,96,shaman,restoration,6,1,5
36427,Yaola,kiljaeden,96,shaman,restoration,6,1,5
36428,Teathin,ragnaros,96,shaman,restoration,6,1,5
36429,Shapaman,tichondrius,96,shaman,restoration,6,1,5
36430,Eyris,dathremar,96,shaman,restoration,6,1,5
36431,Erii,undermine,96,shaman,restoration,6,1,5
36432,Swinginwilly,barthilas,96,shaman,restoration,6,1,5
36433,Calicø,durotan,96,shaman,restoration,7,1,6
36434,Finark,tichondrius,96,shaman,restoration,7,1,6
36435,Akharis,frostmane,96,shaman,restoration,15,2,13
36436,Tinytiddies,chogall,96,shaman,restoration,12,1,11
36437,Njolmir,khazgoroth,96,shaman,restoration,12,1,11
36438,Meatlog,dalaran,96,shaman,restoration,12,1,11
36439,Hexpert,firetree,96,shaman,restoration,12,1,11
36440,Tehbeast,khadgar,96,shaman,restoration,12,1,11
36441,Latishas,alleria,96,shaman,restoration,18,1,17
36442,Okdopey,area-52,95,shaman,restoration,6,1,5
36443,Lupog,illidan,89,shaman,restoration,8,4,4
36444,Dirtyshammy,mugthol,79,shaman,restoration,11,1,10
36445,Totèm,tichondrius,64,shaman,restoration,4,1,3
36446,Annöying,ysera,42,shaman,restoration,6,2,4
36447,Applicable,tichondrius,42,shaman,restoration,9,2,7
36448,Shamining,illidan,31,shaman,restoration,2,1,1
36449,Snowtem,moonrunner,31,shaman,restoration,2,1,1
36450,Ttvozzyxy,tichondrius,2385,shaman,elemental,139,89,50
36451,Cashe,kiljaeden,2368,shaman,elemental,126,80,46
36452,Bronzer,tichondrius,2325,shaman,elemental,75,53,22
36453,Meatbeaterx,aggramar,2189,shaman,elemental,135,70,65
36454,Luhz,tichondrius,2187,shaman,elemental,113,60,53
36455,Thegloc,illidan,2168,shaman,elemental,59,36,23
36456,Crøwgød,tichondrius,2156,shaman,elemental,109,65,44
36457,Ranjeesh,frostmourne,2155,shaman,elemental,144,82,62
36458,Bøøgaa,proudmoore,2155,shaman,elemental,125,67,58
36459,Itzgucci,illidan,2143,shaman,elemental,80,46,34
36460,Jimmysporty,malganis,2135,shaman,elemental,84,43,41
36461,Jgmbs,dalaran,2134,shaman,elemental,106,64,42
36462,Axelsteel,illidan,2132,shaman,elemental,66,45,21
36463,Hitzz,malganis,2127,shaman,elemental,78,49,29
36464,Lardaz,darkspear,2118,shaman,elemental,60,37,23
36465,Benanderson,tichondrius,2111,shaman,elemental,110,61,49
36466,Bøulderfist,tichondrius,2108,shaman,elemental,60,37,23
36467,Shiggenbasta,tichondrius,2107,shaman,elemental,119,63,56
36468,Hexecute,tichondrius,2106,shaman,elemental,84,42,42
36469,Hollowbaby,tichondrius,2101,shaman,elemental,73,48,25
36470,Jeasham,malganis,2056,shaman,elemental,125,64,61
36471,Iavalash,bleeding-hollow,2044,shaman,elemental,178,89,89
36472,Bujii,frostmourne,2033,shaman,elemental,131,69,62
36473,Billycool,tichondrius,2032,shaman,elemental,60,38,22
36474,Tisaa,tichondrius,2025,shaman,elemental,66,32,34
36475,Dxxlol,tichondrius,2008,shaman,elemental,54,37,17
36476,Zipzsham,maiev,1989,shaman,elemental,63,48,15
36477,Trenzix,sargeras,1989,shaman,elemental,196,100,96
36478,Reckfulq,proudmoore,1986,shaman,elemental,137,84,53
36479,Yejinok,tichondrius,1969,shaman,elemental,102,53,49
36480,Emppege,tichondrius,1967,shaman,elemental,121,60,61
36481,Beyoncé,lethon,1966,shaman,elemental,54,32,22
36482,Kaandel,azralon,1961,shaman,elemental,138,66,72
36483,Chunchünmaru,area-52,1957,shaman,elemental,71,40,31
36484,Depression,baelgun,1948,shaman,elemental,78,49,29
36485,Bakenquake,tichondrius,1947,shaman,elemental,92,48,44
36486,Manofsand,drenden,1940,shaman,elemental,167,85,82
36487,Funuser,hellscream,1937,shaman,elemental,86,53,33
36488,Joedna,tichondrius,1933,shaman,elemental,94,48,46
36489,Kimkar,bleeding-hollow,1926,shaman,elemental,54,28,26
36490,Johnsju,sargeras,1926,shaman,elemental,93,48,45
36491,Foudre,malganis,1925,shaman,elemental,42,27,15
36492,Safeword,nesingwary,1919,shaman,elemental,74,42,32
36493,Sleepysham,kelthuzad,1910,shaman,elemental,108,59,49
36494,Geodude,executus,1909,shaman,elemental,53,33,20
36495,Zoeytur,sargeras,1905,shaman,elemental,60,31,29
36496,Scaman,tichondrius,1903,shaman,elemental,36,23,13
36497,Makazar,tichondrius,1901,shaman,elemental,42,26,16
36498,Ultron,deathwing,1890,shaman,elemental,143,74,69
36499,Molbeato,uldum,1888,shaman,elemental,102,51,51
36500,Hedeadxs,illidan,1882,shaman,elemental,60,30,30
36501,Bronzers,tichondrius,1879,shaman,elemental,42,25,17
36502,Matikz,boulderfist,1878,shaman,elemental,142,78,64
36503,Powerdown,blackrock,1878,shaman,elemental,65,32,33
36504,Tremordrfear,lightbringer,1877,shaman,elemental,30,20,10
36505,Orksham,tichondrius,1877,shaman,elemental,60,30,30
36506,Tyar,area-52,1876,shaman,elemental,45,31,14
36507,Blmqt,stormrage,1875,shaman,elemental,65,44,21
36508,Juicébox,tichondrius,1874,shaman,elemental,62,35,27
36509,Sasageyo,tichondrius,1873,shaman,elemental,93,51,42
36510,Cùìó,barthilas,1868,shaman,elemental,54,25,29
36511,Hexxás,bloodscalp,1865,shaman,elemental,45,27,18
36512,Fàlç,stormrage,1863,shaman,elemental,54,32,22
36513,Shockay,tichondrius,1861,shaman,elemental,56,30,26
36514,Gangmembr,illidan,1857,shaman,elemental,42,25,17
36515,Mazadu,malganis,1849,shaman,elemental,35,20,15
36516,Snookìe,sargeras,1846,shaman,elemental,82,38,44
36517,Hecstacy,dalaran,1842,shaman,elemental,66,42,24
36518,Shøckys,tichondrius,1839,shaman,elemental,54,22,32
36519,Illchayqt,frostmourne,1838,shaman,elemental,47,26,21
36520,Utilitytotem,moon-guard,1838,shaman,elemental,154,83,71
36521,Chemjenn,korgath,1838,shaman,elemental,84,37,47
36522,Saphlare,tichondrius,1836,shaman,elemental,36,22,14
36523,Zapmavz,area-52,1833,shaman,elemental,77,42,35
36524,Starmaker,malganis,1833,shaman,elemental,44,23,21
36525,Gaymakaí,sargeras,1828,shaman,elemental,48,27,21
36526,Zzarit,tichondrius,1825,shaman,elemental,48,24,24
36527,Donkeyteeth,bleeding-hollow,1822,shaman,elemental,72,43,29
36528,Magtark,frostwolf,1820,shaman,elemental,61,38,23
36529,Hotdogwaterx,tichondrius,1817,shaman,elemental,62,42,20
36530,Wangyinanmin,tichondrius,1812,shaman,elemental,30,19,11
36531,Mercs,frostmourne,1812,shaman,elemental,56,32,24
36532,Whameradetu,suramar,1809,shaman,elemental,80,38,42
36533,Elefusion,sargeras,1806,shaman,elemental,36,22,14
36534,Swigadee,tichondrius,1806,shaman,elemental,72,33,39
36535,Missedkick,tichondrius,1805,shaman,elemental,54,34,20
36536,Bismarks,frostmourne,1805,shaman,elemental,66,38,28
36537,Drazziqt,malganis,1803,shaman,elemental,45,27,18
36538,Nonomori,frostmourne,1802,shaman,elemental,48,30,18
36539,Torchic,drakkari,1801,shaman,elemental,60,31,29
36540,Monkeysham,dathremar,1800,shaman,elemental,48,30,18
36541,Elementàlius,quelthalas,1800,shaman,elemental,80,46,34
36542,Mackq,tichondrius,1800,shaman,elemental,103,54,49
36543,Scherzer,frostwolf,1800,shaman,elemental,90,42,48
36544,Skkarz,malganis,1790,shaman,elemental,89,51,38
36545,Meatyball,tichondrius,1786,shaman,elemental,59,38,21
36546,Vkzz,sargeras,1784,shaman,elemental,49,23,26
36547,Ralae,zuljin,1782,shaman,elemental,29,19,10
36548,Ñîmåbè,tichondrius,1780,shaman,elemental,30,19,11
36549,Ãmg,tichondrius,1779,shaman,elemental,36,24,12
36550,Molerat,illidan,1774,shaman,elemental,152,69,83
36551,Zqsyyds,illidan,1770,shaman,elemental,35,19,16
36552,Meatbeaterx,bleeding-hollow,1768,shaman,elemental,42,23,19
36553,Møp,spirestone,1766,shaman,elemental,66,39,27
36554,Hadèes,zuljin,1750,shaman,elemental,186,100,86
36555,Dampenedxx,bleeding-hollow,1749,shaman,elemental,121,66,55
36556,Brezel,azralon,1740,shaman,elemental,42,27,15
36557,Cepheí,bleeding-hollow,1740,shaman,elemental,59,30,29
36558,Hexistential,tichondrius,1731,shaman,elemental,34,26,8
36559,Uglymuger,tichondrius,1730,shaman,elemental,62,30,32
36560,Taranís,sargeras,1730,shaman,elemental,54,25,29
36561,Handzum,blades-edge,1728,shaman,elemental,54,28,26
36562,Sshaman,tichondrius,1728,shaman,elemental,58,26,32
36563,Däbü,tichondrius,1724,shaman,elemental,30,18,12
36564,Baddaboom,sargeras,1724,shaman,elemental,79,42,37
36565,Swiatek,ragnaros,1723,shaman,elemental,49,28,21
36566,Deckìn,proudmoore,1721,shaman,elemental,136,75,61
36567,Apyôn,tichondrius,1719,shaman,elemental,42,24,18
36568,Liquidmagma,deathwing,1711,shaman,elemental,100,50,50
36569,Ayumihamasai,tichondrius,1710,shaman,elemental,60,33,27
36570,Flüke,tichondrius,1704,shaman,elemental,54,31,23
36571,Notahappyone,area-52,1703,shaman,elemental,48,34,14
36572,Osev,stormrage,1703,shaman,elemental,36,21,15
36573,Carondes,proudmoore,1703,shaman,elemental,57,29,28
36574,Kustys,tichondrius,1699,shaman,elemental,30,18,12
36575,Mytotemisbig,lothar,1694,shaman,elemental,59,38,21
36576,Notbpage,burning-blade,1694,shaman,elemental,102,51,51
36577,Soyboyxxo,barthilas,1691,shaman,elemental,83,40,43
36578,Shockyshock,emerald-dream,1683,shaman,elemental,46,29,17
36579,Caserguy,sargeras,1683,shaman,elemental,58,24,34
36580,Enkix,drakkari,1681,shaman,elemental,42,23,19
36581,Cyhren,illidan,1679,shaman,elemental,54,33,21
36582,Gorjun,stormrage,1679,shaman,elemental,81,38,43
36583,Zugzugdogg,destromath,1674,shaman,elemental,42,23,19
36584,Zeroclue,area-52,1673,shaman,elemental,40,22,18
36585,Buffele,tichondrius,1672,shaman,elemental,42,18,24
36586,Jerkdaddy,aggramar,1668,shaman,elemental,30,19,11
36587,Buju,bleeding-hollow,1662,shaman,elemental,152,84,68
36588,Loxshox,gnomeregan,1661,shaman,elemental,228,118,110
36589,Sweatshock,frostmourne,1659,shaman,elemental,164,93,71
36590,Ptee,tichondrius,1659,shaman,elemental,39,22,17
36591,Illmental,kelthuzad,1658,shaman,elemental,85,44,41
36592,Kawj,eonar,1652,shaman,elemental,36,21,15
36593,Dyxlol,tichondrius,1652,shaman,elemental,56,25,31
36594,Thaelia,azgalor,1650,shaman,elemental,40,23,17
36595,Walabi,tichondrius,1649,shaman,elemental,50,22,28
36596,Gravygumdrop,tichondrius,1648,shaman,elemental,80,39,41
36597,Zeylhe,proudmoore,1647,shaman,elemental,54,26,28
36598,Hexzy,moon-guard,1645,shaman,elemental,47,23,24
36599,Smoketide,stormrage,1644,shaman,elemental,47,21,26
36600,Shockisha,sisters-of-elune,1644,shaman,elemental,52,23,29
36601,Shlmmyjimmy,tichondrius,1642,shaman,elemental,78,27,51
36602,Streetmeat,crushridge,1640,shaman,elemental,125,64,61
36603,Hüsky,dalaran,1637,shaman,elemental,41,21,20
36604,Triknolov,dalaran,1636,shaman,elemental,47,22,25
36605,Setò,quelthalas,1634,shaman,elemental,54,30,24
36606,Billydreams,drakkari,1634,shaman,elemental,123,59,64
36607,Illbuyurmom,tichondrius,1634,shaman,elemental,49,23,26
36608,Imnumberl,sargeras,1630,shaman,elemental,78,51,27
36609,Stormsage,jubeithos,1627,shaman,elemental,54,31,23
36610,Tenyks,tichondrius,1627,shaman,elemental,40,22,18
36611,Fiftybeers,frostmourne,1627,shaman,elemental,35,19,16
36612,Lff,stormrage,1626,shaman,elemental,24,17,7
36613,Shaymîn,malganis,1624,shaman,elemental,38,21,17
36614,Chandye,proudmoore,1620,shaman,elemental,48,22,26
36615,Fruityrudyy,area-52,1618,shaman,elemental,30,22,8
36616,Eimear,kelthuzad,1618,shaman,elemental,33,20,13
36617,Thunderfaker,tichondrius,1618,shaman,elemental,36,17,19
36618,Mulak,frostmourne,1616,shaman,elemental,110,54,56
36619,Duality,shattered-halls,1615,shaman,elemental,59,38,21
36620,Ryukims,tichondrius,1615,shaman,elemental,46,24,22
36621,Chajaa,ragnaros,1615,shaman,elemental,171,86,85
36622,Gangstà,stormrage,1611,shaman,elemental,66,30,36
36623,Nayro,bleeding-hollow,1610,shaman,elemental,30,20,10
36624,Orkuss,illidan,1609,shaman,elemental,29,19,10
36625,Thündermoose,tichondrius,1608,shaman,elemental,42,21,21
36626,Roxxiggom,aggramar,1605,shaman,elemental,24,19,5
36627,Taxd,sargeras,1605,shaman,elemental,40,21,19
36628,Sonire,tichondrius,1605,shaman,elemental,204,97,107
36629,Soo,kiljaeden,1605,shaman,elemental,84,39,45
36630,Jaimenohex,illidan,1603,shaman,elemental,36,19,17
36631,Nutty,dentarg,1602,shaman,elemental,42,24,18
36632,Tulol,tichondrius,1602,shaman,elemental,114,54,60
36633,Ssjgreen,illidan,1601,shaman,elemental,66,33,33
36634,Opaltsing,tichondrius,1601,shaman,elemental,39,19,20
36635,Daddykooll,tichondrius,1600,shaman,elemental,36,22,14
36636,Datbigthing,frostmourne,1596,shaman,elemental,60,24,36
36637,Igotu,tichondrius,1595,shaman,elemental,30,17,13
36638,Letronix,azralon,1595,shaman,elemental,65,29,36
36639,Honeybean,tichondrius,1591,shaman,elemental,96,50,46
36640,Squealer,sargeras,1587,shaman,elemental,86,42,44
36641,Zelthakaru,emerald-dream,1587,shaman,elemental,42,18,24
36642,Moodizzle,tichondrius,1585,shaman,elemental,66,36,30
36643,Imense,sargeras,1584,shaman,elemental,42,24,18
36644,Cornivore,malganis,1582,shaman,elemental,36,19,17
36645,Generators,area-52,1582,shaman,elemental,201,101,100
36646,Zap,wyrmrest-accord,1576,shaman,elemental,78,39,39
36647,ßævis,magtheridon,1572,shaman,elemental,24,17,7
36648,Óompaloompa,frostmourne,1570,shaman,elemental,42,25,17
36649,Topax,vashj,1568,shaman,elemental,35,21,14
36650,Indika,stormrage,1560,shaman,elemental,30,18,12
36651,Climhazard,senjin,1555,shaman,elemental,36,18,18
36652,Stitchis,black-dragonflight,1554,shaman,elemental,69,41,28
36653,Shellshocka,korgath,1554,shaman,elemental,38,20,18
36654,Dtab,tichondrius,1552,shaman,elemental,36,18,18
36655,Doodleburger,dathremar,1545,shaman,elemental,50,41,9
36656,Talonga,moon-guard,1544,shaman,elemental,48,21,27
36657,Drogues,tichondrius,1543,shaman,elemental,47,26,21
36658,Univearth,emerald-dream,1542,shaman,elemental,66,34,32
36659,Makocc,tichondrius,1541,shaman,elemental,73,39,34
36660,Borheals,tichondrius,1537,shaman,elemental,44,21,23
36661,Uglymugshock,tichondrius,1537,shaman,elemental,66,31,35
36662,Pikopiko,tichondrius,1535,shaman,elemental,24,16,8
36663,Ratson,ragnaros,1535,shaman,elemental,36,19,17
36664,Robot,illidan,1534,shaman,elemental,30,16,14
36665,Simada,tichondrius,1532,shaman,elemental,30,16,14
36666,Harrypotqueu,zuljin,1527,shaman,elemental,30,16,14
36667,Thundermatt,aegwynn,1525,shaman,elemental,81,39,42
36668,Heavyboxer,tichondrius,1524,shaman,elemental,78,37,41
36669,Caninius,sargeras,1521,shaman,elemental,30,16,14
36670,Draghul,frostwolf,1520,shaman,elemental,43,24,19
36671,Yasmiel,zuljin,1517,shaman,elemental,60,27,33
36672,Clapton,darkspear,1515,shaman,elemental,47,21,26
36673,Rss,barthilas,1507,shaman,elemental,47,25,22
36674,Kakaaroto,nemesis,1506,shaman,elemental,45,28,17
36675,Evilraven,tichondrius,1506,shaman,elemental,173,86,87
36676,Faygodream,illidan,1499,shaman,elemental,84,46,38
36677,Malosa,hyjal,1495,shaman,elemental,53,22,31
36678,Tunegrote,ragnaros,1492,shaman,elemental,60,31,29
36679,Keldinraz,stormrage,1492,shaman,elemental,48,22,26
36680,Cowish,illidan,1487,shaman,elemental,42,23,19
36681,Soulrak,tichondrius,1486,shaman,elemental,94,44,50
36682,Groundme,malganis,1484,shaman,elemental,29,16,13
36683,Huskër,tichondrius,1483,shaman,elemental,64,38,26
36684,Innvious,sargeras,1483,shaman,elemental,60,28,32
36685,Gloi,ragnaros,1481,shaman,elemental,31,19,12
36686,Tuntar,ragnaros,1479,shaman,elemental,132,69,63
36687,Defrout,kelthuzad,1469,shaman,elemental,68,32,36
36688,Gahaa,tichondrius,1464,shaman,elemental,23,16,7
36689,Joehogan,stormrage,1463,shaman,elemental,67,40,27
36690,Washedupty,illidan,1460,shaman,elemental,118,56,62
36691,Cavolt,stormrage,1459,shaman,elemental,41,21,20
36692,Drazzella,arthas,1445,shaman,elemental,41,19,22
36693,Lovesthegear,blackrock,1438,shaman,elemental,24,15,9
36694,Kumer,tichondrius,1436,shaman,elemental,34,19,15
36695,Biberom,kelthuzad,1434,shaman,elemental,57,32,25
36696,Nøir,drakkari,1432,shaman,elemental,48,20,28
36697,Pipesable,ragnaros,1430,shaman,elemental,24,15,9
36698,Smiteums,sargeras,1429,shaman,elemental,30,15,15
36699,Waterground,tichondrius,1428,shaman,elemental,31,16,15
36700,Saraguthix,dalaran,1427,shaman,elemental,60,27,33
36701,Earthclap,tichondrius,1427,shaman,elemental,39,16,23
36702,Zugzugthug,moon-guard,1426,shaman,elemental,107,58,49
36703,Cgq,tichondrius,1425,shaman,elemental,54,28,26
36704,Hazzathxy,tichondrius,1420,shaman,elemental,29,15,14
36705,Bramah,bonechewer,1420,shaman,elemental,36,16,20
36706,Snapstr,illidan,1419,shaman,elemental,36,15,21
36707,Hufflefluffs,kiljaeden,1418,shaman,elemental,38,23,15
36708,Scryerman,area-52,1418,shaman,elemental,30,16,14
36709,Blacklm,tichondrius,1413,shaman,elemental,24,15,9
36710,Plotious,antonidas,1413,shaman,elemental,36,19,17
36711,Dumpweed,stormscale,1413,shaman,elemental,42,21,21
36712,Gumballin,sargeras,1412,shaman,elemental,85,41,44
36713,Morluné,tichondrius,1407,shaman,elemental,54,26,28
36714,Baodan,azshara,1406,shaman,elemental,41,20,21
36715,Zappynips,frostmourne,1399,shaman,elemental,39,20,19
36716,Liloggie,illidan,1385,shaman,elemental,23,15,8
36717,Redlava,turalyon,1384,shaman,elemental,31,19,12
36718,Golozok,zuljin,1382,shaman,elemental,35,16,19
36719,Ceedlamb,kelthuzad,1381,shaman,elemental,66,34,32
36720,Shuñk,frostmourne,1376,shaman,elemental,60,27,33
36721,Chonkymilk,illidan,1373,shaman,elemental,44,18,26
36722,Luvstospooj,thaurissan,1372,shaman,elemental,73,34,39
36723,Zechary,proudmoore,1372,shaman,elemental,48,19,29
36724,Venekk,shattered-hand,1366,shaman,elemental,29,17,12
36725,Rythia,elune,1363,shaman,elemental,40,18,22
36726,Telain,quelthalas,1360,shaman,elemental,84,42,42
36727,Bycrax,ragnaros,1358,shaman,elemental,28,15,13
36728,Isekai,alterac-mountains,1357,shaman,elemental,171,82,89
36729,Boomsele,tichondrius,1356,shaman,elemental,19,15,4
36730,Pepîllo,ragnaros,1356,shaman,elemental,66,20,46
36731,Conductivity,frostmourne,1351,shaman,elemental,30,15,15
36732,Stormsanta,emerald-dream,1349,shaman,elemental,35,15,20
36733,Rinnobunen,wyrmrest-accord,1347,shaman,elemental,30,15,15
36734,Snewboii,malganis,1346,shaman,elemental,30,15,15
36735,Planetwaves,malganis,1344,shaman,elemental,18,14,4
36736,Spoonforkorc,thrall,1342,shaman,elemental,24,14,10
36737,Bagele,tichondrius,1342,shaman,elemental,30,14,16
36738,Hurky,sargeras,1340,shaman,elemental,85,43,42
36739,Oontuk,illidan,1337,shaman,elemental,66,31,35
36740,Laelyk,kiljaeden,1336,shaman,elemental,30,14,16
36741,Cocainbear,emerald-dream,1332,shaman,elemental,39,20,19
36742,Hengler,emerald-dream,1330,shaman,elemental,30,14,16
36743,Rolltìde,tichondrius,1328,shaman,elemental,129,72,57
36744,Totem,burning-legion,1327,shaman,elemental,24,14,10
36745,Mittss,sargeras,1324,shaman,elemental,88,45,43
36746,Sheriffbj,emerald-dream,1324,shaman,elemental,36,14,22
36747,Ekstasiel,azralon,1323,shaman,elemental,54,28,26
36748,Ragnards,ragnaros,1323,shaman,elemental,79,35,44
36749,Electriik,kiljaeden,1322,shaman,elemental,24,14,10
36750,Pipelord,destromath,1321,shaman,elemental,24,14,10
36751,Pacapinchhit,azgalor,1320,shaman,elemental,24,14,10
36752,Lenin,nathrezim,1316,shaman,elemental,62,24,38
36753,Endorovich,mannoroth,1309,shaman,elemental,30,14,16
36754,Vktr,drakkari,1306,shaman,elemental,40,17,23
36755,Tulnak,kelthuzad,1304,shaman,elemental,66,27,39
36756,Hueymagoo,firetree,1295,shaman,elemental,24,14,10
36757,Totempoke,frostmourne,1292,shaman,elemental,23,14,9
36758,Wfb,sargeras,1291,shaman,elemental,24,14,10
36759,Totemtown,darkspear,1286,shaman,elemental,60,28,32
36760,Afw,darkspear,1282,shaman,elemental,41,17,24
36761,Ffaísca,azralon,1279,shaman,elemental,38,19,19
36762,Shamanzinh,azralon,1262,shaman,elemental,36,19,17
36763,Sugirukifuja,stormrage,1258,shaman,elemental,23,16,7
36764,Baltharzhard,saurfang,1257,shaman,elemental,36,16,20
36765,Malrom,kelthuzad,1255,shaman,elemental,321,162,159
36766,Jaapo,barthilas,1255,shaman,elemental,86,42,44
36767,Everyst,darkspear,1253,shaman,elemental,35,20,15
36768,Moacmathi,quelthalas,1253,shaman,elemental,60,27,33
36769,Siò,barthilas,1247,shaman,elemental,15,14,1
36770,Glochaswon,illidan,1247,shaman,elemental,18,13,5
36771,Gambezee,kelthuzad,1247,shaman,elemental,30,13,17
36772,Jazuul,zuljin,1247,shaman,elemental,30,13,17
36773,Oldcregg,emerald-dream,1246,shaman,elemental,18,13,5
36774,Lugak,ragnaros,1245,shaman,elemental,41,15,26
36775,Clarix,quelthalas,1241,shaman,elemental,24,13,11
36776,Lezzer,ragnaros,1238,shaman,elemental,66,29,37
36777,Kkangsiki,tichondrius,1233,shaman,elemental,30,13,17
36778,Edenorion,ragnaros,1232,shaman,elemental,48,23,25
36779,Shampainn,demon-soul,1231,shaman,elemental,66,33,33
36780,Ectomee,tichondrius,1230,shaman,elemental,24,13,11
36781,Porkfririe,kelthuzad,1224,shaman,elemental,34,14,20
36782,Yasuriyamile,illidan,1222,shaman,elemental,82,36,46
36783,Chaposz,tichondrius,1221,shaman,elemental,30,13,17
36784,Nírnez,ragnaros,1220,shaman,elemental,42,14,28
36785,Engara,frostmane,1216,shaman,elemental,29,13,16
36786,Øten,area-52,1214,shaman,elemental,30,20,10
36787,Saulgudmon,area-52,1214,shaman,elemental,30,16,14
36788,Beerofdoom,proudmoore,1214,shaman,elemental,30,15,15
36789,Vulkuro,quelthalas,1214,shaman,elemental,30,13,17
36790,Seinnome,azralon,1213,shaman,elemental,31,14,17
36791,Mhaal,wyrmrest-accord,1213,shaman,elemental,106,42,64
36792,Yippeekiyay,zuluhed,1212,shaman,elemental,33,14,19
36793,Amonita,stonemaul,1210,shaman,elemental,18,13,5
36794,Grezzkall,malganis,1207,shaman,elemental,39,19,20
36795,Syile,stormrage,1206,shaman,elemental,26,14,12
36796,Omegaman,lightninghoof,1204,shaman,elemental,69,35,34
36797,Rafiki,haomarush,1198,shaman,elemental,48,19,29
36798,Kanasya,quelthalas,1197,shaman,elemental,36,14,22
36799,Alphamael,lightbringer,1195,shaman,elemental,41,21,20
36800,Forgediniron,stormrage,1195,shaman,elemental,36,17,19
36801,Hansolorz,tichondrius,1195,shaman,elemental,36,13,23
36802,Hurìon,coilfang,1192,shaman,elemental,20,14,6
36803,Synerggy,hakkar,1185,shaman,elemental,128,63,65
36804,Eze,tichondrius,1182,shaman,elemental,34,20,14
36805,Bazinguinha,azralon,1170,shaman,elemental,48,21,27
36806,Srbski,emerald-dream,1167,shaman,elemental,26,13,13
36807,Zhokal,quelthalas,1166,shaman,elemental,125,65,60
36808,Cptnmagma,bleeding-hollow,1162,shaman,elemental,124,57,67
36809,Jaycobb,area-52,1159,shaman,elemental,30,13,17
36810,Firecracker,warsong,1158,shaman,elemental,76,42,34
36811,Zugdabou,bonechewer,1155,shaman,elemental,66,30,36
36812,Bovinebeauty,tichondrius,1152,shaman,elemental,18,12,6
36813,Kebboz,frostmourne,1152,shaman,elemental,18,12,6
36814,Dràgoon,thrall,1152,shaman,elemental,18,12,6
36815,Pasto,bleeding-hollow,1152,shaman,elemental,18,12,6
36816,Nanosec,tichondrius,1152,shaman,elemental,22,13,9
36817,Krupto,tichondrius,1151,shaman,elemental,24,12,12
36818,Minigible,tichondrius,1151,shaman,elemental,30,12,18
36819,Kang,terenas,1150,shaman,elemental,18,12,6
36820,Poonqtx,frostmourne,1149,shaman,elemental,18,12,6
36821,Enhancers,sargeras,1144,shaman,elemental,24,12,12
36822,Kowabounga,ragnaros,1140,shaman,elemental,24,12,12
36823,Thunderblood,nerzhul,1138,shaman,elemental,24,12,12
36824,Muggs,cairne,1137,shaman,elemental,18,12,6
36825,Nuggitz,tichondrius,1136,shaman,elemental,31,20,11
36826,Ayahuaskah,illidan,1132,shaman,elemental,25,12,13
36827,Üchihamadarâ,tichondrius,1132,shaman,elemental,33,13,20
36828,Yodahh,daggerspine,1131,shaman,elemental,27,15,12
36829,Exoticz,barthilas,1131,shaman,elemental,38,12,26
36830,Johnwilke,area-52,1123,shaman,elemental,43,17,26
36831,Bravederp,kelthuzad,1120,shaman,elemental,63,31,32
36832,Karashamy,ragnaros,1114,shaman,elemental,65,31,34
36833,Skwiglz,tichondrius,1113,shaman,elemental,90,44,46
36834,Shockazulu,vashj,1109,shaman,elemental,42,22,20
36835,Afgoox,tichondrius,1105,shaman,elemental,36,24,12
36836,Shamarock,stonemaul,1103,shaman,elemental,42,23,19
36837,Xoelement,borean-tundra,1103,shaman,elemental,54,25,29
36838,Yunow,ragnaros,1096,shaman,elemental,48,20,28
36839,Shadowowl,tanaris,1085,shaman,elemental,27,12,15
36840,Omnath,zuluhed,1083,shaman,elemental,35,19,16
36841,Zappz,thunderlord,1082,shaman,elemental,60,34,26
36842,Shammpain,barthilas,1072,shaman,elemental,53,28,25
36843,Semasham,khazgoroth,1068,shaman,elemental,25,12,13
36844,Bestshamus,sargeras,1056,shaman,elemental,18,11,7
36845,Petrafk,illidan,1056,shaman,elemental,18,11,7
36846,Redpocket,zuluhed,1056,shaman,elemental,18,11,7
36847,Xpire,ragnaros,1056,shaman,elemental,18,11,7
36848,Palcyon,eonar,1056,shaman,elemental,18,11,7
36849,Miroen,tichondrius,1056,shaman,elemental,24,11,13
36850,Pubechin,jubeithos,1056,shaman,elemental,24,11,13
36851,Highsteakss,tichondrius,1055,shaman,elemental,12,11,1
36852,Smooths,bloodscalp,1055,shaman,elemental,18,11,7
36853,Ndndurkadurk,malganis,1055,shaman,elemental,18,11,7
36854,Bootietootie,bleeding-hollow,1055,shaman,elemental,18,11,7
36855,Kymo,tichondrius,1055,shaman,elemental,18,11,7
36856,Thuntard,bleeding-hollow,1055,shaman,elemental,24,11,13
36857,Ayetex,kelthuzad,1054,shaman,elemental,18,11,7
36858,Kigoros,bleeding-hollow,1054,shaman,elemental,18,11,7
36859,Sumnah,sargeras,1054,shaman,elemental,42,22,20
36860,Blastuh,kiljaeden,1053,shaman,elemental,18,11,7
36861,Dwarfdude,gorefiend,1051,shaman,elemental,16,12,4
36862,Madmartiggen,scilla,1051,shaman,elemental,21,12,9
36863,Ôprawindfury,mugthol,1050,shaman,elemental,18,11,7
36864,Taeilendar,ragnaros,1050,shaman,elemental,24,11,13
36865,Nazz,cenarion-circle,1048,shaman,elemental,18,11,7
36866,Metlar,sargeras,1048,shaman,elemental,24,11,13
36867,Shamans,zuljin,1047,shaman,elemental,18,11,7
36868,Darizzler,bleeding-hollow,1047,shaman,elemental,18,11,7
36869,Luxenor,kelthuzad,1046,shaman,elemental,18,11,7
36870,Minzysm,illidan,1045,shaman,elemental,24,11,13
36871,Bonevykin,area-52,1044,shaman,elemental,21,12,9
36872,Enflexi,lightbringer,1044,shaman,elemental,24,11,13
36873,Darkrock,echo-isles,1033,shaman,elemental,24,12,12
36874,Rollypolli,gnomeregan,1022,shaman,elemental,72,36,36
36875,Olani,nesingwary,1022,shaman,elemental,38,12,26
36876,Treesntotemz,darkspear,1020,shaman,elemental,18,11,7
36877,Geladoo,gallywix,1008,shaman,elemental,68,29,39
36878,Mîkâ,area-52,1007,shaman,elemental,24,11,13
36879,Wälee,sargeras,1004,shaman,elemental,77,37,40
36880,Shambix,illidan,1002,shaman,elemental,19,12,7
36881,Dizzytotem,dalaran,991,shaman,elemental,24,11,13
36882,Rodbert,sargeras,990,shaman,elemental,20,11,9
36883,Cheweydadawg,shandris,990,shaman,elemental,23,11,12
36884,Soartotes,sargeras,987,shaman,elemental,22,11,11
36885,Shamanic,dunemaul,984,shaman,elemental,83,31,52
36886,Bronan,laughing-skull,976,shaman,elemental,54,20,34
36887,Mistayl,bleeding-hollow,968,shaman,elemental,30,12,18
36888,Destroçadorx,azralon,961,shaman,elemental,26,11,15
36889,Asanako,illidan,961,shaman,elemental,64,26,38
36890,Graveshocks,illidan,960,shaman,elemental,12,10,2
36891,Smrtdeath,zuljin,960,shaman,elemental,12,10,2
36892,Dewoverload,garithos,960,shaman,elemental,12,10,2
36893,Smeagles,ragnaros,960,shaman,elemental,18,10,8
36894,Hydroponicz,sargeras,960,shaman,elemental,18,10,8
36895,Ryanxo,azjolnerub,960,shaman,elemental,18,10,8
36896,Àspect,aegwynn,960,shaman,elemental,18,10,8
36897,Folus,azjolnerub,960,shaman,elemental,18,10,8
36898,Bigdaddyion,thrall,960,shaman,elemental,18,10,8
36899,Deathblasts,zuljin,960,shaman,elemental,30,10,20
36900,Everspell,lightnings-blade,959,shaman,elemental,18,10,8
36901,Hexoffend,zuljin,959,shaman,elemental,18,10,8
36902,Tawambji,kiljaeden,959,shaman,elemental,18,10,8
36903,Kodyaj,illidan,959,shaman,elemental,18,10,8
36904,Tidalstorm,thrall,959,shaman,elemental,18,10,8
36905,Feetfungus,area-52,959,shaman,elemental,24,10,14
36906,Ehhmacros,doomhammer,959,shaman,elemental,24,10,14
36907,Aingry,darkspear,958,shaman,elemental,18,10,8
36908,Arukz,tichondrius,958,shaman,elemental,24,10,14
36909,Korlog,tichondrius,957,shaman,elemental,12,10,2
36910,Moartotems,kelthuzad,957,shaman,elemental,12,10,2
36911,Gerrkiing,amanthul,957,shaman,elemental,18,10,8
36912,Xakaeri,hyjal,957,shaman,elemental,18,10,8
36913,Charabon,ragnaros,957,shaman,elemental,18,10,8
36914,Richode,burning-legion,956,shaman,elemental,18,10,8
36915,Shockshammy,kiljaeden,956,shaman,elemental,18,10,8
36916,Sanlu,tichondrius,955,shaman,elemental,65,30,35
36917,Tinkd,stormrage,953,shaman,elemental,18,10,8
36918,Izreborn,tichondrius,953,shaman,elemental,24,10,14
36919,Discokid,norgannon,951,shaman,elemental,24,10,14
36920,Tuksha,alleria,951,shaman,elemental,30,10,20
36921,Saanrixa,jubeithos,946,shaman,elemental,84,29,55
36922,Proignite,drakthul,934,shaman,elemental,35,17,18
36923,Lavablaster,kelthuzad,932,shaman,elemental,12,10,2
36924,Gorron,frostwolf,929,shaman,elemental,24,10,14
36925,Dooman,area-52,927,shaman,elemental,30,10,20
36926,Bulljay,bleeding-hollow,910,shaman,elemental,21,11,10
36927,Bushdeedit,stormrage,910,shaman,elemental,23,10,13
36928,Aragog,malygos,899,shaman,elemental,32,16,16
36929,Threehandz,bleeding-hollow,886,shaman,elemental,55,20,35
36930,Trilz,barthilas,880,shaman,elemental,19,10,9
36931,Jer,tichondrius,864,shaman,elemental,12,9,3
36932,Koalatricks,shadow-council,864,shaman,elemental,12,9,3
36933,Notragii,kelthuzad,864,shaman,elemental,12,9,3
36934,Helga,hellscream,864,shaman,elemental,12,9,3
36935,Bikáchu,tichondrius,864,shaman,elemental,12,9,3
36936,Zuescannon,kelthuzad,864,shaman,elemental,18,9,9
36937,Shockjob,frostmourne,864,shaman,elemental,18,9,9
36938,Councilman,illidan,864,shaman,elemental,18,9,9
36939,Exceedër,ragnaros,864,shaman,elemental,18,9,9
36940,Kilydily,destromath,864,shaman,elemental,18,9,9
36941,Owtyobwol,area-52,864,shaman,elemental,18,9,9
36942,Doorti,area-52,864,shaman,elemental,18,9,9
36943,Ðomzy,tichondrius,863,shaman,elemental,12,9,3
36944,Earthfirex,ragnaros,863,shaman,elemental,18,9,9
36945,Blöw,tichondrius,863,shaman,elemental,18,9,9
36946,Poseidon,kiljaeden,863,shaman,elemental,18,9,9
36947,Onnyx,proudmoore,863,shaman,elemental,18,9,9
36948,Hexellént,kiljaeden,863,shaman,elemental,18,9,9
36949,Skyten,quelthalas,863,shaman,elemental,21,10,11
36950,Dtrumpx,tichondrius,863,shaman,elemental,24,9,15
36951,Thaél,proudmoore,863,shaman,elemental,24,9,15
36952,Dehsaw,illidan,863,shaman,elemental,24,9,15
36953,Xodeus,frostmourne,863,shaman,elemental,24,9,15
36954,Tottemic,blackrock,862,shaman,elemental,18,9,9
36955,Phagocytosis,illidan,861,shaman,elemental,18,9,9
36956,Cónò,tichondrius,861,shaman,elemental,18,9,9
36957,Grandwolf,ragnaros,861,shaman,elemental,18,9,9
36958,Jensenx,proudmoore,861,shaman,elemental,24,9,15
36959,Grukall,galakrond,860,shaman,elemental,12,9,3
36960,Galabanjø,malganis,860,shaman,elemental,24,9,15
36961,Lilmollet,tichondrius,859,shaman,elemental,18,9,9
36962,Velekar,moon-guard,858,shaman,elemental,24,9,15
36963,Gorakh,illidan,856,shaman,elemental,18,9,9
36964,Battleshammy,nagrand,854,shaman,elemental,24,9,15
36965,Dellnar,nagrand,847,shaman,elemental,18,9,9
36966,Tideborn,azralon,845,shaman,elemental,22,10,12
36967,Daiskei,nordrassil,838,shaman,elemental,18,9,9
36968,Justballs,stormscale,835,shaman,elemental,18,9,9
36969,Shàmpow,darkspear,823,shaman,elemental,17,9,8
36970,Vegaslights,tichondrius,816,shaman,elemental,21,9,12
36971,Thanwirn,ragnaros,809,shaman,elemental,24,9,15
36972,Relâx,icecrown,779,shaman,elemental,19,9,10
36973,Xammaa,illidan,768,shaman,elemental,12,8,4
36974,Squidzy,tichondrius,768,shaman,elemental,12,8,4
36975,Biggiechief,illidan,768,shaman,elemental,12,8,4
36976,Coffinpls,illidan,768,shaman,elemental,12,8,4
36977,Genesisz,tichondrius,768,shaman,elemental,12,8,4
36978,Morabebi,tichondrius,768,shaman,elemental,12,8,4
36979,Supbrø,zuluhed,768,shaman,elemental,12,8,4
36980,Bagovs,tichondrius,768,shaman,elemental,12,8,4
36981,Shocksrus,arthas,768,shaman,elemental,18,8,10
36982,Storminlorka,sargeras,768,shaman,elemental,18,8,10
36983,Scrymax,area-52,768,shaman,elemental,18,8,10
36984,Ieeguen,tichondrius,768,shaman,elemental,18,8,10
36985,Graymatterz,ysondre,767,shaman,elemental,12,8,4
36986,Shockerfist,thunderlord,767,shaman,elemental,12,8,4
36987,Tierrox,tichondrius,767,shaman,elemental,12,8,4
36988,Strugs,area-52,767,shaman,elemental,12,8,4
36989,Momothewolf,malganis,767,shaman,elemental,12,8,4
36990,Mazdamundï,ragnaros,767,shaman,elemental,24,8,16
36991,Krimzs,executus,767,shaman,elemental,24,8,16
36992,Fênrisulfer,area-52,766,shaman,elemental,18,8,10
36993,Cheddatotz,illidan,764,shaman,elemental,12,8,4
36994,Pãníç,bladefist,764,shaman,elemental,18,8,10
36995,Toho,ragnaros,764,shaman,elemental,18,8,10
36996,Maldini,tol-barad,764,shaman,elemental,18,8,10
36997,Neebon,jubeithos,763,shaman,elemental,12,8,4
36998,Shachone,zuljin,763,shaman,elemental,18,8,10
36999,Shammany,stormrage,763,shaman,elemental,18,8,10
37000,Teekona,tichondrius,763,shaman,elemental,18,8,10
37001,Lowiqpleb,tichondrius,719,shaman,elemental,17,8,9
37002,Pileef,thrall,704,shaman,elemental,10,8,2
37003,Dmt,exodar,704,shaman,elemental,22,8,14
37004,Fwwrs,illidan,703,shaman,elemental,14,8,6
37005,Makogo,earthen-ring,686,shaman,elemental,13,8,5
37006,Afri,tichondrius,672,shaman,elemental,10,8,2
37007,Xinz,guldan,672,shaman,elemental,12,7,5
37008,Willy,icecrown,672,shaman,elemental,12,7,5
37009,Merkal,illidan,672,shaman,elemental,12,7,5
37010,Glizzyjamon,sargeras,672,shaman,elemental,12,7,5
37011,Thoraq,bleeding-hollow,672,shaman,elemental,12,7,5
37012,Shocks,alleria,672,shaman,elemental,12,7,5
37013,Tatespeech,barthilas,672,shaman,elemental,12,7,5
37014,Cuban,kelthuzad,672,shaman,elemental,12,7,5
37015,Pericazo,sargeras,672,shaman,elemental,12,7,5
37016,Shambergler,tichondrius,672,shaman,elemental,12,7,5
37017,Humorlava,tichondrius,672,shaman,elemental,12,7,5
37018,Chazzwozza,area-52,672,shaman,elemental,12,7,5
37019,Ðøææøð,stormrage,672,shaman,elemental,12,7,5
37020,Totemzie,illidan,672,shaman,elemental,12,7,5
37021,Mesdew,tichondrius,672,shaman,elemental,12,7,5
37022,Drmeatballmd,tichondrius,672,shaman,elemental,12,7,5
37023,Rahkarg,korgath,672,shaman,elemental,12,7,5
37024,Eravas,thrall,672,shaman,elemental,18,7,11
37025,Alwaysbulkin,tichondrius,672,shaman,elemental,18,7,11
37026,Shamigo,tichondrius,672,shaman,elemental,18,7,11
37027,Tampíco,ragnaros,672,shaman,elemental,18,7,11
37028,Zò,zuljin,672,shaman,elemental,18,7,11
37029,Lovebody,zuljin,672,shaman,elemental,18,7,11
37030,Neotrad,proudmoore,672,shaman,elemental,18,7,11
37031,Desdìnova,tortheldrin,672,shaman,elemental,18,7,11
37032,Pozcaster,tichondrius,672,shaman,elemental,24,7,17
37033,Dansham,zuljin,672,shaman,elemental,24,7,17
37034,Lenå,moon-guard,671,shaman,elemental,12,7,5
37035,Hairyrichard,zuljin,671,shaman,elemental,12,7,5
37036,Lilthrall,skullcrusher,671,shaman,elemental,12,7,5
37037,Jacori,malganis,671,shaman,elemental,12,7,5
37038,Bigway,area-52,671,shaman,elemental,18,7,11
37039,Xantoor,area-52,670,shaman,elemental,12,7,5
37040,Alariaa,sargeras,670,shaman,elemental,12,7,5
37041,Neukims,nemesis,670,shaman,elemental,20,7,13
37042,Grimlên,skullcrusher,669,shaman,elemental,18,7,11
37043,Madeleines,goldrinn,667,shaman,elemental,12,7,5
37044,Phuamya,dalaran,667,shaman,elemental,12,7,5
37045,Jyster,area-52,664,shaman,elemental,24,7,17
37046,Piloncho,ragnaros,660,shaman,elemental,30,7,23
37047,Cardanø,illidan,652,shaman,elemental,29,7,22
37048,Cheesewheelz,arthas,651,shaman,elemental,22,7,15
37049,Aestheticsx,thrall,640,shaman,elemental,16,7,9
37050,Megalithic,moon-guard,639,shaman,elemental,14,8,6
37051,Koongram,area-52,623,shaman,elemental,11,7,4
37052,Shizzänk,illidan,606,shaman,elemental,11,7,4
37053,Adutchcowboy,tichondrius,576,shaman,elemental,6,6,0
37054,Notsock,zuljin,576,shaman,elemental,6,6,0
37055,Boltadeez,tichondrius,576,shaman,elemental,6,6,0
37056,Kasparøv,tichondrius,576,shaman,elemental,6,6,0
37057,Orkshammy,illidan,576,shaman,elemental,12,6,6
37058,Deyodin,illidan,576,shaman,elemental,12,6,6
37059,Mistysham,illidan,576,shaman,elemental,12,6,6
37060,Jeffspicele,emerald-dream,576,shaman,elemental,12,6,6
37061,Doommjölnir,sargeras,576,shaman,elemental,12,6,6
37062,Chenjiawei,tichondrius,576,shaman,elemental,12,6,6
37063,Jnzz,area-52,576,shaman,elemental,12,6,6
37064,Darkcharles,illidan,576,shaman,elemental,12,6,6
37065,Rubmytotêm,tichondrius,576,shaman,elemental,12,6,6
37066,Rahtal,malganis,576,shaman,elemental,12,6,6
37067,Getwetand,quelthalas,576,shaman,elemental,12,6,6
37068,Zynt,illidan,576,shaman,elemental,12,6,6
37069,Mcgraff,frostmourne,576,shaman,elemental,12,6,6
37070,Finark,tichondrius,576,shaman,elemental,12,6,6
37071,Bustinbooty,kiljaeden,576,shaman,elemental,12,6,6
37072,Littz,malganis,576,shaman,elemental,12,6,6
37073,Traindablue,illidan,576,shaman,elemental,12,6,6
37074,Fuseillar,illidan,576,shaman,elemental,12,6,6
37075,Deeznuts,the-forgotten-coast,576,shaman,elemental,12,6,6
37076,Zlateral,malganis,576,shaman,elemental,12,6,6
37077,Tairen,ragnaros,576,shaman,elemental,12,6,6
37078,Mugumbo,frostmourne,576,shaman,elemental,13,6,7
37079,Bitamin,frostmourne,576,shaman,elemental,18,6,12
37080,Vixeen,kelthuzad,576,shaman,elemental,18,6,12
37081,Adesaa,illidan,576,shaman,elemental,18,6,12
37082,Cowtidetotem,thrall,576,shaman,elemental,18,6,12
37083,Withinfinity,stormrage,576,shaman,elemental,18,6,12
37084,Drewshammy,zuljin,575,shaman,elemental,12,6,6
37085,Nemei,zuljin,575,shaman,elemental,12,6,6
37086,Drzhong,frostmourne,575,shaman,elemental,12,6,6
37087,Deggle,frostwolf,575,shaman,elemental,12,6,6
37088,Moctezumma,area-52,575,shaman,elemental,12,6,6
37089,Nuofu,illidan,575,shaman,elemental,12,6,6
37090,Shøckolate,magtheridon,575,shaman,elemental,12,6,6
37091,Skribblez,tichondrius,575,shaman,elemental,12,6,6
37092,Procdepartme,area-52,575,shaman,elemental,12,6,6
37093,Apocalypsehb,quelthalas,575,shaman,elemental,12,6,6
37094,Grimitt,suramar,575,shaman,elemental,18,6,12
37095,Nomahuata,cenarion-circle,575,shaman,elemental,18,6,12
37096,Chanintotem,shattered-halls,574,shaman,elemental,12,6,6
37097,Axelrose,ragnaros,574,shaman,elemental,12,6,6
37098,Budgetseaan,stormrage,574,shaman,elemental,12,6,6
37099,Coffee,mugthol,574,shaman,elemental,18,6,12
37100,Bcs,lightbringer,573,shaman,elemental,12,6,6
37101,Nezzuk,quelthalas,573,shaman,elemental,12,6,6
37102,Thuggliife,frostmourne,573,shaman,elemental,18,6,12
37103,Totempaul,frostmourne,570,shaman,elemental,18,6,12
37104,Ryudark,stormrage,569,shaman,elemental,24,6,18
37105,Asy,tichondrius,559,shaman,elemental,11,6,5
37106,Aitex,kelthuzad,543,shaman,elemental,15,7,8
37107,Thanen,the-scryers,541,shaman,elemental,16,6,10
37108,Sarahfe,wyrmrest-accord,527,shaman,elemental,11,6,5
37109,Zerium,nemesis,526,shaman,elemental,21,7,14
37110,Aseew,drakkari,522,shaman,elemental,21,9,12
37111,Maxchamo,ragnaros,522,shaman,elemental,25,7,18
37112,Riptideafk,sargeras,480,shaman,elemental,6,5,1
37113,Axaxaxaxaxax,illidan,480,shaman,elemental,6,5,1
37114,Feuerbart,dalaran,480,shaman,elemental,6,5,1
37115,Farku,illidan,480,shaman,elemental,6,5,1
37116,Shamxrob,sargeras,480,shaman,elemental,6,5,1
37117,Meatballsx,tichondrius,480,shaman,elemental,6,5,1
37118,Josiahsham,kelthuzad,480,shaman,elemental,6,5,1
37119,Shoxz,korgath,480,shaman,elemental,6,5,1
37120,Spaceghost,illidan,480,shaman,elemental,6,5,1
37121,Dook,ghostlands,480,shaman,elemental,6,5,1
37122,Shinydiglett,area-52,480,shaman,elemental,6,5,1
37123,Vulcansh,azralon,480,shaman,elemental,6,5,1
37124,Totems,the-underbog,480,shaman,elemental,6,5,1
37125,PlayerHLFJNY,moon-guard,480,shaman,elemental,6,5,1
37126,Sxr,moon-guard,480,shaman,elemental,6,5,1
37127,Windfurygød,tichondrius,480,shaman,elemental,7,5,2
37128,Firedchips,tichondrius,480,shaman,elemental,17,8,9
37129,Jaedrick,chogall,480,shaman,elemental,12,5,7
37130,Mariarlee,proudmoore,480,shaman,elemental,12,5,7
37131,Drakhe,proudmoore,480,shaman,elemental,12,5,7
37132,Groundfaults,bleeding-hollow,480,shaman,elemental,12,5,7
37133,Zeebouzy,illidan,480,shaman,elemental,12,5,7
37134,Junkygreens,proudmoore,480,shaman,elemental,12,5,7
37135,Zajashuna,malganis,480,shaman,elemental,12,5,7
37136,Delement,ragnaros,480,shaman,elemental,12,5,7
37137,Kissmywalnut,frostmourne,480,shaman,elemental,12,5,7
37138,Boodissy,tichondrius,480,shaman,elemental,12,5,7
37139,Vashidda,stormrage,480,shaman,elemental,12,5,7
37140,Wobbleshock,tichondrius,480,shaman,elemental,12,5,7
37141,Chomolungma,azralon,480,shaman,elemental,12,5,7
37142,Daerönn,azralon,480,shaman,elemental,12,5,7
37143,Conjury,tichondrius,480,shaman,elemental,12,5,7
37144,Slumpinator,tichondrius,480,shaman,elemental,12,5,7
37145,Stayz,tichondrius,480,shaman,elemental,12,5,7
37146,Gjaj,tichondrius,480,shaman,elemental,12,5,7
37147,Shamberheard,kelthuzad,480,shaman,elemental,12,5,7
37148,Ferdi,kelthuzad,480,shaman,elemental,12,5,7
37149,Twistedteas,tichondrius,480,shaman,elemental,12,5,7
37150,Eluulne,silvermoon,480,shaman,elemental,12,5,7
37151,Jènova,whisperwind,480,shaman,elemental,12,5,7
37152,Rokogg,thrall,480,shaman,elemental,12,5,7
37153,Flamestrife,illidan,480,shaman,elemental,12,5,7
37154,Sgorr,illidan,480,shaman,elemental,12,5,7
37155,Totemchucker,stormrage,480,shaman,elemental,15,6,9
37156,Dwârf,tichondrius,480,shaman,elemental,18,5,13
37157,Firesurge,sargeras,480,shaman,elemental,18,5,13
37158,Helapoon,area-52,480,shaman,elemental,18,5,13
37159,Arialial,hyjal,480,shaman,elemental,18,5,13
37160,Advìl,area-52,480,shaman,elemental,18,5,13
37161,Killdeaderer,barthilas,479,shaman,elemental,6,5,1
37162,Shanão,nemesis,479,shaman,elemental,6,5,1
37163,Aeromarius,ragnaros,479,shaman,elemental,9,6,3
37164,Ðarkvolts,stormrage,479,shaman,elemental,12,5,7
37165,Sparkyy,kelthuzad,479,shaman,elemental,12,5,7
37166,Bigrider,nemesis,479,shaman,elemental,12,5,7
37167,Doughboy,khadgar,478,shaman,elemental,14,6,8
37168,Talraviebor,stormrage,478,shaman,elemental,12,5,7
37169,Diokles,skywall,478,shaman,elemental,12,5,7
37170,Totemsmacker,quelthalas,447,shaman,elemental,17,5,12
37171,Novajersey,azralon,432,shaman,elemental,9,6,3
37172,Kinjin,dragonmaw,415,shaman,elemental,14,5,9
37173,Ripklanian,blood-furnace,400,shaman,elemental,13,5,8
37174,Kromdag,dalaran,384,shaman,elemental,6,4,2
37175,Trickyjf,dalaran,384,shaman,elemental,6,4,2
37176,Zappithorus,stormrage,384,shaman,elemental,6,4,2
37177,Zenan,stormreaver,384,shaman,elemental,6,4,2
37178,Lukora,stonemaul,384,shaman,elemental,6,4,2
37179,Nyroh,zuljin,384,shaman,elemental,6,4,2
37180,Brickzilla,dalaran,384,shaman,elemental,6,4,2
37181,Jimmyapple,illidan,384,shaman,elemental,6,4,2
37182,Thorlottie,stormrage,384,shaman,elemental,6,4,2
37183,Dgshaman,tichondrius,384,shaman,elemental,6,4,2
37184,Oscarmike,auchindoun,384,shaman,elemental,6,4,2
37185,Greensween,thrall,384,shaman,elemental,6,4,2
37186,Badandbooshi,stormreaver,384,shaman,elemental,6,4,2
37187,Borgmash,chogall,384,shaman,elemental,6,4,2
37188,Muffïn,moon-guard,384,shaman,elemental,6,4,2
37189,Olboy,thrall,384,shaman,elemental,6,4,2
37190,Novoz,tichondrius,384,shaman,elemental,6,4,2
37191,Dromus,dalvengyr,384,shaman,elemental,6,4,2
37192,Coldbeer,frostmourne,384,shaman,elemental,6,4,2
37193,Cduck,zuljin,384,shaman,elemental,6,4,2
37194,Jashar,spinebreaker,384,shaman,elemental,6,4,2
37195,Munchies,madoran,384,shaman,elemental,6,4,2
37196,Boogiefever,area-52,384,shaman,elemental,6,4,2
37197,Oukami,area-52,384,shaman,elemental,6,4,2
37198,Seraøth,area-52,384,shaman,elemental,6,4,2
37199,Simped,bleeding-hollow,384,shaman,elemental,6,4,2
37200,Lasso,shattered-hand,384,shaman,elemental,6,4,2
37201,Aishel,area-52,384,shaman,elemental,6,4,2
37202,Blueku,tichondrius,384,shaman,elemental,6,4,2
37203,Beibeihangh,tichondrius,384,shaman,elemental,6,4,2
37204,Creativemind,ragnaros,384,shaman,elemental,6,4,2
37205,Madelements,tichondrius,384,shaman,elemental,6,4,2
37206,Hulan,tichondrius,384,shaman,elemental,6,4,2
37207,Dingfu,sargeras,384,shaman,elemental,6,4,2
37208,Checkmâte,emerald-dream,384,shaman,elemental,6,4,2
37209,Shammyqua,tichondrius,384,shaman,elemental,6,4,2
37210,Ruugo,malganis,384,shaman,elemental,6,4,2
37211,Thandius,arygos,384,shaman,elemental,6,4,2
37212,Weebdestroyr,illidan,384,shaman,elemental,6,4,2
37213,Elebro,emerald-dream,384,shaman,elemental,6,4,2
37214,Yshi,kelthuzad,384,shaman,elemental,6,4,2
37215,Clamson,tichondrius,384,shaman,elemental,6,4,2
37216,Zezlek,malganis,384,shaman,elemental,6,4,2
37217,Dragaru,illidan,384,shaman,elemental,6,4,2
37218,Kranif,tichondrius,384,shaman,elemental,6,4,2
37219,Wodgodx,sargeras,384,shaman,elemental,6,4,2
37220,Vodord,arathor,384,shaman,elemental,6,4,2
37221,Ktom,runetotem,384,shaman,elemental,6,4,2
37222,Sheman,galakrond,384,shaman,elemental,7,4,3
37223,Super,azshara,384,shaman,elemental,14,5,9
37224,Sjostrom,proudmoore,384,shaman,elemental,12,4,8
37225,Jhivone,tichondrius,384,shaman,elemental,12,4,8
37226,Ayatsu,thrall,384,shaman,elemental,12,4,8
37227,Sin,bleeding-hollow,384,shaman,elemental,12,4,8
37228,Shrektar,cenarius,384,shaman,elemental,12,4,8
37229,Manitbaggins,earthen-ring,384,shaman,elemental,12,4,8
37230,Kushnations,chogall,384,shaman,elemental,12,4,8
37231,Yukishock,illidan,384,shaman,elemental,12,4,8
37232,Oohkillemm,silvermoon,384,shaman,elemental,12,4,8
37233,Fatherrtime,illidan,384,shaman,elemental,12,4,8
37234,Lavasurge,area-52,384,shaman,elemental,12,4,8
37235,Rudoboy,ragnaros,384,shaman,elemental,12,4,8
37236,Anahvee,moon-guard,384,shaman,elemental,12,4,8
37237,Popsoot,area-52,384,shaman,elemental,12,4,8
37238,Zizö,barthilas,384,shaman,elemental,12,4,8
37239,Duza,frostmourne,384,shaman,elemental,12,4,8
37240,Naweiv,caelestrasz,384,shaman,elemental,12,4,8
37241,Natorr,dalaran,384,shaman,elemental,12,4,8
37242,Elryl,sargeras,384,shaman,elemental,12,4,8
37243,Vjeze,frostmourne,384,shaman,elemental,18,4,14
37244,Zevelynne,wyrmrest-accord,384,shaman,elemental,18,4,14
37245,Enroks,greymane,383,shaman,elemental,12,4,8
37246,Machalo,sargeras,383,shaman,elemental,12,4,8
37247,Potatopirate,burning-legion,381,shaman,elemental,18,4,14
37248,Coffeeblacc,magtheridon,379,shaman,elemental,12,4,8
37249,Babyblake,malganis,351,shaman,elemental,8,5,3
37250,Shk,illidan,351,shaman,elemental,11,4,7
37251,Råys,turalyon,350,shaman,elemental,11,4,7
37252,Stormfronts,kelthuzad,336,shaman,elemental,9,4,5
37253,Trashaman,garona,336,shaman,elemental,9,4,5
37254,Nondracil,ragnaros,336,shaman,elemental,14,4,10
37255,Statikrage,eonar,330,shaman,elemental,16,5,11
37256,Taraneh,garrosh,325,shaman,elemental,15,5,10
37257,Shamankie,tichondrius,319,shaman,elemental,5,4,1
37258,Orochishaman,stormrage,319,shaman,elemental,5,4,1
37259,Sweetbabyraé,bleeding-hollow,304,shaman,elemental,7,4,3
37260,Tsunamibrew,moon-guard,302,shaman,elemental,9,4,5
37261,Doop,kiljaeden,288,shaman,elemental,6,3,3
37262,Iloverina,stormrage,288,shaman,elemental,6,3,3
37263,Groink,kiljaeden,288,shaman,elemental,6,3,3
37264,Hedeadx,illidan,288,shaman,elemental,6,3,3
37265,Dialtone,blackrock,288,shaman,elemental,6,3,3
37266,Flowerchild,proudmoore,288,shaman,elemental,6,3,3
37267,Mønønøke,tichondrius,288,shaman,elemental,6,3,3
37268,Curtrex,amanthul,288,shaman,elemental,6,3,3
37269,Oxforcefairy,tichondrius,288,shaman,elemental,6,3,3
37270,Beatryx,the-scryers,288,shaman,elemental,6,3,3
37271,Vanëssão,stormrage,288,shaman,elemental,6,3,3
37272,Tokelahoma,stormrage,288,shaman,elemental,6,3,3
37273,Spacemilk,stormrage,288,shaman,elemental,6,3,3
37274,Trenhance,stormrage,288,shaman,elemental,6,3,3
37275,Oingo,destromath,288,shaman,elemental,6,3,3
37276,Raiden,gorgonnash,288,shaman,elemental,6,3,3
37277,Gödöfbüdå,tichondrius,288,shaman,elemental,6,3,3
37278,Blakki,barthilas,288,shaman,elemental,6,3,3
37279,Applicable,tichondrius,288,shaman,elemental,6,3,3
37280,Shajay,area-52,288,shaman,elemental,6,3,3
37281,Floon,barthilas,288,shaman,elemental,6,3,3
37282,Flukz,nazjatar,288,shaman,elemental,6,3,3
37283,Shamyuna,dalaran,288,shaman,elemental,6,3,3
37284,Awesomeus,barthilas,288,shaman,elemental,6,3,3
37285,Exsh,area-52,288,shaman,elemental,6,3,3
37286,Dì,barthilas,288,shaman,elemental,6,3,3
37287,Improvize,malganis,288,shaman,elemental,6,3,3
37288,Garalath,bleeding-hollow,288,shaman,elemental,6,3,3
37289,Healingtime,nerzhul,288,shaman,elemental,6,3,3
37290,Häzel,nerzhul,288,shaman,elemental,6,3,3
37291,Daiablo,barthilas,288,shaman,elemental,6,3,3
37292,Ggoong,tichondrius,288,shaman,elemental,6,3,3
37293,Zon,laughing-skull,288,shaman,elemental,6,3,3
37294,Éarl,sargeras,288,shaman,elemental,6,3,3
37295,Shadeele,cenarius,288,shaman,elemental,6,3,3
37296,Blaydin,elune,288,shaman,elemental,6,3,3
37297,Mabite,frostmourne,288,shaman,elemental,6,3,3
37298,Wabiex,illidan,288,shaman,elemental,6,3,3
37299,Shàman,durotan,288,shaman,elemental,6,3,3
37300,Axshaman,darkspear,288,shaman,elemental,6,3,3
37301,Xhamankng,quelthalas,288,shaman,elemental,6,3,3
37302,Altryn,shuhalo,288,shaman,elemental,6,3,3
37303,Shizamm,hyjal,288,shaman,elemental,6,3,3
37304,Autisty,sargeras,288,shaman,elemental,6,3,3
37305,Fobb,area-52,288,shaman,elemental,6,3,3
37306,Frenchy,hyjal,288,shaman,elemental,6,3,3
37307,Vibration,akama,288,shaman,elemental,6,3,3
37308,Malito,ursin,288,shaman,elemental,6,3,3
37309,Shamtactic,thrall,288,shaman,elemental,6,3,3
37310,Scarshamxn,frostmourne,288,shaman,elemental,6,3,3
37311,Cvoa,bonechewer,288,shaman,elemental,6,3,3
37312,Largerwang,sargeras,288,shaman,elemental,6,3,3
37313,Aerôv,area-52,288,shaman,elemental,6,3,3
37314,Talfur,area-52,288,shaman,elemental,6,3,3
37315,Dazu,drakkari,288,shaman,elemental,6,3,3
37316,Passion,sargeras,288,shaman,elemental,6,3,3
37317,Fluffyhex,sargeras,288,shaman,elemental,6,3,3
37318,Arckos,thrall,288,shaman,elemental,6,3,3
37319,Malgrave,ragnaros,288,shaman,elemental,6,3,3
37320,Moosk,zuluhed,288,shaman,elemental,6,3,3
37321,Ragor,quelthalas,288,shaman,elemental,6,3,3
37322,Bolteon,malganis,288,shaman,elemental,6,3,3
37323,Niarkx,frostmourne,288,shaman,elemental,6,3,3
37324,Ioki,spirestone,288,shaman,elemental,6,3,3
37325,Fattizer,sargeras,288,shaman,elemental,6,3,3
37326,Fanatix,moon-guard,288,shaman,elemental,6,3,3
37327,Rampàge,ragnaros,288,shaman,elemental,6,3,3
37328,Bens,malganis,288,shaman,elemental,6,3,3
37329,Bizle,jaedenar,288,shaman,elemental,6,3,3
37330,Earthfurÿ,quelthalas,288,shaman,elemental,6,3,3
37331,Grimnur,bleeding-hollow,288,shaman,elemental,11,3,8
37332,Winiethepoöh,stormrage,288,shaman,elemental,12,3,9
37333,Olex,zuluhed,288,shaman,elemental,12,3,9
37334,Oznog,bleeding-hollow,288,shaman,elemental,12,3,9
37335,Emptee,area-52,288,shaman,elemental,12,3,9
37336,Stormklepter,fizzcrank,288,shaman,elemental,12,3,9
37337,Tawahka,hyjal,288,shaman,elemental,12,3,9
37338,Sumyl,ragnaros,288,shaman,elemental,12,3,9
37339,Bloodytotemz,emerald-dream,288,shaman,elemental,12,3,9
37340,Lumpyshaman,tichondrius,288,shaman,elemental,12,3,9
37341,Bitflip,jubeithos,288,shaman,elemental,12,3,9
37342,Tdub,frostmourne,288,shaman,elemental,12,3,9
37343,Káládin,malganis,288,shaman,elemental,12,3,9
37344,Taquitho,quelthalas,288,shaman,elemental,12,3,9
37345,Juanisan,stormrage,287,shaman,elemental,6,3,3
37346,Arakye,stormrage,287,shaman,elemental,6,3,3
37347,Mðna,zuluhed,287,shaman,elemental,6,3,3
37348,Strikzjr,frostmourne,287,shaman,elemental,6,3,3
37349,Slåpntickle,darkspear,287,shaman,elemental,12,3,9
37350,Trabolta,hyjal,287,shaman,elemental,12,3,9
37351,Balrog,vashj,287,shaman,elemental,12,3,9
37352,Cropdustr,sargeras,286,shaman,elemental,6,3,3
37353,Hexytimexoqt,thrall,255,shaman,elemental,11,3,8
37354,Hannibol,tichondrius,255,shaman,elemental,11,3,8
37355,Oxxnabatko,amanthul,240,shaman,elemental,9,3,6
37356,Nikeshocks,detheroc,239,shaman,elemental,5,3,2
37357,Liamus,amanthul,239,shaman,elemental,5,3,2
37358,Spunjie,frostmourne,239,shaman,elemental,5,3,2
37359,Ladash,ragnaros,192,shaman,elemental,6,2,4
37360,Trizzeh,moon-guard,192,shaman,elemental,6,2,4
37361,Zugharder,illidan,192,shaman,elemental,6,2,4
37362,Beazel,moon-guard,192,shaman,elemental,6,2,4
37363,Naextramus,ragnaros,192,shaman,elemental,6,2,4
37364,Piffzorz,tichondrius,192,shaman,elemental,6,2,4
37365,Oriyani,sargeras,192,shaman,elemental,6,2,4
37366,Matzahmeal,skywall,192,shaman,elemental,6,2,4
37367,Wrestleman,drakthul,192,shaman,elemental,6,2,4
37368,Ínfected,azralon,192,shaman,elemental,6,2,4
37369,Flappygooch,illidan,192,shaman,elemental,6,2,4
37370,Snoocher,kelthuzad,192,shaman,elemental,6,2,4
37371,Oppaswag,tichondrius,192,shaman,elemental,6,2,4
37372,Tartar,lightbringer,192,shaman,elemental,6,2,4
37373,Killtotem,illidan,192,shaman,elemental,6,2,4
37374,Shockbot,stormscale,192,shaman,elemental,6,2,4
37375,Yellowfev,thrall,192,shaman,elemental,6,2,4
37376,Lividelemnts,area-52,192,shaman,elemental,6,2,4
37377,Aiggiggigne,sargeras,192,shaman,elemental,6,2,4
37378,Whitecake,frostmourne,192,shaman,elemental,6,2,4
37379,Ric,malganis,192,shaman,elemental,6,2,4
37380,Jbahr,hyjal,192,shaman,elemental,6,2,4
37381,Dantheman,twisting-nether,192,shaman,elemental,6,2,4
37382,Chadious,illidan,192,shaman,elemental,6,2,4
37383,Bigbadbolt,malganis,192,shaman,elemental,6,2,4
37384,Zaxibow,area-52,192,shaman,elemental,6,2,4
37385,Smellyogre,area-52,192,shaman,elemental,6,2,4
37386,Dadadabang,frostmourne,192,shaman,elemental,6,2,4
37387,Artnatu,nemesis,192,shaman,elemental,6,2,4
37388,Branasou,emerald-dream,192,shaman,elemental,6,2,4
37389,Shåmwowz,sargeras,192,shaman,elemental,6,2,4
37390,Gorillox,chogall,192,shaman,elemental,6,2,4
37391,Yangsangchu,tichondrius,192,shaman,elemental,6,2,4
37392,Wempa,moon-guard,192,shaman,elemental,6,2,4
37393,Elîas,tichondrius,192,shaman,elemental,6,2,4
37394,Krilick,blackrock,192,shaman,elemental,6,2,4
37395,Drünk,hyjal,192,shaman,elemental,6,2,4
37396,Alleys,tichondrius,192,shaman,elemental,6,2,4
37397,Hruggol,bleeding-hollow,192,shaman,elemental,6,2,4
37398,Blaiserpub,tichondrius,192,shaman,elemental,6,2,4
37399,Praisegodx,stormrage,192,shaman,elemental,6,2,4
37400,Grandmaster,frostmourne,192,shaman,elemental,6,2,4
37401,Zeldrys,emerald-dream,192,shaman,elemental,6,2,4
37402,Lenxd,dalaran,192,shaman,elemental,6,2,4
37403,Shamsky,tichondrius,192,shaman,elemental,6,2,4
37404,Yssyyds,illidan,192,shaman,elemental,6,2,4
37405,Stickshaman,sargeras,192,shaman,elemental,6,2,4
37406,Thormzz,tichondrius,192,shaman,elemental,6,2,4
37407,Dxycollapse,illidan,192,shaman,elemental,6,2,4
37408,Sid,frostmourne,192,shaman,elemental,6,2,4
37409,Hehew,kelthuzad,192,shaman,elemental,6,2,4
37410,Saltywap,proudmoore,192,shaman,elemental,6,2,4
37411,Heniu,tichondrius,192,shaman,elemental,6,2,4
37412,Blastj,tichondrius,192,shaman,elemental,6,2,4
37413,Rokhnar,zuljin,192,shaman,elemental,6,2,4
37414,Funeropolis,stormrage,192,shaman,elemental,6,2,4
37415,Kanbar,emerald-dream,192,shaman,elemental,6,2,4
37416,Britisy,stormrage,192,shaman,elemental,6,2,4
37417,Puntress,barthilas,192,shaman,elemental,6,2,4
37418,Zuroster,kiljaeden,192,shaman,elemental,7,2,5
37419,Martisor,barthilas,192,shaman,elemental,16,3,13
37420,Mega,azralon,192,shaman,elemental,12,2,10
37421,Harrìson,tichondrius,192,shaman,elemental,12,2,10
37422,Rìddles,malygos,192,shaman,elemental,12,2,10
37423,Telryndas,hyjal,192,shaman,elemental,12,2,10
37424,Electrïck,tichondrius,192,shaman,elemental,12,2,10
37425,Fluffy,smolderthorn,192,shaman,elemental,12,2,10
37426,Dodona,sargeras,192,shaman,elemental,12,2,10
37427,Jazzblast,tichondrius,192,shaman,elemental,12,2,10
37428,Thermopile,wildhammer,192,shaman,elemental,12,2,10
37429,Jedley,azshara,192,shaman,elemental,12,2,10
37430,Fulingyu,moon-guard,192,shaman,elemental,12,2,10
37431,Azl,guldan,192,shaman,elemental,13,2,11
37432,Eleveil,emerald-dream,191,shaman,elemental,9,2,7
37433,Hakaskry,caelestrasz,191,shaman,elemental,12,2,10
37434,Mentàl,baelgun,159,shaman,elemental,5,2,3
37435,Hazzardttvz,illidan,159,shaman,elemental,5,2,3
37436,Kidkovid,illidan,159,shaman,elemental,17,2,15
37437,Noslol,bronzebeard,138,shaman,elemental,9,3,6
37438,Uracemytotem,kiljaeden,138,shaman,elemental,10,3,7
37439,Marduul,azralon,138,shaman,elemental,11,3,8
37440,Mynigabob,zuljin,128,shaman,elemental,4,2,2
37441,Rahloo,sargeras,127,shaman,elemental,8,2,6
37442,Sinsar,illidan,96,shaman,elemental,6,1,5
37443,Orruddon,thaurissan,96,shaman,elemental,6,1,5
37444,Wonima,tichondrius,96,shaman,elemental,6,1,5
37445,Nerfmytotemz,frostmourne,96,shaman,elemental,6,1,5
37446,Ludacrìtz,stormrage,96,shaman,elemental,6,1,5
37447,Bouje,frostmourne,96,shaman,elemental,6,1,5
37448,Seanie,bleeding-hollow,96,shaman,elemental,6,1,5
37449,Aegaeonlol,tichondrius,96,shaman,elemental,6,1,5
37450,Drmn,frostmourne,96,shaman,elemental,6,1,5
37451,Zorgen,anvilmar,96,shaman,elemental,6,1,5
37452,Girafasuarx,korgath,96,shaman,elemental,6,1,5
37453,Tatius,stormreaver,96,shaman,elemental,6,1,5
37454,Crigga,dalaran,96,shaman,elemental,6,1,5
37455,Juicemcroose,zuljin,96,shaman,elemental,6,1,5
37456,Mcshockturds,tichondrius,96,shaman,elemental,6,1,5
37457,Sàuron,tichondrius,96,shaman,elemental,6,1,5
37458,Jalgago,tichondrius,96,shaman,elemental,6,1,5
37459,Detair,malganis,96,shaman,elemental,6,1,5
37460,Healsquish,area-52,96,shaman,elemental,6,1,5
37461,Mugiwára,ragnaros,96,shaman,elemental,6,1,5
37462,Ognerkish,black-dragonflight,96,shaman,elemental,6,1,5
37463,Firevag,hakkar,96,shaman,elemental,6,1,5
37464,Bullcowsby,darkspear,96,shaman,elemental,6,1,5
37465,Gan,silvermoon,96,shaman,elemental,6,1,5
37466,Mdawwg,kelthuzad,96,shaman,elemental,6,1,5
37467,Ggsggs,akama,96,shaman,elemental,6,1,5
37468,Teathin,ragnaros,96,shaman,elemental,6,1,5
37469,Youngmulakek,area-52,96,shaman,elemental,6,1,5
37470,Oldshammy,eldrethalas,96,shaman,elemental,6,1,5
37471,Obiwonsamdi,illidan,96,shaman,elemental,6,1,5
37472,Ravaburst,sargeras,96,shaman,elemental,6,1,5
37473,Khoden,emerald-dream,96,shaman,elemental,6,1,5
37474,Zral,emerald-dream,96,shaman,elemental,6,1,5
37475,Akó,quelthalas,96,shaman,elemental,6,1,5
37476,Succies,emerald-dream,96,shaman,elemental,6,1,5
37477,Cathxy,kelthuzad,96,shaman,elemental,6,1,5
37478,Toxidizetkö,azralon,96,shaman,elemental,6,1,5
37479,Bigstormz,fenris,96,shaman,elemental,12,1,11
37480,Bubbert,illidan,96,shaman,elemental,12,1,11
37481,Shamofshame,garrosh,96,shaman,elemental,12,1,11
37482,Staticshock,darkspear,96,shaman,elemental,12,1,11
37483,Cyrah,azjolnerub,96,shaman,elemental,12,1,11
37484,Ramonsanchez,ragnaros,96,shaman,elemental,12,1,11
37485,Ëìê,tichondrius,96,shaman,elemental,18,1,17
37486,Eleshamanz,tichondrius,79,shaman,elemental,5,1,4
37487,Docadams,chogall,79,shaman,elemental,5,1,4
37488,Camltotem,tichondrius,79,shaman,elemental,5,1,4
37489,Esbet,echo-isles,79,shaman,elemental,11,1,10
37490,Mcstop,tanaris,64,shaman,elemental,4,1,3
37491,Gurdle,frostwolf,48,shaman,elemental,3,1,2
37492,Hentaistorm,kiljaeden,48,shaman,elemental,3,1,2
37493,Hothouse,malganis,31,shaman,elemental,2,1,1
37494,Djskinflute,bleeding-hollow,16,shaman,elemental,1,1,0
37495,Mítsurí,tichondrius,2244,shaman,enhancement,210,109,101
37496,Saul,tichondrius,2218,shaman,enhancement,66,42,24
37497,Aýanokoji,tichondrius,2201,shaman,enhancement,137,74,63
37498,Alleys,tichondrius,2179,shaman,enhancement,171,88,83
37499,Rauthgar,dalaran,2167,shaman,enhancement,102,58,44
37500,Veggiess,emerald-dream,2162,shaman,enhancement,324,165,159
37501,Opoy,sargeras,2142,shaman,enhancement,201,112,89
37502,Stew,illidan,2138,shaman,enhancement,125,67,58
37503,Crowns,tichondrius,2136,shaman,enhancement,114,59,55
37504,Nopnopajnin,tichondrius,2135,shaman,enhancement,112,57,55
37505,Skydre,area-52,2131,shaman,enhancement,89,54,35
37506,Jimmyjobs,tichondrius,2129,shaman,enhancement,114,70,44
37507,Pizzashaman,illidan,2128,shaman,enhancement,106,63,43
37508,Zarktwo,azralon,2125,shaman,enhancement,132,70,62
37509,Futeuncle,tichondrius,2123,shaman,enhancement,78,41,37
37510,Ftyue,area-52,2116,shaman,enhancement,112,59,53
37511,Rawdòggin,emerald-dream,2113,shaman,enhancement,71,45,26
37512,Shapaman,tichondrius,2110,shaman,enhancement,77,53,24
37513,Doomwìnds,stormrage,2108,shaman,enhancement,168,93,75
37514,Wetdraenei,moon-guard,2102,shaman,enhancement,271,152,119
37515,Lustingchery,area-52,2101,shaman,enhancement,63,41,22
37516,Smxxn,tichondrius,2084,shaman,enhancement,84,42,42
37517,Baseballcap,sargeras,2070,shaman,enhancement,96,58,38
37518,Bjorengahr,emerald-dream,2054,shaman,enhancement,77,48,29
37519,Peynful,shadowsong,2046,shaman,enhancement,75,48,27
37520,Realypump,area-52,2034,shaman,enhancement,137,72,65
37521,Shakeys,tichondrius,2032,shaman,enhancement,71,45,26
37522,Shamsz,frostmourne,2028,shaman,enhancement,66,42,24
37523,Tastydonut,blackrock,2026,shaman,enhancement,116,70,46
37524,Xiaoxiboy,tichondrius,2024,shaman,enhancement,54,35,19
37525,Musclebrain,tichondrius,2021,shaman,enhancement,138,67,71
37526,Algresh,muradin,2018,shaman,enhancement,60,31,29
37527,Stormnala,zuljin,2015,shaman,enhancement,89,51,38
37528,Windshearbøt,tichondrius,2006,shaman,enhancement,77,47,30
37529,Zarasvati,tichondrius,2004,shaman,enhancement,119,63,56
37530,Swrdfsh,tichondrius,1995,shaman,enhancement,234,123,111
37531,Dopeysimida,illidan,1976,shaman,enhancement,92,57,35
37532,Shylabuffkin,area-52,1976,shaman,enhancement,112,67,45
37533,Spippippin,illidan,1972,shaman,enhancement,80,42,38
37534,Musclebrains,tichondrius,1969,shaman,enhancement,66,36,30
37535,Windfury,chogall,1968,shaman,enhancement,96,51,45
37536,Oosheratchet,illidan,1963,shaman,enhancement,58,41,17
37537,Zootywild,tichondrius,1963,shaman,enhancement,123,69,54
37538,Axegerd,quelthalas,1962,shaman,enhancement,183,96,87
37539,Proctopus,moon-guard,1958,shaman,enhancement,142,77,65
37540,Imchuckbass,tichondrius,1957,shaman,enhancement,104,55,49
37541,Superchief,altar-of-storms,1954,shaman,enhancement,86,50,36
37542,Musclebrainz,tichondrius,1952,shaman,enhancement,54,26,28
37543,Balgron,emerald-dream,1949,shaman,enhancement,52,26,26
37544,Tokyofresh,malganis,1944,shaman,enhancement,90,62,28
37545,Ohmálley,tichondrius,1944,shaman,enhancement,62,40,22
37546,Shk,illidan,1938,shaman,enhancement,60,36,24
37547,Ogeezkush,zuljin,1935,shaman,enhancement,160,93,67
37548,Kaediea,moon-guard,1932,shaman,enhancement,30,24,6
37549,Rozboiclique,frostmourne,1929,shaman,enhancement,132,89,43
37550,Gatorwaves,bleeding-hollow,1924,shaman,enhancement,42,27,15
37551,Enhancex,frostwolf,1923,shaman,enhancement,62,30,32
37552,Vanhalestorm,frostmourne,1922,shaman,enhancement,64,34,30
37553,Beañ,barthilas,1922,shaman,enhancement,315,162,153
37554,Typhe,bleeding-hollow,1919,shaman,enhancement,36,25,11
37555,Eletastic,tichondrius,1918,shaman,enhancement,54,35,19
37556,Eityhdz,tichondrius,1912,shaman,enhancement,401,207,194
37557,Temar,sargeras,1905,shaman,enhancement,81,54,27
37558,Earlainn,stormrage,1905,shaman,enhancement,84,48,36
37559,Scaman,tichondrius,1904,shaman,enhancement,24,20,4
37560,Cowaii,illidan,1904,shaman,enhancement,60,37,23
37561,Greenydapooh,nerzhul,1903,shaman,enhancement,60,40,20
37562,Rukagar,barthilas,1902,shaman,enhancement,72,42,30
37563,Keyturn,tichondrius,1899,shaman,enhancement,78,36,42
37564,Dano,tichondrius,1895,shaman,enhancement,108,57,51
37565,Interruptbøt,tichondrius,1894,shaman,enhancement,41,27,14
37566,Jayhastotems,area-52,1890,shaman,enhancement,96,69,27
37567,Jazzlightnin,tichondrius,1888,shaman,enhancement,46,29,17
37568,Fwwrs,illidan,1887,shaman,enhancement,61,41,20
37569,Olxsixsm,illidan,1884,shaman,enhancement,74,48,26
37570,Bestshamus,sargeras,1883,shaman,enhancement,71,42,29
37571,Gìmli,tichondrius,1882,shaman,enhancement,65,37,28
37572,Electricity,tichondrius,1880,shaman,enhancement,115,57,58
37573,Plsnerfret,stormrage,1876,shaman,enhancement,48,33,15
37574,Stormrageman,tichondrius,1875,shaman,enhancement,81,49,32
37575,Antek,quelthalas,1868,shaman,enhancement,141,86,55
37576,Shamikazi,crushridge,1866,shaman,enhancement,159,98,61
37577,Zarrka,tichondrius,1864,shaman,enhancement,36,20,16
37578,Ëxceeder,ragnaros,1861,shaman,enhancement,120,69,51
37579,Shakeysham,tichondrius,1860,shaman,enhancement,30,22,8
37580,Napski,cenarius,1859,shaman,enhancement,66,32,34
37581,Ballinhance,illidan,1858,shaman,enhancement,48,28,20
37582,Wonima,tichondrius,1858,shaman,enhancement,35,20,15
37583,Watergirl,thaurissan,1857,shaman,enhancement,170,84,86
37584,Taikø,area-52,1856,shaman,enhancement,42,25,17
37585,Loabud,tichondrius,1855,shaman,enhancement,58,37,21
37586,Lavitris,illidan,1854,shaman,enhancement,42,29,13
37587,Kiddfurious,kelthuzad,1854,shaman,enhancement,78,40,38
37588,Mcshockturds,tichondrius,1849,shaman,enhancement,143,82,61
37589,Undertów,area-52,1847,shaman,enhancement,48,26,22
37590,Xakaeri,hyjal,1844,shaman,enhancement,60,36,24
37591,Koalakisses,shadow-council,1842,shaman,enhancement,54,32,22
37592,Artenior,stormrage,1841,shaman,enhancement,89,44,45
37593,Megalithic,moon-guard,1840,shaman,enhancement,62,44,18
37594,Vonvulviln,emerald-dream,1839,shaman,enhancement,64,34,30
37595,Ishano,area-52,1839,shaman,enhancement,48,23,25
37596,Dcg,hyjal,1838,shaman,enhancement,65,33,32
37597,Berxek,tichondrius,1835,shaman,enhancement,48,27,21
37598,Thuntard,bleeding-hollow,1835,shaman,enhancement,66,33,33
37599,Norlak,antonidas,1834,shaman,enhancement,84,42,42
37600,Bøulderfist,tichondrius,1827,shaman,enhancement,36,28,8
37601,Shamanabuser,illidan,1825,shaman,enhancement,60,27,33
37602,Jokerxksx,tichondrius,1822,shaman,enhancement,72,43,29
37603,Midwestern,emerald-dream,1822,shaman,enhancement,44,26,18
37604,Hooftoface,moon-guard,1822,shaman,enhancement,78,43,35
37605,Blueraccoon,tichondrius,1821,shaman,enhancement,57,35,22
37606,Gladdorta,azralon,1821,shaman,enhancement,54,30,24
37607,Btruez,tichondrius,1819,shaman,enhancement,63,35,28
37608,Thunderlaw,area-52,1819,shaman,enhancement,82,44,38
37609,Harrypotqueu,zuljin,1819,shaman,enhancement,60,32,28
37610,Whírlwínd,area-52,1818,shaman,enhancement,30,19,11
37611,Konfuzious,emerald-dream,1818,shaman,enhancement,129,74,55
37612,Turdfergesen,destromath,1817,shaman,enhancement,70,37,33
37613,Léxar,sargeras,1817,shaman,enhancement,72,33,39
37614,Cunkinator,stormrage,1815,shaman,enhancement,115,74,41
37615,Riptiedx,barthilas,1815,shaman,enhancement,48,29,19
37616,Sarthuul,emerald-dream,1814,shaman,enhancement,48,30,18
37617,Thrallas,frostmourne,1814,shaman,enhancement,54,33,21
37618,Boombigshaq,ysera,1813,shaman,enhancement,38,25,13
37619,Louiev,bleeding-hollow,1812,shaman,enhancement,48,28,20
37620,Timzero,tichondrius,1812,shaman,enhancement,78,39,39
37621,Tdlz,tichondrius,1811,shaman,enhancement,92,60,32
37622,Legendslayar,area-52,1811,shaman,enhancement,42,27,15
37623,Drakhe,proudmoore,1811,shaman,enhancement,232,128,104
37624,Nygiants,tichondrius,1810,shaman,enhancement,24,19,5
37625,Xibalba,khaz-modan,1810,shaman,enhancement,96,57,39
37626,Sassyx,steamwheedle-cartel,1810,shaman,enhancement,48,27,21
37627,Iamashaman,malganis,1810,shaman,enhancement,302,154,148
37628,Cammeez,area-52,1809,shaman,enhancement,109,57,52
37629,Bikboisteez,barthilas,1808,shaman,enhancement,92,47,45
37630,Shamguards,tichondrius,1806,shaman,enhancement,24,19,5
37631,Lashandtrash,tichondrius,1806,shaman,enhancement,30,19,11
37632,Boboyaga,emerald-dream,1805,shaman,enhancement,54,29,25
37633,Niuniudada,illidan,1805,shaman,enhancement,84,39,45
37634,Kltz,sargeras,1804,shaman,enhancement,41,23,18
37635,Mercó,bleeding-hollow,1803,shaman,enhancement,54,31,23
37636,Madonion,zuljin,1803,shaman,enhancement,60,31,29
37637,Flabby,lightbringer,1802,shaman,enhancement,48,25,23
37638,Darkcnight,stormrage,1801,shaman,enhancement,63,39,24
37639,Blakki,barthilas,1801,shaman,enhancement,66,40,26
37640,Xiaoxiaoxi,tichondrius,1801,shaman,enhancement,48,28,20
37641,Stronghit,tichondrius,1801,shaman,enhancement,36,19,17
37642,Bodai,magtheridon,1800,shaman,enhancement,48,32,16
37643,Turbowolf,sargeras,1800,shaman,enhancement,98,43,55
37644,Doomberrie,thrall,1798,shaman,enhancement,114,63,51
37645,Landlordxx,area-52,1795,shaman,enhancement,52,32,20
37646,Lavamon,illidan,1787,shaman,enhancement,72,41,31
37647,Chillpoppin,emerald-dream,1784,shaman,enhancement,30,23,7
37648,Zanderpla,kelthuzad,1783,shaman,enhancement,84,44,40
37649,Wautyriex,area-52,1783,shaman,enhancement,48,23,25
37650,Yakora,stormrage,1781,shaman,enhancement,66,41,25
37651,Heisna,stormrage,1781,shaman,enhancement,288,153,135
37652,Adalid,thrall,1780,shaman,enhancement,54,39,15
37653,Garai,emerald-dream,1775,shaman,enhancement,135,69,66
37654,Krovn,stormrage,1772,shaman,enhancement,60,33,27
37655,Nomoreswap,zuljin,1767,shaman,enhancement,42,30,12
37656,Novedz,illidan,1767,shaman,enhancement,62,32,30
37657,Stonetides,tichondrius,1765,shaman,enhancement,30,21,9
37658,Muisor,quelthalas,1763,shaman,enhancement,60,33,27
37659,Biubiuz,tichondrius,1757,shaman,enhancement,102,63,39
37660,Grommi,proudmoore,1752,shaman,enhancement,255,120,135
37661,Beaviis,frostmourne,1749,shaman,enhancement,48,29,19
37662,Soshatsumi,tichondrius,1749,shaman,enhancement,76,42,34
37663,Shocksrus,arthas,1747,shaman,enhancement,78,44,34
37664,Kalvishdam,dalaran,1746,shaman,enhancement,36,25,11
37665,Kushnations,chogall,1746,shaman,enhancement,38,20,18
37666,Metako,sargeras,1737,shaman,enhancement,71,38,33
37667,Shinian,tichondrius,1733,shaman,enhancement,51,31,20
37668,Thromjin,ragnaros,1731,shaman,enhancement,65,39,26
37669,Badshock,tichondrius,1730,shaman,enhancement,24,22,2
37670,Xaltas,moon-guard,1727,shaman,enhancement,78,49,29
37671,Meataballa,the-underbog,1727,shaman,enhancement,42,24,18
37672,Hurrikaine,dalaran,1723,shaman,enhancement,140,77,63
37673,Doex,thrall,1723,shaman,enhancement,48,26,22
37674,Reflexsivx,malganis,1722,shaman,enhancement,48,29,19
37675,Shearx,illidan,1722,shaman,enhancement,75,43,32
37676,Poizele,tichondrius,1717,shaman,enhancement,294,164,130
37677,Nibrax,moknathal,1716,shaman,enhancement,36,19,17
37678,Hallofcost,illidan,1715,shaman,enhancement,54,34,20
37679,Gorillahazed,tichondrius,1713,shaman,enhancement,132,69,63
37680,Cwippin,tichondrius,1712,shaman,enhancement,134,77,57
37681,Asumo,azralon,1712,shaman,enhancement,75,41,34
37682,Døømsdáy,thrall,1709,shaman,enhancement,96,54,42
37683,Slapnarp,wyrmrest-accord,1709,shaman,enhancement,84,42,42
37684,Stewtwo,illidan,1705,shaman,enhancement,39,22,17
37685,Wrathics,emerald-dream,1702,shaman,enhancement,60,32,28
37686,Plzbuffme,dalaran,1700,shaman,enhancement,78,46,32
37687,Geeblast,area-52,1699,shaman,enhancement,68,42,26
37688,Bbshock,stormrage,1698,shaman,enhancement,84,50,34
37689,Nøname,azshara,1698,shaman,enhancement,167,87,80
37690,Halfzugzug,sargeras,1697,shaman,enhancement,30,21,9
37691,Axelsteel,illidan,1697,shaman,enhancement,48,21,27
37692,Bitsuey,frostmourne,1696,shaman,enhancement,84,46,38
37693,Stonetrog,blackrock,1695,shaman,enhancement,24,19,5
37694,Synivabyatch,eonar,1695,shaman,enhancement,78,44,34
37695,Tkarfuno,exodar,1694,shaman,enhancement,66,34,32
37696,Thiccsha,moon-guard,1694,shaman,enhancement,54,24,30
37697,Miketideson,proudmoore,1693,shaman,enhancement,72,38,34
37698,Valkriie,tichondrius,1692,shaman,enhancement,31,20,11
37699,Seltheran,tichondrius,1691,shaman,enhancement,42,29,13
37700,Zappithorus,stormrage,1691,shaman,enhancement,36,24,12
37701,Shamezee,stormreaver,1689,shaman,enhancement,47,22,25
37702,Nyckysh,illidan,1688,shaman,enhancement,106,56,50
37703,Jàro,thrall,1688,shaman,enhancement,42,20,22
37704,Elryl,sargeras,1686,shaman,enhancement,116,64,52
37705,Gorgonash,magtheridon,1684,shaman,enhancement,42,22,20
37706,Durozu,tichondrius,1682,shaman,enhancement,36,18,18
37707,Vortexfury,area-52,1682,shaman,enhancement,42,20,22
37708,Haishoe,stormrage,1677,shaman,enhancement,58,35,23
37709,Pla,tichondrius,1669,shaman,enhancement,162,91,71
37710,Volkuul,zuljin,1669,shaman,enhancement,72,40,32
37711,Sonofabat,spirestone,1669,shaman,enhancement,188,99,89
37712,Onlyshams,dalaran,1666,shaman,enhancement,36,22,14
37713,Hecks,malorne,1664,shaman,enhancement,96,51,45
37714,Tandrian,daggerspine,1662,shaman,enhancement,36,18,18
37715,Windflex,emerald-dream,1651,shaman,enhancement,85,43,42
37716,Roysoy,stormrage,1648,shaman,enhancement,72,45,27
37717,Judgeesham,bleeding-hollow,1647,shaman,enhancement,45,23,22
37718,Volsdeep,illidan,1644,shaman,enhancement,52,31,21
37719,Platanos,proudmoore,1644,shaman,enhancement,122,65,57
37720,Elemores,tichondrius,1642,shaman,enhancement,66,40,26
37721,Struck,emerald-dream,1639,shaman,enhancement,143,88,55
37722,Murig,bladefist,1638,shaman,enhancement,57,34,23
37723,Dalianyen,bladefist,1638,shaman,enhancement,40,19,21
37724,Ràntòn,bleeding-hollow,1637,shaman,enhancement,35,24,11
37725,Bòómz,stormrage,1637,shaman,enhancement,216,105,111
37726,Seanan,tichondrius,1635,shaman,enhancement,48,31,17
37727,Askpuntee,sargeras,1635,shaman,enhancement,42,25,17
37728,Anadal,kargath,1634,shaman,enhancement,48,22,26
37729,Clappadactyl,frostmourne,1631,shaman,enhancement,117,64,53
37730,Orkuss,illidan,1631,shaman,enhancement,48,25,23
37731,Thunderchad,jubeithos,1631,shaman,enhancement,50,25,25
37732,Tettnanger,azralon,1630,shaman,enhancement,31,19,12
37733,Slashpity,stormrage,1630,shaman,enhancement,63,33,30
37734,Shámdemons,area-52,1629,shaman,enhancement,96,58,38
37735,Omaguap,tichondrius,1628,shaman,enhancement,50,29,21
37736,Toobeastly,deathwing,1628,shaman,enhancement,42,24,18
37737,Crownsx,tichondrius,1628,shaman,enhancement,37,17,20
37738,Wingshaman,illidan,1626,shaman,enhancement,220,114,106
37739,Hxzard,stormrage,1626,shaman,enhancement,36,17,19
37740,Stormbash,ragnaros,1626,shaman,enhancement,54,23,31
37741,Åvarice,shattered-halls,1626,shaman,enhancement,54,22,32
37742,Alablast,malganis,1625,shaman,enhancement,36,21,15
37743,Jyupaonaiwa,tichondrius,1625,shaman,enhancement,30,17,13
37744,Addroi,tichondrius,1625,shaman,enhancement,30,17,13
37745,Shockdome,daggerspine,1624,shaman,enhancement,33,23,10
37746,Shamom,silver-hand,1624,shaman,enhancement,112,64,48
37747,Täcti,tichondrius,1624,shaman,enhancement,87,46,41
37748,Zapnclap,tichondrius,1623,shaman,enhancement,42,24,18
37749,Smash,fenris,1623,shaman,enhancement,82,42,40
37750,Ironaddictz,kiljaeden,1620,shaman,enhancement,51,30,21
37751,Venmoo,illidan,1620,shaman,enhancement,42,20,22
37752,Ceasebelief,tichondrius,1619,shaman,enhancement,30,21,9
37753,Deyodin,illidan,1619,shaman,enhancement,26,18,8
37754,Krûde,tichondrius,1617,shaman,enhancement,101,61,40
37755,Shamgawd,illidan,1617,shaman,enhancement,36,20,16
37756,Justkitettv,stormrage,1616,shaman,enhancement,30,20,10
37757,Deww,sargeras,1616,shaman,enhancement,58,29,29
37758,Keeba,wyrmrest-accord,1615,shaman,enhancement,48,27,21
37759,Forksin,tichondrius,1615,shaman,enhancement,48,20,28
37760,Stýlébéñdér,kelthuzad,1613,shaman,enhancement,24,17,7
37761,Ryuuraix,area-52,1610,shaman,enhancement,27,18,9
37762,Robdaman,tichondrius,1607,shaman,enhancement,24,18,6
37763,Egirlshmu,stormrage,1606,shaman,enhancement,48,28,20
37764,Kindaretro,tichondrius,1605,shaman,enhancement,42,27,15
37765,Rêngoku,dalaran,1604,shaman,enhancement,30,22,8
37766,Soupi,illidan,1602,shaman,enhancement,78,45,33
37767,Totemnikiel,stormrage,1602,shaman,enhancement,84,39,45
37768,Lenin,nathrezim,1600,shaman,enhancement,36,23,13
37769,Hellamental,malganis,1598,shaman,enhancement,42,22,20
37770,Revtide,thrall,1597,shaman,enhancement,30,19,11
37771,Eliteshamann,tichondrius,1596,shaman,enhancement,54,30,24
37772,Eyecandi,barthilas,1595,shaman,enhancement,151,76,75
37773,Aibheit,area-52,1592,shaman,enhancement,24,22,2
37774,Jerykco,drakkari,1591,shaman,enhancement,36,20,16
37775,Furrybâstard,wyrmrest-accord,1587,shaman,enhancement,60,35,25
37776,Dankthunda,stormrage,1586,shaman,enhancement,120,67,53
37777,Mobiediqônú,skywall,1586,shaman,enhancement,36,19,17
37778,Tootshock,illidan,1585,shaman,enhancement,42,21,21
37779,Deemmorti,stormrage,1584,shaman,enhancement,46,26,20
37780,Sinestario,illidan,1584,shaman,enhancement,94,53,41
37781,Youngmulakek,area-52,1581,shaman,enhancement,42,31,11
37782,Mixn,frostmourne,1581,shaman,enhancement,89,56,33
37783,Zavar,tichondrius,1579,shaman,enhancement,77,40,37
37784,Harrìson,tichondrius,1575,shaman,enhancement,29,17,12
37785,Gambazzlok,terokkar,1574,shaman,enhancement,48,28,20
37786,Thunda,black-dragonflight,1572,shaman,enhancement,30,21,9
37787,Zeroshocks,kelthuzad,1572,shaman,enhancement,30,19,11
37788,Shamanees,area-52,1572,shaman,enhancement,147,73,74
37789,Nÿh,quelthalas,1569,shaman,enhancement,48,27,21
37790,Ðr,earthen-ring,1569,shaman,enhancement,104,57,47
37791,Mobi,tichondrius,1569,shaman,enhancement,36,17,19
37792,Aoshiferuzz,ragnaros,1566,shaman,enhancement,78,43,35
37793,Shmnsm,kiljaeden,1565,shaman,enhancement,42,18,24
37794,Lyrzsa,blackwing-lair,1562,shaman,enhancement,74,46,28
37795,Uracemytotem,kiljaeden,1562,shaman,enhancement,84,51,33
37796,Heäven,malganis,1561,shaman,enhancement,163,88,75
37797,Shakerina,azralon,1561,shaman,enhancement,62,26,36
37798,Zmogon,quelthalas,1559,shaman,enhancement,38,19,19
37799,ßurstmedaddy,bleeding-hollow,1557,shaman,enhancement,36,27,9
37800,Cayed,stormscale,1553,shaman,enhancement,84,44,40
37801,Dirtyunique,tichondrius,1549,shaman,enhancement,84,49,35
37802,Speedrush,nagrand,1546,shaman,enhancement,38,25,13
37803,Shockmehard,area-52,1545,shaman,enhancement,71,57,14
37804,Lavawreckage,malganis,1544,shaman,enhancement,122,66,56
37805,Thilv,ravenholdt,1543,shaman,enhancement,30,19,11
37806,Udb,the-scryers,1542,shaman,enhancement,53,32,21
37807,Mindfields,barthilas,1542,shaman,enhancement,73,42,31
37808,Grx,tichondrius,1539,shaman,enhancement,41,22,19
37809,Small,alleria,1538,shaman,enhancement,60,32,28
37810,Wortwort,tichondrius,1537,shaman,enhancement,99,49,50
37811,Pedaphil,frostmourne,1534,shaman,enhancement,24,16,8
37812,Anzet,ragnaros,1534,shaman,enhancement,24,16,8
37813,Shamgødx,dalaran,1533,shaman,enhancement,18,16,2
37814,Derzwaz,draka,1532,shaman,enhancement,29,17,12
37815,Killavicious,area-52,1531,shaman,enhancement,84,39,45
37816,Khormac,moon-guard,1529,shaman,enhancement,64,43,21
37817,Larrylardazz,tichondrius,1529,shaman,enhancement,85,51,34
37818,Chaposz,tichondrius,1529,shaman,enhancement,73,40,33
37819,Split,zuljin,1529,shaman,enhancement,172,93,79
37820,Loadiez,frostmourne,1527,shaman,enhancement,30,21,9
37821,Shamwows,dalaran,1527,shaman,enhancement,171,84,87
37822,Gordonramsai,sargeras,1526,shaman,enhancement,30,21,9
37823,Nonomori,frostmourne,1526,shaman,enhancement,36,17,19
37824,Beaversniper,tichondrius,1523,shaman,enhancement,72,34,38
37825,Vulcänyr,quelthalas,1522,shaman,enhancement,30,16,14
37826,Thewindman,sargeras,1520,shaman,enhancement,60,27,33
37827,Jamieslays,korgath,1519,shaman,enhancement,47,22,25
37828,Solka,illidan,1518,shaman,enhancement,54,32,22
37829,Tumble,frostmourne,1516,shaman,enhancement,97,53,44
37830,Smartbunny,illidan,1516,shaman,enhancement,246,121,125
37831,Flirstatic,nemesis,1512,shaman,enhancement,135,73,62
37832,Deshamann,illidan,1507,shaman,enhancement,59,24,35
37833,Maribain,barthilas,1505,shaman,enhancement,88,54,34
37834,Elementin,kelthuzad,1503,shaman,enhancement,96,46,50
37835,Yildiri,area-52,1501,shaman,enhancement,18,16,2
37836,Kronkxd,malganis,1501,shaman,enhancement,30,16,14
37837,Pingatronx,ragnaros,1500,shaman,enhancement,43,31,12
37838,Pockethealer,emerald-dream,1497,shaman,enhancement,131,71,60
37839,Justincasé,sargeras,1494,shaman,enhancement,66,31,35
37840,Azumaa,tichondrius,1493,shaman,enhancement,30,16,14
37841,Earthfirex,ragnaros,1493,shaman,enhancement,48,25,23
37842,Hephron,area-52,1493,shaman,enhancement,72,32,40
37843,Quakenbake,emerald-dream,1491,shaman,enhancement,33,20,13
37844,Daddymacktv,malganis,1490,shaman,enhancement,50,23,27
37845,Tyranitaur,frostmourne,1490,shaman,enhancement,60,24,36
37846,Bräindëad,hyjal,1487,shaman,enhancement,84,46,38
37847,Hungnuts,sargeras,1487,shaman,enhancement,124,67,57
37848,Jäyp,thrall,1486,shaman,enhancement,52,30,22
37849,Taowth,tichondrius,1486,shaman,enhancement,29,16,13
37850,Shoresy,kaelthas,1485,shaman,enhancement,42,22,20
37851,Çhïcagø,aegwynn,1484,shaman,enhancement,41,16,25
37852,Konga,korialstrasz,1483,shaman,enhancement,38,22,16
37853,Shalkahn,malganis,1480,shaman,enhancement,35,17,18
37854,Ragnarocck,sargeras,1479,shaman,enhancement,75,36,39
37855,Dashmmy,dalaran,1478,shaman,enhancement,54,26,28
37856,Armønixx,ragnaros,1476,shaman,enhancement,120,65,55
37857,Falasha,bloodscalp,1475,shaman,enhancement,46,27,19
37858,Zugzugenh,stormrage,1475,shaman,enhancement,36,18,18
37859,Abigdude,frostmourne,1474,shaman,enhancement,107,57,50
37860,Lakindrentv,gorefiend,1467,shaman,enhancement,30,17,13
37861,Dilfmaster,tichondrius,1467,shaman,enhancement,51,26,25
37862,Mackandal,tichondrius,1466,shaman,enhancement,86,43,43
37863,Skyzik,area-52,1465,shaman,enhancement,54,34,20
37864,Woof,agamaggan,1464,shaman,enhancement,30,16,14
37865,Earthlsflat,tichondrius,1463,shaman,enhancement,31,21,10
37866,Daddyzap,stormrage,1462,shaman,enhancement,104,58,46
37867,Somebozo,darkspear,1462,shaman,enhancement,109,52,57
37868,Shockolatte,sargeras,1460,shaman,enhancement,55,20,35
37869,Lavabone,dalaran,1459,shaman,enhancement,66,28,38
37870,Arlikai,arthas,1459,shaman,enhancement,89,35,54
37871,Sndhlp,tichondrius,1457,shaman,enhancement,46,29,17
37872,Shabenn,proudmoore,1457,shaman,enhancement,60,26,34
37873,Rexoss,hyjal,1454,shaman,enhancement,123,64,59
37874,Iamurfather,magtheridon,1453,shaman,enhancement,107,55,52
37875,Amasaei,bleeding-hollow,1453,shaman,enhancement,54,26,28
37876,Usul,frostmane,1451,shaman,enhancement,60,34,26
37877,Hehew,kelthuzad,1451,shaman,enhancement,48,27,21
37878,Scrötotem,saurfang,1450,shaman,enhancement,83,47,36
37879,Goribash,wyrmrest-accord,1449,shaman,enhancement,42,26,16
37880,Calich,kelthuzad,1445,shaman,enhancement,38,23,15
37881,Odïn,tichondrius,1444,shaman,enhancement,54,33,21
37882,Makocc,tichondrius,1440,shaman,enhancement,74,33,41
37883,Drakkaa,tichondrius,1439,shaman,enhancement,31,20,11
37884,Sswf,auchindoun,1439,shaman,enhancement,24,15,9
37885,Teeroll,frostmourne,1439,shaman,enhancement,41,25,16
37886,Exxosenh,tichondrius,1438,shaman,enhancement,18,15,3
37887,Tamtam,gorefiend,1438,shaman,enhancement,24,15,9
37888,Gundar,chogall,1436,shaman,enhancement,56,31,25
37889,Dimitrio,azralon,1436,shaman,enhancement,48,22,26
37890,Qvibin,tichondrius,1435,shaman,enhancement,30,21,9
37891,Arque,stormrage,1435,shaman,enhancement,78,49,29
37892,Overpowered,korgath,1435,shaman,enhancement,24,15,9
37893,Tungusk,tichondrius,1435,shaman,enhancement,24,15,9
37894,Däbü,tichondrius,1435,shaman,enhancement,30,15,15
37895,Friednocap,kelthuzad,1435,shaman,enhancement,48,21,27
37896,Rojhaz,stormrage,1433,shaman,enhancement,48,28,20
37897,Cuzcuz,tichondrius,1431,shaman,enhancement,24,15,9
37898,Whydead,sargeras,1431,shaman,enhancement,72,40,32
37899,Djasura,blackhand,1430,shaman,enhancement,53,29,24
37900,Earfshock,thrall,1428,shaman,enhancement,74,41,33
37901,Convolutedx,tichondrius,1427,shaman,enhancement,30,15,15
37902,Grippysockz,dalaran,1424,shaman,enhancement,24,15,9
37903,Killbro,blackrock,1424,shaman,enhancement,98,50,48
37904,Cowely,madoran,1423,shaman,enhancement,30,17,13
37905,Rtÿo,area-52,1422,shaman,enhancement,24,15,9
37906,Raazzasham,moon-guard,1422,shaman,enhancement,65,34,31
37907,Silyshamshyt,stormrage,1421,shaman,enhancement,24,15,9
37908,Ginjij,thrall,1419,shaman,enhancement,24,15,9
37909,Atthegates,illidan,1416,shaman,enhancement,96,38,58
37910,Clownshòes,tichondrius,1415,shaman,enhancement,42,26,16
37911,Tyven,tichondrius,1415,shaman,enhancement,42,17,25
37912,Mudroller,moon-guard,1414,shaman,enhancement,52,24,28
37913,Spacex,velen,1413,shaman,enhancement,36,16,20
37914,Frëdstorm,kelthuzad,1410,shaman,enhancement,125,54,71
37915,Raylord,ragnaros,1406,shaman,enhancement,131,72,59
37916,Nankdug,tichondrius,1405,shaman,enhancement,47,25,22
37917,Zzar,daggerspine,1404,shaman,enhancement,42,23,19
37918,Prymalfury,illidan,1404,shaman,enhancement,96,46,50
37919,Neyter,azralon,1403,shaman,enhancement,59,42,17
37920,Surtel,tichondrius,1401,shaman,enhancement,66,28,38
37921,Ventus,thrall,1399,shaman,enhancement,60,27,33
37922,Clenlift,emerald-dream,1398,shaman,enhancement,162,83,79
37923,Scrototëm,azralon,1398,shaman,enhancement,57,27,30
37924,Gaelfury,malganis,1396,shaman,enhancement,48,23,25
37925,Djelemental,darkspear,1394,shaman,enhancement,27,17,10
37926,Shamann,azshara,1393,shaman,enhancement,57,29,28
37927,Stickysham,illidan,1391,shaman,enhancement,42,26,16
37928,Neyavv,tichondrius,1390,shaman,enhancement,97,48,49
37929,Kohatan,moon-guard,1389,shaman,enhancement,50,26,24
37930,Groundfaults,bleeding-hollow,1389,shaman,enhancement,35,15,20
37931,Shipmatekev,sargeras,1386,shaman,enhancement,54,29,25
37932,Zktz,warsong,1385,shaman,enhancement,31,17,14
37933,Rbmx,frostmourne,1384,shaman,enhancement,70,41,29
37934,Lazugga,area-52,1378,shaman,enhancement,80,42,38
37935,Saphage,tichondrius,1376,shaman,enhancement,30,15,15
37936,Tyzek,illidan,1375,shaman,enhancement,42,26,16
37937,Fhenh,proudmoore,1375,shaman,enhancement,70,37,33
37938,Stubbywayne,area-52,1374,shaman,enhancement,172,83,89
37939,Gettatotem,frostmourne,1373,shaman,enhancement,30,17,13
37940,Getacho,stormrage,1373,shaman,enhancement,108,48,60
37941,Shamrockcawk,malganis,1372,shaman,enhancement,30,21,9
37942,Lagroupie,ragnaros,1372,shaman,enhancement,23,15,8
37943,Montí,moon-guard,1361,shaman,enhancement,83,51,32
37944,Grohltusk,barthilas,1360,shaman,enhancement,42,24,18
37945,Blasho,ragnaros,1360,shaman,enhancement,60,27,33
37946,Borwald,dalaran,1359,shaman,enhancement,96,48,48
37947,Johnwilke,area-52,1356,shaman,enhancement,119,59,60
37948,Murlook,sargeras,1354,shaman,enhancement,67,44,23
37949,Hagass,tichondrius,1354,shaman,enhancement,55,26,29
37950,Isbabani,moon-guard,1353,shaman,enhancement,30,16,14
37951,Argrax,sargeras,1350,shaman,enhancement,36,24,12
37952,Chalked,stormrage,1348,shaman,enhancement,93,46,47
37953,Orcshamen,tichondrius,1347,shaman,enhancement,42,24,18
37954,Mybadshawty,tichondrius,1347,shaman,enhancement,72,32,40
37955,Drumman,skullcrusher,1346,shaman,enhancement,70,39,31
37956,Bessame,sargeras,1346,shaman,enhancement,94,48,46
37957,Futeboy,tichondrius,1343,shaman,enhancement,24,14,10
37958,Keyturns,tichondrius,1342,shaman,enhancement,18,14,4
37959,Døømwinds,tichondrius,1342,shaman,enhancement,24,14,10
37960,Dugomik,malganis,1342,shaman,enhancement,77,39,38
37961,Tsaheylu,barthilas,1342,shaman,enhancement,48,22,26
37962,Rngena,trollbane,1341,shaman,enhancement,24,14,10
37963,Dashinra,stormrage,1341,shaman,enhancement,26,15,11
37964,Clumpen,thunderhorn,1341,shaman,enhancement,29,16,13
37965,Stormwolf,emerald-dream,1341,shaman,enhancement,42,23,19
37966,Dä,tichondrius,1341,shaman,enhancement,30,14,16
37967,Joeschno,bleeding-hollow,1341,shaman,enhancement,41,16,25
37968,Crøwgød,tichondrius,1340,shaman,enhancement,24,14,10
37969,Mairn,tichondrius,1338,shaman,enhancement,54,28,26
37970,Stormgraves,moon-guard,1337,shaman,enhancement,24,14,10
37971,Dorta,azralon,1337,shaman,enhancement,30,14,16
37972,Leaning,wyrmrest-accord,1335,shaman,enhancement,24,14,10
37973,Tuugo,mannoroth,1334,shaman,enhancement,24,14,10
37974,Aldinatir,ragnaros,1332,shaman,enhancement,24,14,10
37975,Atroll,moonrunner,1332,shaman,enhancement,66,30,36
37976,Flaméy,stormrage,1332,shaman,enhancement,45,20,25
37977,Chapope,quelthalas,1329,shaman,enhancement,46,30,16
37978,Niteshammy,lothar,1328,shaman,enhancement,24,14,10
37979,Cbomberz,tichondrius,1328,shaman,enhancement,61,31,30
37980,Psilocypher,nazjatar,1327,shaman,enhancement,26,19,7
37981,Shomani,madoran,1326,shaman,enhancement,41,17,24
37982,Leschaises,skullcrusher,1325,shaman,enhancement,27,18,9
37983,Zheúz,azralon,1324,shaman,enhancement,38,18,20
37984,Baloneyfiveo,kiljaeden,1322,shaman,enhancement,56,31,25
37985,Firevag,hakkar,1321,shaman,enhancement,72,38,34
37986,Canabal,eonar,1315,shaman,enhancement,24,14,10
37987,Zügz,illidan,1314,shaman,enhancement,37,22,15
37988,Kungfuvoodoo,tichondrius,1314,shaman,enhancement,24,14,10
37989,Rokogg,thrall,1312,shaman,enhancement,133,69,64
37990,Kushgodd,kiljaeden,1312,shaman,enhancement,30,14,16
37991,Shamorrhoids,frostmourne,1311,shaman,enhancement,118,62,56
37992,Harvesting,azralon,1311,shaman,enhancement,30,14,16
37993,Trashfarmer,tichondrius,1311,shaman,enhancement,102,46,56
37994,Eze,tichondrius,1306,shaman,enhancement,58,36,22
37995,Díesel,azralon,1306,shaman,enhancement,29,14,15
37996,Obeilius,illidan,1303,shaman,enhancement,49,25,24
37997,Whichdoctah,proudmoore,1302,shaman,enhancement,30,14,16
37998,Lightnessx,stormrage,1301,shaman,enhancement,42,17,25
37999,Microwavbakn,emerald-dream,1300,shaman,enhancement,70,38,32
38000,Tizzl,kelthuzad,1300,shaman,enhancement,60,29,31
38001,Astrò,illidan,1299,shaman,enhancement,18,14,4
38002,Rongkhan,tichondrius,1296,shaman,enhancement,41,23,18
38003,Vapus,area-52,1294,shaman,enhancement,89,47,42
38004,Yâmz,area-52,1292,shaman,enhancement,51,21,30
38005,Sigir,darrowmere,1290,shaman,enhancement,36,16,20
38006,Pandashamnda,area-52,1288,shaman,enhancement,34,18,16
38007,Lilpump,boulderfist,1286,shaman,enhancement,60,32,28
38008,Dàfèng,wyrmrest-accord,1286,shaman,enhancement,41,14,27
38009,Jackofstorms,veknilash,1285,shaman,enhancement,56,25,31
38010,Sockittooya,bleeding-hollow,1282,shaman,enhancement,18,14,4
38011,Piffenstien,malganis,1282,shaman,enhancement,54,25,29
38012,Shometrin,tichondrius,1282,shaman,enhancement,35,15,20
38013,Torgami,tichondrius,1274,shaman,enhancement,23,14,9
38014,Lüca,wyrmrest-accord,1274,shaman,enhancement,148,73,75
38015,Zechary,proudmoore,1273,shaman,enhancement,54,33,21
38016,Fyahchaming,drakkari,1271,shaman,enhancement,46,24,22
38017,Popsmoke,gnomeregan,1265,shaman,enhancement,23,14,9
38018,Datblueboi,dalaran,1263,shaman,enhancement,76,39,37
38019,Gorebog,feathermoon,1259,shaman,enhancement,42,23,19
38020,Obrahma,burning-legion,1258,shaman,enhancement,24,16,8
38021,Deathjoker,icecrown,1255,shaman,enhancement,66,34,32
38022,Taò,tichondrius,1254,shaman,enhancement,75,37,38
38023,Holosoul,bleeding-hollow,1254,shaman,enhancement,67,27,40
38024,Rikswordfire,wyrmrest-accord,1251,shaman,enhancement,35,16,19
38025,Beardcramps,tichondrius,1250,shaman,enhancement,57,20,37
38026,Bigsquatzy,bleeding-hollow,1247,shaman,enhancement,24,13,11
38027,Forgediniron,stormrage,1247,shaman,enhancement,36,17,19
38028,Freyía,illidan,1246,shaman,enhancement,18,13,5
38029,Hexoffnder,zuljin,1246,shaman,enhancement,18,13,5
38030,Sin,bleeding-hollow,1246,shaman,enhancement,18,13,5
38031,Yucasinmojo,illidan,1245,shaman,enhancement,19,13,6
38032,Shamcowhah,frostmourne,1245,shaman,enhancement,24,13,11
38033,Dalthragoz,tichondrius,1239,shaman,enhancement,24,13,11
38034,Blackenergy,stormrage,1238,shaman,enhancement,24,13,11
38035,Dalsun,turalyon,1237,shaman,enhancement,30,13,17
38036,Githealed,kelthuzad,1234,shaman,enhancement,27,15,12
38037,Vozs,proudmoore,1233,shaman,enhancement,60,34,26
38038,Thromir,blackwing-lair,1233,shaman,enhancement,48,22,26
38039,Willy,icecrown,1230,shaman,enhancement,23,13,10
38040,Magmao,quelthalas,1228,shaman,enhancement,44,25,19
38041,Lamagra,nemesis,1227,shaman,enhancement,18,13,5
38042,Kasukaga,shadowmoon,1227,shaman,enhancement,54,23,31
38043,Kamíhameha,stormrage,1226,shaman,enhancement,56,26,30
38044,Lavalavalava,dentarg,1225,shaman,enhancement,18,13,5
38045,Uglykunt,barthilas,1224,shaman,enhancement,111,62,49
38046,Netherfury,illidan,1224,shaman,enhancement,51,28,23
38047,Totesmagotes,scilla,1223,shaman,enhancement,18,13,5
38048,Shamantwo,windrunner,1223,shaman,enhancement,24,13,11
38049,Mullten,sargeras,1219,shaman,enhancement,36,15,21
38050,Prasu,spirestone,1217,shaman,enhancement,34,14,20
38051,Shamgoddam,illidan,1217,shaman,enhancement,48,19,29
38052,Crigga,dalaran,1216,shaman,enhancement,24,13,11
38053,Onezap,trollbane,1214,shaman,enhancement,43,17,26
38054,Hammeredd,hyjal,1212,shaman,enhancement,36,18,18
38055,Fireclaws,bleeding-hollow,1206,shaman,enhancement,36,16,20
38056,Sheared,emerald-dream,1205,shaman,enhancement,26,14,12
38057,Slowgrath,burning-legion,1202,shaman,enhancement,33,19,14
38058,Sinsar,illidan,1200,shaman,enhancement,35,13,22
38059,Trenbolone,maiev,1196,shaman,enhancement,49,27,22
38060,Triní,ragnaros,1191,shaman,enhancement,39,22,17
38061,Iamegirl,moon-guard,1191,shaman,enhancement,29,13,16
38062,Mëister,stormrage,1191,shaman,enhancement,77,34,43
38063,Gdiafplox,thunderhorn,1186,shaman,enhancement,54,27,27
38064,Djshammy,barthilas,1183,shaman,enhancement,28,15,13
38065,Àspec,aegwynn,1182,shaman,enhancement,16,13,3
38066,Hanhze,quelthalas,1178,shaman,enhancement,48,28,20
38067,Spiderjohn,sargeras,1177,shaman,enhancement,36,20,16
38068,Enhancementz,azralon,1174,shaman,enhancement,68,37,31
38069,Litchuckie,thrall,1169,shaman,enhancement,46,25,21
38070,Mortzor,frostmourne,1166,shaman,enhancement,23,13,10
38071,Meattoilet,tichondrius,1164,shaman,enhancement,17,13,4
38072,Finnaburstt,tichondrius,1162,shaman,enhancement,54,29,25
38073,Parallels,blackrock,1161,shaman,enhancement,52,20,32
38074,Camdoc,destromath,1156,shaman,enhancement,41,19,22
38075,Robis,thrall,1156,shaman,enhancement,84,38,46
38076,Splendapapi,stormrage,1155,shaman,enhancement,38,13,25
38077,Gangmember,shadowmoon,1152,shaman,enhancement,18,12,6
38078,Cyclrin,sargeras,1152,shaman,enhancement,18,12,6
38079,Jinxicle,illidan,1151,shaman,enhancement,18,12,6
38080,Daysub,crushridge,1151,shaman,enhancement,18,12,6
38081,Meiku,emerald-dream,1151,shaman,enhancement,24,12,12
38082,Lutheran,dragonmaw,1151,shaman,enhancement,35,14,21
38083,Nyknicks,tichondrius,1150,shaman,enhancement,18,12,6
38084,Arázi,wyrmrest-accord,1150,shaman,enhancement,24,12,12
38085,Dialtone,blackrock,1150,shaman,enhancement,30,12,18
38086,Rainjig,emerald-dream,1149,shaman,enhancement,21,12,9
38087,Olíndo,tichondrius,1146,shaman,enhancement,18,12,6
38088,Goonxdz,illidan,1146,shaman,enhancement,24,12,12
38089,Zèus,draka,1146,shaman,enhancement,24,12,12
38090,Slapchainz,tichondrius,1146,shaman,enhancement,24,12,12
38091,Katojune,tichondrius,1144,shaman,enhancement,21,13,8
38092,Saraguthix,dalaran,1141,shaman,enhancement,18,12,6
38093,Fourstorms,gundrak,1141,shaman,enhancement,37,19,18
38094,Extraguacpls,tichondrius,1139,shaman,enhancement,18,12,6
38095,Wagar,dawnbringer,1139,shaman,enhancement,30,12,18
38096,Sydstorm,frostmourne,1137,shaman,enhancement,18,12,6
38097,Popz,dark-iron,1128,shaman,enhancement,18,12,6
38098,ßøn,altar-of-storms,1125,shaman,enhancement,33,16,17
38099,Astroglyde,emerald-dream,1123,shaman,enhancement,24,12,12
38100,Shøxic,perenolde,1118,shaman,enhancement,18,12,6
38101,Drokron,azralon,1118,shaman,enhancement,36,17,19
38102,Catiçero,azralon,1117,shaman,enhancement,30,12,18
38103,Hazak,nemesis,1113,shaman,enhancement,66,34,32
38104,Schlemiel,barthilas,1112,shaman,enhancement,82,36,46
38105,Cseril,bonechewer,1111,shaman,enhancement,71,41,30
38106,Lassoway,illidan,1110,shaman,enhancement,30,12,18
38107,Golkork,quelthalas,1108,shaman,enhancement,24,13,11
38108,Hordeymaori,jubeithos,1103,shaman,enhancement,110,58,52
38109,Shaminism,chromaggus,1103,shaman,enhancement,23,12,11
38110,Wigwog,hyjal,1102,shaman,enhancement,61,35,26
38111,Ashida,stormrage,1086,shaman,enhancement,26,14,12
38112,Oreahsham,tichondrius,1085,shaman,enhancement,30,12,18
38113,Nîghtstalker,vashj,1081,shaman,enhancement,52,20,32
38114,Svddëndëath,sargeras,1079,shaman,enhancement,60,22,38
38115,Shamikkazee,illidan,1073,shaman,enhancement,31,14,17
38116,Ctrlaltelite,burning-blade,1071,shaman,enhancement,48,17,31
38117,Chesos,tichondrius,1066,shaman,enhancement,38,13,25
38118,Tekashi,muradin,1060,shaman,enhancement,31,12,19
38119,Gamergirlx,area-52,1056,shaman,enhancement,18,11,7
38120,Jyster,area-52,1056,shaman,enhancement,65,27,38
38121,Shamawolf,stormrage,1055,shaman,enhancement,12,11,1
38122,Juliojones,trollbane,1055,shaman,enhancement,18,11,7
38123,Shinydiglett,area-52,1055,shaman,enhancement,18,11,7
38124,Enhance,bleeding-hollow,1055,shaman,enhancement,24,11,13
38125,Shampowl,jaedenar,1055,shaman,enhancement,30,11,19
38126,Möuthbläster,malganis,1054,shaman,enhancement,12,11,1
38127,Syraak,elune,1054,shaman,enhancement,15,12,3
38128,Jirig,tichondrius,1054,shaman,enhancement,18,11,7
38129,Khorgan,emerald-dream,1054,shaman,enhancement,18,11,7
38130,Balldo,stormrage,1054,shaman,enhancement,30,11,19
38131,Buffdudé,illidan,1052,shaman,enhancement,24,11,13
38132,Peepingtotem,tichondrius,1052,shaman,enhancement,24,11,13
38133,Faminex,dragonmaw,1051,shaman,enhancement,12,11,1
38134,Elementalïst,durotan,1051,shaman,enhancement,18,11,7
38135,Swapxylee,tichondrius,1051,shaman,enhancement,24,11,13
38136,Naesala,thunderlord,1050,shaman,enhancement,24,11,13
38137,Dronesum,tichondrius,1050,shaman,enhancement,24,11,13
38138,Totegoat,nazjatar,1050,shaman,enhancement,30,11,19
38139,Scams,bleeding-hollow,1049,shaman,enhancement,30,18,12
38140,Vöödooranger,stormrage,1048,shaman,enhancement,18,11,7
38141,Spicyballs,coilfang,1048,shaman,enhancement,24,11,13
38142,Grindl,stormrage,1047,shaman,enhancement,18,11,7
38143,Sparkqt,sargeras,1047,shaman,enhancement,18,11,7
38144,Emptyy,azralon,1047,shaman,enhancement,24,11,13
38145,Johnnygeh,stormrage,1047,shaman,enhancement,30,11,19
38146,Îvôry,bloodhoof,1046,shaman,enhancement,24,11,13
38147,Stormwolf,azjolnerub,1045,shaman,enhancement,36,20,16
38148,Jamblee,sargeras,1043,shaman,enhancement,18,11,7
38149,Beanerburst,frostwolf,1042,shaman,enhancement,30,14,16
38150,Trulos,stormrage,1041,shaman,enhancement,18,11,7
38151,Bobaflexqt,korgath,1039,shaman,enhancement,18,11,7
38152,Hannibol,tichondrius,1036,shaman,enhancement,72,25,47
38153,Allmeatie,hyjal,1035,shaman,enhancement,18,11,7
38154,Zalkran,area-52,1034,shaman,enhancement,24,15,9
38155,Lovetides,area-52,1031,shaman,enhancement,24,14,10
38156,Sevare,area-52,1023,shaman,enhancement,21,12,9
38157,Tøtëm,tichondrius,1021,shaman,enhancement,28,12,16
38158,Facebooksux,sargeras,1019,shaman,enhancement,18,13,5
38159,Karlpoppa,thunderhorn,1019,shaman,enhancement,18,11,7
38160,Raxabico,nemesis,1017,shaman,enhancement,32,12,20
38161,Shayymann,exodar,1013,shaman,enhancement,48,19,29
38162,Pùffball,anvilmar,1011,shaman,enhancement,57,29,28
38163,Xapoxy,nemesis,1008,shaman,enhancement,20,12,8
38164,Tukkutz,moon-guard,1006,shaman,enhancement,27,12,15
38165,Dedlystorm,dalaran,1003,shaman,enhancement,18,12,6
38166,Hoodfigga,tichondrius,1002,shaman,enhancement,23,11,12
38167,Bigbólts,emerald-dream,1001,shaman,enhancement,18,12,6
38168,Stroheim,warsong,1000,shaman,enhancement,21,12,9
38169,Poseidonxd,lightbringer,1000,shaman,enhancement,23,13,10
38170,Korgen,area-52,999,shaman,enhancement,25,12,13
38171,Slaughterdog,coilfang,995,shaman,enhancement,22,13,9
38172,Prinkipíssa,tichondrius,994,shaman,enhancement,36,16,20
38173,Synshenrongt,thrall,990,shaman,enhancement,178,70,108
38174,Pwnôgraphy,kelthuzad,989,shaman,enhancement,14,11,3
38175,Zelzus,moon-guard,989,shaman,enhancement,22,11,11
38176,Deckìn,proudmoore,987,shaman,enhancement,14,11,3
38177,Dizzytotem,dalaran,987,shaman,enhancement,24,14,10
38178,Shamvandám,kiljaeden,978,shaman,enhancement,30,13,17
38179,Mudpwet,borean-tundra,974,shaman,enhancement,30,18,12
38180,Shammybreakx,malganis,971,shaman,enhancement,35,20,15
38181,Enhance,sargeras,960,shaman,enhancement,18,10,8
38182,Mcb,barthilas,960,shaman,enhancement,18,10,8
38183,Zatchbell,lightnings-blade,960,shaman,enhancement,30,13,17
38184,Lokrath,zangarmarsh,959,shaman,enhancement,12,10,2
38185,Pikachil,tichondrius,959,shaman,enhancement,15,11,4
38186,Vonnsmallpp,area-52,959,shaman,enhancement,18,10,8
38187,Kumboi,frostmourne,959,shaman,enhancement,24,10,14
38188,Unezx,tichondrius,958,shaman,enhancement,12,10,2
38189,Thoramgar,malganis,958,shaman,enhancement,18,10,8
38190,Marginalized,tichondrius,958,shaman,enhancement,18,10,8
38191,Ggsggs,akama,958,shaman,enhancement,18,10,8
38192,Leotis,tichondrius,957,shaman,enhancement,18,10,8
38193,Kandin,icecrown,957,shaman,enhancement,24,10,14
38194,Keroh,blackrock,956,shaman,enhancement,18,10,8
38195,Súrtr,sargeras,955,shaman,enhancement,18,10,8
38196,ßigðåddy,ghostlands,955,shaman,enhancement,24,10,14
38197,Aelpian,emerald-dream,954,shaman,enhancement,18,10,8
38198,Ryntyntyn,blood-furnace,954,shaman,enhancement,24,10,14
38199,Shomminn,tichondrius,953,shaman,enhancement,18,10,8
38200,Pumpz,magtheridon,953,shaman,enhancement,24,10,14
38201,Mcgraff,frostmourne,949,shaman,enhancement,18,10,8
38202,Majhrakova,stormrage,946,shaman,enhancement,24,10,14
38203,Bloodytotemz,emerald-dream,944,shaman,enhancement,18,10,8
38204,Esko,magtheridon,943,shaman,enhancement,24,10,14
38205,Thanwirn,ragnaros,924,shaman,enhancement,30,13,17
38206,Wälee,sargeras,921,shaman,enhancement,18,10,8
38207,Gammacide,sargeras,921,shaman,enhancement,29,10,19
38208,Oct,thrall,912,shaman,enhancement,36,18,18
38209,Grimlên,skullcrusher,910,shaman,enhancement,32,12,20
38210,Duality,shattered-halls,909,shaman,enhancement,23,10,13
38211,Orcmanshamn,moon-guard,902,shaman,enhancement,29,11,18
38212,Ongruge,hyjal,895,shaman,enhancement,60,22,38
38213,Orfelix,nemesis,889,shaman,enhancement,30,11,19
38214,Poagrious,bonechewer,876,shaman,enhancement,40,17,23
38215,ßlessedx,tichondrius,875,shaman,enhancement,17,10,7
38216,Solbis,tichondrius,864,shaman,enhancement,12,9,3
38217,Torvi,saurfang,864,shaman,enhancement,12,9,3
38218,Raídyn,sargeras,864,shaman,enhancement,12,9,3
38219,Conorfotm,tichondrius,864,shaman,enhancement,12,9,3
38220,Deixw,tichondrius,864,shaman,enhancement,12,9,3
38221,Frantìk,tichondrius,864,shaman,enhancement,12,9,3
38222,Shlongers,illidan,864,shaman,enhancement,18,9,9
38223,Purgegodryuu,area-52,864,shaman,enhancement,18,9,9
38224,Sethbrogen,vashj,864,shaman,enhancement,24,9,15
38225,Armîn,moon-guard,863,shaman,enhancement,12,9,3
38226,Lickerman,stormreaver,863,shaman,enhancement,12,9,3
38227,Flukz,nazjatar,863,shaman,enhancement,18,9,9
38228,Massivebolts,stormrage,863,shaman,enhancement,18,9,9
38229,Ephraalin,frostmourne,863,shaman,enhancement,18,9,9
38230,Rubious,cenarius,863,shaman,enhancement,19,9,10
38231,Okkoto,malfurion,862,shaman,enhancement,12,9,3
38232,Tigtotem,malganis,861,shaman,enhancement,12,9,3
38233,Gorgrom,thunderlord,861,shaman,enhancement,12,9,3
38234,Shawkedu,tichondrius,861,shaman,enhancement,24,11,13
38235,Dì,barthilas,859,shaman,enhancement,12,9,3
38236,Vekku,ragnaros,858,shaman,enhancement,18,9,9
38237,Denki,nesingwary,858,shaman,enhancement,18,9,9
38238,Columan,frostmourne,858,shaman,enhancement,46,22,24
38239,Hazorele,nagrand,857,shaman,enhancement,18,9,9
38240,Bilbobaggenz,sargeras,854,shaman,enhancement,18,9,9
38241,Cdont,zuljin,853,shaman,enhancement,18,9,9
38242,Windfuryshm,emerald-dream,853,shaman,enhancement,18,9,9
38243,Googurt,barthilas,831,shaman,enhancement,17,9,8
38244,Taowth,area-52,831,shaman,enhancement,29,9,20
38245,Grosgars,burning-blade,830,shaman,enhancement,20,10,10
38246,Britisy,stormrage,825,shaman,enhancement,24,10,14
38247,Garabashi,boulderfist,814,shaman,enhancement,21,9,12
38248,Maicer,goldrinn,809,shaman,enhancement,29,9,20
38249,Notglads,thrall,799,shaman,enhancement,14,9,5
38250,Thorael,borean-tundra,798,shaman,enhancement,11,9,2
38251,Forloren,zuljin,798,shaman,enhancement,22,9,13
38252,Zêûs,moon-guard,768,shaman,enhancement,12,8,4
38253,Clasm,tichondrius,768,shaman,enhancement,12,8,4
38254,Cinderfury,magtheridon,768,shaman,enhancement,12,8,4
38255,Movemaker,shattered-hand,768,shaman,enhancement,12,8,4
38256,Totemclass,bleeding-hollow,768,shaman,enhancement,12,8,4
38257,Onamakawash,black-dragonflight,768,shaman,enhancement,12,8,4
38258,Blöw,tichondrius,768,shaman,enhancement,12,8,4
38259,Ennoku,khadgar,768,shaman,enhancement,12,8,4
38260,Plznostepmom,tichondrius,768,shaman,enhancement,12,8,4
38261,Hagie,moon-guard,768,shaman,enhancement,15,8,7
38262,Pinechanga,ragnaros,768,shaman,enhancement,18,8,10
38263,Lindsanx,illidan,768,shaman,enhancement,18,8,10
38264,Kinzle,tichondrius,768,shaman,enhancement,24,8,16
38265,Elevatezxo,stormrage,767,shaman,enhancement,12,8,4
38266,Faultline,khadgar,767,shaman,enhancement,12,8,4
38267,Chavezlives,area-52,767,shaman,enhancement,12,8,4
38268,Volrog,magtheridon,767,shaman,enhancement,18,8,10
38269,Feroxture,frostmourne,767,shaman,enhancement,18,8,10
38270,Cuban,kelthuzad,767,shaman,enhancement,18,8,10
38271,Jags,baelgun,767,shaman,enhancement,18,8,10
38272,Beast,mannoroth,767,shaman,enhancement,18,8,10
38273,Finaplex,spirestone,767,shaman,enhancement,18,8,10
38274,Loliqueenfae,illidan,767,shaman,enhancement,18,8,10
38275,Reptimus,sargeras,767,shaman,enhancement,24,8,16
38276,Pipers,frostmourne,767,shaman,enhancement,30,8,22
38277,Chamxz,ragnaros,766,shaman,enhancement,12,8,4
38278,Kulnash,auchindoun,766,shaman,enhancement,12,8,4
38279,Xillas,moon-guard,766,shaman,enhancement,18,8,10
38280,Adhdeeznuts,frostmourne,766,shaman,enhancement,18,8,10
38281,Lazygemini,illidan,764,shaman,enhancement,18,8,10
38282,Orendail,jubeithos,758,shaman,enhancement,24,8,16
38283,Shimshak,destromath,756,shaman,enhancement,18,8,10
38284,Kumu,stormscale,735,shaman,enhancement,11,8,3
38285,Ryb,sargeras,735,shaman,enhancement,14,9,5
38286,Töpg,garrosh,735,shaman,enhancement,16,8,8
38287,Radan,kelthuzad,735,shaman,enhancement,17,8,9
38288,Darshidarsh,emerald-dream,735,shaman,enhancement,22,8,14
38289,Blackshami,quelthalas,718,shaman,enhancement,18,8,10
38290,Pwnskillz,area-52,712,shaman,enhancement,17,8,9
38291,Hammerdog,illidan,703,shaman,enhancement,16,8,8
38292,Grìmlock,lightbringer,687,shaman,enhancement,13,8,5
38293,Lavalinks,malganis,672,shaman,enhancement,12,7,5
38294,Jofstrom,tichondrius,672,shaman,enhancement,12,7,5
38295,Ftp,kelthuzad,672,shaman,enhancement,12,7,5
38296,Battleimp,kelthuzad,672,shaman,enhancement,12,7,5
38297,Yaytotems,sargeras,672,shaman,enhancement,12,7,5
38298,Vásh,quelthalas,672,shaman,enhancement,12,7,5
38299,Windführer,illidan,672,shaman,enhancement,12,7,5
38300,Lividelement,area-52,672,shaman,enhancement,12,7,5
38301,Vokxulsin,tichondrius,672,shaman,enhancement,12,7,5
38302,Vlal,tichondrius,672,shaman,enhancement,12,7,5
38303,Eimear,kelthuzad,672,shaman,enhancement,12,7,5
38304,Oneripemango,illidan,672,shaman,enhancement,12,7,5
38305,Asy,tichondrius,672,shaman,enhancement,12,7,5
38306,Goondruka,area-52,672,shaman,enhancement,12,7,5
38307,Mattzander,kiljaeden,672,shaman,enhancement,12,7,5
38308,Pashå,norgannon,672,shaman,enhancement,12,7,5
38309,Shockshack,illidan,672,shaman,enhancement,12,7,5
38310,Zapstrike,stormrage,672,shaman,enhancement,12,7,5
38311,Shokaria,frostwolf,672,shaman,enhancement,17,8,9
38312,Kidkovid,illidan,672,shaman,enhancement,18,7,11
38313,Stoneseed,steamwheedle-cartel,672,shaman,enhancement,18,7,11
38314,Yungcreampie,bleeding-hollow,672,shaman,enhancement,18,7,11
38315,Raywhiter,tichondrius,672,shaman,enhancement,22,8,14
38316,Murm,burning-blade,671,shaman,enhancement,12,7,5
38317,Checkmâte,emerald-dream,671,shaman,enhancement,12,7,5
38318,Hexondabeach,barthilas,671,shaman,enhancement,12,7,5
38319,Ayahuaska,darkspear,671,shaman,enhancement,12,7,5
38320,Nondracil,ragnaros,671,shaman,enhancement,18,7,11
38321,Gwyste,moon-guard,671,shaman,enhancement,18,7,11
38322,Jëks,azjolnerub,671,shaman,enhancement,18,7,11
38323,Zald,shattered-halls,671,shaman,enhancement,18,7,11
38324,Hrotah,wyrmrest-accord,671,shaman,enhancement,18,7,11
38325,Enhancee,bonechewer,671,shaman,enhancement,18,7,11
38326,Azl,guldan,671,shaman,enhancement,21,8,13
38327,Velekar,moon-guard,671,shaman,enhancement,21,8,13
38328,Radiology,garithos,670,shaman,enhancement,12,7,5
38329,Drewshammy,zuljin,670,shaman,enhancement,12,7,5
38330,Morehammeerr,thunderlord,670,shaman,enhancement,12,7,5
38331,Kigorami,nerzhul,670,shaman,enhancement,18,7,11
38332,Orcgirth,kiljaeden,670,shaman,enhancement,21,8,13
38333,Bhaelfury,moon-guard,669,shaman,enhancement,12,7,5
38334,Halajo,thrall,669,shaman,enhancement,15,8,7
38335,Vladd,hellscream,669,shaman,enhancement,18,7,11
38336,Helljumper,illidan,669,shaman,enhancement,21,8,13
38337,Thorre,the-scryers,666,shaman,enhancement,12,7,5
38338,Blaçktide,thrall,665,shaman,enhancement,12,7,5
38339,Shammich,vashj,655,shaman,enhancement,11,7,4
38340,Speedmonster,hellscream,655,shaman,enhancement,19,8,11
38341,Icedogg,malganis,652,shaman,enhancement,18,7,11
38342,Relyts,tichondrius,638,shaman,enhancement,18,9,9
38343,Rhagnar,warsong,623,shaman,enhancement,11,7,4
38344,Thanen,the-scryers,608,shaman,enhancement,22,8,14
38345,Intress,moon-guard,607,shaman,enhancement,10,7,3
38346,Daikí,ragnaros,606,shaman,enhancement,16,7,9
38347,Eanne,moon-guard,592,shaman,enhancement,19,7,12
38348,Ftierspec,frostmourne,576,shaman,enhancement,6,6,0
38349,Pikoom,tichondrius,576,shaman,enhancement,6,6,0
38350,Nøtørious,thrall,576,shaman,enhancement,6,6,0
38351,Shockpanda,zuljin,576,shaman,enhancement,6,6,0
38352,Ambevsulfr,deathwing,576,shaman,enhancement,6,6,0
38353,Angrymán,ragnaros,576,shaman,enhancement,6,6,0
38354,Spotbeard,shadowsong,576,shaman,enhancement,6,6,0
38355,Vuduü,stormrage,576,shaman,enhancement,6,6,0
38356,Clear,darkspear,576,shaman,enhancement,6,6,0
38357,Scarlo,bleeding-hollow,576,shaman,enhancement,12,6,6
38358,Vultan,winterhoof,576,shaman,enhancement,12,6,6
38359,Owtyobwol,area-52,576,shaman,enhancement,12,6,6
38360,Vanklayser,ragnaros,576,shaman,enhancement,12,6,6
38361,Kêtchpup,wyrmrest-accord,576,shaman,enhancement,12,6,6
38362,Stnky,cairne,576,shaman,enhancement,12,6,6
38363,Stormdancer,elune,576,shaman,enhancement,12,6,6
38364,Nyvka,ragnaros,576,shaman,enhancement,12,6,6
38365,Hruggol,bleeding-hollow,576,shaman,enhancement,12,6,6
38366,Måståçåstå,bleeding-hollow,576,shaman,enhancement,12,6,6
38367,Xaspen,skullcrusher,576,shaman,enhancement,12,6,6
38368,Crucybletv,korgath,576,shaman,enhancement,12,6,6
38369,Dreamers,anvilmar,576,shaman,enhancement,12,6,6
38370,Gódsgíft,tichondrius,576,shaman,enhancement,12,6,6
38371,Agpx,tichondrius,576,shaman,enhancement,12,6,6
38372,Ayahuaskah,illidan,576,shaman,enhancement,12,6,6
38373,Tosil,tichondrius,576,shaman,enhancement,12,6,6
38374,Bussybutter,sargeras,576,shaman,enhancement,12,6,6
38375,Cooperation,kelthuzad,576,shaman,enhancement,12,6,6
38376,Orkshammy,illidan,576,shaman,enhancement,12,6,6
38377,Uggoluga,dalaran,576,shaman,enhancement,12,6,6
38378,Fischerman,barthilas,576,shaman,enhancement,12,6,6
38379,Strønklesøn,drakthul,576,shaman,enhancement,12,6,6
38380,Enhpower,area-52,576,shaman,enhancement,12,6,6
38381,Shamwik,frostmourne,576,shaman,enhancement,12,6,6
38382,Kyzen,tichondrius,576,shaman,enhancement,12,6,6
38383,Groovesh,thrall,576,shaman,enhancement,14,6,8
38384,Ikiteforlsd,zuljin,576,shaman,enhancement,14,6,8
38385,Gluestick,shadowmoon,576,shaman,enhancement,18,6,12
38386,Ferdashock,tichondrius,576,shaman,enhancement,18,6,12
38387,Earthclap,tichondrius,576,shaman,enhancement,18,6,12
38388,Argues,tichondrius,575,shaman,enhancement,12,6,6
38389,Fevolution,dreadmaul,575,shaman,enhancement,12,6,6
38390,Tumble,barthilas,575,shaman,enhancement,12,6,6
38391,Naextramus,ragnaros,575,shaman,enhancement,12,6,6
38392,Oaktar,bleeding-hollow,575,shaman,enhancement,12,6,6
38393,Morderus,aegwynn,575,shaman,enhancement,12,6,6
38394,Somethingdop,sargeras,575,shaman,enhancement,12,6,6
38395,Gingeroo,stonemaul,575,shaman,enhancement,12,6,6
38396,Eternalife,khazgoroth,575,shaman,enhancement,12,6,6
38397,Darkvx,quelthalas,575,shaman,enhancement,12,6,6
38398,Frèya,uldaman,575,shaman,enhancement,12,6,6
38399,Nuofu,illidan,575,shaman,enhancement,16,7,9
38400,Møp,spirestone,575,shaman,enhancement,18,6,12
38401,Zeebouzy,illidan,575,shaman,enhancement,18,6,12
38402,Talfur,area-52,575,shaman,enhancement,18,6,12
38403,Okdopey,area-52,574,shaman,enhancement,18,6,12
38404,Floon,barthilas,573,shaman,enhancement,24,6,18
38405,Størmbreäker,tichondrius,572,shaman,enhancement,12,6,6
38406,Hazreti,zuljin,572,shaman,enhancement,18,6,12
38407,Fadesrp,moon-guard,571,shaman,enhancement,12,6,6
38408,Charr,nemesis,571,shaman,enhancement,12,6,6
38409,Ðg,tichondrius,569,shaman,enhancement,18,6,12
38410,Maxsimiliano,emerald-dream,559,shaman,enhancement,18,6,12
38411,Rykutu,lightbringer,544,shaman,enhancement,10,7,3
38412,Gïrthquake,tichondrius,543,shaman,enhancement,8,7,1
38413,Noveske,arthas,522,shaman,enhancement,15,7,8
38414,Monadazs,ragnaros,511,shaman,enhancement,8,6,2
38415,Slumb,stormrage,496,shaman,enhancement,13,6,7
38416,Zaxibow,area-52,496,shaman,enhancement,19,6,13
38417,Fiercegoblin,drakkari,493,shaman,enhancement,19,6,13
38418,Zappiiboii,malganis,480,shaman,enhancement,6,5,1
38419,Nekorii,bleeding-hollow,480,shaman,enhancement,6,5,1
38420,Beatmán,blades-edge,480,shaman,enhancement,6,5,1
38421,Mokho,stormrage,480,shaman,enhancement,6,5,1
38422,Krunggar,azralon,480,shaman,enhancement,6,5,1
38423,Mynigabob,zuljin,480,shaman,enhancement,6,5,1
38424,Iava,dalaran,480,shaman,enhancement,6,5,1
38425,Dörnèr,malganis,480,shaman,enhancement,6,5,1
38426,Rokudo,dragonmaw,480,shaman,enhancement,6,5,1
38427,Nakamora,tichondrius,480,shaman,enhancement,6,5,1
38428,Bofah,draktharon,480,shaman,enhancement,6,5,1
38429,Tactíc,chromaggus,480,shaman,enhancement,6,5,1
38430,Thiccpedro,andorhal,480,shaman,enhancement,6,5,1
38431,Slothycrit,emerald-dream,480,shaman,enhancement,6,5,1
38432,Taintvapor,stormrage,480,shaman,enhancement,6,5,1
38433,Wugmuk,illidan,480,shaman,enhancement,6,5,1
38434,Tekdar,kiljaeden,480,shaman,enhancement,10,6,4
38435,Sèktor,dalaran,480,shaman,enhancement,12,5,7
38436,Tiostroke,stormrage,480,shaman,enhancement,12,5,7
38437,Macumbolo,nemesis,480,shaman,enhancement,12,5,7
38438,Stankydad,tichondrius,480,shaman,enhancement,12,5,7
38439,Meatlog,dalaran,480,shaman,enhancement,12,5,7
38440,Scrototæm,area-52,480,shaman,enhancement,12,5,7
38441,Jonatasele,stormrage,480,shaman,enhancement,12,5,7
38442,Matzahmeal,skywall,480,shaman,enhancement,12,5,7
38443,Electrikz,moonrunner,480,shaman,enhancement,12,5,7
38444,Capivarãão,stormrage,480,shaman,enhancement,12,5,7
38445,Kuull,thunderlord,480,shaman,enhancement,12,5,7
38446,Hroth,tanaris,480,shaman,enhancement,12,5,7
38447,Indaka,kiljaeden,480,shaman,enhancement,12,5,7
38448,Kamisenhance,illidan,480,shaman,enhancement,12,5,7
38449,Sleepysham,anubarak,480,shaman,enhancement,12,5,7
38450,Spencesham,sargeras,480,shaman,enhancement,12,5,7
38451,Mustachex,kelthuzad,480,shaman,enhancement,12,5,7
38452,Kultirio,quelthalas,480,shaman,enhancement,12,5,7
38453,Azzula,tichondrius,480,shaman,enhancement,13,5,8
38454,Gyokuken,stormrage,480,shaman,enhancement,18,5,13
38455,Fíren,area-52,480,shaman,enhancement,18,5,13
38456,Böc,tichondrius,479,shaman,enhancement,12,5,7
38457,Dushkanar,barthilas,479,shaman,enhancement,12,5,7
38458,Tugnar,ragnaros,479,shaman,enhancement,12,5,7
38459,Aegaeonlol,tichondrius,479,shaman,enhancement,18,5,13
38460,Paulenia,quelthalas,479,shaman,enhancement,21,5,16
38461,Brorogan,aerie-peak,478,shaman,enhancement,12,5,7
38462,Enkkiz,ragnaros,477,shaman,enhancement,12,5,7
38463,Curtrex,amanthul,472,shaman,enhancement,19,8,11
38464,Catchclause,eonar,463,shaman,enhancement,12,6,6
38465,Flamestrife,illidan,426,shaman,enhancement,28,8,20
38466,Megumi,aggramar,415,shaman,enhancement,8,5,3
38467,Furiousnick,stormrage,415,shaman,enhancement,8,5,3
38468,Lukora,stonemaul,384,shaman,enhancement,6,4,2
38469,Tokyotimxxo,malganis,384,shaman,enhancement,6,4,2
38470,Kylani,thrall,384,shaman,enhancement,6,4,2
38471,Exsh,area-52,384,shaman,enhancement,6,4,2
38472,Skipler,stormrage,384,shaman,enhancement,6,4,2
38473,Utilitytotem,moon-guard,384,shaman,enhancement,6,4,2
38474,Drugdòér,tichondrius,384,shaman,enhancement,6,4,2
38475,Tarazhim,kelthuzad,384,shaman,enhancement,6,4,2
38476,Ezzroz,guldan,384,shaman,enhancement,6,4,2
38477,Garshok,tichondrius,384,shaman,enhancement,6,4,2
38478,Firetrucks,area-52,384,shaman,enhancement,6,4,2
38479,Bioshocked,korgath,384,shaman,enhancement,6,4,2
38480,Dingfu,sargeras,384,shaman,enhancement,6,4,2
38481,Wools,frostmourne,384,shaman,enhancement,6,4,2
38482,Anlukla,gilneas,384,shaman,enhancement,6,4,2
38483,Protoaster,tichondrius,384,shaman,enhancement,6,4,2
38484,Aureal,malganis,384,shaman,enhancement,6,4,2
38485,Mastrionilol,dragonmaw,384,shaman,enhancement,6,4,2
38486,Grimwind,tichondrius,384,shaman,enhancement,6,4,2
38487,Enanomka,drakkari,384,shaman,enhancement,6,4,2
38488,Lizardhusk,barthilas,384,shaman,enhancement,6,4,2
38489,Angrytotems,ragnaros,384,shaman,enhancement,6,4,2
38490,Sorgal,area-52,384,shaman,enhancement,6,4,2
38491,Meramin,illidan,384,shaman,enhancement,6,4,2
38492,Kisseyfaçaí,kelthuzad,384,shaman,enhancement,6,4,2
38493,Goldshîre,tichondrius,384,shaman,enhancement,6,4,2
38494,Hooluu,frostmourne,384,shaman,enhancement,6,4,2
38495,Jènova,whisperwind,384,shaman,enhancement,6,4,2
38496,Slurslinger,area-52,384,shaman,enhancement,6,4,2
38497,Eleshortal,azuremyst,384,shaman,enhancement,9,4,5
38498,Smackzs,sargeras,384,shaman,enhancement,12,4,8
38499,Wabfurrie,twisting-nether,384,shaman,enhancement,12,4,8
38500,Piril,moon-guard,384,shaman,enhancement,12,4,8
38501,Bloudabadee,emerald-dream,384,shaman,enhancement,12,4,8
38502,Tictactotem,lothar,384,shaman,enhancement,12,4,8
38503,Nìke,nazgrel,384,shaman,enhancement,12,4,8
38504,Neeman,malganis,384,shaman,enhancement,12,4,8
38505,Newele,thrall,384,shaman,enhancement,12,4,8
38506,Gangdan,emerald-dream,384,shaman,enhancement,12,4,8
38507,Emppege,tichondrius,384,shaman,enhancement,12,4,8
38508,Kooj,frostmourne,384,shaman,enhancement,12,4,8
38509,Nehrakgu,wyrmrest-accord,384,shaman,enhancement,12,4,8
38510,Skizzymars,malganis,384,shaman,enhancement,12,4,8
38511,Ironloins,kelthuzad,384,shaman,enhancement,12,4,8
38512,Vertrág,malganis,384,shaman,enhancement,12,4,8
38513,Omaboa,azgalor,384,shaman,enhancement,12,4,8
38514,Kinnarlan,sargeras,384,shaman,enhancement,12,4,8
38515,Gaurudon,zuljin,384,shaman,enhancement,12,4,8
38516,Xoelement,borean-tundra,384,shaman,enhancement,18,4,14
38517,Brenqt,nemesis,384,shaman,enhancement,18,4,14
38518,Grimdil,quelthalas,384,shaman,enhancement,18,4,14
38519,Jacniclstorm,frostmourne,383,shaman,enhancement,6,4,2
38520,Ipponhim,saurfang,383,shaman,enhancement,6,4,2
38521,Ghogann,bleeding-hollow,383,shaman,enhancement,6,4,2
38522,Rhal,ragnaros,383,shaman,enhancement,6,4,2
38523,Rocktor,alleria,383,shaman,enhancement,6,4,2
38524,Toeto,darrowmere,383,shaman,enhancement,6,4,2
38525,Ugaboogah,thrall,383,shaman,enhancement,6,4,2
38526,Shambostik,thrall,383,shaman,enhancement,12,4,8
38527,Kalashnikov,maiev,383,shaman,enhancement,12,4,8
38528,Smolder,magtheridon,383,shaman,enhancement,12,4,8
38529,Drokán,ragnaros,383,shaman,enhancement,20,5,15
38530,Notahealz,zuljin,367,shaman,enhancement,11,4,7
38531,Kyness,area-52,364,shaman,enhancement,13,5,8
38532,Admetis,vashj,351,shaman,enhancement,17,4,13
38533,Thorsén,ursin,335,shaman,enhancement,17,4,13
38534,Jeaunoo,darkspear,330,shaman,enhancement,14,5,9
38535,Totojar,alexstrasza,330,shaman,enhancement,16,5,11
38536,Olani,nesingwary,319,shaman,enhancement,5,4,1
38537,Sasageyo,tichondrius,319,shaman,enhancement,8,4,4
38538,Habrith,proudmoore,319,shaman,enhancement,11,4,7
38539,Xulangshammy,illidan,319,shaman,enhancement,11,4,7
38540,Tempestsmash,tichondrius,304,shaman,enhancement,7,4,3
38541,Bimbly,eitrigg,303,shaman,enhancement,13,4,9
38542,Shammateur,malganis,288,shaman,enhancement,6,3,3
38543,Defiant,azgalor,288,shaman,enhancement,6,3,3
38544,Freshoranges,blood-furnace,288,shaman,enhancement,6,3,3
38545,Gumballin,sargeras,288,shaman,enhancement,6,3,3
38546,Shamaro,malganis,288,shaman,enhancement,6,3,3
38547,Cluffatty,tichondrius,288,shaman,enhancement,6,3,3
38548,Zeroshears,tichondrius,288,shaman,enhancement,6,3,3
38549,Kubisham,warsong,288,shaman,enhancement,6,3,3
38550,Drgreek,barthilas,288,shaman,enhancement,6,3,3
38551,Slowdown,malganis,288,shaman,enhancement,6,3,3
38552,Jumoma,thrall,288,shaman,enhancement,6,3,3
38553,Arckos,thrall,288,shaman,enhancement,6,3,3
38554,Gojiras,barthilas,288,shaman,enhancement,6,3,3
38555,Totemtantrum,tichondrius,288,shaman,enhancement,6,3,3
38556,Glexhex,tichondrius,288,shaman,enhancement,6,3,3
38557,Swifteyy,area-52,288,shaman,enhancement,6,3,3
38558,Aruçar,drakkari,288,shaman,enhancement,6,3,3
38559,Yelpreviewer,dalaran,288,shaman,enhancement,6,3,3
38560,Sourcreamqtx,stormrage,288,shaman,enhancement,6,3,3
38561,Botu,malorne,288,shaman,enhancement,6,3,3
38562,Spankì,kelthuzad,288,shaman,enhancement,6,3,3
38563,Smokedemtree,stormrage,288,shaman,enhancement,6,3,3
38564,Corkrain,sargeras,288,shaman,enhancement,6,3,3
38565,Argena,bonechewer,288,shaman,enhancement,6,3,3
38566,Owiez,sargeras,288,shaman,enhancement,6,3,3
38567,Zapmavz,area-52,288,shaman,enhancement,6,3,3
38568,Lennylemons,stormrage,288,shaman,enhancement,6,3,3
38569,Morgoph,bleeding-hollow,288,shaman,enhancement,6,3,3
38570,Haititnahtou,kaelthas,288,shaman,enhancement,6,3,3
38571,Ulala,azshara,288,shaman,enhancement,6,3,3
38572,Vanmaichet,azshara,288,shaman,enhancement,6,3,3
38573,Getwetand,quelthalas,288,shaman,enhancement,6,3,3
38574,Cars,jaedenar,288,shaman,enhancement,6,3,3
38575,Bottlez,sargeras,288,shaman,enhancement,6,3,3
38576,Electabuzz,arygos,288,shaman,enhancement,6,3,3
38577,Dogcompany,tichondrius,288,shaman,enhancement,6,3,3
38578,Jibbajabber,laughing-skull,288,shaman,enhancement,6,3,3
38579,Zoma,elune,288,shaman,enhancement,6,3,3
38580,Painfury,zuljin,288,shaman,enhancement,6,3,3
38581,Luxenor,kelthuzad,288,shaman,enhancement,6,3,3
38582,Xantíd,wyrmrest-accord,288,shaman,enhancement,6,3,3
38583,Sleepysham,kelthuzad,288,shaman,enhancement,6,3,3
38584,Stylebenderx,frostmourne,288,shaman,enhancement,6,3,3
38585,Bovinefony,blackrock,288,shaman,enhancement,6,3,3
38586,Thiccwater,frostmourne,288,shaman,enhancement,6,3,3
38587,Suejitsue,malganis,288,shaman,enhancement,6,3,3
38588,Redpocket,zuluhed,288,shaman,enhancement,6,3,3
38589,Feesstt,malganis,288,shaman,enhancement,6,3,3
38590,Toyletpaper,mugthol,288,shaman,enhancement,6,3,3
38591,Ban,blackrock,288,shaman,enhancement,6,3,3
38592,Vivean,kelthuzad,288,shaman,enhancement,6,3,3
38593,Lïnc,sargeras,288,shaman,enhancement,6,3,3
38594,Dwightjr,emerald-dream,288,shaman,enhancement,6,3,3
38595,Smeeza,frostmourne,288,shaman,enhancement,6,3,3
38596,Ceromental,frostmane,288,shaman,enhancement,6,3,3
38597,Emtflakes,darkspear,288,shaman,enhancement,6,3,3
38598,Slowkeeper,azralon,288,shaman,enhancement,6,3,3
38599,Mundi,madoran,288,shaman,enhancement,6,3,3
38600,Gimpanzee,kiljaeden,288,shaman,enhancement,6,3,3
38601,Gorszu,proudmoore,288,shaman,enhancement,6,3,3
38602,Jaftter,quelthalas,288,shaman,enhancement,9,4,5
38603,Putinsdad,tichondrius,288,shaman,enhancement,10,4,6
38604,Kakiscala,proudmoore,288,shaman,enhancement,11,3,8
38605,Gudac,tichondrius,288,shaman,enhancement,12,3,9
38606,Jireñ,area-52,288,shaman,enhancement,12,3,9
38607,Çatastrophe,dalaran,288,shaman,enhancement,12,3,9
38608,Regeneration,darkspear,288,shaman,enhancement,12,3,9
38609,Faelzão,nemesis,288,shaman,enhancement,12,3,9
38610,Fishmoley,zuljin,288,shaman,enhancement,12,3,9
38611,Cvoa,bonechewer,288,shaman,enhancement,12,3,9
38612,Shockfreak,stormrage,288,shaman,enhancement,12,3,9
38613,Immunize,tichondrius,288,shaman,enhancement,12,3,9
38614,Jajxshammy,rivendare,288,shaman,enhancement,12,3,9
38615,Malsturm,stormrage,288,shaman,enhancement,12,3,9
38616,Rockbass,sargeras,288,shaman,enhancement,12,3,9
38617,Yaazz,frostmourne,288,shaman,enhancement,12,3,9
38618,Azão,stormrage,288,shaman,enhancement,12,3,9
38619,Thunderblood,nerzhul,288,shaman,enhancement,12,3,9
38620,Hammaam,illidan,288,shaman,enhancement,12,3,9
38621,Khazy,skullcrusher,288,shaman,enhancement,12,3,9
38622,Smeagðl,tichondrius,288,shaman,enhancement,12,3,9
38623,Drahlos,tichondrius,288,shaman,enhancement,12,3,9
38624,Bobbymooshay,area-52,288,shaman,enhancement,12,3,9
38625,Drekkhal,area-52,288,shaman,enhancement,12,3,9
38626,Silverwolf,eredar,288,shaman,enhancement,12,3,9
38627,Wickyz,moon-guard,288,shaman,enhancement,12,3,9
38628,Drgiggleheim,tichondrius,288,shaman,enhancement,12,3,9
38629,Jhivone,tichondrius,288,shaman,enhancement,12,3,9
38630,Cydarta,ragnaros,287,shaman,enhancement,6,3,3
38631,Xaryu,shuhalo,287,shaman,enhancement,12,3,9
38632,Dnttazemebro,area-52,286,shaman,enhancement,6,3,3
38633,ßodycount,area-52,240,shaman,enhancement,9,3,6
38634,Caobuloso,azralon,239,shaman,enhancement,5,3,2
38635,Sølbi,tichondrius,239,shaman,enhancement,5,3,2
38636,Deeznuts,the-forgotten-coast,239,shaman,enhancement,5,3,2
38637,Smooths,bloodscalp,234,shaman,enhancement,19,5,14
38638,Forge,maelstrom,223,shaman,enhancement,8,3,5
38639,Møostrom,thrall,192,shaman,enhancement,6,2,4
38640,Sparklebunny,dark-iron,192,shaman,enhancement,6,2,4
38641,Loused,shattered-hand,192,shaman,enhancement,6,2,4
38642,Badjujubruh,thrall,192,shaman,enhancement,6,2,4
38643,Olboy,thrall,192,shaman,enhancement,6,2,4
38644,Skyten,quelthalas,192,shaman,enhancement,6,2,4
38645,Shamnick,malganis,192,shaman,enhancement,6,2,4
38646,Saltt,proudmoore,192,shaman,enhancement,6,2,4
38647,Meatyball,tichondrius,192,shaman,enhancement,6,2,4
38648,Totemzie,illidan,192,shaman,enhancement,6,2,4
38649,Virô,sargeras,192,shaman,enhancement,6,2,4
38650,Durogh,darkspear,192,shaman,enhancement,6,2,4
38651,Scarshamxn,frostmourne,192,shaman,enhancement,6,2,4
38652,Milkmeforhp,frostmourne,192,shaman,enhancement,6,2,4
38653,Shaminja,kiljaeden,192,shaman,enhancement,6,2,4
38654,Amzurs,area-52,192,shaman,enhancement,6,2,4
38655,Dennwoop,sargeras,192,shaman,enhancement,6,2,4
38656,Elecpod,frostmourne,192,shaman,enhancement,6,2,4
38657,Ectomee,tichondrius,192,shaman,enhancement,6,2,4
38658,Cutedraenei,destromath,192,shaman,enhancement,6,2,4
38659,Shockedya,destromath,192,shaman,enhancement,6,2,4
38660,Twistër,illidan,192,shaman,enhancement,6,2,4
38661,Dadajuju,azralon,192,shaman,enhancement,6,2,4
38662,Hothandxo,illidan,192,shaman,enhancement,6,2,4
38663,Jasonnworb,tichondrius,192,shaman,enhancement,6,2,4
38664,Víì,tichondrius,192,shaman,enhancement,6,2,4
38665,Pandancement,thrall,192,shaman,enhancement,6,2,4
38666,Bitxxnumber,tichondrius,192,shaman,enhancement,6,2,4
38667,Szael,durotan,192,shaman,enhancement,6,2,4
38668,Eraali,stormrage,192,shaman,enhancement,6,2,4
38669,Blooddtears,stormrage,192,shaman,enhancement,6,2,4
38670,Kelce,stormrage,192,shaman,enhancement,6,2,4
38671,Contraponto,azralon,192,shaman,enhancement,6,2,4
38672,Stormfronts,kelthuzad,192,shaman,enhancement,6,2,4
38673,Vywolf,frostmourne,192,shaman,enhancement,6,2,4
38674,Rayjamalblk,tichondrius,192,shaman,enhancement,6,2,4
38675,Bootsix,area-52,192,shaman,enhancement,6,2,4
38676,Ôprawindfury,mugthol,192,shaman,enhancement,6,2,4
38677,Friedshammy,frostmourne,192,shaman,enhancement,6,2,4
38678,Unhapintadaa,azralon,192,shaman,enhancement,6,2,4
38679,Ceedlamb,kelthuzad,192,shaman,enhancement,6,2,4
38680,Vitaminc,garona,192,shaman,enhancement,6,2,4
38681,Beelzeburst,sargeras,192,shaman,enhancement,6,2,4
38682,Bullcowsby,darkspear,192,shaman,enhancement,6,2,4
38683,Zeldrys,emerald-dream,192,shaman,enhancement,6,2,4
38684,Brofessor,frostwolf,192,shaman,enhancement,6,2,4
38685,Quequin,quelthalas,192,shaman,enhancement,6,2,4
38686,Vjeze,frostmourne,192,shaman,enhancement,6,2,4
38687,Shamutari,sargeras,192,shaman,enhancement,6,2,4
38688,Zenitsue,sargeras,192,shaman,enhancement,6,2,4
38689,Detair,malganis,192,shaman,enhancement,6,2,4
38690,Jahahahamon,arthas,192,shaman,enhancement,6,2,4
38691,Electrica,quelthalas,192,shaman,enhancement,6,2,4
38692,Bearmanshrek,tichondrius,192,shaman,enhancement,6,2,4
38693,Kumer,tichondrius,192,shaman,enhancement,6,2,4
38694,Daiablo,barthilas,192,shaman,enhancement,6,2,4
38695,ßeesy,emerald-dream,192,shaman,enhancement,6,2,4
38696,Thorlottie,stormrage,192,shaman,enhancement,6,2,4
38697,Pericazo,sargeras,192,shaman,enhancement,6,2,4
38698,Netflixnfeet,moonrunner,192,shaman,enhancement,6,2,4
38699,Killamanjaro,alterac-mountains,192,shaman,enhancement,6,2,4
38700,Ageegee,sargeras,192,shaman,enhancement,6,2,4
38701,Tamzlol,the-forgotten-coast,192,shaman,enhancement,6,2,4
38702,Freesolo,barthilas,192,shaman,enhancement,6,2,4
38703,Boj,magtheridon,192,shaman,enhancement,6,2,4
38704,Rinjio,zuljin,192,shaman,enhancement,6,2,4
38705,Khuufu,fizzcrank,192,shaman,enhancement,6,2,4
38706,Stallos,zuljin,192,shaman,enhancement,6,2,4
38707,Valcannos,area-52,192,shaman,enhancement,6,2,4
38708,Jammylol,frostmourne,192,shaman,enhancement,6,2,4
38709,Shamanakin,emerald-dream,192,shaman,enhancement,6,2,4
38710,Thrallzballz,firetree,192,shaman,enhancement,6,2,4
38711,Soapmactavis,sargeras,192,shaman,enhancement,6,2,4
38712,Fatluma,zuljin,192,shaman,enhancement,6,2,4
38713,Whameradetu,suramar,192,shaman,enhancement,6,2,4
38714,Mishalla,tichondrius,192,shaman,enhancement,6,2,4
38715,Jbahr,hyjal,192,shaman,enhancement,6,2,4
38716,Kaalyssia,moon-guard,192,shaman,enhancement,6,2,4
38717,Wìzz,zuljin,192,shaman,enhancement,6,2,4
38718,Hèllzpyro,sargeras,192,shaman,enhancement,6,2,4
38719,Pissticles,bleeding-hollow,192,shaman,enhancement,6,2,4
38720,Shamflu,tichondrius,192,shaman,enhancement,6,2,4
38721,Kermut,frostmourne,192,shaman,enhancement,6,2,4
38722,Sluggox,bleeding-hollow,192,shaman,enhancement,6,2,4
38723,Amärök,area-52,192,shaman,enhancement,6,2,4
38724,Zentius,thunderhorn,192,shaman,enhancement,6,2,4
38725,Girthquake,agamaggan,192,shaman,enhancement,6,2,4
38726,Nawoma,quelthalas,192,shaman,enhancement,8,2,6
38727,Zarzlek,destromath,192,shaman,enhancement,12,2,10
38728,Legendmatic,illidan,192,shaman,enhancement,12,2,10
38729,Tarresh,azralon,192,shaman,enhancement,12,2,10
38730,Zuljiba,illidan,192,shaman,enhancement,12,2,10
38731,Gusgusgus,laughing-skull,192,shaman,enhancement,12,2,10
38732,Chontu,area-52,192,shaman,enhancement,12,2,10
38733,Shockszz,onyxia,192,shaman,enhancement,12,2,10
38734,Ahzar,stormrage,192,shaman,enhancement,12,2,10
38735,Stylebend,area-52,192,shaman,enhancement,12,2,10
38736,Dahmerjr,area-52,191,shaman,enhancement,6,2,4
38737,Calmconflict,daggerspine,191,shaman,enhancement,6,2,4
38738,Skuffedx,spirestone,159,shaman,enhancement,5,2,3
38739,Nuggitz,tichondrius,159,shaman,enhancement,5,2,3
38740,Dønßlack,thunderhorn,159,shaman,enhancement,5,2,3
38741,Shamto,zuljin,144,shaman,enhancement,3,3,0
38742,Reavs,illidan,138,shaman,enhancement,16,3,13
38743,Bogz,korgath,128,shaman,enhancement,4,2,2
38744,Grogakk,moon-guard,128,shaman,enhancement,4,2,2
38745,Flashyjoe,tichondrius,128,shaman,enhancement,4,2,2
38746,Badgeshock,area-52,128,shaman,enhancement,4,2,2
38747,Ludacrìtz,stormrage,112,shaman,enhancement,7,2,5
38748,Shamcakes,kilrogg,96,shaman,enhancement,17,3,14
38749,Ohtoro,zuljin,96,shaman,enhancement,6,1,5
38750,Wangbangjr,mugthol,96,shaman,enhancement,6,1,5
38751,Zapsquidzap,illidan,96,shaman,enhancement,6,1,5
38752,Totemtîme,frostmourne,96,shaman,enhancement,6,1,5
38753,Pileef,thrall,96,shaman,enhancement,6,1,5
38754,Sureofname,frostmourne,96,shaman,enhancement,6,1,5
38755,Kinjin,dragonmaw,96,shaman,enhancement,6,1,5
38756,Feuerbart,dalaran,96,shaman,enhancement,6,1,5
38757,Yudo,stormrage,96,shaman,enhancement,6,1,5
38758,Zizö,barthilas,96,shaman,enhancement,6,1,5
38759,Blackjackxx,frostmourne,96,shaman,enhancement,6,1,5
38760,Zoeyzour,illidan,96,shaman,enhancement,6,1,5
38761,Mawcus,zuljin,96,shaman,enhancement,6,1,5
38762,Muyg,staghelm,96,shaman,enhancement,6,1,5
38763,Geladoo,gallywix,96,shaman,enhancement,6,1,5
38764,Hangellyca,azralon,96,shaman,enhancement,6,1,5
38765,Volaarn,area-52,96,shaman,enhancement,6,1,5
38766,Aerôv,area-52,96,shaman,enhancement,6,1,5
38767,Saesenthesis,barthilas,96,shaman,enhancement,6,1,5
38768,Aiggiggigne,sargeras,96,shaman,enhancement,6,1,5
38769,Succies,emerald-dream,96,shaman,enhancement,6,1,5
38770,Stormsanta,emerald-dream,96,shaman,enhancement,6,1,5
38771,Littz,malganis,96,shaman,enhancement,6,1,5
38772,Sweettooth,area-52,96,shaman,enhancement,6,1,5
38773,Fourever,ragnaros,96,shaman,enhancement,6,1,5
38774,Toyotatron,tichondrius,96,shaman,enhancement,6,1,5
38775,Shamofshame,garrosh,96,shaman,enhancement,6,1,5
38776,Kàrlx,tichondrius,96,shaman,enhancement,6,1,5
38777,Beazel,moon-guard,96,shaman,enhancement,6,1,5
38778,Ikora,crushridge,96,shaman,enhancement,6,1,5
38779,Sandmanatee,crushridge,96,shaman,enhancement,6,1,5
38780,Tictactotum,hyjal,96,shaman,enhancement,6,1,5
38781,Axshaman,darkspear,96,shaman,enhancement,6,1,5
38782,Kranif,tichondrius,96,shaman,enhancement,6,1,5
38783,Globad,tichondrius,96,shaman,enhancement,6,1,5
38784,Paramecium,sargeras,96,shaman,enhancement,6,1,5
38785,Acéz,korgath,96,shaman,enhancement,6,1,5
38786,Shrektar,cenarius,96,shaman,enhancement,6,1,5
38787,Alferian,moon-guard,96,shaman,enhancement,6,1,5
38788,Karmar,proudmoore,96,shaman,enhancement,6,1,5
38789,Tritun,proudmoore,96,shaman,enhancement,6,1,5
38790,Yungmeaty,tichondrius,96,shaman,enhancement,7,1,6
38791,Threehandz,bleeding-hollow,96,shaman,enhancement,8,1,7
38792,Immutef,tichondrius,96,shaman,enhancement,12,1,11
38793,Thallor,stormrage,96,shaman,enhancement,12,1,11
38794,Smokeymcpots,khazgoroth,95,shaman,enhancement,6,1,5
38795,Artsha,tol-barad,79,shaman,enhancement,5,1,4
38796,Dilldoughnut,sargeras,79,shaman,enhancement,5,1,4
38797,Shablam,daggerspine,64,shaman,enhancement,10,1,9
38798,Engorgdshock,tichondrius,63,shaman,enhancement,2,2,0
38799,Zugxo,area-52,63,shaman,enhancement,2,2,0
38800,Toastsshaman,tichondrius,48,shaman,enhancement,3,1,2
38801,Ekatonkiro,ragnaros,48,shaman,enhancement,3,1,2
38802,Totemlord,lightnings-blade,31,shaman,enhancement,2,1,1
38803,Rykku,illidan,16,shaman,enhancement,1,1,0
38804,Stumpyjoe,terokkar,16,shaman,enhancement,7,1,6
38805,Wildimp,aerie-peak,2323,warlock,demonology,108,66,42
38806,Mlx,proudmoore,2294,warlock,demonology,137,79,58
38807,Btsfangirl,moon-guard,2263,warlock,demonology,104,60,44
38808,Wildimpx,sargeras,2240,warlock,demonology,107,60,47
38809,Wzxx,tichondrius,2222,warlock,demonology,84,46,38
38810,Babyaga,illidan,2201,warlock,demonology,84,47,37
38811,Beyourselff,tichondrius,2195,warlock,demonology,151,80,71
38812,Mixtape,stormrage,2178,warlock,demonology,77,47,30
38813,Bahamas,bleeding-hollow,2166,warlock,demonology,78,46,32
38814,Jojofann,nemesis,2165,warlock,demonology,53,37,16
38815,Bronzerl,tichondrius,2149,warlock,demonology,51,32,19
38816,Gentleq,tichondrius,2149,warlock,demonology,99,53,46
38817,Gianni,chogall,2149,warlock,demonology,107,57,50
38818,Kaossqt,azralon,2144,warlock,demonology,114,62,52
38819,Zuelu,tichondrius,2141,warlock,demonology,121,68,53
38820,Erock,korgath,2138,warlock,demonology,60,47,13
38821,Wesyane,anetheron,2135,warlock,demonology,124,66,58
38822,Xadge,tichondrius,2128,warlock,demonology,79,43,36
38823,Fishorz,tichondrius,2128,warlock,demonology,89,47,42
38824,Ediya,tichondrius,2128,warlock,demonology,147,74,73
38825,Harambê,sargeras,2127,warlock,demonology,36,27,9
38826,Lemmefear,illidan,2127,warlock,demonology,47,32,15
38827,Miredö,tichondrius,2121,warlock,demonology,60,35,25
38828,Bigdaddylol,ragnaros,2120,warlock,demonology,83,45,38
38829,Fatass,cairne,2114,warlock,demonology,66,38,28
38830,Awdam,tichondrius,2114,warlock,demonology,96,50,46
38831,Ensebado,azralon,2111,warlock,demonology,140,78,62
38832,Falco,azshara,2110,warlock,demonology,66,38,28
38833,Synkz,blood-furnace,2110,warlock,demonology,72,38,34
38834,Cosmosxx,illidan,2110,warlock,demonology,112,58,54
38835,Lilballz,tichondrius,2107,warlock,demonology,53,31,22
38836,Ogchaos,tichondrius,2107,warlock,demonology,78,45,33
38837,Tessarath,area-52,2106,warlock,demonology,59,38,21
38838,Unhòólylck,ragnaros,2082,warlock,demonology,105,56,49
38839,Erlandesher,tichondrius,2066,warlock,demonology,131,65,66
38840,Spicyfingers,illidan,2056,warlock,demonology,72,41,31
38841,Persistencss,tichondrius,2047,warlock,demonology,48,29,19
38842,Oymmander,illidan,2046,warlock,demonology,56,37,19
38843,Boltqt,tichondrius,2046,warlock,demonology,54,33,21
38844,Vexxes,malganis,2042,warlock,demonology,168,89,79
38845,Broccoleh,area-52,2033,warlock,demonology,59,36,23
38846,Etuskaa,tichondrius,2032,warlock,demonology,167,83,84
38847,Eazyw,stormrage,2024,warlock,demonology,95,47,48
38848,Sslock,sargeras,2008,warlock,demonology,71,37,34
38849,Ziffy,emerald-dream,2008,warlock,demonology,66,34,32
38850,Nocrackrocks,stormrage,2007,warlock,demonology,117,66,51
38851,Atheô,ragnaros,2004,warlock,demonology,106,57,49
38852,Elbrujon,sargeras,2002,warlock,demonology,107,55,52
38853,Xygg,tichondrius,2000,warlock,demonology,54,31,23
38854,Ztlivid,area-52,2000,warlock,demonology,175,91,84
38855,Awangdemon,tichondrius,1997,warlock,demonology,54,27,27
38856,Bleachkk,tichondrius,1992,warlock,demonology,71,47,24
38857,Maadhum,illidan,1992,warlock,demonology,69,37,32
38858,Coèrce,tichondrius,1989,warlock,demonology,47,32,15
38859,Megamindx,tichondrius,1981,warlock,demonology,24,21,3
38860,Teivlol,mugthol,1980,warlock,demonology,96,51,45
38861,Extreme,blackwing-lair,1978,warlock,demonology,78,53,25
38862,Toiletghost,tichondrius,1973,warlock,demonology,56,35,21
38863,Littlerod,tichondrius,1967,warlock,demonology,60,34,26
38864,Procalypse,stormrage,1966,warlock,demonology,54,32,22
38865,Patoquenn,azralon,1966,warlock,demonology,54,32,22
38866,Ofc,malganis,1961,warlock,demonology,48,29,19
38867,Snuufels,area-52,1950,warlock,demonology,60,37,23
38868,Ketahole,warsong,1949,warlock,demonology,99,50,49
38869,Ihaveapowers,maiev,1944,warlock,demonology,120,60,60
38870,Naughtybolts,sargeras,1941,warlock,demonology,80,46,34
38871,Amazingamez,sargeras,1940,warlock,demonology,137,66,71
38872,Baka,moon-guard,1937,warlock,demonology,54,29,25
38873,Stopdot,lightnings-blade,1934,warlock,demonology,76,38,38
38874,Paygo,tichondrius,1930,warlock,demonology,57,32,25
38875,Aramith,tichondrius,1922,warlock,demonology,64,37,27
38876,Shadowmoonon,tichondrius,1921,warlock,demonology,43,21,22
38877,Bronzel,tichondrius,1920,warlock,demonology,48,30,18
38878,Invalid,frostmourne,1914,warlock,demonology,36,25,11
38879,Ceeloftw,tichondrius,1914,warlock,demonology,113,60,53
38880,Lilgigs,stormrage,1909,warlock,demonology,60,30,30
38881,Inmøtion,tichondrius,1906,warlock,demonology,60,33,27
38882,Sofan,dalaran,1905,warlock,demonology,58,33,25
38883,Lockedinn,mannoroth,1904,warlock,demonology,91,54,37
38884,Iselltacos,dalaran,1900,warlock,demonology,31,21,10
38885,Daerde,malganis,1900,warlock,demonology,47,27,20
38886,Siphoned,darkspear,1900,warlock,demonology,53,27,26
38887,Deadlpoo,stormscale,1899,warlock,demonology,81,41,40
38888,Xiyangpvp,tichondrius,1898,warlock,demonology,54,31,23
38889,Bwonsamdijin,tichondrius,1898,warlock,demonology,95,44,51
38890,Lemmepvponu,illidan,1896,warlock,demonology,48,30,18
38891,Alisa,moon-guard,1896,warlock,demonology,60,28,32
38892,Lrry,dalaran,1893,warlock,demonology,144,84,60
38893,Shinyballz,tichondrius,1890,warlock,demonology,47,28,19
38894,Rakshama,chogall,1885,warlock,demonology,42,25,17
38895,Abrocket,alleria,1883,warlock,demonology,36,23,13
38896,Debao,malganis,1881,warlock,demonology,60,29,31
38897,Petattack,nerzhul,1878,warlock,demonology,125,60,65
38898,Kimchiblast,tichondrius,1876,warlock,demonology,48,28,20
38899,Demondisco,tichondrius,1873,warlock,demonology,95,45,50
38900,Zydiva,sargeras,1872,warlock,demonology,118,62,56
38901,Cosmosxi,illidan,1871,warlock,demonology,36,23,13
38902,Sàill,tichondrius,1871,warlock,demonology,35,22,13
38903,Dotman,tichondrius,1871,warlock,demonology,60,32,28
38904,Thranlock,area-52,1862,warlock,demonology,132,65,67
38905,Bbangtimo,tichondrius,1858,warlock,demonology,39,22,17
38906,Mhael,lightninghoof,1856,warlock,demonology,54,32,22
38907,Playtoy,moon-guard,1856,warlock,demonology,154,78,76
38908,Atheø,ragnaros,1854,warlock,demonology,42,23,19
38909,Lcomi,tichondrius,1850,warlock,demonology,42,26,16
38910,Demyo,tichondrius,1849,warlock,demonology,38,21,17
38911,Díablo,bleeding-hollow,1848,warlock,demonology,53,36,17
38912,Redfish,tichondrius,1847,warlock,demonology,34,20,14
38913,Phóbòs,tichondrius,1843,warlock,demonology,54,40,14
38914,Percadu,barthilas,1843,warlock,demonology,85,43,42
38915,Metic,firetree,1842,warlock,demonology,48,33,15
38916,Kerrigan,the-venture-co,1842,warlock,demonology,66,38,28
38917,Darkzell,azralon,1841,warlock,demonology,48,30,18
38918,Dlhmlock,tichondrius,1840,warlock,demonology,41,25,16
38919,Alndron,thrall,1837,warlock,demonology,78,38,40
38920,Aoepump,tichondrius,1836,warlock,demonology,54,27,27
38921,Ccona,tichondrius,1835,warlock,demonology,42,23,19
38922,Speakeasy,malygos,1835,warlock,demonology,58,29,29
38923,Beatinu,draenor,1834,warlock,demonology,54,32,22
38924,Åmön,zuljin,1832,warlock,demonology,66,32,34
38925,ßøßßÿßøûçhêr,tichondrius,1831,warlock,demonology,36,25,11
38926,Drakatattwo,tichondrius,1831,warlock,demonology,42,23,19
38927,Evildeath,tichondrius,1829,warlock,demonology,48,26,22
38928,Bic,thrall,1828,warlock,demonology,66,45,21
38929,Lowrcase,zuljin,1828,warlock,demonology,42,24,18
38930,Juleno,quelthalas,1827,warlock,demonology,51,28,23
38931,Xoboroz,moon-guard,1827,warlock,demonology,60,29,31
38932,Maral,kelthuzad,1826,warlock,demonology,57,32,25
38933,Cendit,malganis,1825,warlock,demonology,54,34,20
38934,Jerclard,proudmoore,1825,warlock,demonology,90,51,39
38935,Castingfear,barthilas,1825,warlock,demonology,48,27,21
38936,Greasymario,area-52,1824,warlock,demonology,60,42,18
38937,Axelrodx,tichondrius,1824,warlock,demonology,54,35,19
38938,Dowal,whisperwind,1824,warlock,demonology,54,28,26
38939,Cidkagenou,sargeras,1821,warlock,demonology,25,19,6
38940,Idoovoodoo,burning-legion,1820,warlock,demonology,36,23,13
38941,Sharaßha,moon-guard,1820,warlock,demonology,69,41,28
38942,Dëvïl,ragnaros,1818,warlock,demonology,92,58,34
38943,Dapete,malorne,1818,warlock,demonology,53,30,23
38944,Villaìn,moon-guard,1818,warlock,demonology,117,55,62
38945,Arcinian,kelthuzad,1817,warlock,demonology,66,39,27
38946,Wls,frostmourne,1817,warlock,demonology,89,50,39
38947,Hellbraive,queldorei,1817,warlock,demonology,54,30,24
38948,Richards,thrall,1812,warlock,demonology,42,32,10
38949,Ltr,moon-guard,1811,warlock,demonology,30,22,8
38950,Kronii,jubeithos,1811,warlock,demonology,35,25,10
38951,Voidxo,tichondrius,1811,warlock,demonology,36,22,14
38952,Raegon,kiljaeden,1811,warlock,demonology,39,23,16
38953,Errogant,area-52,1810,warlock,demonology,60,30,30
38954,Nüts,blackrock,1810,warlock,demonology,50,23,27
38955,Beckypls,zuljin,1809,warlock,demonology,36,27,9
38956,Mcjoy,akama,1809,warlock,demonology,145,91,54
38957,Dounutlock,area-52,1809,warlock,demonology,54,33,21
38958,Saevitar,area-52,1809,warlock,demonology,45,24,21
38959,Hadoukën,hyjal,1809,warlock,demonology,108,56,52
38960,Chilipeppa,wyrmrest-accord,1808,warlock,demonology,60,34,26
38961,Keylloggz,sargeras,1808,warlock,demonology,120,63,57
38962,Mälwaré,tichondrius,1808,warlock,demonology,58,29,29
38963,Chaosthekid,malganis,1807,warlock,demonology,40,25,15
38964,Reneqtxo,jubeithos,1806,warlock,demonology,30,19,11
38965,Evelyne,tichondrius,1805,warlock,demonology,30,19,11
38966,Xacayth,ragnaros,1804,warlock,demonology,80,47,33
38967,Rakudemon,ragnaros,1804,warlock,demonology,147,77,70
38968,Scatach,area-52,1804,warlock,demonology,48,25,23
38969,Darkborkain,tichondrius,1803,warlock,demonology,30,19,11
38970,Lockeslock,sargeras,1801,warlock,demonology,118,62,56
38971,Thelockzx,azralon,1801,warlock,demonology,60,28,32
38972,Tarth,sargeras,1797,warlock,demonology,102,51,51
38973,Hugebolt,tichondrius,1793,warlock,demonology,48,28,20
38974,Precogfear,tichondrius,1793,warlock,demonology,60,29,31
38975,Jaganshi,tichondrius,1791,warlock,demonology,52,29,23
38976,Búmchúm,frostmourne,1788,warlock,demonology,54,34,20
38977,Babydots,stormreaver,1786,warlock,demonology,136,67,69
38978,Lockiator,moon-guard,1782,warlock,demonology,53,29,24
38979,Zörkô,zuljin,1775,warlock,demonology,78,37,41
38980,Flocka,agamaggan,1773,warlock,demonology,42,33,9
38981,Amgs,frostmourne,1773,warlock,demonology,54,38,16
38982,Qp,thrall,1771,warlock,demonology,38,28,10
38983,Spreadlove,emerald-dream,1771,warlock,demonology,162,86,76
38984,Gamecover,azralon,1768,warlock,demonology,86,50,36
38985,Magë,ursin,1768,warlock,demonology,84,36,48
38986,Döremi,tichondrius,1760,warlock,demonology,35,21,14
38987,Aidadeshu,tichondrius,1750,warlock,demonology,72,33,39
38988,Scarysherri,aggramar,1746,warlock,demonology,48,31,17
38989,ßállin,illidan,1745,warlock,demonology,35,22,13
38990,Mcpickls,illidan,1740,warlock,demonology,48,26,22
38991,Michae,tichondrius,1740,warlock,demonology,48,25,23
38992,Feldren,wyrmrest-accord,1739,warlock,demonology,59,33,26
38993,Arityy,tichondrius,1738,warlock,demonology,33,23,10
38994,Missalice,nesingwary,1738,warlock,demonology,42,23,19
38995,Chanigay,tichondrius,1737,warlock,demonology,35,20,15
38996,Dreadlõck,malganis,1737,warlock,demonology,78,39,39
38997,Cinderwhip,moon-guard,1730,warlock,demonology,207,104,103
38998,Ðëâthløck,tichondrius,1729,warlock,demonology,47,25,22
38999,Overclocked,destromath,1726,warlock,demonology,24,18,6
39000,Domenic,sentinels,1725,warlock,demonology,46,26,20
39001,Lemmewin,illidan,1724,warlock,demonology,24,18,6
39002,Playßøy,area-52,1724,warlock,demonology,30,18,12
39003,Eriebos,area-52,1724,warlock,demonology,60,35,25
39004,Canobio,tichondrius,1723,warlock,demonology,35,26,9
39005,Ökïlôck,proudmoore,1722,warlock,demonology,36,18,18
39006,Devilman,darkspear,1720,warlock,demonology,129,64,65
39007,Hitwarlock,tichondrius,1718,warlock,demonology,36,19,17
39008,Muchas,area-52,1717,warlock,demonology,30,18,12
39009,Fadedemon,area-52,1716,warlock,demonology,42,32,10
39010,Ciprýan,azralon,1715,warlock,demonology,76,35,41
39011,Eastwitch,ragnaros,1712,warlock,demonology,90,39,51
39012,Archibalding,area-52,1710,warlock,demonology,60,37,23
39013,Dätura,tichondrius,1708,warlock,demonology,32,21,11
39014,Sasaology,frostmourne,1706,warlock,demonology,78,41,37
39015,Tazlock,blackrock,1706,warlock,demonology,52,25,27
39016,Milkybøng,area-52,1705,warlock,demonology,99,61,38
39017,Shooterg,tichondrius,1704,warlock,demonology,66,32,34
39018,Larixpotanin,tichondrius,1703,warlock,demonology,66,35,31
39019,Dìablo,area-52,1702,warlock,demonology,78,43,35
39020,Nethron,the-venture-co,1700,warlock,demonology,72,35,37
39021,Zver,drakkari,1698,warlock,demonology,90,49,41
39022,Salaszar,illidan,1695,warlock,demonology,24,18,6
39023,Ourlegacy,tichondrius,1695,warlock,demonology,40,24,16
39024,Qwêrty,ursin,1693,warlock,demonology,29,20,9
39025,Fksm,tichondrius,1692,warlock,demonology,36,20,16
39026,Gengar,dalaran,1692,warlock,demonology,95,47,48
39027,Stopdottroll,zuljin,1690,warlock,demonology,30,18,12
39028,Hulkyy,illidan,1690,warlock,demonology,95,55,40
39029,Metrow,area-52,1688,warlock,demonology,30,18,12
39030,Houdneeznuts,tichondrius,1688,warlock,demonology,150,81,69
39031,Melisândre,kiljaeden,1687,warlock,demonology,47,23,24
39032,Leeka,tichondrius,1687,warlock,demonology,48,23,25
39033,Gørb,wyrmrest-accord,1686,warlock,demonology,48,30,18
39034,Notomorrow,tichondrius,1686,warlock,demonology,146,87,59
39035,Dogegg,tichondrius,1685,warlock,demonology,66,28,38
39036,Säbrine,zuljin,1679,warlock,demonology,73,35,38
39037,Døtyou,area-52,1676,warlock,demonology,35,18,17
39038,Juswannarock,tichondrius,1676,warlock,demonology,51,25,26
39039,Jyhoona,chromaggus,1675,warlock,demonology,325,164,161
39040,Spicyfingerx,illidan,1673,warlock,demonology,36,22,14
39041,Yuengling,illidan,1671,warlock,demonology,42,22,20
39042,Bigfatballz,tichondrius,1670,warlock,demonology,40,24,16
39043,Wrathh,stormscale,1669,warlock,demonology,45,20,25
39044,Narmazulnn,area-52,1666,warlock,demonology,41,25,16
39045,Geauxst,tichondrius,1666,warlock,demonology,44,25,19
39046,Gløcked,area-52,1666,warlock,demonology,48,26,22
39047,Altairo,illidan,1666,warlock,demonology,76,39,37
39048,Doties,bleeding-hollow,1663,warlock,demonology,42,23,19
39049,Aroug,aggramar,1663,warlock,demonology,96,47,49
39050,Mcpickl,illidan,1662,warlock,demonology,54,25,29
39051,Funkminot,illidan,1658,warlock,demonology,235,123,112
39052,Edzeá,frostmourne,1656,warlock,demonology,48,24,24
39053,Skanckqt,malganis,1654,warlock,demonology,54,29,25
39054,Rathul,bonechewer,1654,warlock,demonology,61,30,31
39055,Vcain,stormrage,1652,warlock,demonology,66,31,35
39056,Gimmeprecog,tichondrius,1651,warlock,demonology,30,21,9
39057,Gihaewon,tichondrius,1650,warlock,demonology,30,20,10
39058,Cappadonna,azralon,1650,warlock,demonology,82,45,37
39059,Dlchem,tichondrius,1644,warlock,demonology,70,37,33
39060,Phogy,bleeding-hollow,1644,warlock,demonology,71,35,36
39061,Invisibles,barthilas,1642,warlock,demonology,35,20,15
39062,Juxsr,nerzhul,1642,warlock,demonology,42,22,20
39063,Huajianmanwu,tichondrius,1642,warlock,demonology,220,106,114
39064,Saeph,burning-legion,1640,warlock,demonology,30,18,12
39065,Blastfinger,tichondrius,1637,warlock,demonology,42,24,18
39066,Suzüki,tichondrius,1635,warlock,demonology,36,19,17
39067,Fearmebro,bleeding-hollow,1633,warlock,demonology,84,53,31
39068,Oluluo,andorhal,1633,warlock,demonology,41,21,20
39069,Fearedu,thunderhorn,1633,warlock,demonology,101,47,54
39070,Innocentius,illidan,1631,warlock,demonology,76,40,36
39071,Graendol,tichondrius,1630,warlock,demonology,30,17,13
39072,Zzooxxqt,area-52,1630,warlock,demonology,30,17,13
39073,Sickmade,zuljin,1628,warlock,demonology,76,47,29
39074,Discordance,zuljin,1628,warlock,demonology,30,17,13
39075,Voltshot,tichondrius,1626,warlock,demonology,295,153,142
39076,Ggooudan,tichondrius,1625,warlock,demonology,29,21,8
39077,Stonelocke,area-52,1624,warlock,demonology,71,37,34
39078,Kreâtor,tichondrius,1622,warlock,demonology,71,40,31
39079,Demonicsmoke,darrowmere,1622,warlock,demonology,104,56,48
39080,Bagn,tichondrius,1620,warlock,demonology,42,23,19
39081,Zehzet,area-52,1619,warlock,demonology,24,17,7
39082,Mcpickles,illidan,1618,warlock,demonology,30,19,11
39083,Epinetheus,stormrage,1617,warlock,demonology,54,23,31
39084,Buymymixtåpe,ursin,1615,warlock,demonology,33,21,12
39085,Soreanus,illidan,1615,warlock,demonology,48,30,18
39086,Zantology,frostmourne,1615,warlock,demonology,54,31,23
39087,Krýptizl,frostmourne,1615,warlock,demonology,81,45,36
39088,Raisa,chogall,1615,warlock,demonology,48,23,25
39089,Ministàff,ursin,1615,warlock,demonology,36,17,19
39090,Xlilgee,kelthuzad,1614,warlock,demonology,30,17,13
39091,Abismoarmdr,ragnaros,1613,warlock,demonology,115,66,49
39092,Yükina,stormrage,1611,warlock,demonology,54,29,25
39093,Hentry,sargeras,1608,warlock,demonology,47,25,22
39094,Gulßad,tichondrius,1607,warlock,demonology,36,24,12
39095,Diabolock,proudmoore,1607,warlock,demonology,48,26,22
39096,Skullsoul,arthas,1607,warlock,demonology,44,23,21
39097,Eternalsmile,tichondrius,1606,warlock,demonology,36,21,15
39098,Rasildur,ragnaros,1606,warlock,demonology,49,21,28
39099,Cambolts,tichondrius,1604,warlock,demonology,36,20,16
39100,Ktlock,frostmourne,1603,warlock,demonology,114,65,49
39101,Lamdyn,moon-guard,1602,warlock,demonology,78,46,32
39102,Toestye,lightbringer,1600,warlock,demonology,108,56,52
39103,Harrydotterr,bonechewer,1598,warlock,demonology,60,29,31
39104,Lazymongoose,frostmourne,1597,warlock,demonology,126,67,59
39105,Valkynaris,chogall,1594,warlock,demonology,30,20,10
39106,Warlocklmao,malganis,1594,warlock,demonology,36,19,17
39107,Yanlexx,stormrage,1592,warlock,demonology,86,44,42
39108,Amour,wyrmrest-accord,1592,warlock,demonology,58,26,32
39109,Doombaby,zuljin,1588,warlock,demonology,48,30,18
39110,Theseance,dalaran,1587,warlock,demonology,42,20,22
39111,Garcheros,ragnaros,1584,warlock,demonology,45,23,22
39112,Raidspot,bleeding-hollow,1581,warlock,demonology,72,40,32
39113,Goorock,area-52,1581,warlock,demonology,78,40,38
39114,Tsunamibaby,anvilmar,1579,warlock,demonology,90,53,37
39115,Curseifier,frostmourne,1579,warlock,demonology,62,33,29
39116,Dreamsw,frostmourne,1578,warlock,demonology,36,18,18
39117,Agertis,frostmourne,1578,warlock,demonology,42,18,24
39118,Spookyfurry,area-52,1576,warlock,demonology,48,33,15
39119,Smallj,zuljin,1576,warlock,demonology,54,27,27
39120,Sadgellation,arthas,1574,warlock,demonology,42,27,15
39121,Thelocker,stormrage,1573,warlock,demonology,35,22,13
39122,Redbullsz,bleeding-hollow,1573,warlock,demonology,68,34,34
39123,Davekoresh,dunemaul,1571,warlock,demonology,50,27,23
39124,Empiratore,quelthalas,1569,warlock,demonology,59,26,33
39125,Hers,vashj,1568,warlock,demonology,48,30,18
39126,Bosongo,boulderfist,1567,warlock,demonology,36,20,16
39127,Xephostwo,area-52,1567,warlock,demonology,42,20,22
39128,Th,kiljaeden,1567,warlock,demonology,59,26,33
39129,Kìllèrgf,area-52,1564,warlock,demonology,205,102,103
39130,Caesaros,quelthalas,1563,warlock,demonology,87,40,47
39131,Miryem,illidan,1556,warlock,demonology,67,36,31
39132,Necronemesis,arthas,1556,warlock,demonology,60,27,33
39133,Hoana,azralon,1555,warlock,demonology,105,59,46
39134,Cilium,illidan,1554,warlock,demonology,41,23,18
39135,Fullxd,quelthalas,1551,warlock,demonology,54,31,23
39136,Paparoxy,illidan,1551,warlock,demonology,35,18,17
39137,Spooknjuke,bleeding-hollow,1546,warlock,demonology,41,26,15
39138,Wickdways,daggerspine,1546,warlock,demonology,54,32,22
39139,Xitokaiba,tichondrius,1544,warlock,demonology,37,21,16
39140,Exofilth,thrall,1543,warlock,demonology,35,22,13
39141,Bauchalain,area-52,1541,warlock,demonology,36,21,15
39142,Maldinath,sargeras,1535,warlock,demonology,24,16,8
39143,Soulrulerxc,tichondrius,1534,warlock,demonology,30,16,14
39144,Isometrics,barthilas,1534,warlock,demonology,30,16,14
39145,Dárklórd,dalaran,1534,warlock,demonology,180,95,85
39146,Heartpvp,tichondrius,1532,warlock,demonology,92,48,44
39147,Forsâken,tichondrius,1531,warlock,demonology,95,42,53
39148,Giantgobrin,zuljin,1529,warlock,demonology,30,16,14
39149,Almostoogood,illidan,1526,warlock,demonology,24,16,8
39150,Deathcyth,crushridge,1526,warlock,demonology,155,84,71
39151,Wollylock,dark-iron,1520,warlock,demonology,52,25,27
39152,Kandrus,moon-guard,1514,warlock,demonology,140,70,70
39153,Fãttyqt,sargeras,1513,warlock,demonology,52,35,17
39154,Smartpimp,tichondrius,1508,warlock,demonology,38,21,17
39155,Xaryl,stormrage,1506,warlock,demonology,90,41,49
39156,Krolczdots,tichondrius,1505,warlock,demonology,30,18,12
39157,Proletariat,moon-guard,1503,warlock,demonology,64,38,26
39158,Parmenides,tichondrius,1502,warlock,demonology,112,56,56
39159,Bigdotenergi,tichondrius,1501,warlock,demonology,24,16,8
39160,Icemanliddel,area-52,1500,warlock,demonology,35,16,19
39161,Mindfulchimp,sargeras,1497,warlock,demonology,37,21,16
39162,Krumlax,thrall,1496,warlock,demonology,24,16,8
39163,Thekook,illidan,1495,warlock,demonology,43,21,22
39164,Shigero,tichondrius,1494,warlock,demonology,30,19,11
39165,Prägä,drakkari,1493,warlock,demonology,51,27,24
39166,Damerus,illidan,1487,warlock,demonology,57,24,33
39167,Eriand,nordrassil,1482,warlock,demonology,102,51,51
39168,Zhoull,thrall,1479,warlock,demonology,48,23,25
39169,Grixis,zuluhed,1478,warlock,demonology,36,23,13
39170,Fabriziø,ragnaros,1472,warlock,demonology,31,21,10
39171,Mssy,illidan,1470,warlock,demonology,29,16,13
39172,Rotsndotss,thrall,1469,warlock,demonology,42,19,23
39173,Lamo,dawnbringer,1468,warlock,demonology,154,76,78
39174,Celestialock,tichondrius,1467,warlock,demonology,31,22,9
39175,Tubarão,azralon,1467,warlock,demonology,42,26,16
39176,Khanaan,illidan,1466,warlock,demonology,30,16,14
39177,Blavindy,illidan,1461,warlock,demonology,54,26,28
39178,Sugarwaffles,area-52,1460,warlock,demonology,60,33,27
39179,Gigagnomer,kelthuzad,1459,warlock,demonology,37,16,21
39180,Immortallock,tichondrius,1454,warlock,demonology,96,48,48
39181,Malegnant,proudmoore,1442,warlock,demonology,42,20,22
39182,Darkwîngduck,illidan,1439,warlock,demonology,24,15,9
39183,Avery,mannoroth,1439,warlock,demonology,30,15,15
39184,Dyenamik,stormrage,1438,warlock,demonology,18,15,3
39185,Sosahawk,stormrage,1437,warlock,demonology,30,15,15
39186,Dottcha,blackrock,1436,warlock,demonology,24,15,9
39187,Chaosboltlol,tichondrius,1436,warlock,demonology,30,15,15
39188,Valerik,azralon,1435,warlock,demonology,42,20,22
39189,Helyana,illidan,1433,warlock,demonology,53,31,22
39190,Dcpwns,arthas,1433,warlock,demonology,66,31,35
39191,Synisterlock,moon-guard,1432,warlock,demonology,36,18,18
39192,Voidwarlord,tichondrius,1427,warlock,demonology,73,39,34
39193,Aomniloltv,zuljin,1426,warlock,demonology,24,15,9
39194,Mothapucka,thrall,1426,warlock,demonology,47,21,26
39195,Løcalplugxø,barthilas,1425,warlock,demonology,24,15,9
39196,Tickleskin,windrunner,1419,warlock,demonology,87,47,40
39197,Arlenna,sargeras,1419,warlock,demonology,128,60,68
39198,Emperator,quelthalas,1413,warlock,demonology,28,16,12
39199,Kuyog,illidan,1411,warlock,demonology,60,30,30
39200,Laggyturbo,barthilas,1409,warlock,demonology,66,38,28
39201,Adlfcritler,emerald-dream,1402,warlock,demonology,36,19,17
39202,Monstir,sargeras,1396,warlock,demonology,31,16,15
39203,Suminl,tichondrius,1392,warlock,demonology,24,15,9
39204,Kuroyt,drakkari,1390,warlock,demonology,61,29,32
39205,Gromy,lightnings-blade,1388,warlock,demonology,56,32,24
39206,Guisls,azralon,1386,warlock,demonology,54,22,32
39207,Tiná,tichondrius,1385,warlock,demonology,27,15,12
39208,Silentfears,tichondrius,1381,warlock,demonology,27,20,7
39209,Lemongillo,stormrage,1378,warlock,demonology,35,20,15
39210,Guldorum,kiljaeden,1375,warlock,demonology,48,28,20
39211,Nezsarek,sargeras,1373,warlock,demonology,41,22,19
39212,Mysteryannie,tichondrius,1371,warlock,demonology,70,42,28
39213,Narcan,arthas,1371,warlock,demonology,29,16,13
39214,Memon,frostmane,1368,warlock,demonology,41,19,22
39215,Destrokk,gorefiend,1364,warlock,demonology,24,16,8
39216,Felorc,wyrmrest-accord,1358,warlock,demonology,63,39,24
39217,Voidxx,tichondrius,1343,warlock,demonology,18,14,4
39218,Ellynaria,nemesis,1343,warlock,demonology,18,14,4
39219,Biubius,tichondrius,1343,warlock,demonology,24,14,10
39220,Idotû,tichondrius,1343,warlock,demonology,30,14,16
39221,Hrrpeuh,zuljin,1343,warlock,demonology,30,14,16
39222,Joung,tichondrius,1342,warlock,demonology,24,14,10
39223,Doomdm,zuljin,1342,warlock,demonology,24,14,10
39224,Demonalien,malganis,1339,warlock,demonology,18,14,4
39225,Douzz,frostmourne,1338,warlock,demonology,24,14,10
39226,Antigotenent,sargeras,1336,warlock,demonology,24,14,10
39227,Jamesiyah,moon-guard,1333,warlock,demonology,60,29,31
39228,Smôkedsôul,area-52,1330,warlock,demonology,24,14,10
39229,Ézman,tichondrius,1330,warlock,demonology,24,14,10
39230,Bestwarlock,skywall,1328,warlock,demonology,30,14,16
39231,Vawns,zuljin,1326,warlock,demonology,23,16,7
39232,Eldriptch,kelthuzad,1325,warlock,demonology,27,15,12
39233,Medallok,laughing-skull,1323,warlock,demonology,77,35,42
39234,Seekma,gallywix,1322,warlock,demonology,24,14,10
39235,Superjuno,sargeras,1319,warlock,demonology,18,14,4
39236,Warlockluo,tichondrius,1319,warlock,demonology,24,14,10
39237,Dawdrax,gallywix,1313,warlock,demonology,22,15,7
39238,Jokerks,tichondrius,1310,warlock,demonology,23,14,9
39239,Avoidence,tanaris,1308,warlock,demonology,24,14,10
39240,Sû,stormrage,1301,warlock,demonology,82,39,43
39241,Shadowflame,skullcrusher,1299,warlock,demonology,91,48,43
39242,Salacia,chogall,1286,warlock,demonology,93,45,48
39243,Gauul,illidan,1281,warlock,demonology,70,39,31
39244,Heathncraig,illidan,1279,warlock,demonology,50,29,21
39245,Screampied,sargeras,1279,warlock,demonology,53,24,29
39246,Tizzy,malganis,1276,warlock,demonology,32,21,11
39247,Valerilma,azralon,1276,warlock,demonology,36,16,20
39248,Cornboil,tichondrius,1274,warlock,demonology,57,27,30
39249,Yoyoling,illidan,1267,warlock,demonology,82,41,41
39250,Willsayan,ragnaros,1266,warlock,demonology,42,16,26
39251,Arcaangell,sargeras,1264,warlock,demonology,63,35,28
39252,Bluffzlock,boulderfist,1260,warlock,demonology,23,14,9
39253,Wazog,jubeithos,1250,warlock,demonology,30,16,14
39254,Scalpelx,tichondrius,1248,warlock,demonology,18,13,5
39255,Deathboltx,zuljin,1248,warlock,demonology,24,13,11
39256,Drakatat,tichondrius,1248,warlock,demonology,24,13,11
39257,Adonege,tichondrius,1248,warlock,demonology,24,13,11
39258,Pfhear,area-52,1247,warlock,demonology,24,13,11
39259,Mukkamuk,shadowmoon,1246,warlock,demonology,18,13,5
39260,Feinnx,dalaran,1246,warlock,demonology,30,13,17
39261,Evianne,skywall,1244,warlock,demonology,30,13,17
39262,Thalsiani,moon-guard,1239,warlock,demonology,24,13,11
39263,Esdreel,ragnaros,1236,warlock,demonology,24,13,11
39264,Drain,proudmoore,1233,warlock,demonology,18,13,5
39265,Lpharji,tichondrius,1231,warlock,demonology,24,13,11
39266,Kymochaos,sargeras,1231,warlock,demonology,29,13,16
39267,Alaren,korgath,1231,warlock,demonology,36,13,23
39268,Gotfear,zuljin,1229,warlock,demonology,198,98,100
39269,Brawndelock,stormrage,1228,warlock,demonology,24,13,11
39270,Welendiock,malganis,1228,warlock,demonology,43,21,22
39271,Kothoped,wyrmrest-accord,1227,warlock,demonology,30,13,17
39272,Es,velen,1226,warlock,demonology,72,34,38
39273,Jezzika,azralon,1211,warlock,demonology,45,17,28
39274,Zeeref,stormrage,1206,warlock,demonology,30,13,17
39275,Demophile,bleeding-hollow,1204,warlock,demonology,24,18,6
39276,Lockdlhm,tichondrius,1197,warlock,demonology,23,13,10
39277,Syndrielle,emerald-dream,1175,warlock,demonology,42,16,26
39278,Artmaster,nordrassil,1174,warlock,demonology,30,20,10
39279,Snuffer,detheroc,1164,warlock,demonology,30,13,17
39280,Adistril,bleeding-hollow,1161,warlock,demonology,42,13,29
39281,Zjxy,tichondrius,1152,warlock,demonology,18,12,6
39282,Voidxz,tichondrius,1152,warlock,demonology,18,12,6
39283,Medzor,tichondrius,1152,warlock,demonology,24,12,12
39284,Blliizz,aegwynn,1151,warlock,demonology,18,12,6
39285,Mongobros,illidan,1151,warlock,demonology,24,12,12
39286,Tazerr,sargeras,1151,warlock,demonology,24,12,12
39287,Demise,azuremyst,1151,warlock,demonology,24,12,12
39288,Spectaclol,crushridge,1150,warlock,demonology,18,12,6
39289,Emurog,icecrown,1150,warlock,demonology,18,12,6
39290,Lentil,zuljin,1150,warlock,demonology,18,12,6
39291,Daxxter,tichondrius,1149,warlock,demonology,24,12,12
39292,Kotica,stormrage,1149,warlock,demonology,28,13,15
39293,Chipt,kelthuzad,1149,warlock,demonology,30,12,18
39294,Zrò,bleeding-hollow,1147,warlock,demonology,18,12,6
39295,Nyhn,bleeding-hollow,1144,warlock,demonology,18,12,6
39296,Critthis,illidan,1141,warlock,demonology,24,12,12
39297,Wawrlock,stormrage,1140,warlock,demonology,18,12,6
39298,Moryan,malfurion,1136,warlock,demonology,33,13,20
39299,Saltiernuts,malganis,1128,warlock,demonology,48,22,26
39300,Xtralyfe,hyjal,1117,warlock,demonology,22,12,10
39301,Omertà,staghelm,1114,warlock,demonology,22,13,9
39302,Warlockafk,darkspear,1109,warlock,demonology,18,12,6
39303,Kronicdotz,bleeding-hollow,1102,warlock,demonology,26,13,13
39304,Löksöflöve,sargeras,1101,warlock,demonology,60,25,35
39305,Elipsis,bloodhoof,1086,warlock,demonology,23,12,11
39306,Netherhigh,tichondrius,1085,warlock,demonology,42,21,21
39307,Politepvperx,kelthuzad,1070,warlock,demonology,17,12,5
39308,Lilmollyboy,demon-soul,1068,warlock,demonology,13,12,1
39309,Bøltqt,tichondrius,1056,warlock,demonology,12,11,1
39310,Igortrikadva,zuljin,1056,warlock,demonology,12,11,1
39311,Waii,emerald-dream,1056,warlock,demonology,12,11,1
39312,Voidbb,tichondrius,1056,warlock,demonology,24,11,13
39313,Iordozzy,malganis,1055,warlock,demonology,18,11,7
39314,Fearbarx,illidan,1055,warlock,demonology,18,11,7
39315,Homeschooler,darkspear,1055,warlock,demonology,18,11,7
39316,Betterone,azralon,1055,warlock,demonology,18,11,7
39317,Fotmspec,area-52,1055,warlock,demonology,18,11,7
39318,Comina,kelthuzad,1055,warlock,demonology,24,11,13
39319,Minervini,kiljaeden,1054,warlock,demonology,12,11,1
39320,Praemonium,dalaran,1054,warlock,demonology,18,11,7
39321,Stormrift,sargeras,1052,warlock,demonology,30,11,19
39322,Pollodelight,deathwing,1051,warlock,demonology,18,11,7
39323,Zorah,quelthalas,1051,warlock,demonology,18,11,7
39324,Menedemus,amanthul,1050,warlock,demonology,24,11,13
39325,Mêdìvh,tichondrius,1050,warlock,demonology,24,11,13
39326,Zinkro,quelthalas,1049,warlock,demonology,22,12,10
39327,Tròll,moon-guard,1049,warlock,demonology,54,25,29
39328,Tartamuda,ragnaros,1037,warlock,demonology,30,11,19
39329,Yozzik,illidan,1036,warlock,demonology,29,11,18
39330,Rickrock,gnomeregan,1034,warlock,demonology,18,11,7
39331,Rannieck,dark-iron,1022,warlock,demonology,16,12,4
39332,Tichondrus,ragnaros,1007,warlock,demonology,29,11,18
39333,Stankidanky,illidan,1002,warlock,demonology,18,11,7
39334,Minichompei,frostmourne,990,warlock,demonology,17,11,6
39335,Lukelock,azralon,990,warlock,demonology,22,11,11
39336,Mocreia,azralon,981,warlock,demonology,28,11,17
39337,Uzag,mugthol,975,warlock,demonology,26,11,15
39338,Meltlordqt,mannoroth,960,warlock,demonology,12,10,2
39339,Phyxylock,stormrage,960,warlock,demonology,12,10,2
39340,Séptima,illidan,960,warlock,demonology,12,10,2
39341,Hecataeus,stormrage,960,warlock,demonology,12,10,2
39342,Xyguoguo,tichondrius,960,warlock,demonology,18,10,8
39343,Klol,proudmoore,960,warlock,demonology,18,10,8
39344,Spacedots,illidan,960,warlock,demonology,18,10,8
39345,Idiocy,stormrage,960,warlock,demonology,18,10,8
39346,Felegance,proudmoore,960,warlock,demonology,18,10,8
39347,Vexice,firetree,960,warlock,demonology,18,10,8
39348,Millions,barthilas,960,warlock,demonology,24,10,14
39349,Slothycrip,emerald-dream,960,warlock,demonology,30,10,20
39350,Syraxi,illidan,959,warlock,demonology,18,10,8
39351,Purraisa,tichondrius,959,warlock,demonology,18,10,8
39352,Hâm,dalaran,959,warlock,demonology,36,10,26
39353,Ötì,altar-of-storms,958,warlock,demonology,12,10,2
39354,Daesire,moon-guard,957,warlock,demonology,18,10,8
39355,Lockswagger,stormrage,956,warlock,demonology,18,10,8
39356,Bizcochito,thrall,955,warlock,demonology,18,10,8
39357,Zaintv,illidan,955,warlock,demonology,18,10,8
39358,Musgrin,gallywix,955,warlock,demonology,24,10,14
39359,Leine,proudmoore,955,warlock,demonology,24,10,14
39360,Methrocks,emerald-dream,953,warlock,demonology,24,10,14
39361,Sørceress,bonechewer,948,warlock,demonology,18,10,8
39362,Sheara,silver-hand,905,warlock,demonology,24,10,14
39363,Twinklockxx,mannoroth,895,warlock,demonology,23,10,13
39364,Apples,ravencrest,894,warlock,demonology,17,10,7
39365,Maxice,zuljin,864,warlock,demonology,12,9,3
39366,Impenjoyer,tichondrius,864,warlock,demonology,12,9,3
39367,Azrezzael,area-52,864,warlock,demonology,12,9,3
39368,Peterdotz,whisperwind,864,warlock,demonology,13,9,4
39369,Louu,emerald-dream,864,warlock,demonology,18,9,9
39370,Bewær,deathwing,864,warlock,demonology,18,9,9
39371,Evanylock,proudmoore,864,warlock,demonology,18,9,9
39372,Dxhusky,tichondrius,864,warlock,demonology,18,9,9
39373,Abomasnow,frostmourne,864,warlock,demonology,18,9,9
39374,Deboltzaru,ragnaros,864,warlock,demonology,19,9,10
39375,Ezgamejr,tichondrius,863,warlock,demonology,12,9,3
39376,Fatals,thrall,863,warlock,demonology,12,9,3
39377,Jorloz,ragnaros,863,warlock,demonology,12,9,3
39378,Criticalpets,stormrage,863,warlock,demonology,18,9,9
39379,Harleyjames,ravenholdt,862,warlock,demonology,12,9,3
39380,Päpï,tichondrius,862,warlock,demonology,12,9,3
39381,Oopsíe,nagrand,860,warlock,demonology,24,9,15
39382,Varian,quelthalas,860,warlock,demonology,24,9,15
39383,Easymac,thunderlord,860,warlock,demonology,24,9,15
39384,Braylon,azuremyst,856,warlock,demonology,18,9,9
39385,Orbvoid,sargeras,845,warlock,demonology,24,9,15
39386,Demoniclily,kiljaeden,816,warlock,demonology,21,9,12
39387,Cleavüs,stormrage,815,warlock,demonology,11,9,2
39388,Moramont,stormrage,768,warlock,demonology,12,8,4
39389,Xanetor,illidan,768,warlock,demonology,12,8,4
39390,Bigboltkazar,tichondrius,768,warlock,demonology,12,8,4
39391,Asmion,earthen-ring,768,warlock,demonology,12,8,4
39392,Lockedlock,nemesis,768,warlock,demonology,12,8,4
39393,Perfectíon,tichondrius,768,warlock,demonology,12,8,4
39394,Marshyxd,tichondrius,768,warlock,demonology,12,8,4
39395,Pvtpotato,tichondrius,768,warlock,demonology,12,8,4
39396,Gnumbnutz,blades-edge,768,warlock,demonology,12,8,4
39397,Westhofs,sargeras,768,warlock,demonology,12,8,4
39398,Thefunk,tichondrius,768,warlock,demonology,12,8,4
39399,Malatharr,quelthalas,768,warlock,demonology,12,8,4
39400,Niava,tichondrius,768,warlock,demonology,18,8,10
39401,Tinkerfell,sargeras,768,warlock,demonology,18,8,10
39402,Dunni,area-52,768,warlock,demonology,18,8,10
39403,Joseph,draktharon,768,warlock,demonology,18,8,10
39404,Vasqu,stormrage,768,warlock,demonology,18,8,10
39405,Nismo,trollbane,768,warlock,demonology,18,8,10
39406,Bïcho,queldorei,768,warlock,demonology,18,8,10
39407,Neutrinowal,tichondrius,768,warlock,demonology,24,8,16
39408,Rosacrutian,tichondrius,767,warlock,demonology,12,8,4
39409,Shâdowman,stormrage,767,warlock,demonology,12,8,4
39410,Gibberishss,tichondrius,767,warlock,demonology,12,8,4
39411,Regime,deathwing,767,warlock,demonology,12,8,4
39412,Fullmelt,azjolnerub,767,warlock,demonology,18,8,10
39413,Boltsfordays,dalaran,767,warlock,demonology,24,8,16
39414,Bojàck,stormrage,766,warlock,demonology,12,8,4
39415,Elioknight,area-52,766,warlock,demonology,18,8,10
39416,Warlockdelux,thrall,766,warlock,demonology,24,8,16
39417,Lustyclam,tichondrius,765,warlock,demonology,12,8,4
39418,Cvntpvntcans,kelthuzad,764,warlock,demonology,18,8,10
39419,Pulentinskin,quelthalas,764,warlock,demonology,24,8,16
39420,Bâppo,antonidas,714,warlock,demonology,24,11,13
39421,Eklypso,kelthuzad,714,warlock,demonology,20,9,11
39422,Devilin,drakkari,672,warlock,demonology,12,7,5
39423,Laiquisha,zuljin,672,warlock,demonology,12,7,5
39424,Bestcookies,malganis,672,warlock,demonology,12,7,5
39425,Sauronne,illidan,672,warlock,demonology,12,7,5
39426,Actualjoke,frostmourne,672,warlock,demonology,12,7,5
39427,Dadtired,tichondrius,672,warlock,demonology,12,7,5
39428,Deammon,tichondrius,672,warlock,demonology,12,7,5
39429,Djvetis,blackhand,672,warlock,demonology,12,7,5
39430,Protomán,agamaggan,672,warlock,demonology,12,7,5
39431,Isömetrics,barthilas,672,warlock,demonology,12,7,5
39432,Fearmore,bleeding-hollow,672,warlock,demonology,12,7,5
39433,Zeexi,illidan,672,warlock,demonology,12,7,5
39434,Sorenbjerga,zuljin,672,warlock,demonology,12,7,5
39435,Anjkh,skullcrusher,672,warlock,demonology,12,7,5
39436,Aruotnof,nemesis,672,warlock,demonology,12,7,5
39437,Demonmal,frostmourne,672,warlock,demonology,12,7,5
39438,Løckyun,tichondrius,672,warlock,demonology,12,7,5
39439,Ðamndaddy,sargeras,672,warlock,demonology,12,7,5
39440,Expiredonion,bleeding-hollow,672,warlock,demonology,12,7,5
39441,Agla,quelthalas,672,warlock,demonology,12,7,5
39442,Lifeinsuranc,tichondrius,672,warlock,demonology,12,7,5
39443,Jweezy,malganis,672,warlock,demonology,12,7,5
39444,Staywrong,malganis,672,warlock,demonology,18,7,11
39445,Ranil,mannoroth,672,warlock,demonology,18,7,11
39446,Matrriixx,proudmoore,672,warlock,demonology,18,7,11
39447,Evarona,gorefiend,672,warlock,demonology,18,7,11
39448,Nëcrophil,area-52,671,warlock,demonology,12,7,5
39449,Damagexx,the-underbog,671,warlock,demonology,12,7,5
39450,Saldori,malganis,671,warlock,demonology,12,7,5
39451,Glortheeb,spirestone,671,warlock,demonology,12,7,5
39452,Celindeyn,stormrage,671,warlock,demonology,12,7,5
39453,Dotsfired,crushridge,671,warlock,demonology,18,7,11
39454,Bashel,sargeras,670,warlock,demonology,12,7,5
39455,Deanwarlock,sargeras,670,warlock,demonology,12,7,5
39456,Nostractus,azralon,667,warlock,demonology,12,7,5
39457,Lokiiee,azuremyst,664,warlock,demonology,12,7,5
39458,Tsmcfker,tichondrius,654,warlock,demonology,17,7,10
39459,Voldamorte,tichondrius,639,warlock,demonology,17,7,10
39460,Bänno,bleeding-hollow,623,warlock,demonology,11,7,4
39461,Chlomakï,azralon,622,warlock,demonology,11,7,4
39462,Chaosboltex,tichondrius,618,warlock,demonology,14,8,6
39463,Ritzhul,nordrassil,576,warlock,demonology,6,6,0
39464,Nðm,tichondrius,576,warlock,demonology,6,6,0
39465,Lillpfudd,area-52,576,warlock,demonology,6,6,0
39466,Eddybigbolts,tichondrius,576,warlock,demonology,12,6,6
39467,Chaosblade,burning-blade,576,warlock,demonology,12,6,6
39468,Sorath,blackrock,576,warlock,demonology,12,6,6
39469,Kyralena,stormrage,576,warlock,demonology,12,6,6
39470,Aboode,blackrock,576,warlock,demonology,12,6,6
39471,Zoerina,fizzcrank,576,warlock,demonology,12,6,6
39472,Jæja,wyrmrest-accord,576,warlock,demonology,12,6,6
39473,Marothredd,nathrezim,576,warlock,demonology,12,6,6
39474,Oniyooshi,kelthuzad,576,warlock,demonology,12,6,6
39475,Epícburn,illidan,576,warlock,demonology,12,6,6
39476,Davidofbowie,burning-legion,576,warlock,demonology,12,6,6
39477,Dalah,illidan,576,warlock,demonology,12,6,6
39478,Pumpkeenky,hyjal,576,warlock,demonology,12,6,6
39479,Muchopower,ragnaros,576,warlock,demonology,12,6,6
39480,Yaldin,nemesis,576,warlock,demonology,12,6,6
39481,Imbooms,blackrock,576,warlock,demonology,12,6,6
39482,Sytrick,bleeding-hollow,576,warlock,demonology,12,6,6
39483,Westhofz,tichondrius,576,warlock,demonology,12,6,6
39484,Bellath,azralon,576,warlock,demonology,12,6,6
39485,Projectpump,kelthuzad,576,warlock,demonology,12,6,6
39486,Scarletdemon,malganis,576,warlock,demonology,12,6,6
39487,Destructio,tichondrius,576,warlock,demonology,12,6,6
39488,Artzul,tichondrius,576,warlock,demonology,15,7,8
39489,Yazonics,area-52,576,warlock,demonology,18,6,12
39490,Dreadful,frostmourne,576,warlock,demonology,18,6,12
39491,Puchador,sargeras,576,warlock,demonology,18,6,12
39492,Shadowhax,area-52,576,warlock,demonology,18,6,12
39493,Ragnalock,laughing-skull,576,warlock,demonology,20,6,14
39494,Shadü,tichondrius,576,warlock,demonology,25,6,19
39495,Bazeni,frostmourne,575,warlock,demonology,6,6,0
39496,Griffoz,frostwolf,575,warlock,demonology,12,6,6
39497,Ronacq,norgannon,575,warlock,demonology,12,6,6
39498,Xenagos,antonidas,575,warlock,demonology,12,6,6
39499,Twototheone,illidan,575,warlock,demonology,12,6,6
39500,Sylvanes,emerald-dream,575,warlock,demonology,12,6,6
39501,Szell,caelestrasz,575,warlock,demonology,12,6,6
39502,Voidgown,moon-guard,575,warlock,demonology,12,6,6
39503,Naydene,moon-guard,575,warlock,demonology,18,6,12
39504,Canning,shuhalo,575,warlock,demonology,18,6,12
39505,Nécromonster,illidan,574,warlock,demonology,18,6,12
39506,Undeadcurse,frostmourne,574,warlock,demonology,24,6,18
39507,Algard,emerald-dream,573,warlock,demonology,12,6,6
39508,Keturáh,garrosh,566,warlock,demonology,12,6,6
39509,Westhøf,sargeras,543,warlock,demonology,11,6,5
39510,Jafi,coilfang,543,warlock,demonology,17,6,11
39511,Penzer,stormrage,528,warlock,demonology,15,6,9
39512,Creepydotman,mannoroth,511,warlock,demonology,14,6,8
39513,Velrose,thrall,480,warlock,demonology,6,5,1
39514,Necrotko,malganis,480,warlock,demonology,6,5,1
39515,Tiatiatia,illidan,480,warlock,demonology,6,5,1
39516,Owwie,malganis,480,warlock,demonology,6,5,1
39517,Niadmer,gnomeregan,480,warlock,demonology,6,5,1
39518,Khaozx,ragnaros,480,warlock,demonology,6,5,1
39519,Aînzooalgown,ragnaros,480,warlock,demonology,6,5,1
39520,Sinixx,tichondrius,480,warlock,demonology,6,5,1
39521,Seutóóbinha,stormrage,480,warlock,demonology,6,5,1
39522,Luku,kiljaeden,480,warlock,demonology,6,5,1
39523,Igniz,tichondrius,480,warlock,demonology,6,5,1
39524,Salsong,draka,480,warlock,demonology,6,5,1
39525,Reneqtxo,frostmourne,480,warlock,demonology,6,5,1
39526,Drainedd,blades-edge,480,warlock,demonology,6,5,1
39527,Gavvi,frostmourne,480,warlock,demonology,6,5,1
39528,Symplicìty,area-52,480,warlock,demonology,6,5,1
39529,Dodgebolts,khaz-modan,480,warlock,demonology,6,5,1
39530,Druzzaj,thrall,480,warlock,demonology,6,5,1
39531,Charlieo,barthilas,480,warlock,demonology,6,5,1
39532,Scalpelexis,stormrage,480,warlock,demonology,6,5,1
39533,Floorlamp,anvilmar,480,warlock,demonology,6,5,1
39534,Beerbolt,dalaran,480,warlock,demonology,6,5,1
39535,Fshi,frostmourne,480,warlock,demonology,12,5,7
39536,Meisy,quelthalas,480,warlock,demonology,12,5,7
39537,Klumzey,tichondrius,480,warlock,demonology,12,5,7
39538,Grandpapapa,tichondrius,480,warlock,demonology,12,5,7
39539,Grineed,emerald-dream,480,warlock,demonology,12,5,7
39540,Dapperdanxy,tichondrius,480,warlock,demonology,12,5,7
39541,Wdc,illidan,480,warlock,demonology,12,5,7
39542,Mânuel,akama,480,warlock,demonology,12,5,7
39543,Rumpology,illidan,480,warlock,demonology,12,5,7
39544,Rooms,sargeras,480,warlock,demonology,12,5,7
39545,Breeak,sargeras,480,warlock,demonology,12,5,7
39546,Alataar,sargeras,480,warlock,demonology,12,5,7
39547,Tribulatiön,moon-guard,480,warlock,demonology,12,5,7
39548,Ragdoll,illidan,480,warlock,demonology,12,5,7
39549,Yungwilly,silvermoon,480,warlock,demonology,12,5,7
39550,Dewandoritos,kelthuzad,480,warlock,demonology,12,5,7
39551,Wheremyshoes,area-52,480,warlock,demonology,12,5,7
39552,Liuh,tichondrius,480,warlock,demonology,12,5,7
39553,Demic,thrall,480,warlock,demonology,12,5,7
39554,Søcks,tichondrius,480,warlock,demonology,12,5,7
39555,Aellorie,proudmoore,480,warlock,demonology,12,5,7
39556,Zarinista,veknilash,480,warlock,demonology,12,5,7
39557,Demonâ,ragnaros,480,warlock,demonology,12,5,7
39558,Demonkiiller,kelthuzad,480,warlock,demonology,12,5,7
39559,Sinápsís,ragnaros,480,warlock,demonology,12,5,7
39560,Gandreleda,wyrmrest-accord,480,warlock,demonology,16,6,10
39561,Paleontology,moon-guard,480,warlock,demonology,14,5,9
39562,Arckádia,stormrage,480,warlock,demonology,18,5,13
39563,Yury,scarlet-crusade,479,warlock,demonology,12,5,7
39564,Stinkmeaner,chogall,479,warlock,demonology,12,5,7
39565,Eflock,barthilas,479,warlock,demonology,12,5,7
39566,Omegawarlock,quelthalas,479,warlock,demonology,18,5,13
39567,Lockybalbowa,amanthul,479,warlock,demonology,18,5,13
39568,Sathorastus,spirestone,448,warlock,demonology,10,6,4
39569,Sicksick,tichondrius,426,warlock,demonology,15,6,9
39570,Agaros,zuljin,426,warlock,demonology,17,6,11
39571,Dôctor,tichondrius,400,warlock,demonology,13,5,8
39572,Rosalynda,azralon,398,warlock,demonology,10,5,5
39573,Catarina,kaelthas,384,warlock,demonology,6,4,2
39574,Leleth,nordrassil,384,warlock,demonology,6,4,2
39575,Hélà,sargeras,384,warlock,demonology,6,4,2
39576,Il,nerzhul,384,warlock,demonology,6,4,2
39577,Fokâi,sargeras,384,warlock,demonology,6,4,2
39578,Mazzaleen,area-52,384,warlock,demonology,6,4,2
39579,Ardam,cenarion-circle,384,warlock,demonology,6,4,2
39580,Ahp,stormrage,384,warlock,demonology,6,4,2
39581,Frezy,stormrage,384,warlock,demonology,6,4,2
39582,Lizlock,stormrage,384,warlock,demonology,6,4,2
39583,Deatthmoon,stormrage,384,warlock,demonology,6,4,2
39584,Ethero,emerald-dream,384,warlock,demonology,6,4,2
39585,Lockniel,skullcrusher,384,warlock,demonology,6,4,2
39586,Hordefella,malganis,384,warlock,demonology,6,4,2
39587,Coomerdoomer,stormrage,384,warlock,demonology,6,4,2
39588,Frustration,darkspear,384,warlock,demonology,6,4,2
39589,Vesaloth,zuljin,384,warlock,demonology,6,4,2
39590,Drix,wyrmrest-accord,384,warlock,demonology,6,4,2
39591,Menemies,malganis,384,warlock,demonology,6,4,2
39592,Bellatriks,nemesis,384,warlock,demonology,6,4,2
39593,Meep,madoran,384,warlock,demonology,6,4,2
39594,Rodneyjones,emerald-dream,384,warlock,demonology,6,4,2
39595,Kyrionn,azralon,384,warlock,demonology,6,4,2
39596,Djdemolordx,bleeding-hollow,384,warlock,demonology,6,4,2
39597,Crayonchewer,alleria,384,warlock,demonology,6,4,2
39598,Lambe,tichondrius,384,warlock,demonology,6,4,2
39599,Xekk,wyrmrest-accord,384,warlock,demonology,6,4,2
39600,Viejitaa,quelthalas,384,warlock,demonology,6,4,2
39601,Quonton,tichondrius,384,warlock,demonology,6,4,2
39602,Curpt,the-scryers,384,warlock,demonology,6,4,2
39603,Helheim,haomarush,384,warlock,demonology,6,4,2
39604,Brujever,ragnaros,384,warlock,demonology,6,4,2
39605,Vilebrute,illidan,384,warlock,demonology,6,4,2
39606,Ptwo,illidan,384,warlock,demonology,6,4,2
39607,Fanzhiyi,illidan,384,warlock,demonology,6,4,2
39608,Kernlberton,tichondrius,384,warlock,demonology,6,4,2
39609,Moräl,frostmourne,384,warlock,demonology,6,4,2
39610,Jvilla,tichondrius,384,warlock,demonology,6,4,2
39611,Alchan,tichondrius,384,warlock,demonology,6,4,2
39612,Syndel,drakkari,384,warlock,demonology,6,4,2
39613,Bigmancam,illidan,384,warlock,demonology,6,4,2
39614,Conjur,barthilas,384,warlock,demonology,6,4,2
39615,Meelady,tichondrius,384,warlock,demonology,6,4,2
39616,Dashaad,illidan,384,warlock,demonology,6,4,2
39617,Thanock,illidan,384,warlock,demonology,6,4,2
39618,Famington,tichondrius,384,warlock,demonology,6,4,2
39619,Sakuin,bonechewer,384,warlock,demonology,6,4,2
39620,Nerolock,frostmourne,384,warlock,demonology,6,4,2
39621,Retaruko,illidan,384,warlock,demonology,6,4,2
39622,Logixo,sargeras,384,warlock,demonology,7,4,3
39623,Warlooch,area-52,384,warlock,demonology,9,5,4
39624,Woudini,malganis,384,warlock,demonology,10,5,5
39625,Nazare,tichondrius,384,warlock,demonology,12,4,8
39626,Xoxoxu,frostmourne,384,warlock,demonology,12,4,8
39627,Tahmrin,quelthalas,384,warlock,demonology,12,4,8
39628,Uarus,tichondrius,384,warlock,demonology,12,4,8
39629,Soulrman,tichondrius,384,warlock,demonology,12,4,8
39630,Demodar,tol-barad,384,warlock,demonology,12,4,8
39631,Warlack,jubeithos,384,warlock,demonology,12,4,8
39632,Arsaurelica,blackrock,384,warlock,demonology,12,4,8
39633,Deatt,deathwing,384,warlock,demonology,12,4,8
39634,Srz,stormrage,384,warlock,demonology,12,4,8
39635,Pìnto,illidan,384,warlock,demonology,12,4,8
39636,Ddorangmoon,tichondrius,384,warlock,demonology,12,4,8
39637,Rylal,illidan,384,warlock,demonology,12,4,8
39638,Picklecatz,barthilas,384,warlock,demonology,12,4,8
39639,Diekast,tichondrius,384,warlock,demonology,12,4,8
39640,Çheesestick,dalaran,384,warlock,demonology,12,4,8
39641,Dogcookie,moon-guard,384,warlock,demonology,12,4,8
39642,Ven,dalaran,384,warlock,demonology,12,4,8
39643,Naz,shadowsong,384,warlock,demonology,12,4,8
39644,Demonia,dathremar,384,warlock,demonology,12,4,8
39645,Nefertarie,illidan,384,warlock,demonology,12,4,8
39646,Tofulery,tichondrius,384,warlock,demonology,18,4,14
39647,Dagadon,arathor,384,warlock,demonology,24,4,20
39648,Lockman,frostwolf,383,warlock,demonology,6,4,2
39649,Greems,tichondrius,383,warlock,demonology,6,4,2
39650,Daggondai,tichondrius,383,warlock,demonology,12,4,8
39651,Voodootidies,proudmoore,382,warlock,demonology,9,4,5
39652,Mamabolts,kelthuzad,367,warlock,demonology,11,4,7
39653,Freshimps,blood-furnace,367,warlock,demonology,11,4,7
39654,Sharee,azuremyst,363,warlock,demonology,11,4,7
39655,Ärminvßuurën,barthilas,351,warlock,demonology,11,4,7
39656,Sumondeznuts,wyrmrest-accord,319,warlock,demonology,5,4,1
39657,Rentacletape,kelthuzad,319,warlock,demonology,5,4,1
39658,Gotty,stormrage,288,warlock,demonology,6,3,3
39659,Iamfear,shuhalo,288,warlock,demonology,6,3,3
39660,Naokishi,stormrage,288,warlock,demonology,6,3,3
39661,Crtyodautr,skullcrusher,288,warlock,demonology,6,3,3
39662,Archleon,smolderthorn,288,warlock,demonology,6,3,3
39663,Superbroly,area-52,288,warlock,demonology,6,3,3
39664,Yanned,hakkar,288,warlock,demonology,6,3,3
39665,Hauntsin,hyjal,288,warlock,demonology,6,3,3
39666,Keezus,area-52,288,warlock,demonology,6,3,3
39667,Bral,hyjal,288,warlock,demonology,6,3,3
39668,Feartool,stormrage,288,warlock,demonology,6,3,3
39669,Domwarlock,uther,288,warlock,demonology,6,3,3
39670,Areolaz,kelthuzad,288,warlock,demonology,6,3,3
39671,Juankkii,bonechewer,288,warlock,demonology,6,3,3
39672,Capslock,arthas,288,warlock,demonology,6,3,3
39673,Shutupthug,illidan,288,warlock,demonology,6,3,3
39674,Sooshi,malganis,288,warlock,demonology,6,3,3
39675,Deadlylock,gilneas,288,warlock,demonology,6,3,3
39676,Asiopdu,tichondrius,288,warlock,demonology,6,3,3
39677,Faraday,laughing-skull,288,warlock,demonology,6,3,3
39678,Molguzano,ragnaros,288,warlock,demonology,6,3,3
39679,Criptix,bleeding-hollow,288,warlock,demonology,6,3,3
39680,Aeonss,stormrage,288,warlock,demonology,6,3,3
39681,Sangala,malganis,288,warlock,demonology,6,3,3
39682,Shìnedown,eonar,288,warlock,demonology,6,3,3
39683,Didntflush,blood-furnace,288,warlock,demonology,6,3,3
39684,Disgustingfk,illidan,288,warlock,demonology,6,3,3
39685,Drerrday,kelthuzad,288,warlock,demonology,6,3,3
39686,Leonito,tichondrius,288,warlock,demonology,6,3,3
39687,Dippndotz,bleeding-hollow,288,warlock,demonology,6,3,3
39688,Ganknãmstyle,illidan,288,warlock,demonology,6,3,3
39689,Volanti,bleeding-hollow,288,warlock,demonology,6,3,3
39690,Impbiscuit,stormrage,288,warlock,demonology,6,3,3
39691,Darthael,stormrage,288,warlock,demonology,6,3,3
39692,Ðemented,bleeding-hollow,288,warlock,demonology,6,3,3
39693,Tynks,mannoroth,288,warlock,demonology,6,3,3
39694,Drelgun,aerie-peak,288,warlock,demonology,6,3,3
39695,Asmodeun,malganis,288,warlock,demonology,6,3,3
39696,Locksoul,area-52,288,warlock,demonology,6,3,3
39697,Lhordeign,area-52,288,warlock,demonology,6,3,3
39698,Viejita,quelthalas,288,warlock,demonology,6,3,3
39699,Wiredftw,illidan,288,warlock,demonology,6,3,3
39700,Zanlockos,dalaran,288,warlock,demonology,6,3,3
39701,Psyløck,bleeding-hollow,288,warlock,demonology,6,3,3
39702,Lefteexd,tichondrius,288,warlock,demonology,6,3,3
39703,Dkdakìng,dalaran,288,warlock,demonology,6,3,3
39704,Pikslol,bleeding-hollow,288,warlock,demonology,6,3,3
39705,Agonie,tichondrius,288,warlock,demonology,6,3,3
39706,Hgma,tichondrius,288,warlock,demonology,6,3,3
39707,Poggun,tichondrius,288,warlock,demonology,6,3,3
39708,Chaøsbolt,area-52,288,warlock,demonology,6,3,3
39709,Fëlgibson,illidan,288,warlock,demonology,6,3,3
39710,Chody,sargeras,288,warlock,demonology,6,3,3
39711,Soulruler,tichondrius,288,warlock,demonology,6,3,3
39712,Gulvandan,dathremar,288,warlock,demonology,6,3,3
39713,Fancynuts,kiljaeden,288,warlock,demonology,6,3,3
39714,Guldylox,kiljaeden,288,warlock,demonology,6,3,3
39715,Kodyconner,darkspear,288,warlock,demonology,6,3,3
39716,Idoturmum,frostmourne,288,warlock,demonology,6,3,3
39717,Elementzero,malorne,288,warlock,demonology,6,3,3
39718,Notprint,sargeras,288,warlock,demonology,6,3,3
39719,Lockinha,azralon,288,warlock,demonology,6,3,3
39720,Schrader,sargeras,288,warlock,demonology,6,3,3
39721,Drsauce,sargeras,288,warlock,demonology,6,3,3
39722,Graveland,frostwolf,288,warlock,demonology,6,3,3
39723,Zhul,nerzhul,288,warlock,demonology,6,3,3
39724,Rumjugs,barthilas,288,warlock,demonology,6,3,3
39725,Symaitiel,azralon,288,warlock,demonology,6,3,3
39726,Khamzatt,proudmoore,288,warlock,demonology,6,3,3
39727,Teron,stonemaul,288,warlock,demonology,6,3,3
39728,Fatuglyegirl,sargeras,288,warlock,demonology,6,3,3
39729,Tesil,tichondrius,288,warlock,demonology,6,3,3
39730,Munick,spirestone,288,warlock,demonology,6,3,3
39731,Khatrat,azralon,288,warlock,demonology,6,3,3
39732,Bertnasty,tichondrius,288,warlock,demonology,6,3,3
39733,Azland,proudmoore,288,warlock,demonology,6,3,3
39734,Jennifear,sargeras,288,warlock,demonology,6,3,3
39735,Nockdreal,azralon,288,warlock,demonology,6,3,3
39736,Blastyboat,terenas,288,warlock,demonology,6,3,3
39737,Cyrillus,moon-guard,288,warlock,demonology,6,3,3
39738,Saffuky,frostmourne,288,warlock,demonology,6,3,3
39739,Itzlandox,emerald-dream,288,warlock,demonology,6,3,3
39740,Nightterrour,frostmourne,288,warlock,demonology,6,3,3
39741,Jèdi,drenden,288,warlock,demonology,6,3,3
39742,Lilthicy,sargeras,288,warlock,demonology,6,3,3
39743,Insanemids,tichondrius,288,warlock,demonology,6,3,3
39744,Diebydots,blackrock,288,warlock,demonology,6,3,3
39745,Okul,frostmourne,288,warlock,demonology,6,3,3
39746,Neruvian,tichondrius,288,warlock,demonology,6,3,3
39747,Whydemono,tichondrius,288,warlock,demonology,6,3,3
39748,Nipz,korialstrasz,288,warlock,demonology,6,3,3
39749,Alprazoläm,illidan,288,warlock,demonology,14,6,8
39750,Constantine,exodar,288,warlock,demonology,12,3,9
39751,Dàmagicman,drakthul,288,warlock,demonology,12,3,9
39752,Pachips,zuljin,288,warlock,demonology,12,3,9
39753,Wineburger,frostmourne,288,warlock,demonology,12,3,9
39754,Strax,shattered-hand,288,warlock,demonology,12,3,9
39755,Mementomøri,quelthalas,288,warlock,demonology,12,3,9
39756,Tatemor,barthilas,288,warlock,demonology,12,3,9
39757,Legïõn,uldaman,288,warlock,demonology,12,3,9
39758,Albbanoo,tichondrius,288,warlock,demonology,12,3,9
39759,Crispee,azuremyst,288,warlock,demonology,12,3,9
39760,Overlard,illidan,288,warlock,demonology,12,3,9
39761,Killvilock,kelthuzad,288,warlock,demonology,12,3,9
39762,Kwrhitom,zuljin,288,warlock,demonology,12,3,9
39763,Gbow,malygos,287,warlock,demonology,6,3,3
39764,Ijustsharded,area-52,255,warlock,demonology,11,3,8
39765,Slugworth,rivendare,239,warlock,demonology,5,3,2
39766,Quetzâlcoâtl,sargeras,239,warlock,demonology,5,3,2
39767,Ceeloww,illidan,239,warlock,demonology,5,3,2
39768,Uwantpeach,tichondrius,239,warlock,demonology,5,3,2
39769,Frankandbean,dawnbringer,234,warlock,demonology,7,4,3
39770,Getavoided,azralon,234,warlock,demonology,7,4,3
39771,Predictions,sargeras,234,warlock,demonology,10,5,5
39772,Apøçàlÿpsè,firetree,234,warlock,demonology,11,5,6
39773,Schofen,tichondrius,234,warlock,demonology,13,4,9
39774,Annubyz,quelthalas,208,warlock,demonology,7,3,4
39775,Cocoabuttâ,stormrage,192,warlock,demonology,4,3,1
39776,Honne,sargeras,192,warlock,demonology,4,3,1
39777,Javirr,ragnaros,192,warlock,demonology,15,5,10
39778,Kaertis,emerald-dream,192,warlock,demonology,9,3,6
39779,Wearelegionx,frostmourne,192,warlock,demonology,6,2,4
39780,Promancer,drakkari,192,warlock,demonology,6,2,4
39781,Vendareth,earthen-ring,192,warlock,demonology,6,2,4
39782,Borudo,thrall,192,warlock,demonology,6,2,4
39783,Ggaayyooii,anubarak,192,warlock,demonology,6,2,4
39784,Réliok,quelthalas,192,warlock,demonology,6,2,4
39785,Xuker,tichondrius,192,warlock,demonology,6,2,4
39786,Umadbruhh,tichondrius,192,warlock,demonology,6,2,4
39787,Pinkypay,ragnaros,192,warlock,demonology,6,2,4
39788,Feardr,frostmourne,192,warlock,demonology,6,2,4
39789,Greenbeanzs,tichondrius,192,warlock,demonology,6,2,4
39790,Feldotz,illidan,192,warlock,demonology,6,2,4
39791,Ziroken,crushridge,192,warlock,demonology,6,2,4
39792,Destructo,illidan,192,warlock,demonology,6,2,4
39793,Felforyouu,illidan,192,warlock,demonology,6,2,4
39794,Qic,runetotem,192,warlock,demonology,6,2,4
39795,Irene,nagrand,192,warlock,demonology,6,2,4
39796,Zalissel,proudmoore,192,warlock,demonology,6,2,4
39797,Draino,tichondrius,192,warlock,demonology,6,2,4
39798,Warfeen,malganis,192,warlock,demonology,6,2,4
39799,Nigthdeath,nemesis,192,warlock,demonology,6,2,4
39800,Rôsé,tichondrius,192,warlock,demonology,6,2,4
39801,Zevoc,tichondrius,192,warlock,demonology,6,2,4
39802,Cozu,tichondrius,192,warlock,demonology,6,2,4
39803,Psykana,barthilas,192,warlock,demonology,6,2,4
39804,Caesis,illidan,192,warlock,demonology,6,2,4
39805,Bagelandlock,tichondrius,192,warlock,demonology,6,2,4
39806,Brough,illidan,192,warlock,demonology,6,2,4
39807,Soorisoori,tichondrius,192,warlock,demonology,6,2,4
39808,Hentailust,kiljaeden,192,warlock,demonology,6,2,4
39809,Pulpfliction,kiljaeden,192,warlock,demonology,6,2,4
39810,Doomtome,moon-guard,192,warlock,demonology,6,2,4
39811,Xblessed,stormrage,192,warlock,demonology,6,2,4
39812,Capïrota,nemesis,192,warlock,demonology,6,2,4
39813,Kaosqt,nemesis,192,warlock,demonology,6,2,4
39814,Aceej,nazgrel,192,warlock,demonology,6,2,4
39815,Soulbane,tol-barad,192,warlock,demonology,6,2,4
39816,Jkun,malganis,192,warlock,demonology,6,2,4
39817,Boon,spirestone,192,warlock,demonology,6,2,4
39818,Agamendoir,frostmane,192,warlock,demonology,6,2,4
39819,Zerowarlock,stormrage,192,warlock,demonology,6,2,4
39820,Lopenx,korgath,192,warlock,demonology,6,2,4
39821,Barbieelf,sargeras,192,warlock,demonology,6,2,4
39822,Shadow,frostwolf,192,warlock,demonology,6,2,4
39823,Koffay,bleeding-hollow,192,warlock,demonology,6,2,4
39824,Maroth,elune,192,warlock,demonology,6,2,4
39825,Sinissa,ysondre,192,warlock,demonology,6,2,4
39826,Stuffs,wyrmrest-accord,192,warlock,demonology,6,2,4
39827,Sphîñx,sargeras,192,warlock,demonology,6,2,4
39828,Firemike,kelthuzad,192,warlock,demonology,6,2,4
39829,Tomathus,moon-guard,192,warlock,demonology,6,2,4
39830,Ðeimøn,azralon,192,warlock,demonology,6,2,4
39831,Erc,alterac-mountains,192,warlock,demonology,6,2,4
39832,Wtb,blackrock,192,warlock,demonology,6,2,4
39833,Evilempire,sargeras,192,warlock,demonology,6,2,4
39834,Dotsandpot,malfurion,192,warlock,demonology,6,2,4
39835,Infecçäo,stormrage,192,warlock,demonology,6,2,4
39836,Sheshð,stormrage,192,warlock,demonology,6,2,4
39837,Watchmeport,onyxia,192,warlock,demonology,6,2,4
39838,Lilbiackguy,stormrage,192,warlock,demonology,6,2,4
39839,Anukh,emerald-dream,192,warlock,demonology,6,2,4
39840,Sakyameil,area-52,192,warlock,demonology,6,2,4
39841,Nanicide,kelthuzad,192,warlock,demonology,6,2,4
39842,Yuckytoetoe,emerald-dream,192,warlock,demonology,6,2,4
39843,Leônidos,ghostlands,192,warlock,demonology,6,2,4
39844,Draindeez,sargeras,192,warlock,demonology,6,2,4
39845,Ceelowtf,sargeras,192,warlock,demonology,6,2,4
39846,Caduz,stormrage,192,warlock,demonology,6,2,4
39847,Wreckquiem,draka,192,warlock,demonology,6,2,4
39848,Reckzet,stormrage,192,warlock,demonology,6,2,4
39849,Trippednfel,stormrage,192,warlock,demonology,6,2,4
39850,Cursedkash,stormrage,192,warlock,demonology,6,2,4
39851,Rokdas,area-52,192,warlock,demonology,6,2,4
39852,Knobbynobbas,stormrage,192,warlock,demonology,6,2,4
39853,Darkboltz,area-52,192,warlock,demonology,6,2,4
39854,Buboñic,area-52,192,warlock,demonology,6,2,4
39855,Dedology,area-52,192,warlock,demonology,6,2,4
39856,Daliadark,sargeras,192,warlock,demonology,9,2,7
39857,Elyshia,illidan,192,warlock,demonology,15,3,12
39858,Vielkä,ragnaros,192,warlock,demonology,12,2,10
39859,Drkdestro,boulderfist,192,warlock,demonology,12,2,10
39860,Sinful,darkspear,192,warlock,demonology,12,2,10
39861,Timerad,maelstrom,192,warlock,demonology,14,2,12
39862,Wårloçk,tichondrius,159,warlock,demonology,5,2,3
39863,Tunacanthicc,moon-guard,159,warlock,demonology,5,2,3
39864,Gartlarrey,daggerspine,158,warlock,demonology,14,3,11
39865,Kogath,thunderlord,138,warlock,demonology,10,4,6
39866,Cslice,magtheridon,128,warlock,demonology,4,2,2
39867,Decrepticus,kargath,96,warlock,demonology,6,1,5
39868,Starwitch,darkspear,96,warlock,demonology,6,1,5
39869,Solöw,tichondrius,96,warlock,demonology,6,1,5
39870,Shadococo,tichondrius,96,warlock,demonology,6,1,5
39871,Ñinelyfe,frostmourne,96,warlock,demonology,6,1,5
39872,Isthismeta,tichondrius,96,warlock,demonology,6,1,5
39873,Nùts,frostmourne,96,warlock,demonology,6,1,5
39874,Xalithra,moon-guard,96,warlock,demonology,6,1,5
39875,Oreo,velen,96,warlock,demonology,6,1,5
39876,Malzahard,ragnaros,96,warlock,demonology,6,1,5
39877,Erimegara,ragnaros,96,warlock,demonology,6,1,5
39878,Bmó,stormrage,96,warlock,demonology,6,1,5
39879,Nameflagged,arathor,96,warlock,demonology,6,1,5
39880,Glizzÿ,thrall,96,warlock,demonology,6,1,5
39881,Borthrel,moon-guard,96,warlock,demonology,6,1,5
39882,Amauder,moon-guard,96,warlock,demonology,6,1,5
39883,Repláced,thrall,96,warlock,demonology,6,1,5
39884,Sidiouss,dreadmaul,96,warlock,demonology,6,1,5
39885,Bilidin,azralon,96,warlock,demonology,6,1,5
39886,Osteogenesis,quelthalas,96,warlock,demonology,6,1,5
39887,Yora,illidan,96,warlock,demonology,6,1,5
39888,Perkz,moon-guard,96,warlock,demonology,6,1,5
39889,Flangy,kiljaeden,96,warlock,demonology,6,1,5
39890,Hâunted,khazgoroth,96,warlock,demonology,6,1,5
39891,Badstepbro,sargeras,96,warlock,demonology,6,1,5
39892,Skured,maiev,96,warlock,demonology,6,1,5
39893,Halloweèn,kelthuzad,96,warlock,demonology,6,1,5
39894,Hsxcx,stonemaul,96,warlock,demonology,6,1,5
39895,Lazzarros,area-52,96,warlock,demonology,6,1,5
39896,Somethingud,tichondrius,96,warlock,demonology,6,1,5
39897,Quinsnyder,zuljin,96,warlock,demonology,6,1,5
39898,Laklin,stormscale,96,warlock,demonology,6,1,5
39899,Eriss,exodar,96,warlock,demonology,6,1,5
39900,Kajayak,nazjatar,96,warlock,demonology,6,1,5
39901,Uggaboogga,malganis,96,warlock,demonology,6,1,5
39902,Fearedit,bleeding-hollow,96,warlock,demonology,6,1,5
39903,Varvanta,proudmoore,96,warlock,demonology,6,1,5
39904,Damdochael,bleeding-hollow,96,warlock,demonology,6,1,5
39905,Tonyxx,tichondrius,96,warlock,demonology,6,1,5
39906,Velondris,illidan,96,warlock,demonology,6,1,5
39907,Hutchyw,tichondrius,96,warlock,demonology,6,1,5
39908,Fashon,barthilas,96,warlock,demonology,6,1,5
39909,Zíppen,proudmoore,96,warlock,demonology,6,1,5
39910,Shortbuhz,tichondrius,96,warlock,demonology,6,1,5
39911,Thugpenus,frostmane,96,warlock,demonology,6,1,5
39912,Wakingdead,mugthol,96,warlock,demonology,6,1,5
39913,Bfaclâssic,zuljin,96,warlock,demonology,6,1,5
39914,Jazzycj,bleeding-hollow,96,warlock,demonology,6,1,5
39915,Zerosix,sargeras,96,warlock,demonology,6,1,5
39916,Thinkchair,sargeras,96,warlock,demonology,6,1,5
39917,Fluximilian,azralon,96,warlock,demonology,7,1,6
39918,Vèigarr,frostmourne,96,warlock,demonology,9,1,8
39919,Resima,stormscale,96,warlock,demonology,13,1,12
39920,Kecca,azralon,96,warlock,demonology,15,1,14
39921,Hecataeus,proudmoore,63,warlock,demonology,8,2,6
39922,Shaurial,zuljin,48,warlock,demonology,3,1,2
39923,Eternitty,nemesis,42,warlock,demonology,11,3,8
39924,Locksyy,tichondrius,31,warlock,demonology,2,1,1
39925,Synysta,tichondrius,31,warlock,demonology,2,1,1
39926,Warlow,mugthol,31,warlock,demonology,8,1,7
39927,Camila,lightnings-blade,16,warlock,demonology,1,1,0
39928,Voidchaos,whisperwind,2335,warlock,destruction,184,103,81
39929,Drexia,tichondrius,2312,warlock,destruction,66,49,17
39930,Nos,bleeding-hollow,2308,warlock,destruction,88,55,33
39931,Reverence,tichondrius,2283,warlock,destruction,101,64,37
39932,Nosw,bleeding-hollow,2275,warlock,destruction,102,61,41
39933,Mengqil,tichondrius,2267,warlock,destruction,114,64,50
39934,Hahahahahha,stormrage,2261,warlock,destruction,77,49,28
39935,Singleaf,stormrage,2255,warlock,destruction,98,57,41
39936,Butteredbun,stormrage,2239,warlock,destruction,186,110,76
39937,Dannyl,tichondrius,2219,warlock,destruction,66,44,22
39938,Ihavestds,tichondrius,2213,warlock,destruction,66,40,26
39939,Diabolicalz,sargeras,2213,warlock,destruction,111,62,49
39940,Mclovn,suramar,2199,warlock,destruction,155,85,70
39941,Slantsix,tichondrius,2198,warlock,destruction,90,50,40
39942,Mcdudebro,malganis,2192,warlock,destruction,72,45,27
39943,Warzog,wyrmrest-accord,2186,warlock,destruction,78,49,29
39944,Disgustingfk,illidan,2183,warlock,destruction,102,65,37
39945,Demonicxs,area-52,2182,warlock,destruction,137,74,63
39946,Kamohoalii,bleeding-hollow,2181,warlock,destruction,84,52,32
39947,Usainboltzz,tichondrius,2176,warlock,destruction,66,48,18
39948,Søülætër,bleeding-hollow,2161,warlock,destruction,66,42,24
39949,Sourslock,shadowsong,2158,warlock,destruction,102,67,35
39950,Impenjoyer,tichondrius,2154,warlock,destruction,66,41,25
39951,Playßøy,area-52,2154,warlock,destruction,78,45,33
39952,Luvana,kelthuzad,2147,warlock,destruction,119,72,47
39953,Truetime,tichondrius,2147,warlock,destruction,84,46,38
39954,Woahlock,thrall,2146,warlock,destruction,64,40,24
39955,Ihatemyson,tichondrius,2144,warlock,destruction,59,33,26
39956,Gimmeprecog,tichondrius,2143,warlock,destruction,74,45,29
39957,Ellynaria,nemesis,2142,warlock,destruction,78,51,27
39958,Slipnslide,malganis,2136,warlock,destruction,65,41,24
39959,Tomatobob,thrall,2136,warlock,destruction,84,44,40
39960,Igortrikadva,zuljin,2135,warlock,destruction,72,43,29
39961,Thumperrz,frostmourne,2135,warlock,destruction,83,45,38
39962,Leredi,stormrage,2135,warlock,destruction,146,78,68
39963,Abrocket,alleria,2134,warlock,destruction,88,47,41
39964,Yifaruhún,illidan,2132,warlock,destruction,78,58,20
39965,Locean,tichondrius,2131,warlock,destruction,106,59,47
39966,Deideimeow,illidan,2130,warlock,destruction,65,42,23
39967,Darthael,stormrage,2130,warlock,destruction,188,112,76
39968,Butterboyx,stormrage,2129,warlock,destruction,83,51,32
39969,Etuskaa,tichondrius,2128,warlock,destruction,108,64,44
39970,Drâkedog,illidan,2128,warlock,destruction,66,38,28
39971,Medzor,tichondrius,2128,warlock,destruction,93,53,40
39972,Turiggyjr,tichondrius,2127,warlock,destruction,83,45,38
39973,Loopsy,stormrage,2126,warlock,destruction,115,64,51
39974,Sockems,guldan,2125,warlock,destruction,90,51,39
39975,Demonman,kirin-tor,2124,warlock,destruction,72,41,31
39976,Dodgeykun,khaz-modan,2123,warlock,destruction,83,53,30
39977,Rizzard,lightnings-blade,2123,warlock,destruction,107,64,43
39978,Zyzx,malganis,2120,warlock,destruction,59,37,22
39979,Hudwinx,illidan,2119,warlock,destruction,78,47,31
39980,Drakedogee,illidan,2119,warlock,destruction,66,35,31
39981,Bananapan,tichondrius,2116,warlock,destruction,66,44,22
39982,Dyenamik,stormrage,2116,warlock,destruction,65,36,29
39983,Minglocked,proudmoore,2114,warlock,destruction,54,37,17
39984,Usurpest,bleeding-hollow,2114,warlock,destruction,79,50,29
39985,Xavier,wyrmrest-accord,2112,warlock,destruction,99,56,43
39986,Heckindoggø,tichondrius,2111,warlock,destruction,81,44,37
39987,Dean,frostmourne,2111,warlock,destruction,66,33,33
39988,Alucarduo,emerald-dream,2110,warlock,destruction,72,39,33
39989,Ghoul,demon-soul,2109,warlock,destruction,60,35,25
39990,Dxxz,tichondrius,2109,warlock,destruction,115,63,52
39991,Mjn,tichondrius,2107,warlock,destruction,100,51,49
39992,Stingzz,azralon,2106,warlock,destruction,61,38,23
39993,Chaosboltex,tichondrius,2106,warlock,destruction,72,41,31
39994,Jcm,hyjal,2104,warlock,destruction,59,41,18
39995,Dottle,frostmourne,2104,warlock,destruction,66,39,27
39996,Dae,burning-legion,2103,warlock,destruction,59,38,21
39997,Bufflockmore,tichondrius,2103,warlock,destruction,112,62,50
39998,Kaytoxic,tichondrius,2103,warlock,destruction,72,39,33
39999,Babyaga,illidan,2103,warlock,destruction,97,48,49
40000,Ohmend,thrall,2102,warlock,destruction,69,45,24
40001,Disembolt,illidan,2102,warlock,destruction,66,41,25
40002,Rainbowdate,tichondrius,2101,warlock,destruction,36,29,7
40003,Implify,tichondrius,2101,warlock,destruction,142,73,69
40004,Çxb,tichondrius,2092,warlock,destruction,72,45,27
40005,Kaidow,tichondrius,2090,warlock,destruction,96,61,35
40006,Sarcophagus,duskwood,2084,warlock,destruction,156,80,76
40007,Cc,hellscream,2075,warlock,destruction,155,97,58
40008,Thugonomicz,demon-soul,2071,warlock,destruction,54,37,17
40009,Hàrrydotter,darkspear,2071,warlock,destruction,70,43,27
40010,Quinsnyder,zuljin,2071,warlock,destruction,186,94,92
40011,Horror,moon-guard,2069,warlock,destruction,81,39,42
40012,Jonboyy,illidan,2068,warlock,destruction,144,72,72
40013,Eggós,sargeras,2066,warlock,destruction,251,134,117
40014,Babybolt,frostmourne,2066,warlock,destruction,90,46,44
40015,Felfeels,area-52,2065,warlock,destruction,96,58,38
40016,Nvlnx,tichondrius,2065,warlock,destruction,101,57,44
40017,Insanetroll,stormrage,2064,warlock,destruction,72,49,23
40018,Demofire,tichondrius,2063,warlock,destruction,63,39,24
40019,Idotû,tichondrius,2063,warlock,destruction,161,87,74
40020,Koitis,tichondrius,2061,warlock,destruction,68,43,25
40021,Realization,illidan,2060,warlock,destruction,30,25,5
40022,Vapeboi,bleeding-hollow,2060,warlock,destruction,54,33,21
40023,Pillçosby,bleeding-hollow,2054,warlock,destruction,192,96,96
40024,Revenid,tichondrius,2049,warlock,destruction,72,42,30
40025,Rightwaylovê,illidan,2048,warlock,destruction,65,37,28
40026,Breeped,tichondrius,2044,warlock,destruction,108,68,40
40027,Foresthills,sargeras,2044,warlock,destruction,96,50,46
40028,Uwantpeach,tichondrius,2043,warlock,destruction,46,34,12
40029,Brainless,tichondrius,2040,warlock,destruction,109,66,43
40030,Sinápsís,ragnaros,2035,warlock,destruction,54,36,18
40031,Ðlrwêcïûj,stormrage,2034,warlock,destruction,60,41,19
40032,Äran,azralon,2029,warlock,destruction,54,30,24
40033,Instabilityx,tichondrius,2028,warlock,destruction,71,42,29
40034,Mazewl,illidan,2027,warlock,destruction,105,68,37
40035,Scørrgx,azralon,2021,warlock,destruction,84,43,41
40036,Duukka,malganis,2015,warlock,destruction,96,53,43
40037,Forestfruit,tichondrius,2012,warlock,destruction,42,28,14
40038,Napiersdot,tichondrius,2009,warlock,destruction,72,39,33
40039,Alchandil,tichondrius,1999,warlock,destruction,48,34,14
40040,Nightmanx,sargeras,1999,warlock,destruction,83,43,40
40041,Isodjdojk,sargeras,1998,warlock,destruction,64,37,27
40042,Epícburn,illidan,1996,warlock,destruction,30,21,9
40043,Darkmagicc,tichondrius,1995,warlock,destruction,96,48,48
40044,Ribman,stormrage,1992,warlock,destruction,66,32,34
40045,Neruvian,tichondrius,1991,warlock,destruction,42,28,14
40046,Qp,thrall,1989,warlock,destruction,36,27,9
40047,Kaytoxics,tichondrius,1988,warlock,destruction,24,21,3
40048,Cvoaw,bonechewer,1987,warlock,destruction,72,41,31
40049,Whodatman,illidan,1986,warlock,destruction,48,34,14
40050,Hollowl,tichondrius,1986,warlock,destruction,83,55,28
40051,Albbanoo,tichondrius,1986,warlock,destruction,143,76,67
40052,Deadlpoo,stormscale,1984,warlock,destruction,154,81,73
40053,Sitomey,emerald-dream,1982,warlock,destruction,66,38,28
40054,Tacobelf,magtheridon,1980,warlock,destruction,129,73,56
40055,Zhul,nerzhul,1979,warlock,destruction,63,40,23
40056,Fotmspec,area-52,1976,warlock,destruction,66,46,20
40057,Narila,firetree,1976,warlock,destruction,48,29,19
40058,Zeari,sargeras,1972,warlock,destruction,109,55,54
40059,Calvarr,bleeding-hollow,1970,warlock,destruction,77,45,32
40060,Destroyy,greymane,1968,warlock,destruction,54,30,24
40061,Payn,kiljaeden,1968,warlock,destruction,66,36,30
40062,Nðm,tichondrius,1968,warlock,destruction,114,57,57
40063,Pigii,tichondrius,1967,warlock,destruction,42,28,14
40064,Kruxxqt,illidan,1967,warlock,destruction,274,142,132
40065,Freddiewill,tichondrius,1966,warlock,destruction,101,63,38
40066,Audition,ragnaros,1966,warlock,destruction,102,51,51
40067,Salanzø,bleeding-hollow,1965,warlock,destruction,54,31,23
40068,Dazu,illidan,1965,warlock,destruction,125,66,59
40069,Mizmagius,moon-guard,1965,warlock,destruction,65,31,34
40070,Realgodlock,proudmoore,1964,warlock,destruction,134,70,64
40071,Boltsnhoes,illidan,1961,warlock,destruction,78,46,32
40072,Chaosbolt,bloodhoof,1961,warlock,destruction,66,37,29
40073,Hrrpeuh,zuljin,1961,warlock,destruction,82,41,41
40074,Blackyeonnam,tichondrius,1959,warlock,destruction,86,46,40
40075,Kyranu,tichondrius,1955,warlock,destruction,115,60,55
40076,Seangnong,tichondrius,1953,warlock,destruction,54,34,20
40077,Heresucacok,frostmourne,1947,warlock,destruction,36,22,14
40078,Sweatystain,tichondrius,1945,warlock,destruction,70,45,25
40079,Tichonkimc,tichondrius,1945,warlock,destruction,62,33,29
40080,Rakshama,chogall,1944,warlock,destruction,45,26,19
40081,Xertling,sargeras,1941,warlock,destruction,55,38,17
40082,Zyltan,tichondrius,1938,warlock,destruction,36,25,11
40083,Balveer,tichondrius,1937,warlock,destruction,35,21,14
40084,Pernicious,bladefist,1937,warlock,destruction,197,95,102
40085,Warlockwars,amanthul,1931,warlock,destruction,172,88,84
40086,Beegbeechy,nesingwary,1929,warlock,destruction,72,41,31
40087,Archimondee,rivendare,1928,warlock,destruction,84,42,42
40088,Yuoalx,tichondrius,1922,warlock,destruction,72,38,34
40089,Kaelith,kelthuzad,1920,warlock,destruction,103,53,50
40090,Deathair,tichondrius,1918,warlock,destruction,54,31,23
40091,Shadowhax,area-52,1918,warlock,destruction,90,47,43
40092,Mayelinvail,moon-guard,1917,warlock,destruction,72,41,31
40093,Truenatestes,proudmoore,1916,warlock,destruction,89,44,45
40094,Wzxx,tichondrius,1914,warlock,destruction,141,78,63
40095,Benafflockz,kelthuzad,1913,warlock,destruction,71,44,27
40096,Ignorai,illidan,1913,warlock,destruction,148,82,66
40097,Sereniaa,sargeras,1913,warlock,destruction,50,27,23
40098,Salival,chogall,1912,warlock,destruction,39,29,10
40099,Ztlivid,area-52,1911,warlock,destruction,93,56,37
40100,Starta,tichondrius,1910,warlock,destruction,48,27,21
40101,Grandmama,tichondrius,1909,warlock,destruction,53,33,20
40102,Vileröze,zuljin,1909,warlock,destruction,78,43,35
40103,Dreadful,frostmourne,1907,warlock,destruction,81,49,32
40104,Reneqtxo,frostmourne,1906,warlock,destruction,92,60,32
40105,Whatisthis,tichondrius,1906,warlock,destruction,36,20,16
40106,Yoyoyosup,stormrage,1905,warlock,destruction,48,32,16
40107,Coilsinfive,tichondrius,1904,warlock,destruction,42,27,15
40108,Hellsparks,malganis,1903,warlock,destruction,48,29,19
40109,Sosahawk,stormrage,1902,warlock,destruction,137,87,50
40110,Laiquisha,zuljin,1900,warlock,destruction,49,29,20
40111,Ozmat,spirestone,1900,warlock,destruction,36,20,16
40112,Amez,grizzly-hills,1900,warlock,destruction,60,33,27
40113,Tott,hellscream,1898,warlock,destruction,50,26,24
40114,Scatz,sargeras,1897,warlock,destruction,36,33,3
40115,Fingerslock,malganis,1897,warlock,destruction,102,52,50
40116,Radicalz,ragnaros,1894,warlock,destruction,49,26,23
40117,Maadhum,illidan,1894,warlock,destruction,72,32,40
40118,Belandyr,stormrage,1893,warlock,destruction,36,20,16
40119,Stilltrilly,tichondrius,1892,warlock,destruction,36,25,11
40120,Amgs,frostmourne,1890,warlock,destruction,131,71,60
40121,Genzy,tichondrius,1888,warlock,destruction,114,55,59
40122,Sonlyc,tichondrius,1886,warlock,destruction,66,33,33
40123,Naughtybolts,sargeras,1884,warlock,destruction,59,41,18
40124,Toggafputuhs,illidan,1884,warlock,destruction,42,26,16
40125,Madthelock,sargeras,1884,warlock,destruction,42,20,22
40126,Eav,area-52,1883,warlock,destruction,54,34,20
40127,Zettian,quelthalas,1883,warlock,destruction,54,30,24
40128,Warcalk,stormrage,1882,warlock,destruction,60,37,23
40129,Vexe,tichondrius,1880,warlock,destruction,38,29,9
40130,Humanwarlock,spirestone,1879,warlock,destruction,57,32,25
40131,Neverending,malganis,1878,warlock,destruction,49,28,21
40132,Tommybahama,velen,1875,warlock,destruction,64,39,25
40133,Roxmysox,darkspear,1875,warlock,destruction,84,43,41
40134,Illinkin,illidan,1874,warlock,destruction,126,75,51
40135,Pikslol,bleeding-hollow,1874,warlock,destruction,48,27,21
40136,Lopenx,korgath,1874,warlock,destruction,146,73,73
40137,Dottcha,blackrock,1873,warlock,destruction,90,48,42
40138,Locodwarf,frostmourne,1873,warlock,destruction,274,136,138
40139,Zarinista,veknilash,1872,warlock,destruction,91,47,44
40140,Twinklockxx,mannoroth,1872,warlock,destruction,143,66,77
40141,Hommer,tichondrius,1870,warlock,destruction,57,34,23
40142,Bigdamege,tichondrius,1870,warlock,destruction,67,39,28
40143,Ñpç,bleeding-hollow,1870,warlock,destruction,89,48,41
40144,Amazingamez,sargeras,1867,warlock,destruction,78,42,36
40145,Puchador,sargeras,1867,warlock,destruction,138,74,64
40146,Dustywlx,area-52,1865,warlock,destruction,74,45,29
40147,Pheadas,deathwing,1865,warlock,destruction,42,20,22
40148,Palumorl,deathwing,1864,warlock,destruction,36,23,13
40149,Scathey,area-52,1863,warlock,destruction,138,84,54
40150,Colombø,gallywix,1863,warlock,destruction,145,75,70
40151,Drakwlya,tichondrius,1859,warlock,destruction,48,30,18
40152,Oopsprecog,tichondrius,1857,warlock,destruction,66,32,34
40153,Dottx,frostmourne,1856,warlock,destruction,48,32,16
40154,Luhgëek,tichondrius,1856,warlock,destruction,47,29,18
40155,Zadelyn,whisperwind,1855,warlock,destruction,30,23,7
40156,Snerp,frostmourne,1855,warlock,destruction,135,78,57
40157,Soulrulerxc,tichondrius,1854,warlock,destruction,42,27,15
40158,Mongobros,illidan,1853,warlock,destruction,54,35,19
40159,Darksummoner,kaelthas,1853,warlock,destruction,84,46,38
40160,Immolate,eitrigg,1852,warlock,destruction,48,29,19
40161,Drugmuffin,tichondrius,1852,warlock,destruction,48,28,20
40162,Milkdrunk,blackrock,1852,warlock,destruction,119,61,58
40163,Eqx,illidan,1851,warlock,destruction,54,31,23
40164,Warsmock,tichondrius,1850,warlock,destruction,41,22,19
40165,Kissmybolts,frostmourne,1850,warlock,destruction,66,35,31
40166,Mistrnesbitt,malganis,1850,warlock,destruction,48,25,23
40167,Brujoalfa,ragnaros,1849,warlock,destruction,139,81,58
40168,Synkz,blood-furnace,1849,warlock,destruction,42,24,18
40169,Threeinches,kelthuzad,1848,warlock,destruction,170,100,70
40170,Mycelium,greymane,1848,warlock,destruction,34,20,14
40171,Dotorama,sargeras,1846,warlock,destruction,41,30,11
40172,Brazlem,blackrock,1846,warlock,destruction,49,34,15
40173,Verbzz,tichondrius,1846,warlock,destruction,36,23,13
40174,Lemmepvponu,illidan,1846,warlock,destruction,59,28,31
40175,Maureenn,mannoroth,1845,warlock,destruction,55,29,26
40176,Omegapasta,illidan,1845,warlock,destruction,84,42,42
40177,Boxtrolls,ragnaros,1843,warlock,destruction,48,28,20
40178,Sithaholic,wildhammer,1843,warlock,destruction,72,39,33
40179,Chilipeppa,wyrmrest-accord,1842,warlock,destruction,36,27,9
40180,Jierd,tichondrius,1842,warlock,destruction,52,32,20
40181,Herpalock,illidan,1842,warlock,destruction,78,34,44
40182,Rocketman,hydraxis,1841,warlock,destruction,48,32,16
40183,Urukái,dalaran,1841,warlock,destruction,111,65,46
40184,Rizzofsparta,stormrage,1841,warlock,destruction,48,27,21
40185,Benafflockzz,kelthuzad,1840,warlock,destruction,66,44,22
40186,Millidots,bleeding-hollow,1840,warlock,destruction,54,31,23
40187,Cosmosxx,illidan,1838,warlock,destruction,42,31,11
40188,Enter,saurfang,1838,warlock,destruction,36,24,12
40189,Jaspieno,illidan,1838,warlock,destruction,48,29,19
40190,Naughtybôlts,sargeras,1837,warlock,destruction,45,33,12
40191,Philsbad,lightbringer,1837,warlock,destruction,122,70,52
40192,Dragonixs,ragnaros,1837,warlock,destruction,96,53,43
40193,Kekbolt,tichondrius,1836,warlock,destruction,53,33,20
40194,Wife,bleeding-hollow,1836,warlock,destruction,60,31,29
40195,Sibëria,quelthalas,1835,warlock,destruction,48,35,13
40196,Painful,mannoroth,1835,warlock,destruction,96,57,39
40197,Badstep,tichondrius,1835,warlock,destruction,51,30,21
40198,Tonyxx,tichondrius,1835,warlock,destruction,112,58,54
40199,Panna,tichondrius,1835,warlock,destruction,237,118,119
40200,Gigabiga,area-52,1834,warlock,destruction,24,20,4
40201,Soragen,barthilas,1834,warlock,destruction,54,37,17
40202,Løcalplugxø,barthilas,1834,warlock,destruction,119,78,41
40203,Farathos,ragnaros,1834,warlock,destruction,120,74,46
40204,Jfet,sargeras,1833,warlock,destruction,29,21,8
40205,Gotthmog,nerzhul,1833,warlock,destruction,48,30,18
40206,Cumbledor,bleeding-hollow,1831,warlock,destruction,44,23,21
40207,Barovir,tichondrius,1830,warlock,destruction,54,33,21
40208,Buu,veknilash,1830,warlock,destruction,54,33,21
40209,Rhelialock,stormrage,1830,warlock,destruction,36,21,15
40210,Demonicsnap,bleeding-hollow,1829,warlock,destruction,100,59,41
40211,Suaveaye,tichondrius,1829,warlock,destruction,54,31,23
40212,Brillina,windrunner,1829,warlock,destruction,60,30,30
40213,Nezlock,moon-guard,1829,warlock,destruction,92,45,47
40214,Dadtired,tichondrius,1826,warlock,destruction,36,29,7
40215,Vyrecks,hyjal,1826,warlock,destruction,54,31,23
40216,Shequita,stormrage,1825,warlock,destruction,48,37,11
40217,Agaros,zuljin,1825,warlock,destruction,49,30,19
40218,Necroboi,alterac-mountains,1825,warlock,destruction,52,29,23
40219,Dàmagicman,drakthul,1824,warlock,destruction,48,32,16
40220,Dipicrowcaw,tichondrius,1822,warlock,destruction,24,19,5
40221,Hakai,bleeding-hollow,1822,warlock,destruction,80,51,29
40222,Drazh,area-52,1821,warlock,destruction,57,32,25
40223,Soulbane,jubeithos,1820,warlock,destruction,30,19,11
40224,Róckroad,lightnings-blade,1820,warlock,destruction,42,26,16
40225,Azaradx,sargeras,1819,warlock,destruction,84,54,30
40226,Yipláw,stormrage,1819,warlock,destruction,36,23,13
40227,Puginlock,illidan,1819,warlock,destruction,60,38,22
40228,Chazzlock,area-52,1819,warlock,destruction,30,19,11
40229,Slurpme,stormscale,1819,warlock,destruction,48,30,18
40230,Vamprixlz,illidan,1818,warlock,destruction,49,34,15
40231,Lamaso,area-52,1818,warlock,destruction,66,43,23
40232,Haì,illidan,1818,warlock,destruction,60,37,23
40233,Gucciflops,bleeding-hollow,1818,warlock,destruction,60,29,31
40234,Bumbleebolt,azralon,1817,warlock,destruction,24,19,5
40235,Nahalmaeim,tichondrius,1817,warlock,destruction,36,24,12
40236,Firenzy,dalaran,1817,warlock,destruction,67,39,28
40237,Antinurse,bleeding-hollow,1817,warlock,destruction,78,45,33
40238,Lockonomicz,tichondrius,1817,warlock,destruction,42,24,18
40239,Feinnx,dalaran,1817,warlock,destruction,70,38,32
40240,Zehoc,thrall,1817,warlock,destruction,102,55,47
40241,Wraithlord,chogall,1816,warlock,destruction,51,32,19
40242,Reallymagic,malganis,1816,warlock,destruction,106,63,43
40243,Doclove,destromath,1816,warlock,destruction,149,83,66
40244,Bismorc,frostmourne,1816,warlock,destruction,42,23,19
40245,Starwitch,darkspear,1816,warlock,destruction,77,35,42
40246,Noxfear,azralon,1815,warlock,destruction,66,48,18
40247,Leeroydots,area-52,1815,warlock,destruction,54,37,17
40248,Dunnin,dalaran,1815,warlock,destruction,36,22,14
40249,Savlonicsego,stormrage,1815,warlock,destruction,78,45,33
40250,Frappucino,wyrmrest-accord,1814,warlock,destruction,30,23,7
40251,Shinjuro,stormrage,1814,warlock,destruction,36,24,12
40252,Slpxoxo,sargeras,1814,warlock,destruction,54,30,24
40253,Crayonchewer,alleria,1814,warlock,destruction,60,31,29
40254,Zaef,kelthuzad,1814,warlock,destruction,88,45,43
40255,Evilclass,tichondrius,1813,warlock,destruction,42,31,11
40256,Famerap,tichondrius,1813,warlock,destruction,36,25,11
40257,Wiredftw,illidan,1813,warlock,destruction,30,19,11
40258,Sacalawia,drakkari,1813,warlock,destruction,45,27,18
40259,Monika,anetheron,1813,warlock,destruction,58,32,26
40260,Zauber,magtheridon,1812,warlock,destruction,44,29,15
40261,Destructio,tichondrius,1812,warlock,destruction,54,31,23
40262,Marshyw,tichondrius,1812,warlock,destruction,36,19,17
40263,Bellaswans,hyjal,1811,warlock,destruction,54,33,21
40264,Naroy,malygos,1811,warlock,destruction,38,21,17
40265,Thegodd,nemesis,1811,warlock,destruction,54,28,26
40266,Dommön,ragnaros,1811,warlock,destruction,54,28,26
40267,Tìdals,zuljin,1810,warlock,destruction,44,28,16
40268,Venticm,tichondrius,1810,warlock,destruction,42,26,16
40269,Alchan,tichondrius,1810,warlock,destruction,65,38,27
40270,Fartymårty,tichondrius,1810,warlock,destruction,36,21,15
40271,Omnireaper,tichondrius,1810,warlock,destruction,54,29,25
40272,Berkz,stormrage,1810,warlock,destruction,66,33,33
40273,Oof,dalaran,1809,warlock,destruction,30,22,8
40274,Ashlet,kelthuzad,1809,warlock,destruction,48,30,18
40275,Charlieo,barthilas,1809,warlock,destruction,96,55,41
40276,Brutalsummon,frostmourne,1809,warlock,destruction,105,59,46
40277,Il,nerzhul,1808,warlock,destruction,24,19,5
40278,Emeraldflame,turalyon,1808,warlock,destruction,60,44,16
40279,Fanzhiyi,illidan,1808,warlock,destruction,43,27,16
40280,Blackchinese,zuljin,1808,warlock,destruction,138,73,65
40281,Niava,tichondrius,1808,warlock,destruction,54,28,26
40282,Kyrmax,malganis,1808,warlock,destruction,126,62,64
40283,Drthiccbolts,malganis,1807,warlock,destruction,47,29,18
40284,Drdoom,sargeras,1807,warlock,destruction,36,22,14
40285,Cheqmate,moon-guard,1807,warlock,destruction,61,36,25
40286,Symaitiel,azralon,1807,warlock,destruction,72,41,31
40287,Aidadeshu,tichondrius,1807,warlock,destruction,60,32,28
40288,Yeepzbytre,bleeding-hollow,1806,warlock,destruction,42,32,10
40289,Almostoogood,illidan,1806,warlock,destruction,30,19,11
40290,Elfwarlock,aerie-peak,1806,warlock,destruction,40,25,15
40291,Belenas,tichondrius,1806,warlock,destruction,48,28,20
40292,Rotshtëin,tichondrius,1806,warlock,destruction,173,91,82
40293,Nigthdeath,nemesis,1806,warlock,destruction,173,91,82
40294,Döremi,tichondrius,1805,warlock,destruction,48,28,20
40295,Veleza,kiljaeden,1805,warlock,destruction,82,47,35
40296,Vulcke,kelthuzad,1805,warlock,destruction,47,23,24
40297,Curse,agamaggan,1804,warlock,destruction,114,65,49
40298,Meatmanxtrem,sargeras,1804,warlock,destruction,60,33,27
40299,Expiredfood,stormreaver,1803,warlock,destruction,42,26,16
40300,Bod,bleeding-hollow,1803,warlock,destruction,42,24,18
40301,Neghros,illidan,1803,warlock,destruction,101,52,49
40302,Wwlock,area-52,1803,warlock,destruction,116,59,57
40303,Scârecrow,stormrage,1802,warlock,destruction,72,46,26
40304,Dxhusky,tichondrius,1802,warlock,destruction,48,26,22
40305,Struggles,emerald-dream,1802,warlock,destruction,159,85,74
40306,Mamosa,stormrage,1801,warlock,destruction,72,52,20
40307,Geekmonster,tichondrius,1801,warlock,destruction,54,33,21
40308,Rettek,bleeding-hollow,1801,warlock,destruction,48,27,21
40309,Seltzi,illidan,1801,warlock,destruction,47,25,22
40310,Dauntx,proudmoore,1801,warlock,destruction,66,33,33
40311,Necrochemist,frostmane,1800,warlock,destruction,24,19,5
40312,Xervas,frostmourne,1800,warlock,destruction,54,33,21
40313,Soulbane,nemesis,1800,warlock,destruction,36,22,14
40314,Notprint,sargeras,1800,warlock,destruction,36,22,14
40315,Warmstreak,blackrock,1800,warlock,destruction,48,28,20
40316,Lapidate,malganis,1800,warlock,destruction,59,33,26
40317,Latchlock,malganis,1800,warlock,destruction,149,83,66
40318,Sherlóck,duskwood,1798,warlock,destruction,54,28,26
40319,Cróhns,bleeding-hollow,1797,warlock,destruction,139,86,53
40320,Marcelium,greymane,1793,warlock,destruction,36,24,12
40321,Aryoc,ragnaros,1793,warlock,destruction,84,51,33
40322,Krikxy,tichondrius,1793,warlock,destruction,56,31,25
40323,Kartharian,wyrmrest-accord,1793,warlock,destruction,142,70,72
40324,Feardotjpg,stormrage,1791,warlock,destruction,42,29,13
40325,Kogath,thunderlord,1791,warlock,destruction,98,57,41
40326,Shadøwy,nemesis,1791,warlock,destruction,184,102,82
40327,Kyleslock,illidan,1790,warlock,destruction,29,21,8
40328,Barbieelf,sargeras,1790,warlock,destruction,186,98,88
40329,Isoldmysoul,stormrage,1788,warlock,destruction,72,35,37
40330,Marware,quelthalas,1787,warlock,destruction,42,22,20
40331,Whitexzz,tichondrius,1786,warlock,destruction,42,24,18
40332,Deathhawkz,ravencrest,1784,warlock,destruction,36,24,12
40333,Espanyolo,zuljin,1783,warlock,destruction,48,37,11
40334,Wreyz,mannoroth,1783,warlock,destruction,72,39,33
40335,Eskyx,tichondrius,1783,warlock,destruction,42,22,20
40336,Nevermindxd,barthilas,1783,warlock,destruction,66,32,34
40337,Positivity,thunderhorn,1782,warlock,destruction,48,30,18
40338,Tonnon,stormrage,1782,warlock,destruction,84,47,37
40339,Ercaz,frostmourne,1781,warlock,destruction,42,20,22
40340,Dupapad,stormrage,1780,warlock,destruction,65,31,34
40341,Wineburger,frostmourne,1779,warlock,destruction,48,34,14
40342,Feetsampler,stormrage,1779,warlock,destruction,52,26,26
40343,Jakjub,kelthuzad,1778,warlock,destruction,54,31,23
40344,Deathcoill,frostmourne,1778,warlock,destruction,48,27,21
40345,Grq,stormrage,1775,warlock,destruction,69,43,26
40346,Hellparks,malganis,1774,warlock,destruction,42,27,15
40347,Spicywhite,tichondrius,1774,warlock,destruction,43,24,19
40348,Screwed,tichondrius,1773,warlock,destruction,96,49,47
40349,Cenich,darkspear,1772,warlock,destruction,49,33,16
40350,Corkeý,azuremyst,1772,warlock,destruction,54,28,26
40351,Tenaciousd,malganis,1772,warlock,destruction,42,21,21
40352,Alùcärd,tichondrius,1772,warlock,destruction,54,25,29
40353,Azlloa,tichondrius,1771,warlock,destruction,42,27,15
40354,Plasticware,korgath,1771,warlock,destruction,48,29,19
40355,Andelaylas,tichondrius,1771,warlock,destruction,95,57,38
40356,Twilson,moon-guard,1771,warlock,destruction,54,29,25
40357,Dxhusky,illidan,1771,warlock,destruction,54,28,26
40358,Karimbenzema,tichondrius,1770,warlock,destruction,48,28,20
40359,Bigjmmywiggl,illidan,1768,warlock,destruction,85,51,34
40360,Doughnut,mugthol,1768,warlock,destruction,60,34,26
40361,Lifeinsuranc,tichondrius,1767,warlock,destruction,30,19,11
40362,Trundle,area-52,1766,warlock,destruction,29,21,8
40363,Chaosjedi,stormrage,1764,warlock,destruction,99,49,50
40364,Punstable,tichondrius,1763,warlock,destruction,121,65,56
40365,Kakistocracy,kelthuzad,1761,warlock,destruction,30,23,7
40366,Gottawiz,illidan,1758,warlock,destruction,60,32,28
40367,Nick,llane,1757,warlock,destruction,36,23,13
40368,Jussmollett,arygos,1756,warlock,destruction,83,49,34
40369,Squishyboy,tichondrius,1755,warlock,destruction,57,30,27
40370,Ravëncläw,quelthalas,1755,warlock,destruction,67,35,32
40371,Flattsl,tichondrius,1755,warlock,destruction,84,39,45
40372,Obliceress,crushridge,1754,warlock,destruction,42,26,16
40373,Screampies,tichondrius,1754,warlock,destruction,46,27,19
40374,Ibrroski,proudmoore,1753,warlock,destruction,24,20,4
40375,Glôck,lightbringer,1752,warlock,destruction,86,41,45
40376,Romdi,tichondrius,1750,warlock,destruction,46,29,17
40377,Åbyssal,stormrage,1750,warlock,destruction,147,86,61
40378,Homeboyardee,the-venture-co,1747,warlock,destruction,48,27,21
40379,Darkwidow,sargeras,1746,warlock,destruction,182,89,93
40380,Qualio,thrall,1746,warlock,destruction,123,59,64
40381,Razlock,moon-guard,1744,warlock,destruction,192,104,88
40382,Magnetix,arthas,1744,warlock,destruction,175,90,85
40383,Thinktank,tichondrius,1743,warlock,destruction,42,25,17
40384,Mjndewb,tichondrius,1741,warlock,destruction,36,28,8
40385,Halloweèn,kelthuzad,1741,warlock,destruction,131,74,57
40386,Pkzy,azralon,1741,warlock,destruction,36,19,17
40387,Maggotworm,sargeras,1740,warlock,destruction,183,103,80
40388,Keylloggz,sargeras,1740,warlock,destruction,96,54,42
40389,Lockfaceguy,agamaggan,1738,warlock,destruction,72,37,35
40390,Darkmagician,kelthuzad,1735,warlock,destruction,30,22,8
40391,Hädes,frostwolf,1734,warlock,destruction,42,29,13
40392,Mânuel,akama,1731,warlock,destruction,30,22,8
40393,Midoolock,proudmoore,1729,warlock,destruction,60,40,20
40394,Harmfuul,illidan,1728,warlock,destruction,45,28,17
40395,Swapsfour,area-52,1727,warlock,destruction,30,19,11
40396,Nasn,black-dragonflight,1726,warlock,destruction,50,31,19
40397,Revenus,tichondrius,1724,warlock,destruction,100,52,48
40398,Mindrekt,azralon,1723,warlock,destruction,60,44,16
40399,Daylyt,sargeras,1723,warlock,destruction,27,19,8
40400,Popdotdropit,frostwolf,1723,warlock,destruction,72,42,30
40401,Daimonic,bronzebeard,1721,warlock,destruction,66,40,26
40402,Xivra,thrall,1721,warlock,destruction,47,27,20
40403,Inmøtion,tichondrius,1721,warlock,destruction,36,18,18
40404,Chaoticchaos,kelthuzad,1719,warlock,destruction,29,19,10
40405,Evanylock,proudmoore,1718,warlock,destruction,39,23,16
40406,Agni,gurubashi,1718,warlock,destruction,126,66,60
40407,Bigulinhos,nemesis,1717,warlock,destruction,30,18,12
40408,Yidhra,aerie-peak,1717,warlock,destruction,99,55,44
40409,Spooked,khadgar,1716,warlock,destruction,36,24,12
40410,Loksoflove,tichondrius,1715,warlock,destruction,24,18,6
40411,Lockfoxyy,tichondrius,1714,warlock,destruction,30,21,9
40412,Podda,shuhalo,1713,warlock,destruction,47,29,18
40413,Evatar,malganis,1712,warlock,destruction,36,21,15
40414,Hehimx,bleeding-hollow,1711,warlock,destruction,24,18,6
40415,Serveq,tichondrius,1710,warlock,destruction,103,58,45
40416,Richãrd,area-52,1709,warlock,destruction,49,26,23
40417,Destructo,illidan,1709,warlock,destruction,54,25,29
40418,Juicestarr,barthilas,1708,warlock,destruction,84,41,43
40419,Wårløck,stormrage,1707,warlock,destruction,24,18,6
40420,Cocaineparty,tichondrius,1707,warlock,destruction,53,29,24
40421,Terrorbytes,frostmourne,1705,warlock,destruction,74,42,32
40422,Doombaby,zuljin,1703,warlock,destruction,88,56,32
40423,Eggpower,tichondrius,1703,warlock,destruction,40,23,17
40424,Uranusa,proudmoore,1700,warlock,destruction,84,40,44
40425,Shutkax,sargeras,1699,warlock,destruction,30,23,7
40426,Wolfstein,tichondrius,1699,warlock,destruction,24,18,6
40427,Conradlenoir,illidan,1699,warlock,destruction,36,23,13
40428,Giantgobrin,zuljin,1699,warlock,destruction,60,31,29
40429,Frightbright,sargeras,1698,warlock,destruction,31,18,13
40430,Cloudynightz,tichondrius,1698,warlock,destruction,149,81,68
40431,Daartaru,quelthalas,1698,warlock,destruction,90,48,42
40432,Azazil,malganis,1697,warlock,destruction,36,22,14
40433,Tribulatiön,moon-guard,1697,warlock,destruction,292,157,135
40434,Fredwinsta,laughing-skull,1697,warlock,destruction,54,29,25
40435,Iskiplegday,illidan,1697,warlock,destruction,101,43,58
40436,Sairic,azralon,1696,warlock,destruction,48,36,12
40437,Hiddentech,saurfang,1696,warlock,destruction,36,20,16
40438,Pigmahz,malganis,1696,warlock,destruction,59,32,27
40439,Zírds,stormrage,1696,warlock,destruction,42,22,20
40440,Teivlol,mugthol,1696,warlock,destruction,36,18,18
40441,Covidmaster,frostmourne,1695,warlock,destruction,83,45,38
40442,Chaosbôlt,proudmoore,1695,warlock,destruction,84,43,41
40443,Koramoz,area-52,1695,warlock,destruction,152,75,77
40444,Mchawi,tichondrius,1694,warlock,destruction,42,26,16
40445,Scarified,illidan,1693,warlock,destruction,60,25,35
40446,Pk,azralon,1691,warlock,destruction,24,18,6
40447,Dotandforget,tichondrius,1691,warlock,destruction,36,24,12
40448,Cbx,kelthuzad,1690,warlock,destruction,36,28,8
40449,Aluaris,earthen-ring,1690,warlock,destruction,30,23,7
40450,Chaosbeard,korgath,1690,warlock,destruction,62,36,26
40451,Buboñic,area-52,1690,warlock,destruction,47,27,20
40452,Vilebeing,frostmourne,1689,warlock,destruction,24,20,4
40453,Deammon,tichondrius,1689,warlock,destruction,42,28,14
40454,Jarasseck,malganis,1688,warlock,destruction,76,41,35
40455,Kairiesmirk,illidan,1688,warlock,destruction,93,48,45
40456,Paparoxy,illidan,1688,warlock,destruction,48,23,25
40457,Hynnis,nemesis,1687,warlock,destruction,54,36,18
40458,Tahmrin,quelthalas,1687,warlock,destruction,40,23,17
40459,Dautenit,illidan,1687,warlock,destruction,66,32,34
40460,Drain,proudmoore,1686,warlock,destruction,60,38,22
40461,Bobbyshmurdå,frostmourne,1686,warlock,destruction,48,29,19
40462,Contagion,dragonmaw,1685,warlock,destruction,36,20,16
40463,Hellwish,tichondrius,1682,warlock,destruction,96,48,48
40464,Muffîn,moon-guard,1681,warlock,destruction,103,62,41
40465,Viralwashbrn,illidan,1681,warlock,destruction,36,19,17
40466,Droptopp,malganis,1680,warlock,destruction,42,27,15
40467,Gladyr,frostmourne,1680,warlock,destruction,36,21,15
40468,Missmonday,tichondrius,1679,warlock,destruction,41,23,18
40469,Yaresly,kelthuzad,1678,warlock,destruction,38,25,13
40470,Gavrhin,area-52,1678,warlock,destruction,41,26,15
40471,Exilegd,proudmoore,1678,warlock,destruction,59,37,22
40472,Sakyameil,area-52,1678,warlock,destruction,42,25,17
40473,Lïttle,stormrage,1678,warlock,destruction,81,48,33
40474,Krokusx,illidan,1678,warlock,destruction,84,46,38
40475,Breeak,sargeras,1676,warlock,destruction,48,31,17
40476,Dipixd,tichondrius,1675,warlock,destruction,24,22,2
40477,Gianni,chogall,1675,warlock,destruction,42,24,18
40478,Feardadots,tichondrius,1674,warlock,destruction,69,46,23
40479,Pyatpree,bleeding-hollow,1671,warlock,destruction,30,19,11
40480,Intentionz,sargeras,1671,warlock,destruction,41,24,17
40481,Lemonfire,area-52,1671,warlock,destruction,43,24,19
40482,Sidgnosis,stormrage,1671,warlock,destruction,177,91,86
40483,Mlxd,tichondrius,1670,warlock,destruction,24,19,5
40484,Nocrackrocks,stormrage,1670,warlock,destruction,34,22,12
40485,Bouldrlickr,dragonmaw,1669,warlock,destruction,42,25,17
40486,Ðiêsel,malganis,1668,warlock,destruction,57,32,25
40487,Manapouli,area-52,1667,warlock,destruction,33,21,12
40488,Levantine,barthilas,1667,warlock,destruction,45,24,21
40489,Ifearjoo,vashj,1666,warlock,destruction,48,25,23
40490,Zimer,moon-guard,1665,warlock,destruction,60,34,26
40491,Degred,tichondrius,1664,warlock,destruction,45,34,11
40492,Evilempire,sargeras,1663,warlock,destruction,36,22,14
40493,Ralerhard,kelthuzad,1663,warlock,destruction,46,27,19
40494,Olgee,tortheldrin,1663,warlock,destruction,53,30,23
40495,Chnos,mugthol,1663,warlock,destruction,41,23,18
40496,Uarus,tichondrius,1662,warlock,destruction,30,19,11
40497,Kossnen,shandris,1661,warlock,destruction,46,25,21
40498,Dartthvader,azralon,1661,warlock,destruction,92,45,47
40499,Booßiemiles,area-52,1659,warlock,destruction,127,77,50
40500,Kâyn,area-52,1659,warlock,destruction,71,36,35
40501,Bytezlk,area-52,1657,warlock,destruction,30,20,10
40502,Sendnudez,nemesis,1657,warlock,destruction,53,30,23
40503,Lønewølf,sargeras,1657,warlock,destruction,66,32,34
40504,Denotate,zuljin,1656,warlock,destruction,44,26,18
40505,Mephizar,moon-guard,1656,warlock,destruction,56,30,26
40506,Deangood,tichondrius,1656,warlock,destruction,152,77,75
40507,Mursay,tichondrius,1655,warlock,destruction,30,23,7
40508,Steebi,tichondrius,1655,warlock,destruction,36,23,13
40509,Nooko,frostmourne,1655,warlock,destruction,48,25,23
40510,Fece,area-52,1652,warlock,destruction,38,24,14
40511,Warmandei,dalaran,1652,warlock,destruction,72,42,30
40512,Derok,bleeding-hollow,1652,warlock,destruction,235,117,118
40513,Zoagen,ragnaros,1650,warlock,destruction,28,20,8
40514,Lockniel,skullcrusher,1649,warlock,destruction,60,37,23
40515,Absoluté,nemesis,1649,warlock,destruction,36,19,17
40516,Getoffmedawg,illidan,1648,warlock,destruction,48,28,20
40517,Royalmace,dethecus,1648,warlock,destruction,46,25,21
40518,Zakhim,zuljin,1647,warlock,destruction,42,28,14
40519,Noggét,frostmourne,1647,warlock,destruction,102,61,41
40520,Vallàx,area-52,1647,warlock,destruction,114,57,57
40521,Nt,burning-legion,1646,warlock,destruction,37,30,7
40522,Agonie,tichondrius,1646,warlock,destruction,239,128,111
40523,Cairo,emerald-dream,1646,warlock,destruction,219,115,104
40524,Lhandus,drakkari,1646,warlock,destruction,56,28,28
40525,Javirr,ragnaros,1645,warlock,destruction,65,39,26
40526,Neverportx,kirin-tor,1645,warlock,destruction,36,21,15
40527,Critthis,illidan,1644,warlock,destruction,35,25,10
40528,Misolock,sargeras,1644,warlock,destruction,105,56,49
40529,Revérence,sargeras,1644,warlock,destruction,41,21,20
40530,Oblivious,firetree,1644,warlock,destruction,195,98,97
40531,Ðemented,bleeding-hollow,1643,warlock,destruction,33,19,14
40532,Carcøsa,malganis,1643,warlock,destruction,36,20,16
40533,Devilman,darkspear,1643,warlock,destruction,109,57,52
40534,Làsko,area-52,1643,warlock,destruction,84,41,43
40535,Debigbolt,area-52,1642,warlock,destruction,30,22,8
40536,Fiddlesticks,draka,1642,warlock,destruction,54,36,18
40537,Galfear,malganis,1642,warlock,destruction,165,88,77
40538,Katrisse,aegwynn,1642,warlock,destruction,60,32,28
40539,Chaosage,sargeras,1640,warlock,destruction,42,28,14
40540,Fearmebro,bleeding-hollow,1639,warlock,destruction,139,72,67
40541,Dotgonewrong,malganis,1639,warlock,destruction,35,18,17
40542,Sixv,barthilas,1638,warlock,destruction,30,22,8
40543,Adelrinn,frostmourne,1638,warlock,destruction,125,72,53
40544,Annereyn,stormrage,1638,warlock,destruction,72,39,33
40545,Pyralock,malfurion,1638,warlock,destruction,48,25,23
40546,Demonclock,sargeras,1637,warlock,destruction,39,24,15
40547,Stocktonslap,saurfang,1637,warlock,destruction,133,75,58
40548,Ardentia,malganis,1637,warlock,destruction,54,30,24
40549,Reficul,frostmourne,1637,warlock,destruction,50,23,27
40550,Parishiltoon,frostmourne,1637,warlock,destruction,52,22,30
40551,Arenis,stormrage,1636,warlock,destruction,36,25,11
40552,Xylâ,emerald-dream,1636,warlock,destruction,39,22,17
40553,Dëstró,tichondrius,1636,warlock,destruction,41,23,18
40554,Eyoeyo,tichondrius,1636,warlock,destruction,42,18,24
40555,Flággedname,area-52,1635,warlock,destruction,36,21,15
40556,Killabeesack,tichondrius,1635,warlock,destruction,43,25,18
40557,Bénâfflock,area-52,1634,warlock,destruction,54,32,22
40558,Bolsheivik,dentarg,1634,warlock,destruction,46,25,21
40559,Iconicxo,thrall,1634,warlock,destruction,84,43,41
40560,Spaceghóst,bleeding-hollow,1633,warlock,destruction,141,73,68
40561,Zhaphrax,frostmourne,1633,warlock,destruction,85,43,42
40562,Meraz,zuljin,1632,warlock,destruction,34,20,14
40563,Evapilot,tichondrius,1632,warlock,destruction,54,31,23
40564,Guldoom,tichondrius,1631,warlock,destruction,18,17,1
40565,Demonista,illidan,1631,warlock,destruction,31,22,9
40566,Sagatt,illidan,1631,warlock,destruction,68,37,31
40567,Shendù,stormrage,1631,warlock,destruction,48,23,25
40568,Ddorangmoon,tichondrius,1630,warlock,destruction,42,25,17
40569,Dipixyz,tichondrius,1630,warlock,destruction,30,17,13
40570,Tanskeeh,sargeras,1630,warlock,destruction,64,35,29
40571,Holunging,illidan,1630,warlock,destruction,36,19,17
40572,Wafflezcb,frostmourne,1630,warlock,destruction,37,18,19
40573,Strykerliath,bleeding-hollow,1629,warlock,destruction,43,26,17
40574,Psyløck,bleeding-hollow,1629,warlock,destruction,48,29,19
40575,Dewandoritos,kelthuzad,1629,warlock,destruction,30,17,13
40576,Stormrift,sargeras,1629,warlock,destruction,74,39,35
40577,Ltoplaylock,area-52,1628,warlock,destruction,24,17,7
40578,Soranpotter,tichondrius,1628,warlock,destruction,24,17,7
40579,Cöpeñhagen,illidan,1627,warlock,destruction,48,26,22
40580,Undeadzx,tichondrius,1627,warlock,destruction,36,19,17
40581,Meep,madoran,1626,warlock,destruction,59,35,24
40582,Nahz,tichondrius,1626,warlock,destruction,30,17,13
40583,Katastrophïk,area-52,1626,warlock,destruction,36,20,16
40584,Sîthfu,tichondrius,1626,warlock,destruction,183,98,85
40585,Døomsday,hyjal,1626,warlock,destruction,42,21,21
40586,Byndedlock,dragonmaw,1625,warlock,destruction,33,20,13
40587,Vvivienx,tichondrius,1625,warlock,destruction,30,17,13
40588,Dovahkini,stormrage,1625,warlock,destruction,47,23,24
40589,Shadowsloc,tichondrius,1625,warlock,destruction,48,22,26
40590,Stølo,deathwing,1624,warlock,destruction,112,73,39
40591,Zandõx,jubeithos,1624,warlock,destruction,42,27,15
40592,Matafé,kelthuzad,1623,warlock,destruction,30,20,10
40593,Doomswitch,sargeras,1622,warlock,destruction,36,27,9
40594,Thotblood,stormrage,1622,warlock,destruction,24,18,6
40595,Friendd,frostmourne,1622,warlock,destruction,41,30,11
40596,Maddotts,malganis,1622,warlock,destruction,36,26,10
40597,Jerearderedo,thrall,1622,warlock,destruction,48,28,20
40598,Permaslowed,kiljaeden,1622,warlock,destruction,40,22,18
40599,Golock,tichondrius,1621,warlock,destruction,24,17,7
40600,Richãrdjr,area-52,1621,warlock,destruction,24,17,7
40601,Elmobolt,thrall,1620,warlock,destruction,37,27,10
40602,Penzer,stormrage,1618,warlock,destruction,36,20,16
40603,Dolut,azralon,1617,warlock,destruction,54,31,23
40604,Restolock,destromath,1617,warlock,destruction,60,34,26
40605,Infecçäo,stormrage,1616,warlock,destruction,72,43,29
40606,Calidaze,tichondrius,1616,warlock,destruction,80,44,36
40607,Plexwl,sargeras,1616,warlock,destruction,69,37,32
40608,Esså,jaedenar,1616,warlock,destruction,42,18,24
40609,Jpepps,perenolde,1615,warlock,destruction,41,28,13
40610,Ðarkñess,burning-legion,1615,warlock,destruction,66,38,28
40611,Birez,kelthuzad,1614,warlock,destruction,62,31,31
40612,Leruss,zangarmarsh,1614,warlock,destruction,37,17,20
40613,Saltiez,sargeras,1613,warlock,destruction,24,18,6
40614,Shïrõ,tichondrius,1613,warlock,destruction,30,22,8
40615,Anujy,moon-guard,1612,warlock,destruction,60,38,22
40616,Thirdsol,stormrage,1612,warlock,destruction,29,18,11
40617,Belzebud,area-52,1612,warlock,destruction,93,56,37
40618,Ko,nordrassil,1612,warlock,destruction,66,34,32
40619,Grandpa,daggerspine,1612,warlock,destruction,97,49,48
40620,Razzakka,stormrage,1612,warlock,destruction,159,79,80
40621,Hypnotikal,illidan,1611,warlock,destruction,30,22,8
40622,Draenil,eredar,1611,warlock,destruction,24,17,7
40623,Josaith,moon-guard,1610,warlock,destruction,89,51,38
40624,Omleaf,malganis,1610,warlock,destruction,36,18,18
40625,Gigabiga,tol-barad,1609,warlock,destruction,24,17,7
40626,Horloc,moon-guard,1609,warlock,destruction,68,38,30
40627,Zuyumin,ragnaros,1608,warlock,destruction,89,57,32
40628,Ayrr,zuljin,1608,warlock,destruction,30,17,13
40629,Gnomlette,smolderthorn,1608,warlock,destruction,98,53,45
40630,Kály,azralon,1608,warlock,destruction,69,37,32
40631,Notspeedy,tichondrius,1608,warlock,destruction,75,32,43
40632,Lostanubis,tichondrius,1607,warlock,destruction,39,24,15
40633,Trewlocke,sargeras,1607,warlock,destruction,36,22,14
40634,Wayce,burning-blade,1607,warlock,destruction,98,52,46
40635,Grindwald,echo-isles,1606,warlock,destruction,55,30,25
40636,Bugha,ravencrest,1605,warlock,destruction,31,21,10
40637,Macdeezylock,sargeras,1605,warlock,destruction,36,23,13
40638,Vugaddi,illidan,1605,warlock,destruction,30,19,11
40639,Hordeadlock,illidan,1604,warlock,destruction,60,31,29
40640,Brickedx,malfurion,1604,warlock,destruction,101,50,51
40641,Honchoe,illidan,1603,warlock,destruction,42,29,13
40642,Nosferatu,arthas,1602,warlock,destruction,26,20,6
40643,Sslock,sargeras,1602,warlock,destruction,46,26,20
40644,Dippidydot,illidan,1602,warlock,destruction,60,31,29
40645,Espyn,silvermoon,1602,warlock,destruction,105,51,54
40646,Juswannarock,tichondrius,1601,warlock,destruction,33,22,11
40647,Lyonesse,frostmourne,1601,warlock,destruction,34,21,13
40648,Daenon,kiljaeden,1601,warlock,destruction,42,23,19
40649,Lafourche,tichondrius,1601,warlock,destruction,54,28,26
40650,Pauldiesel,ragnaros,1601,warlock,destruction,42,21,21
40651,Hâm,dalaran,1601,warlock,destruction,96,46,50
40652,Dapete,malorne,1600,warlock,destruction,36,26,10
40653,Locknug,tichondrius,1600,warlock,destruction,132,74,58
40654,Kurifodo,illidan,1600,warlock,destruction,59,33,26
40655,Adouken,ragnaros,1600,warlock,destruction,36,19,17
40656,Rxjr,sargeras,1599,warlock,destruction,81,39,42
40657,Boltsnhoez,tichondrius,1598,warlock,destruction,34,20,14
40658,Apøçàlÿpsè,firetree,1598,warlock,destruction,71,37,34
40659,Belford,tichondrius,1598,warlock,destruction,49,25,24
40660,Predictions,sargeras,1597,warlock,destruction,77,40,37
40661,Closetslut,moon-guard,1596,warlock,destruction,24,20,4
40662,Nefandous,malganis,1596,warlock,destruction,161,90,71
40663,Guula,alexstrasza,1595,warlock,destruction,42,22,20
40664,Dotcoin,tichondrius,1594,warlock,destruction,30,17,13
40665,Lockforyou,frostmourne,1594,warlock,destruction,66,37,29
40666,Rotfull,burning-legion,1594,warlock,destruction,39,18,21
40667,Wheremyshoes,area-52,1593,warlock,destruction,141,68,73
40668,Kernlberton,tichondrius,1592,warlock,destruction,48,25,23
40669,Larryfisher,drenden,1591,warlock,destruction,30,19,11
40670,Dots,haomarush,1591,warlock,destruction,60,31,29
40671,Yisuschríst,quelthalas,1591,warlock,destruction,41,21,20
40672,Demonkiiller,kelthuzad,1591,warlock,destruction,48,19,29
40673,Caustikk,malganis,1587,warlock,destruction,44,25,19
40674,Klumzey,tichondrius,1587,warlock,destruction,36,20,16
40675,Buffwarlocks,senjin,1587,warlock,destruction,48,26,22
40676,Tothegrave,sargeras,1585,warlock,destruction,35,22,13
40677,Kuroyt,drakkari,1583,warlock,destruction,42,26,16
40678,Gluestik,shadowmoon,1581,warlock,destruction,54,28,26
40679,Gerthclas,aggramar,1579,warlock,destruction,35,24,11
40680,Bbclover,thrall,1579,warlock,destruction,29,19,10
40681,Matilla,tichondrius,1579,warlock,destruction,30,19,11
40682,Korose,tichondrius,1579,warlock,destruction,142,72,70
40683,Woezz,tichondrius,1577,warlock,destruction,93,49,44
40684,Charnoob,kelthuzad,1577,warlock,destruction,54,26,28
40685,Soreanus,illidan,1576,warlock,destruction,28,20,8
40686,Xiyangpvp,tichondrius,1576,warlock,destruction,48,18,30
40687,Brettmackson,area-52,1574,warlock,destruction,87,48,39
40688,Borthrel,moon-guard,1573,warlock,destruction,132,75,57
40689,Hootenanny,korialstrasz,1573,warlock,destruction,54,28,26
40690,Leônidos,ghostlands,1573,warlock,destruction,102,52,50
40691,Chachanoobx,sargeras,1572,warlock,destruction,114,72,42
40692,Stankbigly,thrall,1571,warlock,destruction,38,23,15
40693,Warlockmf,sargeras,1571,warlock,destruction,115,64,51
40694,Carmelasin,moon-guard,1570,warlock,destruction,60,39,21
40695,Melôck,area-52,1569,warlock,destruction,30,20,10
40696,Mythdot,ragnaros,1569,warlock,destruction,88,45,43
40697,Killvilock,kelthuzad,1569,warlock,destruction,61,30,31
40698,Necrotic,mannoroth,1569,warlock,destruction,96,41,55
40699,Babydots,stormreaver,1568,warlock,destruction,74,40,34
40700,Burnzul,bleeding-hollow,1567,warlock,destruction,42,22,20
40701,Khrom,illidan,1565,warlock,destruction,64,32,32
40702,Whathurts,tichondrius,1564,warlock,destruction,86,42,44
40703,Uow,stormrage,1564,warlock,destruction,42,20,22
40704,Alfaflux,tol-barad,1563,warlock,destruction,53,24,29
40705,Felnightz,area-52,1562,warlock,destruction,48,23,25
40706,Watchmegate,darkspear,1561,warlock,destruction,60,38,22
40707,Kevin,moon-guard,1560,warlock,destruction,58,34,24
40708,Khurze,area-52,1558,warlock,destruction,57,29,28
40709,Vasago,jubeithos,1558,warlock,destruction,71,36,35
40710,Lustyclam,tichondrius,1557,warlock,destruction,59,38,21
40711,Tuugadark,echo-isles,1557,warlock,destruction,51,32,19
40712,Sauromann,sargeras,1557,warlock,destruction,72,42,30
40713,Promethian,proudmoore,1556,warlock,destruction,59,26,33
40714,Lilbiackguy,stormrage,1555,warlock,destruction,72,45,27
40715,Niked,sargeras,1553,warlock,destruction,114,67,47
40716,Funnysoxx,caelestrasz,1553,warlock,destruction,40,22,18
40717,Hugechungusw,frostmourne,1552,warlock,destruction,32,21,11
40718,Tunacangirth,mannoroth,1551,warlock,destruction,24,17,7
40719,Wiildgoose,area-52,1551,warlock,destruction,36,24,12
40720,Ændrew,darkspear,1551,warlock,destruction,29,18,11
40721,Flake,kelthuzad,1550,warlock,destruction,36,18,18
40722,Jaythuzad,stormrage,1549,warlock,destruction,92,48,44
40723,Neph,malganis,1549,warlock,destruction,38,19,19
40724,Loadybigbolt,dalaran,1548,warlock,destruction,59,30,29
40725,Bayfayth,zuljin,1546,warlock,destruction,92,52,40
40726,Jnxzlock,sargeras,1546,warlock,destruction,61,34,27
40727,Bunnyhugs,gorefiend,1542,warlock,destruction,24,17,7
40728,Remua,tichondrius,1540,warlock,destruction,29,18,11
40729,Dragoska,kiljaeden,1540,warlock,destruction,30,17,13
40730,Ioroselmi,illidan,1540,warlock,destruction,101,51,50
40731,Nybeth,malganis,1539,warlock,destruction,80,39,41
40732,Cryptos,kalecgos,1538,warlock,destruction,38,22,16
40733,Flxmin,area-52,1538,warlock,destruction,58,29,29
40734,Hadouh,stormrage,1537,warlock,destruction,29,17,12
40735,Egirlgamer,sargeras,1537,warlock,destruction,36,21,15
40736,Tharki,darkspear,1537,warlock,destruction,64,34,30
40737,Gorontar,kelthuzad,1537,warlock,destruction,44,20,24
40738,Manthos,sargeras,1537,warlock,destruction,63,24,39
40739,Lockdogg,mannoroth,1536,warlock,destruction,30,18,12
40740,Lockybalboah,turalyon,1536,warlock,destruction,108,58,50
40741,Ezdagor,quelthalas,1535,warlock,destruction,140,76,64
40742,Chadica,malganis,1534,warlock,destruction,18,16,2
40743,Boodizz,frostmourne,1534,warlock,destruction,30,16,14
40744,Sylrath,illidan,1534,warlock,destruction,36,17,19
40745,Scarletdemon,malganis,1532,warlock,destruction,65,35,30
40746,Captrollol,tichondrius,1531,warlock,destruction,60,30,30
40747,Fearem,tichondrius,1530,warlock,destruction,27,17,10
40748,Stonnerz,ragnaros,1530,warlock,destruction,47,29,18
40749,Sdiaz,illidan,1529,warlock,destruction,24,16,8
40750,Badmagic,area-52,1529,warlock,destruction,81,44,37
40751,Malagas,tichondrius,1529,warlock,destruction,69,37,32
40752,Beetlejoos,stormreaver,1529,warlock,destruction,30,16,14
40753,Brucelock,proudmoore,1528,warlock,destruction,24,16,8
40754,Zalord,mannoroth,1528,warlock,destruction,124,54,70
40755,Somethingud,tichondrius,1527,warlock,destruction,77,31,46
40756,Asetiks,tichondrius,1526,warlock,destruction,30,16,14
40757,Dewars,aggramar,1525,warlock,destruction,90,49,41
40758,Isarac,zuljin,1524,warlock,destruction,54,35,19
40759,Sidious,jubeithos,1523,warlock,destruction,38,24,14
40760,Dferreira,azralon,1523,warlock,destruction,99,56,43
40761,Plaintive,moon-guard,1523,warlock,destruction,30,16,14
40762,Conspiration,sargeras,1522,warlock,destruction,24,19,5
40763,Gnomerky,stormrage,1522,warlock,destruction,30,18,12
40764,Cesily,frostmourne,1522,warlock,destruction,30,16,14
40765,Tunacanthicc,moon-guard,1522,warlock,destruction,136,70,66
40766,Kascade,drakkari,1520,warlock,destruction,50,27,23
40767,Resuah,tichondrius,1520,warlock,destruction,63,30,33
40768,Xêlsnåp,steamwheedle-cartel,1519,warlock,destruction,91,53,38
40769,Thravis,tichondrius,1518,warlock,destruction,36,20,16
40770,Picklepuller,arthas,1517,warlock,destruction,42,28,14
40771,Grammapatty,tichondrius,1517,warlock,destruction,30,16,14
40772,Impdad,destromath,1515,warlock,destruction,60,42,18
40773,Darknessgodd,goldrinn,1514,warlock,destruction,73,43,30
40774,Austeeny,wyrmrest-accord,1513,warlock,destruction,31,21,10
40775,Politex,malganis,1513,warlock,destruction,64,40,24
40776,Kongal,tichondrius,1512,warlock,destruction,30,16,14
40777,Xoxoxu,frostmourne,1511,warlock,destruction,32,18,14
40778,Joseph,draktharon,1509,warlock,destruction,66,35,31
40779,Guldåniel,tichondrius,1508,warlock,destruction,30,16,14
40780,Obscurity,tichondrius,1507,warlock,destruction,48,23,25
40781,Luckehlock,firetree,1506,warlock,destruction,53,23,30
40782,Loçk,zuljin,1505,warlock,destruction,81,41,40
40783,Shaneyxd,bleeding-hollow,1504,warlock,destruction,24,16,8
40784,Squatchamp,sargeras,1503,warlock,destruction,48,28,20
40785,Dinglerdots,tichondrius,1502,warlock,destruction,27,21,6
40786,Jugaa,arthas,1502,warlock,destruction,41,29,12
40787,Yaldin,nemesis,1502,warlock,destruction,149,83,66
40788,Yükina,stormrage,1502,warlock,destruction,106,55,51
40789,Bosongo,boulderfist,1501,warlock,destruction,65,37,28
40790,Cbolt,tichondrius,1501,warlock,destruction,36,20,16
40791,Deboltzaru,ragnaros,1501,warlock,destruction,91,45,46
40792,Marcedlc,ragnaros,1500,warlock,destruction,66,38,28
40793,Jennifear,sargeras,1499,warlock,destruction,50,28,22
40794,Hellbòund,mugthol,1499,warlock,destruction,36,20,16
40795,Odiums,area-52,1498,warlock,destruction,77,44,33
40796,Kyoarnez,quelthalas,1498,warlock,destruction,48,24,24
40797,Kalellock,azralon,1497,warlock,destruction,108,57,51
40798,Firewõrks,moon-guard,1496,warlock,destruction,30,17,13
40799,Darthðotspam,mugthol,1495,warlock,destruction,66,41,25
40800,Memnøch,emerald-dream,1492,warlock,destruction,41,24,17
40801,Teesolinia,stormrage,1491,warlock,destruction,36,22,14
40802,Deathmask,alleria,1490,warlock,destruction,34,18,16
40803,Darkÿoda,malganis,1490,warlock,destruction,44,22,22
40804,Goomgoom,doomhammer,1489,warlock,destruction,114,50,64
40805,Titusvorenus,runetotem,1488,warlock,destruction,50,30,20
40806,Terrival,illidan,1487,warlock,destruction,41,22,19
40807,Zetsu,zuljin,1487,warlock,destruction,235,120,115
40808,Dotte,tichondrius,1486,warlock,destruction,59,31,28
40809,Nytefels,skullcrusher,1485,warlock,destruction,30,20,10
40810,Romminus,zuljin,1484,warlock,destruction,31,20,11
40811,Dynamó,tichondrius,1483,warlock,destruction,74,37,37
40812,Gingery,the-underbog,1483,warlock,destruction,71,34,37
40813,Humanreapers,malganis,1482,warlock,destruction,31,22,9
40814,Fshi,frostmourne,1482,warlock,destruction,102,58,44
40815,Dercair,korgath,1480,warlock,destruction,30,18,12
40816,Beyourselff,tichondrius,1479,warlock,destruction,35,16,19
40817,Dloq,azgalor,1478,warlock,destruction,117,70,47
40818,Chàõs,tichondrius,1477,warlock,destruction,54,27,27
40819,Garbagefarts,aegwynn,1475,warlock,destruction,38,20,18
40820,Tofulery,tichondrius,1475,warlock,destruction,50,23,27
40821,Sickgurl,stormrage,1474,warlock,destruction,42,26,16
40822,Bauchalain,area-52,1474,warlock,destruction,38,19,19
40823,Gatewayoncd,frostmourne,1474,warlock,destruction,54,25,29
40824,Glenfarclas,tichondrius,1471,warlock,destruction,43,19,24
40825,Pestilocks,area-52,1469,warlock,destruction,44,28,16
40826,Gharlock,tichondrius,1469,warlock,destruction,38,22,16
40827,Demondots,sargeras,1469,warlock,destruction,54,31,23
40828,Laylowl,tichondrius,1468,warlock,destruction,36,22,14
40829,Shadowxlock,misha,1468,warlock,destruction,95,51,44
40830,Magy,deathwing,1467,warlock,destruction,48,30,18
40831,Flor,khadgar,1467,warlock,destruction,164,82,82
40832,Pwz,azralon,1465,warlock,destruction,108,60,48
40833,Noxdolor,stormreaver,1465,warlock,destruction,36,20,16
40834,Zemphius,illidan,1463,warlock,destruction,55,27,28
40835,Daremyth,azralon,1461,warlock,destruction,30,20,10
40836,Morcegø,azralon,1460,warlock,destruction,42,20,22
40837,Jakeyboii,frostmourne,1459,warlock,destruction,51,33,18
40838,Falcorr,area-52,1459,warlock,destruction,34,19,15
40839,Jezwazerox,area-52,1458,warlock,destruction,93,50,43
40840,Covírus,azralon,1452,warlock,destruction,24,16,8
40841,Hellcon,area-52,1452,warlock,destruction,58,38,20
40842,Eriess,burning-blade,1447,warlock,destruction,54,24,30
40843,Ptheven,area-52,1446,warlock,destruction,52,35,17
40844,Stunresistin,tichondrius,1446,warlock,destruction,60,33,27
40845,Avelmi,daggerspine,1446,warlock,destruction,72,34,38
40846,Sickmade,zuljin,1445,warlock,destruction,24,16,8
40847,Mcjoy,akama,1445,warlock,destruction,224,114,110
40848,Demonicus,thunderlord,1445,warlock,destruction,51,24,27
40849,Maleficmango,tichondrius,1444,warlock,destruction,36,23,13
40850,Widdleywahh,area-52,1443,warlock,destruction,36,18,18
40851,Munar,quelthalas,1442,warlock,destruction,93,47,46
40852,Xbqss,illidan,1442,warlock,destruction,36,16,20
40853,Jaboltz,tichondrius,1441,warlock,destruction,25,16,9
40854,Mantis,proudmoore,1441,warlock,destruction,43,23,20
40855,Nttslock,tichondrius,1441,warlock,destruction,42,22,20
40856,Eldriptch,kelthuzad,1441,warlock,destruction,47,23,24
40857,Atrofourth,tichondrius,1441,warlock,destruction,48,23,25
40858,Discordant,trollbane,1439,warlock,destruction,36,23,13
40859,Printwo,sargeras,1439,warlock,destruction,24,15,9
40860,Janeciap,tichondrius,1439,warlock,destruction,24,15,9
40861,Maldivà,tichondrius,1439,warlock,destruction,24,15,9
40862,Indelock,drenden,1439,warlock,destruction,24,15,9
40863,Chaosmorty,tichondrius,1439,warlock,destruction,39,24,15
40864,Twototheone,illidan,1439,warlock,destruction,131,67,64
40865,Danaowns,spirestone,1439,warlock,destruction,30,15,15
40866,Selwitch,dalaran,1438,warlock,destruction,18,15,3
40867,Spectro,laughing-skull,1438,warlock,destruction,18,15,3
40868,Sâlâñzø,bleeding-hollow,1438,warlock,destruction,18,15,3
40869,Mykiel,sargeras,1438,warlock,destruction,42,21,21
40870,Goofycupcake,drakthul,1437,warlock,destruction,18,15,3
40871,Deathmásk,ragnaros,1437,warlock,destruction,18,15,3
40872,Krokodiil,tichondrius,1437,warlock,destruction,56,35,21
40873,Imbooms,blackrock,1437,warlock,destruction,30,15,15
40874,Pikme,bleeding-hollow,1436,warlock,destruction,18,15,3
40875,Rzlrot,tichondrius,1436,warlock,destruction,30,18,12
40876,Jämeson,tichondrius,1436,warlock,destruction,30,15,15
40877,Artzul,tichondrius,1436,warlock,destruction,60,25,35
40878,Bourrasq,illidan,1435,warlock,destruction,18,15,3
40879,Rollup,turalyon,1435,warlock,destruction,24,15,9
40880,Sonnagalook,sargeras,1435,warlock,destruction,42,24,18
40881,Mastasnipah,illidan,1435,warlock,destruction,30,15,15
40882,Stizzy,eredar,1434,warlock,destruction,24,15,9
40883,Kuoma,boulderfist,1434,warlock,destruction,121,57,64
40884,Felacid,tichondrius,1433,warlock,destruction,48,28,20
40885,Mcrfan,illidan,1432,warlock,destruction,18,15,3
40886,Wickedry,antonidas,1432,warlock,destruction,24,15,9
40887,Sëcond,azralon,1432,warlock,destruction,24,15,9
40888,Mldxd,undermine,1432,warlock,destruction,34,17,17
40889,Kayersoul,tichondrius,1432,warlock,destruction,30,15,15
40890,Dance,sargeras,1431,warlock,destruction,18,15,3
40891,Dunbu,illidan,1431,warlock,destruction,133,71,62
40892,Masefield,moon-guard,1431,warlock,destruction,68,33,35
40893,Verminosa,nemesis,1429,warlock,destruction,24,15,9
40894,Dotsyu,frostmourne,1429,warlock,destruction,50,28,22
40895,Conorloco,tichondrius,1429,warlock,destruction,36,15,21
40896,Naome,cenarius,1428,warlock,destruction,36,16,20
40897,Demontos,darkspear,1427,warlock,destruction,48,24,24
40898,Vexedconvex,area-52,1425,warlock,destruction,307,151,156
40899,Shadowfork,illidan,1424,warlock,destruction,24,15,9
40900,Thralord,blackrock,1424,warlock,destruction,30,18,12
40901,Straightlock,sargeras,1424,warlock,destruction,53,22,31
40902,Kanekiskid,mannoroth,1423,warlock,destruction,42,29,13
40903,Balepyre,moon-guard,1423,warlock,destruction,24,15,9
40904,Saddestboi,proudmoore,1423,warlock,destruction,66,40,26
40905,Siellisele,illidan,1423,warlock,destruction,30,15,15
40906,Gvvo,tichondrius,1423,warlock,destruction,30,15,15
40907,Çrayoneater,tichondrius,1423,warlock,destruction,52,22,30
40908,Soiedentaire,illidan,1422,warlock,destruction,36,30,6
40909,Nueleth,frostmourne,1422,warlock,destruction,47,24,23
40910,Tulu,muradin,1421,warlock,destruction,42,26,16
40911,Yuh,moon-guard,1420,warlock,destruction,18,15,3
40912,Fearloom,tichondrius,1420,warlock,destruction,151,78,73
40913,Chéztér,proudmoore,1420,warlock,destruction,121,60,61
40914,Soloart,tichondrius,1419,warlock,destruction,24,15,9
40915,Decrepticus,kargath,1419,warlock,destruction,44,26,18
40916,Jenda,blackrock,1419,warlock,destruction,30,15,15
40917,Destruction,frostmourne,1418,warlock,destruction,45,25,20
40918,Desconjuro,nemesis,1416,warlock,destruction,50,29,21
40919,Deatthmoon,stormrage,1415,warlock,destruction,24,15,9
40920,Kelifan,sargeras,1415,warlock,destruction,78,45,33
40921,Evillyñ,tichondrius,1415,warlock,destruction,66,35,31
40922,Locker,lightnings-blade,1414,warlock,destruction,30,18,12
40923,Iceameri,tichondrius,1414,warlock,destruction,62,34,28
40924,Alizondemdik,azralon,1414,warlock,destruction,45,23,22
40925,Priiscilá,drakkari,1414,warlock,destruction,36,16,20
40926,Exofilth,thrall,1414,warlock,destruction,58,25,33
40927,Budgetkroozz,illidan,1413,warlock,destruction,30,15,15
40928,Bilidin,azralon,1413,warlock,destruction,93,41,52
40929,Doublebolt,illidan,1412,warlock,destruction,65,42,23
40930,Baldandugly,illidan,1412,warlock,destruction,24,15,9
40931,Yorchziel,ragnaros,1412,warlock,destruction,88,47,41
40932,Aliciayd,andorhal,1411,warlock,destruction,24,15,9
40933,Greedy,garrosh,1410,warlock,destruction,24,15,9
40934,Thicclöcc,tichondrius,1410,warlock,destruction,30,15,15
40935,Parmenides,tichondrius,1410,warlock,destruction,42,19,23
40936,Johnnybegood,frostmourne,1409,warlock,destruction,24,15,9
40937,Mongdot,frostmourne,1408,warlock,destruction,27,17,10
40938,Lôrdslug,bleeding-hollow,1408,warlock,destruction,24,15,9
40939,Blackguldan,illidan,1405,warlock,destruction,24,15,9
40940,Meatybolts,nagrand,1405,warlock,destruction,78,43,35
40941,Lightname,arthas,1404,warlock,destruction,24,17,7
40942,Raizël,ragnaros,1404,warlock,destruction,49,28,21
40943,Lockerdoo,aegwynn,1404,warlock,destruction,30,17,13
40944,Fatals,thrall,1404,warlock,destruction,30,15,15
40945,Bellanomikus,stormrage,1404,warlock,destruction,60,25,35
40946,Drudotzz,hyjal,1403,warlock,destruction,30,16,14
40947,Kecca,azralon,1402,warlock,destruction,96,52,44
40948,Adderall,altar-of-storms,1402,warlock,destruction,42,20,22
40949,Chuwhee,sargeras,1401,warlock,destruction,54,18,36
40950,Antistar,barthilas,1400,warlock,destruction,43,27,16
40951,Perples,dalaran,1399,warlock,destruction,60,30,30
40952,Shadow,frostwolf,1399,warlock,destruction,44,17,27
40953,Vindicated,azgalor,1397,warlock,destruction,31,22,9
40954,Momshutup,sargeras,1397,warlock,destruction,23,15,8
40955,Azöd,tichondrius,1397,warlock,destruction,93,57,36
40956,Év,azralon,1397,warlock,destruction,42,20,22
40957,Oldwing,illidan,1396,warlock,destruction,35,15,20
40958,Iongestpp,bleeding-hollow,1395,warlock,destruction,42,22,20
40959,Celash,barthilas,1394,warlock,destruction,42,20,22
40960,Barathron,tichondrius,1394,warlock,destruction,54,22,32
40961,Rotsndotss,thrall,1393,warlock,destruction,33,16,17
40962,Shadococo,tichondrius,1393,warlock,destruction,36,16,20
40963,Magiaoscurax,quelthalas,1392,warlock,destruction,66,34,32
40964,Ganknãmstyle,illidan,1391,warlock,destruction,60,30,30
40965,Adhauto,illidan,1390,warlock,destruction,113,62,51
40966,Bustednut,nerzhul,1388,warlock,destruction,92,53,39
40967,Tergale,illidan,1388,warlock,destruction,66,28,38
40968,Castngcouch,tichondrius,1387,warlock,destruction,45,25,20
40969,Nazzlock,lethon,1387,warlock,destruction,29,16,13
40970,Yanned,hakkar,1387,warlock,destruction,147,78,69
40971,Umdur,zuljin,1385,warlock,destruction,62,29,33
40972,Rangmar,ragnaros,1385,warlock,destruction,39,18,21
40973,Gorelami,tichondrius,1384,warlock,destruction,42,23,19
40974,Neodron,thrall,1380,warlock,destruction,69,45,24
40975,Necrotic,antonidas,1379,warlock,destruction,66,33,33
40976,Warlo,moonrunner,1378,warlock,destruction,30,20,10
40977,Coreleron,proudmoore,1378,warlock,destruction,61,29,32
40978,Siccwidit,area-52,1378,warlock,destruction,74,34,40
40979,Notchinese,kiljaeden,1377,warlock,destruction,41,19,22
40980,Aksness,stormrage,1377,warlock,destruction,42,18,24
40981,Blankdots,sargeras,1375,warlock,destruction,42,27,15
40982,Zénth,kiljaeden,1375,warlock,destruction,28,17,11
40983,Lockonthc,korgath,1375,warlock,destruction,32,16,16
40984,Wasrenai,tichondrius,1375,warlock,destruction,47,21,26
40985,Connect,borean-tundra,1371,warlock,destruction,35,18,17
40986,Dessoft,ragnaros,1371,warlock,destruction,36,17,19
40987,Foxfoxfel,thrall,1369,warlock,destruction,24,16,8
40988,Warlockgomes,azralon,1368,warlock,destruction,145,69,76
40989,Condevil,quelthalas,1367,warlock,destruction,83,47,36
40990,Notäçultist,nagrand,1367,warlock,destruction,45,25,20
40991,Verdoso,stormrage,1367,warlock,destruction,60,33,27
40992,Gukky,misha,1366,warlock,destruction,101,62,39
40993,Diabhlaí,tichondrius,1365,warlock,destruction,90,51,39
40994,Getpissed,emerald-dream,1365,warlock,destruction,65,32,33
40995,Critneyfearz,stormscale,1365,warlock,destruction,53,25,28
40996,Blindingsun,kiljaeden,1365,warlock,destruction,72,27,45
40997,Avae,frostmourne,1363,warlock,destruction,96,51,45
40998,Luxenna,malganis,1363,warlock,destruction,84,40,44
40999,Esteedees,moon-guard,1361,warlock,destruction,42,16,26
41000,Wackykid,azralon,1360,warlock,destruction,86,39,47
41001,Lockssy,tichondrius,1359,warlock,destruction,101,58,43
41002,Freggen,shadowsong,1358,warlock,destruction,24,15,9
41003,Lafuke,tichondrius,1358,warlock,destruction,25,15,10
41004,Locksyy,tichondrius,1357,warlock,destruction,59,24,35
41005,Matdamon,barthilas,1354,warlock,destruction,60,33,27
41006,Nezsarek,sargeras,1352,warlock,destruction,169,73,96
41007,Ørfna,zuljin,1351,warlock,destruction,66,33,33
41008,Sauronne,illidan,1351,warlock,destruction,36,15,21
41009,Jhop,sargeras,1349,warlock,destruction,72,40,32
41010,Karadelice,stormrage,1349,warlock,destruction,54,29,25
41011,Mèrlin,aerie-peak,1346,warlock,destruction,24,17,7
41012,Razizzles,malganis,1345,warlock,destruction,72,42,30
41013,Stallrooks,moon-guard,1345,warlock,destruction,29,16,13
41014,Zinkro,quelthalas,1345,warlock,destruction,59,22,37
41015,Retwarr,tichondrius,1344,warlock,destruction,18,14,4
41016,Odjure,zuljin,1344,warlock,destruction,23,14,9
41017,Soulruler,tichondrius,1344,warlock,destruction,24,14,10
41018,Spreadnhiv,thrall,1344,warlock,destruction,42,18,24
41019,Drwongmd,sargeras,1343,warlock,destruction,18,14,4
41020,Súpersonic,tichondrius,1343,warlock,destruction,24,14,10
41021,Kryl,kiljaeden,1343,warlock,destruction,24,14,10
41022,Sktfäker,sargeras,1343,warlock,destruction,24,14,10
41023,Naiyuan,tichondrius,1343,warlock,destruction,30,14,16
41024,Austen,tichondrius,1343,warlock,destruction,55,24,31
41025,Dobbythelock,zuljin,1340,warlock,destruction,24,14,10
41026,Bobbygoulant,tichondrius,1340,warlock,destruction,259,128,131
41027,Lladyyheartt,nesingwary,1339,warlock,destruction,54,28,26
41028,Sunkuna,aerie-peak,1339,warlock,destruction,96,48,48
41029,Aemma,proudmoore,1338,warlock,destruction,18,14,4
41030,Extinção,azralon,1338,warlock,destruction,64,39,25
41031,Pantypeeler,barthilas,1338,warlock,destruction,60,35,25
41032,Knockknock,llane,1338,warlock,destruction,24,14,10
41033,Sofan,dalaran,1338,warlock,destruction,24,14,10
41034,Scãryz,jubeithos,1338,warlock,destruction,50,29,21
41035,Veerdz,area-52,1338,warlock,destruction,30,14,16
41036,Éx,jubeithos,1337,warlock,destruction,18,14,4
41037,Xlilgee,kelthuzad,1337,warlock,destruction,18,14,4
41038,Jackscar,windrunner,1337,warlock,destruction,23,16,7
41039,Punishment,jubeithos,1337,warlock,destruction,23,15,8
41040,Nattydots,sargeras,1337,warlock,destruction,59,28,31
41041,Gingerspise,nathrezim,1337,warlock,destruction,30,14,16
41042,Sugmabone,zuluhed,1336,warlock,destruction,24,17,7
41043,Shipmatelock,stormrage,1336,warlock,destruction,24,17,7
41044,Nazgal,tichondrius,1336,warlock,destruction,27,16,11
41045,Memon,frostmane,1336,warlock,destruction,36,19,17
41046,Fearsntears,stormrage,1336,warlock,destruction,36,14,22
41047,Yarrz,kelthuzad,1335,warlock,destruction,24,16,8
41048,Powertrîp,sargeras,1335,warlock,destruction,24,14,10
41049,Theredwoman,emerald-dream,1335,warlock,destruction,30,14,16
41050,Ozgwad,thunderhorn,1334,warlock,destruction,36,18,18
41051,Lòthloria,mannoroth,1334,warlock,destruction,149,74,75
41052,Majinbuû,malganis,1334,warlock,destruction,30,14,16
41053,Wadoom,tichondrius,1332,warlock,destruction,54,27,27
41054,Spongebobjrj,tichondrius,1331,warlock,destruction,36,20,16
41055,Aomniloltv,zuljin,1331,warlock,destruction,47,24,23
41056,Lefteexd,tichondrius,1330,warlock,destruction,24,14,10
41057,Grandpapapa,tichondrius,1330,warlock,destruction,54,22,32
41058,Darksolace,dalaran,1329,warlock,destruction,24,14,10
41059,Laklin,stormscale,1329,warlock,destruction,110,51,59
41060,Freestyle,blackwater-raiders,1328,warlock,destruction,54,34,20
41061,Gingerlocky,barthilas,1328,warlock,destruction,106,50,56
41062,Celeden,emerald-dream,1327,warlock,destruction,30,18,12
41063,Cursedoll,ragnaros,1327,warlock,destruction,36,15,21
41064,Salties,magtheridon,1326,warlock,destruction,24,14,10
41065,Felpsychosis,illidan,1323,warlock,destruction,93,49,44
41066,Drcameron,zuljin,1322,warlock,destruction,24,15,9
41067,Lockednloade,tichondrius,1322,warlock,destruction,57,33,24
41068,Zephee,queldorei,1322,warlock,destruction,54,31,23
41069,Gòtti,frostmourne,1320,warlock,destruction,24,14,10
41070,Jugerdotz,sargeras,1320,warlock,destruction,30,14,16
41071,Addonic,hyjal,1318,warlock,destruction,24,14,10
41072,Dialalock,frostmourne,1318,warlock,destruction,24,14,10
41073,Jeramie,darkspear,1317,warlock,destruction,38,17,21
41074,Undies,demon-soul,1314,warlock,destruction,72,39,33
41075,Plagueîs,area-52,1313,warlock,destruction,27,15,12
41076,Jecklez,tichondrius,1312,warlock,destruction,135,70,65
41077,Shedara,ragnaros,1311,warlock,destruction,23,14,9
41078,Kabroom,boulderfist,1311,warlock,destruction,24,14,10
41079,Dotyoazz,tichondrius,1308,warlock,destruction,38,22,16
41080,Rustý,illidan,1307,warlock,destruction,47,30,17
41081,Dotsfired,crushridge,1307,warlock,destruction,24,15,9
41082,Muchoprecogo,tichondrius,1306,warlock,destruction,24,14,10
41083,Sû,stormrage,1306,warlock,destruction,72,31,41
41084,Downbad,ysera,1305,warlock,destruction,37,16,21
41085,Heathncraig,illidan,1305,warlock,destruction,50,20,30
41086,Imprecátion,tichondrius,1304,warlock,destruction,53,19,34
41087,Gscar,area-52,1303,warlock,destruction,48,28,20
41088,Felqueenn,windrunner,1301,warlock,destruction,30,19,11
41089,Voidchaos,korgath,1300,warlock,destruction,18,14,4
41090,Tsmcfker,tichondrius,1298,warlock,destruction,24,14,10
41091,Sylestrio,feathermoon,1297,warlock,destruction,48,22,26
41092,Striga,staghelm,1297,warlock,destruction,51,20,31
41093,Covenslave,nemesis,1295,warlock,destruction,264,130,134
41094,Boltybarnes,area-52,1292,warlock,destruction,24,16,8
41095,Rauwërrs,azralon,1292,warlock,destruction,55,26,29
41096,Kombat,amanthul,1292,warlock,destruction,71,32,39
41097,Bigdoinks,nagrand,1290,warlock,destruction,34,19,15
41098,Killafornia,runetotem,1288,warlock,destruction,30,16,14
41099,Stinkychef,hyjal,1287,warlock,destruction,18,14,4
41100,Lolimalock,bleeding-hollow,1286,warlock,destruction,35,19,16
41101,Ganosh,aggramar,1285,warlock,destruction,110,59,51
41102,Identiti,tichondrius,1285,warlock,destruction,27,14,13
41103,Haxlock,azralon,1282,warlock,destruction,34,15,19
41104,Awfeelya,sargeras,1281,warlock,destruction,29,17,12
41105,Zuldar,tichondrius,1281,warlock,destruction,36,21,15
41106,Mickylock,tichondrius,1281,warlock,destruction,108,58,50
41107,Dealcloud,tichondrius,1281,warlock,destruction,62,30,32
41108,Zoluraan,proudmoore,1280,warlock,destruction,51,33,18
41109,Hurriicane,stormrage,1280,warlock,destruction,92,48,44
41110,Buildsuccess,tichondrius,1278,warlock,destruction,35,14,21
41111,Ppoonlock,tichondrius,1277,warlock,destruction,28,14,14
41112,Lilibe,tichondrius,1276,warlock,destruction,54,23,31
41113,Ahrimus,area-52,1275,warlock,destruction,28,14,14
41114,Aboode,blackrock,1274,warlock,destruction,47,23,24
41115,Potatostew,dalaran,1273,warlock,destruction,36,14,22
41116,Boltster,destromath,1271,warlock,destruction,30,18,12
41117,Telvanni,sargeras,1270,warlock,destruction,43,24,19
41118,Derfflinger,tichondrius,1270,warlock,destruction,118,49,69
41119,Felryssa,kiljaeden,1269,warlock,destruction,60,29,31
41120,Fearndot,draenor,1268,warlock,destruction,45,21,24
41121,Prinzheinric,quelthalas,1267,warlock,destruction,33,21,12
41122,Gwar,khazgoroth,1267,warlock,destruction,169,79,90
41123,Kyle,shandris,1267,warlock,destruction,45,21,24
41124,Theporkchunk,nordrassil,1265,warlock,destruction,52,35,17
41125,Griget,runetotem,1265,warlock,destruction,59,28,31
41126,Ehcsrop,doomhammer,1263,warlock,destruction,86,42,44
41127,Gattsonn,kiljaeden,1259,warlock,destruction,42,15,27
41128,Honne,sargeras,1258,warlock,destruction,26,14,12
41129,Deseo,moon-guard,1257,warlock,destruction,18,14,4
41130,Thizzmaa,area-52,1255,warlock,destruction,89,44,45
41131,Mordekhay,tichondrius,1255,warlock,destruction,62,30,32
41132,Felancholy,illidan,1254,warlock,destruction,32,22,10
41133,Wizlox,illidan,1254,warlock,destruction,119,49,70
41134,Ticktóck,ghostlands,1253,warlock,destruction,19,14,5
41135,Kortinanga,tichondrius,1252,warlock,destruction,54,30,24
41136,Eurygnomous,thrall,1252,warlock,destruction,30,14,16
41137,Exupery,emerald-dream,1250,warlock,destruction,31,15,16
41138,Xtwistedteas,tichondrius,1249,warlock,destruction,31,14,17
41139,Beastsuper,tichondrius,1248,warlock,destruction,24,13,11
41140,Pressurë,tichondrius,1247,warlock,destruction,18,13,5
41141,Voqo,shandris,1247,warlock,destruction,18,13,5
41142,Enkryption,dalaran,1247,warlock,destruction,18,13,5
41143,Drakedog,ragnaros,1247,warlock,destruction,18,13,5
41144,Cyrus,akama,1247,warlock,destruction,24,16,8
41145,Kimsoul,zuljin,1247,warlock,destruction,24,13,11
41146,Rèdrùm,tichondrius,1247,warlock,destruction,24,13,11
41147,Oymmander,illidan,1247,warlock,destruction,24,13,11
41148,Grenswood,arathor,1247,warlock,destruction,27,14,13
41149,Medusaqn,tichondrius,1246,warlock,destruction,18,13,5
41150,Lotussama,anetheron,1246,warlock,destruction,18,13,5
41151,Inaane,thrall,1246,warlock,destruction,24,13,11
41152,Skanckqt,malganis,1246,warlock,destruction,24,13,11
41153,Hauntsin,hyjal,1246,warlock,destruction,30,13,17
41154,Duckboji,tichondrius,1245,warlock,destruction,24,13,11
41155,Sladez,tichondrius,1245,warlock,destruction,36,13,23
41156,Toastwl,tichondrius,1244,warlock,destruction,18,13,5
41157,Riptyler,illidan,1244,warlock,destruction,24,13,11
41158,Mailerdaemön,proudmoore,1244,warlock,destruction,24,13,11
41159,Wampeter,azshara,1243,warlock,destruction,30,13,17
41160,Nigsy,nagrand,1242,warlock,destruction,24,13,11
41161,Spòngwò,tichondrius,1242,warlock,destruction,24,13,11
41162,Tirzah,frostmourne,1241,warlock,destruction,18,13,5
41163,Mothmayhem,moon-guard,1241,warlock,destruction,24,13,11
41164,Soulwipe,dethecus,1241,warlock,destruction,24,13,11
41165,Shadü,tichondrius,1241,warlock,destruction,36,14,22
41166,Ruknài,barthilas,1240,warlock,destruction,24,13,11
41167,Jnzi,area-52,1239,warlock,destruction,18,13,5
41168,Ciprýan,azralon,1238,warlock,destruction,24,13,11
41169,Pruevolf,tichondrius,1236,warlock,destruction,80,35,45
41170,Reppedlock,illidan,1234,warlock,destruction,24,13,11
41171,Rainymood,frostmourne,1233,warlock,destruction,18,13,5
41172,Munick,spirestone,1233,warlock,destruction,24,13,11
41173,Blastyboat,terenas,1233,warlock,destruction,39,15,24
41174,Dalruk,wyrmrest-accord,1232,warlock,destruction,18,13,5
41175,Klatuu,stonemaul,1232,warlock,destruction,24,15,9
41176,Chaotíc,zuljin,1231,warlock,destruction,24,13,11
41177,Jelluz,ghostlands,1230,warlock,destruction,33,16,17
41178,Wåbi,tichondrius,1228,warlock,destruction,30,13,17
41179,Impieties,emerald-dream,1228,warlock,destruction,36,14,22
41180,Ellneggro,zuljin,1226,warlock,destruction,18,13,5
41181,Rickyspanish,malygos,1226,warlock,destruction,30,13,17
41182,Kyrionn,azralon,1225,warlock,destruction,24,13,11
41183,Dirtybóy,tichondrius,1224,warlock,destruction,24,13,11
41184,Finnickk,blackrock,1221,warlock,destruction,30,13,17
41185,Darkboltz,area-52,1218,warlock,destruction,18,13,5
41186,Enaria,queldorei,1218,warlock,destruction,24,13,11
41187,Sepültüra,quelthalas,1218,warlock,destruction,36,13,23
41188,Iiferna,sargeras,1217,warlock,destruction,149,70,79
41189,Cursedtool,quelthalas,1216,warlock,destruction,21,14,7
41190,Schmok,terenas,1216,warlock,destruction,64,33,31
41191,Blockk,moknathal,1216,warlock,destruction,62,26,36
41192,Hawkstalker,thaurissan,1215,warlock,destruction,76,39,37
41193,Zydaria,stormrage,1213,warlock,destruction,30,18,12
41194,Erevas,area-52,1213,warlock,destruction,24,14,10
41195,Prototyp,azralon,1212,warlock,destruction,18,13,5
41196,Atrabiliario,quelthalas,1210,warlock,destruction,36,13,23
41197,Repláced,thrall,1207,warlock,destruction,45,19,26
41198,Felinå,hyjal,1206,warlock,destruction,39,24,15
41199,Superbroly,area-52,1204,warlock,destruction,30,16,14
41200,Daeykras,crushridge,1203,warlock,destruction,45,25,20
41201,Patagucci,bleeding-hollow,1203,warlock,destruction,24,13,11
41202,Luulloo,proudmoore,1203,warlock,destruction,60,32,28
41203,Gouldon,sargeras,1202,warlock,destruction,40,20,20
41204,Blew,bleeding-hollow,1200,warlock,destruction,15,14,1
41205,Wodwarlock,thrall,1199,warlock,destruction,15,14,1
41206,Tm,dalaran,1196,warlock,destruction,23,15,8
41207,Jannus,wyrmrest-accord,1196,warlock,destruction,32,15,17
41208,Boltsfordays,dalaran,1195,warlock,destruction,80,40,40
41209,Zaeloc,ragnaros,1195,warlock,destruction,42,13,29
41210,Goldieloc,sargeras,1192,warlock,destruction,42,26,16
41211,Spookyfurry,area-52,1192,warlock,destruction,30,13,17
41212,Bénn,moon-guard,1189,warlock,destruction,60,39,21
41213,Cørruption,emerald-dream,1188,warlock,destruction,47,22,25
41214,Pancakestack,stormrage,1187,warlock,destruction,73,38,35
41215,Kemchaos,illidan,1187,warlock,destruction,82,38,44
41216,Mocreia,azralon,1186,warlock,destruction,113,53,60
41217,Kärên,proudmoore,1185,warlock,destruction,22,16,6
41218,Sutra,tichondrius,1185,warlock,destruction,23,14,9
41219,Sñeed,sargeras,1184,warlock,destruction,35,17,18
41220,Chodetamer,lethon,1180,warlock,destruction,29,18,11
41221,Necrodeath,malygos,1180,warlock,destruction,30,15,15
41222,Maldíta,quelthalas,1180,warlock,destruction,117,52,65
41223,Rodimus,hyjal,1179,warlock,destruction,129,72,57
41224,Kidsoul,illidan,1178,warlock,destruction,97,46,51
41225,Nanodingo,tichondrius,1176,warlock,destruction,59,30,29
41226,Nhen,daggerspine,1169,warlock,destruction,119,65,54
41227,Ilovedemons,aegwynn,1168,warlock,destruction,42,26,16
41228,Bawldimort,stormrage,1165,warlock,destruction,89,46,43
41229,Aerozyn,wyrmrest-accord,1161,warlock,destruction,30,16,14
41230,Dudda,sargeras,1152,warlock,destruction,12,12,0
41231,Osmatz,area-52,1152,warlock,destruction,18,12,6
41232,Livinpink,zuljin,1152,warlock,destruction,18,12,6
41233,Sphoo,tichondrius,1152,warlock,destruction,18,12,6
41234,Phreekish,bleeding-hollow,1152,warlock,destruction,18,12,6
41235,Blodrain,tichondrius,1152,warlock,destruction,18,12,6
41236,Koei,tichondrius,1152,warlock,destruction,24,12,12
41237,Shutupthug,illidan,1151,warlock,destruction,18,12,6
41238,Blastamastah,tichondrius,1151,warlock,destruction,18,12,6
41239,Oceangrownx,emerald-dream,1151,warlock,destruction,24,12,12
41240,Shadowmoonon,tichondrius,1151,warlock,destruction,24,12,12
41241,Pugnatwo,kelthuzad,1151,warlock,destruction,24,12,12
41242,Keniiwood,quelthalas,1151,warlock,destruction,24,12,12
41243,Lockdotsftw,illidan,1151,warlock,destruction,24,12,12
41244,Flûké,tichondrius,1151,warlock,destruction,24,12,12
41245,Asmit,firetree,1151,warlock,destruction,28,13,15
41246,Zaiocian,tichondrius,1151,warlock,destruction,26,12,14
41247,Dralok,area-52,1150,warlock,destruction,18,12,6
41248,Mattypatty,the-forgotten-coast,1150,warlock,destruction,18,12,6
41249,Dëception,ragnaros,1150,warlock,destruction,18,12,6
41250,Ggooudan,tichondrius,1150,warlock,destruction,18,12,6
41251,Ñigorshedøn,area-52,1150,warlock,destruction,18,12,6
41252,Canobio,tichondrius,1150,warlock,destruction,24,12,12
41253,Soulripped,area-52,1150,warlock,destruction,24,12,12
41254,Iggyiggy,sargeras,1149,warlock,destruction,24,12,12
41255,Ole,area-52,1149,warlock,destruction,27,13,14
41256,Beldiinlock,khazgoroth,1149,warlock,destruction,75,36,39
41257,Poock,goldrinn,1148,warlock,destruction,18,12,6
41258,Kylaria,emerald-dream,1148,warlock,destruction,24,12,12
41259,Omarlil,kelthuzad,1147,warlock,destruction,18,12,6
41260,Nadirius,shadowmoon,1146,warlock,destruction,18,12,6
41261,Soulicit,kelthuzad,1146,warlock,destruction,24,12,12
41262,Superbvious,lothar,1145,warlock,destruction,83,40,43
41263,Soulsurvivor,tichondrius,1144,warlock,destruction,30,12,18
41264,Xiáoyan,tichondrius,1143,warlock,destruction,18,12,6
41265,Gambel,duskwood,1143,warlock,destruction,30,13,17
41266,Handler,earthen-ring,1142,warlock,destruction,42,28,14
41267,Escro,azgalor,1142,warlock,destruction,80,47,33
41268,Gridwild,drakkari,1142,warlock,destruction,24,12,12
41269,Løvesick,zuljin,1141,warlock,destruction,30,12,18
41270,Nadek,tichondrius,1140,warlock,destruction,24,12,12
41271,Bmó,stormrage,1139,warlock,destruction,18,12,6
41272,Lessance,dalaran,1138,warlock,destruction,24,12,12
41273,Taylôr,proudmoore,1136,warlock,destruction,30,12,18
41274,Nozyroh,emerald-dream,1134,warlock,destruction,23,12,11
41275,Lagcursed,frostmourne,1133,warlock,destruction,18,12,6
41276,Skullsoul,arthas,1132,warlock,destruction,24,12,12
41277,Cælohin,tichondrius,1132,warlock,destruction,24,12,12
41278,Mordror,azralon,1132,warlock,destruction,29,14,15
41279,Dlchem,tichondrius,1126,warlock,destruction,18,12,6
41280,Batär,area-52,1126,warlock,destruction,18,12,6
41281,Rageraff,trollbane,1121,warlock,destruction,30,18,12
41282,Dotdoctor,thrall,1120,warlock,destruction,27,12,15
41283,Nocchi,amanthul,1119,warlock,destruction,22,12,10
41284,Kracky,tichondrius,1115,warlock,destruction,162,87,75
41285,Josemb,ragnaros,1114,warlock,destruction,26,14,12
41286,Ðeãdman,bleeding-hollow,1112,warlock,destruction,20,13,7
41287,Marvolö,darkspear,1112,warlock,destruction,24,15,9
41288,Mshyde,gurubashi,1106,warlock,destruction,24,14,10
41289,Dex,jubeithos,1105,warlock,destruction,107,37,70
41290,Juniorsalanu,quelthalas,1104,warlock,destruction,36,19,17
41291,Anstik,area-52,1103,warlock,destruction,15,13,2
41292,Tempestzone,barthilas,1096,warlock,destruction,29,16,13
41293,Darthlockz,illidan,1095,warlock,destruction,24,13,11
41294,Madgettike,stormrage,1094,warlock,destruction,36,22,14
41295,Varuuss,ragnaros,1092,warlock,destruction,21,12,9
41296,Mindfulchimp,sargeras,1092,warlock,destruction,23,12,11
41297,Cheiff,tichondrius,1092,warlock,destruction,42,16,26
41298,Timmerstar,tichondrius,1091,warlock,destruction,48,22,26
41299,Taìnted,lightbringer,1088,warlock,destruction,28,12,16
41300,Medeia,tichondrius,1087,warlock,destruction,23,12,11
41301,Skynflute,tichondrius,1087,warlock,destruction,28,12,16
41302,Necrotiá,tichondrius,1085,warlock,destruction,17,12,5
41303,Vafa,kelthuzad,1084,warlock,destruction,20,12,8
41304,Spicý,sargeras,1084,warlock,destruction,63,31,32
41305,Abracadavers,ragnaros,1081,warlock,destruction,23,12,11
41306,Idrannell,illidan,1077,warlock,destruction,26,12,14
41307,Valval,moon-guard,1074,warlock,destruction,72,22,50
41308,Wolfib,tichondrius,1072,warlock,destruction,19,12,7
41309,Phreaky,area-52,1072,warlock,destruction,36,17,19
41310,Nøvah,tichondrius,1070,warlock,destruction,19,12,7
41311,Toby,azralon,1066,warlock,destruction,25,12,13
41312,Davnport,frostmourne,1065,warlock,destruction,38,12,26
41313,Luke,lightnings-blade,1062,warlock,destruction,18,12,6
41314,Krýstál,ragnaros,1057,warlock,destruction,25,13,12
41315,Caesaros,quelthalas,1057,warlock,destruction,25,12,13
41316,Bumbleebolts,azralon,1056,warlock,destruction,12,11,1
41317,Xidothewitch,stormrage,1056,warlock,destruction,18,11,7
41318,Lockâsf,tichondrius,1056,warlock,destruction,18,11,7
41319,Søulswap,tichondrius,1056,warlock,destruction,18,11,7
41320,Urukaix,sargeras,1056,warlock,destruction,18,11,7
41321,Drböb,area-52,1056,warlock,destruction,18,11,7
41322,Ghettobeluga,area-52,1056,warlock,destruction,18,11,7
41323,Thragèqt,sargeras,1056,warlock,destruction,18,11,7
41324,Drsmegmaz,dreadmaul,1056,warlock,destruction,24,11,13
41325,Tacticalderp,bleeding-hollow,1056,warlock,destruction,24,11,13
41326,Finalboss,tichondrius,1055,warlock,destruction,12,11,1
41327,Edeklock,frostmourne,1055,warlock,destruction,12,11,1
41328,Dreadxbolts,stormrage,1055,warlock,destruction,18,11,7
41329,Feardotzrun,illidan,1055,warlock,destruction,18,11,7
41330,Mindheist,stormrage,1055,warlock,destruction,18,11,7
41331,Tuzadin,tichondrius,1055,warlock,destruction,18,11,7
41332,Sahdude,illidan,1055,warlock,destruction,18,11,7
41333,Fabiusbilex,tichondrius,1055,warlock,destruction,18,11,7
41334,Alktrz,azralon,1055,warlock,destruction,18,11,7
41335,Ðòt,nagrand,1055,warlock,destruction,18,11,7
41336,Guldansbicep,illidan,1055,warlock,destruction,22,12,10
41337,Itstista,proudmoore,1055,warlock,destruction,24,11,13
41338,Aureboros,sargeras,1054,warlock,destruction,18,11,7
41339,Vasqu,stormrage,1054,warlock,destruction,18,11,7
41340,Dunkindots,dalaran,1054,warlock,destruction,18,11,7
41341,Friggus,azralon,1054,warlock,destruction,18,11,7
41342,Locksolo,tichondrius,1054,warlock,destruction,18,11,7
41343,Vigius,dalaran,1054,warlock,destruction,24,11,13
41344,Spudzies,bleeding-hollow,1054,warlock,destruction,24,11,13
41345,Dipz,zuljin,1053,warlock,destruction,18,11,7
41346,Faënn,zuljin,1053,warlock,destruction,18,11,7
41347,Buffwarlockz,stormrage,1053,warlock,destruction,18,11,7
41348,Nightshan,draenor,1053,warlock,destruction,24,11,13
41349,Ranil,mannoroth,1052,warlock,destruction,18,11,7
41350,Azrezzael,area-52,1052,warlock,destruction,18,11,7
41351,Trastham,malganis,1052,warlock,destruction,24,11,13
41352,Blanklee,tichondrius,1051,warlock,destruction,12,11,1
41353,Domenic,sentinels,1051,warlock,destruction,16,12,4
41354,Doobielock,kelthuzad,1051,warlock,destruction,18,11,7
41355,Mateekabr,malganis,1051,warlock,destruction,18,11,7
41356,Teahourse,tichondrius,1051,warlock,destruction,24,11,13
41357,Microd,tichondrius,1050,warlock,destruction,18,11,7
41358,Sathorastus,spirestone,1050,warlock,destruction,24,11,13
41359,Unprønuncea,azralon,1050,warlock,destruction,25,11,14
41360,Tirp,illidan,1048,warlock,destruction,24,11,13
41361,Pokemebutt,hydraxis,1046,warlock,destruction,18,11,7
41362,Mysophobia,frostmourne,1046,warlock,destruction,101,47,54
41363,Altazor,thunderlord,1046,warlock,destruction,30,11,19
41364,Ltr,moon-guard,1045,warlock,destruction,18,11,7
41365,Haloren,moon-guard,1044,warlock,destruction,18,11,7
41366,Xenagos,antonidas,1043,warlock,destruction,30,11,19
41367,Seeword,sargeras,1039,warlock,destruction,18,11,7
41368,Ktlock,frostmourne,1032,warlock,destruction,24,11,13
41369,Baiss,tichondrius,1030,warlock,destruction,18,11,7
41370,Lowkei,stonemaul,1030,warlock,destruction,30,11,19
41371,Danoinfelizz,nemesis,1029,warlock,destruction,15,12,3
41372,Noriaeradra,illidan,1025,warlock,destruction,24,13,11
41373,Basicwitch,malganis,1023,warlock,destruction,17,11,6
41374,Daddybolt,blackrock,1023,warlock,destruction,23,11,12
41375,Getsmoked,moknathal,1023,warlock,destruction,23,11,12
41376,Locksoul,area-52,1019,warlock,destruction,54,25,29
41377,Cascades,icecrown,1019,warlock,destruction,96,38,58
41378,Nathalyâ,drakkari,1018,warlock,destruction,60,28,32
41379,Bobthedoc,sargeras,1011,warlock,destruction,23,11,12
41380,Kklock,frostmourne,1007,warlock,destruction,45,26,19
41381,Faliceu,sargeras,1006,warlock,destruction,26,11,15
41382,Plagué,barthilas,1004,warlock,destruction,21,11,10
41383,Panyc,tichondrius,1002,warlock,destruction,23,11,12
41384,Ticklebolts,tichondrius,1001,warlock,destruction,34,12,22
41385,Saraphina,maiev,1000,warlock,destruction,236,111,125
41386,Valerilma,azralon,998,warlock,destruction,23,11,12
41387,Rnicu,bonechewer,995,warlock,destruction,81,39,42
41388,Wingzerø,tichondrius,988,warlock,destruction,23,11,12
41389,Nevermorde,area-52,986,warlock,destruction,23,11,12
41390,Wìckedelf,area-52,986,warlock,destruction,81,38,43
41391,Mystikcloak,lightbringer,980,warlock,destruction,19,13,6
41392,Hanoaa,tichondrius,975,warlock,destruction,11,11,0
41393,Zíppen,proudmoore,970,warlock,destruction,61,30,31
41394,Plagueis,zuluhed,969,warlock,destruction,25,11,14
41395,Kimis,azralon,963,warlock,destruction,24,14,10
41396,Lockbtw,altar-of-storms,960,warlock,destruction,12,10,2
41397,Nino,barthilas,960,warlock,destruction,12,10,2
41398,Letmecastpls,tichondrius,960,warlock,destruction,12,10,2
41399,Jaboy,dragonmaw,960,warlock,destruction,12,10,2
41400,Bodhisage,kelthuzad,960,warlock,destruction,12,10,2
41401,Wanglock,blackrock,960,warlock,destruction,12,10,2
41402,Fxckyuo,tichondrius,960,warlock,destruction,12,10,2
41403,Mesw,tichondrius,960,warlock,destruction,12,10,2
41404,Kammuany,sargeras,960,warlock,destruction,12,10,2
41405,Lilshedon,kelthuzad,960,warlock,destruction,12,10,2
41406,Renatis,malganis,960,warlock,destruction,15,11,4
41407,Klol,proudmoore,960,warlock,destruction,18,10,8
41408,Baka,moon-guard,960,warlock,destruction,18,10,8
41409,Spicyfingerx,illidan,960,warlock,destruction,18,10,8
41410,Yuvirayz,illidan,960,warlock,destruction,18,10,8
41411,Busterbob,tichondrius,960,warlock,destruction,18,10,8
41412,Dimanel,moon-guard,960,warlock,destruction,18,10,8
41413,Teefgap,sargeras,960,warlock,destruction,18,10,8
41414,Veryezgame,tichondrius,960,warlock,destruction,18,10,8
41415,Areufearious,sargeras,960,warlock,destruction,18,10,8
41416,Contägion,bleeding-hollow,960,warlock,destruction,24,10,14
41417,Dampenedx,bleeding-hollow,960,warlock,destruction,28,11,17
41418,Mixolydian,malganis,959,warlock,destruction,12,10,2
41419,Dkdakìng,dalaran,959,warlock,destruction,12,10,2
41420,Percaddict,illidan,959,warlock,destruction,12,10,2
41421,Foxar,stormrage,959,warlock,destruction,12,10,2
41422,Gregfearnrun,area-52,959,warlock,destruction,16,11,5
41423,Maral,kelthuzad,959,warlock,destruction,18,10,8
41424,Sixonenine,boulderfist,959,warlock,destruction,18,10,8
41425,Years,moon-guard,959,warlock,destruction,18,10,8
41426,Thânàtös,malganis,959,warlock,destruction,18,10,8
41427,Juiçédaddy,aggramar,959,warlock,destruction,18,10,8
41428,Notatryhard,emerald-dream,959,warlock,destruction,18,10,8
41429,Pykorrg,ragnaros,959,warlock,destruction,24,10,14
41430,Helraz,darkspear,958,warlock,destruction,12,10,2
41431,Delarae,frostmourne,958,warlock,destruction,12,10,2
41432,Trobgol,bleeding-hollow,958,warlock,destruction,12,10,2
41433,Mørgoth,thrall,958,warlock,destruction,18,10,8
41434,Wondon,tichondrius,958,warlock,destruction,18,10,8
41435,Yibbel,area-52,958,warlock,destruction,18,10,8
41436,Iockgodtkoz,tichondrius,958,warlock,destruction,18,10,8
41437,Chrishasnen,moon-guard,958,warlock,destruction,24,10,14
41438,Newty,zuljin,957,warlock,destruction,12,10,2
41439,Kbolt,barthilas,957,warlock,destruction,18,10,8
41440,Xerozus,tichondrius,957,warlock,destruction,18,10,8
41441,Diabolous,malganis,957,warlock,destruction,18,10,8
41442,Kåos,kelthuzad,957,warlock,destruction,18,10,8
41443,Dercrow,quelthalas,957,warlock,destruction,18,10,8
41444,Greasymario,area-52,957,warlock,destruction,22,11,11
41445,Tromeo,sargeras,957,warlock,destruction,24,10,14
41446,Ragnalock,laughing-skull,956,warlock,destruction,18,10,8
41447,Dårkfyre,kiljaeden,956,warlock,destruction,18,10,8
41448,Manã,wyrmrest-accord,956,warlock,destruction,18,10,8
41449,Kkokko,tichondrius,956,warlock,destruction,18,10,8
41450,Graced,dalaran,956,warlock,destruction,18,10,8
41451,Forsâken,tichondrius,956,warlock,destruction,22,11,11
41452,Raidspot,bleeding-hollow,956,warlock,destruction,24,10,14
41453,Zaintv,illidan,955,warlock,destruction,18,10,8
41454,Chaoticstorm,area-52,955,warlock,destruction,18,10,8
41455,Hellslayer,frostmourne,955,warlock,destruction,24,10,14
41456,Balfast,quelthalas,955,warlock,destruction,30,10,20
41457,Dvorakk,frostmourne,954,warlock,destruction,15,11,4
41458,Crashcrash,area-52,954,warlock,destruction,24,10,14
41459,Harleyjames,ravenholdt,953,warlock,destruction,18,10,8
41460,Siliconsnipe,tichondrius,952,warlock,destruction,12,10,2
41461,Punjj,jubeithos,952,warlock,destruction,18,10,8
41462,Huuchie,moon-guard,951,warlock,destruction,18,10,8
41463,Puscifear,azralon,951,warlock,destruction,30,10,20
41464,Sojupain,kaelthas,950,warlock,destruction,12,10,2
41465,Moreedotss,malganis,947,warlock,destruction,30,10,20
41466,Hamadan,azralon,946,warlock,destruction,24,10,14
41467,Cursé,stormrage,944,warlock,destruction,18,10,8
41468,Øutbreak,thrall,943,warlock,destruction,17,10,7
41469,Nessro,stormrage,934,warlock,destruction,12,10,2
41470,Mogran,twisting-nether,934,warlock,destruction,18,10,8
41471,Imsupercool,bleeding-hollow,927,warlock,destruction,17,10,7
41472,Goal,malganis,927,warlock,destruction,20,11,9
41473,Astarõth,zuljin,926,warlock,destruction,26,11,15
41474,Twohandedkil,stormrage,920,warlock,destruction,26,11,15
41475,Keleiron,velen,916,warlock,destruction,18,10,8
41476,Xekk,wyrmrest-accord,910,warlock,destruction,23,10,13
41477,Wawfw,bleeding-hollow,909,warlock,destruction,15,11,4
41478,Lockyy,khaz-modan,904,warlock,destruction,26,11,15
41479,Fiennx,dalaran,894,warlock,destruction,17,10,7
41480,Katsby,moon-guard,894,warlock,destruction,17,10,7
41481,Rakudemon,ragnaros,894,warlock,destruction,20,10,10
41482,Marlett,destromath,890,warlock,destruction,113,58,55
41483,Savagetheron,korgath,887,warlock,destruction,18,10,8
41484,Pyria,boulderfist,877,warlock,destruction,13,10,3
41485,Nikôlas,stormrage,871,warlock,destruction,66,26,40
41486,Bonita,garona,864,warlock,destruction,12,9,3
41487,Lokiy,ragnaros,864,warlock,destruction,12,9,3
41488,Whaad,tichondrius,864,warlock,destruction,12,9,3
41489,Fenriakshog,zuljin,864,warlock,destruction,12,9,3
41490,Matthewx,stormrage,864,warlock,destruction,12,9,3
41491,Liuh,tichondrius,864,warlock,destruction,12,9,3
41492,Baddummy,tichondrius,864,warlock,destruction,12,9,3
41493,Voidsoda,whisperwind,864,warlock,destruction,12,9,3
41494,Lysitheä,moon-guard,864,warlock,destruction,12,9,3
41495,Quickzmaster,blackrock,864,warlock,destruction,12,9,3
41496,Pengliyuaner,illidan,864,warlock,destruction,12,9,3
41497,Demoabuser,lightnings-blade,864,warlock,destruction,12,9,3
41498,Crnowarlock,area-52,864,warlock,destruction,12,9,3
41499,Drezx,frostmourne,864,warlock,destruction,12,9,3
41500,Raxxis,moon-guard,864,warlock,destruction,12,9,3
41501,Rice,lothar,864,warlock,destruction,12,9,3
41502,Shokran,frostmourne,864,warlock,destruction,12,9,3
41503,Moóndust,bleeding-hollow,864,warlock,destruction,12,9,3
41504,Frustration,darkspear,864,warlock,destruction,12,9,3
41505,Biggbolts,tichondrius,864,warlock,destruction,18,9,9
41506,Sonovabeech,winterhoof,864,warlock,destruction,18,9,9
41507,Reflexlock,malganis,864,warlock,destruction,18,9,9
41508,Stuffs,wyrmrest-accord,864,warlock,destruction,18,9,9
41509,Bigolehogger,area-52,864,warlock,destruction,18,9,9
41510,Rorvask,area-52,864,warlock,destruction,18,9,9
41511,Voidxo,tichondrius,864,warlock,destruction,18,9,9
41512,Miroir,illidan,864,warlock,destruction,18,9,9
41513,Woopie,malfurion,864,warlock,destruction,18,9,9
41514,Ahrimaan,illidan,863,warlock,destruction,12,9,3
41515,Shooff,area-52,863,warlock,destruction,12,9,3
41516,Hawklock,ragnaros,863,warlock,destruction,12,9,3
41517,Zycas,tichondrius,863,warlock,destruction,12,9,3
41518,Slicktrik,stormrage,863,warlock,destruction,12,9,3
41519,Pacopico,illidan,863,warlock,destruction,12,9,3
41520,Glergarby,stormscale,863,warlock,destruction,15,10,5
41521,Cyio,zuljin,863,warlock,destruction,18,9,9
41522,Rothmar,bleeding-hollow,863,warlock,destruction,18,9,9
41523,Minzyw,illidan,863,warlock,destruction,18,9,9
41524,Ðarkbat,ragnaros,863,warlock,destruction,18,9,9
41525,Nethron,the-venture-co,863,warlock,destruction,18,9,9
41526,Rhabdo,ravenholdt,863,warlock,destruction,18,9,9
41527,Kymamd,sargeras,863,warlock,destruction,18,9,9
41528,Dmox,darkspear,863,warlock,destruction,18,9,9
41529,Goarage,tichondrius,863,warlock,destruction,22,10,12
41530,Rokdas,area-52,863,warlock,destruction,24,9,15
41531,Pyresworn,wyrmrest-accord,862,warlock,destruction,12,9,3
41532,Namig,aerie-peak,862,warlock,destruction,12,9,3
41533,Locklockdead,earthen-ring,862,warlock,destruction,12,9,3
41534,Cvntpvntcans,kelthuzad,862,warlock,destruction,12,9,3
41535,Cogitoergo,stormrage,862,warlock,destruction,12,9,3
41536,Çhåos,destromath,862,warlock,destruction,12,9,3
41537,Artheás,azralon,862,warlock,destruction,18,9,9
41538,Sanzofunke,area-52,862,warlock,destruction,18,9,9
41539,Nmelock,malganis,862,warlock,destruction,18,9,9
41540,Youkeyoh,illidan,862,warlock,destruction,18,9,9
41541,Breaad,tichondrius,862,warlock,destruction,24,9,15
41542,Ravikk,dalaran,862,warlock,destruction,24,9,15
41543,Tanathoz,thrall,862,warlock,destruction,28,10,18
41544,Aveeda,malganis,861,warlock,destruction,12,9,3
41545,Methandmmkay,illidan,861,warlock,destruction,15,10,5
41546,Frdchickiana,tichondrius,861,warlock,destruction,18,9,9
41547,Funnelcakies,area-52,861,warlock,destruction,18,9,9
41548,Snapp,kelthuzad,861,warlock,destruction,24,9,15
41549,Raebolts,area-52,860,warlock,destruction,18,9,9
41550,Damdochael,bleeding-hollow,860,warlock,destruction,24,9,15
41551,Githany,hyjal,859,warlock,destruction,18,9,9
41552,Shivalx,tichondrius,859,warlock,destruction,18,9,9
41553,Gorskij,frostwolf,859,warlock,destruction,19,9,10
41554,Damerus,illidan,859,warlock,destruction,24,9,15
41555,Cynwise,arathor,858,warlock,destruction,18,9,9
41556,Lerooux,hyjal,857,warlock,destruction,18,9,9
41557,Sykosenpai,zuljin,856,warlock,destruction,12,9,3
41558,Hookslinger,barthilas,856,warlock,destruction,18,9,9
41559,Scentient,jubeithos,855,warlock,destruction,12,9,3
41560,Shadohz,lightnings-blade,855,warlock,destruction,12,9,3
41561,Buttkins,tichondrius,855,warlock,destruction,24,9,15
41562,Klummzy,tichondrius,850,warlock,destruction,18,9,9
41563,Sitra,ragnaros,850,warlock,destruction,18,9,9
41564,Vampir,hellscream,850,warlock,destruction,24,9,15
41565,Juan,borean-tundra,850,warlock,destruction,24,9,15
41566,Elyzier,gallywix,839,warlock,destruction,48,20,28
41567,Freakdoa,blades-edge,834,warlock,destruction,53,20,33
41568,Dazedl,stormrage,816,warlock,destruction,15,9,6
41569,Ovosound,tichondrius,815,warlock,destruction,11,9,2
41570,Chaospump,frostmourne,815,warlock,destruction,17,9,8
41571,Cheêsyx,tichondrius,815,warlock,destruction,17,9,8
41572,Metamòrph,malganis,810,warlock,destruction,16,10,6
41573,Biubius,tichondrius,799,warlock,destruction,11,9,2
41574,Taneverah,wyrmrest-accord,799,warlock,destruction,11,9,2
41575,Conboii,tichondrius,768,warlock,destruction,10,9,1
41576,Rebolting,tichondrius,768,warlock,destruction,12,8,4
41577,Shatteroidz,darkspear,768,warlock,destruction,12,8,4
41578,Falsaqt,area-52,768,warlock,destruction,12,8,4
41579,Kápz,darkspear,768,warlock,destruction,12,8,4
41580,Esolock,malganis,768,warlock,destruction,12,8,4
41581,Shinagae,tichondrius,768,warlock,destruction,12,8,4
41582,Harambê,sargeras,768,warlock,destruction,12,8,4
41583,Slackjaww,kiljaeden,768,warlock,destruction,12,8,4
41584,Searinox,scilla,768,warlock,destruction,12,8,4
41585,Flackory,tichondrius,768,warlock,destruction,12,8,4
41586,Dumbfknclass,malganis,768,warlock,destruction,12,8,4
41587,Munje,bleeding-hollow,768,warlock,destruction,12,8,4
41588,Roblockz,illidan,768,warlock,destruction,12,8,4
41589,Cheylock,stormrage,768,warlock,destruction,12,8,4
41590,Aptukk,archimonde,768,warlock,destruction,12,8,4
41591,Warlocknroll,frostmourne,768,warlock,destruction,12,8,4
41592,Clorvenna,zuljin,768,warlock,destruction,12,8,4
41593,Narzhul,drakkari,768,warlock,destruction,12,8,4
41594,Felegance,proudmoore,768,warlock,destruction,12,8,4
41595,Zunexx,malganis,768,warlock,destruction,12,8,4
41596,Yze,sargeras,768,warlock,destruction,12,8,4
41597,Tatemor,barthilas,768,warlock,destruction,12,8,4
41598,Diznei,nemesis,768,warlock,destruction,12,8,4
41599,Flavakid,malganis,768,warlock,destruction,12,8,4
41600,Chaoscoach,sargeras,768,warlock,destruction,12,8,4
41601,Pandasrlegit,burning-blade,768,warlock,destruction,12,8,4
41602,Djdemolordx,bleeding-hollow,768,warlock,destruction,12,8,4
41603,Badhombre,tichondrius,768,warlock,destruction,12,8,4
41604,Ayedss,dalaran,768,warlock,destruction,12,8,4
41605,Arthyr,twisting-nether,768,warlock,destruction,12,8,4
41606,Devi,executus,768,warlock,destruction,12,8,4
41607,Elldiablo,darkspear,768,warlock,destruction,12,8,4
41608,Fearsponce,dragonmaw,768,warlock,destruction,12,8,4
41609,Idoovoodoo,burning-legion,768,warlock,destruction,12,8,4
41610,Bopplock,tichondrius,768,warlock,destruction,12,8,4
41611,Smeezles,frostmourne,768,warlock,destruction,12,8,4
41612,Ceeloftw,tichondrius,768,warlock,destruction,12,8,4
41613,Nyhn,bleeding-hollow,768,warlock,destruction,13,8,5
41614,Westtung,tichondrius,768,warlock,destruction,13,8,5
41615,Metic,firetree,768,warlock,destruction,16,9,7
41616,Threk,quelthalas,768,warlock,destruction,18,8,10
41617,Iniboltquity,tichondrius,768,warlock,destruction,18,8,10
41618,Westhofxx,sargeras,768,warlock,destruction,18,8,10
41619,Kallym,azralon,768,warlock,destruction,18,8,10
41620,Pardoned,stormrage,768,warlock,destruction,18,8,10
41621,Demfearslol,terokkar,768,warlock,destruction,18,8,10
41622,Gneçro,area-52,768,warlock,destruction,18,8,10
41623,Rashiko,bleeding-hollow,768,warlock,destruction,18,8,10
41624,Bbangtimo,tichondrius,768,warlock,destruction,18,8,10
41625,Dethknell,stormrage,768,warlock,destruction,18,8,10
41626,Lynnilock,area-52,767,warlock,destruction,12,8,4
41627,Darthtequila,stormrage,767,warlock,destruction,12,8,4
41628,Ebølarot,tichondrius,767,warlock,destruction,12,8,4
41629,Cursedstales,stormrage,767,warlock,destruction,12,8,4
41630,Coil,kiljaeden,767,warlock,destruction,12,8,4
41631,Yonz,area-52,767,warlock,destruction,12,8,4
41632,Doman,thorium-brotherhood,767,warlock,destruction,12,8,4
41633,Reportmenerd,tichondrius,767,warlock,destruction,12,8,4
41634,Shadowlifts,kelthuzad,767,warlock,destruction,12,8,4
41635,Accentuate,tichondrius,767,warlock,destruction,12,8,4
41636,Daracon,thrall,767,warlock,destruction,12,8,4
41637,Toxec,barthilas,767,warlock,destruction,12,8,4
41638,Misscháos,malganis,767,warlock,destruction,18,8,10
41639,Hargol,azralon,767,warlock,destruction,18,8,10
41640,Aldaill,moon-guard,767,warlock,destruction,18,8,10
41641,Shikyo,lightnings-blade,767,warlock,destruction,18,8,10
41642,Katsurägi,tichondrius,767,warlock,destruction,18,8,10
41643,Webrar,frostmourne,767,warlock,destruction,18,8,10
41644,Mêdìvh,tichondrius,767,warlock,destruction,18,8,10
41645,Oxylock,magtheridon,767,warlock,destruction,18,8,10
41646,Plutö,thrall,767,warlock,destruction,18,8,10
41647,Carcine,frostwolf,767,warlock,destruction,18,8,10
41648,Windwolff,dalvengyr,767,warlock,destruction,18,8,10
41649,Síkaría,malganis,767,warlock,destruction,18,8,10
41650,Feoona,hyjal,767,warlock,destruction,24,8,16
41651,Necrófear,tichondrius,767,warlock,destruction,24,8,16
41652,Faldoras,kalecgos,766,warlock,destruction,12,8,4
41653,Devdolittle,tichondrius,766,warlock,destruction,12,8,4
41654,Doomers,frostmourne,766,warlock,destruction,12,8,4
41655,Enur,malganis,766,warlock,destruction,12,8,4
41656,Pocserlock,drakkari,766,warlock,destruction,12,8,4
41657,Dmgcrit,destromath,766,warlock,destruction,12,8,4
41658,Assaulttron,wyrmrest-accord,766,warlock,destruction,12,8,4
41659,Dinkydeen,area-52,766,warlock,destruction,12,8,4
41660,Raglans,amanthul,766,warlock,destruction,12,8,4
41661,Staudt,mugthol,766,warlock,destruction,12,8,4
41662,Seniorshneef,emerald-dream,766,warlock,destruction,18,8,10
41663,Mandley,nazgrel,766,warlock,destruction,18,8,10
41664,Spiritofodin,grizzly-hills,765,warlock,destruction,12,8,4
41665,Zezkin,alexstrasza,765,warlock,destruction,22,9,13
41666,Lilitht,drakkari,764,warlock,destruction,18,8,10
41667,Guinegobbler,hyjal,764,warlock,destruction,20,8,12
41668,Esoo,kul-tiras,763,warlock,destruction,12,8,4
41669,Caryn,dalaran,763,warlock,destruction,18,8,10
41670,Infortunium,sargeras,762,warlock,destruction,12,8,4
41671,Disrespex,kelthuzad,762,warlock,destruction,18,8,10
41672,Djfear,tichondrius,762,warlock,destruction,18,8,10
41673,Degynlock,wyrmrest-accord,762,warlock,destruction,24,8,16
41674,Shooterg,tichondrius,761,warlock,destruction,18,8,10
41675,Feladrae,wyrmrest-accord,761,warlock,destruction,30,8,22
41676,Thugpenus,frostmane,760,warlock,destruction,18,8,10
41677,Myshadow,gorefiend,758,warlock,destruction,24,8,16
41678,Jonuts,korgath,752,warlock,destruction,19,8,11
41679,Valintine,khadgar,749,warlock,destruction,15,9,6
41680,Nobuyori,tichondrius,745,warlock,destruction,24,9,15
41681,Chaoticman,tichondrius,733,warlock,destruction,17,8,9
41682,Fellraiser,bleeding-hollow,720,warlock,destruction,15,8,7
41683,Notoriusmma,illidan,720,warlock,destruction,19,10,9
41684,Sotera,bleeding-hollow,719,warlock,destruction,11,8,3
41685,Rentblod,azralon,719,warlock,destruction,11,8,3
41686,Lökdown,dalaran,714,warlock,destruction,15,11,4
41687,Ihaveapowers,maiev,703,warlock,destruction,11,8,3
41688,Tinyjo,sargeras,703,warlock,destruction,11,8,3
41689,Bäbz,barthilas,703,warlock,destruction,11,8,3
41690,Demotional,wyrmrest-accord,703,warlock,destruction,14,8,6
41691,Liljamie,stormrage,703,warlock,destruction,17,8,9
41692,Screampied,sargeras,699,warlock,destruction,20,8,12
41693,Getfeared,emerald-dream,672,warlock,destruction,10,8,2
41694,Hellfires,ragnaros,672,warlock,destruction,12,7,5
41695,Thinkchair,sargeras,672,warlock,destruction,12,7,5
41696,Mokfernal,tichondrius,672,warlock,destruction,12,7,5
41697,Glizzÿ,thrall,672,warlock,destruction,12,7,5
41698,Warpstar,area-52,672,warlock,destruction,12,7,5
41699,Rothslock,tichondrius,672,warlock,destruction,12,7,5
41700,Flicks,arthas,672,warlock,destruction,12,7,5
41701,Callofzevoid,tichondrius,672,warlock,destruction,12,7,5
41702,Kountdrakula,tichondrius,672,warlock,destruction,12,7,5
41703,Méphisto,emerald-dream,672,warlock,destruction,12,7,5
41704,Luciusvrenus,tichondrius,672,warlock,destruction,12,7,5
41705,Lessthanjake,zuljin,672,warlock,destruction,12,7,5
41706,Ztc,dalaran,672,warlock,destruction,12,7,5
41707,Alterity,kelthuzad,672,warlock,destruction,12,7,5
41708,Tamzin,kelthuzad,672,warlock,destruction,12,7,5
41709,Hdys,tichondrius,672,warlock,destruction,12,7,5
41710,Dotlockndrop,stormreaver,672,warlock,destruction,12,7,5
41711,Sasaology,frostmourne,672,warlock,destruction,12,7,5
41712,Dplexs,jubeithos,672,warlock,destruction,12,7,5
41713,Spicytaters,malganis,672,warlock,destruction,12,7,5
41714,Pillock,bleeding-hollow,672,warlock,destruction,12,7,5
41715,Tatordotzz,tichondrius,672,warlock,destruction,12,7,5
41716,Afflackxl,sargeras,672,warlock,destruction,12,7,5
41717,Spliffxl,stormrage,672,warlock,destruction,12,7,5
41718,Stîgz,stormrage,672,warlock,destruction,12,7,5
41719,Insànity,bleeding-hollow,672,warlock,destruction,12,7,5
41720,Schlutty,malganis,672,warlock,destruction,12,7,5
41721,Aegywn,gorgonnash,672,warlock,destruction,12,7,5
41722,Ðòm,tichondrius,672,warlock,destruction,12,7,5
41723,Zelophobiaz,crushridge,672,warlock,destruction,12,7,5
41724,Snikpan,silver-hand,672,warlock,destruction,12,7,5
41725,Dötkill,illidan,672,warlock,destruction,12,7,5
41726,Iboltudie,tichondrius,672,warlock,destruction,12,7,5
41727,Says,gorefiend,672,warlock,destruction,12,7,5
41728,Blair,wildhammer,672,warlock,destruction,12,7,5
41729,Clingrita,tichondrius,672,warlock,destruction,12,7,5
41730,Sylvarri,stormrage,672,warlock,destruction,12,7,5
41731,Felforyouu,illidan,672,warlock,destruction,12,7,5
41732,Suminl,tichondrius,672,warlock,destruction,12,7,5
41733,Westhofz,sargeras,672,warlock,destruction,12,7,5
41734,Furryfears,gurubashi,672,warlock,destruction,12,7,5
41735,Deebeel,sargeras,672,warlock,destruction,12,7,5
41736,Yikës,stormrage,672,warlock,destruction,12,7,5
41737,Lokintots,darkspear,672,warlock,destruction,12,7,5
41738,Uggaboogga,malganis,672,warlock,destruction,12,7,5
41739,Thewkama,tichondrius,672,warlock,destruction,12,7,5
41740,Dipgodx,bleeding-hollow,672,warlock,destruction,12,7,5
41741,Puvvo,tichondrius,672,warlock,destruction,12,7,5
41742,Blayzen,elune,672,warlock,destruction,12,7,5
41743,Bosswarlock,tichondrius,672,warlock,destruction,13,7,6
41744,Ahp,stormrage,672,warlock,destruction,15,8,7
41745,Anasúi,quelthalas,672,warlock,destruction,18,7,11
41746,Modot,tichondrius,672,warlock,destruction,18,7,11
41747,Zantology,frostmourne,672,warlock,destruction,18,7,11
41748,Dmacxl,tichondrius,672,warlock,destruction,18,7,11
41749,Sourmilkz,zuljin,672,warlock,destruction,18,7,11
41750,Brough,illidan,672,warlock,destruction,24,7,17
41751,Bhupzy,barthilas,671,warlock,destruction,12,7,5
41752,Mérli,quelthalas,671,warlock,destruction,12,7,5
41753,Dotznfearz,zuljin,671,warlock,destruction,12,7,5
41754,Briside,malganis,671,warlock,destruction,12,7,5
41755,Grimzo,mugthol,671,warlock,destruction,12,7,5
41756,Boltondahoes,sargeras,671,warlock,destruction,12,7,5
41757,Strawberryz,boulderfist,671,warlock,destruction,12,7,5
41758,Saicinxd,darkspear,671,warlock,destruction,12,7,5
41759,Aroris,silver-hand,671,warlock,destruction,12,7,5
41760,Zyraxx,moon-guard,671,warlock,destruction,12,7,5
41761,Demosthenes,nazjatar,671,warlock,destruction,12,7,5
41762,Shadowpainn,the-underbog,671,warlock,destruction,12,7,5
41763,Irunaways,stormrage,671,warlock,destruction,12,7,5
41764,Leroybrown,alterac-mountains,671,warlock,destruction,12,7,5
41765,Azâziel,ragnaros,671,warlock,destruction,12,7,5
41766,Naba,malorne,671,warlock,destruction,12,7,5
41767,Hadit,malganis,671,warlock,destruction,15,8,7
41768,Soulinite,fizzcrank,671,warlock,destruction,18,7,11
41769,Jvilla,tichondrius,671,warlock,destruction,18,7,11
41770,Vorituuray,moon-guard,671,warlock,destruction,18,7,11
41771,Kachauwoo,kiljaeden,671,warlock,destruction,18,7,11
41772,Vetislock,thrall,671,warlock,destruction,18,7,11
41773,Yury,scarlet-crusade,671,warlock,destruction,18,7,11
41774,Jhivtwo,tichondrius,671,warlock,destruction,18,7,11
41775,Wollylock,dark-iron,671,warlock,destruction,18,7,11
41776,Fearlord,shattered-hand,671,warlock,destruction,24,7,17
41777,Doomtome,moon-guard,671,warlock,destruction,26,7,19
41778,Amilkman,area-52,670,warlock,destruction,12,7,5
41779,Noteko,korgath,670,warlock,destruction,12,7,5
41780,Tørturë,tichondrius,670,warlock,destruction,12,7,5
41781,Cazadorius,jubeithos,670,warlock,destruction,13,7,6
41782,Heartpvp,tichondrius,670,warlock,destruction,18,7,11
41783,Kristenßell,senjin,669,warlock,destruction,12,7,5
41784,Otus,echo-isles,669,warlock,destruction,12,7,5
41785,Revenancer,smolderthorn,669,warlock,destruction,12,7,5
41786,Sumonníng,tichondrius,669,warlock,destruction,18,7,11
41787,Sneakywarlok,dalaran,668,warlock,destruction,19,7,12
41788,Deathjerky,thrall,667,warlock,destruction,12,7,5
41789,Klapincheeks,malganis,659,warlock,destruction,44,10,34
41790,Saltboi,azjolnerub,640,warlock,destruction,16,7,9
41791,Voidxx,tichondrius,639,warlock,destruction,11,7,4
41792,Greenwarlock,bleeding-hollow,639,warlock,destruction,14,8,6
41793,Shendotigans,illidan,639,warlock,destruction,17,7,10
41794,Demondan,magtheridon,638,warlock,destruction,23,7,16
41795,Hobblefoòt,proudmoore,623,warlock,destruction,11,7,4
41796,Seregå,skywall,623,warlock,destruction,11,7,4
41797,Cassetes,tichondrius,622,warlock,destruction,11,7,4
41798,Lazzarros,area-52,618,warlock,destruction,22,8,14
41799,Pontoontim,mugthol,617,warlock,destruction,20,8,12
41800,Fancynuts,kiljaeden,607,warlock,destruction,11,7,4
41801,Perfsx,bleeding-hollow,607,warlock,destruction,14,7,7
41802,Furrlokc,tichondrius,607,warlock,destruction,16,7,9
41803,Surleshilla,malganis,592,warlock,destruction,13,7,6
41804,Studathlete,tichondrius,592,warlock,destruction,13,7,6
41805,Pandemik,turalyon,591,warlock,destruction,11,8,3
41806,Freyanna,moon-guard,588,warlock,destruction,19,7,12
41807,Baconmuffin,tichondrius,576,warlock,destruction,6,6,0
41808,Winipuhmalo,quelthalas,576,warlock,destruction,6,6,0
41809,Kòngal,tichondrius,576,warlock,destruction,6,6,0
41810,Mitchosx,frostmourne,576,warlock,destruction,6,6,0
41811,Gabbagoul,sargeras,576,warlock,destruction,6,6,0
41812,Redsolojdc,tichondrius,576,warlock,destruction,6,6,0
41813,Bronzel,tichondrius,576,warlock,destruction,6,6,0
41814,Hypexis,area-52,576,warlock,destruction,6,6,0
41815,Bakko,tichondrius,576,warlock,destruction,6,6,0
41816,Drainerx,kelthuzad,576,warlock,destruction,6,6,0
41817,Xhrine,frostmourne,576,warlock,destruction,6,6,0
41818,Menggoth,tichondrius,576,warlock,destruction,6,6,0
41819,Malevolent,velen,576,warlock,destruction,6,6,0
41820,Joromojo,zuljin,576,warlock,destruction,6,6,0
41821,Notstingz,azralon,576,warlock,destruction,6,6,0
41822,Schrader,sargeras,576,warlock,destruction,6,6,0
41823,Pndasrntlegt,burning-blade,576,warlock,destruction,6,6,0
41824,Impbisqit,stormrage,576,warlock,destruction,6,6,0
41825,Broovid,tichondrius,576,warlock,destruction,13,7,6
41826,Imbadatpvp,tichondrius,576,warlock,destruction,12,6,6
41827,Maèlstrom,area-52,576,warlock,destruction,12,6,6
41828,Insanemids,tichondrius,576,warlock,destruction,12,6,6
41829,Poxnhub,tichondrius,576,warlock,destruction,12,6,6
41830,Truepain,tichondrius,576,warlock,destruction,12,6,6
41831,Chabolt,tichondrius,576,warlock,destruction,12,6,6
41832,Ronnietherat,tichondrius,576,warlock,destruction,12,6,6
41833,Tinked,stormrage,576,warlock,destruction,12,6,6
41834,Quadrillion,stormrage,576,warlock,destruction,12,6,6
41835,Shigero,tichondrius,576,warlock,destruction,12,6,6
41836,Badmir,area-52,576,warlock,destruction,12,6,6
41837,Manethail,aegwynn,576,warlock,destruction,12,6,6
41838,Sauzith,area-52,576,warlock,destruction,12,6,6
41839,Betrili,tichondrius,576,warlock,destruction,12,6,6
41840,Árkadiano,drakkari,576,warlock,destruction,12,6,6
41841,Kmüz,drakkari,576,warlock,destruction,12,6,6
41842,Kulgar,aerie-peak,576,warlock,destruction,12,6,6
41843,Massivebolts,area-52,576,warlock,destruction,12,6,6
41844,Girthlock,tichondrius,576,warlock,destruction,12,6,6
41845,Donutd,stormrage,576,warlock,destruction,12,6,6
41846,Justignoreme,tichondrius,576,warlock,destruction,12,6,6
41847,Itsmeagain,area-52,576,warlock,destruction,12,6,6
41848,Manalis,zuljin,576,warlock,destruction,12,6,6
41849,Andrewpg,zuljin,576,warlock,destruction,12,6,6
41850,Lucíela,ragnaros,576,warlock,destruction,12,6,6
41851,Akolite,tichondrius,576,warlock,destruction,12,6,6
41852,Eboknight,area-52,576,warlock,destruction,12,6,6
41853,Aikus,quelthalas,576,warlock,destruction,12,6,6
41854,Jessewheels,tichondrius,576,warlock,destruction,12,6,6
41855,Metafin,quelthalas,576,warlock,destruction,12,6,6
41856,Kreemy,ysera,576,warlock,destruction,12,6,6
41857,Salentsia,malganis,576,warlock,destruction,12,6,6
41858,Lambe,tichondrius,576,warlock,destruction,12,6,6
41859,Peeberson,tichondrius,576,warlock,destruction,12,6,6
41860,Souldrain,malganis,576,warlock,destruction,12,6,6
41861,Graingrippin,malganis,576,warlock,destruction,12,6,6
41862,Coffeezx,malganis,576,warlock,destruction,12,6,6
41863,Geegas,malganis,576,warlock,destruction,12,6,6
41864,Bowltz,chogall,576,warlock,destruction,12,6,6
41865,Ðáyshéll,kelthuzad,576,warlock,destruction,12,6,6
41866,Vravras,kelthuzad,576,warlock,destruction,12,6,6
41867,Ïmpdance,tichondrius,576,warlock,destruction,12,6,6
41868,Liability,zuljin,576,warlock,destruction,12,6,6
41869,Gagitha,black-dragonflight,576,warlock,destruction,12,6,6
41870,Tjdotter,stormrage,576,warlock,destruction,12,6,6
41871,Bhris,wildhammer,576,warlock,destruction,12,6,6
41872,Bolèyn,moon-guard,576,warlock,destruction,12,6,6
41873,Hiro,steamwheedle-cartel,576,warlock,destruction,12,6,6
41874,Beamin,dentarg,576,warlock,destruction,12,6,6
41875,Tlock,azjolnerub,576,warlock,destruction,12,6,6
41876,Crimsonela,emerald-dream,576,warlock,destruction,12,6,6
41877,Baconmarty,emerald-dream,576,warlock,destruction,12,6,6
41878,Tonifortnite,emerald-dream,576,warlock,destruction,12,6,6
41879,Tomato,azjolnerub,576,warlock,destruction,12,6,6
41880,Riskydemon,azralon,576,warlock,destruction,12,6,6
41881,Trixtah,illidan,576,warlock,destruction,12,6,6
41882,Footyl,stormrage,576,warlock,destruction,12,6,6
41883,Flu,darkspear,576,warlock,destruction,12,6,6
41884,Zeromech,sargeras,576,warlock,destruction,12,6,6
41885,Asamsbinladn,illidan,576,warlock,destruction,12,6,6
41886,Iemonv,vashj,576,warlock,destruction,12,6,6
41887,Draxxus,barthilas,576,warlock,destruction,12,6,6
41888,Emptysoul,illidan,576,warlock,destruction,12,6,6
41889,Lokkup,dalaran,576,warlock,destruction,12,6,6
41890,Sumrule,dreadmaul,576,warlock,destruction,12,6,6
41891,Limeriax,emerald-dream,576,warlock,destruction,12,6,6
41892,Mangdaemon,silvermoon,576,warlock,destruction,12,6,6
41893,Beerbolt,dalaran,576,warlock,destruction,12,6,6
41894,Zedonius,dragonmaw,576,warlock,destruction,12,6,6
41895,Taye,barthilas,576,warlock,destruction,12,6,6
41896,Charmandfarm,nerzhul,576,warlock,destruction,12,6,6
41897,Ritua,dragonmaw,576,warlock,destruction,12,6,6
41898,Zephidel,thrall,576,warlock,destruction,12,6,6
41899,Marinw,azralon,576,warlock,destruction,16,7,9
41900,Indrah,tichondrius,576,warlock,destruction,14,6,8
41901,Esoteríc,sargeras,576,warlock,destruction,18,6,12
41902,Jinxdacat,shandris,576,warlock,destruction,18,6,12
41903,Cigárillo,thrall,576,warlock,destruction,18,6,12
41904,Bêlthazor,kelthuzad,576,warlock,destruction,18,6,12
41905,Lenestus,stormrage,576,warlock,destruction,18,6,12
41906,Tenletters,kirin-tor,576,warlock,destruction,18,6,12
41907,Wzrdtrx,deathwing,576,warlock,destruction,18,6,12
41908,Lamdyn,moon-guard,576,warlock,destruction,18,6,12
41909,Familjia,nagrand,576,warlock,destruction,18,6,12
41910,Plutheros,stormrage,576,warlock,destruction,18,6,12
41911,Klisman,azralon,576,warlock,destruction,18,6,12
41912,Xdta,frostmourne,576,warlock,destruction,18,6,12
41913,Tharax,moon-guard,576,warlock,destruction,18,6,12
41914,Spamfearftw,sargeras,575,warlock,destruction,6,6,0
41915,Dipndøtz,illidan,575,warlock,destruction,6,6,0
41916,Shadowy,dragonblight,575,warlock,destruction,12,6,6
41917,Edielyth,proudmoore,575,warlock,destruction,12,6,6
41918,Baphomët,tichondrius,575,warlock,destruction,12,6,6
41919,Azracore,illidan,575,warlock,destruction,12,6,6
41920,Cutewarlock,draktharon,575,warlock,destruction,12,6,6
41921,Méhoe,bleeding-hollow,575,warlock,destruction,12,6,6
41922,Daimon,kaelthas,575,warlock,destruction,12,6,6
41923,Beelzibub,firetree,575,warlock,destruction,12,6,6
41924,Naparima,stormreaver,575,warlock,destruction,12,6,6
41925,Ifeludead,sargeras,575,warlock,destruction,12,6,6
41926,Filthypumper,proudmoore,575,warlock,destruction,12,6,6
41927,Rathianna,sargeras,575,warlock,destruction,12,6,6
41928,Pactman,sargeras,575,warlock,destruction,12,6,6
41929,Crankshaft,nordrassil,575,warlock,destruction,12,6,6
41930,Lockswagger,stormrage,575,warlock,destruction,12,6,6
41931,Oluluo,andorhal,575,warlock,destruction,18,6,12
41932,Helpimdýing,sargeras,575,warlock,destruction,18,6,12
41933,Leno,twisting-nether,575,warlock,destruction,18,6,12
41934,Yetiaids,tichondrius,575,warlock,destruction,18,6,12
41935,Pachips,zuljin,575,warlock,destruction,18,6,12
41936,Xmochahollic,tichondrius,575,warlock,destruction,23,6,17
41937,Ëliphas,tichondrius,575,warlock,destruction,24,6,18
41938,Trayga,illidan,574,warlock,destruction,6,6,0
41939,Persephoné,blackrock,574,warlock,destruction,12,6,6
41940,Tesdeez,tichondrius,574,warlock,destruction,12,6,6
41941,Totti,tol-barad,574,warlock,destruction,12,6,6
41942,Ggumx,tichondrius,574,warlock,destruction,12,6,6
41943,Hungovermate,barthilas,574,warlock,destruction,12,6,6
41944,Träzyn,kiljaeden,574,warlock,destruction,18,6,12
41945,Trïnîty,tichondrius,574,warlock,destruction,18,6,12
41946,Zahba,stormrage,572,warlock,destruction,12,6,6
41947,Supercracker,bleeding-hollow,572,warlock,destruction,18,6,12
41948,Fidobiu,stormrage,571,warlock,destruction,12,6,6
41949,Rôver,crushridge,568,warlock,destruction,12,6,6
41950,Ledrlpxlx,bleeding-hollow,563,warlock,destruction,24,10,14
41951,Expiredonion,bleeding-hollow,559,warlock,destruction,11,6,5
41952,Friend,frostmourne,559,warlock,destruction,17,6,11
41953,Drdotngo,tichondrius,543,warlock,destruction,8,7,1
41954,Promancer,drakkari,528,warlock,destruction,9,6,3
41955,Loch,destromath,527,warlock,destruction,11,6,5
41956,Shardgodx,barthilas,527,warlock,destruction,11,6,5
41957,Exillis,barthilas,527,warlock,destruction,17,6,11
41958,Tesowenn,tichondrius,522,warlock,destruction,15,7,8
41959,Locdup,sargeras,512,warlock,destruction,22,6,16
41960,Cs,icecrown,511,warlock,destruction,9,7,2
41961,Ðêcimatê,frostmourne,511,warlock,destruction,12,6,6
41962,Glifosáto,quelthalas,510,warlock,destruction,10,8,2
41963,Dixynormis,zuljin,510,warlock,destruction,11,6,5
41964,Ràistlin,madoran,494,warlock,destruction,11,6,5
41965,Babyvet,stormreaver,480,warlock,destruction,6,5,1
41966,Ozric,quelthalas,480,warlock,destruction,6,5,1
41967,Khaozx,ragnaros,480,warlock,destruction,6,5,1
41968,Phyxylock,stormrage,480,warlock,destruction,6,5,1
41969,Cytosine,medivh,480,warlock,destruction,6,5,1
41970,Novah,balnazzar,480,warlock,destruction,6,5,1
41971,Cloperry,area-52,480,warlock,destruction,6,5,1
41972,Fapchat,silvermoon,480,warlock,destruction,6,5,1
41973,Halftism,sargeras,480,warlock,destruction,6,5,1
41974,Jalean,illidan,480,warlock,destruction,6,5,1
41975,Kargos,bonechewer,480,warlock,destruction,6,5,1
41976,Michae,tichondrius,480,warlock,destruction,6,5,1
41977,Warwand,tichondrius,480,warlock,destruction,6,5,1
41978,Onidium,area-52,480,warlock,destruction,6,5,1
41979,Poonanifotm,gundrak,480,warlock,destruction,6,5,1
41980,Halfmade,tichondrius,480,warlock,destruction,6,5,1
41981,Destructium,stormrage,480,warlock,destruction,6,5,1
41982,Elprup,tichondrius,480,warlock,destruction,6,5,1
41983,Unicornspit,tichondrius,480,warlock,destruction,6,5,1
41984,Zoljinn,frostwolf,480,warlock,destruction,6,5,1
41985,Cozu,tichondrius,480,warlock,destruction,6,5,1
41986,Ohthemisery,sargeras,480,warlock,destruction,6,5,1
41987,Drossx,illidan,480,warlock,destruction,6,5,1
41988,Meddsurgx,emerald-dream,480,warlock,destruction,6,5,1
41989,Zerocastspec,tichondrius,480,warlock,destruction,6,5,1
41990,Buypork,tichondrius,480,warlock,destruction,6,5,1
41991,Evierine,zuljin,480,warlock,destruction,6,5,1
41992,Pantubølt,stormrage,480,warlock,destruction,6,5,1
41993,Stíngz,nemesis,480,warlock,destruction,6,5,1
41994,Ikite,zuljin,480,warlock,destruction,6,5,1
41995,Theovohn,thrall,480,warlock,destruction,6,5,1
41996,Dippindotz,scilla,480,warlock,destruction,6,5,1
41997,Malékíth,ragnaros,480,warlock,destruction,6,5,1
41998,Mørøs,tichondrius,480,warlock,destruction,6,5,1
41999,Balencinaga,frostmourne,480,warlock,destruction,6,5,1
42000,Bâppo,antonidas,480,warlock,destruction,6,5,1
42001,Púp,bleeding-hollow,480,warlock,destruction,6,5,1
42002,Virûs,vashj,480,warlock,destruction,6,5,1
42003,Goldielocks,eredar,480,warlock,destruction,6,5,1
42004,Humblegodd,illidan,480,warlock,destruction,6,5,1
42005,Leîa,tichondrius,480,warlock,destruction,6,5,1
42006,Adonegege,tichondrius,480,warlock,destruction,6,5,1
42007,Cheesëbolt,illidan,480,warlock,destruction,6,5,1
42008,Chewybolt,illidan,480,warlock,destruction,6,5,1
42009,Popnloc,tichondrius,480,warlock,destruction,6,5,1
42010,Gritzixx,frostmourne,480,warlock,destruction,6,5,1
42011,Foxbolt,tichondrius,480,warlock,destruction,6,5,1
42012,Efuc,tichondrius,480,warlock,destruction,6,5,1
42013,Pikolock,bleeding-hollow,480,warlock,destruction,6,5,1
42014,Beranflakes,darkspear,480,warlock,destruction,6,5,1
42015,Awdam,tichondrius,480,warlock,destruction,6,5,1
42016,Yuckytoetoe,emerald-dream,480,warlock,destruction,6,5,1
42017,Karmalock,malganis,480,warlock,destruction,6,5,1
42018,Oreganow,icecrown,480,warlock,destruction,6,5,1
42019,Arnan,korgath,480,warlock,destruction,6,5,1
42020,Blorgaflob,thaurissan,480,warlock,destruction,7,5,2
42021,Corruptblxck,tichondrius,480,warlock,destruction,9,6,3
42022,Avoidahoe,sargeras,480,warlock,destruction,12,5,7
42023,Zrok,bleeding-hollow,480,warlock,destruction,12,5,7
42024,Thirsts,tichondrius,480,warlock,destruction,12,5,7
42025,Souljäboy,bleeding-hollow,480,warlock,destruction,12,5,7
42026,Gallynna,moon-guard,480,warlock,destruction,12,5,7
42027,Bellgrande,shadowmoon,480,warlock,destruction,12,5,7
42028,Macnab,malganis,480,warlock,destruction,12,5,7
42029,Lockandload,malfurion,480,warlock,destruction,12,5,7
42030,Marbuldan,frostmourne,480,warlock,destruction,12,5,7
42031,Coviddotsrot,sargeras,480,warlock,destruction,12,5,7
42032,Jankity,kelthuzad,480,warlock,destruction,12,5,7
42033,Darezs,frostmourne,480,warlock,destruction,12,5,7
42034,Yurick,frostmourne,480,warlock,destruction,12,5,7
42035,Fearedit,bleeding-hollow,480,warlock,destruction,12,5,7
42036,Totsdots,blackrock,480,warlock,destruction,12,5,7
42037,Lockwell,tichondrius,480,warlock,destruction,12,5,7
42038,Archleon,smolderthorn,480,warlock,destruction,12,5,7
42039,Pveisboring,tichondrius,480,warlock,destruction,12,5,7
42040,Justganmore,tichondrius,480,warlock,destruction,12,5,7
42041,Seraphserius,laughing-skull,480,warlock,destruction,12,5,7
42042,Lildottythot,malganis,480,warlock,destruction,12,5,7
42043,Daemonixx,vashj,480,warlock,destruction,12,5,7
42044,Pabloqlx,ragnaros,480,warlock,destruction,12,5,7
42045,Ascendant,amanthul,480,warlock,destruction,12,5,7
42046,Arkangel,dalvengyr,480,warlock,destruction,12,5,7
42047,Imhereforrbg,moon-guard,480,warlock,destruction,12,5,7
42048,Wombogombo,malganis,480,warlock,destruction,12,5,7
42049,Marshyxd,tichondrius,480,warlock,destruction,12,5,7
42050,Enmama,malganis,480,warlock,destruction,12,5,7
42051,Locknes,kiljaeden,480,warlock,destruction,12,5,7
42052,Excusey,tichondrius,480,warlock,destruction,12,5,7
42053,Chaoz,aggramar,480,warlock,destruction,12,5,7
42054,Oppaijuggler,tichondrius,480,warlock,destruction,12,5,7
42055,Richards,thrall,480,warlock,destruction,12,5,7
42056,Wediditjoe,kelthuzad,480,warlock,destruction,12,5,7
42057,Zugzor,shadowmoon,480,warlock,destruction,12,5,7
42058,Sylvine,korgath,480,warlock,destruction,12,5,7
42059,Yungwilly,silvermoon,480,warlock,destruction,12,5,7
42060,Hyjixy,stormrage,480,warlock,destruction,12,5,7
42061,Topboypepito,tichondrius,480,warlock,destruction,12,5,7
42062,Errogant,area-52,480,warlock,destruction,12,5,7
42063,Pikvas,darkspear,480,warlock,destruction,12,5,7
42064,Valrena,rivendare,480,warlock,destruction,12,5,7
42065,Balden,fenris,480,warlock,destruction,12,5,7
42066,Gameface,garrosh,480,warlock,destruction,12,5,7
42067,Shadowflame,skullcrusher,480,warlock,destruction,12,5,7
42068,Ensanaty,dalaran,480,warlock,destruction,12,5,7
42069,Mitryc,illidan,480,warlock,destruction,12,5,7
42070,Rytaint,emerald-dream,480,warlock,destruction,12,5,7
42071,Rainali,tichondrius,480,warlock,destruction,12,5,7
42072,Kubera,mannoroth,480,warlock,destruction,12,5,7
42073,Zalurk,emerald-dream,480,warlock,destruction,12,5,7
42074,Gnimms,sargeras,480,warlock,destruction,12,5,7
42075,Sukmalock,proudmoore,480,warlock,destruction,15,6,9
42076,Caplock,barthilas,480,warlock,destruction,18,5,13
42077,Corezach,proudmoore,480,warlock,destruction,18,5,13
42078,Kazam,quelthalas,479,warlock,destruction,6,5,1
42079,Yelabanxtown,thaurissan,479,warlock,destruction,6,5,1
42080,Skrillhex,dragonmaw,479,warlock,destruction,6,5,1
42081,Dogetrash,tichondrius,479,warlock,destruction,11,8,3
42082,Esmaldo,tichondrius,479,warlock,destruction,12,5,7
42083,Dotess,illidan,479,warlock,destruction,12,5,7
42084,Vordz,amanthul,479,warlock,destruction,12,5,7
42085,Kelici,borean-tundra,479,warlock,destruction,12,5,7
42086,Grix,uldaman,479,warlock,destruction,12,5,7
42087,Aliceðupree,darkspear,479,warlock,destruction,12,5,7
42088,Loccdawg,laughing-skull,479,warlock,destruction,12,5,7
42089,Osteogenesis,quelthalas,479,warlock,destruction,12,5,7
42090,Fazzlock,nagrand,479,warlock,destruction,16,6,10
42091,Karkloc,stormrage,479,warlock,destruction,18,5,13
42092,Daemonddred,hakkar,479,warlock,destruction,18,5,13
42093,Giled,runetotem,478,warlock,destruction,12,5,7
42094,Saintvil,drakkari,477,warlock,destruction,6,5,1
42095,Warrogoblin,ragnaros,476,warlock,destruction,9,6,3
42096,Casusita,area-52,472,warlock,destruction,12,5,7
42097,Raven,baelgun,463,warlock,destruction,11,5,6
42098,Viejitaa,quelthalas,447,warlock,destruction,10,6,4
42099,Døtbomb,stormrage,447,warlock,destruction,11,5,6
42100,Magniwl,zuljin,447,warlock,destruction,11,5,6
42101,Britnyfears,korgath,447,warlock,destruction,16,5,11
42102,Djvetis,blackhand,442,warlock,destruction,15,7,8
42103,Heizx,area-52,432,warlock,destruction,15,5,10
42104,Mcscrotie,tichondrius,431,warlock,destruction,11,5,6
42105,Brútek,moon-guard,431,warlock,destruction,11,5,6
42106,Stainn,gallywix,430,warlock,destruction,9,5,4
42107,Empowerdlock,garrosh,416,warlock,destruction,10,5,5
42108,Velsona,moon-guard,415,warlock,destruction,14,5,9
42109,Krozu,bleeding-hollow,415,warlock,destruction,14,5,9
42110,Pescador,tichondrius,400,warlock,destruction,7,5,2
42111,Brokenaf,stormrage,384,warlock,destruction,6,4,2
42112,Fearoshimá,thrall,384,warlock,destruction,6,4,2
42113,Slappndemons,mugthol,384,warlock,destruction,6,4,2
42114,Naginikill,zuljin,384,warlock,destruction,6,4,2
42115,Necroferal,whisperwind,384,warlock,destruction,6,4,2
42116,Lockiana,zuljin,384,warlock,destruction,6,4,2
42117,Rickthelock,tichondrius,384,warlock,destruction,6,4,2
42118,Mmrceo,azgalor,384,warlock,destruction,6,4,2
42119,Xevari,zuljin,384,warlock,destruction,6,4,2
42120,Bedtimes,tichondrius,384,warlock,destruction,6,4,2
42121,Smallj,zuljin,384,warlock,destruction,6,4,2
42122,Underchicken,blackrock,384,warlock,destruction,6,4,2
42123,Asalaviik,illidan,384,warlock,destruction,6,4,2
42124,Vilebrute,illidan,384,warlock,destruction,6,4,2
42125,Pegorn,illidan,384,warlock,destruction,6,4,2
42126,Fatherbolt,tichondrius,384,warlock,destruction,6,4,2
42127,Damienn,wyrmrest-accord,384,warlock,destruction,6,4,2
42128,Drgiggles,tichondrius,384,warlock,destruction,6,4,2
42129,Toomanymind,stormrage,384,warlock,destruction,6,4,2
42130,Moramont,stormrage,384,warlock,destruction,6,4,2
42131,Saruon,proudmoore,384,warlock,destruction,6,4,2
42132,Sheetzlock,azgalor,384,warlock,destruction,6,4,2
42133,Maquedonia,quelthalas,384,warlock,destruction,6,4,2
42134,Sprenn,bleeding-hollow,384,warlock,destruction,6,4,2
42135,Yëët,wildhammer,384,warlock,destruction,6,4,2
42136,Calcadius,zuljin,384,warlock,destruction,6,4,2
42137,Ñever,winterhoof,384,warlock,destruction,6,4,2
42138,Siltharious,senjin,384,warlock,destruction,6,4,2
42139,Erock,korgath,384,warlock,destruction,6,4,2
42140,Biger,nemesis,384,warlock,destruction,6,4,2
42141,Eatmybeef,ravencrest,384,warlock,destruction,6,4,2
42142,Eazyw,stormrage,384,warlock,destruction,6,4,2
42143,Xijp,illidan,384,warlock,destruction,6,4,2
42144,Asiopdu,tichondrius,384,warlock,destruction,6,4,2
42145,Quetzâlcoâtl,sargeras,384,warlock,destruction,6,4,2
42146,Arredivh,blackhand,384,warlock,destruction,6,4,2
42147,Wallzz,stormrage,384,warlock,destruction,6,4,2
42148,Carielict,sargeras,384,warlock,destruction,6,4,2
42149,Souwantwar,kiljaeden,384,warlock,destruction,6,4,2
42150,Ruination,cenarius,384,warlock,destruction,6,4,2
42151,Laytome,stormreaver,384,warlock,destruction,6,4,2
42152,Antagony,bleeding-hollow,384,warlock,destruction,6,4,2
42153,Pendïng,area-52,384,warlock,destruction,6,4,2
42154,Lîlý,bleeding-hollow,384,warlock,destruction,6,4,2
42155,Hawtchili,illidan,384,warlock,destruction,6,4,2
42156,Slurper,frostwolf,384,warlock,destruction,6,4,2
42157,Alwysoom,aegwynn,384,warlock,destruction,6,4,2
42158,Jerothia,lethon,384,warlock,destruction,6,4,2
42159,Jxstinl,tichondrius,384,warlock,destruction,6,4,2
42160,Zerfall,area-52,384,warlock,destruction,6,4,2
42161,Dealindoug,bonechewer,384,warlock,destruction,6,4,2
42162,Outkãst,illidan,384,warlock,destruction,6,4,2
42163,Lunazz,tichondrius,384,warlock,destruction,6,4,2
42164,Galtur,azralon,384,warlock,destruction,6,4,2
42165,Chumbing,sargeras,384,warlock,destruction,6,4,2
42166,Khaos,norgannon,384,warlock,destruction,6,4,2
42167,Dottcom,laughing-skull,384,warlock,destruction,6,4,2
42168,Thelynx,chogall,384,warlock,destruction,6,4,2
42169,Woofbolt,malganis,384,warlock,destruction,6,4,2
42170,Norastrum,area-52,384,warlock,destruction,6,4,2
42171,Gordoxin,area-52,384,warlock,destruction,6,4,2
42172,Zonss,tichondrius,384,warlock,destruction,6,4,2
42173,Rodneyjones,emerald-dream,384,warlock,destruction,6,4,2
42174,Wiredftwx,illidan,384,warlock,destruction,6,4,2
42175,Drakatat,tichondrius,384,warlock,destruction,6,4,2
42176,Cursebolt,tichondrius,384,warlock,destruction,6,4,2
42177,Panicmode,darkspear,384,warlock,destruction,6,4,2
42178,Dettocs,emerald-dream,384,warlock,destruction,6,4,2
42179,Smnslock,emerald-dream,384,warlock,destruction,6,4,2
42180,Anthaxel,dalaran,384,warlock,destruction,6,4,2
42181,Necrotko,malganis,384,warlock,destruction,6,4,2
42182,Stambye,ragnaros,384,warlock,destruction,6,4,2
42183,Extreme,blackwing-lair,384,warlock,destruction,6,4,2
42184,Deathtones,moon-guard,384,warlock,destruction,6,4,2
42185,Wreckquiem,burning-blade,384,warlock,destruction,6,4,2
42186,Moonsoaps,moon-guard,384,warlock,destruction,6,4,2
42187,Espanol,magtheridon,384,warlock,destruction,6,4,2
42188,Alliciia,area-52,384,warlock,destruction,6,4,2
42189,Magvezx,kelthuzad,384,warlock,destruction,6,4,2
42190,Qfear,tichondrius,384,warlock,destruction,6,4,2
42191,Dottzie,malganis,384,warlock,destruction,6,4,2
42192,Warfeen,malganis,384,warlock,destruction,6,4,2
42193,Zzat,area-52,384,warlock,destruction,6,4,2
42194,Menedemus,amanthul,384,warlock,destruction,6,4,2
42195,Kroshuto,ragnaros,384,warlock,destruction,6,4,2
42196,Ozidus,tichondrius,384,warlock,destruction,6,4,2
42197,Geists,emerald-dream,384,warlock,destruction,6,4,2
42198,Kidneystone,emerald-dream,384,warlock,destruction,6,4,2
42199,Marrowsipper,tichondrius,384,warlock,destruction,6,4,2
42200,Botoslap,dragonmaw,384,warlock,destruction,6,4,2
42201,Crackhammer,sargeras,384,warlock,destruction,6,4,2
42202,Wømanizer,azralon,384,warlock,destruction,6,4,2
42203,Décalisse,eonar,384,warlock,destruction,6,4,2
42204,Vicnutz,tichondrius,384,warlock,destruction,6,4,2
42205,Zhing,frostmourne,384,warlock,destruction,6,4,2
42206,Kractdlk,tichondrius,384,warlock,destruction,6,4,2
42207,Mithlock,azralon,384,warlock,destruction,6,4,2
42208,Cowboydann,malganis,384,warlock,destruction,6,4,2
42209,Superspreadr,silvermoon,384,warlock,destruction,6,4,2
42210,Tichondrus,ragnaros,384,warlock,destruction,6,4,2
42211,Rendori,the-scryers,384,warlock,destruction,6,4,2
42212,Iamfear,shuhalo,384,warlock,destruction,6,4,2
42213,Demonchurch,area-52,384,warlock,destruction,6,4,2
42214,Doubledigit,tichondrius,384,warlock,destruction,6,4,2
42215,Elcidoo,tichondrius,384,warlock,destruction,6,4,2
42216,Adøràßøltz,tichondrius,384,warlock,destruction,6,4,2
42217,Litemeatlary,kelthuzad,384,warlock,destruction,6,4,2
42218,Cønsfèáracy,sargeras,384,warlock,destruction,6,4,2
42219,Bugbugg,tichondrius,384,warlock,destruction,6,4,2
42220,Donttouchme,azralon,384,warlock,destruction,6,4,2
42221,Roota,dalaran,384,warlock,destruction,6,4,2
42222,Synisterlock,moon-guard,384,warlock,destruction,6,4,2
42223,Ardamelech,quelthalas,384,warlock,destruction,6,4,2
42224,Solöw,tichondrius,384,warlock,destruction,6,4,2
42225,Zver,drakkari,384,warlock,destruction,6,4,2
42226,Syraxi,illidan,384,warlock,destruction,6,4,2
42227,Fearann,ragnaros,384,warlock,destruction,6,4,2
42228,Rhelialock,icecrown,384,warlock,destruction,6,4,2
42229,Moistpoodle,the-underbog,384,warlock,destruction,6,4,2
42230,Methrocks,emerald-dream,384,warlock,destruction,6,4,2
42231,Frem,eonar,384,warlock,destruction,6,4,2
42232,Kerrigan,the-venture-co,384,warlock,destruction,6,4,2
42233,Agla,quelthalas,384,warlock,destruction,6,4,2
42234,Tizzy,malganis,384,warlock,destruction,6,4,2
42235,Meathat,gorefiend,384,warlock,destruction,9,5,4
42236,Deathboltx,zuljin,384,warlock,destruction,9,5,4
42237,Chrönic,azralon,384,warlock,destruction,9,5,4
42238,Soulfired,kiljaeden,384,warlock,destruction,11,5,6
42239,Sumondeznuts,wyrmrest-accord,384,warlock,destruction,15,5,10
42240,Fullmelt,azjolnerub,384,warlock,destruction,12,4,8
42241,Antigotenent,sargeras,384,warlock,destruction,12,4,8
42242,Perfidien,tichondrius,384,warlock,destruction,12,4,8
42243,Persianloc,tichondrius,384,warlock,destruction,12,4,8
42244,Alexmeister,jubeithos,384,warlock,destruction,12,4,8
42245,Blumercricet,stormrage,384,warlock,destruction,12,4,8
42246,Rumpology,illidan,384,warlock,destruction,12,4,8
42247,Mostlyundead,darkspear,384,warlock,destruction,12,4,8
42248,Ionithvia,tichondrius,384,warlock,destruction,12,4,8
42249,Poisondeepnu,malganis,384,warlock,destruction,12,4,8
42250,Kelthutard,area-52,384,warlock,destruction,12,4,8
42251,Pitou,akama,384,warlock,destruction,12,4,8
42252,Offendor,stormrage,384,warlock,destruction,12,4,8
42253,Regent,nemesis,384,warlock,destruction,12,4,8
42254,Sailuhh,frostwolf,384,warlock,destruction,12,4,8
42255,Melodyh,laughing-skull,384,warlock,destruction,12,4,8
42256,Syileria,frostmourne,384,warlock,destruction,12,4,8
42257,Freezâ,stormrage,384,warlock,destruction,12,4,8
42258,Dotsamoray,frostmourne,384,warlock,destruction,12,4,8
42259,Jerclard,proudmoore,384,warlock,destruction,12,4,8
42260,Darksòúl,stormrage,384,warlock,destruction,12,4,8
42261,Letsfckingo,tichondrius,384,warlock,destruction,12,4,8
42262,Fowll,frostwolf,384,warlock,destruction,12,4,8
42263,Kholdstarev,thunderlord,384,warlock,destruction,12,4,8
42264,Dotington,frostmourne,384,warlock,destruction,12,4,8
42265,Nazrakin,malganis,384,warlock,destruction,12,4,8
42266,Praemonium,dalaran,384,warlock,destruction,12,4,8
42267,Mokushiroku,trollbane,384,warlock,destruction,12,4,8
42268,Catastrophk,malganis,384,warlock,destruction,12,4,8
42269,Stepmommie,moon-guard,384,warlock,destruction,12,4,8
42270,Hateslocks,bladefist,384,warlock,destruction,12,4,8
42271,Capslockfury,frostmourne,384,warlock,destruction,12,4,8
42272,Daedayus,frostwolf,384,warlock,destruction,12,4,8
42273,Giggideez,bleeding-hollow,384,warlock,destruction,12,4,8
42274,Capïrota,nemesis,384,warlock,destruction,12,4,8
42275,Spacedots,illidan,384,warlock,destruction,12,4,8
42276,Tarth,sargeras,384,warlock,destruction,12,4,8
42277,Overlard,illidan,384,warlock,destruction,12,4,8
42278,Dotsandchill,dalaran,384,warlock,destruction,12,4,8
42279,Flocka,agamaggan,384,warlock,destruction,12,4,8
42280,Destructing,hyjal,384,warlock,destruction,12,4,8
42281,Evarona,gorefiend,384,warlock,destruction,12,4,8
42282,Veyra,malganis,384,warlock,destruction,12,4,8
42283,Pãni,area-52,384,warlock,destruction,12,4,8
42284,Skrublockz,area-52,384,warlock,destruction,12,4,8
42285,Awangdemon,tichondrius,384,warlock,destruction,12,4,8
42286,Jáws,zuljin,384,warlock,destruction,12,4,8
42287,Puddulz,thrall,384,warlock,destruction,12,4,8
42288,Medraut,wyrmrest-accord,384,warlock,destruction,12,4,8
42289,Aededa,proudmoore,384,warlock,destruction,12,4,8
42290,Mozbet,kiljaeden,384,warlock,destruction,13,4,9
42291,Pvman,onyxia,384,warlock,destruction,18,4,14
42292,Gorski,frostwolf,383,warlock,destruction,6,4,2
42293,Destroyaz,stormreaver,383,warlock,destruction,6,4,2
42294,Thulium,dawnbringer,383,warlock,destruction,6,4,2
42295,Halkroz,nathrezim,383,warlock,destruction,6,4,2
42296,Stonelocker,stormrage,383,warlock,destruction,6,4,2
42297,Anahaldever,fenris,383,warlock,destruction,6,4,2
42298,Fearanddots,moon-guard,383,warlock,destruction,12,4,8
42299,Asheräh,stormrage,383,warlock,destruction,12,4,8
42300,Loçkshow,hyjal,383,warlock,destruction,12,4,8
42301,Coheatt,hyjal,383,warlock,destruction,12,4,8
42302,Xargeras,emerald-dream,383,warlock,destruction,12,4,8
42303,Downing,drakkari,383,warlock,destruction,12,4,8
42304,Yesmistress,thrall,383,warlock,destruction,14,4,10
42305,Necromaniac,nerzhul,383,warlock,destruction,18,4,14
42306,Kurmenos,uldum,382,warlock,destruction,6,4,2
42307,Mageline,thrall,382,warlock,destruction,18,4,14
42308,Fartonomus,illidan,381,warlock,destruction,12,4,8
42309,Vanvídd,ragnaros,351,warlock,destruction,11,4,7
42310,Cyrillus,moon-guard,351,warlock,destruction,11,4,7
42311,Gobbledeez,moknathal,349,warlock,destruction,19,5,14
42312,Gyxx,exodar,336,warlock,destruction,9,4,5
42313,Tangslock,skullcrusher,335,warlock,destruction,11,4,7
42314,Sooshi,malganis,330,warlock,destruction,11,6,5
42315,Lockazo,quelthalas,330,warlock,destruction,11,6,5
42316,Redmil,quelthalas,330,warlock,destruction,29,5,24
42317,Sojulord,sargeras,320,warlock,destruction,10,4,6
42318,Saintläurent,bleeding-hollow,319,warlock,destruction,5,4,1
42319,Lockedyaup,skullcrusher,319,warlock,destruction,8,4,4
42320,Valkynaris,chogall,319,warlock,destruction,14,4,10
42321,Xbendover,proudmoore,288,warlock,destruction,6,3,3
42322,Rockalock,burning-blade,288,warlock,destruction,6,3,3
42323,Vxms,barthilas,288,warlock,destruction,6,3,3
42324,Sweetjezuz,barthilas,288,warlock,destruction,6,3,3
42325,Voldamorte,tichondrius,288,warlock,destruction,6,3,3
42326,Anastadora,proudmoore,288,warlock,destruction,6,3,3
42327,Ärminvßuurën,barthilas,288,warlock,destruction,6,3,3
42328,Picklecatz,barthilas,288,warlock,destruction,6,3,3
42329,Signalnine,thrall,288,warlock,destruction,6,3,3
42330,Borudo,thrall,288,warlock,destruction,6,3,3
42331,Merlinsbeard,zuluhed,288,warlock,destruction,6,3,3
42332,Crafterism,barthilas,288,warlock,destruction,6,3,3
42333,Speakeasy,malygos,288,warlock,destruction,6,3,3
42334,Kronman,zuluhed,288,warlock,destruction,6,3,3
42335,Astarothe,proudmoore,288,warlock,destruction,6,3,3
42336,Feeltheviibe,zuljin,288,warlock,destruction,6,3,3
42337,Meltingface,bleeding-hollow,288,warlock,destruction,6,3,3
42338,Papablasty,nagrand,288,warlock,destruction,6,3,3
42339,Milkybøng,area-52,288,warlock,destruction,6,3,3
42340,Souldotz,proudmoore,288,warlock,destruction,6,3,3
42341,Embraces,tichondrius,288,warlock,destruction,6,3,3
42342,Mamabolts,kelthuzad,288,warlock,destruction,6,3,3
42343,Pennydrop,barthilas,288,warlock,destruction,6,3,3
42344,Firemike,kelthuzad,288,warlock,destruction,6,3,3
42345,Mylock,andorhal,288,warlock,destruction,6,3,3
42346,Ijustsharded,area-52,288,warlock,destruction,6,3,3
42347,Thisisturtle,area-52,288,warlock,destruction,6,3,3
42348,Oleg,bleeding-hollow,288,warlock,destruction,6,3,3
42349,Mastroguise,illidan,288,warlock,destruction,6,3,3
42350,Crucifieds,tichondrius,288,warlock,destruction,6,3,3
42351,Notdiesel,thrall,288,warlock,destruction,6,3,3
42352,Odelgabiana,area-52,288,warlock,destruction,6,3,3
42353,Æsidius,tichondrius,288,warlock,destruction,6,3,3
42354,Shawzyy,tichondrius,288,warlock,destruction,6,3,3
42355,Gurlock,illidan,288,warlock,destruction,6,3,3
42356,Amuros,illidan,288,warlock,destruction,6,3,3
42357,Rumplefust,thrall,288,warlock,destruction,6,3,3
42358,Poggyjones,tichondrius,288,warlock,destruction,6,3,3
42359,Dìpndots,wyrmrest-accord,288,warlock,destruction,6,3,3
42360,Gotfear,zuljin,288,warlock,destruction,6,3,3
42361,Héllboy,akama,288,warlock,destruction,6,3,3
42362,Creedmore,sargeras,288,warlock,destruction,6,3,3
42363,Warlooch,area-52,288,warlock,destruction,6,3,3
42364,Gingerlock,stonemaul,288,warlock,destruction,6,3,3
42365,Geofar,bleeding-hollow,288,warlock,destruction,6,3,3
42366,Lillpfudd,area-52,288,warlock,destruction,6,3,3
42367,Shädowflame,bleeding-hollow,288,warlock,destruction,6,3,3
42368,Joung,tichondrius,288,warlock,destruction,6,3,3
42369,Ovoíd,area-52,288,warlock,destruction,6,3,3
42370,Dohmie,argent-dawn,288,warlock,destruction,6,3,3
42371,Nutzosaurus,darkspear,288,warlock,destruction,6,3,3
42372,Fungiforest,kelthuzad,288,warlock,destruction,6,3,3
42373,Eliphas,bronzebeard,288,warlock,destruction,6,3,3
42374,Phénom,tichondrius,288,warlock,destruction,6,3,3
42375,Deejaye,frostmourne,288,warlock,destruction,6,3,3
42376,Tiptonb,tichondrius,288,warlock,destruction,6,3,3
42377,Dashaad,illidan,288,warlock,destruction,6,3,3
42378,Pillçosby,tichondrius,288,warlock,destruction,6,3,3
42379,Gümbÿ,illidan,288,warlock,destruction,6,3,3
42380,Lübelock,illidan,288,warlock,destruction,6,3,3
42381,Sàill,tichondrius,288,warlock,destruction,6,3,3
42382,Hamdulla,tichondrius,288,warlock,destruction,6,3,3
42383,Ökïlôck,proudmoore,288,warlock,destruction,6,3,3
42384,Ragnorök,medivh,288,warlock,destruction,6,3,3
42385,Maleficist,bleeding-hollow,288,warlock,destruction,6,3,3
42386,Gildedknight,arthas,288,warlock,destruction,6,3,3
42387,Famouslos,anetheron,288,warlock,destruction,6,3,3
42388,Karter,anetheron,288,warlock,destruction,6,3,3
42389,Zuelu,tichondrius,288,warlock,destruction,6,3,3
42390,Cancer,bloodscalp,288,warlock,destruction,6,3,3
42391,Hauntgød,tichondrius,288,warlock,destruction,6,3,3
42392,Drskeeters,malganis,288,warlock,destruction,6,3,3
42393,Vetadul,proudmoore,288,warlock,destruction,6,3,3
42394,Nihilus,anvilmar,288,warlock,destruction,6,3,3
42395,Avadakedavra,warsong,288,warlock,destruction,6,3,3
42396,Felsgoodman,illidan,288,warlock,destruction,6,3,3
42397,Famelol,tichondrius,288,warlock,destruction,6,3,3
42398,Jishtructo,frostmourne,288,warlock,destruction,6,3,3
42399,Neversoft,bleeding-hollow,288,warlock,destruction,6,3,3
42400,Xephostwo,area-52,288,warlock,destruction,6,3,3
42401,Lockabeesha,chogall,288,warlock,destruction,6,3,3
42402,Siphoned,darkspear,288,warlock,destruction,6,3,3
42403,Discordance,zuljin,288,warlock,destruction,6,3,3
42404,Ðëâthløck,tichondrius,288,warlock,destruction,6,3,3
42405,Bushmelded,tichondrius,288,warlock,destruction,6,3,3
42406,Ratedtorgast,illidan,288,warlock,destruction,6,3,3
42407,Babylung,bleeding-hollow,288,warlock,destruction,6,3,3
42408,Velvalla,chogall,288,warlock,destruction,6,3,3
42409,Imports,tichondrius,288,warlock,destruction,6,3,3
42410,Hairydottr,malganis,288,warlock,destruction,6,3,3
42411,Drelgun,aerie-peak,288,warlock,destruction,6,3,3
42412,Sorath,blackrock,288,warlock,destruction,6,3,3
42413,Darthzugzug,gorefiend,288,warlock,destruction,6,3,3
42414,Tamzlock,the-forgotten-coast,288,warlock,destruction,6,3,3
42415,Unquit,frostmourne,288,warlock,destruction,6,3,3
42416,Dotbot,blades-edge,288,warlock,destruction,6,3,3
42417,Ñevaeh,emerald-dream,288,warlock,destruction,6,3,3
42418,Shâdowman,stormrage,288,warlock,destruction,6,3,3
42419,Stretchmark,stormrage,288,warlock,destruction,6,3,3
42420,Blakedogx,tichondrius,288,warlock,destruction,6,3,3
42421,Tomathus,moon-guard,288,warlock,destruction,6,3,3
42422,Mfcalamity,uldum,288,warlock,destruction,6,3,3
42423,Cocoabuttâ,stormrage,288,warlock,destruction,6,3,3
42424,Niétzsché,emerald-dream,288,warlock,destruction,6,3,3
42425,Fearlok,malorne,288,warlock,destruction,6,3,3
42426,Nergoul,stormrage,288,warlock,destruction,6,3,3
42427,Nismo,trollbane,288,warlock,destruction,6,3,3
42428,Dluttysots,emerald-dream,288,warlock,destruction,6,3,3
42429,Carpedemon,malganis,288,warlock,destruction,6,3,3
42430,Trainwreck,sargeras,288,warlock,destruction,6,3,3
42431,Feardr,frostmourne,288,warlock,destruction,6,3,3
42432,Porsimorgis,firetree,288,warlock,destruction,6,3,3
42433,Hëctic,nerzhul,288,warlock,destruction,6,3,3
42434,Noslock,aegwynn,288,warlock,destruction,6,3,3
42435,Rerolledfotm,sargeras,288,warlock,destruction,6,3,3
42436,Feartool,stormrage,288,warlock,destruction,6,3,3
42437,Maledictivus,stormrage,288,warlock,destruction,6,3,3
42438,Bazeni,frostmourne,288,warlock,destruction,6,3,3
42439,Fatass,cairne,288,warlock,destruction,6,3,3
42440,Devi,destromath,288,warlock,destruction,6,3,3
42441,Shifulock,azralon,288,warlock,destruction,6,3,3
42442,Aruotnof,nemesis,288,warlock,destruction,6,3,3
42443,Ägnar,nemesis,288,warlock,destruction,6,3,3
42444,Soulbane,tol-barad,288,warlock,destruction,6,3,3
42445,Silkxy,frostwolf,288,warlock,destruction,6,3,3
42446,Toxicatedz,azralon,288,warlock,destruction,6,3,3
42447,Larsiezwei,spirestone,288,warlock,destruction,6,3,3
42448,Tacolock,azshara,288,warlock,destruction,6,3,3
42449,Slothdots,tichondrius,288,warlock,destruction,6,3,3
42450,Saffuky,frostmourne,288,warlock,destruction,6,3,3
42451,Reyaena,moon-guard,288,warlock,destruction,6,3,3
42452,Atheô,ragnaros,288,warlock,destruction,6,3,3
42453,Gasgrassnass,sargeras,288,warlock,destruction,6,3,3
42454,Itsawarlock,thunderlord,288,warlock,destruction,6,3,3
42455,Warlockluo,tichondrius,288,warlock,destruction,6,3,3
42456,Eiram,ragnaros,288,warlock,destruction,6,3,3
42457,Bunami,kiljaeden,288,warlock,destruction,6,3,3
42458,Muchopower,ragnaros,288,warlock,destruction,6,3,3
42459,Voldormort,uldaman,288,warlock,destruction,6,3,3
42460,Blastindotz,frostmane,288,warlock,destruction,6,3,3
42461,Xblessed,stormrage,288,warlock,destruction,6,3,3
42462,Uwubolt,moon-guard,288,warlock,destruction,6,3,3
42463,Háydn,azuremyst,288,warlock,destruction,6,3,3
42464,Minos,tichondrius,288,warlock,destruction,6,3,3
42465,Feldune,sargeras,288,warlock,destruction,6,3,3
42466,Berszerk,quelthalas,288,warlock,destruction,6,3,3
42467,Metaphors,stormrage,288,warlock,destruction,6,3,3
42468,Nòpê,tichondrius,288,warlock,destruction,6,3,3
42469,Bhalthazar,staghelm,288,warlock,destruction,6,3,3
42470,Dogcookie,moon-guard,288,warlock,destruction,6,3,3
42471,Reallygud,tichondrius,288,warlock,destruction,6,3,3
42472,Mokulock,tichondrius,288,warlock,destruction,6,3,3
42473,Shadøwcrits,quelthalas,288,warlock,destruction,6,3,3
42474,Ÿoucantwin,kiljaeden,288,warlock,destruction,6,3,3
42475,Pheríe,sargeras,288,warlock,destruction,6,3,3
42476,Demtros,tichondrius,288,warlock,destruction,6,3,3
42477,Ashtak,coilfang,288,warlock,destruction,6,3,3
42478,Pennÿ,quelthalas,288,warlock,destruction,6,3,3
42479,Peterdotz,whisperwind,288,warlock,destruction,6,3,3
42480,Vampydark,quelthalas,288,warlock,destruction,6,3,3
42481,Amauder,moon-guard,288,warlock,destruction,6,3,3
42482,Blaxzlock,stormscale,288,warlock,destruction,6,3,3
42483,Chesterfear,quelthalas,288,warlock,destruction,6,3,3
42484,Liltoastii,illidan,288,warlock,destruction,7,3,4
42485,Taldaroth,moon-guard,288,warlock,destruction,7,3,4
42486,Ellipsispain,bleeding-hollow,288,warlock,destruction,7,3,4
42487,Fluximilian,azralon,288,warlock,destruction,10,4,6
42488,Prelick,illidan,288,warlock,destruction,12,3,9
42489,Drwolfman,bonechewer,288,warlock,destruction,12,3,9
42490,Shaddaj,illidan,288,warlock,destruction,12,3,9
42491,Darkhadouken,sargeras,288,warlock,destruction,12,3,9
42492,Gotty,stormrage,288,warlock,destruction,12,3,9
42493,Reluxify,dalaran,288,warlock,destruction,12,3,9
42494,Kkuldan,tichondrius,288,warlock,destruction,12,3,9
42495,Zeeref,stormrage,288,warlock,destruction,12,3,9
42496,Demondays,sargeras,288,warlock,destruction,12,3,9
42497,Sankestones,burning-legion,288,warlock,destruction,12,3,9
42498,Mireffect,auchindoun,288,warlock,destruction,12,3,9
42499,Fearfactory,lethon,288,warlock,destruction,12,3,9
42500,Rabiesdot,tichondrius,288,warlock,destruction,12,3,9
42501,Gorgaron,zuljin,288,warlock,destruction,12,3,9
42502,Wickedt,ragnaros,288,warlock,destruction,12,3,9
42503,Demonâ,ragnaros,288,warlock,destruction,12,3,9
42504,Trotndot,dragonmaw,288,warlock,destruction,12,3,9
42505,Hachiui,galakrond,288,warlock,destruction,12,3,9
42506,Markov,goldrinn,288,warlock,destruction,12,3,9
42507,Wyrelock,hyjal,288,warlock,destruction,12,3,9
42508,Gdpx,malganis,288,warlock,destruction,12,3,9
42509,Cexdragon,tichondrius,288,warlock,destruction,14,3,11
42510,Hulion,kiljaeden,288,warlock,destruction,18,3,15
42511,Gulliftonan,zuljin,288,warlock,destruction,18,3,15
42512,Izmadara,frostmane,287,warlock,destruction,6,3,3
42513,Verybaked,sargeras,287,warlock,destruction,6,3,3
42514,Brenmen,tichondrius,287,warlock,destruction,6,3,3
42515,Deatthwish,ragnaros,287,warlock,destruction,6,3,3
42516,Trrolling,jubeithos,287,warlock,destruction,12,5,7
42517,Alvatio,tichondrius,287,warlock,destruction,12,3,9
42518,Evilbacon,stormrage,287,warlock,destruction,12,3,9
42519,Drunklockdot,tichondrius,271,warlock,destruction,11,3,8
42520,Ainzeal,nagrand,256,warlock,destruction,10,4,6
42521,Sophia,wildhammer,255,warlock,destruction,8,4,4
42522,Mikejones,dawnbringer,255,warlock,destruction,14,4,10
42523,Draisien,moon-guard,250,warlock,destruction,7,5,2
42524,Warakaso,ragnaros,240,warlock,destruction,9,3,6
42525,Infectionl,ragnaros,239,warlock,destruction,5,3,2
42526,Thuglovex,sargeras,239,warlock,destruction,5,3,2
42527,Blightbeast,area-52,239,warlock,destruction,5,3,2
42528,Nawtychannel,aegwynn,239,warlock,destruction,5,3,2
42529,Vialdkaseun,muradin,239,warlock,destruction,5,3,2
42530,Azaradx,azralon,239,warlock,destruction,11,3,8
42531,Nozixx,thrall,224,warlock,destruction,10,3,7
42532,Wàtchmebolt,dalvengyr,223,warlock,destruction,8,3,5
42533,Perfidious,altar-of-storms,192,warlock,destruction,4,3,1
42534,Particles,proudmoore,192,warlock,destruction,4,3,1
42535,Portalgun,tichondrius,192,warlock,destruction,4,3,1
42536,Draindeez,sargeras,192,warlock,destruction,9,3,6
42537,Konarik,nagrand,192,warlock,destruction,6,2,4
42538,Erimegara,ragnaros,192,warlock,destruction,6,2,4
42539,Maxice,zuljin,192,warlock,destruction,6,2,4
42540,Oopsíe,nagrand,192,warlock,destruction,6,2,4
42541,Iadminl,moon-guard,192,warlock,destruction,6,2,4
42542,Ðuckworth,azralon,192,warlock,destruction,6,2,4
42543,Biznam,tichondrius,192,warlock,destruction,6,2,4
42544,Gløcked,area-52,192,warlock,destruction,6,2,4
42545,Silverfire,ragnaros,192,warlock,destruction,6,2,4
42546,Lazzie,thrall,192,warlock,destruction,6,2,4
42547,Brawndelock,stormrage,192,warlock,destruction,6,2,4
42548,Chipt,kelthuzad,192,warlock,destruction,6,2,4
42549,Imindanger,frostmourne,192,warlock,destruction,6,2,4
42550,Sn,dalaran,192,warlock,destruction,6,2,4
42551,Doomhauzer,kiljaeden,192,warlock,destruction,6,2,4
42552,Medusablood,area-52,192,warlock,destruction,6,2,4
42553,Felpuppet,barthilas,192,warlock,destruction,6,2,4
42554,Asaveyous,wyrmrest-accord,192,warlock,destruction,6,2,4
42555,Abbyshapiro,kelthuzad,192,warlock,destruction,6,2,4
42556,Disapoin,stormrage,192,warlock,destruction,6,2,4
42557,Åchse,ragnaros,192,warlock,destruction,6,2,4
42558,Diablox,silvermoon,192,warlock,destruction,6,2,4
42559,Diabolock,proudmoore,192,warlock,destruction,6,2,4
42560,Omegawarlock,quelthalas,192,warlock,destruction,6,2,4
42561,Nightterrour,frostmourne,192,warlock,destruction,6,2,4
42562,Leine,proudmoore,192,warlock,destruction,6,2,4
42563,Checkit,zuljin,192,warlock,destruction,6,2,4
42564,Zephiy,kelthuzad,192,warlock,destruction,6,2,4
42565,Terminall,quelthalas,192,warlock,destruction,6,2,4
42566,Daesire,moon-guard,192,warlock,destruction,6,2,4
42567,Bleachkk,tichondrius,192,warlock,destruction,6,2,4
42568,Dach,moon-guard,192,warlock,destruction,6,2,4
42569,Raghog,kelthuzad,192,warlock,destruction,6,2,4
42570,Dotsin,wyrmrest-accord,192,warlock,destruction,6,2,4
42571,Nazug,dark-iron,192,warlock,destruction,6,2,4
42572,Zoboo,zuljin,192,warlock,destruction,6,2,4
42573,Hadés,aerie-peak,192,warlock,destruction,6,2,4
42574,Lhorgainz,area-52,192,warlock,destruction,6,2,4
42575,Xaraki,skullcrusher,192,warlock,destruction,6,2,4
42576,Fstndantilus,moonrunner,192,warlock,destruction,6,2,4
42577,Yordich,kelthuzad,192,warlock,destruction,6,2,4
42578,Camila,lightnings-blade,192,warlock,destruction,6,2,4
42579,Sulívan,azralon,192,warlock,destruction,6,2,4
42580,Gvz,tichondrius,192,warlock,destruction,6,2,4
42581,Deiformis,malganis,192,warlock,destruction,6,2,4
42582,Darkbaron,khadgar,192,warlock,destruction,6,2,4
42583,Hadeys,amanthul,192,warlock,destruction,6,2,4
42584,Theyfearbuda,kelthuzad,192,warlock,destruction,6,2,4
42585,Encanis,dalaran,192,warlock,destruction,6,2,4
42586,Arthürr,thrall,192,warlock,destruction,6,2,4
42587,Aksanaa,area-52,192,warlock,destruction,6,2,4
42588,Gadalann,area-52,192,warlock,destruction,6,2,4
42589,Mlx,proudmoore,192,warlock,destruction,6,2,4
42590,Maniacal,shattered-halls,192,warlock,destruction,6,2,4
42591,Toxik,zuljin,192,warlock,destruction,6,2,4
42592,Cityswimmer,malganis,192,warlock,destruction,6,2,4
42593,Theboss,arygos,192,warlock,destruction,6,2,4
42594,Muffinlol,frostmourne,192,warlock,destruction,6,2,4
42595,Thotorina,tichondrius,192,warlock,destruction,6,2,4
42596,Mythh,hyjal,192,warlock,destruction,6,2,4
42597,Guisls,azralon,192,warlock,destruction,6,2,4
42598,Locksama,area-52,192,warlock,destruction,6,2,4
42599,Dotnrunn,kelthuzad,192,warlock,destruction,6,2,4
42600,Hollows,burning-blade,192,warlock,destruction,6,2,4
42601,Dotcòm,illidan,192,warlock,destruction,6,2,4
42602,Becà,stormrage,192,warlock,destruction,6,2,4
42603,Seizuresauce,stormrage,192,warlock,destruction,6,2,4
42604,Curaven,emerald-dream,192,warlock,destruction,6,2,4
42605,Mutexlock,whisperwind,192,warlock,destruction,6,2,4
42606,Mothapucka,thrall,192,warlock,destruction,6,2,4
42607,Albuuss,daggerspine,192,warlock,destruction,6,2,4
42608,Vorkaz,moon-guard,192,warlock,destruction,6,2,4
42609,Ramone,turalyon,192,warlock,destruction,6,2,4
42610,Amz,grizzly-hills,192,warlock,destruction,6,2,4
42611,Bludlock,illidan,192,warlock,destruction,6,2,4
42612,Cycaeria,moon-guard,192,warlock,destruction,6,2,4
42613,Itzlandox,emerald-dream,192,warlock,destruction,6,2,4
42614,Shanelle,korgath,192,warlock,destruction,6,2,4
42615,Pinguswalrus,stormrage,192,warlock,destruction,6,2,4
42616,Adalaya,emerald-dream,192,warlock,destruction,6,2,4
42617,Fluffylockk,bloodscalp,192,warlock,destruction,6,2,4
42618,Outlanderr,tichondrius,192,warlock,destruction,6,2,4
42619,Qbl,wyrmrest-accord,192,warlock,destruction,6,2,4
42620,Spicyfingers,illidan,192,warlock,destruction,6,2,4
42621,Moistdank,tichondrius,192,warlock,destruction,6,2,4
42622,Njunx,queldorei,192,warlock,destruction,6,2,4
42623,Selitose,illidan,192,warlock,destruction,6,2,4
42624,Theredwolf,zuljin,192,warlock,destruction,6,2,4
42625,Musgrin,gallywix,192,warlock,destruction,6,2,4
42626,Luciffer,windrunner,192,warlock,destruction,6,2,4
42627,Sugarfire,nemesis,192,warlock,destruction,6,2,4
42628,Actualjoke,frostmourne,192,warlock,destruction,6,2,4
42629,Ibanez,bleeding-hollow,192,warlock,destruction,6,2,4
42630,Nüts,blackrock,192,warlock,destruction,6,2,4
42631,Apokálipse,frostmourne,192,warlock,destruction,6,2,4
42632,Nameflagged,arathor,192,warlock,destruction,6,2,4
42633,Poltergiiest,korgath,192,warlock,destruction,6,2,4
42634,Dihva,malganis,192,warlock,destruction,6,2,4
42635,Sinissa,ysondre,192,warlock,destruction,6,2,4
42636,Kuaa,illidan,192,warlock,destruction,6,2,4
42637,Dotzlol,jubeithos,192,warlock,destruction,6,2,4
42638,Fantumz,illidan,192,warlock,destruction,6,2,4
42639,Cholock,anubarak,192,warlock,destruction,6,2,4
42640,Montaine,malganis,192,warlock,destruction,6,2,4
42641,Rococo,emerald-dream,192,warlock,destruction,6,2,4
42642,Fjklock,nemesis,192,warlock,destruction,6,2,4
42643,Cthuga,frostmourne,192,warlock,destruction,6,2,4
42644,Ricklock,aggramar,192,warlock,destruction,6,2,4
42645,Reckzet,stormrage,192,warlock,destruction,6,2,4
42646,Raisa,chogall,192,warlock,destruction,6,2,4
42647,Sinnâcle,illidan,192,warlock,destruction,6,2,4
42648,Vetic,area-52,192,warlock,destruction,6,2,4
42649,Lexist,darkspear,192,warlock,destruction,6,2,4
42650,Sinsky,darkspear,192,warlock,destruction,6,2,4
42651,Tirisfel,tichondrius,192,warlock,destruction,6,2,4
42652,Srz,stormrage,192,warlock,destruction,6,2,4
42653,Morganith,ravenholdt,192,warlock,destruction,6,2,4
42654,Sorenbjerga,zuljin,192,warlock,destruction,6,2,4
42655,Dpz,darkspear,192,warlock,destruction,6,2,4
42656,Nuradzec,illidan,192,warlock,destruction,6,2,4
42657,Demonia,dathremar,192,warlock,destruction,6,2,4
42658,Lolokayhaha,vashj,192,warlock,destruction,6,2,4
42659,Scaryðreams,malganis,192,warlock,destruction,6,2,4
42660,Ourlegacy,tichondrius,192,warlock,destruction,6,2,4
42661,Cynnd,tichondrius,192,warlock,destruction,6,2,4
42662,Infant,agamaggan,192,warlock,destruction,6,2,4
42663,Gihaewon,tichondrius,192,warlock,destruction,6,2,4
42664,Æonas,bladefist,192,warlock,destruction,6,2,4
42665,Shredlock,tichondrius,192,warlock,destruction,6,2,4
42666,Deathwishiz,tichondrius,192,warlock,destruction,6,2,4
42667,Startx,tichondrius,192,warlock,destruction,6,2,4
42668,Voltshot,tichondrius,192,warlock,destruction,6,2,4
42669,Petez,sargeras,192,warlock,destruction,6,2,4
42670,Savemykoalas,tichondrius,192,warlock,destruction,6,2,4
42671,Pikkon,malorne,192,warlock,destruction,6,2,4
42672,Lõck,tichondrius,192,warlock,destruction,6,2,4
42673,Innerforce,tichondrius,192,warlock,destruction,6,2,4
42674,Ðamndaddy,sargeras,192,warlock,destruction,6,2,4
42675,Ballpain,sargeras,192,warlock,destruction,6,2,4
42676,Dedremus,korialstrasz,192,warlock,destruction,6,2,4
42677,Deanwarlock,sargeras,192,warlock,destruction,6,2,4
42678,Geauxst,tichondrius,192,warlock,destruction,6,2,4
42679,Cauldron,tichondrius,192,warlock,destruction,6,2,4
42680,Xalcezar,sargeras,192,warlock,destruction,6,2,4
42681,Deathteller,tichondrius,192,warlock,destruction,6,2,4
42682,Whydemono,tichondrius,192,warlock,destruction,10,2,8
42683,Asumi,nemesis,192,warlock,destruction,12,2,10
42684,Moknuhg,emerald-dream,192,warlock,destruction,12,2,10
42685,Bladebank,kirin-tor,192,warlock,destruction,12,2,10
42686,Daggondai,tichondrius,192,warlock,destruction,12,2,10
42687,Wizie,arthas,192,warlock,destruction,12,2,10
42688,Luntrazz,arthas,192,warlock,destruction,12,2,10
42689,Dapperdanxy,tichondrius,192,warlock,destruction,12,2,10
42690,Kandrus,moon-guard,192,warlock,destruction,12,2,10
42691,Abramerlin,tichondrius,192,warlock,destruction,12,2,10
42692,Beamac,cenarius,192,warlock,destruction,14,2,12
42693,Thediaz,quelthalas,191,warlock,destruction,6,2,4
42694,Mystickittie,aerie-peak,191,warlock,destruction,6,2,4
42695,Eldrien,spirestone,191,warlock,destruction,12,2,10
42696,Mìrä,kelthuzad,175,warlock,destruction,11,2,9
42697,Prds,illidan,159,warlock,destruction,5,2,3
42698,Fearfeaster,tichondrius,159,warlock,destruction,5,2,3
42699,Eatmyboltz,hyjal,159,warlock,destruction,5,2,3
42700,Hayhatchie,nagrand,159,warlock,destruction,5,2,3
42701,Dotyoazz,stormrage,159,warlock,destruction,5,2,3
42702,Fengfeiss,tichondrius,144,warlock,destruction,3,3,0
42703,Olsdead,aegwynn,138,warlock,destruction,6,3,3
42704,Ganondolph,sargeras,138,warlock,destruction,9,3,6
42705,Catarina,kaelthas,128,warlock,destruction,4,2,2
42706,Miggazzizle,senjin,128,warlock,destruction,4,2,2
42707,Rosacrutian,tichondrius,128,warlock,destruction,4,2,2
42708,Hentailust,kiljaeden,128,warlock,destruction,4,2,2
42709,Thegoatmen,stormrage,128,warlock,destruction,4,2,2
42710,Oreo,velen,112,warlock,destruction,7,2,5
42711,Willsayan,ragnaros,96,warlock,destruction,3,2,1
42712,Ministàff,ursin,96,warlock,destruction,3,2,1
42713,Crankak,zuljin,96,warlock,destruction,3,2,1
42714,Goodforyou,stormscale,96,warlock,destruction,3,2,1
42715,Flemball,aegwynn,96,warlock,destruction,9,2,7
42716,Niubeelol,tichondrius,96,warlock,destruction,6,1,5
42717,Darkmatter,frostmourne,96,warlock,destruction,6,1,5
42718,Chilevael,sargeras,96,warlock,destruction,6,1,5
42719,Demonellea,frostmourne,96,warlock,destruction,6,1,5
42720,Charlîe,vashj,96,warlock,destruction,6,1,5
42721,Juwi,frostmourne,96,warlock,destruction,6,1,5
42722,Lazymongoose,frostmourne,96,warlock,destruction,6,1,5
42723,Mazip,vashj,96,warlock,destruction,6,1,5
42724,Digylock,kelthuzad,96,warlock,destruction,6,1,5
42725,Siinistuh,tichondrius,96,warlock,destruction,6,1,5
42726,Demonist,moon-guard,96,warlock,destruction,6,1,5
42727,Vexxes,malganis,96,warlock,destruction,6,1,5
42728,Cornboil,tichondrius,96,warlock,destruction,6,1,5
42729,Gibkii,tichondrius,96,warlock,destruction,6,1,5
42730,Yallsdead,frostmourne,96,warlock,destruction,6,1,5
42731,Alcorick,moon-guard,96,warlock,destruction,6,1,5
42732,Saytiri,tichondrius,96,warlock,destruction,6,1,5
42733,Mílkduds,zuljin,96,warlock,destruction,6,1,5
42734,Amour,wyrmrest-accord,96,warlock,destruction,6,1,5
42735,Bitrot,jubeithos,96,warlock,destruction,6,1,5
42736,Biigdaddyy,kelthuzad,96,warlock,destruction,6,1,5
42737,Mônkêy,kelthuzad,96,warlock,destruction,6,1,5
42738,Acribal,quelthalas,96,warlock,destruction,6,1,5
42739,Proletariat,moon-guard,96,warlock,destruction,6,1,5
42740,Taddedlock,kelthuzad,96,warlock,destruction,6,1,5
42741,Crushbucket,stormreaver,96,warlock,destruction,6,1,5
42742,Gamecobra,greymane,96,warlock,destruction,6,1,5
42743,Hinatasu,greymane,96,warlock,destruction,6,1,5
42744,Xaryus,barthilas,96,warlock,destruction,6,1,5
42745,Lawkdown,dark-iron,96,warlock,destruction,6,1,5
42746,Kaotiq,area-52,96,warlock,destruction,6,1,5
42747,Infear,area-52,96,warlock,destruction,6,1,5
42748,Scatach,area-52,96,warlock,destruction,6,1,5
42749,Erindevil,demon-soul,96,warlock,destruction,6,1,5
42750,Druzzaj,thrall,96,warlock,destruction,6,1,5
42751,Basticor,moon-guard,96,warlock,destruction,6,1,5
42752,Stonelocke,area-52,96,warlock,destruction,6,1,5
42753,Killulock,area-52,96,warlock,destruction,6,1,5
42754,Däemön,area-52,96,warlock,destruction,6,1,5
42755,Lokiiee,azuremyst,96,warlock,destruction,6,1,5
42756,Elaïla,area-52,96,warlock,destruction,6,1,5
42757,Lockedinn,mannoroth,96,warlock,destruction,6,1,5
42758,Kuasta,shadowmoon,96,warlock,destruction,6,1,5
42759,Shidded,lightbringer,96,warlock,destruction,6,1,5
42760,Tartamuda,ragnaros,96,warlock,destruction,6,1,5
42761,Mythsubpar,tichondrius,96,warlock,destruction,6,1,5
42762,Plaguelnc,illidan,96,warlock,destruction,6,1,5
42763,Wesyane,anetheron,96,warlock,destruction,6,1,5
42764,Yuengling,illidan,96,warlock,destruction,6,1,5
42765,Catdog,bleeding-hollow,96,warlock,destruction,6,1,5
42766,Mcpickl,illidan,96,warlock,destruction,6,1,5
42767,Ezgamejr,tichondrius,96,warlock,destruction,6,1,5
42768,Wickedicky,alleria,96,warlock,destruction,6,1,5
42769,Lilintrovert,illidan,96,warlock,destruction,6,1,5
42770,Belfomént,ragnaros,96,warlock,destruction,6,1,5
42771,Heffyboi,frostmourne,96,warlock,destruction,6,1,5
42772,Fearxd,maiev,96,warlock,destruction,6,1,5
42773,Medivhz,tichondrius,96,warlock,destruction,6,1,5
42774,Kothoped,wyrmrest-accord,96,warlock,destruction,6,1,5
42775,Rëappér,ragnaros,96,warlock,destruction,6,1,5
42776,Karpawarlock,ragnaros,96,warlock,destruction,6,1,5
42777,Gsr,bleeding-hollow,96,warlock,destruction,6,1,5
42778,Pspot,kiljaeden,96,warlock,destruction,6,1,5
42779,Koillock,bleeding-hollow,96,warlock,destruction,6,1,5
42780,Resima,stormscale,96,warlock,destruction,6,1,5
42781,Plaguedoctor,stormrage,96,warlock,destruction,6,1,5
42782,Adlfcritler,emerald-dream,96,warlock,destruction,6,1,5
42783,Ashlëen,ragnaros,96,warlock,destruction,6,1,5
42784,Lilcarmy,emerald-dream,96,warlock,destruction,6,1,5
42785,Badufin,azralon,96,warlock,destruction,6,1,5
42786,Kurtcodrain,blackhand,96,warlock,destruction,6,1,5
42787,Bfaclâssic,zuljin,96,warlock,destruction,6,1,5
42788,Sheara,silver-hand,96,warlock,destruction,6,1,5
42789,Brothadoinks,zuljin,96,warlock,destruction,6,1,5
42790,Ãids,khadgar,96,warlock,destruction,6,1,5
42791,Spellbøund,malorne,96,warlock,destruction,6,1,5
42792,Tubarão,azralon,96,warlock,destruction,6,1,5
42793,Kraguenöth,drakkari,96,warlock,destruction,6,1,5
42794,Dotomizer,moonrunner,96,warlock,destruction,6,1,5
42795,Vendareth,earthen-ring,96,warlock,destruction,6,1,5
42796,Meinhundin,stormrage,96,warlock,destruction,6,1,5
42797,Deadlockz,stormrage,96,warlock,destruction,6,1,5
42798,Lucifuhrerr,tichondrius,96,warlock,destruction,6,1,5
42799,Monstir,sargeras,96,warlock,destruction,6,1,5
42800,Lokinzz,tichondrius,96,warlock,destruction,6,1,5
42801,Jill,thunderhorn,96,warlock,destruction,6,1,5
42802,Lizlock,stormrage,96,warlock,destruction,6,1,5
42803,Cursenkill,sargeras,96,warlock,destruction,6,1,5
42804,Vandenso,stormrage,96,warlock,destruction,6,1,5
42805,Gulgrin,eldrethalas,96,warlock,destruction,6,1,5
42806,Delaye,tichondrius,96,warlock,destruction,6,1,5
42807,Seutóóbinha,stormrage,96,warlock,destruction,6,1,5
42808,Radii,bladefist,96,warlock,destruction,6,1,5
42809,Jiwonpark,goldrinn,96,warlock,destruction,6,1,5
42810,Bosshoglock,whisperwind,96,warlock,destruction,6,1,5
42811,Voky,whisperwind,96,warlock,destruction,6,1,5
42812,Wherelock,area-52,96,warlock,destruction,7,1,6
42813,Solrad,illidan,95,warlock,destruction,9,2,7
42814,Anubís,vashj,79,warlock,destruction,5,1,4
42815,Epicgaymer,zuljin,79,warlock,destruction,5,1,4
42816,Felse,stormrage,64,warlock,destruction,10,1,9
42817,Bagn,tichondrius,63,warlock,destruction,2,2,0
42818,Thiccdoinkz,tichondrius,63,warlock,destruction,2,2,0
42819,Brockdot,tichondrius,63,warlock,destruction,2,2,0
42820,Cokelime,sargeras,63,warlock,destruction,2,2,0
42821,Aoneandatwo,proudmoore,48,warlock,destruction,3,1,2
42822,ßenafflock,wyrmrest-accord,48,warlock,destruction,3,1,2
42823,Clevingert,frostmourne,48,warlock,destruction,3,1,2
42824,Kosugi,kelthuzad,42,warlock,destruction,8,2,6
42825,Amarexd,stormrage,31,warlock,destruction,2,1,1
42826,Earllock,sargeras,31,warlock,destruction,2,1,1
42827,Moräl,frostmourne,31,warlock,destruction,2,1,1
42828,Emurog,icecrown,30,warlock,destruction,12,6,6
42829,Goofhu,sargeras,2270,warlock,affliction,102,62,40
42830,Exgenshinpro,proudmoore,2257,warlock,affliction,154,86,68
42831,Goofgg,sargeras,2152,warlock,affliction,287,144,143
42832,Yandhi,bronzebeard,2129,warlock,affliction,46,30,16
42833,Dewandoritos,kelthuzad,2088,warlock,affliction,111,54,57
42834,Dotdzdotdoze,tichondrius,2077,warlock,affliction,221,118,103
42835,Rangrang,tichondrius,1995,warlock,affliction,72,37,35
42836,Tcchiu,tichondrius,1982,warlock,affliction,35,24,11
42837,Sphoo,tichondrius,1971,warlock,affliction,82,42,40
42838,Exódia,tichondrius,1957,warlock,affliction,147,76,71
42839,Boyahancook,tichondrius,1925,warlock,affliction,76,44,32
42840,Diminish,sargeras,1923,warlock,affliction,78,39,39
42841,Arityy,tichondrius,1919,warlock,affliction,78,41,37
42842,Hiro,steamwheedle-cartel,1908,warlock,affliction,51,37,14
42843,Dyenamik,stormrage,1891,warlock,affliction,60,33,27
42844,Burtreynolds,shattered-hand,1884,warlock,affliction,54,30,24
42845,Yellowfevr,thrall,1870,warlock,affliction,48,27,21
42846,Limeriax,emerald-dream,1869,warlock,affliction,102,59,43
42847,Jukethisxo,tichondrius,1863,warlock,affliction,99,59,40
42848,Pardoned,stormrage,1859,warlock,affliction,41,20,21
42849,Hyoozy,illidan,1846,warlock,affliction,94,52,42
42850,Rangz,tichondrius,1842,warlock,affliction,54,31,23
42851,Renosa,illidan,1818,warlock,affliction,57,32,25
42852,Prnhbgødx,sargeras,1818,warlock,affliction,42,22,20
42853,Lockhippo,illidan,1818,warlock,affliction,58,30,28
42854,Bugbugg,tichondrius,1814,warlock,affliction,51,38,13
42855,Fallenis,proudmoore,1812,warlock,affliction,36,24,12
42856,Woopie,malfurion,1809,warlock,affliction,53,29,24
42857,Hilzin,area-52,1808,warlock,affliction,66,40,26
42858,Dotplaystyle,blackrock,1806,warlock,affliction,90,42,48
42859,Widenose,agamaggan,1805,warlock,affliction,47,29,18
42860,Octopus,nerzhul,1803,warlock,affliction,53,29,24
42861,Warlocknroll,frostmourne,1803,warlock,affliction,47,21,26
42862,Dröwzy,sargeras,1801,warlock,affliction,48,25,23
42863,Phlares,stormrage,1798,warlock,affliction,71,30,41
42864,Oymmander,illidan,1795,warlock,affliction,30,22,8
42865,Lostlock,sargeras,1792,warlock,affliction,108,60,48
42866,Vialdkaseun,muradin,1788,warlock,affliction,96,50,46
42867,Eh,laughing-skull,1777,warlock,affliction,120,61,59
42868,Lucyloux,sargeras,1775,warlock,affliction,40,23,17
42869,Gry,malganis,1767,warlock,affliction,34,19,15
42870,Duukka,malganis,1763,warlock,affliction,47,28,19
42871,Ezgamejr,tichondrius,1740,warlock,affliction,52,30,22
42872,Baxmoney,malganis,1740,warlock,affliction,48,19,29
42873,Jimmyvagene,area-52,1736,warlock,affliction,59,26,33
42874,Cumbledora,kelthuzad,1730,warlock,affliction,36,22,14
42875,Beetlejoos,stormreaver,1727,warlock,affliction,86,46,40
42876,Cocaineparty,tichondrius,1697,warlock,affliction,96,49,47
42877,Locklist,frostmourne,1695,warlock,affliction,78,41,37
42878,Fatals,thrall,1694,warlock,affliction,54,28,26
42879,Cslice,magtheridon,1686,warlock,affliction,36,20,16
42880,Beamin,dentarg,1683,warlock,affliction,42,27,15
42881,Àfflìction,tichondrius,1683,warlock,affliction,101,54,47
42882,Ticktickdoom,sargeras,1683,warlock,affliction,74,36,38
42883,Liarz,tichondrius,1667,warlock,affliction,72,36,36
42884,Mornnah,dalaran,1665,warlock,affliction,48,20,28
42885,Kopium,tichondrius,1645,warlock,affliction,36,24,12
42886,Dottcha,blackrock,1643,warlock,affliction,60,37,23
42887,Wojii,kelthuzad,1636,warlock,affliction,44,24,20
42888,Matrielan,azshara,1629,warlock,affliction,78,49,29
42889,Unsee,sargeras,1623,warlock,affliction,54,33,21
42890,Portalgun,tichondrius,1617,warlock,affliction,42,21,21
42891,Strudelfears,tichondrius,1612,warlock,affliction,71,48,23
42892,Fancynuts,kiljaeden,1609,warlock,affliction,30,17,13
42893,Urwjoa,tichondrius,1609,warlock,affliction,74,39,35
42894,Jkun,malganis,1608,warlock,affliction,126,70,56
42895,Muffîn,moon-guard,1606,warlock,affliction,36,21,15
42896,Slothycrip,emerald-dream,1606,warlock,affliction,59,33,26
42897,Fasteddywow,arygos,1603,warlock,affliction,71,41,30
42898,Tjdotter,stormrage,1600,warlock,affliction,30,19,11
42899,Pykorrg,ragnaros,1600,warlock,affliction,47,23,24
42900,Demonkiiller,kelthuzad,1597,warlock,affliction,49,25,24
42901,Loodle,moon-guard,1594,warlock,affliction,36,21,15
42902,Waifucandy,tichondrius,1588,warlock,affliction,60,29,31
42903,Mechnite,sargeras,1586,warlock,affliction,67,31,36
42904,Xentzor,auchindoun,1585,warlock,affliction,78,39,39
42905,Parmenides,tichondrius,1584,warlock,affliction,210,110,100
42906,Damage,khadgar,1584,warlock,affliction,66,33,33
42907,Sventka,ragnaros,1578,warlock,affliction,231,116,115
42908,Mitryc,illidan,1572,warlock,affliction,43,21,22
42909,Gekku,ragnaros,1569,warlock,affliction,23,17,6
42910,Sìnister,nazgrel,1569,warlock,affliction,77,49,28
42911,Evarona,gorefiend,1565,warlock,affliction,49,23,26
42912,Mørøs,tichondrius,1561,warlock,affliction,60,42,18
42913,Aomniloltv,zuljin,1559,warlock,affliction,140,74,66
42914,Hauntgød,tichondrius,1558,warlock,affliction,66,38,28
42915,Stalezz,barthilas,1558,warlock,affliction,50,27,23
42916,Stopdot,lightnings-blade,1548,warlock,affliction,65,36,29
42917,Torowasabi,tichondrius,1548,warlock,affliction,36,19,17
42918,Vaalac,tichondrius,1547,warlock,affliction,316,155,161
42919,Dotte,tichondrius,1544,warlock,affliction,30,22,8
42920,Dautenit,illidan,1544,warlock,affliction,54,27,27
42921,Squirtwee,frostmourne,1543,warlock,affliction,54,24,30
42922,Chilipeppa,wyrmrest-accord,1538,warlock,affliction,82,39,43
42923,Elend,elune,1534,warlock,affliction,36,25,11
42924,Ðåntë,thrall,1532,warlock,affliction,62,32,30
42925,Methrocks,emerald-dream,1529,warlock,affliction,64,39,25
42926,Knothy,proudmoore,1527,warlock,affliction,36,16,20
42927,Zod,burning-legion,1525,warlock,affliction,36,17,19
42928,Dirtydotting,nerzhul,1524,warlock,affliction,30,17,13
42929,Thecat,shattered-hand,1523,warlock,affliction,18,16,2
42930,Erolidra,blackrock,1519,warlock,affliction,30,16,14
42931,Soulripped,area-52,1514,warlock,affliction,64,36,28
42932,Yanned,hakkar,1514,warlock,affliction,99,51,48
42933,Xoxoxoxoxo,lightnings-blade,1513,warlock,affliction,70,33,37
42934,Tyicuslok,tichondrius,1510,warlock,affliction,60,31,29
42935,Sheboy,moon-guard,1509,warlock,affliction,96,52,44
42936,Laurela,aegwynn,1508,warlock,affliction,48,22,26
42937,Forcedbeejay,sargeras,1502,warlock,affliction,48,24,24
42938,Sillyrabbut,kelthuzad,1491,warlock,affliction,114,60,54
42939,Adeadsaint,boulderfist,1475,warlock,affliction,35,19,16
42940,Moräl,frostmourne,1470,warlock,affliction,51,25,26
42941,Skoobler,tichondrius,1468,warlock,affliction,93,53,40
42942,Blackchinese,zuljin,1467,warlock,affliction,53,30,23
42943,Tizl,tichondrius,1465,warlock,affliction,102,50,52
42944,Yisuschríst,quelthalas,1453,warlock,affliction,39,23,16
42945,Captrollol,tichondrius,1450,warlock,affliction,37,26,11
42946,Tsalagi,sargeras,1444,warlock,affliction,37,23,14
42947,Dghuldahn,bleeding-hollow,1436,warlock,affliction,48,29,19
42948,Sinápsís,ragnaros,1423,warlock,affliction,24,15,9
42949,Maxcorrupted,sargeras,1420,warlock,affliction,24,16,8
42950,Garthbrookz,bleeding-hollow,1418,warlock,affliction,63,29,34
42951,Soulcore,area-52,1416,warlock,affliction,24,15,9
42952,Marà,ragnaros,1409,warlock,affliction,45,18,27
42953,Fowll,frostwolf,1407,warlock,affliction,85,54,31
42954,Dårkfyre,kiljaeden,1406,warlock,affliction,24,15,9
42955,Purp,vashj,1405,warlock,affliction,32,16,16
42956,Elliarquet,akama,1404,warlock,affliction,106,52,54
42957,Yuckytoetoe,emerald-dream,1400,warlock,affliction,42,24,18
42958,Søül,tichondrius,1399,warlock,affliction,30,16,14
42959,Cantibor,illidan,1398,warlock,affliction,112,60,52
42960,Diosban,malganis,1391,warlock,affliction,48,20,28
42961,Morgil,suramar,1389,warlock,affliction,39,20,19
42962,Chachanoobx,sargeras,1387,warlock,affliction,48,23,25
42963,Feoona,hyjal,1384,warlock,affliction,60,36,24
42964,Winipuhmalo,quelthalas,1384,warlock,affliction,59,33,26
42965,Sweetjuly,area-52,1378,warlock,affliction,48,31,17
42966,Gordaroth,barthilas,1372,warlock,affliction,35,21,14
42967,Hairydotter,doomhammer,1365,warlock,affliction,30,18,12
42968,Munick,spirestone,1365,warlock,affliction,30,17,13
42969,Crazikrix,area-52,1365,warlock,affliction,30,15,15
42970,Snuffe,vashj,1364,warlock,affliction,38,24,14
42971,Arillus,thrall,1364,warlock,affliction,53,29,24
42972,Jumlock,illidan,1361,warlock,affliction,42,23,19
42973,Kålêïðøsçøpê,sargeras,1343,warlock,affliction,18,14,4
42974,Steven,firetree,1342,warlock,affliction,24,14,10
42975,Hemmlock,moknathal,1342,warlock,affliction,39,19,20
42976,Dotpocket,runetotem,1342,warlock,affliction,30,14,16
42977,Irene,nagrand,1341,warlock,affliction,37,23,14
42978,Mïer,tichondrius,1341,warlock,affliction,60,34,26
42979,Uggaboogga,malganis,1338,warlock,affliction,30,14,16
42980,Swath,firetree,1335,warlock,affliction,30,14,16
42981,Karpawarlock,ragnaros,1334,warlock,affliction,66,36,30
42982,Fatuglyegirl,sargeras,1331,warlock,affliction,57,27,30
42983,Warakaso,ragnaros,1326,warlock,affliction,42,28,14
42984,Dippindots,boulderfist,1324,warlock,affliction,104,49,55
42985,Squasum,sargeras,1318,warlock,affliction,59,35,24
42986,Dercrow,quelthalas,1314,warlock,affliction,38,21,17
42987,Ialfizzle,dethecus,1309,warlock,affliction,60,26,34
42988,Violentx,tichondrius,1301,warlock,affliction,45,20,25
42989,Castngcouch,tichondrius,1296,warlock,affliction,117,62,55
42990,Fluffylockk,bloodscalp,1295,warlock,affliction,52,26,26
42991,Punished,arthas,1293,warlock,affliction,56,30,26
42992,Cuteboy,tichondrius,1288,warlock,affliction,36,21,15
42993,Mymmic,ragnaros,1288,warlock,affliction,64,30,34
42994,Whathurts,tichondrius,1287,warlock,affliction,32,23,9
42995,Zinkro,quelthalas,1286,warlock,affliction,82,47,35
42996,Wallow,thunderhorn,1285,warlock,affliction,53,29,24
42997,Aights,zuljin,1284,warlock,affliction,62,21,41
42998,Lilpewpeww,bleeding-hollow,1282,warlock,affliction,105,56,49
42999,Äffie,aerie-peak,1281,warlock,affliction,102,45,57
43000,Gregg,laughing-skull,1280,warlock,affliction,138,74,64
43001,Novichok,amanthul,1276,warlock,affliction,36,15,21
43002,Aalkaid,dathremar,1273,warlock,affliction,54,31,23
43003,Mindfulchimp,sargeras,1273,warlock,affliction,36,15,21
43004,Zamorakk,nemesis,1272,warlock,affliction,58,33,25
43005,Ragnalock,laughing-skull,1270,warlock,affliction,24,14,10
43006,Volsace,moon-guard,1267,warlock,affliction,30,14,16
43007,Lockneo,stormrage,1265,warlock,affliction,66,37,29
43008,Lisaleda,stormrage,1263,warlock,affliction,30,16,14
43009,Eyedot,stormscale,1257,warlock,affliction,18,14,4
43010,Ysnou,nemesis,1251,warlock,affliction,24,15,9
43011,Spi,chogall,1250,warlock,affliction,134,63,71
43012,Xicó,tichondrius,1248,warlock,affliction,47,20,27
43013,Barovir,tichondrius,1247,warlock,affliction,18,13,5
43014,Imadotyasan,shandris,1246,warlock,affliction,18,13,5
43015,Gurlock,illidan,1246,warlock,affliction,42,26,16
43016,Quitxmanlm,tichondrius,1245,warlock,affliction,24,13,11
43017,Eraticlock,illidan,1237,warlock,affliction,25,13,12
43018,Reckzet,stormrage,1234,warlock,affliction,24,13,11
43019,Cascades,icecrown,1228,warlock,affliction,37,19,18
43020,Killernix,drakkari,1219,warlock,affliction,54,29,25
43021,Juniorsalanu,quelthalas,1219,warlock,affliction,97,43,54
43022,Kogath,thunderlord,1209,warlock,affliction,53,29,24
43023,Phelly,frostmourne,1205,warlock,affliction,75,41,34
43024,Beelzismurph,emerald-dream,1205,warlock,affliction,30,14,16
43025,Yoyoling,illidan,1200,warlock,affliction,82,43,39
43026,Atraedes,moon-guard,1200,warlock,affliction,45,22,23
43027,Aeonss,stormrage,1196,warlock,affliction,36,16,20
43028,Zaliki,hellscream,1191,warlock,affliction,30,20,10
43029,Bashel,sargeras,1185,warlock,affliction,51,32,19
43030,Coolwipp,demon-soul,1185,warlock,affliction,109,51,58
43031,Valtimorh,ragnaros,1182,warlock,affliction,24,13,11
43032,Eightyfall,barthilas,1180,warlock,affliction,40,17,23
43033,Iainmbanks,barthilas,1178,warlock,affliction,202,94,108
43034,Nedrien,moon-guard,1177,warlock,affliction,48,27,21
43035,Pipeo,quelthalas,1177,warlock,affliction,90,50,40
43036,Batär,area-52,1171,warlock,affliction,62,26,36
43037,Poltergiiest,korgath,1164,warlock,affliction,24,13,11
43038,Khatrat,azralon,1164,warlock,affliction,106,43,63
43039,Promann,drakkari,1151,warlock,affliction,12,12,0
43040,Háydn,azuremyst,1151,warlock,affliction,18,12,6
43041,Slendyman,stormrage,1151,warlock,affliction,24,12,12
43042,Dpz,spirestone,1150,warlock,affliction,18,12,6
43043,Kruxxqt,illidan,1150,warlock,affliction,24,12,12
43044,Kyugin,goldrinn,1148,warlock,affliction,18,12,6
43045,Bigdammich,bleeding-hollow,1148,warlock,affliction,24,12,12
43046,Studious,sargeras,1139,warlock,affliction,26,15,11
43047,Skrufenjoyer,sargeras,1137,warlock,affliction,63,29,34
43048,Moxz,garona,1136,warlock,affliction,30,12,18
43049,Sugarwaffles,area-52,1135,warlock,affliction,18,12,6
43050,Azâziel,ragnaros,1128,warlock,affliction,35,17,18
43051,Flangy,kiljaeden,1123,warlock,affliction,84,33,51
43052,Sinesta,bleeding-hollow,1122,warlock,affliction,24,12,12
43053,Drskeeters,malganis,1116,warlock,affliction,26,13,13
43054,Zrx,proudmoore,1115,warlock,affliction,69,27,42
43055,Beetlegiese,doomhammer,1114,warlock,affliction,40,19,21
43056,Auntzhang,tichondrius,1101,warlock,affliction,29,12,17
43057,Phøbøs,hyjal,1099,warlock,affliction,24,13,11
43058,Dipdip,illidan,1097,warlock,affliction,63,25,38
43059,Dirtydeikan,stormrage,1082,warlock,affliction,54,26,28
43060,Yosuljaengi,stormrage,1076,warlock,affliction,42,16,26
43061,Elander,azuremyst,1067,warlock,affliction,30,17,13
43062,Finnek,moon-guard,1064,warlock,affliction,24,12,12
43063,Päinoth,wyrmrest-accord,1059,warlock,affliction,24,15,9
43064,Swinefrommud,zuljin,1056,warlock,affliction,24,11,13
43065,Varvanta,proudmoore,1051,warlock,affliction,30,11,19
43066,Beitrice,barthilas,1050,warlock,affliction,30,11,19
43067,Naburn,tichondrius,1049,warlock,affliction,24,11,13
43068,Guacamolock,drakkari,1045,warlock,affliction,24,11,13
43069,Cozu,tichondrius,1045,warlock,affliction,30,11,19
43070,Nazrakin,malganis,1042,warlock,affliction,24,11,13
43071,Mangku,frostmourne,1042,warlock,affliction,46,19,27
43072,Kimis,proudmoore,1042,warlock,affliction,30,11,19
43073,Teaset,hellscream,1039,warlock,affliction,66,33,33
43074,Rorrlex,muradin,1037,warlock,affliction,42,20,22
43075,Kokoto,azralon,1030,warlock,affliction,54,31,23
43076,Basticor,moon-guard,1024,warlock,affliction,42,18,24
43077,Aerozyn,wyrmrest-accord,1013,warlock,affliction,30,17,13
43078,Corvos,garrosh,1001,warlock,affliction,32,12,20
43079,Wizlox,illidan,996,warlock,affliction,33,11,22
43080,Miredö,tichondrius,991,warlock,affliction,17,11,6
43081,Whydemono,tichondrius,982,warlock,affliction,26,11,15
43082,Sîthfu,tichondrius,969,warlock,affliction,29,11,18
43083,Medran,azralon,966,warlock,affliction,56,30,26
43084,Avelmi,daggerspine,964,warlock,affliction,31,11,20
43085,Niubeelol,tichondrius,959,warlock,affliction,24,10,14
43086,Shadowhax,area-52,959,warlock,affliction,24,10,14
43087,Wtb,blackrock,958,warlock,affliction,18,10,8
43088,Makumbeiro,sargeras,958,warlock,affliction,18,10,8
43089,Downing,drakkari,958,warlock,affliction,71,26,45
43090,Xdq,malganis,957,warlock,affliction,27,12,15
43091,Mothapucka,thrall,955,warlock,affliction,24,10,14
43092,Mysoultotake,sargeras,954,warlock,affliction,18,10,8
43093,Acceptdeath,stormrage,954,warlock,affliction,18,10,8
43094,Munch,khadgar,954,warlock,affliction,24,10,14
43095,Jennifear,sargeras,952,warlock,affliction,18,10,8
43096,Doombaby,zuljin,952,warlock,affliction,18,10,8
43097,Shadöwdancer,uldum,943,warlock,affliction,18,12,6
43098,Avadakedávra,darkspear,941,warlock,affliction,18,10,8
43099,Donnellus,frostmane,916,warlock,affliction,18,10,8
43100,Popdotdropit,frostwolf,895,warlock,affliction,17,10,7
43101,Britainwl,azshara,892,warlock,affliction,30,13,17
43102,Sammythebull,frostwolf,880,warlock,affliction,20,10,10
43103,Quitxman,tichondrius,864,warlock,affliction,12,9,3
43104,Nöxïöüs,sargeras,864,warlock,affliction,12,9,3
43105,Crayonchewer,alleria,864,warlock,affliction,18,9,9
43106,Minglocked,proudmoore,864,warlock,affliction,18,9,9
43107,Jfet,sargeras,864,warlock,affliction,18,9,9
43108,Demonycc,archimonde,863,warlock,affliction,12,9,3
43109,Halloweèn,kelthuzad,863,warlock,affliction,12,9,3
43110,Sslock,sargeras,863,warlock,affliction,18,9,9
43111,Twilson,moon-guard,863,warlock,affliction,18,9,9
43112,Búmchúm,frostmourne,863,warlock,affliction,18,9,9
43113,Gateor,zuljin,863,warlock,affliction,18,9,9
43114,Onmyioji,dalaran,862,warlock,affliction,12,9,3
43115,Curaven,emerald-dream,862,warlock,affliction,18,9,9
43116,Scarysherri,aggramar,862,warlock,affliction,24,9,15
43117,Vardros,moon-guard,862,warlock,affliction,24,9,15
43118,Thisist,kiljaeden,861,warlock,affliction,12,9,3
43119,Nestpas,tichondrius,861,warlock,affliction,18,9,9
43120,Côp,tichondrius,861,warlock,affliction,18,9,9
43121,Vyntras,kelthuzad,861,warlock,affliction,18,9,9
43122,Bignoselock,illidan,861,warlock,affliction,18,9,9
43123,Avatar,uldum,861,warlock,affliction,24,9,15
43124,Abyssisle,malygos,860,warlock,affliction,20,10,10
43125,Holloch,bonechewer,860,warlock,affliction,18,9,9
43126,Sylencia,demon-soul,859,warlock,affliction,24,9,15
43127,Yratiprocs,ysera,853,warlock,affliction,18,9,9
43128,Hungovermate,barthilas,851,warlock,affliction,12,9,3
43129,Obertito,kelthuzad,828,warlock,affliction,16,9,7
43130,Rickrock,gnomeregan,806,warlock,affliction,26,10,16
43131,Buccs,barthilas,799,warlock,affliction,11,9,2
43132,Hexxüs,area-52,784,warlock,affliction,19,9,10
43133,Slothdots,tichondrius,768,warlock,affliction,12,8,4
43134,Kåléïðøsçøpè,sargeras,768,warlock,affliction,12,8,4
43135,Sadoldman,malganis,768,warlock,affliction,12,8,4
43136,Hutchyw,tichondrius,768,warlock,affliction,12,8,4
43137,Guldåniel,tichondrius,768,warlock,affliction,12,8,4
43138,Wreckquiem,draka,767,warlock,affliction,12,8,4
43139,Herladytha,aegwynn,767,warlock,affliction,12,8,4
43140,Juleno,quelthalas,767,warlock,affliction,12,8,4
43141,Necroñomicon,malganis,767,warlock,affliction,12,8,4
43142,Livingdead,dreadmaul,767,warlock,affliction,12,8,4
43143,Losecontrol,illidan,767,warlock,affliction,12,8,4
43144,Mattypatty,the-forgotten-coast,767,warlock,affliction,18,8,10
43145,Eastwitch,ragnaros,767,warlock,affliction,18,8,10
43146,Yeepzbytre,bleeding-hollow,767,warlock,affliction,18,8,10
43147,Oblivious,firetree,767,warlock,affliction,18,8,10
43148,Arkterris,doomhammer,766,warlock,affliction,18,8,10
43149,Flixon,tichondrius,765,warlock,affliction,12,8,4
43150,Çheesestick,dalaran,765,warlock,affliction,18,8,10
43151,Oreo,velen,765,warlock,affliction,24,8,16
43152,Aksness,stormrage,765,warlock,affliction,24,8,16
43153,Dowglips,area-52,763,warlock,affliction,18,8,10
43154,Fearocity,argent-dawn,763,warlock,affliction,18,8,10
43155,Cássandra,ragnaros,761,warlock,affliction,12,8,4
43156,Covidkillerr,tichondrius,759,warlock,affliction,13,8,5
43157,Rotfull,burning-legion,751,warlock,affliction,17,8,9
43158,Hiddentech,saurfang,719,warlock,affliction,11,8,3
43159,Darkestholy,illidan,719,warlock,affliction,17,8,9
43160,Apéx,frostmourne,716,warlock,affliction,17,8,9
43161,Amgs,frostmourne,714,warlock,affliction,23,11,12
43162,Nuckz,whisperwind,687,warlock,affliction,14,9,5
43163,Modot,tichondrius,685,warlock,affliction,23,9,14
43164,Ellneggro,zuljin,672,warlock,affliction,12,7,5
43165,Nightkiss,sargeras,672,warlock,affliction,12,7,5
43166,Bakko,tichondrius,672,warlock,affliction,12,7,5
43167,Înfy,sargeras,672,warlock,affliction,12,7,5
43168,Grimdreams,malganis,672,warlock,affliction,13,7,6
43169,Necromâncer,stormreaver,672,warlock,affliction,18,7,11
43170,Soloart,tichondrius,672,warlock,affliction,18,7,11
43171,Killhorde,thunderlord,671,warlock,affliction,12,7,5
43172,Zurp,wyrmrest-accord,671,warlock,affliction,12,7,5
43173,Benafflock,kaelthas,671,warlock,affliction,18,7,11
43174,Jìbril,stormrage,671,warlock,affliction,18,7,11
43175,Skyvre,tichondrius,670,warlock,affliction,12,7,5
43176,Kuoma,boulderfist,670,warlock,affliction,12,7,5
43177,Deusita,kelthuzad,670,warlock,affliction,18,7,11
43178,Magicbones,tichondrius,669,warlock,affliction,15,8,7
43179,Larlock,black-dragonflight,667,warlock,affliction,12,7,5
43180,Ikis,cenarion-circle,666,warlock,affliction,12,7,5
43181,Balmir,tichondrius,658,warlock,affliction,18,7,11
43182,Paparoxy,illidan,623,warlock,affliction,15,8,7
43183,Mustacheguy,tichondrius,620,warlock,affliction,23,7,16
43184,Radiscul,dragonmaw,619,warlock,affliction,17,7,10
43185,Cezarz,tichondrius,592,warlock,affliction,13,7,6
43186,Dlarenn,kelthuzad,576,warlock,affliction,12,6,6
43187,Shadøwy,nemesis,576,warlock,affliction,12,6,6
43188,Løcalplugxø,barthilas,576,warlock,affliction,12,6,6
43189,Sluglishphsh,stormrage,576,warlock,affliction,12,6,6
43190,Justganmore,tichondrius,576,warlock,affliction,12,6,6
43191,Lilcarmy,emerald-dream,576,warlock,affliction,12,6,6
43192,Khil,darkspear,576,warlock,affliction,12,6,6
43193,Arcziz,tichondrius,576,warlock,affliction,12,6,6
43194,Rakshama,chogall,576,warlock,affliction,12,6,6
43195,Nihilus,anvilmar,576,warlock,affliction,12,6,6
43196,Biubius,tichondrius,576,warlock,affliction,12,6,6
43197,Chrishasnen,moon-guard,576,warlock,affliction,12,6,6
43198,Parishiltoon,frostmourne,576,warlock,affliction,12,6,6
43199,Daëmön,stormrage,576,warlock,affliction,12,6,6
43200,Brunemon,proudmoore,576,warlock,affliction,12,6,6
43201,Lokkup,dalaran,576,warlock,affliction,12,6,6
43202,Neevius,barthilas,576,warlock,affliction,12,6,6
43203,Malagas,tichondrius,576,warlock,affliction,12,6,6
43204,Smockalock,proudmoore,575,warlock,affliction,12,6,6
43205,Shadowbo,aggramar,575,warlock,affliction,12,6,6
43206,Gødmôde,tichondrius,575,warlock,affliction,12,6,6
43207,Deatthmoon,stormrage,575,warlock,affliction,12,6,6
43208,Jhop,sargeras,575,warlock,affliction,12,6,6
43209,Valvravé,malganis,575,warlock,affliction,12,6,6
43210,Leroybrown,alterac-mountains,575,warlock,affliction,12,6,6
43211,Infortunium,sargeras,575,warlock,affliction,12,6,6
43212,Kunozonbi,malganis,575,warlock,affliction,12,6,6
43213,Holdmybeard,senjin,575,warlock,affliction,18,6,12
43214,Zuldar,tichondrius,575,warlock,affliction,18,6,12
43215,Bloodybooger,area-52,574,warlock,affliction,12,6,6
43216,Conrii,burning-blade,574,warlock,affliction,18,6,12
43217,Fyahwalka,aggramar,574,warlock,affliction,18,6,12
43218,Sind,garona,573,warlock,affliction,12,6,6
43219,Hâunted,khazgoroth,571,warlock,affliction,12,6,6
43220,Dreadloxx,whisperwind,570,warlock,affliction,12,6,6
43221,Justero,kelthuzad,569,warlock,affliction,12,6,6
43222,Kflexxpt,hydraxis,569,warlock,affliction,12,6,6
43223,Socketriver,bleeding-hollow,568,warlock,affliction,18,6,12
43224,Medallok,laughing-skull,566,warlock,affliction,18,6,12
43225,Gnock,garona,543,warlock,affliction,11,6,5
43226,Markuss,boulderfist,511,warlock,affliction,14,6,8
43227,Dotdoctor,thrall,511,warlock,affliction,16,6,10
43228,Oluluo,andorhal,510,warlock,affliction,8,6,2
43229,Beexy,sargeras,510,warlock,affliction,14,6,8
43230,Satunir,shadowsong,480,warlock,affliction,6,5,1
43231,Ttub,stormrage,480,warlock,affliction,6,5,1
43232,Freddiewill,tichondrius,480,warlock,affliction,6,5,1
43233,Antigotenent,sargeras,480,warlock,affliction,6,5,1
43234,Flòwstate,tichondrius,480,warlock,affliction,6,5,1
43235,Bigdamege,tichondrius,480,warlock,affliction,6,5,1
43236,Albright,azralon,480,warlock,affliction,6,5,1
43237,Ribman,stormrage,480,warlock,affliction,6,5,1
43238,Lunazz,tichondrius,480,warlock,affliction,6,5,1
43239,Berszerk,quelthalas,480,warlock,affliction,12,5,7
43240,Artzul,tichondrius,480,warlock,affliction,12,5,7
43241,Bwup,tichondrius,480,warlock,affliction,12,5,7
43242,Itsmedirt,malganis,480,warlock,affliction,12,5,7
43243,Perfectwar,tichondrius,480,warlock,affliction,12,5,7
43244,Tvfazedorito,kelthuzad,480,warlock,affliction,12,5,7
43245,Buboñic,area-52,480,warlock,affliction,12,5,7
43246,Astralrunner,moon-guard,480,warlock,affliction,12,5,7
43247,Chaoz,aggramar,480,warlock,affliction,12,5,7
43248,Yogurtslingr,tichondrius,480,warlock,affliction,12,5,7
43249,Cryolock,nagrand,480,warlock,affliction,12,5,7
43250,Tsmcfker,tichondrius,480,warlock,affliction,12,5,7
43251,Balveer,tichondrius,480,warlock,affliction,12,5,7
43252,Disneytoon,moon-guard,480,warlock,affliction,12,5,7
43253,Idotû,tichondrius,480,warlock,affliction,12,5,7
43254,Necrosith,ragnaros,480,warlock,affliction,15,6,9
43255,Lockring,zuljin,480,warlock,affliction,18,5,13
43256,Lockboxx,stormscale,480,warlock,affliction,18,5,13
43257,Daesire,moon-guard,480,warlock,affliction,18,5,13
43258,Pruevolf,tichondrius,479,warlock,affliction,12,5,7
43259,Morepetss,saurfang,479,warlock,affliction,12,5,7
43260,Hélà,sargeras,479,warlock,affliction,18,5,13
43261,Whitchpoison,nagrand,479,warlock,affliction,30,5,25
43262,Dravin,alleria,478,warlock,affliction,12,5,7
43263,Cityswimmer,malganis,478,warlock,affliction,12,5,7
43264,Skellisama,moon-guard,478,warlock,affliction,12,5,7
43265,Fearfactory,lethon,478,warlock,affliction,12,5,7
43266,Redbro,darkspear,478,warlock,affliction,12,5,7
43267,Suzüki,tichondrius,463,warlock,affliction,11,5,6
43268,Demfearslol,terokkar,447,warlock,affliction,11,5,6
43269,Baiano,nagrand,447,warlock,affliction,22,5,17
43270,Verrøkel,sargeras,426,warlock,affliction,11,7,4
43271,Felegance,proudmoore,426,warlock,affliction,19,6,13
43272,Fublizz,black-dragonflight,416,warlock,affliction,10,5,5
43273,Khaozx,ragnaros,416,warlock,affliction,10,5,5
43274,Onlytoez,tichondrius,416,warlock,affliction,16,5,11
43275,Åbyssal,stormrage,384,warlock,affliction,6,4,2
43276,Rbnz,kiljaeden,384,warlock,affliction,6,4,2
43277,Demoiceman,bleeding-hollow,384,warlock,affliction,6,4,2
43278,Djminuterice,bleeding-hollow,384,warlock,affliction,6,4,2
43279,Omegapasta,illidan,384,warlock,affliction,6,4,2
43280,Plsdontcrit,tichondrius,384,warlock,affliction,6,4,2
43281,Bliztivision,proudmoore,384,warlock,affliction,6,4,2
43282,Hypnotikal,illidan,384,warlock,affliction,6,4,2
43283,Methrocks,tichondrius,384,warlock,affliction,6,4,2
43284,Jessndistres,stormrage,384,warlock,affliction,6,4,2
43285,Locker,darkspear,384,warlock,affliction,6,4,2
43286,Tylandér,nordrassil,384,warlock,affliction,6,4,2
43287,Mèsut,malganis,384,warlock,affliction,6,4,2
43288,Superbroly,area-52,384,warlock,affliction,6,4,2
43289,Aroug,aggramar,384,warlock,affliction,6,4,2
43290,Blliizz,aegwynn,384,warlock,affliction,6,4,2
43291,Soulrman,tichondrius,384,warlock,affliction,6,4,2
43292,Bänno,bleeding-hollow,384,warlock,affliction,6,4,2
43293,Kryllua,tichondrius,384,warlock,affliction,6,4,2
43294,Eupheriia,thaurissan,384,warlock,affliction,6,4,2
43295,Astarõth,zuljin,384,warlock,affliction,6,4,2
43296,Celin,rivendare,384,warlock,affliction,6,4,2
43297,Tonickush,area-52,384,warlock,affliction,6,4,2
43298,Ãids,khadgar,384,warlock,affliction,6,4,2
43299,Gasgrassnass,sargeras,384,warlock,affliction,6,4,2
43300,Infecçäo,stormrage,384,warlock,affliction,6,4,2
43301,Jotkbe,ragnaros,384,warlock,affliction,6,4,2
43302,Omleaf,malganis,384,warlock,affliction,6,4,2
43303,Cowboydann,malganis,384,warlock,affliction,6,4,2
43304,Walterrør,nemesis,384,warlock,affliction,6,4,2
43305,Necroraise,boulderfist,384,warlock,affliction,9,5,4
43306,Bmó,stormrage,384,warlock,affliction,12,4,8
43307,Emptyx,tichondrius,384,warlock,affliction,12,4,8
43308,Promancer,drakkari,384,warlock,affliction,12,4,8
43309,Fksm,tichondrius,384,warlock,affliction,12,4,8
43310,Nethron,the-venture-co,384,warlock,affliction,12,4,8
43311,Fearedit,bleeding-hollow,384,warlock,affliction,12,4,8
43312,Pauldiesel,ragnaros,384,warlock,affliction,12,4,8
43313,Bharim,quelthalas,384,warlock,affliction,12,4,8
43314,Dotsfìred,tichondrius,384,warlock,affliction,12,4,8
43315,Emptysoul,illidan,384,warlock,affliction,12,4,8
43316,Yagumi,crushridge,384,warlock,affliction,12,4,8
43317,Punstable,tichondrius,384,warlock,affliction,12,4,8
43318,Tichonkimc,tichondrius,384,warlock,affliction,12,4,8
43319,Bïcho,queldorei,384,warlock,affliction,12,4,8
43320,Lockie,skywall,384,warlock,affliction,12,4,8
43321,Duckboji,tichondrius,384,warlock,affliction,12,4,8
43322,Asetiks,tichondrius,384,warlock,affliction,12,4,8
43323,Necromaniac,nerzhul,384,warlock,affliction,18,4,14
43324,Saltyfries,wildhammer,384,warlock,affliction,18,4,14
43325,Lockazo,quelthalas,383,warlock,affliction,6,4,2
43326,Krïttzïe,proudmoore,383,warlock,affliction,6,4,2
43327,Mefound,nerzhul,383,warlock,affliction,6,4,2
43328,Wirthless,area-52,383,warlock,affliction,12,4,8
43329,Luciffer,windrunner,383,warlock,affliction,12,4,8
43330,Persianloc,tichondrius,383,warlock,affliction,12,4,8
43331,Darkdestine,emerald-dream,382,warlock,affliction,12,4,8
43332,Chadre,feathermoon,351,warlock,affliction,11,4,7
43333,Damint,sargeras,351,warlock,affliction,11,4,7
43334,Gattsonn,kiljaeden,350,warlock,affliction,12,5,7
43335,Yury,scarlet-crusade,334,warlock,affliction,11,4,7
43336,Maelganis,thrall,319,warlock,affliction,11,4,7
43337,Devdolittle,tichondrius,288,warlock,affliction,6,3,3
43338,Yanlexx,stormrage,288,warlock,affliction,6,3,3
43339,Crucifieds,tichondrius,288,warlock,affliction,6,3,3
43340,Impbiscuit,stormrage,288,warlock,affliction,6,3,3
43341,Fatherbolt,tichondrius,288,warlock,affliction,6,3,3
43342,Dotfearspam,alterac-mountains,288,warlock,affliction,6,3,3
43343,Abrocket,alleria,288,warlock,affliction,6,3,3
43344,Dotymania,aegwynn,288,warlock,affliction,6,3,3
43345,Chåndler,nemesis,288,warlock,affliction,6,3,3
43346,Redsolojdc,tichondrius,288,warlock,affliction,6,3,3
43347,Berathelok,aerie-peak,288,warlock,affliction,6,3,3
43348,Schofen,tichondrius,288,warlock,affliction,6,3,3
43349,Blockk,moknathal,288,warlock,affliction,6,3,3
43350,Diablox,silvermoon,288,warlock,affliction,6,3,3
43351,Warlockmf,sargeras,288,warlock,affliction,6,3,3
43352,Phishdots,tichondrius,288,warlock,affliction,6,3,3
43353,Chaôtic,daggerspine,288,warlock,affliction,6,3,3
43354,Lockfold,illidan,288,warlock,affliction,6,3,3
43355,Kamai,frostwolf,288,warlock,affliction,6,3,3
43356,Leônidos,ghostlands,288,warlock,affliction,6,3,3
43357,Knäbue,tichondrius,288,warlock,affliction,6,3,3
43358,Voltshot,tichondrius,288,warlock,affliction,6,3,3
43359,Datazdotcom,illidan,288,warlock,affliction,6,3,3
43360,Hauntu,stormreaver,288,warlock,affliction,6,3,3
43361,Róckroad,lightnings-blade,288,warlock,affliction,6,3,3
43362,Stepzxo,sargeras,288,warlock,affliction,6,3,3
43363,Emurog,icecrown,288,warlock,affliction,6,3,3
43364,Drdoom,sargeras,288,warlock,affliction,6,3,3
43365,Dötsonurpp,stormrage,288,warlock,affliction,6,3,3
43366,Capïrota,nemesis,288,warlock,affliction,6,3,3
43367,Nutzosaurus,darkspear,288,warlock,affliction,6,3,3
43368,Oogren,korgath,288,warlock,affliction,6,3,3
43369,Nozyroh,emerald-dream,288,warlock,affliction,6,3,3
43370,Hauntx,bonechewer,288,warlock,affliction,6,3,3
43371,Freseate,quelthalas,288,warlock,affliction,6,3,3
43372,Dodgebolts,khaz-modan,288,warlock,affliction,6,3,3
43373,Lockinha,azralon,288,warlock,affliction,6,3,3
43374,Sidiouss,dreadmaul,288,warlock,affliction,6,3,3
43375,Bajheerafan,illidan,288,warlock,affliction,6,3,3
43376,Arnan,korgath,288,warlock,affliction,6,3,3
43377,Muchø,emerald-dream,288,warlock,affliction,6,3,3
43378,Warfeen,malganis,288,warlock,affliction,6,3,3
43379,Harleyjames,ravenholdt,288,warlock,affliction,6,3,3
43380,Alarauca,nerzhul,288,warlock,affliction,6,3,3
43381,Sinaman,barthilas,288,warlock,affliction,6,3,3
43382,Wizie,arthas,288,warlock,affliction,6,3,3
43383,Eilethen,cenarion-circle,288,warlock,affliction,6,3,3
43384,Goldface,frostmourne,288,warlock,affliction,6,3,3
43385,Kokushu,burning-legion,288,warlock,affliction,6,3,3
43386,Brujoalfa,ragnaros,288,warlock,affliction,6,3,3
43387,Imien,moknathal,288,warlock,affliction,9,3,6
43388,Camila,lightnings-blade,288,warlock,affliction,12,3,9
43389,Miermortal,tichondrius,288,warlock,affliction,12,3,9
43390,Grendaldots,tichondrius,288,warlock,affliction,12,3,9
43391,Mynerve,velen,288,warlock,affliction,12,3,9
43392,Ezzako,area-52,288,warlock,affliction,12,3,9
43393,Aluridan,azralon,288,warlock,affliction,12,3,9
43394,Felno,emerald-dream,288,warlock,affliction,12,3,9
43395,Ÿoucantwin,kiljaeden,288,warlock,affliction,12,3,9
43396,Lithani,ragnaros,288,warlock,affliction,12,3,9
43397,Castshadow,nordrassil,288,warlock,affliction,18,3,15
43398,Nhen,daggerspine,287,warlock,affliction,6,3,3
43399,Lowkei,stonemaul,286,warlock,affliction,6,3,3
43400,Lilthicy,sargeras,271,warlock,affliction,14,3,11
43401,Kentus,moonrunner,255,warlock,affliction,14,4,10
43402,Niava,tichondrius,239,warlock,affliction,5,3,2
43403,Matzoball,zuljin,234,warlock,affliction,14,4,10
43404,Hoana,azralon,233,warlock,affliction,8,4,4
43405,Lifelock,auchindoun,223,warlock,affliction,8,3,5
43406,Spookytrev,stormrage,223,warlock,affliction,14,3,11
43407,Kuroyt,drakkari,192,warlock,affliction,4,3,1
43408,Leruss,zangarmarsh,192,warlock,affliction,6,2,4
43409,Nerolock,frostmourne,192,warlock,affliction,6,2,4
43410,Nightterrour,frostmourne,192,warlock,affliction,6,2,4
43411,Yurick,frostmourne,192,warlock,affliction,6,2,4
43412,Sâltylôck,tichondrius,192,warlock,affliction,6,2,4
43413,Karmalock,malganis,192,warlock,affliction,6,2,4
43414,Jèdi,drenden,192,warlock,affliction,6,2,4
43415,Scepti,area-52,192,warlock,affliction,6,2,4
43416,Dawaatisme,zuljin,192,warlock,affliction,6,2,4
43417,Ministàff,ursin,192,warlock,affliction,6,2,4
43418,Sylorelol,stormreaver,192,warlock,affliction,6,2,4
43419,Døtyou,area-52,192,warlock,affliction,6,2,4
43420,Anastadora,proudmoore,192,warlock,affliction,6,2,4
43421,Xoxoxu,frostmourne,192,warlock,affliction,6,2,4
43422,Abomasnow,frostmourne,192,warlock,affliction,6,2,4
43423,Apolodys,garona,192,warlock,affliction,6,2,4
43424,Glifosáto,quelthalas,192,warlock,affliction,6,2,4
43425,Meelady,tichondrius,192,warlock,affliction,6,2,4
43426,Zörkô,zuljin,192,warlock,affliction,6,2,4
43427,Yyoyo,tichondrius,192,warlock,affliction,6,2,4
43428,Critthis,illidan,192,warlock,affliction,6,2,4
43429,Sosomaa,kelthuzad,192,warlock,affliction,6,2,4
43430,Trillas,illidan,192,warlock,affliction,6,2,4
43431,Bigheadjr,gorgonnash,192,warlock,affliction,6,2,4
43432,Charmandfarm,nerzhul,192,warlock,affliction,6,2,4
43433,Yolandahadid,gilneas,192,warlock,affliction,6,2,4
43434,Es,velen,192,warlock,affliction,6,2,4
43435,Gianni,chogall,192,warlock,affliction,6,2,4
43436,Vorlos,bonechewer,192,warlock,affliction,6,2,4
43437,Cheesëbolt,illidan,192,warlock,affliction,6,2,4
43438,Pk,azralon,192,warlock,affliction,6,2,4
43439,Dotdottgoose,kiljaeden,192,warlock,affliction,6,2,4
43440,Salival,chogall,192,warlock,affliction,6,2,4
43441,Jacorian,illidan,192,warlock,affliction,6,2,4
43442,Catarina,kaelthas,192,warlock,affliction,6,2,4
43443,Grixis,zuluhed,192,warlock,affliction,6,2,4
43444,Thralord,blackrock,192,warlock,affliction,6,2,4
43445,Dejagu,tichondrius,192,warlock,affliction,6,2,4
43446,Plaguedoctor,stormrage,192,warlock,affliction,6,2,4
43447,Willogan,gurubashi,192,warlock,affliction,6,2,4
43448,Ðeãdman,bleeding-hollow,192,warlock,affliction,6,2,4
43449,Zeraedify,bleeding-hollow,192,warlock,affliction,6,2,4
43450,Sebss,proudmoore,192,warlock,affliction,6,2,4
43451,Lockednloade,tichondrius,192,warlock,affliction,6,2,4
43452,Vessires,darkspear,192,warlock,affliction,6,2,4
43453,Damerus,illidan,192,warlock,affliction,6,2,4
43454,Khurze,area-52,192,warlock,affliction,6,2,4
43455,Screwed,tichondrius,192,warlock,affliction,6,2,4
43456,Destructo,illidan,192,warlock,affliction,6,2,4
43457,Fearanddots,moon-guard,192,warlock,affliction,6,2,4
43458,Carcine,frostwolf,192,warlock,affliction,6,2,4
43459,Asmodeun,malganis,192,warlock,affliction,6,2,4
43460,Kreatur,ragnaros,192,warlock,affliction,6,2,4
43461,Avii,drakthul,192,warlock,affliction,6,2,4
43462,Thoxy,barthilas,192,warlock,affliction,6,2,4
43463,Deanwarlock,sargeras,192,warlock,affliction,6,2,4
43464,Fondlemydot,stormscale,192,warlock,affliction,6,2,4
43465,Tribulatiön,moon-guard,192,warlock,affliction,12,2,10
43466,Leviathen,shattered-hand,192,warlock,affliction,12,2,10
43467,Tormentedcat,nazjatar,192,warlock,affliction,12,2,10
43468,Refîk,sargeras,192,warlock,affliction,12,2,10
43469,Dloq,azgalor,192,warlock,affliction,12,2,10
43470,Rurnt,bloodhoof,192,warlock,affliction,13,2,11
43471,Lilliara,korgath,159,warlock,affliction,5,2,3
43472,Ramone,turalyon,159,warlock,affliction,5,2,3
43473,Babydots,stormreaver,159,warlock,affliction,5,2,3
43474,Dotlockndrop,stormreaver,159,warlock,affliction,5,2,3
43475,Volturnus,wildhammer,96,warlock,affliction,6,1,5
43476,Efg,illidan,96,warlock,affliction,6,1,5
43477,Drainedd,blades-edge,96,warlock,affliction,6,1,5
43478,Sikmagic,kelthuzad,96,warlock,affliction,6,1,5
43479,Fabiusbilex,tichondrius,96,warlock,affliction,6,1,5
43480,Tatemor,barthilas,96,warlock,affliction,6,1,5
43481,Malignant,tichondrius,96,warlock,affliction,6,1,5
43482,Imhereforrbg,moon-guard,96,warlock,affliction,6,1,5
43483,Conspiration,sargeras,96,warlock,affliction,6,1,5
43484,Aerumna,barthilas,96,warlock,affliction,6,1,5
43485,Xylõck,sargeras,96,warlock,affliction,6,1,5
43486,Menedemus,amanthul,96,warlock,affliction,6,1,5
43487,Bluffzlock,boulderfist,96,warlock,affliction,6,1,5
43488,Gamecobra,greymane,96,warlock,affliction,6,1,5
43489,Pinkypay,ragnaros,96,warlock,affliction,6,1,5
43490,Sunkuna,aerie-peak,96,warlock,affliction,6,1,5
43491,Feár,emerald-dream,96,warlock,affliction,6,1,5
43492,Apocryphh,stormrage,96,warlock,affliction,6,1,5
43493,Malchiev,area-52,96,warlock,affliction,6,1,5
43494,Superbvious,lothar,96,warlock,affliction,6,1,5
43495,Shennaniganz,bleeding-hollow,96,warlock,affliction,6,1,5
43496,Frem,eonar,96,warlock,affliction,6,1,5
43497,Frdchickiana,tichondrius,96,warlock,affliction,6,1,5
43498,Mickylock,tichondrius,96,warlock,affliction,6,1,5
43499,Kammuany,sargeras,96,warlock,affliction,6,1,5
43500,Cornboil,tichondrius,96,warlock,affliction,6,1,5
43501,Aedarine,uldum,96,warlock,affliction,6,1,5
43502,Joseph,draktharon,96,warlock,affliction,6,1,5
43503,Carabelois,aegwynn,96,warlock,affliction,6,1,5
43504,Smôkedsôul,area-52,96,warlock,affliction,6,1,5
43505,Chaøsbolt,area-52,96,warlock,affliction,6,1,5
43506,Brujildå,area-52,96,warlock,affliction,6,1,5
43507,Guinegobbler,hyjal,96,warlock,affliction,6,1,5
43508,Olgreg,daggerspine,96,warlock,affliction,6,1,5
43509,Fenrinozil,tichondrius,96,warlock,affliction,12,1,11
43510,Shendù,stormrage,79,warlock,affliction,5,1,4
43511,Zuelu,tichondrius,64,warlock,affliction,4,1,3
43512,Mìrä,kelthuzad,48,warlock,affliction,3,1,2
43513,Delete,greymane,16,warlock,affliction,1,1,0
43514,Marinw,azralon,16,warlock,affliction,1,1,0
43515,Ttvdjrio,area-52,2200,warrior,fury,84,54,30
43516,Grimgrip,frostmane,2131,warrior,fury,92,53,39
43517,Joshiman,area-52,2124,warrior,fury,78,42,36
43518,Cabelastwo,tichondrius,2124,warrior,fury,87,46,41
43519,Americanbull,moon-guard,2119,warrior,fury,253,134,119
43520,Cabelas,tichondrius,2112,warrior,fury,89,45,44
43521,Thrator,wyrmrest-accord,2110,warrior,fury,108,55,53
43522,Riproarin,stormrage,2105,warrior,fury,92,53,39
43523,Gazzef,thrall,2041,warrior,fury,102,57,45
43524,Coldlòve,akama,2039,warrior,fury,76,45,31
43525,Veevz,proudmoore,2037,warrior,fury,78,35,43
43526,Braxxínn,tichondrius,2023,warrior,fury,42,34,8
43527,Sworda,sargeras,2017,warrior,fury,77,48,29
43528,Taras,blackhand,2006,warrior,fury,93,43,50
43529,Warqt,kelthuzad,1983,warrior,fury,89,49,40
43530,Lahired,drakkari,1967,warrior,fury,185,91,94
43531,Wienertoes,tichondrius,1963,warrior,fury,114,63,51
43532,Ragwreck,bleeding-hollow,1959,warrior,fury,68,35,33
43533,Sandronb,illidan,1938,warrior,fury,83,41,42
43534,Eno,ragnaros,1937,warrior,fury,69,46,23
43535,Alabamá,sargeras,1925,warrior,fury,36,21,15
43536,Furrytakeda,kelthuzad,1925,warrior,fury,72,39,33
43537,Biaa,tichondrius,1922,warrior,fury,60,28,32
43538,Vèév,proudmoore,1894,warrior,fury,62,41,21
43539,Mphx,tichondrius,1888,warrior,fury,48,30,18
43540,Rôxi,malganis,1884,warrior,fury,142,74,68
43541,Brodestar,sargeras,1874,warrior,fury,48,31,17
43542,Badvelic,tichondrius,1874,warrior,fury,46,28,18
43543,Zanzaa,sargeras,1870,warrior,fury,85,47,38
43544,Hlt,tichondrius,1869,warrior,fury,66,38,28
43545,Shîzu,moon-guard,1868,warrior,fury,102,67,35
43546,Cannabiddies,illidan,1860,warrior,fury,48,23,25
43547,Damonadrann,proudmoore,1859,warrior,fury,66,34,32
43548,Dowser,goldrinn,1852,warrior,fury,131,69,62
43549,Okme,tichondrius,1849,warrior,fury,60,34,26
43550,Kevy,arygos,1848,warrior,fury,42,30,12
43551,Ragemane,illidan,1841,warrior,fury,72,39,33
43552,Larrybiscuit,moon-guard,1839,warrior,fury,156,95,61
43553,Esilox,area-52,1836,warrior,fury,42,28,14
43554,Ethyrie,ragnaros,1836,warrior,fury,61,34,27
43555,Jenjang,proudmoore,1834,warrior,fury,83,52,31
43556,Brainhaze,tichondrius,1829,warrior,fury,36,21,15
43557,Ragwreckz,bleeding-hollow,1826,warrior,fury,52,32,20
43558,Soymong,frostmourne,1825,warrior,fury,116,74,42
43559,Mty,tichondrius,1824,warrior,fury,54,35,19
43560,Szauren,stormrage,1824,warrior,fury,63,31,32
43561,Apocalyptist,stormrage,1821,warrior,fury,99,58,41
43562,Thadamaja,kiljaeden,1821,warrior,fury,48,26,22
43563,Bosswin,tichondrius,1820,warrior,fury,53,28,25
43564,Skyja,quelthalas,1820,warrior,fury,42,22,20
43565,Gorehardt,illidan,1820,warrior,fury,48,22,26
43566,Veyrin,stormrage,1818,warrior,fury,138,81,57
43567,Isahri,moon-guard,1818,warrior,fury,110,64,46
43568,Orchilles,illidan,1817,warrior,fury,60,35,25
43569,Damiansuv,moon-guard,1817,warrior,fury,154,89,65
43570,Jírky,ragnaros,1816,warrior,fury,240,134,106
43571,Zujuzo,moon-guard,1815,warrior,fury,111,64,47
43572,Neôn,frostmourne,1815,warrior,fury,66,37,29
43573,Onionsauce,frostmourne,1815,warrior,fury,161,90,71
43574,Slughorn,moon-guard,1814,warrior,fury,102,53,49
43575,Kazora,zuljin,1813,warrior,fury,48,33,15
43576,Darkduke,tichondrius,1813,warrior,fury,33,21,12
43577,Donutwar,proudmoore,1813,warrior,fury,54,30,24
43578,Duxor,sargeras,1811,warrior,fury,70,41,29
43579,Barafang,wyrmrest-accord,1811,warrior,fury,234,125,109
43580,Kennäy,azralon,1810,warrior,fury,46,28,18
43581,Psychogenic,barthilas,1810,warrior,fury,102,60,42
43582,Zyzz,scarlet-crusade,1807,warrior,fury,72,41,31
43583,Killuall,sargeras,1807,warrior,fury,42,23,19
43584,Yawdamper,illidan,1805,warrior,fury,51,32,19
43585,Starshattr,bleeding-hollow,1805,warrior,fury,108,64,44
43586,Seoní,wyrmrest-accord,1805,warrior,fury,76,43,33
43587,Girioo,thrall,1802,warrior,fury,24,19,5
43588,Franticlol,tichondrius,1802,warrior,fury,90,59,31
43589,Cubie,malganis,1802,warrior,fury,75,40,35
43590,Tøpg,sargeras,1801,warrior,fury,55,32,23
43591,Burger,the-underbog,1800,warrior,fury,24,19,5
43592,Gooberbear,frostmourne,1791,warrior,fury,139,78,61
43593,Melifehorde,tichondrius,1790,warrior,fury,222,111,111
43594,Jimjinjin,tichondrius,1784,warrior,fury,78,39,39
43595,Rekatron,area-52,1783,warrior,fury,49,25,24
43596,Sàndman,malganis,1775,warrior,fury,39,23,16
43597,ßdm,illidan,1775,warrior,fury,42,21,21
43598,Choppiechop,area-52,1763,warrior,fury,42,26,16
43599,Rynkae,moon-guard,1762,warrior,fury,36,20,16
43600,Guerreraa,ragnaros,1755,warrior,fury,65,34,31
43601,Chopped,wyrmrest-accord,1750,warrior,fury,93,43,50
43602,Bulgrim,moon-guard,1748,warrior,fury,78,41,37
43603,Alarìon,malganis,1745,warrior,fury,45,31,14
43604,Velarrine,illidan,1745,warrior,fury,103,58,45
43605,Eazyc,tichondrius,1741,warrior,fury,60,28,32
43606,Illaedan,quelthalas,1740,warrior,fury,65,32,33
43607,Käggai,khadgar,1739,warrior,fury,83,46,37
43608,Coldshots,stormreaver,1736,warrior,fury,66,41,25
43609,Dripgodx,malganis,1736,warrior,fury,54,30,24
43610,Ágsgøðx,bleeding-hollow,1736,warrior,fury,126,67,59
43611,Blgjb,tichondrius,1733,warrior,fury,72,32,40
43612,Ðåddý,stormrage,1732,warrior,fury,131,68,63
43613,Mchamstring,stormrage,1731,warrior,fury,39,22,17
43614,Invinciblé,tichondrius,1730,warrior,fury,36,22,14
43615,Beanstrom,tichondrius,1729,warrior,fury,77,39,38
43616,Escånor,moon-guard,1728,warrior,fury,25,19,6
43617,Akaínu,area-52,1728,warrior,fury,48,27,21
43618,Daedrion,dalaran,1726,warrior,fury,66,37,29
43619,Splasch,kelthuzad,1725,warrior,fury,59,26,33
43620,Bigdude,frostwolf,1721,warrior,fury,48,24,24
43621,Slamurai,moon-guard,1719,warrior,fury,24,18,6
43622,Duochuanjun,illidan,1719,warrior,fury,48,26,22
43623,Cleavxy,sargeras,1715,warrior,fury,42,27,15
43624,Maximad,moon-guard,1714,warrior,fury,84,43,41
43625,Bigfatork,area-52,1712,warrior,fury,88,43,45
43626,Zuggrok,zuljin,1708,warrior,fury,148,75,73
43627,Riggs,stonemaul,1706,warrior,fury,59,32,27
43628,Oddyseey,moon-guard,1706,warrior,fury,54,27,27
43629,Warroiser,quelthalas,1705,warrior,fury,135,73,62
43630,Shadax,bleeding-hollow,1703,warrior,fury,146,77,69
43631,Mochigome,moon-guard,1696,warrior,fury,97,49,48
43632,Scolpi,stormrage,1695,warrior,fury,76,42,34
43633,Kholusia,kul-tiras,1695,warrior,fury,136,67,69
43634,Killbørn,azralon,1694,warrior,fury,30,20,10
43635,Onîkudakì,sargeras,1689,warrior,fury,91,55,36
43636,Eggroll,emerald-dream,1689,warrior,fury,144,80,64
43637,Mulish,frostmourne,1681,warrior,fury,67,40,27
43638,Ðowser,area-52,1680,warrior,fury,24,18,6
43639,Scrotedog,area-52,1680,warrior,fury,55,24,31
43640,Tyroe,thunderhorn,1679,warrior,fury,36,22,14
43641,Ashwalker,malganis,1677,warrior,fury,38,24,14
43642,Chillawigs,kelthuzad,1676,warrior,fury,42,26,16
43643,Torbajhorn,moon-guard,1676,warrior,fury,66,34,32
43644,Fearless,moon-guard,1675,warrior,fury,126,68,58
43645,Thugdorr,sargeras,1675,warrior,fury,102,53,49
43646,Aotha,moon-guard,1674,warrior,fury,26,18,8
43647,Morfoggore,ragnaros,1673,warrior,fury,55,25,30
43648,Sayjaki,stormrage,1671,warrior,fury,60,35,25
43649,Youaredafeds,moon-guard,1669,warrior,fury,131,75,56
43650,Noramed,moon-guard,1669,warrior,fury,90,50,40
43651,Rendwarchief,garrosh,1668,warrior,fury,145,76,69
43652,Festergrin,area-52,1665,warrior,fury,60,32,28
43653,Drashi,nazjatar,1663,warrior,fury,48,31,17
43654,Moistt,nesingwary,1660,warrior,fury,32,22,10
43655,Alteryx,sargeras,1658,warrior,fury,238,129,109
43656,Gladheateher,bonechewer,1658,warrior,fury,60,28,32
43657,Berawar,tichondrius,1656,warrior,fury,60,31,29
43658,Calder,malganis,1656,warrior,fury,72,36,36
43659,Ggull,tichondrius,1654,warrior,fury,35,19,16
43660,Gnomageddon,anetheron,1653,warrior,fury,82,39,43
43661,Jarheadz,bleeding-hollow,1649,warrior,fury,48,32,16
43662,Baeowar,area-52,1648,warrior,fury,57,28,29
43663,Eggdoubles,sargeras,1647,warrior,fury,33,19,14
43664,Eregor,sargeras,1647,warrior,fury,54,27,27
43665,Ssamba,shattered-hand,1643,warrior,fury,36,20,16
43666,Faren,agamaggan,1643,warrior,fury,167,91,76
43667,Traka,stormrage,1642,warrior,fury,36,19,17
43668,Basedaf,frostmourne,1642,warrior,fury,117,61,56
43669,Mandragorn,kelthuzad,1642,warrior,fury,71,37,34
43670,Lowz,hyjal,1641,warrior,fury,32,23,9
43671,Tádakatsu,sargeras,1640,warrior,fury,147,79,68
43672,Saîyanroyce,barthilas,1638,warrior,fury,36,21,15
43673,Budgetclap,nordrassil,1636,warrior,fury,36,18,18
43674,Dardash,ragnaros,1634,warrior,fury,30,21,9
43675,Getthechoppa,aegwynn,1629,warrior,fury,33,22,11
43676,Kellyboitv,frostmourne,1628,warrior,fury,42,20,22
43677,Hellamoist,tichondrius,1627,warrior,fury,30,18,12
43678,Gûard,stormrage,1627,warrior,fury,85,46,39
43679,Wagù,moon-guard,1626,warrior,fury,30,21,9
43680,Colorx,sargeras,1625,warrior,fury,52,30,22
43681,Ugriker,skullcrusher,1623,warrior,fury,42,26,16
43682,Illmindofpoo,kelthuzad,1620,warrior,fury,24,17,7
43683,Nordama,stormrage,1619,warrior,fury,42,27,15
43684,Ediann,elune,1619,warrior,fury,77,45,32
43685,Keltanas,quelthalas,1618,warrior,fury,89,45,44
43686,Rinima,tichondrius,1616,warrior,fury,72,37,35
43687,Hìm,tichondrius,1616,warrior,fury,36,17,19
43688,Hârambe,kiljaeden,1614,warrior,fury,41,25,16
43689,Ruuthless,sargeras,1614,warrior,fury,75,42,33
43690,Takeda,sargeras,1613,warrior,fury,41,21,20
43691,Zangetsy,sargeras,1612,warrior,fury,87,47,40
43692,Damburga,tichondrius,1609,warrior,fury,48,30,18
43693,Khrull,khazgoroth,1609,warrior,fury,74,40,34
43694,Wrniss,tichondrius,1608,warrior,fury,48,31,17
43695,Leviqt,moon-guard,1606,warrior,fury,36,21,15
43696,Hairygrundel,area-52,1605,warrior,fury,60,34,26
43697,Lilgucci,stonemaul,1602,warrior,fury,36,20,16
43698,Ianprime,the-scryers,1602,warrior,fury,42,23,19
43699,Sperow,malygos,1601,warrior,fury,38,23,15
43700,Soulfang,stormscale,1600,warrior,fury,36,20,16
43701,Brutality,kirin-tor,1598,warrior,fury,107,57,50
43702,Gaazhel,quelthalas,1598,warrior,fury,97,49,48
43703,Wangjianguo,illidan,1597,warrior,fury,35,19,16
43704,Cupper,tichondrius,1597,warrior,fury,41,22,19
43705,Sigiswald,cenarion-circle,1597,warrior,fury,36,19,17
43706,Darkbunny,thaurissan,1597,warrior,fury,78,40,38
43707,Flexid,tichondrius,1597,warrior,fury,80,41,39
43708,Neurötic,ragnaros,1594,warrior,fury,30,20,10
43709,Gigatroll,tichondrius,1592,warrior,fury,59,30,29
43710,Påpi,sargeras,1591,warrior,fury,72,43,29
43711,Nogèt,frostmourne,1591,warrior,fury,41,24,17
43712,Wampzug,azshara,1591,warrior,fury,78,37,41
43713,Koffray,malfurion,1590,warrior,fury,51,26,25
43714,Furíous,thunderhorn,1588,warrior,fury,54,25,29
43715,Hammerock,ragnaros,1587,warrior,fury,35,18,17
43716,Igoboom,bleeding-hollow,1585,warrior,fury,46,25,21
43717,Scrümp,illidan,1583,warrior,fury,37,25,12
43718,Kolosaltwo,tichondrius,1583,warrior,fury,53,27,26
43719,Tanorai,area-52,1582,warrior,fury,42,27,15
43720,Nilah,tichondrius,1582,warrior,fury,36,21,15
43721,Sithlõrd,moon-guard,1580,warrior,fury,60,30,30
43722,Bigßiceps,tichondrius,1579,warrior,fury,36,21,15
43723,Trôca,ragnaros,1575,warrior,fury,48,25,23
43724,Wolfcultist,moon-guard,1572,warrior,fury,117,54,63
43725,Mers,garrosh,1571,warrior,fury,42,24,18
43726,Dann,ragnaros,1569,warrior,fury,59,35,24
43727,Ohdang,dark-iron,1567,warrior,fury,102,58,44
43728,Dwarlan,stormrage,1563,warrior,fury,71,44,27
43729,Romus,spirestone,1562,warrior,fury,42,26,16
43730,Khargrok,ragnaros,1561,warrior,fury,93,53,40
43731,Swiftslaýer,vashj,1558,warrior,fury,53,27,26
43732,Rikbielo,dragonmaw,1554,warrior,fury,67,37,30
43733,Garobber,stormrage,1552,warrior,fury,36,17,19
43734,Stavsie,tichondrius,1548,warrior,fury,35,18,17
43735,Wöûlöû,trollbane,1546,warrior,fury,91,48,43
43736,Morguez,tichondrius,1545,warrior,fury,78,43,35
43737,Sugmad,area-52,1545,warrior,fury,48,22,26
43738,Zuggyboi,moon-guard,1544,warrior,fury,48,25,23
43739,Raggnarsøøn,ragnaros,1543,warrior,fury,101,47,54
43740,Easons,tichondrius,1540,warrior,fury,59,25,34
43741,Pootyspootz,warsong,1536,warrior,fury,47,28,19
43742,Iceice,dalaran,1535,warrior,fury,70,35,35
43743,Impalle,nazjatar,1531,warrior,fury,54,33,21
43744,Philsbbqnow,dark-iron,1525,warrior,fury,24,16,8
43745,Tctc,emerald-dream,1524,warrior,fury,41,22,19
43746,Cohëëd,kelthuzad,1523,warrior,fury,119,64,55
43747,Daelganis,blood-furnace,1523,warrior,fury,42,21,21
43748,Zombad,azralon,1522,warrior,fury,30,18,12
43749,Warrmachine,mannoroth,1520,warrior,fury,132,75,57
43750,Crohdey,madoran,1519,warrior,fury,120,65,55
43751,Abomlnatlon,tichondrius,1517,warrior,fury,60,34,26
43752,Invdeath,azralon,1517,warrior,fury,46,23,23
43753,Zitfrlt,wildhammer,1515,warrior,fury,87,39,48
43754,Playbox,area-52,1514,warrior,fury,83,37,46
43755,Fearlessxq,tichondrius,1512,warrior,fury,106,59,47
43756,Mytharion,sargeras,1511,warrior,fury,30,18,12
43757,Linker,ragnaros,1511,warrior,fury,42,25,17
43758,Shibaraku,tichondrius,1511,warrior,fury,263,125,138
43759,Hoodlark,lightbringer,1509,warrior,fury,42,24,18
43760,Machomanran,zuljin,1509,warrior,fury,89,47,42
43761,Jorked,drakkari,1509,warrior,fury,68,35,33
43762,Mayonnaise,ragnaros,1509,warrior,fury,36,18,18
43763,Dcashmoney,moon-guard,1508,warrior,fury,59,33,26
43764,Benchpress,bleeding-hollow,1508,warrior,fury,60,30,30
43765,Rücküs,tichondrius,1506,warrior,fury,74,45,29
43766,Tinyexcute,tichondrius,1506,warrior,fury,30,16,14
43767,Bestgrunt,tichondrius,1504,warrior,fury,96,45,51
43768,Fearlessly,moon-guard,1503,warrior,fury,130,69,61
43769,Anandamide,frostwolf,1503,warrior,fury,51,27,24
43770,Gorrtog,stormrage,1502,warrior,fury,147,71,76
43771,Grômm,tichondrius,1500,warrior,fury,63,33,30
43772,Brøsk,azralon,1500,warrior,fury,48,24,24
43773,Nimna,moon-guard,1499,warrior,fury,59,29,30
43774,Andorane,bleeding-hollow,1499,warrior,fury,42,19,23
43775,Stoopkid,uldum,1494,warrior,fury,52,26,26
43776,Varith,sargeras,1493,warrior,fury,54,26,28
43777,Arágorn,sargeras,1490,warrior,fury,30,18,12
43778,Albinosword,azralon,1488,warrior,fury,74,37,37
43779,Commandó,proudmoore,1487,warrior,fury,59,37,22
43780,Viagraliker,tichondrius,1487,warrior,fury,63,37,26
43781,Shádo,darkspear,1485,warrior,fury,36,23,13
43782,Rafurk,area-52,1483,warrior,fury,30,18,12
43783,Ronok,ghostlands,1481,warrior,fury,42,26,16
43784,Know,anetheron,1480,warrior,fury,39,25,14
43785,Ikoré,saurfang,1480,warrior,fury,81,44,37
43786,Ragnararagor,ragnaros,1480,warrior,fury,251,124,127
43787,Genrÿuusai,azralon,1478,warrior,fury,35,19,16
43788,Lavablood,moon-guard,1478,warrior,fury,48,22,26
43789,Himiko,kaelthas,1476,warrior,fury,45,23,22
43790,Zareshi,sargeras,1474,warrior,fury,134,70,64
43791,Karusuke,stormrage,1472,warrior,fury,36,21,15
43792,Shaøkahn,azralon,1471,warrior,fury,38,21,17
43793,Sensho,azralon,1467,warrior,fury,52,29,23
43794,Badoosh,kaelthas,1466,warrior,fury,40,26,14
43795,Hôdû,tichondrius,1466,warrior,fury,58,32,26
43796,Jubeithos,draktharon,1466,warrior,fury,60,28,32
43797,Venirith,moon-guard,1465,warrior,fury,76,39,37
43798,Nixe,caelestrasz,1465,warrior,fury,80,38,42
43799,Axesage,tichondrius,1465,warrior,fury,48,22,26
43800,Xenogears,boulderfist,1463,warrior,fury,36,16,20
43801,Cliveswife,frostmourne,1462,warrior,fury,23,16,7
43802,Teyroporah,azralon,1462,warrior,fury,63,34,29
43803,Violençe,malganis,1462,warrior,fury,42,19,23
43804,Timer,nagrand,1459,warrior,fury,18,17,1
43805,Jimseung,tichondrius,1459,warrior,fury,36,16,20
43806,Bigbungus,frostmourne,1458,warrior,fury,30,16,14
43807,Celere,azralon,1458,warrior,fury,54,23,31
43808,Mandremin,moon-guard,1456,warrior,fury,24,17,7
43809,Rhann,kelthuzad,1454,warrior,fury,44,23,21
43810,Calzonez,bloodscalp,1449,warrior,fury,53,31,22
43811,Kortera,malganis,1449,warrior,fury,59,33,26
43812,Chounshiryu,drakkari,1449,warrior,fury,245,126,119
43813,Wazy,ragnaros,1448,warrior,fury,60,28,32
43814,Lujzika,stormreaver,1439,warrior,fury,24,17,7
43815,Smexxin,tichondrius,1439,warrior,fury,24,15,9
43816,Wurrukattezz,tichondrius,1435,warrior,fury,38,22,16
43817,Elken,haomarush,1434,warrior,fury,48,26,22
43818,Azázyel,quelthalas,1433,warrior,fury,48,19,29
43819,Mankus,tichondrius,1432,warrior,fury,90,45,45
43820,Giannï,chogall,1431,warrior,fury,24,15,9
43821,Vnw,illidan,1427,warrior,fury,24,15,9
43822,Tenger,velen,1422,warrior,fury,101,56,45
43823,Maciste,exodar,1422,warrior,fury,30,15,15
43824,Murderwalk,shadowmoon,1422,warrior,fury,39,19,20
43825,Attractive,silvermoon,1420,warrior,fury,103,57,46
43826,Heenguer,azralon,1420,warrior,fury,60,31,29
43827,Majindoom,illidan,1418,warrior,fury,47,27,20
43828,Gromarth,wyrmrest-accord,1418,warrior,fury,70,38,32
43829,Lechonk,suramar,1415,warrior,fury,30,16,14
43830,Modì,sargeras,1415,warrior,fury,36,16,20
43831,Johnnysnowx,sargeras,1412,warrior,fury,89,47,42
43832,Aarmii,ragnaros,1410,warrior,fury,59,29,30
43833,Warsongwolf,tichondrius,1409,warrior,fury,78,36,42
43834,Burtiera,wyrmrest-accord,1407,warrior,fury,54,33,21
43835,Errejota,illidan,1406,warrior,fury,54,26,28
43836,Whitetaure,arthas,1405,warrior,fury,30,15,15
43837,Biggbudzz,sargeras,1404,warrior,fury,30,16,14
43838,Exëqt,area-52,1404,warrior,fury,60,25,35
43839,Apeal,skullcrusher,1403,warrior,fury,84,44,40
43840,Sálieri,ragnaros,1403,warrior,fury,42,22,20
43841,Hêllseeker,ragnaros,1403,warrior,fury,46,22,24
43842,Braxtön,moon-guard,1401,warrior,fury,45,20,25
43843,Sindarin,eitrigg,1400,warrior,fury,54,32,22
43844,Xurug,zuljin,1400,warrior,fury,30,15,15
43845,Moriax,azralon,1398,warrior,fury,83,43,40
43846,Fluffytaco,illidan,1395,warrior,fury,60,32,28
43847,Slaggdad,illidan,1395,warrior,fury,74,33,41
43848,Lyonele,moon-guard,1394,warrior,fury,50,28,22
43849,Ourhero,malganis,1392,warrior,fury,27,16,11
43850,Gokkuu,dragonblight,1392,warrior,fury,36,20,16
43851,Zekken,blades-edge,1392,warrior,fury,77,39,38
43852,Aladrynne,dalaran,1390,warrior,fury,96,44,52
43853,Sïxsnacks,stormrage,1389,warrior,fury,26,16,10
43854,Bigjier,proudmoore,1386,warrior,fury,38,18,20
43855,Zerríck,moon-guard,1385,warrior,fury,78,38,40
43856,Reesse,eonar,1384,warrior,fury,24,16,8
43857,Noten,thunderlord,1383,warrior,fury,72,39,33
43858,Rageinc,jubeithos,1383,warrior,fury,62,28,34
43859,Kratøz,tichondrius,1382,warrior,fury,36,18,18
43860,Thywub,proudmoore,1380,warrior,fury,36,17,19
43861,Fendimonster,tichondrius,1379,warrior,fury,136,74,62
43862,Weesten,aerie-peak,1378,warrior,fury,178,99,79
43863,Cenanuandra,gnomeregan,1377,warrior,fury,58,31,27
43864,Swiffy,stormrage,1375,warrior,fury,46,29,17
43865,Zootonius,bloodscalp,1368,warrior,fury,36,20,16
43866,Firmware,illidan,1368,warrior,fury,34,15,19
43867,Crushanater,tichondrius,1364,warrior,fury,33,17,16
43868,Dissx,illidan,1363,warrior,fury,42,19,23
43869,Trco,quelthalas,1361,warrior,fury,42,22,20
43870,Nebgleb,bleeding-hollow,1360,warrior,fury,24,16,8
43871,Emotionaldps,malygos,1360,warrior,fury,141,74,67
43872,Ivanzaytsev,ragnaros,1360,warrior,fury,78,40,38
43873,Iskandr,amanthul,1357,warrior,fury,87,40,47
43874,Matthegreat,area-52,1354,warrior,fury,51,25,26
43875,Cougaloo,sargeras,1348,warrior,fury,54,26,28
43876,Thiccyb,area-52,1344,warrior,fury,18,14,4
43877,Rerollrogue,thrall,1344,warrior,fury,95,42,53
43878,Arfzz,zangarmarsh,1343,warrior,fury,36,16,20
43879,Kaladbolg,tichondrius,1340,warrior,fury,42,23,19
43880,Rekill,emerald-dream,1337,warrior,fury,24,14,10
43881,Michaela,moon-guard,1336,warrior,fury,24,14,10
43882,Ensïs,moon-guard,1335,warrior,fury,54,22,32
43883,Kombatwombat,kaelthas,1334,warrior,fury,18,14,4
43884,Ciellë,proudmoore,1334,warrior,fury,27,17,10
43885,Krovikân,area-52,1333,warrior,fury,24,14,10
43886,Ciege,illidan,1333,warrior,fury,24,14,10
43887,Lighttaker,proudmoore,1332,warrior,fury,90,49,41
43888,Râvik,illidan,1332,warrior,fury,30,14,16
43889,Zartren,khazgoroth,1331,warrior,fury,24,14,10
43890,Breaker,undermine,1331,warrior,fury,30,14,16
43891,Washim,area-52,1329,warrior,fury,41,24,17
43892,Alysson,moon-guard,1329,warrior,fury,24,14,10
43893,Wouili,zuljin,1329,warrior,fury,24,14,10
43894,Screwz,blackrock,1328,warrior,fury,78,43,35
43895,Crøm,tichondrius,1327,warrior,fury,36,14,22
43896,Youserg,khazgoroth,1325,warrior,fury,82,39,43
43897,Bondeye,stormrage,1325,warrior,fury,83,38,45
43898,Metalstorms,firetree,1321,warrior,fury,30,16,14
43899,Galaxarr,bonechewer,1319,warrior,fury,65,32,33
43900,Mäjka,dalaran,1316,warrior,fury,30,14,16
43901,Zenrrei,ragnaros,1315,warrior,fury,31,15,16
43902,Destructör,nagrand,1315,warrior,fury,36,15,21
43903,Hellframe,ysondre,1315,warrior,fury,42,17,25
43904,Selathiel,burning-blade,1313,warrior,fury,24,14,10
43905,Warföx,stormrage,1310,warrior,fury,36,15,21
43906,Thyssara,moon-guard,1309,warrior,fury,81,38,43
43907,Áres,spinebreaker,1308,warrior,fury,42,19,23
43908,Varlekt,frostmourne,1307,warrior,fury,59,30,29
43909,Ironpanzer,thrall,1306,warrior,fury,50,25,25
43910,Tüssèll,khazgoroth,1306,warrior,fury,97,48,49
43911,Brugo,area-52,1301,warrior,fury,50,33,17
43912,Osannd,tichondrius,1301,warrior,fury,66,31,35
43913,Uggtrick,zuljin,1301,warrior,fury,72,33,39
43914,Contradict,thrall,1301,warrior,fury,36,16,20
43915,Goleus,emerald-dream,1299,warrior,fury,42,17,25
43916,Assaulttank,drenden,1298,warrior,fury,42,17,25
43917,Mikejustice,kelthuzad,1297,warrior,fury,124,57,67
43918,Xeto,ragnaros,1296,warrior,fury,34,20,14
43919,Fabian,kelthuzad,1296,warrior,fury,76,40,36
43920,Joxer,nordrassil,1293,warrior,fury,48,25,23
43921,Eatmyblade,wyrmrest-accord,1293,warrior,fury,187,83,104
43922,Kelandrin,illidan,1292,warrior,fury,24,15,9
43923,Vapyr,moon-guard,1291,warrior,fury,23,14,9
43924,Orrof,antonidas,1291,warrior,fury,111,50,61
43925,Maytrix,bleeding-hollow,1290,warrior,fury,48,24,24
43926,Wuushang,area-52,1288,warrior,fury,62,31,31
43927,Zweihänder,nemesis,1284,warrior,fury,23,14,9
43928,Dhaemom,azralon,1282,warrior,fury,90,43,47
43929,Tupacsback,stormrage,1281,warrior,fury,36,22,14
43930,Rsage,lightbringer,1274,warrior,fury,116,59,57
43931,Spaceguybro,whisperwind,1272,warrior,fury,47,20,27
43932,Grumok,tichondrius,1267,warrior,fury,26,14,12
43933,Ivoryana,kelthuzad,1266,warrior,fury,48,25,23
43934,Paí,nemesis,1265,warrior,fury,24,15,9
43935,Akusenshi,dragonblight,1263,warrior,fury,48,24,24
43936,Elbetoques,ragnaros,1261,warrior,fury,30,18,12
43937,Lilcha,stormrage,1258,warrior,fury,36,15,21
43938,Savikk,earthen-ring,1256,warrior,fury,42,23,19
43939,Garce,aerie-peak,1253,warrior,fury,31,16,15
43940,Vandrad,stormrage,1252,warrior,fury,123,56,67
43941,Kurishjadar,tichondrius,1251,warrior,fury,66,31,35
43942,Elonownesme,zuljin,1251,warrior,fury,44,20,24
43943,Wariorphilip,moon-guard,1250,warrior,fury,30,18,12
43944,Wakkawar,stormrage,1248,warrior,fury,48,24,24
43945,Agragar,zuljin,1247,warrior,fury,18,13,5
43946,Blackpro,sargeras,1247,warrior,fury,42,26,16
43947,Vuraxx,area-52,1246,warrior,fury,18,13,5
43948,Carnemontana,shadowsong,1246,warrior,fury,24,17,7
43949,Smache,tichondrius,1244,warrior,fury,18,13,5
43950,Verigan,barthilas,1244,warrior,fury,18,13,5
43951,Islik,stormrage,1243,warrior,fury,24,13,11
43952,Torkscreww,bleeding-hollow,1243,warrior,fury,24,13,11
43953,Taiine,moon-guard,1243,warrior,fury,24,13,11
43954,Grommasth,jubeithos,1242,warrior,fury,24,14,10
43955,Buckleboot,illidan,1242,warrior,fury,24,13,11
43956,Rendard,sargeras,1242,warrior,fury,24,13,11
43957,Tdaddy,lightbringer,1242,warrior,fury,121,61,60
43958,Cheiftain,dalaran,1241,warrior,fury,30,13,17
43959,Bopwar,malganis,1240,warrior,fury,24,13,11
43960,Robocöp,quelthalas,1239,warrior,fury,24,13,11
43961,Evilkorean,tichondrius,1237,warrior,fury,24,13,11
43962,Skipowawa,area-52,1237,warrior,fury,30,16,14
43963,Atracasöl,ragnaros,1236,warrior,fury,24,13,11
43964,Wishayzka,drakkari,1234,warrior,fury,24,13,11
43965,Zephyron,moonrunner,1231,warrior,fury,38,18,20
43966,Renseven,frostmourne,1230,warrior,fury,36,19,17
43967,Cjay,bleeding-hollow,1229,warrior,fury,30,13,17
43968,Kyle,kargath,1227,warrior,fury,34,21,13
43969,Groggam,illidan,1226,warrior,fury,24,13,11
43970,Furiousangel,area-52,1223,warrior,fury,36,19,17
43971,Vornicar,moon-guard,1221,warrior,fury,32,14,18
43972,Thänatøs,nemesis,1219,warrior,fury,32,17,15
43973,Thorfjin,stormrage,1218,warrior,fury,24,13,11
43974,Wraithvlad,moon-guard,1215,warrior,fury,50,20,30
43975,Grosjambes,turalyon,1214,warrior,fury,30,18,12
43976,Tenebrocity,stormrage,1213,warrior,fury,42,19,23
43977,Breinan,ragnaros,1205,warrior,fury,51,26,25
43978,Kaíroz,quelthalas,1203,warrior,fury,42,24,18
43979,Rendus,hyjal,1198,warrior,fury,54,21,33
43980,Bigglyjoobs,tichondrius,1195,warrior,fury,23,13,10
43981,Lidia,windrunner,1194,warrior,fury,38,14,24
43982,Tinycutty,frostmourne,1189,warrior,fury,23,13,10
43983,Koraciá,illidan,1188,warrior,fury,42,19,23
43984,Nemesioh,tichondrius,1184,warrior,fury,59,25,34
43985,Honduranhary,sargeras,1183,warrior,fury,34,17,17
43986,Serviettski,zuljin,1181,warrior,fury,36,19,17
43987,Ragemarley,dalaran,1180,warrior,fury,41,19,22
43988,Furyknight,velen,1177,warrior,fury,73,38,35
43989,Akarì,emerald-dream,1176,warrior,fury,30,15,15
43990,Antei,thunderlord,1171,warrior,fury,23,13,10
43991,Zèldris,gallywix,1171,warrior,fury,109,61,48
43992,Warkinit,proudmoore,1167,warrior,fury,34,15,19
43993,Liljon,windrunner,1166,warrior,fury,36,17,19
43994,Zorhn,skywall,1161,warrior,fury,24,18,6
43995,Markodarko,gilneas,1161,warrior,fury,24,13,11
43996,Starplatinum,aerie-peak,1158,warrior,fury,36,16,20
43997,Darthwarr,bleeding-hollow,1156,warrior,fury,35,23,12
43998,Ðêed,area-52,1152,warrior,fury,18,12,6
43999,Arrad,sargeras,1152,warrior,fury,42,17,25
44000,Yepkorean,tichondrius,1151,warrior,fury,18,12,6
44001,Líliúm,ragnaros,1151,warrior,fury,31,19,12
44002,Slughörn,moon-guard,1151,warrior,fury,24,12,12
44003,Ganzi,tichondrius,1150,warrior,fury,24,12,12
44004,Ganzism,tichondrius,1150,warrior,fury,24,12,12
44005,Notcoverage,tichondrius,1150,warrior,fury,24,12,12
44006,Ganzar,nesingwary,1148,warrior,fury,30,12,18
44007,Sonyanalogue,frostmourne,1148,warrior,fury,30,12,18
44008,Justicwar,area-52,1147,warrior,fury,24,12,12
44009,Zarxc,quelthalas,1147,warrior,fury,24,12,12
44010,Synalia,sargeras,1147,warrior,fury,24,12,12
44011,Galigiggs,emerald-dream,1146,warrior,fury,18,12,6
44012,Lòrdnasher,tichondrius,1146,warrior,fury,21,13,8
44013,Setseno,stormrage,1145,warrior,fury,24,12,12
44014,Faywarsong,area-52,1145,warrior,fury,24,12,12
44015,Midweststuna,kul-tiras,1144,warrior,fury,18,12,6
44016,Jingson,moon-guard,1143,warrior,fury,21,13,8
44017,Kanekhy,ragnaros,1143,warrior,fury,28,13,15
44018,Casmier,tichondrius,1141,warrior,fury,18,12,6
44019,Mezmer,sargeras,1139,warrior,fury,18,12,6
44020,Balbyo,shattered-hand,1139,warrior,fury,30,12,18
44021,Sansãocore,nemesis,1138,warrior,fury,28,13,15
44022,Originalkhan,stormrage,1138,warrior,fury,30,12,18
44023,Droun,rexxar,1137,warrior,fury,59,30,29
44024,Talismantate,quelthalas,1135,warrior,fury,18,12,6
44025,Kaladïn,ragnaros,1135,warrior,fury,18,12,6
44026,Sarovek,thrall,1134,warrior,fury,24,12,12
44027,Makcumba,ragnaros,1132,warrior,fury,24,12,12
44028,Zoldian,tichondrius,1132,warrior,fury,29,14,15
44029,Stinkyfuq,area-52,1128,warrior,fury,18,12,6
44030,Chahta,shadowsong,1125,warrior,fury,18,12,6
44031,Roxon,hellscream,1125,warrior,fury,89,45,44
44032,Rekitralph,tichondrius,1116,warrior,fury,30,13,17
44033,Filamon,dentarg,1116,warrior,fury,35,12,23
44034,Irontarkus,garrosh,1112,warrior,fury,18,12,6
44035,Sphílly,thrall,1107,warrior,fury,36,19,17
44036,Tyraelius,kiljaeden,1103,warrior,fury,39,24,15
44037,Rocketcayton,veknilash,1096,warrior,fury,54,30,24
44038,Madaroy,stormrage,1096,warrior,fury,24,12,12
44039,Goinberserk,tichondrius,1093,warrior,fury,34,16,18
44040,Smallestwar,zuljin,1093,warrior,fury,47,18,29
44041,Xfootman,quelthalas,1092,warrior,fury,42,25,17
44042,Dodiru,azralon,1084,warrior,fury,27,13,14
44043,Brodîn,tichondrius,1083,warrior,fury,54,30,24
44044,Elsee,drakkari,1080,warrior,fury,26,12,14
44045,Undmyaxe,shattered-halls,1078,warrior,fury,24,13,11
44046,Fatguy,tichondrius,1076,warrior,fury,60,29,31
44047,Nezzarek,sargeras,1075,warrior,fury,34,12,22
44048,Assmut,stormrage,1074,warrior,fury,35,15,20
44049,Garmeg,nemesis,1073,warrior,fury,60,26,34
44050,Lucymay,kelthuzad,1072,warrior,fury,36,19,17
44051,Creedz,dreadmaul,1064,warrior,fury,42,18,24
44052,Orclog,illidan,1056,warrior,fury,18,11,7
44053,Cryposlice,malganis,1056,warrior,fury,24,11,13
44054,Xcuses,area-52,1055,warrior,fury,18,11,7
44055,Nicfury,alterac-mountains,1055,warrior,fury,18,11,7
44056,Ragingboner,aggramar,1055,warrior,fury,18,11,7
44057,Ásúrá,quelthalas,1055,warrior,fury,18,11,7
44058,Flaco,tichondrius,1055,warrior,fury,21,12,9
44059,Gorbagglúk,azralon,1055,warrior,fury,30,15,15
44060,Uhtred,moonrunner,1055,warrior,fury,24,12,12
44061,Chlord,proudmoore,1055,warrior,fury,24,11,13
44062,Bearlornan,frostmourne,1054,warrior,fury,18,11,7
44063,Claymation,tichondrius,1054,warrior,fury,18,11,7
44064,Bloodfist,tichondrius,1054,warrior,fury,18,11,7
44065,Sulze,tichondrius,1054,warrior,fury,21,12,9
44066,Hjomura,quelthalas,1053,warrior,fury,18,11,7
44067,Zerkxi,kelthuzad,1053,warrior,fury,18,11,7
44068,Beryrn,farstriders,1053,warrior,fury,23,13,10
44069,Berthibar,dalaran,1053,warrior,fury,30,11,19
44070,Radisa,sargeras,1051,warrior,fury,30,11,19
44071,Koppo,kelthuzad,1050,warrior,fury,30,11,19
44072,Shrekshomie,zuljin,1049,warrior,fury,18,11,7
44073,Ráionshin,quelthalas,1049,warrior,fury,24,11,13
44074,Limpninny,dalaran,1049,warrior,fury,27,11,16
44075,Wolurog,emerald-dream,1048,warrior,fury,18,11,7
44076,Studsrus,aegwynn,1048,warrior,fury,42,21,21
44077,Bhutjolokia,ragnaros,1048,warrior,fury,24,11,13
44078,Tayne,ragnaros,1046,warrior,fury,24,11,13
44079,Ghostwalker,akama,1045,warrior,fury,24,11,13
44080,Marcuss,bonechewer,1043,warrior,fury,18,11,7
44081,Cåfe,tichondrius,1043,warrior,fury,18,11,7
44082,Djfredsd,tichondrius,1041,warrior,fury,24,11,13
44083,Offthecharts,mannoroth,1033,warrior,fury,41,20,21
44084,Jellyjamz,zuljin,1032,warrior,fury,30,14,16
44085,Owwycowwy,area-52,1032,warrior,fury,36,15,21
44086,Learila,moon-guard,1027,warrior,fury,30,14,16
44087,Munanio,stormrage,1024,warrior,fury,24,11,13
44088,Lykon,echo-isles,1020,warrior,fury,18,11,7
44089,Cannan,the-underbog,1019,warrior,fury,51,15,36
44090,Rumka,draktharon,1015,warrior,fury,65,26,39
44091,Lodog,proudmoore,1012,warrior,fury,28,12,16
44092,Éeu,anubarak,1008,warrior,fury,112,58,54
44093,Moelolita,illidan,1007,warrior,fury,23,11,12
44094,Crazysharpz,thaurissan,1001,warrior,fury,29,12,17
44095,Leturen,emerald-dream,999,warrior,fury,25,12,13
44096,Painfulangel,nesingwary,994,warrior,fury,20,15,5
44097,Warchine,malganis,994,warrior,fury,27,12,15
44098,Shoteiotoshi,ragnaros,993,warrior,fury,41,21,20
44099,Splurger,thrall,991,warrior,fury,17,11,6
44100,Udmwarrior,zuljin,991,warrior,fury,22,11,11
44101,Yêawen,tichondrius,990,warrior,fury,20,11,9
44102,Jimmfro,zuljin,990,warrior,fury,22,11,11
44103,Tyranatusk,malganis,989,warrior,fury,18,12,6
44104,Jonÿ,sargeras,989,warrior,fury,84,44,40
44105,Muufasa,nerzhul,988,warrior,fury,24,13,11
44106,Curacao,dark-iron,987,warrior,fury,26,11,15
44107,Bèèfcake,shattered-hand,984,warrior,fury,20,11,9
44108,Wyrmscream,moon-guard,981,warrior,fury,90,42,48
44109,Pulp,sargeras,976,warrior,fury,19,11,8
44110,Judessi,kiljaeden,971,warrior,fury,20,11,9
44111,Youngmoneyd,illidan,960,warrior,fury,12,10,2
44112,Dawx,thrall,960,warrior,fury,18,10,8
44113,Hasbullaa,proudmoore,959,warrior,fury,18,10,8
44114,Turboboy,tichondrius,959,warrior,fury,18,10,8
44115,Chopemupp,area-52,959,warrior,fury,18,10,8
44116,Orrkky,jubeithos,959,warrior,fury,18,10,8
44117,Toberino,illidan,959,warrior,fury,18,10,8
44118,Coalpit,emerald-dream,959,warrior,fury,24,10,14
44119,Sixtydolla,kelthuzad,959,warrior,fury,24,10,14
44120,Ymìr,moon-guard,959,warrior,fury,24,10,14
44121,Gahenk,chogall,958,warrior,fury,12,10,2
44122,Strëngth,aggramar,958,warrior,fury,18,10,8
44123,Blxckbeard,hyjal,958,warrior,fury,24,10,14
44124,Semiru,zuljin,957,warrior,fury,12,10,2
44125,Quuavo,tichondrius,957,warrior,fury,18,10,8
44126,Farklesnarf,tichondrius,957,warrior,fury,18,10,8
44127,Venóm,moon-guard,957,warrior,fury,18,10,8
44128,Dabier,bleeding-hollow,956,warrior,fury,24,10,14
44129,Harlow,spirestone,955,warrior,fury,24,10,14
44130,Tacomeat,malorne,954,warrior,fury,22,11,11
44131,Icon,tichondrius,954,warrior,fury,24,10,14
44132,Äléx,frostmourne,953,warrior,fury,18,10,8
44133,Nordrages,stormrage,953,warrior,fury,18,10,8
44134,Rakshata,destromath,953,warrior,fury,18,10,8
44135,Brutalpløx,illidan,953,warrior,fury,30,10,20
44136,Ísrafel,ragnaros,952,warrior,fury,18,10,8
44137,Maytrixx,stormrage,950,warrior,fury,12,10,2
44138,Jellybomb,sargeras,950,warrior,fury,24,10,14
44139,Tlâloque,quelthalas,943,warrior,fury,24,10,14
44140,Trendxx,stormrage,941,warrior,fury,30,10,20
44141,Darkarus,drakkari,925,warrior,fury,36,14,22
44142,Hùlksmâsh,zuljin,924,warrior,fury,23,13,10
44143,Ghostlyedge,turalyon,918,warrior,fury,72,25,47
44144,Obiwun,azgalor,910,warrior,fury,17,10,7
44145,Harkeigh,wyrmrest-accord,909,warrior,fury,17,10,7
44146,Dolsorae,malganis,905,warrior,fury,28,11,17
44147,Pigonhae,zuljin,904,warrior,fury,25,12,13
44148,Samdarkblade,kilrogg,898,warrior,fury,33,10,23
44149,Joog,kalecgos,895,warrior,fury,22,10,12
44150,Grievouz,nemesis,894,warrior,fury,17,10,7
44151,Snugglebuggs,stormrage,894,warrior,fury,23,10,13
44152,Copinhodagua,azralon,889,warrior,fury,19,11,8
44153,Elmosmash,thrall,879,warrior,fury,19,10,9
44154,Zambonibob,eonar,876,warrior,fury,24,12,12
44155,Notacop,malygos,864,warrior,fury,12,9,3
44156,Tastý,moon-guard,864,warrior,fury,12,9,3
44157,Shadowstingg,tichondrius,864,warrior,fury,12,9,3
44158,Gbrz,stormrage,864,warrior,fury,12,9,3
44159,Lindsanv,illidan,864,warrior,fury,18,9,9
44160,Riftgar,hyjal,864,warrior,fury,18,9,9
44161,Naelynh,quelthalas,864,warrior,fury,18,9,9
44162,Bornclueless,illidan,864,warrior,fury,18,9,9
44163,Astrëa,quelthalas,864,warrior,fury,18,9,9
44164,Baylîfe,illidan,864,warrior,fury,18,9,9
44165,Progesterone,bleeding-hollow,864,warrior,fury,18,9,9
44166,Lootacris,illidan,864,warrior,fury,24,9,15
44167,Shimizuken,tichondrius,864,warrior,fury,24,9,15
44168,Likelygood,tichondrius,863,warrior,fury,12,9,3
44169,Squonks,kelthuzad,863,warrior,fury,12,9,3
44170,Okkin,cairne,863,warrior,fury,12,9,3
44171,Liltom,sargeras,863,warrior,fury,18,9,9
44172,Zastrow,dalaran,863,warrior,fury,18,9,9
44173,Xakp,tichondrius,863,warrior,fury,18,9,9
44174,Tyrannus,chogall,863,warrior,fury,18,9,9
44175,Klieterious,bleeding-hollow,863,warrior,fury,18,9,9
44176,Gzilla,queldorei,863,warrior,fury,24,9,15
44177,Youjumpijump,frostmourne,863,warrior,fury,24,9,15
44178,Tylerdurdenx,dalaran,862,warrior,fury,12,9,3
44179,Lurtras,exodar,862,warrior,fury,18,9,9
44180,Gurukakko,ragnaros,862,warrior,fury,18,9,9
44181,Nowarriororc,thrall,862,warrior,fury,18,9,9
44182,Conflíct,illidan,862,warrior,fury,18,9,9
44183,Saabre,tichondrius,862,warrior,fury,18,9,9
44184,Kåyotix,proudmoore,862,warrior,fury,18,9,9
44185,Kreigër,area-52,862,warrior,fury,18,9,9
44186,Cannonballz,sargeras,861,warrior,fury,18,9,9
44187,Nornogin,tichondrius,861,warrior,fury,24,9,15
44188,Rageraz,trollbane,860,warrior,fury,12,9,3
44189,Maddzspin,tichondrius,860,warrior,fury,18,9,9
44190,Asuna,burning-blade,860,warrior,fury,18,9,9
44191,Rodorn,frostmourne,860,warrior,fury,22,10,12
44192,Groguu,windrunner,859,warrior,fury,18,9,9
44193,Stunninchaos,shattered-hand,859,warrior,fury,24,9,15
44194,Lovehandlez,proudmoore,858,warrior,fury,18,9,9
44195,Melankoma,sargeras,856,warrior,fury,18,9,9
44196,Kræzee,kelthuzad,856,warrior,fury,24,9,15
44197,Trufsoturi,bleeding-hollow,845,warrior,fury,23,9,14
44198,Kajing,boulderfist,836,warrior,fury,19,10,9
44199,Cønan,stormrage,830,warrior,fury,14,10,4
44200,Machâ,illidan,830,warrior,fury,17,9,8
44201,Kessahh,moon-guard,820,warrior,fury,18,9,9
44202,Magdar,daggerspine,813,warrior,fury,28,9,19
44203,Futtmebuck,emerald-dream,810,warrior,fury,18,10,8
44204,Damnge,zuljin,806,warrior,fury,21,10,11
44205,Rediger,aggramar,805,warrior,fury,40,16,24
44206,Bargorengar,skullcrusher,797,warrior,fury,108,48,60
44207,Liquidbagel,frostmourne,794,warrior,fury,22,9,13
44208,Haelerostus,moon-guard,785,warrior,fury,42,16,26
44209,Klim,grizzly-hills,781,warrior,fury,25,9,16
44210,Nïckböï,misha,780,warrior,fury,17,9,8
44211,Cüba,nemesis,770,warrior,fury,24,9,15
44212,Rimshotts,sargeras,768,warrior,fury,12,8,4
44213,Kruma,stormscale,768,warrior,fury,12,8,4
44214,Beforever,kiljaeden,768,warrior,fury,12,8,4
44215,Swìll,illidan,768,warrior,fury,12,8,4
44216,Bbcapitalist,blackrock,768,warrior,fury,12,8,4
44217,Angryexe,zuljin,768,warrior,fury,12,8,4
44218,Perserve,thunderlord,768,warrior,fury,12,8,4
44219,Stimm,blood-furnace,768,warrior,fury,12,8,4
44220,Humanlog,illidan,768,warrior,fury,12,8,4
44221,Volgarr,zuljin,768,warrior,fury,12,8,4
44222,Collosalx,stormrage,768,warrior,fury,12,8,4
44223,Ramseyx,dalaran,768,warrior,fury,12,8,4
44224,Dahakawar,malganis,768,warrior,fury,12,8,4
44225,Akenox,area-52,768,warrior,fury,12,8,4
44226,Ryse,aegwynn,768,warrior,fury,12,8,4
44227,Idranel,nordrassil,768,warrior,fury,12,8,4
44228,Colonclogger,proudmoore,768,warrior,fury,12,8,4
44229,Bamag,dethecus,768,warrior,fury,12,8,4
44230,Stånnis,moon-guard,768,warrior,fury,12,8,4
44231,Doczz,malganis,768,warrior,fury,18,8,10
44232,Oohsht,tichondrius,768,warrior,fury,18,8,10
44233,Asstastic,bonechewer,768,warrior,fury,18,8,10
44234,Coltyn,illidan,768,warrior,fury,18,8,10
44235,Icebringer,frostmourne,768,warrior,fury,24,8,16
44236,Drunkwarriôr,malygos,767,warrior,fury,12,8,4
44237,Dagrone,drakkari,767,warrior,fury,12,8,4
44238,Hydrolisk,area-52,767,warrior,fury,12,8,4
44239,Moggos,firetree,767,warrior,fury,12,8,4
44240,Rodahn,emerald-dream,767,warrior,fury,12,8,4
44241,Mittyroar,khazgoroth,767,warrior,fury,12,8,4
44242,Kyres,moon-guard,767,warrior,fury,12,8,4
44243,Ungabunga,frostwolf,767,warrior,fury,18,8,10
44244,Wíldcat,illidan,767,warrior,fury,18,8,10
44245,Maintarget,malganis,767,warrior,fury,18,8,10
44246,Dtrumpo,moon-guard,767,warrior,fury,18,8,10
44247,Funk,illidan,767,warrior,fury,18,8,10
44248,Gízzmo,tichondrius,767,warrior,fury,18,8,10
44249,Zêtt,drakkari,767,warrior,fury,18,8,10
44250,Gorethrax,tichondrius,767,warrior,fury,18,8,10
44251,Darkirondadi,frostmourne,766,warrior,fury,12,8,4
44252,Maarilayne,wyrmrest-accord,766,warrior,fury,12,8,4
44253,Droggo,cenarius,766,warrior,fury,12,8,4
44254,Drumann,hyjal,766,warrior,fury,12,8,4
44255,Theßull,frostmourne,766,warrior,fury,12,8,4
44256,Ryukendo,stormrage,766,warrior,fury,12,8,4
44257,Alrekur,moon-guard,766,warrior,fury,12,8,4
44258,Arågòrn,stormrage,766,warrior,fury,18,8,10
44259,Sheerwill,wyrmrest-accord,766,warrior,fury,18,8,10
44260,Gromtalin,sargeras,766,warrior,fury,18,8,10
44261,Ayn,llane,766,warrior,fury,18,8,10
44262,Shééylias,moon-guard,766,warrior,fury,24,8,16
44263,Corbray,frostmourne,766,warrior,fury,24,8,16
44264,Syaon,moon-guard,765,warrior,fury,12,8,4
44265,Hellsinga,stormrage,764,warrior,fury,18,8,10
44266,Huri,nemesis,763,warrior,fury,30,8,22
44267,Frettyhooman,blood-furnace,762,warrior,fury,12,8,4
44268,Çampbêll,area-52,762,warrior,fury,24,8,16
44269,Villäïness,daggerspine,760,warrior,fury,12,8,4
44270,Alandris,icecrown,760,warrior,fury,18,10,8
44271,Axekill,bleeding-hollow,760,warrior,fury,24,8,16
44272,Kilp,thrall,751,warrior,fury,17,8,9
44273,Marleau,bleeding-hollow,742,warrior,fury,21,9,12
44274,Urnitemare,hyjal,742,warrior,fury,42,9,33
44275,Tankieone,aggramar,740,warrior,fury,39,11,28
44276,Arngrimm,area-52,735,warrior,fury,14,9,5
44277,Gushee,medivh,735,warrior,fury,17,10,7
44278,Azmael,sargeras,735,warrior,fury,17,8,9
44279,Extremerogu,tichondrius,734,warrior,fury,17,8,9
44280,Alexthar,drakkari,726,warrior,fury,36,10,26
44281,Shapur,tichondrius,719,warrior,fury,11,8,3
44282,Onionlord,wyrmrest-accord,719,warrior,fury,11,8,3
44283,Eleronogoth,draka,704,warrior,fury,16,8,8
44284,Zaraki,moon-guard,704,warrior,fury,16,8,8
44285,Chippurrz,illidan,685,warrior,fury,11,8,3
44286,Krunas,quelthalas,672,warrior,fury,12,7,5
44287,Eino,llane,672,warrior,fury,12,7,5
44288,Ðrëäd,area-52,672,warrior,fury,12,7,5
44289,Maar,lightbringer,672,warrior,fury,12,7,5
44290,Sypii,malganis,672,warrior,fury,12,7,5
44291,Cjz,tichondrius,672,warrior,fury,12,7,5
44292,Kolgrim,hyjal,672,warrior,fury,12,7,5
44293,Canduin,queldorei,672,warrior,fury,12,7,5
44294,Ðow,burning-blade,672,warrior,fury,12,7,5
44295,Unbreakkable,tichondrius,672,warrior,fury,12,7,5
44296,Funsyze,garona,672,warrior,fury,12,7,5
44297,Xårren,stormrage,672,warrior,fury,12,7,5
44298,Kryptonite,illidan,672,warrior,fury,12,7,5
44299,Dós,emerald-dream,672,warrior,fury,12,7,5
44300,Draxxarlol,zuljin,672,warrior,fury,12,7,5
44301,Ladderx,area-52,672,warrior,fury,12,7,5
44302,Ankhxiety,sargeras,672,warrior,fury,12,7,5
44303,Ruckw,stormrage,672,warrior,fury,12,7,5
44304,Prestico,ragnaros,672,warrior,fury,18,7,11
44305,Mardrex,korgath,672,warrior,fury,18,7,11
44306,Warhand,frostmourne,672,warrior,fury,18,7,11
44307,Endlesskilla,destromath,672,warrior,fury,18,7,11
44308,Goaco,drakkari,672,warrior,fury,18,7,11
44309,Potjiekos,lightninghoof,671,warrior,fury,12,7,5
44310,Pelikanesis,arthas,671,warrior,fury,12,7,5
44311,Quintonious,dark-iron,671,warrior,fury,12,7,5
44312,Pancárcho,quelthalas,671,warrior,fury,12,7,5
44313,Lucicicia,bronzebeard,671,warrior,fury,12,7,5
44314,Mág,burning-legion,671,warrior,fury,12,7,5
44315,Seksyme,darkspear,671,warrior,fury,12,7,5
44316,Ahmorok,moon-guard,671,warrior,fury,12,7,5
44317,Iorak,queldorei,671,warrior,fury,12,7,5
44318,Hewman,aerie-peak,671,warrior,fury,12,7,5
44319,Yagluth,illidan,671,warrior,fury,12,7,5
44320,Nokak,borean-tundra,671,warrior,fury,12,7,5
44321,Zikeno,dalaran,671,warrior,fury,12,7,5
44322,Vedrikk,ragnaros,671,warrior,fury,12,7,5
44323,Mullf,stormrage,671,warrior,fury,12,7,5
44324,Remudan,tichondrius,671,warrior,fury,18,7,11
44325,Ghurrk,hyjal,671,warrior,fury,18,7,11
44326,Nondracio,ragnaros,671,warrior,fury,18,7,11
44327,Xochicotzin,mugthol,671,warrior,fury,18,7,11
44328,Ragnir,kelthuzad,671,warrior,fury,18,7,11
44329,Aggravation,bleeding-hollow,671,warrior,fury,18,7,11
44330,Chacca,suramar,671,warrior,fury,18,7,11
44331,Xiosè,ragnaros,671,warrior,fury,24,7,17
44332,Ganon,garrosh,670,warrior,fury,12,7,5
44333,Dragnol,quelthalas,670,warrior,fury,12,7,5
44334,Tiqokz,sargeras,670,warrior,fury,12,7,5
44335,Xauce,queldorei,670,warrior,fury,24,7,17
44336,Rafaeldantas,azralon,669,warrior,fury,12,7,5
44337,Gamoosh,illidan,669,warrior,fury,20,7,13
44338,Deáthwing,steamwheedle-cartel,669,warrior,fury,24,7,17
44339,Shadowtitanx,korgath,669,warrior,fury,30,7,23
44340,Misgnomer,farstriders,667,warrior,fury,12,7,5
44341,Warbane,barthilas,667,warrior,fury,18,7,11
44342,Siiss,stormrage,665,warrior,fury,21,9,12
44343,Keateane,frostmourne,662,warrior,fury,12,7,5
44344,Crashacorn,stormrage,659,warrior,fury,18,7,11
44345,Jendal,ragnaros,658,warrior,fury,12,7,5
44346,Lourdadmiwal,aegwynn,655,warrior,fury,18,7,11
44347,Naughtytwat,tichondrius,639,warrior,fury,14,8,6
44348,Zovudo,area-52,638,warrior,fury,14,8,6
44349,Wintz,dreadmaul,638,warrior,fury,14,8,6
44350,Donjuan,skullcrusher,637,warrior,fury,20,8,12
44351,Nanor,zuljin,635,warrior,fury,14,8,6
44352,Hyperdevil,ragnaros,618,warrior,fury,18,9,9
44353,Furryhorv,frostmourne,608,warrior,fury,22,7,15
44354,Vorthax,korgath,607,warrior,fury,14,7,7
44355,Rohkvan,illidan,607,warrior,fury,14,7,7
44356,Splints,nesingwary,604,warrior,fury,14,7,7
44357,Noktyn,haomarush,591,warrior,fury,11,7,4
44358,Monreale,area-52,576,warrior,fury,6,6,0
44359,Zak,feathermoon,576,warrior,fury,6,6,0
44360,Grïnk,stormrage,576,warrior,fury,6,6,0
44361,Flaapjack,malganis,576,warrior,fury,6,6,0
44362,Contented,illidan,576,warrior,fury,9,7,2
44363,Gtrain,barthilas,576,warrior,fury,12,6,6
44364,Ezeji,area-52,576,warrior,fury,12,6,6
44365,Ggludan,area-52,576,warrior,fury,12,6,6
44366,Endurefen,sargeras,576,warrior,fury,12,6,6
44367,Snowflakee,jaedenar,576,warrior,fury,12,6,6
44368,Serzull,area-52,576,warrior,fury,12,6,6
44369,Disarmed,proudmoore,576,warrior,fury,12,6,6
44370,Vinvivenna,emerald-dream,576,warrior,fury,12,6,6
44371,Gamelagged,area-52,576,warrior,fury,12,6,6
44372,Bestseason,kelthuzad,576,warrior,fury,12,6,6
44373,Skoll,illidan,576,warrior,fury,12,6,6
44374,Rigil,the-forgotten-coast,576,warrior,fury,12,6,6
44375,Carnemølida,thrall,576,warrior,fury,12,6,6
44376,Jcßot,exodar,576,warrior,fury,12,6,6
44377,Whateverzhan,tichondrius,576,warrior,fury,12,6,6
44378,Maydie,illidan,576,warrior,fury,12,6,6
44379,Dëåth,azgalor,576,warrior,fury,12,6,6
44380,Kaivax,tichondrius,576,warrior,fury,12,6,6
44381,Yükana,quelthalas,576,warrior,fury,12,6,6
44382,Ezcharger,kelthuzad,576,warrior,fury,12,6,6
44383,Strongerjaw,tichondrius,576,warrior,fury,12,6,6
44384,Mordoo,zuljin,576,warrior,fury,12,6,6
44385,Faytful,thrall,576,warrior,fury,12,6,6
44386,Ðrënch,tichondrius,576,warrior,fury,12,6,6
44387,Benieswar,frostmourne,576,warrior,fury,12,6,6
44388,Marfas,hyjal,576,warrior,fury,12,6,6
44389,Modzilla,aerie-peak,576,warrior,fury,12,6,6
44390,Gromkhor,tichondrius,576,warrior,fury,12,6,6
44391,Xiaoheihei,tichondrius,576,warrior,fury,12,6,6
44392,Whittyxc,tichondrius,576,warrior,fury,12,6,6
44393,Bonafidesimp,stormrage,576,warrior,fury,12,6,6
44394,Nertharul,zuljin,576,warrior,fury,12,6,6
44395,Yadiig,illidan,576,warrior,fury,12,6,6
44396,Tacrolimus,thrall,576,warrior,fury,12,6,6
44397,Digitaldj,frostmourne,576,warrior,fury,18,6,12
44398,Décapitator,area-52,576,warrior,fury,18,6,12
44399,Hup,dethecus,576,warrior,fury,18,6,12
44400,Cogsbixby,aerie-peak,575,warrior,fury,6,6,0
44401,Boneskull,zuljin,575,warrior,fury,6,6,0
44402,Kratthos,azralon,575,warrior,fury,12,6,6
44403,Isitorganic,nesingwary,575,warrior,fury,12,6,6
44404,Luckychaos,bleeding-hollow,575,warrior,fury,12,6,6
44405,Plidan,shuhalo,575,warrior,fury,12,6,6
44406,Lorelie,malganis,575,warrior,fury,12,6,6
44407,Xenyn,malganis,575,warrior,fury,12,6,6
44408,Kârzâ,dawnbringer,575,warrior,fury,12,6,6
44409,Trackhawk,moon-guard,575,warrior,fury,12,6,6
44410,Greenugly,tichondrius,575,warrior,fury,12,6,6
44411,Chash,frostmourne,575,warrior,fury,12,6,6
44412,Elleaux,bloodscalp,575,warrior,fury,12,6,6
44413,Ironbark,elune,575,warrior,fury,12,6,6
44414,Berario,garrosh,575,warrior,fury,12,6,6
44415,Burninated,tichondrius,575,warrior,fury,12,6,6
44416,Bloodhârdt,area-52,575,warrior,fury,18,6,12
44417,Redblade,bleeding-hollow,575,warrior,fury,18,6,12
44418,Honorloxo,bleeding-hollow,575,warrior,fury,24,6,18
44419,Badairplane,gilneas,574,warrior,fury,12,6,6
44420,Rageroni,tichondrius,574,warrior,fury,12,6,6
44421,Siegeshatter,moon-guard,574,warrior,fury,24,6,18
44422,Deltong,bonechewer,569,warrior,fury,12,6,6
44423,Shiddoshi,ragnaros,569,warrior,fury,12,6,6
44424,Vlark,eredar,568,warrior,fury,12,6,6
44425,Tochixchaos,illidan,543,warrior,fury,14,7,7
44426,Alaricck,quelthalas,543,warrior,fury,14,7,7
44427,Freakin,ragnaros,543,warrior,fury,16,6,10
44428,Ghonad,windrunner,541,warrior,fury,17,6,11
44429,Thorkéll,proudmoore,541,warrior,fury,23,6,17
44430,Sinbãd,sargeras,527,warrior,fury,11,6,5
44431,Agarto,illidan,526,warrior,fury,11,6,5
44432,Cornmaster,darkspear,522,warrior,fury,18,10,8
44433,Onyx,auchindoun,480,warrior,fury,6,5,1
44434,Falconheart,wyrmrest-accord,480,warrior,fury,6,5,1
44435,Tryhardr,sargeras,480,warrior,fury,6,5,1
44436,Timbermack,moon-guard,480,warrior,fury,6,5,1
44437,Swingretzky,zuljin,480,warrior,fury,6,5,1
44438,Korsarro,frostmourne,480,warrior,fury,6,5,1
44439,Kiritarokila,area-52,480,warrior,fury,6,5,1
44440,Goon,frostmourne,480,warrior,fury,6,5,1
44441,Thecollector,borean-tundra,480,warrior,fury,6,5,1
44442,Balrog,firetree,480,warrior,fury,6,5,1
44443,Statistical,area-52,480,warrior,fury,6,5,1
44444,Orkussw,illidan,480,warrior,fury,6,5,1
44445,Finnin,nathrezim,480,warrior,fury,6,5,1
44446,Deseroth,illidan,480,warrior,fury,6,5,1
44447,Kaitlanzhan,malganis,480,warrior,fury,6,5,1
44448,Tazmanianfur,akama,480,warrior,fury,6,5,1
44449,Flanrych,illidan,480,warrior,fury,6,5,1
44450,Devaya,ragnaros,480,warrior,fury,6,5,1
44451,Beleña,dalaran,480,warrior,fury,6,5,1
44452,Smorc,stormrage,480,warrior,fury,6,5,1
44453,Ramranch,dawnbringer,480,warrior,fury,8,5,3
44454,Victoriaöus,emerald-dream,480,warrior,fury,9,5,4
44455,Taurenosaur,illidan,480,warrior,fury,12,5,7
44456,Dtherockj,kiljaeden,480,warrior,fury,12,5,7
44457,Ðìbs,moon-guard,480,warrior,fury,12,5,7
44458,Chop,khadgar,480,warrior,fury,12,5,7
44459,Trekk,azralon,480,warrior,fury,12,5,7
44460,Axesomebody,tichondrius,480,warrior,fury,12,5,7
44461,Marimadelene,aegwynn,480,warrior,fury,12,5,7
44462,Pingolona,nemesis,480,warrior,fury,12,5,7
44463,Lilsweet,moon-guard,480,warrior,fury,12,5,7
44464,Hexmaul,zuljin,480,warrior,fury,12,5,7
44465,Nukemdown,darkspear,480,warrior,fury,12,5,7
44466,Lingho,illidan,480,warrior,fury,12,5,7
44467,Vallkÿria,goldrinn,480,warrior,fury,12,5,7
44468,Archibaldo,darkspear,480,warrior,fury,12,5,7
44469,Clansy,moon-guard,480,warrior,fury,12,5,7
44470,Chainsa,stormrage,480,warrior,fury,12,5,7
44471,Izhansheni,illidan,480,warrior,fury,12,5,7
44472,Kritsg,azgalor,480,warrior,fury,12,5,7
44473,Vvârriôr,barthilas,480,warrior,fury,12,5,7
44474,Warkaiser,ragnaros,480,warrior,fury,12,5,7
44475,Smeshyou,kelthuzad,480,warrior,fury,12,5,7
44476,Còlòssal,moknathal,480,warrior,fury,12,5,7
44477,Sabers,mannoroth,480,warrior,fury,12,5,7
44478,Iwillcrushyo,darkspear,480,warrior,fury,12,5,7
44479,Noteko,tichondrius,480,warrior,fury,12,5,7
44480,Maltrate,hyjal,480,warrior,fury,12,5,7
44481,Cubanßûrst,stormrage,480,warrior,fury,12,5,7
44482,Buhurt,sargeras,480,warrior,fury,12,5,7
44483,Slamuëladams,bleeding-hollow,480,warrior,fury,12,5,7
44484,Tinyterror,sargeras,480,warrior,fury,12,5,7
44485,Pápý,ragnaros,480,warrior,fury,12,5,7
44486,Ironsavage,frostmourne,480,warrior,fury,12,5,7
44487,Carnith,arthas,480,warrior,fury,12,5,7
44488,Sleazedog,kelthuzad,480,warrior,fury,12,5,7
44489,Dalinare,area-52,480,warrior,fury,12,5,7
44490,Orcveinz,tichondrius,480,warrior,fury,17,7,10
44491,Gadlfuerte,ragnaros,480,warrior,fury,14,5,9
44492,Warborn,agamaggan,480,warrior,fury,18,5,13
44493,Spinspin,borean-tundra,480,warrior,fury,18,5,13
44494,Georgedubya,illidan,480,warrior,fury,18,5,13
44495,Dragonrage,tanaris,480,warrior,fury,18,5,13
44496,Thiccsauce,wyrmrest-accord,480,warrior,fury,18,5,13
44497,Zirtag,proudmoore,479,warrior,fury,6,5,1
44498,Vonkinky,sargeras,479,warrior,fury,6,5,1
44499,Morshaz,drakkari,479,warrior,fury,6,5,1
44500,Morasar,area-52,479,warrior,fury,12,5,7
44501,Gros,exodar,479,warrior,fury,12,5,7
44502,Buckets,chogall,479,warrior,fury,12,5,7
44503,Guantid,sargeras,479,warrior,fury,12,5,7
44504,Warsero,tichondrius,479,warrior,fury,12,5,7
44505,Lawyer,quelthalas,479,warrior,fury,12,5,7
44506,Yasser,ragnaros,479,warrior,fury,12,5,7
44507,Olegg,laughing-skull,479,warrior,fury,12,5,7
44508,Ksubîî,frostmourne,479,warrior,fury,12,5,7
44509,Supersquish,moon-guard,479,warrior,fury,18,5,13
44510,Evergardens,saurfang,478,warrior,fury,12,5,7
44511,Welgo,moon-guard,478,warrior,fury,12,5,7
44512,Drovik,malygos,477,warrior,fury,18,5,13
44513,Shhiraq,zuljin,477,warrior,fury,24,5,19
44514,Fabszord,nemesis,476,warrior,fury,12,5,7
44515,Veganwarrior,quelthalas,469,warrior,fury,18,5,13
44516,Torv,frostmourne,447,warrior,fury,8,6,2
44517,Oiledman,emerald-dream,447,warrior,fury,11,5,6
44518,Erdnase,ragnaros,447,warrior,fury,11,5,6
44519,Rageverd,malganis,432,warrior,fury,9,5,4
44520,Chiffonade,kelthuzad,432,warrior,fury,11,6,5
44521,Avatarl,ragnaros,432,warrior,fury,15,5,10
44522,Thalloom,thaurissan,432,warrior,fury,15,5,10
44523,Hugz,thrall,431,warrior,fury,11,5,6
44524,Leónard,moon-guard,431,warrior,fury,11,5,6
44525,Sukstofuk,frostmourne,431,warrior,fury,11,5,6
44526,Glaros,blood-furnace,431,warrior,fury,11,5,6
44527,Panterra,azralon,426,warrior,fury,16,7,9
44528,Israelelel,azralon,416,warrior,fury,10,5,5
44529,Forerunner,tichondrius,416,warrior,fury,10,5,5
44530,Stompgnomes,malganis,414,warrior,fury,14,5,9
44531,Husyuzhi,tichondrius,400,warrior,fury,7,5,2
44532,Painedd,stormrage,384,warrior,fury,6,4,2
44533,Ymirock,area-52,384,warrior,fury,6,4,2
44534,Varkiren,moon-guard,384,warrior,fury,6,4,2
44535,Machutron,quelthalas,384,warrior,fury,6,4,2
44536,Methodicaly,aerie-peak,384,warrior,fury,6,4,2
44537,Alerish,quelthalas,384,warrior,fury,6,4,2
44538,Mortalstrike,chogall,384,warrior,fury,6,4,2
44539,Breké,moon-guard,384,warrior,fury,6,4,2
44540,Drengarusk,area-52,384,warrior,fury,6,4,2
44541,Fornido,quelthalas,384,warrior,fury,6,4,2
44542,Olaqwarraso,sargeras,384,warrior,fury,6,4,2
44543,Phandrosa,ragnaros,384,warrior,fury,6,4,2
44544,Gorgoz,area-52,384,warrior,fury,6,4,2
44545,Sarachnis,area-52,384,warrior,fury,6,4,2
44546,Techanina,aerie-peak,384,warrior,fury,6,4,2
44547,Pepétí,azralon,384,warrior,fury,6,4,2
44548,Nunu,firetree,384,warrior,fury,6,4,2
44549,Amphyctionis,zuljin,384,warrior,fury,6,4,2
44550,Mommystrasza,kelthuzad,384,warrior,fury,6,4,2
44551,Slashen,sargeras,384,warrior,fury,6,4,2
44552,Inocencius,ragnaros,384,warrior,fury,6,4,2
44553,Murghol,malganis,384,warrior,fury,6,4,2
44554,Spraten,bonechewer,384,warrior,fury,6,4,2
44555,Carfal,spirestone,384,warrior,fury,6,4,2
44556,Affeine,malganis,384,warrior,fury,6,4,2
44557,Pz,ravencrest,384,warrior,fury,6,4,2
44558,Hasbullá,ragnaros,384,warrior,fury,6,4,2
44559,Nikomasked,kelthuzad,384,warrior,fury,6,4,2
44560,Brogdar,moon-guard,384,warrior,fury,6,4,2
44561,Squishmello,hyjal,384,warrior,fury,6,4,2
44562,Unpaused,kelthuzad,384,warrior,fury,6,4,2
44563,Rezhan,area-52,384,warrior,fury,6,4,2
44564,Psyrush,area-52,384,warrior,fury,6,4,2
44565,Alecsten,tichondrius,384,warrior,fury,6,4,2
44566,Cidrick,stormrage,384,warrior,fury,6,4,2
44567,Willcharge,tichondrius,384,warrior,fury,6,4,2
44568,Heyzulnut,whisperwind,384,warrior,fury,6,4,2
44569,Boryndin,caelestrasz,384,warrior,fury,6,4,2
44570,Jàmiè,wyrmrest-accord,384,warrior,fury,6,4,2
44571,Nerjinzul,bloodscalp,384,warrior,fury,6,4,2
44572,Mcfatstuffs,boulderfist,384,warrior,fury,6,4,2
44573,Testees,senjin,384,warrior,fury,6,4,2
44574,Suzushi,tichondrius,384,warrior,fury,6,4,2
44575,Braxxinn,tichondrius,384,warrior,fury,6,4,2
44576,Darkoil,illidan,384,warrior,fury,6,4,2
44577,Tomatogodx,sargeras,384,warrior,fury,6,4,2
44578,Qram,illidan,384,warrior,fury,6,4,2
44579,Youdumbaut,tichondrius,384,warrior,fury,6,4,2
44580,Bakadoom,illidan,384,warrior,fury,6,4,2
44581,Blackbaba,illidan,384,warrior,fury,6,4,2
44582,Gorcker,hellscream,384,warrior,fury,6,4,2
44583,Lísterfiend,illidan,384,warrior,fury,6,4,2
44584,Samuluo,tichondrius,384,warrior,fury,6,4,2
44585,Kamidaren,tichondrius,384,warrior,fury,6,4,2
44586,Jutank,sargeras,384,warrior,fury,6,4,2
44587,Negrus,sargeras,384,warrior,fury,11,4,7
44588,Beetcoyne,azuremyst,384,warrior,fury,12,4,8
44589,Sîn,sargeras,384,warrior,fury,12,4,8
44590,Wanderlie,zangarmarsh,384,warrior,fury,12,4,8
44591,Goremack,hellscream,384,warrior,fury,12,4,8
44592,Flexo,moon-guard,384,warrior,fury,12,4,8
44593,Brolgo,quelthalas,384,warrior,fury,12,4,8
44594,Yahnjee,stormrage,384,warrior,fury,12,4,8
44595,Quinntis,anvilmar,384,warrior,fury,12,4,8
44596,Rezzett,wyrmrest-accord,384,warrior,fury,12,4,8
44597,Skrot,stormrage,384,warrior,fury,12,4,8
44598,Eamonvalda,dalaran,384,warrior,fury,12,4,8
44599,Neak,kelthuzad,384,warrior,fury,12,4,8
44600,Choppin,sargeras,384,warrior,fury,12,4,8
44601,Worgasum,black-dragonflight,384,warrior,fury,12,4,8
44602,Goatmanee,tichondrius,384,warrior,fury,12,4,8
44603,Smasher,garona,384,warrior,fury,12,4,8
44604,Dotlom,wyrmrest-accord,384,warrior,fury,12,4,8
44605,Wårrior,kelthuzad,384,warrior,fury,12,4,8
44606,Potan,thrall,384,warrior,fury,12,4,8
44607,Aislistraee,moon-guard,384,warrior,fury,12,4,8
44608,Agonistes,emerald-dream,384,warrior,fury,12,4,8
44609,Zibby,malganis,384,warrior,fury,12,4,8
44610,Luosifen,tichondrius,384,warrior,fury,12,4,8
44611,Truegit,illidan,384,warrior,fury,12,4,8
44612,Metalhaed,thrall,384,warrior,fury,12,4,8
44613,Gorm,greymane,384,warrior,fury,12,4,8
44614,Krodah,quelthalas,384,warrior,fury,12,4,8
44615,Shinshido,tichondrius,384,warrior,fury,12,4,8
44616,Cýnzz,frostmourne,384,warrior,fury,12,4,8
44617,Muradinpica,stormrage,384,warrior,fury,12,4,8
44618,Connero,stormrage,384,warrior,fury,12,4,8
44619,Pigblind,azralon,384,warrior,fury,12,4,8
44620,Rägnarök,stormrage,384,warrior,fury,12,4,8
44621,Corazondleón,ragnaros,384,warrior,fury,12,4,8
44622,Hukzula,illidan,384,warrior,fury,12,4,8
44623,Bladetko,tichondrius,384,warrior,fury,12,4,8
44624,Lsays,tichondrius,384,warrior,fury,18,4,14
44625,Awell,azralon,383,warrior,fury,6,4,2
44626,Mercurial,mugthol,383,warrior,fury,6,4,2
44627,Nelissa,runetotem,383,warrior,fury,6,4,2
44628,Greggor,frostmourne,383,warrior,fury,12,4,8
44629,Galadon,amanthul,383,warrior,fury,12,4,8
44630,Rahmholz,bonechewer,383,warrior,fury,12,4,8
44631,Hæmomancy,moon-guard,383,warrior,fury,12,4,8
44632,Anger,zuljin,383,warrior,fury,24,4,20
44633,Ünö,proudmoore,382,warrior,fury,6,4,2
44634,Fangerbiter,destromath,382,warrior,fury,6,4,2
44635,Solveighelga,drakkari,381,warrior,fury,12,4,8
44636,Bonebreakr,tichondrius,381,warrior,fury,24,4,20
44637,Glennyballs,dalaran,379,warrior,fury,12,4,8
44638,Baxel,arthas,367,warrior,fury,11,4,7
44639,Gotrekson,azralon,351,warrior,fury,11,4,7
44640,Ghazzghkull,illidan,351,warrior,fury,11,4,7
44641,Orangerzze,hyjal,350,warrior,fury,20,5,15
44642,Darkrevel,dalvengyr,335,warrior,fury,11,4,7
44643,Boonn,frostmourne,330,warrior,fury,13,7,6
44644,Kíngkaisér,azralon,330,warrior,fury,15,6,9
44645,Huleo,tichondrius,330,warrior,fury,14,5,9
44646,Mataviejitos,ragnaros,329,warrior,fury,16,7,9
44647,Gentlehugs,illidan,319,warrior,fury,5,4,1
44648,Ángron,ragnaros,319,warrior,fury,5,4,1
44649,Rohde,nemesis,319,warrior,fury,8,4,4
44650,Wallzar,sargeras,304,warrior,fury,13,4,9
44651,Decimateme,tichondrius,288,warrior,fury,6,3,3
44652,Chubw,tichondrius,288,warrior,fury,6,3,3
44653,Instakill,garrosh,288,warrior,fury,6,3,3
44654,Hazknar,azralon,288,warrior,fury,6,3,3
44655,Linara,shandris,288,warrior,fury,6,3,3
44656,Thaann,illidan,288,warrior,fury,6,3,3
44657,Zangre,stormrage,288,warrior,fury,6,3,3
44658,Lechee,silvermoon,288,warrior,fury,6,3,3
44659,Aùstin,moon-guard,288,warrior,fury,6,3,3
44660,Säbeër,ragnaros,288,warrior,fury,6,3,3
44661,Vongrave,moonrunner,288,warrior,fury,6,3,3
44662,Calmebigfeet,tichondrius,288,warrior,fury,6,3,3
44663,Wisslogia,ragnaros,288,warrior,fury,6,3,3
44664,Chapublin,ragnaros,288,warrior,fury,6,3,3
44665,Hithen,quelthalas,288,warrior,fury,6,3,3
44666,Malystik,ragnaros,288,warrior,fury,6,3,3
44667,Worclin,illidan,288,warrior,fury,6,3,3
44668,Wargasms,alterac-mountains,288,warrior,fury,6,3,3
44669,Magnis,stormrage,288,warrior,fury,6,3,3
44670,Slãmpiece,stormrage,288,warrior,fury,6,3,3
44671,Kurowar,drakkari,288,warrior,fury,6,3,3
44672,Riechst,quelthalas,288,warrior,fury,6,3,3
44673,Unng,emerald-dream,288,warrior,fury,6,3,3
44674,Madblackcat,illidan,288,warrior,fury,6,3,3
44675,Kénblock,tichondrius,288,warrior,fury,6,3,3
44676,Rockadoodle,tichondrius,288,warrior,fury,6,3,3
44677,Demobox,malganis,288,warrior,fury,6,3,3
44678,Cocó,sargeras,288,warrior,fury,6,3,3
44679,Razzik,emerald-dream,288,warrior,fury,6,3,3
44680,Twilightrain,tichondrius,288,warrior,fury,6,3,3
44681,Fartden,tichondrius,288,warrior,fury,6,3,3
44682,Painfulsin,tichondrius,288,warrior,fury,6,3,3
44683,Oprampage,illidan,288,warrior,fury,6,3,3
44684,Kujø,wyrmrest-accord,288,warrior,fury,6,3,3
44685,Heavydoody,moon-guard,288,warrior,fury,6,3,3
44686,Bruzerk,ragnaros,288,warrior,fury,6,3,3
44687,Vodak,daggerspine,288,warrior,fury,6,3,3
44688,Swíshersweét,kelthuzad,288,warrior,fury,6,3,3
44689,Thren,tichondrius,288,warrior,fury,6,3,3
44690,Lightswords,stormrage,288,warrior,fury,6,3,3
44691,Santhvel,jubeithos,288,warrior,fury,6,3,3
44692,Klen,kelthuzad,288,warrior,fury,6,3,3
44693,Wwesheamus,frostmourne,288,warrior,fury,6,3,3
44694,Mcdowëll,moon-guard,288,warrior,fury,6,3,3
44695,Milkmebby,bleeding-hollow,288,warrior,fury,6,3,3
44696,Warriorbrain,wyrmrest-accord,288,warrior,fury,6,3,3
44697,Vicegripp,misha,288,warrior,fury,6,3,3
44698,Govosh,thrall,288,warrior,fury,6,3,3
44699,Jethrix,kelthuzad,288,warrior,fury,6,3,3
44700,Seymourbot,illidan,288,warrior,fury,6,3,3
44701,Zerrekarr,wyrmrest-accord,288,warrior,fury,6,3,3
44702,Demøletiøn,stormrage,288,warrior,fury,6,3,3
44703,Nylissia,blood-furnace,288,warrior,fury,6,3,3
44704,Kreamyumyums,tichondrius,288,warrior,fury,6,3,3
44705,Morelz,stormrage,288,warrior,fury,6,3,3
44706,Cassetto,icecrown,288,warrior,fury,6,3,3
44707,Wescer,frostmourne,288,warrior,fury,6,3,3
44708,Barbarìan,bleeding-hollow,288,warrior,fury,6,3,3
44709,Daddyd,sargeras,288,warrior,fury,6,3,3
44710,Beârz,the-underbog,288,warrior,fury,6,3,3
44711,Kahn,andorhal,288,warrior,fury,6,3,3
44712,Ruffless,skullcrusher,288,warrior,fury,6,3,3
44713,Boitoróh,azralon,288,warrior,fury,6,3,3
44714,Resize,wyrmrest-accord,288,warrior,fury,6,3,3
44715,Galachad,jubeithos,288,warrior,fury,6,3,3
44716,Uncritable,dalaran,288,warrior,fury,6,3,3
44717,Tâlos,magtheridon,288,warrior,fury,6,3,3
44718,Taywar,sargeras,288,warrior,fury,6,3,3
44719,Glexecute,sargeras,288,warrior,fury,6,3,3
44720,Rí,moon-guard,288,warrior,fury,6,3,3
44721,Wolfsbanne,khadgar,288,warrior,fury,6,3,3
44722,Gryl,stormrage,288,warrior,fury,6,3,3
44723,Youngmop,eitrigg,288,warrior,fury,6,3,3
44724,Nginx,queldorei,288,warrior,fury,6,3,3
44725,Executie,duskwood,288,warrior,fury,6,3,3
44726,Terazova,tichondrius,288,warrior,fury,6,3,3
44727,Swiftÿ,gurubashi,288,warrior,fury,6,3,3
44728,Carborr,frostmourne,288,warrior,fury,6,3,3
44729,Smxrf,hyjal,288,warrior,fury,6,3,3
44730,Guillotinè,area-52,288,warrior,fury,6,3,3
44731,Gläedr,dalaran,288,warrior,fury,6,3,3
44732,Corvesio,wyrmrest-accord,288,warrior,fury,6,3,3
44733,Scylall,area-52,288,warrior,fury,6,3,3
44734,Arthurston,tichondrius,288,warrior,fury,6,3,3
44735,Skynitez,area-52,288,warrior,fury,6,3,3
44736,Xragnar,area-52,288,warrior,fury,6,3,3
44737,Bothar,sargeras,288,warrior,fury,6,3,3
44738,Scran,sargeras,288,warrior,fury,6,3,3
44739,Herkja,barthilas,288,warrior,fury,6,3,3
44740,Rowdyanders,area-52,288,warrior,fury,6,3,3
44741,Makeranbing,barthilas,288,warrior,fury,6,3,3
44742,Stonksi,shadowmoon,288,warrior,fury,6,3,3
44743,Crowsfall,aggramar,288,warrior,fury,6,3,3
44744,Joarmyman,proudmoore,288,warrior,fury,6,3,3
44745,Tobyrendrson,area-52,288,warrior,fury,6,3,3
44746,Vengxdor,stormrage,288,warrior,fury,6,3,3
44747,Anticiðe,zuljin,288,warrior,fury,6,3,3
44748,Pongk,tichondrius,288,warrior,fury,6,3,3
44749,Júmmy,area-52,288,warrior,fury,6,3,3
44750,Colössal,moon-guard,288,warrior,fury,6,3,3
44751,Orcly,kilrogg,288,warrior,fury,6,3,3
44752,Kimed,nordrassil,288,warrior,fury,6,3,3
44753,Martrek,amanthul,288,warrior,fury,6,3,3
44754,Aeros,winterhoof,288,warrior,fury,6,3,3
44755,Kàli,kiljaeden,288,warrior,fury,6,3,3
44756,Corgii,khaz-modan,288,warrior,fury,6,3,3
44757,Akj,sargeras,288,warrior,fury,6,3,3
44758,Brøly,sargeras,288,warrior,fury,6,3,3
44759,Bled,quelthalas,288,warrior,fury,10,4,6
44760,Kromgrall,tichondrius,288,warrior,fury,12,3,9
44761,Pastorpeen,thrall,288,warrior,fury,12,3,9
44762,Flexìn,tichondrius,288,warrior,fury,12,3,9
44763,Lynn,zangarmarsh,288,warrior,fury,12,3,9
44764,Blackscale,grizzly-hills,288,warrior,fury,12,3,9
44765,Krilles,tichondrius,288,warrior,fury,12,3,9
44766,Kimuraa,hyjal,288,warrior,fury,12,3,9
44767,Kuragdem,trollbane,288,warrior,fury,12,3,9
44768,Leonz,undermine,288,warrior,fury,12,3,9
44769,Seanpaiuwu,zuljin,288,warrior,fury,12,3,9
44770,Forks,malganis,288,warrior,fury,12,3,9
44771,Warseed,ragnaros,288,warrior,fury,12,3,9
44772,Mfgodofwar,kelthuzad,288,warrior,fury,12,3,9
44773,Krimmjðw,sargeras,288,warrior,fury,12,3,9
44774,Apolio,magtheridon,288,warrior,fury,12,3,9
44775,Shínkicker,area-52,288,warrior,fury,12,3,9
44776,Rólex,tichondrius,288,warrior,fury,12,3,9
44777,Banggo,frostmourne,288,warrior,fury,12,3,9
44778,Barcëlð,frostmourne,288,warrior,fury,12,3,9
44779,Zelekron,emerald-dream,288,warrior,fury,12,3,9
44780,Gristly,sargeras,288,warrior,fury,12,3,9
44781,Tríxman,moon-guard,288,warrior,fury,12,3,9
44782,Ratface,frostmourne,288,warrior,fury,12,3,9
44783,Jujuassgeter,darkspear,288,warrior,fury,18,3,15
44784,Eadsmasher,jubeithos,287,warrior,fury,6,3,3
44785,Disclone,tichondrius,287,warrior,fury,6,3,3
44786,Worc,aggramar,287,warrior,fury,6,3,3
44787,Monsterpepe,tichondrius,287,warrior,fury,12,3,9
44788,Boothtowolf,the-forgotten-coast,286,warrior,fury,6,3,3
44789,Bigdaddyzees,bleeding-hollow,255,warrior,fury,11,3,8
44790,Kitiará,area-52,240,warrior,fury,9,4,5
44791,Chupelo,tichondrius,239,warrior,fury,5,3,2
44792,Reagzy,stormrage,234,warrior,fury,10,4,6
44793,Schlosh,laughing-skull,223,warrior,fury,8,3,5
44794,Heirel,kelthuzad,208,warrior,fury,7,3,4
44795,Datneck,tichondrius,192,warrior,fury,4,3,1
44796,Mightypikel,illidan,192,warrior,fury,4,3,1
44797,Çórý,area-52,192,warrior,fury,4,3,1
44798,Drefnor,thunderhorn,192,warrior,fury,9,3,6
44799,Ballinx,illidan,192,warrior,fury,6,2,4
44800,Kokixz,tichondrius,192,warrior,fury,6,2,4
44801,Clerond,tichondrius,192,warrior,fury,6,2,4
44802,Aisinbro,illidan,192,warrior,fury,6,2,4
44803,Brewstrike,dalaran,192,warrior,fury,6,2,4
44804,Shrexecute,tichondrius,192,warrior,fury,6,2,4
44805,Nebraskapete,wyrmrest-accord,192,warrior,fury,6,2,4
44806,Kaniks,dalaran,192,warrior,fury,6,2,4
44807,Tickletickle,illidan,192,warrior,fury,6,2,4
44808,Neifle,tichondrius,192,warrior,fury,6,2,4
44809,Cartmain,illidan,192,warrior,fury,6,2,4
44810,Mortaldznuts,tichondrius,192,warrior,fury,6,2,4
44811,Bighamm,tichondrius,192,warrior,fury,6,2,4
44812,Iapologiz,illidan,192,warrior,fury,6,2,4
44813,Reäl,dalaran,192,warrior,fury,6,2,4
44814,Linios,tichondrius,192,warrior,fury,6,2,4
44815,Gangelx,illidan,192,warrior,fury,6,2,4
44816,Shandrar,frostmourne,192,warrior,fury,6,2,4
44817,Chieef,illidan,192,warrior,fury,6,2,4
44818,Matahorda,darkspear,192,warrior,fury,6,2,4
44819,Tempusbane,proudmoore,192,warrior,fury,6,2,4
44820,Wqnmlgbd,tichondrius,192,warrior,fury,6,2,4
44821,Melithiae,barthilas,192,warrior,fury,6,2,4
44822,Aqee,illidan,192,warrior,fury,6,2,4
44823,Zdokk,sargeras,192,warrior,fury,6,2,4
44824,Skollyd,tichondrius,192,warrior,fury,6,2,4
44825,Wariorwang,tichondrius,192,warrior,fury,6,2,4
44826,Noor,tichondrius,192,warrior,fury,6,2,4
44827,Painstake,illidan,192,warrior,fury,6,2,4
44828,Xorjak,tichondrius,192,warrior,fury,6,2,4
44829,Gakatarc,thrall,192,warrior,fury,6,2,4
44830,Ultraa,lightbringer,192,warrior,fury,6,2,4
44831,Cellyndia,area-52,192,warrior,fury,6,2,4
44832,Daymancometh,proudmoore,192,warrior,fury,6,2,4
44833,Hadowar,thrall,192,warrior,fury,6,2,4
44834,Dragmös,nemesis,192,warrior,fury,6,2,4
44835,Halò,thrall,192,warrior,fury,6,2,4
44836,Bigbadaxe,sargeras,192,warrior,fury,6,2,4
44837,Exsolacyst,sargeras,192,warrior,fury,6,2,4
44838,Supersteak,tichondrius,192,warrior,fury,6,2,4
44839,Bobisyourmom,tichondrius,192,warrior,fury,6,2,4
44840,Swinkyzug,tichondrius,192,warrior,fury,6,2,4
44841,Ragetide,illidan,192,warrior,fury,6,2,4
44842,Assamith,nemesis,192,warrior,fury,6,2,4
44843,Torimzor,nemesis,192,warrior,fury,6,2,4
44844,Sako,amanthul,192,warrior,fury,6,2,4
44845,Kross,illidan,192,warrior,fury,6,2,4
44846,Kachigas,sargeras,192,warrior,fury,6,2,4
44847,Blademaw,stormreaver,192,warrior,fury,6,2,4
44848,Helder,destromath,192,warrior,fury,6,2,4
44849,Saltyniples,aegwynn,192,warrior,fury,6,2,4
44850,Fooko,lethon,192,warrior,fury,6,2,4
44851,Itzyourmom,nazjatar,192,warrior,fury,6,2,4
44852,Oledcktwist,garrosh,192,warrior,fury,6,2,4
44853,Saltyareolas,destromath,192,warrior,fury,6,2,4
44854,Zareos,azralon,192,warrior,fury,6,2,4
44855,Estrozo,sargeras,192,warrior,fury,6,2,4
44856,Containerbox,korgath,192,warrior,fury,6,2,4
44857,Koast,aerie-peak,192,warrior,fury,6,2,4
44858,Peekyblinder,kiljaeden,192,warrior,fury,6,2,4
44859,Erikx,ragnaros,192,warrior,fury,6,2,4
44860,Illicitiri,sargeras,192,warrior,fury,6,2,4
44861,Ghostkin,ragnaros,192,warrior,fury,6,2,4
44862,Horahloux,ragnaros,192,warrior,fury,6,2,4
44863,Twilightzza,sargeras,192,warrior,fury,6,2,4
44864,Amberlym,ragnaros,192,warrior,fury,6,2,4
44865,Xanåtos,moon-guard,192,warrior,fury,6,2,4
44866,Andrexion,moon-guard,192,warrior,fury,6,2,4
44867,Bernardes,stormrage,192,warrior,fury,6,2,4
44868,Gistid,frostmourne,192,warrior,fury,6,2,4
44869,Jeyvil,stormrage,192,warrior,fury,6,2,4
44870,Xtargaryen,stormrage,192,warrior,fury,6,2,4
44871,Beatmeat,frostmourne,192,warrior,fury,6,2,4
44872,Gomachi,moon-guard,192,warrior,fury,6,2,4
44873,Impaling,moon-guard,192,warrior,fury,6,2,4
44874,Elchacál,ragnaros,192,warrior,fury,6,2,4
44875,Tepaste,ragnaros,192,warrior,fury,6,2,4
44876,Azrailz,stormrage,192,warrior,fury,6,2,4
44877,Bachyr,stormrage,192,warrior,fury,6,2,4
44878,Veyronn,stormrage,192,warrior,fury,6,2,4
44879,Hughmungús,frostmourne,192,warrior,fury,6,2,4
44880,Tarkvs,ragnaros,192,warrior,fury,6,2,4
44881,Jägernaught,stormrage,192,warrior,fury,6,2,4
44882,Deafwarrior,sargeras,192,warrior,fury,6,2,4
44883,Twoironfist,azralon,192,warrior,fury,6,2,4
44884,Yeèzy,stormrage,192,warrior,fury,6,2,4
44885,Eîghtysîx,sargeras,192,warrior,fury,6,2,4
44886,Appleleon,ragnaros,192,warrior,fury,6,2,4
44887,Outo,stormrage,192,warrior,fury,6,2,4
44888,ßoris,grizzly-hills,192,warrior,fury,6,2,4
44889,Thrawb,bleeding-hollow,192,warrior,fury,6,2,4
44890,Youdeadx,aegwynn,192,warrior,fury,6,2,4
44891,Vaclein,quelthalas,192,warrior,fury,6,2,4
44892,Warmul,bleeding-hollow,192,warrior,fury,6,2,4
44893,Zultråk,quelthalas,192,warrior,fury,6,2,4
44894,Druckerz,lightnings-blade,192,warrior,fury,6,2,4
44895,Freÿdis,zuljin,192,warrior,fury,6,2,4
44896,Jäëgër,moon-guard,192,warrior,fury,6,2,4
44897,Boombop,zuljin,192,warrior,fury,6,2,4
44898,Rundai,zuljin,192,warrior,fury,6,2,4
44899,Therealflex,zuljin,192,warrior,fury,6,2,4
44900,Tortag,malganis,192,warrior,fury,6,2,4
44901,Drugdilla,zuljin,192,warrior,fury,6,2,4
44902,Stugwar,moon-guard,192,warrior,fury,6,2,4
44903,Sustantus,emerald-dream,192,warrior,fury,6,2,4
44904,Jayynorthyy,malganis,192,warrior,fury,6,2,4
44905,Sveenn,area-52,192,warrior,fury,6,2,4
44906,Ëdwärd,moon-guard,192,warrior,fury,6,2,4
44907,Tigas,icecrown,192,warrior,fury,6,2,4
44908,Lox,blades-edge,192,warrior,fury,6,2,4
44909,Docmoriarty,malygos,192,warrior,fury,6,2,4
44910,Tappyz,area-52,192,warrior,fury,6,2,4
44911,Lepzed,area-52,192,warrior,fury,6,2,4
44912,Slamspam,the-underbog,192,warrior,fury,6,2,4
44913,Arx,frostwolf,192,warrior,fury,6,2,4
44914,Browngusher,sargeras,192,warrior,fury,6,2,4
44915,Onlyslams,sargeras,192,warrior,fury,6,2,4
44916,Aboveaverage,arthas,192,warrior,fury,6,2,4
44917,Rageroidz,area-52,192,warrior,fury,6,2,4
44918,Good,garona,192,warrior,fury,6,2,4
44919,Bariotyr,the-underbog,192,warrior,fury,6,2,4
44920,Franc,kiljaeden,192,warrior,fury,6,2,4
44921,Bonesheild,ursin,192,warrior,fury,11,2,9
44922,Mickyplate,tichondrius,192,warrior,fury,12,2,10
44923,Mnoga,azralon,192,warrior,fury,12,2,10
44924,Doappy,darkspear,192,warrior,fury,12,2,10
44925,Queterompo,ragnaros,192,warrior,fury,12,2,10
44926,Beilian,quelthalas,192,warrior,fury,12,2,10
44927,Norru,moon-guard,192,warrior,fury,12,2,10
44928,Gymnopolar,barthilas,192,warrior,fury,12,2,10
44929,Danastus,icecrown,192,warrior,fury,15,2,13
44930,Naabii,moon-guard,191,warrior,fury,6,2,4
44931,Werrewolf,kul-tiras,191,warrior,fury,6,2,4
44932,Wayne,kargath,160,warrior,fury,16,2,14
44933,Sheluh,illidan,159,warrior,fury,5,2,3
44934,Loosypoosy,magtheridon,159,warrior,fury,5,2,3
44935,Crankyhorn,stormrage,159,warrior,fury,5,2,3
44936,Mariò,area-52,159,warrior,fury,5,2,3
44937,Ngu,eldrethalas,159,warrior,fury,5,2,3
44938,Dräxxär,sargeras,138,warrior,fury,10,3,7
44939,Rhohan,ysera,128,warrior,fury,4,2,2
44940,Fatbarstard,jubeithos,128,warrior,fury,4,2,2
44941,Bootskrapp,azgalor,112,warrior,fury,7,2,5
44942,Bradockqt,azralon,96,warrior,fury,3,2,1
44943,Dabdaddyy,dawnbringer,96,warrior,fury,6,1,5
44944,Largegayman,sargeras,96,warrior,fury,6,1,5
44945,Freanor,azralon,96,warrior,fury,6,1,5
44946,Srze,azralon,96,warrior,fury,6,1,5
44947,Play,dark-iron,96,warrior,fury,6,1,5
44948,Girthyslaps,frostmourne,96,warrior,fury,6,1,5
44949,Kevinersaa,frostmourne,96,warrior,fury,6,1,5
44950,Spartacam,frostmourne,96,warrior,fury,6,1,5
44951,Genesisxp,barthilas,96,warrior,fury,6,1,5
44952,Warriorlee,jubeithos,96,warrior,fury,6,1,5
44953,ßallinjr,illidan,96,warrior,fury,6,1,5
44954,Polox,ragnaros,96,warrior,fury,6,1,5
44955,Wapistun,thrall,96,warrior,fury,6,1,5
44956,Pcprincipal,khadgar,96,warrior,fury,6,1,5
44957,Lifaen,zangarmarsh,96,warrior,fury,6,1,5
44958,Aiforix,gorefiend,96,warrior,fury,6,1,5
44959,Draann,kirin-tor,96,warrior,fury,6,1,5
44960,Alitalia,thunderlord,96,warrior,fury,6,1,5
44961,Swollenbicep,tichondrius,96,warrior,fury,6,1,5
44962,Nerdturd,mannoroth,96,warrior,fury,6,1,5
44963,Ridemepapi,tichondrius,96,warrior,fury,6,1,5
44964,Loveføx,stormrage,96,warrior,fury,6,1,5
44965,Lawlstørm,stormrage,96,warrior,fury,6,1,5
44966,Igmif,stormrage,96,warrior,fury,6,1,5
44967,Grândmâ,zuljin,96,warrior,fury,6,1,5
44968,Dokoba,bleeding-hollow,96,warrior,fury,6,1,5
44969,Andro,arthas,96,warrior,fury,6,1,5
44970,Warrbull,spirestone,96,warrior,fury,6,1,5
44971,Carnagè,area-52,96,warrior,fury,6,1,5
44972,Furyofbeans,area-52,96,warrior,fury,6,1,5
44973,Broxar,area-52,96,warrior,fury,6,1,5
44974,Ustadbaba,area-52,96,warrior,fury,6,1,5
44975,Flabergaster,skullcrusher,96,warrior,fury,6,1,5
44976,Smashkuntz,lightnings-blade,96,warrior,fury,6,1,5
44977,Neotico,quelthalas,96,warrior,fury,6,1,5
44978,Xehm,tichondrius,96,warrior,fury,6,1,5
44979,Vvengencezz,the-underbog,96,warrior,fury,6,1,5
44980,Warritha,ragnaros,96,warrior,fury,6,1,5
44981,Warrdawg,tichondrius,96,warrior,fury,6,1,5
44982,Orsex,ragnaros,96,warrior,fury,6,1,5
44983,Freesubs,sargeras,96,warrior,fury,6,1,5
44984,Aftershóck,daggerspine,96,warrior,fury,6,1,5
44985,Trollchopo,kiljaeden,96,warrior,fury,6,1,5
44986,Kaikah,aegwynn,96,warrior,fury,6,1,5
44987,Keirina,bonechewer,96,warrior,fury,6,1,5
44988,Rexxous,hyjal,96,warrior,fury,6,1,5
44989,Nasrôth,korialstrasz,96,warrior,fury,6,1,5
44990,Bigwarrior,stonemaul,96,warrior,fury,6,1,5
44991,Flywar,nesingwary,96,warrior,fury,6,1,5
44992,Bigk,korgath,96,warrior,fury,6,1,5
44993,Xut,moon-guard,96,warrior,fury,6,1,5
44994,Bbyè,tichondrius,96,warrior,fury,6,1,5
44995,Augutra,moon-guard,96,warrior,fury,6,1,5
44996,Xiaohuzi,tichondrius,96,warrior,fury,6,1,5
44997,Philbert,alexstrasza,96,warrior,fury,6,1,5
44998,Arkayla,moon-guard,96,warrior,fury,6,1,5
44999,Bumrushed,tichondrius,96,warrior,fury,6,1,5
45000,Aladarith,moon-guard,96,warrior,fury,6,1,5
45001,Tamagoshi,kiljaeden,96,warrior,fury,6,1,5
45002,Murrdock,nesingwary,96,warrior,fury,6,1,5
45003,Trén,hydraxis,96,warrior,fury,6,1,5
45004,Magarrior,shadowsong,96,warrior,fury,6,1,5
45005,Osselan,moon-guard,96,warrior,fury,6,1,5
45006,Horabad,terenas,96,warrior,fury,6,1,5
45007,Fletçhér,sargeras,96,warrior,fury,7,1,6
45008,Zaxari,gurubashi,96,warrior,fury,12,1,11
45009,Mamalonic,ragnaros,96,warrior,fury,12,1,11
45010,Mawdryn,destromath,96,warrior,fury,12,1,11
45011,Cremosö,azralon,64,warrior,fury,4,1,3
45012,Gigglamesh,muradin,64,warrior,fury,4,1,3
45013,Coverage,frostmourne,63,warrior,fury,2,2,0
45014,Kirikash,illidan,42,warrior,fury,6,2,4
45015,Husurnanny,dalaran,42,warrior,fury,7,2,5
45016,Lokiullr,tichondrius,42,warrior,fury,9,2,7
45017,Ztg,tichondrius,42,warrior,fury,11,2,9
45018,Vioar,hyjal,31,warrior,fury,2,1,1
45019,Racknon,ragnaros,16,warrior,fury,1,1,0
45020,Sanduin,drakkari,16,warrior,fury,1,1,0
45021,Río,area-52,2216,warrior,arms,136,72,64
45022,Hapigirl,tichondrius,2193,warrior,arms,60,43,17
45023,Exzistance,area-52,2168,warrior,arms,110,58,52
45024,Thiccbiscuit,area-52,2168,warrior,arms,133,67,66
45025,Zhanwudix,tichondrius,2162,warrior,arms,111,62,49
45026,Killbørn,azralon,2156,warrior,arms,90,47,43
45027,Turtleboy,feathermoon,2141,warrior,arms,79,45,34
45028,Todory,moon-guard,2137,warrior,arms,155,78,77
45029,Ðêed,area-52,2133,warrior,arms,81,46,35
45030,Dpoy,tichondrius,2128,warrior,arms,108,54,54
45031,Kraftyx,bleeding-hollow,2125,warrior,arms,72,44,28
45032,Ssamök,ragnaros,2125,warrior,arms,329,168,161
45033,Huzha,tichondrius,2114,warrior,arms,117,64,53
45034,Warried,sargeras,2113,warrior,arms,66,37,29
45035,Tyranitar,proudmoore,2113,warrior,arms,90,50,40
45036,Strife,sargeras,2112,warrior,arms,56,32,24
45037,Buckwar,zuljin,2110,warrior,arms,72,39,33
45038,Vituu,sargeras,2104,warrior,arms,104,54,50
45039,Killborn,tichondrius,2104,warrior,arms,145,73,72
45040,Edgarllama,sargeras,2103,warrior,arms,87,48,39
45041,ßallinjr,illidan,2103,warrior,arms,90,46,44
45042,Huuzha,tichondrius,2102,warrior,arms,95,55,40
45043,Récksus,tichondrius,2101,warrior,arms,74,43,31
45044,Nikomasked,kelthuzad,2100,warrior,arms,66,37,29
45045,Schonkopf,moon-guard,2100,warrior,arms,90,46,44
45046,Vø,agamaggan,2097,warrior,arms,141,73,68
45047,Menethíl,tichondrius,2075,warrior,arms,88,48,40
45048,Leans,sargeras,2048,warrior,arms,143,78,65
45049,Exespamtwo,area-52,2044,warrior,arms,194,106,88
45050,Abswar,tichondrius,2043,warrior,arms,84,54,30
45051,Recksus,tichondrius,2041,warrior,arms,101,63,38
45052,Grantlol,illidan,2033,warrior,arms,96,55,41
45053,Orclog,illidan,2033,warrior,arms,72,37,35
45054,Perfs,bleeding-hollow,2031,warrior,arms,90,48,42
45055,Kimchikick,tichondrius,2019,warrior,arms,173,92,81
45056,Gyracide,area-52,2016,warrior,arms,101,49,52
45057,Tryhardr,sargeras,2004,warrior,arms,194,107,87
45058,Bacchanal,illidan,2003,warrior,arms,120,62,58
45059,Foxxfighter,thrall,2000,warrior,arms,77,40,37
45060,Nuqipq,tichondrius,1997,warrior,arms,54,31,23
45061,Cloudxxy,kiljaeden,1988,warrior,arms,69,38,31
45062,Ikkyuo,proudmoore,1984,warrior,arms,96,48,48
45063,Zankets,area-52,1981,warrior,arms,144,74,70
45064,Veilsidewar,kelthuzad,1980,warrior,arms,324,176,148
45065,Boblennon,tichondrius,1977,warrior,arms,72,33,39
45066,Ironbad,sargeras,1975,warrior,arms,94,50,44
45067,Exëqt,nemesis,1974,warrior,arms,114,61,53
45068,Lyrics,tichondrius,1969,warrior,arms,62,32,30
45069,Pdbq,tichondrius,1968,warrior,arms,108,56,52
45070,Icarryrats,tichondrius,1967,warrior,arms,81,39,42
45071,Fanglerondz,area-52,1966,warrior,arms,42,25,17
45072,Bighamm,tichondrius,1965,warrior,arms,71,40,31
45073,Ælilblessedñ,azralon,1964,warrior,arms,154,81,73
45074,Massacretko,area-52,1962,warrior,arms,88,50,38
45075,Og,shattered-hand,1958,warrior,arms,47,29,18
45076,Foraken,dragonmaw,1948,warrior,arms,59,36,23
45077,Belàriá,tichondrius,1948,warrior,arms,66,36,30
45078,Bhaldur,sargeras,1945,warrior,arms,128,72,56
45079,Islonely,tichondrius,1944,warrior,arms,138,63,75
45080,Yermalx,tichondrius,1941,warrior,arms,54,30,24
45081,Barrbarossa,stormrage,1932,warrior,arms,139,73,66
45082,Toutie,tichondrius,1932,warrior,arms,48,24,24
45083,Marsshine,tichondrius,1930,warrior,arms,72,33,39
45084,Trezturbo,tichondrius,1929,warrior,arms,129,70,59
45085,Kalpok,tichondrius,1928,warrior,arms,58,30,28
45086,Ricorecklezz,korgath,1925,warrior,arms,66,32,34
45087,Marfas,hyjal,1924,warrior,arms,157,86,71
45088,Sziw,tichondrius,1924,warrior,arms,186,98,88
45089,Eqztw,tichondrius,1923,warrior,arms,137,86,51
45090,Jgillz,sargeras,1922,warrior,arms,72,39,33
45091,Gormag,sargeras,1917,warrior,arms,60,35,25
45092,Smorc,stormrage,1917,warrior,arms,60,31,29
45093,Granzelion,tichondrius,1912,warrior,arms,120,61,59
45094,Bigbait,hyjal,1912,warrior,arms,72,36,36
45095,Tankypandazd,stormrage,1910,warrior,arms,198,97,101
45096,Cosmicsteel,tichondrius,1908,warrior,arms,88,51,37
45097,Solastro,malganis,1906,warrior,arms,74,35,39
45098,Destrey,emerald-dream,1905,warrior,arms,71,41,30
45099,Yermalt,tichondrius,1905,warrior,arms,80,41,39
45100,Arivok,hyjal,1905,warrior,arms,143,73,70
45101,Mítos,quelthalas,1904,warrior,arms,198,101,97
45102,Painqt,area-52,1903,warrior,arms,24,20,4
45103,Cutgirl,quelthalas,1903,warrior,arms,74,38,36
45104,Madblackcat,illidan,1902,warrior,arms,58,34,24
45105,Isnlonely,tichondrius,1901,warrior,arms,42,26,16
45106,Rageroidz,area-52,1901,warrior,arms,72,40,32
45107,Azaks,drakkari,1900,warrior,arms,52,28,24
45108,Jadeemerald,kelthuzad,1897,warrior,arms,66,37,29
45109,Míasma,ragnaros,1895,warrior,arms,72,34,38
45110,Salgadoryan,stormrage,1894,warrior,arms,196,95,101
45111,Lícketysplít,ysondre,1893,warrior,arms,52,29,23
45112,Kydrav,khadgar,1891,warrior,arms,52,28,24
45113,Zindawg,frostmourne,1891,warrior,arms,247,123,124
45114,Paoxiaolol,tichondrius,1890,warrior,arms,73,47,26
45115,Jdubz,frostmourne,1889,warrior,arms,66,36,30
45116,Joshiguy,area-52,1889,warrior,arms,78,36,42
45117,Etchiasoko,gurubashi,1888,warrior,arms,48,33,15
45118,Betterthanu,azralon,1885,warrior,arms,174,91,83
45119,Facefïster,malganis,1883,warrior,arms,48,28,20
45120,Baitson,hyjal,1882,warrior,arms,60,30,30
45121,Masumura,kaelthas,1877,warrior,arms,62,31,31
45122,Bùbbájr,emerald-dream,1874,warrior,arms,66,31,35
45123,Dishonorkill,dentarg,1873,warrior,arms,37,25,12
45124,Xîonorc,ragnaros,1872,warrior,arms,189,96,93
45125,Leoneceo,azralon,1871,warrior,arms,90,56,34
45126,Shadowstingg,tichondrius,1871,warrior,arms,71,33,38
45127,Ignid,tichondrius,1871,warrior,arms,108,49,59
45128,Executeqt,azralon,1870,warrior,arms,149,82,67
45129,Huugg,skullcrusher,1870,warrior,arms,99,52,47
45130,Dawx,thrall,1862,warrior,arms,65,32,33
45131,Pezy,frostmourne,1858,warrior,arms,120,59,61
45132,Spìke,thrall,1856,warrior,arms,149,75,74
45133,Pooshshi,illidan,1855,warrior,arms,60,29,31
45134,Falindrah,moon-guard,1854,warrior,arms,66,32,34
45135,Archosaurs,illidan,1854,warrior,arms,48,23,25
45136,Evnine,illidan,1853,warrior,arms,39,29,10
45137,Bakadoom,illidan,1853,warrior,arms,90,53,37
45138,Rafheeki,tichondrius,1853,warrior,arms,90,49,41
45139,Ruzoc,frostmourne,1851,warrior,arms,112,50,62
45140,Demetor,skywall,1850,warrior,arms,53,27,26
45141,Jikith,proudmoore,1847,warrior,arms,48,23,25
45142,Icon,tichondrius,1846,warrior,arms,46,35,11
45143,Blozar,illidan,1846,warrior,arms,60,30,30
45144,Blackpînk,tichondrius,1845,warrior,arms,54,32,22
45145,Randydanger,illidan,1845,warrior,arms,66,32,34
45146,Battousai,kiljaeden,1844,warrior,arms,54,27,27
45147,Sukonamí,draka,1842,warrior,arms,60,33,27
45148,Madwolf,tichondrius,1842,warrior,arms,103,51,52
45149,Krunnknator,azralon,1840,warrior,arms,41,26,15
45150,Kigame,tichondrius,1840,warrior,arms,96,53,43
45151,Narwhål,tichondrius,1840,warrior,arms,90,44,46
45152,Orçaos,ragnaros,1839,warrior,arms,126,73,53
45153,Warney,tichondrius,1838,warrior,arms,53,31,22
45154,Uzza,stormrage,1838,warrior,arms,60,34,26
45155,Draus,nemesis,1838,warrior,arms,119,67,52
45156,Kylewalker,tichondrius,1838,warrior,arms,71,32,39
45157,Adaana,kargath,1836,warrior,arms,119,70,49
45158,Mantrà,skullcrusher,1836,warrior,arms,42,24,18
45159,Szw,tichondrius,1836,warrior,arms,221,124,97
45160,Vatix,sargeras,1836,warrior,arms,50,28,22
45161,Ânticide,darkspear,1836,warrior,arms,78,40,38
45162,Zacharyx,tichondrius,1836,warrior,arms,242,118,124
45163,Croc,frostmourne,1834,warrior,arms,32,21,11
45164,Fleegugeegu,malganis,1834,warrior,arms,90,45,45
45165,Yossarrion,frostwolf,1833,warrior,arms,48,25,23
45166,Arthurjlol,tichondrius,1833,warrior,arms,54,24,30
45167,Brilliance,suramar,1832,warrior,arms,60,30,30
45168,Hildemir,tichondrius,1831,warrior,arms,88,52,36
45169,Darrowshire,moon-guard,1831,warrior,arms,41,23,18
45170,Frëdsmite,kelthuzad,1831,warrior,arms,144,77,67
45171,Zira,thrall,1831,warrior,arms,133,69,64
45172,Damage,malganis,1829,warrior,arms,48,23,25
45173,Bahlahkay,proudmoore,1829,warrior,arms,48,23,25
45174,Ruinenlust,zuljin,1828,warrior,arms,60,28,32
45175,Elpappa,tichondrius,1827,warrior,arms,48,42,6
45176,Sanquelme,ragnaros,1827,warrior,arms,63,32,31
45177,Jonathann,suramar,1827,warrior,arms,132,65,67
45178,Samuluo,tichondrius,1827,warrior,arms,66,30,36
45179,Blaíze,ragnaros,1826,warrior,arms,44,24,20
45180,Grayview,sargeras,1826,warrior,arms,77,41,36
45181,Seblleddo,drakkari,1826,warrior,arms,66,34,32
45182,Rebied,ragnaros,1826,warrior,arms,96,43,53
45183,Warriorbloo,sargeras,1825,warrior,arms,72,39,33
45184,Lebanesemvp,tichondrius,1825,warrior,arms,85,45,40
45185,Sandycrack,blackrock,1825,warrior,arms,60,30,30
45186,Coby,wildhammer,1823,warrior,arms,65,36,29
45187,Gbar,azralon,1823,warrior,arms,79,42,37
45188,Bigdaddyxo,whisperwind,1823,warrior,arms,47,24,23
45189,Cyster,proudmoore,1822,warrior,arms,42,24,18
45190,Kiggs,tichondrius,1822,warrior,arms,48,27,21
45191,Soultarius,area-52,1822,warrior,arms,69,36,33
45192,Kurï,duskwood,1822,warrior,arms,51,24,27
45193,Pkkcrisis,archimonde,1822,warrior,arms,60,28,32
45194,Kamoo,bonechewer,1820,warrior,arms,48,27,21
45195,Meccsecute,tichondrius,1820,warrior,arms,102,54,48
45196,Anautumnday,tichondrius,1820,warrior,arms,48,24,24
45197,Aggnilia,proudmoore,1820,warrior,arms,102,50,52
45198,Honock,ragnaros,1820,warrior,arms,72,34,38
45199,Boomergodx,stormrage,1819,warrior,arms,96,56,40
45200,Badboyjan,tichondrius,1818,warrior,arms,30,19,11
45201,Nilah,tichondrius,1818,warrior,arms,46,26,20
45202,Yeawen,tichondrius,1818,warrior,arms,42,23,19
45203,Nozmok,proudmoore,1818,warrior,arms,65,33,32
45204,Wutains,tichondrius,1818,warrior,arms,65,33,32
45205,Thugdorr,sargeras,1818,warrior,arms,70,33,37
45206,Smashxx,area-52,1816,warrior,arms,95,55,40
45207,Deadhate,sargeras,1816,warrior,arms,54,28,26
45208,Missrend,hyjal,1816,warrior,arms,114,57,57
45209,Strongbaby,tichondrius,1816,warrior,arms,60,30,30
45210,Berzek,area-52,1816,warrior,arms,59,23,36
45211,Destram,kelthuzad,1815,warrior,arms,107,57,50
45212,Icanfixher,moon-guard,1815,warrior,arms,451,222,229
45213,Cammerz,area-52,1815,warrior,arms,78,36,42
45214,Anti,nerzhul,1814,warrior,arms,57,30,27
45215,Dissector,ragnaros,1814,warrior,arms,54,28,26
45216,Zapatín,quelthalas,1814,warrior,arms,67,32,35
45217,Mäddôx,tichondrius,1814,warrior,arms,126,60,66
45218,Slaten,barthilas,1813,warrior,arms,119,63,56
45219,Ðìbs,moon-guard,1813,warrior,arms,59,31,28
45220,Utxpia,azralon,1812,warrior,arms,53,26,27
45221,Onebraincell,stormrage,1811,warrior,arms,48,34,14
45222,Gohrgroc,quelthalas,1811,warrior,arms,48,30,18
45223,Glocç,sargeras,1811,warrior,arms,112,59,53
45224,Knuklez,tichondrius,1811,warrior,arms,64,33,31
45225,Dangerousd,kiljaeden,1811,warrior,arms,60,30,30
45226,Vergerak,tichondrius,1811,warrior,arms,58,29,29
45227,Kaimedran,moon-guard,1810,warrior,arms,48,30,18
45228,Kriloth,frostmourne,1810,warrior,arms,50,30,20
45229,Bussupshut,kelthuzad,1810,warrior,arms,64,32,32
45230,Ürürææae,sargeras,1810,warrior,arms,189,94,95
45231,Darkduet,tichondrius,1810,warrior,arms,70,33,37
45232,Møcat,illidan,1809,warrior,arms,90,52,38
45233,Gryffith,bleeding-hollow,1809,warrior,arms,81,36,45
45234,Vâlôr,tichondrius,1808,warrior,arms,45,30,15
45235,Ciz,emerald-dream,1808,warrior,arms,64,34,30
45236,Spartus,kelthuzad,1808,warrior,arms,78,32,46
45237,Crøm,tichondrius,1807,warrior,arms,48,29,19
45238,Crowsfall,aggramar,1807,warrior,arms,268,141,127
45239,Xiaoheihei,tichondrius,1806,warrior,arms,174,88,86
45240,Sickwidit,kiljaeden,1805,warrior,arms,49,28,21
45241,Noblewinter,sargeras,1805,warrior,arms,36,19,17
45242,Tenskj,proudmoore,1805,warrior,arms,57,30,27
45243,Wootzu,zuljin,1805,warrior,arms,54,27,27
45244,Mildlol,tichondrius,1804,warrior,arms,42,25,17
45245,Rookìe,illidan,1804,warrior,arms,119,67,52
45246,Peinx,ragnaros,1804,warrior,arms,59,31,28
45247,Blackpinkx,tichondrius,1804,warrior,arms,42,19,23
45248,Vascoes,alleria,1803,warrior,arms,168,92,76
45249,Ollena,wyrmrest-accord,1803,warrior,arms,78,40,38
45250,Cgelangdula,tichondrius,1802,warrior,arms,54,28,26
45251,Matesan,jubeithos,1801,warrior,arms,48,28,20
45252,Hìm,tichondrius,1801,warrior,arms,54,28,26
45253,Chakø,tichondrius,1800,warrior,arms,78,42,36
45254,Këther,tichondrius,1800,warrior,arms,66,33,33
45255,Kustybuckets,korgath,1798,warrior,arms,46,27,19
45256,Comehnrfce,illidan,1798,warrior,arms,122,55,67
45257,Überwältigen,thrall,1796,warrior,arms,48,22,26
45258,Stáclin,ragnaros,1795,warrior,arms,392,217,175
45259,Brahmo,kelthuzad,1794,warrior,arms,60,33,27
45260,Ksharer,tichondrius,1793,warrior,arms,83,38,45
45261,Tehfury,area-52,1792,warrior,arms,51,24,27
45262,Sponsored,argent-dawn,1792,warrior,arms,59,26,33
45263,Kruma,stormscale,1791,warrior,arms,37,22,15
45264,Debbie,bleeding-hollow,1790,warrior,arms,60,31,29
45265,Beanbags,zangarmarsh,1790,warrior,arms,72,36,36
45266,Nuvola,tichondrius,1789,warrior,arms,60,33,27
45267,Melifehorde,tichondrius,1787,warrior,arms,48,25,23
45268,Bigglyjoobs,tichondrius,1787,warrior,arms,78,38,40
45269,Forakenna,dragonmaw,1785,warrior,arms,41,27,14
45270,Musclehead,moon-guard,1785,warrior,arms,69,45,24
45271,Wulouzhan,tichondrius,1785,warrior,arms,89,52,37
45272,Nïcowo,ragnaros,1783,warrior,arms,134,67,67
45273,Dabdaddyy,dawnbringer,1783,warrior,arms,99,47,52
45274,Ígnatius,malganis,1781,warrior,arms,48,31,17
45275,Samwolok,tichondrius,1780,warrior,arms,36,19,17
45276,Mecc,tichondrius,1780,warrior,arms,60,29,31
45277,Nanchobo,tichondrius,1778,warrior,arms,66,28,38
45278,Bladebuster,stormrage,1777,warrior,arms,42,23,19
45279,Hoboedd,area-52,1776,warrior,arms,40,22,18
45280,Ariést,bleeding-hollow,1776,warrior,arms,66,30,36
45281,Longzhan,tichondrius,1776,warrior,arms,84,37,47
45282,Sayîon,zuljin,1773,warrior,arms,108,57,51
45283,Undefied,moon-guard,1772,warrior,arms,51,29,22
45284,Cushman,tichondrius,1772,warrior,arms,132,73,59
45285,Picarus,thunderhorn,1772,warrior,arms,60,32,28
45286,Sharer,tichondrius,1772,warrior,arms,36,19,17
45287,Noodlezz,moon-guard,1772,warrior,arms,65,31,34
45288,Skolltonxoxo,tichondrius,1772,warrior,arms,42,20,22
45289,Kaÿip,tichondrius,1771,warrior,arms,66,34,32
45290,Asstastic,bonechewer,1771,warrior,arms,137,64,73
45291,Evach,kelthuzad,1770,warrior,arms,40,21,19
45292,Tùngrâu,frostmourne,1769,warrior,arms,172,89,83
45293,Thlam,muradin,1768,warrior,arms,131,69,62
45294,Dalan,korgath,1766,warrior,arms,48,30,18
45295,Rólex,tichondrius,1766,warrior,arms,54,25,29
45296,Støne,draktharon,1764,warrior,arms,74,41,33
45297,Krbigcow,tichondrius,1764,warrior,arms,96,49,47
45298,Goodlikeplay,ragnaros,1762,warrior,arms,48,25,23
45299,Okita,bleeding-hollow,1761,warrior,arms,118,60,58
45300,Invalidoath,tichondrius,1760,warrior,arms,54,27,27
45301,Dawxw,thrall,1759,warrior,arms,41,24,17
45302,Everchosen,proudmoore,1758,warrior,arms,111,57,54
45303,Yonkerss,garrosh,1756,warrior,arms,95,51,44
45304,Marchdream,tichondrius,1756,warrior,arms,60,32,28
45305,Mirado,tichondrius,1755,warrior,arms,72,38,34
45306,Hbrandy,tichondrius,1752,warrior,arms,71,35,36
45307,Ddaÿ,tichondrius,1752,warrior,arms,53,24,29
45308,Tutifrutiø,azralon,1750,warrior,arms,108,49,59
45309,Warfuse,illidan,1749,warrior,arms,126,63,63
45310,Nànchobo,tichondrius,1749,warrior,arms,72,31,41
45311,Bigdude,frostwolf,1748,warrior,arms,66,38,28
45312,Goonassassin,tichondrius,1748,warrior,arms,48,24,24
45313,Polydopam,tichondrius,1746,warrior,arms,104,53,51
45314,Coldlòve,akama,1744,warrior,arms,36,22,14
45315,Kurodia,quelthalas,1744,warrior,arms,84,35,49
45316,Ogrelurd,malygos,1743,warrior,arms,42,22,20
45317,Brendanshwab,bleeding-hollow,1743,warrior,arms,89,44,45
45318,Iwillcrushyo,darkspear,1743,warrior,arms,54,26,28
45319,Razw,frostmourne,1742,warrior,arms,36,23,13
45320,Dogmar,staghelm,1739,warrior,arms,110,54,56
45321,Wartruë,tichondrius,1738,warrior,arms,256,136,120
45322,Doublezuglol,tichondrius,1737,warrior,arms,162,83,79
45323,Danceylol,barthilas,1736,warrior,arms,78,37,41
45324,Lvlthreemage,fizzcrank,1733,warrior,arms,72,34,38
45325,Nightheller,stormrage,1733,warrior,arms,78,33,45
45326,Hoobaz,area-52,1732,warrior,arms,34,19,15
45327,Slaught,kelthuzad,1731,warrior,arms,76,37,39
45328,Tiredkev,tichondrius,1726,warrior,arms,60,32,28
45329,Mantistabogn,zuluhed,1726,warrior,arms,82,43,39
45330,Swifty,anvilmar,1725,warrior,arms,30,18,12
45331,Crushedlol,bleeding-hollow,1725,warrior,arms,42,22,20
45332,Athalen,nemesis,1724,warrior,arms,67,33,34
45333,Relerocker,area-52,1722,warrior,arms,101,53,48
45334,Swordborne,moon-guard,1722,warrior,arms,94,43,51
45335,Itsfall,tichondrius,1721,warrior,arms,42,21,21
45336,Sick,azralon,1720,warrior,arms,52,27,25
45337,Abbastanza,tichondrius,1720,warrior,arms,77,32,45
45338,Zenrrei,ragnaros,1718,warrior,arms,133,74,59
45339,Afrikunt,tichondrius,1717,warrior,arms,72,38,34
45340,Cåfe,tichondrius,1715,warrior,arms,119,66,53
45341,Mezdrì,quelthalas,1714,warrior,arms,54,33,21
45342,Milough,nesingwary,1714,warrior,arms,124,71,53
45343,Línfert,stormrage,1714,warrior,arms,172,94,78
45344,Smokes,sargeras,1714,warrior,arms,114,55,59
45345,Bigladmike,sargeras,1714,warrior,arms,48,21,27
45346,Odiseo,ragnaros,1713,warrior,arms,38,22,16
45347,Basedaf,frostmourne,1713,warrior,arms,84,45,39
45348,Kilgorath,area-52,1713,warrior,arms,78,37,41
45349,Murderbell,tichondrius,1711,warrior,arms,90,45,45
45350,Alëwar,quelthalas,1711,warrior,arms,60,28,32
45351,Warginger,malygos,1710,warrior,arms,41,23,18
45352,Partyx,tichondrius,1710,warrior,arms,229,117,112
45353,Ggtk,tichondrius,1709,warrior,arms,48,24,24
45354,Pachacutecxx,ragnaros,1708,warrior,arms,75,40,35
45355,Smashies,kelthuzad,1708,warrior,arms,47,24,23
45356,Gromkhor,tichondrius,1708,warrior,arms,72,30,42
45357,Chaytin,bleeding-hollow,1707,warrior,arms,50,27,23
45358,Paoxiaoevs,tichondrius,1707,warrior,arms,36,18,18
45359,Joebo,thrall,1706,warrior,arms,24,20,4
45360,Unhòólyshy,ragnaros,1704,warrior,arms,42,27,15
45361,Cokeroom,tichondrius,1704,warrior,arms,79,46,33
45362,Niubzs,tichondrius,1704,warrior,arms,53,27,26
45363,Tepaste,ragnaros,1704,warrior,arms,54,27,27
45364,Battlestance,shadowsong,1704,warrior,arms,53,22,31
45365,Ðíablø,tichondrius,1703,warrior,arms,71,40,31
45366,Maddawgg,mugthol,1702,warrior,arms,46,23,23
45367,Nuccî,azralon,1702,warrior,arms,47,23,24
45368,Misakizs,illidan,1701,warrior,arms,61,26,35
45369,Zarrdune,darkspear,1700,warrior,arms,30,21,9
45370,Thrator,wyrmrest-accord,1699,warrior,arms,42,23,19
45371,Rocta,tichondrius,1698,warrior,arms,86,47,39
45372,Johnburns,tichondrius,1698,warrior,arms,36,19,17
45373,Urdem,moon-guard,1697,warrior,arms,120,63,57
45374,Warkingx,tichondrius,1696,warrior,arms,36,18,18
45375,Hariban,shuhalo,1695,warrior,arms,65,31,34
45376,Ashtonx,sargeras,1694,warrior,arms,36,24,12
45377,Jubeithos,draktharon,1694,warrior,arms,47,27,20
45378,Genghiz,azralon,1694,warrior,arms,66,36,30
45379,Arx,frostwolf,1694,warrior,arms,153,82,71
45380,Hoodrch,azralon,1694,warrior,arms,65,32,33
45381,Lôwkeyfix,illidan,1694,warrior,arms,96,46,50
45382,Tastý,moon-guard,1694,warrior,arms,54,22,32
45383,Delphont,stormrage,1693,warrior,arms,107,59,48
45384,Wargasmx,tichondrius,1693,warrior,arms,58,27,31
45385,Wolfcultist,moon-guard,1693,warrior,arms,72,32,40
45386,Endstorm,proudmoore,1692,warrior,arms,56,27,29
45387,Zaÿne,moon-guard,1692,warrior,arms,87,41,46
45388,Hookahboss,area-52,1692,warrior,arms,52,24,28
45389,Soloqandy,moon-guard,1692,warrior,arms,72,29,43
45390,Wolfsbanne,khadgar,1690,warrior,arms,138,76,62
45391,Kolosal,tichondrius,1690,warrior,arms,45,22,23
45392,Bozzy,illidan,1690,warrior,arms,77,34,43
45393,Kâdé,malganis,1689,warrior,arms,30,18,12
45394,Lostsummer,frostmourne,1689,warrior,arms,58,31,27
45395,Rflexxo,tichondrius,1688,warrior,arms,48,24,24
45396,Bigbrick,stormrage,1688,warrior,arms,90,44,46
45397,Vargoth,frostmourne,1687,warrior,arms,48,24,24
45398,Raph,barthilas,1686,warrior,arms,42,25,17
45399,Zastrow,dalaran,1686,warrior,arms,84,33,51
45400,Meowdaa,proudmoore,1686,warrior,arms,72,24,48
45401,Pipedoctor,kelthuzad,1685,warrior,arms,36,23,13
45402,Bbyè,tichondrius,1685,warrior,arms,234,121,113
45403,Jdubzr,frostmourne,1685,warrior,arms,54,27,27
45404,Sindevelor,tichondrius,1684,warrior,arms,89,50,39
45405,Bebob,tichondrius,1684,warrior,arms,62,33,29
45406,Bmo,chogall,1684,warrior,arms,87,44,43
45407,Chimbrila,azralon,1684,warrior,arms,102,44,58
45408,Patwong,frostmourne,1683,warrior,arms,90,51,39
45409,Nazraill,aggramar,1683,warrior,arms,75,42,33
45410,Kralo,moon-guard,1683,warrior,arms,51,26,25
45411,Shinigamix,steamwheedle-cartel,1682,warrior,arms,48,29,19
45412,Janjannodie,tichondrius,1682,warrior,arms,41,20,21
45413,Sherrywalken,azralon,1681,warrior,arms,67,36,31
45414,Bloodbath,kiljaeden,1680,warrior,arms,41,21,20
45415,Stonesoup,kelthuzad,1680,warrior,arms,83,33,50
45416,Gtr,illidan,1679,warrior,arms,48,31,17
45417,Gravewurm,twisting-nether,1679,warrior,arms,42,24,18
45418,Dramalas,lightbringer,1679,warrior,arms,269,136,133
45419,Killimanjaro,aggramar,1679,warrior,arms,53,22,31
45420,Twilightrain,tichondrius,1678,warrior,arms,352,187,165
45421,Swagramarr,area-52,1677,warrior,arms,93,51,42
45422,Hèphæstús,sargeras,1677,warrior,arms,120,62,58
45423,Mynameyaff,tichondrius,1676,warrior,arms,133,75,58
45424,Ochinching,tichondrius,1676,warrior,arms,60,24,36
45425,Heater,stormrage,1675,warrior,arms,95,46,49
45426,Matrias,tichondrius,1674,warrior,arms,159,89,70
45427,Bajheera,sargeras,1674,warrior,arms,35,18,17
45428,Fartazz,zuljin,1673,warrior,arms,84,40,44
45429,Franziskaner,frostmourne,1673,warrior,arms,126,59,67
45430,Indominate,tichondrius,1671,warrior,arms,152,72,80
45431,Pusspeepers,kelthuzad,1671,warrior,arms,39,18,21
45432,Heylol,blackhand,1671,warrior,arms,58,25,33
45433,Trágus,azralon,1670,warrior,arms,95,56,39
45434,Qingmei,illidan,1670,warrior,arms,60,26,34
45435,Winota,frostmourne,1669,warrior,arms,30,22,8
45436,Sakutarou,lightbringer,1669,warrior,arms,271,134,137
45437,Axazel,drakkari,1669,warrior,arms,88,43,45
45438,Zenchi,nerzhul,1669,warrior,arms,76,36,40
45439,Brøly,sargeras,1669,warrior,arms,84,38,46
45440,Amlahj,stormrage,1668,warrior,arms,53,30,23
45441,Rarefxck,tichondrius,1668,warrior,arms,84,37,47
45442,Izugyou,thrall,1666,warrior,arms,75,40,35
45443,Bilboswagins,agamaggan,1665,warrior,arms,47,25,22
45444,Marcellùs,proudmoore,1664,warrior,arms,52,29,23
45445,Legoyoda,zuljin,1663,warrior,arms,54,29,25
45446,Edgárllama,sargeras,1663,warrior,arms,38,20,18
45447,Colössal,moon-guard,1663,warrior,arms,94,48,46
45448,Infernae,emerald-dream,1662,warrior,arms,48,30,18
45449,Ystkk,tichondrius,1662,warrior,arms,42,25,17
45450,Warbeshar,area-52,1662,warrior,arms,42,21,21
45451,Hydranoid,ragnaros,1662,warrior,arms,110,54,56
45452,Khørnë,ragnaros,1661,warrior,arms,54,30,24
45453,Tyránny,stormrage,1661,warrior,arms,53,22,31
45454,Killbórn,azralon,1660,warrior,arms,30,19,11
45455,Armamortal,kelthuzad,1659,warrior,arms,239,127,112
45456,Bugsberserk,tichondrius,1658,warrior,arms,107,57,50
45457,Twshizgd,proudmoore,1657,warrior,arms,157,77,80
45458,Kames,garrosh,1657,warrior,arms,107,49,58
45459,Zalakan,malganis,1656,warrior,arms,36,24,12
45460,Golem,frostmourne,1655,warrior,arms,54,27,27
45461,Rogôsh,tichondrius,1655,warrior,arms,54,22,32
45462,Sineatér,frostmourne,1654,warrior,arms,61,30,31
45463,Maktarax,zuljin,1654,warrior,arms,40,18,22
45464,Purrava,tichondrius,1653,warrior,arms,44,23,21
45465,Jehocc,tichondrius,1653,warrior,arms,44,21,23
45466,Rynrak,tichondrius,1653,warrior,arms,41,19,22
45467,Creøn,silvermoon,1650,warrior,arms,68,35,33
45468,Bøek,area-52,1650,warrior,arms,98,45,53
45469,Phabian,frostmourne,1648,warrior,arms,41,22,19
45470,Crowncrumpah,illidan,1647,warrior,arms,36,22,14
45471,Hickorie,sargeras,1646,warrior,arms,96,49,47
45472,Droguernaut,tichondrius,1646,warrior,arms,59,30,29
45473,Sulze,tichondrius,1645,warrior,arms,227,110,117
45474,Xwarz,drakkari,1645,warrior,arms,42,19,23
45475,Morfoggore,ragnaros,1644,warrior,arms,66,34,32
45476,Rainingblooð,blackrock,1644,warrior,arms,103,53,50
45477,Arkkaine,sargeras,1644,warrior,arms,87,44,43
45478,Rhynehardt,scilla,1644,warrior,arms,48,24,24
45479,Kekbyemmr,illidan,1644,warrior,arms,48,22,26
45480,Kpc,tichondrius,1644,warrior,arms,66,25,41
45481,Kromgrall,tichondrius,1643,warrior,arms,161,75,86
45482,Garrmash,hyjal,1642,warrior,arms,199,102,97
45483,Tatsuu,tichondrius,1640,warrior,arms,264,131,133
45484,Sonjeba,malganis,1640,warrior,arms,70,32,38
45485,Fulaixiong,illidan,1639,warrior,arms,51,34,17
45486,Morioso,boulderfist,1639,warrior,arms,66,30,36
45487,Blaiize,ragnaros,1638,warrior,arms,54,22,32
45488,Painsoul,illidan,1636,warrior,arms,53,27,26
45489,Ngu,eldrethalas,1636,warrior,arms,53,26,27
45490,Mavrus,malganis,1634,warrior,arms,36,19,17
45491,Yueren,tichondrius,1634,warrior,arms,54,21,33
45492,Trapbois,tichondrius,1633,warrior,arms,36,22,14
45493,Wingaling,malganis,1633,warrior,arms,54,24,30
45494,Xunxie,tichondrius,1632,warrior,arms,89,49,40
45495,Anukhar,emerald-dream,1632,warrior,arms,84,46,38
45496,Lexíbelle,korgath,1631,warrior,arms,36,21,15
45497,Tatsuujin,sargeras,1631,warrior,arms,50,26,24
45498,Raveve,area-52,1631,warrior,arms,71,36,35
45499,Allyer,darkspear,1630,warrior,arms,66,34,32
45500,Montibello,moon-guard,1630,warrior,arms,78,39,39
45501,Shazbøt,tichondrius,1630,warrior,arms,45,19,26
45502,Delakos,frostmourne,1629,warrior,arms,78,43,35
45503,Groundpound,sargeras,1629,warrior,arms,90,46,44
45504,Furykets,proudmoore,1629,warrior,arms,38,19,19
45505,Evoltoad,illidan,1629,warrior,arms,53,21,32
45506,Draugus,azralon,1628,warrior,arms,52,29,23
45507,Yabahdabah,stormrage,1628,warrior,arms,81,45,36
45508,Bûm,sargeras,1628,warrior,arms,42,23,19
45509,Tatërs,zuljin,1628,warrior,arms,42,22,20
45510,Alteryx,sargeras,1628,warrior,arms,75,36,39
45511,Hõdõnsin,tichondrius,1628,warrior,arms,57,26,31
45512,Mokron,moon-guard,1628,warrior,arms,56,25,31
45513,Ikaikasan,illidan,1627,warrior,arms,32,22,10
45514,Magicalol,tichondrius,1627,warrior,arms,36,21,15
45515,Sosimi,tichondrius,1627,warrior,arms,78,44,34
45516,Wârtorn,darkspear,1627,warrior,arms,42,22,20
45517,Iwillcrushu,tichondrius,1627,warrior,arms,89,45,44
45518,Coollelex,proudmoore,1626,warrior,arms,56,29,27
45519,Zeroskill,cenarius,1626,warrior,arms,60,28,32
45520,Kazecap,proudmoore,1626,warrior,arms,66,29,37
45521,Orgnosh,tichondrius,1625,warrior,arms,96,52,44
45522,Gutting,moon-guard,1625,warrior,arms,36,18,18
45523,Unitsven,barthilas,1625,warrior,arms,54,26,28
45524,Potero,ragnaros,1625,warrior,arms,53,25,28
45525,Duxor,sargeras,1625,warrior,arms,54,24,30
45526,Ironboar,proudmoore,1625,warrior,arms,48,21,27
45527,Faelash,stormrage,1624,warrior,arms,67,32,35
45528,Bddg,tichondrius,1623,warrior,arms,30,18,12
45529,Testflight,tichondrius,1623,warrior,arms,54,30,24
45530,Ryängosling,azralon,1623,warrior,arms,168,92,76
45531,Dotlom,wyrmrest-accord,1623,warrior,arms,144,73,71
45532,Bwandøn,moon-guard,1623,warrior,arms,76,38,38
45533,Lindsanv,illidan,1622,warrior,arms,110,59,51
45534,Larrylurker,proudmoore,1622,warrior,arms,119,62,57
45535,Ciskokido,illidan,1622,warrior,arms,47,24,23
45536,Raahjz,sargeras,1622,warrior,arms,84,38,46
45537,Ðrex,nagrand,1621,warrior,arms,75,42,33
45538,Chadwarr,tichondrius,1621,warrior,arms,31,17,14
45539,Bigbadaxe,sargeras,1621,warrior,arms,36,18,18
45540,Kirown,quelthalas,1621,warrior,arms,98,45,53
45541,Stooklol,tichondrius,1621,warrior,arms,54,22,32
45542,Warrgawd,illidan,1620,warrior,arms,71,38,33
45543,Illing,tichondrius,1620,warrior,arms,214,110,104
45544,Mcluffin,proudmoore,1618,warrior,arms,57,35,22
45545,Timbermack,moon-guard,1618,warrior,arms,96,52,44
45546,Szeo,tichondrius,1617,warrior,arms,24,17,7
45547,Achilex,sargeras,1617,warrior,arms,127,66,61
45548,Brocky,malorne,1617,warrior,arms,485,243,242
45549,Flexìn,tichondrius,1617,warrior,arms,42,21,21
45550,Bromro,tichondrius,1617,warrior,arms,116,55,61
45551,Necroticism,bleeding-hollow,1616,warrior,arms,36,17,19
45552,Slamuëladams,bleeding-hollow,1616,warrior,arms,48,20,28
45553,Ichirisw,tichondrius,1615,warrior,arms,47,23,24
45554,Axellent,gilneas,1614,warrior,arms,70,44,26
45555,Rittylord,frostmourne,1614,warrior,arms,68,37,31
45556,Michaelrossx,bloodhoof,1614,warrior,arms,192,98,94
45557,Metalchileno,ragnaros,1614,warrior,arms,48,20,28
45558,Willcharge,tichondrius,1614,warrior,arms,49,17,32
45559,Myndon,area-52,1613,warrior,arms,37,27,10
45560,Soupwar,moon-guard,1612,warrior,arms,125,63,62
45561,Fluffyarm,sargeras,1612,warrior,arms,198,98,100
45562,Hofukumizuki,tichondrius,1612,warrior,arms,54,21,33
45563,Shaõkahn,nemesis,1611,warrior,arms,46,23,23
45564,Mindgoblin,smolderthorn,1611,warrior,arms,59,29,30
45565,Hugeflopper,malganis,1610,warrior,arms,32,19,13
45566,Scrümp,illidan,1610,warrior,arms,79,44,35
45567,Stormlørd,frostmourne,1610,warrior,arms,76,41,35
45568,Ramzeé,kelthuzad,1609,warrior,arms,78,47,31
45569,Thebigsmash,tichondrius,1609,warrior,arms,42,23,19
45570,Banhaezzi,tichondrius,1609,warrior,arms,154,80,74
45571,Gannïcûs,drakkari,1608,warrior,arms,71,30,41
45572,Liltop,moon-guard,1607,warrior,arms,75,41,34
45573,Furydudz,tichondrius,1607,warrior,arms,42,21,21
45574,Wartrue,tichondrius,1607,warrior,arms,156,71,85
45575,Dokgö,tichondrius,1607,warrior,arms,60,27,33
45576,Asgér,quelthalas,1607,warrior,arms,48,21,27
45577,Ottø,area-52,1606,warrior,arms,72,40,32
45578,Bobu,area-52,1606,warrior,arms,52,28,24
45579,Stick,tichondrius,1606,warrior,arms,119,62,57
45580,Aventajadu,ragnaros,1606,warrior,arms,42,20,22
45581,Brainhaze,tichondrius,1606,warrior,arms,48,21,27
45582,Vanexx,tichondrius,1605,warrior,arms,37,22,15
45583,Maraudertko,area-52,1605,warrior,arms,30,17,13
45584,Dre,anubarak,1605,warrior,arms,53,28,25
45585,Mitigated,bleeding-hollow,1605,warrior,arms,42,22,20
45586,Myxz,barthilas,1605,warrior,arms,120,59,61
45587,Ethuil,azshara,1605,warrior,arms,65,29,36
45588,Jottman,tichondrius,1605,warrior,arms,93,41,52
45589,Morboo,illidan,1604,warrior,arms,48,27,21
45590,Kakamallo,black-dragonflight,1604,warrior,arms,201,109,92
45591,Bìgpoppapump,tichondrius,1604,warrior,arms,114,57,57
45592,Blodreìna,hyjal,1604,warrior,arms,109,53,56
45593,Wurua,tichondrius,1604,warrior,arms,42,20,22
45594,Sayyaf,moon-guard,1604,warrior,arms,57,20,37
45595,Kamoo,gurubashi,1603,warrior,arms,54,41,13
45596,Bleedx,bleeding-hollow,1603,warrior,arms,51,30,21
45597,Yamadaflash,tichondrius,1603,warrior,arms,37,21,16
45598,Zaràki,area-52,1603,warrior,arms,186,95,91
45599,Mahoogler,hakkar,1603,warrior,arms,66,31,35
45600,Malerick,illidan,1603,warrior,arms,63,27,36
45601,Reave,wyrmrest-accord,1602,warrior,arms,42,24,18
45602,Aumni,illidan,1601,warrior,arms,92,43,49
45603,Sheriff,eldrethalas,1600,warrior,arms,54,31,23
45604,Ramparts,moon-guard,1600,warrior,arms,36,17,19
45605,Kilgrah,emerald-dream,1599,warrior,arms,40,21,19
45606,Flavor,aegwynn,1599,warrior,arms,42,20,22
45607,Koberos,queldorei,1599,warrior,arms,66,26,40
45608,Shiv,illidan,1598,warrior,arms,116,60,56
45609,Memorylane,proudmoore,1598,warrior,arms,42,20,22
45610,Yolo,dunemaul,1597,warrior,arms,63,37,26
45611,Benjiprice,sargeras,1597,warrior,arms,35,19,16
45612,Vauquelin,tichondrius,1594,warrior,arms,78,41,37
45613,Rapcherawr,illidan,1593,warrior,arms,33,20,13
45614,Áres,malganis,1593,warrior,arms,268,146,122
45615,Hydrolisk,area-52,1591,warrior,arms,126,63,63
45616,Marvachi,moon-guard,1591,warrior,arms,110,53,57
45617,Theokos,dalaran,1590,warrior,arms,84,41,43
45618,Meatbone,emerald-dream,1589,warrior,arms,84,48,36
45619,Mistrpower,bleeding-hollow,1589,warrior,arms,78,44,34
45620,Gorgan,ragnaros,1589,warrior,arms,90,46,44
45621,Lootacris,illidan,1588,warrior,arms,67,34,33
45622,Ghianna,quelthalas,1586,warrior,arms,65,34,31
45623,Dewbae,whisperwind,1586,warrior,arms,72,37,35
45624,Homebody,uldaman,1585,warrior,arms,38,25,13
45625,Hyperdevil,ragnaros,1585,warrior,arms,35,19,16
45626,Brokthard,ragnaros,1585,warrior,arms,36,18,18
45627,Sheetss,tichondrius,1585,warrior,arms,48,23,25
45628,Dukà,hyjal,1584,warrior,arms,54,30,24
45629,Destructör,nagrand,1584,warrior,arms,93,49,44
45630,Lyliumn,frostmourne,1583,warrior,arms,66,34,32
45631,Ävdol,emerald-dream,1582,warrior,arms,77,37,40
45632,Unkultom,stormrage,1581,warrior,arms,81,46,35
45633,Torzzen,azralon,1581,warrior,arms,99,53,46
45634,Lsays,tichondrius,1581,warrior,arms,127,67,60
45635,Slamedi,frostmourne,1581,warrior,arms,48,20,28
45636,Çrusha,thrall,1581,warrior,arms,42,17,25
45637,Wydstepwar,malganis,1580,warrior,arms,60,38,22
45638,Rongor,drakkari,1580,warrior,arms,54,26,28
45639,Dashballer,sargeras,1578,warrior,arms,42,22,20
45640,Drjuicce,tichondrius,1577,warrior,arms,24,17,7
45641,Bestseason,kelthuzad,1577,warrior,arms,87,48,39
45642,Ragetodef,illidan,1577,warrior,arms,91,45,46
45643,Därkzh,stormrage,1576,warrior,arms,30,20,10
45644,Møønnlight,quelthalas,1576,warrior,arms,77,33,44
45645,Anticiðe,zuljin,1575,warrior,arms,30,18,12
45646,Juuz,frostmourne,1575,warrior,arms,114,56,58
45647,Lunartime,sargeras,1575,warrior,arms,42,20,22
45648,Ferozan,azralon,1575,warrior,arms,42,20,22
45649,Durres,tichondrius,1575,warrior,arms,42,19,23
45650,Vadio,area-52,1575,warrior,arms,40,17,23
45651,Aranacn,tichondrius,1574,warrior,arms,36,22,14
45652,Skronkar,illidan,1574,warrior,arms,126,64,62
45653,Exorbit,sargeras,1573,warrior,arms,30,19,11
45654,Darthbleezy,malygos,1573,warrior,arms,42,22,20
45655,Sinbãd,sargeras,1573,warrior,arms,65,29,36
45656,Ashantia,stormrage,1571,warrior,arms,90,48,42
45657,Yarock,malganis,1571,warrior,arms,84,38,46
45658,Ÿüñí,tichondrius,1570,warrior,arms,42,19,23
45659,Spartiguss,emerald-dream,1569,warrior,arms,35,18,17
45660,Okanos,tichondrius,1569,warrior,arms,42,17,25
45661,Juicylumpia,moon-guard,1568,warrior,arms,48,31,17
45662,PlayerRNKMRN,korgath,1567,warrior,arms,55,35,20
45663,Habakkos,firetree,1567,warrior,arms,60,35,25
45664,Jaybers,malganis,1567,warrior,arms,59,31,28
45665,Gulgosh,stormscale,1566,warrior,arms,59,30,29
45666,Riggragg,tichondrius,1565,warrior,arms,48,28,20
45667,Stickybladez,frostmourne,1565,warrior,arms,130,67,63
45668,Ryank,bonechewer,1565,warrior,arms,48,24,24
45669,Orahard,illidan,1565,warrior,arms,176,86,90
45670,Xkickaxes,tichondrius,1565,warrior,arms,95,46,49
45671,Enzoh,zuljin,1565,warrior,arms,80,25,55
45672,Pigzig,nagrand,1564,warrior,arms,36,18,18
45673,Endurefen,sargeras,1563,warrior,arms,24,17,7
45674,Nyle,zuljin,1563,warrior,arms,84,44,40
45675,Kenshín,ragnaros,1563,warrior,arms,65,27,38
45676,Ohanaglad,illidan,1562,warrior,arms,120,64,56
45677,Chogar,proudmoore,1562,warrior,arms,64,34,30
45678,Chañ,tichondrius,1562,warrior,arms,36,19,17
45679,Executie,duskwood,1562,warrior,arms,73,36,37
45680,Nerdstompêr,illidan,1561,warrior,arms,66,29,37
45681,Hônor,ragnaros,1558,warrior,arms,54,24,30
45682,Claymation,tichondrius,1558,warrior,arms,48,18,30
45683,Kénjar,tichondrius,1556,warrior,arms,30,20,10
45684,Alator,gorgonnash,1556,warrior,arms,36,21,15
45685,Firesx,tichondrius,1555,warrior,arms,36,20,16
45686,Devildriver,malganis,1555,warrior,arms,78,43,35
45687,Gorez,ragnaros,1555,warrior,arms,42,21,21
45688,Arctures,stormrage,1554,warrior,arms,72,45,27
45689,Azindar,gilneas,1554,warrior,arms,42,21,21
45690,Jenkin,korgath,1554,warrior,arms,36,18,18
45691,Naejwar,ragnaros,1552,warrior,arms,164,85,79
45692,Lilreese,tichondrius,1552,warrior,arms,66,34,32
45693,Soez,tichondrius,1551,warrior,arms,28,20,8
45694,Blíding,ragnaros,1551,warrior,arms,75,28,47
45695,Ghóstx,alleria,1550,warrior,arms,53,37,16
45696,Aragorn,mannoroth,1550,warrior,arms,36,19,17
45697,Titanzz,quelthalas,1550,warrior,arms,71,35,36
45698,Pachacutec,area-52,1550,warrior,arms,80,36,44
45699,Rèckit,thrall,1550,warrior,arms,48,21,27
45700,Zzchocolate,illidan,1549,warrior,arms,84,36,48
45701,Itskel,stormreaver,1546,warrior,arms,44,23,21
45702,Johnnysmizle,kelthuzad,1546,warrior,arms,84,38,46
45703,Brostormftw,shattered-halls,1544,warrior,arms,72,43,29
45704,Kowboy,stormrage,1544,warrior,arms,120,62,58
45705,Radox,tichondrius,1544,warrior,arms,54,27,27
45706,Hanadaddy,frostmourne,1544,warrior,arms,175,86,89
45707,Zyppz,sargeras,1543,warrior,arms,38,26,12
45708,Lykemore,moon-guard,1542,warrior,arms,74,41,33
45709,Know,anetheron,1542,warrior,arms,98,45,53
45710,Bozwar,tichondrius,1541,warrior,arms,60,33,27
45711,Wingedknight,malganis,1541,warrior,arms,98,47,51
45712,Galehna,ragnaros,1541,warrior,arms,41,17,24
45713,Uhttercow,tichondrius,1539,warrior,arms,66,33,33
45714,Flexeçute,moon-guard,1539,warrior,arms,72,34,38
45715,Slitt,azralon,1538,warrior,arms,78,42,36
45716,Perrin,burning-blade,1538,warrior,arms,43,21,22
45717,Cowtipin,illidan,1538,warrior,arms,110,50,60
45718,Ôn,tichondrius,1537,warrior,arms,159,76,83
45719,Underbite,area-52,1536,warrior,arms,54,33,21
45720,Akkar,gilneas,1536,warrior,arms,69,40,29
45721,Aloregorey,malganis,1536,warrior,arms,96,45,51
45722,Nitron,dawnbringer,1535,warrior,arms,24,16,8
45723,Amputate,akama,1535,warrior,arms,53,20,33
45724,Trackstarz,llane,1534,warrior,arms,201,103,98
45725,Nornogin,tichondrius,1534,warrior,arms,66,31,35
45726,Rohta,kiljaeden,1533,warrior,arms,77,36,41
45727,Rokgral,tichondrius,1531,warrior,arms,56,29,27
45728,Chillimus,tichondrius,1530,warrior,arms,48,23,25
45729,Maddorlon,thrall,1530,warrior,arms,53,24,29
45730,Hanzmat,illidan,1529,warrior,arms,30,16,14
45731,Ratfang,zuljin,1528,warrior,arms,28,17,11
45732,Stinkyw,tichondrius,1528,warrior,arms,49,27,22
45733,Tkazo,tichondrius,1527,warrior,arms,35,17,18
45734,Yiplaw,stormrage,1526,warrior,arms,30,16,14
45735,Zaddybear,aerie-peak,1526,warrior,arms,45,23,22
45736,Yawdamper,illidan,1525,warrior,arms,30,21,9
45737,Flynnstone,tichondrius,1524,warrior,arms,30,19,11
45738,Chinamonk,tichondrius,1524,warrior,arms,101,49,52
45739,Hannibalkng,zangarmarsh,1524,warrior,arms,52,20,32
45740,Lokityr,tichondrius,1523,warrior,arms,108,67,41
45741,Lionbuster,ragnaros,1523,warrior,arms,36,22,14
45742,Ewenki,tichondrius,1523,warrior,arms,159,83,76
45743,Monstersynde,nemesis,1523,warrior,arms,108,54,54
45744,Gwlade,sargeras,1522,warrior,arms,198,104,94
45745,Traumaj,bleeding-hollow,1521,warrior,arms,129,68,61
45746,Joesbàr,tichondrius,1521,warrior,arms,54,24,30
45747,Kimed,nordrassil,1520,warrior,arms,30,16,14
45748,Unstàble,frostmourne,1520,warrior,arms,66,34,32
45749,Metalwarr,illidan,1520,warrior,arms,53,27,26
45750,Spartacam,frostmourne,1520,warrior,arms,166,83,83
45751,Elchacál,ragnaros,1520,warrior,arms,66,27,39
45752,Randysnapper,zuljin,1519,warrior,arms,24,16,8
45753,Ichigö,gundrak,1519,warrior,arms,51,25,26
45754,Rukittenme,area-52,1519,warrior,arms,72,29,43
45755,Cosmosz,illidan,1518,warrior,arms,60,35,25
45756,Powerbucks,tichondrius,1518,warrior,arms,32,17,15
45757,Noyel,tichondrius,1518,warrior,arms,40,18,22
45758,Sigfir,ragnaros,1517,warrior,arms,58,31,27
45759,Malakaimapk,korgath,1517,warrior,arms,30,16,14
45760,Warriordanim,tichondrius,1517,warrior,arms,150,67,83
45761,Bainian,tichondrius,1516,warrior,arms,49,25,24
45762,Pelonna,drakkari,1516,warrior,arms,126,61,65
45763,Damiansuv,moon-guard,1516,warrior,arms,153,73,80
45764,Jimjinjin,tichondrius,1515,warrior,arms,30,16,14
45765,Grumtak,azralon,1515,warrior,arms,41,20,21
45766,Cronguin,bleeding-hollow,1515,warrior,arms,36,17,19
45767,Rads,stormscale,1514,warrior,arms,69,39,30
45768,Brayitann,illidan,1514,warrior,arms,49,27,22
45769,Chupelo,tichondrius,1513,warrior,arms,24,18,6
45770,Dtrumpo,moon-guard,1513,warrior,arms,52,27,25
45771,Ginormous,rivendare,1513,warrior,arms,63,31,32
45772,Elevate,whisperwind,1513,warrior,arms,36,16,20
45773,Tuvia,malganis,1511,warrior,arms,177,89,88
45774,Wmf,frostmourne,1511,warrior,arms,90,42,48
45775,Warthok,turalyon,1511,warrior,arms,46,21,25
45776,Raala,cenarius,1510,warrior,arms,51,34,17
45777,Cathillex,eonar,1510,warrior,arms,24,16,8
45778,Tríxman,moon-guard,1510,warrior,arms,106,61,45
45779,Draganovich,aerie-peak,1509,warrior,arms,54,30,24
45780,Karrosh,agamaggan,1509,warrior,arms,42,18,24
45781,Doomreaper,hellscream,1508,warrior,arms,71,40,31
45782,Punknicanor,quelthalas,1508,warrior,arms,66,33,33
45783,Hotdadparty,frostmourne,1508,warrior,arms,103,51,52
45784,Cagrekk,wyrmrest-accord,1507,warrior,arms,53,28,25
45785,Machete,nemesis,1507,warrior,arms,76,40,36
45786,Wilric,ragnaros,1507,warrior,arms,36,16,20
45787,Dysensor,illidan,1506,warrior,arms,60,33,27
45788,Geñeralguap,tichondrius,1506,warrior,arms,192,102,90
45789,Ogeezus,crushridge,1506,warrior,arms,42,20,22
45790,Legbreaker,tichondrius,1504,warrior,arms,70,37,33
45791,Lilmerman,laughing-skull,1504,warrior,arms,59,30,29
45792,Pocserwar,drakkari,1504,warrior,arms,36,16,20
45793,Wouili,zuljin,1503,warrior,arms,97,59,38
45794,Bottlecaps,shadowmoon,1502,warrior,arms,51,25,26
45795,Nagaboner,frostmourne,1501,warrior,arms,77,45,32
45796,Neotico,quelthalas,1501,warrior,arms,50,22,28
45797,Swólepetrol,tichondrius,1499,warrior,arms,30,16,14
45798,Marsoc,burning-legion,1499,warrior,arms,36,17,19
45799,Lehzera,frostmourne,1499,warrior,arms,74,34,40
45800,Boypartz,onyxia,1499,warrior,arms,42,16,26
45801,Auzery,emerald-dream,1498,warrior,arms,42,17,25
45802,Tcchmm,akama,1497,warrior,arms,64,28,36
45803,Enilaw,proudmoore,1496,warrior,arms,62,36,26
45804,Crustyfella,stormrage,1496,warrior,arms,52,28,24
45805,Danield,illidan,1496,warrior,arms,42,16,26
45806,Flintish,moon-guard,1495,warrior,arms,48,30,18
45807,Ralphy,lightnings-blade,1495,warrior,arms,88,48,40
45808,Achillescool,tichondrius,1495,warrior,arms,60,28,32
45809,Dajva,ragnaros,1495,warrior,arms,48,20,28
45810,Oppressor,darkspear,1494,warrior,arms,77,37,40
45811,Gorenay,nemesis,1494,warrior,arms,36,17,19
45812,Datneck,tichondrius,1493,warrior,arms,30,16,14
45813,Kastenz,frostmourne,1493,warrior,arms,55,25,30
45814,Horsekok,tichondrius,1492,warrior,arms,30,19,11
45815,Pepétí,azralon,1492,warrior,arms,148,68,80
45816,Aggorak,illidan,1492,warrior,arms,36,16,20
45817,Sáítámá,tichondrius,1491,warrior,arms,58,30,28
45818,Fraannky,windrunner,1490,warrior,arms,90,47,43
45819,Roidraging,thunderlord,1490,warrior,arms,149,66,83
45820,Garadiels,tichondrius,1490,warrior,arms,73,31,42
45821,Sinsinatra,azralon,1489,warrior,arms,174,85,89
45822,Rockstedy,area-52,1489,warrior,arms,68,31,37
45823,Taywar,sargeras,1488,warrior,arms,60,29,31
45824,Casablancas,azralon,1488,warrior,arms,42,16,26
45825,Dragvovar,thrall,1488,warrior,arms,42,16,26
45826,Zänn,dalaran,1486,warrior,arms,60,38,22
45827,Painfulsin,tichondrius,1486,warrior,arms,42,19,23
45828,Krimgar,quelthalas,1485,warrior,arms,76,32,44
45829,Karnakk,thrall,1485,warrior,arms,41,16,25
45830,Elyll,tichondrius,1484,warrior,arms,30,16,14
45831,Peacemake,tichondrius,1484,warrior,arms,39,20,19
45832,Braxin,dalaran,1483,warrior,arms,77,42,35
45833,Earlsiriuz,tichondrius,1483,warrior,arms,51,23,28
45834,Kolossux,ragnaros,1482,warrior,arms,66,35,31
45835,Jäÿ,proudmoore,1482,warrior,arms,63,31,32
45836,Islik,stormrage,1482,warrior,arms,73,35,38
45837,Frankoiz,quelthalas,1482,warrior,arms,42,19,23
45838,Visenyä,mannoroth,1481,warrior,arms,52,21,31
45839,Kissmyaxê,tichondrius,1480,warrior,arms,57,24,33
45840,Brutallicus,kelthuzad,1479,warrior,arms,33,17,16
45841,Tommytimbo,destromath,1479,warrior,arms,37,16,21
45842,Volstraya,frostmourne,1478,warrior,arms,36,18,18
45843,Shortgoofy,sargeras,1477,warrior,arms,129,61,68
45844,Crystaríum,stormrage,1477,warrior,arms,79,37,42
45845,Rainzy,stormrage,1476,warrior,arms,36,16,20
45846,Andrès,sargeras,1475,warrior,arms,54,21,33
45847,Weedow,proudmoore,1474,warrior,arms,29,16,13
45848,Themudcrab,frostmourne,1474,warrior,arms,303,146,157
45849,Himer,tichondrius,1474,warrior,arms,42,17,25
45850,Saîyanroyce,barthilas,1473,warrior,arms,137,69,68
45851,Armsprotfury,tichondrius,1472,warrior,arms,48,30,18
45852,Furyass,bleeding-hollow,1472,warrior,arms,120,65,55
45853,Fatnfurious,dunemaul,1472,warrior,arms,88,46,42
45854,Rimz,sargeras,1472,warrior,arms,39,20,19
45855,Naughtytwat,tichondrius,1472,warrior,arms,183,90,93
45856,Dann,ragnaros,1472,warrior,arms,84,39,45
45857,Radagøn,drakkari,1472,warrior,arms,36,16,20
45858,Malvadin,stormrage,1472,warrior,arms,48,19,29
45859,Lòrdnasher,tichondrius,1471,warrior,arms,53,29,24
45860,Ninefingers,madoran,1471,warrior,arms,48,26,22
45861,Arthwarf,proudmoore,1470,warrior,arms,60,29,31
45862,Baul,area-52,1469,warrior,arms,59,31,28
45863,Gerztok,aggramar,1469,warrior,arms,34,17,17
45864,Dáinsleif,frostmourne,1469,warrior,arms,36,17,19
45865,Mardrex,korgath,1469,warrior,arms,36,16,20
45866,Smokedaperc,illidan,1468,warrior,arms,84,44,40
45867,Jeffo,amanthul,1468,warrior,arms,38,18,20
45868,Thurman,spirestone,1467,warrior,arms,44,26,18
45869,Theisius,tichondrius,1466,warrior,arms,51,19,32
45870,Barbatenaz,ragnaros,1465,warrior,arms,48,18,30
45871,Eggroll,emerald-dream,1465,warrior,arms,47,17,30
45872,Torimzor,nemesis,1464,warrior,arms,138,74,64
45873,Toughguts,saurfang,1464,warrior,arms,60,29,31
45874,Bricksquad,mannoroth,1464,warrior,arms,57,25,32
45875,Frashes,darkspear,1463,warrior,arms,55,26,29
45876,Bigdingus,frostwolf,1463,warrior,arms,60,28,32
45877,Moonär,emerald-dream,1463,warrior,arms,60,27,33
45878,Tekaiatsu,tichondrius,1462,warrior,arms,107,61,46
45879,Duroxzee,area-52,1462,warrior,arms,187,100,87
45880,Tzumugi,ragnaros,1462,warrior,arms,277,142,135
45881,Paddyj,illidan,1462,warrior,arms,45,23,22
45882,Skollyd,tichondrius,1462,warrior,arms,38,17,21
45883,Sertss,proudmoore,1462,warrior,arms,71,30,41
45884,Druckerz,lightnings-blade,1462,warrior,arms,60,23,37
45885,Golkän,goldrinn,1461,warrior,arms,66,34,32
45886,Ihadnochoice,barthilas,1461,warrior,arms,256,126,130
45887,Muskratz,tichondrius,1461,warrior,arms,147,72,75
45888,Brewstrike,dalaran,1461,warrior,arms,42,20,22
45889,Supersquish,moon-guard,1460,warrior,arms,54,29,25
45890,Slyith,shadow-council,1460,warrior,arms,77,38,39
45891,Nabiouscx,malganis,1460,warrior,arms,101,47,54
45892,Asgaurdius,thunderlord,1459,warrior,arms,60,31,29
45893,Raves,quelthalas,1459,warrior,arms,60,22,38
45894,Riskydevil,azralon,1458,warrior,arms,58,32,26
45895,Dennlss,quelthalas,1458,warrior,arms,84,39,45
45896,Warlow,korgath,1458,warrior,arms,64,29,35
45897,Mommysharky,illidan,1457,warrior,arms,36,26,10
45898,Dathalidus,area-52,1457,warrior,arms,50,32,18
45899,Zizwe,proudmoore,1457,warrior,arms,65,35,30
45900,Creepi,sargeras,1457,warrior,arms,56,30,26
45901,Zeerohkool,malganis,1457,warrior,arms,68,31,37
45902,Bullmastic,deathwing,1456,warrior,arms,46,21,25
45903,Warsongwolf,tichondrius,1456,warrior,arms,38,16,22
45904,Pongk,tichondrius,1456,warrior,arms,57,17,40
45905,Amaragos,tichondrius,1455,warrior,arms,62,37,25
45906,Jotto,zuljin,1455,warrior,arms,36,18,18
45907,Jrod,boulderfist,1455,warrior,arms,192,95,97
45908,Xaka,tichondrius,1455,warrior,arms,42,19,23
45909,Dou,barthilas,1454,warrior,arms,29,18,11
45910,Bryk,korgath,1454,warrior,arms,30,17,13
45911,Zhânshen,tichondrius,1454,warrior,arms,48,24,24
45912,Seukkang,tichondrius,1454,warrior,arms,36,16,20
45913,Lionssong,bleeding-hollow,1454,warrior,arms,71,31,40
45914,Doves,tichondrius,1453,warrior,arms,33,16,17
45915,Mailløche,bleeding-hollow,1452,warrior,arms,60,32,28
45916,Xenogears,boulderfist,1452,warrior,arms,96,51,45
45917,Luosifen,tichondrius,1452,warrior,arms,185,93,92
45918,Banggo,frostmourne,1450,warrior,arms,60,36,24
45919,Biznizwar,sargeras,1450,warrior,arms,124,61,63
45920,Isarat,illidan,1450,warrior,arms,48,23,25
45921,Qetimporta,quelthalas,1449,warrior,arms,96,54,42
45922,Erple,eldrethalas,1449,warrior,arms,116,54,62
45923,Haxzors,sargeras,1448,warrior,arms,54,24,30
45924,Wellowarr,moon-guard,1448,warrior,arms,78,34,44
45925,Dcashmoney,moon-guard,1448,warrior,arms,66,28,38
45926,Balroge,illidan,1447,warrior,arms,48,22,26
45927,Radamäntthys,nemesis,1447,warrior,arms,93,39,54
45928,Gtatewarr,azjolnerub,1446,warrior,arms,26,16,10
45929,Overswing,tichondrius,1446,warrior,arms,78,32,46
45930,Rárict,moon-guard,1445,warrior,arms,46,26,20
45931,Shawnemd,proudmoore,1445,warrior,arms,54,29,25
45932,Streetdog,stormrage,1445,warrior,arms,48,23,25
45933,Belldor,barthilas,1445,warrior,arms,72,28,44
45934,Iigotu,tichondrius,1444,warrior,arms,220,108,112
45935,Coisini,tichondrius,1443,warrior,arms,79,41,38
45936,Aoste,tichondrius,1442,warrior,arms,61,33,28
45937,Ashbringera,proudmoore,1442,warrior,arms,120,57,63
45938,Kréix,sargeras,1442,warrior,arms,59,27,32
45939,Destoryhamer,illidan,1441,warrior,arms,96,51,45
45940,Lisande,sargeras,1440,warrior,arms,70,40,30
45941,Ðêad,area-52,1439,warrior,arms,24,15,9
45942,Bigjbs,tichondrius,1439,warrior,arms,24,15,9
45943,Rekatron,area-52,1439,warrior,arms,30,15,15
45944,Crownzz,tichondrius,1439,warrior,arms,30,15,15
45945,Yunnkel,ragnaros,1439,warrior,arms,110,53,57
45946,Darkfang,icecrown,1438,warrior,arms,48,26,22
45947,Jichelei,tichondrius,1438,warrior,arms,72,35,37
45948,Loosz,stormrage,1438,warrior,arms,36,15,21
45949,Brotu,nemesis,1437,warrior,arms,151,85,66
45950,Themessiah,stormrage,1437,warrior,arms,59,33,26
45951,Graelus,terenas,1437,warrior,arms,43,24,19
45952,Jellybomb,sargeras,1437,warrior,arms,186,92,94
45953,Volkz,ragnaros,1437,warrior,arms,47,19,28
45954,Stufit,emerald-dream,1436,warrior,arms,34,20,14
45955,Slamix,area-52,1436,warrior,arms,63,33,30
45956,Bigbadbaka,thaurissan,1435,warrior,arms,36,15,21
45957,Nikon,bleeding-hollow,1435,warrior,arms,42,16,26
45958,Vainamóinen,kelthuzad,1433,warrior,arms,24,15,9
45959,Gooshin,sargeras,1433,warrior,arms,109,58,51
45960,Monowarx,frostmourne,1433,warrior,arms,46,22,24
45961,Helrise,sargeras,1432,warrior,arms,30,15,15
45962,Ushouldnome,tichondrius,1432,warrior,arms,30,15,15
45963,Ôxluck,ragnaros,1432,warrior,arms,92,34,58
45964,Maywarro,ragnaros,1431,warrior,arms,42,23,19
45965,Badguys,illidan,1431,warrior,arms,36,15,21
45966,Kushhy,illidan,1429,warrior,arms,45,19,26
45967,Destroid,zuljin,1428,warrior,arms,24,15,9
45968,Klouddraft,tichondrius,1428,warrior,arms,39,22,17
45969,Laintimee,tichondrius,1428,warrior,arms,56,30,26
45970,Ginthril,magtheridon,1428,warrior,arms,108,46,62
45971,Dorianfrost,ravenholdt,1428,warrior,arms,66,24,42
45972,Shiiftybuga,frostmourne,1427,warrior,arms,50,27,23
45973,Shishokun,quelthalas,1427,warrior,arms,76,35,41
45974,Hulkbuster,ragnaros,1427,warrior,arms,42,18,24
45975,Kadira,stormrage,1427,warrior,arms,90,37,53
45976,Calmebigfeet,tichondrius,1426,warrior,arms,30,15,15
45977,Donivan,illidan,1425,warrior,arms,30,15,15
45978,Robodad,illidan,1425,warrior,arms,30,15,15
45979,Dinogc,barthilas,1424,warrior,arms,32,17,15
45980,Aesom,wyrmrest-accord,1423,warrior,arms,133,73,60
45981,Ángron,ragnaros,1423,warrior,arms,74,37,37
45982,Tergll,illidan,1423,warrior,arms,51,23,28
45983,Cjz,tichondrius,1422,warrior,arms,42,25,17
45984,Ooze,darkspear,1422,warrior,arms,81,46,35
45985,Automator,proudmoore,1422,warrior,arms,36,15,21
45986,Beaerboy,darkspear,1421,warrior,arms,113,50,63
45987,Mahkrash,quelthalas,1420,warrior,arms,47,22,25
45988,Sleazedog,kelthuzad,1420,warrior,arms,48,21,27
45989,Waraze,tichondrius,1420,warrior,arms,42,17,25
45990,Orctiddy,emerald-dream,1419,warrior,arms,32,16,16
45991,Erradic,sargeras,1419,warrior,arms,30,15,15
45992,Mopwarrior,sargeras,1419,warrior,arms,30,15,15
45993,Karrok,zuluhed,1418,warrior,arms,210,99,111
45994,Dreadedbeef,area-52,1417,warrior,arms,24,15,9
45995,Alexitwo,ragnaros,1416,warrior,arms,66,36,30
45996,Cheeriozz,thrall,1416,warrior,arms,48,26,22
45997,Ártorius,sargeras,1416,warrior,arms,108,53,55
45998,Aaryn,caelestrasz,1415,warrior,arms,104,56,48
45999,Ughh,bleeding-hollow,1415,warrior,arms,42,21,21
46000,Ukris,area-52,1414,warrior,arms,89,48,41
46001,Bestid,tichondrius,1414,warrior,arms,36,19,17
46002,Kahuwuna,tichondrius,1414,warrior,arms,30,15,15
46003,Scumrat,frostmourne,1414,warrior,arms,66,32,34
46004,Bâlthor,quelthalas,1413,warrior,arms,120,59,61
46005,Korboc,malganis,1413,warrior,arms,60,29,31
46006,Slickpapi,area-52,1413,warrior,arms,93,44,49
46007,Muertededios,quelthalas,1412,warrior,arms,141,70,71
46008,Ëssex,tichondrius,1412,warrior,arms,83,38,45
46009,Shadderaz,sargeras,1411,warrior,arms,66,30,36
46010,Dropopen,tichondrius,1411,warrior,arms,54,17,37
46011,Tusktrollmon,illidan,1410,warrior,arms,104,53,51
46012,Áustin,sargeras,1409,warrior,arms,24,15,9
46013,Atróx,quelthalas,1409,warrior,arms,30,15,15
46014,Utgarde,stormrage,1408,warrior,arms,200,101,99
46015,Warthorns,malganis,1408,warrior,arms,49,17,32
46016,Rägar,quelthalas,1407,warrior,arms,49,25,24
46017,Ponchetas,quelthalas,1407,warrior,arms,60,28,32
46018,Kannzox,quelthalas,1406,warrior,arms,79,40,39
46019,Solano,illidan,1405,warrior,arms,48,30,18
46020,Blokz,arthas,1405,warrior,arms,42,26,16
46021,Bruttallis,frostmane,1405,warrior,arms,51,25,26
46022,Hoodlark,lightbringer,1405,warrior,arms,78,30,48
46023,Baix,frostmourne,1404,warrior,arms,63,35,28
46024,Tithousand,tichondrius,1404,warrior,arms,45,24,21
46025,Broodthorne,tichondrius,1404,warrior,arms,30,15,15
46026,Rhohan,ysera,1404,warrior,arms,77,38,39
46027,Yummysushi,gorgonnash,1404,warrior,arms,76,31,45
46028,Leapgodx,drenden,1403,warrior,arms,24,15,9
46029,Mortalstrike,chogall,1403,warrior,arms,52,25,27
46030,Aloloco,ragnaros,1403,warrior,arms,66,30,36
46031,Arot,bloodhoof,1403,warrior,arms,117,52,65
46032,Zareos,azralon,1403,warrior,arms,40,17,23
46033,Bløødy,lethon,1402,warrior,arms,26,17,9
46034,Roughknuckle,kelthuzad,1402,warrior,arms,29,15,14
46035,Supremegalek,tichondrius,1401,warrior,arms,88,46,42
46036,Aión,nemesis,1400,warrior,arms,24,17,7
46037,Thaisyta,tichondrius,1400,warrior,arms,30,19,11
46038,Dubstoob,illidan,1400,warrior,arms,148,77,71
46039,Buntpunt,mannoroth,1400,warrior,arms,109,53,56
46040,Blightscream,bleeding-hollow,1400,warrior,arms,130,60,70
46041,Kappis,illidan,1399,warrior,arms,41,23,18
46042,Peeb,tichondrius,1399,warrior,arms,30,15,15
46043,Hêllseeker,ragnaros,1399,warrior,arms,78,37,41
46044,Tern,emerald-dream,1398,warrior,arms,82,42,40
46045,Ikrad,quelthalas,1398,warrior,arms,84,42,42
46046,Coolade,thunderhorn,1398,warrior,arms,70,33,37
46047,Tenebrous,nemesis,1397,warrior,arms,48,20,28
46048,Rokó,illidan,1396,warrior,arms,72,34,38
46049,Edwiddin,frostmourne,1396,warrior,arms,68,31,37
46050,Varith,sargeras,1394,warrior,arms,36,20,16
46051,Vayper,illidan,1394,warrior,arms,48,23,25
46052,Allenwrite,frostmourne,1394,warrior,arms,36,17,19
46053,Ghostmourne,ragnaros,1393,warrior,arms,181,88,93
46054,Disarmiea,cairne,1393,warrior,arms,69,31,38
46055,Magnar,zuljin,1392,warrior,arms,42,25,17
46056,Vanglorio,azralon,1392,warrior,arms,81,44,37
46057,Gusbus,malganis,1392,warrior,arms,112,60,52
46058,Märkdî,quelthalas,1392,warrior,arms,30,16,14
46059,Zaurka,sargeras,1391,warrior,arms,30,18,12
46060,Bigster,malganis,1391,warrior,arms,30,16,14
46061,Nicegirl,sargeras,1391,warrior,arms,69,36,33
46062,Martyferrari,black-dragonflight,1391,warrior,arms,60,30,30
46063,Thorado,nemesis,1391,warrior,arms,104,51,53
46064,Warrgodlol,illidan,1391,warrior,arms,33,15,18
46065,Zeerohkool,tichondrius,1391,warrior,arms,102,46,56
46066,Wapistun,thrall,1390,warrior,arms,42,21,21
46067,Saleem,tichondrius,1390,warrior,arms,205,100,105
46068,Khargrok,ragnaros,1389,warrior,arms,30,15,15
46069,Túrin,quelthalas,1389,warrior,arms,75,34,41
46070,Apallô,tichondrius,1388,warrior,arms,89,40,49
46071,Saltyundies,tichondrius,1387,warrior,arms,117,54,63
46072,Momojojo,daggerspine,1385,warrior,arms,26,18,8
46073,Morhgath,bonechewer,1385,warrior,arms,49,26,23
46074,Kilrosao,nordrassil,1385,warrior,arms,83,43,40
46075,Chanchoswar,ragnaros,1385,warrior,arms,93,41,52
46076,Soltrain,stormrage,1385,warrior,arms,68,29,39
46077,Yirko,quelthalas,1385,warrior,arms,74,31,43
46078,Sludgthwaps,stormrage,1383,warrior,arms,59,29,30
46079,Kanamechan,area-52,1383,warrior,arms,65,24,41
46080,Holddapoop,area-52,1382,warrior,arms,36,19,17
46081,Ghostss,tichondrius,1382,warrior,arms,67,29,38
46082,Eîghtysîx,sargeras,1382,warrior,arms,100,43,57
46083,Rivenz,moon-guard,1382,warrior,arms,57,20,37
46084,Verain,thrall,1381,warrior,arms,36,17,19
46085,Bagur,ragnaros,1380,warrior,arms,114,61,53
46086,Typhön,tichondrius,1380,warrior,arms,77,31,46
46087,Drekzul,azralon,1379,warrior,arms,24,15,9
46088,Grimus,bleeding-hollow,1379,warrior,arms,70,38,32
46089,Weepingdeath,burning-legion,1379,warrior,arms,60,30,30
46090,Killtarget,tichondrius,1377,warrior,arms,76,42,34
46091,Gwendolynl,hyjal,1377,warrior,arms,73,35,38
46092,Tdestroy,ragnaros,1376,warrior,arms,33,17,16
46093,Luckyw,draktharon,1375,warrior,arms,42,23,19
46094,Beowúlf,burning-blade,1375,warrior,arms,41,16,25
46095,Dolkal,tichondrius,1375,warrior,arms,57,21,36
46096,Asc,barthilas,1374,warrior,arms,171,89,82
46097,Danzohh,dalaran,1374,warrior,arms,33,15,18
46098,Nightshauyia,kelthuzad,1373,warrior,arms,51,27,24
46099,Machineofwar,zuluhed,1373,warrior,arms,138,65,73
46100,Rushour,quelthalas,1372,warrior,arms,32,15,17
46101,Storkos,moon-guard,1371,warrior,arms,107,57,50
46102,Kinzi,quelthalas,1371,warrior,arms,94,38,56
46103,Xradull,dawnbringer,1370,warrior,arms,44,25,19
46104,Ðarkstar,zuljin,1370,warrior,arms,140,62,78
46105,Justfair,barthilas,1368,warrior,arms,51,28,23
46106,Budzie,frostwolf,1368,warrior,arms,34,18,16
46107,Powerhard,area-52,1368,warrior,arms,57,26,31
46108,Fatty,mugthol,1367,warrior,arms,24,16,8
46109,Dhaemom,azralon,1366,warrior,arms,133,69,64
46110,Evilkorean,tichondrius,1366,warrior,arms,59,29,30
46111,Durko,whisperwind,1365,warrior,arms,36,16,20
46112,Danzael,quelthalas,1364,warrior,arms,42,18,24
46113,Xampuu,ragnaros,1363,warrior,arms,34,20,14
46114,Rayks,tichondrius,1363,warrior,arms,60,34,26
46115,Theragar,kilrogg,1363,warrior,arms,36,20,16
46116,Sevala,spinebreaker,1363,warrior,arms,58,32,26
46117,Juicey,burning-blade,1363,warrior,arms,43,22,21
46118,Gritrog,thrall,1362,warrior,arms,50,37,13
46119,Neozsmash,thrall,1362,warrior,arms,58,29,29
46120,Mjorn,sargeras,1362,warrior,arms,64,30,34
46121,Yummybumbum,barthilas,1362,warrior,arms,60,26,34
46122,Hopar,illidan,1361,warrior,arms,39,23,16
46123,Mervyn,aegwynn,1360,warrior,arms,48,29,19
46124,Allgas,barthilas,1360,warrior,arms,107,58,49
46125,Warsaínt,area-52,1360,warrior,arms,65,31,34
46126,Lègèndáry,dark-iron,1359,warrior,arms,48,21,27
46127,Tigo,khaz-modan,1358,warrior,arms,81,44,37
46128,Davidorco,drakkari,1358,warrior,arms,41,19,22
46129,Rikuduo,quelthalas,1358,warrior,arms,102,46,56
46130,Estivador,kelthuzad,1358,warrior,arms,50,21,29
46131,Drygen,tichondrius,1357,warrior,arms,36,22,14
46132,Toagrim,azralon,1357,warrior,arms,36,17,19
46133,Caupølican,ragnaros,1356,warrior,arms,60,28,32
46134,Bùlk,barthilas,1355,warrior,arms,77,33,44
46135,Kratosxx,quelthalas,1355,warrior,arms,35,15,20
46136,Doomreaprr,hellscream,1354,warrior,arms,28,18,10
46137,Rapralph,barthilas,1354,warrior,arms,30,15,15
46138,Lowlow,lightbringer,1354,warrior,arms,36,16,20
46139,Rockadoodle,tichondrius,1353,warrior,arms,48,22,26
46140,Silverkiller,drakkari,1352,warrior,arms,51,26,25
46141,Týrodar,moon-guard,1352,warrior,arms,36,16,20
46142,Browneyed,area-52,1352,warrior,arms,36,15,21
46143,Nviv,proudmoore,1351,warrior,arms,90,40,50
46144,Kror,garona,1350,warrior,arms,59,27,32
46145,Swordmasters,icecrown,1350,warrior,arms,42,18,24
46146,Rampage,azralon,1349,warrior,arms,125,59,66
46147,Ximzhao,quelthalas,1348,warrior,arms,42,21,21
46148,Cauldrin,bleeding-hollow,1348,warrior,arms,60,29,31
46149,Jsolucky,thrall,1348,warrior,arms,36,15,21
46150,Thegoochgoon,malorne,1347,warrior,arms,57,31,26
46151,Dimus,area-52,1347,warrior,arms,36,15,21
46152,Zaexx,stormrage,1346,warrior,arms,59,29,30
46153,Scrapx,malganis,1346,warrior,arms,107,51,56
46154,Rasgriz,moon-guard,1346,warrior,arms,43,20,23
46155,Tasesino,quelthalas,1345,warrior,arms,40,21,19
46156,ßaldbornë,stormrage,1344,warrior,arms,94,47,47
46157,Jeffe,khadgar,1344,warrior,arms,74,30,44
46158,Warraaxx,stonemaul,1343,warrior,arms,48,25,23
46159,Notmagnusz,zuljin,1343,warrior,arms,30,14,16
46160,Legday,stormrage,1343,warrior,arms,30,14,16
46161,Wtssap,ragnaros,1342,warrior,arms,24,14,10
46162,Twobyfuor,sargeras,1342,warrior,arms,48,23,25
46163,Niudazhuang,tichondrius,1341,warrior,arms,76,43,33
46164,Handkerchief,bleeding-hollow,1341,warrior,arms,31,15,16
46165,Gentlehugs,illidan,1340,warrior,arms,36,14,22
46166,Sunamys,illidan,1340,warrior,arms,36,14,22
46167,Tamagoshi,kiljaeden,1339,warrior,arms,102,53,49
46168,Gáren,quelthalas,1338,warrior,arms,24,14,10
46169,Kelidar,kaelthas,1338,warrior,arms,42,22,20
46170,Juggerboo,frostmourne,1338,warrior,arms,55,25,30
46171,Verigislena,moon-guard,1337,warrior,arms,38,20,18
46172,Byung,terenas,1337,warrior,arms,90,38,52
46173,Tÿÿr,azralon,1337,warrior,arms,54,22,32
46174,Govosh,thrall,1336,warrior,arms,24,14,10
46175,Swamis,stormreaver,1336,warrior,arms,36,19,17
46176,Azog,bleeding-hollow,1336,warrior,arms,48,25,23
46177,Omnïslash,tichondrius,1336,warrior,arms,30,14,16
46178,Viagraliker,tichondrius,1336,warrior,arms,44,19,25
46179,Rhorix,korialstrasz,1336,warrior,arms,36,14,22
46180,Wesih,ragnaros,1336,warrior,arms,60,22,38
46181,Xenoblade,wildhammer,1335,warrior,arms,48,21,27
46182,Xenowar,alleria,1335,warrior,arms,96,41,55
46183,Dicedup,stormrage,1335,warrior,arms,36,14,22
46184,Rageinice,tichondrius,1334,warrior,arms,42,21,21
46185,Vemue,tichondrius,1334,warrior,arms,160,79,81
46186,Slammshady,tichondrius,1333,warrior,arms,21,15,6
46187,Ybo,illidan,1333,warrior,arms,63,39,24
46188,Torkus,ragnaros,1333,warrior,arms,52,26,26
46189,Barricade,velen,1333,warrior,arms,131,64,67
46190,Konraad,amanthul,1333,warrior,arms,36,15,21
46191,Jijiyeya,tichondrius,1332,warrior,arms,36,17,19
46192,Odrath,tichondrius,1332,warrior,arms,75,35,40
46193,Blackwulff,korgath,1332,warrior,arms,66,29,37
46194,Varekai,frostmourne,1331,warrior,arms,62,32,30
46195,Loothar,goldrinn,1331,warrior,arms,75,37,38
46196,Warb,aggramar,1331,warrior,arms,72,35,37
46197,Erdres,kelthuzad,1331,warrior,arms,63,22,41
46198,Lexxsteele,mugthol,1330,warrior,arms,24,14,10
46199,Carken,kiljaeden,1330,warrior,arms,36,20,16
46200,Thulsan,emerald-dream,1329,warrior,arms,30,14,16
46201,Kilroywar,tichondrius,1329,warrior,arms,30,14,16
46202,Marraneitor,quelthalas,1328,warrior,arms,30,16,14
46203,Fixafflock,bleeding-hollow,1327,warrior,arms,24,14,10
46204,Chilicezo,durotan,1327,warrior,arms,65,37,28
46205,Kalnor,dark-iron,1327,warrior,arms,50,26,24
46206,Kantorowicz,goldrinn,1327,warrior,arms,66,32,34
46207,Retros,kelthuzad,1327,warrior,arms,66,32,34
46208,Ketasshi,kelthuzad,1327,warrior,arms,36,14,22
46209,Suprslayer,spirestone,1326,warrior,arms,24,14,10
46210,Twistwarr,area-52,1326,warrior,arms,24,14,10
46211,Zuljikan,illidan,1326,warrior,arms,47,16,31
46212,Handain,malganis,1324,warrior,arms,30,14,16
46213,Kiayla,quelthalas,1324,warrior,arms,40,16,24
46214,Mitered,tichondrius,1323,warrior,arms,39,19,20
46215,Aparentlynot,shattered-hand,1323,warrior,arms,30,14,16
46216,Hiddensquidd,stormrage,1322,warrior,arms,51,31,20
46217,Overfury,azralon,1322,warrior,arms,36,18,18
46218,Venecus,stormrage,1321,warrior,arms,30,14,16
46219,Sharpen,terokkar,1320,warrior,arms,24,14,10
46220,Rekem,malganis,1320,warrior,arms,60,27,33
46221,Macsen,zuljin,1319,warrior,arms,36,18,18
46222,Thrawb,bleeding-hollow,1319,warrior,arms,33,15,18
46223,Grimreáper,bleeding-hollow,1319,warrior,arms,42,14,28
46224,Gï,fizzcrank,1318,warrior,arms,24,14,10
46225,Chargeback,zuljin,1318,warrior,arms,63,34,29
46226,Arkayko,quelthalas,1318,warrior,arms,28,15,13
46227,Zroz,ragnaros,1318,warrior,arms,54,28,26
46228,Lujzika,stormreaver,1318,warrior,arms,39,17,22
46229,Calmaah,frostmourne,1317,warrior,arms,63,33,30
46230,Orcaine,ursin,1315,warrior,arms,41,27,14
46231,Emaree,thrall,1315,warrior,arms,64,34,30
46232,Valder,akama,1315,warrior,arms,30,15,15
46233,Fuller,kelthuzad,1314,warrior,arms,36,18,18
46234,Säbeër,ragnaros,1314,warrior,arms,30,14,16
46235,Qtcrow,frostmourne,1310,warrior,arms,78,39,39
46236,Fòntaine,shandris,1310,warrior,arms,30,15,15
46237,Sseobeon,tichondrius,1310,warrior,arms,28,14,14
46238,Irix,tichondrius,1310,warrior,arms,123,61,62
46239,Tunasurprize,stormrage,1310,warrior,arms,33,16,17
46240,Korsarro,frostmourne,1310,warrior,arms,86,40,46
46241,Doomtree,zuljin,1309,warrior,arms,18,14,4
46242,Makcumba,ragnaros,1309,warrior,arms,54,29,25
46243,Northhill,tichondrius,1309,warrior,arms,59,30,29
46244,Arm,stormscale,1309,warrior,arms,56,26,30
46245,Yoruba,burning-blade,1309,warrior,arms,49,18,31
46246,Ightdoex,zuljin,1308,warrior,arms,26,18,8
46247,Mussashí,stormrage,1308,warrior,arms,56,35,21
46248,Daymiian,blackrock,1308,warrior,arms,42,17,25
46249,Mickyplate,tichondrius,1307,warrior,arms,78,39,39
46250,Aldérmach,zuljin,1306,warrior,arms,112,57,55
46251,Velarrine,illidan,1306,warrior,arms,89,39,50
46252,Knghtofseven,nemesis,1305,warrior,arms,72,39,33
46253,Tikkò,tichondrius,1305,warrior,arms,50,25,25
46254,Rhagnael,malganis,1305,warrior,arms,72,30,42
46255,Raekor,tichondrius,1304,warrior,arms,42,25,17
46256,Zuggarnaught,tichondrius,1304,warrior,arms,82,44,38
46257,Brontok,darkspear,1304,warrior,arms,52,25,27
46258,Bersorcker,ragnaros,1304,warrior,arms,60,24,36
46259,Deadee,aerie-peak,1302,warrior,arms,100,48,52
46260,Akj,sargeras,1302,warrior,arms,54,23,31
46261,Ludicrous,dreadmaul,1302,warrior,arms,85,36,49
46262,Kittybang,quelthalas,1302,warrior,arms,54,19,35
46263,Donhoolio,illidan,1301,warrior,arms,24,14,10
46264,Legolant,uther,1301,warrior,arms,30,14,16
46265,Filthyrandy,proudmoore,1301,warrior,arms,36,15,21
46266,Skornnd,malganis,1301,warrior,arms,56,23,33
46267,Dúmßlòwn,tichondrius,1300,warrior,arms,162,75,87
46268,Pvpheart,tichondrius,1299,warrior,arms,47,27,20
46269,Krostyx,ragnaros,1299,warrior,arms,72,40,32
46270,Chawp,emerald-dream,1299,warrior,arms,47,24,23
46271,Warrdawg,tichondrius,1298,warrior,arms,36,20,16
46272,Nuclearfury,khadgar,1298,warrior,arms,48,24,24
46273,Fuknazum,gundrak,1298,warrior,arms,120,55,65
46274,Xufoxpikmin,gurubashi,1297,warrior,arms,100,43,57
46275,Kitonic,proudmoore,1296,warrior,arms,29,18,11
46276,Guitter,nazjatar,1296,warrior,arms,48,20,28
46277,Greywo,tichondrius,1295,warrior,arms,61,34,27
46278,Beeny,tichondrius,1295,warrior,arms,33,14,19
46279,Blacksmiff,malganis,1294,warrior,arms,78,44,34
46280,Iyamii,hyjal,1294,warrior,arms,29,16,13
46281,Superpot,bleeding-hollow,1294,warrior,arms,48,22,26
46282,Xl,quelthalas,1294,warrior,arms,55,24,31
46283,Crú,stormrage,1293,warrior,arms,30,14,16
46284,Noobslayr,wyrmrest-accord,1290,warrior,arms,30,18,12
46285,Golîath,mannoroth,1290,warrior,arms,79,35,44
46286,Ønì,tichondrius,1289,warrior,arms,48,35,13
46287,Grumok,tichondrius,1289,warrior,arms,57,24,33
46288,Pangpou,tichondrius,1288,warrior,arms,108,56,52
46289,Bifilar,frostmourne,1288,warrior,arms,36,18,18
46290,Devilsbane,khaz-modan,1287,warrior,arms,54,26,28
46291,Walterwhîte,tichondrius,1287,warrior,arms,30,14,16
46292,Swiftui,nemesis,1287,warrior,arms,69,30,39
46293,Rockystyle,tichondrius,1286,warrior,arms,54,30,24
46294,Hôdû,tichondrius,1286,warrior,arms,75,36,39
46295,Egargiss,malygos,1285,warrior,arms,24,14,10
46296,Sllvrbck,tichondrius,1284,warrior,arms,28,17,11
46297,Valde,stormrage,1284,warrior,arms,27,14,13
46298,Logi,alexstrasza,1284,warrior,arms,36,15,21
46299,Munchiesxqc,exodar,1284,warrior,arms,50,19,31
46300,Dualip,tichondrius,1283,warrior,arms,75,38,37
46301,Excaliburz,frostmourne,1283,warrior,arms,101,48,53
46302,Rnkman,quelthalas,1282,warrior,arms,25,16,9
46303,Putong,tichondrius,1282,warrior,arms,41,23,18
46304,Kagerou,ragnaros,1282,warrior,arms,62,28,34
46305,Marvél,quelthalas,1278,warrior,arms,69,36,33
46306,Nervoxztwo,ragnaros,1278,warrior,arms,81,39,42
46307,Bfrenzy,dalaran,1278,warrior,arms,42,18,24
46308,Mogtash,blackrock,1278,warrior,arms,41,16,25
46309,Jhave,ragnaros,1277,warrior,arms,38,17,21
46310,Kourny,frostmourne,1276,warrior,arms,75,36,39
46311,Aintou,aegwynn,1276,warrior,arms,42,20,22
46312,Ragnarwar,azralon,1275,warrior,arms,40,21,19
46313,Chrosis,norgannon,1275,warrior,arms,65,25,40
46314,Dieselsauce,stormscale,1273,warrior,arms,24,18,6
46315,Swám,quelthalas,1273,warrior,arms,36,16,20
46316,Amrap,dentarg,1273,warrior,arms,37,16,21
46317,Krazyguerra,bleeding-hollow,1272,warrior,arms,48,26,22
46318,Arox,ghostlands,1272,warrior,arms,60,30,30
46319,Warnick,illidan,1272,warrior,arms,60,28,32
46320,Dëkm,quelthalas,1272,warrior,arms,41,18,23
46321,Unbeatablezs,tichondrius,1271,warrior,arms,48,25,23
46322,Papaming,tichondrius,1270,warrior,arms,60,25,35
46323,Thorablade,barthilas,1268,warrior,arms,96,44,52
46324,Loucha,nagrand,1268,warrior,arms,75,32,43
46325,Eudora,stormrage,1267,warrior,arms,66,35,31
46326,Athin,azralon,1267,warrior,arms,29,14,15
46327,Catastrophie,mugthol,1266,warrior,arms,87,39,48
46328,Spartaner,shadowsong,1265,warrior,arms,36,14,22
46329,Babybears,tichondrius,1265,warrior,arms,38,14,24
46330,Spitfired,kiljaeden,1264,warrior,arms,36,19,17
46331,Ygucheng,emerald-dream,1264,warrior,arms,55,26,29
46332,Datsongz,proudmoore,1264,warrior,arms,90,42,48
46333,Vyndronor,illidan,1264,warrior,arms,54,24,30
46334,Timotheapple,stormrage,1264,warrior,arms,32,14,18
46335,Winjerrywin,frostwolf,1263,warrior,arms,34,22,12
46336,Krimmjðw,sargeras,1263,warrior,arms,36,14,22
46337,Babyguns,tichondrius,1262,warrior,arms,66,29,37
46338,ßloodshed,frostmourne,1261,warrior,arms,19,14,5
46339,Ivanovh,quelthalas,1261,warrior,arms,180,90,90
46340,Kuchikilla,borean-tundra,1261,warrior,arms,82,40,42
46341,Laynarri,hyjal,1260,warrior,arms,60,28,32
46342,Wrathena,khadgar,1258,warrior,arms,55,26,29
46343,Gorash,gundrak,1257,warrior,arms,87,43,44
46344,Superdah,kiljaeden,1257,warrior,arms,60,26,34
46345,Bootstraps,hyjal,1256,warrior,arms,54,25,29
46346,Selathiel,burning-blade,1256,warrior,arms,40,16,24
46347,Queterompo,ragnaros,1255,warrior,arms,66,36,30
46348,Aleniá,tichondrius,1255,warrior,arms,79,37,42
46349,Croxxs,aegwynn,1253,warrior,arms,50,17,33
46350,Cbum,quelthalas,1251,warrior,arms,30,14,16
46351,Brynjah,azralon,1249,warrior,arms,90,40,50
46352,Lagzistance,area-52,1248,warrior,arms,24,13,11
46353,Bloodwish,stormrage,1247,warrior,arms,46,26,20
46354,Areaves,moon-guard,1247,warrior,arms,24,13,11
46355,Wtbfriends,malganis,1247,warrior,arms,24,13,11
46356,Belàrià,tichondrius,1247,warrior,arms,24,13,11
46357,Groxxigore,chogall,1247,warrior,arms,72,38,34
46358,Scotteh,eredar,1247,warrior,arms,30,13,17
46359,Xvett,drakkari,1246,warrior,arms,36,20,16
46360,Callad,tichondrius,1246,warrior,arms,47,22,25
46361,Schizogeist,malganis,1246,warrior,arms,40,18,22
46362,Betterwar,zuljin,1246,warrior,arms,30,13,17
46363,Vamtoro,illidan,1244,warrior,arms,34,19,15
46364,Bigdumborc,tichondrius,1244,warrior,arms,24,13,11
46365,Thelgrath,quelthalas,1244,warrior,arms,125,60,65
46366,Småckin,frostmourne,1243,warrior,arms,36,20,16
46367,Andorane,bleeding-hollow,1243,warrior,arms,24,13,11
46368,Qookymonster,zuljin,1243,warrior,arms,66,33,33
46369,Flexinbooty,kelthuzad,1243,warrior,arms,36,13,23
46370,Dånkers,sargeras,1243,warrior,arms,36,13,23
46371,Dodgestrikes,khaz-modan,1242,warrior,arms,18,13,5
46372,Ystk,tichondrius,1242,warrior,arms,24,13,11
46373,Exxic,zuljin,1242,warrior,arms,26,14,12
46374,Gíal,ragnaros,1242,warrior,arms,64,26,38
46375,Titanika,wyrmrest-accord,1242,warrior,arms,72,28,44
46376,Deadhawk,wyrmrest-accord,1242,warrior,arms,72,28,44
46377,Guerra,goldrinn,1241,warrior,arms,24,13,11
46378,Ragedump,shadowsong,1241,warrior,arms,26,13,13
46379,Juff,hakkar,1241,warrior,arms,36,15,21
46380,Methwitch,moon-guard,1240,warrior,arms,24,13,11
46381,Chadblade,tichondrius,1240,warrior,arms,24,13,11
46382,Qtxd,malganis,1240,warrior,arms,24,13,11
46383,Grimjouw,sargeras,1240,warrior,arms,24,13,11
46384,Deamonkiller,kelthuzad,1240,warrior,arms,103,45,58
46385,Jaminos,frostmourne,1240,warrior,arms,51,22,29
46386,Ðhrâgøn,ragnaros,1239,warrior,arms,18,15,3
46387,Tämuros,thrall,1239,warrior,arms,36,17,19
46388,Mitigation,hyjal,1239,warrior,arms,34,15,19
46389,Noitrak,azralon,1239,warrior,arms,33,14,19
46390,Demonsláyer,illidan,1238,warrior,arms,24,13,11
46391,Retrostorm,illidan,1238,warrior,arms,24,13,11
46392,Depthsii,lightbringer,1238,warrior,arms,30,14,16
46393,Deathengine,area-52,1237,warrior,arms,29,14,15
46394,Squeekzz,frostmane,1236,warrior,arms,50,24,26
46395,Macray,proudmoore,1235,warrior,arms,24,13,11
46396,Moozz,dreadmaul,1235,warrior,arms,30,13,17
46397,Rahgnarson,kelthuzad,1235,warrior,arms,36,13,23
46398,Lokiilloo,drakkari,1234,warrior,arms,61,30,31
46399,Naxxiki,wyrmrest-accord,1234,warrior,arms,120,57,63
46400,Hoodlord,tichondrius,1234,warrior,arms,54,24,30
46401,Beatmeat,frostmourne,1234,warrior,arms,30,13,17
46402,Nosfuratuzod,frostmourne,1233,warrior,arms,49,22,27
46403,Standsonkegs,illidan,1233,warrior,arms,30,13,17
46404,Bananae,stormrage,1232,warrior,arms,21,14,7
46405,Pandaniela,area-52,1232,warrior,arms,30,18,12
46406,Goldbêrg,malganis,1232,warrior,arms,24,13,11
46407,Gale,kelthuzad,1232,warrior,arms,24,13,11
46408,Tansozzi,tichondrius,1232,warrior,arms,24,13,11
46409,Aqee,illidan,1231,warrior,arms,36,21,15
46410,Wankcelot,kiljaeden,1231,warrior,arms,48,21,27
46411,Moonsworn,moon-guard,1231,warrior,arms,30,13,17
46412,Eternalwill,rexxar,1229,warrior,arms,24,13,11
46413,Awkagar,hyjal,1228,warrior,arms,23,13,10
46414,Dji,tichondrius,1228,warrior,arms,215,102,113
46415,Dhano,drakkari,1228,warrior,arms,30,14,16
46416,Prodigál,dalaran,1228,warrior,arms,30,13,17
46417,Malystik,ragnaros,1225,warrior,arms,93,49,44
46418,Monardaid,uldum,1225,warrior,arms,36,14,22
46419,Tunchi,runetotem,1224,warrior,arms,90,47,43
46420,Armorlancer,stormrage,1223,warrior,arms,24,13,11
46421,Mortawar,tichondrius,1222,warrior,arms,24,13,11
46422,Boocawkeyy,illidan,1222,warrior,arms,36,13,23
46423,Diamict,wyrmrest-accord,1221,warrior,arms,18,13,5
46424,Kannerhus,quelthalas,1221,warrior,arms,47,22,25
46425,Notsi,ragnaros,1219,warrior,arms,36,15,21
46426,Slivers,stormrage,1218,warrior,arms,30,16,14
46427,Ðwârf,tichondrius,1218,warrior,arms,46,17,29
46428,Rekcd,sargeras,1217,warrior,arms,18,13,5
46429,Lilboytroy,korgath,1217,warrior,arms,30,13,17
46430,Zeldrissx,quelthalas,1217,warrior,arms,50,19,31
46431,Urscrewed,frostmane,1217,warrior,arms,35,13,22
46432,Akunaswar,dalaran,1215,warrior,arms,89,41,48
46433,Dsz,nemesis,1215,warrior,arms,53,24,29
46434,Southmariner,malganis,1214,warrior,arms,42,22,20
46435,Hikikomori,goldrinn,1214,warrior,arms,41,20,21
46436,Vâìn,tichondrius,1214,warrior,arms,34,15,19
46437,Dippindabz,area-52,1213,warrior,arms,47,26,21
46438,Truongx,kiljaeden,1212,warrior,arms,24,14,10
46439,Franc,kiljaeden,1212,warrior,arms,29,14,15
46440,Calynn,frostmourne,1212,warrior,arms,114,55,59
46441,Ediict,illidan,1212,warrior,arms,29,13,16
46442,Hatedßyßlízz,area-52,1212,warrior,arms,30,13,17
46443,Jalaskâ,azralon,1212,warrior,arms,64,27,37
46444,Deomer,quelthalas,1211,warrior,arms,30,14,16
46445,Avoraçado,nemesis,1210,warrior,arms,115,46,69
46446,Aelrog,malganis,1209,warrior,arms,106,55,51
46447,Geoorg,ragnaros,1209,warrior,arms,53,24,29
46448,Brozown,wildhammer,1209,warrior,arms,32,14,18
46449,Rageloading,amanthul,1208,warrior,arms,36,18,18
46450,Mezi,tichondrius,1208,warrior,arms,35,17,18
46451,Baadomishram,ragnaros,1208,warrior,arms,30,14,16
46452,Tenchuu,azralon,1208,warrior,arms,100,43,57
46453,Rageoverdose,burning-legion,1208,warrior,arms,42,18,24
46454,Yiffathon,wyrmrest-accord,1207,warrior,arms,87,37,50
46455,Deadhofe,azuremyst,1205,warrior,arms,33,16,17
46456,Carralee,azralon,1203,warrior,arms,30,19,11
46457,Fkndog,tichondrius,1203,warrior,arms,66,31,35
46458,Vapòr,frostmourne,1201,warrior,arms,24,14,10
46459,Rawlur,zuljin,1201,warrior,arms,35,14,21
46460,Kapalua,darkspear,1200,warrior,arms,45,21,24
46461,Rebelzudo,azralon,1199,warrior,arms,42,25,17
46462,Dreweth,altar-of-storms,1199,warrior,arms,24,13,11
46463,Friendnoodle,frostmourne,1199,warrior,arms,59,28,31
46464,Kiddoe,rivendare,1199,warrior,arms,84,39,45
46465,Swamphell,barthilas,1199,warrior,arms,43,13,30
46466,Aclipse,nagrand,1197,warrior,arms,65,34,31
46467,Warrshield,ragnaros,1197,warrior,arms,61,26,35
46468,Flexakute,malganis,1196,warrior,arms,24,14,10
46469,Darkhorv,frostmourne,1196,warrior,arms,23,13,10
46470,Dazfotm,tichondrius,1196,warrior,arms,35,13,22
46471,Thebruce,nemesis,1194,warrior,arms,112,55,57
46472,Franticlol,tichondrius,1193,warrior,arms,37,17,20
46473,Babamama,tichondrius,1192,warrior,arms,23,13,10
46474,Buliwyff,wyrmrest-accord,1192,warrior,arms,36,17,19
46475,Bazironbeard,ravencrest,1190,warrior,arms,17,13,4
46476,Annaliyah,wyrmrest-accord,1190,warrior,arms,66,36,30
46477,Areiden,sargeras,1190,warrior,arms,48,16,32
46478,Axharafuji,dalvengyr,1188,warrior,arms,48,20,28
46479,Gohawn,hyjal,1186,warrior,arms,37,20,17
46480,Lazyclap,nagrand,1185,warrior,arms,41,21,20
46481,Broxhar,ragnaros,1185,warrior,arms,39,18,21
46482,Aràthor,stormrage,1185,warrior,arms,93,41,52
46483,Helandas,moknathal,1184,warrior,arms,127,65,62
46484,Hadesz,nazjatar,1183,warrior,arms,71,34,37
46485,Cowbøycrytoo,azralon,1182,warrior,arms,88,46,42
46486,Yagura,emerald-dream,1182,warrior,arms,28,13,15
46487,Sherway,quelthalas,1180,warrior,arms,203,100,103
46488,Twoone,illidan,1178,warrior,arms,32,13,19
46489,Archonian,stormscale,1177,warrior,arms,34,21,13
46490,Skumwarr,moon-guard,1177,warrior,arms,58,22,36
46491,Orsex,ragnaros,1176,warrior,arms,26,13,13
46492,Orcbreaker,quelthalas,1176,warrior,arms,38,18,20
46493,Ragebladë,tichondrius,1175,warrior,arms,54,34,20
46494,Robotríp,illidan,1175,warrior,arms,42,18,24
46495,Zarrock,emerald-dream,1174,warrior,arms,26,14,12
46496,Süspicious,malfurion,1174,warrior,arms,35,14,21
46497,Rhydonero,azralon,1173,warrior,arms,27,16,11
46498,Tÿ,haomarush,1172,warrior,arms,25,14,11
46499,Bigolpeen,sargeras,1172,warrior,arms,36,19,17
46500,Droogust,tichondrius,1172,warrior,arms,30,15,15
46501,Rauh,emerald-dream,1171,warrior,arms,22,13,9
46502,Thedargz,trollbane,1170,warrior,arms,110,58,52
46503,Stoul,illidan,1168,warrior,arms,30,22,8
46504,Rockley,mugthol,1168,warrior,arms,48,19,29
46505,Nosetackle,area-52,1166,warrior,arms,64,31,33
46506,Medusaann,proudmoore,1166,warrior,arms,33,15,18
46507,Adunken,ragnaros,1165,warrior,arms,30,17,13
46508,Purplepiper,ragnaros,1165,warrior,arms,23,13,10
46509,Grömäash,ragnaros,1165,warrior,arms,32,13,19
46510,Looffy,saurfang,1165,warrior,arms,42,16,26
46511,Puertorc,ragnaros,1163,warrior,arms,36,17,19
46512,Daddymoist,moon-guard,1163,warrior,arms,54,24,30
46513,Gongos,doomhammer,1161,warrior,arms,207,107,100
46514,Joed,quelthalas,1160,warrior,arms,78,37,41
46515,Mortilant,perenolde,1160,warrior,arms,75,34,41
46516,Ãleister,stormrage,1160,warrior,arms,63,25,38
46517,Stolz,dragonmaw,1157,warrior,arms,30,13,17
46518,Tomatogodx,sargeras,1156,warrior,arms,31,15,16
46519,Elpish,ragnaros,1154,warrior,arms,66,31,35
46520,Magnuszx,zuljin,1152,warrior,arms,18,12,6
46521,Pathelsonsus,stormrage,1152,warrior,arms,30,12,18
46522,Wewladdie,malganis,1151,warrior,arms,18,12,6
46523,Atomiclol,area-52,1151,warrior,arms,18,12,6
46524,Noelglz,quelthalas,1151,warrior,arms,18,12,6
46525,Moxxyy,tichondrius,1151,warrior,arms,24,12,12
46526,Kroni,ragnaros,1151,warrior,arms,24,12,12
46527,Gorek,illidan,1151,warrior,arms,24,12,12
46528,Turecw,illidan,1151,warrior,arms,24,12,12
46529,Mixx,bleeding-hollow,1151,warrior,arms,24,12,12
46530,Tokugawaieya,nemesis,1151,warrior,arms,24,12,12
46531,Onefourfifty,tichondrius,1150,warrior,arms,18,12,6
46532,Hàru,illidan,1150,warrior,arms,18,12,6
46533,Downblow,tichondrius,1150,warrior,arms,18,12,6
46534,Einnarr,tichondrius,1150,warrior,arms,19,12,7
46535,Nexgenwar,destromath,1150,warrior,arms,24,12,12
46536,Recktko,sargeras,1150,warrior,arms,33,13,20
46537,Nyloras,illidan,1150,warrior,arms,34,13,21
46538,Jarheadz,bleeding-hollow,1150,warrior,arms,35,12,23
46539,Gordofofo,azralon,1149,warrior,arms,18,12,6
46540,Iblowloads,illidan,1149,warrior,arms,24,14,10
46541,Scaredwarr,stormrage,1149,warrior,arms,45,24,21
46542,Marzse,sargeras,1149,warrior,arms,24,12,12
46543,Arixos,frostmourne,1149,warrior,arms,24,12,12
46544,Cúdi,darkspear,1148,warrior,arms,18,12,6
46545,Retrospex,black-dragonflight,1148,warrior,arms,24,12,12
46546,Kamuwarr,azralon,1148,warrior,arms,24,12,12
46547,Woth,deathwing,1148,warrior,arms,24,12,12
46548,Suicider,stormrage,1148,warrior,arms,30,12,18
46549,Omnismash,stormrage,1148,warrior,arms,32,12,20
46550,Misclickëd,dalaran,1147,warrior,arms,24,12,12
46551,Vodkagoblin,sargeras,1147,warrior,arms,24,12,12
46552,Wo,alleria,1147,warrior,arms,24,12,12
46553,Virillius,wyrmrest-accord,1147,warrior,arms,28,13,15
46554,Jianhung,tichondrius,1147,warrior,arms,30,12,18
46555,Hektar,tichondrius,1146,warrior,arms,18,12,6
46556,Stompyocouch,mugthol,1146,warrior,arms,21,13,8
46557,Furryhorv,frostmourne,1146,warrior,arms,24,12,12
46558,Dâvo,area-52,1146,warrior,arms,24,12,12
46559,Ikitee,zuljin,1146,warrior,arms,24,12,12
46560,Alejandrica,ragnaros,1146,warrior,arms,30,12,18
46561,Ragnarloðbró,tichondrius,1146,warrior,arms,36,12,24
46562,Struka,drakkari,1145,warrior,arms,24,12,12
46563,Staystrong,tichondrius,1144,warrior,arms,18,12,6
46564,Skittlesxo,bleeding-hollow,1144,warrior,arms,24,12,12
46565,Maintarget,malganis,1144,warrior,arms,35,12,23
46566,Sartin,boulderfist,1144,warrior,arms,42,14,28
46567,Invared,stormrage,1143,warrior,arms,18,12,6
46568,Nibbzy,sargeras,1142,warrior,arms,18,12,6
46569,Lucidx,malfurion,1142,warrior,arms,18,12,6
46570,Haldeer,shadow-council,1142,warrior,arms,24,12,12
46571,Realthiccbbw,tichondrius,1142,warrior,arms,24,12,12
46572,Carnith,arthas,1142,warrior,arms,30,12,18
46573,Yisunshin,azralon,1141,warrior,arms,24,12,12
46574,Elmosmash,thrall,1141,warrior,arms,24,12,12
46575,Saskouach,stormrage,1140,warrior,arms,26,12,14
46576,Hblock,barthilas,1140,warrior,arms,30,12,18
46577,Brocc,tichondrius,1139,warrior,arms,24,12,12
46578,Tooto,kelthuzad,1138,warrior,arms,24,12,12
46579,Sloppyglucks,moon-guard,1138,warrior,arms,24,12,12
46580,Baloz,tichondrius,1138,warrior,arms,30,13,17
46581,Warrimon,nemesis,1138,warrior,arms,36,12,24
46582,Tappia,quelthalas,1138,warrior,arms,36,12,24
46583,Dizgraceful,malganis,1137,warrior,arms,18,12,6
46584,Soggynapkin,proudmoore,1136,warrior,arms,30,17,13
46585,Purefury,whisperwind,1136,warrior,arms,99,46,53
46586,Odinsglory,mugthol,1136,warrior,arms,112,48,64
46587,Zulgadark,ragnaros,1136,warrior,arms,39,15,24
46588,Theregulator,area-52,1135,warrior,arms,58,29,29
46589,Anotee,kelthuzad,1134,warrior,arms,93,48,45
46590,Shattering,fizzcrank,1134,warrior,arms,24,12,12
46591,Drahconian,aggramar,1134,warrior,arms,24,12,12
46592,Demðnslayer,kelthuzad,1134,warrior,arms,54,24,30
46593,Cecchino,zuluhed,1133,warrior,arms,24,12,12
46594,Angelsantos,sargeras,1133,warrior,arms,24,12,12
46595,Varyanguard,quelthalas,1133,warrior,arms,24,12,12
46596,Tripleblack,mugthol,1132,warrior,arms,18,12,6
46597,Isildur,nerzhul,1132,warrior,arms,36,20,16
46598,Sugarpanties,moon-guard,1132,warrior,arms,81,33,48
46599,Âmânthul,alexstrasza,1131,warrior,arms,158,82,76
46600,Bigsvit,trollbane,1131,warrior,arms,60,29,31
46601,Spritez,malganis,1131,warrior,arms,70,27,43
46602,Inunotaysho,quelthalas,1129,warrior,arms,54,22,32
46603,Azeryan,azralon,1129,warrior,arms,35,12,23
46604,Lunks,kelthuzad,1128,warrior,arms,18,12,6
46605,Bulletfodder,tichondrius,1127,warrior,arms,24,12,12
46606,Funderr,eonar,1126,warrior,arms,30,13,17
46607,Arashikage,malganis,1126,warrior,arms,34,13,21
46608,Angitu,quelthalas,1124,warrior,arms,24,14,10
46609,Rodhin,proudmoore,1124,warrior,arms,24,12,12
46610,Úmarth,azralon,1124,warrior,arms,60,29,31
46611,Mfmuggz,thunderlord,1124,warrior,arms,35,14,21
46612,Ambiss,azjolnerub,1120,warrior,arms,47,21,26
46613,Slumdawgg,andorhal,1119,warrior,arms,59,32,27
46614,Garìk,moon-guard,1119,warrior,arms,69,27,42
46615,Swiftynifty,area-52,1118,warrior,arms,48,29,19
46616,Clovê,ragnaros,1118,warrior,arms,36,21,15
46617,Aersasi,tichondrius,1117,warrior,arms,24,13,11
46618,Rahtahtas,area-52,1116,warrior,arms,24,12,12
46619,Philbert,alexstrasza,1116,warrior,arms,57,28,29
46620,Xyazhiro,ragnaros,1115,warrior,arms,66,29,37
46621,Hemone,frostmourne,1114,warrior,arms,30,15,15
46622,Thunderclapz,stormscale,1114,warrior,arms,24,12,12
46623,Containerbox,korgath,1112,warrior,arms,42,18,24
46624,Casteleiro,azralon,1112,warrior,arms,32,13,19
46625,Alejandros,azgalor,1111,warrior,arms,23,12,11
46626,Warriorlee,jubeithos,1111,warrior,arms,44,19,25
46627,Brysontiller,frostmourne,1110,warrior,arms,23,12,11
46628,Raygé,malygos,1109,warrior,arms,26,13,13
46629,Huri,nemesis,1106,warrior,arms,32,17,15
46630,Cocainiouz,dalaran,1106,warrior,arms,42,17,25
46631,Youtank,kiljaeden,1105,warrior,arms,78,36,42
46632,Dvhwec,tichondrius,1105,warrior,arms,28,12,16
46633,Riga,tichondrius,1102,warrior,arms,48,24,24
46634,Laint,wyrmrest-accord,1102,warrior,arms,140,68,72
46635,Ðåddý,stormrage,1102,warrior,arms,29,12,17
46636,Tipincider,perenolde,1100,warrior,arms,21,12,9
46637,Bloodfx,darkspear,1100,warrior,arms,93,41,52
46638,Vaclein,quelthalas,1100,warrior,arms,30,13,17
46639,Raserei,moonrunner,1098,warrior,arms,75,35,40
46640,Panzerian,area-52,1097,warrior,arms,37,14,23
46641,Tyrantwolf,ragnaros,1097,warrior,arms,45,17,28
46642,Forevercute,proudmoore,1096,warrior,arms,23,14,9
46643,Theøcritus,korgath,1096,warrior,arms,42,25,17
46644,Knocks,blackrock,1094,warrior,arms,21,13,8
46645,Melankoma,sargeras,1094,warrior,arms,30,12,18
46646,Arrogated,emerald-dream,1093,warrior,arms,90,44,46
46647,Dissx,illidan,1092,warrior,arms,37,16,21
46648,Njjszn,thrall,1091,warrior,arms,196,93,103
46649,Ujumpijump,andorhal,1089,warrior,arms,78,29,49
46650,Royye,blood-furnace,1088,warrior,arms,24,12,12
46651,Jiszle,sargeras,1085,warrior,arms,34,12,22
46652,Agresvnapkin,dalaran,1084,warrior,arms,20,12,8
46653,Kempachii,ragnaros,1083,warrior,arms,82,40,42
46654,Aquannas,bloodscalp,1082,warrior,arms,24,14,10
46655,Pingorosho,quelthalas,1082,warrior,arms,36,16,20
46656,Imcute,senjin,1082,warrior,arms,72,28,44
46657,Malok,deathwing,1082,warrior,arms,57,20,37
46658,Locotto,ragnaros,1082,warrior,arms,42,13,29
46659,Rockedanger,stormrage,1080,warrior,arms,26,15,11
46660,Riuk,goldrinn,1080,warrior,arms,29,16,13
46661,Tribbally,silver-hand,1079,warrior,arms,20,13,7
46662,Warrage,kiljaeden,1079,warrior,arms,68,32,36
46663,Eihn,quelthalas,1079,warrior,arms,35,14,21
46664,Raharon,chogall,1079,warrior,arms,52,20,32
46665,Gorfin,spirestone,1077,warrior,arms,42,12,30
46666,Sudavis,alleria,1075,warrior,arms,35,21,14
46667,Repsey,zuljin,1073,warrior,arms,17,12,5
46668,Several,whisperwind,1073,warrior,arms,39,23,16
46669,Ødïñ,sargeras,1071,warrior,arms,75,37,38
46670,Linçpin,tichondrius,1070,warrior,arms,26,12,14
46671,Yuccaleaptus,area-52,1070,warrior,arms,77,31,46
46672,Colosal,drakkari,1068,warrior,arms,21,14,7
46673,Hippy,kiljaeden,1067,warrior,arms,22,12,10
46674,Axedeity,caelestrasz,1063,warrior,arms,81,45,36
46675,Ugrundan,zuljin,1061,warrior,arms,48,21,27
46676,Hagud,tichondrius,1061,warrior,arms,29,12,17
46677,Bussundas,azralon,1059,warrior,arms,72,32,40
46678,Dackøzzt,quelthalas,1056,warrior,arms,18,11,7
46679,Midorikwa,area-52,1056,warrior,arms,18,11,7
46680,Benkenobi,khaz-modan,1056,warrior,arms,18,11,7
46681,Wizcleavuh,area-52,1056,warrior,arms,24,11,13
46682,Evanx,sargeras,1056,warrior,arms,24,11,13
46683,Varenkä,drakkari,1056,warrior,arms,24,11,13
46684,Pkgd,tichondrius,1055,warrior,arms,12,11,1
46685,Hotshótz,kelthuzad,1055,warrior,arms,12,11,1
46686,Dutchyy,frostmourne,1055,warrior,arms,18,11,7
46687,Gladiator,azshara,1055,warrior,arms,18,11,7
46688,Deathsteelw,zuljin,1055,warrior,arms,18,11,7
46689,Sonwar,azralon,1055,warrior,arms,18,11,7
46690,Tommygunns,area-52,1055,warrior,arms,18,11,7
46691,Hashwar,area-52,1055,warrior,arms,18,11,7
46692,Nerdstorm,tichondrius,1055,warrior,arms,18,11,7
46693,Vicioustalol,proudmoore,1055,warrior,arms,18,11,7
46694,Turtlestorm,tichondrius,1055,warrior,arms,18,11,7
46695,Zugprime,dragonmaw,1055,warrior,arms,18,11,7
46696,Breyns,garrosh,1055,warrior,arms,25,12,13
46697,Carriney,illidan,1055,warrior,arms,77,36,41
46698,Duckyuwu,tichondrius,1055,warrior,arms,24,11,13
46699,Bigdad,whisperwind,1055,warrior,arms,24,11,13
46700,Abomlnatlon,tichondrius,1055,warrior,arms,24,11,13
46701,Laddèrx,area-52,1055,warrior,arms,24,11,13
46702,Wheyprotein,illidan,1055,warrior,arms,24,11,13
46703,Feedzz,area-52,1055,warrior,arms,24,11,13
46704,Tankomode,area-52,1055,warrior,arms,24,11,13
46705,Édton,area-52,1055,warrior,arms,42,18,24
46706,Chopped,wyrmrest-accord,1054,warrior,arms,18,11,7
46707,Vooné,tichondrius,1054,warrior,arms,18,11,7
46708,Wargasms,alterac-mountains,1054,warrior,arms,24,11,13
46709,Vexwar,bleeding-hollow,1054,warrior,arms,24,11,13
46710,Wolfsrage,frostmourne,1054,warrior,arms,30,11,19
46711,Kolossus,korgath,1054,warrior,arms,30,11,19
46712,Ttl,dalaran,1053,warrior,arms,18,11,7
46713,Mimiovo,tichondrius,1053,warrior,arms,18,11,7
46714,Iwooglybool,icecrown,1053,warrior,arms,18,11,7
46715,Awm,wyrmrest-accord,1053,warrior,arms,24,11,13
46716,Mortalgodtko,ragnaros,1053,warrior,arms,28,12,16
46717,Môrôdin,area-52,1053,warrior,arms,30,11,19
46718,Adryina,zuljin,1052,warrior,arms,18,11,7
46719,Carrange,moon-guard,1052,warrior,arms,24,11,13
46720,Guguito,drakkari,1052,warrior,arms,24,11,13
46721,Drillbit,wyrmrest-accord,1051,warrior,arms,30,11,19
46722,Georgedubya,illidan,1051,warrior,arms,36,11,25
46723,Warriorbod,area-52,1050,warrior,arms,18,11,7
46724,Thecolor,tichondrius,1050,warrior,arms,30,11,19
46725,Crul,gurubashi,1050,warrior,arms,31,11,20
46726,Myceliumlog,frostmourne,1049,warrior,arms,18,11,7
46727,Raahjv,sargeras,1049,warrior,arms,18,11,7
46728,Halis,illidan,1049,warrior,arms,27,16,11
46729,Plagueis,dark-iron,1049,warrior,arms,24,11,13
46730,Gadderhammer,azgalor,1049,warrior,arms,42,17,25
46731,Snewdawg,malganis,1048,warrior,arms,22,12,10
46732,Jamil,illidan,1048,warrior,arms,156,75,81
46733,Kanekhy,ragnaros,1048,warrior,arms,24,11,13
46734,Genesisxp,barthilas,1048,warrior,arms,24,11,13
46735,Pum,bleeding-hollow,1048,warrior,arms,24,11,13
46736,Rathty,shadowsong,1048,warrior,arms,24,11,13
46737,Noktyn,haomarush,1048,warrior,arms,24,11,13
46738,Sako,amanthul,1048,warrior,arms,24,11,13
46739,Irishhammer,malfurion,1048,warrior,arms,35,12,23
46740,Bøgz,kelthuzad,1047,warrior,arms,18,11,7
46741,Bouk,bloodscalp,1047,warrior,arms,18,11,7
46742,Lololosda,quelthalas,1047,warrior,arms,36,17,19
46743,Cptstarship,sargeras,1047,warrior,arms,24,11,13
46744,Josephcrazy,tichondrius,1047,warrior,arms,24,11,13
46745,Dwarfanage,tichondrius,1047,warrior,arms,28,12,16
46746,Blaxst,gorgonnash,1046,warrior,arms,30,16,14
46747,Prunebery,area-52,1046,warrior,arms,30,16,14
46748,Fûry,tichondrius,1046,warrior,arms,124,59,65
46749,Nirax,burning-legion,1046,warrior,arms,26,11,15
46750,Jfordnever,area-52,1045,warrior,arms,18,11,7
46751,Eiendira,proudmoore,1045,warrior,arms,30,11,19
46752,Logsplitter,stormrage,1045,warrior,arms,36,11,25
46753,Orphasmic,moon-guard,1044,warrior,arms,36,11,25
46754,Homicideted,frostmourne,1043,warrior,arms,18,11,7
46755,Racky,dragonmaw,1043,warrior,arms,24,11,13
46756,Thedin,gorefiend,1043,warrior,arms,42,11,31
46757,Tenserr,kiljaeden,1042,warrior,arms,24,11,13
46758,Rineer,tichondrius,1042,warrior,arms,24,11,13
46759,Marcolatus,ragnaros,1042,warrior,arms,54,24,30
46760,Creator,dalaran,1041,warrior,arms,24,11,13
46761,Irongummy,frostmourne,1041,warrior,arms,24,11,13
46762,Hunnam,illidan,1041,warrior,arms,30,11,19
46763,Dylaiin,kelthuzad,1038,warrior,arms,30,11,19
46764,Wrekkshop,tichondrius,1037,warrior,arms,27,13,14
46765,Wrrx,frostmourne,1037,warrior,arms,24,11,13
46766,Thebeastwar,area-52,1036,warrior,arms,54,26,28
46767,Regthar,illidan,1034,warrior,arms,23,11,12
46768,Indoondabeat,azgalor,1034,warrior,arms,32,15,17
46769,Nobowar,tichondrius,1032,warrior,arms,24,11,13
46770,Potan,thrall,1030,warrior,arms,60,25,35
46771,Janlei,quelthalas,1030,warrior,arms,29,11,18
46772,Uglycubano,quelthalas,1029,warrior,arms,24,11,13
46773,Märiä,ragnaros,1028,warrior,arms,52,27,25
46774,Cronie,steamwheedle-cartel,1027,warrior,arms,36,16,20
46775,Nøzerker,kelthuzad,1020,warrior,arms,26,12,14
46776,Guanyúu,tichondrius,1017,warrior,arms,23,11,12
46777,Stygïàn,draenor,1016,warrior,arms,80,45,35
46778,Kì,moon-guard,1016,warrior,arms,30,13,17
46779,Galuf,malygos,1014,warrior,arms,18,11,7
46780,Coffetea,area-52,1011,warrior,arms,41,25,16
46781,Psýchótic,tichondrius,1009,warrior,arms,23,11,12
46782,Bionikus,nemesis,1009,warrior,arms,90,41,49
46783,Fazeo,madoran,1007,warrior,arms,21,11,10
46784,Blackstamp,tichondrius,1006,warrior,arms,35,18,17
46785,Oppos,lightnings-blade,1006,warrior,arms,23,11,12
46786,Hexenbæne,tichondrius,1006,warrior,arms,23,11,12
46787,Flycosmos,tichondrius,1006,warrior,arms,67,31,36
46788,Bingchilly,aegwynn,1004,warrior,arms,21,12,9
46789,Titanrage,tichondrius,1004,warrior,arms,21,11,10
46790,Starplatinum,aerie-peak,1004,warrior,arms,32,11,21
46791,Wastenott,area-52,1003,warrior,arms,18,11,7
46792,Vicor,ragnaros,1003,warrior,arms,24,14,10
46793,Gorepig,sargeras,1002,warrior,arms,29,11,18
46794,Deathsmirk,illidan,1001,warrior,arms,49,25,24
46795,Kreeper,farstriders,1001,warrior,arms,23,11,12
46796,Goofyahwok,doomhammer,998,warrior,arms,33,12,21
46797,Altruiel,sargeras,995,warrior,arms,40,20,20
46798,Joran,dathremar,995,warrior,arms,32,14,18
46799,Slimmjim,malganis,994,warrior,arms,17,11,6
46800,Kyritto,azralon,994,warrior,arms,35,18,17
46801,Tyrantt,malganis,994,warrior,arms,48,21,27
46802,Orkuduro,azralon,993,warrior,arms,77,37,40
46803,Tmhinfen,tichondrius,991,warrior,arms,16,11,5
46804,Szee,tichondrius,991,warrior,arms,17,11,6
46805,Elsamok,ragnaros,991,warrior,arms,17,11,6
46806,Jragonmaster,borean-tundra,991,warrior,arms,36,13,23
46807,Aggripa,kelthuzad,990,warrior,arms,20,11,9
46808,Neekka,tichondrius,990,warrior,arms,28,12,16
46809,Kalaxe,quelthalas,990,warrior,arms,36,11,25
46810,Brownman,saurfang,989,warrior,arms,30,12,18
46811,Midge,proudmoore,988,warrior,arms,65,31,34
46812,Târtàrûs,tichondrius,987,warrior,arms,36,17,19
46813,Lokiullr,tichondrius,985,warrior,arms,35,11,24
46814,Darkthok,drakkari,982,warrior,arms,34,15,19
46815,Sneaknyoface,sargeras,982,warrior,arms,26,11,15
46816,Tucô,skullcrusher,976,warrior,arms,49,22,27
46817,Happywarrior,tichondrius,976,warrior,arms,30,11,19
46818,Sudokubrain,tichondrius,974,warrior,arms,19,11,8
46819,Pumpuup,bleeding-hollow,973,warrior,arms,36,16,20
46820,Djfredsd,tichondrius,972,warrior,arms,13,11,2
46821,Nitechaos,thrall,972,warrior,arms,19,12,7
46822,Beardoff,sargeras,966,warrior,arms,16,11,5
46823,Elfmonger,proudmoore,966,warrior,arms,19,11,8
46824,Varrior,wyrmrest-accord,960,warrior,arms,18,10,8
46825,Adios,tichondrius,960,warrior,arms,18,10,8
46826,Szew,tichondrius,960,warrior,arms,18,10,8
46827,Codyjones,illidan,960,warrior,arms,18,10,8
46828,Sowavey,korgath,960,warrior,arms,18,10,8
46829,Tigris,nesingwary,960,warrior,arms,18,10,8
46830,Escanòr,malganis,960,warrior,arms,18,10,8
46831,Nuqupq,tichondrius,960,warrior,arms,18,10,8
46832,Battousäi,kiljaeden,960,warrior,arms,18,10,8
46833,Zhangye,tichondrius,960,warrior,arms,18,10,8
46834,ßdm,illidan,960,warrior,arms,24,10,14
46835,Jethrix,kelthuzad,960,warrior,arms,24,10,14
46836,Americanbull,moon-guard,960,warrior,arms,24,10,14
46837,Bradockqt,azralon,960,warrior,arms,24,10,14
46838,Choppin,sargeras,960,warrior,arms,24,10,14
46839,Wargázm,thrall,960,warrior,arms,24,10,14
46840,Benw,dawnbringer,960,warrior,arms,24,10,14
46841,Iløveaysla,azralon,960,warrior,arms,30,10,20
46842,Fatalian,proudmoore,960,warrior,arms,30,10,20
46843,Tantei,moon-guard,959,warrior,arms,18,10,8
46844,Akaius,ragnaros,959,warrior,arms,18,10,8
46845,Sheyshey,quelthalas,959,warrior,arms,18,10,8
46846,Blakeb,area-52,959,warrior,arms,18,10,8
46847,Doucherocket,kelthuzad,959,warrior,arms,18,10,8
46848,Bamxz,sargeras,959,warrior,arms,18,10,8
46849,Tmjakeful,area-52,959,warrior,arms,18,10,8
46850,Kaìju,dragonmaw,959,warrior,arms,18,10,8
46851,Crysis,malorne,959,warrior,arms,24,10,14
46852,Warfeno,malganis,959,warrior,arms,24,10,14
46853,Drdelicious,tichondrius,959,warrior,arms,24,10,14
46854,Elsee,drakkari,959,warrior,arms,42,10,32
46855,Est,illidan,958,warrior,arms,12,10,2
46856,Arrtorias,quelthalas,958,warrior,arms,12,10,2
46857,Glacierrsz,sargeras,958,warrior,arms,18,10,8
46858,Kolacut,tichondrius,958,warrior,arms,18,10,8
46859,Icrìtmypants,dragonmaw,958,warrior,arms,18,10,8
46860,Nickfurie,emerald-dream,958,warrior,arms,18,10,8
46861,Zolotrollo,area-52,958,warrior,arms,18,10,8
46862,Rallyingcry,illidan,958,warrior,arms,18,10,8
46863,Kanchy,sargeras,958,warrior,arms,18,10,8
46864,Bigdickfever,sargeras,958,warrior,arms,24,10,14
46865,Magnis,stormrage,958,warrior,arms,24,10,14
46866,Icestormray,illidan,958,warrior,arms,24,10,14
46867,Kelmor,thunderhorn,958,warrior,arms,30,10,20
46868,Farquahd,illidan,958,warrior,arms,30,10,20
46869,Matutekz,ragnaros,958,warrior,arms,30,10,20
46870,Babyweenis,sargeras,957,warrior,arms,12,10,2
46871,Razakamx,tichondrius,957,warrior,arms,12,10,2
46872,Ghostblood,stormscale,957,warrior,arms,12,10,2
46873,Leapsalp,proudmoore,957,warrior,arms,18,10,8
46874,Vecira,moon-guard,957,warrior,arms,18,10,8
46875,Sìkarío,illidan,957,warrior,arms,18,10,8
46876,Whórm,kelthuzad,957,warrior,arms,18,10,8
46877,Lieutemajor,nemesis,957,warrior,arms,43,21,22
46878,Targos,frostwolf,957,warrior,arms,24,10,14
46879,Pootybeef,daggerspine,957,warrior,arms,24,10,14
46880,Aberwarr,illidan,956,warrior,arms,18,10,8
46881,Seshømaru,quelthalas,956,warrior,arms,18,10,8
46882,Carrito,perenolde,956,warrior,arms,29,16,13
46883,Numb,moon-guard,956,warrior,arms,26,11,15
46884,Rottlingberg,kelthuzad,956,warrior,arms,24,10,14
46885,Aisinbro,illidan,956,warrior,arms,24,10,14
46886,Barøneza,stormrage,956,warrior,arms,24,10,14
46887,Ermeji,ragnaros,956,warrior,arms,24,10,14
46888,Torbajhorn,moon-guard,956,warrior,arms,24,10,14
46889,Warrbull,spirestone,956,warrior,arms,30,10,20
46890,Topmeoff,bleeding-hollow,955,warrior,arms,30,10,20
46891,Sneeze,kul-tiras,954,warrior,arms,18,10,8
46892,Theestallion,kiljaeden,954,warrior,arms,18,10,8
46893,Biloni,ragnaros,954,warrior,arms,24,10,14
46894,Xiosè,ragnaros,954,warrior,arms,24,10,14
46895,Starshattr,bleeding-hollow,954,warrior,arms,30,10,20
46896,Coffeebottom,wyrmrest-accord,953,warrior,arms,18,10,8
46897,Zomars,ragnaros,953,warrior,arms,18,10,8
46898,Roitty,proudmoore,953,warrior,arms,24,10,14
46899,Toky,malganis,952,warrior,arms,18,10,8
46900,Brianya,moon-guard,952,warrior,arms,24,10,14
46901,Aaltara,barthilas,951,warrior,arms,18,10,8
46902,Helaume,arathor,950,warrior,arms,18,10,8
46903,Darroma,bleeding-hollow,950,warrior,arms,18,10,8
46904,Spredforbred,area-52,950,warrior,arms,24,10,14
46905,Discopogo,nemesis,950,warrior,arms,24,10,14
46906,Waabi,emerald-dream,949,warrior,arms,18,10,8
46907,Vobiscum,drakkari,949,warrior,arms,24,10,14
46908,Ontull,emerald-dream,949,warrior,arms,36,10,26
46909,Imgunnacrum,malganis,946,warrior,arms,18,10,8
46910,Digitalpsyko,hyjal,946,warrior,arms,18,10,8
46911,Meatdrps,frostmane,941,warrior,arms,26,11,15
46912,Thing,gorgonnash,941,warrior,arms,24,10,14
46913,Vezixx,dragonmaw,939,warrior,arms,18,10,8
46914,Brutallypwnd,tichondrius,939,warrior,arms,35,19,16
46915,Hkbdynamus,black-dragonflight,939,warrior,arms,30,10,20
46916,Dragmös,nemesis,937,warrior,arms,12,10,2
46917,Hunchless,detheroc,937,warrior,arms,28,10,18
46918,Mariò,area-52,934,warrior,arms,18,10,8
46919,Tramplehaste,barthilas,931,warrior,arms,18,10,8
46920,Pocketaxe,blackwater-raiders,927,warrior,arms,83,40,43
46921,Ragesimp,stormrage,926,warrior,arms,23,10,13
46922,Gargameld,stormrage,925,warrior,arms,42,20,22
46923,Wondaimon,drakkari,922,warrior,arms,24,10,14
46924,Thråsh,area-52,916,warrior,arms,48,20,28
46925,Velliena,tichondrius,916,warrior,arms,32,11,21
46926,Rrawrr,bleeding-hollow,912,warrior,arms,20,11,9
46927,Jindyn,boulderfist,912,warrior,arms,58,27,31
46928,Skarkla,thrall,911,warrior,arms,29,10,19
46929,Beyblade,jubeithos,910,warrior,arms,17,10,7
46930,Nexie,moon-guard,910,warrior,arms,21,10,11
46931,Jägernaught,stormrage,910,warrior,arms,23,10,13
46932,Tandiko,wyrmrest-accord,908,warrior,arms,17,10,7
46933,Spitts,frostmourne,904,warrior,arms,21,10,11
46934,Tankdatt,frostmourne,899,warrior,arms,24,10,14
46935,Atrocithy,ragnaros,896,warrior,arms,16,10,6
46936,Girioo,thrall,895,warrior,arms,14,10,4
46937,Krokgoldmane,drakkari,893,warrior,arms,36,17,19
46938,Malathire,illidan,893,warrior,arms,22,10,12
46939,Tsebaoth,quelthalas,890,warrior,arms,48,19,29
46940,Wallzar,sargeras,887,warrior,arms,20,10,10
46941,Tankadin,dragonmaw,885,warrior,arms,24,10,14
46942,Bluthammer,wyrmrest-accord,884,warrior,arms,29,11,18
46943,Mortalchop,tichondrius,880,warrior,arms,19,10,9
46944,Hintofmint,tichondrius,878,warrior,arms,20,10,10
46945,Sígmar,dreadmaul,869,warrior,arms,18,10,8
46946,Skynitez,area-52,864,warrior,arms,12,9,3
46947,Moonyxx,frostmourne,864,warrior,arms,12,9,3
46948,Dripgodx,malganis,864,warrior,arms,12,9,3
46949,Ådderall,thrall,864,warrior,arms,12,9,3
46950,Dedgamesucks,darkspear,864,warrior,arms,12,9,3
46951,Thuggyfresh,malganis,864,warrior,arms,12,9,3
46952,Youngmoneyd,illidan,864,warrior,arms,12,9,3
46953,Microraccoon,tichondrius,864,warrior,arms,12,9,3
46954,Warronin,kaelthas,864,warrior,arms,12,9,3
46955,Alchera,fizzcrank,864,warrior,arms,18,9,9
46956,Miniraccoon,tichondrius,864,warrior,arms,18,9,9
46957,Oxia,quelthalas,864,warrior,arms,18,9,9
46958,Yamatoflash,tichondrius,864,warrior,arms,18,9,9
46959,Natating,terenas,864,warrior,arms,18,9,9
46960,Warwagon,the-underbog,864,warrior,arms,18,9,9
46961,Ârmstrong,quelthalas,864,warrior,arms,18,9,9
46962,Mlau,tichondrius,864,warrior,arms,18,9,9
46963,Dreamonn,illidan,864,warrior,arms,18,9,9
46964,Scoopdog,stormrage,864,warrior,arms,18,9,9
46965,Hateuu,tichondrius,864,warrior,arms,18,9,9
46966,Undeadbones,firetree,864,warrior,arms,18,9,9
46967,Faronstompz,sargeras,864,warrior,arms,18,9,9
46968,Stÿgian,blood-furnace,864,warrior,arms,18,9,9
46969,Golodiso,mugthol,864,warrior,arms,18,9,9
46970,Herey,moon-guard,864,warrior,arms,18,9,9
46971,Dreadtøøth,tichondrius,864,warrior,arms,24,9,15
46972,Sejac,moon-guard,864,warrior,arms,24,9,15
46973,Pretending,dalaran,864,warrior,arms,24,9,15
46974,Warrmoose,tichondrius,864,warrior,arms,24,9,15
46975,Feiler,ragnaros,864,warrior,arms,24,9,15
46976,Sabotender,suramar,864,warrior,arms,24,9,15
46977,Furyslam,tichondrius,864,warrior,arms,24,9,15
46978,Dustywx,area-52,864,warrior,arms,24,9,15
46979,Eensy,sargeras,864,warrior,arms,24,9,15
46980,Durist,tichondrius,864,warrior,arms,30,9,21
46981,Hiness,tichondrius,864,warrior,arms,30,9,21
46982,Boardslide,proudmoore,864,warrior,arms,30,9,21
46983,Eggheadorc,area-52,863,warrior,arms,12,9,3
46984,Grehk,sargeras,863,warrior,arms,12,9,3
46985,Tinymooie,frostmourne,863,warrior,arms,12,9,3
46986,Bowlingball,darkspear,863,warrior,arms,18,9,9
46987,Fulreck,tichondrius,863,warrior,arms,18,9,9
46988,Chrom,illidan,863,warrior,arms,18,9,9
46989,Tâte,sargeras,863,warrior,arms,18,9,9
46990,Suntore,malganis,863,warrior,arms,18,9,9
46991,Illicitkillz,destromath,863,warrior,arms,18,9,9
46992,Zaynafein,emerald-dream,863,warrior,arms,18,9,9
46993,Trén,hydraxis,863,warrior,arms,18,9,9
46994,Terneitor,ragnaros,863,warrior,arms,18,9,9
46995,Shino,garona,863,warrior,arms,18,9,9
46996,Theseuse,tichondrius,863,warrior,arms,18,9,9
46997,Nosoraki,thrall,863,warrior,arms,18,9,9
46998,Erdnase,ragnaros,863,warrior,arms,18,9,9
46999,Bladeblade,burning-blade,863,warrior,arms,21,9,12
47000,Spincycle,khadgar,863,warrior,arms,21,9,12
47001,Touhen,illidan,863,warrior,arms,24,9,15
47002,Flexid,tichondrius,863,warrior,arms,24,9,15
47003,Wrecktang,tichondrius,863,warrior,arms,24,9,15
47004,Ðirtyboy,tichondrius,863,warrior,arms,24,9,15
47005,Notoxzy,tichondrius,863,warrior,arms,24,9,15
47006,Abidis,tichondrius,863,warrior,arms,30,9,21
47007,Warwslayer,tichondrius,863,warrior,arms,30,9,21
47008,Xumæ,akama,863,warrior,arms,30,9,21
47009,Kilrok,thunderlord,863,warrior,arms,30,9,21
47010,Nyuk,tichondrius,862,warrior,arms,15,9,6
47011,Tallix,smolderthorn,862,warrior,arms,18,9,9
47012,Izârâk,frostmourne,862,warrior,arms,18,9,9
47013,Cogsbixby,aerie-peak,862,warrior,arms,18,9,9
47014,Um,moon-guard,862,warrior,arms,18,9,9
47015,Linga,bleeding-hollow,862,warrior,arms,18,9,9
47016,Xargosh,magtheridon,862,warrior,arms,18,9,9
47017,Hazew,kelthuzad,862,warrior,arms,18,9,9
47018,Thezboy,tichondrius,862,warrior,arms,18,9,9
47019,Wargorin,bleeding-hollow,862,warrior,arms,18,9,9
47020,Wárriór,tichondrius,862,warrior,arms,24,9,15
47021,Xurc,gnomeregan,862,warrior,arms,24,9,15
47022,Lögän,azralon,862,warrior,arms,24,9,15
47023,Balakay,drenden,861,warrior,arms,12,9,3
47024,Jodoro,malfurion,861,warrior,arms,18,9,9
47025,Gunnaoffxans,sargeras,860,warrior,arms,18,9,9
47026,Durtmcsmash,stormrage,860,warrior,arms,18,9,9
47027,Stormit,illidan,860,warrior,arms,19,9,10
47028,Marnan,quelthalas,860,warrior,arms,24,9,15
47029,Umogarmac,draktharon,860,warrior,arms,24,9,15
47030,Layllassa,moon-guard,860,warrior,arms,24,9,15
47031,Nishtana,quelthalas,859,warrior,arms,18,9,9
47032,Vio,mannoroth,859,warrior,arms,18,9,9
47033,Ñors,spinebreaker,859,warrior,arms,24,9,15
47034,Åres,wyrmrest-accord,858,warrior,arms,18,9,9
47035,Féril,ragnaros,858,warrior,arms,18,9,9
47036,Tolette,quelthalas,858,warrior,arms,18,9,9
47037,Rickyxp,aggramar,858,warrior,arms,19,9,10
47038,Tinyguysmall,eredar,857,warrior,arms,22,11,11
47039,Arthknight,ragnaros,857,warrior,arms,18,9,9
47040,Kaimana,zuljin,857,warrior,arms,18,9,9
47041,Baroque,darkspear,857,warrior,arms,18,9,9
47042,Gahii,barthilas,857,warrior,arms,18,9,9
47043,Joshums,warsong,857,warrior,arms,26,10,16
47044,Karusuke,stormrage,857,warrior,arms,24,9,15
47045,Lilsweet,moon-guard,856,warrior,arms,12,9,3
47046,Éllenor,azralon,856,warrior,arms,18,9,9
47047,Sparkye,gallywix,856,warrior,arms,18,9,9
47048,Eorik,stormrage,856,warrior,arms,36,9,27
47049,Daytime,scilla,855,warrior,arms,18,9,9
47050,Coldsnaps,azjolnerub,855,warrior,arms,18,9,9
47051,Preschool,sargeras,854,warrior,arms,12,9,3
47052,Wândêrer,wyrmrest-accord,854,warrior,arms,18,9,9
47053,Garusok,thrall,853,warrior,arms,12,9,3
47054,Asiyurekhans,borean-tundra,851,warrior,arms,12,9,3
47055,Moosebeef,garrosh,851,warrior,arms,31,12,19
47056,Jaimey,malganis,845,warrior,arms,23,9,14
47057,Rainiki,stormrage,845,warrior,arms,24,9,15
47058,Whiteclouds,blood-furnace,844,warrior,arms,42,17,25
47059,Macdollibee,barthilas,834,warrior,arms,18,9,9
47060,Soulcalibur,zuljin,830,warrior,arms,23,9,14
47061,Brrzrrkrr,twisting-nether,827,warrior,arms,18,9,9
47062,Seniorsherk,dalaran,827,warrior,arms,18,9,9
47063,Xwoyer,malganis,825,warrior,arms,22,11,11
47064,Eskama,hyjal,823,warrior,arms,23,9,14
47065,Hjoz,illidan,822,warrior,arms,16,9,7
47066,Dupaminichav,stormrage,814,warrior,arms,15,9,6
47067,Bargorengar,skullcrusher,814,warrior,arms,78,34,44
47068,Amberlym,ragnaros,814,warrior,arms,23,9,14
47069,Khâi,tichondrius,811,warrior,arms,27,9,18
47070,Scran,sargeras,809,warrior,arms,21,10,11
47071,Paí,nemesis,808,warrior,arms,17,9,8
47072,Fraccx,area-52,800,warrior,arms,22,9,13
47073,Rahj,saurfang,799,warrior,arms,20,9,11
47074,Gigazug,stormrage,799,warrior,arms,20,9,11
47075,Fatmân,tichondrius,798,warrior,arms,22,9,13
47076,Murrdock,nesingwary,794,warrior,arms,14,9,5
47077,Ripstorm,emerald-dream,794,warrior,arms,20,9,11
47078,Vandalizer,sargeras,788,warrior,arms,20,10,10
47079,Klingensturm,thrall,784,warrior,arms,13,9,4
47080,Joecules,kelthuzad,783,warrior,arms,17,9,8
47081,Patékphilípe,area-52,768,warrior,arms,12,8,4
47082,Chestbrook,icecrown,768,warrior,arms,12,8,4
47083,Smallbrainx,tichondrius,768,warrior,arms,12,8,4
47084,Traglos,ragnaros,768,warrior,arms,12,8,4
47085,Dadslapper,illidan,768,warrior,arms,12,8,4
47086,Príde,kiljaeden,768,warrior,arms,12,8,4
47087,Åthos,illidan,768,warrior,arms,12,8,4
47088,Piimpmaster,malganis,768,warrior,arms,12,8,4
47089,Grüumsh,drenden,768,warrior,arms,12,8,4
47090,Zdokk,sargeras,768,warrior,arms,12,8,4
47091,Sweeped,darkspear,768,warrior,arms,12,8,4
47092,Gladìus,area-52,768,warrior,arms,12,8,4
47093,Spinspin,borean-tundra,768,warrior,arms,12,8,4
47094,Executiepie,hyjal,768,warrior,arms,12,8,4
47095,Msallsunday,nerzhul,768,warrior,arms,12,8,4
47096,Slvrback,stormrage,768,warrior,arms,12,8,4
47097,Huangatang,wyrmrest-accord,768,warrior,arms,12,8,4
47098,Zleam,area-52,768,warrior,arms,12,8,4
47099,Thornhardt,frostmourne,768,warrior,arms,12,8,4
47100,Gabv,shadowmoon,768,warrior,arms,12,8,4
47101,Saucebussin,emerald-dream,768,warrior,arms,12,8,4
47102,Imakeupuddin,turalyon,768,warrior,arms,12,8,4
47103,Stoneball,kiljaeden,768,warrior,arms,18,8,10
47104,Chronek,sargeras,768,warrior,arms,18,8,10
47105,Ricksanches,shadowmoon,768,warrior,arms,18,8,10
47106,Orangesoda,tichondrius,768,warrior,arms,18,8,10
47107,Elkz,tichondrius,768,warrior,arms,18,8,10
47108,Elky,area-52,768,warrior,arms,18,8,10
47109,Cuddlechamp,barthilas,768,warrior,arms,18,8,10
47110,Onecho,tichondrius,768,warrior,arms,18,8,10
47111,Elitistx,bleeding-hollow,768,warrior,arms,18,8,10
47112,Ogre,magtheridon,768,warrior,arms,18,8,10
47113,Dtitanzz,quelthalas,768,warrior,arms,18,8,10
47114,Gízzmo,tichondrius,768,warrior,arms,18,8,10
47115,Supermieo,illidan,768,warrior,arms,18,8,10
47116,Imuti,illidan,768,warrior,arms,18,8,10
47117,Rahj,caelestrasz,768,warrior,arms,18,8,10
47118,Easylel,stormrage,768,warrior,arms,18,8,10
47119,Tuggernaut,khadgar,768,warrior,arms,18,8,10
47120,Toxxel,wyrmrest-accord,768,warrior,arms,18,8,10
47121,Tádakatsu,sargeras,768,warrior,arms,18,8,10
47122,Leunitas,shadow-council,768,warrior,arms,18,8,10
47123,Soultarius,sargeras,768,warrior,arms,21,9,12
47124,Dirkdallas,tichondrius,768,warrior,arms,24,8,16
47125,Warhji,malganis,768,warrior,arms,24,8,16
47126,Bornne,doomhammer,768,warrior,arms,30,8,22
47127,Letsgosmokes,stormrage,767,warrior,arms,12,8,4
47128,Executefreak,illidan,767,warrior,arms,12,8,4
47129,Pigblind,azralon,767,warrior,arms,12,8,4
47130,Alucardio,turalyon,767,warrior,arms,12,8,4
47131,Rúz,illidan,767,warrior,arms,12,8,4
47132,Rushee,argent-dawn,767,warrior,arms,12,8,4
47133,Nãrax,area-52,767,warrior,arms,12,8,4
47134,Domminux,darkspear,767,warrior,arms,12,8,4
47135,Blazingguard,stormrage,767,warrior,arms,12,8,4
47136,Skizoid,kiljaeden,767,warrior,arms,12,8,4
47137,Warwagon,malganis,767,warrior,arms,12,8,4
47138,Silac,drenden,767,warrior,arms,12,8,4
47139,Angrybulky,illidan,767,warrior,arms,12,8,4
47140,Wantor,lightnings-blade,767,warrior,arms,12,8,4
47141,Gränd,frostmourne,767,warrior,arms,12,8,4
47142,Kàkarot,illidan,767,warrior,arms,12,8,4
47143,Kixxel,sargeras,767,warrior,arms,12,8,4
47144,Itskinggrizz,thrall,767,warrior,arms,16,9,7
47145,Zédelívery,azralon,767,warrior,arms,16,9,7
47146,Empriux,quelthalas,767,warrior,arms,18,8,10
47147,Moarbrainz,mannoroth,767,warrior,arms,18,8,10
47148,Pípe,nemesis,767,warrior,arms,18,8,10
47149,Karín,tichondrius,767,warrior,arms,18,8,10
47150,Execute,kirin-tor,767,warrior,arms,18,8,10
47151,Ihazlolstorm,area-52,767,warrior,arms,18,8,10
47152,Zxlor,tichondrius,767,warrior,arms,18,8,10
47153,Drusillaa,deathwing,767,warrior,arms,18,8,10
47154,Dalinare,area-52,767,warrior,arms,18,8,10
47155,Æwarrìor,tichondrius,767,warrior,arms,18,8,10
47156,Cevadix,azralon,767,warrior,arms,18,8,10
47157,Nogèt,frostmourne,767,warrior,arms,18,8,10
47158,Nanor,zuljin,767,warrior,arms,18,8,10
47159,Himurinha,nemesis,767,warrior,arms,18,8,10
47160,Steelfist,grizzly-hills,767,warrior,arms,18,8,10
47161,Calthi,moon-guard,767,warrior,arms,18,8,10
47162,Onionion,stormrage,767,warrior,arms,18,8,10
47163,Orgreshin,area-52,767,warrior,arms,21,9,12
47164,Báhamut,area-52,767,warrior,arms,20,8,12
47165,Brawnforce,shadowsong,767,warrior,arms,24,8,16
47166,Techanina,aerie-peak,767,warrior,arms,24,8,16
47167,Essofeit,frostmourne,767,warrior,arms,24,8,16
47168,Krakitus,azralon,767,warrior,arms,24,8,16
47169,Cajual,area-52,767,warrior,arms,24,8,16
47170,Warriorc,laughing-skull,766,warrior,arms,12,8,4
47171,Ragarok,jubeithos,766,warrior,arms,12,8,4
47172,Horvv,frostmourne,766,warrior,arms,12,8,4
47173,Diãbel,azralon,766,warrior,arms,12,8,4
47174,Jackhanma,kelthuzad,766,warrior,arms,12,8,4
47175,Zhasi,bonechewer,766,warrior,arms,12,8,4
47176,Khrull,khazgoroth,766,warrior,arms,12,8,4
47177,Donnacha,garona,766,warrior,arms,18,8,10
47178,Edalthor,quelthalas,766,warrior,arms,18,8,10
47179,Hemmyroidz,tichondrius,766,warrior,arms,18,8,10
47180,Lobsterrj,emerald-dream,766,warrior,arms,18,8,10
47181,Truecarnage,emerald-dream,766,warrior,arms,18,8,10
47182,Sálieri,ragnaros,766,warrior,arms,18,8,10
47183,Çleåvage,stormrage,766,warrior,arms,18,8,10
47184,Syllana,sargeras,766,warrior,arms,18,8,10
47185,Rezzett,wyrmrest-accord,766,warrior,arms,21,9,12
47186,Aziz,kiljaeden,766,warrior,arms,19,8,11
47187,Violençe,malganis,766,warrior,arms,24,8,16
47188,Modzilla,aerie-peak,766,warrior,arms,30,8,22
47189,Odrak,ragnaros,766,warrior,arms,30,8,22
47190,Belladeom,azralon,765,warrior,arms,18,8,10
47191,Ligerii,quelthalas,765,warrior,arms,18,8,10
47192,Ulfioff,whisperwind,765,warrior,arms,18,8,10
47193,Percthirty,blackrock,765,warrior,arms,18,8,10
47194,Loktarrogar,illidan,765,warrior,arms,24,8,16
47195,Maxprotein,area-52,764,warrior,arms,14,8,6
47196,Pangean,sargeras,764,warrior,arms,18,8,10
47197,Alexarchos,chogall,764,warrior,arms,18,8,10
47198,Xarlon,stormrage,764,warrior,arms,18,8,10
47199,Plssaveme,ysera,764,warrior,arms,24,8,16
47200,Enthria,illidan,763,warrior,arms,12,8,4
47201,Stalecrouton,doomhammer,763,warrior,arms,12,8,4
47202,Märx,barthilas,763,warrior,arms,18,8,10
47203,Baghatur,tichondrius,763,warrior,arms,18,8,10
47204,Friends,azjolnerub,763,warrior,arms,18,8,10
47205,Sygw,area-52,763,warrior,arms,24,8,16
47206,Tarmer,moon-guard,762,warrior,arms,18,8,10
47207,Buffalobob,bronzebeard,762,warrior,arms,18,8,10
47208,Sweetdeé,zuljin,762,warrior,arms,18,8,10
47209,Revenn,greymane,761,warrior,arms,12,8,4
47210,Asarg,emerald-dream,761,warrior,arms,12,8,4
47211,Vynfull,area-52,760,warrior,arms,18,8,10
47212,Lumilis,draenor,760,warrior,arms,18,8,10
47213,Padalouh,kelthuzad,760,warrior,arms,24,8,16
47214,Rágnárr,ragnaros,759,warrior,arms,18,8,10
47215,Rafaelwar,drakkari,758,warrior,arms,18,8,10
47216,Badazzdad,thunderhorn,757,warrior,arms,18,8,10
47217,Clortho,korialstrasz,756,warrior,arms,27,9,18
47218,Trapwar,malganis,755,warrior,arms,12,8,4
47219,Bilmuuri,illidan,754,warrior,arms,27,9,18
47220,Fleshtuxedo,stormrage,752,warrior,arms,12,8,4
47221,Gladiattor,tol-barad,749,warrior,arms,18,8,10
47222,Ironwarr,hyjal,740,warrior,arms,23,8,15
47223,Vetinari,nazjatar,735,warrior,arms,11,8,3
47224,Outo,stormrage,735,warrior,arms,17,8,9
47225,Lòvex,alterac-mountains,735,warrior,arms,18,8,10
47226,Thistleberry,aegwynn,735,warrior,arms,23,8,15
47227,Casmier,tichondrius,734,warrior,arms,17,8,9
47228,Gorakis,barthilas,733,warrior,arms,20,9,11
47229,Señor,barthilas,719,warrior,arms,15,8,7
47230,Mêlo,area-52,719,warrior,arms,17,8,9
47231,Kzw,illidan,719,warrior,arms,17,8,9
47232,Layoon,azralon,718,warrior,arms,17,8,9
47233,Wreckthis,area-52,718,warrior,arms,17,8,9
47234,Alemão,bleeding-hollow,713,warrior,arms,23,9,14
47235,Jurojin,tichondrius,703,warrior,arms,11,8,3
47236,Ketaqt,illidan,702,warrior,arms,14,8,6
47237,Tabadigbick,bleeding-hollow,698,warrior,arms,17,8,9
47238,Olgran,drakkari,697,warrior,arms,28,8,20
47239,Lishajr,malganis,687,warrior,arms,14,8,6
47240,Psyrush,area-52,687,warrior,arms,19,8,11
47241,Greenbrain,dunemaul,685,warrior,arms,19,8,11
47242,Wreckerr,area-52,680,warrior,arms,20,10,10
47243,Vids,aegwynn,672,warrior,arms,12,7,5
47244,Bean,ragnaros,672,warrior,arms,12,7,5
47245,Tkavalan,proudmoore,672,warrior,arms,12,7,5
47246,Heojae,tichondrius,672,warrior,arms,12,7,5
47247,Drashka,ragnaros,672,warrior,arms,12,7,5
47248,Madmartiggan,tichondrius,672,warrior,arms,12,7,5
47249,Jaysmom,tichondrius,672,warrior,arms,12,7,5
47250,Zekkenx,azjolnerub,672,warrior,arms,12,7,5
47251,Ryalaeth,moon-guard,672,warrior,arms,12,7,5
47252,Rage,uther,672,warrior,arms,12,7,5
47253,Kevy,arygos,672,warrior,arms,12,7,5
47254,Reichbeast,area-52,672,warrior,arms,12,7,5
47255,Xdoombringer,area-52,672,warrior,arms,12,7,5
47256,Salthouse,sargeras,672,warrior,arms,12,7,5
47257,Jesbar,ragnaros,672,warrior,arms,12,7,5
47258,Slaughtér,tichondrius,672,warrior,arms,12,7,5
47259,Solocon,tichondrius,672,warrior,arms,12,7,5
47260,Papazugs,kelthuzad,672,warrior,arms,12,7,5
47261,Toungy,kelthuzad,672,warrior,arms,12,7,5
47262,Havocsmash,tichondrius,672,warrior,arms,12,7,5
47263,Okayge,proudmoore,672,warrior,arms,12,7,5
47264,Mõgorrin,area-52,672,warrior,arms,12,7,5
47265,Yrz,malganis,672,warrior,arms,12,7,5
47266,Baye,kargath,672,warrior,arms,12,7,5
47267,Magnusz,zuljin,672,warrior,arms,12,7,5
47268,Madamemarie,stormrage,672,warrior,arms,12,7,5
47269,Dehumanized,greymane,672,warrior,arms,12,7,5
47270,Püsspeepers,kelthuzad,672,warrior,arms,12,7,5
47271,Roiboy,stormrage,672,warrior,arms,12,7,5
47272,Jahrakál,thunderlord,672,warrior,arms,12,7,5
47273,Furìous,stormrage,672,warrior,arms,12,7,5
47274,Arsis,whisperwind,672,warrior,arms,12,7,5
47275,Jypster,stormrage,672,warrior,arms,12,7,5
47276,Bloodshêdz,stormrage,672,warrior,arms,12,7,5
47277,Turtleofhope,barthilas,672,warrior,arms,12,7,5
47278,Deathammer,stormrage,672,warrior,arms,12,7,5
47279,Petuniä,zuljin,672,warrior,arms,12,7,5
47280,Cugij,frostmourne,672,warrior,arms,12,7,5
47281,Ousetadoidao,nemesis,672,warrior,arms,12,7,5
47282,Studdythejet,zuljin,672,warrior,arms,12,7,5
47283,Giv,frostmourne,672,warrior,arms,12,7,5
47284,Grounyl,azralon,672,warrior,arms,12,7,5
47285,Gbrz,stormrage,672,warrior,arms,12,7,5
47286,Vxjohnson,proudmoore,672,warrior,arms,15,8,7
47287,Soyu,tichondrius,672,warrior,arms,16,8,8
47288,Imyourdaddy,chogall,672,warrior,arms,16,8,8
47289,Kappiz,wyrmrest-accord,672,warrior,arms,14,7,7
47290,Yamzprime,stormrage,672,warrior,arms,18,7,11
47291,Ryänlord,mugthol,672,warrior,arms,18,7,11
47292,Käggai,khadgar,672,warrior,arms,18,7,11
47293,Gizzmo,bonechewer,672,warrior,arms,18,7,11
47294,Raxek,stormrage,672,warrior,arms,18,7,11
47295,Thètrùth,duskwood,672,warrior,arms,18,7,11
47296,Ivory,emerald-dream,672,warrior,arms,18,7,11
47297,Sayjaki,stormrage,672,warrior,arms,18,7,11
47298,Rraw,demon-soul,672,warrior,arms,18,7,11
47299,Jamajuicedx,thrall,672,warrior,arms,18,7,11
47300,Ignorebrain,tichondrius,672,warrior,arms,18,7,11
47301,Tbagg,area-52,672,warrior,arms,18,7,11
47302,Tasilia,tichondrius,672,warrior,arms,18,7,11
47303,Goyqqw,illidan,672,warrior,arms,18,7,11
47304,Zerosends,kelthuzad,672,warrior,arms,18,7,11
47305,Infâmous,proudmoore,672,warrior,arms,18,7,11
47306,July,arthas,672,warrior,arms,18,7,11
47307,Hazelbean,tichondrius,672,warrior,arms,18,7,11
47308,Organge,zuljin,672,warrior,arms,18,7,11
47309,Corevp,barthilas,672,warrior,arms,24,7,17
47310,Festerclaws,wyrmrest-accord,672,warrior,arms,24,7,17
47311,Pokeyobutt,hydraxis,672,warrior,arms,24,7,17
47312,Tigima,tichondrius,672,warrior,arms,24,7,17
47313,Baciless,illidan,672,warrior,arms,24,7,17
47314,Omlas,azralon,672,warrior,arms,24,7,17
47315,Swàgnáros,area-52,671,warrior,arms,12,7,5
47316,Furiousangel,area-52,671,warrior,arms,12,7,5
47317,Blazie,barthilas,671,warrior,arms,12,7,5
47318,Glizzarms,dalaran,671,warrior,arms,12,7,5
47319,Jedeva,stormrage,671,warrior,arms,12,7,5
47320,Exceldoc,frostwolf,671,warrior,arms,12,7,5
47321,Dêsêcratê,frostmourne,671,warrior,arms,12,7,5
47322,Vijit,stormrage,671,warrior,arms,12,7,5
47323,Rhuktar,azralon,671,warrior,arms,12,7,5
47324,Dunkindots,tichondrius,671,warrior,arms,12,7,5
47325,Shrikewing,moon-guard,671,warrior,arms,12,7,5
47326,Pipeman,blackhand,671,warrior,arms,12,7,5
47327,Nehpets,akama,671,warrior,arms,12,7,5
47328,Vodkalol,bleeding-hollow,671,warrior,arms,12,7,5
47329,Crnogorac,hakkar,671,warrior,arms,12,7,5
47330,Maddzspin,tichondrius,671,warrior,arms,12,7,5
47331,Ramborco,kelthuzad,671,warrior,arms,12,7,5
47332,Gunnëy,malganis,671,warrior,arms,12,7,5
47333,Saero,ragnaros,671,warrior,arms,12,7,5
47334,Sneakyhand,draktharon,671,warrior,arms,12,7,5
47335,Girthstick,eredar,671,warrior,arms,12,7,5
47336,Qtrpndwcheez,area-52,671,warrior,arms,12,7,5
47337,Orthopedic,tichondrius,671,warrior,arms,12,7,5
47338,Riffralph,quelthalas,671,warrior,arms,12,7,5
47339,Menestz,dreadmaul,671,warrior,arms,17,9,8
47340,Mirandakerrx,frostmourne,671,warrior,arms,18,7,11
47341,Timbajimba,silvermoon,671,warrior,arms,18,7,11
47342,Tsurik,malfurion,671,warrior,arms,18,7,11
47343,Andrexion,moon-guard,671,warrior,arms,18,7,11
47344,Ironhide,malorne,671,warrior,arms,18,7,11
47345,Paratech,thrall,671,warrior,arms,18,7,11
47346,Stepzugger,illidan,671,warrior,arms,18,7,11
47347,Nosferagc,frostmourne,671,warrior,arms,18,7,11
47348,Elíte,kelthuzad,671,warrior,arms,18,7,11
47349,Colnar,stormrage,671,warrior,arms,18,7,11
47350,Layøut,azralon,671,warrior,arms,18,7,11
47351,Bröstörm,bonechewer,671,warrior,arms,18,7,11
47352,Kasheeka,spirestone,671,warrior,arms,18,7,11
47353,Chumbinhu,stormrage,671,warrior,arms,18,7,11
47354,Pharan,malganis,671,warrior,arms,18,7,11
47355,Pneumasmash,tichondrius,671,warrior,arms,18,7,11
47356,Brøxigár,quelthalas,671,warrior,arms,18,7,11
47357,Grazellor,khaz-modan,671,warrior,arms,18,7,11
47358,Xeniwar,tichondrius,671,warrior,arms,20,7,13
47359,Tasërface,hakkar,671,warrior,arms,24,7,17
47360,Winso,blood-furnace,671,warrior,arms,24,7,17
47361,Powerjaw,stormrage,671,warrior,arms,24,7,17
47362,Vandammage,cenarion-circle,671,warrior,arms,24,7,17
47363,Babyreap,frostmourne,670,warrior,arms,12,7,5
47364,Eniaan,khaz-modan,670,warrior,arms,12,7,5
47365,Chacca,suramar,670,warrior,arms,12,7,5
47366,Svantevit,tichondrius,670,warrior,arms,12,7,5
47367,Draggo,tortheldrin,670,warrior,arms,12,7,5
47368,Nraged,illidan,670,warrior,arms,12,7,5
47369,Dizzygal,hyjal,670,warrior,arms,18,7,11
47370,Notakîd,stormrage,670,warrior,arms,18,7,11
47371,Gìraffe,illidan,670,warrior,arms,18,7,11
47372,Reidahn,zuljin,670,warrior,arms,24,7,17
47373,Torage,wyrmrest-accord,669,warrior,arms,12,7,5
47374,Astrokreep,emerald-dream,669,warrior,arms,12,7,5
47375,Harnor,garrosh,669,warrior,arms,18,7,11
47376,Rollz,amanthul,669,warrior,arms,24,7,17
47377,Teyliemond,amanthul,668,warrior,arms,12,7,5
47378,Pandamoanman,moon-guard,668,warrior,arms,18,7,11
47379,Hoshigaki,frostmourne,668,warrior,arms,18,7,11
47380,Grokash,azralon,668,warrior,arms,18,7,11
47381,Yerajmiel,proudmoore,667,warrior,arms,12,7,5
47382,Yanïka,barthilas,667,warrior,arms,13,7,6
47383,Aistine,alterac-mountains,667,warrior,arms,18,7,11
47384,Moøster,aggramar,667,warrior,arms,18,7,11
47385,Rogkhan,tichondrius,667,warrior,arms,18,7,11
47386,Kevasaurr,sargeras,667,warrior,arms,24,7,17
47387,Borgee,tichondrius,666,warrior,arms,18,7,11
47388,Terribletom,stormrage,665,warrior,arms,18,7,11
47389,Nepharia,kirin-tor,664,warrior,arms,18,7,11
47390,Tanatos,the-venture-co,664,warrior,arms,24,7,17
47391,Jötunn,dalaran,663,warrior,arms,12,7,5
47392,Lilwarrior,blackrock,661,warrior,arms,12,7,5
47393,Dierdris,gnomeregan,659,warrior,arms,13,7,6
47394,Ruick,wyrmrest-accord,658,warrior,arms,12,7,5
47395,Parmizan,hydraxis,639,warrior,arms,16,7,9
47396,Agnesis,quelthalas,639,warrior,arms,16,7,9
47397,Phoveros,sargeras,639,warrior,arms,17,7,10
47398,Moostorm,darkspear,639,warrior,arms,17,7,10
47399,Fewfingers,sargeras,638,warrior,arms,16,7,9
47400,Punnisher,nerzhul,638,warrior,arms,17,7,10
47401,Twinxin,thrall,637,warrior,arms,17,7,10
47402,Jrodrick,nemesis,624,warrior,arms,21,8,13
47403,Rexxous,hyjal,624,warrior,arms,21,7,14
47404,Loudpee,tichondrius,623,warrior,arms,11,7,4
47405,Allenwalker,dreadmaul,623,warrior,arms,13,7,6
47406,Fidel,blackrock,623,warrior,arms,23,7,16
47407,Ogpapabear,stormscale,623,warrior,arms,33,7,26
47408,Bigboycandy,malganis,621,warrior,arms,11,7,4
47409,Xunaco,quelthalas,620,warrior,arms,26,7,19
47410,Xandrak,barthilas,618,warrior,arms,11,7,4
47411,Ålbedo,malganis,616,warrior,arms,23,8,15
47412,Bruze,hellscream,607,warrior,arms,14,7,7
47413,Pkrage,hellscream,606,warrior,arms,11,7,4
47414,Bullkathoss,bleeding-hollow,605,warrior,arms,22,7,15
47415,Tyférious,tichondrius,602,warrior,arms,32,7,25
47416,Elpresador,dragonmaw,576,warrior,arms,6,6,0
47417,Baltusrol,hydraxis,576,warrior,arms,6,6,0
47418,Stoneshield,senjin,576,warrior,arms,6,6,0
47419,Dreadwarr,stormrage,576,warrior,arms,6,6,0
47420,Darkoil,illidan,576,warrior,arms,6,6,0
47421,Khalwar,ragnaros,576,warrior,arms,6,6,0
47422,Dóminus,malfurion,576,warrior,arms,6,6,0
47423,Iskandr,amanthul,576,warrior,arms,9,7,2
47424,Dypnos,ragnaros,576,warrior,arms,12,6,6
47425,Sodarzok,thaurissan,576,warrior,arms,12,6,6
47426,Reflective,zuljin,576,warrior,arms,12,6,6
47427,Dreamwarr,tichondrius,576,warrior,arms,12,6,6
47428,Cassetto,icecrown,576,warrior,arms,12,6,6
47429,Toegap,illidan,576,warrior,arms,12,6,6
47430,Ratherfull,ragnaros,576,warrior,arms,12,6,6
47431,Auxthas,tichondrius,576,warrior,arms,12,6,6
47432,Prìscìlla,stormrage,576,warrior,arms,12,6,6
47433,Novastormer,barthilas,576,warrior,arms,12,6,6
47434,Targramu,emerald-dream,576,warrior,arms,12,6,6
47435,Rargou,illidan,576,warrior,arms,12,6,6
47436,Sunderstruck,boulderfist,576,warrior,arms,12,6,6
47437,Bailu,ragnaros,576,warrior,arms,12,6,6
47438,Feedmetren,tichondrius,576,warrior,arms,12,6,6
47439,Musclecrowe,illidan,576,warrior,arms,12,6,6
47440,Blazight,dunemaul,576,warrior,arms,12,6,6
47441,Zzode,tichondrius,576,warrior,arms,12,6,6
47442,Raime,sargeras,576,warrior,arms,12,6,6
47443,Amortens,area-52,576,warrior,arms,12,6,6
47444,Mcflury,skullcrusher,576,warrior,arms,12,6,6
47445,Orkussw,illidan,576,warrior,arms,12,6,6
47446,Painremaìns,dunemaul,576,warrior,arms,12,6,6
47447,Rudakoff,ragnaros,576,warrior,arms,12,6,6
47448,Lotsay,tichondrius,576,warrior,arms,12,6,6
47449,Flanrych,illidan,576,warrior,arms,12,6,6
47450,Malvicious,proudmoore,576,warrior,arms,12,6,6
47451,Houdinix,stormrage,576,warrior,arms,12,6,6
47452,Hololeave,tichondrius,576,warrior,arms,12,6,6
47453,Zuans,azralon,576,warrior,arms,12,6,6
47454,Areiana,stormrage,576,warrior,arms,12,6,6
47455,Illmindofboo,tichondrius,576,warrior,arms,12,6,6
47456,Grughak,kiljaeden,576,warrior,arms,12,6,6
47457,Fatpoos,barthilas,576,warrior,arms,12,6,6
47458,Luckychaos,bleeding-hollow,576,warrior,arms,12,6,6
47459,Garysmalls,kelthuzad,576,warrior,arms,12,6,6
47460,Aliminar,zuluhed,576,warrior,arms,12,6,6
47461,Linjunfeng,tichondrius,576,warrior,arms,12,6,6
47462,Raahj,sargeras,576,warrior,arms,12,6,6
47463,Biorhn,area-52,576,warrior,arms,12,6,6
47464,Monkeystrike,barthilas,576,warrior,arms,12,6,6
47465,Bedman,tichondrius,576,warrior,arms,12,6,6
47466,Aladarith,moon-guard,576,warrior,arms,12,6,6
47467,Husyuzhi,tichondrius,576,warrior,arms,12,6,6
47468,Griftustle,moon-guard,576,warrior,arms,12,6,6
47469,Headsour,thunderhorn,576,warrior,arms,12,6,6
47470,Jerebeloz,proudmoore,576,warrior,arms,12,6,6
47471,Sigrik,moon-guard,576,warrior,arms,12,6,6
47472,Rembrand,blackhand,576,warrior,arms,12,6,6
47473,Roflcombo,illidan,576,warrior,arms,12,6,6
47474,Flidumpling,tichondrius,576,warrior,arms,12,6,6
47475,Warsongworg,tichondrius,576,warrior,arms,12,6,6
47476,Aùstin,moon-guard,576,warrior,arms,12,6,6
47477,Bamlin,sargeras,576,warrior,arms,12,6,6
47478,Stÿgían,kelthuzad,576,warrior,arms,12,6,6
47479,Gnomërcy,tichondrius,576,warrior,arms,12,6,6
47480,Breaker,undermine,576,warrior,arms,12,6,6
47481,Larrythelob,kelthuzad,576,warrior,arms,12,6,6
47482,Flèx,stormrage,576,warrior,arms,12,6,6
47483,Crusherr,earthen-ring,576,warrior,arms,12,6,6
47484,Azrailz,stormrage,576,warrior,arms,12,6,6
47485,Fraxxure,proudmoore,576,warrior,arms,12,6,6
47486,Vãryan,frostmourne,576,warrior,arms,12,6,6
47487,Arozay,illidan,576,warrior,arms,12,6,6
47488,Ragehir,thrall,576,warrior,arms,12,6,6
47489,Linios,tichondrius,576,warrior,arms,12,6,6
47490,Glourfindel,quelthalas,576,warrior,arms,12,6,6
47491,Rexquando,barthilas,576,warrior,arms,12,6,6
47492,Tàlent,thrall,576,warrior,arms,12,6,6
47493,Ankhxiety,sargeras,576,warrior,arms,12,6,6
47494,Horcules,kiljaeden,576,warrior,arms,12,6,6
47495,Hülkamanïa,sargeras,576,warrior,arms,12,6,6
47496,Geubsalx,tichondrius,576,warrior,arms,12,6,6
47497,Inkurushio,suramar,576,warrior,arms,12,6,6
47498,Kazabare,tichondrius,576,warrior,arms,12,6,6
47499,Armsofury,kelthuzad,576,warrior,arms,12,6,6
47500,Invinciblé,tichondrius,576,warrior,arms,12,6,6
47501,Luminiere,sargeras,576,warrior,arms,12,6,6
47502,Maleap,moon-guard,576,warrior,arms,12,6,6
47503,Gílly,borean-tundra,576,warrior,arms,12,6,6
47504,Gladdz,moon-guard,576,warrior,arms,12,6,6
47505,Bigdickgomez,frostmourne,576,warrior,arms,12,6,6
47506,Averagewar,frostwolf,576,warrior,arms,12,6,6
47507,Bonclay,nerzhul,576,warrior,arms,12,6,6
47508,Bagginses,quelthalas,576,warrior,arms,12,6,6
47509,Lacorte,ragnaros,576,warrior,arms,12,6,6
47510,Róngor,ragnaros,576,warrior,arms,12,6,6
47511,Fûry,barthilas,576,warrior,arms,12,6,6
47512,Trexxen,stormrage,576,warrior,arms,12,6,6
47513,Assamith,nemesis,576,warrior,arms,12,6,6
47514,Unwarmas,ragnaros,576,warrior,arms,12,6,6
47515,Marîn,stormrage,576,warrior,arms,12,6,6
47516,Atuey,area-52,576,warrior,arms,12,6,6
47517,Ganzism,tichondrius,576,warrior,arms,13,6,7
47518,Mercystaling,tichondrius,576,warrior,arms,18,6,12
47519,Robar,trollbane,576,warrior,arms,18,6,12
47520,Kennäy,azralon,576,warrior,arms,18,6,12
47521,Deathstrøke,illidan,576,warrior,arms,18,6,12
47522,Stormwald,sargeras,576,warrior,arms,18,6,12
47523,Natalieftm,tichondrius,576,warrior,arms,18,6,12
47524,Grimspin,tichondrius,576,warrior,arms,18,6,12
47525,Tonesman,tichondrius,576,warrior,arms,18,6,12
47526,Swìll,illidan,576,warrior,arms,18,6,12
47527,Egoist,malganis,576,warrior,arms,18,6,12
47528,Dankdad,garrosh,576,warrior,arms,18,6,12
47529,Ezgamelol,azralon,576,warrior,arms,18,6,12
47530,Májorrobot,area-52,576,warrior,arms,18,6,12
47531,Ooktanx,emerald-dream,576,warrior,arms,18,6,12
47532,Cowboybeast,tanaris,576,warrior,arms,18,6,12
47533,Psilly,sargeras,576,warrior,arms,18,6,12
47534,Nillor,emerald-dream,576,warrior,arms,18,6,12
47535,Eabywarrs,tichondrius,576,warrior,arms,18,6,12
47536,Hugz,thrall,576,warrior,arms,18,6,12
47537,Shöthetank,area-52,576,warrior,arms,18,6,12
47538,Xgraves,sargeras,576,warrior,arms,18,6,12
47539,Ronak,vashj,576,warrior,arms,18,6,12
47540,Sõnics,tichondrius,576,warrior,arms,18,6,12
47541,Geubsal,tichondrius,576,warrior,arms,18,6,12
47542,Morphexo,quelthalas,576,warrior,arms,18,6,12
47543,Pushh,thrall,576,warrior,arms,18,6,12
47544,Ahkimih,ragnaros,576,warrior,arms,18,6,12
47545,Cleavxy,sargeras,576,warrior,arms,18,6,12
47546,Mahoneslice,thrall,576,warrior,arms,18,6,12
47547,Lieofa,tichondrius,576,warrior,arms,19,6,13
47548,Contentious,moon-guard,576,warrior,arms,24,6,18
47549,Shîzu,moon-guard,576,warrior,arms,24,6,18
47550,Fenømenoide,ragnaros,575,warrior,arms,6,6,0
47551,Ragefested,tichondrius,575,warrior,arms,12,6,6
47552,Bkdorbandit,illidan,575,warrior,arms,12,6,6
47553,Teyrn,stormrage,575,warrior,arms,12,6,6
47554,Zhyper,frostmourne,575,warrior,arms,12,6,6
47555,Vioar,hyjal,575,warrior,arms,12,6,6
47556,Ereborh,ragnaros,575,warrior,arms,12,6,6
47557,Uragiri,shadowsong,575,warrior,arms,12,6,6
47558,Rongkhunxyz,tichondrius,575,warrior,arms,12,6,6
47559,Croton,moon-guard,575,warrior,arms,12,6,6
47560,Orryn,proudmoore,575,warrior,arms,12,6,6
47561,Pandatrue,azralon,575,warrior,arms,12,6,6
47562,Redneckk,emerald-dream,575,warrior,arms,12,6,6
47563,Theodere,moon-guard,575,warrior,arms,12,6,6
47564,Obstruktíon,tichondrius,575,warrior,arms,12,6,6
47565,Gimmiefood,emerald-dream,575,warrior,arms,12,6,6
47566,Nospace,tichondrius,575,warrior,arms,12,6,6
47567,Bolx,archimonde,575,warrior,arms,12,6,6
47568,Desul,tichondrius,575,warrior,arms,12,6,6
47569,Kurgos,quelthalas,575,warrior,arms,12,6,6
47570,Jujuassgeter,darkspear,575,warrior,arms,12,6,6
47571,Balthazãr,quelthalas,575,warrior,arms,12,6,6
47572,Weewarrior,wyrmrest-accord,575,warrior,arms,12,6,6
47573,Thornakh,stormrage,575,warrior,arms,12,6,6
47574,Maltrate,hyjal,575,warrior,arms,15,7,8
47575,Bärdock,ragnaros,575,warrior,arms,16,7,9
47576,Corthíus,stormrage,575,warrior,arms,16,7,9
47577,Gaydin,eldrethalas,575,warrior,arms,18,6,12
47578,Chadler,dragonmaw,575,warrior,arms,18,6,12
47579,Opalert,tichondrius,575,warrior,arms,18,6,12
47580,Slamchowdy,tichondrius,575,warrior,arms,18,6,12
47581,Babybiif,azralon,575,warrior,arms,24,6,18
47582,Sarget,ragnaros,574,warrior,arms,12,6,6
47583,Darkshrek,quelthalas,574,warrior,arms,12,6,6
47584,Kenroc,illidan,574,warrior,arms,12,6,6
47585,Nashallo,zuljin,574,warrior,arms,12,6,6
47586,Ådolf,sargeras,574,warrior,arms,15,7,8
47587,Masami,moon-guard,574,warrior,arms,18,6,12
47588,Newtommi,barthilas,574,warrior,arms,18,6,12
47589,Irgon,quelthalas,573,warrior,arms,12,6,6
47590,Môgwai,kelthuzad,573,warrior,arms,12,6,6
47591,Dúmp,stormrage,573,warrior,arms,12,6,6
47592,Cizzik,emerald-dream,573,warrior,arms,12,6,6
47593,Logohn,wyrmrest-accord,573,warrior,arms,12,6,6
47594,Gfree,kiljaeden,573,warrior,arms,21,7,14
47595,Brosèph,sargeras,573,warrior,arms,18,6,12
47596,Faóra,moon-guard,572,warrior,arms,12,6,6
47597,Azyxia,emerald-dream,572,warrior,arms,15,7,8
47598,Bitiatus,scilla,572,warrior,arms,18,6,12
47599,Tatsher,turalyon,571,warrior,arms,12,6,6
47600,Rudiblade,dalaran,571,warrior,arms,12,6,6
47601,Sezariùs,darkspear,559,warrior,arms,19,7,12
47602,Conchalover,illidan,559,warrior,arms,17,6,11
47603,Dadookibooty,area-52,552,warrior,arms,18,9,9
47604,Ecopolis,azshara,544,warrior,arms,16,6,10
47605,Ballzindeep,tichondrius,543,warrior,arms,8,7,1
47606,Tâlos,ysondre,543,warrior,arms,11,6,5
47607,Tastyskeet,illidan,543,warrior,arms,11,6,5
47608,Uneasyw,tichondrius,543,warrior,arms,17,6,11
47609,Randywar,tichondrius,528,warrior,arms,15,6,9
47610,Vikkz,frostmourne,527,warrior,arms,11,6,5
47611,Luckybrother,tichondrius,527,warrior,arms,15,6,9
47612,Llewellenar,stormrage,527,warrior,arms,17,6,11
47613,Warwik,stormscale,527,warrior,arms,17,6,11
47614,Meadsweats,tichondrius,522,warrior,arms,17,10,7
47615,Bersérk,area-52,522,warrior,arms,14,8,6
47616,Tomcruz,bloodscalp,522,warrior,arms,16,7,9
47617,Hrókr,kiljaeden,522,warrior,arms,19,8,11
47618,Orz,sargeras,522,warrior,arms,25,7,18
47619,Rhok,elune,515,warrior,arms,16,9,7
47620,Illicitiri,sargeras,511,warrior,arms,10,6,4
47621,Psychosicko,tichondrius,511,warrior,arms,11,6,5
47622,Kvobash,area-52,511,warrior,arms,11,6,5
47623,Ohjim,stormrage,511,warrior,arms,14,6,8
47624,Jackjaeger,area-52,511,warrior,arms,16,6,10
47625,Berzerc,stormrage,511,warrior,arms,18,6,12
47626,Alzuga,quelthalas,511,warrior,arms,20,6,14
47627,Ruiend,bonechewer,510,warrior,arms,14,6,8
47628,Tyraelius,kiljaeden,510,warrior,arms,17,6,11
47629,Magarrior,shadowsong,495,warrior,arms,13,7,6
47630,Noreaga,tichondrius,480,warrior,arms,6,5,1
47631,Rickywarx,illidan,480,warrior,arms,6,5,1
47632,Bootypound,sargeras,480,warrior,arms,6,5,1
47633,Thombelina,malganis,480,warrior,arms,6,5,1
47634,Roadglide,korgath,480,warrior,arms,6,5,1
47635,Tâlos,magtheridon,480,warrior,arms,6,5,1
47636,Meatsweatx,stormrage,480,warrior,arms,6,5,1
47637,Drippyjones,sargeras,480,warrior,arms,6,5,1
47638,Gorva,emerald-dream,480,warrior,arms,6,5,1
47639,Dukagã,tichondrius,480,warrior,arms,6,5,1
47640,Madrak,greymane,480,warrior,arms,6,5,1
47641,Millywhopz,thrall,480,warrior,arms,6,5,1
47642,Xaenne,zuljin,480,warrior,arms,6,5,1
47643,Vanlur,khaz-modan,480,warrior,arms,6,5,1
47644,Houk,frostmourne,480,warrior,arms,6,5,1
47645,Flexecute,area-52,480,warrior,arms,6,5,1
47646,Cowstik,illidan,480,warrior,arms,6,5,1
47647,Violence,icecrown,480,warrior,arms,6,5,1
47648,Geàrbreaker,tichondrius,480,warrior,arms,6,5,1
47649,Noor,tichondrius,480,warrior,arms,6,5,1
47650,Biggesttoees,tichondrius,480,warrior,arms,6,5,1
47651,Jackox,sargeras,480,warrior,arms,6,5,1
47652,Billythunda,tichondrius,480,warrior,arms,6,5,1
47653,Saladin,gnomeregan,480,warrior,arms,6,5,1
47654,Armsupx,tichondrius,480,warrior,arms,6,5,1
47655,Kushian,tichondrius,480,warrior,arms,6,5,1
47656,Ryü,khaz-modan,480,warrior,arms,6,5,1
47657,Mongosyco,proudmoore,480,warrior,arms,6,5,1
47658,Tinymo,archimonde,480,warrior,arms,6,5,1
47659,Jarlaix,dragonmaw,480,warrior,arms,6,5,1
47660,Moè,frostmourne,480,warrior,arms,10,6,4
47661,Warpenguin,kelthuzad,480,warrior,arms,10,6,4
47662,Whittyxc,tichondrius,480,warrior,arms,9,5,4
47663,Dynamiite,bleeding-hollow,480,warrior,arms,12,5,7
47664,Huricas,arthas,480,warrior,arms,12,5,7
47665,Orcimonde,arthas,480,warrior,arms,12,5,7
47666,Ponygon,quelthalas,480,warrior,arms,12,5,7
47667,Thehóund,area-52,480,warrior,arms,12,5,7
47668,Drudw,moon-guard,480,warrior,arms,12,5,7
47669,Cuantascopas,ragnaros,480,warrior,arms,12,5,7
47670,Justicwar,area-52,480,warrior,arms,12,5,7
47671,Zerevik,stormrage,480,warrior,arms,12,5,7
47672,Kethsel,ragnaros,480,warrior,arms,12,5,7
47673,Taürok,azralon,480,warrior,arms,12,5,7
47674,Qwort,moon-guard,480,warrior,arms,12,5,7
47675,Felorelea,moon-guard,480,warrior,arms,12,5,7
47676,Meatspinner,sargeras,480,warrior,arms,12,5,7
47677,Crogosh,quelthalas,480,warrior,arms,12,5,7
47678,Kriegsheer,bleeding-hollow,480,warrior,arms,12,5,7
47679,Fracked,sargeras,480,warrior,arms,12,5,7
47680,Fayttful,area-52,480,warrior,arms,12,5,7
47681,Peters,malfurion,480,warrior,arms,12,5,7
47682,Originalpimp,bleeding-hollow,480,warrior,arms,12,5,7
47683,Quinntis,anvilmar,480,warrior,arms,12,5,7
47684,Biggiesmash,bleeding-hollow,480,warrior,arms,12,5,7
47685,Ericthegreat,azuremyst,480,warrior,arms,12,5,7
47686,Broxar,area-52,480,warrior,arms,12,5,7
47687,Toddlovesu,kelthuzad,480,warrior,arms,12,5,7
47688,Thaedes,kelthuzad,480,warrior,arms,12,5,7
47689,Kð,zuljin,480,warrior,arms,12,5,7
47690,Vãnth,kelthuzad,480,warrior,arms,12,5,7
47691,Kluster,kelthuzad,480,warrior,arms,12,5,7
47692,Beerstorm,stormrage,480,warrior,arms,12,5,7
47693,Metalbiff,bleeding-hollow,480,warrior,arms,12,5,7
47694,Mondëgo,stormrage,480,warrior,arms,12,5,7
47695,Baaltica,ragnaros,480,warrior,arms,12,5,7
47696,Crushingnews,sargeras,480,warrior,arms,12,5,7
47697,Etothed,stormrage,480,warrior,arms,12,5,7
47698,Coltronitis,kelthuzad,480,warrior,arms,12,5,7
47699,Gävilar,sargeras,480,warrior,arms,12,5,7
47700,Mustachelove,bleeding-hollow,480,warrior,arms,12,5,7
47701,Secsecute,moon-guard,480,warrior,arms,12,5,7
47702,Wonbin,moon-guard,480,warrior,arms,12,5,7
47703,Hemkcus,zuluhed,480,warrior,arms,12,5,7
47704,Dillý,area-52,480,warrior,arms,12,5,7
47705,Wcb,sargeras,480,warrior,arms,12,5,7
47706,Nipnipz,kelthuzad,480,warrior,arms,12,5,7
47707,Sylvanos,arthas,480,warrior,arms,12,5,7
47708,Tamajkaz,the-forgotten-coast,480,warrior,arms,12,5,7
47709,Thalfor,emerald-dream,480,warrior,arms,12,5,7
47710,Sideon,frostmourne,480,warrior,arms,12,5,7
47711,Manbok,tichondrius,480,warrior,arms,12,5,7
47712,Conviction,draka,480,warrior,arms,12,5,7
47713,Ccmeharder,kiljaeden,480,warrior,arms,12,5,7
47714,Loveføx,stormrage,480,warrior,arms,12,5,7
47715,Schoolbuhs,tichondrius,480,warrior,arms,12,5,7
47716,Gonzwold,drenden,480,warrior,arms,12,5,7
47717,Takenotez,sargeras,480,warrior,arms,12,5,7
47718,Sabers,mannoroth,480,warrior,arms,12,5,7
47719,Martydom,proudmoore,480,warrior,arms,12,5,7
47720,Buffwar,tichondrius,480,warrior,arms,12,5,7
47721,Excalibruh,frostmourne,480,warrior,arms,12,5,7
47722,Turlesoup,proudmoore,480,warrior,arms,12,5,7
47723,Boxxyy,tichondrius,480,warrior,arms,12,5,7
47724,Mayshowgunmo,tichondrius,480,warrior,arms,12,5,7
47725,Greyknights,kiljaeden,480,warrior,arms,12,5,7
47726,Bloodxfrenzy,silvermoon,480,warrior,arms,12,5,7
47727,Scozziee,barthilas,480,warrior,arms,12,5,7
47728,Astrálís,nemesis,480,warrior,arms,12,5,7
47729,Shapur,tichondrius,480,warrior,arms,12,5,7
47730,Arcâdio,cairne,480,warrior,arms,12,5,7
47731,Maniel,greymane,480,warrior,arms,12,5,7
47732,Lanlorash,barthilas,480,warrior,arms,12,5,7
47733,Azkaosa,tichondrius,480,warrior,arms,12,5,7
47734,Spirìt,illidan,480,warrior,arms,12,5,7
47735,Stattic,illidan,480,warrior,arms,12,5,7
47736,Angertooth,tichondrius,480,warrior,arms,12,5,7
47737,Madhouse,tanaris,480,warrior,arms,12,5,7
47738,Zewl,barthilas,480,warrior,arms,12,5,7
47739,Cabi,frostmourne,480,warrior,arms,12,5,7
47740,Flëët,tichondrius,480,warrior,arms,12,5,7
47741,Bariotyr,the-underbog,480,warrior,arms,12,5,7
47742,Huleo,tichondrius,480,warrior,arms,12,5,7
47743,Empyrius,exodar,480,warrior,arms,12,5,7
47744,Haowar,tichondrius,480,warrior,arms,12,5,7
47745,Shwip,tichondrius,480,warrior,arms,12,5,7
47746,Karik,proudmoore,480,warrior,arms,12,5,7
47747,Orcbum,kiljaeden,480,warrior,arms,12,5,7
47748,Slamoholic,turalyon,480,warrior,arms,12,5,7
47749,Dondà,illidan,480,warrior,arms,12,5,7
47750,Téry,dalaran,480,warrior,arms,12,5,7
47751,Kaikah,aegwynn,480,warrior,arms,12,5,7
47752,Clamjammed,thrall,480,warrior,arms,12,5,7
47753,Kàli,kiljaeden,480,warrior,arms,12,5,7
47754,Ahore,illidan,480,warrior,arms,12,5,7
47755,Antoníuz,drakkari,480,warrior,arms,12,5,7
47756,Lanco,kiljaeden,480,warrior,arms,12,5,7
47757,Igoon,dentarg,480,warrior,arms,12,5,7
47758,Zuiken,kiljaeden,480,warrior,arms,12,5,7
47759,Draenøk,tichondrius,480,warrior,arms,12,5,7
47760,Pandaxes,proudmoore,480,warrior,arms,12,5,7
47761,Brickhouse,tichondrius,480,warrior,arms,12,5,7
47762,Paulhëyman,sargeras,480,warrior,arms,12,5,7
47763,Slasherman,illidan,480,warrior,arms,12,5,7
47764,Shrëkslovaki,tichondrius,480,warrior,arms,12,5,7
47765,Gläedr,dalaran,480,warrior,arms,12,5,7
47766,Battosaì,bonechewer,480,warrior,arms,15,6,9
47767,Grandtank,veknilash,480,warrior,arms,15,6,9
47768,Mág,burning-legion,480,warrior,arms,13,5,8
47769,Siegfriéd,bleeding-hollow,480,warrior,arms,14,5,9
47770,Tigershárk,tichondrius,480,warrior,arms,16,5,11
47771,Imprw,stormrage,480,warrior,arms,18,5,13
47772,Goaco,drakkari,480,warrior,arms,18,5,13
47773,Golinn,aerie-peak,480,warrior,arms,18,5,13
47774,Kamigoroshi,crushridge,480,warrior,arms,18,5,13
47775,Osannd,tichondrius,480,warrior,arms,18,5,13
47776,Skyanidas,korgath,480,warrior,arms,18,5,13
47777,Huacai,tichondrius,480,warrior,arms,18,5,13
47778,Tsathoggua,kiljaeden,480,warrior,arms,18,5,13
47779,Kkuzo,bleeding-hollow,480,warrior,arms,18,5,13
47780,Øvrpwrd,frostmourne,480,warrior,arms,18,5,13
47781,Eightydeuce,bonechewer,480,warrior,arms,18,5,13
47782,Calto,tichondrius,480,warrior,arms,18,5,13
47783,Aldathion,argent-dawn,480,warrior,arms,18,5,13
47784,Shaynaynay,tichondrius,480,warrior,arms,18,5,13
47785,Cyllyzie,emerald-dream,480,warrior,arms,18,5,13
47786,Bornclueless,illidan,480,warrior,arms,21,5,16
47787,Thunderbash,thrall,480,warrior,arms,24,5,19
47788,Lorinzer,zuljin,480,warrior,arms,24,5,19
47789,Tanger,korgath,479,warrior,arms,6,5,1
47790,Rinngo,proudmoore,479,warrior,arms,6,5,1
47791,Faiken,quelthalas,479,warrior,arms,6,5,1
47792,Arrozkonlech,proudmoore,479,warrior,arms,10,6,4
47793,Celt,uldum,479,warrior,arms,12,5,7
47794,Maudlewis,bladefist,479,warrior,arms,12,5,7
47795,Qqmachine,tichondrius,479,warrior,arms,12,5,7
47796,Synestira,frostmourne,479,warrior,arms,12,5,7
47797,Sienge,tortheldrin,479,warrior,arms,12,5,7
47798,Têzeret,shadowmoon,479,warrior,arms,12,5,7
47799,Josiah,frostmourne,479,warrior,arms,12,5,7
47800,Spàcetìme,stormrage,479,warrior,arms,12,5,7
47801,Cueromodel,ragnaros,479,warrior,arms,12,5,7
47802,Loaksz,tichondrius,479,warrior,arms,12,5,7
47803,Alderr,frostmourne,479,warrior,arms,12,5,7
47804,Luneblade,tichondrius,479,warrior,arms,12,5,7
47805,Bovisrex,shadow-council,479,warrior,arms,12,5,7
47806,Azaeil,tanaris,479,warrior,arms,12,5,7
47807,Liiberator,emerald-dream,479,warrior,arms,12,5,7
47808,Rücküs,tichondrius,479,warrior,arms,12,5,7
47809,Baloraj,barthilas,479,warrior,arms,12,5,7
47810,Dirtyrandy,zuluhed,479,warrior,arms,12,5,7
47811,Trufsoturi,bleeding-hollow,479,warrior,arms,12,5,7
47812,Burgdur,sargeras,479,warrior,arms,18,5,13
47813,Flexecute,senjin,479,warrior,arms,18,5,13
47814,Helscreem,hyjal,479,warrior,arms,18,5,13
47815,Gorrthrax,area-52,479,warrior,arms,24,5,19
47816,Arooy,azralon,478,warrior,arms,6,5,1
47817,Bloren,thrall,478,warrior,arms,12,5,7
47818,Dirtywarrior,lightnings-blade,478,warrior,arms,12,5,7
47819,Otyek,proudmoore,478,warrior,arms,12,5,7
47820,Bennybrock,crushridge,478,warrior,arms,12,5,7
47821,Wnunes,nemesis,478,warrior,arms,12,5,7
47822,Tmible,ragnaros,477,warrior,arms,6,5,1
47823,Bratomil,amanthul,476,warrior,arms,12,5,7
47824,Acanof,azjolnerub,474,warrior,arms,9,6,3
47825,Beepboop,malganis,473,warrior,arms,12,5,7
47826,Inuyasha,korgath,473,warrior,arms,12,5,7
47827,Raktrazbirt,dalaran,472,warrior,arms,12,5,7
47828,Danalle,area-52,448,warrior,arms,10,6,4
47829,Turboboy,tichondrius,448,warrior,arms,10,5,5
47830,Mverstappen,azralon,448,warrior,arms,10,5,5
47831,Broxigore,nerzhul,448,warrior,arms,22,5,17
47832,Notcoverage,tichondrius,447,warrior,arms,11,5,6
47833,Dontkiteme,frostmourne,447,warrior,arms,17,5,12
47834,Cyllå,frostmourne,446,warrior,arms,9,6,3
47835,Shotgunzx,tichondrius,432,warrior,arms,9,5,4
47836,Esko,tichondrius,431,warrior,arms,11,5,6
47837,Gurgak,illidan,431,warrior,arms,11,5,6
47838,Jackedaniels,stormrage,431,warrior,arms,12,5,7
47839,Bloodbottle,darkspear,426,warrior,arms,14,7,7
47840,Boombasta,shuhalo,426,warrior,arms,15,6,9
47841,Machutron,quelthalas,415,warrior,arms,8,5,3
47842,Yarocktoo,kelthuzad,415,warrior,arms,8,5,3
47843,Crackersmack,stormrage,415,warrior,arms,11,6,5
47844,Thano,kiljaeden,415,warrior,arms,10,5,5
47845,Nrico,frostmourne,415,warrior,arms,10,5,5
47846,Warrihoe,stormrage,415,warrior,arms,11,5,6
47847,Arroezze,earthen-ring,399,warrior,arms,13,5,8
47848,Koraciá,illidan,399,warrior,arms,13,5,8
47849,Gushyguts,tichondrius,399,warrior,arms,19,5,14
47850,Swingyslammy,area-52,384,warrior,arms,6,4,2
47851,Kahn,andorhal,384,warrior,arms,6,4,2
47852,Gnasty,hyjal,384,warrior,arms,6,4,2
47853,Hipower,lethon,384,warrior,arms,6,4,2
47854,Bütch,stormrage,384,warrior,arms,6,4,2
47855,Titanmax,kelthuzad,384,warrior,arms,6,4,2
47856,Picpay,area-52,384,warrior,arms,6,4,2
47857,Fròthy,emerald-dream,384,warrior,arms,6,4,2
47858,Warcheif,dentarg,384,warrior,arms,6,4,2
47859,Kimbö,quelthalas,384,warrior,arms,6,4,2
47860,Nextquestion,sargeras,384,warrior,arms,6,4,2
47861,Bruisebanner,area-52,384,warrior,arms,6,4,2
47862,Alèx,tichondrius,384,warrior,arms,6,4,2
47863,Hamburgezo,quelthalas,384,warrior,arms,6,4,2
47864,Mòrgo,agamaggan,384,warrior,arms,6,4,2
47865,Tsutsana,lightninghoof,384,warrior,arms,6,4,2
47866,Wariorwang,tichondrius,384,warrior,arms,6,4,2
47867,Neon,wildhammer,384,warrior,arms,6,4,2
47868,Krokü,area-52,384,warrior,arms,6,4,2
47869,Martiallawl,skullcrusher,384,warrior,arms,6,4,2
47870,Odalp,tichondrius,384,warrior,arms,6,4,2
47871,Braxxìnn,tichondrius,384,warrior,arms,6,4,2
47872,Yivicus,sargeras,384,warrior,arms,6,4,2
47873,Mortalhandx,tichondrius,384,warrior,arms,6,4,2
47874,Ayath,hyjal,384,warrior,arms,6,4,2
47875,Swaystko,sargeras,384,warrior,arms,6,4,2
47876,Jersucristö,quelthalas,384,warrior,arms,6,4,2
47877,Jakslasfa,aegwynn,384,warrior,arms,6,4,2
47878,Appolyonn,hyjal,384,warrior,arms,6,4,2
47879,Littlegengar,tichondrius,384,warrior,arms,6,4,2
47880,Restoy,tichondrius,384,warrior,arms,6,4,2
47881,Sokõ,tichondrius,384,warrior,arms,6,4,2
47882,Malgoth,illidan,384,warrior,arms,6,4,2
47883,Yêawen,tichondrius,384,warrior,arms,6,4,2
47884,Blucollardad,bleeding-hollow,384,warrior,arms,6,4,2
47885,Boomtacular,moon-guard,384,warrior,arms,6,4,2
47886,Bajheeraz,tichondrius,384,warrior,arms,6,4,2
47887,Swillzz,illidan,384,warrior,arms,6,4,2
47888,Beleña,dalaran,384,warrior,arms,6,4,2
47889,Thiccyb,area-52,384,warrior,arms,6,4,2
47890,Koalabear,shadow-council,384,warrior,arms,6,4,2
47891,Daddydomtop,moon-guard,384,warrior,arms,6,4,2
47892,Bailo,dathremar,384,warrior,arms,6,4,2
47893,Afelhia,moon-guard,384,warrior,arms,6,4,2
47894,Sayuri,frostmourne,384,warrior,arms,6,4,2
47895,Ckoaw,dalaran,384,warrior,arms,6,4,2
47896,Hitwkey,tichondrius,384,warrior,arms,6,4,2
47897,Evergardens,saurfang,384,warrior,arms,6,4,2
47898,Tickej,dragonmaw,384,warrior,arms,6,4,2
47899,Còlòssal,moknathal,384,warrior,arms,6,4,2
47900,Swordfighter,moon-guard,384,warrior,arms,6,4,2
47901,Rinima,tichondrius,384,warrior,arms,6,4,2
47902,Evencane,stormrage,384,warrior,arms,6,4,2
47903,Potalot,draenor,384,warrior,arms,6,4,2
47904,Thottprot,blackhand,384,warrior,arms,6,4,2
47905,Gurneyhalec,proudmoore,384,warrior,arms,6,4,2
47906,Sonoflaw,skullcrusher,384,warrior,arms,6,4,2
47907,Zarttorius,quelthalas,384,warrior,arms,6,4,2
47908,Brrazze,moon-guard,384,warrior,arms,6,4,2
47909,Rõcky,frostmourne,384,warrior,arms,6,4,2
47910,Dysazter,ravencrest,384,warrior,arms,6,4,2
47911,Cheshe,area-52,384,warrior,arms,6,4,2
47912,Sygurd,drakkari,384,warrior,arms,6,4,2
47913,Termana,azjolnerub,384,warrior,arms,6,4,2
47914,Pilgrimslays,tichondrius,384,warrior,arms,6,4,2
47915,Skorgebt,thrall,384,warrior,arms,6,4,2
47916,Zoldyak,ragnaros,384,warrior,arms,6,4,2
47917,Hordrek,moon-guard,384,warrior,arms,6,4,2
47918,Zuggernaut,shadowsong,384,warrior,arms,6,4,2
47919,Sparts,area-52,384,warrior,arms,6,4,2
47920,Mommystrasza,kelthuzad,384,warrior,arms,6,4,2
47921,Murrderrface,azgalor,384,warrior,arms,6,4,2
47922,Gomachi,moon-guard,384,warrior,arms,6,4,2
47923,Keffdog,laughing-skull,384,warrior,arms,6,4,2
47924,Slapywar,illidan,384,warrior,arms,6,4,2
47925,Pineapplezz,kelthuzad,384,warrior,arms,6,4,2
47926,Ziggeraut,cenarion-circle,384,warrior,arms,6,4,2
47927,Míaguiulfo,ragnaros,384,warrior,arms,6,4,2
47928,Irascible,stormrage,384,warrior,arms,6,4,2
47929,Kufflinks,kelthuzad,384,warrior,arms,6,4,2
47930,Elbelgon,ragnaros,384,warrior,arms,6,4,2
47931,Trevmo,bloodscalp,384,warrior,arms,6,4,2
47932,Hamur,azralon,384,warrior,arms,6,4,2
47933,Fernzie,malganis,384,warrior,arms,6,4,2
47934,Fancysin,malganis,384,warrior,arms,6,4,2
47935,Mfgodofwar,kelthuzad,384,warrior,arms,6,4,2
47936,Dazfury,barthilas,384,warrior,arms,6,4,2
47937,Aægekaz,proudmoore,384,warrior,arms,6,4,2
47938,Gangdan,sargeras,384,warrior,arms,6,4,2
47939,Sakuraya,tichondrius,384,warrior,arms,6,4,2
47940,Ragingboner,aggramar,384,warrior,arms,6,4,2
47941,Helder,destromath,384,warrior,arms,6,4,2
47942,Gamörä,illidan,384,warrior,arms,6,4,2
47943,Misticstorm,barthilas,384,warrior,arms,6,4,2
47944,Styiex,ragnaros,384,warrior,arms,6,4,2
47945,Diesel,duskwood,384,warrior,arms,6,4,2
47946,Bajheeraz,sargeras,384,warrior,arms,6,4,2
47947,Frakt,illidan,384,warrior,arms,6,4,2
47948,Veedrin,ysera,384,warrior,arms,6,4,2
47949,Gozugurself,barthilas,384,warrior,arms,6,4,2
47950,Takitó,ragnaros,384,warrior,arms,6,4,2
47951,Ummso,nerzhul,384,warrior,arms,6,4,2
47952,Airhood,frostmourne,384,warrior,arms,6,4,2
47953,Killaen,thrall,384,warrior,arms,6,4,2
47954,Amérus,moon-guard,384,warrior,arms,6,4,2
47955,Oddyseey,moon-guard,384,warrior,arms,6,4,2
47956,Jire,shadowmoon,384,warrior,arms,7,4,3
47957,Greenishfox,illidan,384,warrior,arms,9,5,4
47958,Ragnarlbrok,goldrinn,384,warrior,arms,10,5,5
47959,Kalisandra,undermine,384,warrior,arms,10,5,5
47960,Ailes,hakkar,384,warrior,arms,11,4,7
47961,Flabergaster,skullcrusher,384,warrior,arms,12,4,8
47962,Meanface,malganis,384,warrior,arms,12,4,8
47963,Tinydingo,sargeras,384,warrior,arms,12,4,8
47964,Warriormikey,tichondrius,384,warrior,arms,12,4,8
47965,Xdorkie,area-52,384,warrior,arms,12,4,8
47966,Twoshoutz,stormrage,384,warrior,arms,12,4,8
47967,Gnizzmo,sargeras,384,warrior,arms,12,4,8
47968,Doully,proudmoore,384,warrior,arms,12,4,8
47969,Durango,duskwood,384,warrior,arms,12,4,8
47970,Chongos,malganis,384,warrior,arms,12,4,8
47971,Grullhamer,ragnaros,384,warrior,arms,12,4,8
47972,Estrasystole,sargeras,384,warrior,arms,12,4,8
47973,Turkin,proudmoore,384,warrior,arms,12,4,8
47974,Drewpqawk,tichondrius,384,warrior,arms,12,4,8
47975,Sandrine,fizzcrank,384,warrior,arms,12,4,8
47976,Mikejustice,kelthuzad,384,warrior,arms,12,4,8
47977,Beifong,barthilas,384,warrior,arms,12,4,8
47978,Cupper,tichondrius,384,warrior,arms,12,4,8
47979,Warmachined,grizzly-hills,384,warrior,arms,12,4,8
47980,Palumorw,deathwing,384,warrior,arms,12,4,8
47981,Flexyx,arthas,384,warrior,arms,12,4,8
47982,Nginx,queldorei,384,warrior,arms,12,4,8
47983,Angrybrog,malfurion,384,warrior,arms,12,4,8
47984,Raokao,senjin,384,warrior,arms,12,4,8
47985,Kenedy,moon-guard,384,warrior,arms,12,4,8
47986,Joekenshield,stonemaul,384,warrior,arms,12,4,8
47987,Iden,vashj,384,warrior,arms,12,4,8
47988,Runningatyou,area-52,384,warrior,arms,12,4,8
47989,Redrumman,demon-soul,384,warrior,arms,12,4,8
47990,Nxmabala,proudmoore,384,warrior,arms,12,4,8
47991,Ladderx,area-52,384,warrior,arms,12,4,8
47992,Amaus,queldorei,384,warrior,arms,12,4,8
47993,Exist,kaelthas,384,warrior,arms,12,4,8
47994,Guyllol,barthilas,384,warrior,arms,12,4,8
47995,Yamato,skywall,384,warrior,arms,12,4,8
47996,Grândmâ,zuljin,384,warrior,arms,12,4,8
47997,Furyofrage,dalaran,384,warrior,arms,12,4,8
47998,Iridikron,dalaran,384,warrior,arms,12,4,8
47999,Dámöuse,stormrage,384,warrior,arms,12,4,8
48000,Lui,the-forgotten-coast,384,warrior,arms,12,4,8
48001,Handikap,stormrage,384,warrior,arms,12,4,8
48002,Còsmico,trollbane,384,warrior,arms,12,4,8
48003,Brendan,llane,384,warrior,arms,12,4,8
48004,Warspartan,stormrage,384,warrior,arms,12,4,8
48005,Iargestpp,bleeding-hollow,384,warrior,arms,12,4,8
48006,Swingú,illidan,384,warrior,arms,12,4,8
48007,Aldaøm,ragnaros,384,warrior,arms,12,4,8
48008,Burstmacro,garrosh,384,warrior,arms,12,4,8
48009,Heliza,ragnaros,384,warrior,arms,12,4,8
48010,Draiken,dalaran,384,warrior,arms,12,4,8
48011,Bewbeebangz,kelthuzad,384,warrior,arms,12,4,8
48012,Barrocops,kiljaeden,384,warrior,arms,12,4,8
48013,Snack,stormreaver,384,warrior,arms,12,4,8
48014,Hameey,sargeras,384,warrior,arms,12,4,8
48015,Moseshrute,zuljin,384,warrior,arms,12,4,8
48016,Mefus,wyrmrest-accord,384,warrior,arms,12,4,8
48017,Fortchin,area-52,384,warrior,arms,12,4,8
48018,Renclave,wyrmrest-accord,384,warrior,arms,12,4,8
48019,Nänchobo,tichondrius,384,warrior,arms,12,4,8
48020,Augutra,moon-guard,384,warrior,arms,12,4,8
48021,Ballsy,fenris,384,warrior,arms,12,4,8
48022,Daduké,stormrage,384,warrior,arms,12,4,8
48023,Koei,illidan,384,warrior,arms,12,4,8
48024,Tappyc,tichondrius,384,warrior,arms,12,4,8
48025,Hârambe,kiljaeden,384,warrior,arms,12,4,8
48026,Sonicboom,whisperwind,384,warrior,arms,12,4,8
48027,Licona,wyrmrest-accord,384,warrior,arms,12,4,8
48028,Fatherkelso,tichondrius,384,warrior,arms,12,4,8
48029,Naelynh,quelthalas,384,warrior,arms,12,4,8
48030,Rocketbom,tichondrius,384,warrior,arms,12,4,8
48031,Laokan,illidan,384,warrior,arms,12,4,8
48032,Bigboy,icecrown,384,warrior,arms,12,4,8
48033,Lørdvingådør,azralon,384,warrior,arms,12,4,8
48034,Totenhammer,nathrezim,384,warrior,arms,12,4,8
48035,Tharsìs,emerald-dream,384,warrior,arms,12,4,8
48036,Verrynasty,area-52,384,warrior,arms,12,4,8
48037,Xårren,stormrage,384,warrior,arms,12,4,8
48038,Magmaheart,lightbringer,384,warrior,arms,12,4,8
48039,Izhansheni,illidan,384,warrior,arms,12,4,8
48040,Mindgoblin,bleeding-hollow,384,warrior,arms,12,4,8
48041,Dessindir,quelthalas,384,warrior,arms,12,4,8
48042,Stewwar,wyrmrest-accord,384,warrior,arms,12,4,8
48043,Zugface,tichondrius,384,warrior,arms,12,4,8
48044,Jasonsdady,illidan,384,warrior,arms,12,4,8
48045,Skunkz,kelthuzad,384,warrior,arms,12,4,8
48046,Porchorc,hyjal,384,warrior,arms,12,4,8
48047,Crimsóñ,kelthuzad,384,warrior,arms,12,4,8
48048,Narduk,emerald-dream,384,warrior,arms,12,4,8
48049,Hamslamm,area-52,384,warrior,arms,12,4,8
48050,Jaclksparrow,azralon,384,warrior,arms,12,4,8
48051,Filth,tichondrius,384,warrior,arms,12,4,8
48052,Metalhit,tichondrius,384,warrior,arms,12,4,8
48053,Lundyswung,silver-hand,384,warrior,arms,12,4,8
48054,Shínkicker,area-52,384,warrior,arms,12,4,8
48055,Jathellum,stormrage,384,warrior,arms,12,4,8
48056,Gazah,skullcrusher,384,warrior,arms,12,4,8
48057,Gangaa,barthilas,384,warrior,arms,12,4,8
48058,Bondadoso,stormrage,384,warrior,arms,13,4,9
48059,Varkery,sargeras,384,warrior,arms,13,4,9
48060,Kyres,moon-guard,384,warrior,arms,16,4,12
48061,Cowsgomerr,tichondrius,384,warrior,arms,18,4,14
48062,Bêelzebub,aerie-peak,384,warrior,arms,18,4,14
48063,Asphyxiating,illidan,384,warrior,arms,18,4,14
48064,Retiarius,tichondrius,384,warrior,arms,18,4,14
48065,Draxxarlol,zuljin,384,warrior,arms,18,4,14
48066,Noppô,tichondrius,384,warrior,arms,18,4,14
48067,Dulapamore,tichondrius,384,warrior,arms,18,4,14
48068,Gladicus,zuljin,384,warrior,arms,18,4,14
48069,Yeit,tichondrius,383,warrior,arms,6,4,2
48070,Ezaxe,tichondrius,383,warrior,arms,6,4,2
48071,Chisum,gnomeregan,383,warrior,arms,6,4,2
48072,Orcrist,stormreaver,383,warrior,arms,6,4,2
48073,Shìromìzù,eredar,383,warrior,arms,6,4,2
48074,Tookbeki,tichondrius,383,warrior,arms,6,4,2
48075,Shabus,moon-guard,383,warrior,arms,12,4,8
48076,Spitbeard,kargath,383,warrior,arms,12,4,8
48077,Ajamu,aegwynn,383,warrior,arms,12,4,8
48078,Svênd,ragnaros,383,warrior,arms,12,4,8
48079,Kâyous,tichondrius,383,warrior,arms,12,4,8
48080,Christellà,dalaran,383,warrior,arms,18,4,14
48081,Blockcheese,illidan,383,warrior,arms,18,4,14
48082,Såmmÿ,moon-guard,379,warrior,arms,12,4,8
48083,Handdok,runetotem,379,warrior,arms,12,4,8
48084,Dingoe,wyrmrest-accord,379,warrior,arms,12,4,8
48085,Lightstrikes,sargeras,379,warrior,arms,12,4,8
48086,Loomine,illidan,367,warrior,arms,11,4,7
48087,Ayuko,greymane,367,warrior,arms,11,4,7
48088,Warsins,bonechewer,367,warrior,arms,17,4,13
48089,Tecnowar,quelthalas,352,warrior,arms,10,4,6
48090,Bellonar,stormrage,351,warrior,arms,8,5,3
48091,Thøros,moon-guard,351,warrior,arms,11,4,7
48092,Vaetren,area-52,351,warrior,arms,11,4,7
48093,Förkz,ragnaros,351,warrior,arms,11,4,7
48094,Matasimio,drakkari,336,warrior,arms,9,4,5
48095,Toir,bladefist,335,warrior,arms,11,4,7
48096,Caynos,stormrage,335,warrior,arms,11,4,7
48097,Ashrah,emerald-dream,330,warrior,arms,9,5,4
48098,Rubbers,thrall,330,warrior,arms,17,6,11
48099,Macray,zuljin,330,warrior,arms,18,5,13
48100,Mnoga,azralon,330,warrior,arms,22,5,17
48101,Machatlan,stormrage,324,warrior,arms,16,7,9
48102,Slashcry,frostmourne,320,warrior,arms,10,4,6
48103,Lildumptruck,emerald-dream,320,warrior,arms,10,4,6
48104,Painstake,illidan,320,warrior,arms,19,5,14
48105,Toetoeto,darrowmere,319,warrior,arms,5,4,1
48106,Skollton,tichondrius,319,warrior,arms,5,4,1
48107,Rauwers,azralon,319,warrior,arms,8,4,4
48108,Armada,sargeras,319,warrior,arms,8,4,4
48109,Cptdrako,alterac-mountains,319,warrior,arms,8,4,4
48110,Knewty,stormrage,319,warrior,arms,8,4,4
48111,Aerriz,area-52,319,warrior,arms,11,4,7
48112,Edmaghar,ragnaros,319,warrior,arms,14,4,10
48113,Kleavage,korgath,304,warrior,arms,13,4,9
48114,Rezhan,area-52,304,warrior,arms,13,4,9
48115,Syradar,ragnaros,304,warrior,arms,13,4,9
48116,Nicolasrage,trollbane,303,warrior,arms,11,5,6
48117,Faywarsong,area-52,288,warrior,arms,6,3,3
48118,Larosfan,tichondrius,288,warrior,arms,6,3,3
48119,Dronarmus,ragnaros,288,warrior,arms,6,3,3
48120,Hanginaround,zuluhed,288,warrior,arms,6,3,3
48121,Yasser,ragnaros,288,warrior,arms,6,3,3
48122,Desertor,illidan,288,warrior,arms,6,3,3
48123,Rockybâlboa,illidan,288,warrior,arms,6,3,3
48124,Largegayman,sargeras,288,warrior,arms,6,3,3
48125,Glowstick,tichondrius,288,warrior,arms,6,3,3
48126,Seymourbot,illidan,288,warrior,arms,6,3,3
48127,Wqnmlgbd,tichondrius,288,warrior,arms,6,3,3
48128,Axeslaps,illidan,288,warrior,arms,6,3,3
48129,Rankjuan,area-52,288,warrior,arms,6,3,3
48130,Davien,tichondrius,288,warrior,arms,6,3,3
48131,Ragemelon,icecrown,288,warrior,arms,6,3,3
48132,Alondir,quelthalas,288,warrior,arms,6,3,3
48133,Rockhardt,tichondrius,288,warrior,arms,6,3,3
48134,Poppacd,stormrage,288,warrior,arms,6,3,3
48135,Ragelol,icecrown,288,warrior,arms,6,3,3
48136,Robio,tichondrius,288,warrior,arms,6,3,3
48137,Kénblock,tichondrius,288,warrior,arms,6,3,3
48138,Fivewarrior,tichondrius,288,warrior,arms,6,3,3
48139,Corrum,shuhalo,288,warrior,arms,6,3,3
48140,Akilosh,illidan,288,warrior,arms,6,3,3
48141,Exdilla,zuljin,288,warrior,arms,6,3,3
48142,Bachyr,stormrage,288,warrior,arms,6,3,3
48143,Ghomory,quelthalas,288,warrior,arms,6,3,3
48144,Nukehazard,bleeding-hollow,288,warrior,arms,6,3,3
48145,Pezek,thrall,288,warrior,arms,6,3,3
48146,Notawar,stormrage,288,warrior,arms,6,3,3
48147,Shiromiya,tichondrius,288,warrior,arms,6,3,3
48148,Brayven,area-52,288,warrior,arms,6,3,3
48149,Consolidate,hyjal,288,warrior,arms,6,3,3
48150,Drugdilla,zuljin,288,warrior,arms,6,3,3
48151,Asäel,ragnaros,288,warrior,arms,6,3,3
48152,Jerveen,quelthalas,288,warrior,arms,6,3,3
48153,Dazuu,illidan,288,warrior,arms,6,3,3
48154,Swifty,tichondrius,288,warrior,arms,6,3,3
48155,Zenmore,illidan,288,warrior,arms,6,3,3
48156,Robostergler,tichondrius,288,warrior,arms,6,3,3
48157,Allmotor,zuljin,288,warrior,arms,6,3,3
48158,Tiitlefight,bleeding-hollow,288,warrior,arms,6,3,3
48159,Reishera,stormrage,288,warrior,arms,6,3,3
48160,Spartanfury,tichondrius,288,warrior,arms,6,3,3
48161,Vnw,illidan,288,warrior,arms,6,3,3
48162,Fyle,stormrage,288,warrior,arms,6,3,3
48163,Grapegush,bleeding-hollow,288,warrior,arms,6,3,3
48164,Jabakas,tichondrius,288,warrior,arms,6,3,3
48165,Toragorr,illidan,288,warrior,arms,6,3,3
48166,Hitmypronoun,illidan,288,warrior,arms,6,3,3
48167,Warbreaker,stormrage,288,warrior,arms,6,3,3
48168,Serindel,quelthalas,288,warrior,arms,6,3,3
48169,Orkwar,tichondrius,288,warrior,arms,6,3,3
48170,Milbën,tichondrius,288,warrior,arms,6,3,3
48171,Dunsker,stormrage,288,warrior,arms,6,3,3
48172,Caalypso,stormrage,288,warrior,arms,6,3,3
48173,Scottpilgrim,illidan,288,warrior,arms,6,3,3
48174,Wrèckingball,tichondrius,288,warrior,arms,6,3,3
48175,Pummels,area-52,288,warrior,arms,6,3,3
48176,Cryptex,illidan,288,warrior,arms,6,3,3
48177,Idarkshakra,illidan,288,warrior,arms,6,3,3
48178,Ichigami,kelthuzad,288,warrior,arms,6,3,3
48179,Udmwarrior,zuljin,288,warrior,arms,6,3,3
48180,Huffzo,tichondrius,288,warrior,arms,6,3,3
48181,Humanlog,illidan,288,warrior,arms,6,3,3
48182,Zåzriel,tichondrius,288,warrior,arms,6,3,3
48183,Críxus,sargeras,288,warrior,arms,6,3,3
48184,Kuntahkintah,tichondrius,288,warrior,arms,6,3,3
48185,Qutuz,illidan,288,warrior,arms,6,3,3
48186,Hukzula,illidan,288,warrior,arms,6,3,3
48187,Sambojüjü,stormrage,288,warrior,arms,6,3,3
48188,Drakr,ragnaros,288,warrior,arms,6,3,3
48189,Wingnut,zuluhed,288,warrior,arms,6,3,3
48190,Bigshett,sargeras,288,warrior,arms,6,3,3
48191,Warnuk,lightnings-blade,288,warrior,arms,6,3,3
48192,Exequet,tichondrius,288,warrior,arms,6,3,3
48193,Jutank,sargeras,288,warrior,arms,6,3,3
48194,Assmut,stormrage,288,warrior,arms,6,3,3
48195,Tnytank,burning-legion,288,warrior,arms,6,3,3
48196,Mortaryon,malganis,288,warrior,arms,6,3,3
48197,Zemi,sargeras,288,warrior,arms,6,3,3
48198,Szar,stormrage,288,warrior,arms,6,3,3
48199,Finndal,bleeding-hollow,288,warrior,arms,6,3,3
48200,Yenør,stormrage,288,warrior,arms,6,3,3
48201,Gypsypsycho,stormrage,288,warrior,arms,6,3,3
48202,Swizzly,tichondrius,288,warrior,arms,6,3,3
48203,Dublinn,llane,288,warrior,arms,6,3,3
48204,Hìtchslap,tichondrius,288,warrior,arms,6,3,3
48205,Clerond,tichondrius,288,warrior,arms,6,3,3
48206,Noteko,tichondrius,288,warrior,arms,6,3,3
48207,Evôlutiôn,kelthuzad,288,warrior,arms,6,3,3
48208,Fakktwo,blackhand,288,warrior,arms,6,3,3
48209,Daedrion,dalaran,288,warrior,arms,6,3,3
48210,Zulataza,zuljin,288,warrior,arms,6,3,3
48211,Magthor,warsong,288,warrior,arms,6,3,3
48212,Topee,area-52,288,warrior,arms,6,3,3
48213,Solembuumm,illidan,288,warrior,arms,6,3,3
48214,Imperiial,stormrage,288,warrior,arms,6,3,3
48215,Schlosh,laughing-skull,288,warrior,arms,6,3,3
48216,Thunderess,illidan,288,warrior,arms,6,3,3
48217,Éten,drakkari,288,warrior,arms,6,3,3
48218,Mandofl,ragnaros,288,warrior,arms,6,3,3
48219,Kokurawr,burning-legion,288,warrior,arms,6,3,3
48220,Êraser,tichondrius,288,warrior,arms,6,3,3
48221,Renning,malganis,288,warrior,arms,6,3,3
48222,Claphub,malganis,288,warrior,arms,6,3,3
48223,Smashndspin,sargeras,288,warrior,arms,6,3,3
48224,Richenbach,kelthuzad,288,warrior,arms,6,3,3
48225,Warreeper,area-52,288,warrior,arms,6,3,3
48226,Rageroidz,sargeras,288,warrior,arms,6,3,3
48227,Krïtzkreig,the-forgotten-coast,288,warrior,arms,6,3,3
48228,Jackanape,sargeras,288,warrior,arms,6,3,3
48229,Philipjoo,illidan,288,warrior,arms,6,3,3
48230,Akhinoz,area-52,288,warrior,arms,6,3,3
48231,Hungdiesel,area-52,288,warrior,arms,6,3,3
48232,Zebel,tichondrius,288,warrior,arms,6,3,3
48233,Tenderturtle,tichondrius,288,warrior,arms,6,3,3
48234,Oxxelfer,tichondrius,288,warrior,arms,6,3,3
48235,Hesch,thunderlord,288,warrior,arms,6,3,3
48236,Ellx,sargeras,288,warrior,arms,6,3,3
48237,Sunhands,emerald-dream,288,warrior,arms,6,3,3
48238,Skullsplittr,illidan,288,warrior,arms,6,3,3
48239,Grognäk,malganis,288,warrior,arms,6,3,3
48240,Vistacleave,maiev,288,warrior,arms,6,3,3
48241,Ambevsgunnar,tichondrius,288,warrior,arms,6,3,3
48242,Runtasticx,tichondrius,288,warrior,arms,6,3,3
48243,Najarath,barthilas,288,warrior,arms,6,3,3
48244,Tothepain,thrall,288,warrior,arms,6,3,3
48245,Duglug,malganis,288,warrior,arms,6,3,3
48246,Bëowulf,malganis,288,warrior,arms,6,3,3
48247,Temperament,area-52,288,warrior,arms,6,3,3
48248,Deadlypsycho,moonrunner,288,warrior,arms,6,3,3
48249,Polox,ragnaros,288,warrior,arms,6,3,3
48250,Salveknight,ragnaros,288,warrior,arms,6,3,3
48251,Zugmeov,barthilas,288,warrior,arms,6,3,3
48252,Zugsok,thrall,288,warrior,arms,6,3,3
48253,Uzy,proudmoore,288,warrior,arms,6,3,3
48254,Tomcruizes,tichondrius,288,warrior,arms,6,3,3
48255,Hopefulki,duskwood,288,warrior,arms,6,3,3
48256,Outterspace,illidan,288,warrior,arms,6,3,3
48257,Zibby,malganis,288,warrior,arms,6,3,3
48258,Cabelas,tichondrius,288,warrior,arms,6,3,3
48259,Exiledwarz,area-52,288,warrior,arms,6,3,3
48260,Rezorc,stormrage,288,warrior,arms,6,3,3
48261,Cheekclapps,tichondrius,288,warrior,arms,6,3,3
48262,Tragictonka,stormrage,288,warrior,arms,6,3,3
48263,Actio,stormrage,288,warrior,arms,6,3,3
48264,Valför,ysera,288,warrior,arms,6,3,3
48265,Aggor,trollbane,288,warrior,arms,6,3,3
48266,Guille,skullcrusher,288,warrior,arms,6,3,3
48267,Leonidas,barthilas,288,warrior,arms,6,3,3
48268,Unhealbedam,area-52,288,warrior,arms,6,3,3
48269,Iwishiknew,kargath,288,warrior,arms,6,3,3
48270,Zeroaxx,ragnaros,288,warrior,arms,6,3,3
48271,Nazakeen,tichondrius,288,warrior,arms,6,3,3
48272,Biggieswords,madoran,288,warrior,arms,6,3,3
48273,Skaaxx,barthilas,288,warrior,arms,6,3,3
48274,Executing,emerald-dream,288,warrior,arms,6,3,3
48275,Reckonting,moon-guard,288,warrior,arms,6,3,3
48276,Shloope,barthilas,288,warrior,arms,6,3,3
48277,Demetrïus,moon-guard,288,warrior,arms,6,3,3
48278,Onisusu,frostmourne,288,warrior,arms,6,3,3
48279,Elix,stormscale,288,warrior,arms,6,3,3
48280,Retrô,uldum,288,warrior,arms,6,3,3
48281,Batchat,frostmourne,288,warrior,arms,6,3,3
48282,Tread,mugthol,288,warrior,arms,6,3,3
48283,Smokezee,barthilas,288,warrior,arms,6,3,3
48284,Fatalsfury,tichondrius,288,warrior,arms,6,3,3
48285,Tôpanga,lightninghoof,288,warrior,arms,6,3,3
48286,Ymìr,moon-guard,288,warrior,arms,6,3,3
48287,Sweetmojito,vashj,288,warrior,arms,6,3,3
48288,Mcrîb,stormscale,288,warrior,arms,6,3,3
48289,Faelzerá,azralon,288,warrior,arms,6,3,3
48290,Smash,frostmane,288,warrior,arms,6,3,3
48291,Az,malorne,288,warrior,arms,6,3,3
48292,Mewpaw,azralon,288,warrior,arms,6,3,3
48293,Trashman,frostwolf,288,warrior,arms,6,3,3
48294,Wulfgarn,frostwolf,288,warrior,arms,6,3,3
48295,Småckêd,sargeras,288,warrior,arms,6,3,3
48296,Leeth,azralon,288,warrior,arms,6,3,3
48297,Doubleturbo,illidan,288,warrior,arms,6,3,3
48298,Preceptron,azralon,288,warrior,arms,6,3,3
48299,Prontera,illidan,288,warrior,arms,6,3,3
48300,Saelaa,azralon,288,warrior,arms,6,3,3
48301,Titanor,illidan,288,warrior,arms,6,3,3
48302,Telynne,frostmourne,288,warrior,arms,6,3,3
48303,Miarisa,moon-guard,288,warrior,arms,6,3,3
48304,Hawkior,moon-guard,288,warrior,arms,6,3,3
48305,Elessarr,moon-guard,288,warrior,arms,6,3,3
48306,Warnazx,azralon,288,warrior,arms,6,3,3
48307,Aalrua,moon-guard,288,warrior,arms,6,3,3
48308,Gorkrog,frostmourne,288,warrior,arms,6,3,3
48309,Readytoflee,moon-guard,288,warrior,arms,6,3,3
48310,Valperion,frostmourne,288,warrior,arms,6,3,3
48311,Kushe,moon-guard,288,warrior,arms,6,3,3
48312,Fregory,moon-guard,288,warrior,arms,6,3,3
48313,Finnagnome,sargeras,288,warrior,arms,6,3,3
48314,Sauceslinga,frostmourne,288,warrior,arms,6,3,3
48315,Awöl,jubeithos,288,warrior,arms,6,3,3
48316,Mittyroar,khazgoroth,288,warrior,arms,6,3,3
48317,Rendron,frostmourne,288,warrior,arms,6,3,3
48318,Tinylimbs,frostmourne,288,warrior,arms,6,3,3
48319,Nebraskapete,wyrmrest-accord,288,warrior,arms,6,3,3
48320,Fumzxy,frostmourne,288,warrior,arms,6,3,3
48321,Dolph,sargeras,288,warrior,arms,6,3,3
48322,Scanlan,dalvengyr,288,warrior,arms,6,3,3
48323,Benieswar,frostmourne,288,warrior,arms,6,3,3
48324,Edokthong,frostmourne,288,warrior,arms,6,3,3
48325,Trackhawk,moon-guard,288,warrior,arms,6,3,3
48326,Ðuffman,jubeithos,288,warrior,arms,6,3,3
48327,Kryptïç,moon-guard,288,warrior,arms,6,3,3
48328,Mikero,terenas,288,warrior,arms,6,3,3
48329,Liltotey,frostmourne,288,warrior,arms,6,3,3
48330,Vinetic,kiljaeden,288,warrior,arms,6,3,3
48331,Osselan,moon-guard,288,warrior,arms,6,3,3
48332,Poonoxo,gundrak,288,warrior,arms,6,3,3
48333,Capo,windrunner,288,warrior,arms,6,3,3
48334,Carborr,frostmourne,288,warrior,arms,6,3,3
48335,Ei,darrowmere,288,warrior,arms,6,3,3
48336,Metaphoric,stormrage,288,warrior,arms,9,4,5
48337,Maldre,stormrage,288,warrior,arms,9,4,5
48338,Rageslayer,area-52,288,warrior,arms,9,4,5
48339,Oledcktwist,garrosh,288,warrior,arms,7,3,4
48340,Kwelve,proudmoore,288,warrior,arms,7,3,4
48341,Ohdang,dark-iron,288,warrior,arms,8,3,5
48342,Ennia,azralon,288,warrior,arms,9,3,6
48343,Shewar,ragnaros,288,warrior,arms,9,3,6
48344,Akil,ragnaros,288,warrior,arms,15,4,11
48345,Wxxz,tichondrius,288,warrior,arms,12,3,9
48346,Hrl,tichondrius,288,warrior,arms,12,3,9
48347,Kaggorax,tichondrius,288,warrior,arms,12,3,9
48348,Émerald,kilrogg,288,warrior,arms,12,3,9
48349,Zaeyr,tichondrius,288,warrior,arms,12,3,9
48350,Gosariw,tichondrius,288,warrior,arms,12,3,9
48351,Dablao,tichondrius,288,warrior,arms,12,3,9
48352,Gorrock,dreadmaul,288,warrior,arms,12,3,9
48353,Ulamøg,proudmoore,288,warrior,arms,12,3,9
48354,Melancalli,thorium-brotherhood,288,warrior,arms,12,3,9
48355,Ledezma,proudmoore,288,warrior,arms,12,3,9
48356,Mesw,illidan,288,warrior,arms,12,3,9
48357,Staticego,dalaran,288,warrior,arms,12,3,9
48358,Extremist,nagrand,288,warrior,arms,12,3,9
48359,Lowdopamine,tichondrius,288,warrior,arms,12,3,9
48360,Neltar,nagrand,288,warrior,arms,12,3,9
48361,Kirikash,illidan,288,warrior,arms,12,3,9
48362,Porori,proudmoore,288,warrior,arms,12,3,9
48363,Scrubzwarr,barthilas,288,warrior,arms,12,3,9
48364,Kintownhero,aegwynn,288,warrior,arms,12,3,9
48365,Fupatwo,moon-guard,288,warrior,arms,12,3,9
48366,Kigo,azralon,288,warrior,arms,12,3,9
48367,Aræn,sargeras,288,warrior,arms,12,3,9
48368,Basingsei,area-52,288,warrior,arms,12,3,9
48369,Nightwing,bleeding-hollow,288,warrior,arms,12,3,9
48370,Minnysota,area-52,288,warrior,arms,12,3,9
48371,Roadpig,zuljin,288,warrior,arms,12,3,9
48372,Aralla,area-52,288,warrior,arms,12,3,9
48373,Snippy,garona,288,warrior,arms,12,3,9
48374,Doomr,tichondrius,288,warrior,arms,12,3,9
48375,Phargo,korgath,288,warrior,arms,12,3,9
48376,Chardz,ragnaros,288,warrior,arms,12,3,9
48377,Wasabiz,tichondrius,288,warrior,arms,12,3,9
48378,Valestrike,moon-guard,288,warrior,arms,12,3,9
48379,Mansin,tichondrius,288,warrior,arms,12,3,9
48380,Bjjorm,malganis,288,warrior,arms,12,3,9
48381,Kero,malganis,288,warrior,arms,12,3,9
48382,Legnar,malganis,288,warrior,arms,12,3,9
48383,Ggéz,stormrage,288,warrior,arms,12,3,9
48384,Erzawälkër,quelthalas,288,warrior,arms,12,3,9
48385,Alliancerulz,darrowmere,288,warrior,arms,12,3,9
48386,Greenmachine,twisting-nether,288,warrior,arms,12,3,9
48387,Äisemberg,quelthalas,288,warrior,arms,12,3,9
48388,Guerreraa,ragnaros,288,warrior,arms,12,3,9
48389,Smallraccoon,tichondrius,288,warrior,arms,12,3,9
48390,Gnomas,destromath,288,warrior,arms,12,3,9
48391,Grimthad,emerald-dream,288,warrior,arms,12,3,9
48392,Sabini,nemesis,288,warrior,arms,12,3,9
48393,Aztecvil,drakkari,288,warrior,arms,12,3,9
48394,Kregnar,gundrak,288,warrior,arms,12,3,9
48395,Darthfaith,azgalor,288,warrior,arms,12,3,9
48396,Ichil,azshara,288,warrior,arms,12,3,9
48397,Glamen,alleria,288,warrior,arms,12,3,9
48398,Xdragonfirex,terenas,288,warrior,arms,12,3,9
48399,Brütalize,wyrmrest-accord,288,warrior,arms,12,3,9
48400,Morgithia,suramar,288,warrior,arms,12,3,9
48401,Ammeh,draka,288,warrior,arms,12,3,9
48402,Creannew,drakkari,288,warrior,arms,12,3,9
48403,Enulimen,daggerspine,288,warrior,arms,12,3,9
48404,Smashyu,fenris,288,warrior,arms,12,3,9
48405,Kiillwar,smolderthorn,288,warrior,arms,12,3,9
48406,Slamspam,the-underbog,288,warrior,arms,13,3,10
48407,Khallell,illidan,288,warrior,arms,18,3,15
48408,Drdrip,shuhalo,288,warrior,arms,18,3,15
48409,Mathilan,moon-guard,288,warrior,arms,18,3,15
48410,Macbride,blackrock,288,warrior,arms,24,3,21
48411,Aiforix,gorefiend,287,warrior,arms,6,3,3
48412,Yomaaln,blackrock,287,warrior,arms,6,3,3
48413,Smashthings,area-52,287,warrior,arms,6,3,3
48414,Magtharas,dunemaul,287,warrior,arms,6,3,3
48415,Saintgeorge,thorium-brotherhood,287,warrior,arms,6,3,3
48416,Angryskeever,garona,287,warrior,arms,12,3,9
48417,Leosax,drakthul,287,warrior,arms,12,3,9
48418,Brutekush,barthilas,287,warrior,arms,12,3,9
48419,Clayske,gurubashi,287,warrior,arms,12,3,9
48420,Dekromm,tol-barad,287,warrior,arms,12,3,9
48421,Borgosa,wyrmrest-accord,287,warrior,arms,18,3,15
48422,Hruum,moknathal,286,warrior,arms,6,3,3
48423,Dazanor,moon-guard,271,warrior,arms,11,3,8
48424,Nooy,blackrock,271,warrior,arms,17,3,14
48425,Thorsën,sargeras,256,warrior,arms,8,4,4
48426,Tánktop,sargeras,255,warrior,arms,8,4,4
48427,Spicywagyu,tichondrius,255,warrior,arms,11,3,8
48428,Nècroxious,hellscream,255,warrior,arms,11,3,8
48429,Kholusia,kul-tiras,239,warrior,arms,5,3,2
48430,Hakén,tichondrius,239,warrior,arms,5,3,2
48431,Kalphok,tichondrius,239,warrior,arms,5,3,2
48432,Busyguyw,kiljaeden,239,warrior,arms,5,3,2
48433,Jÿp,tichondrius,239,warrior,arms,5,3,2
48434,Likearock,thrall,239,warrior,arms,5,3,2
48435,Omicripto,tichondrius,239,warrior,arms,5,3,2
48436,ßlitzxkreig,tichondrius,239,warrior,arms,5,3,2
48437,Baultenaz,draenor,239,warrior,arms,5,3,2
48438,Hugewarrior,area-52,234,warrior,arms,9,4,5
48439,Benchpress,bleeding-hollow,223,warrior,arms,8,3,5
48440,Nayaqt,tichondrius,223,warrior,arms,8,3,5
48441,Snikkles,frostmourne,223,warrior,arms,8,3,5
48442,Condemnd,area-52,207,warrior,arms,8,3,5
48443,Stickystorm,proudmoore,192,warrior,arms,4,3,1
48444,Elyn,tichondrius,192,warrior,arms,4,3,1
48445,Wonderjack,akama,192,warrior,arms,4,3,1
48446,Berru,bleeding-hollow,192,warrior,arms,9,3,6
48447,Arianarkw,sargeras,192,warrior,arms,9,3,6
48448,Cugino,tichondrius,192,warrior,arms,9,3,6
48449,Àyo,frostmourne,192,warrior,arms,6,2,4
48450,Kostikk,tichondrius,192,warrior,arms,6,2,4
48451,Flyaf,illidan,192,warrior,arms,6,2,4
48452,Helminth,kirin-tor,192,warrior,arms,6,2,4
48453,Düde,whisperwind,192,warrior,arms,6,2,4
48454,Flakesskillz,darkspear,192,warrior,arms,6,2,4
48455,Bearlornan,frostmourne,192,warrior,arms,6,2,4
48456,Avansys,tichondrius,192,warrior,arms,6,2,4
48457,Frankal,aegwynn,192,warrior,arms,6,2,4
48458,Uldrath,hyjal,192,warrior,arms,6,2,4
48459,Berario,garrosh,192,warrior,arms,6,2,4
48460,Mututu,frostmourne,192,warrior,arms,6,2,4
48461,Focalabbys,illidan,192,warrior,arms,6,2,4
48462,Trigon,chromaggus,192,warrior,arms,6,2,4
48463,Anabolicjim,frostmourne,192,warrior,arms,6,2,4
48464,Kreits,drakkari,192,warrior,arms,6,2,4
48465,Kvoth,bleeding-hollow,192,warrior,arms,6,2,4
48466,Eleenoor,drakkari,192,warrior,arms,6,2,4
48467,Endlesskilla,destromath,192,warrior,arms,6,2,4
48468,Superbest,tichondrius,192,warrior,arms,6,2,4
48469,Rendus,hyjal,192,warrior,arms,6,2,4
48470,Orcly,kilrogg,192,warrior,arms,6,2,4
48471,Sosaalmigh,tichondrius,192,warrior,arms,6,2,4
48472,Eurthx,lightbringer,192,warrior,arms,6,2,4
48473,Hugezs,tichondrius,192,warrior,arms,6,2,4
48474,Kimuraa,hyjal,192,warrior,arms,6,2,4
48475,Åmowarr,illidan,192,warrior,arms,6,2,4
48476,Taigola,aggramar,192,warrior,arms,6,2,4
48477,Krunchal,terenas,192,warrior,arms,6,2,4
48478,Saabre,tichondrius,192,warrior,arms,6,2,4
48479,Tatro,tichondrius,192,warrior,arms,6,2,4
48480,Karlsabad,medivh,192,warrior,arms,6,2,4
48481,Stellabear,aggramar,192,warrior,arms,6,2,4
48482,Alitalia,thunderlord,192,warrior,arms,6,2,4
48483,Thiccthôt,frostmourne,192,warrior,arms,6,2,4
48484,Trouz,ragnaros,192,warrior,arms,6,2,4
48485,Elimination,tichondrius,192,warrior,arms,6,2,4
48486,Fabszord,nemesis,192,warrior,arms,6,2,4
48487,Gigglamesh,muradin,192,warrior,arms,6,2,4
48488,Xaviorn,illidan,192,warrior,arms,6,2,4
48489,Derr,tichondrius,192,warrior,arms,6,2,4
48490,Dustiezi,stormrage,192,warrior,arms,6,2,4
48491,Warkaiser,ragnaros,192,warrior,arms,6,2,4
48492,Chuck,zangarmarsh,192,warrior,arms,6,2,4
48493,Doominus,tichondrius,192,warrior,arms,6,2,4
48494,Ggrone,ragnaros,192,warrior,arms,6,2,4
48495,Tobiwan,ragnaros,192,warrior,arms,6,2,4
48496,Maleficous,tol-barad,192,warrior,arms,6,2,4
48497,Wl,ragnaros,192,warrior,arms,6,2,4
48498,Flexo,moon-guard,192,warrior,arms,6,2,4
48499,Kraff,tichondrius,192,warrior,arms,6,2,4
48500,Negrolas,nemesis,192,warrior,arms,6,2,4
48501,Nabii,tichondrius,192,warrior,arms,6,2,4
48502,Jírky,ragnaros,192,warrior,arms,6,2,4
48503,Aquaknight,tortheldrin,192,warrior,arms,6,2,4
48504,Bradic,bladefist,192,warrior,arms,6,2,4
48505,Rekshor,wyrmrest-accord,192,warrior,arms,6,2,4
48506,Jéshka,wyrmrest-accord,192,warrior,arms,6,2,4
48507,Uprisèn,illidan,192,warrior,arms,6,2,4
48508,Guroku,tichondrius,192,warrior,arms,6,2,4
48509,Chapa,tichondrius,192,warrior,arms,6,2,4
48510,Jessicajinn,illidan,192,warrior,arms,6,2,4
48511,Hildibrawn,stormrage,192,warrior,arms,6,2,4
48512,Wooglinx,stormrage,192,warrior,arms,6,2,4
48513,Lhariza,stormrage,192,warrior,arms,6,2,4
48514,Primørdíal,tichondrius,192,warrior,arms,6,2,4
48515,Stinkdog,khazgoroth,192,warrior,arms,6,2,4
48516,Tüssèll,khazgoroth,192,warrior,arms,6,2,4
48517,Rambð,illidan,192,warrior,arms,6,2,4
48518,Kvnñ,frostmourne,192,warrior,arms,6,2,4
48519,Dalmor,stormrage,192,warrior,arms,6,2,4
48520,Wakkawar,stormrage,192,warrior,arms,6,2,4
48521,Smokingops,frostmourne,192,warrior,arms,6,2,4
48522,Yeèzy,stormrage,192,warrior,arms,6,2,4
48523,Tarkvs,ragnaros,192,warrior,arms,6,2,4
48524,Pookythebear,tichondrius,192,warrior,arms,6,2,4
48525,Stormbadge,tichondrius,192,warrior,arms,6,2,4
48526,Agoge,stormrage,192,warrior,arms,6,2,4
48527,Raldoron,thrall,192,warrior,arms,6,2,4
48528,Reginato,ravenholdt,192,warrior,arms,6,2,4
48529,Pisagnòmos,quelthalas,192,warrior,arms,6,2,4
48530,Demonsterz,ravenholdt,192,warrior,arms,6,2,4
48531,Hagger,quelthalas,192,warrior,arms,6,2,4
48532,Bjorgsen,frostmourne,192,warrior,arms,6,2,4
48533,Stebe,thunderlord,192,warrior,arms,6,2,4
48534,Mongofiera,quelthalas,192,warrior,arms,6,2,4
48535,Trenbopanda,tichondrius,192,warrior,arms,6,2,4
48536,Pippysmallz,tichondrius,192,warrior,arms,6,2,4
48537,Twinktop,tichondrius,192,warrior,arms,6,2,4
48538,Dahakawar,malganis,192,warrior,arms,6,2,4
48539,Ychazz,stormrage,192,warrior,arms,6,2,4
48540,Kratøz,tichondrius,192,warrior,arms,6,2,4
48541,Sypii,malganis,192,warrior,arms,6,2,4
48542,Irondefense,thrall,192,warrior,arms,6,2,4
48543,Enzothebaker,thrall,192,warrior,arms,6,2,4
48544,Pép,malganis,192,warrior,arms,6,2,4
48545,Shain,thrall,192,warrior,arms,6,2,4
48546,Maxalyss,stormrage,192,warrior,arms,6,2,4
48547,Jäëgër,moon-guard,192,warrior,arms,6,2,4
48548,Brenrainn,thrall,192,warrior,arms,6,2,4
48549,Risr,illidan,192,warrior,arms,6,2,4
48550,Titanwarr,malganis,192,warrior,arms,6,2,4
48551,Nachobeef,illidan,192,warrior,arms,6,2,4
48552,Humansmash,thrall,192,warrior,arms,6,2,4
48553,Digitalfear,malganis,192,warrior,arms,6,2,4
48554,Icebringer,frostmourne,192,warrior,arms,6,2,4
48555,Girei,ghostlands,192,warrior,arms,6,2,4
48556,Threg,malganis,192,warrior,arms,6,2,4
48557,Donni,kelthuzad,192,warrior,arms,6,2,4
48558,Lazarenthus,stormrage,192,warrior,arms,6,2,4
48559,Aavyrre,moon-guard,192,warrior,arms,6,2,4
48560,Verwischen,zuljin,192,warrior,arms,6,2,4
48561,Mahknut,moon-guard,192,warrior,arms,6,2,4
48562,Suavay,executus,192,warrior,arms,6,2,4
48563,Smeshyou,kelthuzad,192,warrior,arms,6,2,4
48564,Chura,kiljaeden,192,warrior,arms,6,2,4
48565,Squonks,kelthuzad,192,warrior,arms,6,2,4
48566,Ronipastrami,kelthuzad,192,warrior,arms,6,2,4
48567,Tinykong,zuljin,192,warrior,arms,6,2,4
48568,Zerríck,moon-guard,192,warrior,arms,6,2,4
48569,Lavablood,moon-guard,192,warrior,arms,6,2,4
48570,Gageoddord,kiljaeden,192,warrior,arms,6,2,4
48571,Rí,moon-guard,192,warrior,arms,6,2,4
48572,Mochigome,moon-guard,192,warrior,arms,6,2,4
48573,Braxxinn,tichondrius,192,warrior,arms,6,2,4
48574,Fäey,dalaran,192,warrior,arms,6,2,4
48575,Bonetotem,azralon,192,warrior,arms,6,2,4
48576,Sylvannlee,tichondrius,192,warrior,arms,6,2,4
48577,Lilfookur,dalaran,192,warrior,arms,6,2,4
48578,Deloum,tichondrius,192,warrior,arms,6,2,4
48579,Tanksbad,lightnings-blade,192,warrior,arms,6,2,4
48580,Stavsie,tichondrius,192,warrior,arms,6,2,4
48581,Adonis,burning-blade,192,warrior,arms,6,2,4
48582,Xurug,zuljin,192,warrior,arms,6,2,4
48583,Skalvi,moon-guard,192,warrior,arms,6,2,4
48584,Disturbed,velen,192,warrior,arms,6,2,4
48585,Hawaiianko,guldan,192,warrior,arms,6,2,4
48586,Scrubwarrior,black-dragonflight,192,warrior,arms,6,2,4
48587,Corazondleón,ragnaros,192,warrior,arms,6,2,4
48588,Fùzzy,zuluhed,192,warrior,arms,6,2,4
48589,Dodiru,azralon,192,warrior,arms,6,2,4
48590,Ningz,tichondrius,192,warrior,arms,6,2,4
48591,Papichoppyme,bleeding-hollow,192,warrior,arms,6,2,4
48592,Orphenkaos,bleeding-hollow,192,warrior,arms,6,2,4
48593,Dreadworld,bleeding-hollow,192,warrior,arms,6,2,4
48594,Rekitralph,tichondrius,192,warrior,arms,6,2,4
48595,Noblêsix,dalaran,192,warrior,arms,6,2,4
48596,Shiestyzug,tichondrius,192,warrior,arms,6,2,4
48597,Nerffrogues,stormrage,192,warrior,arms,6,2,4
48598,Nordrages,stormrage,192,warrior,arms,6,2,4
48599,Hellabandz,bleeding-hollow,192,warrior,arms,6,2,4
48600,Burstful,bleeding-hollow,192,warrior,arms,6,2,4
48601,Tormite,spirestone,192,warrior,arms,6,2,4
48602,Iapologiz,illidan,192,warrior,arms,6,2,4
48603,Pollere,firetree,192,warrior,arms,6,2,4
48604,Befòx,tichondrius,192,warrior,arms,6,2,4
48605,Shrexecute,tichondrius,192,warrior,arms,6,2,4
48606,Saltycrakerz,area-52,192,warrior,arms,6,2,4
48607,Danskmand,tichondrius,192,warrior,arms,6,2,4
48608,Hookahmasta,area-52,192,warrior,arms,6,2,4
48609,Loudnoise,frostwolf,192,warrior,arms,6,2,4
48610,Katre,malorne,192,warrior,arms,6,2,4
48611,Daechoochoo,frostwolf,192,warrior,arms,6,2,4
48612,Moosoka,malorne,192,warrior,arms,6,2,4
48613,Hbbaboy,nagrand,192,warrior,arms,6,2,4
48614,Gátzú,ragnaros,192,warrior,arms,6,2,4
48615,Passionjar,bleeding-hollow,192,warrior,arms,6,2,4
48616,Overlordz,azralon,192,warrior,arms,6,2,4
48617,Jakelope,proudmoore,192,warrior,arms,6,2,4
48618,Deldramor,proudmoore,192,warrior,arms,6,2,4
48619,Gâbríel,maiev,192,warrior,arms,6,2,4
48620,Riggs,stonemaul,192,warrior,arms,6,2,4
48621,Luchonamøm,ragnaros,192,warrior,arms,6,2,4
48622,Hurricán,tichondrius,192,warrior,arms,6,2,4
48623,Guanabacoa,area-52,192,warrior,arms,6,2,4
48624,Akaínu,area-52,192,warrior,arms,6,2,4
48625,Vamsx,barthilas,192,warrior,arms,6,2,4
48626,Chrizo,area-52,192,warrior,arms,6,2,4
48627,Vegr,queldorei,192,warrior,arms,6,2,4
48628,Èxecutè,area-52,192,warrior,arms,6,2,4
48629,Gtrain,barthilas,192,warrior,arms,6,2,4
48630,Annubiis,tichondrius,192,warrior,arms,6,2,4
48631,Swolthelas,tichondrius,192,warrior,arms,6,2,4
48632,Joelyyonerr,barthilas,192,warrior,arms,6,2,4
48633,Spaceshuttle,bleeding-hollow,192,warrior,arms,6,2,4
48634,Drtbag,tichondrius,192,warrior,arms,6,2,4
48635,Soldiër,proudmoore,192,warrior,arms,6,2,4
48636,Relaxnerdlol,antonidas,192,warrior,arms,6,2,4
48637,Airolol,tichondrius,192,warrior,arms,6,2,4
48638,Fealix,moon-guard,192,warrior,arms,6,2,4
48639,Smokinlean,chogall,192,warrior,arms,6,2,4
48640,Pendrake,proudmoore,192,warrior,arms,6,2,4
48641,Slamzftw,stormreaver,192,warrior,arms,6,2,4
48642,Annihilataur,blackhand,192,warrior,arms,6,2,4
48643,Obama,chogall,192,warrior,arms,6,2,4
48644,Bogii,area-52,192,warrior,arms,6,2,4
48645,Thresdan,emerald-dream,192,warrior,arms,6,2,4
48646,Tnknspnk,magtheridon,192,warrior,arms,6,2,4
48647,Lgnasty,area-52,192,warrior,arms,6,2,4
48648,Çampbêll,area-52,192,warrior,arms,6,2,4
48649,Playbox,area-52,192,warrior,arms,6,2,4
48650,Sorty,emerald-dream,192,warrior,arms,6,2,4
48651,Kinaed,durotan,192,warrior,arms,6,2,4
48652,Krongarr,area-52,192,warrior,arms,6,2,4
48653,Fetalalcohol,illidan,192,warrior,arms,6,2,4
48654,Bbyzugga,kelthuzad,192,warrior,arms,6,2,4
48655,Revinth,sargeras,192,warrior,arms,6,2,4
48656,Yeicomoon,ragnaros,192,warrior,arms,6,2,4
48657,Baynn,frostmourne,192,warrior,arms,6,2,4
48658,Deseroth,sargeras,192,warrior,arms,6,2,4
48659,Enelsita,sargeras,192,warrior,arms,6,2,4
48660,Alppha,emerald-dream,192,warrior,arms,6,2,4
48661,Xtrego,quelthalas,192,warrior,arms,6,2,4
48662,Berserkchow,sargeras,192,warrior,arms,6,2,4
48663,Oow,barthilas,192,warrior,arms,6,2,4
48664,Fugmaface,sargeras,192,warrior,arms,6,2,4
48665,Hellizzy,sargeras,192,warrior,arms,6,2,4
48666,Donpepe,sargeras,192,warrior,arms,6,2,4
48667,Plugz,sargeras,192,warrior,arms,6,2,4
48668,Oðín,emerald-dream,192,warrior,arms,6,2,4
48669,Lopotron,sargeras,192,warrior,arms,6,2,4
48670,Zekken,blades-edge,192,warrior,arms,6,2,4
48671,Valky,sargeras,192,warrior,arms,6,2,4
48672,Rassius,sargeras,192,warrior,arms,6,2,4
48673,Oneeyewille,sargeras,192,warrior,arms,6,2,4
48674,Suhwoosh,bleeding-hollow,192,warrior,arms,10,3,7
48675,Sinenrs,tichondrius,192,warrior,arms,8,2,6
48676,Xavíerus,tichondrius,192,warrior,arms,9,2,7
48677,Hiddensquids,laughing-skull,192,warrior,arms,11,2,9
48678,Brutaltruth,dragonmaw,192,warrior,arms,12,2,10
48679,Kaimera,echo-isles,192,warrior,arms,12,2,10
48680,Connero,stormrage,192,warrior,arms,12,2,10
48681,Loktaromoose,frostmourne,192,warrior,arms,12,2,10
48682,Avondwella,undermine,192,warrior,arms,12,2,10
48683,Erwin,kiljaeden,192,warrior,arms,12,2,10
48684,Pennyonebutt,barthilas,192,warrior,arms,12,2,10
48685,Twoironfist,azralon,192,warrior,arms,12,2,10
48686,Rios,jubeithos,192,warrior,arms,12,2,10
48687,Hellswine,barthilas,192,warrior,arms,12,2,10
48688,Ragekilla,silvermoon,192,warrior,arms,12,2,10
48689,Ohhgeekush,proudmoore,192,warrior,arms,12,2,10
48690,Goretooth,moon-guard,192,warrior,arms,12,2,10
48691,Gambii,moon-guard,192,warrior,arms,12,2,10
48692,Haruq,tichondrius,192,warrior,arms,12,2,10
48693,Cleaver,draka,192,warrior,arms,12,2,10
48694,Aymadommy,illidan,192,warrior,arms,12,2,10
48695,Item,nerzhul,192,warrior,arms,12,2,10
48696,Arthurston,tichondrius,192,warrior,arms,12,2,10
48697,Lawlstørm,stormrage,192,warrior,arms,12,2,10
48698,Jsl,tichondrius,192,warrior,arms,12,2,10
48699,Gornal,sargeras,192,warrior,arms,12,2,10
48700,Léonwow,tichondrius,192,warrior,arms,12,2,10
48701,Råging,area-52,192,warrior,arms,12,2,10
48702,Loveliuna,illidan,192,warrior,arms,12,2,10
48703,Warmachîne,area-52,192,warrior,arms,12,2,10
48704,Spårtacus,illidan,192,warrior,arms,12,2,10
48705,Bearyfresh,area-52,192,warrior,arms,12,2,10
48706,Annyan,ragnaros,192,warrior,arms,12,2,10
48707,Alvitr,kelthuzad,192,warrior,arms,12,2,10
48708,Damadar,malganis,192,warrior,arms,12,2,10
48709,Warhoofz,malganis,192,warrior,arms,12,2,10
48710,Bronkyaf,hyjal,192,warrior,arms,12,2,10
48711,Kurzix,crushridge,192,warrior,arms,12,2,10
48712,Lawyer,quelthalas,192,warrior,arms,12,2,10
48713,Humminity,quelthalas,192,warrior,arms,14,2,12
48714,Schecterguy,stormrage,192,warrior,arms,14,2,12
48715,Fallensoul,nazjatar,192,warrior,arms,14,2,12
48716,Blackkcow,zuljin,191,warrior,arms,6,2,4
48717,Deathhit,barthilas,191,warrior,arms,6,2,4
48718,Edrelang,bronzebeard,191,warrior,arms,6,2,4
48719,Hazell,gundrak,191,warrior,arms,6,2,4
48720,Krátös,farstriders,191,warrior,arms,6,2,4
48721,Bunedau,azgalor,191,warrior,arms,12,2,10
48722,Nanaru,tichondrius,180,warrior,arms,20,6,14
48723,Hornsolo,archimonde,175,warrior,arms,11,2,9
48724,Hemmy,kilrogg,175,warrior,arms,11,2,9
48725,Ybsorc,kelthuzad,160,warrior,arms,10,2,8
48726,Swordblood,ragnaros,159,warrior,arms,5,2,3
48727,Notoriousmmà,illidan,159,warrior,arms,5,2,3
48728,Gontore,thrall,159,warrior,arms,5,2,3
48729,Trevvel,proudmoore,159,warrior,arms,5,2,3
48730,Kellsbro,hyjal,159,warrior,arms,5,2,3
48731,Vapyr,moon-guard,159,warrior,arms,5,2,3
48732,Wyerlyn,illidan,159,warrior,arms,5,2,3
48733,Eatscrayons,barthilas,159,warrior,arms,11,2,9
48734,Czartacus,dalaran,144,warrior,arms,3,3,0
48735,Liftedgainz,stormreaver,144,warrior,arms,3,3,0
48736,Fatbarstard,jubeithos,138,warrior,arms,10,3,7
48737,Strongtall,tichondrius,138,warrior,arms,12,3,9
48738,Scottie,cairne,136,warrior,arms,7,3,4
48739,Clarityw,illidan,128,warrior,arms,4,2,2
48740,Nosors,kelthuzad,128,warrior,arms,4,2,2
48741,Stunahh,bleeding-hollow,128,warrior,arms,4,2,2
48742,Eatmyblade,wyrmrest-accord,128,warrior,arms,10,2,8
48743,Berserko,gurubashi,112,warrior,arms,7,2,5
48744,Seariphim,lothar,105,warrior,arms,9,4,5
48745,Ragemane,illidan,96,warrior,arms,3,2,1
48746,Kevs,sargeras,96,warrior,arms,3,2,1
48747,Ryuulion,proudmoore,96,warrior,arms,3,2,1
48748,Biggieth,sargeras,96,warrior,arms,9,2,7
48749,Deathislovê,moonrunner,96,warrior,arms,6,1,5
48750,Ivadell,stormrage,96,warrior,arms,6,1,5
48751,Faintswar,stormrage,96,warrior,arms,6,1,5
48752,Elodié,stormrage,96,warrior,arms,6,1,5
48753,Einoch,stormrage,96,warrior,arms,6,1,5
48754,Galaxywar,stormrage,96,warrior,arms,6,1,5
48755,Betsisword,stormrage,96,warrior,arms,6,1,5
48756,Striphex,trollbane,96,warrior,arms,6,1,5
48757,Meytuglin,stormrage,96,warrior,arms,6,1,5
48758,Codey,stormrage,96,warrior,arms,6,1,5
48759,Jimhoffa,bonechewer,96,warrior,arms,6,1,5
48760,Shadowswar,tichondrius,96,warrior,arms,6,1,5
48761,Myc,zuljin,96,warrior,arms,6,1,5
48762,Luckstang,zuljin,96,warrior,arms,6,1,5
48763,Charcharbinx,zuljin,96,warrior,arms,6,1,5
48764,Skärz,azshara,96,warrior,arms,6,1,5
48765,Klobnslob,mannoroth,96,warrior,arms,6,1,5
48766,Zørg,bleeding-hollow,96,warrior,arms,6,1,5
48767,Rarityw,tichondrius,96,warrior,arms,6,1,5
48768,Bootysmelly,mannoroth,96,warrior,arms,6,1,5
48769,Weechubber,bleeding-hollow,96,warrior,arms,6,1,5
48770,Dokoba,bleeding-hollow,96,warrior,arms,6,1,5
48771,Solsirrior,tichondrius,96,warrior,arms,6,1,5
48772,Selockclap,bleeding-hollow,96,warrior,arms,6,1,5
48773,Akoro,bleeding-hollow,96,warrior,arms,6,1,5
48774,Kboyrage,sargeras,96,warrior,arms,6,1,5
48775,Beastro,rexxar,96,warrior,arms,6,1,5
48776,Cloudsmash,arthas,96,warrior,arms,6,1,5
48777,Noctrelor,sargeras,96,warrior,arms,6,1,5
48778,Adav,arthas,96,warrior,arms,6,1,5
48779,Durseyturm,area-52,96,warrior,arms,6,1,5
48780,Aidenwr,area-52,96,warrior,arms,6,1,5
48781,Goywarr,illidan,96,warrior,arms,6,1,5
48782,Dragginball,garrosh,96,warrior,arms,6,1,5
48783,Roxesc,area-52,96,warrior,arms,6,1,5
48784,Morotak,area-52,96,warrior,arms,6,1,5
48785,Draann,kirin-tor,96,warrior,arms,6,1,5
48786,Shagstrike,azralon,96,warrior,arms,6,1,5
48787,Gordurin,akama,96,warrior,arms,6,1,5
48788,Doriax,sentinels,96,warrior,arms,6,1,5
48789,Ghaladir,area-52,96,warrior,arms,6,1,5
48790,Gromhell,azralon,96,warrior,arms,6,1,5
48791,Soymong,frostmourne,96,warrior,arms,6,1,5
48792,Kado,zuluhed,96,warrior,arms,6,1,5
48793,Immortal,icecrown,96,warrior,arms,6,1,5
48794,Notacop,malygos,96,warrior,arms,6,1,5
48795,Warrmachine,scarlet-crusade,96,warrior,arms,6,1,5
48796,Airwick,kelthuzad,96,warrior,arms,6,1,5
48797,Xeno,steamwheedle-cartel,96,warrior,arms,6,1,5
48798,Heyzulnut,whisperwind,96,warrior,arms,6,1,5
48799,Ästen,kargath,96,warrior,arms,6,1,5
48800,Beatstickz,malganis,96,warrior,arms,6,1,5
48801,Wàrrðèémzý,frostmourne,96,warrior,arms,6,1,5
48802,Nibones,malganis,96,warrior,arms,6,1,5
48803,Uub,malganis,96,warrior,arms,6,1,5
48804,Nerolanast,wyrmrest-accord,96,warrior,arms,6,1,5
48805,Paralyzed,malganis,96,warrior,arms,6,1,5
48806,Darkromel,quelthalas,96,warrior,arms,6,1,5
48807,Jimpepega,quelthalas,96,warrior,arms,6,1,5
48808,Lifaen,zangarmarsh,96,warrior,arms,6,1,5
48809,Joetempest,azralon,96,warrior,arms,6,1,5
48810,Áres,spinebreaker,96,warrior,arms,6,1,5
48811,Morlu,alleria,96,warrior,arms,6,1,5
48812,Rasazghal,darrowmere,96,warrior,arms,6,1,5
48813,Nyaner,quelthalas,96,warrior,arms,6,1,5
48814,Horahloux,ragnaros,96,warrior,arms,6,1,5
48815,Facekilla,nordrassil,96,warrior,arms,6,1,5
48816,Darkmagno,ragnaros,96,warrior,arms,6,1,5
48817,Silverdeadl,ragnaros,96,warrior,arms,6,1,5
48818,Kevinersaa,frostmourne,96,warrior,arms,6,1,5
48819,Mikachero,ragnaros,96,warrior,arms,6,1,5
48820,Racsorr,ragnaros,96,warrior,arms,6,1,5
48821,Däger,ragnaros,96,warrior,arms,6,1,5
48822,Gärroshh,ragnaros,96,warrior,arms,6,1,5
48823,Fréäkk,ragnaros,96,warrior,arms,6,1,5
48824,Flexxinpapi,exodar,96,warrior,arms,6,1,5
48825,Sweetlove,akama,96,warrior,arms,6,1,5
48826,Mauler,medivh,96,warrior,arms,6,1,5
48827,Shelbyqt,azralon,96,warrior,arms,6,1,5
48828,Meleth,darkspear,96,warrior,arms,6,1,5
48829,Hergo,spirestone,96,warrior,arms,6,1,5
48830,Õctane,thrall,96,warrior,arms,6,1,5
48831,Beenbag,aerie-peak,96,warrior,arms,6,1,5
48832,Grosjambes,turalyon,96,warrior,arms,6,1,5
48833,Hadrum,turalyon,96,warrior,arms,6,1,5
48834,Geontage,drakkari,96,warrior,arms,6,1,5
48835,Blitzkrieegz,drakkari,96,warrior,arms,6,1,5
48836,Jazz,frostwolf,96,warrior,arms,6,1,5
48837,Nelfmoehawk,barthilas,96,warrior,arms,6,1,5
48838,Abaton,wyrmrest-accord,96,warrior,arms,6,1,5
48839,Rage,tanaris,96,warrior,arms,6,1,5
48840,Warbomb,thrall,96,warrior,arms,6,1,5
48841,Nicrose,hyjal,96,warrior,arms,6,1,5
48842,Regax,thrall,96,warrior,arms,6,1,5
48843,Kargan,thrall,96,warrior,arms,6,1,5
48844,Maxtavius,baelgun,96,warrior,arms,6,1,5
48845,Gouzizhang,proudmoore,96,warrior,arms,6,1,5
48846,Ghostierip,illidan,96,warrior,arms,6,1,5
48847,Brigandier,shattered-hand,96,warrior,arms,6,1,5
48848,Dikesrus,tichondrius,96,warrior,arms,6,1,5
48849,Bobisyourmom,tichondrius,96,warrior,arms,6,1,5
48850,Dogmar,moon-guard,96,warrior,arms,6,1,5
48851,Zépileque,azralon,96,warrior,arms,6,1,5
48852,Yongvi,tichondrius,96,warrior,arms,6,1,5
48853,Wartrué,tichondrius,96,warrior,arms,6,1,5
48854,Xalë,tichondrius,96,warrior,arms,6,1,5
48855,Wolurog,emerald-dream,96,warrior,arms,6,1,5
48856,Soughloe,illidan,96,warrior,arms,6,1,5
48857,Atomicboxer,tichondrius,96,warrior,arms,6,1,5
48858,Blacken,tichondrius,96,warrior,arms,6,1,5
48859,Erhue,sargeras,96,warrior,arms,6,1,5
48860,Jiva,emerald-dream,96,warrior,arms,6,1,5
48861,Smoogzz,tichondrius,96,warrior,arms,6,1,5
48862,Glonzito,tichondrius,96,warrior,arms,6,1,5
48863,Cursedogre,tichondrius,96,warrior,arms,6,1,5
48864,Sosaw,moon-guard,96,warrior,arms,6,1,5
48865,Vhagaar,emerald-dream,96,warrior,arms,6,1,5
48866,Mezw,tichondrius,96,warrior,arms,6,1,5
48867,Tfd,tichondrius,96,warrior,arms,6,1,5
48868,Rambovix,tichondrius,96,warrior,arms,6,1,5
48869,Wienertoes,tichondrius,96,warrior,arms,6,1,5
48870,Bigwarrior,stonemaul,96,warrior,arms,6,1,5
48871,Bestgrunt,tichondrius,96,warrior,arms,6,1,5
48872,Jennatolls,boulderfist,96,warrior,arms,6,1,5
48873,Sver,dalaran,96,warrior,arms,6,1,5
48874,Vlix,korgath,96,warrior,arms,6,1,5
48875,Dezeran,tichondrius,96,warrior,arms,6,1,5
48876,Berawar,tichondrius,96,warrior,arms,6,1,5
48877,Edariana,dalaran,96,warrior,arms,6,1,5
48878,Droggo,cenarius,96,warrior,arms,6,1,5
48879,Cindabotica,sargeras,96,warrior,arms,6,1,5
48880,Eightballerz,barthilas,96,warrior,arms,6,1,5
48881,Mechagodzila,kiljaeden,96,warrior,arms,6,1,5
48882,Nukefrmorbit,dalaran,96,warrior,arms,6,1,5
48883,Cainne,proudmoore,96,warrior,arms,6,1,5
48884,Kåyotix,proudmoore,96,warrior,arms,6,1,5
48885,Tangö,barthilas,96,warrior,arms,6,1,5
48886,Olavson,proudmoore,96,warrior,arms,6,1,5
48887,Braygar,barthilas,96,warrior,arms,6,1,5
48888,Bhuppzz,barthilas,96,warrior,arms,6,1,5
48889,Äléx,frostmourne,96,warrior,arms,7,1,6
48890,Sangettsu,stormrage,96,warrior,arms,8,1,7
48891,Maat,blood-furnace,96,warrior,arms,8,1,7
48892,Ruinsteel,area-52,96,warrior,arms,8,1,7
48893,Ogrimir,moon-guard,96,warrior,arms,9,1,8
48894,Baozz,frostmourne,96,warrior,arms,12,1,11
48895,Njalulfhild,korgath,96,warrior,arms,12,1,11
48896,Babyfelix,tichondrius,96,warrior,arms,12,1,11
48897,Integrâl,tichondrius,96,warrior,arms,12,1,11
48898,Falkur,amanthul,96,warrior,arms,12,1,11
48899,Drdalidou,zuljin,96,warrior,arms,12,1,11
48900,Cartou,stormscale,96,warrior,arms,12,1,11
48901,Meelehard,zuljin,96,warrior,arms,12,1,11
48902,Drarn,norgannon,96,warrior,arms,12,1,11
48903,Wmuuzh,quelthalas,96,warrior,arms,12,1,11
48904,Odyssey,vashj,96,warrior,arms,12,1,11
48905,Berzerk,dentarg,96,warrior,arms,12,1,11
48906,Semyus,ragnaros,96,warrior,arms,12,1,11
48907,Bushwook,emerald-dream,96,warrior,arms,12,1,11
48908,Roxon,hellscream,79,warrior,arms,5,1,4
48909,Psykd,arathor,79,warrior,arms,5,1,4
48910,Rokmok,frostmane,79,warrior,arms,5,1,4
48911,Keringan,stormrage,79,warrior,arms,5,1,4
48912,Naindejardin,sargeras,79,warrior,arms,5,1,4
48913,Savagetko,illidan,79,warrior,arms,5,1,4
48914,Hexenwolf,moon-guard,79,warrior,arms,5,1,4
48915,Sniperbeer,sargeras,64,warrior,arms,4,1,3
48916,Garrossh,thunderhorn,64,warrior,arms,4,1,3
48917,Boorabill,stormrage,63,warrior,arms,2,2,0
48918,Warriorba,tichondrius,48,warrior,arms,3,1,2
48919,Thewarrior,tichondrius,48,warrior,arms,3,1,2
48920,Haveya,ghostlands,48,warrior,arms,3,1,2
48921,Foldrak,quelthalas,48,warrior,arms,3,1,2
48922,Critnectar,aggramar,48,warrior,arms,3,1,2
48923,Rumka,draktharon,42,warrior,arms,6,2,4
48924,Ghostkin,ragnaros,42,warrior,arms,7,2,5
48925,Reignwolf,azralon,42,warrior,arms,7,2,5
48926,Trôca,ragnaros,42,warrior,arms,8,2,6
48927,Danielss,ragnaros,42,warrior,arms,12,2,10
48928,Flandiz,sargeras,31,warrior,arms,2,1,1
48929,Nicked,azralon,31,warrior,arms,2,1,1
48930,Billy,area-52,31,warrior,arms,2,1,1
48931,Mantiflash,stormrage,31,warrior,arms,2,1,1
48932,Valuxia,sargeras,16,warrior,arms,1,1,0
48933,Zachw,stormrage,16,warrior,arms,1,1,0
48934,Shwutty,stormrage,16,warrior,arms,1,1,0
48935,Goodidea,mannoroth,16,warrior,arms,1,1,0
48936,Americanbull,moon-guard,1455,warrior,protection,62,34,28
48937,Percaderp,barthilas,1242,warrior,protection,33,18,15
48938,Graventhal,tichondrius,1192,warrior,protection,53,25,28
48939,Thororan,whisperwind,845,warrior,protection,27,10,17
48940,Appolyonn,hyjal,836,warrior,protection,43,17,26
48941,Logan,twisting-nether,705,warrior,protection,44,12,32
48942,Nansitao,kelthuzad,668,warrior,protection,24,7,17
48943,Ghostoffury,thrall,574,warrior,protection,12,6,6
48944,Stophitingme,bloodscalp,469,warrior,protection,18,5,13
48945,Ksubîî,frostmourne,448,warrior,protection,16,5,11
48946,Smelldrglove,frostmourne,443,warrior,protection,11,5,6
48947,Dabdaddyy,dawnbringer,384,warrior,protection,6,4,2
48948,Kidkolby,moon-guard,384,warrior,protection,12,4,8
48949,Rhuk,drakkari,383,warrior,protection,24,4,20
48950,Manthraxx,sargeras,288,warrior,protection,6,3,3
48951,Chàrr,crushridge,288,warrior,protection,15,4,11
48952,Meadier,windrunner,286,warrior,protection,6,3,3
48953,Toothnnailz,destromath,284,warrior,protection,12,3,9
48954,Tåra,area-52,256,warrior,protection,22,3,19
48955,Stowdace,bladefist,239,warrior,protection,5,3,2
48956,Lagurtz,ragnaros,192,warrior,protection,6,2,4
48957,Executespam,madoran,192,warrior,protection,6,2,4
48958,Loonycity,arygos,192,warrior,protection,12,2,10
48959,Littlefatman,terokkar,192,warrior,protection,12,2,10
48960,Fearless,moon-guard,96,warrior,protection,6,1,5
48961,Varith,sargeras,96,warrior,protection,12,1,11
48962,Jindyn,boulderfist,95,warrior,protection,6,1,5
48963,Axiyum,tichondrius,79,warrior,protection,5,1,4
48964,Juicey,burning-blade,31,warrior,protection,2,1,1
