name,realm,rating,cls,spec,play,win,lose
Phearbunny,bleeding-hollow,1469,deathknight,blood,66,32,34
Pagumon,moon-guard,1421,deathknight,blood,126,65,61
Bloodbukkaky,bleeding-hollow,1201,deathknight,blood,42,13,29
Tiumau,goldrinn,1088,deathknight,blood,54,23,31
Tragül,sargeras,1012,deathknight,blood,36,16,20
Valind,eredar,854,deathknight,blood,18,9,9
Kult,azralon,841,deathknight,blood,12,9,3
Insonne,dalaran,837,deathknight,blood,18,9,9
Réndwarchièf,garrosh,749,deathknight,blood,15,9,6
Blasphemus,malganis,575,deathknight,blood,12,6,6
Kaîne,dalaran,480,deathknight,blood,12,5,7
Belfknightt,area-52,479,deathknight,blood,15,5,10
Tristam,area-52,384,deathknight,blood,6,4,2
Pride,ragnaros,384,deathknight,blood,12,4,8
He,echo-isles,383,deathknight,blood,6,4,2
ßläzë,baelgun,288,deathknight,blood,15,4,11
Kimbøslîce,area-52,288,deathknight,blood,12,3,9
Neroxzdvm,area-52,192,deathknight,blood,6,2,4
Cerbeefquake,wyrmrest-accord,192,deathknight,blood,12,2,10
Eteson,tichondrius,191,deathknight,blood,6,2,4
Unhølydøøm,misha,191,deathknight,blood,12,2,10
Lunatick,darkspear,96,deathknight,blood,6,1,5
Gnargnarr,firetree,96,deathknight,blood,6,1,5
Wowattorney,tichondrius,96,deathknight,blood,6,1,5
Cozzasad,barthilas,96,deathknight,blood,6,1,5
Nbayoungboy,kiljaeden,96,deathknight,blood,6,1,5
Determinate,deathwing,96,deathknight,blood,6,1,5
Hulmorr,bleeding-hollow,64,deathknight,blood,4,1,3
Zerhistran,proudmoore,64,deathknight,blood,4,1,3
Graphics,moon-guard,2125,deathknight,unholy,382,194,188
Pwaff,illidan,2125,deathknight,unholy,89,45,44
Neroxz,area-52,2105,deathknight,unholy,83,43,40
Qipara,zuljin,2104,deathknight,unholy,163,87,76
Partywaffles,illidan,2079,deathknight,unholy,259,133,126
Spaidzz,malganis,2076,deathknight,unholy,199,100,99
Níngjìng,tichondrius,2074,deathknight,unholy,84,43,41
Flarkness,area-52,2010,deathknight,unholy,78,37,41
Búddy,zuljin,1992,deathknight,unholy,94,45,49
Achílles,sargeras,1979,deathknight,unholy,175,85,90
Scriptløl,sargeras,1975,deathknight,unholy,138,66,72
Roidboy,illidan,1954,deathknight,unholy,115,57,58
Vineyard,area-52,1942,deathknight,unholy,287,143,144
Toxicwaste,malganis,1942,deathknight,unholy,82,39,43
Juelzjerk,tichondrius,1918,deathknight,unholy,101,54,47
Mårlbørø,tichondrius,1915,deathknight,unholy,41,21,20
Darkdj,kelthuzad,1914,deathknight,unholy,73,34,39
Éternalnight,tichondrius,1913,deathknight,unholy,76,32,44
Zynyzter,malganis,1912,deathknight,unholy,72,41,31
Veilsidé,kelthuzad,1910,deathknight,unholy,250,125,125
Killinois,tichondrius,1910,deathknight,unholy,47,21,26
Brutos,thrall,1905,deathknight,unholy,98,55,43
Geomdae,tichondrius,1901,deathknight,unholy,71,31,40
Barelyviable,tichondrius,1898,deathknight,unholy,72,32,40
Pradas,area-52,1897,deathknight,unholy,100,51,49
Dkya,tichondrius,1891,deathknight,unholy,224,113,111
Malhandir,bleeding-hollow,1880,deathknight,unholy,41,23,18
Cardii,area-52,1877,deathknight,unholy,124,63,61
Kilohotel,stormrage,1873,deathknight,unholy,42,25,17
Ilceses,area-52,1870,deathknight,unholy,66,29,37
Catarïa,tichondrius,1869,deathknight,unholy,90,44,46
Iato,sargeras,1868,deathknight,unholy,60,39,21
Drauguss,azralon,1860,deathknight,unholy,106,53,53
Cavaliers,ragnaros,1860,deathknight,unholy,66,32,34
Lattè,area-52,1859,deathknight,unholy,55,30,25
Bloodbruh,blackrock,1854,deathknight,unholy,60,34,26
Tduggylolz,tichondrius,1851,deathknight,unholy,60,26,34
Bedstains,thunderlord,1850,deathknight,unholy,113,64,49
Morbiddesire,stormrage,1849,deathknight,unholy,87,49,38
Ceomdae,tichondrius,1849,deathknight,unholy,60,29,31
Didri,quelthalas,1846,deathknight,unholy,72,34,38
Nixonxx,tichondrius,1843,deathknight,unholy,94,58,36
Tokyotimxx,malganis,1842,deathknight,unholy,48,30,18
Azhid,tichondrius,1841,deathknight,unholy,130,70,60
Cloüd,wyrmrest-accord,1841,deathknight,unholy,64,31,33
Bicepsüal,zuljin,1840,deathknight,unholy,36,28,8
Bruceleedk,tichondrius,1839,deathknight,unholy,100,51,49
Milleh,bleeding-hollow,1838,deathknight,unholy,78,35,43
Riddles,maiev,1837,deathknight,unholy,119,64,55
Blackfyré,sargeras,1837,deathknight,unholy,62,32,30
Haldevarik,doomhammer,1834,deathknight,unholy,78,43,35
Orphanmakerx,area-52,1832,deathknight,unholy,123,60,63
Zerhistran,proudmoore,1831,deathknight,unholy,254,136,118
Goonà,tichondrius,1831,deathknight,unholy,63,29,34
Aurious,lightnings-blade,1830,deathknight,unholy,84,47,37
Kortingert,nagrand,1830,deathknight,unholy,59,33,26
Wøund,black-dragonflight,1830,deathknight,unholy,220,112,108
Anatøly,ragnaros,1827,deathknight,unholy,42,21,21
Soulhand,tichondrius,1826,deathknight,unholy,104,57,47
Arthez,frostmourne,1824,deathknight,unholy,72,38,34
Sadboy,grizzly-hills,1822,deathknight,unholy,65,27,38
Zerøimperial,quelthalas,1821,deathknight,unholy,209,111,98
Altareon,ragnaros,1820,deathknight,unholy,150,79,71
Serwestley,stormrage,1820,deathknight,unholy,59,31,28
Kciktep,tichondrius,1819,deathknight,unholy,36,19,17
Aerd,sargeras,1819,deathknight,unholy,251,126,125
Hrsb,tichondrius,1817,deathknight,unholy,124,68,56
Poesoul,tichondrius,1817,deathknight,unholy,261,131,130
Skideroth,kelthuzad,1817,deathknight,unholy,60,28,32
Hwml,barthilas,1816,deathknight,unholy,93,54,39
Flizzycash,malganis,1816,deathknight,unholy,56,27,29
Õdin,area-52,1815,deathknight,unholy,203,103,100
Wowattorney,tichondrius,1815,deathknight,unholy,82,33,49
Xebane,frostmourne,1812,deathknight,unholy,348,182,166
Ravindrannor,saurfang,1812,deathknight,unholy,65,32,33
Dahnga,frostmourne,1811,deathknight,unholy,54,32,22
Plagueflavor,tichondrius,1811,deathknight,unholy,306,152,154
Fatzilla,tichondrius,1811,deathknight,unholy,66,26,40
Keomdae,tichondrius,1809,deathknight,unholy,59,30,29
Warrcc,steamwheedle-cartel,1809,deathknight,unholy,48,24,24
Evilduck,ragnaros,1808,deathknight,unholy,66,37,29
Infectik,tichondrius,1807,deathknight,unholy,59,35,24
Anhedonía,illidan,1807,deathknight,unholy,162,86,76
Chillbaynê,the-scryers,1807,deathknight,unholy,119,62,57
Jakeboyswag,shandris,1807,deathknight,unholy,143,73,70
Ddibb,tichondrius,1807,deathknight,unholy,57,28,29
Brocigar,tichondrius,1806,deathknight,unholy,84,43,41
Sagadk,hyjal,1806,deathknight,unholy,70,33,37
Necrôtic,area-52,1806,deathknight,unholy,76,35,41
Twindleroot,aggramar,1804,deathknight,unholy,77,45,32
Mûs,tichondrius,1804,deathknight,unholy,66,36,30
Kaeligh,ragnaros,1803,deathknight,unholy,66,29,37
Ziskon,illidan,1802,deathknight,unholy,100,53,47
Zìlêán,tichondrius,1800,deathknight,unholy,70,39,31
Harókz,azralon,1800,deathknight,unholy,65,31,34
Azre,tichondrius,1800,deathknight,unholy,160,74,86
Starshopping,proudmoore,1799,deathknight,unholy,85,41,44
Avengering,tichondrius,1794,deathknight,unholy,75,40,35
Brandonsdk,tichondrius,1794,deathknight,unholy,143,71,72
Muspellheim,azralon,1791,deathknight,unholy,54,29,25
Attack,grizzly-hills,1787,deathknight,unholy,60,28,32
Boneyards,bleeding-hollow,1787,deathknight,unholy,96,43,53
Daoniancc,tichondrius,1784,deathknight,unholy,322,168,154
Nabbiby,tichondrius,1784,deathknight,unholy,72,33,39
Áethros,malganis,1778,deathknight,unholy,96,44,52
Thorediks,stormrage,1777,deathknight,unholy,54,27,27
Skippee,tichondrius,1775,deathknight,unholy,54,24,30
Grimiz,tichondrius,1774,deathknight,unholy,145,71,74
Demonboyjr,tichondrius,1766,deathknight,unholy,75,31,44
Asukka,tichondrius,1763,deathknight,unholy,72,29,43
Apøçálýpsé,firetree,1761,deathknight,unholy,67,35,32
Goonaa,tichondrius,1760,deathknight,unholy,54,27,27
Sinell,kargath,1753,deathknight,unholy,139,75,64
Xiaodabaolol,tichondrius,1751,deathknight,unholy,48,26,22
Stankybreath,bleeding-hollow,1750,deathknight,unholy,58,27,31
Cesaroo,aegwynn,1747,deathknight,unholy,100,49,51
Muspel,sargeras,1746,deathknight,unholy,59,28,31
Standalizer,gilneas,1745,deathknight,unholy,72,40,32
Ermanotruta,azralon,1744,deathknight,unholy,77,37,40
Carryme,quelthalas,1742,deathknight,unholy,92,45,47
Xibbas,illidan,1741,deathknight,unholy,48,27,21
Nh,malganis,1737,deathknight,unholy,54,28,26
Teksurugi,korgath,1734,deathknight,unholy,60,32,28
Zìlêáns,tichondrius,1730,deathknight,unholy,84,50,34
Exaar,tichondrius,1730,deathknight,unholy,63,27,36
Nevermore,hyjal,1727,deathknight,unholy,113,57,56
Arroyo,borean-tundra,1724,deathknight,unholy,54,29,25
Hatrèd,quelthalas,1724,deathknight,unholy,71,36,35
Doombeast,area-52,1722,deathknight,unholy,72,32,40
Ålastor,stormrage,1721,deathknight,unholy,58,32,26
Sussybakadk,sargeras,1718,deathknight,unholy,58,27,31
Nalz,drakkari,1716,deathknight,unholy,135,71,64
Lazarise,area-52,1713,deathknight,unholy,71,34,37
Tkyo,tichondrius,1712,deathknight,unholy,47,22,25
Huuzzha,tichondrius,1706,deathknight,unholy,124,69,55
Komplex,kelthuzad,1705,deathknight,unholy,64,36,28
Volyant,frostmourne,1704,deathknight,unholy,48,22,26
Dâki,blades-edge,1702,deathknight,unholy,108,61,47
Koda,thrall,1701,deathknight,unholy,77,36,41
Justafkdk,gorefiend,1700,deathknight,unholy,84,43,41
Kinkysgnome,tichondrius,1696,deathknight,unholy,131,61,70
Krätos,zuljin,1694,deathknight,unholy,36,23,13
Ðomìnus,moon-guard,1693,deathknight,unholy,96,57,39
Barakhenaku,illidan,1692,deathknight,unholy,36,20,16
Mephostophel,sargeras,1688,deathknight,unholy,168,88,80
Onefire,illidan,1680,deathknight,unholy,59,29,30
Fakiez,kelthuzad,1679,deathknight,unholy,68,30,38
Nevmic,emerald-dream,1677,deathknight,unholy,155,74,81
Falkorn,korgath,1675,deathknight,unholy,69,33,36
Wittlewanka,zuljin,1675,deathknight,unholy,40,18,22
Blacklabel,andorhal,1675,deathknight,unholy,72,31,41
Dunduner,tichondrius,1672,deathknight,unholy,90,44,46
Noik,azralon,1671,deathknight,unholy,87,41,46
Cantmove,area-52,1669,deathknight,unholy,50,22,28
Malhandir,azgalor,1668,deathknight,unholy,54,20,34
Spacealien,malganis,1667,deathknight,unholy,60,32,28
Howdoulose,illidan,1667,deathknight,unholy,48,22,26
Darktone,tichondrius,1665,deathknight,unholy,35,18,17
Slty,tichondrius,1664,deathknight,unholy,42,18,24
Lichtborne,illidan,1662,deathknight,unholy,73,33,40
Azynks,azralon,1660,deathknight,unholy,102,47,55
Ståtìc,tichondrius,1659,deathknight,unholy,78,40,38
Imadkloldie,frostmourne,1659,deathknight,unholy,90,46,44
Bellum,moon-guard,1658,deathknight,unholy,99,56,43
Properterps,bonechewer,1658,deathknight,unholy,122,67,55
Xhoul,sargeras,1658,deathknight,unholy,195,106,89
Bopalop,malganis,1657,deathknight,unholy,69,28,41
Kjarnda,malganis,1653,deathknight,unholy,48,21,27
Yubell,barthilas,1652,deathknight,unholy,275,138,137
Pooseunpoose,velen,1652,deathknight,unholy,84,40,44
Ullísés,ragnaros,1651,deathknight,unholy,45,24,21
Trumps,stormrage,1649,deathknight,unholy,48,27,21
Ludgan,stormrage,1649,deathknight,unholy,180,86,94
Floreon,tichondrius,1648,deathknight,unholy,41,23,18
Lighostx,tichondrius,1647,deathknight,unholy,52,22,30
Merados,quelthalas,1646,deathknight,unholy,79,30,49
Tråuma,uther,1645,deathknight,unholy,42,22,20
Vexxan,thrall,1644,deathknight,unholy,41,23,18
Galarick,area-52,1643,deathknight,unholy,41,22,19
Ligmagooch,tichondrius,1642,deathknight,unholy,87,45,42
Lichanis,bonechewer,1641,deathknight,unholy,60,30,30
Tailm,ragnaros,1639,deathknight,unholy,36,20,16
Billieeilish,sargeras,1638,deathknight,unholy,36,21,15
Dkdanim,tichondrius,1637,deathknight,unholy,130,71,59
Vynox,frostmourne,1637,deathknight,unholy,56,27,29
Khaíne,wyrmrest-accord,1634,deathknight,unholy,175,90,85
Grimmdreamer,stormrage,1634,deathknight,unholy,76,37,39
Søad,quelthalas,1633,deathknight,unholy,94,52,42
Raps,frostmourne,1632,deathknight,unholy,56,23,33
Lùcius,garrosh,1631,deathknight,unholy,154,82,72
Kakarotó,azralon,1629,deathknight,unholy,53,30,23
Fasterjake,sargeras,1629,deathknight,unholy,110,59,51
Zerochillz,sargeras,1628,deathknight,unholy,30,17,13
Kenishii,kiljaeden,1627,deathknight,unholy,48,30,18
Landez,ragnaros,1627,deathknight,unholy,66,37,29
Krargosh,quelthalas,1627,deathknight,unholy,173,89,84
Wastethis,sargeras,1626,deathknight,unholy,71,40,31
Hhasaki,area-52,1626,deathknight,unholy,152,78,74
Paratekdk,thrall,1625,deathknight,unholy,71,39,32
Megatroun,stormreaver,1625,deathknight,unholy,42,23,19
Bladê,tichondrius,1624,deathknight,unholy,61,26,35
Jeremiahe,hyjal,1622,deathknight,unholy,84,45,39
Kwolve,proudmoore,1621,deathknight,unholy,237,118,119
Xraduky,dawnbringer,1620,deathknight,unholy,38,26,12
Gripyourhoe,tichondrius,1619,deathknight,unholy,42,26,16
Elogy,velen,1619,deathknight,unholy,60,34,26
Wheatasil,garona,1618,deathknight,unholy,64,33,31
Ayooplaguez,guldan,1617,deathknight,unholy,42,19,23
Supblood,tichondrius,1614,deathknight,unholy,36,20,16
Drpepp,bleeding-hollow,1614,deathknight,unholy,137,75,62
Kurnoth,barthilas,1614,deathknight,unholy,104,49,55
Boofcigars,sargeras,1612,deathknight,unholy,42,21,21
Rezøk,ragnaros,1612,deathknight,unholy,54,20,34
Ðogmá,vashj,1610,deathknight,unholy,35,22,13
Mikoaa,bladefist,1610,deathknight,unholy,30,17,13
Lagmasterx,sargeras,1609,deathknight,unholy,42,20,22
Ousted,daggerspine,1608,deathknight,unholy,36,20,16
Ilikelydead,tichondrius,1608,deathknight,unholy,66,32,34
Deuter,quelthalas,1606,deathknight,unholy,204,105,99
Takeurcheeks,tichondrius,1605,deathknight,unholy,101,49,52
Ãstaroth,stormrage,1605,deathknight,unholy,48,22,26
Notorious,garrosh,1605,deathknight,unholy,42,18,24
Thotiannaqt,area-52,1605,deathknight,unholy,42,17,25
Boofcigars,kelthuzad,1604,deathknight,unholy,77,41,36
Unholykevin,sargeras,1604,deathknight,unholy,42,21,21
Dominos,tichondrius,1604,deathknight,unholy,42,20,22
Idodamn,tichondrius,1603,deathknight,unholy,84,45,39
Wednesdæ,moon-guard,1603,deathknight,unholy,54,28,26
Voncleaver,tichondrius,1603,deathknight,unholy,64,20,44
Gargoylepowa,nemesis,1602,deathknight,unholy,42,20,22
Nofoamlattes,thrall,1602,deathknight,unholy,42,19,23
Puppykisses,perenolde,1602,deathknight,unholy,89,38,51
Originalcimm,stormrage,1601,deathknight,unholy,60,25,35
Promotheseis,sargeras,1600,deathknight,unholy,66,41,25
Lickblood,sargeras,1600,deathknight,unholy,30,17,13
Burbash,moon-guard,1600,deathknight,unholy,79,41,38
Giznator,malganis,1598,deathknight,unholy,108,50,58
Bukum,zuljin,1598,deathknight,unholy,53,20,33
Aldebamuu,ragnaros,1592,deathknight,unholy,90,46,44
Shadow,ragnaros,1591,deathknight,unholy,55,30,25
Ulísés,ragnaros,1591,deathknight,unholy,58,20,38
Arcticc,area-52,1589,deathknight,unholy,48,21,27
Kellydean,moon-guard,1588,deathknight,unholy,78,41,37
Libitina,tichondrius,1587,deathknight,unholy,30,19,11
Telrenaur,proudmoore,1587,deathknight,unholy,42,22,20
Aidsbenedict,malganis,1586,deathknight,unholy,54,20,34
Papalich,stormrage,1582,deathknight,unholy,132,65,67
Daethiel,demon-soul,1580,deathknight,unholy,59,27,32
Morrticia,malganis,1579,deathknight,unholy,31,22,9
Nøsfferatus,azralon,1579,deathknight,unholy,65,34,31
Frostbite,the-venture-co,1577,deathknight,unholy,84,48,36
Auniel,gorefiend,1577,deathknight,unholy,48,19,29
Orkky,jubeithos,1573,deathknight,unholy,104,50,54
Kaaizer,azralon,1572,deathknight,unholy,120,68,52
Loongdk,kiljaeden,1572,deathknight,unholy,121,57,64
Fydedk,stormrage,1571,deathknight,unholy,60,29,31
Brß,tichondrius,1570,deathknight,unholy,36,19,17
Läskö,area-52,1569,deathknight,unholy,55,34,21
Onlyfunss,moon-guard,1568,deathknight,unholy,108,52,56
Evilbot,tichondrius,1564,deathknight,unholy,60,40,20
Lichkong,dalaran,1561,deathknight,unholy,59,33,26
Zzdk,thrall,1561,deathknight,unholy,48,23,25
Demonnation,illidan,1556,deathknight,unholy,114,49,65
Emopalli,tichondrius,1554,deathknight,unholy,128,65,63
Døømhøund,tichondrius,1554,deathknight,unholy,92,43,49
Siphilusxo,dalaran,1551,deathknight,unholy,36,20,16
Toophus,sargeras,1551,deathknight,unholy,74,35,39
Arc,maiev,1551,deathknight,unholy,87,36,51
Alistra,frostmourne,1550,deathknight,unholy,36,17,19
Tuicca,frostmane,1550,deathknight,unholy,79,34,45
Kuwarerubana,proudmoore,1549,deathknight,unholy,74,41,33
Catena,blood-furnace,1548,deathknight,unholy,71,32,39
Kalgor,illidan,1544,deathknight,unholy,114,58,56
Drfauci,boulderfist,1544,deathknight,unholy,36,18,18
Takeoverr,ragnaros,1543,deathknight,unholy,78,48,30
Deathwavez,cenarius,1537,deathknight,unholy,42,21,21
Garht,azralon,1533,deathknight,unholy,40,22,18
Chachio,kiljaeden,1532,deathknight,unholy,30,16,14
Nymppho,kelthuzad,1532,deathknight,unholy,193,85,108
Arktoz,tichondrius,1531,deathknight,unholy,30,16,14
Clearlol,bleeding-hollow,1531,deathknight,unholy,36,16,20
Dialysis,emerald-dream,1530,deathknight,unholy,137,68,69
Kindaholy,malganis,1528,deathknight,unholy,23,17,6
Nokenoke,illidan,1528,deathknight,unholy,190,97,93
Biefeile,tichondrius,1526,deathknight,unholy,40,18,22
Risottonero,kelthuzad,1524,deathknight,unholy,165,87,78
Deathbloss,illidan,1523,deathknight,unholy,32,17,15
Gottajuice,moonrunner,1522,deathknight,unholy,57,32,25
Tigs,proudmoore,1522,deathknight,unholy,126,65,61
Rixin,agamaggan,1520,deathknight,unholy,54,22,32
Zaxrree,malganis,1519,deathknight,unholy,60,37,23
Raíndrop,tichondrius,1519,deathknight,unholy,102,54,48
Azibar,moon-guard,1519,deathknight,unholy,35,17,18
Wisdôm,frostmourne,1518,deathknight,unholy,47,21,26
Hooterzqt,tichondrius,1518,deathknight,unholy,106,47,59
Dóm,proudmoore,1516,deathknight,unholy,66,29,37
Zedsdead,mannoroth,1514,deathknight,unholy,24,16,8
Deathzpeckt,tichondrius,1513,deathknight,unholy,36,17,19
Devillele,proudmoore,1509,deathknight,unholy,78,36,42
Elyxoxo,tichondrius,1507,deathknight,unholy,54,25,29
Fadedlight,zuljin,1506,deathknight,unholy,96,47,49
Dexarax,norgannon,1505,deathknight,unholy,87,49,38
Urieen,gorefiend,1505,deathknight,unholy,77,43,34
Coldsleeps,saurfang,1503,deathknight,unholy,30,16,14
Unfórgíven,arthas,1501,deathknight,unholy,48,17,31
Cammy,frostmourne,1500,deathknight,unholy,29,16,13
Obedient,firetree,1499,deathknight,unholy,114,65,49
Axeldrion,tichondrius,1499,deathknight,unholy,35,17,18
Abroham,arthas,1498,deathknight,unholy,59,30,29
Câpîrota,nemesis,1498,deathknight,unholy,46,23,23
Stoicïsm,tichondrius,1496,deathknight,unholy,102,57,45
Asheravon,moon-guard,1495,deathknight,unholy,271,129,142
Naxn,tichondrius,1495,deathknight,unholy,54,25,29
Apocxo,lightnings-blade,1491,deathknight,unholy,119,58,61
Ams,moon-guard,1490,deathknight,unholy,48,27,21
Ghoulslasher,bleeding-hollow,1490,deathknight,unholy,62,28,34
Kcorides,tichondrius,1488,deathknight,unholy,49,28,21
Laxatives,tichondrius,1488,deathknight,unholy,45,19,26
Thenin,crushridge,1487,deathknight,unholy,54,32,22
Blackary,emerald-dream,1486,deathknight,unholy,47,30,17
Jaxxftw,azralon,1485,deathknight,unholy,46,27,19
Deezwaz,draka,1485,deathknight,unholy,40,21,19
Fanggrief,proudmoore,1485,deathknight,unholy,54,26,28
Typhøn,illidan,1484,deathknight,unholy,157,78,79
Coolk,tichondrius,1482,deathknight,unholy,48,31,17
Saighast,illidan,1482,deathknight,unholy,72,39,33
Unholyfish,malganis,1482,deathknight,unholy,103,52,51
Zaluster,malganis,1479,deathknight,unholy,143,72,71
Allianknight,windrunner,1479,deathknight,unholy,36,17,19
Brounlyii,drakkari,1478,deathknight,unholy,54,35,19
Tiansama,ragnaros,1478,deathknight,unholy,30,18,12
Alexeous,wyrmrest-accord,1477,deathknight,unholy,160,85,75
Nialich,kelthuzad,1476,deathknight,unholy,41,16,25
Eldavò,quelthalas,1473,deathknight,unholy,54,25,29
Beeftip,area-52,1471,deathknight,unholy,155,76,79
Aradorn,azralon,1470,deathknight,unholy,160,77,83
Gankstagrip,anvilmar,1469,deathknight,unholy,85,43,42
Grayfoxx,twisting-nether,1469,deathknight,unholy,41,18,23
Brisblade,shattered-hand,1468,deathknight,unholy,48,26,22
Mortarîon,icecrown,1467,deathknight,unholy,138,66,72
Xlive,tichondrius,1466,deathknight,unholy,42,17,25
Buttrfingrz,cenarius,1465,deathknight,unholy,54,22,32
Tronnie,kelthuzad,1463,deathknight,unholy,72,37,35
Grimnuts,thrall,1463,deathknight,unholy,60,29,31
Regiknight,stormrage,1462,deathknight,unholy,176,97,79
Rhaeisxalnym,sargeras,1460,deathknight,unholy,106,52,54
Släke,azralon,1460,deathknight,unholy,160,78,82
Rk,blackhand,1457,deathknight,unholy,97,58,39
Banjingquan,tichondrius,1457,deathknight,unholy,59,33,26
Wryu,malganis,1451,deathknight,unholy,35,21,14
Fallen,nazjatar,1450,deathknight,unholy,30,19,11
Allhejluya,illidan,1449,deathknight,unholy,199,101,98
Genjírou,frostwolf,1449,deathknight,unholy,224,110,114
Balboskina,shattered-hand,1448,deathknight,unholy,76,39,37
Paulpatine,tichondrius,1448,deathknight,unholy,54,21,33
Pmpfrmdwntwn,stormrage,1447,deathknight,unholy,61,26,35
Tracyminaj,tichondrius,1445,deathknight,unholy,60,27,33
Starms,ragnaros,1445,deathknight,unholy,65,29,36
Knownkilla,hyjal,1444,deathknight,unholy,77,45,32
Garù,ragnaros,1444,deathknight,unholy,56,29,27
Nightskull,malganis,1444,deathknight,unholy,36,18,18
Gerometal,ragnaros,1440,deathknight,unholy,42,18,24
Breadtruck,area-52,1440,deathknight,unholy,75,31,44
Dreadfang,the-venture-co,1438,deathknight,unholy,24,15,9
Corrpsse,tichondrius,1438,deathknight,unholy,157,81,76
Pettyk,tichondrius,1438,deathknight,unholy,36,15,21
Redbr,tichondrius,1437,deathknight,unholy,78,37,41
Flavorchops,kelthuzad,1437,deathknight,unholy,48,16,32
Steamerboy,stormrage,1436,deathknight,unholy,30,15,15
Yadaddy,hydraxis,1434,deathknight,unholy,36,21,15
Ningjinglol,tichondrius,1434,deathknight,unholy,30,15,15
Greenduck,malganis,1433,deathknight,unholy,30,15,15
Unknowndk,kul-tiras,1433,deathknight,unholy,36,17,19
Exin,cenarion-circle,1432,deathknight,unholy,24,15,9
Moonjae,illidan,1432,deathknight,unholy,24,15,9
Halvôr,moon-guard,1431,deathknight,unholy,132,70,62
Coffeebagel,bleeding-hollow,1426,deathknight,unholy,149,65,84
Anexdk,korgath,1423,deathknight,unholy,24,15,9
Jarah,destromath,1422,deathknight,unholy,54,25,29
Sannistus,ysera,1420,deathknight,unholy,97,43,54
Sgtdead,thrall,1418,deathknight,unholy,63,35,28
Hornpipe,borean-tundra,1418,deathknight,unholy,126,61,65
Rycerzfrost,ragnaros,1418,deathknight,unholy,54,21,33
Fellenn,stormrage,1417,deathknight,unholy,144,78,66
Deathofchaos,smolderthorn,1417,deathknight,unholy,65,25,40
Seranta,wyrmrest-accord,1417,deathknight,unholy,54,19,35
Sniperlord,uldaman,1415,deathknight,unholy,90,51,39
Fuzzknight,ravenholdt,1414,deathknight,unholy,30,15,15
Subparatbest,chogall,1414,deathknight,unholy,30,15,15
Dûsk,thunderlord,1413,deathknight,unholy,52,21,31
Ganancïa,nemesis,1412,deathknight,unholy,39,22,17
Reinhartlol,sargeras,1411,deathknight,unholy,81,38,43
Deathpool,shadowmoon,1409,deathknight,unholy,54,19,35
Seiyokú,ragnaros,1408,deathknight,unholy,74,38,36
Desen,arthas,1408,deathknight,unholy,39,15,24
Fugs,ghostlands,1406,deathknight,unholy,56,30,26
Hatreon,sargeras,1401,deathknight,unholy,30,20,10
Sílthree,barthilas,1401,deathknight,unholy,42,17,25
Wndypefrcorn,sargeras,1397,deathknight,unholy,37,24,13
Vazarus,darrowmere,1397,deathknight,unholy,66,30,36
Fzero,frostmourne,1392,deathknight,unholy,66,23,43
Sammåel,malganis,1387,deathknight,unholy,36,18,18
Paíín,illidan,1387,deathknight,unholy,48,21,27
Degrease,bonechewer,1385,deathknight,unholy,36,15,21
Unrealzrotz,tichondrius,1383,deathknight,unholy,60,39,21
Tenóry,nemesis,1383,deathknight,unholy,72,31,41
Egirlgripper,area-52,1382,deathknight,unholy,30,15,15
Plagueghoul,wyrmrest-accord,1381,deathknight,unholy,92,47,45
Silanvia,wyrmrest-accord,1377,deathknight,unholy,48,21,27
Mèrc,ragnaros,1376,deathknight,unholy,89,38,51
Sparklekitty,illidan,1374,deathknight,unholy,24,16,8
Greeasy,bleeding-hollow,1374,deathknight,unholy,41,23,18
Volcolm,kelthuzad,1373,deathknight,unholy,54,26,28
Zuly,moon-guard,1369,deathknight,unholy,113,54,59
Putrefactive,frostmourne,1368,deathknight,unholy,174,85,89
Darkunral,stormrage,1365,deathknight,unholy,80,33,47
Warstompgød,tichondrius,1364,deathknight,unholy,36,16,20
Any,the-venture-co,1364,deathknight,unholy,54,21,33
Waremoto,ragnaros,1361,deathknight,unholy,81,47,34
Bloodramen,dalaran,1360,deathknight,unholy,327,166,161
Dkzote,quelthalas,1360,deathknight,unholy,48,20,28
Deathsatan,barthilas,1359,deathknight,unholy,36,20,16
Awzy,azralon,1358,deathknight,unholy,36,20,16
Hydree,bleeding-hollow,1358,deathknight,unholy,42,17,25
Luckyson,tichondrius,1357,deathknight,unholy,40,19,21
Belegos,quelthalas,1356,deathknight,unholy,81,38,43
Shélly,ragnaros,1354,deathknight,unholy,83,41,42
Darknessice,tichondrius,1350,deathknight,unholy,66,35,31
Bumbleton,blackrock,1349,deathknight,unholy,45,24,21
Unhøøly,nemesis,1346,deathknight,unholy,53,30,23
Dethcro,shandris,1343,deathknight,unholy,93,47,46
Deliriioh,ragnaros,1340,deathknight,unholy,156,82,74
Koltíra,azralon,1339,deathknight,unholy,50,26,24
Tötenkaiser,quelthalas,1337,deathknight,unholy,30,14,16
Ântipaladin,arthas,1335,deathknight,unholy,46,19,27
Zeban,area-52,1334,deathknight,unholy,78,36,42
Bannedforevr,dalaran,1334,deathknight,unholy,36,14,22
Fiddleop,thrall,1333,deathknight,unholy,24,14,10
Negril,tichondrius,1332,deathknight,unholy,78,38,40
Darthsydius,azralon,1330,deathknight,unholy,24,14,10
Zxy,hyjal,1327,deathknight,unholy,23,17,6
Madmaxxy,barthilas,1326,deathknight,unholy,121,59,62
Rekbari,sargeras,1325,deathknight,unholy,24,15,9
Vynkys,shadow-council,1325,deathknight,unholy,58,32,26
Ellipsoro,onyxia,1325,deathknight,unholy,36,14,22
Unholychillz,ghostlands,1324,deathknight,unholy,44,20,24
Stangz,bonechewer,1322,deathknight,unholy,36,14,22
Earador,dalaran,1321,deathknight,unholy,30,15,15
Mords,area-52,1321,deathknight,unholy,30,14,16
Asylïthcc,sargeras,1317,deathknight,unholy,48,28,20
Gilden,malfurion,1317,deathknight,unholy,80,34,46
Midway,drakkari,1316,deathknight,unholy,30,16,14
Afterdeath,frostmourne,1313,deathknight,unholy,36,16,20
Maligned,uldum,1312,deathknight,unholy,49,18,31
Wrothgarr,stormreaver,1311,deathknight,unholy,36,18,18
Frðst,executus,1310,deathknight,unholy,24,14,10
Ñovacaine,moon-guard,1309,deathknight,unholy,77,36,41
Gwiffhm,tichondrius,1304,deathknight,unholy,40,14,26
Grizzdk,blackrock,1303,deathknight,unholy,30,14,16
Anonymousix,kelthuzad,1301,deathknight,unholy,29,15,14
Darkàn,lightnings-blade,1301,deathknight,unholy,42,20,22
Killerundead,area-52,1299,deathknight,unholy,39,17,22
Kallgìn,emerald-dream,1299,deathknight,unholy,36,15,21
Unholycube,zuljin,1290,deathknight,unholy,35,14,21
Mëgazørd,nemesis,1289,deathknight,unholy,42,22,20
Cripticknigt,spinebreaker,1289,deathknight,unholy,48,22,26
Shargan,tichondrius,1284,deathknight,unholy,84,44,40
Demona,ragnaros,1275,deathknight,unholy,52,18,34
Harlthas,ragnaros,1274,deathknight,unholy,30,17,13
Ometecuhtli,kelthuzad,1273,deathknight,unholy,60,35,25
Kromgarath,stormrage,1271,deathknight,unholy,60,28,32
Twodkitty,kelthuzad,1269,deathknight,unholy,21,14,7
Flo,ghostlands,1266,deathknight,unholy,34,17,17
Unleud,tichondrius,1260,deathknight,unholy,36,21,15
Nukydoe,azralon,1260,deathknight,unholy,42,19,23
Enjal,stormrage,1255,deathknight,unholy,53,23,30
Aretos,dreadmaul,1254,deathknight,unholy,32,16,16
Abruptdk,bonechewer,1254,deathknight,unholy,61,29,32
Ownaron,moon-guard,1249,deathknight,unholy,45,24,21
Resumen,steamwheedle-cartel,1249,deathknight,unholy,32,15,17
Clowngodx,illidan,1247,deathknight,unholy,24,13,11
Darktonelol,tichondrius,1247,deathknight,unholy,30,13,17
Buldrokastee,tichondrius,1247,deathknight,unholy,36,13,23
Bloodyloco,malganis,1246,deathknight,unholy,64,32,32
Earthican,bleeding-hollow,1245,deathknight,unholy,18,13,5
Daixks,proudmoore,1245,deathknight,unholy,42,22,20
Magipierrot,ragnaros,1245,deathknight,unholy,62,31,31
Lovedaddy,frostmourne,1242,deathknight,unholy,30,13,17
Lemuriön,nemesis,1242,deathknight,unholy,30,13,17
Bubblesdk,whisperwind,1242,deathknight,unholy,66,27,39
Youngmoneyyd,illidan,1241,deathknight,unholy,18,13,5
Shezoe,drakkari,1238,deathknight,unholy,24,13,11
Lebrônjames,tichondrius,1236,deathknight,unholy,24,13,11
Althamon,tanaris,1235,deathknight,unholy,36,13,23
Neipum,stormrage,1234,deathknight,unholy,18,13,5
Rarum,bleeding-hollow,1233,deathknight,unholy,24,13,11
Muffinstomp,eredar,1231,deathknight,unholy,53,29,24
Hellzkknight,tichondrius,1231,deathknight,unholy,34,16,18
Treikorh,quelthalas,1230,deathknight,unholy,148,66,82
Yamanji,wyrmrest-accord,1229,deathknight,unholy,24,13,11
Soulhuntress,doomhammer,1227,deathknight,unholy,114,58,56
Unhølydøøm,misha,1226,deathknight,unholy,78,39,39
Lorð,malganis,1225,deathknight,unholy,42,22,20
Sokthr,proudmoore,1224,deathknight,unholy,38,17,21
Déká,tichondrius,1222,deathknight,unholy,24,13,11
Necrósy,azralon,1222,deathknight,unholy,30,13,17
Potatobob,dalaran,1222,deathknight,unholy,30,13,17
Ahrímán,illidan,1219,deathknight,unholy,30,13,17
Malsedius,kelthuzad,1216,deathknight,unholy,39,16,23
Mazey,moon-guard,1209,deathknight,unholy,199,98,101
Nevarro,lightbringer,1209,deathknight,unholy,234,114,120
Darktrinnity,nemesis,1201,deathknight,unholy,47,27,20
Golurun,tichondrius,1197,deathknight,unholy,25,15,10
Zeeroo,moon-guard,1191,deathknight,unholy,34,17,17
Möchi,ragnaros,1190,deathknight,unholy,75,36,39
Leviiathan,tichondrius,1185,deathknight,unholy,30,14,16
Gatrars,sargeras,1185,deathknight,unholy,72,32,40
Lieyanyanwan,tichondrius,1181,deathknight,unholy,42,15,27
Sne,dragonmaw,1180,deathknight,unholy,30,17,13
Coffïnfeeder,dalaran,1178,deathknight,unholy,78,31,47
Drowhd,nemesis,1177,deathknight,unholy,60,27,33
Deadwait,rivendare,1175,deathknight,unholy,22,13,9
Hanmayuziro,tichondrius,1171,deathknight,unholy,23,13,10
Mmrhostage,kelthuzad,1165,deathknight,unholy,30,14,16
Lazenca,malganis,1158,deathknight,unholy,20,13,7
Oql,tichondrius,1152,deathknight,unholy,24,12,12
Diviniumx,bleeding-hollow,1152,deathknight,unholy,27,13,14
Gutterboy,malganis,1152,deathknight,unholy,30,12,18
Divinium,bleeding-hollow,1152,deathknight,unholy,30,12,18
Xtador,quelthalas,1150,deathknight,unholy,23,13,10
Kryptikkyt,blackrock,1150,deathknight,unholy,30,12,18
Böffa,dalaran,1149,deathknight,unholy,30,12,18
Vesel,tichondrius,1149,deathknight,unholy,36,12,24
Azgaroth,dathremar,1148,deathknight,unholy,38,20,18
Orcsexual,azralon,1148,deathknight,unholy,24,12,12
Zebastion,amanthul,1147,deathknight,unholy,36,15,21
Oldskul,sargeras,1146,deathknight,unholy,34,17,17
Chalamander,tichondrius,1146,deathknight,unholy,24,12,12
Blightrish,icecrown,1146,deathknight,unholy,42,19,23
Iamthedanger,aerie-peak,1145,deathknight,unholy,24,12,12
Kehin,azralon,1144,deathknight,unholy,70,29,41
Zukcho,tichondrius,1144,deathknight,unholy,36,12,24
Dravix,azshara,1143,deathknight,unholy,18,12,6
Skeleton,lightnings-blade,1141,deathknight,unholy,33,13,20
Rognarash,emerald-dream,1139,deathknight,unholy,24,12,12
Balakk,tichondrius,1137,deathknight,unholy,32,13,19
Skellig,wyrmrest-accord,1137,deathknight,unholy,60,24,36
Deathwardenn,ghostlands,1136,deathknight,unholy,24,12,12
Araris,stormrage,1135,deathknight,unholy,36,12,24
Ventuss,bleeding-hollow,1134,deathknight,unholy,24,12,12
Shinici,kelthuzad,1132,deathknight,unholy,24,12,12
Kel,stormreaver,1132,deathknight,unholy,35,12,23
Heärt,bleeding-hollow,1127,deathknight,unholy,68,28,40
Edhral,ragnaros,1123,deathknight,unholy,30,13,17
Vampirecarti,tichondrius,1122,deathknight,unholy,38,18,20
Darthblade,darkspear,1121,deathknight,unholy,36,26,10
Toroandmoi,area-52,1121,deathknight,unholy,24,12,12
Carecaa,azralon,1119,deathknight,unholy,44,19,25
Sabotdk,tichondrius,1117,deathknight,unholy,24,12,12
Mordekaiseer,azralon,1116,deathknight,unholy,142,73,69
Mercysparx,thrall,1116,deathknight,unholy,72,34,38
Frostcleave,emerald-dream,1115,deathknight,unholy,24,16,8
Joeyxdk,tichondrius,1114,deathknight,unholy,23,12,11
Druncker,blackrock,1114,deathknight,unholy,53,20,33
Mordeo,bleeding-hollow,1114,deathknight,unholy,34,12,22
Pántera,darkspear,1113,deathknight,unholy,24,12,12
Exequias,zuljin,1111,deathknight,unholy,30,17,13
Mandrágor,quelthalas,1111,deathknight,unholy,52,20,32
Fuzzyrump,eitrigg,1108,deathknight,unholy,30,19,11
Alphabro,zuluhed,1108,deathknight,unholy,42,22,20
Vaseline,zangarmarsh,1105,deathknight,unholy,53,27,26
Virulous,zuljin,1100,deathknight,unholy,21,13,8
Jukpark,tichondrius,1100,deathknight,unholy,42,25,17
Morghulas,moon-guard,1098,deathknight,unholy,30,12,18
Omegaseven,gorgonnash,1094,deathknight,unholy,166,84,82
Polydeuces,queldorei,1091,deathknight,unholy,66,26,40
Rhaenyrà,tichondrius,1089,deathknight,unholy,27,15,12
Beanboyx,tichondrius,1085,deathknight,unholy,22,12,10
Kanthrix,illidan,1084,deathknight,unholy,32,12,20
Trüppen,area-52,1078,deathknight,unholy,49,24,25
Volardan,trollbane,1071,deathknight,unholy,21,13,8
Zaelize,sargeras,1065,deathknight,unholy,48,21,27
Ragsec,bleeding-hollow,1056,deathknight,unholy,18,11,7
Vleryan,ragnaros,1055,deathknight,unholy,18,11,7
Asastac,tichondrius,1054,deathknight,unholy,18,11,7
Bhyrnam,ragnaros,1054,deathknight,unholy,36,11,25
Rongkhun,proudmoore,1054,deathknight,unholy,36,11,25
Sommeliergg,stormrage,1053,deathknight,unholy,18,11,7
Xaldalas,kelthuzad,1053,deathknight,unholy,24,11,13
Deathboost,stormrage,1053,deathknight,unholy,36,11,25
Plaguebreak,darrowmere,1052,deathknight,unholy,60,35,25
Boofcigars,stormrage,1052,deathknight,unholy,21,12,9
Happynaru,tichondrius,1052,deathknight,unholy,24,11,13
Polpop,zuljin,1051,deathknight,unholy,18,11,7
Acidirin,tichondrius,1049,deathknight,unholy,18,11,7
Draenor,shadowmoon,1049,deathknight,unholy,18,11,7
Runicblade,jaedenar,1048,deathknight,unholy,18,11,7
Salahzar,stormrage,1048,deathknight,unholy,24,11,13
Agohnim,moon-guard,1046,deathknight,unholy,30,11,19
Bazzingaxd,hyjal,1044,deathknight,unholy,36,21,15
Lazta,azralon,1044,deathknight,unholy,40,17,23
Cswildwind,aerie-peak,1041,deathknight,unholy,30,11,19
Alayka,stormrage,1040,deathknight,unholy,24,11,13
Deathcometh,tichondrius,1027,deathknight,unholy,30,11,19
Kayzark,tichondrius,1026,deathknight,unholy,36,20,16
Deathnorris,zuljin,1026,deathknight,unholy,80,38,42
Annerito,area-52,1023,deathknight,unholy,29,11,18
Dredrikbane,moon-guard,1022,deathknight,unholy,23,12,11
Deathsmog,quelthalas,1016,deathknight,unholy,19,11,8
Puppykiss,perenolde,1007,deathknight,unholy,27,11,16
Gêralt,darkspear,996,deathknight,unholy,24,12,12
Honustustere,emerald-dream,986,deathknight,unholy,23,11,12
Hansmclroy,trollbane,970,deathknight,unholy,24,14,10
Fendos,turalyon,963,deathknight,unholy,24,14,10
Vaske,azjolnerub,963,deathknight,unholy,55,20,35
Wölf,durotan,960,deathknight,unholy,12,10,2
Vaizard,malganis,960,deathknight,unholy,18,10,8
Giveretms,azralon,960,deathknight,unholy,24,10,14
Ragrek,bleeding-hollow,960,deathknight,unholy,24,10,14
Einherjiar,tichondrius,960,deathknight,unholy,24,10,14
Rängi,caelestrasz,960,deathknight,unholy,78,26,52
Immadkx,area-52,960,deathknight,unholy,30,10,20
Rxzo,frostmourne,960,deathknight,unholy,30,10,20
Pookr,area-52,960,deathknight,unholy,30,10,20
Hotdk,thrall,960,deathknight,unholy,30,10,20
Sithdog,blackrock,960,deathknight,unholy,30,10,20
Awshuks,illidan,959,deathknight,unholy,18,10,8
Mainxx,stormrage,959,deathknight,unholy,18,10,8
Tragdore,thrall,959,deathknight,unholy,18,10,8
Emarose,illidan,959,deathknight,unholy,24,10,14
Distorted,emerald-dream,959,deathknight,unholy,24,10,14
Galaxyboom,tichondrius,958,deathknight,unholy,12,10,2
Reapsouls,stormrage,958,deathknight,unholy,13,10,3
Pacedd,silvermoon,958,deathknight,unholy,18,10,8
Iðûnn,barthilas,957,deathknight,unholy,18,10,8
Aldoraenna,illidan,957,deathknight,unholy,24,10,14
Cimitiere,stormrage,956,deathknight,unholy,24,10,14
Arthyius,kiljaeden,956,deathknight,unholy,30,10,20
Mëlødy,quelthalas,955,deathknight,unholy,18,10,8
Gobaiakun,proudmoore,955,deathknight,unholy,18,10,8
Vërmilliøn,ragnaros,951,deathknight,unholy,18,10,8
Deathafter,tichondrius,948,deathknight,unholy,24,10,14
Thaylenaar,eredar,947,deathknight,unholy,18,10,8
Niennahh,sargeras,946,deathknight,unholy,24,10,14
Ghorzul,thrall,945,deathknight,unholy,24,10,14
Morhtzen,moon-guard,944,deathknight,unholy,13,10,3
Hentaideath,kiljaeden,934,deathknight,unholy,24,10,14
Bahtman,hakkar,925,deathknight,unholy,18,10,8
Jaydkx,tichondrius,906,deathknight,unholy,28,11,17
Jhiv,tichondrius,903,deathknight,unholy,22,11,11
Rottenwiener,sargeras,900,deathknight,unholy,17,10,7
Cishei,quelthalas,897,deathknight,unholy,21,12,9
Càsshêrn,lightbringer,893,deathknight,unholy,14,10,4
Dragoroth,zuluhed,893,deathknight,unholy,31,15,16
Zareon,zuluhed,876,deathknight,unholy,24,12,12
Dandandor,muradin,876,deathknight,unholy,38,17,21
Deathstrikex,tichondrius,864,deathknight,unholy,12,9,3
Nerfdklul,illidan,864,deathknight,unholy,12,9,3
Linyive,malganis,864,deathknight,unholy,18,9,9
Skullash,stormrage,864,deathknight,unholy,18,9,9
Utthrity,ysera,864,deathknight,unholy,18,9,9
Methyldk,frostmourne,864,deathknight,unholy,21,10,11
Shadowsdk,tichondrius,864,deathknight,unholy,24,9,15
Dill,madoran,864,deathknight,unholy,24,9,15
Datnai,barthilas,864,deathknight,unholy,24,9,15
Shinukishin,stormrage,864,deathknight,unholy,24,9,15
Fortissax,area-52,864,deathknight,unholy,30,9,21
Howlex,barthilas,863,deathknight,unholy,18,9,9
Kranaz,frostmourne,863,deathknight,unholy,24,9,15
Sbplaysdk,akama,863,deathknight,unholy,30,9,21
Tharegorn,azralon,862,deathknight,unholy,18,9,9
Umbranox,arthas,862,deathknight,unholy,18,9,9
Vynlerran,skullcrusher,862,deathknight,unholy,18,9,9
Runeswanson,area-52,861,deathknight,unholy,18,9,9
Isaarid,proudmoore,860,deathknight,unholy,12,9,3
Cosanostrá,malganis,860,deathknight,unholy,12,9,3
Rinthosaka,ragnaros,860,deathknight,unholy,18,9,9
Orphnoch,illidan,860,deathknight,unholy,24,9,15
Velyssiah,stormrage,860,deathknight,unholy,24,9,15
Feorlar,dalaran,860,deathknight,unholy,24,9,15
Ðerion,stormrage,859,deathknight,unholy,18,9,9
Sidbane,kalecgos,859,deathknight,unholy,19,9,10
Krixia,ragnaros,859,deathknight,unholy,24,9,15
Tugs,nathrezim,858,deathknight,unholy,18,9,9
Kaórii,stormrage,858,deathknight,unholy,30,9,21
Yosemithe,quelthalas,857,deathknight,unholy,18,9,9
Bloopdabloop,sargeras,856,deathknight,unholy,18,10,8
Tinytanx,aerie-peak,856,deathknight,unholy,30,9,21
Nicrack,malganis,853,deathknight,unholy,18,9,9
Zathog,lightbringer,853,deathknight,unholy,30,9,21
Ulerin,illidan,850,deathknight,unholy,18,9,9
Plaza,thorium-brotherhood,844,deathknight,unholy,18,9,9
Grimmtidings,dentarg,839,deathknight,unholy,42,17,25
Destruktion,uldaman,838,deathknight,unholy,12,9,3
Deadspellz,bleeding-hollow,832,deathknight,unholy,34,9,25
Handler,nemesis,830,deathknight,unholy,20,10,10
Ulyssess,jubeithos,827,deathknight,unholy,58,26,32
Alderma,zuljin,814,deathknight,unholy,29,10,19
Littlekims,emerald-dream,799,deathknight,unholy,16,9,7
Hobdk,malganis,798,deathknight,unholy,21,9,12
Festers,burning-legion,794,deathknight,unholy,26,9,17
Mesx,illidan,768,deathknight,unholy,12,8,4
Vitad,tichondrius,768,deathknight,unholy,12,8,4
Liqùid,moon-guard,768,deathknight,unholy,12,8,4
Deadsamurai,illidan,768,deathknight,unholy,12,8,4
Gromhal,azralon,768,deathknight,unholy,12,8,4
Poderrosodk,azralon,768,deathknight,unholy,12,8,4
Dicromick,illidan,768,deathknight,unholy,15,9,6
Asterend,proudmoore,768,deathknight,unholy,16,9,7
Aisö,bleeding-hollow,768,deathknight,unholy,18,8,10
Clapt,kelthuzad,768,deathknight,unholy,18,8,10
Icytoast,tichondrius,768,deathknight,unholy,18,8,10
Piratehookah,sargeras,768,deathknight,unholy,18,8,10
Loomoros,sargeras,768,deathknight,unholy,24,8,16
Novädk,ragnaros,768,deathknight,unholy,24,8,16
Bigdollars,eredar,767,deathknight,unholy,12,8,4
Deathsloot,sargeras,767,deathknight,unholy,12,8,4
Ørcrist,area-52,767,deathknight,unholy,12,8,4
Akrylo,ragnaros,767,deathknight,unholy,12,8,4
Ðaz,zuljin,767,deathknight,unholy,12,8,4
Hædës,area-52,767,deathknight,unholy,18,8,10
Traitre,onyxia,767,deathknight,unholy,18,8,10
Rulord,wyrmrest-accord,767,deathknight,unholy,18,8,10
Fluffymoo,frostmourne,767,deathknight,unholy,18,8,10
Gorillagrip,sargeras,767,deathknight,unholy,18,8,10
Bloodygrip,bleeding-hollow,767,deathknight,unholy,18,8,10
Mordumi,stormrage,767,deathknight,unholy,24,8,16
Deephideblue,proudmoore,767,deathknight,unholy,25,8,17
Redcancer,tichondrius,766,deathknight,unholy,12,8,4
Olblueyes,hyjal,766,deathknight,unholy,18,8,10
Riparonii,illidan,766,deathknight,unholy,21,8,13
Shadowghast,saurfang,765,deathknight,unholy,12,8,4
Hildolfr,shattered-hand,765,deathknight,unholy,18,8,10
Bloodydebt,malganis,765,deathknight,unholy,18,8,10
Dalrin,emerald-dream,765,deathknight,unholy,24,8,16
Abadena,illidan,765,deathknight,unholy,27,8,19
Leiry,darkspear,762,deathknight,unholy,12,8,4
Primoverdino,azralon,762,deathknight,unholy,18,8,10
Kowell,drakkari,762,deathknight,unholy,18,8,10
Dankbro,tichondrius,761,deathknight,unholy,24,10,14
Iamlrr,maelstrom,761,deathknight,unholy,24,8,16
Croaker,gurubashi,760,deathknight,unholy,12,8,4
Kaciann,dalaran,758,deathknight,unholy,12,8,4
Lepanda,skywall,758,deathknight,unholy,18,8,10
Moxtexd,drakkari,752,deathknight,unholy,12,8,4
Soulfarm,tichondrius,751,deathknight,unholy,12,8,4
Frozenkappa,hyjal,735,deathknight,unholy,17,8,9
Poonen,area-52,735,deathknight,unholy,17,8,9
Starset,burning-legion,728,deathknight,unholy,24,9,15
Tonylin,tichondrius,703,deathknight,unholy,14,8,6
Somethingdum,sargeras,703,deathknight,unholy,16,8,8
Froznorbs,tichondrius,700,deathknight,unholy,14,8,6
Cgg,tichondrius,672,deathknight,unholy,12,7,5
Liverkick,zuljin,672,deathknight,unholy,12,7,5
Khørne,area-52,672,deathknight,unholy,12,7,5
Jbert,sargeras,672,deathknight,unholy,12,7,5
Raizzhít,ragnaros,672,deathknight,unholy,12,7,5
Apoz,tichondrius,672,deathknight,unholy,12,7,5
Plag,bleeding-hollow,672,deathknight,unholy,12,7,5
Mcdeathturds,tichondrius,672,deathknight,unholy,12,7,5
Bigdekay,illidan,672,deathknight,unholy,12,7,5
Dezmond,quelthalas,672,deathknight,unholy,12,7,5
Karthayne,area-52,672,deathknight,unholy,12,7,5
Donrhythmic,ysera,672,deathknight,unholy,12,7,5
Gurnok,barthilas,672,deathknight,unholy,12,7,5
Inemia,wyrmrest-accord,672,deathknight,unholy,16,7,9
Mightyfails,frostmourne,672,deathknight,unholy,18,7,11
Bryku,tichondrius,672,deathknight,unholy,18,7,11
Kûri,runetotem,672,deathknight,unholy,18,7,11
Bellybuster,malganis,672,deathknight,unholy,18,7,11
Vigarst,azralon,672,deathknight,unholy,18,7,11
Ebolaxd,area-52,672,deathknight,unholy,18,7,11
Umbramane,tichondrius,672,deathknight,unholy,18,7,11
Mmaximus,darkspear,672,deathknight,unholy,18,7,11
Darione,twisting-nether,672,deathknight,unholy,24,7,17
Xenocrates,illidan,672,deathknight,unholy,24,7,17
Cptsäveähöe,tichondrius,672,deathknight,unholy,24,7,17
Ceedog,crushridge,672,deathknight,unholy,30,7,23
Deatheey,area-52,671,deathknight,unholy,12,7,5
Sevexi,moon-guard,671,deathknight,unholy,12,7,5
Tiller,mannoroth,671,deathknight,unholy,12,7,5
Woahwtf,area-52,671,deathknight,unholy,12,7,5
Dreadcowpie,dalaran,671,deathknight,unholy,12,7,5
Fligdeath,llane,671,deathknight,unholy,12,7,5
Gâbriel,cairne,671,deathknight,unholy,12,7,5
Biukanon,ragnaros,671,deathknight,unholy,18,7,11
Kidek,proudmoore,671,deathknight,unholy,18,7,11
Shhnitzle,stormrage,671,deathknight,unholy,18,7,11
Mfknight,archimonde,671,deathknight,unholy,18,7,11
Dravoc,kelthuzad,671,deathknight,unholy,24,7,17
Demonstalker,boulderfist,671,deathknight,unholy,24,7,17
Coldrhelx,quelthalas,671,deathknight,unholy,30,7,23
Emberwarden,stormrage,670,deathknight,unholy,18,7,11
Irokthefrost,frostmourne,669,deathknight,unholy,12,7,5
Boneguard,stormrage,668,deathknight,unholy,18,7,11
Terracundo,quelthalas,667,deathknight,unholy,18,9,9
Grtmisdirect,illidan,666,deathknight,unholy,21,8,13
Zëb,sargeras,665,deathknight,unholy,12,7,5
Zàkgor,moon-guard,665,deathknight,unholy,12,7,5
Argar,crushridge,664,deathknight,unholy,12,7,5
Heldwynd,bonechewer,664,deathknight,unholy,24,7,17
Garshna,ragnaros,658,deathknight,unholy,12,7,5
Hadianton,stormrage,654,deathknight,unholy,15,8,7
Dbg,frostmane,639,deathknight,unholy,11,7,4
Arthureon,kelthuzad,635,deathknight,unholy,20,7,13
Bonalumë,azralon,620,deathknight,unholy,17,7,10
Soulkiti,blackwater-raiders,608,deathknight,unholy,16,7,9
Nekrosys,eitrigg,608,deathknight,unholy,22,7,15
Aundethell,moon-guard,608,deathknight,unholy,33,7,26
Bingoez,frostmourne,607,deathknight,unholy,11,7,4
Xènia,exodar,592,deathknight,unholy,13,7,6
Bernaldino,illidan,576,deathknight,unholy,6,6,0
Arcänn,drenden,576,deathknight,unholy,6,6,0
Feej,malganis,576,deathknight,unholy,6,6,0
Delwrath,proudmoore,576,deathknight,unholy,12,6,6
Chainsawmàn,tichondrius,576,deathknight,unholy,12,6,6
Justtaki,zuljin,576,deathknight,unholy,12,6,6
Bøoth,area-52,576,deathknight,unholy,12,6,6
Raaizz,ragnaros,576,deathknight,unholy,12,6,6
Svlla,doomhammer,576,deathknight,unholy,12,6,6
Ridesatenspd,caelestrasz,576,deathknight,unholy,12,6,6
Zifandel,bleeding-hollow,576,deathknight,unholy,12,6,6
Lilwayne,archimonde,576,deathknight,unholy,12,6,6
Cali,bladefist,576,deathknight,unholy,12,6,6
Bossdk,tichondrius,576,deathknight,unholy,12,6,6
Migwel,emerald-dream,576,deathknight,unholy,12,6,6
Meisterdeath,stormrage,576,deathknight,unholy,12,6,6
Remõrse,moon-guard,576,deathknight,unholy,12,6,6
Surkk,tichondrius,576,deathknight,unholy,12,6,6
Demonicrunes,windrunner,576,deathknight,unholy,12,6,6
Zakka,korgath,576,deathknight,unholy,12,6,6
Hickish,tichondrius,576,deathknight,unholy,12,6,6
Lagérthâ,ragnaros,576,deathknight,unholy,12,6,6
Bébøp,malganis,576,deathknight,unholy,12,6,6
Ghouldruis,barthilas,576,deathknight,unholy,12,6,6
Maiatsu,illidan,576,deathknight,unholy,12,6,6
Friezen,illidan,576,deathknight,unholy,12,6,6
Jonahdk,sargeras,576,deathknight,unholy,12,6,6
Witdk,illidan,576,deathknight,unholy,15,6,9
Lainmortal,ragnaros,576,deathknight,unholy,18,6,12
Maripaula,ragnaros,576,deathknight,unholy,18,6,12
Cirillan,bleeding-hollow,576,deathknight,unholy,18,6,12
Kterrorblade,sargeras,576,deathknight,unholy,18,6,12
Joystickwrld,silvermoon,576,deathknight,unholy,18,6,12
Conquest,drenden,576,deathknight,unholy,24,6,18
Baldlord,tichondrius,576,deathknight,unholy,24,6,18
Zevrynn,barthilas,575,deathknight,unholy,12,6,6
Agamoth,ragnaros,575,deathknight,unholy,12,6,6
Åkatsukii,uther,575,deathknight,unholy,12,6,6
Zebirock,stormrage,575,deathknight,unholy,12,6,6
Ksoldier,illidan,575,deathknight,unholy,12,6,6
Christophe,skullcrusher,575,deathknight,unholy,12,6,6
Corpsepetal,muradin,575,deathknight,unholy,18,6,12
Hordbadia,garrosh,574,deathknight,unholy,12,6,6
Vicentão,tichondrius,574,deathknight,unholy,12,6,6
Liltinktink,stormreaver,574,deathknight,unholy,12,6,6
Masochrist,baelgun,574,deathknight,unholy,18,6,12
Vapelounge,darkspear,574,deathknight,unholy,18,6,12
Fraänrisco,ragnaros,574,deathknight,unholy,18,6,12
Scaista,tichondrius,573,deathknight,unholy,12,6,6
Juggérnaút,bonechewer,572,deathknight,unholy,12,6,6
Tormentsoul,ragnaros,572,deathknight,unholy,12,6,6
Lowan,stormrage,566,deathknight,unholy,12,6,6
Waterboy,malganis,566,deathknight,unholy,12,6,6
Syzurp,barthilas,558,deathknight,unholy,13,7,6
Zillachilla,azshara,527,deathknight,unholy,9,7,2
Herstôry,kelthuzad,527,deathknight,unholy,11,6,5
Gkdm,tichondrius,522,deathknight,unholy,21,8,13
Chës,tichondrius,522,deathknight,unholy,22,7,15
Abømination,zuljin,510,deathknight,unholy,20,6,14
Kalëndar,drakkari,503,deathknight,unholy,25,12,13
Bawlsauce,area-52,496,deathknight,unholy,13,6,7
Monstrosìty,bleeding-hollow,480,deathknight,unholy,6,5,1
Andariel,ragnaros,480,deathknight,unholy,6,5,1
Depthknight,barthilas,480,deathknight,unholy,6,5,1
Wâggies,moon-guard,480,deathknight,unholy,6,5,1
Solø,proudmoore,480,deathknight,unholy,6,5,1
Jongro,tichondrius,480,deathknight,unholy,6,5,1
Bànished,moon-guard,480,deathknight,unholy,7,5,2
Nwnqt,frostmourne,480,deathknight,unholy,9,6,3
Serathai,tichondrius,480,deathknight,unholy,12,5,7
Laboön,stormrage,480,deathknight,unholy,12,5,7
Granknight,azralon,480,deathknight,unholy,12,5,7
Defaultz,turalyon,480,deathknight,unholy,12,5,7
Darkwraith,illidan,480,deathknight,unholy,12,5,7
Swänsz,stormrage,480,deathknight,unholy,12,5,7
Dkbunny,thaurissan,480,deathknight,unholy,12,5,7
Gneanderthal,bloodscalp,480,deathknight,unholy,12,5,7
Lîch,azralon,480,deathknight,unholy,12,5,7
Noitrox,azralon,480,deathknight,unholy,12,5,7
Hardtoplaydk,chogall,480,deathknight,unholy,12,5,7
Andem,elune,480,deathknight,unholy,12,5,7
Römney,stormrage,480,deathknight,unholy,12,5,7
Schreit,zuljin,480,deathknight,unholy,12,5,7
Yeahgood,frostmourne,480,deathknight,unholy,12,5,7
Akmy,illidan,480,deathknight,unholy,12,5,7
Frostyclaws,blackrock,480,deathknight,unholy,12,5,7
Smerknight,proudmoore,480,deathknight,unholy,12,5,7
Aoshië,area-52,480,deathknight,unholy,12,5,7
Katakuri,azralon,480,deathknight,unholy,12,5,7
Erodin,moon-guard,480,deathknight,unholy,12,5,7
Irreversible,zuljin,480,deathknight,unholy,12,5,7
Cammykickbot,frostmourne,480,deathknight,unholy,12,5,7
Cosmicrune,turalyon,480,deathknight,unholy,12,5,7
Pathæs,bleeding-hollow,480,deathknight,unholy,12,5,7
Nordiin,stormrage,480,deathknight,unholy,12,5,7
Maggotmulch,zuljin,480,deathknight,unholy,12,5,7
Xariuz,quelthalas,480,deathknight,unholy,12,5,7
Deathpair,bleeding-hollow,480,deathknight,unholy,12,5,7
Darkfög,sargeras,480,deathknight,unholy,12,5,7
Raull,ragnaros,480,deathknight,unholy,12,5,7
Skotch,lightninghoof,480,deathknight,unholy,12,5,7
Akilol,tichondrius,480,deathknight,unholy,12,5,7
Vläad,ragnaros,480,deathknight,unholy,12,5,7
Initiative,moon-guard,480,deathknight,unholy,12,5,7
Ghrat,bleeding-hollow,480,deathknight,unholy,12,5,7
Kasteny,frostmourne,480,deathknight,unholy,12,5,7
Zaratose,area-52,480,deathknight,unholy,12,5,7
Defekaite,kiljaeden,480,deathknight,unholy,12,5,7
Renaming,area-52,480,deathknight,unholy,15,6,9
Skulm,emerald-dream,480,deathknight,unholy,14,5,9
Sylèss,tichondrius,480,deathknight,unholy,18,5,13
Sevendeadly,frostmourne,480,deathknight,unholy,18,5,13
Arkhän,ragnaros,480,deathknight,unholy,18,5,13
Maskofwintrs,zuljin,480,deathknight,unholy,18,5,13
Rytex,moon-guard,480,deathknight,unholy,18,5,13
Nappão,azralon,480,deathknight,unholy,19,5,14
Dementrius,zuljin,480,deathknight,unholy,25,5,20
Extremepvp,aegwynn,479,deathknight,unholy,6,5,1
Ahwooh,kelthuzad,479,deathknight,unholy,6,5,1
Mefistô,quelthalas,479,deathknight,unholy,10,6,4
Caqw,akama,479,deathknight,unholy,12,5,7
Azombie,burning-blade,479,deathknight,unholy,12,5,7
Nekrofeelyak,kelthuzad,479,deathknight,unholy,12,5,7
Borgin,emerald-dream,479,deathknight,unholy,12,5,7
Amaethyst,kelthuzad,479,deathknight,unholy,12,5,7
Jessefur,undermine,479,deathknight,unholy,12,5,7
Jojomcdeath,senjin,479,deathknight,unholy,12,5,7
Deathfearsme,kiljaeden,479,deathknight,unholy,12,5,7
Itired,tichondrius,479,deathknight,unholy,12,5,7
Kramy,barthilas,479,deathknight,unholy,12,5,7
Aborter,arthas,478,deathknight,unholy,12,5,7
Dàndàn,lightbringer,477,deathknight,unholy,12,5,7
Tandarilada,shadowmoon,476,deathknight,unholy,12,5,7
Delamuerte,ragnaros,476,deathknight,unholy,12,5,7
Draxsos,quelthalas,475,deathknight,unholy,18,5,13
Dreekon,bleeding-hollow,468,deathknight,unholy,19,9,10
Megatrôn,malganis,463,deathknight,unholy,17,5,12
Faelmo,malganis,447,deathknight,unholy,11,5,6
Fearfull,hyjal,447,deathknight,unholy,11,5,6
Iloveenzley,tichondrius,447,deathknight,unholy,11,5,6
Sorry,ysera,432,deathknight,unholy,9,6,3
Spôôn,aggramar,430,deathknight,unholy,11,5,6
Dtrayn,tichondrius,416,deathknight,unholy,10,5,5
Reighart,kiljaeden,415,deathknight,unholy,8,5,3
Testifier,illidan,415,deathknight,unholy,8,5,3
Unholyreap,arthas,415,deathknight,unholy,10,5,5
Shiminy,chogall,415,deathknight,unholy,10,5,5
Wuhán,proudmoore,414,deathknight,unholy,26,5,21
Noahmelo,nemesis,400,deathknight,unholy,7,5,2
Frostology,echo-isles,399,deathknight,unholy,5,5,0
Claudio,tichondrius,384,deathknight,unholy,6,4,2
Mistmoorex,stormscale,384,deathknight,unholy,6,4,2
Hiki,ragnaros,384,deathknight,unholy,6,4,2
Atrahazis,quelthalas,384,deathknight,unholy,6,4,2
Raynorr,dawnbringer,384,deathknight,unholy,6,4,2
Richiex,tichondrius,384,deathknight,unholy,6,4,2
Horîzon,sargeras,384,deathknight,unholy,6,4,2
Futruth,khaz-modan,384,deathknight,unholy,6,4,2
Lxsol,illidan,384,deathknight,unholy,6,4,2
Higeki,area-52,384,deathknight,unholy,6,4,2
Nøzawkolypse,area-52,384,deathknight,unholy,6,4,2
Darkswar,barthilas,384,deathknight,unholy,6,4,2
Vampygeizt,zuljin,384,deathknight,unholy,6,4,2
Koreandk,tichondrius,384,deathknight,unholy,6,4,2
Chooksknight,tichondrius,384,deathknight,unholy,6,4,2
Tragül,sargeras,384,deathknight,unholy,6,4,2
Penguinlolx,sargeras,384,deathknight,unholy,6,4,2
Whaleofwales,ysondre,384,deathknight,unholy,6,4,2
Zeathial,moon-guard,384,deathknight,unholy,6,4,2
Logann,azralon,384,deathknight,unholy,6,4,2
Keator,tichondrius,384,deathknight,unholy,6,4,2
Metinchaff,shadowmoon,384,deathknight,unholy,6,4,2
Murphu,stormrage,384,deathknight,unholy,6,4,2
Sleezyfbaby,sargeras,384,deathknight,unholy,6,4,2
Sephirott,boulderfist,384,deathknight,unholy,6,4,2
Chillbruh,garrosh,384,deathknight,unholy,6,4,2
Tibocourtois,tichondrius,384,deathknight,unholy,6,4,2
Xhamstr,frostmourne,384,deathknight,unholy,6,4,2
Zyzz,frostmourne,384,deathknight,unholy,6,4,2
Pleasecakes,blood-furnace,384,deathknight,unholy,9,5,4
Bjorstad,moon-guard,384,deathknight,unholy,12,4,8
Furcht,gundrak,384,deathknight,unholy,12,4,8
Kárd,tichondrius,384,deathknight,unholy,12,4,8
Bøngripx,tichondrius,384,deathknight,unholy,12,4,8
Dalka,laughing-skull,384,deathknight,unholy,12,4,8
Bealzabub,sargeras,384,deathknight,unholy,12,4,8
Cäin,dreadmaul,384,deathknight,unholy,12,4,8
Oomak,bonechewer,384,deathknight,unholy,12,4,8
Hounura,dathremar,384,deathknight,unholy,12,4,8
Asana,illidan,384,deathknight,unholy,12,4,8
Valandiel,jubeithos,384,deathknight,unholy,12,4,8
Boltman,malganis,384,deathknight,unholy,12,4,8
Tyrien,frostmane,384,deathknight,unholy,12,4,8
Threehunned,frostmourne,384,deathknight,unholy,12,4,8
Sonoftwodads,thrall,384,deathknight,unholy,12,4,8
Dkekk,illidan,384,deathknight,unholy,12,4,8
Dkinaboxx,hyjal,384,deathknight,unholy,12,4,8
Çorn,sargeras,384,deathknight,unholy,12,4,8
Tinylich,arthas,384,deathknight,unholy,12,4,8
Libramontes,ragnaros,384,deathknight,unholy,12,4,8
Àrchøn,kelthuzad,384,deathknight,unholy,12,4,8
Mardrank,stormrage,384,deathknight,unholy,12,4,8
Coronä,malfurion,384,deathknight,unholy,12,4,8
Grýmm,bonechewer,384,deathknight,unholy,12,4,8
Ambagrips,frostmourne,384,deathknight,unholy,12,4,8
Pharoahx,gurubashi,384,deathknight,unholy,12,4,8
Raakaa,ghostlands,384,deathknight,unholy,12,4,8
Cokedrip,bleeding-hollow,384,deathknight,unholy,12,4,8
Darkcata,tichondrius,384,deathknight,unholy,12,4,8
Noiksnow,azralon,384,deathknight,unholy,12,4,8
Yeetmaster,area-52,384,deathknight,unholy,12,4,8
Nolderosdk,nemesis,384,deathknight,unholy,12,4,8
Mournehowl,stormrage,384,deathknight,unholy,12,4,8
Wúhan,moon-guard,384,deathknight,unholy,12,4,8
Sandooñ,tichondrius,384,deathknight,unholy,12,4,8
Zoomoth,illidan,384,deathknight,unholy,12,4,8
Maalevolent,thunderlord,384,deathknight,unholy,12,4,8
Eightamdk,tichondrius,384,deathknight,unholy,12,4,8
Annuvyz,darkspear,384,deathknight,unholy,12,4,8
Daellius,ragnaros,384,deathknight,unholy,12,4,8
Testamentxx,thunderlord,384,deathknight,unholy,12,4,8
Avengis,bleeding-hollow,384,deathknight,unholy,18,4,14
Dkjs,anetheron,384,deathknight,unholy,18,4,14
Drzièglér,tichondrius,384,deathknight,unholy,18,4,14
Sahaile,moon-guard,384,deathknight,unholy,18,4,14
Keralius,stormrage,384,deathknight,unholy,18,4,14
Lho,caelestrasz,384,deathknight,unholy,18,4,14
Artous,stormrage,384,deathknight,unholy,24,4,20
Flazzul,kiljaeden,383,deathknight,unholy,6,4,2
Turbotoxic,illidan,383,deathknight,unholy,6,4,2
Hitsüyi,quelthalas,383,deathknight,unholy,11,6,5
Demher,ragnaros,383,deathknight,unholy,12,4,8
Plaguedoctor,moon-guard,383,deathknight,unholy,12,4,8
Mëllowhypë,sargeras,383,deathknight,unholy,12,4,8
Runíc,demon-soul,383,deathknight,unholy,12,4,8
Optics,bleeding-hollow,383,deathknight,unholy,12,4,8
Jinxtar,wyrmrest-accord,382,deathknight,unholy,6,4,2
Rinngar,quelthalas,382,deathknight,unholy,6,4,2
Hobyrt,bleeding-hollow,382,deathknight,unholy,6,4,2
Gankhiss,emerald-dream,351,deathknight,unholy,11,4,7
Azupo,aerie-peak,351,deathknight,unholy,14,5,9
Zuum,kelthuzad,351,deathknight,unholy,17,4,13
Ghostdeath,blackhand,336,deathknight,unholy,9,4,5
Zygon,thrall,336,deathknight,unholy,9,4,5
Ahirek,quelthalas,320,deathknight,unholy,10,4,6
Ekaj,azuremyst,319,deathknight,unholy,5,4,1
Icefrost,ghostlands,288,deathknight,unholy,6,3,3
Birnolan,proudmoore,288,deathknight,unholy,6,3,3
Drippedout,illidan,288,deathknight,unholy,6,3,3
Frostdest,kiljaeden,288,deathknight,unholy,6,3,3
Jerkin,area-52,288,deathknight,unholy,6,3,3
Adavynn,darkspear,288,deathknight,unholy,6,3,3
Xijiñpiñg,hyjal,288,deathknight,unholy,6,3,3
Greizul,area-52,288,deathknight,unholy,6,3,3
Deathlyvoid,sargeras,288,deathknight,unholy,6,3,3
Nethaar,tichondrius,288,deathknight,unholy,6,3,3
Trant,tichondrius,288,deathknight,unholy,6,3,3
Nifftybear,tichondrius,288,deathknight,unholy,6,3,3
Ödens,dalaran,288,deathknight,unholy,6,3,3
Laeroth,zuluhed,288,deathknight,unholy,6,3,3
Andeadx,tichondrius,288,deathknight,unholy,6,3,3
Darthkeefers,zuljin,288,deathknight,unholy,6,3,3
Alivaron,lothar,288,deathknight,unholy,6,3,3
Petkick,tichondrius,288,deathknight,unholy,6,3,3
Holsey,moon-guard,288,deathknight,unholy,6,3,3
Necrotictko,tichondrius,288,deathknight,unholy,6,3,3
Xhín,bleeding-hollow,288,deathknight,unholy,6,3,3
Rhors,nemesis,288,deathknight,unholy,6,3,3
Jacklinn,ysondre,288,deathknight,unholy,6,3,3
Mýrrh,wyrmrest-accord,288,deathknight,unholy,6,3,3
Redrox,tichondrius,288,deathknight,unholy,6,3,3
Jorich,ragnaros,288,deathknight,unholy,6,3,3
Smokeyjoe,aegwynn,288,deathknight,unholy,6,3,3
Rizzchimp,tichondrius,288,deathknight,unholy,6,3,3
Legendåryx,sargeras,288,deathknight,unholy,6,3,3
Válak,stormrage,288,deathknight,unholy,6,3,3
Monglord,arthas,288,deathknight,unholy,6,3,3
Viscerus,stormrage,288,deathknight,unholy,6,3,3
Plaguewar,thrall,288,deathknight,unholy,6,3,3
Vinaroth,kiljaeden,288,deathknight,unholy,6,3,3
Shookdnation,suramar,288,deathknight,unholy,6,3,3
Chrønnøz,nemesis,288,deathknight,unholy,6,3,3
Disritmia,stormrage,288,deathknight,unholy,6,3,3
Anderius,tichondrius,288,deathknight,unholy,6,3,3
Siêgfriëd,ragnaros,288,deathknight,unholy,6,3,3
Malairia,area-52,288,deathknight,unholy,6,3,3
Qberks,elune,288,deathknight,unholy,6,3,3
Mawvac,quelthalas,288,deathknight,unholy,6,3,3
Mendoh,tichondrius,288,deathknight,unholy,6,3,3
Chibalaloca,quelthalas,288,deathknight,unholy,6,3,3
Kossero,thunderlord,288,deathknight,unholy,6,3,3
Bosleigor,elune,288,deathknight,unholy,6,3,3
Pepecoomer,frostmourne,288,deathknight,unholy,6,3,3
Marash,moon-guard,288,deathknight,unholy,6,3,3
Icycrazy,azralon,288,deathknight,unholy,6,3,3
Blitzcreig,sargeras,288,deathknight,unholy,6,3,3
Ariacy,sargeras,288,deathknight,unholy,6,3,3
Indraz,jubeithos,288,deathknight,unholy,6,3,3
Vexmaw,twisting-nether,288,deathknight,unholy,6,3,3
Sindragosa,dragonmaw,288,deathknight,unholy,6,3,3
Frenzza,frostmourne,288,deathknight,unholy,6,3,3
Sherank,akama,288,deathknight,unholy,6,3,3
Lafourche,sargeras,288,deathknight,unholy,6,3,3
Micteca,moonrunner,288,deathknight,unholy,7,3,4
Oroborus,korgath,288,deathknight,unholy,8,3,5
Boomxic,shuhalo,288,deathknight,unholy,11,4,7
Garonse,wyrmrest-accord,288,deathknight,unholy,12,3,9
Rottenqunt,tichondrius,288,deathknight,unholy,12,3,9
Chosenrune,stormrage,288,deathknight,unholy,12,3,9
Mongomongo,malganis,288,deathknight,unholy,12,3,9
Gigabone,tichondrius,288,deathknight,unholy,12,3,9
Lolgriped,tichondrius,288,deathknight,unholy,12,3,9
Techneeq,tichondrius,288,deathknight,unholy,12,3,9
Fokit,barthilas,288,deathknight,unholy,12,3,9
Chosenhero,stormrage,288,deathknight,unholy,12,3,9
Angerforge,illidan,288,deathknight,unholy,12,3,9
Emotionaldam,area-52,288,deathknight,unholy,12,3,9
Zerky,stormrage,288,deathknight,unholy,12,3,9
Sübzerö,quelthalas,288,deathknight,unholy,12,3,9
Danlorinis,moon-guard,288,deathknight,unholy,12,3,9
Coldmilk,wyrmrest-accord,288,deathknight,unholy,12,3,9
Kaspbrak,destromath,288,deathknight,unholy,12,3,9
Supermane,jubeithos,288,deathknight,unholy,12,3,9
Carmii,wyrmrest-accord,288,deathknight,unholy,12,3,9
Torsophuk,stormrage,288,deathknight,unholy,12,3,9
Coffeemilk,kiljaeden,288,deathknight,unholy,13,3,10
Deathsent,malganis,288,deathknight,unholy,18,3,15
Kreachuer,lightbringer,287,deathknight,unholy,6,3,3
Thepanzer,elune,287,deathknight,unholy,6,3,3
Malovv,nemesis,287,deathknight,unholy,6,3,3
Jman,kaelthas,287,deathknight,unholy,6,3,3
Chanskey,stormrage,287,deathknight,unholy,9,3,6
Zedknight,emerald-dream,287,deathknight,unholy,15,4,11
Morthul,tol-barad,287,deathknight,unholy,12,3,9
Papparoach,ysera,286,deathknight,unholy,6,3,3
Orthason,moon-guard,286,deathknight,unholy,6,3,3
Copy,suramar,271,deathknight,unholy,11,3,8
Lockstocked,dathremar,256,deathknight,unholy,4,4,0
Milkdrugs,daggerspine,256,deathknight,unholy,10,3,7
Baskel,frostmane,255,deathknight,unholy,11,3,8
Deathrowe,blackhand,240,deathknight,unholy,9,3,6
Dairboi,sargeras,239,deathknight,unholy,5,3,2
Originalsin,tichondrius,239,deathknight,unholy,11,3,8
Rompeimën,ragnaros,234,deathknight,unholy,11,6,5
Charabone,ragnaros,192,deathknight,unholy,4,3,1
Moonkhink,stormrage,192,deathknight,unholy,6,2,4
Junepí,stormrage,192,deathknight,unholy,6,2,4
Geth,sargeras,192,deathknight,unholy,6,2,4
Eastcoast,azuremyst,192,deathknight,unholy,6,2,4
Sieg,goldrinn,192,deathknight,unholy,6,2,4
Deathgimbo,hellscream,192,deathknight,unholy,6,2,4
Spaxz,illidan,192,deathknight,unholy,6,2,4
Bloodemperor,malfurion,192,deathknight,unholy,6,2,4
Dkb,drakthul,192,deathknight,unholy,6,2,4
Deathhimself,moonrunner,192,deathknight,unholy,6,2,4
Teedk,drakthul,192,deathknight,unholy,6,2,4
Ralphpootawn,illidan,192,deathknight,unholy,6,2,4
Grimreminder,zuljin,192,deathknight,unholy,6,2,4
Afkftwok,illidan,192,deathknight,unholy,6,2,4
Uncoachablex,illidan,192,deathknight,unholy,6,2,4
Mythandour,shandris,192,deathknight,unholy,6,2,4
Corscadden,zuljin,192,deathknight,unholy,6,2,4
Fizzease,illidan,192,deathknight,unholy,6,2,4
Blooddisease,frostmourne,192,deathknight,unholy,6,2,4
Menalise,moon-guard,192,deathknight,unholy,6,2,4
Dkgrrick,bleeding-hollow,192,deathknight,unholy,6,2,4
Kranaz,barthilas,192,deathknight,unholy,6,2,4
Tristam,area-52,192,deathknight,unholy,6,2,4
Twocolors,gilneas,192,deathknight,unholy,6,2,4
Dustknight,sargeras,192,deathknight,unholy,6,2,4
Nightdaddyy,laughing-skull,192,deathknight,unholy,6,2,4
Bogoraptor,emerald-dream,192,deathknight,unholy,6,2,4
Orbo,elune,192,deathknight,unholy,6,2,4
Questíonable,arthas,192,deathknight,unholy,6,2,4
Ahmisu,tichondrius,192,deathknight,unholy,6,2,4
Disturbedtwo,azralon,192,deathknight,unholy,6,2,4
Janoh,the-scryers,192,deathknight,unholy,6,2,4
Dxssxe,tichondrius,192,deathknight,unholy,6,2,4
Dhaarok,malganis,192,deathknight,unholy,6,2,4
Nurglet,proudmoore,192,deathknight,unholy,6,2,4
Reizu,ragnaros,192,deathknight,unholy,6,2,4
Otr,wyrmrest-accord,192,deathknight,unholy,6,2,4
Jinus,earthen-ring,192,deathknight,unholy,6,2,4
Atheion,the-underbog,192,deathknight,unholy,6,2,4
Onsslaught,sargeras,192,deathknight,unholy,6,2,4
Patchi,area-52,192,deathknight,unholy,6,2,4
Sinnan,turalyon,192,deathknight,unholy,6,2,4
Orcazmic,area-52,192,deathknight,unholy,6,2,4
Kmardk,area-52,192,deathknight,unholy,6,2,4
Mesx,tichondrius,192,deathknight,unholy,6,2,4
Supfam,tichondrius,192,deathknight,unholy,6,2,4
Lunatick,darkspear,192,deathknight,unholy,6,2,4
Rockadeath,sargeras,192,deathknight,unholy,6,2,4
Havasu,proudmoore,192,deathknight,unholy,6,2,4
Lìlith,dreadmaul,192,deathknight,unholy,6,2,4
Saraphdk,area-52,192,deathknight,unholy,6,2,4
Weedseagull,dragonmaw,192,deathknight,unholy,6,2,4
Hastë,proudmoore,192,deathknight,unholy,6,2,4
Gusabio,drakkari,192,deathknight,unholy,6,2,4
Kniightdkk,kelthuzad,192,deathknight,unholy,6,2,4
Vlladimir,kelthuzad,192,deathknight,unholy,6,2,4
Zerodk,kelthuzad,192,deathknight,unholy,6,2,4
Bealzabubb,sargeras,192,deathknight,unholy,6,2,4
Hanung,tichondrius,192,deathknight,unholy,6,2,4
Chandsformer,tichondrius,192,deathknight,unholy,6,2,4
Gatitos,ragnaros,192,deathknight,unholy,6,2,4
Dkdkdkdkdk,chromaggus,192,deathknight,unholy,6,2,4
Semisoftbody,malganis,192,deathknight,unholy,6,2,4
Tbop,ragnaros,192,deathknight,unholy,6,2,4
Poubelle,malganis,192,deathknight,unholy,6,2,4
Zilli,blackrock,192,deathknight,unholy,6,2,4
Kookx,tichondrius,192,deathknight,unholy,6,2,4
Bagul,azralon,192,deathknight,unholy,6,2,4
Raahjx,sargeras,192,deathknight,unholy,6,2,4
Válhállá,ragnaros,192,deathknight,unholy,6,2,4
Gooré,ragnaros,192,deathknight,unholy,6,2,4
Spotsdk,hyjal,192,deathknight,unholy,6,2,4
Mako,garithos,192,deathknight,unholy,6,2,4
Mistake,ragnaros,192,deathknight,unholy,6,2,4
Chachea,kiljaeden,192,deathknight,unholy,12,2,10
Rykard,hyjal,192,deathknight,unholy,12,2,10
Longlnus,malganis,192,deathknight,unholy,12,2,10
Stteve,proudmoore,192,deathknight,unholy,12,2,10
Tacofoxlol,tichondrius,192,deathknight,unholy,12,2,10
Maliceborn,stormrage,192,deathknight,unholy,12,2,10
Scythê,barthilas,192,deathknight,unholy,12,2,10
Mystery,wyrmrest-accord,192,deathknight,unholy,12,2,10
Cow,sargeras,192,deathknight,unholy,12,2,10
Giraldus,stormrage,192,deathknight,unholy,12,2,10
Ðìvíne,illidan,192,deathknight,unholy,12,2,10
Ovulating,malganis,192,deathknight,unholy,12,2,10
Lunaxx,ragnaros,192,deathknight,unholy,12,2,10
Vynjonc,drenden,191,deathknight,unholy,6,2,4
Larrisey,illidan,191,deathknight,unholy,6,2,4
Drdeathz,sargeras,191,deathknight,unholy,6,2,4
Fishtouching,illidan,175,deathknight,unholy,11,2,9
Guffles,tichondrius,160,deathknight,unholy,10,2,8
Hooker,dragonmaw,138,deathknight,unholy,8,4,4
Glacíuss,ragnaros,138,deathknight,unholy,9,4,5
Plutonyus,stonemaul,128,deathknight,unholy,4,2,2
Ðëthbringër,jubeithos,127,deathknight,unholy,8,2,6
Tìtø,ragnaros,96,deathknight,unholy,6,1,5
Moldremover,frostmourne,96,deathknight,unholy,6,1,5
Testitickler,gurubashi,96,deathknight,unholy,6,1,5
Lazynome,azshara,96,deathknight,unholy,6,1,5
Bulltille,azralon,96,deathknight,unholy,6,1,5
Hushima,lightbringer,96,deathknight,unholy,6,1,5
Drip,whisperwind,96,deathknight,unholy,6,1,5
Andivh,hydraxis,96,deathknight,unholy,6,1,5
Bealzabbub,sargeras,96,deathknight,unholy,6,1,5
Amö,emerald-dream,96,deathknight,unholy,6,1,5
Stormsick,ragnaros,96,deathknight,unholy,6,1,5
Hunwild,emerald-dream,96,deathknight,unholy,6,1,5
Apeirøn,quelthalas,96,deathknight,unholy,6,1,5
Istery,thrall,96,deathknight,unholy,6,1,5
Gnargnarr,firetree,96,deathknight,unholy,6,1,5
Alexanderz,quelthalas,96,deathknight,unholy,6,1,5
Krw,stormrage,96,deathknight,unholy,6,1,5
Deathscyythe,illidan,96,deathknight,unholy,6,1,5
Terrethess,illidan,96,deathknight,unholy,6,1,5
Abake,illidan,96,deathknight,unholy,6,1,5
Iluvbooty,blackrock,96,deathknight,unholy,6,1,5
Gröxxigor,azralon,96,deathknight,unholy,6,1,5
Bein,frostmourne,96,deathknight,unholy,6,1,5
Lichhbanne,doomhammer,96,deathknight,unholy,6,1,5
Wacktony,illidan,96,deathknight,unholy,6,1,5
Rgn,deathwing,96,deathknight,unholy,6,1,5
Dknightor,dalaran,96,deathknight,unholy,6,1,5
Sever,demon-soul,96,deathknight,unholy,6,1,5
Kìrìtó,malygos,96,deathknight,unholy,6,1,5
Artyboy,icecrown,96,deathknight,unholy,6,1,5
Apocalypsis,uldum,96,deathknight,unholy,6,1,5
Ishamaael,tichondrius,96,deathknight,unholy,6,1,5
Heavic,skywall,96,deathknight,unholy,6,1,5
Skynyght,area-52,96,deathknight,unholy,6,1,5
Alayssia,darkspear,96,deathknight,unholy,6,1,5
Argy,zuljin,96,deathknight,unholy,6,1,5
Requísition,barthilas,96,deathknight,unholy,6,1,5
Tarone,zuljin,96,deathknight,unholy,6,1,5
Sandolorian,area-52,96,deathknight,unholy,6,1,5
Dontbanmepls,zuljin,96,deathknight,unholy,6,1,5
Zetarexia,area-52,96,deathknight,unholy,6,1,5
Dethklòk,area-52,96,deathknight,unholy,6,1,5
Almostdead,proudmoore,96,deathknight,unholy,6,1,5
Grimorra,bleeding-hollow,96,deathknight,unholy,6,1,5
Dreâmer,tichondrius,96,deathknight,unholy,6,1,5
Vicedro,arthas,96,deathknight,unholy,6,1,5
Percy,thaurissan,96,deathknight,unholy,6,1,5
Vicesquad,tichondrius,96,deathknight,unholy,6,1,5
Zenin,emerald-dream,96,deathknight,unholy,6,1,5
Report,dathremar,96,deathknight,unholy,6,1,5
Nachohands,laughing-skull,96,deathknight,unholy,6,1,5
Azryull,perenolde,96,deathknight,unholy,6,1,5
Vorlakesh,boulderfist,96,deathknight,unholy,6,1,5
Otarin,tichondrius,96,deathknight,unholy,6,1,5
Worgenracist,tichondrius,96,deathknight,unholy,6,1,5
Rotfang,elune,96,deathknight,unholy,6,1,5
Diviniums,bleeding-hollow,96,deathknight,unholy,6,1,5
Perculës,sargeras,96,deathknight,unholy,7,1,6
Aqs,sargeras,96,deathknight,unholy,9,1,8
Níce,tichondrius,96,deathknight,unholy,12,1,11
Dípero,azralon,96,deathknight,unholy,12,1,11
Wkxx,tichondrius,96,deathknight,unholy,12,1,11
Klàssy,stormrage,96,deathknight,unholy,12,1,11
Skadattle,emerald-dream,96,deathknight,unholy,12,1,11
Darnkiller,kelthuzad,96,deathknight,unholy,18,1,17
Droko,thunderlord,95,deathknight,unholy,9,2,7
Funerall,azralon,95,deathknight,unholy,12,1,11
Frostbytez,barthilas,79,deathknight,unholy,5,1,4
Explorer,kelthuzad,64,deathknight,unholy,4,1,3
Deanz,stormrage,63,deathknight,unholy,2,2,0
Asfaq,frostmourne,63,deathknight,unholy,2,2,0
Weebfiend,moon-guard,63,deathknight,unholy,2,2,0
Spleem,stormrage,48,deathknight,unholy,3,1,2
Lördd,moon-guard,42,deathknight,unholy,11,3,8
Harrypottr,darrowmere,42,deathknight,unholy,8,2,6
Pookr,area-52,2214,deathknight,frost,355,180,175
Yoinkzz,illidan,2167,deathknight,frost,113,58,55
Thânätos,nemesis,1980,deathknight,frost,84,44,40
Sylèss,tichondrius,1979,deathknight,frost,84,47,37
Runtasticxz,tichondrius,1906,deathknight,frost,60,29,31
Raiekko,dalaran,1888,deathknight,frost,68,33,35
Duranteh,illidan,1881,deathknight,frost,60,32,28
Venvicta,tichondrius,1850,deathknight,frost,44,31,13
Saco,malganis,1845,deathknight,frost,110,62,48
Scareth,proudmoore,1823,deathknight,frost,46,27,19
Deaddubya,illidan,1815,deathknight,frost,63,40,23
Mikeycal,stormrage,1805,deathknight,frost,66,34,32
Gladiaturd,hellscream,1782,deathknight,frost,76,38,38
Dkyeico,ragnaros,1762,deathknight,frost,90,44,46
Chillbaynê,the-scryers,1754,deathknight,frost,36,22,14
Ksmc,tichondrius,1740,deathknight,frost,54,27,27
Fastapi,tichondrius,1737,deathknight,frost,90,41,49
Iccyhottie,stormrage,1722,deathknight,frost,196,103,93
Sober,destromath,1712,deathknight,frost,95,48,47
Axiomqt,tichondrius,1710,deathknight,frost,48,25,23
Devcoil,sargeras,1706,deathknight,frost,54,22,32
Mikepinkdk,illidan,1700,deathknight,frost,75,40,35
Remanent,tichondrius,1680,deathknight,frost,48,27,21
Crink,sargeras,1658,deathknight,frost,47,24,23
Menalise,moon-guard,1650,deathknight,frost,42,22,20
Deathboost,stormrage,1647,deathknight,frost,75,33,42
Børeas,quelthalas,1645,deathknight,frost,96,43,53
Gkdm,tichondrius,1643,deathknight,frost,42,21,21
Jykupajr,proudmoore,1629,deathknight,frost,42,22,20
Xelonith,sargeras,1627,deathknight,frost,30,17,13
Tzepesci,hyjal,1626,deathknight,frost,58,26,32
Sinizster,kelthuzad,1615,deathknight,frost,31,18,13
Ebolaxd,area-52,1614,deathknight,frost,42,21,21
Rekktless,aerie-peak,1613,deathknight,frost,66,34,32
Grippygarý,illidan,1600,deathknight,frost,42,19,23
Worgenracist,tichondrius,1598,deathknight,frost,53,22,31
Frosthana,illidan,1596,deathknight,frost,78,34,44
Fußuky,quelthalas,1594,deathknight,frost,76,39,37
Zemzil,tichondrius,1559,deathknight,frost,56,25,31
Skullash,stormrage,1538,deathknight,frost,36,19,17
Grakth,quelthalas,1527,deathknight,frost,66,37,29
Darkwraith,illidan,1525,deathknight,frost,42,21,21
Uzgard,zuljin,1517,deathknight,frost,65,38,27
Jimmyjohnson,illidan,1500,deathknight,frost,77,44,33
Report,dathremar,1494,deathknight,frost,75,38,37
Trødz,tichondrius,1468,deathknight,frost,87,42,45
Rembrandtdk,gorefiend,1467,deathknight,frost,54,29,25
Lho,caelestrasz,1465,deathknight,frost,107,54,53
Vust,malganis,1454,deathknight,frost,42,23,19
Dekanok,korgath,1452,deathknight,frost,30,16,14
Jazh,tichondrius,1441,deathknight,frost,59,23,36
Umbramane,tichondrius,1438,deathknight,frost,39,19,20
Iskandàr,ragnaros,1435,deathknight,frost,32,16,16
Vãl,sargeras,1434,deathknight,frost,155,72,83
Abrahams,tichondrius,1427,deathknight,frost,100,48,52
Percy,thaurissan,1427,deathknight,frost,181,80,101
Emanuels,quelthalas,1425,deathknight,frost,56,28,28
Deadspellz,bleeding-hollow,1423,deathknight,frost,30,15,15
Vuldy,blackhand,1396,deathknight,frost,30,17,13
Eldavò,quelthalas,1393,deathknight,frost,60,25,35
Corrpsse,tichondrius,1390,deathknight,frost,30,16,14
Algeross,dalaran,1379,deathknight,frost,42,15,27
Khalid,azgalor,1376,deathknight,frost,54,23,31
Clongeus,tichondrius,1374,deathknight,frost,54,25,29
Tangarang,dalaran,1372,deathknight,frost,68,30,38
Imfrozone,stormrage,1371,deathknight,frost,35,15,20
Sinyay,tichondrius,1370,deathknight,frost,82,48,34
Ellipsoro,onyxia,1362,deathknight,frost,78,35,43
Sandooñ,tichondrius,1359,deathknight,frost,138,67,71
Nevermor,malganis,1358,deathknight,frost,98,50,48
Theronguard,area-52,1358,deathknight,frost,48,22,26
Rylas,destromath,1356,deathknight,frost,75,38,37
Gwab,stormrage,1354,deathknight,frost,48,20,28
Eloton,daggerspine,1350,deathknight,frost,35,18,17
Thetalis,moon-guard,1346,deathknight,frost,78,38,40
Kryptikkyt,blackrock,1341,deathknight,frost,18,14,4
Ðerion,stormrage,1339,deathknight,frost,116,52,64
Clapdat,malganis,1335,deathknight,frost,114,56,58
Onsslaught,sargeras,1334,deathknight,frost,42,14,28
Kruspy,area-52,1324,deathknight,frost,53,27,26
Dontbanmepls,zuljin,1318,deathknight,frost,30,14,16
Tekc,nemesis,1317,deathknight,frost,132,64,68
Jordankg,tanaris,1312,deathknight,frost,36,15,21
Bridenbrad,quelthalas,1299,deathknight,frost,27,17,10
Iceice,emerald-dream,1296,deathknight,frost,102,47,55
Flins,nemesis,1288,deathknight,frost,384,195,189
Estali,kelthuzad,1272,deathknight,frost,110,51,59
Abake,illidan,1267,deathknight,frost,62,30,32
Lichborn,azralon,1265,deathknight,frost,65,26,39
Alexanderz,quelthalas,1264,deathknight,frost,36,15,21
Alexeous,wyrmrest-accord,1261,deathknight,frost,103,43,60
Friggintough,tichondrius,1255,deathknight,frost,30,14,16
Barrodir,tichondrius,1243,deathknight,frost,69,36,33
Darkdeviliv,darkspear,1238,deathknight,frost,41,21,20
Bâttalion,illidan,1237,deathknight,frost,30,13,17
Rayden,frostmourne,1235,deathknight,frost,24,13,11
Yödä,barthilas,1235,deathknight,frost,36,14,22
Darketvam,illidan,1230,deathknight,frost,38,23,15
Bossk,emerald-dream,1229,deathknight,frost,30,13,17
Spoon,sargeras,1223,deathknight,frost,70,33,37
Sécret,tichondrius,1212,deathknight,frost,24,13,11
Rohdey,madoran,1210,deathknight,frost,42,15,27
Jackofblades,veknilash,1204,deathknight,frost,66,32,34
Darkreígn,tichondrius,1202,deathknight,frost,59,28,31
Seeyoudiebr,gallywix,1190,deathknight,frost,42,17,25
Zefdk,illidan,1186,deathknight,frost,48,27,21
Dkptador,azralon,1182,deathknight,frost,130,64,66
Darfik,sargeras,1177,deathknight,frost,120,65,55
Lîch,azralon,1157,deathknight,frost,63,24,39
Tìtø,ragnaros,1151,deathknight,frost,24,12,12
Lxsol,illidan,1149,deathknight,frost,18,12,6
Tambaknight,nemesis,1146,deathknight,frost,44,15,29
Soulfang,nemesis,1145,deathknight,frost,54,25,29
Laumuelden,ragnaros,1143,deathknight,frost,48,17,31
Janco,runetotem,1141,deathknight,frost,24,12,12
Frostunholy,tichondrius,1140,deathknight,frost,24,12,12
Hiki,ragnaros,1134,deathknight,frost,30,12,18
Verhangnis,azjolnerub,1123,deathknight,frost,20,12,8
Achilleo,quelthalas,1115,deathknight,frost,24,12,12
Pembadk,tichondrius,1110,deathknight,frost,33,14,19
Janoh,the-scryers,1095,deathknight,frost,32,16,16
Ârtas,uldum,1090,deathknight,frost,39,16,23
Moonnwater,frostmourne,1087,deathknight,frost,84,43,41
Sephirott,boulderfist,1086,deathknight,frost,35,19,16
Garryxz,quelthalas,1077,deathknight,frost,22,12,10
Darkdevilvii,tichondrius,1069,deathknight,frost,66,33,33
Mawvac,quelthalas,1069,deathknight,frost,72,33,39
Zephyx,lightbringer,1056,deathknight,frost,18,11,7
Toxismall,zuljin,1056,deathknight,frost,24,11,13
Puppykisses,perenolde,1055,deathknight,frost,24,11,13
Icewalløw,darkspear,1052,deathknight,frost,18,11,7
Jhonnsnow,frostmourne,1051,deathknight,frost,24,11,13
Dregdar,emerald-dream,1049,deathknight,frost,18,11,7
Griswold,windrunner,1049,deathknight,frost,30,15,15
Malovv,nemesis,1042,deathknight,frost,18,12,6
Dromidon,darkspear,1036,deathknight,frost,23,11,12
Vanyor,wyrmrest-accord,1025,deathknight,frost,44,14,30
Zarathraz,ragnaros,1004,deathknight,frost,23,11,12
Roarbane,muradin,999,deathknight,frost,42,22,20
Icedmilk,zuluhed,982,deathknight,frost,25,14,11
Tarone,zuljin,981,deathknight,frost,27,14,13
Vorlakesh,boulderfist,979,deathknight,frost,22,11,11
Skittsdk,thrall,966,deathknight,frost,24,12,12
Xhín,bleeding-hollow,959,deathknight,frost,18,10,8
Tokyotimxx,malganis,958,deathknight,frost,18,10,8
Thetissuebox,emerald-dream,958,deathknight,frost,18,10,8
Toothstick,stormrage,957,deathknight,frost,18,10,8
Necrósy,azralon,955,deathknight,frost,18,10,8
Axylus,kelthuzad,953,deathknight,frost,18,10,8
Raegywn,blood-furnace,952,deathknight,frost,24,10,14
Eliagianluca,caelestrasz,949,deathknight,frost,60,25,35
Loverianed,aerie-peak,946,deathknight,frost,106,46,60
Úndead,barthilas,943,deathknight,frost,18,10,8
Larrisey,illidan,940,deathknight,frost,33,18,15
Kraige,tichondrius,933,deathknight,frost,30,10,20
Ciputra,blood-furnace,929,deathknight,frost,47,23,24
ßlazedkush,kelthuzad,928,deathknight,frost,18,10,8
Blooddisease,frostmourne,926,deathknight,frost,23,10,13
Kallugrax,kelthuzad,919,deathknight,frost,30,12,18
Fokit,barthilas,897,deathknight,frost,58,28,30
Sandolorian,area-52,892,deathknight,frost,24,10,14
Lokitabeso,ragnaros,864,deathknight,frost,12,9,3
Legendåryx,sargeras,863,deathknight,frost,12,9,3
Lazenca,malganis,863,deathknight,frost,18,9,9
Zarakas,sargeras,863,deathknight,frost,24,9,15
Deathzpeckt,tichondrius,863,deathknight,frost,24,9,15
Kekkijutsu,bleeding-hollow,862,deathknight,frost,12,9,3
Zivz,borean-tundra,862,deathknight,frost,12,9,3
Thesseo,quelthalas,862,deathknight,frost,18,9,9
Surcäfauces,ragnaros,862,deathknight,frost,21,10,11
Dkbunny,thaurissan,862,deathknight,frost,30,9,21
Chicnchsteak,tichondrius,862,deathknight,frost,30,9,21
Jasmíne,vashj,861,deathknight,frost,12,9,3
Dreekon,bleeding-hollow,861,deathknight,frost,12,9,3
Urieen,gorefiend,861,deathknight,frost,18,9,9
Ântipaladin,arthas,859,deathknight,frost,18,9,9
Sporkdk,illidan,859,deathknight,frost,29,9,20
Janzano,deathwing,858,deathknight,frost,20,9,11
Sllice,aegwynn,858,deathknight,frost,24,9,15
Metaphysicsx,amanthul,839,deathknight,frost,20,9,11
Madorderog,stormrage,834,deathknight,frost,34,15,19
Sakaarr,bleeding-hollow,830,deathknight,frost,24,9,15
Dèadpool,blackhand,828,deathknight,frost,18,9,9
Uncfester,onyxia,823,deathknight,frost,18,9,9
Neofrank,drakkari,800,deathknight,frost,54,13,41
Plaw,kiljaeden,799,deathknight,frost,17,9,8
Lokítabesos,ragnaros,768,deathknight,frost,12,8,4
Havince,drenden,768,deathknight,frost,12,8,4
Vigasick,azralon,768,deathknight,frost,18,8,10
Incanis,moon-guard,767,deathknight,frost,18,8,10
Gypo,scilla,766,deathknight,frost,12,8,4
Artourias,wyrmrest-accord,766,deathknight,frost,12,8,4
Kerigann,moon-guard,766,deathknight,frost,12,8,4
Freemoney,wyrmrest-accord,766,deathknight,frost,12,8,4
Dhrogar,moon-guard,762,deathknight,frost,12,8,4
Dyingwolf,ragnaros,761,deathknight,frost,18,8,10
Jyantdeck,area-52,760,deathknight,frost,13,8,5
Zarolden,tichondrius,759,deathknight,frost,24,8,16
Nagaizao,nemesis,757,deathknight,frost,18,8,10
Hansmclroy,trollbane,738,deathknight,frost,24,8,16
Fexon,queldorei,735,deathknight,frost,27,9,18
Monglord,arthas,733,deathknight,frost,27,9,18
Unhappyvelic,tichondrius,720,deathknight,frost,21,8,13
Russkivolk,frostmourne,688,deathknight,frost,19,8,11
Insanity,boulderfist,672,deathknight,frost,12,7,5
Dumbledore,deathwing,672,deathknight,frost,12,7,5
Anexdk,korgath,672,deathknight,frost,18,7,11
Chillpills,stormrage,672,deathknight,frost,18,7,11
Iriwa,tichondrius,672,deathknight,frost,24,7,17
Unholycube,zuljin,671,deathknight,frost,30,7,23
Carecaa,azralon,670,deathknight,frost,18,7,11
Elwoodblooz,stormrage,669,deathknight,frost,15,8,7
Cryptgore,moon-guard,665,deathknight,frost,18,7,11
Ixiefin,sargeras,663,deathknight,frost,12,7,5
Dantte,stormscale,659,deathknight,frost,18,7,11
Iiedown,stormrage,623,deathknight,frost,11,7,4
Wap,bloodhoof,576,deathknight,frost,12,6,6
Soulbone,wyrmrest-accord,576,deathknight,frost,12,6,6
Dementrius,zuljin,576,deathknight,frost,12,6,6
Rotfang,proudmoore,576,deathknight,frost,12,6,6
Dreadlight,moon-guard,576,deathknight,frost,12,6,6
Sparklekitty,illidan,576,deathknight,frost,12,6,6
Cozzasad,barthilas,576,deathknight,frost,12,6,6
Riglros,tichondrius,576,deathknight,frost,12,6,6
Aldrey,bonechewer,576,deathknight,frost,12,6,6
Otarin,tichondrius,576,deathknight,frost,12,6,6
Rennoc,emerald-dream,576,deathknight,frost,12,6,6
Darkxavros,stormrage,576,deathknight,frost,12,6,6
Beliath,crushridge,576,deathknight,frost,17,6,11
Dairboi,sargeras,576,deathknight,frost,18,6,12
Ariacy,sargeras,576,deathknight,frost,18,6,12
Flûffÿ,thrall,575,deathknight,frost,12,6,6
Mexe,ragnaros,575,deathknight,frost,12,6,6
Davenn,stormrage,575,deathknight,frost,12,6,6
Tooe,darrowmere,575,deathknight,frost,12,6,6
Winterstone,moon-guard,575,deathknight,frost,12,6,6
Nezareth,sargeras,574,deathknight,frost,12,6,6
Bloodbanne,darkspear,573,deathknight,frost,12,6,6
Krowl,nagrand,570,deathknight,frost,12,6,6
Ikaris,wildhammer,569,deathknight,frost,12,6,6
Parksy,kelthuzad,559,deathknight,frost,11,6,5
Werebuddy,lightnings-blade,528,deathknight,frost,15,6,9
Bellum,moon-guard,511,deathknight,frost,20,6,14
Kookx,tichondrius,489,deathknight,frost,13,6,7
Wahpow,frostwolf,480,deathknight,frost,6,5,1
Lokitaßeso,ragnaros,480,deathknight,frost,6,5,1
Vett,antonidas,480,deathknight,frost,6,5,1
Sathanazz,ragnaros,480,deathknight,frost,6,5,1
Busynas,thrall,480,deathknight,frost,6,5,1
Subparatbest,chogall,480,deathknight,frost,12,5,7
Martinnash,emerald-dream,480,deathknight,frost,12,5,7
Himanshu,emerald-dream,480,deathknight,frost,12,5,7
Sinistarz,area-52,480,deathknight,frost,12,5,7
Neaz,moon-guard,480,deathknight,frost,12,5,7
Deadbeards,zuluhed,480,deathknight,frost,12,5,7
Denale,darkspear,480,deathknight,frost,12,5,7
Kodokuna,bleeding-hollow,480,deathknight,frost,12,5,7
Flashofdark,proudmoore,480,deathknight,frost,12,5,7
Rumblepuppy,hyjal,480,deathknight,frost,12,5,7
Frozenhawk,lothar,480,deathknight,frost,12,5,7
Unintended,barthilas,480,deathknight,frost,18,5,13
Saighast,illidan,480,deathknight,frost,18,5,13
Moovement,illidan,479,deathknight,frost,6,5,1
Bëlzëbü,stormrage,479,deathknight,frost,6,5,1
Bulltille,azralon,479,deathknight,frost,6,5,1
Twicecursed,kelthuzad,479,deathknight,frost,12,5,7
Caravante,azralon,479,deathknight,frost,12,5,7
Bigdkk,thaurissan,477,deathknight,frost,12,5,7
Adjudicated,darkspear,477,deathknight,frost,12,5,7
Ðecimate,muradin,476,deathknight,frost,12,5,7
Killa,maiev,475,deathknight,frost,12,5,7
Ergoth,darkspear,475,deathknight,frost,24,5,19
Neowolf,azgalor,473,deathknight,frost,30,5,25
Frostyclaws,blackrock,447,deathknight,frost,17,5,12
Greeasy,bleeding-hollow,446,deathknight,frost,17,5,12
Dìs,frostmourne,399,deathknight,frost,5,5,0
Anatøly,ragnaros,384,deathknight,frost,6,4,2
Aldebamuu,ragnaros,384,deathknight,frost,6,4,2
Bigdooks,area-52,384,deathknight,frost,6,4,2
Nabreus,ragnaros,384,deathknight,frost,6,4,2
Tanjus,kelthuzad,384,deathknight,frost,6,4,2
Tontan,cairne,384,deathknight,frost,6,4,2
Lókhä,thrall,384,deathknight,frost,6,4,2
Orbo,elune,384,deathknight,frost,6,4,2
Laxatives,tichondrius,384,deathknight,frost,6,4,2
Hunrune,emerald-dream,384,deathknight,frost,6,4,2
Lichhbanne,doomhammer,384,deathknight,frost,12,4,8
Silanvia,wyrmrest-accord,384,deathknight,frost,12,4,8
Exiledknight,area-52,384,deathknight,frost,12,4,8
Aradorn,azralon,384,deathknight,frost,12,4,8
Shmacmiller,stormrage,384,deathknight,frost,12,4,8
Zenin,emerald-dream,384,deathknight,frost,12,4,8
Almostdead,proudmoore,384,deathknight,frost,12,4,8
Hooterzqt,tichondrius,384,deathknight,frost,12,4,8
Thikness,tichondrius,384,deathknight,frost,12,4,8
Deathrowe,blackhand,384,deathknight,frost,12,4,8
Whytedk,illidan,384,deathknight,frost,12,4,8
Xhoul,sargeras,384,deathknight,frost,12,4,8
Nefarion,nathrezim,384,deathknight,frost,15,4,11
Ðaz,zuljin,384,deathknight,frost,18,4,14
Wãrson,bleeding-hollow,383,deathknight,frost,6,4,2
Shinici,kelthuzad,383,deathknight,frost,9,5,4
Grimmr,tichondrius,383,deathknight,frost,12,4,8
Amauqsun,bleeding-hollow,383,deathknight,frost,12,4,8
Vithael,stormrage,383,deathknight,frost,12,4,8
Getmad,anvilmar,383,deathknight,frost,12,4,8
Bullbanger,runetotem,382,deathknight,frost,6,4,2
Cailras,argent-dawn,382,deathknight,frost,6,4,2
Sindragos,stormrage,382,deathknight,frost,12,4,8
Deathvortex,nemesis,379,deathknight,frost,12,4,8
Khaíne,wyrmrest-accord,352,deathknight,frost,13,4,9
Lokitakisses,ragnaros,351,deathknight,frost,11,4,7
Bunghoolio,nerzhul,315,deathknight,frost,16,4,12
Yungdooks,area-52,288,deathknight,frost,6,3,3
Arnagal,drakkari,288,deathknight,frost,6,3,3
Trant,tichondrius,288,deathknight,frost,6,3,3
Störmrünner,kelthuzad,288,deathknight,frost,6,3,3
Amarlana,mannoroth,288,deathknight,frost,6,3,3
Frostybones,guldan,288,deathknight,frost,6,3,3
Egirlgripper,area-52,288,deathknight,frost,6,3,3
Saraphdk,area-52,288,deathknight,frost,6,3,3
Gorsz,tichondrius,288,deathknight,frost,6,3,3
Fåîrÿdûst,skullcrusher,288,deathknight,frost,6,3,3
Clizforden,kelthuzad,288,deathknight,frost,6,3,3
Nalec,tichondrius,288,deathknight,frost,6,3,3
Zügzug,chogall,288,deathknight,frost,6,3,3
Laboön,stormrage,288,deathknight,frost,6,3,3
Brumaks,quelthalas,288,deathknight,frost,6,3,3
Démise,malganis,288,deathknight,frost,6,3,3
Bootyclapztv,tichondrius,288,deathknight,frost,6,3,3
Víní,azralon,288,deathknight,frost,6,3,3
Pyradine,amanthul,288,deathknight,frost,6,3,3
Billclintonn,sargeras,288,deathknight,frost,6,3,3
Zygon,thrall,288,deathknight,frost,6,3,3
Yamanji,wyrmrest-accord,288,deathknight,frost,6,3,3
Jughéad,thrall,288,deathknight,frost,6,3,3
Ruggair,proudmoore,288,deathknight,frost,6,3,3
Tofurious,barthilas,288,deathknight,frost,6,3,3
Ghouldruis,barthilas,288,deathknight,frost,6,3,3
Jessaminne,nordrassil,288,deathknight,frost,6,3,3
Astanddra,wyrmrest-accord,288,deathknight,frost,6,3,3
Kalevesicant,nesingwary,288,deathknight,frost,6,3,3
Doomdk,azralon,288,deathknight,frost,6,3,3
Plaugedone,lightbringer,288,deathknight,frost,6,3,3
Fearfull,hyjal,288,deathknight,frost,10,4,6
Janus,illidan,288,deathknight,frost,12,3,9
Freyjani,moon-guard,288,deathknight,frost,12,3,9
Nenó,illidan,288,deathknight,frost,12,3,9
Dkpeter,quelthalas,288,deathknight,frost,12,3,9
Paíín,illidan,288,deathknight,frost,12,3,9
Toxicant,zuljin,288,deathknight,frost,12,3,9
Bloodmourne,barthilas,288,deathknight,frost,12,3,9
Flarkness,area-52,288,deathknight,frost,12,3,9
Drzièglér,tichondrius,288,deathknight,frost,12,3,9
Moyjô,aggramar,288,deathknight,frost,15,3,12
Sinfulvoid,darkspear,287,deathknight,frost,6,3,3
Válhállá,ragnaros,287,deathknight,frost,12,3,9
Páthøgen,ravencrest,287,deathknight,frost,12,3,9
Varrine,hyjal,286,deathknight,frost,6,3,3
Xslaught,maiev,286,deathknight,frost,6,3,3
Dragoroth,zuluhed,286,deathknight,frost,6,3,3
Gnomey,area-52,255,deathknight,frost,8,4,4
Crukashongal,zuljin,240,deathknight,frost,9,4,5
Frrost,earthen-ring,240,deathknight,frost,9,3,6
Unwantedgrab,sargeras,239,deathknight,frost,5,3,2
Hamze,stormrage,239,deathknight,frost,5,3,2
Bbcobliterat,proudmoore,234,deathknight,frost,22,4,18
Lindrayëda,moon-guard,206,deathknight,frost,7,3,4
Chilivibes,boulderfist,192,deathknight,frost,6,2,4
Alderollar,stormrage,192,deathknight,frost,6,2,4
Azhid,tichondrius,192,deathknight,frost,6,2,4
Hadeon,boulderfist,192,deathknight,frost,6,2,4
Lichkong,dalaran,192,deathknight,frost,6,2,4
Demise,stormrage,192,deathknight,frost,6,2,4
Chrønnøz,nemesis,192,deathknight,frost,6,2,4
Lospollos,tichondrius,192,deathknight,frost,6,2,4
Superlast,blackrock,192,deathknight,frost,6,2,4
Dego,tichondrius,192,deathknight,frost,6,2,4
Yourunigrip,tichondrius,192,deathknight,frost,6,2,4
Sayâ,frostmane,192,deathknight,frost,6,2,4
Crakdos,illidan,192,deathknight,frost,6,2,4
Edek,frostmourne,192,deathknight,frost,6,2,4
Nebuchadnezz,darkspear,192,deathknight,frost,6,2,4
Maelk,stormrage,192,deathknight,frost,6,2,4
Frozenjuice,sargeras,192,deathknight,frost,6,2,4
Pofokut,bleeding-hollow,192,deathknight,frost,6,2,4
Zëb,sargeras,192,deathknight,frost,6,2,4
Rulord,wyrmrest-accord,192,deathknight,frost,6,2,4
Oldskul,sargeras,192,deathknight,frost,6,2,4
Hunwild,emerald-dream,192,deathknight,frost,6,2,4
Dahaaka,malganis,192,deathknight,frost,6,2,4
Oreodeath,sargeras,192,deathknight,frost,6,2,4
Khørne,area-52,192,deathknight,frost,6,2,4
Fraýja,tichondrius,192,deathknight,frost,6,2,4
Xangrim,emerald-dream,192,deathknight,frost,6,2,4
Soutennizase,azralon,192,deathknight,frost,6,2,4
Noik,azralon,192,deathknight,frost,6,2,4
Bonusman,sargeras,192,deathknight,frost,6,2,4
Kreyun,bleeding-hollow,192,deathknight,frost,6,2,4
Rotfang,elune,192,deathknight,frost,6,2,4
Deathrey,kargath,192,deathknight,frost,6,2,4
Envisage,kelthuzad,192,deathknight,frost,6,2,4
Ryugetzu,drakkari,192,deathknight,frost,6,2,4
Piratehookah,sargeras,192,deathknight,frost,6,2,4
Tarknok,moon-guard,192,deathknight,frost,6,2,4
Evangelina,antonidas,192,deathknight,frost,12,2,10
Záiiko,quelthalas,192,deathknight,frost,12,2,10
Lillylilly,bleeding-hollow,192,deathknight,frost,12,2,10
Melyrc,quelthalas,192,deathknight,frost,12,2,10
Shadar,muradin,192,deathknight,frost,12,2,10
Appledog,ragnaros,192,deathknight,frost,12,2,10
Edhral,ragnaros,191,deathknight,frost,6,2,4
Sübzerö,quelthalas,191,deathknight,frost,6,2,4
Rogoroth,stormrage,191,deathknight,frost,6,2,4
Ulyssess,jubeithos,191,deathknight,frost,6,2,4
Deathmike,bonechewer,191,deathknight,frost,6,2,4
Akmy,illidan,175,deathknight,frost,11,2,9
Nickolas,dalvengyr,159,deathknight,frost,5,2,3
Oilasslover,illidan,128,deathknight,frost,4,2,2
Xaldeth,moon-guard,127,deathknight,frost,8,2,6
Telrenaur,proudmoore,96,deathknight,frost,3,2,1
Teksurugi,korgath,96,deathknight,frost,6,1,5
Skadattle,emerald-dream,96,deathknight,frost,6,1,5
Dotted,tichondrius,96,deathknight,frost,6,1,5
Kakaih,azralon,96,deathknight,frost,6,1,5
Gooré,ragnaros,96,deathknight,frost,6,1,5
Davyjonescx,moon-guard,96,deathknight,frost,6,1,5
Bubblesdk,whisperwind,96,deathknight,frost,6,1,5
Ricedisease,emerald-dream,96,deathknight,frost,6,1,5
Einherjiar,tichondrius,96,deathknight,frost,6,1,5
Grayfoxx,twisting-nether,96,deathknight,frost,6,1,5
Xakri,kelthuzad,96,deathknight,frost,6,1,5
Kireek,stormrage,96,deathknight,frost,6,1,5
Vrolock,quelthalas,96,deathknight,frost,6,1,5
Selasia,malygos,96,deathknight,frost,6,1,5
Krargosh,quelthalas,96,deathknight,frost,6,1,5
Thwap,sargeras,96,deathknight,frost,6,1,5
Grimorra,bleeding-hollow,96,deathknight,frost,6,1,5
Siphilusxo,dalaran,96,deathknight,frost,6,1,5
Koltíra,azralon,96,deathknight,frost,6,1,5
Denkot,stormrage,96,deathknight,frost,6,1,5
Frostpanda,dalaran,96,deathknight,frost,6,1,5
Cellebrok,bleeding-hollow,96,deathknight,frost,6,1,5
Bingoez,frostmourne,96,deathknight,frost,6,1,5
Guffles,tichondrius,96,deathknight,frost,6,1,5
Hadianton,stormrage,96,deathknight,frost,6,1,5
Mordekeiser,wyrmrest-accord,96,deathknight,frost,6,1,5
Mephostophel,sargeras,96,deathknight,frost,6,1,5
Mako,garithos,96,deathknight,frost,6,1,5
Sindragosa,dragonmaw,96,deathknight,frost,6,1,5
Xninjakiller,korgath,95,deathknight,frost,12,1,11
Magipierrot,ragnaros,64,deathknight,frost,4,1,3
Agasuko,ghostlands,48,deathknight,frost,3,1,2
Villåin,hyjal,42,deathknight,frost,9,2,7
Twindleroot,aggramar,31,deathknight,frost,2,1,1
Sharnathos,stormrage,16,deathknight,frost,1,1,0
Jerric,skullcrusher,16,deathknight,frost,7,1,6
Demoncouch,malganis,2137,demonhunter,havoc,90,46,44
Seorae,tichondrius,2126,demonhunter,havoc,84,45,39
Mvqdh,illidan,2114,demonhunter,havoc,65,40,25
Ehtend,sargeras,2106,demonhunter,havoc,78,42,36
Xiaosu,tichondrius,2105,demonhunter,havoc,527,260,267
Insomniaq,sargeras,2102,demonhunter,havoc,115,62,53
Zetara,malganis,2074,demonhunter,havoc,82,49,33
Dhcn,tichondrius,2073,demonhunter,havoc,64,35,29
Taegos,tichondrius,2072,demonhunter,havoc,351,173,178
Ehtend,malganis,2069,demonhunter,havoc,209,103,106
Calpoot,stormscale,2065,demonhunter,havoc,65,38,27
Nasadh,tichondrius,2065,demonhunter,havoc,90,52,38
Fellhamer,malganis,2054,demonhunter,havoc,123,69,54
Sadgirlx,area-52,2054,demonhunter,havoc,90,44,46
Nézuko,eldrethalas,2018,demonhunter,havoc,123,64,59
Ordorll,area-52,1998,demonhunter,havoc,114,59,55
Lademon,tichondrius,1997,demonhunter,havoc,84,46,38
Badhábits,sargeras,1979,demonhunter,havoc,66,37,29
Reps,hydraxis,1979,demonhunter,havoc,114,63,51
Bløødyrøse,illidan,1978,demonhunter,havoc,66,40,26
Terrorsong,tichondrius,1970,demonhunter,havoc,71,45,26
Medrathis,wyrmrest-accord,1970,demonhunter,havoc,48,30,18
Felz,illidan,1964,demonhunter,havoc,95,48,47
Lifting,illidan,1960,demonhunter,havoc,84,40,44
Tømåtøgøðx,sargeras,1953,demonhunter,havoc,180,95,85
Glaivezx,stormreaver,1948,demonhunter,havoc,66,33,33
Lighost,tichondrius,1944,demonhunter,havoc,288,140,148
Xtickles,frostmourne,1937,demonhunter,havoc,148,74,74
Mvpdh,area-52,1936,demonhunter,havoc,200,104,96
Boonchu,frostmourne,1935,demonhunter,havoc,86,45,41
Sypï,malganis,1931,demonhunter,havoc,66,37,29
Jøsem,ragnaros,1930,demonhunter,havoc,94,48,46
Kohî,sargeras,1924,demonhunter,havoc,53,27,26
ßöb,aggramar,1920,demonhunter,havoc,66,34,32
Càrnagex,tichondrius,1916,demonhunter,havoc,255,129,126
Ystkz,tichondrius,1908,demonhunter,havoc,117,64,53
Blasphemus,illidan,1908,demonhunter,havoc,63,34,29
Cromega,malganis,1906,demonhunter,havoc,108,50,58
Oddblindguy,area-52,1903,demonhunter,havoc,42,30,12
Lemilion,wyrmrest-accord,1903,demonhunter,havoc,53,27,26
Winsforgold,area-52,1902,demonhunter,havoc,66,36,30
Solit,illidan,1901,demonhunter,havoc,66,33,33
Cyrøcryphä,quelthalas,1901,demonhunter,havoc,144,68,76
Ouru,area-52,1896,demonhunter,havoc,96,48,48
Ìke,quelthalas,1894,demonhunter,havoc,109,55,54
Tendiës,tichondrius,1891,demonhunter,havoc,62,32,30
Askvivian,sargeras,1890,demonhunter,havoc,91,58,33
Boos,moon-guard,1889,demonhunter,havoc,160,78,82
Frostchaos,ragnaros,1888,demonhunter,havoc,30,20,10
Stellitas,ragnaros,1881,demonhunter,havoc,72,38,34
Xch,aegwynn,1881,demonhunter,havoc,166,87,79
Dayvenie,area-52,1879,demonhunter,havoc,125,70,55
Sleepyjoeb,illidan,1875,demonhunter,havoc,66,35,31
Junma,tichondrius,1874,demonhunter,havoc,84,47,37
Busting,tichondrius,1872,demonhunter,havoc,48,24,24
Mvqqdh,tichondrius,1872,demonhunter,havoc,42,20,22
Leothero,area-52,1863,demonhunter,havoc,54,28,26
Anihilum,zuljin,1858,demonhunter,havoc,90,59,31
Rlycoolclass,zuljin,1858,demonhunter,havoc,65,30,35
Azrethec,wyrmrest-accord,1855,demonhunter,havoc,108,62,46
Potspoon,tichondrius,1855,demonhunter,havoc,138,72,66
Loadingdh,tichondrius,1854,demonhunter,havoc,47,20,27
Nb,silvermoon,1853,demonhunter,havoc,59,32,27
Andthrx,area-52,1853,demonhunter,havoc,198,101,97
Bippy,durotan,1853,demonhunter,havoc,90,44,46
Promitto,tichondrius,1852,demonhunter,havoc,53,29,24
Mizaru,moon-guard,1849,demonhunter,havoc,35,24,11
Rosinanta,malygos,1849,demonhunter,havoc,104,56,48
Joshallen,malganis,1846,demonhunter,havoc,141,73,68
Wowcoldcold,barthilas,1845,demonhunter,havoc,59,30,29
Lamorty,tichondrius,1842,demonhunter,havoc,84,40,44
Airmax,tichondrius,1839,demonhunter,havoc,60,32,28
Doejah,stormrage,1838,demonhunter,havoc,50,28,22
Bigbadmad,stormrage,1838,demonhunter,havoc,155,79,76
Smqkepvrpp,zuljin,1835,demonhunter,havoc,58,39,19
Juiced,thunderhorn,1835,demonhunter,havoc,89,48,41
Asdazanis,nemesis,1835,demonhunter,havoc,80,40,40
Ökìtycoón,proudmoore,1833,demonhunter,havoc,78,45,33
Raiinier,sargeras,1830,demonhunter,havoc,72,45,27
Hasbeen,tichondrius,1830,demonhunter,havoc,39,23,16
Divide,tichondrius,1830,demonhunter,havoc,106,58,48
Maverzz,area-52,1828,demonhunter,havoc,35,20,15
Takagi,kirin-tor,1828,demonhunter,havoc,221,120,101
Devotio,emerald-dream,1825,demonhunter,havoc,96,57,39
Migey,thrall,1825,demonhunter,havoc,112,65,47
Vanarion,area-52,1825,demonhunter,havoc,84,36,48
Beerdash,area-52,1825,demonhunter,havoc,66,28,38
Ninetalesx,sargeras,1823,demonhunter,havoc,81,48,33
Darkrai,area-52,1823,demonhunter,havoc,132,73,59
Nolabb,tichondrius,1822,demonhunter,havoc,128,72,56
Írís,blackrock,1820,demonhunter,havoc,124,75,49
Karonisam,dalaran,1820,demonhunter,havoc,61,32,29
Dannyolo,hyjal,1820,demonhunter,havoc,78,32,46
Daía,ragnaros,1818,demonhunter,havoc,47,24,23
Thânatøs,nemesis,1818,demonhunter,havoc,114,56,58
Cromosh,quelthalas,1818,demonhunter,havoc,78,35,43
Mamazboy,area-52,1817,demonhunter,havoc,34,20,14
Failtimeboat,terenas,1817,demonhunter,havoc,60,34,26
Yaboiswift,stormrage,1817,demonhunter,havoc,36,19,17
Garbage,illidan,1816,demonhunter,havoc,84,44,40
Helenquinn,kelthuzad,1815,demonhunter,havoc,72,46,26
Brotherz,tichondrius,1815,demonhunter,havoc,113,56,57
Brbpetmycat,zuljin,1815,demonhunter,havoc,63,30,33
Skyez,moon-guard,1814,demonhunter,havoc,115,54,61
Kázeshini,frostmourne,1813,demonhunter,havoc,143,71,72
Rufio,nesingwary,1813,demonhunter,havoc,54,25,29
Syrio,frostmourne,1812,demonhunter,havoc,206,114,92
Eldiablaso,malganis,1812,demonhunter,havoc,36,19,17
Zoenin,illidan,1812,demonhunter,havoc,96,46,50
Lucifèr,uther,1812,demonhunter,havoc,59,28,31
Vowz,sargeras,1811,demonhunter,havoc,66,34,32
Tyskeram,bleeding-hollow,1810,demonhunter,havoc,81,47,34
Hatréd,quelthalas,1810,demonhunter,havoc,48,26,22
Bbteaa,frostmourne,1810,demonhunter,havoc,134,72,62
Blode,tichondrius,1810,demonhunter,havoc,153,80,73
Griphunt,tichondrius,1809,demonhunter,havoc,198,102,96
Feldarath,sargeras,1807,demonhunter,havoc,133,76,57
Fenomeno,tichondrius,1807,demonhunter,havoc,58,32,26
Xcf,area-52,1807,demonhunter,havoc,48,22,26
Bitcoingodx,tichondrius,1806,demonhunter,havoc,90,53,37
Raenorion,kelthuzad,1805,demonhunter,havoc,54,33,21
Dangerspud,frostmourne,1805,demonhunter,havoc,66,28,38
Dwilk,sargeras,1804,demonhunter,havoc,136,62,74
Purplekuush,bleeding-hollow,1803,demonhunter,havoc,54,31,23
Fruitbatx,tichondrius,1803,demonhunter,havoc,114,56,58
Dhkyun,tichondrius,1801,demonhunter,havoc,54,29,25
Wompo,wyrmrest-accord,1801,demonhunter,havoc,36,19,17
Dewk,ghostlands,1801,demonhunter,havoc,57,29,28
Icecokelime,black-dragonflight,1800,demonhunter,havoc,38,20,18
Deathbladezx,tichondrius,1800,demonhunter,havoc,47,23,24
Donaldjr,area-52,1798,demonhunter,havoc,69,42,27
Flykzuwu,azralon,1793,demonhunter,havoc,83,48,35
Dyllen,tichondrius,1793,demonhunter,havoc,152,86,66
Zatharas,stormrage,1792,demonhunter,havoc,116,59,57
Nuktukdh,moon-guard,1791,demonhunter,havoc,68,30,38
Dewkee,ghostlands,1789,demonhunter,havoc,36,23,13
Ubetterun,azralon,1781,demonhunter,havoc,141,75,66
Ferano,frostmourne,1781,demonhunter,havoc,187,96,91
Thundiir,area-52,1780,demonhunter,havoc,96,50,46
Aryapudding,tichondrius,1779,demonhunter,havoc,58,28,30
Demonsob,illidan,1772,demonhunter,havoc,59,22,37
Mevadow,bleeding-hollow,1768,demonhunter,havoc,126,57,69
Crittic,thrall,1764,demonhunter,havoc,54,25,29
Mèw,bleeding-hollow,1762,demonhunter,havoc,42,25,17
Drachyn,darkspear,1762,demonhunter,havoc,65,29,36
Sikarnix,stormrage,1761,demonhunter,havoc,66,31,35
Xanthalos,wyrmrest-accord,1759,demonhunter,havoc,144,73,71
Ahsref,stormrage,1757,demonhunter,havoc,60,30,30
Saaldh,zuljin,1753,demonhunter,havoc,65,27,38
Gubydal,frostmourne,1750,demonhunter,havoc,53,29,24
Felswamp,zuljin,1748,demonhunter,havoc,90,45,45
Immortalsinz,dalaran,1747,demonhunter,havoc,112,48,64
Bllackclover,zuljin,1746,demonhunter,havoc,47,25,22
Noobstaa,area-52,1745,demonhunter,havoc,48,34,14
Ðavid,firetree,1745,demonhunter,havoc,96,48,48
Plumkin,kiljaeden,1743,demonhunter,havoc,48,27,21
Lazydeamon,frostmourne,1740,demonhunter,havoc,60,26,34
Obsidians,korgath,1737,demonhunter,havoc,83,49,34
Monfel,dalaran,1737,demonhunter,havoc,108,63,45
Furious,tichondrius,1737,demonhunter,havoc,48,23,25
Nadlli,bleeding-hollow,1736,demonhunter,havoc,152,77,75
Tichóndrius,tichondrius,1735,demonhunter,havoc,173,95,78
Hoochee,lightnings-blade,1735,demonhunter,havoc,73,39,34
Baka,grizzly-hills,1735,demonhunter,havoc,48,22,26
Firstsol,stormrage,1734,demonhunter,havoc,54,33,21
Theprodigy,malganis,1734,demonhunter,havoc,72,36,36
Harríson,tichondrius,1734,demonhunter,havoc,96,47,49
Wherwelandin,zuljin,1734,demonhunter,havoc,51,24,27
Axalark,nemesis,1733,demonhunter,havoc,54,26,28
Lilise,kiljaeden,1731,demonhunter,havoc,72,35,37
Stellartv,tichondrius,1730,demonhunter,havoc,103,49,54
Hogmandh,illidan,1729,demonhunter,havoc,48,23,25
Sacredtree,tichondrius,1724,demonhunter,havoc,80,43,37
Beyondjerky,malganis,1721,demonhunter,havoc,34,20,14
Croches,tichondrius,1721,demonhunter,havoc,36,18,18
Cococat,tichondrius,1721,demonhunter,havoc,50,20,30
Larandaa,sargeras,1720,demonhunter,havoc,60,33,27
Madepp,tichondrius,1720,demonhunter,havoc,48,23,25
Fardyhole,illidan,1719,demonhunter,havoc,36,18,18
Tendies,tichondrius,1716,demonhunter,havoc,48,24,24
Nåxah,bleeding-hollow,1716,demonhunter,havoc,54,26,28
Ibdl,tichondrius,1714,demonhunter,havoc,30,18,12
Irisand,ragnaros,1714,demonhunter,havoc,83,40,43
Doeja,illidan,1713,demonhunter,havoc,30,18,12
Thehonor,tichondrius,1713,demonhunter,havoc,65,36,29
Ruffolina,azralon,1713,demonhunter,havoc,163,89,74
Aetheris,bleeding-hollow,1709,demonhunter,havoc,78,34,44
Demabrak,azralon,1707,demonhunter,havoc,47,23,24
Dãnishroll,illidan,1707,demonhunter,havoc,60,26,34
Soyboycuck,emerald-dream,1705,demonhunter,havoc,36,18,18
Rôsè,tichondrius,1704,demonhunter,havoc,88,49,39
Xeylin,sargeras,1703,demonhunter,havoc,54,34,20
Gamernation,area-52,1703,demonhunter,havoc,57,29,28
Wildh,stormrage,1702,demonhunter,havoc,66,35,31
Xøtourlife,malganis,1701,demonhunter,havoc,52,25,27
Nopohunter,burning-blade,1699,demonhunter,havoc,47,31,16
Junmà,tichondrius,1699,demonhunter,havoc,60,38,22
Vendeem,moonrunner,1697,demonhunter,havoc,104,56,48
Raahjxz,sargeras,1696,demonhunter,havoc,54,33,21
Johnconnor,tichondrius,1696,demonhunter,havoc,53,20,33
Chiesa,sargeras,1695,demonhunter,havoc,34,27,7
Remh,bleeding-hollow,1694,demonhunter,havoc,254,129,125
Kenmu,ragnaros,1693,demonhunter,havoc,50,24,26
Ravana,khaz-modan,1692,demonhunter,havoc,82,46,36
Munyanyô,moon-guard,1691,demonhunter,havoc,41,26,15
Tubaki,tichondrius,1691,demonhunter,havoc,35,19,16
Speedh,area-52,1691,demonhunter,havoc,36,18,18
Deaforalive,malganis,1690,demonhunter,havoc,96,54,42
Cöcainë,stormrage,1689,demonhunter,havoc,36,24,12
Nephxz,tichondrius,1689,demonhunter,havoc,42,21,21
Flyudzhin,azgalor,1689,demonhunter,havoc,116,56,60
Kìed,kiljaeden,1687,demonhunter,havoc,48,24,24
Wickbeams,barthilas,1684,demonhunter,havoc,59,28,31
Dawgzo,thunderhorn,1682,demonhunter,havoc,60,34,26
Nips,lightnings-blade,1675,demonhunter,havoc,54,33,21
Buddyyguy,illidan,1675,demonhunter,havoc,102,45,57
Dragonÿx,ragnaros,1674,demonhunter,havoc,97,53,44
Folkmagic,proudmoore,1673,demonhunter,havoc,30,18,12
Dingowango,illidan,1672,demonhunter,havoc,48,24,24
Biognosis,ragnaros,1672,demonhunter,havoc,84,38,46
Balancedtoon,tichondrius,1670,demonhunter,havoc,54,30,24
Coa,nazjatar,1670,demonhunter,havoc,70,34,36
Glaivediggar,barthilas,1670,demonhunter,havoc,106,49,57
Bloodhunter,exodar,1668,demonhunter,havoc,92,53,39
Imaginedmg,illidan,1668,demonhunter,havoc,60,28,32
Jaauk,ragnaros,1668,demonhunter,havoc,52,23,29
Jcosta,tichondrius,1667,demonhunter,havoc,61,27,34
Hisso,nordrassil,1666,demonhunter,havoc,48,28,20
Oshinoko,area-52,1664,demonhunter,havoc,57,30,27
Dhwhat,stormrage,1661,demonhunter,havoc,89,49,40
Boagz,area-52,1660,demonhunter,havoc,84,48,36
Hundredeye,malganis,1660,demonhunter,havoc,34,18,16
Kioka,khaz-modan,1659,demonhunter,havoc,34,20,14
Fellenkellar,stormrage,1659,demonhunter,havoc,72,38,34
Çhan,tichondrius,1658,demonhunter,havoc,213,108,105
Ilìdarì,zuljin,1657,demonhunter,havoc,33,20,13
Scylus,tichondrius,1657,demonhunter,havoc,66,39,27
Antamoris,sargeras,1656,demonhunter,havoc,52,25,27
Ethhunter,proudmoore,1656,demonhunter,havoc,66,31,35
Poogzzig,tichondrius,1655,demonhunter,havoc,84,43,41
Getpoodon,sargeras,1655,demonhunter,havoc,36,18,18
Sáìto,arthas,1654,demonhunter,havoc,30,19,11
Azexion,malganis,1653,demonhunter,havoc,70,34,36
Baikudyn,darkspear,1651,demonhunter,havoc,30,19,11
Ðaredevil,azralon,1650,demonhunter,havoc,36,22,14
Chîsäki,quelthalas,1649,demonhunter,havoc,75,40,35
Pragma,thrall,1648,demonhunter,havoc,157,89,68
Gesture,malganis,1648,demonhunter,havoc,160,89,71
Vapegodxqt,aegwynn,1647,demonhunter,havoc,50,25,25
Asheng,cairne,1646,demonhunter,havoc,45,22,23
Ironsightsdh,dalaran,1645,demonhunter,havoc,89,47,42
Sarynrae,malganis,1644,demonhunter,havoc,52,24,28
Valerrias,area-52,1643,demonhunter,havoc,42,21,21
Warlasher,zuljin,1640,demonhunter,havoc,150,79,71
Vândel,kelthuzad,1639,demonhunter,havoc,47,22,25
Gôôseberry,malganis,1639,demonhunter,havoc,81,37,44
Dealer,frostmourne,1638,demonhunter,havoc,66,31,35
Randomdh,zuljin,1636,demonhunter,havoc,43,23,20
Khaõs,tichondrius,1636,demonhunter,havoc,78,34,44
Pythongodx,azralon,1635,demonhunter,havoc,42,23,19
Mewmewkitty,tichondrius,1635,demonhunter,havoc,34,18,16
Synthwäve,area-52,1634,demonhunter,havoc,36,23,13
Joric,dalaran,1634,demonhunter,havoc,48,30,18
Azinoht,ragnaros,1634,demonhunter,havoc,146,69,77
Killuaqt,frostmourne,1633,demonhunter,havoc,36,20,16
Demoncastx,tichondrius,1632,demonhunter,havoc,89,50,39
Accidcleaves,sargeras,1632,demonhunter,havoc,48,26,22
Seraphïel,khaz-modan,1631,demonhunter,havoc,36,23,13
Nocturnale,ragnaros,1629,demonhunter,havoc,53,28,25
Cezkia,hyjal,1629,demonhunter,havoc,72,36,36
Xenore,emerald-dream,1628,demonhunter,havoc,47,21,26
Chulakels,tichondrius,1627,demonhunter,havoc,30,18,12
Trilidan,proudmoore,1627,demonhunter,havoc,37,21,16
Stefdh,tichondrius,1627,demonhunter,havoc,51,23,28
Thelor,frostmourne,1626,demonhunter,havoc,48,28,20
Xday,tichondrius,1626,demonhunter,havoc,258,132,126
Sicknizzle,area-52,1626,demonhunter,havoc,126,63,63
Rekttx,area-52,1625,demonhunter,havoc,64,34,30
Cuper,tichondrius,1623,demonhunter,havoc,72,41,31
Perspirant,malganis,1623,demonhunter,havoc,41,23,18
Ídunno,kiljaeden,1623,demonhunter,havoc,42,19,23
Sivà,tichondrius,1622,demonhunter,havoc,69,35,34
Zeroheaven,stormrage,1621,demonhunter,havoc,48,19,29
Hehehaha,wyrmrest-accord,1620,demonhunter,havoc,30,20,10
Skyfly,stormscale,1619,demonhunter,havoc,48,21,27
Ohanadh,ragnaros,1618,demonhunter,havoc,48,19,29
Zachfortnite,emerald-dream,1616,demonhunter,havoc,30,19,11
Taszyn,blackrock,1613,demonhunter,havoc,92,51,41
Karmakula,tichondrius,1613,demonhunter,havoc,77,39,38
Anathørn,ragnaros,1612,demonhunter,havoc,42,23,19
Surå,tichondrius,1612,demonhunter,havoc,76,37,39
Jpdh,frostmourne,1611,demonhunter,havoc,74,39,35
Scriptyscrip,dark-iron,1611,demonhunter,havoc,138,63,75
Bitskii,kelthuzad,1610,demonhunter,havoc,47,21,26
Jk,dreadmaul,1609,demonhunter,havoc,70,40,30
Nistrin,area-52,1609,demonhunter,havoc,72,40,32
Crixxus,zuljin,1609,demonhunter,havoc,48,20,28
Niuzimeile,illidan,1609,demonhunter,havoc,48,17,31
Yiptaw,area-52,1608,demonhunter,havoc,55,29,26
Feníxx,ragnaros,1608,demonhunter,havoc,88,45,43
Beastbringer,proudmoore,1607,demonhunter,havoc,147,86,61
Landorus,barthilas,1607,demonhunter,havoc,100,49,51
Abigëil,quelthalas,1605,demonhunter,havoc,56,31,25
Mavrush,malganis,1604,demonhunter,havoc,54,31,23
Vynthar,wyrmrest-accord,1604,demonhunter,havoc,148,72,76
Dèmonhuntèr,tichondrius,1603,demonhunter,havoc,90,48,42
Tychondrius,earthen-ring,1603,demonhunter,havoc,202,107,95
Kaedri,burning-blade,1603,demonhunter,havoc,141,68,73
Sìlençe,illidan,1602,demonhunter,havoc,29,19,10
Shale,gilneas,1602,demonhunter,havoc,70,35,35
Phaintx,tichondrius,1602,demonhunter,havoc,42,21,21
Ariodh,area-52,1602,demonhunter,havoc,36,17,19
Felnipz,tichondrius,1601,demonhunter,havoc,31,18,13
Deathlex,sargeras,1600,demonhunter,havoc,72,35,37
Gjoat,tichondrius,1600,demonhunter,havoc,42,19,23
Tenthslayer,frostmourne,1598,demonhunter,havoc,30,17,13
Pubelice,draenor,1596,demonhunter,havoc,62,36,26
Ptsdh,bloodhoof,1595,demonhunter,havoc,66,36,30
Netherbane,azgalor,1592,demonhunter,havoc,96,44,52
Dhyzz,proudmoore,1590,demonhunter,havoc,43,25,18
Eugenyackle,bleeding-hollow,1589,demonhunter,havoc,48,35,13
Reito,ragnaros,1589,demonhunter,havoc,53,29,24
Nándÿ,tichondrius,1589,demonhunter,havoc,61,33,28
Darkrasta,ragnaros,1589,demonhunter,havoc,90,41,49
Shyisback,area-52,1588,demonhunter,havoc,96,54,42
Wsickformula,gilneas,1588,demonhunter,havoc,119,66,53
Churchpls,stormrage,1588,demonhunter,havoc,52,19,33
Progenji,azralon,1585,demonhunter,havoc,36,21,15
Alast,emerald-dream,1584,demonhunter,havoc,48,23,25
Sucio,khaz-modan,1581,demonhunter,havoc,36,18,18
Supadupä,stormrage,1580,demonhunter,havoc,30,17,13
Kaelclaira,dalvengyr,1580,demonhunter,havoc,60,29,31
Jaybeezy,balnazzar,1580,demonhunter,havoc,42,18,24
Chungîe,frostmourne,1579,demonhunter,havoc,30,20,10
Ossivil,ragnaros,1579,demonhunter,havoc,90,41,49
Yuppx,tichondrius,1578,demonhunter,havoc,48,29,19
Mcspicyy,tichondrius,1578,demonhunter,havoc,42,22,20
Corngodx,sargeras,1578,demonhunter,havoc,96,47,49
Hoonjojjyana,tichondrius,1578,demonhunter,havoc,46,20,26
Dammitbôbby,tichondrius,1577,demonhunter,havoc,121,66,55
Needlepoint,illidan,1576,demonhunter,havoc,59,32,27
Baalböski,tichondrius,1574,demonhunter,havoc,88,41,47
Billmcawsom,proudmoore,1573,demonhunter,havoc,42,19,23
Demonfarter,tichondrius,1570,demonhunter,havoc,120,61,59
Enfirok,duskwood,1566,demonhunter,havoc,234,122,112
Kssmee,korgath,1565,demonhunter,havoc,42,23,19
Sheepone,tichondrius,1564,demonhunter,havoc,24,19,5
Daymanhunter,bleeding-hollow,1563,demonhunter,havoc,83,41,42
Gymnast,thaurissan,1561,demonhunter,havoc,48,19,29
Nomfries,malganis,1560,demonhunter,havoc,52,27,25
Wikkidd,thrall,1560,demonhunter,havoc,47,22,25
Doomtower,tichondrius,1557,demonhunter,havoc,45,22,23
Ylydary,ragnaros,1554,demonhunter,havoc,66,39,27
Gorillidan,kelthuzad,1553,demonhunter,havoc,30,18,12
Kaelthys,nordrassil,1552,demonhunter,havoc,33,21,12
Yqpro,tichondrius,1549,demonhunter,havoc,119,62,57
Blurblurblur,frostmourne,1549,demonhunter,havoc,42,17,25
Kuramou,area-52,1547,demonhunter,havoc,36,22,14
Bogdan,azjolnerub,1545,demonhunter,havoc,60,33,27
Xionas,moon-guard,1543,demonhunter,havoc,81,42,39
Blackmvp,tichondrius,1537,demonhunter,havoc,24,17,7
Cäldo,tichondrius,1537,demonhunter,havoc,36,21,15
Imwhack,frostmane,1535,demonhunter,havoc,49,27,22
Scoplyn,malfurion,1535,demonhunter,havoc,60,30,30
Doxdevil,tichondrius,1533,demonhunter,havoc,57,19,38
Thêdràïñgáñg,jubeithos,1530,demonhunter,havoc,30,16,14
Mileze,area-52,1530,demonhunter,havoc,60,21,39
Papaelf,thunderlord,1528,demonhunter,havoc,48,33,15
Knuckifubuck,frostwolf,1527,demonhunter,havoc,106,57,49
Knshy,azralon,1527,demonhunter,havoc,44,21,23
Crayoz,tichondrius,1525,demonhunter,havoc,131,73,58
Emopidgeon,dalaran,1525,demonhunter,havoc,30,16,14
Broneill,blood-furnace,1525,demonhunter,havoc,42,21,21
Mattdizzle,illidan,1524,demonhunter,havoc,24,17,7
Brútalgore,area-52,1521,demonhunter,havoc,141,73,68
Sineex,illidan,1520,demonhunter,havoc,30,18,12
Hròðvitnir,quelthalas,1519,demonhunter,havoc,50,30,20
Creãtuss,area-52,1519,demonhunter,havoc,54,29,25
Mazakein,tichondrius,1517,demonhunter,havoc,42,21,21
Allyrian,sargeras,1513,demonhunter,havoc,59,39,20
Dadoftheyear,destromath,1513,demonhunter,havoc,36,20,16
Deadpixellz,illidan,1511,demonhunter,havoc,76,39,37
Yåkuza,daggerspine,1509,demonhunter,havoc,140,70,70
Gittgudd,area-52,1507,demonhunter,havoc,69,36,33
Icrazedcruxl,gnomeregan,1504,demonhunter,havoc,36,16,20
Dirtbag,tichondrius,1503,demonhunter,havoc,30,16,14
Ilydos,emerald-dream,1503,demonhunter,havoc,102,52,50
Darknezzl,ragnaros,1500,demonhunter,havoc,84,39,45
Demodorn,frostmane,1499,demonhunter,havoc,30,19,11
Macacøbrr,azralon,1498,demonhunter,havoc,76,37,39
Littlewolfie,illidan,1496,demonhunter,havoc,30,16,14
Alli,bleeding-hollow,1494,demonhunter,havoc,69,39,30
Ralløszek,illidan,1494,demonhunter,havoc,48,26,22
Ralløs81A363,illidan,1494,demonhunter,havoc,48,26,22
Karmadh,malganis,1494,demonhunter,havoc,30,16,14
Træt,emerald-dream,1494,demonhunter,havoc,83,42,41
Nuredmyy,illidan,1488,demonhunter,havoc,30,17,13
Hellmetal,quelthalas,1488,demonhunter,havoc,36,17,19
Dashxo,tichondrius,1487,demonhunter,havoc,36,17,19
Apõz,tichondrius,1486,demonhunter,havoc,30,16,14
Orgasmia,tichondrius,1486,demonhunter,havoc,106,32,74
Emeress,illidan,1485,demonhunter,havoc,47,20,27
Demontrue,tichondrius,1483,demonhunter,havoc,62,32,30
Kimjonguun,tichondrius,1481,demonhunter,havoc,32,22,10
Häruun,quelthalas,1480,demonhunter,havoc,41,23,18
Wormli,moon-guard,1477,demonhunter,havoc,40,24,16
Nooksuh,bleeding-hollow,1473,demonhunter,havoc,29,16,13
Kegu,stormrage,1469,demonhunter,havoc,54,20,34
Gomesdhunter,azralon,1466,demonhunter,havoc,88,47,41
Henry,tichondrius,1465,demonhunter,havoc,69,41,28
Bjj,bonechewer,1465,demonhunter,havoc,100,58,42
Zackfair,burning-legion,1465,demonhunter,havoc,117,59,58
Papazaraki,tichondrius,1465,demonhunter,havoc,36,18,18
Eery,tichondrius,1461,demonhunter,havoc,71,35,36
Mamif,korgath,1460,demonhunter,havoc,68,31,37
Gaìjîn,barthilas,1459,demonhunter,havoc,132,70,62
Hellnkeller,tichondrius,1459,demonhunter,havoc,36,16,20
Somethingstu,sargeras,1458,demonhunter,havoc,28,18,10
Furiel,quelthalas,1458,demonhunter,havoc,38,22,16
Croisoi,ragnaros,1458,demonhunter,havoc,66,31,35
Bofxo,sargeras,1458,demonhunter,havoc,47,22,25
Gohamx,illidan,1457,demonhunter,havoc,110,54,56
Felseal,frostmourne,1456,demonhunter,havoc,53,34,19
Demonhunter,kirin-tor,1456,demonhunter,havoc,66,28,38
Coohiyan,tichondrius,1455,demonhunter,havoc,30,18,12
Nekrosdaeva,zuljin,1455,demonhunter,havoc,73,40,33
Telmordrin,azralon,1454,demonhunter,havoc,38,21,17
Aiapaec,wyrmrest-accord,1454,demonhunter,havoc,101,50,51
Sciatic,area-52,1454,demonhunter,havoc,68,33,35
Eyecandyxo,grizzly-hills,1452,demonhunter,havoc,37,20,17
Sloôtybag,tichondrius,1452,demonhunter,havoc,36,19,17
Órph,sargeras,1452,demonhunter,havoc,42,22,20
Wangasaurus,emerald-dream,1452,demonhunter,havoc,54,26,28
Xillidan,area-52,1450,demonhunter,havoc,112,70,42
Sëlene,antonidas,1449,demonhunter,havoc,77,37,40
Bucx,barthilas,1445,demonhunter,havoc,60,36,24
Nicodine,tichondrius,1445,demonhunter,havoc,63,34,29
Jaysavage,eitrigg,1443,demonhunter,havoc,63,31,32
Vlääd,ragnaros,1442,demonhunter,havoc,114,54,60
Faphunter,illidan,1441,demonhunter,havoc,87,50,37
Mavèrick,thrall,1441,demonhunter,havoc,45,21,24
Mamadorx,azralon,1438,demonhunter,havoc,24,15,9
Huntoneshot,bleeding-hollow,1438,demonhunter,havoc,43,23,20
Velravyn,moon-guard,1438,demonhunter,havoc,35,17,18
Molchamp,kelthuzad,1438,demonhunter,havoc,60,27,33
Feelmybush,barthilas,1438,demonhunter,havoc,72,29,43
Haades,proudmoore,1437,demonhunter,havoc,48,25,23
Grizzop,sargeras,1437,demonhunter,havoc,96,48,48
Lravanal,quelthalas,1435,demonhunter,havoc,24,17,7
Fametrap,tichondrius,1435,demonhunter,havoc,24,15,9
Backtolumby,bleeding-hollow,1435,demonhunter,havoc,53,30,23
ßlurr,moon-guard,1435,demonhunter,havoc,114,63,51
Sheldoncoop,emerald-dream,1435,demonhunter,havoc,30,15,15
Brackmagik,barthilas,1434,demonhunter,havoc,18,15,3
Illusiondh,tichondrius,1433,demonhunter,havoc,75,47,28
Raith,khazgoroth,1432,demonhunter,havoc,49,27,22
Nepzz,stormrage,1430,demonhunter,havoc,66,37,29
Remuko,tichondrius,1430,demonhunter,havoc,30,15,15
Dridri,quelthalas,1430,demonhunter,havoc,44,21,23
Unjusthunt,magtheridon,1429,demonhunter,havoc,30,15,15
Mybus,tichondrius,1429,demonhunter,havoc,72,32,40
Exequion,ragnaros,1428,demonhunter,havoc,93,53,40
Noxon,stormrage,1428,demonhunter,havoc,92,48,44
Iim,tichondrius,1428,demonhunter,havoc,87,35,52
Absinith,jubeithos,1427,demonhunter,havoc,28,20,8
Demonicfish,malganis,1427,demonhunter,havoc,54,32,22
Superlative,area-52,1423,demonhunter,havoc,24,15,9
Anatema,illidan,1423,demonhunter,havoc,59,30,29
Flirtyscythe,illidan,1422,demonhunter,havoc,30,15,15
Moylecrumbs,stormrage,1420,demonhunter,havoc,72,35,37
Mirriana,thunderlord,1420,demonhunter,havoc,36,15,21
Creamboi,stormrage,1419,demonhunter,havoc,34,19,15
Redkin,moon-guard,1419,demonhunter,havoc,42,21,21
Nuggetx,lightnings-blade,1418,demonhunter,havoc,24,15,9
Viismoke,thaurissan,1418,demonhunter,havoc,42,25,17
Talyethsam,shadowsong,1418,demonhunter,havoc,32,16,16
Valka,emerald-dream,1416,demonhunter,havoc,100,53,47
Ikilldemonz,thrall,1415,demonhunter,havoc,42,19,23
Bremdh,thrall,1413,demonhunter,havoc,30,15,15
Varthalos,thrall,1412,demonhunter,havoc,96,54,42
Oxyoxy,illidan,1410,demonhunter,havoc,37,23,14
Genruis,area-52,1410,demonhunter,havoc,61,30,31
Cybertrax,tichondrius,1408,demonhunter,havoc,24,15,9
Narchis,malganis,1403,demonhunter,havoc,30,17,13
Derperhunter,kiljaeden,1403,demonhunter,havoc,54,26,28
Loreney,quelthalas,1402,demonhunter,havoc,120,55,65
Yodiegang,nazgrel,1400,demonhunter,havoc,24,15,9
Ehrapist,kelthuzad,1399,demonhunter,havoc,30,16,14
Majnun,moon-guard,1399,demonhunter,havoc,30,16,14
Radamanthysi,azralon,1398,demonhunter,havoc,72,43,29
Skace,jubeithos,1397,demonhunter,havoc,102,56,46
Tøwers,aegwynn,1397,demonhunter,havoc,36,18,18
Torments,area-52,1397,demonhunter,havoc,30,15,15
Alganoth,malfurion,1394,demonhunter,havoc,67,36,31
Softkyll,area-52,1394,demonhunter,havoc,369,191,178
Methany,saurfang,1393,demonhunter,havoc,81,37,44
Kellytgt,perenolde,1392,demonhunter,havoc,36,21,15
Falachio,tichondrius,1391,demonhunter,havoc,75,37,38
Tylersdh,illidan,1390,demonhunter,havoc,22,15,7
Swarlee,kiljaeden,1389,demonhunter,havoc,83,46,37
Siksix,bleeding-hollow,1389,demonhunter,havoc,42,21,21
Tharzadan,quelthalas,1387,demonhunter,havoc,51,26,25
Dejay,thunderhorn,1386,demonhunter,havoc,42,27,15
Kúrama,tichondrius,1385,demonhunter,havoc,78,46,32
Snaped,tichondrius,1384,demonhunter,havoc,42,28,14
Jackk,nordrassil,1384,demonhunter,havoc,41,21,20
Ranir,doomhammer,1384,demonhunter,havoc,54,23,31
Lostsoulzz,tichondrius,1383,demonhunter,havoc,45,28,17
Vegan,magtheridon,1382,demonhunter,havoc,48,29,19
Tyredris,kelthuzad,1379,demonhunter,havoc,36,17,19
Duhan,tichondrius,1377,demonhunter,havoc,190,100,90
Yukisyn,proudmoore,1376,demonhunter,havoc,90,48,42
Violegrace,area-52,1376,demonhunter,havoc,106,51,55
Villumninati,tichondrius,1375,demonhunter,havoc,48,27,21
Omgshesocute,hyjal,1375,demonhunter,havoc,36,18,18
Pupupoo,tichondrius,1373,demonhunter,havoc,48,28,20
Lonelydusk,zangarmarsh,1372,demonhunter,havoc,30,15,15
Kellox,ragnaros,1372,demonhunter,havoc,36,15,21
Petty,moon-guard,1371,demonhunter,havoc,48,28,20
Soupwoup,moon-guard,1368,demonhunter,havoc,51,25,26
Colinn,illidan,1367,demonhunter,havoc,30,18,12
Kazdh,sargeras,1367,demonhunter,havoc,48,25,23
Thêpunisher,ragnaros,1367,demonhunter,havoc,118,60,58
Chaz,blood-furnace,1366,demonhunter,havoc,36,16,20
Jellous,rivendare,1366,demonhunter,havoc,42,17,25
Metabeam,tichondrius,1365,demonhunter,havoc,30,19,11
Loadedtruck,frostmourne,1362,demonhunter,havoc,24,16,8
Kakster,tichondrius,1362,demonhunter,havoc,66,35,31
Ronkasprince,thunderlord,1361,demonhunter,havoc,92,41,51
Layli,azralon,1360,demonhunter,havoc,42,25,17
Nupx,frostmourne,1358,demonhunter,havoc,33,17,16
Felbreak,stormrage,1358,demonhunter,havoc,72,35,37
Celestiel,cenarion-circle,1357,demonhunter,havoc,30,17,13
Artemisleto,tichondrius,1356,demonhunter,havoc,36,18,18
Wíkkihx,emerald-dream,1356,demonhunter,havoc,49,24,25
Hornedelf,frostmourne,1355,demonhunter,havoc,41,22,19
Gwendanzig,zangarmarsh,1355,demonhunter,havoc,60,28,32
Metagoblin,tichondrius,1352,demonhunter,havoc,30,15,15
Kitnix,proudmoore,1349,demonhunter,havoc,31,16,15
Krizo,frostmourne,1348,demonhunter,havoc,37,19,18
Rânkle,darkspear,1345,demonhunter,havoc,46,25,21
Exzyo,area-52,1344,demonhunter,havoc,18,14,4
Rem,stormrage,1344,demonhunter,havoc,69,37,32
Onewhoknox,mannoroth,1344,demonhunter,havoc,126,64,62
Ergzydh,frostmourne,1344,demonhunter,havoc,72,30,42
Taylordem,tichondrius,1342,demonhunter,havoc,24,14,10
Riskerdog,tichondrius,1342,demonhunter,havoc,30,14,16
Theflurry,tichondrius,1342,demonhunter,havoc,36,14,22
Catastrophis,tichondrius,1341,demonhunter,havoc,36,18,18
Deviljane,illidan,1340,demonhunter,havoc,24,14,10
Egirlhunter,echo-isles,1339,demonhunter,havoc,24,14,10
Demondubya,illidan,1339,demonhunter,havoc,28,15,13
Malviciouss,tichondrius,1339,demonhunter,havoc,42,19,23
Røllnautløw,aegwynn,1338,demonhunter,havoc,26,16,10
Sillyslayadk,moon-guard,1336,demonhunter,havoc,118,67,51
Devirador,ragnaros,1335,demonhunter,havoc,33,15,18
Danloesh,silver-hand,1334,demonhunter,havoc,24,14,10
Telrindyl,moon-guard,1330,demonhunter,havoc,99,57,42
Xein,khazgoroth,1327,demonhunter,havoc,66,30,36
Kalmor,barthilas,1327,demonhunter,havoc,45,20,25
Elevateztko,stormrage,1326,demonhunter,havoc,36,16,20
Kêrbydh,frostmourne,1325,demonhunter,havoc,36,22,14
Rizzaarrdd,tichondrius,1325,demonhunter,havoc,122,63,59
Refractx,illidan,1322,demonhunter,havoc,42,22,20
Zévron,area-52,1322,demonhunter,havoc,54,26,28
Tickelfist,zuljin,1320,demonhunter,havoc,48,22,26
Xiaochicken,tichondrius,1320,demonhunter,havoc,38,17,21
Báléríón,area-52,1319,demonhunter,havoc,35,21,14
Inkubuz,sargeras,1319,demonhunter,havoc,139,70,69
Gigavlad,area-52,1317,demonhunter,havoc,30,14,16
Valdiran,duskwood,1317,demonhunter,havoc,30,14,16
Chromatïc,jubeithos,1317,demonhunter,havoc,72,30,42
Kaelidan,kelthuzad,1316,demonhunter,havoc,111,58,53
Ovèrrated,area-52,1316,demonhunter,havoc,86,40,46
Demonkratoz,ragnaros,1316,demonhunter,havoc,43,19,24
Litzilla,thrall,1315,demonhunter,havoc,42,20,22
Nolights,area-52,1315,demonhunter,havoc,90,37,53
Mördredd,quelthalas,1315,demonhunter,havoc,37,15,22
Sicklyslick,frostmourne,1313,demonhunter,havoc,25,15,10
Rytesx,moon-guard,1310,demonhunter,havoc,28,21,7
Nurzal,malganis,1310,demonhunter,havoc,30,14,16
Stochastic,ragnaros,1310,demonhunter,havoc,37,15,22
Jibaiye,tichondrius,1309,demonhunter,havoc,30,14,16
Yønkou,stormrage,1308,demonhunter,havoc,114,57,57
Aeonys,stormrage,1304,demonhunter,havoc,36,21,15
Tekkamanevil,tichondrius,1304,demonhunter,havoc,210,104,106
Powertaco,tichondrius,1304,demonhunter,havoc,67,31,36
Silvs,illidan,1299,demonhunter,havoc,184,102,82
Belial,haomarush,1299,demonhunter,havoc,54,28,26
Halftruth,stormrage,1298,demonhunter,havoc,46,22,24
Nrpx,stormrage,1298,demonhunter,havoc,34,14,20
Thechaz,bleeding-hollow,1297,demonhunter,havoc,54,34,20
Revvup,tichondrius,1294,demonhunter,havoc,71,33,38
Alaron,wildhammer,1293,demonhunter,havoc,99,53,46
Naelaksa,tichondrius,1293,demonhunter,havoc,36,14,22
Swoffordsr,tichondrius,1291,demonhunter,havoc,48,23,25
Mursiless,drenden,1290,demonhunter,havoc,24,15,9
Mustardtigër,bleeding-hollow,1290,demonhunter,havoc,23,14,9
Chungg,laughing-skull,1287,demonhunter,havoc,30,15,15
Draenkz,ragnaros,1287,demonhunter,havoc,46,15,31
Cherlas,blood-furnace,1286,demonhunter,havoc,51,24,27
Soulsteall,tichondrius,1285,demonhunter,havoc,30,20,10
Hawkowicz,tichondrius,1284,demonhunter,havoc,181,90,91
Vwap,tichondrius,1284,demonhunter,havoc,29,14,15
Cots,stormrage,1284,demonhunter,havoc,32,15,17
Vaxs,moon-guard,1282,demonhunter,havoc,56,33,23
Roughins,chogall,1278,demonhunter,havoc,51,28,23
Malthazaan,stormrage,1276,demonhunter,havoc,20,14,6
Fiziokratdh,ghostlands,1276,demonhunter,havoc,49,21,28
Turecdh,illidan,1274,demonhunter,havoc,38,14,24
Sylenah,hyjal,1273,demonhunter,havoc,30,14,16
Foxdie,bonechewer,1271,demonhunter,havoc,36,15,21
Greent,stormrage,1270,demonhunter,havoc,30,17,13
Salomesalvi,proudmoore,1268,demonhunter,havoc,24,14,10
Neecro,frostmourne,1268,demonhunter,havoc,60,29,31
Whataboutbob,korgath,1268,demonhunter,havoc,36,14,22
Mortiria,dalaran,1267,demonhunter,havoc,67,30,37
Kereses,bonechewer,1266,demonhunter,havoc,45,25,20
Vizionz,emerald-dream,1266,demonhunter,havoc,41,21,20
Tattedandfab,stormrage,1265,demonhunter,havoc,102,44,58
Diversityabc,bleeding-hollow,1263,demonhunter,havoc,72,30,42
Skilla,frostmourne,1262,demonhunter,havoc,85,42,43
Amdusias,darkspear,1259,demonhunter,havoc,49,22,27
Eullz,skullcrusher,1257,demonhunter,havoc,31,14,17
Twodxoxo,kelthuzad,1256,demonhunter,havoc,24,14,10
Xà,sargeras,1256,demonhunter,havoc,36,14,22
Durello,stormrage,1255,demonhunter,havoc,54,25,29
Onlypain,korgath,1251,demonhunter,havoc,38,16,22
Blinddh,bleeding-hollow,1249,demonhunter,havoc,32,14,18
Mårth,caelestrasz,1248,demonhunter,havoc,48,25,23
Aleira,frostwolf,1247,demonhunter,havoc,33,18,15
Cerebro,stormrage,1247,demonhunter,havoc,24,13,11
Ilovenina,sargeras,1247,demonhunter,havoc,24,13,11
Giselah,malganis,1247,demonhunter,havoc,30,13,17
Gènji,tichondrius,1246,demonhunter,havoc,24,13,11
Achemedåche,dalaran,1245,demonhunter,havoc,18,13,5
Blúr,tichondrius,1245,demonhunter,havoc,18,13,5
Christensen,illidan,1245,demonhunter,havoc,54,30,24
Kalikanzar,sargeras,1245,demonhunter,havoc,24,13,11
Kushidari,tichondrius,1245,demonhunter,havoc,48,24,24
Diablitaa,sargeras,1245,demonhunter,havoc,30,13,17
Fingersdh,malganis,1245,demonhunter,havoc,30,13,17
Rykidh,tichondrius,1245,demonhunter,havoc,30,13,17
Trillidan,mugthol,1245,demonhunter,havoc,30,13,17
Äòégämîñg,stormrage,1245,demonhunter,havoc,36,13,23
Alizqt,ragnaros,1244,demonhunter,havoc,24,13,11
Deathsweep,tichondrius,1244,demonhunter,havoc,24,13,11
Hoguriders,tichondrius,1244,demonhunter,havoc,30,13,17
Baejuhyun,kiljaeden,1243,demonhunter,havoc,24,16,8
Smilingbomb,tichondrius,1243,demonhunter,havoc,24,13,11
Nichousha,tichondrius,1243,demonhunter,havoc,24,13,11
Intensìve,illidan,1242,demonhunter,havoc,48,14,34
Ashtyr,emerald-dream,1241,demonhunter,havoc,22,14,8
Decoi,tichondrius,1241,demonhunter,havoc,24,13,11
Tydriedian,dalaran,1239,demonhunter,havoc,18,13,5
Missjotab,tichondrius,1239,demonhunter,havoc,24,13,11
Harû,tichondrius,1239,demonhunter,havoc,30,13,17
Narandra,malganis,1239,demonhunter,havoc,36,13,23
Zématador,azralon,1238,demonhunter,havoc,100,53,47
Zétta,area-52,1236,demonhunter,havoc,24,13,11
Demonbane,moon-guard,1236,demonhunter,havoc,54,27,27
Maddummy,tichondrius,1234,demonhunter,havoc,30,13,17
Véñom,area-52,1233,demonhunter,havoc,42,13,29
Zunfooki,stormrage,1231,demonhunter,havoc,24,13,11
Sorrybadgas,illidan,1231,demonhunter,havoc,36,13,23
Sikäria,malganis,1229,demonhunter,havoc,24,13,11
Superbug,quelthalas,1229,demonhunter,havoc,42,20,22
Revean,darkspear,1226,demonhunter,havoc,66,36,30
Darthmah,illidan,1222,demonhunter,havoc,18,13,5
Tezrian,earthen-ring,1221,demonhunter,havoc,24,13,11
Lixthing,ragnaros,1220,demonhunter,havoc,55,36,19
Lachesix,tichondrius,1217,demonhunter,havoc,30,13,17
Ralrdh,ragnaros,1216,demonhunter,havoc,24,13,11
Devwillhuntu,barthilas,1216,demonhunter,havoc,80,42,38
Pilyn,ragnaros,1216,demonhunter,havoc,80,39,41
Keelin,ragnaros,1212,demonhunter,havoc,28,13,15
Eraticdh,illidan,1211,demonhunter,havoc,30,13,17
Bzrp,stormrage,1210,demonhunter,havoc,40,23,17
Asmoday,warsong,1209,demonhunter,havoc,102,59,43
Spicywings,arthas,1209,demonhunter,havoc,42,18,24
Dömönic,illidan,1208,demonhunter,havoc,24,13,11
Cursesoul,area-52,1206,demonhunter,havoc,60,31,29
Hoein,eldrethalas,1204,demonhunter,havoc,24,14,10
Raradane,illidan,1203,demonhunter,havoc,18,13,5
Adryr,eredar,1203,demonhunter,havoc,36,19,17
Hellspawnn,malganis,1200,demonhunter,havoc,44,24,20
Miltonpickle,tichondrius,1199,demonhunter,havoc,30,13,17
Etherëäl,stormrage,1194,demonhunter,havoc,53,32,21
Fellight,bonechewer,1193,demonhunter,havoc,42,27,15
Medusarri,frostmourne,1193,demonhunter,havoc,36,19,17
Aroncruel,area-52,1192,demonhunter,havoc,48,27,21
Ixix,proudmoore,1192,demonhunter,havoc,62,30,32
Illidice,tichondrius,1189,demonhunter,havoc,30,13,17
Hiddenblade,coilfang,1188,demonhunter,havoc,55,24,31
Erazuz,stormrage,1188,demonhunter,havoc,30,13,17
Scarshine,frostmourne,1186,demonhunter,havoc,66,25,41
Brunoqt,azralon,1185,demonhunter,havoc,29,13,16
Cyberpsycho,illidan,1184,demonhunter,havoc,30,14,16
Sleepyjobe,sargeras,1183,demonhunter,havoc,16,13,3
Spamsamich,stormscale,1180,demonhunter,havoc,59,35,24
Tyrelara,durotan,1179,demonhunter,havoc,23,13,10
Glayve,emerald-dream,1178,demonhunter,havoc,85,41,44
Saelila,emerald-dream,1172,demonhunter,havoc,30,13,17
Dyingslow,stormrage,1172,demonhunter,havoc,66,24,42
Buzzmezaddy,bleeding-hollow,1170,demonhunter,havoc,63,28,35
Ënky,ragnaros,1170,demonhunter,havoc,54,23,31
Gouge,hakkar,1167,demonhunter,havoc,55,30,25
Daiks,proudmoore,1166,demonhunter,havoc,48,22,26
Blazed,thrall,1164,demonhunter,havoc,94,46,48
Zoruv,quelthalas,1160,demonhunter,havoc,27,14,13
Thedaz,frostmourne,1158,demonhunter,havoc,143,66,77
Larayedia,illidan,1156,demonhunter,havoc,24,17,7
Sucubus,eredar,1155,demonhunter,havoc,30,17,13
Ragiidh,tichondrius,1152,demonhunter,havoc,24,12,12
Xragii,kelthuzad,1152,demonhunter,havoc,24,12,12
Postodesaúde,azralon,1151,demonhunter,havoc,24,12,12
Gtåte,azjolnerub,1151,demonhunter,havoc,42,12,30
Ðrogö,emerald-dream,1150,demonhunter,havoc,18,12,6
Insomdh,sargeras,1150,demonhunter,havoc,18,12,6
Fasnk,tichondrius,1150,demonhunter,havoc,24,12,12
Qixoni,emerald-dream,1150,demonhunter,havoc,30,12,18
Xylëm,tichondrius,1149,demonhunter,havoc,36,12,24
Openhard,stormrage,1148,demonhunter,havoc,24,12,12
Viio,proudmoore,1146,demonhunter,havoc,24,12,12
Chaosfienddh,bleeding-hollow,1146,demonhunter,havoc,30,12,18
Luana,stormscale,1145,demonhunter,havoc,24,12,12
Omygaud,tichondrius,1143,demonhunter,havoc,18,12,6
Namaga,illidan,1143,demonhunter,havoc,18,12,6
Skinnrd,malganis,1142,demonhunter,havoc,24,12,12
Vandeste,tichondrius,1142,demonhunter,havoc,30,12,18
Kagraxxis,stormrage,1141,demonhunter,havoc,21,13,8
Torophz,azralon,1139,demonhunter,havoc,30,12,18
Elidani,area-52,1138,demonhunter,havoc,30,12,18
Vivas,tichondrius,1136,demonhunter,havoc,24,12,12
Endyr,area-52,1136,demonhunter,havoc,25,12,13
Tayel,emerald-dream,1133,demonhunter,havoc,34,19,15
Dakro,blackrock,1130,demonhunter,havoc,22,13,9
Dandreb,draenor,1130,demonhunter,havoc,29,15,14
Ozark,barthilas,1129,demonhunter,havoc,42,25,17
Siicknote,frostmourne,1127,demonhunter,havoc,23,12,11
Jennesis,tichondrius,1126,demonhunter,havoc,78,36,42
Momysimpypoo,tichondrius,1125,demonhunter,havoc,18,12,6
Itachiix,sargeras,1125,demonhunter,havoc,18,12,6
Ibeatrix,malorne,1124,demonhunter,havoc,24,18,6
Howller,azralon,1121,demonhunter,havoc,27,13,14
Syrena,mugthol,1119,demonhunter,havoc,24,12,12
Attritionx,sargeras,1118,demonhunter,havoc,23,13,10
Painkiiller,kelthuzad,1115,demonhunter,havoc,24,15,9
Onií,bleeding-hollow,1110,demonhunter,havoc,29,12,17
Lory,eldrethalas,1108,demonhunter,havoc,67,33,34
Thelada,illidan,1106,demonhunter,havoc,27,13,14
Thèflurry,tichondrius,1102,demonhunter,havoc,23,12,11
Miroir,silvermoon,1094,demonhunter,havoc,119,54,65
Imjustbad,malganis,1091,demonhunter,havoc,48,27,21
Sätän,malganis,1089,demonhunter,havoc,24,13,11
Elenamarth,kiljaeden,1089,demonhunter,havoc,30,12,18
Lilliåna,kiljaeden,1085,demonhunter,havoc,56,24,32
Ghostzface,sargeras,1084,demonhunter,havoc,48,26,22
Kelmar,stormreaver,1084,demonhunter,havoc,32,12,20
Moxí,ragnaros,1082,demonhunter,havoc,36,19,17
Bhuppz,frostmourne,1076,demonhunter,havoc,22,12,10
Misfortune,bloodscalp,1076,demonhunter,havoc,36,15,21
Nixsa,area-52,1073,demonhunter,havoc,84,37,47
Dirtyvitus,gorefiend,1072,demonhunter,havoc,36,24,12
Esomet,stormrage,1070,demonhunter,havoc,27,15,12
Faalleen,quelthalas,1059,demonhunter,havoc,18,12,6
Syrine,veknilash,1059,demonhunter,havoc,72,41,31
Illadra,fizzcrank,1058,demonhunter,havoc,23,12,11
Cavell,tichondrius,1056,demonhunter,havoc,18,11,7
Thegoph,bleeding-hollow,1056,demonhunter,havoc,24,11,13
Zztzz,illidan,1055,demonhunter,havoc,18,11,7
Fëlla,tanaris,1055,demonhunter,havoc,18,11,7
Çópê,sargeras,1055,demonhunter,havoc,18,11,7
Gogungho,tichondrius,1055,demonhunter,havoc,24,11,13
Dennfear,skullcrusher,1054,demonhunter,havoc,18,12,6
Ariaxy,sargeras,1054,demonhunter,havoc,18,11,7
Thumôss,malganis,1054,demonhunter,havoc,18,11,7
Diiecrux,bleeding-hollow,1054,demonhunter,havoc,18,11,7
Ravack,stormrage,1054,demonhunter,havoc,18,11,7
Koverage,frostmourne,1054,demonhunter,havoc,18,11,7
Behemod,thrall,1054,demonhunter,havoc,24,11,13
Spicyblades,stormrage,1054,demonhunter,havoc,47,21,26
Mudßutt,malganis,1054,demonhunter,havoc,30,11,19
Xavid,bleeding-hollow,1053,demonhunter,havoc,24,11,13
Messenoire,area-52,1051,demonhunter,havoc,26,11,15
Mood,stonemaul,1050,demonhunter,havoc,18,11,7
Ønsen,tichondrius,1049,demonhunter,havoc,29,11,18
Trituone,ragnaros,1049,demonhunter,havoc,32,12,20
Shandras,dathremar,1048,demonhunter,havoc,18,11,7
Vuse,moon-guard,1048,demonhunter,havoc,24,11,13
Covoth,bleeding-hollow,1048,demonhunter,havoc,27,12,15
Faster,tichondrius,1048,demonhunter,havoc,30,11,19
Winlegend,gallywix,1048,demonhunter,havoc,32,11,21
Creamin,thrall,1047,demonhunter,havoc,18,11,7
Legäult,bleeding-hollow,1047,demonhunter,havoc,33,17,16
Callux,black-dragonflight,1047,demonhunter,havoc,30,11,19
Rewyle,magtheridon,1047,demonhunter,havoc,30,11,19
Midewdh,proudmoore,1046,demonhunter,havoc,24,11,13
Thunderray,ragnaros,1044,demonhunter,havoc,18,11,7
Throniren,stormrage,1044,demonhunter,havoc,24,11,13
Demonslaier,dragonblight,1043,demonhunter,havoc,20,12,8
Xanthee,drakkari,1043,demonhunter,havoc,81,41,40
Rickinmorty,lightnings-blade,1041,demonhunter,havoc,19,11,8
Aedice,gurubashi,1038,demonhunter,havoc,24,11,13
Rhaast,executus,1035,demonhunter,havoc,79,35,44
Narene,mannoroth,1034,demonhunter,havoc,27,11,16
Aliniron,illidan,1025,demonhunter,havoc,24,12,12
Chronicsmoke,blood-furnace,1024,demonhunter,havoc,30,14,16
Hentaidemon,kiljaeden,1023,demonhunter,havoc,36,18,18
Chinadh,tichondrius,1022,demonhunter,havoc,23,11,12
Darkweast,dalaran,1021,demonhunter,havoc,24,11,13
Dameon,wildhammer,1019,demonhunter,havoc,66,32,34
Jënesis,illidan,1019,demonhunter,havoc,80,35,45
Swansong,norgannon,1016,demonhunter,havoc,24,13,11
Fugabag,thrall,1015,demonhunter,havoc,23,11,12
Eikichi,bleeding-hollow,1009,demonhunter,havoc,54,26,28
Catfood,icecrown,1008,demonhunter,havoc,27,11,16
Chirõn,moonrunner,1007,demonhunter,havoc,23,11,12
Seamenhunter,garrosh,1004,demonhunter,havoc,24,12,12
Shawnchad,blood-furnace,999,demonhunter,havoc,139,71,68
Ethelric,frostmourne,993,demonhunter,havoc,41,12,29
Xxann,tichondrius,991,demonhunter,havoc,26,11,15
Lüky,malganis,986,demonhunter,havoc,22,11,11
Suhui,sargeras,983,demonhunter,havoc,29,11,18
Doomhead,burning-legion,981,demonhunter,havoc,24,15,9
Andarïel,bleeding-hollow,977,demonhunter,havoc,25,12,13
Cuint,barthilas,976,demonhunter,havoc,36,18,18
Hypetraindh,kelthuzad,960,demonhunter,havoc,12,10,2
Kokushiibo,frostwolf,960,demonhunter,havoc,18,10,8
Chainsawz,zuljin,960,demonhunter,havoc,18,10,8
Lancee,zuljin,960,demonhunter,havoc,24,10,14
Ntts,tichondrius,960,demonhunter,havoc,24,10,14
Beerbreak,area-52,960,demonhunter,havoc,30,10,20
Noztak,area-52,960,demonhunter,havoc,30,10,20
Demonleap,proudmoore,959,demonhunter,havoc,18,10,8
Sourapple,barthilas,959,demonhunter,havoc,18,10,8
Iluvboóty,blackrock,959,demonhunter,havoc,24,10,14
Hueylucifer,ravencrest,959,demonhunter,havoc,30,10,20
Cyånan,bleeding-hollow,958,demonhunter,havoc,23,14,9
Yaety,tichondrius,958,demonhunter,havoc,18,10,8
Planeinsky,malganis,958,demonhunter,havoc,18,10,8
Skógarmaðr,garrosh,958,demonhunter,havoc,23,11,12
Alwaysin,zuljin,957,demonhunter,havoc,18,10,8
Krelious,barthilas,957,demonhunter,havoc,18,10,8
Randôm,kelthuzad,957,demonhunter,havoc,21,11,10
Gilberte,stormrage,957,demonhunter,havoc,24,10,14
Tangoh,burning-legion,955,demonhunter,havoc,18,10,8
Derelikte,shadowmoon,955,demonhunter,havoc,18,10,8
Rorac,ragnaros,955,demonhunter,havoc,24,10,14
Jagidan,area-52,955,demonhunter,havoc,24,10,14
Clorhídrico,quelthalas,954,demonhunter,havoc,72,35,37
Xibir,amanthul,953,demonhunter,havoc,24,10,14
Larnol,moon-guard,952,demonhunter,havoc,18,10,8
Allenqt,azralon,952,demonhunter,havoc,24,10,14
Nerco,bleeding-hollow,952,demonhunter,havoc,24,10,14
Akurawrath,area-52,951,demonhunter,havoc,12,10,2
Mázoku,shuhalo,951,demonhunter,havoc,20,11,9
Ghótam,quelthalas,950,demonhunter,havoc,24,10,14
Vladdtepes,cairne,949,demonhunter,havoc,83,44,39
Airaxx,moon-guard,949,demonhunter,havoc,21,11,10
Letzgobrandn,silvermoon,948,demonhunter,havoc,18,10,8
Kwoop,tichondrius,946,demonhunter,havoc,24,10,14
Annabow,moon-guard,944,demonhunter,havoc,66,34,32
Demonizhe,thrall,944,demonhunter,havoc,43,22,21
Elurandre,moon-guard,944,demonhunter,havoc,23,10,13
Weedeaterr,arthas,943,demonhunter,havoc,36,10,26
Evros,tichondrius,933,demonhunter,havoc,21,11,10
Deegsdh,sargeras,932,demonhunter,havoc,27,10,17
Andyhunter,emerald-dream,930,demonhunter,havoc,62,32,30
Gozer,korialstrasz,929,demonhunter,havoc,36,12,24
Lillidum,azralon,927,demonhunter,havoc,45,21,24
Keeblerself,tichondrius,925,demonhunter,havoc,24,11,13
Vilal,dalaran,923,demonhunter,havoc,14,11,3
Gravelot,quelthalas,915,demonhunter,havoc,30,10,20
Bukwheat,thunderhorn,913,demonhunter,havoc,66,31,35
Troigh,thunderlord,912,demonhunter,havoc,60,29,31
Kslicedevil,dalaran,909,demonhunter,havoc,66,28,38
Rissélys,thrall,894,demonhunter,havoc,30,15,15
Falaszun,aegwynn,889,demonhunter,havoc,20,10,10
Ripchimmii,illidan,880,demonhunter,havoc,25,10,15
Mikiller,thrall,879,demonhunter,havoc,109,53,56
Blacktocki,barthilas,878,demonhunter,havoc,22,10,12
Blops,emerald-dream,877,demonhunter,havoc,24,11,13
Riicardo,ragnaros,870,demonhunter,havoc,28,12,16
Faarkyou,barthilas,868,demonhunter,havoc,26,10,16
Myname,aggramar,866,demonhunter,havoc,56,14,42
Souliz,tichondrius,864,demonhunter,havoc,12,9,3
Ragiixoxo,tichondrius,864,demonhunter,havoc,12,9,3
Ravevê,area-52,864,demonhunter,havoc,12,9,3
Pennyx,barthilas,864,demonhunter,havoc,12,9,3
Bammski,tichondrius,864,demonhunter,havoc,18,9,9
Tarro,whisperwind,864,demonhunter,havoc,18,9,9
Mcgurty,illidan,864,demonhunter,havoc,24,9,15
Noobender,malganis,864,demonhunter,havoc,30,9,21
Ripidan,stormrage,864,demonhunter,havoc,30,9,21
Agsakim,tichondrius,863,demonhunter,havoc,12,9,3
Subieshift,sargeras,863,demonhunter,havoc,15,10,5
Rothdh,tichondrius,863,demonhunter,havoc,15,10,5
Sävage,zuljin,863,demonhunter,havoc,18,9,9
Dogcleave,area-52,863,demonhunter,havoc,18,9,9
Orosz,bleeding-hollow,863,demonhunter,havoc,18,9,9
Worldahmelee,illidan,863,demonhunter,havoc,18,9,9
Lördvïngadør,azralon,863,demonhunter,havoc,18,9,9
Dmonslayer,daggerspine,863,demonhunter,havoc,24,9,15
Amanthx,tichondrius,863,demonhunter,havoc,24,9,15
Checkmate,bleeding-hollow,863,demonhunter,havoc,24,9,15
Khaito,illidan,863,demonhunter,havoc,24,9,15
Dragynfíst,malganis,863,demonhunter,havoc,30,9,21
Rizzle,malganis,862,demonhunter,havoc,18,9,9
Vida,winterhoof,862,demonhunter,havoc,18,9,9
Nicosdh,agamaggan,862,demonhunter,havoc,18,9,9
Hugehogger,boulderfist,862,demonhunter,havoc,18,9,9
Moranah,tichondrius,862,demonhunter,havoc,18,9,9
Lucipur,thrall,862,demonhunter,havoc,18,9,9
Phoébé,drakkari,861,demonhunter,havoc,18,9,9
Facerollfel,tichondrius,861,demonhunter,havoc,18,9,9
Felhunt,ragnaros,861,demonhunter,havoc,24,9,15
Rosamune,kelthuzad,861,demonhunter,havoc,24,9,15
Hellboss,dalaran,860,demonhunter,havoc,12,9,3
Zirrey,stormrage,860,demonhunter,havoc,18,9,9
Rèlentless,moon-guard,860,demonhunter,havoc,18,9,9
Bodemön,stormrage,860,demonhunter,havoc,18,9,9
Alphmega,malganis,859,demonhunter,havoc,18,9,9
Smokahontas,eredar,859,demonhunter,havoc,18,9,9
Cleår,kelthuzad,859,demonhunter,havoc,18,9,9
Allukya,azralon,856,demonhunter,havoc,12,9,3
Flyingsky,tichondrius,855,demonhunter,havoc,12,9,3
Aflex,zuljin,855,demonhunter,havoc,18,9,9
Dartanyn,tichondrius,853,demonhunter,havoc,24,9,15
Drackista,stormrage,852,demonhunter,havoc,18,9,9
Jakodh,sargeras,848,demonhunter,havoc,18,9,9
Aussiepleb,nagrand,846,demonhunter,havoc,87,37,50
Dalmandra,arthas,841,demonhunter,havoc,17,9,8
Wut,nemesis,839,demonhunter,havoc,70,34,36
Syldaeya,silvermoon,838,demonhunter,havoc,22,11,11
Fckyouscott,illidan,830,demonhunter,havoc,14,10,4
Necrødh,tichondrius,828,demonhunter,havoc,16,9,7
Aleymar,tichondrius,822,demonhunter,havoc,18,9,9
Szei,tichondrius,815,demonhunter,havoc,11,9,2
Wokeaf,malganis,814,demonhunter,havoc,17,9,8
Coaa,dalaran,814,demonhunter,havoc,23,9,14
Pariah,saurfang,813,demonhunter,havoc,17,9,8
Antistar,emerald-dream,799,demonhunter,havoc,26,9,17
Felraven,scarlet-crusade,797,demonhunter,havoc,16,9,7
Demonci,stormrage,795,demonhunter,havoc,20,11,9
Jellehx,frostmourne,784,demonhunter,havoc,13,9,4
Deuzz,arthas,768,demonhunter,havoc,12,8,4
Lxg,kelthuzad,768,demonhunter,havoc,12,8,4
Dzdh,stormrage,768,demonhunter,havoc,12,8,4
Humanitydh,sargeras,768,demonhunter,havoc,12,8,4
Thickgary,illidan,768,demonhunter,havoc,12,8,4
Dulcibella,tichondrius,768,demonhunter,havoc,12,8,4
Surkkdh,tichondrius,768,demonhunter,havoc,12,8,4
Doomanone,sargeras,768,demonhunter,havoc,12,8,4
Squaller,tichondrius,768,demonhunter,havoc,12,8,4
Mesidan,illidan,768,demonhunter,havoc,12,8,4
Helltaker,blood-furnace,768,demonhunter,havoc,12,8,4
Cegocruel,sargeras,768,demonhunter,havoc,13,8,5
Devssimpspec,sargeras,768,demonhunter,havoc,18,8,10
Raylêy,tichondrius,768,demonhunter,havoc,18,8,10
Felontis,sargeras,768,demonhunter,havoc,18,8,10
Neverblurx,kirin-tor,768,demonhunter,havoc,18,8,10
Zuppashi,area-52,768,demonhunter,havoc,18,8,10
Fingól,ragnaros,768,demonhunter,havoc,18,8,10
Felgobbler,zuljin,768,demonhunter,havoc,18,8,10
Veilmaya,arthas,768,demonhunter,havoc,18,8,10
Tomhenk,blackrock,768,demonhunter,havoc,18,8,10
Doomantwo,sargeras,768,demonhunter,havoc,24,8,16
Bdwxxnmm,tichondrius,768,demonhunter,havoc,24,8,16
Hellrazer,area-52,767,demonhunter,havoc,12,8,4
Aethrys,amanthul,767,demonhunter,havoc,12,8,4
Badwurd,sargeras,767,demonhunter,havoc,12,8,4
Cocomeld,tichondrius,767,demonhunter,havoc,12,8,4
Myspyhu,malganis,767,demonhunter,havoc,12,8,4
Prazethesun,emerald-dream,767,demonhunter,havoc,12,8,4
Netherbird,malganis,767,demonhunter,havoc,12,8,4
Ziyàl,vashj,767,demonhunter,havoc,12,8,4
Xonu,sargeras,767,demonhunter,havoc,12,8,4
Lethalblows,darkspear,767,demonhunter,havoc,15,9,6
Linedori,destromath,767,demonhunter,havoc,16,9,7
ßonècrushèr,tichondrius,767,demonhunter,havoc,18,8,10
Demonqt,blackrock,767,demonhunter,havoc,18,8,10
Hellrazer,azgalor,767,demonhunter,havoc,18,8,10
Madatya,black-dragonflight,767,demonhunter,havoc,18,8,10
Oddlysimple,korgath,767,demonhunter,havoc,18,8,10
Feldumper,illidan,767,demonhunter,havoc,18,8,10
Wólff,azralon,766,demonhunter,havoc,12,8,4
Andein,dalaran,766,demonhunter,havoc,12,8,4
Felshiv,azralon,766,demonhunter,havoc,18,8,10
Rolecheck,tichondrius,766,demonhunter,havoc,18,8,10
Darkglaive,ragnaros,766,demonhunter,havoc,18,8,10
Accipiter,ragnaros,766,demonhunter,havoc,24,8,16
Yedeme,tichondrius,766,demonhunter,havoc,25,8,17
Bholez,illidan,765,demonhunter,havoc,18,8,10
Këÿz,earthen-ring,765,demonhunter,havoc,18,8,10
Lû,arthas,765,demonhunter,havoc,24,8,16
Diddlemethis,nagrand,764,demonhunter,havoc,12,8,4
Margerie,bleeding-hollow,764,demonhunter,havoc,18,8,10
Felbòy,korgath,763,demonhunter,havoc,18,8,10
Llrebelionll,stormrage,762,demonhunter,havoc,12,8,4
Sodiaksd,quelthalas,762,demonhunter,havoc,18,8,10
Lingnafoxy,tichondrius,762,demonhunter,havoc,21,9,12
Illhuntya,bonechewer,758,demonhunter,havoc,18,8,10
Suyu,ragnaros,758,demonhunter,havoc,21,8,13
Maydemon,ragnaros,757,demonhunter,havoc,24,8,16
Covidneitor,drakkari,752,demonhunter,havoc,24,8,16
Menadori,madoran,748,demonhunter,havoc,18,8,10
Abusedchild,dalaran,735,demonhunter,havoc,18,8,10
Grolschen,proudmoore,735,demonhunter,havoc,24,9,15
Wuya,thrall,734,demonhunter,havoc,22,8,14
Kellndore,emerald-dream,730,demonhunter,havoc,18,8,10
Hiresol,emerald-dream,719,demonhunter,havoc,11,8,3
Rôrônôâzôrô,stormrage,719,demonhunter,havoc,17,8,9
Malefisentt,firetree,719,demonhunter,havoc,21,9,12
Lrianna,senjin,706,demonhunter,havoc,17,8,9
Diequickly,tichondrius,704,demonhunter,havoc,22,8,14
Nécô,tichondrius,703,demonhunter,havoc,14,8,6
Dakkemon,zuljin,702,demonhunter,havoc,20,8,12
Rivent,dethecus,702,demonhunter,havoc,26,8,18
Memoryleaky,proudmoore,696,demonhunter,havoc,11,8,3
Neshaan,stormreaver,688,demonhunter,havoc,38,20,18
Dæl,quelthalas,672,demonhunter,havoc,12,7,5
Stalaias,madoran,672,demonhunter,havoc,12,7,5
Reddh,bleeding-hollow,672,demonhunter,havoc,12,7,5
Icantseelol,sargeras,672,demonhunter,havoc,12,7,5
Darthwhorë,frostmane,672,demonhunter,havoc,12,7,5
Levail,wyrmrest-accord,672,demonhunter,havoc,12,7,5
Endofdaysx,tichondrius,672,demonhunter,havoc,12,7,5
Verå,tichondrius,672,demonhunter,havoc,12,7,5
Dabsfordayz,zuluhed,672,demonhunter,havoc,12,7,5
Evelynee,illidan,672,demonhunter,havoc,12,7,5
Warassassin,stormrage,672,demonhunter,havoc,12,7,5
Idontfaced,area-52,672,demonhunter,havoc,12,7,5
Demonthorne,illidan,672,demonhunter,havoc,12,7,5
Fiveiq,malganis,672,demonhunter,havoc,12,7,5
Solbiz,tichondrius,672,demonhunter,havoc,12,7,5
Isev,illidan,672,demonhunter,havoc,12,7,5
Slaarky,malganis,672,demonhunter,havoc,12,7,5
Nichidah,illidan,672,demonhunter,havoc,12,7,5
Flamehunter,durotan,672,demonhunter,havoc,13,7,6
Igotdc,tichondrius,672,demonhunter,havoc,13,7,6
Elchapotko,tichondrius,672,demonhunter,havoc,18,7,11
Faceurdemons,frostmourne,672,demonhunter,havoc,18,7,11
Moistybreeze,frostmourne,672,demonhunter,havoc,18,7,11
Dumbledor,stonemaul,672,demonhunter,havoc,18,7,11
Babahorns,dalaran,672,demonhunter,havoc,18,7,11
Yasuo,moon-guard,672,demonhunter,havoc,18,7,11
Demonaco,tichondrius,672,demonhunter,havoc,24,7,17
Sadpepe,bleeding-hollow,672,demonhunter,havoc,24,7,17
Stormville,illidan,671,demonhunter,havoc,12,7,5
Cresslina,tichondrius,671,demonhunter,havoc,12,7,5
Wìtchblades,tichondrius,671,demonhunter,havoc,12,7,5
Alycina,wyrmrest-accord,671,demonhunter,havoc,12,7,5
Ogmon,tichondrius,671,demonhunter,havoc,12,7,5
Ivalerà,thrall,671,demonhunter,havoc,12,7,5
Fiebzz,queldorei,671,demonhunter,havoc,12,7,5
Jolty,stormrage,671,demonhunter,havoc,12,7,5
Unóhana,drakkari,671,demonhunter,havoc,12,7,5
Rhadê,ragnaros,671,demonhunter,havoc,12,7,5
Taters,gorefiend,671,demonhunter,havoc,12,7,5
Seabisciut,silvermoon,671,demonhunter,havoc,12,7,5
Cascadingeye,emerald-dream,671,demonhunter,havoc,12,7,5
Zarroe,stormrage,671,demonhunter,havoc,12,7,5
Nicòrobin,dalaran,671,demonhunter,havoc,18,7,11
Sektõr,dalaran,671,demonhunter,havoc,18,7,11
Veryaverage,kelthuzad,671,demonhunter,havoc,18,7,11
Haax,azralon,671,demonhunter,havoc,18,7,11
Hyphonìc,area-52,671,demonhunter,havoc,18,7,11
Ðarkone,ragnaros,671,demonhunter,havoc,24,7,17
Keigna,tichondrius,670,demonhunter,havoc,12,7,5
Yaakee,tichondrius,670,demonhunter,havoc,12,7,5
Renshear,cenarius,670,demonhunter,havoc,12,7,5
Bijix,area-52,670,demonhunter,havoc,12,7,5
Ãstoreth,quelthalas,670,demonhunter,havoc,12,7,5
Zanaiahs,sargeras,670,demonhunter,havoc,21,7,14
Stepbroseph,kiljaeden,669,demonhunter,havoc,15,8,7
Halfprepared,kelthuzad,669,demonhunter,havoc,24,7,17
Denjii,malganis,669,demonhunter,havoc,24,7,17
Falsewave,sargeras,668,demonhunter,havoc,12,7,5
Demonbanter,emerald-dream,668,demonhunter,havoc,15,8,7
Xxsozin,skullcrusher,668,demonhunter,havoc,18,7,11
Irìs,blood-furnace,668,demonhunter,havoc,24,7,17
Snòòp,uldaman,667,demonhunter,havoc,12,7,5
Gretadumberg,area-52,666,demonhunter,havoc,12,7,5
Rahgoul,garrosh,666,demonhunter,havoc,18,7,11
Endoshiva,icecrown,666,demonhunter,havoc,18,7,11
Genifer,norgannon,665,demonhunter,havoc,12,7,5
Turbochadbro,spirestone,663,demonhunter,havoc,15,8,7
Rhydonx,korgath,662,demonhunter,havoc,12,7,5
Eckerstrom,tichondrius,659,demonhunter,havoc,12,7,5
Luzev,thrall,657,demonhunter,havoc,12,7,5
Ripperxx,zuljin,653,demonhunter,havoc,18,7,11
Purpsquirter,stormscale,653,demonhunter,havoc,21,8,13
Lëif,stormrage,652,demonhunter,havoc,18,7,11
Gwîlym,area-52,644,demonhunter,havoc,14,9,5
Leg,scilla,640,demonhunter,havoc,16,7,9
Pegásus,kiljaeden,639,demonhunter,havoc,10,7,3
Çummins,malganis,637,demonhunter,havoc,14,8,6
Bliqué,emerald-dream,633,demonhunter,havoc,17,7,10
Bigtitiemilk,tichondrius,623,demonhunter,havoc,11,7,4
Gebblemon,aerie-peak,623,demonhunter,havoc,17,7,10
Hidan,velen,621,demonhunter,havoc,14,8,6
Mqvdh,area-52,618,demonhunter,havoc,39,8,31
Galaxezz,bonechewer,612,demonhunter,havoc,15,8,7
Joegamer,illidan,607,demonhunter,havoc,14,8,6
Wualicho,ragnaros,603,demonhunter,havoc,24,8,16
Runecaster,anvilmar,587,demonhunter,havoc,11,7,4
Bossdh,zuljin,576,demonhunter,havoc,12,6,6
Manmilker,bleeding-hollow,576,demonhunter,havoc,12,6,6
Pabloh,trollbane,576,demonhunter,havoc,12,6,6
Metakigai,ghostlands,576,demonhunter,havoc,12,6,6
Whatdagoof,tichondrius,576,demonhunter,havoc,12,6,6
Basdminority,bleeding-hollow,576,demonhunter,havoc,12,6,6
Carlosjr,stormrage,576,demonhunter,havoc,12,6,6
Felraiser,stormrage,576,demonhunter,havoc,12,6,6
Merzinator,korgath,576,demonhunter,havoc,12,6,6
Everdh,barthilas,576,demonhunter,havoc,12,6,6
Qualitycaulk,tichondrius,576,demonhunter,havoc,12,6,6
Fanc,sargeras,576,demonhunter,havoc,12,6,6
Yikari,stormrage,576,demonhunter,havoc,12,6,6
Lettüceprey,sargeras,576,demonhunter,havoc,12,6,6
Irezumi,icecrown,576,demonhunter,havoc,12,6,6
Niteclawla,illidan,576,demonhunter,havoc,12,6,6
Kolthis,tichondrius,576,demonhunter,havoc,12,6,6
Audara,sargeras,576,demonhunter,havoc,12,6,6
Minhzie,moon-guard,576,demonhunter,havoc,12,6,6
Vishì,thrall,576,demonhunter,havoc,12,6,6
Deathschosen,malganis,576,demonhunter,havoc,12,6,6
Kyuno,eitrigg,576,demonhunter,havoc,12,6,6
Thunderlor,malganis,576,demonhunter,havoc,12,6,6
Beniesdh,frostmourne,576,demonhunter,havoc,12,6,6
Shadöw,emerald-dream,576,demonhunter,havoc,12,6,6
Cðnstantine,barthilas,576,demonhunter,havoc,12,6,6
Abadina,illidan,576,demonhunter,havoc,12,6,6
Trenbolognie,illidan,576,demonhunter,havoc,12,6,6
Stalkdemon,azralon,576,demonhunter,havoc,12,6,6
Crankbaz,malganis,576,demonhunter,havoc,12,6,6
Seya,tichondrius,576,demonhunter,havoc,12,6,6
Blanky,shadowmoon,576,demonhunter,havoc,12,6,6
Valeriya,frostmourne,576,demonhunter,havoc,12,6,6
Zyer,mannoroth,576,demonhunter,havoc,12,6,6
Gommademon,illidan,576,demonhunter,havoc,12,6,6
Dgj,kelthuzad,576,demonhunter,havoc,12,6,6
Evelynvc,illidan,576,demonhunter,havoc,12,6,6
Slapxy,illidan,576,demonhunter,havoc,12,6,6
Solriel,malganis,576,demonhunter,havoc,12,6,6
Jotalejandro,quelthalas,576,demonhunter,havoc,12,6,6
Trampstampz,darkspear,576,demonhunter,havoc,12,6,6
Weskerz,illidan,576,demonhunter,havoc,12,6,6
Ahsoka,arygos,576,demonhunter,havoc,15,7,8
Zümanity,zangarmarsh,576,demonhunter,havoc,18,6,12
Kelan,borean-tundra,576,demonhunter,havoc,18,6,12
Thrania,lothar,576,demonhunter,havoc,18,6,12
Demonfused,illidan,576,demonhunter,havoc,18,6,12
Gayrio,sargeras,576,demonhunter,havoc,18,6,12
Tresbotones,kelthuzad,576,demonhunter,havoc,18,6,12
Busta,dethecus,576,demonhunter,havoc,18,6,12
Xyntel,tichondrius,576,demonhunter,havoc,18,6,12
Abscarnage,ragnaros,576,demonhunter,havoc,18,6,12
Zergedh,kiljaeden,576,demonhunter,havoc,18,6,12
Vyrai,lightbringer,576,demonhunter,havoc,18,6,12
Chabashira,tichondrius,576,demonhunter,havoc,19,6,13
Eazyrat,stormrage,575,demonhunter,havoc,6,6,0
Hootyeahbou,shattered-hand,575,demonhunter,havoc,12,6,6
Diizy,illidan,575,demonhunter,havoc,12,6,6
Lovekills,tichondrius,575,demonhunter,havoc,12,6,6
Lysol,darrowmere,575,demonhunter,havoc,12,6,6
Cholula,korgath,575,demonhunter,havoc,12,6,6
Veladoria,malorne,575,demonhunter,havoc,12,6,6
Tyindorin,gurubashi,575,demonhunter,havoc,12,6,6
Liquidblaze,elune,575,demonhunter,havoc,12,6,6
Sekiro,illidan,575,demonhunter,havoc,12,6,6
Eyesyk,bonechewer,575,demonhunter,havoc,12,6,6
Gurthbrookz,tichondrius,575,demonhunter,havoc,12,6,6
Smoothtaco,azshara,575,demonhunter,havoc,12,6,6
ßatmañ,barthilas,575,demonhunter,havoc,18,6,12
Jalet,azralon,575,demonhunter,havoc,18,6,12
Salveya,stormrage,575,demonhunter,havoc,20,6,14
Casualdemon,emerald-dream,574,demonhunter,havoc,12,6,6
Ðruh,kelthuzad,574,demonhunter,havoc,18,6,12
Firesworn,zuljin,573,demonhunter,havoc,12,6,6
Slaytan,darkspear,573,demonhunter,havoc,18,6,12
Adayinthelif,proudmoore,573,demonhunter,havoc,18,6,12
Lanistus,bloodhoof,570,demonhunter,havoc,18,6,12
Rampyr,terokkar,569,demonhunter,havoc,12,6,6
Kreel,ghostlands,568,demonhunter,havoc,12,6,6
Thjoannys,illidan,567,demonhunter,havoc,12,6,6
Kêydën,ragnaros,541,demonhunter,havoc,10,7,3
Xlash,malganis,528,demonhunter,havoc,15,6,9
Shizune,boulderfist,525,demonhunter,havoc,11,6,5
Wickedlurker,sargeras,519,demonhunter,havoc,17,9,8
Soure,azralon,511,demonhunter,havoc,14,6,8
Äshês,blackhand,510,demonhunter,havoc,8,6,2
Isedelica,area-52,510,demonhunter,havoc,11,6,5
Vessarin,madoran,510,demonhunter,havoc,20,6,14
Ceried,moon-guard,491,demonhunter,havoc,13,6,7
Kyndris,ghostlands,480,demonhunter,havoc,6,5,1
Ottie,kelthuzad,480,demonhunter,havoc,6,5,1
Khaodemus,kaelthas,480,demonhunter,havoc,6,5,1
Lumh,quelthalas,480,demonhunter,havoc,6,5,1
Ljevilin,gilneas,480,demonhunter,havoc,6,5,1
Cynthadra,frostmourne,480,demonhunter,havoc,6,5,1
Tîtø,quelthalas,480,demonhunter,havoc,6,5,1
Ryntx,moon-guard,480,demonhunter,havoc,6,5,1
Damador,malganis,480,demonhunter,havoc,6,5,1
Isabellaluna,illidan,480,demonhunter,havoc,6,5,1
Med,wyrmrest-accord,480,demonhunter,havoc,6,5,1
Milfhuñter,sargeras,480,demonhunter,havoc,6,5,1
Keairà,bleeding-hollow,480,demonhunter,havoc,8,5,3
Hyptonique,queldorei,480,demonhunter,havoc,12,5,7
Delaían,drakkari,480,demonhunter,havoc,12,5,7
Bátmañ,stormrage,480,demonhunter,havoc,12,5,7
Onbloodfam,kelthuzad,480,demonhunter,havoc,12,5,7
Nightwisty,azralon,480,demonhunter,havoc,12,5,7
Dheria,barthilas,480,demonhunter,havoc,12,5,7
Anthvedroth,area-52,480,demonhunter,havoc,12,5,7
Tyrele,drakkari,480,demonhunter,havoc,12,5,7
Wwdh,stormrage,480,demonhunter,havoc,12,5,7
Muffjuice,emerald-dream,480,demonhunter,havoc,12,5,7
Obîtox,illidan,480,demonhunter,havoc,12,5,7
Roughcut,blackrock,480,demonhunter,havoc,12,5,7
Emodan,moon-guard,480,demonhunter,havoc,12,5,7
Billmurray,skullcrusher,480,demonhunter,havoc,12,5,7
Goodrink,tichondrius,480,demonhunter,havoc,12,5,7
Highpower,area-52,480,demonhunter,havoc,12,5,7
Paypaldh,malganis,480,demonhunter,havoc,12,5,7
Bümb,moon-guard,480,demonhunter,havoc,12,5,7
Feliodas,tichondrius,480,demonhunter,havoc,12,5,7
Cabedh,tichondrius,480,demonhunter,havoc,12,5,7
Harahmbae,moon-guard,480,demonhunter,havoc,12,5,7
Hippygamer,frostmourne,480,demonhunter,havoc,12,5,7
Lìttlê,runetotem,480,demonhunter,havoc,12,5,7
Køugami,azralon,480,demonhunter,havoc,12,5,7
Domeemommy,moon-guard,480,demonhunter,havoc,12,5,7
Sailtheskies,tichondrius,480,demonhunter,havoc,12,5,7
Khelt,dalaran,480,demonhunter,havoc,12,5,7
Dontplanahea,tichondrius,480,demonhunter,havoc,12,5,7
Theownz,stormrage,480,demonhunter,havoc,12,5,7
Ahurock,ragnaros,480,demonhunter,havoc,12,5,7
Bellysniffer,illidan,480,demonhunter,havoc,12,5,7
Finagel,destromath,480,demonhunter,havoc,12,5,7
Zlr,bleeding-hollow,480,demonhunter,havoc,12,5,7
Cupernacus,tichondrius,480,demonhunter,havoc,12,5,7
Demondurk,illidan,480,demonhunter,havoc,12,5,7
Drathothian,moon-guard,480,demonhunter,havoc,12,5,7
Xiaodudh,tichondrius,480,demonhunter,havoc,12,5,7
Besoween,tichondrius,480,demonhunter,havoc,12,5,7
Dbljump,kiljaeden,480,demonhunter,havoc,12,5,7
Dhworm,azralon,480,demonhunter,havoc,12,5,7
Chandrian,gorefiend,480,demonhunter,havoc,12,5,7
Jiawen,barthilas,480,demonhunter,havoc,12,5,7
Untouchèd,bleeding-hollow,480,demonhunter,havoc,12,5,7
Uneasydh,tichondrius,480,demonhunter,havoc,12,5,7
Mjin,tichondrius,480,demonhunter,havoc,12,5,7
Chupillidan,tichondrius,480,demonhunter,havoc,12,5,7
Dàrk,zuljin,480,demonhunter,havoc,23,7,16
Soulrending,stormrage,480,demonhunter,havoc,18,5,13
Thedh,ragnaros,480,demonhunter,havoc,18,5,13
Dracxus,sargeras,480,demonhunter,havoc,18,5,13
Barael,tichondrius,480,demonhunter,havoc,18,5,13
Eyebeamtowin,stormrage,480,demonhunter,havoc,18,5,13
Roozi,tichondrius,480,demonhunter,havoc,24,5,19
Pwnagextreme,area-52,479,demonhunter,havoc,6,5,1
Breezoo,tichondrius,479,demonhunter,havoc,6,5,1
Jizzidan,blackhand,479,demonhunter,havoc,6,5,1
Pocahotnes,stormrage,479,demonhunter,havoc,12,5,7
Cantreborn,destromath,479,demonhunter,havoc,12,5,7
ßoobiemiles,area-52,479,demonhunter,havoc,12,5,7
Felmilk,demon-soul,479,demonhunter,havoc,12,5,7
Fliar,black-dragonflight,479,demonhunter,havoc,12,5,7
Denathrion,moon-guard,479,demonhunter,havoc,12,5,7
Epicfront,darkspear,479,demonhunter,havoc,12,5,7
Felvanora,amanthul,479,demonhunter,havoc,12,5,7
Horndawgg,zuljin,479,demonhunter,havoc,12,5,7
Kattsparrow,stormrage,479,demonhunter,havoc,18,5,13
Bonebtwo,area-52,479,demonhunter,havoc,18,5,13
Hàuntress,saurfang,479,demonhunter,havoc,18,5,13
Tdmturbo,zuluhed,478,demonhunter,havoc,12,5,7
Kritik,goldrinn,478,demonhunter,havoc,12,5,7
Midnightlord,tichondrius,477,demonhunter,havoc,6,5,1
Devc,stormrage,477,demonhunter,havoc,12,5,7
Mentoes,tichondrius,473,demonhunter,havoc,12,5,7
Raum,elune,443,demonhunter,havoc,8,6,2
Bogged,emerald-dream,432,demonhunter,havoc,9,5,4
Bituhvic,stormrage,431,demonhunter,havoc,11,5,6
Roosterhead,azjolnerub,430,demonhunter,havoc,11,5,6
Annxyìng,tichondrius,426,demonhunter,havoc,14,6,8
Funky,draenor,420,demonhunter,havoc,22,8,14
Tygerion,emerald-dream,416,demonhunter,havoc,10,5,5
Wheredyougo,proudmoore,416,demonhunter,havoc,10,5,5
Blinddude,sargeras,415,demonhunter,havoc,14,5,9
Ryemortis,malganis,415,demonhunter,havoc,14,5,9
Bladezues,tichondrius,415,demonhunter,havoc,14,5,9
Teenis,malygos,412,demonhunter,havoc,14,5,9
Akiirus,azralon,400,demonhunter,havoc,7,5,2
Italoo,ragnaros,384,demonhunter,havoc,6,4,2
Bopersdh,drakkari,384,demonhunter,havoc,6,4,2
Verasu,kiljaeden,384,demonhunter,havoc,6,4,2
Ktsoulhunter,azralon,384,demonhunter,havoc,6,4,2
Doras,kelthuzad,384,demonhunter,havoc,6,4,2
Tyindron,exodar,384,demonhunter,havoc,6,4,2
Parabolicc,illidan,384,demonhunter,havoc,6,4,2
Blackblades,blackhand,384,demonhunter,havoc,6,4,2
Jinsha,emerald-dream,384,demonhunter,havoc,6,4,2
Felluser,sargeras,384,demonhunter,havoc,6,4,2
Touchmeweird,area-52,384,demonhunter,havoc,6,4,2
Fov,crushridge,384,demonhunter,havoc,6,4,2
Hordesback,illidan,384,demonhunter,havoc,6,4,2
Abakkio,kelthuzad,384,demonhunter,havoc,6,4,2
Intrusive,kelthuzad,384,demonhunter,havoc,6,4,2
Heygriffin,proudmoore,384,demonhunter,havoc,6,4,2
Uncleruckus,bloodscalp,384,demonhunter,havoc,6,4,2
Spasmodiic,illidan,384,demonhunter,havoc,6,4,2
Kasseater,stormrage,384,demonhunter,havoc,6,4,2
Ultear,the-venture-co,384,demonhunter,havoc,6,4,2
Servilletas,spirestone,384,demonhunter,havoc,6,4,2
Whudaz,tichondrius,384,demonhunter,havoc,6,4,2
Florks,area-52,384,demonhunter,havoc,6,4,2
Illidam,arthas,384,demonhunter,havoc,6,4,2
Extínctíon,moon-guard,384,demonhunter,havoc,6,4,2
Tragedydh,sargeras,384,demonhunter,havoc,6,4,2
Nihilist,kaelthas,384,demonhunter,havoc,6,4,2
Ineptbb,frostmourne,384,demonhunter,havoc,6,4,2
Khaosx,ragnaros,384,demonhunter,havoc,6,4,2
Dareassassin,tichondrius,384,demonhunter,havoc,6,4,2
Déörwine,quelthalas,384,demonhunter,havoc,6,4,2
Cwrld,area-52,384,demonhunter,havoc,6,4,2
Darkrëaper,azralon,384,demonhunter,havoc,6,4,2
Mysteryastor,tichondrius,384,demonhunter,havoc,6,4,2
Boonchux,frostmourne,384,demonhunter,havoc,6,4,2
Vyndrestan,dalaran,384,demonhunter,havoc,6,4,2
Darkah,icecrown,384,demonhunter,havoc,6,4,2
Deezhuntz,anvilmar,384,demonhunter,havoc,6,4,2
Jeeprcreeprs,sargeras,384,demonhunter,havoc,6,4,2
Wogarg,sargeras,384,demonhunter,havoc,6,4,2
Bigdingding,area-52,384,demonhunter,havoc,6,4,2
Slyblitz,bleeding-hollow,384,demonhunter,havoc,6,4,2
Tristanzx,sargeras,384,demonhunter,havoc,6,4,2
Yågåmist,dalaran,384,demonhunter,havoc,6,4,2
Cloudzzy,illidan,384,demonhunter,havoc,6,4,2
Diëgo,gallywix,384,demonhunter,havoc,6,4,2
Misriah,sargeras,384,demonhunter,havoc,12,4,8
Separate,stormrage,384,demonhunter,havoc,12,4,8
Pupariuh,illidan,384,demonhunter,havoc,12,4,8
Heallscrean,drakkari,384,demonhunter,havoc,12,4,8
Drîp,moon-guard,384,demonhunter,havoc,12,4,8
Contactfront,whisperwind,384,demonhunter,havoc,12,4,8
Allidox,tichondrius,384,demonhunter,havoc,12,4,8
Sinhful,darkspear,384,demonhunter,havoc,12,4,8
Ahernn,tichondrius,384,demonhunter,havoc,12,4,8
Devilspawnss,barthilas,384,demonhunter,havoc,12,4,8
Butterfinger,greymane,384,demonhunter,havoc,12,4,8
Zoomie,durotan,384,demonhunter,havoc,12,4,8
Reapersauce,illidan,384,demonhunter,havoc,12,4,8
Dhsoop,tichondrius,384,demonhunter,havoc,12,4,8
Vorlimornd,illidan,384,demonhunter,havoc,12,4,8
Maisus,illidan,384,demonhunter,havoc,12,4,8
Vallar,bleeding-hollow,384,demonhunter,havoc,12,4,8
Angelawhite,illidan,384,demonhunter,havoc,12,4,8
Mommafingers,illidan,384,demonhunter,havoc,12,4,8
Zzatmikaze,area-52,384,demonhunter,havoc,12,4,8
Dkdakìng,thrall,384,demonhunter,havoc,12,4,8
Gulios,azralon,384,demonhunter,havoc,12,4,8
Mikemyoffice,illidan,384,demonhunter,havoc,12,4,8
Namthar,quelthalas,384,demonhunter,havoc,12,4,8
Blackclóver,drakkari,384,demonhunter,havoc,12,4,8
Temporarý,bleeding-hollow,384,demonhunter,havoc,12,4,8
Soliit,illidan,384,demonhunter,havoc,12,4,8
Fraxxured,proudmoore,384,demonhunter,havoc,12,4,8
Noliaclap,sargeras,384,demonhunter,havoc,12,4,8
Portgaes,ragnaros,384,demonhunter,havoc,12,4,8
Bazul,tichondrius,384,demonhunter,havoc,12,4,8
Fenthras,thrall,384,demonhunter,havoc,12,4,8
Dystopik,area-52,384,demonhunter,havoc,12,4,8
Anomander,khazgoroth,384,demonhunter,havoc,12,4,8
Uchulu,quelthalas,384,demonhunter,havoc,12,4,8
Dhibjorf,destromath,384,demonhunter,havoc,12,4,8
Zradda,zuljin,384,demonhunter,havoc,12,4,8
Sathsong,tichondrius,384,demonhunter,havoc,12,4,8
Bättousai,kiljaeden,384,demonhunter,havoc,12,4,8
Orsova,area-52,384,demonhunter,havoc,12,4,8
Dhtimes,ragnaros,384,demonhunter,havoc,12,4,8
Kruptikos,tichondrius,384,demonhunter,havoc,12,4,8
Yukimes,frostmourne,384,demonhunter,havoc,12,4,8
Älönë,thrall,384,demonhunter,havoc,12,4,8
Àku,area-52,384,demonhunter,havoc,12,4,8
Dankhuntér,zuljin,384,demonhunter,havoc,12,4,8
Sailtheskys,tichondrius,384,demonhunter,havoc,12,4,8
Alphatoo,area-52,384,demonhunter,havoc,15,4,11
Fuujiin,tol-barad,384,demonhunter,havoc,18,4,14
Roodblurz,zuljin,384,demonhunter,havoc,18,4,14
Severon,stormrage,383,demonhunter,havoc,6,4,2
Demondrëad,lightbringer,383,demonhunter,havoc,9,5,4
Draktyl,bronzebeard,383,demonhunter,havoc,12,4,8
Deathslice,azgalor,383,demonhunter,havoc,12,4,8
Rarespawnjon,tichondrius,383,demonhunter,havoc,12,4,8
Vellinaris,zuljin,383,demonhunter,havoc,12,4,8
Sanllish,illidan,383,demonhunter,havoc,12,4,8
Døffy,area-52,383,demonhunter,havoc,12,4,8
Themurderer,area-52,383,demonhunter,havoc,12,4,8
Sitarok,drakkari,383,demonhunter,havoc,13,4,9
Rouzk,ragnaros,382,demonhunter,havoc,6,4,2
Çherrii,moon-guard,382,demonhunter,havoc,6,4,2
Apaantuh,sargeras,382,demonhunter,havoc,12,4,8
Xiin,cenarion-circle,382,demonhunter,havoc,12,4,8
Saladuoduo,illidan,382,demonhunter,havoc,12,4,8
Anguloke,wyrmrest-accord,381,demonhunter,havoc,10,5,5
Bckzy,sargeras,381,demonhunter,havoc,12,4,8
Killercooter,area-52,381,demonhunter,havoc,12,4,8
Agramun,ragnaros,381,demonhunter,havoc,12,4,8
Polunochnaya,area-52,352,demonhunter,havoc,16,4,12
Findoratoqc,darrowmere,351,demonhunter,havoc,11,4,7
Cassiedemonh,tichondrius,336,demonhunter,havoc,9,5,4
Xiruu,area-52,336,demonhunter,havoc,15,5,10
Unjust,darkspear,336,demonhunter,havoc,15,4,11
Deadlysin,dragonmaw,336,demonhunter,havoc,15,4,11
Cherrycrüsh,sargeras,335,demonhunter,havoc,11,4,7
Fingerjamsx,area-52,335,demonhunter,havoc,11,4,7
Dearborn,frostmourne,330,demonhunter,havoc,16,5,11
Criyn,kelthuzad,330,demonhunter,havoc,17,5,12
Gibbz,wyrmrest-accord,304,demonhunter,havoc,11,5,6
Msbadass,demon-soul,304,demonhunter,havoc,13,4,9
Singueta,stormrage,288,demonhunter,havoc,6,3,3
Fracxures,area-52,288,demonhunter,havoc,6,3,3
Imissher,dalaran,288,demonhunter,havoc,6,3,3
Asukaxox,illidan,288,demonhunter,havoc,6,3,3
Teufelhundn,tichondrius,288,demonhunter,havoc,6,3,3
Thunderrbolt,illidan,288,demonhunter,havoc,6,3,3
Celestez,kelthuzad,288,demonhunter,havoc,6,3,3
Rákdos,illidan,288,demonhunter,havoc,6,3,3
Darkstein,nathrezim,288,demonhunter,havoc,6,3,3
Zurg,wyrmrest-accord,288,demonhunter,havoc,6,3,3
Onedigitiq,thrall,288,demonhunter,havoc,6,3,3
Litan,ragnaros,288,demonhunter,havoc,6,3,3
Gentlesoap,blackrock,288,demonhunter,havoc,6,3,3
Zïlly,blackrock,288,demonhunter,havoc,6,3,3
Kunitsuna,thunderlord,288,demonhunter,havoc,6,3,3
Çreme,tichondrius,288,demonhunter,havoc,6,3,3
Smokepurppx,zuljin,288,demonhunter,havoc,6,3,3
Kylíejennêr,gilneas,288,demonhunter,havoc,6,3,3
Bkeight,dalaran,288,demonhunter,havoc,6,3,3
Relaxnerdss,bleeding-hollow,288,demonhunter,havoc,6,3,3
Vichopan,tichondrius,288,demonhunter,havoc,6,3,3
Shacco,bleeding-hollow,288,demonhunter,havoc,6,3,3
Walk,kul-tiras,288,demonhunter,havoc,6,3,3
Demønical,dalaran,288,demonhunter,havoc,6,3,3
Foodtruck,hellscream,288,demonhunter,havoc,6,3,3
Lyrndrial,wildhammer,288,demonhunter,havoc,6,3,3
Blingtrön,malganis,288,demonhunter,havoc,6,3,3
Businessmaam,malganis,288,demonhunter,havoc,6,3,3
Zeppelìn,stormrage,288,demonhunter,havoc,6,3,3
Cassadega,sargeras,288,demonhunter,havoc,6,3,3
Doomanthree,sargeras,288,demonhunter,havoc,6,3,3
Treyydh,illidan,288,demonhunter,havoc,6,3,3
Felform,area-52,288,demonhunter,havoc,6,3,3
Tink,kilrogg,288,demonhunter,havoc,6,3,3
Mavrii,executus,288,demonhunter,havoc,6,3,3
Âsmodeus,laughing-skull,288,demonhunter,havoc,6,3,3
Walluped,malganis,288,demonhunter,havoc,6,3,3
Pokemibut,frostmourne,288,demonhunter,havoc,6,3,3
Aslowbust,tichondrius,288,demonhunter,havoc,6,3,3
Rhynóe,illidan,288,demonhunter,havoc,6,3,3
Inva,stormrage,288,demonhunter,havoc,6,3,3
Danthedh,illidan,288,demonhunter,havoc,6,3,3
Talsaris,drakthul,288,demonhunter,havoc,6,3,3
Ziyutomioka,moon-guard,288,demonhunter,havoc,6,3,3
Wingsofhavoc,darkspear,288,demonhunter,havoc,6,3,3
Krendron,malganis,288,demonhunter,havoc,6,3,3
Arlequhin,ragnaros,288,demonhunter,havoc,6,3,3
Adycatt,illidan,288,demonhunter,havoc,6,3,3
Ocão,azralon,288,demonhunter,havoc,6,3,3
Riodh,area-52,288,demonhunter,havoc,6,3,3
Cedicdh,illidan,288,demonhunter,havoc,6,3,3
Mèrlyn,sargeras,288,demonhunter,havoc,6,3,3
Gnatman,skywall,288,demonhunter,havoc,6,3,3
Kamakhasi,bleeding-hollow,288,demonhunter,havoc,6,3,3
Illipo,illidan,288,demonhunter,havoc,6,3,3
Llivid,area-52,288,demonhunter,havoc,6,3,3
Gilarian,stormrage,288,demonhunter,havoc,6,3,3
Slodeath,zuljin,288,demonhunter,havoc,6,3,3
Namiisann,terenas,288,demonhunter,havoc,6,3,3
Sourlime,stormrage,288,demonhunter,havoc,6,3,3
Smallsuper,azralon,288,demonhunter,havoc,6,3,3
Yogo,tichondrius,288,demonhunter,havoc,6,3,3
Elgreezy,sargeras,288,demonhunter,havoc,6,3,3
Feltini,whisperwind,288,demonhunter,havoc,6,3,3
Sofedon,kargath,288,demonhunter,havoc,6,3,3
Velerolas,area-52,288,demonhunter,havoc,6,3,3
Sxzure,frostmourne,288,demonhunter,havoc,6,3,3
Songtwo,frostmourne,288,demonhunter,havoc,6,3,3
Touched,guldan,288,demonhunter,havoc,6,3,3
Zalenn,whisperwind,288,demonhunter,havoc,6,3,3
Pub,the-scryers,288,demonhunter,havoc,6,3,3
Rauwèrs,azralon,288,demonhunter,havoc,6,3,3
Kawaiiakitty,tichondrius,288,demonhunter,havoc,6,3,3
Claudija,frostmourne,288,demonhunter,havoc,6,3,3
Dettlaff,sentinels,288,demonhunter,havoc,6,3,3
Noóve,area-52,288,demonhunter,havoc,6,3,3
Blurnomnom,bleeding-hollow,288,demonhunter,havoc,6,3,3
Totheglaive,sargeras,288,demonhunter,havoc,6,3,3
Dhameer,tichondrius,288,demonhunter,havoc,6,3,3
Darkterrôr,sargeras,288,demonhunter,havoc,9,4,5
Asamir,ragnaros,288,demonhunter,havoc,7,3,4
Dhuck,nemesis,288,demonhunter,havoc,15,4,11
Icanmove,area-52,288,demonhunter,havoc,12,3,9
Denadiirx,area-52,288,demonhunter,havoc,12,3,9
Dmfeetpics,dalaran,288,demonhunter,havoc,12,3,9
Dirtyd,dragonmaw,288,demonhunter,havoc,12,3,9
Azziria,aerie-peak,288,demonhunter,havoc,12,3,9
Abrams,tichondrius,288,demonhunter,havoc,12,3,9
Demonichoov,thrall,288,demonhunter,havoc,12,3,9
Gumeasy,tichondrius,288,demonhunter,havoc,12,3,9
Felsa,wyrmrest-accord,288,demonhunter,havoc,12,3,9
Mirante,illidan,288,demonhunter,havoc,12,3,9
Atriax,kelthuzad,288,demonhunter,havoc,12,3,9
Kraky,nemesis,288,demonhunter,havoc,12,3,9
Lawimmortal,tichondrius,288,demonhunter,havoc,12,3,9
Elflerri,area-52,288,demonhunter,havoc,12,3,9
Zudo,amanthul,288,demonhunter,havoc,12,3,9
Çløûdïx,tichondrius,288,demonhunter,havoc,12,3,9
Fleetop,tichondrius,288,demonhunter,havoc,12,3,9
Hemmerdainz,kelthuzad,288,demonhunter,havoc,12,3,9
Skrimpi,dalaran,288,demonhunter,havoc,12,3,9
Ðemonix,tichondrius,288,demonhunter,havoc,12,3,9
Wotlkdh,area-52,288,demonhunter,havoc,12,3,9
Trekt,blades-edge,288,demonhunter,havoc,12,3,9
Rasgon,azralon,288,demonhunter,havoc,12,3,9
Occula,moon-guard,288,demonhunter,havoc,12,3,9
Sammblorqt,illidan,288,demonhunter,havoc,18,3,15
Vellassa,stormscale,288,demonhunter,havoc,18,3,15
Lavantora,tichondrius,288,demonhunter,havoc,23,3,20
Pimm,kelthuzad,287,demonhunter,havoc,6,3,3
Eggandpotato,saurfang,287,demonhunter,havoc,6,3,3
Haydet,stormrage,287,demonhunter,havoc,6,3,3
Holescrewer,tichondrius,287,demonhunter,havoc,6,3,3
Devilina,khadgar,287,demonhunter,havoc,6,3,3
Amneshia,ragnaros,287,demonhunter,havoc,6,3,3
Magoroth,ragnaros,287,demonhunter,havoc,6,3,3
Slixxk,sargeras,287,demonhunter,havoc,9,4,5
Cheriste,malganis,287,demonhunter,havoc,14,4,10
Villoria,kul-tiras,287,demonhunter,havoc,12,3,9
Mindburn,shadowmoon,286,demonhunter,havoc,6,3,3
Lsnusnul,illidan,286,demonhunter,havoc,6,3,3
Psythe,undermine,286,demonhunter,havoc,12,3,9
Dannaris,maelstrom,285,demonhunter,havoc,12,3,9
Pekkora,illidan,284,demonhunter,havoc,12,3,9
Nikator,emerald-dream,255,demonhunter,havoc,11,3,8
Elrr,drakkari,255,demonhunter,havoc,11,3,8
Juantty,area-52,240,demonhunter,havoc,15,3,12
Vickyvette,illidan,239,demonhunter,havoc,5,3,2
Kryzthed,drakkari,233,demonhunter,havoc,13,4,9
Bushwacker,azralon,223,demonhunter,havoc,8,3,5
Onihunter,zangarmarsh,208,demonhunter,havoc,7,3,4
Cobra,quelthalas,208,demonhunter,havoc,7,3,4
Critxclutch,tichondrius,192,demonhunter,havoc,4,3,1
Syrendris,moon-guard,192,demonhunter,havoc,8,3,5
Thedhdream,frostmourne,192,demonhunter,havoc,9,3,6
Rykko,borean-tundra,192,demonhunter,havoc,6,2,4
Shadynãsty,drakthul,192,demonhunter,havoc,6,2,4
Ýizl,ragnaros,192,demonhunter,havoc,6,2,4
Dirtydone,area-52,192,demonhunter,havoc,6,2,4
Ausä,ragnaros,192,demonhunter,havoc,6,2,4
Lilyanie,stormrage,192,demonhunter,havoc,6,2,4
Renoshan,wyrmrest-accord,192,demonhunter,havoc,6,2,4
Ratcnt,barthilas,192,demonhunter,havoc,6,2,4
String,tanaris,192,demonhunter,havoc,6,2,4
Mitsûri,quelthalas,192,demonhunter,havoc,6,2,4
Berquondh,tichondrius,192,demonhunter,havoc,6,2,4
Freddiedread,bladefist,192,demonhunter,havoc,6,2,4
Wartornx,tichondrius,192,demonhunter,havoc,6,2,4
Swagidan,khaz-modan,192,demonhunter,havoc,6,2,4
Renatha,ragnaros,192,demonhunter,havoc,6,2,4
Azshada,shadowmoon,192,demonhunter,havoc,6,2,4
Heptabase,tichondrius,192,demonhunter,havoc,6,2,4
Causinghavoc,dalaran,192,demonhunter,havoc,6,2,4
Cocopapa,tichondrius,192,demonhunter,havoc,6,2,4
Arkynth,dalaran,192,demonhunter,havoc,6,2,4
Sparklepunch,stormrage,192,demonhunter,havoc,6,2,4
Krador,wyrmrest-accord,192,demonhunter,havoc,6,2,4
Muerdun,tichondrius,192,demonhunter,havoc,6,2,4
Atomicsorrow,tichondrius,192,demonhunter,havoc,6,2,4
Trystenn,nagrand,192,demonhunter,havoc,6,2,4
Ivexia,blackrock,192,demonhunter,havoc,6,2,4
Nhoxell,ragnaros,192,demonhunter,havoc,6,2,4
Subsfordubs,illidan,192,demonhunter,havoc,6,2,4
Illimare,tichondrius,192,demonhunter,havoc,6,2,4
Zusi,frostmane,192,demonhunter,havoc,6,2,4
Zarraessa,trollbane,192,demonhunter,havoc,6,2,4
Annmílls,quelthalas,192,demonhunter,havoc,6,2,4
Falan,drakthul,192,demonhunter,havoc,6,2,4
Demonslayyer,saurfang,192,demonhunter,havoc,6,2,4
Cirillas,illidan,192,demonhunter,havoc,6,2,4
Gopump,area-52,192,demonhunter,havoc,6,2,4
Lookatdishoe,tichondrius,192,demonhunter,havoc,6,2,4
Mäläk,zuluhed,192,demonhunter,havoc,6,2,4
Atsudadh,illidan,192,demonhunter,havoc,6,2,4
Metha,kiljaeden,192,demonhunter,havoc,6,2,4
Xannaa,illidan,192,demonhunter,havoc,6,2,4
Kezzaku,frostmourne,192,demonhunter,havoc,6,2,4
Jadyne,frostmourne,192,demonhunter,havoc,6,2,4
Demonwaffle,draka,192,demonhunter,havoc,6,2,4
Demonchild,azralon,192,demonhunter,havoc,6,2,4
Frøppy,illidan,192,demonhunter,havoc,6,2,4
Bleaster,malganis,192,demonhunter,havoc,6,2,4
Sero,malganis,192,demonhunter,havoc,6,2,4
Kayanson,azralon,192,demonhunter,havoc,6,2,4
Cordianx,area-52,192,demonhunter,havoc,6,2,4
Carlibeth,illidan,192,demonhunter,havoc,6,2,4
Showaitie,thrall,192,demonhunter,havoc,6,2,4
Øxxy,azralon,192,demonhunter,havoc,6,2,4
Ossariss,moon-guard,192,demonhunter,havoc,6,2,4
Lovedem,area-52,192,demonhunter,havoc,6,2,4
Reflexin,tichondrius,192,demonhunter,havoc,6,2,4
Daabsdh,thrall,192,demonhunter,havoc,6,2,4
Lilvetis,thrall,192,demonhunter,havoc,6,2,4
Illdaira,windrunner,192,demonhunter,havoc,6,2,4
Kraazi,thrall,192,demonhunter,havoc,6,2,4
Sarithos,frostmourne,192,demonhunter,havoc,6,2,4
Sephmilli,azralon,192,demonhunter,havoc,6,2,4
Xanthrodril,illidan,192,demonhunter,havoc,6,2,4
Wowomg,tichondrius,192,demonhunter,havoc,6,2,4
Spikehed,area-52,192,demonhunter,havoc,6,2,4
Sodí,moon-guard,192,demonhunter,havoc,6,2,4
Illidanmello,proudmoore,192,demonhunter,havoc,6,2,4
Devilweef,whisperwind,192,demonhunter,havoc,6,2,4
Daso,the-forgotten-coast,192,demonhunter,havoc,6,2,4
Ambitiòn,moon-guard,192,demonhunter,havoc,6,2,4
Frino,steamwheedle-cartel,192,demonhunter,havoc,6,2,4
Moxy,kaelthas,192,demonhunter,havoc,6,2,4
Discos,frostmourne,192,demonhunter,havoc,6,2,4
Lillidanss,the-forgotten-coast,192,demonhunter,havoc,6,2,4
Gyutaro,frostmourne,192,demonhunter,havoc,6,2,4
Rkakda,thunderlord,192,demonhunter,havoc,6,2,4
Blynx,destromath,192,demonhunter,havoc,6,2,4
Azuki,lightbringer,192,demonhunter,havoc,6,2,4
Hellishunter,illidan,192,demonhunter,havoc,6,2,4
Yhell,darkspear,192,demonhunter,havoc,6,2,4
Slaymore,sargeras,192,demonhunter,havoc,6,2,4
Imagoon,sargeras,192,demonhunter,havoc,6,2,4
Trackamp,emerald-dream,192,demonhunter,havoc,6,2,4
Elaurenne,sargeras,192,demonhunter,havoc,6,2,4
Arandë,earthen-ring,192,demonhunter,havoc,6,2,4
Bastaghor,stormrage,192,demonhunter,havoc,6,2,4
Cryolite,sargeras,192,demonhunter,havoc,6,2,4
Thesituatíon,sargeras,192,demonhunter,havoc,6,2,4
Logixdh,tichondrius,192,demonhunter,havoc,6,2,4
Zethh,drakkari,192,demonhunter,havoc,6,2,4
Badservice,frostwolf,192,demonhunter,havoc,6,2,4
Aleta,firetree,192,demonhunter,havoc,6,2,4
Skol,andorhal,192,demonhunter,havoc,6,2,4
Daracu,aerie-peak,192,demonhunter,havoc,6,2,4
Jozeez,emerald-dream,192,demonhunter,havoc,6,2,4
Ragath,bonechewer,192,demonhunter,havoc,6,2,4
Buhnana,stormscale,192,demonhunter,havoc,6,2,4
Wreckforce,blades-edge,192,demonhunter,havoc,6,2,4
Texts,norgannon,192,demonhunter,havoc,6,2,4
Rrochy,tichondrius,192,demonhunter,havoc,6,2,4
Hoagiedevil,moon-guard,192,demonhunter,havoc,6,2,4
Vellestia,argent-dawn,192,demonhunter,havoc,6,2,4
Morgoph,burning-legion,192,demonhunter,havoc,6,2,4
Onigirix,area-52,192,demonhunter,havoc,6,2,4
Zeldris,duskwood,192,demonhunter,havoc,6,2,4
Qlmm,stormrage,192,demonhunter,havoc,7,2,5
Hávok,sargeras,192,demonhunter,havoc,7,2,5
Tiristra,cenarion-circle,192,demonhunter,havoc,8,2,6
Daeth,skullcrusher,192,demonhunter,havoc,12,2,10
Denel,laughing-skull,192,demonhunter,havoc,12,2,10
Gyop,azralon,192,demonhunter,havoc,12,2,10
Pokoloko,twisting-nether,192,demonhunter,havoc,12,2,10
Catastroz,ragnaros,192,demonhunter,havoc,12,2,10
Beastforlife,sargeras,192,demonhunter,havoc,12,2,10
Âduka,illidan,192,demonhunter,havoc,12,2,10
Kyska,tichondrius,192,demonhunter,havoc,12,2,10
Melantharia,wyrmrest-accord,192,demonhunter,havoc,12,2,10
Halaena,moon-guard,192,demonhunter,havoc,12,2,10
Kushz,dalaran,192,demonhunter,havoc,12,2,10
Hollownight,area-52,192,demonhunter,havoc,12,2,10
Illidunk,tichondrius,192,demonhunter,havoc,12,2,10
Boofdh,illidan,192,demonhunter,havoc,12,2,10
Proserpinâ,bleeding-hollow,192,demonhunter,havoc,12,2,10
Spacéphoenix,stormrage,192,demonhunter,havoc,12,2,10
Asharian,wyrmrest-accord,192,demonhunter,havoc,12,2,10
Funspunk,nagrand,192,demonhunter,havoc,18,2,16
Teethdaggers,wyrmrest-accord,191,demonhunter,havoc,6,2,4
Tarasam,burning-blade,191,demonhunter,havoc,12,2,10
Feilixx,moon-guard,190,demonhunter,havoc,12,2,10
Ryoga,malganis,159,demonhunter,havoc,5,2,3
Theweektwo,drakkari,159,demonhunter,havoc,11,2,9
Refused,nesingwary,138,demonhunter,havoc,11,4,7
Criolex,stormrage,138,demonhunter,havoc,9,3,6
Shanjara,sargeras,138,demonhunter,havoc,15,3,12
Xeil,zuljin,128,demonhunter,havoc,4,2,2
Zanecksbinge,skullcrusher,128,demonhunter,havoc,4,2,2
Kümï,quelthalas,96,demonhunter,havoc,3,2,1
Tättø,area-52,96,demonhunter,havoc,3,2,1
Litball,stormrage,96,demonhunter,havoc,3,2,1
Giantryhard,tichondrius,96,demonhunter,havoc,6,1,5
Eibizoudh,sargeras,96,demonhunter,havoc,6,1,5
Constantwood,sargeras,96,demonhunter,havoc,6,1,5
Mythundorn,burning-blade,96,demonhunter,havoc,6,1,5
Musewine,tichondrius,96,demonhunter,havoc,6,1,5
Vëngêåncé,tichondrius,96,demonhunter,havoc,6,1,5
Chirøn,darkspear,96,demonhunter,havoc,6,1,5
Negraxo,ragnaros,96,demonhunter,havoc,6,1,5
Jerry,emerald-dream,96,demonhunter,havoc,6,1,5
Theysuffer,scilla,96,demonhunter,havoc,6,1,5
Wubloadz,bleeding-hollow,96,demonhunter,havoc,6,1,5
Hausecat,aegwynn,96,demonhunter,havoc,6,1,5
Elillidan,emerald-dream,96,demonhunter,havoc,6,1,5
Terpenese,chogall,96,demonhunter,havoc,6,1,5
Marxefel,ragnaros,96,demonhunter,havoc,6,1,5
Frenchtoast,bonechewer,96,demonhunter,havoc,6,1,5
Mazïkeen,uther,96,demonhunter,havoc,6,1,5
Ðemonhunterx,frostmourne,96,demonhunter,havoc,6,1,5
Glaivee,dalaran,96,demonhunter,havoc,6,1,5
Painqtxo,area-52,96,demonhunter,havoc,6,1,5
Jekyldh,tichondrius,96,demonhunter,havoc,6,1,5
Devî,ragnaros,96,demonhunter,havoc,6,1,5
Chris,nordrassil,96,demonhunter,havoc,6,1,5
Scarolol,malganis,96,demonhunter,havoc,6,1,5
Demonleàf,area-52,96,demonhunter,havoc,6,1,5
Lauriale,moon-guard,96,demonhunter,havoc,6,1,5
Gil,moonrunner,96,demonhunter,havoc,6,1,5
Boatsnhoze,tichondrius,96,demonhunter,havoc,6,1,5
Chakan,burning-legion,96,demonhunter,havoc,6,1,5
Itsplague,tichondrius,96,demonhunter,havoc,6,1,5
Chad,anvilmar,96,demonhunter,havoc,6,1,5
Nightsatan,stormrage,96,demonhunter,havoc,6,1,5
Félmoose,moon-guard,96,demonhunter,havoc,6,1,5
Treblig,nerzhul,96,demonhunter,havoc,6,1,5
Izruul,tichondrius,96,demonhunter,havoc,6,1,5
Sado,proudmoore,96,demonhunter,havoc,6,1,5
Esøteric,area-52,96,demonhunter,havoc,6,1,5
Slycerr,illidan,96,demonhunter,havoc,6,1,5
Thêworld,azralon,96,demonhunter,havoc,6,1,5
Snazzyy,kelthuzad,96,demonhunter,havoc,6,1,5
Misakidh,sargeras,96,demonhunter,havoc,6,1,5
Siegfridemon,ragnaros,96,demonhunter,havoc,6,1,5
Sternhunt,khadgar,96,demonhunter,havoc,6,1,5
Safikins,tichondrius,96,demonhunter,havoc,6,1,5
Vaestl,zuljin,96,demonhunter,havoc,6,1,5
Memslaw,tichondrius,96,demonhunter,havoc,6,1,5
Varanidae,kelthuzad,96,demonhunter,havoc,6,1,5
Skylinetime,sargeras,96,demonhunter,havoc,6,1,5
Carrîôn,tichondrius,96,demonhunter,havoc,6,1,5
Reezi,sargeras,96,demonhunter,havoc,6,1,5
Anabolicbro,tichondrius,96,demonhunter,havoc,6,1,5
Akammy,proudmoore,96,demonhunter,havoc,6,1,5
Jhinskui,drakkari,96,demonhunter,havoc,6,1,5
Kazadin,azralon,96,demonhunter,havoc,6,1,5
Finnanutt,tichondrius,96,demonhunter,havoc,6,1,5
Majindemon,dragonmaw,96,demonhunter,havoc,6,1,5
Cidolem,area-52,96,demonhunter,havoc,6,1,5
Ellguindh,malganis,96,demonhunter,havoc,6,1,5
Roat,malganis,96,demonhunter,havoc,6,1,5
Demønvil,onyxia,96,demonhunter,havoc,6,1,5
Dhrongor,drakkari,96,demonhunter,havoc,6,1,5
Gosrend,durotan,96,demonhunter,havoc,7,1,6
Lantherin,sargeras,96,demonhunter,havoc,11,1,10
Moonsocks,proudmoore,96,demonhunter,havoc,12,1,11
Gnocchis,thrall,96,demonhunter,havoc,12,1,11
Ichigoo,arthas,96,demonhunter,havoc,12,1,11
Aríes,dreadmaul,94,demonhunter,havoc,4,3,1
Vespherie,moon-guard,84,demonhunter,havoc,8,5,3
Byzzel,barthilas,79,demonhunter,havoc,5,1,4
Miskiiv,malganis,79,demonhunter,havoc,5,1,4
Fellchapo,illidan,79,demonhunter,havoc,5,1,4
Zetsuwaffles,area-52,79,demonhunter,havoc,5,1,4
Demonbluntzz,tichondrius,79,demonhunter,havoc,11,1,10
Shadevon,wyrmrest-accord,64,demonhunter,havoc,4,1,3
Mcthiccyy,moon-guard,64,demonhunter,havoc,4,1,3
Elena,the-underbog,64,demonhunter,havoc,4,1,3
Quinny,runetotem,48,demonhunter,havoc,3,1,2
Quoates,dalaran,48,demonhunter,havoc,3,1,2
Aryía,stormrage,48,demonhunter,havoc,3,1,2
Lifefery,quelthalas,48,demonhunter,havoc,3,1,2
Raptorjèsus,azjolnerub,48,demonhunter,havoc,3,1,2
Jizzidari,frostmourne,48,demonhunter,havoc,3,1,2
Healinfubar,stormrage,47,demonhunter,havoc,3,2,1
Xaryic,stormrage,42,demonhunter,havoc,16,5,11
Worcraf,ragnaros,42,demonhunter,havoc,8,2,6
Pooterjuice,shadowmoon,31,demonhunter,havoc,2,1,1
Lathazar,darkspear,16,demonhunter,havoc,1,1,0
Iwasright,stonemaul,1488,demonhunter,vengeance,72,35,37
Slippedinfel,tichondrius,1335,demonhunter,vengeance,47,22,25
Jersey,proudmoore,1091,demonhunter,vengeance,29,17,12
Nights,greymane,566,demonhunter,vengeance,12,6,6
Agricornia,tichondrius,475,demonhunter,vengeance,12,5,7
Irisand,ragnaros,288,demonhunter,vengeance,6,3,3
Ferano,frostmourne,288,demonhunter,vengeance,6,3,3
Çherrii,moon-guard,286,demonhunter,vengeance,6,3,3
Tilltheend,illidan,239,demonhunter,vengeance,5,3,2
Asderel,zuljin,192,demonhunter,vengeance,6,2,4
Meliødaz,ragnaros,192,demonhunter,vengeance,12,2,10
Shiningvenus,stormrage,192,demonhunter,vengeance,12,2,10
Daymanhunter,bleeding-hollow,96,demonhunter,vengeance,6,1,5
Aleymar,tichondrius,96,demonhunter,vengeance,6,1,5
Foodtruck,hellscream,96,demonhunter,vengeance,6,1,5
Grovetenderx,tichondrius,2238,druid,restoration,86,53,33
Flóp,dalaran,2238,druid,restoration,90,53,37
Renner,zuljin,2192,druid,restoration,109,57,52
Kobaishome,tichondrius,2148,druid,restoration,119,70,49
Linful,tichondrius,2141,druid,restoration,179,92,87
Omkin,tichondrius,2137,druid,restoration,120,62,58
Angrygochux,tichondrius,2132,druid,restoration,148,79,69
Liangpibro,illidan,2123,druid,restoration,85,54,31
Bestrun,tichondrius,2116,druid,restoration,108,58,50
Szwlol,tichondrius,2105,druid,restoration,315,170,145
Andrwceo,stormrage,2104,druid,restoration,60,37,23
Couragé,ragnaros,2098,druid,restoration,147,73,74
Davidqx,zuljin,2060,druid,restoration,72,47,25
Gotheelsx,illidan,2056,druid,restoration,137,67,70
Commercii,tichondrius,2043,druid,restoration,72,42,30
Vers,dathremar,2037,druid,restoration,90,43,47
Shaylyne,moonrunner,2026,druid,restoration,69,41,28
Dannycarry,tichondrius,2025,druid,restoration,59,32,27
Racialmotive,illidan,2017,druid,restoration,134,76,58
Rorae,tichondrius,2000,druid,restoration,167,85,82
Hchls,tichondrius,1996,druid,restoration,152,77,75
Taiwanzz,tichondrius,1994,druid,restoration,79,40,39
Taaienberg,sargeras,1991,druid,restoration,66,34,32
Sanlunainiu,tichondrius,1976,druid,restoration,178,82,96
Brenden,area-52,1958,druid,restoration,150,76,74
Rbavny,tichondrius,1954,druid,restoration,42,25,17
Pornkkimi,tichondrius,1952,druid,restoration,48,29,19
Plorenz,zuljin,1952,druid,restoration,89,51,38
Mengniulol,tichondrius,1947,druid,restoration,179,100,79
Flowen,spinebreaker,1940,druid,restoration,78,39,39
Tizzyy,eredar,1921,druid,restoration,78,43,35
Gotheels,illidan,1910,druid,restoration,41,29,12
Guqingshuang,tichondrius,1905,druid,restoration,85,43,42
Shiftýx,tichondrius,1905,druid,restoration,77,38,39
Sanitizer,tichondrius,1902,druid,restoration,66,38,28
Dancesdru,area-52,1888,druid,restoration,36,20,16
Treenleaves,stormrage,1888,druid,restoration,493,260,233
Saxhouse,illidan,1881,druid,restoration,60,34,26
Nikdruidne,tichondrius,1881,druid,restoration,60,29,31
Darkenëd,dalaran,1880,druid,restoration,68,41,27
Aryawilliams,area-52,1880,druid,restoration,65,36,29
Lenya,bleeding-hollow,1877,druid,restoration,69,38,31
Eddí,illidan,1872,druid,restoration,64,32,32
Bashthecat,tichondrius,1871,druid,restoration,59,39,20
Xijinfing,tichondrius,1870,druid,restoration,42,25,17
Rindy,rexxar,1869,druid,restoration,72,37,35
Ksz,stormrage,1867,druid,restoration,42,25,17
Holydruid,tichondrius,1867,druid,restoration,83,43,40
Represent,tichondrius,1864,druid,restoration,48,26,22
Lotiononmyd,illidan,1860,druid,restoration,153,85,68
Héisénbérg,sargeras,1857,druid,restoration,117,65,52
Corbind,arthas,1853,druid,restoration,250,132,118
Oinkme,kiljaeden,1853,druid,restoration,78,38,40
Druuná,kiljaeden,1852,druid,restoration,81,37,44
Bexdru,area-52,1850,druid,restoration,284,151,133
Psam,emerald-dream,1848,druid,restoration,53,29,24
Lvse,tichondrius,1847,druid,restoration,54,34,20
Rèmix,bleeding-hollow,1847,druid,restoration,42,23,19
Qdeb,akama,1844,druid,restoration,48,27,21
Vesoween,tichondrius,1843,druid,restoration,55,37,18
Creamcow,tichondrius,1843,druid,restoration,52,28,24
Esque,stormrage,1842,druid,restoration,48,24,24
Tokesh,malganis,1840,druid,restoration,72,33,39
Washedgodx,mugthol,1839,druid,restoration,59,34,25
Mimidelol,tichondrius,1839,druid,restoration,66,36,30
Clameo,barthilas,1839,druid,restoration,102,48,54
Gluesmoka,icecrown,1836,druid,restoration,54,31,23
Reehz,stormrage,1834,druid,restoration,53,25,28
Leafowl,tichondrius,1830,druid,restoration,42,25,17
Bodytwisting,tichondrius,1828,druid,restoration,48,29,19
Pvpgold,illidan,1827,druid,restoration,71,39,32
Rerolldr,firetree,1826,druid,restoration,42,24,18
Germlol,sargeras,1825,druid,restoration,51,30,21
Heymeow,tichondrius,1825,druid,restoration,60,24,36
Brendenjr,area-52,1819,druid,restoration,45,32,13
Jegara,auchindoun,1818,druid,restoration,149,81,68
Badtree,tichondrius,1816,druid,restoration,104,63,41
Currants,lightbringer,1815,druid,restoration,138,64,74
Jbdontplay,sargeras,1812,druid,restoration,59,37,22
Tunnaris,ragnaros,1811,druid,restoration,71,33,38
Kenái,nemesis,1810,druid,restoration,30,19,11
Hlchs,tichondrius,1810,druid,restoration,36,22,14
Corcovado,bleeding-hollow,1809,druid,restoration,66,31,35
Udoyu,barthilas,1807,druid,restoration,66,28,38
Aljalladtv,bleeding-hollow,1805,druid,restoration,30,19,11
Yggdrasil,ravencrest,1805,druid,restoration,65,31,34
Kayorva,gurubashi,1804,druid,restoration,47,24,23
Playstyle,stormrage,1801,druid,restoration,49,25,24
Nayko,sargeras,1801,druid,restoration,72,30,42
Ivý,shadowsong,1800,druid,restoration,41,28,13
Mengyu,tichondrius,1800,druid,restoration,64,41,23
Kobrah,twisting-nether,1800,druid,restoration,36,20,16
Blueclàssxx,akama,1796,druid,restoration,52,41,11
Reizzy,sargeras,1793,druid,restoration,72,35,37
Loudswords,barthilas,1784,druid,restoration,54,29,25
Softpawz,kelthuzad,1782,druid,restoration,35,19,16
Ekr,tichondrius,1779,druid,restoration,54,29,25
Jdown,dalaran,1772,druid,restoration,76,43,33
Maen,kelthuzad,1771,druid,restoration,70,32,38
Geddoff,stormrage,1770,druid,restoration,111,51,60
Kruisberg,sargeras,1769,druid,restoration,29,19,10
Sùlyvahn,tichondrius,1761,druid,restoration,57,30,27
Tweeguy,malganis,1761,druid,restoration,78,33,45
Dsheeps,tichondrius,1760,druid,restoration,48,27,21
Gsex,nemesis,1760,druid,restoration,40,22,18
Moldragon,crushridge,1758,druid,restoration,48,24,24
Gloomster,tichondrius,1756,druid,restoration,64,37,27
Facegotrake,stormrage,1748,druid,restoration,78,47,31
Naturae,spirestone,1742,druid,restoration,188,103,85
Caipirinha,tichondrius,1742,druid,restoration,35,19,16
Surefacts,dathremar,1738,druid,restoration,40,21,19
Branchmanagr,dark-iron,1736,druid,restoration,54,23,31
Janzak,thrall,1735,druid,restoration,36,20,16
Airmeodaddy,barthilas,1730,druid,restoration,44,24,20
Fattdiabetic,tichondrius,1726,druid,restoration,42,24,18
Xgodhands,sargeras,1724,druid,restoration,24,18,6
Anaps,frostmourne,1724,druid,restoration,60,35,25
Spiritot,tichondrius,1724,druid,restoration,42,22,20
Thasta,blackrock,1723,druid,restoration,116,62,54
Thundercast,quelthalas,1720,druid,restoration,128,66,62
Zrobloom,stormrage,1720,druid,restoration,69,29,40
Dirtdog,uther,1719,druid,restoration,53,25,28
Bigtimers,illidan,1717,druid,restoration,36,18,18
Ymy,tichondrius,1716,druid,restoration,36,21,15
Soreze,kelthuzad,1714,druid,restoration,44,28,16
Kwd,stormrage,1712,druid,restoration,65,43,22
Fruitberry,malganis,1710,druid,restoration,42,18,24
Drjelly,tichondrius,1707,druid,restoration,76,32,44
Huaxià,tichondrius,1705,druid,restoration,209,114,95
Yungdoinkski,icecrown,1704,druid,restoration,28,19,9
Hideurkidz,tichondrius,1699,druid,restoration,39,23,16
Pizzatimex,zuluhed,1698,druid,restoration,72,38,34
Flowdruid,tichondrius,1698,druid,restoration,45,22,23
Dmxx,kiljaeden,1696,druid,restoration,33,19,14
Remus,hydraxis,1696,druid,restoration,48,23,25
Gankstanerdz,tichondrius,1694,druid,restoration,148,68,80
Socialyst,area-52,1688,druid,restoration,35,21,14
Lifeboomer,ragnaros,1684,druid,restoration,61,41,20
Polyester,frostmourne,1679,druid,restoration,54,25,29
Dabloleu,illidan,1675,druid,restoration,24,19,5
Roen,tichondrius,1672,druid,restoration,40,21,19
Boonsogan,tichondrius,1672,druid,restoration,36,18,18
Afkhottedyou,suramar,1667,druid,restoration,46,24,22
Ellystarry,stormrage,1666,druid,restoration,48,24,24
Bobd,proudmoore,1664,druid,restoration,36,19,17
Legitonedge,zuljin,1662,druid,restoration,55,30,25
Addiedru,zuljin,1659,druid,restoration,63,30,33
Bramii,illidan,1657,druid,restoration,51,28,23
Zoteqt,kelthuzad,1657,druid,restoration,48,25,23
Cienza,proudmoore,1651,druid,restoration,192,98,94
Druidstin,tichondrius,1649,druid,restoration,162,84,78
Defteras,illidan,1647,druid,restoration,42,21,21
Sooey,wyrmrest-accord,1646,druid,restoration,79,46,33
Animalge,sargeras,1643,druid,restoration,60,25,35
Woshiyigede,frostmourne,1642,druid,restoration,66,29,37
Dendrix,area-52,1641,druid,restoration,90,46,44
Gsëx,nemesis,1640,druid,restoration,47,22,25
Images,kilrogg,1638,druid,restoration,54,37,17
Birdfromtree,dalaran,1636,druid,restoration,48,26,22
Pootyleaf,daggerspine,1636,druid,restoration,60,28,32
Zblmystic,tichondrius,1635,druid,restoration,60,33,27
Légz,area-52,1634,druid,restoration,94,49,45
Luckyslot,frostmourne,1631,druid,restoration,36,21,15
Widescreen,burning-blade,1630,druid,restoration,318,168,150
Dexlol,area-52,1629,druid,restoration,18,17,1
Pawsbutton,stormrage,1629,druid,restoration,30,20,10
Viscentdd,illidan,1626,druid,restoration,36,17,19
Acdru,tichondrius,1624,druid,restoration,54,26,28
Sarrati,emerald-dream,1623,druid,restoration,182,98,84
Wolfis,malganis,1622,druid,restoration,36,20,16
Notpodruida,tichondrius,1621,druid,restoration,36,21,15
Cybeé,sargeras,1621,druid,restoration,48,19,29
Chevy,onyxia,1619,druid,restoration,66,23,43
Lobsterdruid,area-52,1617,druid,restoration,36,21,15
Kaperij,sargeras,1617,druid,restoration,30,17,13
Asmitar,illidan,1616,druid,restoration,36,22,14
Muhu,frostmourne,1615,druid,restoration,60,35,25
Shinjis,tichondrius,1615,druid,restoration,36,18,18
Gødriç,tichondrius,1614,druid,restoration,221,112,109
Gulperberg,sargeras,1612,druid,restoration,30,25,5
Hxm,tichondrius,1611,druid,restoration,35,17,18
Hideurchickn,tichondrius,1609,druid,restoration,36,23,13
Douwantoplay,tichondrius,1607,druid,restoration,60,32,28
Fhiziod,kelthuzad,1606,druid,restoration,74,44,30
Wìms,malganis,1606,druid,restoration,36,20,16
Tayriel,area-52,1606,druid,restoration,42,19,23
Jathy,area-52,1606,druid,restoration,51,21,30
Kurrious,frostmourne,1605,druid,restoration,40,18,22
Yavannita,quelthalas,1600,druid,restoration,57,36,21
Hehaw,kelthuzad,1600,druid,restoration,152,87,65
Manycyclones,zuluhed,1598,druid,restoration,60,32,28
Relbedo,sargeras,1598,druid,restoration,138,73,65
Gonimydear,proudmoore,1598,druid,restoration,138,70,68
Erral,malganis,1597,druid,restoration,57,26,31
Kaleaky,thrall,1595,druid,restoration,99,53,46
Tondrai,malganis,1593,druid,restoration,30,17,13
Sixthsex,tichondrius,1593,druid,restoration,83,43,40
Errane,eonar,1587,druid,restoration,193,107,86
Cheddy,tichondrius,1585,druid,restoration,71,38,33
Dbk,suramar,1584,druid,restoration,146,88,58
Poscow,tichondrius,1583,druid,restoration,45,25,20
Durintor,nemesis,1582,druid,restoration,129,67,62
Silentbeer,frostmourne,1581,druid,restoration,168,86,82
Druinin,archimonde,1581,druid,restoration,74,32,42
Aberdare,tichondrius,1574,druid,restoration,123,71,52
Boomtastik,frostmourne,1574,druid,restoration,108,46,62
Methyld,frostmourne,1574,druid,restoration,90,36,54
Møøncry,ragnaros,1571,druid,restoration,154,73,81
Bitsandbobs,tichondrius,1570,druid,restoration,47,19,28
Nerfthedruid,blackrock,1569,druid,restoration,36,25,11
Rizzit,wyrmrest-accord,1568,druid,restoration,173,97,76
Duragx,bleeding-hollow,1567,druid,restoration,100,62,38
Arwëna,tichondrius,1566,druid,restoration,60,34,26
Sanninx,barthilas,1566,druid,restoration,36,18,18
Frydaze,tichondrius,1564,druid,restoration,42,21,21
Breaksilence,tichondrius,1563,druid,restoration,29,18,11
Èmax,barthilas,1560,druid,restoration,31,19,12
Classydruid,spinebreaker,1560,druid,restoration,205,109,96
Riiccflaiir,stormrage,1559,druid,restoration,56,32,24
Zyzzema,frostmourne,1559,druid,restoration,174,82,92
Druxe,zuljin,1555,druid,restoration,85,38,47
Poscod,tichondrius,1552,druid,restoration,48,22,26
Hayase,tichondrius,1551,druid,restoration,42,25,17
Maplêleaf,moon-guard,1551,druid,restoration,163,89,74
Gunnymad,tichondrius,1549,druid,restoration,36,21,15
Psyqobloom,dalaran,1548,druid,restoration,82,45,37
Zyhsul,emerald-dream,1546,druid,restoration,137,65,72
Bedlam,zuljin,1544,druid,restoration,60,25,35
Meruemoo,tichondrius,1543,druid,restoration,362,183,179
Moonyy,emerald-dream,1542,druid,restoration,42,20,22
Hdruid,tichondrius,1540,druid,restoration,77,40,37
Soheezy,illidan,1539,druid,restoration,102,60,42
Lubbeck,stormrage,1538,druid,restoration,98,53,45
Drudma,shadowmoon,1538,druid,restoration,48,23,25
Evokade,dalaran,1534,druid,restoration,42,28,14
Zhn,sargeras,1534,druid,restoration,29,19,10
Hravan,dentarg,1534,druid,restoration,49,26,23
Bigmoran,tichondrius,1534,druid,restoration,36,16,20
Nikotser,dreadmaul,1531,druid,restoration,39,18,21
Qidzerker,arathor,1530,druid,restoration,89,44,45
Shapedance,sargeras,1530,druid,restoration,60,27,33
Creamjr,tichondrius,1528,druid,restoration,30,16,14
Unis,tichondrius,1528,druid,restoration,37,19,18
Rougaroux,andorhal,1527,druid,restoration,54,24,30
Spurzky,emerald-dream,1526,druid,restoration,46,26,20
Pilcosbie,stormrage,1526,druid,restoration,42,21,21
Terkpla,ragnaros,1525,druid,restoration,71,37,34
Mortqt,tichondrius,1524,druid,restoration,96,44,52
Lilbigcow,gnomeregan,1515,druid,restoration,176,77,99
Manzar,illidan,1514,druid,restoration,30,17,13
Ursiiday,sargeras,1507,druid,restoration,60,22,38
Meniscus,arthas,1506,druid,restoration,53,19,34
Seamandeman,sargeras,1504,druid,restoration,90,49,41
Baduret,dalaran,1503,druid,restoration,43,27,16
Kimnim,tichondrius,1500,druid,restoration,106,57,49
Redpigo,tichondrius,1497,druid,restoration,36,18,18
Pëndulum,illidan,1497,druid,restoration,66,29,37
Redo,zuluhed,1496,druid,restoration,30,16,14
Gìtgoodtrash,frostmourne,1494,druid,restoration,76,39,37
Morphiq,tichondrius,1493,druid,restoration,123,63,60
Akeven,illidan,1491,druid,restoration,68,31,37
Poliage,moon-guard,1489,druid,restoration,99,44,55
Rowlex,moon-guard,1483,druid,restoration,22,17,5
Knottywood,muradin,1481,druid,restoration,53,28,25
Stonemonkey,sargeras,1480,druid,restoration,85,38,47
Gizho,dark-iron,1476,druid,restoration,33,19,14
Selling,moon-guard,1476,druid,restoration,60,27,33
Growl,jubeithos,1476,druid,restoration,48,19,29
Rlzdruid,tichondrius,1474,druid,restoration,70,31,39
Lutein,tichondrius,1474,druid,restoration,77,31,46
Dkfm,thrall,1467,druid,restoration,404,207,197
Cndistance,tichondrius,1467,druid,restoration,71,34,37
Bobx,kelthuzad,1467,druid,restoration,66,26,40
Spuncone,frostmourne,1463,druid,restoration,42,24,18
Unpeelable,stormrage,1460,druid,restoration,24,16,8
Volktots,bleeding-hollow,1459,druid,restoration,60,34,26
Elliar,akama,1459,druid,restoration,72,35,37
Staraborn,stormrage,1458,druid,restoration,249,135,114
Rasgabuxoh,azralon,1458,druid,restoration,30,16,14
Utterhots,bleeding-hollow,1457,druid,restoration,146,81,65
Xhoz,tichondrius,1457,druid,restoration,201,109,92
Faramar,sargeras,1456,druid,restoration,35,16,19
Berzz,frostmourne,1455,druid,restoration,217,105,112
Cutely,tichondrius,1452,druid,restoration,153,77,76
Verkara,stormrage,1452,druid,restoration,76,35,41
Meepø,mugthol,1451,druid,restoration,103,56,47
Busanmilk,tichondrius,1445,druid,restoration,60,29,31
Rikishi,executus,1441,druid,restoration,52,27,25
Clubroot,sargeras,1437,druid,restoration,42,17,25
Drøgbä,tichondrius,1436,druid,restoration,24,15,9
Aiyouyou,tichondrius,1436,druid,restoration,159,85,74
Lusam,korialstrasz,1435,druid,restoration,40,23,17
Jonnygg,illidan,1433,druid,restoration,36,15,21
Vuru,azralon,1432,druid,restoration,72,33,39
Eviltwín,frostmourne,1431,druid,restoration,36,20,16
Swiftydel,frostmourne,1431,druid,restoration,52,27,25
Sakpase,area-52,1428,druid,restoration,30,15,15
Grimo,illidan,1427,druid,restoration,38,23,15
Thornblade,stormrage,1427,druid,restoration,30,15,15
Strokingmyd,illidan,1427,druid,restoration,63,31,32
Greylyth,moon-guard,1426,druid,restoration,54,25,29
Hyne,emerald-dream,1425,druid,restoration,114,62,52
Bruujz,moon-guard,1424,druid,restoration,54,33,21
Shirô,bleeding-hollow,1421,druid,restoration,115,59,56
Skêet,tichondrius,1420,druid,restoration,37,24,13
Prevail,nazgrel,1420,druid,restoration,127,66,61
Lauramavra,azralon,1419,druid,restoration,273,143,130
Lucked,tichondrius,1415,druid,restoration,24,15,9
Komaner,frostmourne,1414,druid,restoration,48,21,27
Kaerrort,sargeras,1412,druid,restoration,26,15,11
Approx,tichondrius,1409,druid,restoration,145,68,77
Ozanji,wyrmrest-accord,1406,druid,restoration,30,17,13
Gôdôfwow,tichondrius,1402,druid,restoration,77,31,46
Biggucci,stonemaul,1399,druid,restoration,30,18,12
Darimmx,mannoroth,1397,druid,restoration,84,44,40
Maviç,hyjal,1397,druid,restoration,96,50,46
Cyclone,mugthol,1396,druid,restoration,24,19,5
Leleoceo,azralon,1396,druid,restoration,24,15,9
Haymade,sargeras,1396,druid,restoration,78,36,42
Seizuressld,stormrage,1395,druid,restoration,81,46,35
Arkenix,velen,1395,druid,restoration,36,17,19
Murkeÿ,frostmourne,1391,druid,restoration,24,15,9
Lorern,eldrethalas,1390,druid,restoration,60,30,30
Lexut,ragnaros,1388,druid,restoration,36,16,20
Oobuck,kilrogg,1386,druid,restoration,87,47,40
Diglit,malganis,1386,druid,restoration,40,18,22
Nanniel,tichondrius,1383,druid,restoration,54,24,30
Icastsmells,tichondrius,1381,druid,restoration,57,36,21
Okiesmokied,proudmoore,1378,druid,restoration,30,17,13
Nestaballo,illidan,1375,druid,restoration,117,63,54
Lostnsauce,tichondrius,1375,druid,restoration,72,30,42
Maaui,sargeras,1374,druid,restoration,48,24,24
Venomgtz,laughing-skull,1372,druid,restoration,117,60,57
Kronik,jubeithos,1370,druid,restoration,49,15,34
Azshunara,moon-guard,1369,druid,restoration,84,43,41
Deamondruidz,kaelthas,1367,druid,restoration,78,31,47
Vakimumu,anubarak,1366,druid,restoration,72,31,41
Farmageddon,thunderhorn,1365,druid,restoration,58,33,25
Aramá,drakkari,1365,druid,restoration,38,21,17
Edraen,zuljin,1362,druid,restoration,137,67,70
Daku,moknathal,1362,druid,restoration,64,31,33
Vondutch,tichondrius,1362,druid,restoration,60,24,36
Kuwä,proudmoore,1360,druid,restoration,130,65,65
Santiagowski,ragnaros,1359,druid,restoration,46,23,23
Shifftycent,trollbane,1359,druid,restoration,54,26,28
Amandi,magtheridon,1358,druid,restoration,42,23,19
Kergai,emerald-dream,1355,druid,restoration,102,53,49
Horymory,darkspear,1353,druid,restoration,132,66,66
Onblue,tichondrius,1347,druid,restoration,38,22,16
Hotemz,dragonmaw,1347,druid,restoration,30,16,14
Jimjab,stormreaver,1346,druid,restoration,60,35,25
Fryy,balnazzar,1346,druid,restoration,30,15,15
Treelomilo,stormrage,1345,druid,restoration,61,34,27
Bobobear,proudmoore,1345,druid,restoration,60,23,37
Delody,tichondrius,1343,druid,restoration,38,23,15
Puzzlebox,illidan,1343,druid,restoration,24,14,10
Bemelerberg,sargeras,1343,druid,restoration,24,14,10
Cantmeldthis,zuljin,1340,druid,restoration,30,14,16
Muatigorn,blackrock,1339,druid,restoration,38,19,19
Rwi,tichondrius,1339,druid,restoration,105,49,56
Groschats,area-52,1339,druid,restoration,42,14,28
Ripberg,chogall,1338,druid,restoration,30,14,16
Cznfik,area-52,1338,druid,restoration,78,32,46
Eraticdruid,illidan,1338,druid,restoration,42,16,26
Doglightning,illidan,1336,druid,restoration,25,15,10
Klamediya,illidan,1336,druid,restoration,36,14,22
Vecuronium,tichondrius,1335,druid,restoration,30,14,16
Calmd,sargeras,1334,druid,restoration,18,14,4
Binionsolboy,illidan,1333,druid,restoration,30,14,16
Anchunlol,tichondrius,1332,druid,restoration,36,18,18
Mudpi,illidan,1332,druid,restoration,71,34,37
Izzabelle,deathwing,1330,druid,restoration,25,16,9
Girthture,tichondrius,1330,druid,restoration,130,63,67
Gladelf,sargeras,1327,druid,restoration,230,116,114
Anotherstar,frostmourne,1327,druid,restoration,60,28,32
Hynz,barthilas,1327,druid,restoration,36,15,21
Dokasaurus,lightbringer,1325,druid,restoration,36,17,19
Aristeus,kelthuzad,1322,druid,restoration,144,77,67
Joopsy,tichondrius,1321,druid,restoration,130,71,59
Puntcounder,sargeras,1320,druid,restoration,40,21,19
Nxghtfall,tichondrius,1319,druid,restoration,122,65,57
Youngteezy,barthilas,1319,druid,restoration,142,53,89
Bruitzya,barthilas,1318,druid,restoration,21,15,6
Branu,hyjal,1318,druid,restoration,30,14,16
Petmydeadcow,illidan,1317,druid,restoration,115,56,59
Zelyvia,moon-guard,1313,druid,restoration,24,14,10
Freehealjob,lightnings-blade,1313,druid,restoration,30,14,16
Kzinti,zuluhed,1312,druid,restoration,30,14,16
Donnà,tichondrius,1310,druid,restoration,43,21,22
Kevarcen,dalaran,1310,druid,restoration,66,32,34
Bovindickus,tichondrius,1309,druid,restoration,36,16,20
Ÿozsh,azralon,1306,druid,restoration,22,15,7
Ghirox,stormrage,1306,druid,restoration,54,26,28
Skotty,hyjal,1306,druid,restoration,48,23,25
Dypx,tichondrius,1304,druid,restoration,95,38,57
Gaawdx,illidan,1303,druid,restoration,54,25,29
Madsewerslvt,stormrage,1300,druid,restoration,149,75,74
Yoshí,emerald-dream,1299,druid,restoration,51,22,29
Purpleleaves,stormrage,1299,druid,restoration,119,51,68
Airmíd,illidan,1299,druid,restoration,48,16,32
Aaughh,sargeras,1297,druid,restoration,70,33,37
Rooroo,ragnaros,1296,druid,restoration,28,15,13
Minokawa,kargath,1296,druid,restoration,29,15,14
Zoeyx,tichondrius,1295,druid,restoration,37,21,16
Melbian,tichondrius,1295,druid,restoration,124,70,54
Entydruid,khazgoroth,1295,druid,restoration,34,19,15
Badferal,blackhand,1295,druid,restoration,51,25,26
Plagiarist,stormrage,1295,druid,restoration,44,20,24
Ohhshiift,tichondrius,1295,druid,restoration,33,14,19
Dunedaddy,silvermoon,1294,druid,restoration,42,23,19
Caustìk,malganis,1291,druid,restoration,70,38,32
Haneulso,tichondrius,1290,druid,restoration,55,30,25
Standee,sargeras,1290,druid,restoration,48,18,30
Kybecruz,stormrage,1289,druid,restoration,66,29,37
Magicrock,moon-guard,1285,druid,restoration,42,23,19
Apoxi,arygos,1284,druid,restoration,42,24,18
Ananan,burning-blade,1282,druid,restoration,101,49,52
Rawbacon,blackrock,1281,druid,restoration,40,15,25
Beleraine,moon-guard,1280,druid,restoration,34,17,17
Nogàrd,arygos,1279,druid,restoration,23,14,9
Naseebo,frostmourne,1279,druid,restoration,67,25,42
Zambyr,azralon,1278,druid,restoration,66,28,38
Afonso,frostmourne,1276,druid,restoration,50,26,24
Morphios,barthilas,1274,druid,restoration,54,25,29
Silit,tichondrius,1273,druid,restoration,39,18,21
Thericebags,illidan,1272,druid,restoration,161,86,75
Tenhoteta,goldrinn,1272,druid,restoration,48,22,26
Drazibaz,thrall,1271,druid,restoration,42,24,18
Sxlanderx,malganis,1271,druid,restoration,118,58,60
Haohomie,tichondrius,1270,druid,restoration,41,21,20
Odcerberus,azralon,1267,druid,restoration,36,18,18
Clawriander,barthilas,1266,druid,restoration,90,47,43
Tallenzz,lightninghoof,1265,druid,restoration,96,53,43
Slév,frostmourne,1263,druid,restoration,35,17,18
Beefyhealz,emerald-dream,1260,druid,restoration,48,31,17
Ourse,frostmourne,1260,druid,restoration,23,14,9
Nanate,sargeras,1259,druid,restoration,47,24,23
Greenvibes,drakkari,1257,druid,restoration,77,42,35
Lindi,kelthuzad,1257,druid,restoration,78,42,36
Kerrzo,frostmourne,1256,druid,restoration,36,17,19
Junglefists,frostmourne,1255,druid,restoration,133,68,65
Rockmeifucan,greymane,1253,druid,restoration,78,33,45
Katherine,moon-guard,1251,druid,restoration,132,62,70
Yakuho,proudmoore,1250,druid,restoration,32,20,12
Carlosd,tichondrius,1250,druid,restoration,58,33,25
Romcom,demon-soul,1250,druid,restoration,48,27,21
Jacknit,illidan,1250,druid,restoration,28,15,13
Phåtkid,darkspear,1250,druid,restoration,36,15,21
Druidnim,tichondrius,1249,druid,restoration,48,15,33
Skymund,tichondrius,1247,druid,restoration,50,26,24
Pouncing,sargeras,1247,druid,restoration,32,14,18
Ninzor,tichondrius,1247,druid,restoration,30,13,17
Rapttors,zuljin,1247,druid,restoration,30,13,17
Ziegey,tichondrius,1246,druid,restoration,24,13,11
Jonculler,korgath,1246,druid,restoration,54,26,28
Dolanaar,stormrage,1245,druid,restoration,149,78,71
Shallowcat,tichondrius,1245,druid,restoration,41,15,26
Icehulk,kelthuzad,1244,druid,restoration,24,13,11
Toslick,kelthuzad,1244,druid,restoration,117,59,58
Torofarmeon,quelthalas,1243,druid,restoration,51,30,21
Dankcentral,frostwolf,1242,druid,restoration,88,50,38
Goosebümps,stormrage,1242,druid,restoration,24,13,11
Krevy,nazgrel,1241,druid,restoration,36,13,23
Sarojna,malganis,1239,druid,restoration,18,13,5
Healingcute,tichondrius,1239,druid,restoration,131,70,61
Feldstarx,stormrage,1238,druid,restoration,24,13,11
Larc,frostwolf,1238,druid,restoration,76,39,37
Shanê,proudmoore,1238,druid,restoration,55,27,28
Kyndel,kiljaeden,1237,druid,restoration,44,22,22
Amatxu,ragnaros,1237,druid,restoration,123,61,62
Travys,sargeras,1235,druid,restoration,36,16,20
Veganz,moon-guard,1233,druid,restoration,145,71,74
Svarne,kiljaeden,1232,druid,restoration,59,29,30
Adaralia,tichondrius,1232,druid,restoration,30,13,17
Groõt,barthilas,1232,druid,restoration,99,42,57
Shekelsnätch,area-52,1231,druid,restoration,42,21,21
Smilax,eonar,1231,druid,restoration,71,29,42
Slev,frostmourne,1229,druid,restoration,24,13,11
Lünaä,quelthalas,1228,druid,restoration,42,29,13
Imakitty,aerie-peak,1226,druid,restoration,121,62,59
Carneluna,area-52,1226,druid,restoration,66,31,35
Suye,tichondrius,1226,druid,restoration,66,30,36
Wildwhisper,moon-guard,1225,druid,restoration,96,50,46
Yellowstone,drakthul,1222,druid,restoration,42,23,19
Speaks,moon-guard,1222,druid,restoration,71,29,42
Anothersalad,stormrage,1221,druid,restoration,66,32,34
Beladrexx,stormrage,1221,druid,restoration,54,21,33
Whispurrz,tichondrius,1219,druid,restoration,297,152,145
Druidkingdk,stormrage,1218,druid,restoration,29,18,11
Brandonxerox,tichondrius,1217,druid,restoration,30,13,17
Ännä,moon-guard,1217,druid,restoration,30,13,17
Greemer,sargeras,1213,druid,restoration,39,18,21
Bunnyes,tichondrius,1212,druid,restoration,59,29,30
Malfurionis,tichondrius,1212,druid,restoration,36,13,23
Gryel,area-52,1211,druid,restoration,235,122,113
Bäñgarang,tichondrius,1210,druid,restoration,72,40,32
Ulfaren,frostmourne,1209,druid,restoration,24,15,9
Layala,sargeras,1209,druid,restoration,84,41,43
Pyrogenics,whisperwind,1209,druid,restoration,42,20,22
Lewïs,stormrage,1208,druid,restoration,87,53,34
Barecow,tichondrius,1207,druid,restoration,30,13,17
Tìssuebox,malganis,1207,druid,restoration,75,32,43
Lunkz,tichondrius,1205,druid,restoration,96,46,50
Tuskdaddie,sargeras,1204,druid,restoration,30,17,13
Meôwmix,stormrage,1202,druid,restoration,24,13,11
Kasannaommi,sargeras,1202,druid,restoration,66,32,34
Cuddles,moon-guard,1201,druid,restoration,137,67,70
Driftwood,bonechewer,1201,druid,restoration,64,27,37
Bikacat,kelthuzad,1200,druid,restoration,24,13,11
Darksteak,tichondrius,1200,druid,restoration,168,85,83
Rhatir,stormrage,1200,druid,restoration,104,48,56
Dimzim,lightbringer,1198,druid,restoration,66,31,35
Gokki,zuljin,1197,druid,restoration,22,14,8
Nugren,thrall,1195,druid,restoration,50,22,28
Sweetcorn,malganis,1192,druid,restoration,40,16,24
Gossìpgoat,frostmourne,1191,druid,restoration,80,38,42
Höneyfang,moon-guard,1189,druid,restoration,59,37,22
Cheddastov,illidan,1189,druid,restoration,27,14,13
Knowgo,tichondrius,1188,druid,restoration,54,28,26
Longisland,quelthalas,1188,druid,restoration,84,38,46
Juuru,stormreaver,1185,druid,restoration,24,17,7
Adarindre,aerie-peak,1185,druid,restoration,93,46,47
Pawpurrazzi,moon-guard,1183,druid,restoration,17,13,4
Alphalemon,ragnaros,1182,druid,restoration,63,32,31
Valeñtine,dalaran,1179,druid,restoration,78,39,39
Aterra,ragnaros,1179,druid,restoration,29,13,16
Tworax,frostmourne,1179,druid,restoration,30,13,17
Alastras,tichondrius,1176,druid,restoration,30,16,14
Pollished,kelthuzad,1176,druid,restoration,35,17,18
Ephemere,emerald-dream,1176,druid,restoration,28,13,15
Lizzelune,drakkari,1176,druid,restoration,42,18,24
Hruke,illidan,1173,druid,restoration,42,17,25
Schlotzsky,skullcrusher,1171,druid,restoration,69,37,32
Mf,stormscale,1171,druid,restoration,30,14,16
Iambeefy,hyjal,1170,druid,restoration,165,79,86
Vantorsydmel,proudmoore,1167,druid,restoration,46,24,22
Chixao,tichondrius,1166,druid,restoration,23,13,10
Matpd,norgannon,1165,druid,restoration,124,61,63
Saelyle,illidan,1164,druid,restoration,40,19,21
Frames,area-52,1164,druid,restoration,109,51,58
Kamisamalee,tichondrius,1163,druid,restoration,17,13,4
Sarangzzang,tichondrius,1159,druid,restoration,37,22,15
Pachacamac,dragonmaw,1159,druid,restoration,36,21,15
Lenori,vashj,1159,druid,restoration,48,24,24
Smhyle,frostmourne,1158,druid,restoration,41,21,20
Naturemagic,malganis,1157,druid,restoration,45,26,19
Garbagedruid,scilla,1152,druid,restoration,24,12,12
Doah,kelthuzad,1152,druid,restoration,24,12,12
Rekelberg,sargeras,1151,druid,restoration,18,12,6
Ayalia,saurfang,1151,druid,restoration,18,12,6
Beecammy,frostmourne,1151,druid,restoration,54,31,23
Floofi,kelthuzad,1151,druid,restoration,24,12,12
Concordya,tichondrius,1149,druid,restoration,59,29,30
Enrÿu,nemesis,1149,druid,restoration,30,12,18
Mommymilkers,jubeithos,1149,druid,restoration,54,14,40
Æpex,lightnings-blade,1148,druid,restoration,30,16,14
Idoldeoz,quelthalas,1147,druid,restoration,36,18,18
Dchizzle,tichondrius,1147,druid,restoration,45,20,25
Gorillagloo,area-52,1146,druid,restoration,79,36,43
Fatshift,chogall,1145,druid,restoration,122,62,60
Skibbidy,boulderfist,1145,druid,restoration,33,14,19
Weedmunchies,kelthuzad,1143,druid,restoration,24,12,12
Tyrs,aggramar,1140,druid,restoration,35,15,20
Elylaylalar,moon-guard,1139,druid,restoration,48,21,27
Jijunss,tichondrius,1137,druid,restoration,23,13,10
Sinseir,stormscale,1137,druid,restoration,99,42,57
Miyeonly,dalaran,1137,druid,restoration,36,12,24
Joya,stormrage,1136,druid,restoration,18,12,6
Glenkair,lightnings-blade,1134,druid,restoration,36,17,19
Pumma,darkspear,1134,druid,restoration,28,13,15
Bigherbo,zuljin,1130,druid,restoration,126,61,65
Catlypso,tichondrius,1129,druid,restoration,66,40,26
Foxbear,garona,1127,druid,restoration,51,33,18
Duxz,tichondrius,1127,druid,restoration,23,13,10
Würzel,nemesis,1127,druid,restoration,84,41,43
Sloptoucher,barthilas,1126,druid,restoration,24,12,12
Iheartpvp,tichondrius,1121,druid,restoration,48,21,27
Hotkage,tichondrius,1120,druid,restoration,18,12,6
Hðthead,area-52,1118,druid,restoration,54,26,28
Feralgodx,sargeras,1114,druid,restoration,23,12,11
Stupidranga,barthilas,1114,druid,restoration,48,17,31
Fermata,aegwynn,1113,druid,restoration,28,15,13
Jruids,stormrage,1111,druid,restoration,36,12,24
Dainehoof,area-52,1110,druid,restoration,39,14,25
Kuaite,azralon,1110,druid,restoration,72,25,47
Katdog,warsong,1109,druid,restoration,33,22,11
Löthnälar,ragnaros,1109,druid,restoration,48,24,24
Chowyunfats,proudmoore,1106,druid,restoration,301,155,146
Müfasä,azralon,1106,druid,restoration,54,25,29
Maddoxi,stormrage,1106,druid,restoration,30,12,18
Sharinna,andorhal,1106,druid,restoration,38,14,24
Sodury,tichondrius,1104,druid,restoration,90,50,40
Furfu,illidan,1104,druid,restoration,74,33,41
Moomooheal,moon-guard,1102,druid,restoration,21,13,8
Sneakysoren,kelthuzad,1102,druid,restoration,36,13,23
Carekoala,wyrmrest-accord,1098,druid,restoration,59,30,29
Shroomkin,area-52,1097,druid,restoration,36,19,17
Tensuen,boulderfist,1095,druid,restoration,45,17,28
Kymopexy,sargeras,1095,druid,restoration,41,14,27
Jabina,detheroc,1093,druid,restoration,54,16,38
Mcriblet,illidan,1091,druid,restoration,24,12,12
Barugaf,drakkari,1090,druid,restoration,49,28,21
Kittne,hellscream,1089,druid,restoration,48,24,24
Vollzar,sargeras,1089,druid,restoration,68,23,45
Wp,proudmoore,1088,druid,restoration,32,14,18
Cear,proudmoore,1087,druid,restoration,30,12,18
Ayadel,moon-guard,1086,druid,restoration,118,54,64
Tarzzan,drakkari,1085,druid,restoration,17,13,4
Bubbashift,garona,1080,druid,restoration,30,12,18
Volgoro,thrall,1078,druid,restoration,60,25,35
Mydira,stormrage,1071,druid,restoration,54,30,24
Samerax,vashj,1070,druid,restoration,107,45,62
Slleep,tichondrius,1069,druid,restoration,54,28,26
Gimborion,stormrage,1066,druid,restoration,48,23,25
Nöches,quelthalas,1065,druid,restoration,32,12,20
Quaileggs,illidan,1064,druid,restoration,36,12,24
Aarandiel,borean-tundra,1063,druid,restoration,30,17,13
Lutzenberger,nemesis,1063,druid,restoration,53,23,30
Buffalobillz,lethon,1062,druid,restoration,40,25,15
Soxyeon,tichondrius,1062,druid,restoration,29,12,17
Rëroll,zuljin,1059,druid,restoration,17,12,5
Chinadruids,tichondrius,1056,druid,restoration,18,11,7
Whhm,burning-blade,1056,druid,restoration,24,11,13
Slurpi,barthilas,1056,druid,restoration,30,11,19
Buffdisc,darkspear,1055,druid,restoration,12,11,1
Hoeba,tichondrius,1055,druid,restoration,18,11,7
Gromdruid,azralon,1055,druid,restoration,66,33,33
Momorabbitd,tichondrius,1055,druid,restoration,30,11,19
Qkskill,nemesis,1055,druid,restoration,42,11,31
Goodhealer,akama,1054,druid,restoration,42,26,16
Krobz,bleeding-hollow,1054,druid,restoration,18,11,7
Moonpaws,frostmourne,1053,druid,restoration,18,11,7
Careless,destromath,1053,druid,restoration,66,27,39
Kitnip,proudmoore,1052,druid,restoration,24,16,8
Côunsyl,silvermoon,1052,druid,restoration,18,11,7
Áçxpërt,jubeithos,1052,druid,restoration,18,11,7
Israh,malygos,1052,druid,restoration,26,15,11
Lawlz,aegwynn,1052,druid,restoration,72,39,33
Yorch,stormrage,1052,druid,restoration,60,28,32
Madowl,tichondrius,1052,druid,restoration,24,11,13
Undaunted,bloodhoof,1051,druid,restoration,24,11,13
Solisuu,frostmane,1051,druid,restoration,30,11,19
Cres,moon-guard,1051,druid,restoration,42,11,31
Phxburn,illidan,1050,druid,restoration,30,11,19
Eredorn,darkspear,1049,druid,restoration,24,18,6
Wythrim,quelthalas,1049,druid,restoration,18,11,7
Quarantinia,arathor,1049,druid,restoration,36,20,16
Hallowbranch,moon-guard,1048,druid,restoration,38,15,23
Dinglebops,stormrage,1047,druid,restoration,28,15,13
Xzerhos,area-52,1047,druid,restoration,151,70,81
Cratose,runetotem,1047,druid,restoration,47,20,27
Yimii,stormrage,1046,druid,restoration,18,11,7
Sorrinn,tichondrius,1046,druid,restoration,24,11,13
Thõrr,tichondrius,1046,druid,restoration,24,11,13
Dorzaku,ragnaros,1045,druid,restoration,47,27,20
Zadayos,aerie-peak,1044,druid,restoration,30,16,14
Deximus,wyrmrest-accord,1043,druid,restoration,18,11,7
Druilicious,ghostlands,1043,druid,restoration,55,27,28
Gairen,the-venture-co,1042,druid,restoration,20,12,8
Feaveldin,moon-guard,1041,druid,restoration,18,11,7
Azyx,stormrage,1041,druid,restoration,42,16,26
Ahrilee,area-52,1040,druid,restoration,75,33,42
Jimmycooks,tichondrius,1039,druid,restoration,18,11,7
Chopleaf,khadgar,1039,druid,restoration,180,92,88
Erû,ragnaros,1037,druid,restoration,18,11,7
Beefcurtâins,aggramar,1032,druid,restoration,18,11,7
Fionnbharr,ragnaros,1031,druid,restoration,76,35,41
Delicioso,wyrmrest-accord,1030,druid,restoration,33,21,12
Javoh,drakkari,1030,druid,restoration,25,13,12
Boofndergz,area-52,1027,druid,restoration,24,15,9
Janaki,malygos,1024,druid,restoration,30,13,17
Panacaea,windrunner,1023,druid,restoration,18,11,7
Burdup,tichondrius,1020,druid,restoration,18,11,7
Imcop,tichondrius,1020,druid,restoration,18,11,7
Troply,ragnaros,1020,druid,restoration,20,12,8
Funnydruid,frostmourne,1020,druid,restoration,42,20,22
Xarressian,moon-guard,1019,druid,restoration,24,11,13
Sonrius,proudmoore,1017,druid,restoration,52,25,27
Feanah,tichondrius,1017,druid,restoration,26,12,14
Nachopuppet,kelthuzad,1017,druid,restoration,45,20,25
Skaidi,quelthalas,1015,druid,restoration,24,13,11
Milkmoneymeo,illidan,1011,druid,restoration,29,11,18
Sunneater,azuremyst,1009,druid,restoration,37,18,19
Agranock,nazgrel,1008,druid,restoration,58,27,31
Ojdidnt,bleeding-hollow,1007,druid,restoration,21,12,9
Cannabull,echo-isles,1007,druid,restoration,27,13,14
Rivetrix,azralon,1007,druid,restoration,103,49,54
Agnala,drakkari,1007,druid,restoration,93,32,61
Duducows,tichondrius,1007,druid,restoration,35,12,23
Keladria,bleeding-hollow,1002,druid,restoration,102,55,47
Guron,aegwynn,1001,druid,restoration,57,30,27
Pmsprone,tichondrius,1001,druid,restoration,66,30,36
Yeahhots,frostmourne,1000,druid,restoration,15,12,3
Mainera,sargeras,1000,druid,restoration,26,12,14
Kastro,frostwolf,997,druid,restoration,24,11,13
Alfurr,tichondrius,994,druid,restoration,85,43,42
Krossus,drakkari,993,druid,restoration,38,13,25
Hewozuoai,area-52,990,druid,restoration,35,11,24
Astharon,drakkari,989,druid,restoration,56,31,25
Marrana,altar-of-storms,989,druid,restoration,24,13,11
Ahylen,quelthalas,989,druid,restoration,53,22,31
Canche,arthas,986,druid,restoration,34,19,15
Feralgød,tichondrius,985,druid,restoration,30,11,19
Treewik,emerald-dream,981,druid,restoration,85,48,37
Nerfmesoon,sargeras,978,druid,restoration,22,11,11
Santicow,ragnaros,975,druid,restoration,20,11,9
Sharkhotzlol,frostmourne,974,druid,restoration,30,11,19
Jethelium,illidan,971,druid,restoration,136,73,63
Seceru,proudmoore,968,druid,restoration,58,31,27
Boomshorts,blackrock,968,druid,restoration,29,14,15
Macdonah,tichondrius,967,druid,restoration,54,26,28
Sunyatsen,quelthalas,967,druid,restoration,58,25,33
Tiufill,nemesis,965,druid,restoration,30,16,14
Mielo,illidan,964,druid,restoration,130,62,68
Wiggle,stormscale,962,druid,restoration,44,21,23
Baruc,illidan,960,druid,restoration,12,10,2
Salzadruid,aggramar,960,druid,restoration,12,10,2
Larissaelar,tichondrius,960,druid,restoration,12,10,2
Pekingcuckoo,illidan,960,druid,restoration,18,10,8
Kurohîme,illidan,960,druid,restoration,18,10,8
Jiywa,lightbringer,960,druid,restoration,18,10,8
Aphroditezs,tichondrius,960,druid,restoration,18,10,8
Nhin,ghostlands,960,druid,restoration,24,10,14
Smeekq,tichondrius,960,druid,restoration,24,10,14
Xiaoyi,tichondrius,959,druid,restoration,12,10,2
Overthink,daggerspine,959,druid,restoration,12,10,2
Dolwizz,tichondrius,959,druid,restoration,18,10,8
Hoonjojjyanx,tichondrius,959,druid,restoration,18,10,8
Elyl,tichondrius,959,druid,restoration,18,10,8
Ddi,frostmourne,959,druid,restoration,18,10,8
Slambeezy,emerald-dream,959,druid,restoration,18,10,8
Garbagebutt,burning-legion,959,druid,restoration,18,10,8
Oblackbetty,illidan,959,druid,restoration,39,18,21
Chutney,windrunner,959,druid,restoration,24,10,14
Treesh,kelthuzad,959,druid,restoration,26,10,16
Lissette,thrall,958,druid,restoration,18,10,8
Uggadruid,malganis,958,druid,restoration,18,10,8
Tlanquility,tichondrius,958,druid,restoration,18,10,8
Lolomas,proudmoore,958,druid,restoration,24,10,14
Magzally,stormrage,958,druid,restoration,24,10,14
Simina,kargath,957,druid,restoration,18,10,8
Dreamgaze,zuljin,957,druid,restoration,18,10,8
Chenxguang,tichondrius,957,druid,restoration,42,22,20
Iheartmushu,mannoroth,957,druid,restoration,91,47,44
Lovenug,shadowsong,957,druid,restoration,24,10,14
Ñoobdruid,tichondrius,956,druid,restoration,18,10,8
Cranbérry,sargeras,956,druid,restoration,18,10,8
Vêzpêr,kelthuzad,956,druid,restoration,24,10,14
Lorca,stormrage,955,druid,restoration,12,10,2
Kataless,sargeras,954,druid,restoration,77,40,37
Dobidas,tichondrius,953,druid,restoration,82,40,42
Pronewb,frostmourne,952,druid,restoration,12,10,2
Trolbearpig,malganis,952,druid,restoration,18,10,8
Joink,sargeras,952,druid,restoration,18,10,8
Wildartform,malganis,952,druid,restoration,23,12,11
Dietmilk,sargeras,952,druid,restoration,24,11,13
Däll,tichondrius,952,druid,restoration,24,10,14
Fortnitburgr,tichondrius,951,druid,restoration,18,10,8
Erisya,moon-guard,951,druid,restoration,18,10,8
Wintarz,sargeras,951,druid,restoration,30,10,20
Feckzd,blackhand,950,druid,restoration,18,10,8
Honeymead,wyrmrest-accord,950,druid,restoration,65,36,29
Judar,barthilas,950,druid,restoration,24,10,14
Immabot,tichondrius,949,druid,restoration,36,10,26
Krözjk,quelthalas,948,druid,restoration,27,10,17
Hpcorrection,bleeding-hollow,946,druid,restoration,18,10,8
Yourka,uther,946,druid,restoration,29,15,14
Fatjoints,tichondrius,943,druid,restoration,60,21,39
Maxobviously,stormrage,942,druid,restoration,18,10,8
Devilsparda,frostmane,942,druid,restoration,24,10,14
Kg,cenarion-circle,941,druid,restoration,28,13,15
Dwalk,moknathal,941,druid,restoration,79,36,43
Tyrantha,emerald-dream,941,druid,restoration,24,10,14
Shiftaholic,azgalor,940,druid,restoration,33,17,16
Drucaicer,quelthalas,939,druid,restoration,71,38,33
Bindudream,frostmane,938,druid,restoration,66,30,36
Nattog,area-52,937,druid,restoration,47,12,35
Saltyzz,tichondrius,935,druid,restoration,24,10,14
Blackdawgg,frostmourne,931,druid,restoration,60,21,39
Katochi,area-52,929,druid,restoration,54,24,30
Blooddude,saurfang,927,druid,restoration,30,11,19
Killari,malganis,926,druid,restoration,30,15,15
Movom,tichondrius,925,druid,restoration,23,10,13
Dhannar,proudmoore,924,druid,restoration,12,10,2
Cloudbreaker,duskwood,923,druid,restoration,18,10,8
Chocoo,thaurissan,923,druid,restoration,20,11,9
Bankinbäbe,illidan,923,druid,restoration,50,23,27
Cowtox,moon-guard,920,druid,restoration,60,25,35
Moolan,bleeding-hollow,919,druid,restoration,32,15,17
Fovoss,dalaran,914,druid,restoration,36,18,18
Lazypandas,silvermoon,914,druid,restoration,41,17,24
Worgbearpig,destromath,908,druid,restoration,20,11,9
Aquesadilla,tichondrius,907,druid,restoration,108,36,72
Guerrillera,khadgar,903,druid,restoration,118,54,64
Diaks,proudmoore,900,druid,restoration,24,12,12
Bethemarble,sargeras,900,druid,restoration,47,20,27
Merawr,area-52,896,druid,restoration,22,10,12
Hentaiboom,kiljaeden,893,druid,restoration,36,16,20
Vengaul,amanthul,892,druid,restoration,24,10,14
Lâvazza,tichondrius,890,druid,restoration,28,10,18
Sliickrick,frostmourne,889,druid,restoration,30,10,20
Anasia,barthilas,886,druid,restoration,14,11,3
Theboyz,zuljin,881,druid,restoration,30,11,19
Midníght,drakkari,880,druid,restoration,34,18,16
Bunrÿl,thorium-brotherhood,874,druid,restoration,54,24,30
Augus,hyjal,870,druid,restoration,33,11,22
Theboy,dalaran,869,druid,restoration,48,15,33
Bopplejr,tichondrius,864,druid,restoration,12,9,3
Aiteezy,illidan,864,druid,restoration,12,9,3
Restokinaja,dreadmaul,864,druid,restoration,12,9,3
Duo,demon-soul,864,druid,restoration,12,9,3
Spikeleaf,tichondrius,864,druid,restoration,12,9,3
Justforgame,sargeras,864,druid,restoration,12,9,3
Ppbtw,illidan,864,druid,restoration,18,9,9
Ppbdru,tichondrius,864,druid,restoration,18,9,9
Mmrborrower,icecrown,864,druid,restoration,18,9,9
Hellshifterr,tichondrius,864,druid,restoration,18,9,9
Ppb,illidan,864,druid,restoration,18,9,9
Bridgerén,tichondrius,864,druid,restoration,18,9,9
Lindsanr,illidan,864,druid,restoration,24,9,15
Convokíng,kelthuzad,864,druid,restoration,30,9,21
Ilovejuli,illidan,863,druid,restoration,12,9,3
Naturenugget,tichondrius,863,druid,restoration,12,9,3
Rejuvenation,kaelthas,863,druid,restoration,12,9,3
Ooh,stormreaver,863,druid,restoration,12,9,3
Vernaar,laughing-skull,863,druid,restoration,18,9,9
Asaphelps,stormrage,863,druid,restoration,18,9,9
Canek,ghostlands,863,druid,restoration,18,9,9
Canitöuchit,tichondrius,863,druid,restoration,24,9,15
Opim,sargeras,863,druid,restoration,24,9,15
Guss,mannoroth,863,druid,restoration,24,9,15
Tugginudders,illidan,863,druid,restoration,30,9,21
Shuffleqlol,stormrage,862,druid,restoration,12,9,3
Jentzull,tichondrius,862,druid,restoration,12,9,3
Pawsh,tichondrius,862,druid,restoration,12,9,3
Phylex,frostmourne,862,druid,restoration,18,9,9
Cenarius,frostmourne,862,druid,restoration,18,9,9
Bigrich,malorne,862,druid,restoration,18,9,9
Dummedruid,illidan,862,druid,restoration,24,9,15
Monkeyxo,kelthuzad,861,druid,restoration,18,9,9
Alindrä,moon-guard,861,druid,restoration,18,9,9
Alsei,quelthalas,861,druid,restoration,40,18,22
Goodspeed,thrall,861,druid,restoration,42,11,31
Dankmids,hyjal,860,druid,restoration,12,9,3
Stetile,azralon,859,druid,restoration,18,9,9
Sorio,area-52,858,druid,restoration,28,10,18
Poutyface,sargeras,858,druid,restoration,51,10,41
Feutrine,zuljin,857,druid,restoration,18,9,9
Crackheads,tichondrius,856,druid,restoration,24,9,15
Treeoleo,stormrage,855,druid,restoration,30,13,17
Malice,undermine,854,druid,restoration,24,9,15
Faroo,azralon,854,druid,restoration,24,9,15
Kvacco,kiljaeden,848,druid,restoration,24,9,15
Encosan,azralon,848,druid,restoration,30,9,21
Drexldrood,cenarius,847,druid,restoration,12,9,3
Kanadae,thrall,846,druid,restoration,24,9,15
Uwupollo,ragnaros,846,druid,restoration,42,13,29
Érois,azralon,844,druid,restoration,18,9,9
Stamynn,kelthuzad,843,druid,restoration,133,44,89
Draycø,tichondrius,841,druid,restoration,18,9,9
Fronkysilva,illidan,838,druid,restoration,48,19,29
Kellykapore,area-52,827,druid,restoration,66,15,51
Jennafix,dathremar,825,druid,restoration,18,9,9
Kittyz,wyrmrest-accord,817,druid,restoration,18,9,9
Kawanishi,stormrage,810,druid,restoration,18,9,9
Elauria,stormreaver,804,druid,restoration,42,17,25
Atim,moon-guard,804,druid,restoration,96,28,68
Xxuan,tichondrius,803,druid,restoration,62,16,46
Gypsysoul,barthilas,798,druid,restoration,17,9,8
Mcy,nerzhul,798,druid,restoration,20,9,11
Lazza,blackhand,796,druid,restoration,16,9,7
Cenariun,stormrage,790,druid,restoration,30,9,21
Shturman,blackrock,783,druid,restoration,11,9,2
Judwen,grizzly-hills,779,druid,restoration,70,26,44
Redharp,proudmoore,776,druid,restoration,43,17,26
Hoebaz,tichondrius,768,druid,restoration,12,8,4
Chinadruides,tichondrius,768,druid,restoration,12,8,4
Quss,tichondrius,768,druid,restoration,12,8,4
Cakeinalake,bleeding-hollow,768,druid,restoration,12,8,4
Albafic,illidan,768,druid,restoration,12,8,4
Kustumsdog,tichondrius,768,druid,restoration,12,8,4
Bobxd,kelthuzad,768,druid,restoration,12,8,4
Leafynymph,tichondrius,768,druid,restoration,12,8,4
Xiaootong,tichondrius,768,druid,restoration,12,8,4
Ppm,illidan,768,druid,restoration,12,8,4
Leilani,eredar,768,druid,restoration,12,8,4
Tiggor,ghostlands,768,druid,restoration,12,8,4
Taledra,stormrage,768,druid,restoration,18,8,10
Restobaby,tichondrius,768,druid,restoration,18,8,10
Pekazay,illidan,768,druid,restoration,18,8,10
Înfamous,thrall,767,druid,restoration,12,8,4
Maeo,drenden,767,druid,restoration,12,8,4
Kismet,andorhal,767,druid,restoration,12,8,4
Alend,alexstrasza,767,druid,restoration,12,8,4
Mxlasthope,stormrage,767,druid,restoration,12,8,4
Bringo,executus,767,druid,restoration,21,10,11
Acerolita,azralon,767,druid,restoration,18,8,10
Lifebloomlol,area-52,767,druid,restoration,18,8,10
Waxedchest,emerald-dream,767,druid,restoration,18,8,10
Thetakeout,tichondrius,767,druid,restoration,18,8,10
Kaboomy,moon-guard,767,druid,restoration,18,8,10
Libel,korgath,766,druid,restoration,12,8,4
Terokky,azralon,766,druid,restoration,12,8,4
Hughcockman,tichondrius,766,druid,restoration,12,8,4
Wildsïde,tichondrius,766,druid,restoration,18,8,10
Crapster,boulderfist,766,druid,restoration,18,8,10
Feykurds,sargeras,766,druid,restoration,18,8,10
Bumbleebee,azralon,766,druid,restoration,24,8,16
Hedwíg,ragnaros,766,druid,restoration,24,8,16
Imnotinhuman,tichondrius,765,druid,restoration,12,8,4
Louisvuittón,area-52,765,druid,restoration,12,8,4
Dmanrepus,sargeras,765,druid,restoration,12,8,4
Kupos,lightbringer,765,druid,restoration,21,8,13
Guybranch,illidan,765,druid,restoration,24,8,16
Slee,eredar,764,druid,restoration,12,8,4
Ctarla,tichondrius,764,druid,restoration,18,8,10
Leatherpig,proudmoore,764,druid,restoration,18,8,10
Aurajin,spinebreaker,764,druid,restoration,24,8,16
Needabandaid,arthas,764,druid,restoration,24,8,16
Studioghibli,bleeding-hollow,762,druid,restoration,12,8,4
Atalìa,moon-guard,762,druid,restoration,18,8,10
Blitzÿ,lothar,761,druid,restoration,12,8,4
Rockcow,tichondrius,761,druid,restoration,18,8,10
Markóla,stormrage,761,druid,restoration,18,8,10
Wortsnom,tol-barad,760,druid,restoration,12,8,4
Quan,illidan,760,druid,restoration,18,8,10
Meonk,frostmourne,759,druid,restoration,18,8,10
Rairven,stormrage,757,druid,restoration,42,8,34
Rhondarootsy,zuljin,756,druid,restoration,18,8,10
Bainnê,ragnaros,755,druid,restoration,42,8,34
Cadekey,illidan,752,druid,restoration,24,8,16
Friarpuck,nerzhul,747,druid,restoration,12,8,4
Dragondruid,dawnbringer,742,druid,restoration,35,9,26
Ekj,tichondrius,735,druid,restoration,14,9,5
Akanx,tichondrius,735,druid,restoration,16,9,7
Elvishchamp,mugthol,733,druid,restoration,17,9,8
Kadry,ragnaros,733,druid,restoration,18,8,10
Kataoka,azralon,721,druid,restoration,23,11,12
Rdruidchump,the-forgotten-coast,719,druid,restoration,15,9,6
Basulto,tichondrius,718,druid,restoration,23,8,15
Xîstance,barthilas,717,druid,restoration,23,8,15
Asclepïus,tichondrius,716,druid,restoration,17,8,9
Felinedreams,sargeras,714,druid,restoration,14,9,5
Whiskeyblues,ursin,706,druid,restoration,24,8,16
Zephiee,kelthuzad,692,druid,restoration,23,8,15
Teamwork,moon-guard,681,druid,restoration,20,10,10
Importedalc,zuljin,678,druid,restoration,36,8,28
Crusch,shattered-halls,672,druid,restoration,12,7,5
Scuzzin,zuljin,672,druid,restoration,12,7,5
Skitzo,akama,672,druid,restoration,12,7,5
Mymatejames,tichondrius,672,druid,restoration,12,7,5
Sensations,moon-guard,672,druid,restoration,12,7,5
Cameltail,kelthuzad,672,druid,restoration,12,7,5
Blacksimbá,area-52,672,druid,restoration,12,7,5
Razberriesz,stormrage,672,druid,restoration,12,7,5
Bigdockepoch,sargeras,672,druid,restoration,12,7,5
Motate,malganis,672,druid,restoration,12,7,5
Toketree,sargeras,672,druid,restoration,12,7,5
Tmdogwater,sargeras,672,druid,restoration,12,7,5
Treeofangels,nathrezim,672,druid,restoration,12,7,5
Fresh,earthen-ring,672,druid,restoration,12,7,5
Spicyx,moon-guard,672,druid,restoration,12,7,5
Esqueue,stormrage,672,druid,restoration,12,7,5
Hmoobforshoz,wildhammer,672,druid,restoration,12,7,5
Calimei,bladefist,672,druid,restoration,18,7,11
Hoedrufroza,tichondrius,672,druid,restoration,18,7,11
Washeddruid,area-52,672,druid,restoration,18,7,11
Greentoë,sargeras,672,druid,restoration,18,7,11
Dotsbots,barthilas,672,druid,restoration,18,7,11
Suekey,frostmourne,672,druid,restoration,18,7,11
Wùúkìí,bleeding-hollow,672,druid,restoration,24,7,17
Iâmkyle,darkspear,671,druid,restoration,12,7,5
Zthatchx,shadowmoon,671,druid,restoration,12,7,5
Jessbearly,kiljaeden,671,druid,restoration,12,7,5
Tigranesia,proudmoore,671,druid,restoration,12,7,5
Hugharection,illidan,671,druid,restoration,12,7,5
Heniuhojia,tichondrius,671,druid,restoration,12,7,5
Tickman,altar-of-storms,671,druid,restoration,18,7,11
Wildarumqt,tichondrius,671,druid,restoration,18,7,11
Lilgee,kelthuzad,671,druid,restoration,18,7,11
Clarice,shattered-halls,671,druid,restoration,18,7,11
Boomchí,tichondrius,671,druid,restoration,18,7,11
Sêxcavator,thrall,671,druid,restoration,18,7,11
Topzet,azralon,671,druid,restoration,24,7,17
Hellahots,spinebreaker,670,druid,restoration,12,7,5
Queiq,kelthuzad,670,druid,restoration,12,7,5
Erykk,dalaran,670,druid,restoration,12,7,5
Flexxfurion,thrall,670,druid,restoration,18,7,11
Wreckked,sargeras,670,druid,restoration,18,7,11
Frave,dentarg,670,druid,restoration,24,7,17
Hotpocketz,kiljaeden,670,druid,restoration,28,8,20
Martymoo,bleeding-hollow,670,druid,restoration,30,7,23
Dipset,khadgar,670,druid,restoration,30,7,23
Dylonomancer,tichondrius,669,druid,restoration,12,7,5
Nayelina,stormrage,669,druid,restoration,12,7,5
Zwind,nerzhul,669,druid,restoration,16,8,8
Treesonn,kelthuzad,669,druid,restoration,17,8,9
Razorclaws,stormscale,669,druid,restoration,18,7,11
Battiatus,malganis,669,druid,restoration,18,7,11
Maggiee,arthas,669,druid,restoration,24,7,17
Bloomcrue,moon-guard,668,druid,restoration,12,7,5
Shiftyy,nordrassil,668,druid,restoration,19,7,12
Esyiix,tichondrius,668,druid,restoration,24,7,17
Mïms,area-52,667,druid,restoration,12,7,5
Swagbabe,sargeras,665,druid,restoration,18,7,11
Gentlesoapp,blackrock,665,druid,restoration,18,7,11
Bullshifftt,kelthuzad,664,druid,restoration,12,7,5
Madambuku,thrall,663,druid,restoration,12,7,5
Somars,cenarius,663,druid,restoration,12,7,5
Snarl,blades-edge,657,druid,restoration,12,7,5
Ikova,frostmourne,650,druid,restoration,18,7,11
Solbinn,nordrassil,647,druid,restoration,72,18,54
Gotdruid,sargeras,639,druid,restoration,14,8,6
Riddickd,malfurion,639,druid,restoration,14,8,6
Kellogs,malganis,639,druid,restoration,17,7,10
Warmkitteh,kiljaeden,639,druid,restoration,17,7,10
Breathe,ysera,639,druid,restoration,28,7,21
Wolfelord,sargeras,624,druid,restoration,21,7,14
Rígo,frostmourne,622,druid,restoration,15,8,7
Midoriiro,dentarg,612,druid,restoration,25,8,17
Stupidtree,antonidas,607,druid,restoration,11,7,4
Milkz,zuljin,607,druid,restoration,26,7,19
Ordono,emerald-dream,576,druid,restoration,6,6,0
Pacetwo,area-52,576,druid,restoration,6,6,0
Disembles,illidan,576,druid,restoration,12,6,6
Forèst,sargeras,576,druid,restoration,12,6,6
Sawajirii,tichondrius,576,druid,restoration,12,6,6
Xingyejingmi,tichondrius,576,druid,restoration,12,6,6
Nomilk,illidan,576,druid,restoration,12,6,6
Admoney,sargeras,576,druid,restoration,12,6,6
Smeekqtwo,tichondrius,576,druid,restoration,12,6,6
Fwaffle,bleeding-hollow,576,druid,restoration,12,6,6
Gemo,tichondrius,576,druid,restoration,12,6,6
Daddypompum,tichondrius,576,druid,restoration,12,6,6
Afkifuthrow,ysera,576,druid,restoration,12,6,6
Chinadruidss,tichondrius,576,druid,restoration,12,6,6
Tigd,alleria,576,druid,restoration,12,6,6
Larryjones,alleria,576,druid,restoration,12,6,6
Tricklein,tichondrius,576,druid,restoration,12,6,6
Krunks,frostmourne,576,druid,restoration,12,6,6
Torbock,zuljin,576,druid,restoration,12,6,6
Furrytorpedo,tichondrius,576,druid,restoration,12,6,6
Naturenugget,sargeras,576,druid,restoration,12,6,6
Bearys,area-52,576,druid,restoration,12,6,6
Dirtydrood,mugthol,576,druid,restoration,12,6,6
Connection,emerald-dream,576,druid,restoration,12,6,6
Hawtyforever,tichondrius,576,druid,restoration,18,6,12
Suublime,ragnaros,576,druid,restoration,18,6,12
Nodab,tichondrius,576,druid,restoration,18,6,12
Arútam,ragnaros,576,druid,restoration,18,6,12
Nerglet,aerie-peak,576,druid,restoration,24,6,18
Hottietottie,laughing-skull,576,druid,restoration,24,6,18
Polánd,area-52,575,druid,restoration,6,6,0
Gosch,stormrage,575,druid,restoration,12,6,6
Flôkey,tichondrius,575,druid,restoration,12,6,6
Noonoo,frostwolf,575,druid,restoration,12,6,6
Bamfferal,tichondrius,575,druid,restoration,12,6,6
Lahsa,tichondrius,575,druid,restoration,12,6,6
Clawandørder,tichondrius,575,druid,restoration,12,6,6
Cinderellax,illidan,575,druid,restoration,12,6,6
Velauris,sargeras,575,druid,restoration,12,6,6
Kokushe,burning-legion,575,druid,restoration,12,6,6
Nightnes,sargeras,575,druid,restoration,12,6,6
Weltherion,guldan,575,druid,restoration,12,6,6
Nrp,stormrage,575,druid,restoration,12,6,6
Jonoa,nagrand,575,druid,restoration,12,6,6
Birdie,dalvengyr,575,druid,restoration,13,6,7
Skullchief,barthilas,575,druid,restoration,16,7,9
Treynî,tichondrius,575,druid,restoration,18,6,12
Sleepypaws,silvermoon,575,druid,restoration,18,6,12
Aligantor,thrall,575,druid,restoration,18,6,12
Mithaelar,moon-guard,575,druid,restoration,18,6,12
Dýreðaguð,gurubashi,575,druid,restoration,18,6,12
Kendoboos,moon-guard,575,druid,restoration,24,6,18
Elpako,ragnaros,574,druid,restoration,6,6,0
Dibinha,azralon,574,druid,restoration,12,6,6
Carther,korgath,574,druid,restoration,12,6,6
Aranuir,emerald-dream,574,druid,restoration,18,6,12
Brisketmre,dalaran,574,druid,restoration,36,6,30
Lonewolfdrd,illidan,573,druid,restoration,6,6,0
Quagsire,moon-guard,573,druid,restoration,18,6,12
Ahlekleklekk,azralon,572,druid,restoration,12,6,6
Nightshiver,bleeding-hollow,572,druid,restoration,12,6,6
Dyfurion,stormrage,572,druid,restoration,12,6,6
Modification,eonar,572,druid,restoration,12,6,6
Kupaloidzki,proudmoore,571,druid,restoration,12,6,6
Bonemaul,bonechewer,571,druid,restoration,12,6,6
Kiraval,stormrage,571,druid,restoration,24,6,18
Aokseer,azralon,570,druid,restoration,12,6,6
Vdubz,blackrock,570,druid,restoration,12,6,6
Nordway,alexstrasza,569,druid,restoration,12,6,6
Naachocheeze,tichondrius,566,druid,restoration,12,6,6
Onyayo,barthilas,565,druid,restoration,12,6,6
Shalandrea,sargeras,552,druid,restoration,24,6,18
Lililililil,stormrage,552,druid,restoration,36,6,30
Istishiã,tichondrius,543,druid,restoration,14,7,7
Cudbacrakhed,tichondrius,541,druid,restoration,20,7,13
Isalien,kelthuzad,521,druid,restoration,21,7,14
Arthemisgodx,azralon,520,druid,restoration,17,10,7
Rakins,arthas,496,druid,restoration,13,6,7
Windù,azralon,488,druid,restoration,16,9,7
Sevend,tichondrius,480,druid,restoration,6,5,1
Dëmoníc,ragnaros,480,druid,restoration,6,5,1
Chaníng,frostmourne,480,druid,restoration,6,5,1
Kascatm,area-52,480,druid,restoration,6,5,1
Nersepha,gurubashi,480,druid,restoration,6,5,1
Jaspen,bleeding-hollow,480,druid,restoration,6,5,1
Treehealage,sargeras,480,druid,restoration,6,5,1
Floray,tichondrius,480,druid,restoration,6,5,1
Naakx,tichondrius,480,druid,restoration,6,5,1
Brëed,tichondrius,480,druid,restoration,6,5,1
Fanboy,magtheridon,480,druid,restoration,6,5,1
Hudada,emerald-dream,480,druid,restoration,12,5,7
Whìtewölf,emerald-dream,480,druid,restoration,12,5,7
Twentyfour,laughing-skull,480,druid,restoration,12,5,7
Pigdd,tichondrius,480,druid,restoration,12,5,7
Lookhowirun,emerald-dream,480,druid,restoration,12,5,7
Bobochi,tichondrius,480,druid,restoration,12,5,7
Amanthw,tichondrius,480,druid,restoration,12,5,7
Stamookee,area-52,480,druid,restoration,12,5,7
Lukass,tichondrius,480,druid,restoration,12,5,7
Shwayshift,bleeding-hollow,480,druid,restoration,12,5,7
Omelet,tichondrius,480,druid,restoration,12,5,7
Memoryleaks,proudmoore,480,druid,restoration,12,5,7
Stormjammer,proudmoore,480,druid,restoration,12,5,7
Ashstarfall,barthilas,480,druid,restoration,12,5,7
Hotgoal,frostmourne,480,druid,restoration,12,5,7
Suekeys,frostmourne,480,druid,restoration,12,5,7
Dalrei,jubeithos,480,druid,restoration,12,5,7
Shartah,zuljin,480,druid,restoration,12,5,7
Cokernut,tichondrius,480,druid,restoration,12,5,7
Jaydog,emerald-dream,480,druid,restoration,12,5,7
Liloudadru,tichondrius,480,druid,restoration,12,5,7
Stårrysky,illidan,480,druid,restoration,12,5,7
Greeneguy,thrall,480,druid,restoration,12,5,7
Yevenbother,tichondrius,480,druid,restoration,12,5,7
Moonfannia,malganis,480,druid,restoration,12,5,7
Tydruid,illidan,480,druid,restoration,12,5,7
Imlordgumper,illidan,480,druid,restoration,12,5,7
Mâckdâddy,kul-tiras,480,druid,restoration,12,5,7
Noah,altar-of-storms,480,druid,restoration,12,5,7
Teslabeam,illidan,480,druid,restoration,12,5,7
Afrogx,dalaran,480,druid,restoration,12,5,7
Finn,spinebreaker,480,druid,restoration,12,5,7
Zemul,ragnaros,480,druid,restoration,12,5,7
Tygraz,alleria,480,druid,restoration,12,5,7
Duckbillby,bleeding-hollow,480,druid,restoration,14,5,9
Guavajuice,stormrage,480,druid,restoration,16,5,11
Hgoo,tichondrius,480,druid,restoration,18,5,13
Djimbo,kelthuzad,480,druid,restoration,18,5,13
Blürry,area-52,480,druid,restoration,24,5,19
Spacaa,kelthuzad,480,druid,restoration,24,5,19
Treezy,dalaran,480,druid,restoration,24,5,19
Vacagalo,azralon,479,druid,restoration,6,5,1
Queiq,malganis,479,druid,restoration,6,5,1
Iiliith,moon-guard,479,druid,restoration,12,5,7
Sønèca,azralon,479,druid,restoration,12,5,7
Murkkd,tichondrius,479,druid,restoration,12,5,7
Ateoate,stormscale,479,druid,restoration,12,5,7
Mvqxd,tichondrius,479,druid,restoration,12,5,7
Forest,frostmourne,479,druid,restoration,12,5,7
Jamona,cenarius,479,druid,restoration,12,5,7
Sharialawl,stormreaver,479,druid,restoration,12,5,7
Olegoatjames,darkspear,478,druid,restoration,13,6,7
Treemendous,tichondrius,478,druid,restoration,12,5,7
Chupaone,dalaran,478,druid,restoration,12,5,7
Natruid,sargeras,478,druid,restoration,12,5,7
Fastafboy,stormrage,478,druid,restoration,12,5,7
Bloodyhoofs,malganis,478,druid,restoration,12,5,7
Rònaldò,drakthul,478,druid,restoration,12,5,7
Scheppke,bleeding-hollow,477,druid,restoration,12,5,7
Baha,azralon,477,druid,restoration,18,5,13
Wraiven,elune,477,druid,restoration,18,5,13
Swiftstrider,frostmourne,476,druid,restoration,10,6,4
Phlap,zuljin,476,druid,restoration,12,5,7
Kaldrago,detheroc,476,druid,restoration,12,5,7
Muphausa,area-52,475,druid,restoration,12,5,7
Bigox,area-52,475,druid,restoration,24,5,19
Vuthryx,tichondrius,472,druid,restoration,18,5,13
Bobruid,nagrand,469,druid,restoration,19,9,10
Maerk,aerie-peak,469,druid,restoration,18,5,13
Udroth,kelthuzad,468,druid,restoration,17,5,12
Xiaoddi,tichondrius,463,druid,restoration,11,5,6
Metaldruid,tichondrius,463,druid,restoration,11,5,6
Semangarbage,tichondrius,457,druid,restoration,15,8,7
Tofumation,gorgonnash,447,druid,restoration,14,6,8
Fuzzie,icecrown,447,druid,restoration,16,5,11
Morpheous,emerald-dream,444,druid,restoration,19,5,14
Bigelbows,area-52,432,druid,restoration,15,6,9
Qij,eonar,431,druid,restoration,11,5,6
Breezeys,tichondrius,426,druid,restoration,15,7,8
Nodeathz,sargeras,426,druid,restoration,17,6,11
Gankstababy,tichondrius,426,druid,restoration,20,6,14
Indicahigh,moon-guard,424,druid,restoration,16,7,9
Persiancoco,area-52,422,druid,restoration,14,6,8
Oongadunga,tichondrius,415,druid,restoration,14,5,9
Restokinaka,dreadmaul,384,druid,restoration,6,4,2
Dzone,tichondrius,384,druid,restoration,6,4,2
Nøbuchi,kelthuzad,384,druid,restoration,6,4,2
Shroomdealer,kelthuzad,384,druid,restoration,6,4,2
Kushkilla,malganis,384,druid,restoration,6,4,2
Zbh,tichondrius,384,druid,restoration,6,4,2
Bambi,bleeding-hollow,384,druid,restoration,6,4,2
Hottie,kelthuzad,384,druid,restoration,6,4,2
Lushÿ,tichondrius,384,druid,restoration,6,4,2
Armorkits,area-52,384,druid,restoration,6,4,2
Doomky,area-52,384,druid,restoration,6,4,2
Chyx,stormreaver,384,druid,restoration,6,4,2
Metaindexqt,quelthalas,384,druid,restoration,6,4,2
Glukhar,blackrock,384,druid,restoration,6,4,2
Crayolaa,barthilas,384,druid,restoration,6,4,2
Nbendtner,tichondrius,384,druid,restoration,6,4,2
Leomerchan,stormrage,384,druid,restoration,6,4,2
Êhurricane,dalaran,384,druid,restoration,6,4,2
Bunrack,nerzhul,384,druid,restoration,6,4,2
Jillferal,proudmoore,384,druid,restoration,6,4,2
Johnnybigg,frostmourne,384,druid,restoration,6,4,2
Cuzzidr,tichondrius,384,druid,restoration,6,4,2
Koan,proudmoore,384,druid,restoration,6,4,2
Starshípx,tichondrius,384,druid,restoration,6,4,2
Bearkîng,stormrage,384,druid,restoration,6,4,2
Peazoepico,tichondrius,384,druid,restoration,6,4,2
Someshta,sargeras,384,druid,restoration,6,4,2
Outcastmango,thrall,384,druid,restoration,6,4,2
Clarityx,illidan,384,druid,restoration,6,4,2
Lylek,azshara,384,druid,restoration,6,4,2
Druidlstrudl,moon-guard,384,druid,restoration,6,4,2
Shadru,bleeding-hollow,384,druid,restoration,12,4,8
Nocup,illidan,384,druid,restoration,12,4,8
Ursu,nemesis,384,druid,restoration,12,4,8
Chickenwings,ragnaros,384,druid,restoration,12,4,8
Figsurine,sargeras,384,druid,restoration,12,4,8
Ganizote,ragnaros,384,druid,restoration,12,4,8
Brittanychan,sargeras,384,druid,restoration,12,4,8
Ohioman,bleeding-hollow,384,druid,restoration,12,4,8
Feraldudu,illidan,384,druid,restoration,12,4,8
Flyshles,frostmourne,384,druid,restoration,12,4,8
Metaphysìcs,kelthuzad,384,druid,restoration,12,4,8
Py,stormscale,384,druid,restoration,12,4,8
Bumbally,illidan,384,druid,restoration,12,4,8
Thebutterboy,stormrage,384,druid,restoration,12,4,8
Bwaccowi,sargeras,384,druid,restoration,12,4,8
Lillenan,illidan,384,druid,restoration,12,4,8
Mé,arthas,384,druid,restoration,12,4,8
Synthesïs,malganis,384,druid,restoration,12,4,8
Eldertroll,boulderfist,384,druid,restoration,12,4,8
Hotrecki,kelthuzad,384,druid,restoration,12,4,8
Awguseon,proudmoore,384,druid,restoration,12,4,8
Odenmu,ragnaros,384,druid,restoration,12,4,8
Mastabtw,illidan,384,druid,restoration,12,4,8
Bigshred,tichondrius,384,druid,restoration,12,4,8
Stamaximdru,lightbringer,384,druid,restoration,12,4,8
Tommyjimmy,andorhal,384,druid,restoration,12,4,8
Bopple,tichondrius,384,druid,restoration,12,4,8
Mkat,illidan,384,druid,restoration,12,4,8
Mastahskills,illidan,384,druid,restoration,12,4,8
Flompstomper,skullcrusher,384,druid,restoration,12,4,8
Glenglooie,tichondrius,384,druid,restoration,12,4,8
Tarvosx,thrall,384,druid,restoration,18,4,14
Bryle,kiljaeden,383,druid,restoration,6,4,2
Calleguard,terenas,383,druid,restoration,6,4,2
Zelara,kilrogg,383,druid,restoration,12,4,8
Jonnyutaa,emerald-dream,383,druid,restoration,12,4,8
Posmard,ragnaros,383,druid,restoration,12,4,8
Pahrump,stormrage,383,druid,restoration,12,4,8
Hazbekbek,area-52,383,druid,restoration,12,4,8
Migdrail,nemesis,383,druid,restoration,12,4,8
Nightflow,emerald-dream,383,druid,restoration,12,4,8
Xay,runetotem,383,druid,restoration,12,4,8
Brazzar,kiljaeden,383,druid,restoration,12,4,8
Ssuka,tichondrius,383,druid,restoration,12,4,8
Rikey,thaurissan,383,druid,restoration,18,4,14
Morphiius,archimonde,383,druid,restoration,18,4,14
Madmandan,moon-guard,383,druid,restoration,18,4,14
Beôrn,mugthol,382,druid,restoration,6,4,2
Puzzlè,thrall,382,druid,restoration,12,4,8
Guojue,tichondrius,382,druid,restoration,12,4,8
Dytriax,ragnaros,381,druid,restoration,12,4,8
Maldrake,quelthalas,381,druid,restoration,12,4,8
Certzu,moon-guard,381,druid,restoration,18,4,14
Bigbadcow,sargeras,380,druid,restoration,12,4,8
Metamooseowl,crushridge,379,druid,restoration,12,4,8
Yassi,earthen-ring,379,druid,restoration,12,4,8
Breakthemm,bonechewer,379,druid,restoration,12,4,8
Salpicow,nagrand,379,druid,restoration,12,4,8
Nüg,frostmourne,379,druid,restoration,14,4,10
Reyvin,illidan,362,druid,restoration,20,6,14
Dashíng,proudmoore,348,druid,restoration,11,4,7
Alleae,stormrage,319,druid,restoration,5,4,1
Berchwunden,ragnaros,319,druid,restoration,10,4,6
Elendriss,quelthalas,304,druid,restoration,13,4,9
Realá,kelthuzad,288,druid,restoration,6,3,3
Vadroid,dalaran,288,druid,restoration,6,3,3
Hashdxm,tichondrius,288,druid,restoration,6,3,3
Reptile,terenas,288,druid,restoration,6,3,3
Spinach,moon-guard,288,druid,restoration,6,3,3
Asian,moon-guard,288,druid,restoration,6,3,3
Azaran,bleeding-hollow,288,druid,restoration,6,3,3
Koratan,frostmourne,288,druid,restoration,6,3,3
Wâggles,moon-guard,288,druid,restoration,6,3,3
Cutefeetz,moon-guard,288,druid,restoration,6,3,3
Panterarosa,ragnaros,288,druid,restoration,6,3,3
Mythicdruid,ragnaros,288,druid,restoration,6,3,3
Drmf,frostmourne,288,druid,restoration,6,3,3
Imaoo,illidan,288,druid,restoration,6,3,3
Hotwolf,tichondrius,288,druid,restoration,6,3,3
Sonicphantom,kelthuzad,288,druid,restoration,6,3,3
Obsesséd,aggramar,288,druid,restoration,6,3,3
Ømí,quelthalas,288,druid,restoration,6,3,3
Catahmine,thrall,288,druid,restoration,6,3,3
Mädnhairy,zuljin,288,druid,restoration,6,3,3
Tronita,frostwolf,288,druid,restoration,6,3,3
Vìdá,tichondrius,288,druid,restoration,6,3,3
Juicecarton,thrall,288,druid,restoration,6,3,3
Yllercia,quelthalas,288,druid,restoration,6,3,3
Thenog,arthas,288,druid,restoration,6,3,3
Menapäws,area-52,288,druid,restoration,6,3,3
Lðhnar,malganis,288,druid,restoration,6,3,3
Swagglefrag,zuljin,288,druid,restoration,6,3,3
Restokina,dreadmaul,288,druid,restoration,6,3,3
Oneinchclaw,malganis,288,druid,restoration,6,3,3
Antonniel,azralon,288,druid,restoration,6,3,3
Veyx,malganis,288,druid,restoration,6,3,3
Ðeepsixx,burning-legion,288,druid,restoration,6,3,3
Tarlis,khazgoroth,288,druid,restoration,6,3,3
Ayra,sargeras,288,druid,restoration,6,3,3
Hotmuztard,sargeras,288,druid,restoration,6,3,3
Càlthar,sargeras,288,druid,restoration,6,3,3
Seekamp,khazgoroth,288,druid,restoration,6,3,3
Nokash,tichondrius,288,druid,restoration,6,3,3
Naturetazerr,sargeras,288,druid,restoration,6,3,3
Qkdru,nemesis,288,druid,restoration,6,3,3
Buffjungle,tichondrius,288,druid,restoration,6,3,3
Gizho,sargeras,288,druid,restoration,6,3,3
Junglefevers,tichondrius,288,druid,restoration,6,3,3
Rdruid,zuluhed,288,druid,restoration,6,3,3
Lighthoof,mannoroth,288,druid,restoration,6,3,3
Owaru,stormrage,288,druid,restoration,6,3,3
Eryon,nemesis,288,druid,restoration,6,3,3
Wiskees,sargeras,288,druid,restoration,6,3,3
Flatnose,agamaggan,288,druid,restoration,6,3,3
Kcazz,thorium-brotherhood,288,druid,restoration,6,3,3
Creamsoda,frostmane,288,druid,restoration,6,3,3
Nightz,icecrown,288,druid,restoration,6,3,3
Geno,cenarius,288,druid,restoration,6,3,3
Kollective,sargeras,288,druid,restoration,6,3,3
Aidoh,kelthuzad,288,druid,restoration,6,3,3
Idolizeme,skullcrusher,288,druid,restoration,6,3,3
Xötic,stormrage,288,druid,restoration,6,3,3
Sneakiez,tichondrius,288,druid,restoration,6,3,3
Catdruid,the-forgotten-coast,288,druid,restoration,6,3,3
Tziv,area-52,288,druid,restoration,6,3,3
Ulfvur,nagrand,288,druid,restoration,6,3,3
Demitassie,wyrmrest-accord,288,druid,restoration,8,3,5
Overgrowth,zuljin,288,druid,restoration,9,3,6
Shiftydon,borean-tundra,288,druid,restoration,9,3,6
Brotø,nemesis,288,druid,restoration,12,3,9
Nuantar,nemesis,288,druid,restoration,12,3,9
Endworldx,tichondrius,288,druid,restoration,12,3,9
Nemoo,tichondrius,288,druid,restoration,12,3,9
Oflodor,azralon,288,druid,restoration,12,3,9
Sbc,anvilmar,288,druid,restoration,12,3,9
Fyrleaf,lightnings-blade,288,druid,restoration,12,3,9
Kitiano,thunderlord,288,druid,restoration,12,3,9
Solushuffle,sargeras,288,druid,restoration,12,3,9
Silasel,sargeras,288,druid,restoration,12,3,9
Blacksimba,area-52,288,druid,restoration,12,3,9
Soloqmenace,malganis,288,druid,restoration,12,3,9
Raptormotoo,lothar,288,druid,restoration,12,3,9
Borbys,sargeras,288,druid,restoration,12,3,9
Garrodan,aerie-peak,288,druid,restoration,12,3,9
Qdrui,tichondrius,288,druid,restoration,12,3,9
Krispies,eredar,288,druid,restoration,12,3,9
Wwkd,illidan,288,druid,restoration,12,3,9
Theblind,korgath,288,druid,restoration,12,3,9
Moobees,arthas,288,druid,restoration,12,3,9
Monicaduan,frostmourne,288,druid,restoration,12,3,9
Kanokoho,wyrmrest-accord,288,druid,restoration,12,3,9
Biggié,bleeding-hollow,288,druid,restoration,12,3,9
Quadrivium,stormrage,288,druid,restoration,12,3,9
Møth,anvilmar,288,druid,restoration,12,3,9
Azngødz,tichondrius,288,druid,restoration,12,3,9
Deyz,ysera,288,druid,restoration,12,3,9
Theømega,stormrage,288,druid,restoration,12,3,9
Mattiu,area-52,288,druid,restoration,12,3,9
Bøo,frostmourne,288,druid,restoration,12,3,9
Cleptoresto,dalaran,288,druid,restoration,15,3,12
Giddeonv,draenor,288,druid,restoration,18,3,15
Friendly,wyrmrest-accord,288,druid,restoration,18,3,15
Thundyrcat,tichondrius,288,druid,restoration,18,3,15
Ayakuya,veknilash,287,druid,restoration,6,3,3
Udala,durotan,287,druid,restoration,6,3,3
Ugress,whisperwind,287,druid,restoration,6,3,3
Glowstixz,tichondrius,287,druid,restoration,6,3,3
Anakum,azshara,287,druid,restoration,6,3,3
Sefestria,senjin,287,druid,restoration,6,3,3
Breakertime,illidan,287,druid,restoration,6,3,3
Budsmoke,stormrage,287,druid,restoration,6,3,3
Erourk,azralon,287,druid,restoration,6,3,3
Harderplease,emerald-dream,287,druid,restoration,6,3,3
Xkcc,perenolde,287,druid,restoration,6,3,3
Iamanoob,sargeras,287,druid,restoration,10,4,6
Vulgär,kiljaeden,287,druid,restoration,12,3,9
Lêsly,thrall,287,druid,restoration,12,3,9
Atillah,stormscale,287,druid,restoration,12,3,9
Megara,dalaran,287,druid,restoration,12,3,9
Druishcat,dark-iron,287,druid,restoration,12,3,9
Greythan,madoran,287,druid,restoration,18,3,15
Cieran,senjin,287,druid,restoration,18,3,15
Bullshiftter,ursin,286,druid,restoration,6,3,3
Dcdc,malganis,286,druid,restoration,6,3,3
Fortunecat,illidan,286,druid,restoration,12,3,9
Sabari,area-52,285,druid,restoration,18,3,15
Anastasyiar,illidan,256,druid,restoration,10,3,7
Gloomy,andorhal,256,druid,restoration,10,3,7
Cipozento,azralon,240,druid,restoration,9,3,6
Bbabbi,tichondrius,239,druid,restoration,5,3,2
Awkwarder,emerald-dream,239,druid,restoration,11,3,8
Yoona,kiljaeden,234,druid,restoration,7,4,3
Opiumheals,sargeras,234,druid,restoration,8,4,4
Restyblazed,sargeras,234,druid,restoration,8,4,4
Donaldsr,area-52,234,druid,restoration,9,4,5
Stormwood,moonrunner,234,druid,restoration,21,4,17
Stèvén,tichondrius,233,druid,restoration,13,4,9
Gavdru,tichondrius,223,druid,restoration,8,3,5
Blackmoomba,kiljaeden,192,druid,restoration,4,3,1
Faentz,stormrage,192,druid,restoration,9,3,6
Haful,emerald-dream,192,druid,restoration,6,2,4
Firefireahh,sargeras,192,druid,restoration,6,2,4
Mojoforweeks,bleeding-hollow,192,druid,restoration,6,2,4
Crazywoodowl,tichondrius,192,druid,restoration,6,2,4
Snugglin,kelthuzad,192,druid,restoration,6,2,4
Cauroth,azralon,192,druid,restoration,6,2,4
Batshi,gorefiend,192,druid,restoration,6,2,4
Ghostti,stormrage,192,druid,restoration,6,2,4
Tadoo,tichondrius,192,druid,restoration,6,2,4
Lilcocoxoxo,shadowmoon,192,druid,restoration,6,2,4
Tropikana,burning-legion,192,druid,restoration,6,2,4
Psycloned,magtheridon,192,druid,restoration,6,2,4
Droody,earthen-ring,192,druid,restoration,6,2,4
Netflixnphil,sargeras,192,druid,restoration,6,2,4
Pawpa,daggerspine,192,druid,restoration,6,2,4
Fastyhands,illidan,192,druid,restoration,6,2,4
Kaisuckslol,stormrage,192,druid,restoration,6,2,4
Hawtzi,stormrage,192,druid,restoration,6,2,4
Bigtonkatruk,tichondrius,192,druid,restoration,6,2,4
Gorfrog,tichondrius,192,druid,restoration,6,2,4
Freemac,tichondrius,192,druid,restoration,6,2,4
Sandiegoo,destromath,192,druid,restoration,6,2,4
Clonkzy,area-52,192,druid,restoration,6,2,4
Runningback,emerald-dream,192,druid,restoration,6,2,4
Akinetic,illidan,192,druid,restoration,6,2,4
Krisdu,kelthuzad,192,druid,restoration,6,2,4
Tatahe,zuljin,192,druid,restoration,6,2,4
Fixn,tichondrius,192,druid,restoration,6,2,4
Hatricio,ragnaros,192,druid,restoration,6,2,4
Mcbeef,tichondrius,192,druid,restoration,6,2,4
Nogardfan,tichondrius,192,druid,restoration,6,2,4
Gepardéx,ragnaros,192,druid,restoration,6,2,4
Ambassador,kelthuzad,192,druid,restoration,6,2,4
Chopotron,ragnaros,192,druid,restoration,6,2,4
Terminatore,kelthuzad,192,druid,restoration,6,2,4
Violyte,tichondrius,192,druid,restoration,6,2,4
Megasteak,lightninghoof,192,druid,restoration,6,2,4
Acexten,tichondrius,192,druid,restoration,6,2,4
Bekroh,crushridge,192,druid,restoration,6,2,4
Cultnelf,illidan,192,druid,restoration,6,2,4
Noonwalk,illidan,192,druid,restoration,6,2,4
Tynsley,malganis,192,druid,restoration,6,2,4
Cushionmaker,tichondrius,192,druid,restoration,6,2,4
Bomp,malganis,192,druid,restoration,6,2,4
Uniquexia,tichondrius,192,druid,restoration,6,2,4
Loveflowers,nemesis,192,druid,restoration,6,2,4
Nacur,bleeding-hollow,192,druid,restoration,6,2,4
Minisavage,proudmoore,192,druid,restoration,6,2,4
Niquil,hyjal,192,druid,restoration,6,2,4
Levincy,thrall,192,druid,restoration,6,2,4
Whiplash,deathwing,192,druid,restoration,6,2,4
Hydruidponic,aegwynn,192,druid,restoration,6,2,4
Five,the-underbog,192,druid,restoration,6,2,4
Loved,stormrage,192,druid,restoration,6,2,4
Fracxx,area-52,192,druid,restoration,6,2,4
Barkcheeks,area-52,192,druid,restoration,6,2,4
Relxlol,tichondrius,192,druid,restoration,6,2,4
Dumpesito,frostmourne,192,druid,restoration,6,2,4
Bullbuddy,wyrmrest-accord,192,druid,restoration,6,2,4
Epicbehr,kiljaeden,192,druid,restoration,6,2,4
Tempesd,stormrage,192,druid,restoration,6,2,4
Zaddychulo,area-52,192,druid,restoration,6,2,4
Kroshape,stormrage,192,druid,restoration,6,2,4
Gretatunberg,skywall,192,druid,restoration,6,2,4
Nightwinter,area-52,192,druid,restoration,6,2,4
Zils,bleeding-hollow,192,druid,restoration,6,2,4
Owlgz,barthilas,192,druid,restoration,6,2,4
Murpheey,sargeras,192,druid,restoration,6,2,4
Kagekuma,bleeding-hollow,192,druid,restoration,6,2,4
Spoogel,area-52,192,druid,restoration,6,2,4
Feeoria,lothar,192,druid,restoration,6,2,4
Simperella,dalaran,192,druid,restoration,13,3,10
Hotsx,frostmourne,192,druid,restoration,9,2,7
Sleepyheals,tichondrius,192,druid,restoration,14,3,11
Gradiluth,proudmoore,192,druid,restoration,12,2,10
Urhero,sargeras,192,druid,restoration,12,2,10
Kymolyia,sargeras,192,druid,restoration,12,2,10
Enyu,sargeras,192,druid,restoration,12,2,10
Batlex,thrall,192,druid,restoration,12,2,10
Killvious,kelthuzad,192,druid,restoration,12,2,10
Pinchncheeks,bleeding-hollow,192,druid,restoration,12,2,10
Loganski,korialstrasz,192,druid,restoration,12,2,10
Iyrnae,zuljin,192,druid,restoration,12,2,10
Moocka,ragnaros,192,druid,restoration,12,2,10
Moonkay,tichondrius,192,druid,restoration,12,2,10
Daesdaddy,sargeras,192,druid,restoration,12,2,10
Aelena,whisperwind,192,druid,restoration,12,2,10
Grullandur,hakkar,192,druid,restoration,12,2,10
Gahr,wyrmrest-accord,192,druid,restoration,12,2,10
Kittysnuggle,emerald-dream,192,druid,restoration,12,2,10
Rootslayer,tichondrius,192,druid,restoration,12,2,10
Duckyy,garithos,192,druid,restoration,12,2,10
Fribbleog,korgath,192,druid,restoration,12,2,10
Crunchieroll,illidan,192,druid,restoration,12,2,10
Trèè,frostmane,192,druid,restoration,12,2,10
Bboikha,quelthalas,192,druid,restoration,12,2,10
Elven,frostmourne,192,druid,restoration,12,2,10
Ddizz,cairne,192,druid,restoration,12,2,10
Lunmoon,thrall,192,druid,restoration,12,2,10
Goorybud,tichondrius,192,druid,restoration,12,2,10
Wonderhood,quelthalas,192,druid,restoration,12,2,10
Bennedïct,tichondrius,192,druid,restoration,12,2,10
Cpksdru,tichondrius,192,druid,restoration,12,2,10
Devilzown,fenris,192,druid,restoration,18,2,16
Çarpentree,sargeras,192,druid,restoration,18,2,16
Brutalhealz,aegwynn,192,druid,restoration,18,2,16
Clonemunster,frostmourne,192,druid,restoration,18,2,16
Irontree,dunemaul,192,druid,restoration,18,2,16
Moonkinx,frostwolf,191,druid,restoration,6,2,4
Daweed,zuluhed,191,druid,restoration,12,2,10
Voodooshiftz,emerald-dream,191,druid,restoration,12,2,10
Äbÿss,tichondrius,191,druid,restoration,12,2,10
Calliecat,moon-guard,191,druid,restoration,12,2,10
Wantto,moknathal,190,druid,restoration,12,2,10
Garritass,moon-guard,189,druid,restoration,29,2,27
Dreamwalk,stormrage,175,druid,restoration,17,3,14
Brbcatsonfir,malganis,175,druid,restoration,22,3,19
Pvptactician,tichondrius,159,druid,restoration,11,4,7
Jeppcat,tichondrius,159,druid,restoration,14,3,11
Frenzymoon,zuljin,144,druid,restoration,3,3,0
Pokieoaks,zuljin,138,druid,restoration,10,3,7
Galind,rexxar,128,druid,restoration,4,2,2
Alshari,proudmoore,128,druid,restoration,10,2,8
Crunkk,thunderlord,127,druid,restoration,14,2,12
Nohkotana,illidan,96,druid,restoration,3,2,1
Forestmaster,area-52,96,druid,restoration,8,2,6
Arienne,kelthuzad,96,druid,restoration,6,1,5
Moonshocka,tichondrius,96,druid,restoration,6,1,5
Arthridas,wyrmrest-accord,96,druid,restoration,6,1,5
Feralgo,tichondrius,96,druid,restoration,6,1,5
Rakroz,emerald-dream,96,druid,restoration,6,1,5
Whitehaze,proudmoore,96,druid,restoration,6,1,5
Leoho,tichondrius,96,druid,restoration,6,1,5
Guap,bleeding-hollow,96,druid,restoration,6,1,5
Inblooms,blackhand,96,druid,restoration,6,1,5
Zabartak,lightnings-blade,96,druid,restoration,6,1,5
Zeelán,emerald-dream,96,druid,restoration,6,1,5
Macfluff,emerald-dream,96,druid,restoration,6,1,5
Atagoo,tichondrius,96,druid,restoration,6,1,5
Beldiin,khazgoroth,96,druid,restoration,6,1,5
Ryhighd,sargeras,96,druid,restoration,6,1,5
Ayla,gorefiend,96,druid,restoration,6,1,5
Fartsicle,lightnings-blade,96,druid,restoration,6,1,5
Jammi,skywall,96,druid,restoration,6,1,5
Mollytonasty,demon-soul,96,druid,restoration,6,1,5
Lokobah,wyrmrest-accord,96,druid,restoration,6,1,5
Hille,sargeras,96,druid,restoration,6,1,5
Samully,area-52,96,druid,restoration,6,1,5
Mandingodam,auchindoun,96,druid,restoration,6,1,5
Dotdmage,tichondrius,96,druid,restoration,6,1,5
Botdruid,hyjal,96,druid,restoration,6,1,5
Ðjx,stormrage,96,druid,restoration,6,1,5
Ånxiety,skullcrusher,96,druid,restoration,6,1,5
Kurzul,area-52,96,druid,restoration,6,1,5
Tyrander,tichondrius,96,druid,restoration,6,1,5
Sinistuhd,tichondrius,96,druid,restoration,6,1,5
Djsummer,tichondrius,96,druid,restoration,6,1,5
Hadoriss,kelthuzad,96,druid,restoration,6,1,5
Rezl,sargeras,96,druid,restoration,6,1,5
Fadingfast,frostmourne,96,druid,restoration,6,1,5
Raìñ,tichondrius,96,druid,restoration,6,1,5
Wrathmighty,frostmourne,96,druid,restoration,6,1,5
Wotermelon,moon-guard,96,druid,restoration,6,1,5
Jayto,frostmourne,96,druid,restoration,6,1,5
Moocowbear,illidan,96,druid,restoration,6,1,5
Suncintus,aggramar,96,druid,restoration,6,1,5
Framess,area-52,96,druid,restoration,6,1,5
Juves,frostmourne,96,druid,restoration,6,1,5
Aimafengari,emerald-dream,96,druid,restoration,6,1,5
Ttaure,ragnaros,96,druid,restoration,6,1,5
Nìck,the-scryers,96,druid,restoration,6,1,5
Chomperz,tichondrius,96,druid,restoration,6,1,5
Kzdubya,stormrage,96,druid,restoration,6,1,5
Solá,skywall,96,druid,restoration,6,1,5
Moonfart,zuljin,96,druid,restoration,6,1,5
Natürëblÿät,illidan,96,druid,restoration,6,1,5
Moonkingx,ragnaros,96,druid,restoration,6,1,5
Stephonxd,area-52,96,druid,restoration,6,1,5
Keithmoonkin,area-52,96,druid,restoration,6,1,5
Gruulnir,antonidas,96,druid,restoration,6,1,5
Spatulas,malganis,96,druid,restoration,6,1,5
Caminanube,quelthalas,96,druid,restoration,6,1,5
Rastakant,malganis,96,druid,restoration,6,1,5
Dedderita,bloodhoof,96,druid,restoration,6,1,5
Nyanncat,frostmourne,96,druid,restoration,7,1,6
Lirilith,shadowsong,96,druid,restoration,16,2,14
Shebleeder,aegwynn,96,druid,restoration,11,1,10
Foracus,sargeras,96,druid,restoration,11,1,10
Kaeliah,stormrage,96,druid,restoration,12,1,11
Kopidruid,barthilas,96,druid,restoration,12,1,11
Sinigang,duskwood,96,druid,restoration,12,1,11
Lacarne,tichondrius,96,druid,restoration,12,1,11
Morpheûs,bleeding-hollow,96,druid,restoration,12,1,11
Thorsèn,sargeras,96,druid,restoration,15,1,14
Grakzul,blood-furnace,95,druid,restoration,9,2,7
Eliteshift,frostmourne,64,druid,restoration,4,1,3
Pownage,kelthuzad,64,druid,restoration,16,1,15
Smorak,area-52,63,druid,restoration,2,2,0
Bòmi,tichondrius,63,druid,restoration,2,2,0
Suwonhealer,tichondrius,31,druid,restoration,8,1,7
Neferpitou,fenris,16,druid,restoration,6,1,5
Landro,tichondrius,1433,druid,guardian,101,50,51
Haalls,gallywix,1107,druid,guardian,36,12,24
Crashägásm,proudmoore,1062,druid,guardian,30,15,15
Kesagake,feathermoon,921,druid,guardian,18,10,8
Maraliss,shadowsong,890,druid,guardian,24,12,12
Ashamang,emerald-dream,855,druid,guardian,12,9,3
Mordu,rivendare,838,druid,guardian,25,9,16
Inxert,tichondrius,792,druid,guardian,16,9,7
Koan,proudmoore,671,druid,guardian,24,7,17
Jacinty,saurfang,670,druid,guardian,18,7,11
Multivar,burning-legion,669,druid,guardian,12,7,5
Theme,frostwolf,669,druid,guardian,18,7,11
Agmukar,wyrmrest-accord,659,druid,guardian,12,7,5
Lycanthus,thrall,575,druid,guardian,12,6,6
Ishiftalot,bleeding-hollow,573,druid,guardian,15,7,8
Bjørnen,thrall,570,druid,guardian,12,6,6
Giddeonv,draenor,570,druid,guardian,12,6,6
Dalidielor,dalaran,480,druid,guardian,12,5,7
Chärmin,area-52,479,druid,guardian,12,5,7
Gifteddream,zuljin,474,druid,guardian,12,5,7
Balanah,quelthalas,472,druid,guardian,15,6,9
Maen,kelthuzad,384,druid,guardian,6,4,2
Bigxworm,gurubashi,384,druid,guardian,12,4,8
Wraithman,madoran,383,druid,guardian,6,4,2
Firash,frostmourne,382,druid,guardian,6,4,2
Aìón,emerald-dream,382,druid,guardian,6,4,2
Tankbareass,aerie-peak,382,druid,guardian,18,4,14
Read,boulderfist,288,druid,guardian,12,3,9
Woozydruid,anetheron,288,druid,guardian,12,3,9
Manwool,illidan,288,druid,guardian,12,3,9
Cayinna,altar-of-storms,288,druid,guardian,12,3,9
Deutschland,whisperwind,288,druid,guardian,12,3,9
Mavren,uldaman,286,druid,guardian,6,3,3
Classykitty,tichondrius,192,druid,guardian,4,3,1
Skrimshaw,burning-legion,192,druid,guardian,6,2,4
Athious,moon-guard,192,druid,guardian,6,2,4
Mommyh,duskwood,192,druid,guardian,6,2,4
Lilgushy,area-52,192,druid,guardian,6,2,4
Avbox,proudmoore,192,druid,guardian,6,2,4
Fluff,gurubashi,192,druid,guardian,6,2,4
Battlecát,stormscale,192,druid,guardian,6,2,4
Manasmi,frostmourne,191,druid,guardian,6,2,4
Meliódás,area-52,191,druid,guardian,18,2,16
Gornish,azralon,190,druid,guardian,12,2,10
Kushtiger,ragnaros,96,druid,guardian,6,1,5
Drur,zuljin,96,druid,guardian,6,1,5
Agaxaido,azgalor,96,druid,guardian,6,1,5
Sixfeetunder,shattered-halls,96,druid,guardian,6,1,5
Wintarz,sargeras,96,druid,guardian,6,1,5
Funkbear,black-dragonflight,96,druid,guardian,6,1,5
Vindecca,kelthuzad,96,druid,guardian,6,1,5
Aurno,queldorei,96,druid,guardian,6,1,5
Woowis,stormrage,96,druid,guardian,12,1,11
Vineclaw,emerald-dream,96,druid,guardian,12,1,11
Kylysea,dalaran,96,druid,guardian,12,1,11
Lakroz,zuljin,95,druid,guardian,6,1,5
Sitruk,uldum,63,druid,guardian,10,1,9
Bawbe,lightbringer,2202,druid,feral,89,51,38
Marvin,stormreaver,2201,druid,feral,94,49,45
Loser,stormrage,2155,druid,feral,87,46,41
Nyç,sargeras,2139,druid,feral,216,116,100
Angryalyu,tichondrius,2133,druid,feral,90,45,45
Auntsusie,stormrage,2128,druid,feral,95,61,34
Iinkinbio,alleria,2124,druid,feral,84,50,34
Crunchyroll,sargeras,2100,druid,feral,162,87,75
Formrage,jubeithos,2097,druid,feral,206,108,98
Boomboombom,tichondrius,2054,druid,feral,119,72,47
Jaguar,whisperwind,2041,druid,feral,66,39,27
Floppa,whisperwind,2026,druid,feral,72,39,33
Henikbite,zuljin,2018,druid,feral,125,65,60
Beomjun,tichondrius,2009,druid,feral,101,57,44
Yüxy,sargeras,2002,druid,feral,120,56,64
Boomboomboom,misha,1986,druid,feral,93,47,46
Amellies,quelthalas,1980,druid,feral,184,98,86
Abstractf,sargeras,1972,druid,feral,74,44,30
Trìckyz,tichondrius,1965,druid,feral,116,61,55
Babekisser,stormrage,1961,druid,feral,130,69,61
Vinjo,ragnaros,1955,druid,feral,90,42,48
Pdfilewatch,stormrage,1943,druid,feral,42,30,12
Duhfective,proudmoore,1942,druid,feral,59,32,27
Feeg,sargeras,1937,druid,feral,65,33,32
Chowxx,tichondrius,1937,druid,feral,90,43,47
Cliodhna,kelthuzad,1914,druid,feral,78,40,38
Alleae,stormrage,1908,druid,feral,54,32,22
Skrambles,mugthol,1906,druid,feral,75,36,39
Fappywapple,kiljaeden,1899,druid,feral,118,58,60
Samuel,ravencrest,1897,druid,feral,60,33,27
Floorz,firetree,1895,druid,feral,42,23,19
Ripbot,sargeras,1894,druid,feral,59,31,28
Duzis,tichondrius,1887,druid,feral,48,28,20
Bassy,whisperwind,1885,druid,feral,70,31,39
Porkonmyfork,frostmourne,1870,druid,feral,40,24,16
Astrozxy,sargeras,1860,druid,feral,42,23,19
Darmari,quelthalas,1852,druid,feral,60,27,33
Rwhatkr,tichondrius,1847,druid,feral,47,20,27
Kynvi,moon-guard,1846,druid,feral,48,24,24
Sammy,scilla,1842,druid,feral,84,40,44
Lesliewj,proudmoore,1840,druid,feral,65,35,30
Tyxi,bleeding-hollow,1839,druid,feral,46,31,15
Yukjr,stormrage,1839,druid,feral,137,66,71
Yayue,tichondrius,1830,druid,feral,72,37,35
Bpdferal,stormrage,1828,druid,feral,180,99,81
Russiaguy,area-52,1826,druid,feral,271,141,130
Porkloafed,illidan,1824,druid,feral,94,53,41
Sappora,illidan,1824,druid,feral,178,92,86
Feignxd,emerald-dream,1823,druid,feral,60,43,17
Nuadris,azralon,1822,druid,feral,168,86,82
Chrye,tichondrius,1820,druid,feral,69,35,34
Calikonger,spirestone,1819,druid,feral,48,23,25
Kakaroot,tichondrius,1813,druid,feral,153,78,75
Hugecat,tichondrius,1812,druid,feral,60,26,34
Stellar,steamwheedle-cartel,1808,druid,feral,114,54,60
Ërebüs,emerald-dream,1802,druid,feral,47,22,25
Notapn,tichondrius,1786,druid,feral,78,40,38
Zuljor,sargeras,1784,druid,feral,24,19,5
Icespicè,tichondrius,1772,druid,feral,84,38,46
Killuf,quelthalas,1767,druid,feral,95,35,60
Proudfurryxo,dragonmaw,1765,druid,feral,50,27,23
Kobez,bleeding-hollow,1748,druid,feral,84,46,38
Lemön,frostmourne,1745,druid,feral,42,21,21
Vebee,frostmourne,1744,druid,feral,53,29,24
Mhdd,tichondrius,1739,druid,feral,66,38,28
Tyx,bleeding-hollow,1736,druid,feral,62,28,34
Extic,sargeras,1730,druid,feral,66,38,28
Blrr,sargeras,1730,druid,feral,60,28,32
Fangry,queldorei,1725,druid,feral,106,57,49
Fliip,barthilas,1711,druid,feral,53,27,26
Addymeow,drenden,1709,druid,feral,54,30,24
Thycamore,cenarius,1708,druid,feral,60,23,37
Bearoids,daggerspine,1706,druid,feral,42,29,13
Oroskii,bleeding-hollow,1705,druid,feral,60,31,29
Yavà,tichondrius,1700,druid,feral,48,30,18
Kolbie,emerald-dream,1699,druid,feral,107,59,48
Mocfernando,sargeras,1698,druid,feral,42,23,19
Cjæ,bleeding-hollow,1693,druid,feral,40,26,14
Dahmu,malygos,1691,druid,feral,180,98,82
Turow,firetree,1690,druid,feral,53,25,28
Wildfire,nesingwary,1686,druid,feral,105,55,50
Nicó,darkspear,1686,druid,feral,105,49,56
Nrp,stormrage,1684,druid,feral,108,44,64
Flowkie,illidan,1683,druid,feral,110,55,55
Raincloud,mannoroth,1680,druid,feral,36,22,14
Nitetree,thrall,1679,druid,feral,60,31,29
Akanx,tichondrius,1677,druid,feral,36,21,15
Hriiya,tichondrius,1676,druid,feral,47,18,29
Luvgames,area-52,1673,druid,feral,76,41,35
Lycanthrøpe,moon-guard,1672,druid,feral,80,35,45
Bearlylegalz,kelthuzad,1671,druid,feral,48,23,25
Dewfuss,tichondrius,1669,druid,feral,54,31,23
Tenavï,stormrage,1668,druid,feral,42,20,22
Redhotbean,tichondrius,1665,druid,feral,40,23,17
Anxietyburns,stormrage,1660,druid,feral,66,40,26
Plux,illidan,1658,druid,feral,162,88,74
Brewdock,boulderfist,1656,druid,feral,45,21,24
Chasertv,tichondrius,1650,druid,feral,36,19,17
Zlegacy,anvilmar,1650,druid,feral,54,21,33
Jpegcollectr,tichondrius,1649,druid,feral,66,23,43
Kyoski,moon-guard,1645,druid,feral,34,19,15
Unfriendly,bleeding-hollow,1644,druid,feral,113,62,51
Kibbens,area-52,1643,druid,feral,196,98,98
Bhen,tichondrius,1643,druid,feral,42,19,23
Zirrie,stormrage,1640,druid,feral,44,25,19
Ferar,frostmourne,1640,druid,feral,59,28,31
Tompunch,tichondrius,1640,druid,feral,61,28,33
Lucky,destromath,1638,druid,feral,150,71,79
Bigbite,tichondrius,1637,druid,feral,48,27,21
Xyphor,bladefist,1637,druid,feral,40,22,18
Yavann,tichondrius,1636,druid,feral,106,58,48
Meanbear,stormrage,1633,druid,feral,42,23,19
Erykk,dalaran,1631,druid,feral,54,23,31
Atrumn,emerald-dream,1631,druid,feral,78,33,45
Evildooer,stormrage,1630,druid,feral,30,17,13
Grizzlepaw,tichondrius,1628,druid,feral,81,46,35
Foxmeowz,blackwater-raiders,1627,druid,feral,36,20,16
Jazzxs,proudmoore,1627,druid,feral,36,18,18
Off,ravencrest,1622,druid,feral,172,86,86
Phøënîx,tichondrius,1622,druid,feral,36,17,19
Cracked,vashj,1621,druid,feral,34,21,13
Gabdruid,kiljaeden,1621,druid,feral,48,23,25
Zyhsul,emerald-dream,1620,druid,feral,42,21,21
Fuqet,kelthuzad,1620,druid,feral,111,52,59
Durwyn,sargeras,1620,druid,feral,153,71,82
Sïmba,andorhal,1619,druid,feral,65,26,39
Enya,stormreaver,1618,druid,feral,66,31,35
Hiddenfur,ragnaros,1617,druid,feral,36,19,17
Poosnickety,kelthuzad,1617,druid,feral,49,21,28
Wøs,area-52,1615,druid,feral,98,50,48
Kdrumania,tichondrius,1614,druid,feral,152,83,69
Zenlonn,emerald-dream,1614,druid,feral,41,19,22
Nobruh,sargeras,1608,druid,feral,89,43,46
Melez,kelthuzad,1607,druid,feral,157,82,75
Chococrispis,quelthalas,1606,druid,feral,48,21,27
Linkinbiox,alleria,1603,druid,feral,36,19,17
Stêff,zuljin,1602,druid,feral,66,33,33
Oldtomcat,moon-guard,1601,druid,feral,90,42,48
Zwaski,thrall,1601,druid,feral,74,34,40
Feralgo,tichondrius,1600,druid,feral,30,17,13
Akamu,nemesis,1600,druid,feral,48,17,31
Irontree,dunemaul,1598,druid,feral,48,23,25
Ursarius,skullcrusher,1590,druid,feral,53,25,28
Rank,nerzhul,1588,druid,feral,126,59,67
Azrethyu,emerald-dream,1578,druid,feral,66,28,38
Jaspurr,illidan,1574,druid,feral,60,33,27
Conker,frostmourne,1572,druid,feral,126,63,63
Skyde,sargeras,1571,druid,feral,93,42,51
Franksuba,windrunner,1568,druid,feral,108,53,55
Csinii,bleeding-hollow,1566,druid,feral,48,18,30
Idiotferal,tortheldrin,1564,druid,feral,30,19,11
Slanue,tichondrius,1556,druid,feral,64,26,38
Rokaizu,dalaran,1555,druid,feral,36,17,19
Kwilli,tichondrius,1552,druid,feral,56,29,27
Darkombra,frostmourne,1548,druid,feral,54,27,27
Sugarbawls,area-52,1546,druid,feral,66,32,34
Kaisuckslol,stormrage,1543,druid,feral,150,76,74
Fendiy,barthilas,1539,druid,feral,72,40,32
Rahxay,quelthalas,1539,druid,feral,71,32,39
Jonio,tichondrius,1539,druid,feral,71,30,41
Mxdi,tichondrius,1535,druid,feral,36,19,17
Fyrkax,sargeras,1534,druid,feral,24,16,8
Delorík,illidan,1534,druid,feral,66,32,34
Waggs,illidan,1532,druid,feral,36,16,20
Amishal,stormrage,1529,druid,feral,54,19,35
Cawkaw,frostwolf,1528,druid,feral,122,62,60
Xanybarz,stormrage,1528,druid,feral,107,50,57
Jizzie,tichondrius,1527,druid,feral,90,52,38
Shreds,kirin-tor,1522,druid,feral,48,16,32
Ulcera,nemesis,1520,druid,feral,48,30,18
Senex,stormrage,1518,druid,feral,100,60,40
Ikkarus,nemesis,1515,druid,feral,107,57,50
Cätwälk,gnomeregan,1511,druid,feral,36,16,20
Lakunahof,ragnaros,1510,druid,feral,33,17,16
Hellodan,proudmoore,1509,druid,feral,60,26,34
Kushtiger,ragnaros,1508,druid,feral,102,52,50
Goldferal,illidan,1505,druid,feral,24,18,6
Prowli,tichondrius,1505,druid,feral,128,69,59
Swolareclips,eitrigg,1498,druid,feral,156,75,81
Tree,lothar,1497,druid,feral,48,29,19
Gregondor,skullcrusher,1490,druid,feral,30,16,14
Bênî,emerald-dream,1489,druid,feral,114,57,57
Ozex,crushridge,1484,druid,feral,42,17,25
Dimsump,zuljin,1483,druid,feral,48,16,32
Luluid,tichondrius,1481,druid,feral,65,30,35
Revcow,malganis,1477,druid,feral,42,21,21
Faelonk,frostmourne,1476,druid,feral,66,32,34
Weedsmuggler,burning-legion,1471,druid,feral,179,91,88
Duckystryker,tichondrius,1470,druid,feral,54,21,33
Prêdator,ragnaros,1467,druid,feral,119,63,56
Roots,anubarak,1466,druid,feral,63,36,27
Eletto,stormrage,1466,druid,feral,48,25,23
Oreganic,barthilas,1464,druid,feral,93,48,45
Dillywadz,tichondrius,1463,druid,feral,158,72,86
Zivak,azshara,1460,druid,feral,66,32,34
Hoffhoff,area-52,1458,druid,feral,36,22,14
Blut,stormrage,1458,druid,feral,186,89,97
Malfurionsto,moon-guard,1458,druid,feral,42,16,26
Jurasico,ragnaros,1456,druid,feral,221,110,111
Badferal,blackhand,1455,druid,feral,78,38,40
Erwelz,quelthalas,1455,druid,feral,41,19,22
Sheeyts,tichondrius,1453,druid,feral,72,37,35
Bossdru,sargeras,1447,druid,feral,47,28,19
Chomperz,tichondrius,1442,druid,feral,85,45,40
Prille,tichondrius,1438,druid,feral,33,16,17
Dobromar,quelthalas,1435,druid,feral,18,15,3
Käïïjü,tichondrius,1432,druid,feral,76,28,48
Milkmoneymeo,illidan,1431,druid,feral,30,15,15
Classydruid,spinebreaker,1431,druid,feral,84,39,45
Feond,illidan,1430,druid,feral,94,49,45
Bukybuky,tichondrius,1429,druid,feral,48,26,22
Canlexd,moon-guard,1429,druid,feral,42,20,22
Wowgamer,sargeras,1427,druid,feral,24,15,9
Hööper,illidan,1427,druid,feral,54,19,35
Shiftalk,nerzhul,1422,druid,feral,42,18,24
Galind,rexxar,1421,druid,feral,28,18,10
Fugekî,zuljin,1420,druid,feral,41,24,17
Kaissara,nemesis,1420,druid,feral,32,17,15
Bobmarli,kiljaeden,1420,druid,feral,30,15,15
Ocêanus,sargeras,1417,druid,feral,18,15,3
Treespec,stormrage,1414,druid,feral,29,18,11
Bullcritzz,saurfang,1413,druid,feral,88,50,38
Gairen,the-venture-co,1413,druid,feral,48,25,23
Neetform,zuljin,1413,druid,feral,65,30,35
Muwudred,stormrage,1410,druid,feral,36,15,21
Clarice,shattered-halls,1409,druid,feral,24,15,9
Traxxo,tichondrius,1407,druid,feral,42,17,25
Sweetxtooth,area-52,1403,druid,feral,81,43,38
Flowke,illidan,1401,druid,feral,32,16,16
Swornenemy,mugthol,1399,druid,feral,30,18,12
Snowfaerie,moon-guard,1399,druid,feral,356,186,170
Chitára,ragnaros,1399,druid,feral,130,67,63
Gonjatusk,ravencrest,1397,druid,feral,54,30,24
Freinnar,kiljaeden,1393,druid,feral,36,15,21
Ytgamezoned,darkspear,1390,druid,feral,30,16,14
Oneinchclaw,malganis,1389,druid,feral,84,41,43
Treeweed,tichondrius,1386,druid,feral,81,42,39
Hjerim,quelthalas,1386,druid,feral,50,24,26
Silvshifter,frostmourne,1382,druid,feral,29,22,7
Vakimumu,anubarak,1380,druid,feral,40,18,22
Hroney,area-52,1379,druid,feral,54,22,32
Craak,tichondrius,1376,druid,feral,41,19,22
Bigthirty,area-52,1372,druid,feral,30,19,11
Fastcat,moon-guard,1369,druid,feral,54,25,29
Herbx,sargeras,1366,druid,feral,60,30,30
Vaniedron,zuljin,1365,druid,feral,111,43,68
Gorim,area-52,1364,druid,feral,48,26,22
Tardcakes,tichondrius,1362,druid,feral,62,31,31
Gnairda,sargeras,1361,druid,feral,186,96,90
Boll,akama,1361,druid,feral,34,15,19
Lunarboy,tichondrius,1358,druid,feral,37,16,21
Kilohanno,alexstrasza,1356,druid,feral,42,19,23
Iamnature,dalaran,1355,druid,feral,67,30,37
Fugg,frostmourne,1350,druid,feral,84,34,50
Riseagainst,ragnaros,1349,druid,feral,34,23,11
Darkdragoonz,barthilas,1344,druid,feral,43,20,23
Floorz,bleeding-hollow,1343,druid,feral,24,14,10
Azoth,hyjal,1342,druid,feral,24,14,10
Senorcholo,malganis,1342,druid,feral,36,18,18
Catzetzan,tichondrius,1342,druid,feral,30,14,16
Smeow,zuljin,1339,druid,feral,39,16,23
Brawleyx,tichondrius,1337,druid,feral,36,14,22
Riemannzeta,azgalor,1336,druid,feral,54,29,25
Beastbaby,eldrethalas,1336,druid,feral,36,14,22
Hoppus,icecrown,1336,druid,feral,81,30,51
Hoofin,blackwing-lair,1334,druid,feral,84,34,50
Tenedoors,ragnaros,1334,druid,feral,54,18,36
Dustin,moon-guard,1332,druid,feral,97,46,51
Khyzan,illidan,1329,druid,feral,78,41,37
Gapingloli,tichondrius,1327,druid,feral,39,21,18
Naturestouch,tichondrius,1327,druid,feral,30,14,16
Datkittydoe,kiljaeden,1323,druid,feral,43,20,23
Hadox,azralon,1321,druid,feral,89,43,46
Bullboy,frostmourne,1320,druid,feral,30,17,13
Bleedz,mugthol,1319,druid,feral,36,18,18
Panyot,kiljaeden,1318,druid,feral,60,31,29
Aahx,thrall,1317,druid,feral,123,69,54
Kyrô,sargeras,1317,druid,feral,29,14,15
Isalien,stormrage,1313,druid,feral,62,33,29
Ninefeet,argent-dawn,1311,druid,feral,72,37,35
Suedle,kelthuzad,1309,druid,feral,29,14,15
Jasminonmars,zuluhed,1305,druid,feral,65,36,29
Asteriel,stormrage,1305,druid,feral,52,25,27
Malthen,quelthalas,1304,druid,feral,78,38,40
Frostelles,stormrage,1303,druid,feral,121,57,64
Nyanncat,frostmourne,1302,druid,feral,30,14,16
Nojiling,quelthalas,1301,druid,feral,55,24,31
Azuredreams,bleeding-hollow,1301,druid,feral,36,15,21
Percefhone,azralon,1300,druid,feral,92,41,51
Raebies,dalaran,1297,druid,feral,99,53,46
Sahksi,lothar,1297,druid,feral,60,30,30
Mbarakaja,malganis,1297,druid,feral,149,70,79
Anessan,silvermoon,1296,druid,feral,44,23,21
Ðreadfang,tichondrius,1295,druid,feral,47,28,19
Bigmolii,quelthalas,1293,druid,feral,86,34,52
Awarz,drakkari,1291,druid,feral,36,14,22
Erahar,illidan,1281,druid,feral,46,24,22
Malu,muradin,1278,druid,feral,30,17,13
Cheshiire,moon-guard,1276,druid,feral,161,75,86
Súse,sargeras,1269,druid,feral,59,29,30
Gotroadrash,azuremyst,1268,druid,feral,23,14,9
Glockitty,tichondrius,1262,druid,feral,90,42,48
Dätto,thrall,1261,druid,feral,54,25,29
Feanah,tichondrius,1259,druid,feral,66,29,37
Styli,tichondrius,1253,druid,feral,26,17,9
Nèffex,sargeras,1247,druid,feral,18,13,5
Zelyvia,moon-guard,1247,druid,feral,30,14,16
Sporadiclive,sargeras,1247,druid,feral,30,13,17
Mariko,area-52,1245,druid,feral,59,26,33
Enchiladacat,stormrage,1243,druid,feral,24,13,11
Shmayba,malganis,1241,druid,feral,24,13,11
Kellydacat,azuremyst,1241,druid,feral,24,13,11
Pfheral,area-52,1240,druid,feral,30,13,17
Theømega,stormrage,1237,druid,feral,24,13,11
Hektuk,barthilas,1235,druid,feral,34,19,15
Wwf,thrall,1235,druid,feral,60,23,37
Ourse,aegwynn,1234,druid,feral,77,46,31
Kleanxx,tichondrius,1232,druid,feral,223,111,112
Matpd,norgannon,1228,druid,feral,66,28,38
Orthognathic,emerald-dream,1227,druid,feral,57,35,22
Bâgheera,sargeras,1225,druid,feral,61,25,36
Dkkng,dalaran,1224,druid,feral,30,16,14
Xanbàr,hyjal,1222,druid,feral,35,22,13
Twistach,quelthalas,1222,druid,feral,24,13,11
Koducck,tichondrius,1221,druid,feral,30,13,17
Yobibit,terenas,1221,druid,feral,36,14,22
Swappy,korgath,1220,druid,feral,69,31,38
Zelazia,area-52,1219,druid,feral,30,16,14
Beargodx,stormrage,1218,druid,feral,54,28,26
Scruffywolf,tichondrius,1217,druid,feral,143,63,80
Berd,whisperwind,1215,druid,feral,40,20,20
Midnitex,illidan,1214,druid,feral,37,16,21
Psychofeör,quelthalas,1213,druid,feral,82,39,43
Freddiemerk,moon-guard,1210,druid,feral,24,13,11
Pusswhisperr,bleeding-hollow,1210,druid,feral,42,15,27
Hermbott,proudmoore,1206,druid,feral,48,23,25
Werebruin,bleeding-hollow,1201,druid,feral,61,33,28
Spinach,moon-guard,1195,druid,feral,33,13,20
Behrhart,stormrage,1194,druid,feral,18,13,5
Beygatti,sargeras,1194,druid,feral,49,18,31
Hctibrehtom,illidan,1193,druid,feral,24,20,4
Kaya,hyjal,1193,druid,feral,36,13,23
Destrez,ragnaros,1188,druid,feral,27,13,14
Yukcyducky,tichondrius,1185,druid,feral,60,22,38
Sansao,sargeras,1179,druid,feral,42,21,21
Khione,dreadmaul,1172,druid,feral,68,38,30
Haneulso,tichondrius,1171,druid,feral,33,14,19
Dehltax,stormrage,1169,druid,feral,54,29,25
Nomnomnomn,chogall,1168,druid,feral,22,13,9
Xdkittyrawr,tichondrius,1168,druid,feral,94,46,48
Bloodriot,wyrmrest-accord,1164,druid,feral,50,17,33
Borybuilder,azralon,1153,druid,feral,52,22,30
Ishiftalot,bleeding-hollow,1153,druid,feral,57,23,34
Europecat,stormrage,1152,druid,feral,24,12,12
Ryecoke,stormrage,1151,druid,feral,24,12,12
Kiwidru,frostmourne,1150,druid,feral,18,12,6
Kyrona,frostmourne,1150,druid,feral,36,22,14
Chambz,tichondrius,1148,druid,feral,60,24,36
Hupod,proudmoore,1146,druid,feral,36,17,19
Concordya,tichondrius,1146,druid,feral,30,13,17
Doblun,nemesis,1146,druid,feral,36,12,24
Anastasyiar,illidan,1142,druid,feral,30,12,18
Shiftex,arthas,1140,druid,feral,30,12,18
Zazieraiel,moon-guard,1139,druid,feral,33,13,20
Aligantor,thrall,1134,druid,feral,18,12,6
Chëësëbürgër,illidan,1128,druid,feral,97,45,52
Surmise,tichondrius,1127,druid,feral,30,13,17
Vintera,sargeras,1123,druid,feral,99,49,50
Yobolsun,sargeras,1123,druid,feral,36,16,20
Elunaya,illidan,1122,druid,feral,36,15,21
Tonoshapepai,azralon,1122,druid,feral,36,13,23
Shahahrazad,queldorei,1118,druid,feral,36,12,24
Kotau,azralon,1117,druid,feral,36,23,13
Eyzie,stormrage,1115,druid,feral,36,13,23
Daniin,azralon,1107,druid,feral,66,29,37
Buhooki,tichondrius,1106,druid,feral,113,58,55
Ðementia,stormrage,1101,druid,feral,84,47,37
Azakana,sargeras,1094,druid,feral,23,12,11
Leight,whisperwind,1093,druid,feral,24,14,10
Mordrynn,veknilash,1092,druid,feral,28,14,14
Strikinina,azralon,1091,druid,feral,61,26,35
Zderhs,blackrock,1079,druid,feral,20,12,8
Bernoboy,kelthuzad,1079,druid,feral,30,16,14
Trevvor,thrall,1070,druid,feral,36,12,24
Fb,darkspear,1069,druid,feral,20,12,8
Anarad,dalaran,1068,druid,feral,42,22,20
Druidsling,mugthol,1067,druid,feral,50,20,30
Pokémon,grizzly-hills,1064,druid,feral,33,15,18
Birdy,proudmoore,1056,druid,feral,18,11,7
Glenn,norgannon,1056,druid,feral,18,11,7
Switchform,kiljaeden,1056,druid,feral,18,11,7
Hatergodx,ravencrest,1056,druid,feral,24,11,13
Lelobull,ragnaros,1056,druid,feral,48,19,29
Dangersweg,frostmourne,1056,druid,feral,30,11,19
Orekinya,area-52,1055,druid,feral,24,11,13
Tabbsy,frostmourne,1055,druid,feral,36,11,25
Miviaris,alleria,1054,druid,feral,18,11,7
Kellydabear,azuremyst,1054,druid,feral,24,11,13
Myeow,illidan,1052,druid,feral,24,11,13
Corv,drenden,1051,druid,feral,16,12,4
Swindlestan,zuljin,1051,druid,feral,24,11,13
Bloodynine,cairne,1050,druid,feral,24,11,13
Clawin,frostmourne,1049,druid,feral,18,11,7
Kongquest,emerald-dream,1049,druid,feral,36,11,25
Nyla,nemesis,1048,druid,feral,12,11,1
Vykarux,suramar,1048,druid,feral,24,11,13
Yám,tichondrius,1048,druid,feral,30,11,19
Dròódles,barthilas,1035,druid,feral,18,11,7
Seraphim,lightnings-blade,1029,druid,feral,60,30,30
Gece,dalaran,1022,druid,feral,35,15,20
Screwdrivers,moon-guard,1022,druid,feral,29,11,18
Amdruid,bloodhoof,1021,druid,feral,20,12,8
Twigz,illidan,1018,druid,feral,91,44,47
Fennel,korgath,1017,druid,feral,23,11,12
Lyndonww,frostmourne,1006,druid,feral,26,12,14
Ursuur,drakkari,1004,druid,feral,29,11,18
Wildbeasts,proudmoore,1003,druid,feral,105,53,52
Afrogx,dalaran,1001,druid,feral,24,11,13
Superwrath,khaz-modan,1000,druid,feral,23,11,12
Ruzkit,illidan,996,druid,feral,30,14,16
Skufty,illidan,990,druid,feral,96,34,62
Mojofoshobro,moonrunner,989,druid,feral,54,19,35
Meldzetzan,tichondrius,960,druid,feral,12,10,2
Semveta,alleria,960,druid,feral,12,10,2
Soaring,moon-guard,960,druid,feral,18,10,8
Hypérion,dalaran,960,druid,feral,24,10,14
Buffjungle,tichondrius,960,druid,feral,26,10,16
Juiceonlips,sargeras,959,druid,feral,18,10,8
Kuzigothigh,thunderhorn,959,druid,feral,48,25,23
Yaboidakota,stormrage,959,druid,feral,24,10,14
Kekepöp,illidan,959,druid,feral,24,10,14
Tysandra,sargeras,959,druid,feral,30,10,20
Nearkoo,tichondrius,958,druid,feral,24,10,14
Rekrasaur,emerald-dream,958,druid,feral,30,10,20
Doubledówn,sargeras,957,druid,feral,72,33,39
Pavel,aerie-peak,957,druid,feral,59,18,41
Makonis,tichondrius,956,druid,feral,18,10,8
Shiftingdean,sargeras,956,druid,feral,30,10,20
Moonbow,frostmourne,954,druid,feral,18,10,8
Bananawaffle,proudmoore,954,druid,feral,24,10,14
Samirgodx,tichondrius,954,druid,feral,24,10,14
Dorio,quelthalas,952,druid,feral,18,10,8
Barbary,tichondrius,952,druid,feral,24,10,14
Duckieheit,sargeras,952,druid,feral,24,10,14
Hobbles,emerald-dream,949,druid,feral,24,10,14
Odesellena,moon-guard,942,druid,feral,42,21,21
Drdanknugs,laughing-skull,939,druid,feral,36,10,26
Feraluwu,illidan,938,druid,feral,18,10,8
Lusk,blades-edge,937,druid,feral,64,29,35
Sisilo,bonechewer,933,druid,feral,96,40,56
Téddybéar,smolderthorn,929,druid,feral,12,10,2
Fanaror,frostmourne,929,druid,feral,36,18,18
Arntu,malganis,924,druid,feral,17,10,7
Greasemonkey,trollbane,919,druid,feral,22,12,10
Sjana,bleeding-hollow,918,druid,feral,18,11,7
Lacrarola,nemesis,916,druid,feral,17,10,7
Skrillin,thrall,914,druid,feral,23,11,12
Àspên,moon-guard,908,druid,feral,42,20,22
Blêêd,stormscale,904,druid,feral,13,12,1
Tt,akama,894,druid,feral,20,10,10
Threeo,burning-blade,889,druid,feral,16,10,6
Taurenaught,aegwynn,881,druid,feral,37,17,20
Eglania,stormrage,866,druid,feral,24,11,13
Retzerbil,sargeras,864,druid,feral,12,9,3
Chin,ysera,864,druid,feral,12,9,3
Feorb,azuremyst,864,druid,feral,24,9,15
Faithxo,stormrage,864,druid,feral,24,9,15
Féèd,stormrage,863,druid,feral,18,9,9
Gz,icecrown,863,druid,feral,18,9,9
Thaherb,korgath,863,druid,feral,24,9,15
Jayp,thrall,863,druid,feral,24,9,15
Wabbehkus,barthilas,862,druid,feral,36,9,27
Catten,barthilas,860,druid,feral,12,9,3
Tommyjimmy,andorhal,860,druid,feral,18,9,9
Boofings,sargeras,860,druid,feral,18,9,9
Niwßor,azralon,860,druid,feral,18,9,9
Manlymanman,shandris,859,druid,feral,24,9,15
Ribushe,stormrage,859,druid,feral,24,9,15
Shiftyounot,shattered-hand,859,druid,feral,30,9,21
Ruhgen,deathwing,858,druid,feral,26,10,16
Jonoa,nagrand,858,druid,feral,24,9,15
Wuarlo,moon-guard,857,druid,feral,91,43,48
Rum,the-venture-co,857,druid,feral,36,14,22
Wokoom,windrunner,855,druid,feral,54,20,34
Tolldruid,chogall,852,druid,feral,24,10,14
Koag,dalaran,851,druid,feral,23,11,12
Zauska,cenarion-circle,851,druid,feral,30,9,21
Drulicious,tichondrius,849,druid,feral,27,13,14
Predatõr,malorne,841,druid,feral,24,10,14
Sosd,kelthuzad,837,druid,feral,17,9,8
Fogboom,area-52,830,druid,feral,20,10,10
Mavren,uldaman,828,druid,feral,25,9,16
Dreamfyre,kiljaeden,828,druid,feral,29,9,20
Shartasm,anetheron,822,druid,feral,30,12,18
Tatiannaa,stormreaver,815,druid,feral,15,10,5
Feorelm,proudmoore,810,druid,feral,17,9,8
Nephdruid,stormrage,804,druid,feral,30,9,21
Ðjangø,goldrinn,801,druid,feral,17,9,8
Druski,lightbringer,783,druid,feral,17,9,8
Tastelikecat,kelthuzad,776,druid,feral,21,9,12
Batterydruid,silvermoon,768,druid,feral,12,8,4
Jason,vashj,768,druid,feral,12,8,4
Anìmorph,sargeras,768,druid,feral,12,8,4
Kattles,frostmourne,768,druid,feral,12,8,4
Griefs,emerald-dream,768,druid,feral,12,8,4
Férállgødx,area-52,768,druid,feral,18,8,10
Mooncatbear,malganis,768,druid,feral,18,8,10
Sylvaster,stormrage,768,druid,feral,24,8,16
Germainee,shandris,768,druid,feral,24,8,16
Saltydru,illidan,768,druid,feral,24,8,16
Nahelae,tichondrius,767,druid,feral,12,8,4
Pokeyouryolk,sargeras,767,druid,feral,12,8,4
Jentzull,tichondrius,767,druid,feral,12,8,4
Udderchaos,dark-iron,767,druid,feral,18,8,10
Zascat,malganis,767,druid,feral,18,8,10
Pergutory,frostmourne,767,druid,feral,18,8,10
Kìttykat,stormrage,767,druid,feral,18,8,10
Fullmoon,greymane,767,druid,feral,22,9,13
Zurker,mannoroth,766,druid,feral,12,8,4
Jpnerazim,quelthalas,766,druid,feral,16,8,8
Angulus,darkspear,766,druid,feral,18,8,10
Deaddpool,ragnaros,764,druid,feral,12,8,4
Mooseknuccle,tichondrius,764,druid,feral,15,9,6
Zimah,illidan,764,druid,feral,18,8,10
Raknary,kelthuzad,764,druid,feral,30,8,22
Framko,quelthalas,763,druid,feral,36,8,28
Goorybud,tichondrius,762,druid,feral,12,8,4
Gamble,the-underbog,760,druid,feral,24,8,16
Cooln,bleeding-hollow,759,druid,feral,12,8,4
Pawprika,tichondrius,758,druid,feral,30,9,21
Ediiann,cenarius,756,druid,feral,18,8,10
Mychi,ragnaros,748,druid,feral,20,9,11
Reallysauce,zuljin,748,druid,feral,18,8,10
Nodraent,quelthalas,741,druid,feral,18,8,10
Ashmila,ragnaros,716,druid,feral,17,8,9
Notinsanity,proudmoore,714,druid,feral,20,9,11
Jihadibleeds,stormrage,713,druid,feral,13,9,4
Mazoak,sargeras,703,druid,feral,28,8,20
Byson,bleeding-hollow,702,druid,feral,17,8,9
Bigdeeza,frostmourne,702,druid,feral,17,8,9
Shakedru,stormrage,684,druid,feral,19,8,11
Susruth,area-52,672,druid,feral,12,7,5
Zðzð,zuljin,672,druid,feral,12,7,5
Scuffedx,tichondrius,672,druid,feral,12,7,5
Tnvï,stormrage,672,druid,feral,12,7,5
Primalxd,area-52,672,druid,feral,12,7,5
Dailydruid,illidan,672,druid,feral,12,7,5
Shalaz,magtheridon,672,druid,feral,12,7,5
Venomsecho,vashj,672,druid,feral,12,7,5
Krobz,bleeding-hollow,672,druid,feral,12,7,5
Elyveen,proudmoore,672,druid,feral,12,7,5
Meowny,area-52,672,druid,feral,18,7,11
Selendis,tichondrius,672,druid,feral,18,7,11
Islayne,moon-guard,672,druid,feral,18,7,11
Psyraxus,moon-guard,672,druid,feral,18,7,11
Lunacore,illidan,672,druid,feral,18,7,11
Ronin,arthas,672,druid,feral,18,7,11
Muffbfloppn,zuljin,672,druid,feral,18,7,11
Bearlyviable,stormrage,672,druid,feral,21,8,13
Shiftage,frostmane,672,druid,feral,21,7,14
Bobochan,tichondrius,672,druid,feral,24,7,17
Houseboat,hellscream,672,druid,feral,30,7,23
Happyhotter,proudmoore,671,druid,feral,12,7,5
Fürïous,tichondrius,671,druid,feral,15,8,7
Bearmuda,trollbane,671,druid,feral,18,7,11
Corym,frostmourne,671,druid,feral,18,7,11
Ännä,moon-guard,671,druid,feral,18,7,11
Ruckiz,stormrage,671,druid,feral,18,7,11
Momoxchan,quelthalas,671,druid,feral,18,7,11
Kajla,sargeras,671,druid,feral,18,7,11
Druidydruid,blackrock,671,druid,feral,18,7,11
Thegrefgx,ragnaros,670,druid,feral,12,7,5
Hótlife,fizzcrank,670,druid,feral,12,7,5
Servax,illidan,670,druid,feral,18,7,11
Curainfeliz,nemesis,669,druid,feral,12,7,5
Bullshiftin,area-52,669,druid,feral,12,7,5
Redness,daggerspine,669,druid,feral,18,7,11
Meowzedon,sargeras,668,druid,feral,18,7,11
Yokimo,amanthul,668,druid,feral,18,7,11
Zeldriss,arthas,668,druid,feral,19,7,12
Jordiët,dalaran,667,druid,feral,12,7,5
Nokther,muradin,664,druid,feral,30,7,23
Oxvxo,senjin,648,druid,feral,18,7,11
Hyperlite,bonechewer,643,druid,feral,18,7,11
Injail,tichondrius,640,druid,feral,16,7,9
Chadwickx,illidan,639,druid,feral,11,7,4
Ekkoh,sargeras,638,druid,feral,17,7,10
Jeanz,bonechewer,632,druid,feral,19,9,10
Slapymilf,dentarg,623,druid,feral,11,7,4
Meowzetzan,tichondrius,623,druid,feral,11,7,4
Puzzykat,uldum,621,druid,feral,27,7,20
Gutzzu,area-52,619,druid,feral,15,7,8
Weezydende,area-52,612,druid,feral,29,7,22
Weedleaf,wyrmrest-accord,610,druid,feral,20,8,12
Beaker,uldum,605,druid,feral,11,7,4
Earlgrayl,kelthuzad,591,druid,feral,13,7,6
Bigherbo,zuljin,585,druid,feral,20,8,12
Duuj,illidan,576,druid,feral,6,6,0
Lïberty,ragnaros,576,druid,feral,6,6,0
Hybridxo,kelthuzad,576,druid,feral,6,6,0
Funkattack,tichondrius,576,druid,feral,12,6,6
Nelfwaifú,area-52,576,druid,feral,12,6,6
Spaléxgu,azralon,576,druid,feral,12,6,6
Whitetigeris,tichondrius,576,druid,feral,12,6,6
Daniverse,sargeras,576,druid,feral,12,6,6
Sooey,wyrmrest-accord,576,druid,feral,12,6,6
Wilddeity,tichondrius,576,druid,feral,12,6,6
Ogversaucey,skullcrusher,576,druid,feral,12,6,6
Thontt,sargeras,576,druid,feral,12,6,6
Parallax,shadowsong,576,druid,feral,12,6,6
Yseraspawn,kelthuzad,576,druid,feral,12,6,6
Bables,tichondrius,576,druid,feral,12,6,6
Hashmall,ragnaros,576,druid,feral,12,6,6
Cíphenz,illidan,576,druid,feral,12,6,6
Hotmomlover,malganis,576,druid,feral,12,6,6
Kittysnuggle,emerald-dream,576,druid,feral,15,7,8
Høruss,azralon,576,druid,feral,15,7,8
Welshblack,tichondrius,576,druid,feral,16,7,9
Jinhova,stormrage,576,druid,feral,15,6,9
Rebrrth,antonidas,576,druid,feral,18,6,12
Poppynoff,barthilas,576,druid,feral,18,6,12
Emotionally,illidan,576,druid,feral,18,6,12
Kittendev,tichondrius,576,druid,feral,18,6,12
Mameseph,lightnings-blade,576,druid,feral,18,6,12
Pàntera,tichondrius,576,druid,feral,24,6,18
Kobebeef,malganis,576,druid,feral,24,6,18
Omnilul,zuljin,575,druid,feral,12,6,6
Wulfjack,emerald-dream,575,druid,feral,12,6,6
Allenjunior,ragnaros,575,druid,feral,12,6,6
Fireeloot,tichondrius,575,druid,feral,12,6,6
Davinchii,drakkari,575,druid,feral,12,6,6
Austîn,moon-guard,575,druid,feral,12,6,6
Druishcat,dark-iron,575,druid,feral,12,6,6
Yesqt,dalaran,575,druid,feral,12,6,6
Amoru,moon-guard,575,druid,feral,12,6,6
Stríðsmaður,area-52,575,druid,feral,12,6,6
Andaror,azralon,575,druid,feral,24,6,18
Beelzehog,whisperwind,574,druid,feral,12,6,6
Dinnerbone,echo-isles,573,druid,feral,12,6,6
Nikozho,sargeras,573,druid,feral,18,6,12
Kragma,zuluhed,572,druid,feral,12,6,6
Soldadito,zuljin,572,druid,feral,15,7,8
Udala,durotan,572,druid,feral,14,6,8
Snowlion,the-forgotten-coast,570,druid,feral,12,6,6
Expells,nemesis,569,druid,feral,18,6,12
Dullbozer,thrall,543,druid,feral,11,6,5
Druidcyber,stormrage,543,druid,feral,16,6,10
Lémons,tichondrius,542,druid,feral,17,6,11
Wtfimacat,area-52,527,druid,feral,11,6,5
Ripx,khadgar,522,druid,feral,16,7,9
Shadalor,frostmourne,512,druid,feral,16,6,10
Ivangamaz,area-52,511,druid,feral,11,6,5
Kilbys,nemesis,510,druid,feral,8,6,2
Iamatomic,illidan,509,druid,feral,20,6,14
Bearjoo,kelthuzad,495,druid,feral,18,6,12
Ardelix,emerald-dream,480,druid,feral,6,5,1
Flompstomper,skullcrusher,480,druid,feral,6,5,1
Sweetpurple,elune,480,druid,feral,6,5,1
Chrøniç,illidan,480,druid,feral,6,5,1
Nbnbnb,proudmoore,480,druid,feral,6,5,1
Gloomcat,illidan,480,druid,feral,6,5,1
Idiotdruid,ragnaros,480,druid,feral,6,5,1
Sweetnippies,elune,480,druid,feral,6,5,1
Carboz,jubeithos,480,druid,feral,6,5,1
Exxh,tichondrius,480,druid,feral,6,5,1
Féralis,sargeras,480,druid,feral,6,5,1
Crendorides,bleeding-hollow,480,druid,feral,12,5,7
Loamie,proudmoore,480,druid,feral,12,5,7
Choolah,area-52,480,druid,feral,12,5,7
Frenzyirl,darkspear,480,druid,feral,12,5,7
Wurow,firetree,480,druid,feral,12,5,7
Feralhearted,kelthuzad,480,druid,feral,12,5,7
Zeratull,cenarius,480,druid,feral,12,5,7
Softshirtxo,ragnaros,480,druid,feral,12,5,7
Karizikat,tichondrius,480,druid,feral,12,5,7
Noet,ragnaros,480,druid,feral,12,5,7
Yizhiyuren,aegwynn,480,druid,feral,12,5,7
Ðárk,ragnaros,480,druid,feral,12,5,7
Gunnymad,tichondrius,480,druid,feral,12,5,7
Honeybeam,moon-guard,480,druid,feral,12,5,7
Bloodyugly,area-52,480,druid,feral,12,5,7
Mythienair,stormrage,480,druid,feral,12,5,7
Cenarius,frostmourne,480,druid,feral,12,5,7
Loserceo,stormrage,480,druid,feral,12,5,7
Lurky,dalvengyr,480,druid,feral,12,5,7
Topangâ,lightninghoof,480,druid,feral,12,5,7
Scorn,spirestone,480,druid,feral,13,5,8
Fredolay,tichondrius,480,druid,feral,13,5,8
Oneninesix,frostmourne,480,druid,feral,18,5,13
Maplêleaf,moon-guard,480,druid,feral,18,5,13
Gouzz,frostmourne,480,druid,feral,18,5,13
Purrcat,tichondrius,480,druid,feral,18,5,13
Bere,kul-tiras,480,druid,feral,18,5,13
Caelüm,area-52,480,druid,feral,18,5,13
Lycanjungle,azralon,480,druid,feral,18,5,13
Kayday,bloodscalp,479,druid,feral,6,5,1
Mawnster,drenden,479,druid,feral,9,6,3
Balthøs,moon-guard,479,druid,feral,12,5,7
Animalcade,area-52,479,druid,feral,12,5,7
Aeonás,tichondrius,479,druid,feral,12,5,7
Nisheon,wyrmrest-accord,479,druid,feral,12,5,7
Snugglin,kelthuzad,479,druid,feral,12,5,7
Calani,lightnings-blade,479,druid,feral,12,5,7
Hawthòrn,bloodscalp,479,druid,feral,12,5,7
Ysemia,drakkari,479,druid,feral,14,5,9
Giatafix,whisperwind,479,druid,feral,18,5,13
Bigoldbear,moon-guard,479,druid,feral,18,5,13
Ramso,skullcrusher,478,druid,feral,12,5,7
Drewiid,stormrage,478,druid,feral,12,5,7
Dârkfang,moon-guard,475,druid,feral,12,5,7
Maplesyrup,moonrunner,431,druid,feral,11,5,6
Moonrg,stormrage,431,druid,feral,11,5,6
Empathz,emerald-dream,431,druid,feral,17,5,12
Ninelivez,gorgonnash,426,druid,feral,22,6,16
Yunekai,stormrage,415,druid,feral,11,5,6
Vaelthunis,sargeras,400,druid,feral,13,5,8
Reversflash,emerald-dream,384,druid,feral,6,4,2
Vecuronium,tichondrius,384,druid,feral,6,4,2
Aldr,tichondrius,384,druid,feral,6,4,2
Orizane,moon-guard,384,druid,feral,6,4,2
Kistormx,tichondrius,384,druid,feral,6,4,2
Cfab,tichondrius,384,druid,feral,6,4,2
Drywatter,tichondrius,384,druid,feral,6,4,2
Jaegerbombx,sargeras,384,druid,feral,6,4,2
Eliteshift,frostmourne,384,druid,feral,6,4,2
Pressuretd,frostmourne,384,druid,feral,6,4,2
Curet,lightbringer,384,druid,feral,6,4,2
Oobuck,kilrogg,384,druid,feral,6,4,2
Robomexi,tichondrius,384,druid,feral,6,4,2
Woshiyigede,frostmourne,384,druid,feral,6,4,2
Bearcathawk,sargeras,384,druid,feral,6,4,2
Coolguyzack,stormscale,384,druid,feral,6,4,2
Kittycudi,hyjal,384,druid,feral,6,4,2
Nâturê,dalaran,384,druid,feral,6,4,2
Kaldiel,ysera,384,druid,feral,6,4,2
Olhosdlua,azralon,384,druid,feral,6,4,2
Menapäws,area-52,384,druid,feral,6,4,2
Xrw,kelthuzad,384,druid,feral,6,4,2
Unfunnyferal,kelthuzad,384,druid,feral,6,4,2
Sneekykitty,malygos,384,druid,feral,6,4,2
Srwow,elune,384,druid,feral,6,4,2
Toiiz,malganis,384,druid,feral,9,4,5
Genuine,guldan,384,druid,feral,11,4,7
Strixferal,zuljin,384,druid,feral,12,4,8
Zzkitty,stormreaver,384,druid,feral,12,4,8
Moohok,bleeding-hollow,384,druid,feral,12,4,8
Heìrophant,trollbane,384,druid,feral,12,4,8
Anniehall,stormrage,384,druid,feral,12,4,8
Gatona,stormrage,384,druid,feral,12,4,8
Carnumoose,zuljin,384,druid,feral,12,4,8
Weeñor,tichondrius,384,druid,feral,12,4,8
Timthecatman,frostmourne,384,druid,feral,12,4,8
Gernichora,barthilas,384,druid,feral,12,4,8
Pollykush,sargeras,384,druid,feral,12,4,8
Toetoetoete,darrowmere,384,druid,feral,12,4,8
Freshzk,azralon,384,druid,feral,12,4,8
Pretzle,kelthuzad,384,druid,feral,12,4,8
Rêàgøñ,tichondrius,384,druid,feral,12,4,8
Quiziato,burning-legion,384,druid,feral,12,4,8
Riverthorne,moon-guard,384,druid,feral,12,4,8
Iamfynch,sargeras,384,druid,feral,12,4,8
Atreis,malganis,384,druid,feral,12,4,8
Ewok,vashj,384,druid,feral,12,4,8
Riec,kiljaeden,384,druid,feral,12,4,8
Yakuho,proudmoore,384,druid,feral,12,4,8
Sellîas,senjin,384,druid,feral,12,4,8
Save,aerie-peak,384,druid,feral,12,4,8
Bënzy,frostmourne,384,druid,feral,12,4,8
Feralgød,tichondrius,384,druid,feral,12,4,8
Teddybear,medivh,384,druid,feral,12,4,8
Auxl,tichondrius,384,druid,feral,12,4,8
Hellabanx,tichondrius,384,druid,feral,12,4,8
Binjuicex,frostmourne,384,druid,feral,12,4,8
Carlosd,tichondrius,384,druid,feral,12,4,8
Alaillais,moon-guard,384,druid,feral,12,4,8
Pereréka,azralon,384,druid,feral,14,4,10
Naastir,medivh,384,druid,feral,14,4,10
Ráhilk,quelthalas,384,druid,feral,18,4,14
Startalons,area-52,384,druid,feral,18,4,14
Apothe,emerald-dream,384,druid,feral,18,4,14
Berall,bleeding-hollow,383,druid,feral,6,4,2
Jamesbailey,sargeras,383,druid,feral,12,4,8
Mfgs,kelthuzad,383,druid,feral,12,4,8
Bramth,quelthalas,383,druid,feral,12,4,8
Topguncarl,illidan,383,druid,feral,12,4,8
Shoboski,quelthalas,383,druid,feral,12,4,8
Porrosman,quelthalas,383,druid,feral,12,4,8
Nahtex,tichondrius,383,druid,feral,18,4,14
Mogli,perenolde,383,druid,feral,30,4,26
Cyder,thrall,382,druid,feral,10,5,5
Ssimbaa,area-52,382,druid,feral,12,4,8
Dalinaìr,moon-guard,382,druid,feral,12,4,8
Jabiso,smolderthorn,382,druid,feral,18,4,14
Zyila,garithos,367,druid,feral,11,4,7
Eightyhd,ravencrest,351,druid,feral,11,4,7
Pixyls,bleeding-hollow,336,druid,feral,9,4,5
Shyn,goldrinn,336,druid,feral,15,4,11
Defku,quelthalas,330,druid,feral,28,6,22
Ashvir,wyrmrest-accord,319,druid,feral,5,4,1
Bubbleshiftz,area-52,288,druid,feral,6,3,3
Owlcapwn,stormreaver,288,druid,feral,6,3,3
Pabag,chogall,288,druid,feral,6,3,3
Ysero,area-52,288,druid,feral,6,3,3
Dairycream,skullcrusher,288,druid,feral,6,3,3
Nanassa,spinebreaker,288,druid,feral,6,3,3
Elythria,hellscream,288,druid,feral,6,3,3
Chopleaf,khadgar,288,druid,feral,6,3,3
Güar,area-52,288,druid,feral,6,3,3
Taurenasarus,area-52,288,druid,feral,6,3,3
Ahhpalu,tichondrius,288,druid,feral,6,3,3
Grimtreeper,illidan,288,druid,feral,6,3,3
Askmeaboutmy,shattered-halls,288,druid,feral,6,3,3
Arienne,kelthuzad,288,druid,feral,6,3,3
Thecolortwoo,tichondrius,288,druid,feral,6,3,3
Riddickd,malfurion,288,druid,feral,6,3,3
Ÿùp,tichondrius,288,druid,feral,6,3,3
Hyldru,stormrage,288,druid,feral,6,3,3
Bootayclappa,sargeras,288,druid,feral,6,3,3
Moobees,arthas,288,druid,feral,6,3,3
Duckseasonn,sargeras,288,druid,feral,6,3,3
Rairven,stormrage,288,druid,feral,6,3,3
Pansensual,archimonde,288,druid,feral,6,3,3
Øvernight,azralon,288,druid,feral,6,3,3
Donutdruid,illidan,288,druid,feral,6,3,3
Frrest,proudmoore,288,druid,feral,6,3,3
Nichodameus,firetree,288,druid,feral,6,3,3
Injeckx,tichondrius,288,druid,feral,6,3,3
Datlogan,tichondrius,288,druid,feral,6,3,3
Rotclaws,stormrage,288,druid,feral,6,3,3
Gâlaxy,sargeras,288,druid,feral,6,3,3
Espoir,azuremyst,288,druid,feral,6,3,3
Kardien,quelthalas,288,druid,feral,6,3,3
Opconvoke,illidan,288,druid,feral,6,3,3
Kurokyy,frostmourne,288,druid,feral,6,3,3
Hitchslaps,tichondrius,288,druid,feral,6,3,3
Dramon,tichondrius,288,druid,feral,6,3,3
Saelyle,illidan,288,druid,feral,6,3,3
Zadayos,aerie-peak,288,druid,feral,6,3,3
Plantdaddy,bladefist,288,druid,feral,6,3,3
Uag,emerald-dream,288,druid,feral,6,3,3
Neksir,ragnaros,288,druid,feral,6,3,3
Trottystwin,emerald-dream,288,druid,feral,6,3,3
Deadlykept,ragnaros,288,druid,feral,6,3,3
Balnara,cenarius,288,druid,feral,6,3,3
Jeperty,tichondrius,288,druid,feral,6,3,3
Posmard,ragnaros,288,druid,feral,6,3,3
Thorñ,cenarius,288,druid,feral,6,3,3
Natureswang,bleeding-hollow,288,druid,feral,6,3,3
Nofeets,azshara,288,druid,feral,6,3,3
Steakjr,senjin,288,druid,feral,6,3,3
Rígél,ragnaros,288,druid,feral,6,3,3
Floridaman,moonrunner,288,druid,feral,6,3,3
Worgbearpig,destromath,288,druid,feral,6,3,3
Bigskeeve,sargeras,288,druid,feral,6,3,3
Celetra,kiljaeden,288,druid,feral,6,3,3
Erbirus,proudmoore,288,druid,feral,6,3,3
Katatafish,azralon,288,druid,feral,6,3,3
Purrfact,frostmourne,288,druid,feral,6,3,3
Tasselhoof,hyjal,288,druid,feral,6,3,3
Lilrichdmg,sargeras,288,druid,feral,6,3,3
Ezconvoke,sargeras,288,druid,feral,6,3,3
Zalmo,area-52,288,druid,feral,9,4,5
Hídde,quelthalas,288,druid,feral,12,3,9
Pibily,sargeras,288,druid,feral,12,3,9
Vorare,tichondrius,288,druid,feral,12,3,9
Solstice,frostmourne,288,druid,feral,12,3,9
Uniquex,zuljin,288,druid,feral,12,3,9
Drailyo,ravenholdt,288,druid,feral,12,3,9
Pawpaw,terenas,288,druid,feral,12,3,9
Tchallå,tichondrius,288,druid,feral,12,3,9
Peppapig,mugthol,288,druid,feral,12,3,9
Näna,dalaran,288,druid,feral,12,3,9
Garuharken,skullcrusher,288,druid,feral,12,3,9
Lovemakitty,sargeras,288,druid,feral,12,3,9
Rivetrix,azralon,288,druid,feral,12,3,9
Lilnippy,stormscale,288,druid,feral,12,3,9
Sosorry,blackhand,288,druid,feral,12,3,9
Flushi,nagrand,288,druid,feral,12,3,9
Nighetager,uther,288,druid,feral,12,3,9
Flayx,frostmourne,288,druid,feral,12,3,9
Oo,grizzly-hills,288,druid,feral,12,3,9
Catorcow,aegwynn,288,druid,feral,13,3,10
Iamthewambo,bloodhoof,288,druid,feral,30,3,27
Extremeshift,dalaran,287,druid,feral,8,4,4
Rawrii,nemesis,287,druid,feral,6,3,3
Slymar,darkspear,287,druid,feral,6,3,3
Kurodash,tichondrius,287,druid,feral,6,3,3
Rhaines,moon-guard,287,druid,feral,12,3,9
Absoles,agamaggan,287,druid,feral,12,3,9
Schwiftea,skullcrusher,287,druid,feral,12,3,9
Nast,dreadmaul,287,druid,feral,12,3,9
Psychosis,kul-tiras,285,druid,feral,12,3,9
Kogti,malganis,255,druid,feral,4,4,0
Mightymërlin,stormrage,255,druid,feral,11,3,8
Punderful,stormrage,254,druid,feral,10,4,6
Trippykitty,tichondrius,240,druid,feral,9,3,6
Yámï,stormrage,239,druid,feral,5,3,2
Pél,tichondrius,223,druid,feral,8,3,5
Catahmine,thrall,223,druid,feral,8,3,5
Worldly,medivh,223,druid,feral,14,3,11
Ebrìthil,hyjal,208,druid,feral,7,3,4
Puiltraxs,ragnaros,192,druid,feral,4,3,1
Feraldudu,illidan,192,druid,feral,4,3,1
Kurakai,runetotem,192,druid,feral,6,2,4
Madador,bleeding-hollow,192,druid,feral,6,2,4
Bullbuddy,wyrmrest-accord,192,druid,feral,6,2,4
Klawzy,thrall,192,druid,feral,6,2,4
Barrah,barthilas,192,druid,feral,6,2,4
Pecopeco,sargeras,192,druid,feral,6,2,4
Aethorax,hyjal,192,druid,feral,6,2,4
Prosperz,dalaran,192,druid,feral,6,2,4
Zalledori,thrall,192,druid,feral,6,2,4
Illr,laughing-skull,192,druid,feral,6,2,4
Augus,hyjal,192,druid,feral,6,2,4
Barnedruid,stormreaver,192,druid,feral,6,2,4
Driftwood,bonechewer,192,druid,feral,6,2,4
Evolute,sargeras,192,druid,feral,6,2,4
Numbkin,stormrage,192,druid,feral,6,2,4
Stolenrims,tichondrius,192,druid,feral,6,2,4
Asmondruud,tichondrius,192,druid,feral,6,2,4
Hännibal,hydraxis,192,druid,feral,6,2,4
Tilly,malorne,192,druid,feral,6,2,4
Omgapuddycat,stormrage,192,druid,feral,6,2,4
Ikova,frostmourne,192,druid,feral,6,2,4
Shiftdeznutz,tichondrius,192,druid,feral,6,2,4
Onewitnature,nordrassil,192,druid,feral,6,2,4
Basichoe,bleeding-hollow,192,druid,feral,6,2,4
Evantheomni,tichondrius,192,druid,feral,6,2,4
Manwool,illidan,192,druid,feral,6,2,4
Wreckked,sargeras,192,druid,feral,6,2,4
Taztoc,stormrage,192,druid,feral,6,2,4
Lilstuped,tichondrius,192,druid,feral,6,2,4
Varietypack,antonidas,192,druid,feral,6,2,4
Samsaralol,tichondrius,192,druid,feral,6,2,4
Catmóm,tichondrius,192,druid,feral,6,2,4
Unclebolty,frostmourne,192,druid,feral,6,2,4
Kanadae,thrall,192,druid,feral,6,2,4
Aurajin,spinebreaker,192,druid,feral,6,2,4
Dankbite,doomhammer,192,druid,feral,6,2,4
Fieryferal,kargath,192,druid,feral,6,2,4
Pröfëct,ragnaros,192,druid,feral,6,2,4
Anudi,whisperwind,192,druid,feral,6,2,4
Athious,moon-guard,192,druid,feral,6,2,4
Shiftwork,korgath,192,druid,feral,6,2,4
Perlek,bleeding-hollow,192,druid,feral,6,2,4
Pusscat,illidan,192,druid,feral,6,2,4
Fuujinn,korgath,192,druid,feral,6,2,4
Geno,cenarius,192,druid,feral,6,2,4
Lemonnz,illidan,192,druid,feral,6,2,4
Tootiebootie,bleeding-hollow,192,druid,feral,6,2,4
Handolar,quelthalas,192,druid,feral,6,2,4
Kikothecat,burning-blade,192,druid,feral,6,2,4
Theliono,lightnings-blade,192,druid,feral,6,2,4
Pawblems,sargeras,192,druid,feral,6,2,4
Bdsurges,illidan,192,druid,feral,6,2,4
Owd,tichondrius,192,druid,feral,6,2,4
Meaningfully,kelthuzad,192,druid,feral,6,2,4
Vivinara,moon-guard,192,druid,feral,6,2,4
Karpin,area-52,192,druid,feral,6,2,4
Bronaarr,nordrassil,192,druid,feral,6,2,4
Nabious,malganis,192,druid,feral,6,2,4
Taiga,moon-guard,192,druid,feral,6,2,4
Tauretari,tichondrius,192,druid,feral,6,2,4
Hehaw,kelthuzad,192,druid,feral,6,2,4
Khaoticklaw,stormrage,192,druid,feral,6,2,4
Milezy,area-52,192,druid,feral,6,2,4
Vctrphs,nemesis,192,druid,feral,6,2,4
Katskratch,sargeras,192,druid,feral,6,2,4
Metaldruid,tichondrius,192,druid,feral,6,2,4
Healorhell,azralon,192,druid,feral,6,2,4
Snupy,area-52,192,druid,feral,6,2,4
Qouro,area-52,192,druid,feral,6,2,4
Eliaris,rivendare,192,druid,feral,6,2,4
Yakir,kiljaeden,192,druid,feral,6,2,4
Buyadoge,area-52,192,druid,feral,6,2,4
Majdomoterry,proudmoore,192,druid,feral,6,2,4
Fødaødruida,azralon,192,druid,feral,6,2,4
Haegur,tichondrius,192,druid,feral,6,2,4
Robbieshift,emerald-dream,192,druid,feral,6,2,4
Lavanca,azralon,192,druid,feral,6,2,4
Veryhighrn,area-52,192,druid,feral,6,2,4
Uphine,area-52,192,druid,feral,6,2,4
Dreadonly,tichondrius,192,druid,feral,6,2,4
Timdillon,emerald-dream,192,druid,feral,6,2,4
Dawsonxo,proudmoore,192,druid,feral,6,2,4
Happyc,bleeding-hollow,192,druid,feral,12,2,10
Imass,draka,192,druid,feral,12,2,10
Meudayr,crushridge,192,druid,feral,12,2,10
Drabo,boulderfist,192,druid,feral,12,2,10
Ymirgore,zuljin,192,druid,feral,12,2,10
Àcid,stormreaver,192,druid,feral,12,2,10
Igneël,ragnaros,192,druid,feral,12,2,10
Shadedmika,zuljin,192,druid,feral,12,2,10
Faroo,azralon,192,druid,feral,12,2,10
Codieneme,blades-edge,192,druid,feral,12,2,10
Nerfdemo,kiljaeden,192,druid,feral,12,2,10
Envasions,emerald-dream,192,druid,feral,12,2,10
Pawz,windrunner,192,druid,feral,12,2,10
Seyala,moon-guard,192,druid,feral,12,2,10
Rorhenn,moon-guard,192,druid,feral,18,2,16
Boomanon,illidan,191,druid,feral,6,2,4
Liightbite,illidan,191,druid,feral,12,2,10
Feralhearted,tichondrius,175,druid,feral,11,2,9
Bowbaggins,bleeding-hollow,159,druid,feral,5,2,3
Jdoozie,bleeding-hollow,159,druid,feral,5,2,3
Kipsmiffly,darkspear,128,druid,feral,4,2,2
Jumpjumpcat,tichondrius,96,druid,feral,3,2,1
Feles,darkspear,96,druid,feral,3,2,1
Importedalc,zuljin,96,druid,feral,6,1,5
Krawnk,zuljin,96,druid,feral,6,1,5
Wreckingcrew,emerald-dream,96,druid,feral,6,1,5
Ottoro,azralon,96,druid,feral,6,1,5
Lakroz,zuljin,96,druid,feral,6,1,5
Captclaws,tichondrius,96,druid,feral,6,1,5
Raigor,azralon,96,druid,feral,6,1,5
Aigo,azralon,96,druid,feral,6,1,5
Ghostboy,zuljin,96,druid,feral,6,1,5
Avorah,tichondrius,96,druid,feral,6,1,5
Kî,thunderlord,96,druid,feral,6,1,5
Ciggy,maiev,96,druid,feral,6,1,5
Morizo,proudmoore,96,druid,feral,6,1,5
Valdr,stormrage,96,druid,feral,6,1,5
Alope,blades-edge,96,druid,feral,6,1,5
Polyproof,emerald-dream,96,druid,feral,6,1,5
Yungle,tichondrius,96,druid,feral,6,1,5
Thebigcat,deathwing,96,druid,feral,6,1,5
Ban,chogall,96,druid,feral,6,1,5
Mootality,area-52,96,druid,feral,6,1,5
Édzar,area-52,96,druid,feral,6,1,5
Healthy,auchindoun,96,druid,feral,6,1,5
Yuandi,tichondrius,96,druid,feral,6,1,5
Acórn,frostmourne,96,druid,feral,6,1,5
Colinferal,thrall,96,druid,feral,6,1,5
Shlümp,tichondrius,96,druid,feral,6,1,5
Shawdoostorm,nemesis,96,druid,feral,6,1,5
Terminated,tichondrius,96,druid,feral,6,1,5
Crazypaddy,dark-iron,96,druid,feral,6,1,5
Jawsbee,emerald-dream,96,druid,feral,6,1,5
Samedo,sargeras,96,druid,feral,6,1,5
Bootzs,kelthuzad,96,druid,feral,6,1,5
Treepiss,tichondrius,96,druid,feral,6,1,5
Cattdog,tichondrius,96,druid,feral,6,1,5
Feralhefty,stormrage,96,druid,feral,6,1,5
Tuskdaddie,sargeras,96,druid,feral,6,1,5
Ilikedôggy,saurfang,96,druid,feral,6,1,5
Asaptom,frostmourne,96,druid,feral,6,1,5
Shïfty,tichondrius,96,druid,feral,6,1,5
Frëýá,bleeding-hollow,96,druid,feral,6,1,5
Hynz,barthilas,96,druid,feral,6,1,5
Purpyo,bleeding-hollow,96,druid,feral,6,1,5
Furrycon,ysera,96,druid,feral,6,1,5
Hasemilë,dalaran,96,druid,feral,6,1,5
Vernaar,laughing-skull,96,druid,feral,6,1,5
Garcia,feathermoon,96,druid,feral,6,1,5
Gretatunberg,skywall,96,druid,feral,6,1,5
Kollective,sargeras,96,druid,feral,6,1,5
Dotsgallore,garrosh,96,druid,feral,6,1,5
Nyatarii,hakkar,96,druid,feral,6,1,5
Droody,earthen-ring,96,druid,feral,6,1,5
Naztekk,dalaran,96,druid,feral,6,1,5
Deelark,skywall,96,druid,feral,6,1,5
Boundless,skullcrusher,96,druid,feral,6,1,5
Ashmíla,ragnaros,96,druid,feral,6,1,5
Barnabie,black-dragonflight,96,druid,feral,6,1,5
Dééz,illidan,96,druid,feral,6,1,5
Ausbie,garona,96,druid,feral,6,1,5
Chumdrumrum,malganis,96,druid,feral,6,1,5
Crowaar,moon-guard,96,druid,feral,6,1,5
Ticømia,stormrage,96,druid,feral,6,1,5
Aquahektik,malganis,96,druid,feral,6,1,5
Fortunecat,illidan,96,druid,feral,6,1,5
Swippy,blackhand,96,druid,feral,6,1,5
Whiplash,deathwing,96,druid,feral,6,1,5
Ojira,moon-guard,96,druid,feral,6,1,5
Laynahri,moon-guard,96,druid,feral,6,1,5
Fuzzwuzzyqt,tichondrius,96,druid,feral,6,1,5
Ärianagrande,stormrage,96,druid,feral,6,1,5
Glorp,blackwater-raiders,96,druid,feral,6,1,5
Fbombzz,kalecgos,96,druid,feral,6,1,5
Nezrael,frostwolf,96,druid,feral,6,1,5
Byefren,darkspear,96,druid,feral,7,1,6
Versipex,emerald-dream,96,druid,feral,12,1,11
Ballsnack,zuljin,96,druid,feral,12,1,11
Habras,alterac-mountains,96,druid,feral,12,1,11
Owlcapwn,tichondrius,96,druid,feral,12,1,11
Wonderclam,sargeras,96,druid,feral,12,1,11
Backlazsh,illidan,96,druid,feral,12,1,11
Capson,darkspear,96,druid,feral,12,1,11
Grovestalker,nemesis,96,druid,feral,12,1,11
Funfunfrank,aegwynn,96,druid,feral,12,1,11
Lonewolfdrd,illidan,96,druid,feral,12,1,11
Furiøsä,quelthalas,95,druid,feral,6,1,5
Skwidrific,crushridge,95,druid,feral,12,1,11
Gitsnshigles,frostmourne,79,druid,feral,5,1,4
Chubakea,kiljaeden,48,druid,feral,3,1,2
Wierdosaur,azralon,48,druid,feral,3,1,2
Bjohns,bleeding-hollow,42,druid,feral,9,2,7
Enderhero,illidan,42,druid,feral,14,2,12
Ânhur,tichondrius,42,druid,feral,17,2,15
Dobrman,sargeras,31,druid,feral,2,1,1
Psynix,zuljin,16,druid,feral,1,1,0
Laryfsherman,tichondrius,2324,druid,balance,83,54,29
Legionsucks,tanaris,2321,druid,balance,144,83,61
Fredagn,illidan,2306,druid,balance,90,55,35
Supatease,tichondrius,2302,druid,balance,123,72,51
Jbz,balnazzar,2269,druid,balance,201,128,73
Owl,shadowsong,2261,druid,balance,120,69,51
Cti,tichondrius,2204,druid,balance,59,42,17
Theforeigner,arathor,2194,druid,balance,59,46,13
Notes,sargeras,2187,druid,balance,104,54,50
Gugukuaipao,tichondrius,2186,druid,balance,155,83,72
Flowerboï,azralon,2180,druid,balance,96,69,27
Bkqtpie,tichondrius,2176,druid,balance,106,59,47
Tanerno,illidan,2168,druid,balance,123,72,51
Flapz,illidan,2164,druid,balance,66,38,28
Sonicphantom,kelthuzad,2145,druid,balance,96,61,35
Pushpop,frostmourne,2140,druid,balance,84,53,31
Impëria,quelthalas,2137,druid,balance,89,58,31
Mewfasa,duskwood,2135,druid,balance,147,94,53
Houli,tichondrius,2134,druid,balance,96,50,46
Smëagol,zuljin,2133,druid,balance,114,59,55
Nbadizzyboy,illidan,2130,druid,balance,53,43,10
Bigdiablo,frostmourne,2130,druid,balance,207,114,93
Kidcudi,dentarg,2127,druid,balance,210,108,102
Peterßigßeam,malganis,2127,druid,balance,117,60,57
Xijînping,tichondrius,2125,druid,balance,69,41,28
Pisces,emerald-dream,2123,druid,balance,128,75,53
Boomçhicken,tichondrius,2121,druid,balance,88,48,40
Dízzen,bleeding-hollow,2120,druid,balance,90,57,33
Solareclipse,tichondrius,2120,druid,balance,72,43,29
Tranquilo,stormrage,2118,druid,balance,114,69,45
Riskies,tichondrius,2116,druid,balance,252,133,119
Brose,malganis,2115,druid,balance,66,43,23
Altoberano,azralon,2111,druid,balance,89,49,40
Fergh,tichondrius,2109,druid,balance,83,45,38
Trusyrusty,stormrage,2107,druid,balance,151,83,68
Gritzxv,stormrage,2105,druid,balance,83,48,35
Sqwippyd,tichondrius,2102,druid,balance,78,49,29
Hessenmèow,tichondrius,2102,druid,balance,84,44,40
Gspx,dalaran,2089,druid,balance,60,33,27
Soggykfc,illidan,2078,druid,balance,140,76,64
Treirus,sargeras,2064,druid,balance,142,96,46
Catworm,sargeras,2063,druid,balance,70,46,24
Nokomanida,zuljin,2053,druid,balance,75,48,27
Ertuzi,tichondrius,2052,druid,balance,114,68,46
Balancex,tichondrius,2049,druid,balance,120,58,62
Hayase,tichondrius,2041,druid,balance,108,64,44
Convokeopp,tichondrius,2034,druid,balance,54,39,15
Houlix,stormrage,2034,druid,balance,283,139,144
Lazygaga,zuljin,2025,druid,balance,122,67,55
Megadruidx,stormrage,2022,druid,balance,81,55,26
Lavlol,frostmourne,2021,druid,balance,316,166,150
Lgpepperoni,tichondrius,2020,druid,balance,54,47,7
Biophilic,moon-guard,2020,druid,balance,94,48,46
Omends,thrall,2017,druid,balance,122,66,56
Compléx,tichondrius,2016,druid,balance,78,41,37
Wnxmomthicc,tichondrius,2013,druid,balance,48,31,17
Flatass,cairne,2013,druid,balance,122,73,49
Soulz,quelthalas,2012,druid,balance,72,43,29
Murkeÿ,frostmourne,2004,druid,balance,108,50,58
Babekisser,stormrage,2002,druid,balance,215,123,92
Fhormations,area-52,2000,druid,balance,119,68,51
Snöwghost,aerie-peak,2000,druid,balance,227,118,109
Bobthehefty,area-52,1999,druid,balance,64,38,26
Lazershartz,cenarion-circle,1992,druid,balance,72,36,36
Zneb,darkspear,1987,druid,balance,36,29,7
Dogwáter,tichondrius,1984,druid,balance,40,29,11
Tòmathy,tichondrius,1982,druid,balance,65,38,27
Fracxx,area-52,1981,druid,balance,30,21,9
Astraldank,tichondrius,1980,druid,balance,148,85,63
Firefirelol,proudmoore,1978,druid,balance,101,45,56
Wereocelot,firetree,1977,druid,balance,138,83,55
Starfail,illidan,1974,druid,balance,60,30,30
Murruk,darkspear,1972,druid,balance,153,84,69
Jimmypop,malganis,1970,druid,balance,115,71,44
Cultnelf,illidan,1967,druid,balance,113,60,53
Kaid,malganis,1964,druid,balance,54,33,21
Pønchø,quelthalas,1960,druid,balance,56,33,23
Vertderferk,tichondrius,1954,druid,balance,68,40,28
John,azralon,1954,druid,balance,144,69,75
Ztraws,tichondrius,1953,druid,balance,94,59,35
Giantpanther,tichondrius,1951,druid,balance,66,45,21
Ezgamed,tichondrius,1950,druid,balance,69,46,23
Yepz,tichondrius,1945,druid,balance,75,42,33
Basedcatx,tichondrius,1940,druid,balance,82,52,30
Napes,tichondrius,1940,druid,balance,60,34,26
Thugrose,blackrock,1938,druid,balance,48,25,23
Sebastian,tichondrius,1937,druid,balance,59,36,23
Spamclonewin,tichondrius,1937,druid,balance,123,73,50
Toughshift,zuljin,1936,druid,balance,66,28,38
Daspdruid,nagrand,1928,druid,balance,230,117,113
Jakob,arygos,1926,druid,balance,162,92,70
Boomkek,wyrmrest-accord,1924,druid,balance,48,33,15
Jaseyxxl,area-52,1923,druid,balance,46,35,11
Lovemakitty,sargeras,1922,druid,balance,78,46,32
Oakwalker,moon-guard,1920,druid,balance,108,59,49
Bubalolz,quelthalas,1914,druid,balance,191,101,90
Herpadruid,illidan,1912,druid,balance,102,48,54
Treeheehee,frostmourne,1911,druid,balance,81,60,21
Locose,black-dragonflight,1911,druid,balance,48,34,14
Foekinghobo,sargeras,1911,druid,balance,132,74,58
Acdru,tichondrius,1911,druid,balance,67,37,30
Dorizio,illidan,1910,druid,balance,64,40,24
Dilondru,area-52,1906,druid,balance,117,70,47
Beefnudlsoup,tichondrius,1906,druid,balance,66,39,27
Etherêal,stormrage,1905,druid,balance,102,59,43
Hxzard,dalaran,1905,druid,balance,146,81,65
Vengex,sargeras,1904,druid,balance,48,30,18
Jayelljaÿ,thrall,1899,druid,balance,129,78,51
Knotgiver,moon-guard,1899,druid,balance,52,31,21
Byk,tichondrius,1896,druid,balance,102,57,45
Halrath,sargeras,1891,druid,balance,36,20,16
Vernaar,laughing-skull,1888,druid,balance,84,47,37
Bables,tichondrius,1886,druid,balance,72,45,27
Celtaberano,illidan,1884,druid,balance,24,20,4
Druidstin,tichondrius,1883,druid,balance,66,33,33
Hefkerd,tichondrius,1881,druid,balance,30,20,10
Ethan,the-venture-co,1879,druid,balance,39,26,13
Lazersnewch,kelthuzad,1877,druid,balance,60,35,25
Geezbutt,tichondrius,1876,druid,balance,157,80,77
Psychotycxd,tichondrius,1870,druid,balance,126,69,57
Sadboy,moon-guard,1869,druid,balance,161,87,74
Boyoboy,thrall,1867,druid,balance,30,22,8
Ràjeesh,frostmourne,1867,druid,balance,46,31,15
Hydrahl,thrall,1867,druid,balance,54,35,19
Çoach,tichondrius,1867,druid,balance,78,43,35
Möshinòõb,proudmoore,1865,druid,balance,58,40,18
Sarvi,zuljin,1864,druid,balance,33,24,9
Elythria,hellscream,1863,druid,balance,30,26,4
Enøsh,tichondrius,1861,druid,balance,84,45,39
Vuru,azralon,1860,druid,balance,41,29,12
Doomty,tichondrius,1860,druid,balance,72,42,30
Mverstapp,moon-guard,1859,druid,balance,42,24,18
Poliage,moon-guard,1858,druid,balance,155,89,66
Mcv,tichondrius,1856,druid,balance,60,33,27
Lilbeam,sargeras,1855,druid,balance,42,27,15
Ericzzdd,tichondrius,1854,druid,balance,60,44,16
Thundoon,tichondrius,1854,druid,balance,36,23,13
Hogd,illidan,1854,druid,balance,60,35,25
Rizzit,wyrmrest-accord,1852,druid,balance,58,32,26
Fifty,ragnaros,1851,druid,balance,84,53,31
Johnieboy,azralon,1850,druid,balance,45,32,13
Angryjo,tichondrius,1850,druid,balance,64,38,26
Suen,tichondrius,1848,druid,balance,48,32,16
Jojo,ysera,1848,druid,balance,119,65,54
Swaggu,kelthuzad,1847,druid,balance,72,44,28
Idolizeme,skullcrusher,1845,druid,balance,59,30,29
Laser,bonechewer,1844,druid,balance,42,27,15
Judar,barthilas,1844,druid,balance,71,36,35
Bentøbøx,barthilas,1841,druid,balance,47,27,20
Ballinthree,illidan,1837,druid,balance,42,32,10
Gèb,dalaran,1835,druid,balance,116,71,45
Elunegoddess,tichondrius,1834,druid,balance,46,27,19
Formhub,malganis,1834,druid,balance,84,42,42
Moonflora,stormrage,1833,druid,balance,129,73,56
Cousa,zuljin,1832,druid,balance,88,52,36
Sawsaw,bleeding-hollow,1832,druid,balance,74,42,32
Ilovediegoxo,kelthuzad,1830,druid,balance,48,32,16
Komacine,emerald-dream,1830,druid,balance,403,217,186
Deloria,nemesis,1829,druid,balance,42,25,17
Dontnerfmore,queldorei,1829,druid,balance,66,31,35
Moozzash,azralon,1828,druid,balance,54,32,22
Chernovax,kelthuzad,1828,druid,balance,87,47,40
Equinøxx,malganis,1827,druid,balance,47,30,17
Bcup,sargeras,1826,druid,balance,54,32,22
Striix,ragnaros,1824,druid,balance,42,22,20
Clonemunster,frostmourne,1821,druid,balance,66,38,28
Fleasy,wyrmrest-accord,1820,druid,balance,85,52,33
Lunalai,bloodhoof,1820,druid,balance,96,55,41
Sueycide,tichondrius,1819,druid,balance,71,34,37
Dipii,proudmoore,1818,druid,balance,30,22,8
Resorange,malganis,1818,druid,balance,48,29,19
Dorlingus,tichondrius,1817,druid,balance,48,29,19
Rìniroo,area-52,1816,druid,balance,48,30,18
Xenny,chogall,1815,druid,balance,48,34,14
Form,bleeding-hollow,1815,druid,balance,96,57,39
Raïsin,moon-guard,1814,druid,balance,45,26,19
Jacusias,stormrage,1814,druid,balance,188,102,86
Animatronixz,area-52,1813,druid,balance,66,34,32
Keylae,sargeras,1812,druid,balance,86,46,40
Drugdoer,tichondrius,1811,druid,balance,106,64,42
Thottiie,hyjal,1811,druid,balance,60,36,24
Moonkay,tichondrius,1810,druid,balance,42,26,16
Instar,tichondrius,1810,druid,balance,36,19,17
Tôpdadwôrld,sargeras,1809,druid,balance,30,19,11
Drcuy,ragnaros,1809,druid,balance,98,56,42
Seyala,moon-guard,1809,druid,balance,175,99,76
Wiredxd,illidan,1807,druid,balance,44,28,16
Cattdog,tichondrius,1806,druid,balance,82,55,27
Dustydrx,area-52,1806,druid,balance,56,34,22
Lakermagik,moknathal,1806,druid,balance,43,25,18
Zeromoon,frostmourne,1806,druid,balance,59,29,30
Harukai,azralon,1805,druid,balance,114,67,47
Exxh,tichondrius,1803,druid,balance,46,34,12
Starbränd,azralon,1803,druid,balance,60,38,22
Youngtree,tichondrius,1803,druid,balance,33,20,13
Halenson,illidan,1803,druid,balance,70,41,29
Itachi,dragonmaw,1803,druid,balance,65,38,27
Vengexd,sargeras,1802,druid,balance,24,19,5
Malfuria,tichondrius,1802,druid,balance,47,29,18
Mythleaf,ragnaros,1802,druid,balance,120,70,50
Felny,malganis,1802,druid,balance,54,26,28
Buffjungle,tichondrius,1801,druid,balance,36,20,16
Treelah,tichondrius,1800,druid,balance,48,29,19
Evsn,tichondrius,1799,druid,balance,24,21,3
Burninmoon,tichondrius,1796,druid,balance,48,28,20
Metroboomy,magtheridon,1795,druid,balance,68,40,28
Lekick,tichondrius,1795,druid,balance,66,36,30
Chal,illidan,1791,druid,balance,53,32,21
Alpine,eldrethalas,1790,druid,balance,54,35,19
Hypefull,tichondrius,1790,druid,balance,48,23,25
Zoteqt,kelthuzad,1789,druid,balance,157,84,73
Haohomie,tichondrius,1783,druid,balance,60,42,18
Destromz,zuljin,1780,druid,balance,36,24,12
Ataraxie,illidan,1780,druid,balance,78,47,31
Sommerrays,kelthuzad,1780,druid,balance,60,31,29
Spacedruidx,illidan,1778,druid,balance,84,47,37
Pipiwiwi,stormrage,1773,druid,balance,99,57,42
Orollå,tichondrius,1771,druid,balance,50,29,21
Oungan,illidan,1771,druid,balance,98,56,42
Çørrúptíøñzx,tichondrius,1770,druid,balance,36,25,11
Cirranis,moon-guard,1769,druid,balance,81,53,28
Boomybro,thrall,1768,druid,balance,140,84,56
Chanimal,tichondrius,1766,druid,balance,30,24,6
Olongjonsson,wyrmrest-accord,1766,druid,balance,36,19,17
Lilkitty,tichondrius,1764,druid,balance,148,81,67
Bathrobe,bloodscalp,1762,druid,balance,48,26,22
Weckxa,sargeras,1762,druid,balance,197,102,95
Purkins,barthilas,1761,druid,balance,36,22,14
Ailari,moon-guard,1761,druid,balance,91,52,39
Catpoop,frostmourne,1759,druid,balance,42,30,12
Pennytrate,barthilas,1759,druid,balance,92,54,38
Cocainebeär,tichondrius,1755,druid,balance,77,39,38
Cynhawts,emerald-dream,1754,druid,balance,46,27,19
Swayjizz,tichondrius,1750,druid,balance,114,64,50
Rikishi,executus,1749,druid,balance,54,29,25
Glazinator,sargeras,1749,druid,balance,178,88,90
Deviperdruid,frostmourne,1748,druid,balance,51,35,16
Meowkit,blackrock,1744,druid,balance,48,33,15
Ayla,gorefiend,1741,druid,balance,47,30,17
Foxhoundlol,tichondrius,1741,druid,balance,66,42,24
Jaxer,illidan,1741,druid,balance,111,68,43
Owlyfans,frostmourne,1741,druid,balance,42,25,17
Readt,malganis,1738,druid,balance,198,108,90
Ebrìthil,hyjal,1737,druid,balance,54,27,27
Ilovediego,stormrage,1736,druid,balance,36,21,15
Kydralola,ragnaros,1735,druid,balance,36,21,15
Petruccius,nordrassil,1735,druid,balance,208,104,104
Nxf,sargeras,1734,druid,balance,35,21,14
Druidwhat,stormrage,1734,druid,balance,153,81,72
Deenut,sargeras,1733,druid,balance,36,24,12
Bunnykiss,tichondrius,1733,druid,balance,79,38,41
Melloj,kelthuzad,1732,druid,balance,66,38,28
Yggdrasil,ravencrest,1732,druid,balance,42,24,18
Daddyshift,proudmoore,1731,druid,balance,62,35,27
Jemima,auchindoun,1730,druid,balance,136,80,56
Nyloke,kelthuzad,1729,druid,balance,66,44,22
Choosegoose,area-52,1729,druid,balance,44,29,15
Scene,frostmourne,1729,druid,balance,71,40,31
Dextructive,tichondrius,1729,druid,balance,124,60,64
Kydro,sargeras,1728,druid,balance,48,25,23
Druidk,tichondrius,1728,druid,balance,60,28,32
Cobal,goldrinn,1727,druid,balance,419,216,203
Trapdoorboom,illidan,1726,druid,balance,96,51,45
Souress,shadowsong,1725,druid,balance,48,28,20
Stinkÿ,bleeding-hollow,1724,druid,balance,63,42,21
Faerie,kaelthas,1724,druid,balance,64,36,28
Bukkwild,stormrage,1723,druid,balance,50,38,12
Pannaxx,tichondrius,1723,druid,balance,36,24,12
Naakx,tichondrius,1722,druid,balance,52,30,22
Wecksox,area-52,1721,druid,balance,246,119,127
Wòót,stormreaver,1719,druid,balance,84,58,26
Xantastic,area-52,1719,druid,balance,42,24,18
Starsucceed,illidan,1718,druid,balance,42,21,21
Brainlessqt,tichondrius,1717,druid,balance,34,24,10
Droodaphobé,sargeras,1714,druid,balance,59,34,25
Cjæ,bleeding-hollow,1713,druid,balance,24,18,6
Dànkness,frostwolf,1713,druid,balance,53,29,24
Frames,area-52,1712,druid,balance,77,39,38
Nophysique,zuljin,1709,druid,balance,112,62,50
Líu,area-52,1705,druid,balance,90,55,35
Skeevz,darkspear,1705,druid,balance,56,32,24
Kyura,sargeras,1705,druid,balance,130,62,68
Mädnhairy,zuljin,1703,druid,balance,45,28,17
Maligoz,nemesis,1703,druid,balance,95,49,46
Beamed,thrall,1702,druid,balance,24,18,6
Davione,tichondrius,1702,druid,balance,46,28,18
Rerob,aerie-peak,1702,druid,balance,50,26,24
Whoopz,blackrock,1702,druid,balance,36,18,18
Donutdruid,illidan,1701,druid,balance,46,29,17
Pào,tichondrius,1701,druid,balance,45,28,17
Doomdawn,sargeras,1701,druid,balance,123,65,58
Pils,nemesis,1700,druid,balance,124,74,50
Staystrongox,tichondrius,1700,druid,balance,70,41,29
Smeepy,bleeding-hollow,1700,druid,balance,48,26,22
Binjuicex,frostmourne,1699,druid,balance,45,29,16
Drufasa,tichondrius,1699,druid,balance,41,23,18
Kamero,tichondrius,1697,druid,balance,45,26,19
Tunaren,wyrmrest-accord,1696,druid,balance,42,21,21
Boomfold,tichondrius,1696,druid,balance,36,18,18
Krispz,area-52,1696,druid,balance,59,29,30
Protagonist,zuluhed,1695,druid,balance,37,23,14
Raquelitá,ragnaros,1694,druid,balance,28,19,9
Smeow,zuljin,1694,druid,balance,65,36,29
Aqulaíssaela,sargeras,1694,druid,balance,42,23,19
Showmanship,tichondrius,1691,druid,balance,104,59,45
Bolthor,wyrmrest-accord,1691,druid,balance,84,45,39
Sibby,barthilas,1691,druid,balance,90,48,42
Moonrg,stormrage,1689,druid,balance,66,35,31
Djayolo,illidan,1688,druid,balance,30,23,7
Aule,frostmourne,1687,druid,balance,36,18,18
Realmehji,wyrmrest-accord,1686,druid,balance,36,28,8
Spinach,moon-guard,1686,druid,balance,104,53,51
Mortqt,tichondrius,1685,druid,balance,42,23,19
Khryllx,tichondrius,1683,druid,balance,36,25,11
Chickenwings,ragnaros,1683,druid,balance,42,27,15
Ghaal,tichondrius,1683,druid,balance,84,53,31
Dárách,malganis,1683,druid,balance,90,54,36
Gwiffurry,tichondrius,1683,druid,balance,54,32,22
Roofty,illidan,1681,druid,balance,34,22,12
Justsidious,sargeras,1679,druid,balance,30,23,7
Kzinti,zuluhed,1679,druid,balance,85,41,44
Lothail,windrunner,1678,druid,balance,48,25,23
Ruthlessbro,sargeras,1677,druid,balance,85,45,40
Pizzaparties,tichondrius,1676,druid,balance,35,28,7
Myex,illidan,1676,druid,balance,48,32,16
Abomasnow,turalyon,1675,druid,balance,60,35,25
Glickbear,illidan,1675,druid,balance,48,26,22
Ànìmàl,stormrage,1674,druid,balance,36,27,9
Beamrooster,silvermoon,1672,druid,balance,48,32,16
Lostnsauce,tichondrius,1669,druid,balance,60,43,17
Boiledfrogs,zuljin,1669,druid,balance,30,19,11
Irooftrellen,chogall,1669,druid,balance,53,26,27
Halensen,illidan,1668,druid,balance,47,23,24
Wallower,malganis,1667,druid,balance,54,24,30
Yipëë,moon-guard,1666,druid,balance,64,34,30
Ðøomkinz,azjolnerub,1665,druid,balance,48,33,15
Nickyü,ragnaros,1665,druid,balance,54,23,31
Partybeast,malganis,1664,druid,balance,74,55,19
Animlcracker,emerald-dream,1664,druid,balance,54,36,18
Gumbawl,sargeras,1662,druid,balance,36,22,14
Gokki,zuljin,1660,druid,balance,77,53,24
Shafted,kelthuzad,1660,druid,balance,30,20,10
Seilah,lightbringer,1660,druid,balance,36,20,16
Bloomqt,tichondrius,1658,druid,balance,108,62,46
Foafoa,illidan,1657,druid,balance,31,19,12
Verbz,arthas,1656,druid,balance,54,26,28
Nåpes,frostmourne,1656,druid,balance,44,21,23
Niroxic,frostmourne,1654,druid,balance,42,27,15
Ehleven,tichondrius,1654,druid,balance,42,27,15
Gordzak,illidan,1654,druid,balance,158,81,77
Aull,kelthuzad,1653,druid,balance,36,19,17
Roar,moon-guard,1652,druid,balance,45,31,14
Loudpax,zuljin,1652,druid,balance,53,36,17
Renithen,trollbane,1652,druid,balance,42,28,14
Chedisdru,mugthol,1652,druid,balance,42,28,14
Înfamous,thrall,1652,druid,balance,36,24,12
Starlyxo,malganis,1652,druid,balance,59,37,22
Chernlyssayo,stormrage,1652,druid,balance,50,30,20
Drmf,frostmourne,1652,druid,balance,42,25,17
Ashstarfall,barthilas,1651,druid,balance,36,26,10
Druentia,tichondrius,1650,druid,balance,30,20,10
Coldkill,burning-legion,1650,druid,balance,36,20,16
Dôcteurowl,zuljin,1650,druid,balance,77,36,41
Starz,arthas,1649,druid,balance,41,26,15
Wasabilol,tichondrius,1647,druid,balance,79,46,33
Swiftydel,frostmourne,1646,druid,balance,48,27,21
Ironsightsdr,dalaran,1645,druid,balance,51,29,22
Josepha,tichondrius,1643,druid,balance,30,20,10
Wizdùm,frostmourne,1643,druid,balance,53,34,19
Convokeula,tichondrius,1643,druid,balance,90,55,35
Pankecito,ragnaros,1643,druid,balance,52,30,22
Aethisra,moon-guard,1642,druid,balance,125,72,53
Boomchickens,area-52,1642,druid,balance,60,33,27
Partylord,malganis,1642,druid,balance,108,57,51
Irl,frostmane,1641,druid,balance,41,23,18
Scurse,tichondrius,1641,druid,balance,102,53,49
Grapeful,frostmourne,1640,druid,balance,66,37,29
Sweatypapa,tichondrius,1639,druid,balance,72,49,23
Rumorxo,illidan,1639,druid,balance,30,18,12
Chøpstixs,bleeding-hollow,1639,druid,balance,48,28,20
Snugglin,kelthuzad,1639,druid,balance,60,31,29
Goochies,aerie-peak,1638,druid,balance,29,18,11
Jillferal,proudmoore,1638,druid,balance,78,47,31
Handhandb,tichondrius,1638,druid,balance,30,18,12
Quelarre,velen,1638,druid,balance,94,53,41
Phurr,area-52,1638,druid,balance,48,25,23
Brokenomega,area-52,1637,druid,balance,112,67,45
Killiamp,tichondrius,1636,druid,balance,41,27,14
Kïx,illidan,1636,druid,balance,38,23,15
Marutot,tichondrius,1635,druid,balance,30,24,6
Thamoonsbak,aggramar,1635,druid,balance,35,18,17
Taylorshift,misha,1633,druid,balance,27,23,4
Blitzkreigtv,area-52,1633,druid,balance,36,23,13
Trapkin,tichondrius,1631,druid,balance,167,101,66
Bunnyes,tichondrius,1631,druid,balance,42,22,20
Midnitetoker,hyjal,1631,druid,balance,48,25,23
Meatbender,frostmourne,1630,druid,balance,86,41,45
Relaeh,andorhal,1629,druid,balance,36,19,17
Kekepöp,illidan,1628,druid,balance,36,25,11
Elyveen,proudmoore,1627,druid,balance,63,46,17
Bearyhallsjr,sargeras,1627,druid,balance,24,17,7
Animaldoctor,illidan,1627,druid,balance,57,38,19
Jimrobloxttv,emerald-dream,1627,druid,balance,36,24,12
Oppose,akama,1627,druid,balance,65,37,28
Dreamwalker,bleeding-hollow,1626,druid,balance,24,17,7
Muwudred,stormrage,1626,druid,balance,48,28,20
Ablackdruid,moon-guard,1624,druid,balance,35,21,14
Flappyjacks,elune,1624,druid,balance,42,22,20
Vergota,emerald-dream,1623,druid,balance,67,46,21
Moonra,malganis,1623,druid,balance,66,38,28
Soonntkgo,ragnaros,1623,druid,balance,56,29,27
Eseldra,area-52,1622,druid,balance,58,34,24
Harryhotter,blackrock,1622,druid,balance,109,54,55
Reàsons,stormrage,1622,druid,balance,66,30,36
Kelagoat,kiljaeden,1620,druid,balance,54,26,28
Cenariun,stormrage,1619,druid,balance,30,19,11
Mûû,tichondrius,1619,druid,balance,80,46,34
Contrololol,hyjal,1619,druid,balance,60,32,28
Gatø,area-52,1619,druid,balance,90,42,48
Cyclone,darkspear,1618,druid,balance,36,17,19
Girthybeam,sargeras,1617,druid,balance,38,22,16
Balanci,stormrage,1617,druid,balance,64,36,28
Wildslash,proudmoore,1617,druid,balance,75,37,38
Softkiller,chogall,1616,druid,balance,54,33,21
Yazmawma,tichondrius,1616,druid,balance,30,18,12
Cottonpaw,sargeras,1616,druid,balance,205,118,87
Mastabtw,illidan,1616,druid,balance,30,17,13
Treeshift,tichondrius,1615,druid,balance,53,32,21
Furryswipe,proudmoore,1614,druid,balance,56,33,23
Polánd,area-52,1614,druid,balance,75,43,32
Fätål,ysera,1613,druid,balance,54,33,21
Héisénbérg,sargeras,1613,druid,balance,48,27,21
Auras,kelthuzad,1612,druid,balance,120,73,47
Duglas,illidan,1612,druid,balance,91,55,36
Xannê,tichondrius,1612,druid,balance,38,20,18
Ellguin,malganis,1611,druid,balance,60,44,16
Buckwhêât,illidan,1611,druid,balance,64,28,36
Pänzerkin,sargeras,1609,druid,balance,30,21,9
Yosuzume,thrall,1609,druid,balance,36,24,12
Alaillais,moon-guard,1609,druid,balance,48,28,20
Canek,ghostlands,1609,druid,balance,107,62,45
Kittiepurry,blackrock,1607,druid,balance,112,63,49
Surfingbird,tichondrius,1606,druid,balance,195,116,79
Boys,bleeding-hollow,1606,druid,balance,42,24,18
Braviel,stormrage,1605,druid,balance,54,32,22
Raddosaurus,area-52,1605,druid,balance,83,45,38
Djsummer,tichondrius,1605,druid,balance,107,56,51
Yehaw,bloodhoof,1604,druid,balance,54,35,19
Lyshani,thrall,1604,druid,balance,46,27,19
Awazing,illidan,1604,druid,balance,53,25,28
Nehrudruid,area-52,1603,druid,balance,24,17,7
Anchunlol,tichondrius,1603,druid,balance,36,19,17
Gallianö,frostmourne,1601,druid,balance,40,23,17
Brodda,sargeras,1600,druid,balance,194,101,93
Kletys,azralon,1599,druid,balance,113,57,56
Stellar,steamwheedle-cartel,1597,druid,balance,24,19,5
Inuyasha,sargeras,1597,druid,balance,59,34,25
Fìlø,bleeding-hollow,1595,druid,balance,186,106,80
Odirtytshirt,malganis,1595,druid,balance,55,27,28
Skurts,tichondrius,1594,druid,balance,39,25,14
Blackjésüs,kelthuzad,1594,druid,balance,153,86,67
Soupbeandru,zuljin,1593,druid,balance,48,28,20
Frostig,tichondrius,1593,druid,balance,30,17,13
Faelonk,frostmourne,1592,druid,balance,30,23,7
Soar,destromath,1592,druid,balance,62,36,26
Kittycleave,tichondrius,1591,druid,balance,24,17,7
Charmandxr,hyjal,1589,druid,balance,40,22,18
Sodapooping,azjolnerub,1588,druid,balance,96,58,38
Ånðrømæðå,sargeras,1588,druid,balance,48,26,22
Davo,tichondrius,1587,druid,balance,42,27,15
Seyedo,sargeras,1587,druid,balance,65,38,27
Skirts,area-52,1587,druid,balance,59,34,25
Còyot,stormrage,1586,druid,balance,60,30,30
Korbö,zuljin,1585,druid,balance,30,18,12
Torrox,tichondrius,1585,druid,balance,148,82,66
Druizzy,illidan,1585,druid,balance,54,21,33
Fancynut,kiljaeden,1583,druid,balance,56,26,30
Yoglosmas,tichondrius,1582,druid,balance,24,19,5
Shîfty,ysondre,1580,druid,balance,65,35,30
Jeanz,bonechewer,1579,druid,balance,36,22,14
Druiddruid,daggerspine,1577,druid,balance,59,36,23
Astrals,runetotem,1577,druid,balance,39,21,18
Trippyshift,hyjal,1577,druid,balance,48,24,24
Lewïs,stormrage,1576,druid,balance,57,30,27
Krahz,lightnings-blade,1576,druid,balance,348,177,171
Darach,boulderfist,1575,druid,balance,30,21,9
Quaras,frostmourne,1574,druid,balance,235,125,110
Clarice,shattered-halls,1574,druid,balance,99,51,48
Sombrien,stormrage,1573,druid,balance,90,46,44
Mõoõoõoõoõoõ,tichondrius,1573,druid,balance,36,18,18
Nodadpullout,tichondrius,1572,druid,balance,51,25,26
Beretta,rexxar,1571,druid,balance,84,48,36
Rayzer,bleeding-hollow,1571,druid,balance,120,64,56
Theboomkin,kelthuzad,1570,druid,balance,30,19,11
Saltydru,illidan,1570,druid,balance,44,25,19
Bugbugz,tichondrius,1570,druid,balance,36,18,18
Starsurgê,tichondrius,1569,druid,balance,66,42,24
Boõsty,bleeding-hollow,1569,druid,balance,36,19,17
Sadsex,illidan,1567,druid,balance,101,59,42
Børing,sargeras,1566,druid,balance,60,35,25
Atagoo,tichondrius,1566,druid,balance,198,103,95
Maplêleaf,moon-guard,1566,druid,balance,117,60,57
Venkin,gnomeregan,1566,druid,balance,96,47,49
Fondra,sargeras,1564,druid,balance,37,23,14
Rakex,tichondrius,1564,druid,balance,68,35,33
Groggs,frostwolf,1564,druid,balance,39,20,19
Ahrilee,area-52,1564,druid,balance,36,18,18
Swoopy,stormrage,1563,druid,balance,79,44,35
Slumpxaddy,illidan,1562,druid,balance,35,21,14
Xiaoshuaigê,illidan,1562,druid,balance,30,18,12
Bhboom,tichondrius,1562,druid,balance,42,19,23
Delorík,illidan,1561,druid,balance,96,51,45
Montrá,stormrage,1560,druid,balance,90,42,48
Rokk,baelgun,1558,druid,balance,73,45,28
Nasuu,bleeding-hollow,1556,druid,balance,60,36,24
Zesto,nazjatar,1555,druid,balance,24,17,7
Targareyen,sargeras,1555,druid,balance,47,20,27
Syclonez,stormrage,1554,druid,balance,42,21,21
Hasteley,khadgar,1554,druid,balance,71,34,37
Thespían,tichondrius,1553,druid,balance,369,193,176
Midoo,proudmoore,1553,druid,balance,48,25,23
Drdrulittle,darkspear,1553,druid,balance,78,40,38
Lowkie,llane,1552,druid,balance,39,21,18
Darkombra,frostmourne,1552,druid,balance,60,28,32
Afpak,sargeras,1551,druid,balance,60,33,27
Starcastic,tichondrius,1548,druid,balance,108,57,51
Treetard,altar-of-storms,1545,druid,balance,54,27,27
Boome,blackrock,1544,druid,balance,60,33,27
Aralix,zuljin,1544,druid,balance,108,58,50
Hayop,illidan,1543,druid,balance,60,28,32
Kg,cenarion-circle,1541,druid,balance,149,87,62
Ihavehothots,kiljaeden,1540,druid,balance,38,26,12
Zettka,tichondrius,1539,druid,balance,55,32,23
Donresantis,stormreaver,1539,druid,balance,90,46,44
Qs,rivendare,1539,druid,balance,89,39,50
November,wyrmrest-accord,1538,druid,balance,110,62,48
Offthezaza,tichondrius,1538,druid,balance,76,40,36
Hikoro,sargeras,1536,druid,balance,126,74,52
Skum,bloodscalp,1536,druid,balance,63,27,36
Catculator,tichondrius,1534,druid,balance,27,18,9
Slowreverb,silver-hand,1534,druid,balance,30,16,14
Fironous,nerzhul,1532,druid,balance,36,20,16
Komaner,frostmourne,1529,druid,balance,36,16,20
Brockolini,tichondrius,1528,druid,balance,82,44,38
Cauroth,azralon,1527,druid,balance,133,72,61
Indicamicah,tichondrius,1527,druid,balance,54,29,25
Druuyid,jubeithos,1526,druid,balance,114,65,49
Cyeq,blackrock,1526,druid,balance,243,127,116
Chaossdruid,bleeding-hollow,1525,druid,balance,95,58,37
Velaana,tichondrius,1524,druid,balance,44,21,23
Chiikawa,tichondrius,1524,druid,balance,36,16,20
Âzn,tichondrius,1523,druid,balance,54,39,15
Sweatydruidx,tichondrius,1523,druid,balance,24,16,8
Dreveron,bleeding-hollow,1523,druid,balance,36,16,20
Eyzie,stormrage,1522,druid,balance,62,33,29
Epicworld,stormrage,1521,druid,balance,81,50,31
Abn,sargeras,1521,druid,balance,30,17,13
Ripdimebag,frostmourne,1520,druid,balance,46,27,19
Thorothir,ragnaros,1520,druid,balance,110,62,48
Druidlolwtf,area-52,1520,druid,balance,108,52,56
Myeow,illidan,1520,druid,balance,74,35,39
Swooped,emerald-dream,1519,druid,balance,53,29,24
Adaptivv,sargeras,1518,druid,balance,30,21,9
Pirira,quelthalas,1517,druid,balance,42,24,18
Musha,tichondrius,1517,druid,balance,57,30,27
Hagatta,stormrage,1517,druid,balance,151,77,74
Skyde,sargeras,1517,druid,balance,36,17,19
Faruu,tichondrius,1516,druid,balance,24,16,8
Ghostowl,thrall,1516,druid,balance,66,42,24
Groovyroom,tichondrius,1516,druid,balance,42,23,19
Pëps,emerald-dream,1514,druid,balance,48,27,21
Umadornahh,malganis,1514,druid,balance,48,26,22
Kitinglol,alexstrasza,1513,druid,balance,56,28,28
Haymade,sargeras,1512,druid,balance,54,32,22
Blazeikin,tichondrius,1512,druid,balance,36,16,20
Scrubrat,moon-guard,1511,druid,balance,35,27,8
Mk,caelestrasz,1511,druid,balance,30,17,13
Polvinhoo,azralon,1510,druid,balance,54,29,25
Tyapet,area-52,1509,druid,balance,61,31,30
Twinscroll,tichondrius,1508,druid,balance,65,44,21
Zorn,lightnings-blade,1508,druid,balance,48,26,22
Themustafa,tichondrius,1507,druid,balance,30,17,13
Kazamura,tichondrius,1507,druid,balance,48,18,30
Padavore,wyrmrest-accord,1506,druid,balance,65,40,25
Neytîrî,tichondrius,1506,druid,balance,65,35,30
Vyrrath,stormrage,1504,druid,balance,32,19,13
Woog,moon-guard,1504,druid,balance,60,34,26
Awkwarder,emerald-dream,1504,druid,balance,84,43,41
Shebleeder,aegwynn,1503,druid,balance,54,30,24
Daddymaple,tichondrius,1503,druid,balance,42,23,19
Hoagiecannon,moon-guard,1503,druid,balance,143,75,68
Jxrx,malganis,1501,druid,balance,24,16,8
Rootchan,azralon,1501,druid,balance,58,38,20
Nuubmurph,stormrage,1499,druid,balance,33,20,13
Tak,garrosh,1496,druid,balance,36,17,19
Yoloboomkin,tichondrius,1494,druid,balance,46,23,23
Rashmi,kiljaeden,1494,druid,balance,36,18,18
Milksquirts,thrall,1491,druid,balance,87,49,38
Starsurgeon,thrall,1491,druid,balance,138,72,66
Watchmecap,silvermoon,1490,druid,balance,22,18,4
Wildsïde,tichondrius,1490,druid,balance,48,28,20
Kallabaluwa,azralon,1490,druid,balance,41,18,23
Huggerino,stormrage,1489,druid,balance,58,32,26
Cabek,malganis,1488,druid,balance,60,32,28
Panansy,stormrage,1488,druid,balance,254,123,131
Boxtops,bleeding-hollow,1486,druid,balance,36,23,13
Restorationz,tichondrius,1485,druid,balance,59,36,23
Charnlok,thunderlord,1484,druid,balance,41,29,12
Stepbro,malorne,1484,druid,balance,95,53,42
Dreamkin,tichondrius,1484,druid,balance,48,25,23
Byte,ragnaros,1482,druid,balance,29,16,13
Pawpurrazzi,darkspear,1482,druid,balance,53,27,26
Owlgz,barthilas,1482,druid,balance,36,18,18
Taurenasarus,area-52,1479,druid,balance,33,18,15
Fahnir,ragnaros,1477,druid,balance,66,37,29
Haneulso,tichondrius,1477,druid,balance,237,125,112
Maviç,hyjal,1477,druid,balance,90,45,45
Ryügähidëki,tichondrius,1476,druid,balance,61,32,29
Árès,frostmourne,1475,druid,balance,47,27,20
Fripp,stormrage,1475,druid,balance,36,20,16
Kuwä,proudmoore,1474,druid,balance,72,36,36
Gummoo,tichondrius,1472,druid,balance,42,30,12
Suncintus,aggramar,1468,druid,balance,54,24,30
Softdog,stormrage,1467,druid,balance,30,19,11
Thatscute,moon-guard,1466,druid,balance,312,161,151
Nephdruid,stormrage,1464,druid,balance,93,53,40
Redhotbean,tichondrius,1464,druid,balance,53,25,28
Unclenya,barthilas,1463,druid,balance,72,32,40
Clense,tichondrius,1461,druid,balance,67,38,29
Bruddahderpp,tichondrius,1460,druid,balance,42,28,14
Rajionu,kiljaeden,1460,druid,balance,30,20,10
Zhinger,tichondrius,1460,druid,balance,79,39,40
Seyon,tichondrius,1459,druid,balance,33,17,16
Shiftyn,proudmoore,1457,druid,balance,30,22,8
Lãzy,tichondrius,1456,druid,balance,96,53,43
Yaboidakota,stormrage,1456,druid,balance,160,84,76
Metal,jaedenar,1456,druid,balance,61,30,31
Pooöòôp,kiljaeden,1454,druid,balance,24,18,6
Aranuir,emerald-dream,1452,druid,balance,35,20,15
Queiq,kelthuzad,1452,druid,balance,42,22,20
Rezlur,tichondrius,1452,druid,balance,35,16,19
Thunderhox,tichondrius,1451,druid,balance,67,36,31
Alshari,proudmoore,1450,druid,balance,30,19,11
Kittygoboom,kiljaeden,1450,druid,balance,60,24,36
Paddywhacked,tichondrius,1449,druid,balance,36,22,14
Jruids,stormrage,1449,druid,balance,54,32,22
Cerest,kaelthas,1448,druid,balance,34,21,13
Juicywap,proudmoore,1448,druid,balance,47,26,21
Instanodle,proudmoore,1447,druid,balance,36,20,16
Windstag,korgath,1447,druid,balance,36,17,19
Sileda,nemesis,1445,druid,balance,25,18,7
Rdruidchump,the-forgotten-coast,1445,druid,balance,32,19,13
Syntheris,kaelthas,1445,druid,balance,87,51,36
Bighomïe,emerald-dream,1445,druid,balance,48,27,21
Hitchslaps,tichondrius,1445,druid,balance,36,19,17
Atmospherè,tichondrius,1444,druid,balance,48,27,21
Pavati,bleeding-hollow,1444,druid,balance,38,21,17
Formmaster,malganis,1441,druid,balance,76,38,38
Thatboiscrew,tichondrius,1439,druid,balance,35,26,9
Nicotinefien,sargeras,1439,druid,balance,24,15,9
Drubuzz,tichondrius,1439,druid,balance,102,56,46
Lunarbalance,veknilash,1438,druid,balance,99,44,55
Elvishrage,zuljin,1437,druid,balance,18,15,3
Brettdadad,shandris,1437,druid,balance,30,19,11
Envoy,sargeras,1435,druid,balance,60,33,27
Supafat,thrall,1434,druid,balance,25,16,9
Alliess,aerie-peak,1434,druid,balance,111,56,55
Falkond,tichondrius,1433,druid,balance,35,18,17
Squidwonk,sargeras,1433,druid,balance,48,23,25
Arealdruid,moon-guard,1433,druid,balance,42,18,24
Shapedance,sargeras,1431,druid,balance,35,16,19
Maimz,tichondrius,1430,druid,balance,84,49,35
Ularda,bleeding-hollow,1429,druid,balance,36,22,14
Nokash,tichondrius,1425,druid,balance,43,17,26
Squidrific,tichondrius,1424,druid,balance,71,47,24
Swappy,korgath,1424,druid,balance,36,18,18
Nebulose,moon-guard,1424,druid,balance,59,26,33
Gaawdx,illidan,1424,druid,balance,90,39,51
Tahunne,tichondrius,1423,druid,balance,88,53,35
Mèowcenaary,chogall,1423,druid,balance,60,35,25
Trickatreyy,kelthuzad,1421,druid,balance,37,19,18
Dudur,zuljin,1420,druid,balance,72,33,39
Dontfloodit,tichondrius,1419,druid,balance,87,40,47
Basulto,tichondrius,1418,druid,balance,72,38,34
Monsin,illidan,1418,druid,balance,120,61,59
Maxspeed,tichondrius,1417,druid,balance,24,15,9
Raximus,moon-guard,1417,druid,balance,84,42,42
Bigherbo,zuljin,1417,druid,balance,42,19,23
Seannybhoy,emerald-dream,1417,druid,balance,52,22,30
Dorobloom,sargeras,1416,druid,balance,24,16,8
Jentlegiant,tichondrius,1416,druid,balance,24,15,9
Faroo,azralon,1416,druid,balance,40,24,16
Crocface,tichondrius,1415,druid,balance,66,38,28
Graffsworth,emerald-dream,1415,druid,balance,51,27,24
Axiomisop,tichondrius,1414,druid,balance,53,32,21
Leonardsby,tichondrius,1414,druid,balance,54,28,26
Lightconvoke,norgannon,1413,druid,balance,38,19,19
Gullmock,quelthalas,1412,druid,balance,78,35,43
Sammio,emerald-dream,1411,druid,balance,44,23,21
Wiiee,darkspear,1410,druid,balance,80,48,32
Dalsardirn,sargeras,1410,druid,balance,30,17,13
Sofereir,frostmourne,1410,druid,balance,155,77,78
Snailbeam,shattered-hand,1410,druid,balance,48,20,28
Feroz,frostmourne,1409,druid,balance,24,15,9
Ocâ,cenarius,1408,druid,balance,26,17,9
Swampduck,saurfang,1407,druid,balance,24,15,9
Kawshuhn,bleeding-hollow,1407,druid,balance,90,51,39
Côheed,bleeding-hollow,1407,druid,balance,30,15,15
Chonkykitty,frostmourne,1405,druid,balance,30,19,11
Slyfoxx,stonemaul,1403,druid,balance,92,53,39
Jainzar,dreadmaul,1400,druid,balance,48,22,26
Cudbacrakhed,tichondrius,1399,druid,balance,48,27,21
Jaduss,thrall,1398,druid,balance,38,18,20
Zuice,thrall,1398,druid,balance,69,32,37
Ereshkïgal,stormrage,1397,druid,balance,27,16,11
Nightstalkr,kelthuzad,1397,druid,balance,210,110,100
Deathkahn,lightninghoof,1397,druid,balance,60,31,29
Drunknoodles,stormrage,1396,druid,balance,29,16,13
Ulcera,nemesis,1396,druid,balance,33,17,16
Moonfart,zuljin,1393,druid,balance,47,24,23
Repanda,proudmoore,1389,druid,balance,77,38,39
Beastsworn,alexstrasza,1388,druid,balance,42,15,27
Seneshy,azralon,1387,druid,balance,30,22,8
Meowmixx,frostmane,1385,druid,balance,47,22,25
Skrimshaw,burning-legion,1384,druid,balance,42,20,22
Driftwood,bonechewer,1381,druid,balance,53,30,23
Envasions,emerald-dream,1380,druid,balance,24,15,9
Threk,spirestone,1379,druid,balance,42,16,26
Nanashi,tichondrius,1378,druid,balance,30,15,15
Huskars,tichondrius,1375,druid,balance,48,26,22
Shemeus,malganis,1374,druid,balance,54,27,27
Starsaber,dalaran,1372,druid,balance,42,24,18
Saeval,korgath,1370,druid,balance,87,46,41
Asteriel,stormrage,1367,druid,balance,54,24,30
Binnchook,barthilas,1366,druid,balance,31,19,12
Barrahjr,frostmourne,1366,druid,balance,51,28,23
Skagakr,moon-guard,1366,druid,balance,131,65,66
Throatjelly,blackrock,1363,druid,balance,42,23,19
Justinheras,area-52,1363,druid,balance,64,35,29
Druiddreams,frostmourne,1358,druid,balance,24,17,7
Rígél,ragnaros,1358,druid,balance,72,37,35
Qelthalas,sargeras,1355,druid,balance,189,98,91
Gitsnshigles,frostmourne,1352,druid,balance,43,23,20
Stärfäll,frostmourne,1351,druid,balance,24,17,7
Tahnu,deathwing,1350,druid,balance,23,15,8
Genghisz,area-52,1349,druid,balance,53,24,29
Mythelian,icecrown,1348,druid,balance,60,34,26
Aolus,kaelthas,1344,druid,balance,42,23,19
Ironbark,azuremyst,1344,druid,balance,33,15,18
Dekmdrui,quelthalas,1343,druid,balance,21,16,5
Imshiftastic,area-52,1342,druid,balance,52,28,24
Ottovonbird,tichondrius,1341,druid,balance,24,14,10
Starboy,garona,1340,druid,balance,24,14,10
Bigbeugs,frostmourne,1339,druid,balance,30,15,15
Cheezaygx,arthas,1338,druid,balance,24,14,10
Xevão,nemesis,1338,druid,balance,32,15,17
Boomchí,tichondrius,1337,druid,balance,18,14,4
Boomsquanch,emerald-dream,1337,druid,balance,24,14,10
Boattastic,terenas,1337,druid,balance,24,14,10
Tinkeress,stormrage,1337,druid,balance,96,47,49
Swiftroots,tichondrius,1336,druid,balance,24,14,10
Comidru,tichondrius,1336,druid,balance,30,14,16
Saturday,frostmourne,1335,druid,balance,35,24,11
Brawndiboom,stormrage,1335,druid,balance,71,33,38
Chikinwing,illidan,1333,druid,balance,24,14,10
Shibbith,nordrassil,1333,druid,balance,24,14,10
Imnotinhuman,tichondrius,1333,druid,balance,41,22,19
Knoxella,moon-guard,1333,druid,balance,134,69,65
Droody,earthen-ring,1333,druid,balance,40,20,20
Breynna,draenor,1333,druid,balance,41,20,21
Yungterp,zuljin,1332,druid,balance,18,14,4
Bâzinga,bleeding-hollow,1331,druid,balance,47,24,23
Eldenis,drakkari,1330,druid,balance,76,40,36
Roundtummy,area-52,1330,druid,balance,36,15,21
Meekgrylls,frostmourne,1329,druid,balance,52,25,27
Empriona,wildhammer,1328,druid,balance,25,14,11
Salvattor,stormrage,1327,druid,balance,44,30,14
Noteff,illidan,1327,druid,balance,30,19,11
Yaboydave,stonemaul,1327,druid,balance,24,14,10
Thorsèn,sargeras,1327,druid,balance,47,25,22
Limikeen,bleeding-hollow,1325,druid,balance,30,15,15
Renamebdsm,cenarius,1324,druid,balance,30,14,16
Moohok,bleeding-hollow,1321,druid,balance,33,14,19
Thickmoo,tichondrius,1319,druid,balance,87,41,46
Winekoolers,malganis,1317,druid,balance,48,24,24
Jonoa,nagrand,1315,druid,balance,73,42,31
Shuxz,sargeras,1313,druid,balance,30,20,10
Naurrog,tichondrius,1313,druid,balance,30,19,11
Gepardéx,ragnaros,1313,druid,balance,126,59,67
Indoee,mannoroth,1313,druid,balance,76,33,43
Réko,sargeras,1311,druid,balance,46,26,20
Evilakali,tichondrius,1311,druid,balance,49,27,22
Flôkey,tichondrius,1311,druid,balance,42,21,21
Theirs,tichondrius,1310,druid,balance,176,97,79
Katobe,tichondrius,1310,druid,balance,30,15,15
Audacities,bloodhoof,1309,druid,balance,46,23,23
Ernest,goldrinn,1309,druid,balance,69,33,36
Stepdru,sargeras,1308,druid,balance,24,14,10
Floote,thrall,1308,druid,balance,58,27,31
Annef,tichondrius,1307,druid,balance,42,21,21
Ðjx,stormrage,1306,druid,balance,19,15,4
Dahts,destromath,1306,druid,balance,24,16,8
Fugginskoden,twisting-nether,1305,druid,balance,23,14,9
Duakx,malganis,1305,druid,balance,30,14,16
Deez,korgath,1304,druid,balance,56,23,33
Doomkiñ,darkspear,1303,druid,balance,29,14,15
Treemendous,nemesis,1303,druid,balance,30,14,16
Sergat,stormreaver,1302,druid,balance,54,28,26
Bouffecul,zuljin,1300,druid,balance,30,16,14
Treezús,thrall,1300,druid,balance,64,32,32
Dkat,malganis,1299,druid,balance,46,24,22
Smitenkiten,baelgun,1295,druid,balance,52,23,29
Pneumashift,tichondrius,1294,druid,balance,18,14,4
Stupidranga,barthilas,1286,druid,balance,54,29,25
Minusdruid,dalaran,1286,druid,balance,117,57,60
Styless,azjolnerub,1284,druid,balance,34,17,17
Lokdu,area-52,1284,druid,balance,30,15,15
Redbbull,tichondrius,1282,druid,balance,60,36,24
Xodz,sargeras,1282,druid,balance,42,21,21
Barrah,barthilas,1280,druid,balance,70,34,36
Nimfaa,nemesis,1279,druid,balance,36,21,15
Solarcannon,shuhalo,1279,druid,balance,159,82,77
Beal,azgalor,1279,druid,balance,93,41,52
Illilydan,tichondrius,1276,druid,balance,84,38,46
Zèrkz,tichondrius,1275,druid,balance,54,28,26
Zeanasfaratu,spinebreaker,1273,druid,balance,45,19,26
Almarasta,azralon,1272,druid,balance,31,15,16
Alwind,alleria,1272,druid,balance,48,18,30
Softshirtxo,ragnaros,1271,druid,balance,24,14,10
Datdruidrod,illidan,1270,druid,balance,66,33,33
Odweaven,thunderlord,1269,druid,balance,64,29,35
Mercz,illidan,1267,druid,balance,42,26,16
Sochin,nemesis,1267,druid,balance,90,49,41
Kyabe,ragnaros,1267,druid,balance,73,30,43
Durdern,barthilas,1264,druid,balance,24,19,5
Lønewolf,sargeras,1263,druid,balance,65,32,33
Spicydurid,tichondrius,1261,druid,balance,32,15,17
Muscelmilk,tichondrius,1258,druid,balance,51,25,26
Furu,bonechewer,1254,druid,balance,78,36,42
Xenöchrist,ragnaros,1252,druid,balance,32,16,16
Lavenderowl,arthas,1250,druid,balance,52,27,25
Barekat,emerald-dream,1249,druid,balance,34,18,16
Mayanardz,bleeding-hollow,1248,druid,balance,18,13,5
Gatorskin,sargeras,1247,druid,balance,15,14,1
Ratspot,stormrage,1247,druid,balance,18,13,5
Ssantirap,quelthalas,1247,druid,balance,24,13,11
Hugodruid,frostmourne,1247,druid,balance,24,13,11
Galeshift,stormrage,1246,druid,balance,18,13,5
Lawlz,aegwynn,1246,druid,balance,51,28,23
Dirtdog,uther,1246,druid,balance,24,13,11
Rslm,tichondrius,1246,druid,balance,43,21,22
Antiherø,sargeras,1245,druid,balance,18,13,5
Mntra,emerald-dream,1245,druid,balance,18,13,5
Ghoouul,tichondrius,1245,druid,balance,35,14,21
Sahksi,lothar,1243,druid,balance,24,13,11
Johnnydrip,malganis,1243,druid,balance,24,13,11
Goofyfoot,wyrmrest-accord,1243,druid,balance,42,22,20
Spudpatikins,barthilas,1243,druid,balance,30,14,16
Foxwit,jubeithos,1242,druid,balance,22,14,8
Sym,zuljin,1242,druid,balance,24,13,11
Bbkingschair,tichondrius,1241,druid,balance,18,13,5
Ripkinztko,stormrage,1241,druid,balance,18,13,5
Tummycummy,thrall,1240,druid,balance,18,13,5
Bigboðm,tichondrius,1239,druid,balance,48,24,24
Gwub,illidan,1238,druid,balance,18,13,5
Girthygramps,sargeras,1238,druid,balance,24,13,11
Tickler,durotan,1238,druid,balance,24,13,11
Bäñgarang,tichondrius,1238,druid,balance,37,15,22
Guojue,tichondrius,1237,druid,balance,46,25,21
Hawkk,azralon,1237,druid,balance,56,26,30
Astrixx,frostmourne,1233,druid,balance,18,13,5
Råstafart,tichondrius,1231,druid,balance,36,17,19
Cien,thrall,1231,druid,balance,53,23,30
Catastrophic,whisperwind,1231,druid,balance,30,13,17
Édzar,area-52,1230,druid,balance,70,35,35
Vicvc,tichondrius,1229,druid,balance,54,29,25
Vicorin,illidan,1226,druid,balance,24,13,11
Lavanis,stormrage,1226,druid,balance,187,98,89
Basilix,moon-guard,1226,druid,balance,63,30,33
Vorare,tichondrius,1225,druid,balance,26,14,12
Zentabra,proudmoore,1225,druid,balance,42,18,24
Mommyx,stormrage,1224,druid,balance,30,13,17
Kuroshizen,tichondrius,1224,druid,balance,94,39,55
Sunboy,tichondrius,1221,druid,balance,73,36,37
Morphkow,sargeras,1220,druid,balance,63,33,30
Deths,frostmourne,1219,druid,balance,18,13,5
Mooing,azralon,1219,druid,balance,28,19,9
Acidmoon,tichondrius,1219,druid,balance,52,22,30
Pokémon,grizzly-hills,1218,druid,balance,24,13,11
Strallà,illidan,1217,druid,balance,96,49,47
Flatnose,agamaggan,1216,druid,balance,30,13,17
Nuppxx,frostmourne,1215,druid,balance,18,13,5
Mutlèy,gundrak,1215,druid,balance,18,13,5
Vuginas,bleeding-hollow,1215,druid,balance,62,33,29
Judgedruid,scilla,1213,druid,balance,36,22,14
Deed,korialstrasz,1212,druid,balance,22,14,8
Crazystorm,ragnaros,1212,druid,balance,66,37,29
Shivlary,stormrage,1211,druid,balance,51,29,22
Lindzy,moon-guard,1210,druid,balance,78,43,35
Coorvinus,stormrage,1208,druid,balance,30,13,17
Elpako,ragnaros,1208,druid,balance,54,23,31
Liñk,sargeras,1207,druid,balance,29,15,14
Møønscar,tichondrius,1204,druid,balance,48,22,26
Lazerchicken,boulderfist,1204,druid,balance,30,13,17
Tankbareass,aerie-peak,1203,druid,balance,42,16,26
Huoxiaoying,tichondrius,1202,druid,balance,36,21,15
Trollsmind,tichondrius,1202,druid,balance,28,14,14
Pleasepime,stormrage,1202,druid,balance,84,35,49
Drßoom,stormrage,1201,druid,balance,87,37,50
Thehooligan,stormrage,1200,druid,balance,75,41,34
Feralchild,emerald-dream,1195,druid,balance,24,13,11
Chillcat,illidan,1194,druid,balance,18,14,4
Nolifer,sargeras,1192,druid,balance,30,17,13
Dumdumdugan,korgath,1191,druid,balance,83,41,42
Circadion,illidan,1189,druid,balance,30,14,16
Dampnr,tichondrius,1186,druid,balance,30,14,16
Maxable,alleria,1184,druid,balance,27,14,13
Quincunx,tichondrius,1181,druid,balance,70,39,31
Xvenusaur,bleeding-hollow,1179,druid,balance,24,16,8
Stringbeáns,tanaris,1179,druid,balance,42,21,21
Clawandørder,tichondrius,1178,druid,balance,20,13,7
Jokerdks,tichondrius,1174,druid,balance,26,14,12
Mufaasa,boulderfist,1174,druid,balance,72,37,35
Vaalser,frostmourne,1173,druid,balance,47,19,28
Lavanca,azralon,1171,druid,balance,30,13,17
Aberdare,tichondrius,1169,druid,balance,29,13,16
Immortalwild,tichondrius,1169,druid,balance,38,17,21
Høt,thunderhorn,1168,druid,balance,22,13,9
Trythis,tichondrius,1167,druid,balance,61,28,33
Orkinetvx,frostmourne,1166,druid,balance,25,16,9
Blackmoons,thunderlord,1166,druid,balance,42,15,27
Alphakatt,area-52,1165,druid,balance,84,38,46
Dirtydot,ragnaros,1164,druid,balance,24,14,10
Baboongodx,frostmourne,1164,druid,balance,23,13,10
Ryxu,emerald-dream,1161,druid,balance,26,15,11
Draide,dragonblight,1159,druid,balance,31,13,18
Mihnt,sargeras,1158,druid,balance,40,14,26
Kattel,blackrock,1157,druid,balance,75,37,38
Levincy,thrall,1156,druid,balance,60,33,27
Dojacow,mannoroth,1154,druid,balance,34,16,18
Wombatform,malganis,1151,druid,balance,18,12,6
Ballnout,zuljin,1151,druid,balance,18,12,6
Katbriel,zuljin,1151,druid,balance,18,12,6
Crusch,shattered-halls,1151,druid,balance,18,12,6
Borrdru,arthas,1150,druid,balance,24,12,12
Hefe,terenas,1149,druid,balance,18,12,6
Zebyn,tichondrius,1149,druid,balance,18,12,6
Alagoano,azralon,1149,druid,balance,80,52,28
Ralphrawr,barthilas,1149,druid,balance,24,12,12
Maserati,emerald-dream,1148,druid,balance,18,12,6
Yoona,kiljaeden,1148,druid,balance,24,12,12
Jocek,stormrage,1146,druid,balance,18,12,6
Flapperz,sargeras,1146,druid,balance,30,12,18
Dbanned,nemesis,1144,druid,balance,24,12,12
Roots,boulderfist,1144,druid,balance,30,13,17
Gravshift,zuljin,1143,druid,balance,18,12,6
Piping,thunderlord,1141,druid,balance,24,12,12
Crashägásm,proudmoore,1140,druid,balance,49,19,30
Timdillon,emerald-dream,1139,druid,balance,24,12,12
Enlil,the-underbog,1139,druid,balance,24,12,12
Leetpete,eitrigg,1138,druid,balance,24,12,12
Dodid,laughing-skull,1137,druid,balance,60,30,30
Aozeh,kiljaeden,1136,druid,balance,18,12,6
Furrycringe,stormrage,1135,druid,balance,30,12,18
Airinsurgent,stormrage,1135,druid,balance,30,12,18
Livilla,sargeras,1134,druid,balance,24,12,12
Thecovid,illidan,1134,druid,balance,89,40,49
Hootyhoot,illidan,1133,druid,balance,18,12,6
Scarymon,tichondrius,1133,druid,balance,21,13,8
Ðementia,stormrage,1131,druid,balance,36,12,24
Prismo,ravencrest,1129,druid,balance,24,12,12
Treeteej,kelthuzad,1128,druid,balance,36,16,20
Bayaba,tichondrius,1127,druid,balance,18,12,6
Lunapuma,stonemaul,1127,druid,balance,18,12,6
Kuthian,moon-guard,1126,druid,balance,39,17,22
Kudro,garithos,1122,druid,balance,30,12,18
Burninmôön,tichondrius,1118,druid,balance,35,12,23
Toofast,lightninghoof,1114,druid,balance,18,12,6
Smashthatbox,illidan,1113,druid,balance,44,17,27
Seytu,sargeras,1112,druid,balance,26,13,13
Naturlig,area-52,1109,druid,balance,24,13,11
Ilgalsard,frostmourne,1109,druid,balance,36,16,20
Mambuz,tichondrius,1100,druid,balance,60,30,30
Ûñø,frostmourne,1099,druid,balance,36,21,15
Alucardxd,ragnaros,1094,druid,balance,29,12,17
Krazykritz,illidan,1090,druid,balance,27,13,14
Coppersnout,moon-guard,1089,druid,balance,54,29,25
Gorgoncity,illidan,1088,druid,balance,22,12,10
Moistcream,tichondrius,1087,druid,balance,21,12,9
Zeromeme,frostmourne,1086,druid,balance,20,12,8
Rahkaaga,kiljaeden,1086,druid,balance,30,15,15
Jâykeup,lightbringer,1085,druid,balance,32,13,19
Bethemarble,sargeras,1084,druid,balance,57,22,35
Iamatomic,illidan,1082,druid,balance,36,14,22
Wyldthangz,stormrage,1077,druid,balance,26,12,14
Koratan,frostmourne,1071,druid,balance,19,12,7
Floridajoe,blackrock,1070,druid,balance,36,20,16
Hootie,arygos,1060,druid,balance,33,12,21
Drdoomerkin,area-52,1056,druid,balance,12,11,1
Dirtmaggot,barthilas,1056,druid,balance,19,13,6
Roccko,illidan,1056,druid,balance,18,11,7
Slickitty,kelthuzad,1056,druid,balance,18,11,7
Likorit,azralon,1055,druid,balance,18,11,7
Sharialawl,stormreaver,1055,druid,balance,18,11,7
Docleave,tichondrius,1055,druid,balance,18,11,7
Mastahskills,illidan,1055,druid,balance,18,11,7
Mooseknukel,zuljin,1055,druid,balance,18,11,7
Muunragery,illidan,1055,druid,balance,18,11,7
Feralgo,tichondrius,1055,druid,balance,19,11,8
Druidlow,azralon,1055,druid,balance,26,14,12
Ryannshiftz,proudmoore,1054,druid,balance,18,11,7
Erealana,tichondrius,1054,druid,balance,18,11,7
Buffclyde,blackrock,1054,druid,balance,18,11,7
Quefemme,kelthuzad,1053,druid,balance,18,11,7
Junaleska,lightbringer,1053,druid,balance,18,11,7
Johnnybigg,frostmourne,1053,druid,balance,18,11,7
Volddy,tichondrius,1053,druid,balance,24,12,12
Espoir,azuremyst,1052,druid,balance,18,11,7
Pecopeco,sargeras,1052,druid,balance,24,11,13
Milkman,mannoroth,1052,druid,balance,30,11,19
Awguseon,proudmoore,1051,druid,balance,18,11,7
Milkshift,demon-soul,1051,druid,balance,24,11,13
Fjblol,sargeras,1051,druid,balance,24,11,13
Wildbloom,draenor,1050,druid,balance,18,11,7
Boostgu,illidan,1050,druid,balance,18,11,7
Samsshifter,tichondrius,1050,druid,balance,24,11,13
Jawsbar,tichondrius,1050,druid,balance,24,11,13
Msparker,illidan,1050,druid,balance,36,11,25
Bearyhalls,frostmourne,1049,druid,balance,21,13,8
Herbzlova,lightnings-blade,1049,druid,balance,24,11,13
Balverixqt,tichondrius,1048,druid,balance,24,11,13
Shavedtaco,azshara,1047,druid,balance,12,11,1
Chikenflu,tichondrius,1047,druid,balance,22,11,11
Catrene,mannoroth,1045,druid,balance,45,28,17
Maulinyou,whisperwind,1045,druid,balance,18,11,7
Wrathmighty,frostmourne,1040,druid,balance,27,12,15
Jinglebells,kiljaeden,1038,druid,balance,18,11,7
Jherrak,area-52,1035,druid,balance,18,11,7
Schmeatbawls,illidan,1031,druid,balance,23,11,12
Miggzii,draka,1030,druid,balance,40,17,23
Muhana,runetotem,1028,druid,balance,24,11,13
Nozgöth,quelthalas,1027,druid,balance,86,43,43
Reeiyna,gallywix,1026,druid,balance,60,35,25
Thèbearjèw,tichondrius,1024,druid,balance,55,23,32
Hosehead,malganis,1023,druid,balance,24,14,10
Vallk,area-52,1022,druid,balance,20,12,8
Malamew,antonidas,1016,druid,balance,18,12,6
Lumipawz,frostmourne,1014,druid,balance,19,12,7
Riprip,tichondrius,1012,druid,balance,27,12,15
Bloomsong,emerald-dream,1012,druid,balance,30,13,17
Araminka,drakkari,1011,druid,balance,12,11,1
Vapeculture,lightbringer,1004,druid,balance,54,31,23
Dustin,moon-guard,1000,druid,balance,22,12,10
Finntröll,area-52,993,druid,balance,29,11,18
Boomybalboa,stormrage,990,druid,balance,17,11,6
Caminanube,quelthalas,989,druid,balance,30,13,17
Amigomel,emerald-dream,985,druid,balance,23,11,12
Indy,rivendare,980,druid,balance,22,11,11
Spazz,firetree,975,druid,balance,17,11,6
Cowel,tichondrius,969,druid,balance,25,11,14
Fäncy,sargeras,960,druid,balance,12,10,2
Jubi,bleeding-hollow,960,druid,balance,12,10,2
Smwise,tichondrius,960,druid,balance,12,10,2
Omnigrind,frostmourne,960,druid,balance,18,10,8
Beamerboy,bleeding-hollow,960,druid,balance,18,10,8
Roben,tichondrius,960,druid,balance,18,10,8
Sÿndru,illidan,960,druid,balance,18,10,8
Mcy,nerzhul,960,druid,balance,18,10,8
Tygraz,alleria,959,druid,balance,12,10,2
Hautheurel,illidan,959,druid,balance,12,10,2
Jshwills,sargeras,959,druid,balance,12,10,2
Lazerbeamz,tichondrius,959,druid,balance,18,10,8
Fastlife,drakkari,959,druid,balance,18,10,8
Tankzsz,malganis,959,druid,balance,18,10,8
Sàbrè,darkspear,959,druid,balance,18,10,8
Kohru,moon-guard,959,druid,balance,18,10,8
Schneidèr,quelthalas,959,druid,balance,18,10,8
Ternkote,tichondrius,959,druid,balance,18,10,8
Scoon,aegwynn,959,druid,balance,18,10,8
Ephwürd,malganis,959,druid,balance,18,10,8
Skaie,ragnaros,959,druid,balance,18,10,8
Credd,zuljin,959,druid,balance,18,10,8
Zils,bleeding-hollow,959,druid,balance,22,11,11
Biggieclawz,tichondrius,958,druid,balance,12,10,2
Bumbleebee,azralon,958,druid,balance,18,10,8
Meatcat,sargeras,958,druid,balance,18,10,8
Psilo,kelthuzad,958,druid,balance,18,10,8
Swiftboom,stormrage,958,druid,balance,18,10,8
Shumarina,mannoroth,958,druid,balance,18,10,8
Tensuen,boulderfist,958,druid,balance,22,10,12
Kushidabs,tichondrius,958,druid,balance,34,11,23
Messyboom,illidan,957,druid,balance,12,10,2
Nøzopium,kelthuzad,956,druid,balance,18,10,8
Drewpg,zuljin,955,druid,balance,18,10,8
Zetii,emerald-dream,955,druid,balance,18,10,8
Tanguanota,quelthalas,955,druid,balance,24,10,14
Maldobear,stormrage,954,druid,balance,24,10,14
Moonowl,crushridge,953,druid,balance,18,10,8
Santogrial,blood-furnace,953,druid,balance,46,25,21
Jal,khazgoroth,953,druid,balance,20,10,10
Crunkk,thunderlord,952,druid,balance,18,10,8
Veraciouss,sargeras,952,druid,balance,18,10,8
Barecowbear,bleeding-hollow,951,druid,balance,24,10,14
Uuli,area-52,946,druid,balance,18,10,8
Ðarkscar,laughing-skull,943,druid,balance,50,18,32
Skiouros,emerald-dream,943,druid,balance,36,10,26
Lacroix,wildhammer,938,druid,balance,12,10,2
Rakelan,tichondrius,937,druid,balance,146,75,71
Pilaufakka,zuljin,932,druid,balance,18,10,8
Krustyora,khazgoroth,911,druid,balance,17,10,7
Athious,moon-guard,909,druid,balance,29,13,16
Jokey,quelthalas,906,druid,balance,18,11,7
Stretchhxd,tichondrius,900,druid,balance,21,10,11
Bellä,nazjatar,900,druid,balance,37,11,26
Wantto,moknathal,894,druid,balance,54,26,28
Jynxy,sargeras,889,druid,balance,23,10,13
Nalarin,kaelthas,878,druid,balance,72,35,37
Maen,kelthuzad,864,druid,balance,12,9,3
Gerrt,bleeding-hollow,864,druid,balance,12,9,3
Uhnoheals,tichondrius,864,druid,balance,18,9,9
Lunartiç,kelthuzad,864,druid,balance,18,9,9
Mvpps,thrall,864,druid,balance,18,9,9
Jssy,tichondrius,864,druid,balance,18,9,9
Kûramä,dalaran,864,druid,balance,18,9,9
Catatonik,emerald-dream,864,druid,balance,24,9,15
Coompie,frostmourne,863,druid,balance,12,9,3
Cthulhuqt,kelthuzad,863,druid,balance,12,9,3
Flamejacker,tichondrius,863,druid,balance,12,9,3
Zmk,barthilas,863,druid,balance,12,9,3
Verelyris,nordrassil,863,druid,balance,12,9,3
Cdroo,burning-blade,863,druid,balance,12,9,3
Hàchi,malganis,863,druid,balance,12,9,3
Arnlu,malganis,863,druid,balance,18,9,9
Starkraven,firetree,863,druid,balance,18,9,9
Bullcritzz,saurfang,863,druid,balance,18,9,9
Velaar,arthas,863,druid,balance,18,9,9
Miviaris,alleria,863,druid,balance,18,9,9
Cösmic,anetheron,863,druid,balance,18,9,9
Môônkîn,chogall,863,druid,balance,18,9,9
Doots,aegwynn,863,druid,balance,18,9,9
Amookelia,tichondrius,863,druid,balance,18,9,9
Columpio,area-52,863,druid,balance,18,9,9
Galadriowl,dalaran,863,druid,balance,24,9,15
Dolwizz,tichondrius,863,druid,balance,24,9,15
Oreoshift,illidan,862,druid,balance,12,9,3
Rootslayer,tichondrius,862,druid,balance,12,9,3
Zugdruid,tichondrius,862,druid,balance,13,9,4
Muagor,tichondrius,862,druid,balance,18,9,9
Furrmissile,area-52,862,druid,balance,18,9,9
Felløwship,nemesis,862,druid,balance,18,9,9
Shack,alterac-mountains,862,druid,balance,18,9,9
Tinkker,zuljin,861,druid,balance,12,9,3
Actiad,stormrage,861,druid,balance,16,10,6
Blizdontcuur,area-52,860,druid,balance,12,9,3
Sanleba,tichondrius,860,druid,balance,18,9,9
Itchyrat,moon-guard,859,druid,balance,18,9,9
Bestik,quelthalas,859,druid,balance,24,9,15
Moringo,azralon,858,druid,balance,12,9,3
Ascension,emerald-dream,858,druid,balance,18,9,9
Amandi,magtheridon,858,druid,balance,24,9,15
Kamionero,drakkari,856,druid,balance,12,9,3
Elatheris,stormrage,855,druid,balance,18,9,9
Shiffterzz,tichondrius,855,druid,balance,18,9,9
Slingin,illidan,855,druid,balance,30,9,21
Sleek,illidan,850,druid,balance,24,9,15
Everglim,azralon,847,druid,balance,24,9,15
Dèmønblâckev,malganis,842,druid,balance,24,11,13
Klyadedfogud,trollbane,839,druid,balance,18,9,9
Rogsdruid,sargeras,830,druid,balance,13,10,3
Gavalle,khaz-modan,830,druid,balance,18,9,9
Nokther,muradin,830,druid,balance,28,9,19
Dankasauras,tichondrius,830,druid,balance,42,13,29
Taurenosorus,illidan,827,druid,balance,64,29,35
Tanawak,tichondrius,815,druid,balance,17,9,8
Ssïp,tichondrius,814,druid,balance,21,9,12
Shifterx,illidan,810,druid,balance,22,13,9
Tinyypuppyy,sargeras,806,druid,balance,30,9,21
Stetile,azralon,800,druid,balance,16,9,7
Leeteracola,malganis,798,druid,balance,20,9,11
Grgcostanza,bleeding-hollow,793,druid,balance,14,9,5
Astroshift,emerald-dream,784,druid,balance,20,9,11
Chococrispis,quelthalas,768,druid,balance,12,8,4
Drakemaster,aggramar,768,druid,balance,12,8,4
Elyiaida,emerald-dream,768,druid,balance,12,8,4
Laserxo,tichondrius,768,druid,balance,12,8,4
Kittyboy,emerald-dream,768,druid,balance,12,8,4
Mikelovin,nemesis,768,druid,balance,12,8,4
Shaney,zuljin,768,druid,balance,12,8,4
Argento,frostmourne,768,druid,balance,12,8,4
Sñìp,zuljin,768,druid,balance,12,8,4
Yøpìèrre,zuljin,768,druid,balance,12,8,4
Aenari,anvilmar,768,druid,balance,12,8,4
Guuh,tichondrius,768,druid,balance,12,8,4
Starfallgg,sargeras,768,druid,balance,12,8,4
Duckdie,moon-guard,768,druid,balance,12,8,4
Hootforce,spirestone,768,druid,balance,12,8,4
Thallid,hydraxis,768,druid,balance,12,8,4
Oopygoopy,bleeding-hollow,768,druid,balance,12,8,4
Ryanspeed,mugthol,768,druid,balance,12,8,4
Mådge,frostmourne,768,druid,balance,12,8,4
Slowbleeds,blood-furnace,768,druid,balance,12,8,4
Ligerbomb,bleeding-hollow,768,druid,balance,12,8,4
Sill,illidan,768,druid,balance,12,8,4
Nyzear,bleeding-hollow,768,druid,balance,12,8,4
Chayten,bleeding-hollow,768,druid,balance,12,8,4
Catmoomoo,tichondrius,768,druid,balance,12,8,4
Azakai,sargeras,768,druid,balance,12,8,4
Shiftytom,spirestone,768,druid,balance,12,8,4
Furor,eonar,768,druid,balance,12,8,4
Onsen,tichondrius,768,druid,balance,18,8,10
Arntu,malganis,767,druid,balance,12,8,4
Smokeheaters,dalaran,767,druid,balance,12,8,4
Starbender,arygos,767,druid,balance,12,8,4
Radagaste,stormrage,767,druid,balance,12,8,4
Wizgarkin,area-52,767,druid,balance,12,8,4
Neurotoxins,tichondrius,767,druid,balance,12,8,4
Entakkt,cenarius,767,druid,balance,12,8,4
Cimanin,malganis,767,druid,balance,12,8,4
Eøle,stormrage,767,druid,balance,12,8,4
Xornhxb,tichondrius,767,druid,balance,12,8,4
Harddeenball,area-52,767,druid,balance,15,9,6
Jiya,zuljin,767,druid,balance,18,8,10
Ruckiz,stormrage,767,druid,balance,18,8,10
Sunmoonkong,area-52,767,druid,balance,18,8,10
Ebonclaw,malganis,767,druid,balance,18,8,10
Ïny,emerald-dream,767,druid,balance,18,8,10
Fluff,gurubashi,767,druid,balance,18,8,10
Gloomcat,illidan,767,druid,balance,18,8,10
Meliódás,area-52,767,druid,balance,186,75,111
Khristine,spinebreaker,767,druid,balance,24,8,16
Narthurs,ragnaros,767,druid,balance,24,8,16
Volgoro,thrall,766,druid,balance,12,8,4
Melizaa,stormrage,766,druid,balance,12,8,4
Onidudu,frostmourne,766,druid,balance,12,8,4
Mornis,zuljin,766,druid,balance,12,8,4
Nxghtfall,tichondrius,766,druid,balance,18,8,10
Serega,skywall,766,druid,balance,18,8,10
Kastro,frostwolf,766,druid,balance,18,8,10
Jashrus,korgath,765,druid,balance,12,8,4
Whitekongg,blackhand,765,druid,balance,15,9,6
Sefestria,senjin,765,druid,balance,18,8,10
Worldbullguy,area-52,765,druid,balance,18,8,10
Tegrizelle,cenarion-circle,765,druid,balance,18,8,10
Aton,frostwolf,764,druid,balance,12,8,4
Crépes,bleeding-hollow,764,druid,balance,18,8,10
Xoth,executus,764,druid,balance,18,8,10
Wabbehkus,barthilas,764,druid,balance,26,8,18
Psnárf,area-52,763,druid,balance,12,8,4
Druidoy,tichondrius,763,druid,balance,12,8,4
Anttfj,mannoroth,763,druid,balance,18,8,10
Herbirove,frostmourne,762,druid,balance,12,8,4
Atherra,sargeras,762,druid,balance,12,8,4
Astromyles,tichondrius,762,druid,balance,25,8,17
Baaksau,illidan,761,druid,balance,18,8,10
Exillïs,frostmourne,761,druid,balance,23,9,14
Freyaborn,sargeras,760,druid,balance,17,9,8
Elsombrak,onyxia,759,druid,balance,12,8,4
Dennyyd,illidan,759,druid,balance,12,8,4
Jtogethendr,area-52,759,druid,balance,12,8,4
Boneheir,proudmoore,757,druid,balance,21,9,12
Nîghtcráwlér,tichondrius,752,druid,balance,12,8,4
Seethert,quelthalas,751,druid,balance,12,8,4
Outclone,tichondrius,734,druid,balance,10,9,1
Elydaria,destromath,733,druid,balance,18,8,10
Beleraine,moon-guard,732,druid,balance,17,8,9
Outandy,quelthalas,727,druid,balance,17,8,9
Buyadoge,area-52,703,druid,balance,16,8,8
Mooncry,wyrmrest-accord,700,druid,balance,26,9,17
Alaskanimal,illidan,696,druid,balance,16,8,8
Shiftness,nordrassil,679,druid,balance,11,8,3
Cfp,tichondrius,672,druid,balance,12,7,5
Mofan,tichondrius,672,druid,balance,12,7,5
Boomypower,dalaran,672,druid,balance,12,7,5
Omegablasted,tichondrius,672,druid,balance,12,7,5
Straitbeast,tichondrius,672,druid,balance,12,7,5
Tratean,tichondrius,672,druid,balance,12,7,5
Redscyclone,dalaran,672,druid,balance,12,7,5
Hyzah,tichondrius,672,druid,balance,12,7,5
Pantec,eredar,672,druid,balance,12,7,5
Bippygucci,tichondrius,672,druid,balance,12,7,5
Whodoüvoodoo,tichondrius,672,druid,balance,12,7,5
Pigdd,tichondrius,672,druid,balance,12,7,5
Alteraim,thrall,672,druid,balance,12,7,5
Bronnasaurus,tichondrius,672,druid,balance,12,7,5
Hllw,tichondrius,672,druid,balance,12,7,5
Kittycatman,tichondrius,672,druid,balance,12,7,5
Ehloheim,stormrage,672,druid,balance,12,7,5
Martians,laughing-skull,672,druid,balance,12,7,5
Xioqt,chogall,672,druid,balance,12,7,5
Slickthick,sargeras,672,druid,balance,12,7,5
Wildllama,moon-guard,672,druid,balance,12,7,5
Covidcarrier,thrall,672,druid,balance,12,7,5
Pepperpawz,emerald-dream,672,druid,balance,12,7,5
Notsofat,deathwing,672,druid,balance,12,7,5
Rennar,stormrage,672,druid,balance,12,7,5
Elithyra,area-52,672,druid,balance,12,7,5
Floofi,kelthuzad,672,druid,balance,12,7,5
Suedou,moon-guard,672,druid,balance,12,7,5
Riptin,kelthuzad,672,druid,balance,12,7,5
Flapping,illidan,672,druid,balance,12,7,5
Nbnbnb,proudmoore,672,druid,balance,12,7,5
Donaldsr,area-52,672,druid,balance,12,7,5
Immortalowl,illidan,672,druid,balance,12,7,5
Lalalu,frostmourne,672,druid,balance,15,8,7
Dooruid,tichondrius,672,druid,balance,18,7,11
Bfaboomy,stormrage,672,druid,balance,18,7,11
Dupaface,stormrage,672,druid,balance,18,7,11
Trashytrash,bleeding-hollow,672,druid,balance,18,7,11
Lükê,tichondrius,672,druid,balance,24,7,17
Dobidas,tichondrius,671,druid,balance,12,7,5
Tubemagnet,tichondrius,671,druid,balance,12,7,5
Exxosd,tichondrius,671,druid,balance,12,7,5
Bvó,stormrage,671,druid,balance,12,7,5
Antagonist,burning-blade,671,druid,balance,12,7,5
Stickyleavz,sargeras,671,druid,balance,12,7,5
Trìckyz,tichondrius,671,druid,balance,12,7,5
Jubeam,area-52,671,druid,balance,12,7,5
Coochi,sargeras,671,druid,balance,12,7,5
Jeezelouise,kelthuzad,671,druid,balance,12,7,5
Dgas,tichondrius,671,druid,balance,12,7,5
Catahoula,lothar,671,druid,balance,12,7,5
Àbyss,moon-guard,671,druid,balance,12,7,5
Sekzor,darkspear,671,druid,balance,12,7,5
Ripx,khadgar,671,druid,balance,12,7,5
Jazzmaster,barthilas,671,druid,balance,12,7,5
Chakrabeam,kelthuzad,671,druid,balance,18,7,11
Dashio,lightnings-blade,671,druid,balance,18,7,11
Kelrelyrare,kiljaeden,671,druid,balance,18,7,11
Barkcheeks,area-52,671,druid,balance,18,7,11
Starsurged,moon-guard,671,druid,balance,18,7,11
Rabbismang,area-52,671,druid,balance,24,7,17
Budtender,moon-guard,670,druid,balance,12,7,5
Andrés,azralon,670,druid,balance,12,7,5
Oâk,farstriders,670,druid,balance,12,7,5
Traxxo,tichondrius,670,druid,balance,12,7,5
Chukksz,nerzhul,670,druid,balance,12,7,5
Runhe,zuljin,670,druid,balance,12,7,5
Teziq,sargeras,670,druid,balance,18,7,11
Dizzyshiftz,dalaran,670,druid,balance,24,7,17
Eurotrance,frostmourne,669,druid,balance,12,7,5
Aviendiana,thrall,669,druid,balance,12,7,5
Craftdruid,tichondrius,669,druid,balance,12,7,5
Onecalf,tichondrius,668,druid,balance,12,7,5
Wresty,frostmourne,667,druid,balance,12,7,5
Boatox,jubeithos,666,druid,balance,24,7,17
Bulldohz,tichondrius,665,druid,balance,12,7,5
Coqeh,frostwolf,664,druid,balance,12,7,5
Beammz,stormrage,664,druid,balance,15,8,7
Pao,nordrassil,664,druid,balance,18,7,11
Kångåwalafox,sargeras,663,druid,balance,12,7,5
Azevedoo,nemesis,660,druid,balance,31,7,24
Meiling,spirestone,659,druid,balance,12,7,5
Abzuri,kiljaeden,655,druid,balance,15,8,7
Kogas,hyjal,639,druid,balance,14,8,6
Spacéchicken,stormrage,638,druid,balance,10,8,2
Tumblr,terenas,624,druid,balance,9,7,2
Desiration,area-52,624,druid,balance,15,7,8
Neurologist,tichondrius,623,druid,balance,11,7,4
Arescarriess,shuhalo,622,druid,balance,17,7,10
Chankletta,quelthalas,618,druid,balance,18,8,10
Warberton,moon-guard,616,druid,balance,15,7,8
Lawnkin,dalaran,608,druid,balance,16,7,9
Zalothianx,thrall,608,druid,balance,16,7,9
Feldstarx,stormrage,607,druid,balance,14,7,7
Razzldazzle,thrall,590,druid,balance,13,7,6
Prev,arathor,576,druid,balance,6,6,0
Starship,frostmourne,576,druid,balance,6,6,0
Nardwaur,tichondrius,576,druid,balance,6,6,0
Animatronz,area-52,576,druid,balance,6,6,0
Juìcedbro,illidan,576,druid,balance,6,6,0
Drop,shadow-council,576,druid,balance,6,6,0
Claws,elune,576,druid,balance,6,6,0
Starsùrge,moon-guard,576,druid,balance,6,6,0
Treesrlegal,area-52,576,druid,balance,6,6,0
Trynayeet,area-52,576,druid,balance,6,6,0
Ory,illidan,576,druid,balance,6,6,0
Nerfdemo,kiljaeden,576,druid,balance,12,6,6
Celetra,kiljaeden,576,druid,balance,12,6,6
Peteybears,stormrage,576,druid,balance,12,6,6
Dalaverrunis,tichondrius,576,druid,balance,12,6,6
Scykin,stormrage,576,druid,balance,12,6,6
Slaÿr,malganis,576,druid,balance,12,6,6
Polyproof,emerald-dream,576,druid,balance,12,6,6
Exiledruid,area-52,576,druid,balance,12,6,6
Beomjun,tichondrius,576,druid,balance,12,6,6
Joux,barthilas,576,druid,balance,12,6,6
Moonsliced,kiljaeden,576,druid,balance,12,6,6
Zgg,ragnaros,576,druid,balance,12,6,6
Treehard,malganis,576,druid,balance,12,6,6
Nýla,stormrage,576,druid,balance,12,6,6
Skydín,stormrage,576,druid,balance,12,6,6
Jmackd,frostmourne,576,druid,balance,12,6,6
Yorkville,sargeras,576,druid,balance,12,6,6
Jamuestus,illidan,576,druid,balance,12,6,6
Medibull,tichondrius,576,druid,balance,12,6,6
Grayfan,malganis,576,druid,balance,12,6,6
Brocooli,tichondrius,576,druid,balance,12,6,6
Gigathicc,malganis,576,druid,balance,12,6,6
Kitem,tichondrius,576,druid,balance,12,6,6
Fixn,tichondrius,576,druid,balance,12,6,6
Fugg,frostmourne,576,druid,balance,12,6,6
Tylërðûrðên,sargeras,576,druid,balance,12,6,6
Ggae,tichondrius,576,druid,balance,12,6,6
Wondercat,illidan,576,druid,balance,12,6,6
Bar,stormrage,576,druid,balance,12,6,6
Tone,illidan,576,druid,balance,12,6,6
Bamfferal,tichondrius,576,druid,balance,12,6,6
Whiteglade,moon-guard,576,druid,balance,12,6,6
Runforest,tichondrius,576,druid,balance,12,6,6
Jacknit,illidan,576,druid,balance,12,6,6
Dazedru,stormrage,576,druid,balance,12,6,6
Fungamezx,bleeding-hollow,576,druid,balance,12,6,6
Avishominem,magtheridon,576,druid,balance,12,6,6
Versena,moon-guard,576,druid,balance,12,6,6
Pincho,hyjal,576,druid,balance,12,6,6
Hornny,shattered-hand,576,druid,balance,12,6,6
Juqzy,area-52,576,druid,balance,12,6,6
Gâlaxy,sargeras,576,druid,balance,12,6,6
Notpodruida,tichondrius,576,druid,balance,13,6,7
Longnus,stormrage,576,druid,balance,18,6,12
Proudmom,barthilas,576,druid,balance,18,6,12
Faletra,eitrigg,576,druid,balance,18,6,12
Doomky,area-52,576,druid,balance,18,6,12
Chrisclones,stormrage,576,druid,balance,18,6,12
Droodad,mannoroth,576,druid,balance,18,6,12
Drphilsmith,moon-guard,576,druid,balance,18,6,12
Yorch,stormrage,576,druid,balance,18,6,12
Apoc,bleeding-hollow,575,druid,balance,6,6,0
Hpcorrection,bleeding-hollow,575,druid,balance,12,6,6
Tariksha,sargeras,575,druid,balance,12,6,6
Ridicules,cenarius,575,druid,balance,12,6,6
Guybranch,illidan,575,druid,balance,12,6,6
Ebichu,fenris,575,druid,balance,12,6,6
Pigmanbear,kelthuzad,575,druid,balance,12,6,6
Chodkiewicz,echo-isles,575,druid,balance,12,6,6
Yseraspawn,kelthuzad,575,druid,balance,12,6,6
Runarok,ragnaros,575,druid,balance,12,6,6
Dibinha,azralon,575,druid,balance,12,6,6
Sokodruid,tichondrius,575,druid,balance,18,6,12
Samelthios,proudmoore,575,druid,balance,20,6,14
Eintier,tichondrius,574,druid,balance,12,6,6
Dradugun,hyjal,574,druid,balance,12,6,6
Painsbrook,thrall,574,druid,balance,12,6,6
Quagsire,moon-guard,574,druid,balance,18,6,12
Xinnii,illidan,573,druid,balance,18,7,11
Mctree,cenarius,572,druid,balance,12,6,6
Lunnæ,ragnaros,567,druid,balance,12,6,6
Proñgs,tichondrius,566,druid,balance,12,6,6
Suist,moonrunner,544,druid,balance,10,6,4
Casaran,anetheron,543,druid,balance,11,6,5
Matock,malganis,543,druid,balance,11,6,5
Boufa,dentarg,527,druid,balance,9,7,2
Imhealer,drakkari,522,druid,balance,17,8,9
Galind,rexxar,521,druid,balance,23,7,16
Velais,exodar,512,druid,balance,22,6,16
Gemineye,stormrage,511,druid,balance,11,6,5
Istayfrawsty,darkspear,511,druid,balance,14,6,8
Twcrazyk,tichondrius,511,druid,balance,14,6,8
Rank,nerzhul,496,druid,balance,13,6,7
Numbkin,stormrage,480,druid,balance,6,5,1
Daroot,spinebreaker,480,druid,balance,6,5,1
Fattdiabetic,tichondrius,480,druid,balance,6,5,1
Prøspect,moon-guard,480,druid,balance,6,5,1
Yurself,feathermoon,480,druid,balance,6,5,1
Bearyhalls,sargeras,480,druid,balance,6,5,1
Guår,tichondrius,480,druid,balance,6,5,1
Ichangeabull,bleeding-hollow,480,druid,balance,6,5,1
Crazystarz,frostmourne,480,druid,balance,6,5,1
Cócorosie,tichondrius,480,druid,balance,6,5,1
Rowdie,area-52,480,druid,balance,6,5,1
Tinwhiskerz,bleeding-hollow,480,druid,balance,6,5,1
Aoewynn,nerzhul,480,druid,balance,6,5,1
Ragiix,tichondrius,480,druid,balance,6,5,1
Toastsdruid,tichondrius,480,druid,balance,6,5,1
Eskimocowboy,sargeras,480,druid,balance,6,5,1
Dtefy,ragnaros,480,druid,balance,6,5,1
Smitebacklol,tichondrius,480,druid,balance,6,5,1
Stacker,malganis,480,druid,balance,6,5,1
Hooffy,emerald-dream,480,druid,balance,6,5,1
Canuatemyrat,tichondrius,480,druid,balance,6,5,1
Miçangak,azralon,480,druid,balance,6,5,1
Dojacat,tichondrius,480,druid,balance,6,5,1
Hännibal,hydraxis,480,druid,balance,6,5,1
Løk,sargeras,480,druid,balance,6,5,1
Alindrä,moon-guard,480,druid,balance,6,5,1
Rastakant,malganis,480,druid,balance,6,5,1
Arwëna,tichondrius,480,druid,balance,6,5,1
Mithroi,tichondrius,480,druid,balance,6,5,1
Iconicxz,malganis,480,druid,balance,6,5,1
Yokux,thunderlord,480,druid,balance,6,5,1
Nephsis,kelthuzad,480,druid,balance,6,5,1
Xiaodlol,tichondrius,480,druid,balance,6,5,1
Megåtron,kelthuzad,480,druid,balance,6,5,1
Hennydru,dalaran,480,druid,balance,6,5,1
Galadon,tichondrius,480,druid,balance,6,5,1
Zieda,sisters-of-elune,480,druid,balance,6,5,1
Oo,grizzly-hills,480,druid,balance,6,5,1
ßælot,quelthalas,480,druid,balance,6,5,1
Finkledurp,dalaran,480,druid,balance,6,5,1
Simperella,dalaran,480,druid,balance,6,5,1
Sigure,zuljin,480,druid,balance,7,5,2
Nodeathz,sargeras,480,druid,balance,10,6,4
Phatpat,illidan,480,druid,balance,12,5,7
Bigdaddyferg,illidan,480,druid,balance,12,5,7
Voelcan,tichondrius,480,druid,balance,12,5,7
Bigtammy,moon-guard,480,druid,balance,12,5,7
Gåiâ,malganis,480,druid,balance,12,5,7
Fakechower,stormreaver,480,druid,balance,12,5,7
Cloninglol,darkspear,480,druid,balance,12,5,7
Sodacream,illidan,480,druid,balance,12,5,7
Chillygraves,stormrage,480,druid,balance,12,5,7
Milkmoneymeo,illidan,480,druid,balance,12,5,7
Bearwithit,sargeras,480,druid,balance,12,5,7
Zuga,the-venture-co,480,druid,balance,12,5,7
Paintlicker,emerald-dream,480,druid,balance,12,5,7
Bubblybear,winterhoof,480,druid,balance,12,5,7
Ragerag,trollbane,480,druid,balance,12,5,7
Zimah,illidan,480,druid,balance,12,5,7
Cynderellaa,proudmoore,480,druid,balance,12,5,7
Salanzô,bleeding-hollow,480,druid,balance,12,5,7
Stinky,bleeding-hollow,480,druid,balance,12,5,7
Sunspot,tichondrius,480,druid,balance,12,5,7
Veganmom,zuluhed,480,druid,balance,12,5,7
Dotdmage,tichondrius,480,druid,balance,12,5,7
Ripter,moon-guard,480,druid,balance,12,5,7
Havócdh,tichondrius,480,druid,balance,12,5,7
Trippykitty,tichondrius,480,druid,balance,12,5,7
Bullquenepas,dalaran,480,druid,balance,12,5,7
Nöches,quelthalas,480,druid,balance,12,5,7
Sharkfighter,sargeras,480,druid,balance,12,5,7
Lickmypaws,sargeras,480,druid,balance,12,5,7
Jacinty,saurfang,480,druid,balance,12,5,7
Dèrpin,thrall,480,druid,balance,15,6,9
Boomiè,tichondrius,480,druid,balance,18,5,13
Dobrman,sargeras,480,druid,balance,18,5,13
Tuppyboom,barthilas,480,druid,balance,24,5,19
Wtfiisthis,tichondrius,479,druid,balance,6,5,1
Raknary,kelthuzad,479,druid,balance,12,5,7
Smhyle,frostmourne,479,druid,balance,12,5,7
Justwade,tichondrius,479,druid,balance,12,5,7
Fourthkind,illidan,479,druid,balance,12,5,7
Palermo,aerie-peak,479,druid,balance,12,5,7
Damallis,anubarak,479,druid,balance,12,5,7
Morphntime,blackrock,479,druid,balance,18,5,13
Loggoruk,illidan,479,druid,balance,18,5,13
Mantis,the-underbog,478,druid,balance,12,5,7
Abzyplasm,sargeras,478,druid,balance,12,5,7
Sunneater,azuremyst,478,druid,balance,12,5,7
Wardruidkvn,stormreaver,474,druid,balance,29,5,24
Formgodx,malganis,448,druid,balance,16,5,11
Bearcathawk,sargeras,447,druid,balance,11,5,6
Convoken,tichondrius,447,druid,balance,11,5,6
Guron,aegwynn,432,druid,balance,21,5,16
Féralis,sargeras,431,druid,balance,11,5,6
Biig,stormreaver,425,druid,balance,9,8,1
Jieter,malganis,415,druid,balance,8,5,3
Haallanna,thunderlord,412,druid,balance,10,5,5
Gigajuiced,proudmoore,400,druid,balance,7,5,2
Altha,proudmoore,400,druid,balance,13,5,8
Feathergun,ragnaros,384,druid,balance,6,4,2
Boomkinbob,malganis,384,druid,balance,6,4,2
Cashgame,malganis,384,druid,balance,6,4,2
Tankyguy,ragnaros,384,druid,balance,6,4,2
Bäldir,dalaran,384,druid,balance,6,4,2
Splintered,kelthuzad,384,druid,balance,6,4,2
Anamoorphicc,kelthuzad,384,druid,balance,6,4,2
Upps,kelthuzad,384,druid,balance,6,4,2
Hbf,tichondrius,384,druid,balance,6,4,2
Hadoriss,kelthuzad,384,druid,balance,6,4,2
Yevenbother,tichondrius,384,druid,balance,6,4,2
Abelladañger,area-52,384,druid,balance,6,4,2
Matinee,tichondrius,384,druid,balance,6,4,2
Foxxyroxxy,malganis,384,druid,balance,6,4,2
Tinishaker,ragnaros,384,druid,balance,6,4,2
Watchugonndo,tichondrius,384,druid,balance,6,4,2
Qyuka,area-52,384,druid,balance,6,4,2
Sappyroots,area-52,384,druid,balance,6,4,2
Elonmuskirl,illidan,384,druid,balance,6,4,2
Twostars,thrall,384,druid,balance,6,4,2
Luvgames,area-52,384,druid,balance,6,4,2
Shînx,malganis,384,druid,balance,6,4,2
Lukass,tichondrius,384,druid,balance,6,4,2
Mcdizzil,bloodscalp,384,druid,balance,6,4,2
Shinazugawa,maiev,384,druid,balance,6,4,2
Spèèdy,illidan,384,druid,balance,6,4,2
Daddyfresh,ursin,384,druid,balance,6,4,2
Söökie,tichondrius,384,druid,balance,6,4,2
Korlstone,zuljin,384,druid,balance,6,4,2
Harlisu,stormrage,384,druid,balance,6,4,2
Zxve,stormrage,384,druid,balance,6,4,2
Ahruan,stormrage,384,druid,balance,6,4,2
Nevershiftx,kirin-tor,384,druid,balance,6,4,2
Dokasaurus,lightbringer,384,druid,balance,6,4,2
Withwind,dalaran,384,druid,balance,6,4,2
Dsoul,tichondrius,384,druid,balance,6,4,2
Somarythe,moon-guard,384,druid,balance,6,4,2
Calfurion,stormscale,384,druid,balance,6,4,2
Druz,spirestone,384,druid,balance,6,4,2
Nicklul,llane,384,druid,balance,6,4,2
Armorkits,area-52,384,druid,balance,6,4,2
Oldcreg,emerald-dream,384,druid,balance,6,4,2
Joiczar,maelstrom,384,druid,balance,6,4,2
Selfplay,barthilas,384,druid,balance,6,4,2
Critkatbear,detheroc,384,druid,balance,6,4,2
Yoshí,emerald-dream,384,druid,balance,6,4,2
Duo,demon-soul,384,druid,balance,6,4,2
Notadopted,sargeras,384,druid,balance,6,4,2
Drmnheal,frostmourne,384,druid,balance,6,4,2
Medsurgdruid,emerald-dream,384,druid,balance,6,4,2
Hëllchaos,sargeras,384,druid,balance,6,4,2
Nidalie,frostmourne,384,druid,balance,6,4,2
Seekamp,khazgoroth,384,druid,balance,6,4,2
Kiwidru,frostmourne,384,druid,balance,6,4,2
Bearlylegál,sargeras,384,druid,balance,6,4,2
Thetruetrue,sargeras,384,druid,balance,6,4,2
Formz,nagrand,384,druid,balance,6,4,2
Balancz,thrall,384,druid,balance,10,5,5
Scraww,tichondrius,384,druid,balance,17,6,11
Guitarsolos,nagrand,384,druid,balance,12,4,8
Slottpocket,malganis,384,druid,balance,12,4,8
Omnipaw,kelthuzad,384,druid,balance,12,4,8
Einraedon,dalaran,384,druid,balance,12,4,8
Aexs,kelthuzad,384,druid,balance,12,4,8
Vashida,stormrage,384,druid,balance,12,4,8
Wintarz,sargeras,384,druid,balance,12,4,8
Altius,drakkari,384,druid,balance,12,4,8
Menlove,area-52,384,druid,balance,12,4,8
Tasselhoof,hyjal,384,druid,balance,12,4,8
Veyrønn,stormrage,384,druid,balance,12,4,8
Aesthetical,frostmourne,384,druid,balance,12,4,8
Alastras,tichondrius,384,druid,balance,12,4,8
Stormclaw,elune,384,druid,balance,12,4,8
Amaryllis,the-underbog,384,druid,balance,12,4,8
Blipshift,tichondrius,384,druid,balance,12,4,8
Ayelune,stormrage,384,druid,balance,12,4,8
Jakermans,area-52,384,druid,balance,12,4,8
Lutein,tichondrius,384,druid,balance,12,4,8
Sorh,stormrage,384,druid,balance,12,4,8
Simo,kaelthas,384,druid,balance,12,4,8
Bignosecow,illidan,384,druid,balance,12,4,8
Zenowl,turalyon,384,druid,balance,12,4,8
Madisonivyx,area-52,384,druid,balance,12,4,8
Sinistuhd,tichondrius,384,druid,balance,12,4,8
Katdog,warsong,384,druid,balance,18,4,14
Spatulas,malganis,384,druid,balance,18,4,14
Thiccybear,darkspear,383,druid,balance,6,4,2
Chatdôux,zuljin,383,druid,balance,6,4,2
Bulldog,runetotem,383,druid,balance,6,4,2
Kukulkann,tichondrius,383,druid,balance,6,4,2
Papitank,drakkari,383,druid,balance,6,4,2
Balthøs,moon-guard,383,druid,balance,6,4,2
Xisloko,azralon,383,druid,balance,6,4,2
Aessinawisp,frostmourne,383,druid,balance,6,4,2
Krunge,frostwolf,383,druid,balance,6,4,2
Tyrana,bloodscalp,383,druid,balance,6,4,2
Tïcks,illidan,383,druid,balance,12,4,8
Scienttific,malganis,383,druid,balance,12,4,8
Balantina,tichondrius,383,druid,balance,12,4,8
Nobullshift,icecrown,383,druid,balance,12,4,8
Skke,barthilas,383,druid,balance,12,4,8
Nukaboom,elune,382,druid,balance,6,4,2
Boomanon,illidan,382,druid,balance,6,4,2
Thullian,stormrage,382,druid,balance,13,5,8
Sever,ysera,382,druid,balance,12,4,8
Meowfacebby,stormrage,367,druid,balance,11,4,7
Gutanamo,stormrage,334,druid,balance,8,5,3
Rahdek,azgalor,330,druid,balance,7,5,2
Kimnim,tichondrius,330,druid,balance,9,6,3
Ihjx,sargeras,330,druid,balance,11,6,5
Yangrou,tichondrius,330,druid,balance,11,5,6
Mythianan,aggramar,328,druid,balance,10,7,3
Tehnklox,malorne,319,druid,balance,5,4,1
Murkdruid,frostmourne,319,druid,balance,8,4,4
Monicaduan,frostmourne,319,druid,balance,14,4,10
Icastsmells,tichondrius,288,druid,balance,6,3,3
Cronosphere,stormrage,288,druid,balance,6,3,3
Sodah,tichondrius,288,druid,balance,6,3,3
Papacard,stormrage,288,druid,balance,6,3,3
Kyndel,kiljaeden,288,druid,balance,6,3,3
Kalalana,illidan,288,druid,balance,6,3,3
Loren,gorefiend,288,druid,balance,6,3,3
Helpmeimbad,stormrage,288,druid,balance,6,3,3
Sypìí,stormrage,288,druid,balance,6,3,3
Beörne,sargeras,288,druid,balance,6,3,3
Çãñçèr,frostmourne,288,druid,balance,6,3,3
Jayroneowo,frostmourne,288,druid,balance,6,3,3
Celestialife,frostmourne,288,druid,balance,6,3,3
Kî,thunderlord,288,druid,balance,6,3,3
Guidoanchovz,thrall,288,druid,balance,6,3,3
Sylvanna,tichondrius,288,druid,balance,6,3,3
Akiza,sargeras,288,druid,balance,6,3,3
Jxred,illidan,288,druid,balance,6,3,3
Cbark,ravencrest,288,druid,balance,6,3,3
Crotchlicker,bloodscalp,288,druid,balance,6,3,3
Vykarux,suramar,288,druid,balance,6,3,3
Bwokhanji,proudmoore,288,druid,balance,6,3,3
Ornaaga,blackrock,288,druid,balance,6,3,3
Thumpb,bronzebeard,288,druid,balance,6,3,3
Revitalize,shadowsong,288,druid,balance,6,3,3
Däll,tichondrius,288,druid,balance,6,3,3
Tiju,wyrmrest-accord,288,druid,balance,6,3,3
Fengfeidruid,illidan,288,druid,balance,6,3,3
Alleae,stormrage,288,druid,balance,6,3,3
Rhorr,frostmourne,288,druid,balance,6,3,3
Healthycow,illidan,288,druid,balance,6,3,3
Goldentaint,tichondrius,288,druid,balance,6,3,3
Ohsnapz,silvermoon,288,druid,balance,6,3,3
Fauck,illidan,288,druid,balance,6,3,3
Thebruiser,baelgun,288,druid,balance,6,3,3
Endingitall,illidan,288,druid,balance,6,3,3
Nidalie,zuljin,288,druid,balance,6,3,3
Greenseed,nagrand,288,druid,balance,6,3,3
Shaftomatic,tichondrius,288,druid,balance,6,3,3
Luuxia,tichondrius,288,druid,balance,6,3,3
Aconcat,bleeding-hollow,288,druid,balance,6,3,3
Ðeepsixx,burning-legion,288,druid,balance,6,3,3
Winmax,tichondrius,288,druid,balance,6,3,3
Iploopedyogf,bleeding-hollow,288,druid,balance,6,3,3
Jyuaiai,tichondrius,288,druid,balance,6,3,3
Loraxx,bleeding-hollow,288,druid,balance,6,3,3
Levelboostx,tichondrius,288,druid,balance,6,3,3
Rongrong,kargath,288,druid,balance,6,3,3
Dauncy,sargeras,288,druid,balance,6,3,3
Silynce,tichondrius,288,druid,balance,6,3,3
Uckin,bleeding-hollow,288,druid,balance,6,3,3
Spooser,proudmoore,288,druid,balance,6,3,3
Tabbo,uther,288,druid,balance,6,3,3
Icefang,tichondrius,288,druid,balance,6,3,3
Voodoopipe,tichondrius,288,druid,balance,6,3,3
Pergutory,frostmourne,288,druid,balance,6,3,3
Shalaz,magtheridon,288,druid,balance,6,3,3
Mar,misha,288,druid,balance,6,3,3
Jpylm,ysera,288,druid,balance,6,3,3
Jammi,skywall,288,druid,balance,6,3,3
Tugboat,saurfang,288,druid,balance,6,3,3
Laazz,area-52,288,druid,balance,6,3,3
Supriix,moon-guard,288,druid,balance,6,3,3
Hootiepie,hyjal,288,druid,balance,6,3,3
Jgb,dalaran,288,druid,balance,6,3,3
Haaha,area-52,288,druid,balance,6,3,3
Alcorria,area-52,288,druid,balance,6,3,3
Jabawockdeez,area-52,288,druid,balance,6,3,3
Azoth,hyjal,288,druid,balance,6,3,3
Kaldelar,emerald-dream,288,druid,balance,6,3,3
Sawachicky,frostmourne,288,druid,balance,6,3,3
Bridgerén,tichondrius,288,druid,balance,6,3,3
Gsd,sargeras,288,druid,balance,6,3,3
ßrian,stormscale,288,druid,balance,6,3,3
Waiv,area-52,288,druid,balance,6,3,3
Silkyroad,tichondrius,288,druid,balance,6,3,3
Hallthrok,stormrage,288,druid,balance,6,3,3
Taztoc,stormrage,288,druid,balance,6,3,3
Bearys,area-52,288,druid,balance,6,3,3
Kickconvoke,sargeras,288,druid,balance,6,3,3
Slütcakes,tichondrius,288,druid,balance,6,3,3
Targeted,sargeras,288,druid,balance,6,3,3
Bhíkkhu,stormrage,288,druid,balance,6,3,3
Rabbithomas,malygos,288,druid,balance,6,3,3
Bleedum,guldan,288,druid,balance,6,3,3
Hchhi,ragnaros,288,druid,balance,6,3,3
Noheárt,kelthuzad,288,druid,balance,6,3,3
Delrin,garona,288,druid,balance,6,3,3
Vawdka,proudmoore,288,druid,balance,9,4,5
Bigswaag,malganis,288,druid,balance,7,3,4
Xail,hyjal,288,druid,balance,8,3,5
Wreckingcrew,emerald-dream,288,druid,balance,8,3,5
Retsarehard,illidan,288,druid,balance,8,3,5
Uezzon,tol-barad,288,druid,balance,12,3,9
Machinex,illidan,288,druid,balance,12,3,9
Feyrien,dalaran,288,druid,balance,12,3,9
Alalletsa,destromath,288,druid,balance,12,3,9
Scythé,stormrage,288,druid,balance,12,3,9
Killersilent,quelthalas,288,druid,balance,12,3,9
Drchronic,boulderfist,288,druid,balance,12,3,9
Cêania,moon-guard,288,druid,balance,12,3,9
Davelombardo,tichondrius,288,druid,balance,12,3,9
Gilgorash,kiljaeden,288,druid,balance,12,3,9
Edinhalfhorn,bonechewer,288,druid,balance,12,3,9
Xalstarrot,sargeras,288,druid,balance,12,3,9
Mulgorer,tichondrius,288,druid,balance,12,3,9
Hottiecake,bronzebeard,288,druid,balance,12,3,9
Koan,proudmoore,288,druid,balance,12,3,9
Mørphea,darkspear,288,druid,balance,12,3,9
Jalapenoz,wyrmrest-accord,288,druid,balance,12,3,9
Plye,korgath,288,druid,balance,12,3,9
Loathe,korialstrasz,288,druid,balance,12,3,9
Evarene,vashj,288,druid,balance,12,3,9
Teyollocuani,sargeras,288,druid,balance,12,3,9
Ginunaga,tichondrius,288,druid,balance,12,3,9
Wweegyy,tichondrius,287,druid,balance,6,3,3
Kniitvekitta,jubeithos,287,druid,balance,6,3,3
Guston,lightbringer,287,druid,balance,6,3,3
Johnee,barthilas,287,druid,balance,6,3,3
Bluechicken,sargeras,287,druid,balance,6,3,3
Wiseoldman,jubeithos,286,druid,balance,6,3,3
Clownprince,barthilas,256,druid,balance,10,3,7
Vollzar,sargeras,255,druid,balance,11,3,8
Amanara,echo-isles,255,druid,balance,11,3,8
Bigtoeess,tichondrius,239,druid,balance,5,3,2
Oddclaw,stormrage,239,druid,balance,5,3,2
Corym,frostmourne,239,druid,balance,11,3,8
Gorfrog,tichondrius,234,druid,balance,9,4,5
Jazzman,jubeithos,223,druid,balance,14,3,11
Flummoz,frostmourne,192,druid,balance,4,3,1
Niwßor,azralon,192,druid,balance,10,4,6
Tansdruid,area-52,192,druid,balance,6,2,4
Isunami,emerald-dream,192,druid,balance,6,2,4
Hagenws,azralon,192,druid,balance,6,2,4
Saìyori,area-52,192,druid,balance,6,2,4
Mäûled,fizzcrank,192,druid,balance,6,2,4
Injeckx,tichondrius,192,druid,balance,6,2,4
Blackchina,tichondrius,192,druid,balance,6,2,4
Gidam,moon-guard,192,druid,balance,6,2,4
Loodichriss,area-52,192,druid,balance,6,2,4
Treezyn,sargeras,192,druid,balance,6,2,4
Flarkage,area-52,192,druid,balance,6,2,4
Enyu,sargeras,192,druid,balance,6,2,4
Variandruid,kelthuzad,192,druid,balance,6,2,4
Redness,daggerspine,192,druid,balance,6,2,4
Hancalimon,nemesis,192,druid,balance,6,2,4
Dcountts,area-52,192,druid,balance,6,2,4
Adonalsium,area-52,192,druid,balance,6,2,4
Wtfhommie,madoran,192,druid,balance,6,2,4
Bubblebraìn,area-52,192,druid,balance,6,2,4
Kångåwålafox,sargeras,192,druid,balance,6,2,4
Hamïlton,ragnaros,192,druid,balance,6,2,4
Overfunk,ragnaros,192,druid,balance,6,2,4
Sooey,wyrmrest-accord,192,druid,balance,6,2,4
Mòónwhisper,moon-guard,192,druid,balance,6,2,4
Bullwïnkle,uther,192,druid,balance,6,2,4
Speaks,moon-guard,192,druid,balance,6,2,4
Laymonath,elune,192,druid,balance,6,2,4
Dweralin,nemesis,192,druid,balance,6,2,4
Ohzú,ragnaros,192,druid,balance,6,2,4
Katherine,moon-guard,192,druid,balance,6,2,4
Bearhug,dragonmaw,192,druid,balance,6,2,4
Azshunara,moon-guard,192,druid,balance,6,2,4
Stumphugger,tichondrius,192,druid,balance,6,2,4
Nightnes,sargeras,192,druid,balance,6,2,4
Mythicdruid,ragnaros,192,druid,balance,6,2,4
Totorostard,tichondrius,192,druid,balance,6,2,4
Sloppysheila,sargeras,192,druid,balance,6,2,4
Lindsanr,illidan,192,druid,balance,6,2,4
Smallrichard,bleeding-hollow,192,druid,balance,6,2,4
Tp,dragonblight,192,druid,balance,6,2,4
Lilherb,azralon,192,druid,balance,6,2,4
Srbestias,quelthalas,192,druid,balance,6,2,4
Hawgs,bleeding-hollow,192,druid,balance,6,2,4
Guap,bleeding-hollow,192,druid,balance,6,2,4
Chèétøhz,moon-guard,192,druid,balance,6,2,4
Hawtzi,stormrage,192,druid,balance,6,2,4
Lappz,malganis,192,druid,balance,6,2,4
Glowstixz,tichondrius,192,druid,balance,6,2,4
Spicyorange,dalaran,192,druid,balance,6,2,4
Rakuath,zuljin,192,druid,balance,6,2,4
Astroprof,bloodscalp,192,druid,balance,6,2,4
Boomtastik,frostmourne,192,druid,balance,6,2,4
Starsfall,tichondrius,192,druid,balance,6,2,4
Hoptimus,zuljin,192,druid,balance,6,2,4
Gazwazluz,lothar,192,druid,balance,6,2,4
Kimgurdian,tichondrius,192,druid,balance,6,2,4
Zukru,malganis,192,druid,balance,6,2,4
Cbreezyy,tichondrius,192,druid,balance,6,2,4
Explicít,sargeras,192,druid,balance,6,2,4
Potus,illidan,192,druid,balance,6,2,4
Slavenhausen,azralon,192,druid,balance,6,2,4
Hasemilë,dalaran,192,druid,balance,6,2,4
Octacer,malfurion,192,druid,balance,6,2,4
Dedgame,malfurion,192,druid,balance,6,2,4
Simeron,silvermoon,192,druid,balance,6,2,4
Hellabanx,tichondrius,192,druid,balance,6,2,4
Moonhorn,kelthuzad,192,druid,balance,6,2,4
Moistism,tichondrius,192,druid,balance,6,2,4
Saucyy,malganis,192,druid,balance,6,2,4
Crycloné,stormrage,192,druid,balance,6,2,4
Meowed,sargeras,192,druid,balance,6,2,4
Maidah,malganis,192,druid,balance,6,2,4
Bobobear,proudmoore,192,druid,balance,6,2,4
Markóla,stormrage,192,druid,balance,6,2,4
Shredstitute,tichondrius,192,druid,balance,6,2,4
Arienne,kelthuzad,192,druid,balance,6,2,4
Nokitty,tichondrius,192,druid,balance,6,2,4
Pawswap,tichondrius,192,druid,balance,6,2,4
Honeybeam,moon-guard,192,druid,balance,6,2,4
Teladrizzle,dalaran,192,druid,balance,6,2,4
Hream,echo-isles,192,druid,balance,6,2,4
Absentteeth,stormrage,192,druid,balance,6,2,4
Hzu,kelthuzad,192,druid,balance,6,2,4
Zigh,azralon,192,druid,balance,6,2,4
Malcavelli,tichondrius,192,druid,balance,6,2,4
Malffurryan,draktharon,192,druid,balance,6,2,4
Cathelyana,tichondrius,192,druid,balance,10,3,7
Panchuwuanky,sargeras,192,druid,balance,8,2,6
Daydaygo,illidan,192,druid,balance,12,2,10
Alluminax,sargeras,192,druid,balance,12,2,10
Thundyrcat,tichondrius,192,druid,balance,12,2,10
Solaress,moon-guard,192,druid,balance,12,2,10
Papaland,tichondrius,192,druid,balance,12,2,10
Unhappystill,tichondrius,192,druid,balance,12,2,10
Rigotakz,illidan,192,druid,balance,12,2,10
Visûcius,moon-guard,192,druid,balance,12,2,10
Pusscat,illidan,192,druid,balance,18,2,16
Thicchicken,emerald-dream,191,druid,balance,12,2,10
Stealthhero,lightbringer,159,druid,balance,5,2,3
Irontree,dunemaul,159,druid,balance,5,2,3
Xylemcow,malganis,159,druid,balance,5,2,3
Formality,kalecgos,159,druid,balance,5,2,3
Sludgischonk,stormrage,159,druid,balance,5,2,3
Moonkingx,ragnaros,159,druid,balance,5,2,3
Theriomorph,barthilas,138,druid,balance,10,3,7
Appitrap,emerald-dream,137,druid,balance,19,3,16
Nightruffles,moon-guard,128,druid,balance,4,2,2
Hirtenweg,stormrage,127,druid,balance,14,2,12
Aeo,frostmourne,112,druid,balance,7,2,5
Alistar,scilla,96,druid,balance,3,2,1
Stradamus,sargeras,96,druid,balance,3,2,1
Yøpièrre,bleeding-hollow,96,druid,balance,3,2,1
Scoobyshiftz,frostmourne,96,druid,balance,8,2,6
Omegabeast,frostmourne,96,druid,balance,6,1,5
Klint,darkspear,96,druid,balance,6,1,5
Aelena,whisperwind,96,druid,balance,6,1,5
Kushkilla,malganis,96,druid,balance,6,1,5
Brucey,khadgar,96,druid,balance,6,1,5
Øvernight,azralon,96,druid,balance,6,1,5
Caponetonejr,steamwheedle-cartel,96,druid,balance,6,1,5
Schlaankeyy,stormrage,96,druid,balance,6,1,5
Sinapticc,proudmoore,96,druid,balance,6,1,5
Kirrel,frostmourne,96,druid,balance,6,1,5
Stinkycrotch,malganis,96,druid,balance,6,1,5
Bowlpacka,malganis,96,druid,balance,6,1,5
Torpina,malganis,96,druid,balance,6,1,5
Oatmeals,fizzcrank,96,druid,balance,6,1,5
Shmooglite,emerald-dream,96,druid,balance,6,1,5
Chickenaeg,stormrage,96,druid,balance,6,1,5
Rennan,cenarius,96,druid,balance,6,1,5
Dendríta,ragnaros,96,druid,balance,6,1,5
Runestar,malganis,96,druid,balance,6,1,5
Thissaene,sargeras,96,druid,balance,6,1,5
Ggumy,tichondrius,96,druid,balance,6,1,5
Elivacheth,zuljin,96,druid,balance,6,1,5
Ultracatx,tichondrius,96,druid,balance,6,1,5
Tsaß,bleeding-hollow,96,druid,balance,6,1,5
Cloyer,stormrage,96,druid,balance,6,1,5
Grimmb,emerald-dream,96,druid,balance,6,1,5
Watchlady,thunderhorn,96,druid,balance,6,1,5
Furryluvr,tichondrius,96,druid,balance,6,1,5
Scatpanties,moon-guard,96,druid,balance,6,1,5
Walkdown,turalyon,96,druid,balance,6,1,5
Notdev,grizzly-hills,96,druid,balance,6,1,5
Chalupà,illidan,96,druid,balance,6,1,5
Chulogringo,tichondrius,96,druid,balance,6,1,5
Breedable,elune,96,druid,balance,6,1,5
Hurloon,demon-soul,96,druid,balance,6,1,5
Idontknowbro,bonechewer,96,druid,balance,6,1,5
Youlived,aegwynn,96,druid,balance,6,1,5
Stalfrus,area-52,96,druid,balance,6,1,5
Travys,sargeras,96,druid,balance,6,1,5
Slackoth,dalaran,96,druid,balance,6,1,5
Bernwolf,moon-guard,96,druid,balance,6,1,5
Skaidi,quelthalas,96,druid,balance,6,1,5
Fancyprance,dalaran,96,druid,balance,6,1,5
Feralmain,illidan,96,druid,balance,6,1,5
Sheeftah,illidan,96,druid,balance,6,1,5
Zazinium,illidan,96,druid,balance,6,1,5
Goodhealer,akama,96,druid,balance,6,1,5
Faldrynn,sargeras,96,druid,balance,6,1,5
Gaìjin,barthilas,96,druid,balance,6,1,5
Encosan,azralon,96,druid,balance,7,1,6
Mayarí,sargeras,96,druid,balance,8,1,7
Simbaa,blades-edge,96,druid,balance,10,1,9
Kängawalafox,frostmourne,96,druid,balance,12,1,11
Kodrän,stormrage,96,druid,balance,12,1,11
Ranokaliki,tichondrius,89,druid,balance,10,3,7
Drewcarriesu,arthas,79,druid,balance,5,2,3
Raahmirtah,illidan,79,druid,balance,5,1,4
Lutzenberger,nemesis,79,druid,balance,5,1,4
Foggie,spirestone,79,druid,balance,5,1,4
Manalune,firetree,79,druid,balance,5,1,4
Zephiee,kelthuzad,79,druid,balance,5,1,4
Minxminx,moon-guard,64,druid,balance,4,1,3
Morpheûs,bleeding-hollow,64,druid,balance,4,1,3
Hughhefferr,illidan,63,druid,balance,2,2,0
Policë,skullcrusher,42,druid,balance,8,2,6
Naturae,spirestone,31,druid,balance,2,1,1
Mclarenz,frostmourne,31,druid,balance,2,1,1
Highs,sargeras,16,druid,balance,1,1,0
Äbÿss,tichondrius,16,druid,balance,1,1,0
Nightsanta,emerald-dream,9,druid,balance,6,2,4
Garbagevoker,scilla,2242,evoker,preservation,192,99,93
Dracob,sargeras,2180,evoker,preservation,252,140,112
Meraxes,moonrunner,2160,evoker,preservation,83,44,39
Sleepiiheadx,stormrage,2141,evoker,preservation,96,54,42
Sleepiihead,stormrage,2130,evoker,preservation,96,50,46
Dragocula,tichondrius,2106,evoker,preservation,109,55,54
Jakedrake,stormrage,2062,evoker,preservation,235,117,118
Didy,tichondrius,2043,evoker,preservation,201,105,96
Jdbthyr,malganis,2030,evoker,preservation,239,116,123
Idk,proudmoore,2004,evoker,preservation,66,34,32
Kiry,emerald-dream,1994,evoker,preservation,84,40,44
Storeypagoda,tichondrius,1993,evoker,preservation,89,50,39
Eskrizzle,thrall,1991,evoker,preservation,78,38,40
Dracthyrfang,elune,1975,evoker,preservation,125,65,60
Kallie,whisperwind,1971,evoker,preservation,503,250,253
Eyjes,stormrage,1939,evoker,preservation,131,72,59
Walf,stormrage,1923,evoker,preservation,373,190,183
Sheepstealer,shuhalo,1922,evoker,preservation,72,35,37
Idrinkurine,tichondrius,1918,evoker,preservation,88,45,43
Ellafortnite,emerald-dream,1915,evoker,preservation,55,31,24
Sloane,dunemaul,1899,evoker,preservation,51,32,19
Bimbus,illidan,1887,evoker,preservation,154,85,69
Mngxaltx,ragnaros,1885,evoker,preservation,78,37,41
Philmcracken,proudmoore,1883,evoker,preservation,34,24,10
Benym,tichondrius,1873,evoker,preservation,60,32,28
Lieferant,area-52,1867,evoker,preservation,48,25,23
Advancedonly,tichondrius,1867,evoker,preservation,48,23,25
Draconian,frostmourne,1866,evoker,preservation,76,36,40
Drupy,tichondrius,1860,evoker,preservation,60,31,29
Thnake,zuljin,1839,evoker,preservation,72,38,34
Selkisaurus,area-52,1834,evoker,preservation,60,29,31
Ancalagøn,ragnaros,1833,evoker,preservation,70,35,35
Ojigi,sargeras,1833,evoker,preservation,69,28,41
Driceses,area-52,1831,evoker,preservation,72,44,28
Iba,tichondrius,1828,evoker,preservation,96,54,42
Ravebae,frostmourne,1828,evoker,preservation,45,25,20
Neskor,moon-guard,1827,evoker,preservation,101,58,43
Dragongunz,illidan,1815,evoker,preservation,42,19,23
Lucardeht,illidan,1813,evoker,preservation,44,23,21
Dragonkok,stormrage,1810,evoker,preservation,42,26,16
Hlaargh,illidan,1809,evoker,preservation,60,31,29
Dragonclause,stormrage,1809,evoker,preservation,72,32,40
Furegos,zuljin,1807,evoker,preservation,48,23,25
Lodekiim,malganis,1806,evoker,preservation,66,30,36
Mcdonovan,stormrage,1805,evoker,preservation,81,36,45
Révoked,magtheridon,1802,evoker,preservation,323,179,144
Obama,dragonmaw,1801,evoker,preservation,78,33,45
Novustrasza,lightbringer,1800,evoker,preservation,66,43,23
Petezra,ragnaros,1800,evoker,preservation,70,33,37
Livesey,thunderhorn,1791,evoker,preservation,96,56,40
Drerick,illidan,1772,evoker,preservation,104,53,51
Fatsu,executus,1768,evoker,preservation,54,24,30
Dragontrees,illidan,1765,evoker,preservation,54,28,26
Neocellx,frostwolf,1756,evoker,preservation,49,28,21
Ugg,stormrage,1756,evoker,preservation,171,76,95
Elimi,tichondrius,1748,evoker,preservation,36,22,14
Berquone,tichondrius,1747,evoker,preservation,72,31,41
Áäøxgød,ravencrest,1747,evoker,preservation,70,29,41
Cerevok,area-52,1745,evoker,preservation,60,37,23
Fxii,tichondrius,1737,evoker,preservation,24,20,4
Phooby,sargeras,1736,evoker,preservation,72,37,35
Rosestrasza,silvermoon,1734,evoker,preservation,132,63,69
Stønemonkey,sargeras,1730,evoker,preservation,147,73,74
Dirtydragon,uther,1724,evoker,preservation,54,22,32
Kainalaz,moon-guard,1715,evoker,preservation,55,28,27
Lodedragon,tichondrius,1714,evoker,preservation,108,48,60
Dunkinonem,black-dragonflight,1712,evoker,preservation,642,321,321
Basherm,moon-guard,1711,evoker,preservation,96,47,49
Moralies,area-52,1705,evoker,preservation,48,24,24
Joc,khazgoroth,1704,evoker,preservation,65,33,32
Schmitty,hellscream,1689,evoker,preservation,100,48,52
Evokethisdik,tichondrius,1684,evoker,preservation,37,20,17
Mirandaxo,tichondrius,1684,evoker,preservation,161,73,88
Courtvoke,turalyon,1667,evoker,preservation,176,92,84
Usedbandage,sargeras,1667,evoker,preservation,193,98,95
Hamine,tichondrius,1666,evoker,preservation,48,23,25
Judra,barthilas,1665,evoker,preservation,74,38,36
Velstrasza,stormrage,1664,evoker,preservation,36,20,16
Dupastrasza,illidan,1664,evoker,preservation,60,25,35
Vulkerr,stormrage,1663,evoker,preservation,90,51,39
Gharkul,frostmourne,1663,evoker,preservation,48,25,23
Daegonz,lightbringer,1657,evoker,preservation,116,57,59
Deathdrake,jubeithos,1651,evoker,preservation,156,75,81
Junkstam,malganis,1651,evoker,preservation,69,32,37
Sandragon,ragnaros,1646,evoker,preservation,57,25,32
Dragboy,stormrage,1645,evoker,preservation,116,64,52
Domavem,tichondrius,1642,evoker,preservation,66,28,38
Flamedramon,bleeding-hollow,1641,evoker,preservation,223,103,120
Sanninv,barthilas,1638,evoker,preservation,57,26,31
Trákanon,mugthol,1634,evoker,preservation,67,37,30
Ðrac,bleeding-hollow,1633,evoker,preservation,53,30,23
Purrlynn,tichondrius,1630,evoker,preservation,66,40,26
Modenzu,malganis,1629,evoker,preservation,66,33,33
Dripdrop,stormscale,1627,evoker,preservation,94,49,45
Wingsoflyfe,frostmourne,1625,evoker,preservation,48,20,28
Dracadukez,illidan,1625,evoker,preservation,60,21,39
Dragondikz,tichondrius,1622,evoker,preservation,48,25,23
Redseal,tichondrius,1621,evoker,preservation,80,37,43
Dgevoker,tichondrius,1620,evoker,preservation,47,19,28
Versezz,tichondrius,1619,evoker,preservation,30,17,13
Seeyn,tichondrius,1615,evoker,preservation,66,27,39
Grunkthyr,moon-guard,1614,evoker,preservation,47,25,22
Leonilxd,tichondrius,1610,evoker,preservation,97,51,46
Patzdormu,area-52,1610,evoker,preservation,42,17,25
Tallcanman,kelthuzad,1609,evoker,preservation,36,17,19
Bigdwagon,stormrage,1608,evoker,preservation,36,17,19
Triarcs,sargeras,1606,evoker,preservation,40,21,19
Tinine,frostmourne,1603,evoker,preservation,86,44,42
Deadlybx,bleeding-hollow,1603,evoker,preservation,70,32,38
Drakjar,nemesis,1602,evoker,preservation,48,23,25
Layugos,azralon,1601,evoker,preservation,35,20,15
Emperör,quelthalas,1601,evoker,preservation,91,49,42
Provokker,drakkari,1600,evoker,preservation,30,21,9
Jlucks,wyrmrest-accord,1600,evoker,preservation,166,94,72
Veraxsys,wyrmrest-accord,1600,evoker,preservation,52,20,32
Chessyk,ragnaros,1592,evoker,preservation,47,30,17
Adragon,garithos,1585,evoker,preservation,77,30,47
Stinkler,stormscale,1583,evoker,preservation,90,42,48
Thinprivlege,area-52,1583,evoker,preservation,60,26,34
Evokesyn,stormrage,1582,evoker,preservation,69,37,32
Dragonkink,sargeras,1581,evoker,preservation,60,32,28
Congodragon,frostmourne,1577,evoker,preservation,36,21,15
Lucidreamx,tichondrius,1575,evoker,preservation,67,34,33
Whethersmell,tichondrius,1566,evoker,preservation,158,71,87
Drepz,dalaran,1564,evoker,preservation,63,45,18
Linkinloatr,tichondrius,1563,evoker,preservation,54,23,31
Buttcrease,emerald-dream,1562,evoker,preservation,42,22,20
Møritz,stormrage,1562,evoker,preservation,86,40,46
Twizzthyr,bleeding-hollow,1558,evoker,preservation,138,64,74
Dracore,firetree,1549,evoker,preservation,215,112,103
Ffaarrvv,illidan,1545,evoker,preservation,108,63,45
Tonysaur,lethon,1537,evoker,preservation,30,19,11
Cyndragosa,dalvengyr,1537,evoker,preservation,65,29,36
Kwitty,illidan,1535,evoker,preservation,48,27,21
Fláppÿbírd,bleeding-hollow,1533,evoker,preservation,24,16,8
Corncrake,sargeras,1530,evoker,preservation,50,23,27
Cokobra,haomarush,1529,evoker,preservation,24,16,8
Zenot,malganis,1526,evoker,preservation,40,29,11
Egglayer,tichondrius,1525,evoker,preservation,131,54,77
Velocîraptor,bleeding-hollow,1524,evoker,preservation,92,53,39
Bigbaojian,tichondrius,1522,evoker,preservation,24,16,8
Eyolker,kelthuzad,1522,evoker,preservation,65,34,31
Transmogplz,tichondrius,1522,evoker,preservation,66,27,39
Gobananas,sargeras,1520,evoker,preservation,29,17,12
Ponnukii,tichondrius,1517,evoker,preservation,172,89,83
Elcigala,ragnaros,1516,evoker,preservation,257,131,126
Thevochr,area-52,1514,evoker,preservation,42,27,15
Dragonsteppz,aegwynn,1512,evoker,preservation,30,16,14
Trembulos,malganis,1512,evoker,preservation,48,23,25
Mfka,dalaran,1512,evoker,preservation,83,39,44
Earthshatter,lightbringer,1510,evoker,preservation,166,91,75
Ycnpass,tichondrius,1509,evoker,preservation,134,79,55
Madegood,tichondrius,1508,evoker,preservation,54,26,28
Dragdezenutz,bleeding-hollow,1508,evoker,preservation,94,36,58
Alitasbbq,malganis,1505,evoker,preservation,36,16,20
Waggon,moon-guard,1504,evoker,preservation,48,26,22
Youngyongdie,tichondrius,1499,evoker,preservation,52,25,27
Yop,proudmoore,1494,evoker,preservation,55,16,39
Slither,terenas,1491,evoker,preservation,87,49,38
Vhaegart,area-52,1491,evoker,preservation,90,38,52
Snuggleboo,malganis,1490,evoker,preservation,24,16,8
Emoker,magtheridon,1490,evoker,preservation,84,46,38
Suffler,warsong,1488,evoker,preservation,166,93,73
Dragoncods,velen,1488,evoker,preservation,48,26,22
Hepzibah,kelthuzad,1488,evoker,preservation,53,23,30
Virtualcrush,sisters-of-elune,1486,evoker,preservation,94,49,45
Nikholatrus,malganis,1483,evoker,preservation,106,52,54
Splendadaddy,kiljaeden,1482,evoker,preservation,30,16,14
Sineexe,illidan,1477,evoker,preservation,86,50,36
Kaidagos,tichondrius,1477,evoker,preservation,30,17,13
Buttfinger,bladefist,1476,evoker,preservation,74,33,41
Slimez,malganis,1476,evoker,preservation,107,47,60
Ralzital,auchindoun,1476,evoker,preservation,68,29,39
Healpumper,kelthuzad,1475,evoker,preservation,28,17,11
Nyzara,emerald-dream,1475,evoker,preservation,78,36,42
Yotus,illidan,1474,evoker,preservation,60,35,25
Jacm,fizzcrank,1472,evoker,preservation,77,36,41
Qiblii,moon-guard,1470,evoker,preservation,48,24,24
Monavoker,bleeding-hollow,1466,evoker,preservation,36,20,16
Pauly,suramar,1466,evoker,preservation,72,37,35
Diavai,area-52,1466,evoker,preservation,81,35,46
Setalet,zuljin,1465,evoker,preservation,47,19,28
Weagle,zuljin,1465,evoker,preservation,45,18,27
Delivv,hyjal,1464,evoker,preservation,78,42,36
Enazen,kiljaeden,1460,evoker,preservation,83,45,38
Lalargata,azralon,1459,evoker,preservation,65,32,33
Giratina,area-52,1457,evoker,preservation,102,50,52
Cringilisk,kelthuzad,1454,evoker,preservation,126,82,44
Nulldd,tichondrius,1452,evoker,preservation,47,16,31
Voithyr,moon-guard,1450,evoker,preservation,213,98,115
Vormontis,azralon,1449,evoker,preservation,88,40,48
Suedeshoes,bleeding-hollow,1448,evoker,preservation,162,88,74
Linguistic,tichondrius,1448,evoker,preservation,36,17,19
Nyxtari,ragnaros,1447,evoker,preservation,108,57,51
Spyrox,zuluhed,1445,evoker,preservation,30,16,14
Lizzardload,stormreaver,1445,evoker,preservation,82,37,45
Nazzadormu,tichondrius,1445,evoker,preservation,70,30,40
Dragisha,gnomeregan,1441,evoker,preservation,48,28,20
Derazar,malganis,1438,evoker,preservation,249,111,138
Squarter,kiljaeden,1437,evoker,preservation,48,28,20
Bucket,wyrmrest-accord,1437,evoker,preservation,38,16,22
Dweamfuego,sargeras,1434,evoker,preservation,24,15,9
Apollygos,malganis,1434,evoker,preservation,54,30,24
Dragonmyass,tichondrius,1434,evoker,preservation,43,17,26
Gogmagog,korgath,1433,evoker,preservation,89,42,47
Sovietønion,tichondrius,1433,evoker,preservation,71,32,39
Biggestbroie,frostmourne,1431,evoker,preservation,30,15,15
Nazatra,wyrmrest-accord,1431,evoker,preservation,107,51,56
Fusrodude,shuhalo,1428,evoker,preservation,86,48,38
Zakaraki,bloodscalp,1427,evoker,preservation,60,35,25
Handeezol,malganis,1426,evoker,preservation,48,27,21
Quickshootin,tichondrius,1426,evoker,preservation,249,115,134
Kjerne,stormrage,1424,evoker,preservation,64,34,30
Spyrodadrago,malganis,1423,evoker,preservation,113,50,63
Annum,moon-guard,1423,evoker,preservation,60,22,38
Xurota,proudmoore,1422,evoker,preservation,92,40,52
Ajiz,mannoroth,1421,evoker,preservation,42,18,24
Bendover,proudmoore,1420,evoker,preservation,36,19,17
Kephii,eonar,1415,evoker,preservation,42,22,20
Garchamp,area-52,1412,evoker,preservation,48,20,28
Vyndormu,moon-guard,1410,evoker,preservation,46,22,24
Runawayslave,frostmane,1409,evoker,preservation,227,106,121
Zka,nemesis,1408,evoker,preservation,43,21,22
Meiron,azralon,1407,evoker,preservation,66,33,33
Kigglypuff,illidan,1406,evoker,preservation,36,15,21
Cyntheticdr,malganis,1404,evoker,preservation,54,30,24
Roogye,illidan,1403,evoker,preservation,96,49,47
Miliolievo,azralon,1402,evoker,preservation,265,131,134
Kaldobar,stormrage,1401,evoker,preservation,24,15,9
Cjin,tichondrius,1401,evoker,preservation,30,17,13
Thicscales,tichondrius,1399,evoker,preservation,70,33,37
Anthyrsia,zuljin,1398,evoker,preservation,35,18,17
Dylôn,tichondrius,1398,evoker,preservation,58,27,31
Ráigon,ragnaros,1394,evoker,preservation,136,61,75
Necrathma,tichondrius,1392,evoker,preservation,103,49,54
Macismighty,emerald-dream,1390,evoker,preservation,66,36,30
Kikokosta,tichondrius,1389,evoker,preservation,106,57,49
Grousegamer,barthilas,1389,evoker,preservation,82,35,47
Jmir,tichondrius,1389,evoker,preservation,59,24,35
Growthyy,malganis,1387,evoker,preservation,35,22,13
Mythsvoker,barthilas,1384,evoker,preservation,56,31,25
Otsira,frostmourne,1383,evoker,preservation,48,32,16
Masquemeto,illidan,1382,evoker,preservation,43,21,22
Unknowndrago,kul-tiras,1376,evoker,preservation,30,15,15
Tazarke,dawnbringer,1375,evoker,preservation,60,35,25
Fuoco,kiljaeden,1374,evoker,preservation,50,28,22
Bigdrag,blackhand,1373,evoker,preservation,103,56,47
Dragonpel,azralon,1371,evoker,preservation,124,62,62
Errier,tichondrius,1370,evoker,preservation,33,17,16
Healmeta,sargeras,1369,evoker,preservation,308,154,154
Vodkasauce,tichondrius,1369,evoker,preservation,30,15,15
Xerroh,area-52,1368,evoker,preservation,76,38,38
Kratheu,azralon,1368,evoker,preservation,35,15,20
Pootylizard,daggerspine,1367,evoker,preservation,44,16,28
Tzindelor,illidan,1364,evoker,preservation,60,27,33
Friedwings,wyrmrest-accord,1359,evoker,preservation,27,16,11
Greenscales,frostmourne,1358,evoker,preservation,105,43,62
Aymadragon,sargeras,1357,evoker,preservation,38,15,23
Misico,illidan,1355,evoker,preservation,78,46,32
Thepplschamp,bloodhoof,1354,evoker,preservation,48,23,25
Lifewing,bleeding-hollow,1352,evoker,preservation,67,25,42
Gloamdream,cenarius,1351,evoker,preservation,171,93,78
Darthjarjar,bloodscalp,1351,evoker,preservation,170,84,86
Bomber,frostwolf,1351,evoker,preservation,34,16,18
Quesodillas,stormreaver,1350,evoker,preservation,48,18,30
Sía,drakkari,1349,evoker,preservation,48,28,20
Chambea,kelthuzad,1349,evoker,preservation,59,30,29
Garboker,area-52,1346,evoker,preservation,158,75,83
Neffiie,dalaran,1345,evoker,preservation,96,45,51
Kîñggïgàçhäð,stormrage,1343,evoker,preservation,24,14,10
Kwebab,tichondrius,1343,evoker,preservation,36,14,22
Feijiwang,aegwynn,1342,evoker,preservation,69,41,28
Flyboy,malganis,1339,evoker,preservation,24,14,10
Gotbreath,dalaran,1339,evoker,preservation,76,41,35
Primshin,illidan,1339,evoker,preservation,69,34,35
Enalen,azjolnerub,1338,evoker,preservation,62,29,33
Actïoncat,emerald-dream,1338,evoker,preservation,69,26,43
Naykir,khazgoroth,1335,evoker,preservation,24,16,8
Prettycooll,dathremar,1335,evoker,preservation,24,14,10
Gumbåll,bleeding-hollow,1335,evoker,preservation,168,81,87
Bryagh,executus,1334,evoker,preservation,54,28,26
Forsakentime,sargeras,1333,evoker,preservation,60,32,28
Charbothyr,gorgonnash,1331,evoker,preservation,49,24,25
Chunkè,moon-guard,1331,evoker,preservation,63,26,37
Kalsit,emerald-dream,1330,evoker,preservation,58,26,32
Dawitchvoker,illidan,1329,evoker,preservation,192,102,90
Mäverick,kelthuzad,1327,evoker,preservation,35,23,12
Caphe,nerzhul,1323,evoker,preservation,54,24,30
Lilithlittle,daggerspine,1321,evoker,preservation,148,75,73
Dendywings,zuljin,1321,evoker,preservation,30,14,16
Verk,deathwing,1318,evoker,preservation,138,75,63
Dracniel,illidan,1316,evoker,preservation,69,38,31
Nitalzith,area-52,1311,evoker,preservation,48,23,25
Zmaj,jubeithos,1310,evoker,preservation,24,17,7
Solong,sargeras,1310,evoker,preservation,67,38,29
Inkdsy,detheroc,1310,evoker,preservation,30,16,14
Jazzdragon,tichondrius,1310,evoker,preservation,51,24,27
Lamentation,area-52,1309,evoker,preservation,54,32,22
Longaot,tichondrius,1308,evoker,preservation,28,14,14
Whinks,zangarmarsh,1307,evoker,preservation,35,18,17
Glizzurd,proudmoore,1306,evoker,preservation,273,133,140
Zindrozarath,area-52,1306,evoker,preservation,109,53,56
Aoibae,frostmourne,1303,evoker,preservation,66,30,36
Kalikani,moon-guard,1303,evoker,preservation,93,41,52
Wangasaur,emerald-dream,1302,evoker,preservation,55,26,29
Cynderrellaa,proudmoore,1299,evoker,preservation,152,73,79
Lilacstrasza,moon-guard,1297,evoker,preservation,158,77,81
Oogiewoogie,doomhammer,1294,evoker,preservation,23,14,9
Straxolotl,frostmourne,1293,evoker,preservation,81,33,48
Shenlong,malganis,1292,evoker,preservation,101,55,46
Selfhealzer,korgath,1292,evoker,preservation,80,38,42
Radragão,azralon,1291,evoker,preservation,42,24,18
Boseijwho,emerald-dream,1288,evoker,preservation,36,19,17
Nitalash,moon-guard,1286,evoker,preservation,29,14,15
Gavstarz,frostmourne,1286,evoker,preservation,30,14,16
Ultis,tichondrius,1285,evoker,preservation,373,190,183
Paladinex,tichondrius,1284,evoker,preservation,47,27,20
Thereptile,frostmourne,1284,evoker,preservation,90,41,49
Laggathaa,emerald-dream,1283,evoker,preservation,44,17,27
Mëleys,ragnaros,1280,evoker,preservation,41,20,21
Dragûn,stormrage,1279,evoker,preservation,30,16,14
Shellessturt,kelthuzad,1278,evoker,preservation,27,14,13
Velaryonhero,arthas,1277,evoker,preservation,56,29,27
Feelzz,illidan,1275,evoker,preservation,37,19,18
Hotdawgin,korgath,1269,evoker,preservation,70,30,40
Lickndragons,sargeras,1265,evoker,preservation,36,14,22
Xhamon,quelthalas,1264,evoker,preservation,56,29,27
Cronós,tichondrius,1260,evoker,preservation,78,32,46
Riz,blackhand,1256,evoker,preservation,83,42,41
Skailyx,zuljin,1254,evoker,preservation,30,14,16
Sylf,kiljaeden,1253,evoker,preservation,81,45,36
Brantley,stormscale,1253,evoker,preservation,86,41,45
Vgt,nemesis,1253,evoker,preservation,84,35,49
Nicegirl,stormrage,1252,evoker,preservation,30,15,15
Agony,emerald-dream,1252,evoker,preservation,249,121,128
Mãttyy,malganis,1250,evoker,preservation,42,23,19
Shudo,moon-guard,1250,evoker,preservation,95,47,48
Xazxander,tichondrius,1249,evoker,preservation,78,37,41
Hydrrax,dalaran,1248,evoker,preservation,190,93,97
Mikoriivoker,tichondrius,1247,evoker,preservation,30,13,17
Lévocatrice,hakkar,1246,evoker,preservation,58,29,29
Wethotgarbee,tichondrius,1245,evoker,preservation,44,23,21
Justbreathez,tichondrius,1245,evoker,preservation,35,13,22
Stableboy,bleeding-hollow,1244,evoker,preservation,18,13,5
Thendroz,aerie-peak,1242,evoker,preservation,95,54,41
Valarakuu,illidan,1242,evoker,preservation,24,13,11
Antirrhinum,zuljin,1241,evoker,preservation,36,25,11
Dansauce,sargeras,1241,evoker,preservation,56,30,26
Allaston,tichondrius,1240,evoker,preservation,45,28,17
Zandragosa,dalaran,1240,evoker,preservation,24,13,11
Nêwt,darkspear,1240,evoker,preservation,208,102,106
Dkvastate,tichondrius,1236,evoker,preservation,112,56,56
Zerath,frostmane,1236,evoker,preservation,30,13,17
Lavagurl,stormscale,1235,evoker,preservation,30,13,17
Dragocser,drakkari,1233,evoker,preservation,30,13,17
Astoragosa,moon-guard,1231,evoker,preservation,61,38,23
Everglow,the-forgotten-coast,1231,evoker,preservation,30,17,13
Verosria,area-52,1230,evoker,preservation,24,13,11
Zippityzoom,barthilas,1229,evoker,preservation,59,30,29
Onornun,magtheridon,1229,evoker,preservation,66,32,34
Macdrag,malganis,1228,evoker,preservation,24,13,11
Kycaka,area-52,1228,evoker,preservation,46,14,32
Dracndanuts,draenor,1225,evoker,preservation,32,13,19
Lebronjmz,kiljaeden,1224,evoker,preservation,127,58,69
Evokas,tichondrius,1223,evoker,preservation,234,120,114
Mungwings,area-52,1221,evoker,preservation,43,22,21
Milfwizard,tichondrius,1219,evoker,preservation,24,13,11
Döublepenn,tichondrius,1219,evoker,preservation,75,40,35
Skithyrix,bleeding-hollow,1218,evoker,preservation,55,28,27
Dunkelzahn,gorgonnash,1214,evoker,preservation,30,15,15
Amniotic,hyjal,1212,evoker,preservation,54,31,23
Ysondrius,durotan,1212,evoker,preservation,48,26,22
Raptormoto,lothar,1211,evoker,preservation,32,14,18
Balèrion,illidan,1207,evoker,preservation,60,33,27
Ghidorah,sentinels,1207,evoker,preservation,59,32,27
Frozanat,kelthuzad,1205,evoker,preservation,75,34,41
Sanaz,stormreaver,1204,evoker,preservation,48,25,23
Allaker,kargath,1204,evoker,preservation,39,16,23
Doogiehowser,azshara,1202,evoker,preservation,162,78,84
Hamanv,tichondrius,1202,evoker,preservation,30,13,17
Assassasin,bonechewer,1200,evoker,preservation,60,27,33
Partysnaxx,thrall,1199,evoker,preservation,72,35,37
Çhara,illidan,1198,evoker,preservation,126,65,61
Shênlong,sargeras,1193,evoker,preservation,54,22,32
Crowqt,frostmourne,1190,evoker,preservation,95,34,61
Zitasanazen,tichondrius,1189,evoker,preservation,257,134,123
Goonwing,frostmourne,1188,evoker,preservation,24,13,11
Shook,baelgun,1188,evoker,preservation,122,62,60
Bahamut,magtheridon,1186,evoker,preservation,60,25,35
Wyldefire,senjin,1180,evoker,preservation,48,22,26
Deralan,khaz-modan,1179,evoker,preservation,108,40,68
Xblood,tichondrius,1172,evoker,preservation,42,25,17
Héllfire,ghostlands,1171,evoker,preservation,36,17,19
Frëëbîë,area-52,1170,evoker,preservation,30,13,17
Fránky,ragnaros,1167,evoker,preservation,24,13,11
Kaguax,tichondrius,1167,evoker,preservation,84,32,52
Worldx,illidan,1166,evoker,preservation,24,13,11
Lyingdragon,tichondrius,1166,evoker,preservation,60,26,34
Tinyvoker,area-52,1166,evoker,preservation,48,14,34
Mazalagon,trollbane,1165,evoker,preservation,29,15,14
Brôcôlînî,zuljin,1164,evoker,preservation,25,18,7
Dandera,stormrage,1164,evoker,preservation,88,40,48
Draginnuts,illidan,1162,evoker,preservation,53,25,28
Vermitor,sargeras,1155,evoker,preservation,24,13,11
Soô,tichondrius,1152,evoker,preservation,24,12,12
Mikoribreath,moknathal,1151,evoker,preservation,18,12,6
Crsevencr,tichondrius,1150,evoker,preservation,18,12,6
Raundur,ragnaros,1150,evoker,preservation,24,12,12
Miradrake,icecrown,1150,evoker,preservation,24,12,12
Mysticenergy,tichondrius,1150,evoker,preservation,60,28,32
Cycircle,tichondrius,1149,evoker,preservation,24,12,12
Emozoomer,malganis,1148,evoker,preservation,66,25,41
Vokr,area-52,1147,evoker,preservation,24,12,12
Derkscale,stormrage,1146,evoker,preservation,36,17,19
Distortion,drakthul,1145,evoker,preservation,117,62,55
Masondragon,darkspear,1145,evoker,preservation,30,12,18
Xiwinnie,illidan,1144,evoker,preservation,36,14,22
Visserion,sargeras,1143,evoker,preservation,25,14,11
Detreshan,stormreaver,1142,evoker,preservation,104,57,47
Potfase,tichondrius,1142,evoker,preservation,54,22,32
Hakuroyime,ragnaros,1141,evoker,preservation,24,15,9
Fibonac,frostmourne,1136,evoker,preservation,54,32,22
Tigdragon,proudmoore,1133,evoker,preservation,30,12,18
Vermax,akama,1133,evoker,preservation,45,17,28
Buttstough,aerie-peak,1132,evoker,preservation,23,13,10
Treadcinder,tichondrius,1130,evoker,preservation,30,14,16
Blay,elune,1130,evoker,preservation,36,15,21
Djdavi,azralon,1127,evoker,preservation,102,62,40
Kathendrov,sargeras,1119,evoker,preservation,24,14,10
Endroz,tichondrius,1119,evoker,preservation,24,12,12
Drathron,tichondrius,1118,evoker,preservation,28,13,15
Raykwaza,tichondrius,1114,evoker,preservation,24,12,12
Draczod,proudmoore,1112,evoker,preservation,53,19,34
Careflight,barthilas,1108,evoker,preservation,54,31,23
Dragonwench,sargeras,1101,evoker,preservation,22,13,9
Geico,spinebreaker,1100,evoker,preservation,15,13,2
Ilithiphobia,ghostlands,1100,evoker,preservation,38,16,22
Ashandshadow,area-52,1099,evoker,preservation,68,30,38
Daikis,proudmoore,1098,evoker,preservation,42,20,22
Thegrinchh,malganis,1097,evoker,preservation,81,39,42
Krossbones,cenarion-circle,1096,evoker,preservation,80,47,33
Bayvoker,area-52,1093,evoker,preservation,56,29,27
Shintrax,ragnaros,1092,evoker,preservation,46,23,23
Abigaile,illidan,1088,evoker,preservation,24,17,7
Emyhr,sargeras,1084,evoker,preservation,24,13,11
Draisin,zuljin,1083,evoker,preservation,24,13,11
Tryhard,wyrmrest-accord,1083,evoker,preservation,78,33,45
Setash,hyjal,1081,evoker,preservation,24,12,12
Clubmetro,boulderfist,1081,evoker,preservation,39,18,21
Lahfly,tichondrius,1079,evoker,preservation,54,33,21
Qiuhan,tichondrius,1076,evoker,preservation,48,23,25
Lilithà,kelthuzad,1075,evoker,preservation,30,20,10
Eldenkingy,sargeras,1074,evoker,preservation,40,12,28
Bobstrasz,tichondrius,1073,evoker,preservation,36,12,24
Bumbledragn,moon-guard,1071,evoker,preservation,37,23,14
Maxyz,khadgar,1071,evoker,preservation,42,13,29
Balmoze,tichondrius,1070,evoker,preservation,60,31,29
Dragonknght,tichondrius,1066,evoker,preservation,30,16,14
Draganoche,zuljin,1066,evoker,preservation,30,14,16
Aspecto,area-52,1066,evoker,preservation,34,13,21
Yozhz,ragnaros,1059,evoker,preservation,29,13,16
Dragown,sargeras,1059,evoker,preservation,30,13,17
Flybro,malganis,1056,evoker,preservation,18,11,7
Binidragon,tichondrius,1055,evoker,preservation,12,11,1
Yoyke,tichondrius,1055,evoker,preservation,24,11,13
Slippee,mugthol,1051,evoker,preservation,12,11,1
Imugee,sargeras,1051,evoker,preservation,24,11,13
Mordrakhuul,chogall,1051,evoker,preservation,24,11,13
Puraimaru,sargeras,1049,evoker,preservation,30,11,19
Sacrementus,tichondrius,1049,evoker,preservation,48,14,34
Smögg,quelthalas,1046,evoker,preservation,42,19,23
Draghyon,tichondrius,1044,evoker,preservation,42,11,31
Drittles,illidan,1043,evoker,preservation,62,28,34
Drokula,darkspear,1042,evoker,preservation,24,11,13
Uniqqe,tichondrius,1041,evoker,preservation,18,11,7
Amnemís,tichondrius,1040,evoker,preservation,20,12,8
Rynntynn,blood-furnace,1039,evoker,preservation,24,11,13
Charadrius,zuljin,1038,evoker,preservation,41,23,18
Deezdragon,stormrage,1037,evoker,preservation,18,11,7
Myxter,tichondrius,1035,evoker,preservation,49,25,24
Drgndeeznüts,tichondrius,1035,evoker,preservation,34,13,21
Carloxd,tichondrius,1035,evoker,preservation,34,12,22
Blankebr,gallywix,1032,evoker,preservation,36,24,12
Droggerdrago,stormreaver,1031,evoker,preservation,18,11,7
Degghurtni,area-52,1026,evoker,preservation,18,11,7
Mokkdala,blackrock,1026,evoker,preservation,40,12,28
Evoke,boulderfist,1025,evoker,preservation,28,12,16
Sophdrac,illidan,1024,evoker,preservation,43,25,18
Karmakulax,wildhammer,1024,evoker,preservation,31,12,19
Vandinus,stormrage,1023,evoker,preservation,38,17,21
Adessa,lothar,1020,evoker,preservation,36,14,22
Ownlyfans,silvermoon,1018,evoker,preservation,24,12,12
Prahvlord,shuhalo,1018,evoker,preservation,60,26,34
Turukmakto,illidan,1017,evoker,preservation,29,14,15
Mightywings,skywall,1011,evoker,preservation,138,70,68
Richviewrd,illidan,1010,evoker,preservation,36,19,17
Lightbeing,nazjatar,1001,evoker,preservation,48,29,19
Brahown,altar-of-storms,998,evoker,preservation,36,11,25
Dmuzh,drakkari,996,evoker,preservation,257,133,124
Rubellite,azralon,995,evoker,preservation,47,21,26
Shenrøn,altar-of-storms,994,evoker,preservation,32,17,15
Gemis,anvilmar,991,evoker,preservation,55,25,30
Hover,vashj,989,evoker,preservation,27,13,14
Ozmayzin,proudmoore,989,evoker,preservation,63,27,36
Items,frostmourne,987,evoker,preservation,22,11,11
Vyreth,sargeras,987,evoker,preservation,81,38,43
Arazerazer,thrall,984,evoker,preservation,66,23,43
Trillis,eldrethalas,980,evoker,preservation,30,18,12
Sïgrìd,tichondrius,979,evoker,preservation,27,19,8
Zackxo,moon-guard,969,evoker,preservation,32,19,13
Mesamune,bonechewer,969,evoker,preservation,61,23,38
Echoker,destromath,968,evoker,preservation,55,26,29
Milkspurt,tichondrius,962,evoker,preservation,52,23,29
Solryp,terokkar,961,evoker,preservation,125,59,66
Rubyzz,illidan,960,evoker,preservation,18,10,8
Syraxiez,sargeras,960,evoker,preservation,18,10,8
Seviant,tichondrius,960,evoker,preservation,18,10,8
Uncleìroh,tichondrius,960,evoker,preservation,24,10,14
Jnitoscaly,tichondrius,959,evoker,preservation,18,10,8
Cripcuhz,tichondrius,959,evoker,preservation,48,21,27
Spyrotime,tichondrius,959,evoker,preservation,27,10,17
Puffthemagic,lightnings-blade,958,evoker,preservation,18,10,8
Truffleßutta,tichondrius,958,evoker,preservation,18,10,8
Dragonsand,area-52,958,evoker,preservation,62,30,32
Xaxas,boulderfist,958,evoker,preservation,24,10,14
Drakthussey,illidan,957,evoker,preservation,18,10,8
Dokthyr,lightbringer,956,evoker,preservation,12,10,2
Lazioo,frostmourne,956,evoker,preservation,18,10,8
Kymoxien,sargeras,956,evoker,preservation,18,10,8
Goonguy,gnomeregan,955,evoker,preservation,12,10,2
Holdherhorn,area-52,955,evoker,preservation,18,10,8
Dragy,bonechewer,954,evoker,preservation,24,10,14
Hoverharder,stormrage,953,evoker,preservation,18,10,8
Soziin,skullcrusher,953,evoker,preservation,18,10,8
Proevoker,illidan,951,evoker,preservation,18,10,8
Barneydragon,stormrage,949,evoker,preservation,18,10,8
Wheyvern,malganis,949,evoker,preservation,57,19,38
Ayavi,illidan,942,evoker,preservation,18,10,8
Gidury,tichondrius,934,evoker,preservation,90,41,49
Kivoke,proudmoore,934,evoker,preservation,36,14,22
Faethana,thrall,929,evoker,preservation,23,11,12
Azuril,wyrmrest-accord,929,evoker,preservation,90,29,61
Dragonbro,spirestone,923,evoker,preservation,18,10,8
Kersava,frostmourne,919,evoker,preservation,23,10,13
Justbreathe,sargeras,911,evoker,preservation,17,10,7
Saintetoile,tichondrius,905,evoker,preservation,48,24,24
Badvoker,area-52,902,evoker,preservation,71,26,45
Cransvoker,illidan,902,evoker,preservation,30,10,20
Bandel,tichondrius,896,evoker,preservation,22,12,10
Kerlaan,illidan,895,evoker,preservation,18,10,8
Spitdafire,tichondrius,894,evoker,preservation,27,10,17
Bizzstrasza,shadowsong,886,evoker,preservation,52,21,31
Mugenyan,ragnaros,879,evoker,preservation,41,21,20
Ayoitspav,malganis,872,evoker,preservation,19,10,9
Willowflight,illidan,867,evoker,preservation,50,23,27
Mikorivoker,illidan,864,evoker,preservation,12,9,3
Mewoker,sargeras,864,evoker,preservation,12,9,3
Dreamfuego,tichondrius,864,evoker,preservation,12,9,3
Benbm,proudmoore,864,evoker,preservation,18,9,9
Calvoker,moon-guard,864,evoker,preservation,18,9,9
Yaaty,tichondrius,864,evoker,preservation,24,9,15
Nuubvoker,stormrage,863,evoker,preservation,18,9,9
Tonymanitoba,whisperwind,863,evoker,preservation,18,9,9
Wonderk,frostmourne,863,evoker,preservation,18,9,9
Velocivraull,malganis,862,evoker,preservation,12,9,3
Gannsito,emerald-dream,862,evoker,preservation,18,9,9
Xerithious,bleeding-hollow,862,evoker,preservation,18,9,9
Kakanjutan,azralon,861,evoker,preservation,16,10,6
Gravityblast,tichondrius,861,evoker,preservation,24,9,15
Chewydragoon,kelthuzad,860,evoker,preservation,12,9,3
Binxyboy,garrosh,860,evoker,preservation,16,10,6
Flowsmoke,tichondrius,859,evoker,preservation,18,9,9
Arûmat,tichondrius,859,evoker,preservation,30,9,21
Bjason,tichondrius,855,evoker,preservation,18,9,9
Kaeszandrus,azralon,855,evoker,preservation,18,9,9
Darksmoke,spirestone,855,evoker,preservation,18,9,9
Linabeauty,ragnaros,854,evoker,preservation,24,9,15
Rorie,farstriders,850,evoker,preservation,18,9,9
Moxa,doomhammer,850,evoker,preservation,83,41,42
Moiraine,kargath,850,evoker,preservation,24,9,15
Hentaizilla,kiljaeden,850,evoker,preservation,55,19,36
Lickyertits,tichondrius,849,evoker,preservation,24,9,15
Lechonlechon,tichondrius,847,evoker,preservation,12,9,3
Orïon,azralon,845,evoker,preservation,24,9,15
Nuunos,tichondrius,843,evoker,preservation,23,9,14
Jesstrasza,quelthalas,835,evoker,preservation,60,25,35
Decyrion,bleeding-hollow,830,evoker,preservation,29,9,20
Dragndeez,garrosh,824,evoker,preservation,40,9,31
Sandrozeria,wyrmrest-accord,822,evoker,preservation,14,10,4
Drakthuul,icecrown,819,evoker,preservation,24,11,13
Hlf,tichondrius,817,evoker,preservation,20,10,10
Saintpablox,illidan,810,evoker,preservation,34,10,24
Yaaj,black-dragonflight,808,evoker,preservation,23,10,13
Dragginhealz,stormrage,802,evoker,preservation,71,31,40
Darkspyro,area-52,799,evoker,preservation,11,9,2
Azuragon,illidan,793,evoker,preservation,71,23,48
Itsac,daggerspine,792,evoker,preservation,30,13,17
Drackaras,stormrage,790,evoker,preservation,18,9,9
Æsshayád,area-52,768,evoker,preservation,12,8,4
Kaddyragon,mannoroth,768,evoker,preservation,12,8,4
Ninereeds,malganis,768,evoker,preservation,12,8,4
Hasstle,tichondrius,768,evoker,preservation,12,8,4
Rvrbzv,stormrage,768,evoker,preservation,12,8,4
Epsilon,laughing-skull,768,evoker,preservation,12,8,4
Abevv,bonechewer,768,evoker,preservation,12,8,4
Tigthyr,alleria,768,evoker,preservation,12,8,4
Chañïng,frostmourne,768,evoker,preservation,18,8,10
Babylons,area-52,768,evoker,preservation,18,8,10
Draggin,barthilas,768,evoker,preservation,18,8,10
Messyvok,illidan,768,evoker,preservation,18,8,10
Airschlong,tichondrius,768,evoker,preservation,18,8,10
Sheepdoll,icecrown,768,evoker,preservation,18,8,10
Djvoker,zuljin,767,evoker,preservation,12,8,4
Fluffelss,moon-guard,767,evoker,preservation,12,8,4
Walloper,malganis,767,evoker,preservation,12,8,4
Cadwaladr,frostmourne,767,evoker,preservation,12,8,4
Venjolly,wyrmrest-accord,767,evoker,preservation,18,8,10
Xiaolongmei,frostmourne,767,evoker,preservation,18,8,10
Slèv,frostmourne,767,evoker,preservation,18,8,10
Innervoker,tichondrius,767,evoker,preservation,18,8,10
Nfts,darkspear,767,evoker,preservation,24,8,16
Azarke,rivendare,767,evoker,preservation,24,8,16
Chue,quelthalas,766,evoker,preservation,18,8,10
Nutsdragon,tichondrius,763,evoker,preservation,18,8,10
Wrathiøn,sargeras,763,evoker,preservation,24,8,16
Matsutake,kelthuzad,762,evoker,preservation,18,8,10
Tarnuss,skullcrusher,761,evoker,preservation,24,8,16
Draehgor,hyjal,758,evoker,preservation,18,8,10
Crumbflaps,kelthuzad,758,evoker,preservation,24,8,16
Lervish,durotan,755,evoker,preservation,12,8,4
Tooby,velen,751,evoker,preservation,12,8,4
Drevoker,lightbringer,748,evoker,preservation,18,8,10
Criteria,burning-legion,748,evoker,preservation,18,8,10
Madvillin,stormrage,747,evoker,preservation,12,8,4
Zaldraka,cairne,739,evoker,preservation,20,9,11
Furygos,stormrage,735,evoker,preservation,17,8,9
Durtyvoker,illidan,735,evoker,preservation,22,8,14
Butta,darkspear,734,evoker,preservation,17,8,9
Enuzan,dalaran,734,evoker,preservation,32,8,24
Polland,area-52,731,evoker,preservation,17,8,9
Icthelestron,black-dragonflight,729,evoker,preservation,14,9,5
Geicovoker,tichondrius,714,evoker,preservation,28,9,19
Shardsnorta,chogall,708,evoker,preservation,17,8,9
Tëssarion,quelthalas,704,evoker,preservation,26,10,16
Wilbog,moon-guard,700,evoker,preservation,44,10,34
Letharrian,sargeras,698,evoker,preservation,12,10,2
Razen,silvermoon,692,evoker,preservation,16,8,8
Orame,dalaran,685,evoker,preservation,25,8,17
Venlormi,moon-guard,675,evoker,preservation,46,15,31
Beatxqt,area-52,672,evoker,preservation,12,7,5
Vroomby,area-52,672,evoker,preservation,12,7,5
Whelp,shadow-council,672,evoker,preservation,12,7,5
Goursaud,malganis,672,evoker,preservation,12,7,5
Lilrandal,emerald-dream,672,evoker,preservation,12,7,5
Slrepeat,frostmourne,672,evoker,preservation,12,7,5
Skrimbles,tichondrius,672,evoker,preservation,12,7,5
Iantern,dalaran,672,evoker,preservation,12,7,5
Dzdv,stormrage,672,evoker,preservation,12,7,5
Vrondiss,trollbane,672,evoker,preservation,12,7,5
Clm,staghelm,672,evoker,preservation,12,7,5
Fionyan,proudmoore,672,evoker,preservation,12,7,5
Iamg,stormscale,672,evoker,preservation,18,7,11
Darchomp,illidan,672,evoker,preservation,18,7,11
Soyum,sargeras,672,evoker,preservation,18,7,11
Orncen,emerald-dream,672,evoker,preservation,18,7,11
Draikia,zuljin,672,evoker,preservation,18,7,11
Toastsevoker,tichondrius,672,evoker,preservation,18,7,11
Briggsybear,malganis,672,evoker,preservation,18,7,11
Gaslightqt,tichondrius,672,evoker,preservation,19,7,12
Hdyl,tichondrius,672,evoker,preservation,24,7,17
Kontaz,icecrown,672,evoker,preservation,24,7,17
Reskue,burning-legion,671,evoker,preservation,12,7,5
Forlornomens,area-52,671,evoker,preservation,12,7,5
Flapthewap,illidan,671,evoker,preservation,12,7,5
Vertorgon,proudmoore,671,evoker,preservation,12,7,5
Spicypnuts,zuljin,671,evoker,preservation,12,7,5
Matchamjölk,tichondrius,671,evoker,preservation,12,7,5
Boomlvx,frostmourne,671,evoker,preservation,12,7,5
Toppedyouoff,thrall,671,evoker,preservation,15,7,8
Longxx,dalaran,671,evoker,preservation,18,7,11
Lampizard,bonechewer,671,evoker,preservation,24,7,17
Bookkoo,burning-legion,671,evoker,preservation,24,7,17
Rayvoker,elune,670,evoker,preservation,12,7,5
Mad,aerie-peak,670,evoker,preservation,19,9,10
Woozul,malganis,670,evoker,preservation,30,7,23
Deezyroller,sargeras,669,evoker,preservation,12,7,5
Dragonballer,trollbane,669,evoker,preservation,18,7,11
Retcondragon,sargeras,669,evoker,preservation,18,7,11
Rainwalkers,illidan,666,evoker,preservation,12,7,5
Rilex,kelthuzad,666,evoker,preservation,12,7,5
Azulnova,tichondrius,665,evoker,preservation,18,7,11
Pypokay,nemesis,665,evoker,preservation,18,7,11
Acidbreath,tichondrius,661,evoker,preservation,18,7,11
Straightman,stormrage,661,evoker,preservation,18,7,11
Falsedaze,sargeras,655,evoker,preservation,18,7,11
Yiptondabs,emerald-dream,650,evoker,preservation,29,7,22
Thenasath,sargeras,640,evoker,preservation,17,7,10
Dreamvisage,silvermoon,638,evoker,preservation,14,8,6
Ramas,burning-blade,638,evoker,preservation,32,8,24
Elderdragon,nerzhul,629,evoker,preservation,16,8,8
Kixxely,sargeras,623,evoker,preservation,12,8,4
Terpsy,area-52,620,evoker,preservation,11,7,4
Kilawatt,barthilas,620,evoker,preservation,11,7,4
Tsuruda,illidan,618,evoker,preservation,21,8,13
Gdragons,tichondrius,607,evoker,preservation,11,7,4
Saxthyr,stormreaver,592,evoker,preservation,13,7,6
Ambadragon,frostmourne,591,evoker,preservation,11,7,4
Cheesedragon,tichondrius,576,evoker,preservation,6,6,0
Hwansu,tichondrius,576,evoker,preservation,6,6,0
Tatsurai,tichondrius,576,evoker,preservation,10,7,3
Baldpython,area-52,576,evoker,preservation,12,6,6
Ozvoker,area-52,576,evoker,preservation,12,6,6
Diregon,kelthuzad,576,evoker,preservation,12,6,6
Oldgeorge,tichondrius,576,evoker,preservation,12,6,6
Kwaz,kelthuzad,576,evoker,preservation,12,6,6
Wtfhappen,tichondrius,576,evoker,preservation,12,6,6
Dragonman,twisting-nether,576,evoker,preservation,12,6,6
Localfemboy,area-52,576,evoker,preservation,12,6,6
Thegoone,bleeding-hollow,576,evoker,preservation,12,6,6
Teëst,malganis,576,evoker,preservation,12,6,6
Ccguzzlerx,tichondrius,576,evoker,preservation,12,6,6
Saviorkai,barthilas,576,evoker,preservation,12,6,6
Uneedawhip,zuljin,576,evoker,preservation,12,6,6
Whitesnow,korgath,576,evoker,preservation,12,6,6
Daylenx,thrall,576,evoker,preservation,12,6,6
Theyevokbuda,kelthuzad,576,evoker,preservation,12,6,6
Bookwyrm,khadgar,576,evoker,preservation,12,6,6
Datinysmaug,stormrage,576,evoker,preservation,12,6,6
Talzindera,sargeras,576,evoker,preservation,12,6,6
Teddydarg,tichondrius,576,evoker,preservation,14,6,8
Murphymonsta,stormscale,576,evoker,preservation,18,6,12
Dragonk,dragonblight,576,evoker,preservation,18,6,12
Phanthyr,tichondrius,576,evoker,preservation,18,6,12
Meepslol,kiljaeden,576,evoker,preservation,18,6,12
Flyingmooie,frostmourne,576,evoker,preservation,24,6,18
Ryloun,sargeras,576,evoker,preservation,24,6,18
Toodllesz,stormrage,575,evoker,preservation,6,6,0
Crayonshinch,tichondrius,575,evoker,preservation,12,6,6
Nâpâlm,aggramar,575,evoker,preservation,12,6,6
Drakistraz,draenor,575,evoker,preservation,12,6,6
Valadrakth,tichondrius,575,evoker,preservation,12,6,6
Tekath,altar-of-storms,575,evoker,preservation,12,6,6
Magnito,thorium-brotherhood,575,evoker,preservation,12,6,6
Valeshkanyel,ragnaros,575,evoker,preservation,12,6,6
Shinryuu,warsong,575,evoker,preservation,12,6,6
Bhfflove,area-52,575,evoker,preservation,12,6,6
Flameschosen,malganis,575,evoker,preservation,12,6,6
Madzul,emerald-dream,575,evoker,preservation,12,6,6
Skkuld,stormrage,575,evoker,preservation,12,6,6
Tokeandvoke,haomarush,575,evoker,preservation,12,6,6
Dragonpaws,illidan,575,evoker,preservation,12,6,6
Moiraine,frostwolf,575,evoker,preservation,18,6,12
Naùghtygames,area-52,575,evoker,preservation,18,6,12
Sgtskip,blackrock,575,evoker,preservation,24,6,18
Kyloflight,thrall,575,evoker,preservation,24,6,18
Toothless,garithos,574,evoker,preservation,6,6,0
Amun,frostwolf,574,evoker,preservation,12,6,6
Zascar,stormrage,574,evoker,preservation,12,6,6
Cinderazerat,moon-guard,574,evoker,preservation,18,6,12
Azalana,thrall,574,evoker,preservation,24,6,18
Rzdrag,nemesis,574,evoker,preservation,36,6,30
Moraise,bonechewer,573,evoker,preservation,12,6,6
Ozsandlbs,tichondrius,573,evoker,preservation,12,6,6
Siquitraki,illidan,573,evoker,preservation,18,6,12
Mulutlaser,frostmourne,570,evoker,preservation,12,6,6
Lishalthen,frostmourne,569,evoker,preservation,12,6,6
Rhaeynes,moon-guard,568,evoker,preservation,12,6,6
Ankhalagor,ragnaros,567,evoker,preservation,12,6,6
Preservant,stormrage,567,evoker,preservation,12,6,6
Dragussy,illidan,548,evoker,preservation,28,10,18
Hecklinheals,hyjal,544,evoker,preservation,13,7,6
Hexavalent,tichondrius,542,evoker,preservation,11,6,5
Arazen,frostmourne,539,evoker,preservation,23,6,17
Spliffdragon,sargeras,528,evoker,preservation,17,6,11
Fieros,area-52,527,evoker,preservation,13,6,7
Imperialist,proudmoore,522,evoker,preservation,29,7,22
Shenlòng,drakkari,521,evoker,preservation,15,7,8
Akavoker,sargeras,521,evoker,preservation,20,7,13
Supernovax,illidan,512,evoker,preservation,16,6,10
Imaginedrgn,tichondrius,511,evoker,preservation,11,6,5
Nwo,shattered-hand,494,evoker,preservation,11,6,5
Brindletail,proudmoore,494,evoker,preservation,19,6,13
Allevesh,shadow-council,480,evoker,preservation,6,5,1
Arzaria,stormrage,480,evoker,preservation,6,5,1
Lizardfaith,tichondrius,480,evoker,preservation,6,5,1
Finnahorns,sargeras,480,evoker,preservation,6,5,1
Chinadragon,balnazzar,480,evoker,preservation,6,5,1
Whelpling,cenarion-circle,480,evoker,preservation,6,5,1
Neewhad,malganis,480,evoker,preservation,12,5,7
Fazedd,tichondrius,480,evoker,preservation,12,5,7
Cirroaltos,aerie-peak,480,evoker,preservation,12,5,7
Shazdrag,stormrage,480,evoker,preservation,12,5,7
Supernamv,sargeras,480,evoker,preservation,12,5,7
Evizzar,zuljin,480,evoker,preservation,12,5,7
Hicane,tichondrius,480,evoker,preservation,12,5,7
Oldmandrake,mannoroth,480,evoker,preservation,12,5,7
Evvookkeerr,tichondrius,480,evoker,preservation,12,5,7
Hageiz,tichondrius,480,evoker,preservation,12,5,7
Imwoker,illidan,480,evoker,preservation,12,5,7
Cutewing,tichondrius,480,evoker,preservation,12,5,7
Chronocolter,thunderhorn,480,evoker,preservation,12,5,7
Spyroguts,thrall,480,evoker,preservation,12,5,7
Salusx,proudmoore,480,evoker,preservation,12,5,7
Draktharl,tichondrius,480,evoker,preservation,12,5,7
Roastdrake,tichondrius,480,evoker,preservation,12,5,7
Aetherz,illidan,480,evoker,preservation,18,5,13
Cruv,boulderfist,480,evoker,preservation,18,5,13
Olindoe,tichondrius,480,evoker,preservation,18,5,13
Selenian,area-52,480,evoker,preservation,24,5,19
Bronyflexy,sargeras,480,evoker,preservation,24,5,19
Bvo,stormrage,479,evoker,preservation,6,5,1
Gemish,lethon,479,evoker,preservation,6,5,1
Prevoker,kirin-tor,479,evoker,preservation,6,5,1
Dracdeez,dreadmaul,479,evoker,preservation,12,5,7
Selden,boulderfist,479,evoker,preservation,12,5,7
Álln,sargeras,479,evoker,preservation,12,5,7
Kratostrasz,moon-guard,479,evoker,preservation,12,5,7
Wrathykos,thrall,479,evoker,preservation,12,5,7
Cootietooter,icecrown,479,evoker,preservation,12,5,7
Drizzydrag,jubeithos,479,evoker,preservation,12,5,7
Rhaènyra,sargeras,479,evoker,preservation,12,5,7
Drektar,the-scryers,479,evoker,preservation,12,5,7
Lazzarross,area-52,479,evoker,preservation,12,5,7
Maldormu,stormrage,479,evoker,preservation,12,5,7
Cindermint,mugthol,479,evoker,preservation,14,5,9
Bitkoinz,tichondrius,479,evoker,preservation,18,5,13
Dracomedicus,frostmourne,479,evoker,preservation,22,5,17
Lizardtrash,ragnaros,478,evoker,preservation,12,5,7
Melbu,thunderlord,478,evoker,preservation,12,5,7
Aurastella,frostwolf,478,evoker,preservation,12,5,7
Scaryðragon,akama,477,evoker,preservation,12,5,7
Livemaximii,moon-guard,477,evoker,preservation,12,5,7
Dracoly,medivh,476,evoker,preservation,12,5,7
Tazeneth,sargeras,476,evoker,preservation,12,5,7
Interracial,stormscale,475,evoker,preservation,10,6,4
Lisatallie,moon-guard,475,evoker,preservation,12,5,7
Kaelestian,ragnaros,473,evoker,preservation,12,5,7
Amoraz,tichondrius,460,evoker,preservation,23,5,18
Jcii,tichondrius,447,evoker,preservation,11,5,6
Enoch,chogall,440,evoker,preservation,21,7,14
Got,burning-blade,432,evoker,preservation,9,5,4
Bootymágic,tichondrius,431,evoker,preservation,9,6,3
Temporal,mannoroth,431,evoker,preservation,9,6,3
Gaserick,quelthalas,426,evoker,preservation,17,6,11
Soukizilla,sargeras,416,evoker,preservation,10,5,5
Tealik,frostmourne,416,evoker,preservation,16,5,11
Monzydrake,emerald-dream,408,evoker,preservation,20,5,15
Velahesa,sargeras,384,evoker,preservation,6,4,2
Atraxian,tichondrius,384,evoker,preservation,6,4,2
Docevoker,tichondrius,384,evoker,preservation,6,4,2
Mtndewboy,illidan,384,evoker,preservation,6,4,2
Syneestra,nemesis,384,evoker,preservation,6,4,2
Ygnizem,ysera,384,evoker,preservation,6,4,2
Smnsevoker,emerald-dream,384,evoker,preservation,6,4,2
Jëthrø,illidan,384,evoker,preservation,6,4,2
Murloc,shadowsong,384,evoker,preservation,6,4,2
Ancalagðn,quelthalas,384,evoker,preservation,6,4,2
Tygor,arthas,384,evoker,preservation,6,4,2
Taegon,area-52,384,evoker,preservation,6,4,2
Baradad,frostmourne,384,evoker,preservation,6,4,2
Dyvyne,demon-soul,384,evoker,preservation,6,4,2
Yessirs,shadow-council,384,evoker,preservation,6,4,2
Bassblasterr,dalaran,384,evoker,preservation,6,4,2
Niraz,dalaran,384,evoker,preservation,6,4,2
Setrazen,illidan,384,evoker,preservation,6,4,2
Exrtj,stormrage,384,evoker,preservation,6,4,2
Kharizard,moon-guard,384,evoker,preservation,6,4,2
Azurgos,proudmoore,384,evoker,preservation,6,4,2
Dragoontekka,tichondrius,384,evoker,preservation,6,4,2
Nøzmosis,area-52,384,evoker,preservation,6,4,2
Swanzea,sargeras,384,evoker,preservation,6,4,2
Venitsu,malganis,384,evoker,preservation,6,4,2
Treysongz,area-52,384,evoker,preservation,6,4,2
Spaceox,tichondrius,384,evoker,preservation,6,4,2
Zaedor,stormrage,384,evoker,preservation,10,5,5
Mvpjs,medivh,384,evoker,preservation,8,4,4
Mignificent,sargeras,384,evoker,preservation,12,4,8
Dragwyn,senjin,384,evoker,preservation,12,4,8
Raphdragon,stormrage,384,evoker,preservation,12,4,8
Donresantis,tichondrius,384,evoker,preservation,12,4,8
Boppled,tichondrius,384,evoker,preservation,12,4,8
Pensini,illidan,384,evoker,preservation,12,4,8
Bryágh,wyrmrest-accord,384,evoker,preservation,12,4,8
Psyydragon,azralon,384,evoker,preservation,12,4,8
Oldui,frostmourne,384,evoker,preservation,12,4,8
Vanyalus,uldum,384,evoker,preservation,12,4,8
Yujirohanma,frostmourne,384,evoker,preservation,12,4,8
Crumbsock,thrall,384,evoker,preservation,12,4,8
Shoestrings,tichondrius,384,evoker,preservation,12,4,8
Flipturn,illidan,384,evoker,preservation,12,4,8
Dragrenghost,illidan,384,evoker,preservation,12,4,8
Williamjong,tichondrius,384,evoker,preservation,12,4,8
Imadargin,malganis,384,evoker,preservation,12,4,8
Rawrexp,emerald-dream,384,evoker,preservation,12,4,8
Galrend,firetree,384,evoker,preservation,12,4,8
Satratren,moon-guard,384,evoker,preservation,12,4,8
Upsdriver,dentarg,384,evoker,preservation,18,4,14
Aceu,bloodhoof,383,evoker,preservation,6,4,2
Xdragon,lightbringer,383,evoker,preservation,12,4,8
Tihkal,spinebreaker,383,evoker,preservation,12,4,8
Quesovoke,eldrethalas,383,evoker,preservation,12,4,8
Dombi,moon-guard,383,evoker,preservation,12,4,8
Flymuch,illidan,383,evoker,preservation,12,4,8
Lunearia,stormrage,383,evoker,preservation,12,4,8
Zeldaryel,azralon,382,evoker,preservation,6,4,2
Tribunalis,stormrage,382,evoker,preservation,6,4,2
Bigtoots,illidan,382,evoker,preservation,12,4,8
Frozonic,tichondrius,381,evoker,preservation,12,4,8
Danatreseth,moon-guard,380,evoker,preservation,12,4,8
Ragendragon,hellscream,377,evoker,preservation,18,4,14
Nyxstrasza,moknathal,366,evoker,preservation,11,4,7
Snailor,eldrethalas,351,evoker,preservation,10,4,6
Annazara,stormrage,336,evoker,preservation,9,4,5
Zathasar,tichondrius,333,evoker,preservation,28,4,24
Rápturé,tichondrius,330,evoker,preservation,16,7,9
Corlys,thunderhorn,330,evoker,preservation,17,5,12
Homiedraconi,nordrassil,329,evoker,preservation,12,5,7
Jolynne,illidan,320,evoker,preservation,14,4,10
Vlysage,dark-iron,319,evoker,preservation,5,4,1
Wtsgoldpst,tichondrius,319,evoker,preservation,8,4,4
Lantur,perenolde,319,evoker,preservation,16,4,12
Polyrhythmic,ysera,304,evoker,preservation,7,4,3
Kheeleesi,illidan,288,evoker,preservation,6,3,3
Bigtitsdrag,illidan,288,evoker,preservation,6,3,3
Dragonleaves,sargeras,288,evoker,preservation,6,3,3
Dragonsama,area-52,288,evoker,preservation,6,3,3
Dimpulse,zuljin,288,evoker,preservation,6,3,3
Flexlong,tichondrius,288,evoker,preservation,6,3,3
Predacious,draktharon,288,evoker,preservation,6,3,3
Golden,area-52,288,evoker,preservation,6,3,3
Swagdriver,moon-guard,288,evoker,preservation,6,3,3
Æg,zuljin,288,evoker,preservation,6,3,3
Jokko,moon-guard,288,evoker,preservation,6,3,3
Draislyn,cenarion-circle,288,evoker,preservation,6,3,3
Cônflicted,emerald-dream,288,evoker,preservation,6,3,3
Dracoon,madoran,288,evoker,preservation,6,3,3
Dracritzzx,ragnaros,288,evoker,preservation,6,3,3
Setren,antonidas,288,evoker,preservation,6,3,3
Thendetra,mannoroth,288,evoker,preservation,6,3,3
Karuikei,proudmoore,288,evoker,preservation,6,3,3
Vaeghar,anvilmar,288,evoker,preservation,6,3,3
Draseew,drakkari,288,evoker,preservation,6,3,3
Bad,nerzhul,288,evoker,preservation,6,3,3
Rangä,caelestrasz,288,evoker,preservation,6,3,3
Redhorn,frostmourne,288,evoker,preservation,6,3,3
Heidibibe,tichondrius,288,evoker,preservation,6,3,3
Simplerules,zuljin,288,evoker,preservation,6,3,3
Icallthecops,tichondrius,288,evoker,preservation,6,3,3
Garrgle,sargeras,288,evoker,preservation,6,3,3
Paradïsso,tichondrius,288,evoker,preservation,6,3,3
Vygrax,nerzhul,288,evoker,preservation,6,3,3
Raxdragon,sargeras,288,evoker,preservation,6,3,3
Jakburnon,stormrage,288,evoker,preservation,6,3,3
Knowragretz,tichondrius,288,evoker,preservation,6,3,3
Spyrä,moon-guard,288,evoker,preservation,6,3,3
Jamörant,tichondrius,288,evoker,preservation,6,3,3
Ðçßñÿåæéîùøð,tichondrius,288,evoker,preservation,6,3,3
Kreutzhauser,tichondrius,288,evoker,preservation,6,3,3
Chawp,tichondrius,288,evoker,preservation,6,3,3
Gvoker,nemesis,288,evoker,preservation,6,3,3
Flappeebird,area-52,288,evoker,preservation,6,3,3
Lìthium,frostmourne,288,evoker,preservation,6,3,3
Halcyonxz,tichondrius,288,evoker,preservation,6,3,3
Vokefuu,illidan,288,evoker,preservation,6,3,3
Dragonblazer,illidan,288,evoker,preservation,6,3,3
Ruffee,frostmourne,288,evoker,preservation,6,3,3
Unclelroh,kelthuzad,288,evoker,preservation,6,3,3
Evoketage,malganis,288,evoker,preservation,6,3,3
Sylvee,bleeding-hollow,288,evoker,preservation,7,3,4
Westyvoker,arthas,288,evoker,preservation,12,3,9
Explosives,blades-edge,288,evoker,preservation,12,3,9
Tyrannicull,sargeras,288,evoker,preservation,12,3,9
Raegon,wyrmrest-accord,288,evoker,preservation,12,3,9
Drakkar,elune,288,evoker,preservation,12,3,9
Elurb,illidan,288,evoker,preservation,12,3,9
Ahahaa,frostmourne,288,evoker,preservation,12,3,9
Velzelya,zuljin,288,evoker,preservation,12,3,9
Dwacawys,zuljin,288,evoker,preservation,12,3,9
Teldormu,drenden,288,evoker,preservation,12,3,9
Vandornomu,illidan,288,evoker,preservation,12,3,9
Cøømbuya,sargeras,288,evoker,preservation,12,3,9
Vxfire,sargeras,288,evoker,preservation,12,3,9
Hel,stormrage,288,evoker,preservation,12,3,9
Zumanitÿ,zangarmarsh,288,evoker,preservation,12,3,9
Snáckbóx,alexstrasza,288,evoker,preservation,12,3,9
Stormdagger,proudmoore,288,evoker,preservation,12,3,9
Galfiore,malganis,288,evoker,preservation,12,3,9
Dragonbabu,area-52,288,evoker,preservation,12,3,9
Deàthwing,proudmoore,288,evoker,preservation,12,3,9
Discussion,area-52,288,evoker,preservation,12,3,9
Jammstraza,skywall,288,evoker,preservation,12,3,9
Reflexd,malganis,288,evoker,preservation,12,3,9
Fugginuhh,proudmoore,288,evoker,preservation,12,3,9
Jumpmaster,black-dragonflight,288,evoker,preservation,12,3,9
Simmnyxia,area-52,288,evoker,preservation,12,3,9
Mouthgorawr,tichondrius,288,evoker,preservation,13,3,10
Wapowthion,blades-edge,288,evoker,preservation,18,3,15
Windchaser,kelthuzad,288,evoker,preservation,18,3,15
Rogir,zuljin,288,evoker,preservation,18,3,15
Rizzanomics,zuljin,287,evoker,preservation,8,4,4
Retroo,dark-iron,287,evoker,preservation,6,3,3
Killerdragon,darkspear,287,evoker,preservation,6,3,3
Notvez,bleeding-hollow,287,evoker,preservation,6,3,3
Supereragon,area-52,287,evoker,preservation,6,3,3
Dracorblaq,bleeding-hollow,287,evoker,preservation,6,3,3
Saphfire,burning-legion,287,evoker,preservation,6,3,3
Draktarion,ragnaros,287,evoker,preservation,12,3,9
Dragoreo,illidan,287,evoker,preservation,12,3,9
Tazen,bleeding-hollow,287,evoker,preservation,12,3,9
Chenrong,sargeras,287,evoker,preservation,12,3,9
Toothlesz,draka,287,evoker,preservation,18,3,15
Kalistro,quelthalas,286,evoker,preservation,6,3,3
Lawroadt,tichondrius,286,evoker,preservation,12,3,9
Drakonyx,mugthol,285,evoker,preservation,12,3,9
Arazarion,mugthol,285,evoker,preservation,12,3,9
Jsb,moon-guard,282,evoker,preservation,30,3,27
Uskrait,tichondrius,255,evoker,preservation,14,4,10
Stíckyj,tichondrius,255,evoker,preservation,11,3,8
Dragontamz,the-forgotten-coast,239,evoker,preservation,5,3,2
Slashprovoke,frostmourne,239,evoker,preservation,5,3,2
Tailia,sargeras,239,evoker,preservation,11,3,8
Tugmapvpean,kelthuzad,208,evoker,preservation,7,3,4
Lëåf,area-52,192,evoker,preservation,6,2,4
Flappyboy,bleeding-hollow,192,evoker,preservation,6,2,4
Kcwt,illidan,192,evoker,preservation,6,2,4
Dwagonwage,zuljin,192,evoker,preservation,6,2,4
Invdkill,azralon,192,evoker,preservation,6,2,4
Smurgma,frostmane,192,evoker,preservation,6,2,4
Dscim,zuljin,192,evoker,preservation,6,2,4
Jessefurr,undermine,192,evoker,preservation,6,2,4
Nite,lothar,192,evoker,preservation,6,2,4
Wse,illidan,192,evoker,preservation,6,2,4
Sketchybum,tichondrius,192,evoker,preservation,6,2,4
Drugdoer,illidan,192,evoker,preservation,6,2,4
Nil,malganis,192,evoker,preservation,6,2,4
Racovoker,zuljin,192,evoker,preservation,6,2,4
Carrnedge,area-52,192,evoker,preservation,6,2,4
Slaymedaddy,proudmoore,192,evoker,preservation,6,2,4
Ndr,proudmoore,192,evoker,preservation,6,2,4
Tagritash,kelthuzad,192,evoker,preservation,6,2,4
Scyyterr,azralon,192,evoker,preservation,6,2,4
Nunez,frostmourne,192,evoker,preservation,6,2,4
Lexazule,bleeding-hollow,192,evoker,preservation,6,2,4
Preserveluke,moon-guard,192,evoker,preservation,6,2,4
Surasi,frostmourne,192,evoker,preservation,6,2,4
Froky,stormrage,192,evoker,preservation,6,2,4
Hochelaga,arthas,192,evoker,preservation,6,2,4
Ignicion,quelthalas,192,evoker,preservation,6,2,4
Drakhaz,azralon,192,evoker,preservation,6,2,4
Alexevoker,tichondrius,192,evoker,preservation,6,2,4
Syfen,burning-blade,192,evoker,preservation,6,2,4
Zandet,thunderlord,192,evoker,preservation,6,2,4
Daemon,terokkar,192,evoker,preservation,6,2,4
Conorvokes,tichondrius,192,evoker,preservation,6,2,4
Koopa,malygos,192,evoker,preservation,6,2,4
Sekidrac,ragnaros,192,evoker,preservation,6,2,4
Astaro,area-52,192,evoker,preservation,6,2,4
Dracthott,thrall,192,evoker,preservation,6,2,4
Altevoker,frostmourne,192,evoker,preservation,6,2,4
Exiztx,tichondrius,192,evoker,preservation,6,2,4
Kalrid,sargeras,192,evoker,preservation,6,2,4
Ashgaar,sargeras,192,evoker,preservation,6,2,4
Stickvoker,sargeras,192,evoker,preservation,6,2,4
Oatmealneil,bleeding-hollow,192,evoker,preservation,10,2,8
Shellybelly,shadowmoon,192,evoker,preservation,12,2,10
Contractor,emerald-dream,192,evoker,preservation,12,2,10
Arkaan,malganis,192,evoker,preservation,12,2,10
Zalpx,sargeras,192,evoker,preservation,12,2,10
Hotblower,tichondrius,192,evoker,preservation,12,2,10
Takasaki,dalaran,192,evoker,preservation,12,2,10
Drakthyrmonk,hyjal,192,evoker,preservation,12,2,10
Djornmustman,sargeras,192,evoker,preservation,12,2,10
Shockragosa,chogall,192,evoker,preservation,12,2,10
Dragonarchy,draenor,192,evoker,preservation,12,2,10
Ceraxxes,tichondrius,192,evoker,preservation,12,2,10
Tightp,malganis,192,evoker,preservation,12,2,10
Toyatoki,stormrage,192,evoker,preservation,12,2,10
Luxxa,bloodhoof,192,evoker,preservation,12,2,10
Timecøp,zuljin,192,evoker,preservation,12,2,10
Olesmokey,tichondrius,192,evoker,preservation,12,2,10
Dadydafather,sargeras,192,evoker,preservation,24,2,22
Valethal,ragnaros,191,evoker,preservation,6,2,4
Dracalis,thrall,191,evoker,preservation,6,2,4
Spyrð,emerald-dream,191,evoker,preservation,6,2,4
Draxitar,blackrock,191,evoker,preservation,6,2,4
Lacost,area-52,191,evoker,preservation,6,2,4
Sodre,illidan,191,evoker,preservation,12,2,10
Shadowyasuke,area-52,191,evoker,preservation,12,2,10
Evooern,frostmourne,175,evoker,preservation,11,2,9
Devokerkofwa,tichondrius,159,evoker,preservation,5,2,3
Jetthryx,emerald-dream,159,evoker,preservation,11,2,9
Dragonbush,sargeras,138,evoker,preservation,10,3,7
Shíkyo,stormrage,138,evoker,preservation,20,3,17
Lendren,sargeras,128,evoker,preservation,10,2,8
Dragoondeez,bleeding-hollow,96,evoker,preservation,3,2,1
Hutterbut,malganis,96,evoker,preservation,3,2,1
Nivekk,zuljin,96,evoker,preservation,6,1,5
Myjewelshurt,stormrage,96,evoker,preservation,6,1,5
Dragnips,bleeding-hollow,96,evoker,preservation,6,1,5
Iamthêt,sargeras,96,evoker,preservation,6,1,5
Freeblaze,blackhand,96,evoker,preservation,6,1,5
Mookthyr,area-52,96,evoker,preservation,6,1,5
Patrdorasz,zuljin,96,evoker,preservation,6,1,5
Neroker,malganis,96,evoker,preservation,6,1,5
Ohmylanta,stormrage,96,evoker,preservation,6,1,5
Caelïn,malganis,96,evoker,preservation,6,1,5
Saînt,thrall,96,evoker,preservation,6,1,5
Keedrori,thrall,96,evoker,preservation,6,1,5
Ðräco,quelthalas,96,evoker,preservation,6,1,5
Dragondoh,frostmourne,96,evoker,preservation,6,1,5
Omars,sargeras,96,evoker,preservation,6,1,5
Xampusaurio,ragnaros,96,evoker,preservation,6,1,5
Ripdumpster,bonechewer,96,evoker,preservation,6,1,5
Simarity,thrall,96,evoker,preservation,6,1,5
Spyroh,crushridge,96,evoker,preservation,6,1,5
Deviantart,emerald-dream,96,evoker,preservation,6,1,5
Atreign,blackwing-lair,96,evoker,preservation,6,1,5
Gamerwords,barthilas,96,evoker,preservation,6,1,5
Pyrepeanut,tichondrius,96,evoker,preservation,6,1,5
Tasdarallar,frostmourne,96,evoker,preservation,6,1,5
Nowon,tichondrius,96,evoker,preservation,6,1,5
Etereosthel,ragnaros,96,evoker,preservation,6,1,5
Daraz,tichondrius,96,evoker,preservation,6,1,5
Readwise,tichondrius,96,evoker,preservation,6,1,5
Sobuker,wyrmrest-accord,96,evoker,preservation,6,1,5
Liltj,tichondrius,96,evoker,preservation,6,1,5
Hardstuckirl,tichondrius,96,evoker,preservation,6,1,5
Nändy,tichondrius,96,evoker,preservation,6,1,5
Trrxx,tichondrius,96,evoker,preservation,6,1,5
Uwuspit,tichondrius,96,evoker,preservation,6,1,5
Vermax,spirestone,96,evoker,preservation,6,1,5
Vvhip,tichondrius,96,evoker,preservation,6,1,5
Rdrako,emerald-dream,96,evoker,preservation,6,1,5
Fkndragon,proudmoore,96,evoker,preservation,6,1,5
Shruikan,lightnings-blade,96,evoker,preservation,6,1,5
Henryvoker,moknathal,96,evoker,preservation,6,1,5
Hausebat,moon-guard,96,evoker,preservation,6,1,5
Nelphemuer,wyrmrest-accord,96,evoker,preservation,12,1,11
Khorvin,proudmoore,96,evoker,preservation,12,1,11
Dracarus,crushridge,96,evoker,preservation,12,1,11
Tidehunter,chogall,96,evoker,preservation,12,1,11
Derath,maelstrom,96,evoker,preservation,12,1,11
Eragon,feathermoon,96,evoker,preservation,12,1,11
Shimshine,destromath,96,evoker,preservation,12,1,11
Dakotakek,illidan,96,evoker,preservation,12,1,11
Morkite,moon-guard,96,evoker,preservation,12,1,11
Draghone,illidan,96,evoker,preservation,12,1,11
Daddyrp,tichondrius,84,evoker,preservation,20,6,14
Blowmiê,area-52,79,evoker,preservation,5,1,4
Gadiel,draka,31,evoker,preservation,2,1,1
Thiqc,zuluhed,9,evoker,preservation,9,3,6
Nikthevoker,area-52,2162,evoker,devastation,189,98,91
Nikthevoker,tichondrius,2156,evoker,devastation,156,84,72
Caedalade,proudmoore,2150,evoker,devastation,238,123,115
Ocdgamer,malganis,2133,evoker,devastation,115,58,57
Whilefalse,stormrage,2125,evoker,devastation,95,48,47
Lizzimcguire,zuljin,2118,evoker,devastation,90,60,30
Dametra,proudmoore,2100,evoker,devastation,108,62,46
Shamblewing,arthas,2094,evoker,devastation,89,44,45
Rothvoker,tichondrius,2033,evoker,devastation,121,70,51
Breathalizer,sargeras,2029,evoker,devastation,90,51,39
Eastwubz,norgannon,2010,evoker,devastation,138,73,65
Somyr,area-52,2003,evoker,devastation,78,43,35
Evokemedaddy,bleeding-hollow,1974,evoker,devastation,161,83,78
Bigdrag,blackhand,1952,evoker,devastation,162,88,74
Quadude,illidan,1947,evoker,devastation,197,99,98
Wazgon,emerald-dream,1940,evoker,devastation,194,94,100
Hutaothighs,illidan,1937,evoker,devastation,130,67,63
Saryuja,thunderhorn,1922,evoker,devastation,52,36,16
Dzrn,moon-guard,1922,evoker,devastation,144,72,72
Meltharian,frostmourne,1911,evoker,devastation,98,55,43
Azazél,borean-tundra,1910,evoker,devastation,233,126,107
Arzaria,stormrage,1906,evoker,devastation,158,88,70
Juicyjom,staghelm,1900,evoker,devastation,60,30,30
Ayavi,illidan,1890,evoker,devastation,96,61,35
Trogdør,illidan,1887,evoker,devastation,153,76,77
Seldantria,dalaran,1875,evoker,devastation,71,36,35
Srb,chogall,1868,evoker,devastation,101,59,42
Mtndewboy,illidan,1864,evoker,devastation,48,29,19
Krashbandico,zangarmarsh,1863,evoker,devastation,61,30,31
Drogu,kelthuzad,1862,evoker,devastation,36,22,14
Thrawn,arygos,1855,evoker,devastation,59,37,22
Bugberry,illidan,1854,evoker,devastation,96,51,45
Strepo,proudmoore,1851,evoker,devastation,66,34,32
Royquaza,illidan,1850,evoker,devastation,60,33,27
Wheezee,emerald-dream,1850,evoker,devastation,46,25,21
Rescued,wyrmrest-accord,1848,evoker,devastation,54,31,23
Xxkimura,tichondrius,1848,evoker,devastation,174,94,80
Tatsurai,tichondrius,1845,evoker,devastation,43,24,19
Fores,tichondrius,1845,evoker,devastation,127,65,62
Eshen,ragnaros,1843,evoker,devastation,298,158,140
Plep,wyrmrest-accord,1836,evoker,devastation,51,30,21
Laneva,moon-guard,1835,evoker,devastation,128,86,42
Anachronormu,mannoroth,1831,evoker,devastation,77,43,34
Venarys,dalaran,1826,evoker,devastation,42,30,12
Raxdragon,sargeras,1826,evoker,devastation,36,22,14
Krúnsh,ragnaros,1823,evoker,devastation,191,104,87
Kinndyvoker,sargeras,1823,evoker,devastation,47,23,24
Chun,malganis,1821,evoker,devastation,30,19,11
Gôdzevoker,area-52,1821,evoker,devastation,64,39,25
Airgordan,area-52,1821,evoker,devastation,77,37,40
Koalaman,area-52,1820,evoker,devastation,228,115,113
Zoomi,whisperwind,1819,evoker,devastation,35,20,15
Komodolong,tichondrius,1819,evoker,devastation,53,26,27
Evokes,moon-guard,1818,evoker,devastation,80,41,39
Kyloflight,thrall,1817,evoker,devastation,50,33,17
Dracaryz,blackhand,1814,evoker,devastation,60,35,25
Gridskully,quelthalas,1814,evoker,devastation,81,38,43
Drakori,azralon,1812,evoker,devastation,80,49,31
Gojirastraza,stormrage,1810,evoker,devastation,53,32,21
Gwaelii,tichondrius,1809,evoker,devastation,105,62,43
Pykan,skullcrusher,1809,evoker,devastation,47,24,23
Ragedizzle,twisting-nether,1808,evoker,devastation,91,49,42
Mil,lightnings-blade,1808,evoker,devastation,69,37,32
Juicylizard,stormrage,1807,evoker,devastation,200,105,95
Geicovoker,tichondrius,1806,evoker,devastation,52,30,22
Tazriak,tichondrius,1803,evoker,devastation,83,52,31
Thordak,drakkari,1801,evoker,devastation,72,40,32
Fractalz,alterac-mountains,1800,evoker,devastation,169,92,77
Azradormu,zuljin,1791,evoker,devastation,186,86,100
Yrue,moon-guard,1779,evoker,devastation,36,19,17
Draxarys,area-52,1776,evoker,devastation,224,112,112
Nørbert,frostmourne,1769,evoker,devastation,48,29,19
Draxarys,tichondrius,1767,evoker,devastation,280,135,145
Dooklord,shuhalo,1763,evoker,devastation,54,24,30
Obsidianimp,sargeras,1756,evoker,devastation,42,21,21
Puf,magtheridon,1755,evoker,devastation,206,113,93
Coltist,elune,1753,evoker,devastation,30,22,8
Oldxdrake,sargeras,1747,evoker,devastation,138,70,68
Milkymike,uldum,1745,evoker,devastation,54,33,21
Emiriss,thrall,1744,evoker,devastation,88,45,43
Flapples,stormrage,1743,evoker,devastation,96,53,43
Mfquietus,illidan,1741,evoker,devastation,72,42,30
Dracthael,stormrage,1736,evoker,devastation,63,37,26
Theredmenace,barthilas,1734,evoker,devastation,41,26,15
Cowboyydann,malganis,1733,evoker,devastation,29,19,10
Stickvoker,sargeras,1733,evoker,devastation,66,40,26
Rá,drenden,1728,evoker,devastation,78,34,44
Nunez,frostmourne,1713,evoker,devastation,41,22,19
Izzythelizzy,tichondrius,1710,evoker,devastation,144,79,65
Betasoldier,kelthuzad,1708,evoker,devastation,95,56,39
Æthyr,anubarak,1707,evoker,devastation,36,26,10
Evokez,barthilas,1705,evoker,devastation,42,31,11
Blowmiê,area-52,1695,evoker,devastation,131,70,61
Ðeepßreath,sargeras,1692,evoker,devastation,60,32,28
Jase,gilneas,1691,evoker,devastation,74,45,29
Qbgosa,malganis,1688,evoker,devastation,36,21,15
Scaleychad,zuljin,1688,evoker,devastation,53,27,26
Arkeryte,moon-guard,1686,evoker,devastation,126,66,60
Mushugon,wyrmrest-accord,1684,evoker,devastation,42,25,17
Ethalem,thrall,1683,evoker,devastation,217,116,101
Rizzanomics,zuljin,1683,evoker,devastation,70,31,39
Djvoker,zuljin,1681,evoker,devastation,62,32,30
Darkwingz,icecrown,1680,evoker,devastation,44,25,19
Vhagarius,tichondrius,1680,evoker,devastation,68,32,36
Eszel,thunderlord,1679,evoker,devastation,184,98,86
Catvoker,area-52,1678,evoker,devastation,114,58,56
Shoestrings,tichondrius,1675,evoker,devastation,108,51,57
Vizora,moon-guard,1672,evoker,devastation,56,33,23
Dwagonwage,zuljin,1672,evoker,devastation,54,25,29
Smoochies,emerald-dream,1671,evoker,devastation,60,32,28
Garlicbreth,stormrage,1671,evoker,devastation,76,40,36
Shalander,proudmoore,1670,evoker,devastation,126,71,55
Fizzlevoker,malganis,1670,evoker,devastation,48,23,25
Beatdownbill,sargeras,1657,evoker,devastation,99,48,51
Rengöku,skullcrusher,1656,evoker,devastation,42,23,19
Balrôg,malganis,1656,evoker,devastation,63,29,34
Dovàhkin,moon-guard,1655,evoker,devastation,66,35,31
Mindme,tichondrius,1652,evoker,devastation,53,30,23
Haramcad,tichondrius,1652,evoker,devastation,165,89,76
Bombs,shattered-hand,1651,evoker,devastation,144,77,67
Wingdeadly,tichondrius,1650,evoker,devastation,66,35,31
Nazaral,mannoroth,1647,evoker,devastation,60,32,28
Koralia,moon-guard,1647,evoker,devastation,42,18,24
Deralan,khaz-modan,1645,evoker,devastation,36,20,16
Hmong,proudmoore,1643,evoker,devastation,48,20,28
Blackdragôn,stormrage,1641,evoker,devastation,43,22,21
Epollyon,sargeras,1639,evoker,devastation,42,25,17
Nishalethen,moon-guard,1638,evoker,devastation,56,30,26
Xhamon,quelthalas,1630,evoker,devastation,52,23,29
Burnyxia,zuljin,1628,evoker,devastation,48,23,25
Evòker,tichondrius,1625,evoker,devastation,54,28,26
Galakrønd,illidan,1624,evoker,devastation,116,63,53
Derite,bonechewer,1620,evoker,devastation,28,20,8
Alekoslol,area-52,1615,evoker,devastation,40,23,17
Spyrodadrago,malganis,1615,evoker,devastation,54,29,25
Terraxkhan,quelthalas,1614,evoker,devastation,48,21,27
Zyzzy,icecrown,1613,evoker,devastation,80,48,32
Psynister,illidan,1613,evoker,devastation,150,66,84
Endoveire,tichondrius,1613,evoker,devastation,54,23,31
Voithyr,moon-guard,1612,evoker,devastation,74,43,31
Bréáth,tichondrius,1608,evoker,devastation,48,33,15
Rðsè,tichondrius,1608,evoker,devastation,150,71,79
Akajills,tichondrius,1607,evoker,devastation,124,70,54
Eshaybruh,barthilas,1605,evoker,devastation,34,20,14
Flysokan,tichondrius,1604,evoker,devastation,48,25,23
Dubskis,area-52,1603,evoker,devastation,122,63,59
Jereico,stonemaul,1603,evoker,devastation,78,39,39
Bently,bloodhoof,1603,evoker,devastation,48,21,27
Marccuss,bleeding-hollow,1601,evoker,devastation,24,17,7
Ryuback,sargeras,1601,evoker,devastation,42,26,16
Xhaal,tichondrius,1601,evoker,devastation,168,83,85
Dragonkings,tichondrius,1599,evoker,devastation,75,33,42
Imugee,sargeras,1598,evoker,devastation,54,27,27
Zona,moon-guard,1597,evoker,devastation,54,26,28
Ackreshanaz,nagrand,1594,evoker,devastation,36,17,19
Zenithria,thrall,1593,evoker,devastation,106,54,52
Batwig,tichondrius,1590,evoker,devastation,71,39,32
Eternabeam,gilneas,1586,evoker,devastation,65,32,33
Linguistic,tichondrius,1585,evoker,devastation,54,29,25
Mayhemvoker,rexxar,1584,evoker,devastation,54,32,22
Juooun,tichondrius,1583,evoker,devastation,71,31,40
Algonir,wyrmrest-accord,1581,evoker,devastation,30,17,13
Zeranthal,moon-guard,1580,evoker,devastation,26,17,9
Pewnee,eonar,1579,evoker,devastation,47,21,26
Bucket,wyrmrest-accord,1577,evoker,devastation,36,19,17
Rotscale,proudmoore,1576,evoker,devastation,30,17,13
Envisioned,kelthuzad,1572,evoker,devastation,36,19,17
Aarax,tichondrius,1570,evoker,devastation,89,45,44
Ævoker,tichondrius,1569,evoker,devastation,111,54,57
Mmrglmrglmr,stormrage,1565,evoker,devastation,47,26,21
Rinstraza,thrall,1564,evoker,devastation,132,66,66
Drachenatem,skywall,1561,evoker,devastation,36,22,14
Crappysmellz,tichondrius,1557,evoker,devastation,30,17,13
Karox,moon-guard,1550,evoker,devastation,113,56,57
Flippyflappy,zuljin,1549,evoker,devastation,30,17,13
Kalisee,skullcrusher,1548,evoker,devastation,65,35,30
Lorb,icecrown,1545,evoker,devastation,164,88,76
Sintholo,sargeras,1544,evoker,devastation,98,49,49
Agheel,firetree,1543,evoker,devastation,44,23,21
Caelïn,malganis,1542,evoker,devastation,132,67,65
Jiminsgf,tichondrius,1539,evoker,devastation,56,37,19
Dragnmÿballs,blackrock,1536,evoker,devastation,34,20,14
Emoker,magtheridon,1535,evoker,devastation,54,31,23
Hydrogenbomb,sargeras,1530,evoker,devastation,86,47,39
Børedom,burning-legion,1529,evoker,devastation,48,30,18
Nxnevo,tichondrius,1529,evoker,devastation,36,19,17
Quickshootin,tichondrius,1528,evoker,devastation,24,16,8
You,deathwing,1528,evoker,devastation,42,24,18
Embarasi,moon-guard,1528,evoker,devastation,48,27,21
Chànge,lothar,1527,evoker,devastation,71,36,35
Meleyx,saurfang,1527,evoker,devastation,48,24,24
Hotdragon,zuljin,1526,evoker,devastation,78,43,35
Drgua,tichondrius,1522,evoker,devastation,30,16,14
Bryágh,wyrmrest-accord,1517,evoker,devastation,147,76,71
Bumbaclot,illidan,1516,evoker,devastation,30,16,14
Lïzzy,tichondrius,1515,evoker,devastation,24,16,8
Kheeleesi,illidan,1515,evoker,devastation,77,40,37
Bryiona,proudmoore,1515,evoker,devastation,48,22,26
Spicyrooster,area-52,1514,evoker,devastation,32,18,14
Olesmokey,tichondrius,1513,evoker,devastation,86,45,41
Zenasatral,sargeras,1512,evoker,devastation,25,17,8
Galrend,firetree,1511,evoker,devastation,78,41,37
Dragontales,stormrage,1510,evoker,devastation,72,40,32
Polyrhythmic,ysera,1510,evoker,devastation,79,38,41
Narissian,wyrmrest-accord,1508,evoker,devastation,92,49,43
Xplode,area-52,1504,evoker,devastation,176,89,87
Tinine,frostmourne,1503,evoker,devastation,60,33,27
Atreign,blackwing-lair,1499,evoker,devastation,55,22,33
Tezzyl,kiljaeden,1498,evoker,devastation,30,16,14
Tealetaz,area-52,1495,evoker,devastation,49,32,17
Hochenblume,proudmoore,1494,evoker,devastation,36,17,19
Ùwüdragon,tichondrius,1490,evoker,devastation,118,71,47
Erling,duskwood,1490,evoker,devastation,84,46,38
Xaeradroz,area-52,1486,evoker,devastation,78,41,37
Netreset,illidan,1481,evoker,devastation,31,17,14
Qfyre,frostmourne,1480,evoker,devastation,57,34,23
Dragonvore,moon-guard,1475,evoker,devastation,23,17,6
Elurb,illidan,1475,evoker,devastation,50,30,20
Youdig,nazjatar,1471,evoker,devastation,30,17,13
Tagzy,tichondrius,1469,evoker,devastation,51,28,23
Quadarius,tichondrius,1466,evoker,devastation,105,55,50
Puffthemagiq,mugthol,1465,evoker,devastation,42,24,18
Curtis,shadowmoon,1465,evoker,devastation,88,49,39
Zandrov,greymane,1463,evoker,devastation,39,21,18
Valentis,bleeding-hollow,1461,evoker,devastation,78,44,34
Dekux,elune,1459,evoker,devastation,36,16,20
Mustardtiger,malorne,1458,evoker,devastation,56,31,25
Rhÿu,quelthalas,1455,evoker,devastation,71,36,35
Chinesedragn,tichondrius,1453,evoker,devastation,60,32,28
Dragontrees,illidan,1450,evoker,devastation,36,19,17
Bellerion,proudmoore,1450,evoker,devastation,48,22,26
Amlug,illidan,1450,evoker,devastation,88,38,50
Ýüp,tichondrius,1448,evoker,devastation,34,21,13
Midi,boulderfist,1446,evoker,devastation,42,21,21
Lilfootmommy,emerald-dream,1446,evoker,devastation,36,16,20
Jowtzprev,ragnaros,1443,evoker,devastation,36,19,17
Serthius,darkspear,1439,evoker,devastation,24,17,7
Peef,tichondrius,1439,evoker,devastation,24,15,9
Hoodwings,stormrage,1439,evoker,devastation,37,22,15
Monkeydrake,tichondrius,1438,evoker,devastation,72,31,41
Mcglizzy,stormrage,1437,evoker,devastation,54,22,32
Zalzin,agamaggan,1435,evoker,devastation,92,48,44
Jurokiel,sargeras,1434,evoker,devastation,135,73,62
Vexosza,moon-guard,1434,evoker,devastation,30,16,14
Drussyboy,illidan,1433,evoker,devastation,69,33,36
Brounno,area-52,1429,evoker,devastation,76,49,27
Devonstation,zuljin,1429,evoker,devastation,42,24,18
Dragonbic,illidan,1423,evoker,devastation,36,16,20
Evoqz,stormrage,1422,evoker,devastation,30,18,12
Neith,aerie-peak,1420,evoker,devastation,41,16,25
Grapthar,korgath,1418,evoker,devastation,78,41,37
Trenash,illidan,1418,evoker,devastation,76,32,44
Setash,kiljaeden,1416,evoker,devastation,36,21,15
Shortdargon,zuljin,1414,evoker,devastation,30,15,15
Desiinger,tichondrius,1411,evoker,devastation,30,17,13
Talanoth,skullcrusher,1408,evoker,devastation,57,34,23
Toastragosa,cenarius,1406,evoker,devastation,149,66,83
Kjerne,stormrage,1404,evoker,devastation,30,20,10
Valthenax,frostmourne,1404,evoker,devastation,83,33,50
Thechadwasgr,bleeding-hollow,1403,evoker,devastation,62,31,31
Firkrag,bleeding-hollow,1402,evoker,devastation,60,28,32
Jarzilla,illidan,1401,evoker,devastation,24,15,9
Favoredson,area-52,1400,evoker,devastation,48,25,23
Valkalas,moon-guard,1400,evoker,devastation,63,30,33
Dillss,tichondrius,1397,evoker,devastation,66,31,35
Veserion,azralon,1396,evoker,devastation,90,50,40
Rodgoesinya,blackrock,1392,evoker,devastation,54,30,24
Blittlle,bleeding-hollow,1391,evoker,devastation,66,39,27
Frequevoker,tichondrius,1390,evoker,devastation,35,15,20
Devdjinn,tichondrius,1388,evoker,devastation,168,85,83
Prevocker,sargeras,1388,evoker,devastation,67,28,39
Tyrvin,kiljaeden,1382,evoker,devastation,145,72,73
Dylawn,illidan,1379,evoker,devastation,42,23,19
Howtew,jubeithos,1377,evoker,devastation,72,37,35
Malygoz,frostmourne,1370,evoker,devastation,60,24,36
Zeetash,illidan,1370,evoker,devastation,66,24,42
Zartolas,moon-guard,1369,evoker,devastation,94,40,54
Dragneel,wyrmrest-accord,1367,evoker,devastation,39,17,22
Drakoris,malganis,1365,evoker,devastation,93,50,43
Dailon,stormreaver,1365,evoker,devastation,39,17,22
Bvo,stormrage,1364,evoker,devastation,77,41,36
Navaji,tichondrius,1362,evoker,devastation,55,30,25
Evokedx,area-52,1361,evoker,devastation,42,21,21
Deathwingtwo,sargeras,1361,evoker,devastation,33,16,17
Sidrasza,norgannon,1360,evoker,devastation,73,40,33
Zayllaerth,illidan,1360,evoker,devastation,82,42,40
Cròk,quelthalas,1360,evoker,devastation,33,15,18
Ezarke,madoran,1359,evoker,devastation,35,17,18
Thendroz,moon-guard,1357,evoker,devastation,30,18,12
Grendalevo,tichondrius,1357,evoker,devastation,57,28,29
Drogan,demon-soul,1356,evoker,devastation,92,55,37
Valyrik,illidan,1356,evoker,devastation,110,54,56
Lexgrossman,kelthuzad,1353,evoker,devastation,98,50,48
Aoxila,proudmoore,1353,evoker,devastation,177,82,95
Kêristrasza,wyrmrest-accord,1352,evoker,devastation,54,27,27
Trazana,wyrmrest-accord,1344,evoker,devastation,29,16,13
Bumbledragn,moon-guard,1344,evoker,devastation,101,49,52
Sylnathaire,wyrmrest-accord,1343,evoker,devastation,84,41,43
Aydetal,eonar,1343,evoker,devastation,42,20,22
Âvalon,zuljin,1341,evoker,devastation,18,14,4
Jwoker,malganis,1340,evoker,devastation,36,14,22
Monyz,emerald-dream,1339,evoker,devastation,46,32,14
Yuukee,thrall,1338,evoker,devastation,43,23,20
Dîego,azralon,1333,evoker,devastation,40,24,16
Zlandicaar,area-52,1329,evoker,devastation,66,31,35
Acoldwall,illidan,1328,evoker,devastation,24,15,9
Koralia,wyrmrest-accord,1328,evoker,devastation,30,14,16
Vaelikai,korgath,1326,evoker,devastation,18,14,4
Midnights,scarlet-crusade,1326,evoker,devastation,83,50,33
Spicy,mannoroth,1324,evoker,devastation,34,19,15
Dovå,moon-guard,1322,evoker,devastation,32,16,16
Emikothyr,thrall,1319,evoker,devastation,74,41,33
Tekath,altar-of-storms,1317,evoker,devastation,56,26,30
Drahconne,illidan,1312,evoker,devastation,64,34,30
Itwasntthis,tichondrius,1312,evoker,devastation,117,60,57
Jabbawockeëz,drakkari,1310,evoker,devastation,97,51,46
Skooby,drenden,1309,evoker,devastation,30,16,14
Raghnard,illidan,1303,evoker,devastation,70,37,33
Skykeeper,quelthalas,1300,evoker,devastation,112,58,54
Zlolykcir,malganis,1299,evoker,devastation,89,48,41
Vahaerys,stormrage,1296,evoker,devastation,48,21,27
Vokeero,ysera,1284,evoker,devastation,72,36,36
Wackthyr,frostmourne,1284,evoker,devastation,30,15,15
Benares,zuljin,1279,evoker,devastation,91,43,48
Sylverion,thrall,1277,evoker,devastation,70,35,35
Zendrov,skywall,1276,evoker,devastation,30,14,16
Golden,area-52,1274,evoker,devastation,28,14,14
Draconicus,bonechewer,1266,evoker,devastation,104,52,52
Nazanazar,wyrmrest-accord,1263,evoker,devastation,79,38,41
Evokjoe,tortheldrin,1262,evoker,devastation,58,29,29
Crogosa,quelthalas,1251,evoker,devastation,36,14,22
Ezgamedeez,tichondrius,1247,evoker,devastation,24,13,11
Dracomalfoyy,caelestrasz,1246,evoker,devastation,21,14,7
Marknormand,area-52,1246,evoker,devastation,24,13,11
Kozukimomo,area-52,1245,evoker,devastation,41,15,26
Shanegillis,emerald-dream,1244,evoker,devastation,18,13,5
Gutterskank,illidan,1241,evoker,devastation,23,14,9
Dracfire,saurfang,1239,evoker,devastation,24,13,11
Longxx,dalaran,1235,evoker,devastation,24,13,11
Galakraas,proudmoore,1235,evoker,devastation,75,34,41
Xm,emerald-dream,1235,evoker,devastation,31,14,17
Bigbadfred,tichondrius,1234,evoker,devastation,24,13,11
Raygos,nemesis,1232,evoker,devastation,56,21,35
Sindraxx,stormrage,1228,evoker,devastation,48,25,23
Phlegython,eredar,1226,evoker,devastation,30,13,17
Dingermun,bleeding-hollow,1225,evoker,devastation,20,15,5
Valakaztower,area-52,1225,evoker,devastation,36,19,17
Nathx,drakkari,1222,evoker,devastation,24,18,6
Cheaterz,area-52,1222,evoker,devastation,36,22,14
Jugzxs,frostmourne,1213,evoker,devastation,36,14,22
Azorian,vashj,1208,evoker,devastation,30,17,13
Trenot,draenor,1202,evoker,devastation,42,21,21
Layothyr,stormrage,1201,evoker,devastation,24,14,10
Aelvina,moon-guard,1201,evoker,devastation,30,13,17
Senven,blackhand,1196,evoker,devastation,30,13,17
Dragkon,azuremyst,1190,evoker,devastation,54,22,32
Ironscale,dalaran,1186,evoker,devastation,30,13,17
Paean,moon-guard,1183,evoker,devastation,32,18,14
Evooern,frostmourne,1181,evoker,devastation,84,39,45
Xampusaurio,ragnaros,1178,evoker,devastation,24,13,11
Yiserion,sargeras,1178,evoker,devastation,133,67,66
Kaikisen,malganis,1178,evoker,devastation,41,19,22
Climax,stormrage,1177,evoker,devastation,28,13,15
Potfase,tichondrius,1177,evoker,devastation,32,13,19
Vaayu,moon-guard,1176,evoker,devastation,24,13,11
Teritwo,stormrage,1166,evoker,devastation,28,13,15
Drakonyx,mugthol,1162,evoker,devastation,50,21,29
Dragonpete,whisperwind,1157,evoker,devastation,36,17,19
Drakhaz,azralon,1156,evoker,devastation,22,13,9
Asham,azralon,1152,evoker,devastation,63,36,27
Stretonaught,dalaran,1152,evoker,devastation,27,14,13
Devokerx,emerald-dream,1151,evoker,devastation,18,12,6
Tërminus,quelthalas,1151,evoker,devastation,18,12,6
Shwaydbz,zuljin,1151,evoker,devastation,24,12,12
Zindraco,thrall,1150,evoker,devastation,24,12,12
Klownfiesta,thrall,1148,evoker,devastation,30,15,15
Growthyy,malganis,1147,evoker,devastation,18,12,6
Mythsvoker,barthilas,1147,evoker,devastation,19,12,7
Aentharion,argent-dawn,1147,evoker,devastation,24,12,12
Zervis,arthas,1147,evoker,devastation,30,12,18
Drozul,stormrage,1145,evoker,devastation,30,12,18
Loginplease,frostmourne,1144,evoker,devastation,80,36,44
Unseenzblack,tichondrius,1141,evoker,devastation,18,12,6
Dragoceleste,ragnaros,1140,evoker,devastation,54,26,28
Dinnkyion,dalaran,1138,evoker,devastation,24,12,12
Midyr,nemesis,1137,evoker,devastation,24,15,9
Dragonbranch,area-52,1133,evoker,devastation,24,12,12
Lorathyr,lothar,1128,evoker,devastation,24,12,12
Enuzan,dalaran,1128,evoker,devastation,89,41,48
Archion,azgalor,1127,evoker,devastation,35,13,22
Wrecketz,tichondrius,1122,evoker,devastation,58,28,30
Bhalaria,ragnaros,1113,evoker,devastation,69,25,44
Paycussy,sargeras,1110,evoker,devastation,18,12,6
Zitasanazen,tichondrius,1107,evoker,devastation,64,25,39
Visron,stormrage,1102,evoker,devastation,53,33,20
Drögón,stormrage,1100,evoker,devastation,42,27,15
Crymor,lethon,1099,evoker,devastation,30,16,14
Madelines,tichondrius,1097,evoker,devastation,24,13,11
Byäkuyá,azralon,1091,evoker,devastation,59,30,29
Zhannecgos,moon-guard,1087,evoker,devastation,28,12,16
Erizcdraa,tichondrius,1069,evoker,devastation,19,12,7
Durijus,tichondrius,1069,evoker,devastation,35,14,21
Aktas,illidan,1063,evoker,devastation,28,12,16
Ðarkwyrm,laughing-skull,1062,evoker,devastation,42,22,20
Devokèr,tichondrius,1056,evoker,devastation,24,11,13
Kiry,emerald-dream,1055,evoker,devastation,24,11,13
Hydroponicsz,bloodscalp,1055,evoker,devastation,24,11,13
Drayongari,tichondrius,1054,evoker,devastation,18,11,7
Kubus,emerald-dream,1054,evoker,devastation,18,11,7
Tepaku,thrall,1054,evoker,devastation,18,11,7
Gypgo,ragnaros,1054,evoker,devastation,18,11,7
Yousurper,thunderlord,1054,evoker,devastation,27,14,13
Kinto,stormrage,1054,evoker,devastation,30,11,19
Dracthyrius,thunderlord,1052,evoker,devastation,18,11,7
Eìdolon,sargeras,1049,evoker,devastation,18,11,7
Satanasx,illidan,1048,evoker,devastation,24,11,13
Vlåd,tichondrius,1046,evoker,devastation,24,11,13
Sübjugador,azralon,1042,evoker,devastation,30,20,10
Notvez,bleeding-hollow,1038,evoker,devastation,31,11,20
Tïtäm,area-52,1032,evoker,devastation,21,12,9
Warhammerxx,tichondrius,1027,evoker,devastation,84,33,51
Zippityzoom,barthilas,1026,evoker,devastation,43,18,25
Nathenezital,frostmourne,1022,evoker,devastation,24,11,13
Abaddragon,dalaran,1020,evoker,devastation,29,11,18
Slitherin,dalaran,1014,evoker,devastation,36,11,25
Flygor,quelthalas,1011,evoker,devastation,54,17,37
Culture,khazgoroth,1006,evoker,devastation,15,11,4
Alnuin,stormrage,1004,evoker,devastation,102,42,60
Stolesom,emerald-dream,994,evoker,devastation,65,32,33
Sethelys,tichondrius,989,evoker,devastation,20,11,9
Daydrac,thrall,987,evoker,devastation,26,11,15
Neofarian,lightbringer,986,evoker,devastation,20,11,9
Dragongrim,silvermoon,986,evoker,devastation,30,14,16
Taamyr,wyrmrest-accord,973,evoker,devastation,42,18,24
Kazrekan,moon-guard,960,evoker,devastation,18,10,8
Iantern,dalaran,960,evoker,devastation,18,10,8
Ezath,zuljin,960,evoker,devastation,24,11,13
Cløud,hellscream,959,evoker,devastation,12,10,2
Cmiygl,proudmoore,959,evoker,devastation,12,10,2
Chime,dalaran,959,evoker,devastation,18,10,8
Xeerus,stormreaver,959,evoker,devastation,18,10,8
Hausebat,moon-guard,959,evoker,devastation,18,10,8
Basiliskgodx,tichondrius,959,evoker,devastation,18,10,8
Nasdanot,zuljin,959,evoker,devastation,18,10,8
Dilon,area-52,959,evoker,devastation,24,10,14
Runescape,altar-of-storms,959,evoker,devastation,24,10,14
Grafixx,sargeras,958,evoker,devastation,15,11,4
Averithel,moon-guard,958,evoker,devastation,18,10,8
Obeahfire,tichondrius,958,evoker,devastation,28,11,17
Vokezuì,sargeras,958,evoker,devastation,30,10,20
Dragocser,drakkari,957,evoker,devastation,18,10,8
Jormungandre,wyrmrest-accord,957,evoker,devastation,18,10,8
Jgdragon,sargeras,957,evoker,devastation,18,10,8
Pewpowdragon,malganis,957,evoker,devastation,18,10,8
Herikas,tichondrius,956,evoker,devastation,72,35,37
Oatmealneil,bleeding-hollow,955,evoker,devastation,24,10,14
Sinepbreath,bleeding-hollow,954,evoker,devastation,18,10,8
Rangel,tol-barad,954,evoker,devastation,27,11,16
Tralanoth,destromath,953,evoker,devastation,18,10,8
Liekki,illidan,953,evoker,devastation,24,10,14
Wizadsa,amanthul,951,evoker,devastation,12,10,2
Loganvkr,illidan,950,evoker,devastation,18,10,8
Dragonair,spinebreaker,950,evoker,devastation,21,10,11
Fìg,wyrmrest-accord,948,evoker,devastation,18,10,8
Jorlozthyr,ragnaros,948,evoker,devastation,24,10,14
Prolyfe,blood-furnace,942,evoker,devastation,15,11,4
Lostplanet,drakkari,937,evoker,devastation,30,10,20
Escanorr,ghostlands,936,evoker,devastation,20,11,9
Ryùtt,illidan,933,evoker,devastation,18,10,8
Toyatoki,stormrage,930,evoker,devastation,35,13,22
Salakhar,drakkari,924,evoker,devastation,14,11,3
Fukhur,ragnaros,917,evoker,devastation,24,11,13
Vikings,madoran,909,evoker,devastation,23,10,13
Ciana,black-dragonflight,902,evoker,devastation,38,19,19
Popgoesurmom,tichondrius,901,evoker,devastation,18,10,8
Ezdrake,drakkari,900,evoker,devastation,36,11,25
Aratre,daggerspine,897,evoker,devastation,54,21,33
Arath,zangarmarsh,879,evoker,devastation,36,18,18
Tireoz,frostmourne,866,evoker,devastation,48,12,36
Oracle,duskwood,864,evoker,devastation,12,9,3
Artemad,moon-guard,864,evoker,devastation,12,9,3
Kiserys,suramar,864,evoker,devastation,12,9,3
Áspect,aegwynn,864,evoker,devastation,12,9,3
Gangbânk,tichondrius,864,evoker,devastation,12,9,3
Gobananas,sargeras,864,evoker,devastation,12,9,3
Raller,malganis,864,evoker,devastation,12,9,3
Orncen,emerald-dream,864,evoker,devastation,16,10,6
Puffthemagic,lightnings-blade,864,evoker,devastation,18,9,9
Taylordra,tichondrius,864,evoker,devastation,18,9,9
Todorøki,hyjal,864,evoker,devastation,18,9,9
Bhanethyr,illidan,864,evoker,devastation,24,9,15
Raikori,ragnaros,863,evoker,devastation,12,9,3
Dragonsteppz,aegwynn,863,evoker,devastation,18,9,9
Missjenny,korgath,863,evoker,devastation,18,9,9
Siatrend,moon-guard,863,evoker,devastation,18,9,9
Thyatera,ragnaros,863,evoker,devastation,18,9,9
Misik,frostwolf,863,evoker,devastation,18,9,9
Gharscales,tichondrius,863,evoker,devastation,24,9,15
Demidas,emerald-dream,862,evoker,devastation,13,9,4
Sía,drakkari,861,evoker,devastation,12,9,3
Teanie,tichondrius,861,evoker,devastation,18,9,9
Nasath,arthas,861,evoker,devastation,18,9,9
Madashy,durotan,861,evoker,devastation,24,9,15
Karaxes,gorefiend,861,evoker,devastation,24,9,15
Zorashal,kiljaeden,860,evoker,devastation,12,9,3
Krokuzan,ragnaros,860,evoker,devastation,18,9,9
Doombreath,ragnaros,859,evoker,devastation,18,9,9
Keedrori,thrall,859,evoker,devastation,19,9,10
Drapybaras,bleeding-hollow,859,evoker,devastation,36,13,23
Furyíon,stormrage,855,evoker,devastation,12,9,3
Azuria,lothar,855,evoker,devastation,12,9,3
Acnølogia,stormrage,855,evoker,devastation,18,9,9
Rasec,moon-guard,843,evoker,devastation,20,9,11
Acnøløgia,azralon,840,evoker,devastation,30,9,21
Rikfreedom,ragnaros,836,evoker,devastation,42,19,23
Stylez,anetheron,830,evoker,devastation,42,19,23
Dvrk,frostmourne,812,evoker,devastation,17,9,8
Dreampunk,tichondrius,784,evoker,devastation,13,9,4
Nyranblood,zuljin,779,evoker,devastation,30,11,19
Creachy,kiljaeden,768,evoker,devastation,12,8,4
Saînt,thrall,768,evoker,devastation,12,8,4
Devilmanguy,bonechewer,768,evoker,devastation,12,8,4
Toastsevoker,tichondrius,768,evoker,devastation,15,9,6
Dragonfarts,frostmourne,768,evoker,devastation,18,8,10
Taeloc,frostmourne,768,evoker,devastation,18,8,10
Drsgme,dentarg,768,evoker,devastation,18,8,10
Crosis,azralon,768,evoker,devastation,18,8,10
Dunkinonem,black-dragonflight,767,evoker,devastation,12,8,4
Kozara,trollbane,767,evoker,devastation,18,8,10
Vermax,akama,767,evoker,devastation,18,8,10
Rïvé,tichondrius,767,evoker,devastation,24,8,16
Arokh,frostmourne,767,evoker,devastation,30,8,22
Zirath,emerald-dream,766,evoker,devastation,18,8,10
Dawitchvoker,illidan,766,evoker,devastation,18,8,10
Glideoure,stonemaul,766,evoker,devastation,24,8,16
Aaztra,whisperwind,765,evoker,devastation,12,8,4
Tinà,tichondrius,765,evoker,devastation,18,8,10
Skrillerv,frostmourne,765,evoker,devastation,18,8,10
Byssrak,borean-tundra,764,evoker,devastation,12,8,4
Redeyés,area-52,761,evoker,devastation,12,8,4
Seletgos,quelthalas,761,evoker,devastation,24,8,16
Momonosuke,fizzcrank,760,evoker,devastation,18,8,10
Detraa,illidan,754,evoker,devastation,12,8,4
Daigrefn,echo-isles,751,evoker,devastation,18,8,10
Pouncer,proudmoore,729,evoker,devastation,20,8,12
Littleripper,tichondrius,724,evoker,devastation,18,8,10
Onornun,magtheridon,718,evoker,devastation,17,8,9
Zhyrouvion,stormrage,699,evoker,devastation,17,8,9
Torakk,ravencrest,687,evoker,devastation,13,8,5
Vokr,area-52,672,evoker,devastation,12,7,5
Spikeyboi,eonar,672,evoker,devastation,12,7,5
Caedalade,spirestone,672,evoker,devastation,12,7,5
Nysian,wyrmrest-accord,672,evoker,devastation,12,7,5
Axiomoixa,tichondrius,672,evoker,devastation,12,7,5
Evook,tichondrius,672,evoker,devastation,12,7,5
Shambly,kelthuzad,672,evoker,devastation,12,7,5
Lacadabeef,tichondrius,672,evoker,devastation,12,7,5
Serathrine,smolderthorn,672,evoker,devastation,12,7,5
Chewbigred,vashj,672,evoker,devastation,12,7,5
Dudeofdragon,illidan,672,evoker,devastation,12,7,5
Superscales,zuljin,672,evoker,devastation,12,7,5
Lizardgodtko,tichondrius,672,evoker,devastation,12,7,5
Breezemordus,zuljin,672,evoker,devastation,12,7,5
Rearcalzone,illidan,672,evoker,devastation,12,7,5
Dragonherb,zuljin,672,evoker,devastation,12,7,5
Ruination,lightnings-blade,672,evoker,devastation,12,7,5
Écaille,dalaran,672,evoker,devastation,15,8,7
Sådge,frostmourne,672,evoker,devastation,18,7,11
Müshü,icecrown,672,evoker,devastation,18,7,11
Dragonstonks,moon-guard,672,evoker,devastation,18,7,11
Rõÿ,area-52,672,evoker,devastation,18,7,11
Razistzegrlz,illidan,672,evoker,devastation,24,7,17
Ggcthulhu,area-52,671,evoker,devastation,12,7,5
Gôdswrath,tichondrius,671,evoker,devastation,12,7,5
Glaurungr,ragnaros,671,evoker,devastation,12,7,5
Xeretas,bleeding-hollow,671,evoker,devastation,12,7,5
Boseijwho,emerald-dream,671,evoker,devastation,12,7,5
Whiegrath,azralon,671,evoker,devastation,12,7,5
Garchamp,area-52,671,evoker,devastation,15,8,7
Craterearth,moon-guard,671,evoker,devastation,18,7,11
Hemipenes,tichondrius,671,evoker,devastation,18,7,11
Phatë,nerzhul,671,evoker,devastation,18,7,11
Davidfesago,quelthalas,670,evoker,devastation,12,7,5
Setchagos,emerald-dream,670,evoker,devastation,12,7,5
Gulvoke,shattered-hand,670,evoker,devastation,12,7,5
Beastlysoul,tichondrius,670,evoker,devastation,12,7,5
Nikeze,kiljaeden,670,evoker,devastation,18,7,11
Takhysis,frostmourne,670,evoker,devastation,18,7,11
Lamperr,illidan,670,evoker,devastation,54,10,44
Pyrepapi,thrall,669,evoker,devastation,20,8,12
Fortwonty,thrall,667,evoker,devastation,12,7,5
Mmanigoldo,quelthalas,667,evoker,devastation,18,7,11
Sleepeasy,blackrock,667,evoker,devastation,18,7,11
Evilsquirel,area-52,666,evoker,devastation,12,7,5
Stormstryke,queldorei,641,evoker,devastation,35,7,28
Krefugee,tichondrius,637,evoker,devastation,17,7,10
Drahkoo,azralon,623,evoker,devastation,15,7,8
Zérai,quelthalas,576,evoker,devastation,6,6,0
Draislyn,cenarion-circle,576,evoker,devastation,6,6,0
Miradrake,icecrown,576,evoker,devastation,6,6,0
Ilovepolpot,tichondrius,576,evoker,devastation,6,6,0
Fuecoco,proudmoore,576,evoker,devastation,6,6,0
Zlyrax,moon-guard,576,evoker,devastation,6,6,0
Dracthyrwa,azralon,576,evoker,devastation,6,6,0
Yellowker,thrall,576,evoker,devastation,6,6,0
Joopydrake,tichondrius,576,evoker,devastation,12,6,6
Glizard,firetree,576,evoker,devastation,12,6,6
Dafiya,thrall,576,evoker,devastation,12,6,6
Vysenía,moon-guard,576,evoker,devastation,12,6,6
Alucardragon,turalyon,576,evoker,devastation,12,6,6
Sathregos,emerald-dream,576,evoker,devastation,12,6,6
Shanaynayae,area-52,576,evoker,devastation,12,6,6
Joyburn,tichondrius,576,evoker,devastation,12,6,6
Uncleìroh,tichondrius,576,evoker,devastation,12,6,6
Drøgon,sargeras,576,evoker,devastation,12,6,6
Iamtrash,daggerspine,576,evoker,devastation,12,6,6
Dâpper,queldorei,576,evoker,devastation,12,6,6
Lardicønn,thrall,576,evoker,devastation,12,6,6
Comepancito,quelthalas,576,evoker,devastation,12,6,6
Brakkarion,wyrmrest-accord,576,evoker,devastation,12,6,6
Dragønbørne,blackrock,576,evoker,devastation,12,6,6
Dimatis,ragnaros,576,evoker,devastation,12,6,6
Dukä,dalaran,576,evoker,devastation,15,7,8
Êsh,lightbringer,576,evoker,devastation,13,6,7
Xfemboyqt,area-52,576,evoker,devastation,17,7,10
Syvernius,khazgoroth,576,evoker,devastation,18,6,12
Saxthyr,stormreaver,576,evoker,devastation,24,6,18
Avastri,moon-guard,575,evoker,devastation,12,6,6
Kazecgos,zuljin,575,evoker,devastation,12,6,6
Setasdan,illidan,575,evoker,devastation,12,6,6
Rykuvokr,azuremyst,575,evoker,devastation,12,6,6
Thalyxia,azralon,575,evoker,devastation,12,6,6
Ecksdoom,sargeras,575,evoker,devastation,12,6,6
Cøømbuya,sargeras,575,evoker,devastation,12,6,6
Tylexstranza,malganis,575,evoker,devastation,12,6,6
Koriaz,ragnaros,575,evoker,devastation,12,6,6
Altri,lightnings-blade,575,evoker,devastation,12,6,6
Avithori,borean-tundra,575,evoker,devastation,12,6,6
Chimo,laughing-skull,575,evoker,devastation,12,6,6
Dumbodragon,bleeding-hollow,575,evoker,devastation,12,6,6
Vrtra,lightbringer,575,evoker,devastation,12,6,6
Amaryliss,kelthuzad,575,evoker,devastation,12,6,6
Lòrdope,illidan,575,evoker,devastation,12,6,6
Deàthwing,proudmoore,575,evoker,devastation,18,6,12
Alragos,ragnaros,575,evoker,devastation,18,6,12
Bazelgos,moon-guard,575,evoker,devastation,24,6,18
Snowdragon,azralon,574,evoker,devastation,12,6,6
Dracnovae,emerald-dream,574,evoker,devastation,12,6,6
Vermáx,caelestrasz,574,evoker,devastation,12,6,6
Aegontargary,azralon,574,evoker,devastation,15,7,8
Carloxd,tichondrius,574,evoker,devastation,24,6,18
Syndue,malganis,573,evoker,devastation,12,6,6
Noodleslut,stormrage,573,evoker,devastation,12,6,6
Azuril,wyrmrest-accord,572,evoker,devastation,12,6,6
Reptyle,emerald-dream,569,evoker,devastation,18,6,12
Toephotos,tichondrius,558,evoker,devastation,17,6,11
Lightaurae,thunderlord,556,evoker,devastation,30,6,24
Pzyko,ragnaros,551,evoker,devastation,17,6,11
Zindrozarath,area-52,544,evoker,devastation,10,6,4
Blazor,sisters-of-elune,542,evoker,devastation,11,6,5
Dragonbreaf,emerald-dream,527,evoker,devastation,11,6,5
Kharibdis,kul-tiras,480,evoker,devastation,6,5,1
Hugehorns,jubeithos,480,evoker,devastation,6,5,1
Vellony,kelthuzad,480,evoker,devastation,6,5,1
Khalt,quelthalas,480,evoker,devastation,6,5,1
Emopidgey,dalaran,480,evoker,devastation,6,5,1
Drakedrift,malganis,480,evoker,devastation,6,5,1
Nardleberry,wyrmrest-accord,480,evoker,devastation,12,5,7
Deezdragon,stormrage,480,evoker,devastation,12,5,7
Stælthßømbèr,baelgun,480,evoker,devastation,12,5,7
Trillvoker,illidan,480,evoker,devastation,12,5,7
Ventiev,tichondrius,480,evoker,devastation,12,5,7
Skylizard,illidan,480,evoker,devastation,12,5,7
Rebuk,area-52,480,evoker,devastation,12,5,7
Darkscale,haomarush,480,evoker,devastation,12,5,7
Nuttutted,emerald-dream,480,evoker,devastation,12,5,7
Dhcb,tichondrius,480,evoker,devastation,12,5,7
Draehgor,hyjal,480,evoker,devastation,12,5,7
Nethenezoth,auchindoun,480,evoker,devastation,12,5,7
Purplerocket,illidan,480,evoker,devastation,12,5,7
Ackresh,executus,480,evoker,devastation,12,5,7
Dragonhyde,stormrage,480,evoker,devastation,12,5,7
Vallath,zuljin,480,evoker,devastation,12,5,7
Ammar,drakkari,480,evoker,devastation,12,5,7
Daesired,moon-guard,480,evoker,devastation,12,5,7
Galakrond,black-dragonflight,480,evoker,devastation,12,5,7
Asatrat,greymane,480,evoker,devastation,12,5,7
Saìntgeorge,sargeras,480,evoker,devastation,12,5,7
Nelthendros,moon-guard,480,evoker,devastation,12,5,7
Faahrad,azralon,480,evoker,devastation,12,5,7
Ryhu,sargeras,480,evoker,devastation,12,5,7
Eyedxl,magtheridon,480,evoker,devastation,12,5,7
Moltqt,tichondrius,480,evoker,devastation,12,5,7
Abath,quelthalas,480,evoker,devastation,14,5,9
Velahesa,sargeras,480,evoker,devastation,24,5,19
Emsli,moon-guard,479,evoker,devastation,6,5,1
Scalesun,azralon,479,evoker,devastation,12,5,7
Historius,proudmoore,479,evoker,devastation,12,5,7
Dedderion,zuljin,479,evoker,devastation,12,5,7
Granolajin,ragnaros,479,evoker,devastation,12,5,7
Müshu,duskwood,479,evoker,devastation,12,5,7
Targaryenz,malganis,479,evoker,devastation,12,5,7
Draginnutz,dunemaul,479,evoker,devastation,18,5,13
Niratrenn,area-52,478,evoker,devastation,12,5,7
Nazervis,silver-hand,478,evoker,devastation,18,5,13
Nathrach,wyrmrest-accord,477,evoker,devastation,6,5,1
Sandrov,kaelthas,477,evoker,devastation,12,5,7
Althenot,emerald-dream,477,evoker,devastation,12,5,7
Sammalone,burning-blade,474,evoker,devastation,12,5,7
Zzae,tichondrius,432,evoker,devastation,15,5,10
Swolegarian,emerald-dream,431,evoker,devastation,11,5,6
Kylidon,garrosh,415,evoker,devastation,8,5,3
Lifcleal,moon-guard,415,evoker,devastation,14,5,9
Kosstro,thunderlord,398,evoker,devastation,10,5,5
Skazz,emerald-dream,384,evoker,devastation,6,4,2
Foxstrazagos,hellscream,384,evoker,devastation,6,4,2
Whinks,zangarmarsh,384,evoker,devastation,6,4,2
Atraxian,tichondrius,384,evoker,devastation,6,4,2
Deathraux,tichondrius,384,evoker,devastation,6,4,2
Draisin,zuljin,384,evoker,devastation,6,4,2
Shënrøn,tichondrius,384,evoker,devastation,6,4,2
Emberlyn,sargeras,384,evoker,devastation,6,4,2
Jenovi,tichondrius,384,evoker,devastation,6,4,2
Kaidoxuchihv,ragnaros,384,evoker,devastation,6,4,2
Jòrmungandr,moon-guard,384,evoker,devastation,6,4,2
Dragonsbgay,stormrage,384,evoker,devastation,6,4,2
Tiamaat,black-dragonflight,384,evoker,devastation,6,4,2
Daemon,detheroc,384,evoker,devastation,6,4,2
Ejokerxx,tichondrius,384,evoker,devastation,6,4,2
Docevoker,tichondrius,384,evoker,devastation,6,4,2
Swagondragon,illidan,384,evoker,devastation,6,4,2
Biscotti,illidan,384,evoker,devastation,6,4,2
Solazari,tichondrius,384,evoker,devastation,6,4,2
Jammstraza,skywall,384,evoker,devastation,6,4,2
Mcflý,sargeras,384,evoker,devastation,6,4,2
Shenròn,kelthuzad,384,evoker,devastation,6,4,2
Machaflux,winterhoof,384,evoker,devastation,6,4,2
Kazooie,zuljin,384,evoker,devastation,6,4,2
Testzvoker,dalaran,384,evoker,devastation,6,4,2
Bodytypetwo,area-52,384,evoker,devastation,6,4,2
Vuldon,area-52,384,evoker,devastation,6,4,2
Bmbo,illidan,384,evoker,devastation,6,4,2
Seaserpent,kelthuzad,384,evoker,devastation,6,4,2
Ilovequiet,proudmoore,384,evoker,devastation,6,4,2
Opsmybad,ragnaros,384,evoker,devastation,6,4,2
Mushú,archimonde,384,evoker,devastation,6,4,2
Zorlstisza,moon-guard,384,evoker,devastation,6,4,2
Uhlive,area-52,384,evoker,devastation,6,4,2
Azafs,azralon,384,evoker,devastation,9,5,4
Shenrõn,malganis,384,evoker,devastation,15,5,10
Dragonballer,trollbane,384,evoker,devastation,12,4,8
Thnake,zuljin,384,evoker,devastation,12,4,8
Kcwt,illidan,384,evoker,devastation,12,4,8
Devåståtion,tichondrius,384,evoker,devastation,12,4,8
Ghostfable,emerald-dream,384,evoker,devastation,12,4,8
Usulamili,stormrage,384,evoker,devastation,12,4,8
Trazer,malfurion,384,evoker,devastation,12,4,8
Idiotlizard,stormrage,384,evoker,devastation,12,4,8
Dragostephen,nazjatar,384,evoker,devastation,12,4,8
Smacktoch,sargeras,384,evoker,devastation,12,4,8
Lukamagik,boulderfist,384,evoker,devastation,12,4,8
Smackthyr,thrall,384,evoker,devastation,12,4,8
Dractheseus,tichondrius,384,evoker,devastation,12,4,8
Rizzlordx,bleeding-hollow,384,evoker,devastation,12,4,8
Nitalzith,area-52,384,evoker,devastation,12,4,8
Alligatorz,sargeras,384,evoker,devastation,12,4,8
Kendrac,wyrmrest-accord,384,evoker,devastation,12,4,8
Cuarta,drakkari,384,evoker,devastation,12,4,8
Butta,darkspear,384,evoker,devastation,12,4,8
Blay,elune,384,evoker,devastation,12,4,8
Baddrakthyr,moon-guard,384,evoker,devastation,12,4,8
Muppetgronk,frostmourne,384,evoker,devastation,12,4,8
Lindrak,azralon,384,evoker,devastation,12,4,8
Munichho,spirestone,384,evoker,devastation,18,4,14
Dinossauro,stormrage,383,evoker,devastation,6,4,2
Rysonda,tichondrius,383,evoker,devastation,6,4,2
Pläid,azuremyst,383,evoker,devastation,6,4,2
Broconian,zuljin,383,evoker,devastation,12,4,8
Bagelsaurus,tichondrius,383,evoker,devastation,12,4,8
Jabberwockie,zuljin,383,evoker,devastation,12,4,8
Äpollo,frostmourne,382,evoker,devastation,12,4,8
Fearmybreath,stormrage,370,evoker,devastation,22,7,15
Vermicri,zuljin,351,evoker,devastation,11,4,7
Serazenoth,area-52,336,evoker,devastation,9,4,5
Dragopnik,tichondrius,335,evoker,devastation,9,4,5
Acindor,stormrage,335,evoker,devastation,11,4,7
Carrnedge,area-52,319,evoker,devastation,5,4,1
Avasd,area-52,288,evoker,devastation,6,3,3
Cerisoromis,stormrage,288,evoker,devastation,6,3,3
Inferna,ysera,288,evoker,devastation,6,3,3
Soupywings,illidan,288,evoker,devastation,6,3,3
Ceraxes,stormscale,288,evoker,devastation,6,3,3
Lëåf,area-52,288,evoker,devastation,6,3,3
Saintpablox,illidan,288,evoker,devastation,6,3,3
Shenronda,moon-guard,288,evoker,devastation,6,3,3
Yousmokemids,frostwolf,288,evoker,devastation,6,3,3
Dreamfyrexi,thrall,288,evoker,devastation,6,3,3
Madjeckyl,dalaran,288,evoker,devastation,6,3,3
Deewey,sargeras,288,evoker,devastation,6,3,3
Baddrake,moon-guard,288,evoker,devastation,6,3,3
Trákanon,mugthol,288,evoker,devastation,6,3,3
Jakarn,moon-guard,288,evoker,devastation,6,3,3
Liefarion,barthilas,288,evoker,devastation,6,3,3
Yeda,barthilas,288,evoker,devastation,6,3,3
Aomend,stormrage,288,evoker,devastation,6,3,3
Derkscale,stormrage,288,evoker,devastation,6,3,3
Straykitty,moon-guard,288,evoker,devastation,6,3,3
Deshalth,dalaran,288,evoker,devastation,6,3,3
Kluath,daggerspine,288,evoker,devastation,6,3,3
Hausebat,aegwynn,288,evoker,devastation,6,3,3
Ripdumpster,bonechewer,288,evoker,devastation,6,3,3
Magicev,tichondrius,288,evoker,devastation,6,3,3
Dragoom,saurfang,288,evoker,devastation,6,3,3
Drakthaer,tichondrius,288,evoker,devastation,6,3,3
Platypus,tichondrius,288,evoker,devastation,6,3,3
Kettor,kelthuzad,288,evoker,devastation,6,3,3
Ecoera,tichondrius,288,evoker,devastation,6,3,3
Bigsquirt,proudmoore,288,evoker,devastation,6,3,3
Skeye,malganis,288,evoker,devastation,6,3,3
Scyyterr,azralon,288,evoker,devastation,6,3,3
Shennron,darkspear,288,evoker,devastation,6,3,3
Spyro,nazgrel,288,evoker,devastation,6,3,3
Unisex,ragnaros,288,evoker,devastation,6,3,3
Brokenscales,nerzhul,288,evoker,devastation,6,3,3
Lamdyn,wyrmrest-accord,288,evoker,devastation,6,3,3
Dragbod,korgath,288,evoker,devastation,6,3,3
Kulrainor,drakkari,288,evoker,devastation,6,3,3
Varandir,frostmane,288,evoker,devastation,6,3,3
Nemenyah,emerald-dream,288,evoker,devastation,6,3,3
Ráigon,ragnaros,288,evoker,devastation,6,3,3
Viverion,dalaran,288,evoker,devastation,10,4,6
Taegon,area-52,288,evoker,devastation,10,4,6
Nyldra,area-52,288,evoker,devastation,8,3,5
Vandinus,stormrage,288,evoker,devastation,8,3,5
Healmeta,sargeras,288,evoker,devastation,12,3,9
Talonsong,wyrmrest-accord,288,evoker,devastation,12,3,9
Nephrites,area-52,288,evoker,devastation,12,3,9
Praac,illidan,288,evoker,devastation,12,3,9
Chriszilla,tichondrius,288,evoker,devastation,12,3,9
Ashenoth,antonidas,288,evoker,devastation,12,3,9
Lizardlee,stormrage,288,evoker,devastation,12,3,9
Enserio,stormrage,288,evoker,devastation,12,3,9
Freddragon,illidan,288,evoker,devastation,12,3,9
Zeralzin,aerie-peak,287,evoker,devastation,6,3,3
Zenithgar,aerie-peak,287,evoker,devastation,6,3,3
Evokatoke,proudmoore,287,evoker,devastation,6,3,3
Myvrth,windrunner,287,evoker,devastation,12,3,9
Galaxiz,bonechewer,287,evoker,devastation,12,3,9
Kilnarx,uldaman,286,evoker,devastation,6,3,3
Brontez,malganis,286,evoker,devastation,6,3,3
Ghorin,akama,240,evoker,devastation,9,3,6
Panicnodisco,zuljin,239,evoker,devastation,5,3,2
Reombarth,nemesis,234,evoker,devastation,12,6,6
Trrxx,tichondrius,224,evoker,devastation,10,3,7
Arnoeryan,ragnaros,224,evoker,devastation,10,3,7
Windylyrics,drakkari,192,evoker,devastation,6,2,4
Theyevokbuda,kelthuzad,192,evoker,devastation,6,2,4
Shädòwçäsper,kilrogg,192,evoker,devastation,6,2,4
Racovoker,zuljin,192,evoker,devastation,6,2,4
Daikon,kaelthas,192,evoker,devastation,6,2,4
Dixb,illidan,192,evoker,devastation,6,2,4
Vermithõr,ragnaros,192,evoker,devastation,6,2,4
Nyaraoorun,uther,192,evoker,devastation,6,2,4
Daebruk,ragnaros,192,evoker,devastation,6,2,4
Ilithiphobia,ghostlands,192,evoker,devastation,6,2,4
Siatren,shadowmoon,192,evoker,devastation,6,2,4
Ralzital,auchindoun,192,evoker,devastation,6,2,4
Slydawg,amanthul,192,evoker,devastation,6,2,4
Analogies,stormrage,192,evoker,devastation,6,2,4
Draketyr,area-52,192,evoker,devastation,6,2,4
Zattanik,ragnaros,192,evoker,devastation,6,2,4
Wse,illidan,192,evoker,devastation,6,2,4
Pocketgiga,stormrage,192,evoker,devastation,6,2,4
Lightbeing,nazjatar,192,evoker,devastation,6,2,4
Mattykanish,illidan,192,evoker,devastation,6,2,4
Xazxander,tichondrius,192,evoker,devastation,6,2,4
Selocky,bleeding-hollow,192,evoker,devastation,6,2,4
Yalena,illidan,192,evoker,devastation,6,2,4
Critqueenx,destromath,192,evoker,devastation,6,2,4
Eggvoker,area-52,192,evoker,devastation,6,2,4
Puffed,frostmourne,192,evoker,devastation,6,2,4
Joesount,frostmourne,192,evoker,devastation,6,2,4
Dragonsand,area-52,192,evoker,devastation,6,2,4
Daraz,tichondrius,192,evoker,devastation,6,2,4
Aralzit,tichondrius,192,evoker,devastation,6,2,4
Daemon,terokkar,192,evoker,devastation,6,2,4
Grawlix,stormreaver,192,evoker,devastation,6,2,4
Goreriders,area-52,192,evoker,devastation,6,2,4
Genderboy,tichondrius,192,evoker,devastation,6,2,4
Frozanat,kelthuzad,192,evoker,devastation,6,2,4
Parachutes,kelthuzad,192,evoker,devastation,6,2,4
Acade,tichondrius,192,evoker,devastation,6,2,4
Paindragon,tol-barad,192,evoker,devastation,6,2,4
Mâne,ragnaros,192,evoker,devastation,6,2,4
Actïoncat,emerald-dream,192,evoker,devastation,6,2,4
Nitalash,moon-guard,192,evoker,devastation,6,2,4
Tasdaral,tichondrius,192,evoker,devastation,6,2,4
Hellasketchy,sargeras,192,evoker,devastation,6,2,4
Kazervish,wyrmrest-accord,192,evoker,devastation,6,2,4
Wonyoungx,frostmourne,192,evoker,devastation,6,2,4
Ytq,tichondrius,192,evoker,devastation,6,2,4
Zuberion,wyrmrest-accord,192,evoker,devastation,6,2,4
Brendormu,moon-guard,192,evoker,devastation,6,2,4
Guavomango,moon-guard,192,evoker,devastation,6,2,4
Doldorrii,terenas,192,evoker,devastation,6,2,4
Desdinova,tortheldrin,192,evoker,devastation,6,2,4
Dokthyr,lightbringer,192,evoker,devastation,6,2,4
Darazen,scarlet-crusade,192,evoker,devastation,6,2,4
Wydbro,kiljaeden,192,evoker,devastation,6,2,4
Noxidian,moon-guard,192,evoker,devastation,6,2,4
Kímbah,emerald-dream,192,evoker,devastation,6,2,4
Magnito,thorium-brotherhood,192,evoker,devastation,6,2,4
Swamper,emerald-dream,192,evoker,devastation,6,2,4
Lanati,veknilash,192,evoker,devastation,6,2,4
Cmdragonbalz,sargeras,192,evoker,devastation,6,2,4
Cyromancerr,illidan,192,evoker,devastation,8,2,6
Skizle,destromath,192,evoker,devastation,12,2,10
Ragtharion,tichondrius,192,evoker,devastation,12,2,10
Gamerwords,barthilas,192,evoker,devastation,12,2,10
Blueblack,proudmoore,192,evoker,devastation,12,2,10
Sørrøw,blades-edge,192,evoker,devastation,18,2,16
Dracalis,thrall,191,evoker,devastation,6,2,4
Goongdi,tichondrius,159,evoker,devastation,5,2,3
Tevvez,moon-guard,159,evoker,devastation,5,2,3
Deathflamee,emerald-dream,138,evoker,devastation,12,3,9
Shunkagosa,frostmourne,128,evoker,devastation,4,2,2
Ryü,silver-hand,128,evoker,devastation,4,2,2
Eleechee,magtheridon,128,evoker,devastation,4,2,2
Vïtmercon,frostmourne,128,evoker,devastation,4,2,2
Booniejimbob,illidan,128,evoker,devastation,4,2,2
Vormontis,azralon,112,evoker,devastation,7,2,5
Tugmapvpean,kelthuzad,96,evoker,devastation,3,2,1
Gavstarz,frostmourne,96,evoker,devastation,3,2,1
Zealagon,ragnaros,96,evoker,devastation,6,1,5
Modenzu,malganis,96,evoker,devastation,6,1,5
Batterypowa,frostmourne,96,evoker,devastation,6,1,5
Ackonstraza,frostmourne,96,evoker,devastation,6,1,5
Bløssom,malganis,96,evoker,devastation,6,1,5
Shintrax,ragnaros,96,evoker,devastation,6,1,5
Dragonbornhd,tichondrius,96,evoker,devastation,6,1,5
Erathiss,wyrmrest-accord,96,evoker,devastation,6,1,5
Nosrej,hyjal,96,evoker,devastation,6,1,5
Zinderaz,runetotem,96,evoker,devastation,6,1,5
Handb,tichondrius,96,evoker,devastation,6,1,5
Kurulol,ragnaros,96,evoker,devastation,6,1,5
Koopa,malygos,96,evoker,devastation,6,1,5
Kazadon,icecrown,96,evoker,devastation,6,1,5
Asui,senjin,96,evoker,devastation,6,1,5
Chillistraza,tichondrius,96,evoker,devastation,6,1,5
Draconis,onyxia,96,evoker,devastation,6,1,5
Aoibae,frostmourne,96,evoker,devastation,6,1,5
Fígment,tichondrius,96,evoker,devastation,6,1,5
Rial,frostmourne,96,evoker,devastation,6,1,5
Demobreath,sargeras,96,evoker,devastation,6,1,5
Charrio,illidan,96,evoker,devastation,6,1,5
Bigwurrm,illidan,96,evoker,devastation,6,1,5
Repd,sargeras,96,evoker,devastation,6,1,5
Lucià,thrall,96,evoker,devastation,6,1,5
Drakkar,elune,96,evoker,devastation,6,1,5
Ðrac,bleeding-hollow,96,evoker,devastation,6,1,5
Ojigi,sargeras,96,evoker,devastation,6,1,5
Myjewelshurt,stormrage,96,evoker,devastation,6,1,5
Warchad,stormrage,96,evoker,devastation,6,1,5
Luceryz,drakkari,96,evoker,devastation,6,1,5
Dracoi,illidan,96,evoker,devastation,6,1,5
Pisslizard,stormrage,96,evoker,devastation,6,1,5
Spyrofnir,stormrage,96,evoker,devastation,6,1,5
Carnosaur,lightbringer,96,evoker,devastation,12,1,11
Dracosofi,quelthalas,96,evoker,devastation,12,1,11
Ysondrius,durotan,96,evoker,devastation,12,1,11
Colloc,tichondrius,96,evoker,devastation,12,1,11
Donormi,moon-guard,96,evoker,devastation,12,1,11
Dadydafather,sargeras,96,evoker,devastation,18,1,17
Embeka,illidan,95,evoker,devastation,6,1,5
Bàkèd,illidan,79,evoker,devastation,5,1,4
Nwo,shattered-hand,64,evoker,devastation,4,1,3
Cerevok,area-52,64,evoker,devastation,4,1,3
Charlestrasz,hyjal,42,evoker,devastation,11,3,8
Remisha,emerald-dream,2136,hunter,marksmanship,82,44,38
Darkshady,tichondrius,2108,hunter,marksmanship,84,44,40
Rendel,drakkari,2038,hunter,marksmanship,143,73,70
Dobarantu,tichondrius,1999,hunter,marksmanship,152,77,75
Abolick,area-52,1994,hunter,marksmanship,124,64,60
Imvalence,area-52,1947,hunter,marksmanship,82,36,46
Globalcake,illidan,1940,hunter,marksmanship,162,86,76
Fuknhunter,kiljaeden,1905,hunter,marksmanship,110,56,54
Iconvoked,sargeras,1899,hunter,marksmanship,172,92,80
Rakan,spinebreaker,1884,hunter,marksmanship,54,33,21
Bøl,ragnaros,1882,hunter,marksmanship,30,20,10
Chadsmanship,kelthuzad,1881,hunter,marksmanship,60,29,31
Banshee,frostmourne,1876,hunter,marksmanship,34,22,12
Hokutox,tichondrius,1870,hunter,marksmanship,68,31,37
Blackjesu,blackrock,1868,hunter,marksmanship,72,33,39
Renaître,tichondrius,1866,hunter,marksmanship,120,57,63
Hrafn,illidan,1859,hunter,marksmanship,60,31,29
Preze,moon-guard,1852,hunter,marksmanship,63,37,26
Lely,tichondrius,1851,hunter,marksmanship,60,34,26
Squawkers,sargeras,1848,hunter,marksmanship,78,43,35
Astolenis,quelthalas,1847,hunter,marksmanship,60,29,31
Hâwkêyê,thrall,1827,hunter,marksmanship,48,22,26
Ingrutamig,tichondrius,1814,hunter,marksmanship,66,32,34
Colada,malganis,1813,hunter,marksmanship,72,34,38
Bosshunter,tichondrius,1810,hunter,marksmanship,86,43,43
Nishinos,tichondrius,1808,hunter,marksmanship,183,88,95
Czeroenjoyer,malganis,1803,hunter,marksmanship,66,33,33
Deutêr,quelthalas,1801,hunter,marksmanship,66,35,31
Trapordíe,tichondrius,1800,hunter,marksmanship,42,21,21
Blaðe,kelthuzad,1794,hunter,marksmanship,84,40,44
Kensho,illidan,1789,hunter,marksmanship,48,28,20
Kristemis,thrall,1782,hunter,marksmanship,53,27,26
Drasen,deathwing,1778,hunter,marksmanship,48,27,21
Hagadinn,frostmourne,1765,hunter,marksmanship,48,21,27
Boquiinha,stormrage,1759,hunter,marksmanship,90,46,44
Dynith,sargeras,1756,hunter,marksmanship,39,21,18
Undeadroach,tichondrius,1747,hunter,marksmanship,119,55,64
Notnick,tichondrius,1747,hunter,marksmanship,84,37,47
Barelyknower,area-52,1737,hunter,marksmanship,42,23,19
Overgnome,ragnaros,1736,hunter,marksmanship,66,32,34
Tánsøxøxø,tichondrius,1733,hunter,marksmanship,54,25,29
Kkoduckk,tichondrius,1715,hunter,marksmanship,30,19,11
Gohan,jubeithos,1713,hunter,marksmanship,39,22,17
Blungo,azralon,1713,hunter,marksmanship,60,31,29
Dolcece,tichondrius,1713,hunter,marksmanship,48,24,24
Quickitty,proudmoore,1711,hunter,marksmanship,66,33,33
Trapstar,aggramar,1705,hunter,marksmanship,51,31,20
Babyhydra,frostmourne,1693,hunter,marksmanship,41,23,18
Shatterwax,area-52,1690,hunter,marksmanship,42,21,21
Ladderpolice,tichondrius,1688,hunter,marksmanship,79,42,37
Tropic,proudmoore,1688,hunter,marksmanship,68,28,40
Hmh,burning-legion,1686,hunter,marksmanship,197,102,95
Killatrap,malganis,1677,hunter,marksmanship,42,23,19
Heädshöt,malorne,1672,hunter,marksmanship,66,31,35
Dudemanyeah,skullcrusher,1671,hunter,marksmanship,54,23,31
Petattack,barthilas,1668,hunter,marksmanship,42,20,22
Tassili,illidan,1666,hunter,marksmanship,60,23,37
Vitekz,illidan,1665,hunter,marksmanship,36,25,11
Shawtytraps,tichondrius,1652,hunter,marksmanship,131,53,78
Gotchã,area-52,1650,hunter,marksmanship,42,27,15
Aymas,sargeras,1645,hunter,marksmanship,119,62,57
Surprisemfkr,emerald-dream,1637,hunter,marksmanship,60,30,30
Zumago,tichondrius,1633,hunter,marksmanship,42,19,23
Bigpie,daggerspine,1628,hunter,marksmanship,59,37,22
Taylormadae,frostmourne,1627,hunter,marksmanship,66,37,29
Gor,hyjal,1622,hunter,marksmanship,47,23,24
Arjunå,sargeras,1621,hunter,marksmanship,101,56,45
Easynightjr,bleeding-hollow,1620,hunter,marksmanship,225,117,108
Onemoreshot,bleeding-hollow,1619,hunter,marksmanship,152,72,80
Xcw,stormrage,1619,hunter,marksmanship,60,28,32
Supersaiyan,antonidas,1618,hunter,marksmanship,36,17,19
Alansho,tichondrius,1618,hunter,marksmanship,53,20,33
Tânsøxøxø,tichondrius,1617,hunter,marksmanship,30,17,13
Latesummer,tichondrius,1616,hunter,marksmanship,48,25,23
Johaylon,sargeras,1616,hunter,marksmanship,42,19,23
Dezertpower,sargeras,1613,hunter,marksmanship,36,20,16
Snìpershot,sargeras,1612,hunter,marksmanship,61,33,28
Shotashot,area-52,1612,hunter,marksmanship,36,17,19
Wildder,area-52,1609,hunter,marksmanship,56,31,25
Simbagrove,dalaran,1605,hunter,marksmanship,42,19,23
Evaelfi,illidan,1605,hunter,marksmanship,40,17,23
Tyrmaakk,emerald-dream,1604,hunter,marksmanship,40,23,17
Dienasty,zuljin,1601,hunter,marksmanship,30,21,9
Toxarch,aggramar,1598,hunter,marksmanship,42,20,22
Headshoot,tichondrius,1594,hunter,marksmanship,59,31,28
Dracõ,proudmoore,1591,hunter,marksmanship,78,39,39
Jubiscleudo,azralon,1585,hunter,marksmanship,97,44,53
Plopslopper,frostmourne,1580,hunter,marksmanship,48,28,20
Mambothehunt,stormrage,1579,hunter,marksmanship,60,33,27
Drivebymac,tichondrius,1578,hunter,marksmanship,42,21,21
Dummorogh,stormrage,1578,hunter,marksmanship,108,51,57
Tren,blackrock,1573,hunter,marksmanship,29,17,12
Flämma,azralon,1573,hunter,marksmanship,90,40,50
Richmond,lightnings-blade,1572,hunter,marksmanship,54,26,28
Wìkkihx,emerald-dream,1568,hunter,marksmanship,48,25,23
Papiskrill,staghelm,1568,hunter,marksmanship,91,42,49
Swagprince,skullcrusher,1563,hunter,marksmanship,52,32,20
Stimpblimp,jubeithos,1563,hunter,marksmanship,48,19,29
Onemøreshot,bleeding-hollow,1561,hunter,marksmanship,108,54,54
Saloran,akama,1560,hunter,marksmanship,84,48,36
Gnomorecum,kiljaeden,1558,hunter,marksmanship,87,54,33
Shotsphodays,sargeras,1558,hunter,marksmanship,72,37,35
Crounzz,sargeras,1558,hunter,marksmanship,51,23,28
Rampagez,tichondrius,1555,hunter,marksmanship,36,19,17
Luchadoris,malganis,1552,hunter,marksmanship,60,30,30
Alyywn,tichondrius,1551,hunter,marksmanship,101,44,57
Hötdôg,kiljaeden,1548,hunter,marksmanship,36,20,16
Mukbangbj,terenas,1546,hunter,marksmanship,70,37,33
Aueria,kiljaeden,1540,hunter,marksmanship,48,18,30
Hämhunter,stormrage,1539,hunter,marksmanship,48,31,17
Arrowslol,stormrage,1537,hunter,marksmanship,48,23,25
Huntncheekz,kelthuzad,1534,hunter,marksmanship,76,38,38
Metalgear,icecrown,1533,hunter,marksmanship,66,34,32
Unravel,tichondrius,1532,hunter,marksmanship,57,34,23
Undien,area-52,1532,hunter,marksmanship,34,18,16
Hitts,barthilas,1531,hunter,marksmanship,53,27,26
Smokabombom,eredar,1530,hunter,marksmanship,34,18,16
Boggartt,ragnaros,1530,hunter,marksmanship,46,21,25
Zugbrained,illidan,1529,hunter,marksmanship,48,26,22
Lilbang,thrall,1529,hunter,marksmanship,42,19,23
Kekkww,hyjal,1526,hunter,marksmanship,48,25,23
Acelol,proudmoore,1524,hunter,marksmanship,142,80,62
Tommychong,shandris,1524,hunter,marksmanship,46,19,27
Guacmec,tichondrius,1521,hunter,marksmanship,48,28,20
Elfymcelf,arthas,1520,hunter,marksmanship,84,39,45
Gretress,azralon,1520,hunter,marksmanship,66,28,38
Grands,tortheldrin,1519,hunter,marksmanship,54,26,28
Lsily,tichondrius,1519,hunter,marksmanship,36,16,20
Maia,frostwolf,1518,hunter,marksmanship,66,30,36
Bowflexen,illidan,1518,hunter,marksmanship,42,19,23
Odin,goldrinn,1516,hunter,marksmanship,101,46,55
Insanedabz,tichondrius,1515,hunter,marksmanship,72,35,37
Wockqt,kiljaeden,1514,hunter,marksmanship,37,17,20
Mehontar,area-52,1509,hunter,marksmanship,42,20,22
Boomphaque,ravencrest,1506,hunter,marksmanship,76,36,40
Kimghak,tichondrius,1506,hunter,marksmanship,49,20,29
Lostfaith,tichondrius,1504,hunter,marksmanship,66,36,30
Thebweh,ragnaros,1504,hunter,marksmanship,35,17,18
Rïve,tichondrius,1504,hunter,marksmanship,36,17,19
Marshen,zuljin,1503,hunter,marksmanship,36,17,19
Baixiaochu,area-52,1503,hunter,marksmanship,87,41,46
Huntkiller,tichondrius,1502,hunter,marksmanship,28,18,10
Tup,guldan,1499,hunter,marksmanship,51,28,23
Lixniqua,tichondrius,1498,hunter,marksmanship,75,38,37
Bertimus,sargeras,1498,hunter,marksmanship,42,17,25
Maximos,lightnings-blade,1498,hunter,marksmanship,66,25,41
Papacohen,stormrage,1495,hunter,marksmanship,45,22,23
Lildex,demon-soul,1494,hunter,marksmanship,30,18,12
Takeiya,zuljin,1494,hunter,marksmanship,29,16,13
Jotosalsa,blackrock,1494,hunter,marksmanship,48,26,22
Rubinaldo,azralon,1494,hunter,marksmanship,30,16,14
Föcker,emerald-dream,1492,hunter,marksmanship,25,19,6
Esler,quelthalas,1490,hunter,marksmanship,54,28,26
Yozsh,azralon,1485,hunter,marksmanship,47,32,15
Pâl,quelthalas,1481,hunter,marksmanship,42,21,21
Deliond,moon-guard,1481,hunter,marksmanship,91,45,46
Booyakah,hyjal,1475,hunter,marksmanship,36,19,17
Lederniertra,gorefiend,1475,hunter,marksmanship,212,109,103
Windrein,ysondre,1475,hunter,marksmanship,48,20,28
Barrohunt,tichondrius,1473,hunter,marksmanship,49,31,18
Somethinggo,tichondrius,1472,hunter,marksmanship,161,77,84
Xcisiion,nagrand,1470,hunter,marksmanship,161,82,79
Scourgesurge,kiljaeden,1470,hunter,marksmanship,42,21,21
Gq,garona,1470,hunter,marksmanship,36,16,20
Killshøtß,tichondrius,1466,hunter,marksmanship,54,25,29
Legeye,malganis,1465,hunter,marksmanship,48,21,27
Sagadegêmeos,stormrage,1465,hunter,marksmanship,48,16,32
Lowlore,moon-guard,1463,hunter,marksmanship,96,52,44
Angelickon,tichondrius,1462,hunter,marksmanship,38,18,20
Zeenuts,sargeras,1461,hunter,marksmanship,47,24,23
Skybourne,nemesis,1457,hunter,marksmanship,36,23,13
Bomomatic,zuljin,1454,hunter,marksmanship,30,18,12
Cyrsmen,ragnaros,1454,hunter,marksmanship,75,34,41
Tóri,emerald-dream,1445,hunter,marksmanship,47,25,22
Bwaa,illidan,1444,hunter,marksmanship,83,38,45
Chï,zuljin,1442,hunter,marksmanship,97,49,48
Hemathios,drakkari,1442,hunter,marksmanship,50,21,29
Amyrkvothe,ragnaros,1439,hunter,marksmanship,54,20,34
Pokcmvmxckm,senjin,1433,hunter,marksmanship,66,35,31
Crazyeasy,azshara,1431,hunter,marksmanship,30,15,15
Lewanker,zuljin,1429,hunter,marksmanship,42,23,19
Vibøra,stormrage,1429,hunter,marksmanship,126,56,70
Valimhir,tichondrius,1429,hunter,marksmanship,36,16,20
Mèseeks,bleeding-hollow,1427,hunter,marksmanship,60,34,26
Nelosi,shadowmoon,1427,hunter,marksmanship,42,18,24
Renzô,sargeras,1425,hunter,marksmanship,45,28,17
Lokuhzmarcus,goldrinn,1423,hunter,marksmanship,54,30,24
Timmee,bleeding-hollow,1421,hunter,marksmanship,24,15,9
Leucis,cenarius,1420,hunter,marksmanship,18,15,3
Boombob,sargeras,1415,hunter,marksmanship,53,24,29
Backpedalftw,darrowmere,1414,hunter,marksmanship,30,15,15
Zasnar,malganis,1413,hunter,marksmanship,30,15,15
Aimz,zuluhed,1411,hunter,marksmanship,67,26,41
Vergillx,ragnaros,1409,hunter,marksmanship,74,45,29
Klannis,quelthalas,1409,hunter,marksmanship,42,19,23
Ryukuzen,tichondrius,1409,hunter,marksmanship,36,15,21
Dnicee,stormrage,1408,hunter,marksmanship,36,28,8
Ssdslol,bleeding-hollow,1407,hunter,marksmanship,91,53,38
Cashhapp,zuljin,1407,hunter,marksmanship,129,66,63
Pwnagraphic,barthilas,1407,hunter,marksmanship,64,25,39
Joshmckin,area-52,1406,hunter,marksmanship,116,53,63
Mariaassjx,ragnaros,1406,hunter,marksmanship,102,46,56
Voidmarksman,whisperwind,1404,hunter,marksmanship,49,30,19
Grànd,tortheldrin,1402,hunter,marksmanship,35,17,18
Slayou,uldum,1399,hunter,marksmanship,36,21,15
Madsniper,thunderlord,1397,hunter,marksmanship,42,22,20
Lookøut,moon-guard,1396,hunter,marksmanship,44,18,26
Cholohippie,blackrock,1394,hunter,marksmanship,49,26,23
Littledougie,boulderfist,1392,hunter,marksmanship,42,23,19
Ashx,khazgoroth,1392,hunter,marksmanship,30,15,15
Insulin,moonrunner,1390,hunter,marksmanship,36,17,19
Rockenrique,nemesis,1390,hunter,marksmanship,36,16,20
Trapshawty,darkspear,1389,hunter,marksmanship,48,17,31
ßeãst,bladefist,1387,hunter,marksmanship,24,16,8
Automatic,illidan,1386,hunter,marksmanship,51,23,28
Artemyzz,tichondrius,1384,hunter,marksmanship,36,15,21
Grayføxx,twisting-nether,1381,hunter,marksmanship,30,17,13
Staticarrow,norgannon,1377,hunter,marksmanship,96,45,51
Rumzi,thrall,1375,hunter,marksmanship,36,21,15
Dominate,frostmourne,1374,hunter,marksmanship,48,23,25
Hunsak,ragnaros,1373,hunter,marksmanship,30,20,10
Húntingarrow,area-52,1373,hunter,marksmanship,72,36,36
Idiiot,sargeras,1373,hunter,marksmanship,68,33,35
Precísion,malganis,1372,hunter,marksmanship,35,18,17
Gorîlla,sargeras,1371,hunter,marksmanship,66,31,35
Leshwi,ragnaros,1370,hunter,marksmanship,47,23,24
Wìllòw,khazgoroth,1368,hunter,marksmanship,42,16,26
Malebolick,ragnaros,1367,hunter,marksmanship,65,27,38
Lukhas,moon-guard,1367,hunter,marksmanship,60,24,36
Blackhuntr,garona,1366,hunter,marksmanship,187,97,90
Adive,drakkari,1366,hunter,marksmanship,73,34,39
Chokemescara,stormrage,1364,hunter,marksmanship,36,16,20
Jumaanji,gurubashi,1362,hunter,marksmanship,70,36,34
Kronicbeast,bleeding-hollow,1360,hunter,marksmanship,96,42,54
Bowinc,greymane,1357,hunter,marksmanship,24,15,9
Benme,illidan,1357,hunter,marksmanship,162,73,89
Pleyadez,drakkari,1356,hunter,marksmanship,42,24,18
Braxigarr,area-52,1356,hunter,marksmanship,217,104,113
Elendïr,tichondrius,1353,hunter,marksmanship,48,25,23
Watchmanjoe,grizzly-hills,1350,hunter,marksmanship,54,30,24
Uwuessy,illidan,1348,hunter,marksmanship,66,30,36
Kyukon,illidan,1345,hunter,marksmanship,36,18,18
Diisdik,tichondrius,1344,hunter,marksmanship,51,23,28
Mizhu,ragnaros,1343,hunter,marksmanship,70,38,32
Bootywhop,dalaran,1342,hunter,marksmanship,24,14,10
Hurstt,kelthuzad,1341,hunter,marksmanship,56,27,29
Ripmytoast,chogall,1338,hunter,marksmanship,169,94,75
Huntonthic,korgath,1338,hunter,marksmanship,38,16,22
Toniic,moon-guard,1337,hunter,marksmanship,54,33,21
Vonkrieg,tichondrius,1337,hunter,marksmanship,36,14,22
Orgpopeyes,illidan,1336,hunter,marksmanship,24,14,10
Dvei,silvermoon,1336,hunter,marksmanship,57,25,32
Azaz,khaz-modan,1332,hunter,marksmanship,54,25,29
Tonnyfab,ragnaros,1326,hunter,marksmanship,34,19,15
Hukkx,kalecgos,1325,hunter,marksmanship,50,22,28
Dathunterr,azralon,1325,hunter,marksmanship,65,28,37
Softhunter,tichondrius,1324,hunter,marksmanship,36,14,22
Murza,korgath,1323,hunter,marksmanship,24,15,9
Xhartanis,magtheridon,1323,hunter,marksmanship,63,31,32
Kä,blackhand,1321,hunter,marksmanship,66,28,38
Ahegoface,frostmourne,1321,hunter,marksmanship,54,19,35
Ärtémisa,quelthalas,1320,hunter,marksmanship,35,19,16
Tristiae,stormrage,1319,hunter,marksmanship,67,36,31
Péppérmínt,korgath,1318,hunter,marksmanship,22,15,7
Dogezandalar,illidan,1317,hunter,marksmanship,40,18,22
Explosief,area-52,1315,hunter,marksmanship,60,30,30
Ricas,malganis,1315,hunter,marksmanship,98,44,54
Shooterzz,illidan,1314,hunter,marksmanship,24,16,8
Akomata,emerald-dream,1313,hunter,marksmanship,24,14,10
Shøtii,tichondrius,1309,hunter,marksmanship,24,14,10
Condorexe,illidan,1307,hunter,marksmanship,72,28,44
Smoothbrain,khadgar,1307,hunter,marksmanship,52,19,33
Thirià,garona,1306,hunter,marksmanship,18,14,4
Rekshot,amanthul,1306,hunter,marksmanship,150,73,77
Jeezyxxii,shadowmoon,1305,hunter,marksmanship,36,15,21
Wolverhino,thrall,1304,hunter,marksmanship,48,21,27
Albe,azralon,1303,hunter,marksmanship,76,37,39
Cocobread,stormreaver,1303,hunter,marksmanship,48,21,27
Snewboy,malganis,1299,hunter,marksmanship,24,14,10
Celph,moon-guard,1299,hunter,marksmanship,48,20,28
Sleepyjoee,dalaran,1297,hunter,marksmanship,36,18,18
Gunther,korgath,1296,hunter,marksmanship,30,14,16
Mensrea,illidan,1294,hunter,marksmanship,47,30,17
Markymarc,tichondrius,1294,hunter,marksmanship,35,14,21
Déadshot,thaurissan,1294,hunter,marksmanship,36,14,22
Urtthel,stormrage,1293,hunter,marksmanship,28,17,11
Krattøs,bleeding-hollow,1293,hunter,marksmanship,34,16,18
Rhaygon,arthas,1293,hunter,marksmanship,39,16,23
Ghudi,moon-guard,1292,hunter,marksmanship,26,15,11
Swolfp,tichondrius,1291,hunter,marksmanship,40,16,24
Glediator,tichondrius,1288,hunter,marksmanship,112,51,61
Shadowhokage,zuljin,1286,hunter,marksmanship,30,14,16
Kalibah,azralon,1285,hunter,marksmanship,81,30,51
Hoboh,illidan,1284,hunter,marksmanship,77,34,43
Toowizeë,barthilas,1284,hunter,marksmanship,35,14,21
Juhyeon,tichondrius,1284,hunter,marksmanship,46,17,29
Gromtheponch,area-52,1280,hunter,marksmanship,43,22,21
Rawrzy,sargeras,1278,hunter,marksmanship,29,14,15
Lotatinyfish,malganis,1275,hunter,marksmanship,36,20,16
Bojob,azgalor,1275,hunter,marksmanship,51,26,25
Amanazàra,tichondrius,1275,hunter,marksmanship,48,23,25
Sniperarmy,dalaran,1274,hunter,marksmanship,103,52,51
Darylovejr,destromath,1274,hunter,marksmanship,38,16,22
Nights,nemesis,1271,hunter,marksmanship,24,15,9
Gothew,turalyon,1270,hunter,marksmanship,24,14,10
Thaden,akama,1268,hunter,marksmanship,36,17,19
Zaheerz,sargeras,1268,hunter,marksmanship,30,14,16
Picaubica,kiljaeden,1268,hunter,marksmanship,41,15,26
Spyhunter,malganis,1266,hunter,marksmanship,67,28,39
Xephert,ragnaros,1265,hunter,marksmanship,48,22,26
Cloudbuck,aegwynn,1262,hunter,marksmanship,58,22,36
Apaweclover,stormrage,1259,hunter,marksmanship,250,123,127
Lightweight,kelthuzad,1257,hunter,marksmanship,47,22,25
Ragnarlobkk,ragnaros,1255,hunter,marksmanship,51,26,25
Jerybery,gundrak,1253,hunter,marksmanship,29,18,11
Solomine,jubeithos,1251,hunter,marksmanship,36,15,21
Ëzy,frostmourne,1246,hunter,marksmanship,60,33,27
Comebacks,ragnaros,1245,hunter,marksmanship,24,13,11
Duruainn,zuljin,1245,hunter,marksmanship,73,33,40
Hoeswannafuk,stormrage,1243,hunter,marksmanship,24,13,11
Vipermaster,azralon,1243,hunter,marksmanship,46,24,22
Oattes,daggerspine,1243,hunter,marksmanship,30,13,17
Hogshanks,moon-guard,1242,hunter,marksmanship,24,13,11
Booffmeister,area-52,1242,hunter,marksmanship,24,13,11
Seenobody,stormrage,1242,hunter,marksmanship,100,51,49
Rudekeef,illidan,1240,hunter,marksmanship,24,13,11
Lafleche,kiljaeden,1239,hunter,marksmanship,29,15,14
Islachan,ragnaros,1238,hunter,marksmanship,30,13,17
Coolwhip,demon-soul,1237,hunter,marksmanship,40,20,20
Hunimi,elune,1237,hunter,marksmanship,32,14,18
Birgite,stormrage,1237,hunter,marksmanship,48,17,31
Sootgarbage,sargeras,1235,hunter,marksmanship,18,13,5
Pokeyourbutt,hydraxis,1235,hunter,marksmanship,24,13,11
Killz,skullcrusher,1234,hunter,marksmanship,44,21,23
Drillklinton,tichondrius,1234,hunter,marksmanship,42,18,24
Lolknocked,alexstrasza,1233,hunter,marksmanship,27,14,13
Enuk,nagrand,1232,hunter,marksmanship,52,26,26
Gstring,kelthuzad,1232,hunter,marksmanship,78,31,47
Chikkynuggy,destromath,1228,hunter,marksmanship,33,14,19
Fuzzypjs,stormrage,1226,hunter,marksmanship,33,14,19
Caylix,sargeras,1216,hunter,marksmanship,36,14,22
Targetreaper,proudmoore,1215,hunter,marksmanship,24,13,11
Sukr,korgath,1215,hunter,marksmanship,98,37,61
Give,draktharon,1214,hunter,marksmanship,33,14,19
Malkuri,medivh,1213,hunter,marksmanship,35,13,22
Puresport,hyjal,1212,hunter,marksmanship,24,13,11
Kritsu,tichondrius,1209,hunter,marksmanship,41,20,21
Chainmaster,misha,1204,hunter,marksmanship,97,47,50
Augus,eredar,1202,hunter,marksmanship,41,15,26
Buckethole,doomhammer,1198,hunter,marksmanship,36,18,18
Calî,stormscale,1195,hunter,marksmanship,30,14,16
Vinranya,sargeras,1194,hunter,marksmanship,75,34,41
Chaðs,amanthul,1190,hunter,marksmanship,39,21,18
Kayzia,lightninghoof,1190,hunter,marksmanship,29,13,16
Raneldar,proudmoore,1190,hunter,marksmanship,96,37,59
Bluecoral,frostmourne,1189,hunter,marksmanship,51,21,30
Valieev,black-dragonflight,1188,hunter,marksmanship,42,25,17
Ilovehippos,laughing-skull,1188,hunter,marksmanship,145,67,78
Forthethrill,area-52,1187,hunter,marksmanship,45,24,21
Oopsurtrappd,darkspear,1186,hunter,marksmanship,29,16,13
Juicyjams,moon-guard,1186,hunter,marksmanship,24,13,11
Sunnimuffens,deathwing,1181,hunter,marksmanship,47,23,24
Zock,lothar,1181,hunter,marksmanship,98,47,51
Fova,wyrmrest-accord,1179,hunter,marksmanship,19,14,5
Doubletappz,stormrage,1178,hunter,marksmanship,36,15,21
Chïnchïlla,zuljin,1176,hunter,marksmanship,21,14,7
Rocroc,gurubashi,1175,hunter,marksmanship,66,29,37
Silverweaver,illidan,1174,hunter,marksmanship,30,15,15
Ellishunter,frostmourne,1174,hunter,marksmanship,64,23,41
Aftërlyfe,tichondrius,1170,hunter,marksmanship,29,14,15
Critaclyzm,moon-guard,1169,hunter,marksmanship,36,14,22
Patmypet,terenas,1167,hunter,marksmanship,30,14,16
Mezmore,thrall,1167,hunter,marksmanship,54,24,30
Moüserat,moon-guard,1162,hunter,marksmanship,114,55,59
Netorip,azralon,1161,hunter,marksmanship,27,13,14
Miscreant,kelthuzad,1160,hunter,marksmanship,32,13,19
Cu,frostmourne,1159,hunter,marksmanship,19,13,6
Primalus,tichondrius,1152,hunter,marksmanship,24,12,12
Hunterlist,frostmourne,1151,hunter,marksmanship,24,12,12
Negãn,tichondrius,1151,hunter,marksmanship,24,12,12
Bowdown,moon-guard,1150,hunter,marksmanship,54,28,26
Killincrew,scilla,1149,hunter,marksmanship,38,19,19
Spunky,zuluhed,1149,hunter,marksmanship,24,12,12
Floozyfairy,daggerspine,1149,hunter,marksmanship,53,26,27
Zuuvuya,nemesis,1149,hunter,marksmanship,56,20,36
Nes,azuremyst,1148,hunter,marksmanship,24,12,12
Spiketurtle,queldorei,1148,hunter,marksmanship,30,13,17
Clemenlemon,illidan,1147,hunter,marksmanship,24,14,10
Ocromiun,illidan,1146,hunter,marksmanship,39,13,26
Topshotx,tichondrius,1145,hunter,marksmanship,18,12,6
Desolater,bleeding-hollow,1143,hunter,marksmanship,36,12,24
Inability,emerald-dream,1142,hunter,marksmanship,30,12,18
Jenniekim,mugthol,1141,hunter,marksmanship,19,13,6
Sugarboyy,darkspear,1141,hunter,marksmanship,30,14,16
Alindra,zuluhed,1141,hunter,marksmanship,60,25,35
Òriòn,tichondrius,1141,hunter,marksmanship,36,12,24
Zgabriel,azralon,1140,hunter,marksmanship,24,12,12
Stupidgodx,tichondrius,1140,hunter,marksmanship,24,12,12
Foxhe,hyjal,1137,hunter,marksmanship,42,22,20
Tenlbbow,illidan,1137,hunter,marksmanship,24,12,12
Cßo,tichondrius,1135,hunter,marksmanship,60,27,33
Sï,anubarak,1135,hunter,marksmanship,30,12,18
Vhan,azralon,1133,hunter,marksmanship,44,19,25
Oqqo,tichondrius,1132,hunter,marksmanship,51,21,30
Jarloo,madoran,1129,hunter,marksmanship,35,19,16
Bigolhippy,frostmourne,1129,hunter,marksmanship,24,12,12
Táká,quelthalas,1129,hunter,marksmanship,30,13,17
Kánnah,ragnaros,1126,hunter,marksmanship,120,63,57
Clockwörk,sargeras,1125,hunter,marksmanship,21,13,8
Tiofil,goldrinn,1124,hunter,marksmanship,24,14,10
Linedalina,wyrmrest-accord,1119,hunter,marksmanship,30,14,16
Starkmeister,stormrage,1118,hunter,marksmanship,30,12,18
Wixyy,aegwynn,1114,hunter,marksmanship,58,23,35
Pikochon,illidan,1114,hunter,marksmanship,47,15,32
Mathund,gurubashi,1112,hunter,marksmanship,131,60,71
Yaboismokey,aerie-peak,1112,hunter,marksmanship,35,15,20
Grimbleneep,emerald-dream,1111,hunter,marksmanship,40,16,24
Daytrade,stormrage,1108,hunter,marksmanship,18,12,6
Repotro,drakkari,1108,hunter,marksmanship,42,14,28
Aoolfs,stormrage,1107,hunter,marksmanship,48,20,28
Halibut,quelthalas,1106,hunter,marksmanship,47,25,22
Bemaa,frostmourne,1106,hunter,marksmanship,42,21,21
Rykár,kiljaeden,1106,hunter,marksmanship,24,12,12
Huuntard,proudmoore,1104,hunter,marksmanship,29,12,17
Týrak,illidan,1100,hunter,marksmanship,24,12,12
Bentrick,altar-of-storms,1097,hunter,marksmanship,33,18,15
Udietofast,illidan,1092,hunter,marksmanship,77,31,46
Veranir,nemesis,1091,hunter,marksmanship,98,49,49
Mikeangel,hydraxis,1091,hunter,marksmanship,27,12,15
Yadír,quelthalas,1091,hunter,marksmanship,66,29,37
Malo,dragonmaw,1090,hunter,marksmanship,30,16,14
Angelacross,azralon,1087,hunter,marksmanship,54,26,28
Sitaelh,quelthalas,1082,hunter,marksmanship,30,17,13
Maxwel,sargeras,1082,hunter,marksmanship,175,86,89
Ud,eldrethalas,1081,hunter,marksmanship,17,12,5
Lezzbow,tichondrius,1081,hunter,marksmanship,61,32,29
Redskul,azralon,1081,hunter,marksmanship,30,15,15
Ackzar,ragnaros,1077,hunter,marksmanship,76,37,39
Chetta,ragnaros,1075,hunter,marksmanship,41,14,27
Pewpow,barthilas,1072,hunter,marksmanship,60,28,32
Katebishop,nemesis,1071,hunter,marksmanship,22,12,10
Towness,kelthuzad,1067,hunter,marksmanship,48,23,25
Fartingshot,proudmoore,1065,hunter,marksmanship,35,13,22
Thoopered,korgath,1062,hunter,marksmanship,65,33,32
Thunter,kiljaeden,1060,hunter,marksmanship,24,14,10
Piloks,gallywix,1058,hunter,marksmanship,42,20,22
Imperatrix,emerald-dream,1058,hunter,marksmanship,72,25,47
Runsfromcops,sargeras,1056,hunter,marksmanship,18,11,7
Gvjellybeans,tichondrius,1056,hunter,marksmanship,18,11,7
Ryutiz,fizzcrank,1056,hunter,marksmanship,30,11,19
Orber,stormrage,1055,hunter,marksmanship,18,11,7
Redzic,tichondrius,1054,hunter,marksmanship,18,11,7
Landon,lightnings-blade,1054,hunter,marksmanship,24,11,13
Inktray,durotan,1054,hunter,marksmanship,30,11,19
Longshánks,stormrage,1052,hunter,marksmanship,24,11,13
Callenna,zuljin,1051,hunter,marksmanship,18,11,7
Shootipie,hyjal,1051,hunter,marksmanship,18,11,7
Tråppin,sargeras,1050,hunter,marksmanship,21,12,9
Blimpbooty,stormrage,1050,hunter,marksmanship,24,11,13
Balun,sargeras,1049,hunter,marksmanship,24,11,13
Vansatih,azralon,1047,hunter,marksmanship,66,27,39
Fëanora,quelthalas,1044,hunter,marksmanship,24,11,13
Sumom,darrowmere,1043,hunter,marksmanship,99,45,54
Porkerr,black-dragonflight,1040,hunter,marksmanship,48,25,23
Corruptid,moon-guard,1039,hunter,marksmanship,18,11,7
Tazent,moon-guard,1039,hunter,marksmanship,24,11,13
Deadalot,dalaran,1038,hunter,marksmanship,18,11,7
Yoimiya,thunderlord,1036,hunter,marksmanship,41,18,23
Baldor,stormrage,1036,hunter,marksmanship,66,27,39
Sartros,drakkari,1034,hunter,marksmanship,19,13,6
Huntnfizzle,dethecus,1031,hunter,marksmanship,18,11,7
Nelandris,tichondrius,1031,hunter,marksmanship,60,25,35
Vendortrash,aggramar,1029,hunter,marksmanship,24,12,12
Trìggered,dark-iron,1028,hunter,marksmanship,30,13,17
Delukzin,azralon,1028,hunter,marksmanship,38,13,25
Silenciozzo,azralon,1026,hunter,marksmanship,42,17,25
Emeri,winterhoof,1025,hunter,marksmanship,18,11,7
Wwing,frostwolf,1023,hunter,marksmanship,244,120,124
Benryats,area-52,1019,hunter,marksmanship,36,11,25
Metalstorm,draenor,1018,hunter,marksmanship,23,11,12
Madogite,azralon,1017,hunter,marksmanship,66,37,29
Flacidhunter,kelthuzad,1017,hunter,marksmanship,30,12,18
Shukucingjr,illidan,1015,hunter,marksmanship,39,23,16
Kødran,stormrage,1013,hunter,marksmanship,54,26,28
Jzander,ragnaros,1010,hunter,marksmanship,20,13,7
Thyraza,proudmoore,1010,hunter,marksmanship,24,11,13
Secure,doomhammer,1010,hunter,marksmanship,42,18,24
Triggaplease,jubeithos,1008,hunter,marksmanship,67,37,30
Killerxzxz,stormrage,1007,hunter,marksmanship,24,13,11
Aïmïng,tichondrius,1006,hunter,marksmanship,24,11,13
Salsa,hakkar,1005,hunter,marksmanship,107,39,68
Brenri,boulderfist,1003,hunter,marksmanship,30,15,15
Styles,thaurissan,1003,hunter,marksmanship,24,12,12
Torturekilla,bleeding-hollow,1003,hunter,marksmanship,54,26,28
Koonorc,dalaran,998,hunter,marksmanship,46,22,24
Kalinor,cenarius,992,hunter,marksmanship,42,18,24
Balgair,hakkar,991,hunter,marksmanship,46,24,22
Scottcrume,area-52,990,hunter,marksmanship,60,27,33
Nelay,ragnaros,988,hunter,marksmanship,23,11,12
Ritler,frostmourne,987,hunter,marksmanship,21,11,10
Myrfes,ragnaros,982,hunter,marksmanship,28,11,17
Àbyss,shandris,982,hunter,marksmanship,42,15,27
Kuramax,senjin,975,hunter,marksmanship,89,39,50
Galaxxis,bonechewer,974,hunter,marksmanship,51,26,25
Iiwii,burning-legion,969,hunter,marksmanship,19,11,8
Tiidkloul,illidan,968,hunter,marksmanship,18,12,6
Reanivan,kiljaeden,968,hunter,marksmanship,66,24,42
Drjingajanga,zuluhed,961,hunter,marksmanship,33,13,20
Hanabanana,wyrmrest-accord,960,hunter,marksmanship,12,10,2
Nainit,sargeras,960,hunter,marksmanship,18,10,8
Goonsh,tichondrius,960,hunter,marksmanship,18,10,8
Zota,frostmourne,960,hunter,marksmanship,18,10,8
Kagaramar,hellscream,960,hunter,marksmanship,21,11,10
Taumelz,sargeras,960,hunter,marksmanship,24,10,14
Sylvaa,tichondrius,960,hunter,marksmanship,30,10,20
Brewster,burning-legion,959,hunter,marksmanship,24,10,14
Ñðñdêsçrípt,frostmourne,959,hunter,marksmanship,30,10,20
Austelos,moon-guard,958,hunter,marksmanship,18,10,8
Lilnatty,area-52,958,hunter,marksmanship,27,11,16
Deadshöt,bleeding-hollow,958,hunter,marksmanship,30,10,20
Revo,darkspear,957,hunter,marksmanship,18,10,8
Zulorion,the-forgotten-coast,956,hunter,marksmanship,24,10,14
Dartháne,moon-guard,956,hunter,marksmanship,29,11,18
Chuvug,quelthalas,955,hunter,marksmanship,24,10,14
Grimcask,ragnaros,955,hunter,marksmanship,24,10,14
Klitz,lightninghoof,954,hunter,marksmanship,18,10,8
Hawkeyë,ragnaros,954,hunter,marksmanship,18,10,8
Daymanaahh,malfurion,954,hunter,marksmanship,24,10,14
Xaveco,gallywix,954,hunter,marksmanship,58,23,35
Twist,burning-legion,953,hunter,marksmanship,12,10,2
Skelyeelegno,perenolde,953,hunter,marksmanship,18,10,8
Shuweet,moon-guard,953,hunter,marksmanship,24,10,14
Damadar,tichondrius,953,hunter,marksmanship,24,10,14
Konar,nemesis,952,hunter,marksmanship,60,23,37
Verdao,stormrage,952,hunter,marksmanship,30,10,20
Moonet,amanthul,948,hunter,marksmanship,18,10,8
Vanhe,quelthalas,947,hunter,marksmanship,18,10,8
Katnie,azralon,947,hunter,marksmanship,52,25,27
Milktoker,tichondrius,947,hunter,marksmanship,24,10,14
Globlauncher,tichondrius,946,hunter,marksmanship,18,10,8
Moktarg,archimonde,936,hunter,marksmanship,29,11,18
Lazygnome,azshara,934,hunter,marksmanship,23,11,12
Zarely,frostmourne,932,hunter,marksmanship,24,10,14
Nachtcloverr,stormrage,931,hunter,marksmanship,63,27,36
Jamzlol,frostmourne,930,hunter,marksmanship,23,14,9
Thundershots,tichondrius,927,hunter,marksmanship,62,23,39
Adbéélitø,ragnaros,926,hunter,marksmanship,36,18,18
Silhouettes,barthilas,923,hunter,marksmanship,27,13,14
Ontarget,cairne,921,hunter,marksmanship,76,34,42
Wael,perenolde,920,hunter,marksmanship,29,10,19
Viciosa,bleeding-hollow,914,hunter,marksmanship,30,16,14
Dairoxd,drakkari,912,hunter,marksmanship,29,14,15
Zievieda,hellscream,910,hunter,marksmanship,24,12,12
Lauannÿ,gallywix,910,hunter,marksmanship,118,55,63
Blaws,tichondrius,906,hunter,marksmanship,27,10,17
Onehitrip,illidan,904,hunter,marksmanship,90,38,52
Flechá,illidan,900,hunter,marksmanship,17,10,7
Desolateone,nazgrel,900,hunter,marksmanship,42,21,21
Déadlyshot,tichondrius,900,hunter,marksmanship,77,36,41
Cazadorelite,tichondrius,900,hunter,marksmanship,59,16,43
Huntercotoco,azralon,894,hunter,marksmanship,47,24,23
Amonerhunter,bleeding-hollow,893,hunter,marksmanship,24,11,13
Fourkayiv,azgalor,889,hunter,marksmanship,41,18,23
Brenogam,azralon,884,hunter,marksmanship,33,16,17
Yamanashi,black-dragonflight,884,hunter,marksmanship,114,55,59
Ganeva,sargeras,883,hunter,marksmanship,30,14,16
Alleessa,goldrinn,883,hunter,marksmanship,54,21,33
Jetlinx,thrall,881,hunter,marksmanship,21,12,9
Nightwatch,kelthuzad,877,hunter,marksmanship,18,10,8
Rödrigö,azralon,876,hunter,marksmanship,30,14,16
Thaendra,moon-guard,865,hunter,marksmanship,23,11,12
Karazuba,ragnaros,865,hunter,marksmanship,89,33,56
Eratichunt,illidan,864,hunter,marksmanship,18,9,9
Xonios,frostwolf,864,hunter,marksmanship,24,9,15
Hunghang,frostmourne,864,hunter,marksmanship,24,9,15
Singletap,barthilas,864,hunter,marksmanship,24,9,15
Trapkeithx,frostmourne,864,hunter,marksmanship,24,9,15
Drãgenox,quelthalas,864,hunter,marksmanship,24,9,15
Keenz,frostmourne,864,hunter,marksmanship,24,9,15
Rambot,bleeding-hollow,863,hunter,marksmanship,12,9,3
Photos,moon-guard,863,hunter,marksmanship,14,9,5
Pkn,chogall,863,hunter,marksmanship,18,9,9
Ohifren,proudmoore,863,hunter,marksmanship,18,9,9
Dôntlosmebro,stormrage,863,hunter,marksmanship,18,9,9
Ultrasj,malfurion,863,hunter,marksmanship,18,9,9
Telånnas,illidan,863,hunter,marksmanship,18,9,9
Torrthack,area-52,863,hunter,marksmanship,18,9,9
Dayanier,ragnaros,863,hunter,marksmanship,18,9,9
Bacchantress,tichondrius,863,hunter,marksmanship,18,9,9
Junglejam,elune,863,hunter,marksmanship,24,9,15
Nosmoke,kargath,863,hunter,marksmanship,24,9,15
Vivaswan,tichondrius,863,hunter,marksmanship,24,9,15
Fangs,arthas,862,hunter,marksmanship,12,9,3
Ðaybreâker,tichondrius,862,hunter,marksmanship,12,9,3
Airpodpro,emerald-dream,862,hunter,marksmanship,12,9,3
Mídnîght,azralon,862,hunter,marksmanship,18,9,9
Syrach,area-52,862,hunter,marksmanship,18,9,9
Audioannie,thrall,862,hunter,marksmanship,18,9,9
Varrinda,wyrmrest-accord,862,hunter,marksmanship,24,9,15
Insgesicht,proudmoore,862,hunter,marksmanship,24,9,15
Snipastyle,twisting-nether,861,hunter,marksmanship,30,9,21
Twistedtawl,area-52,860,hunter,marksmanship,18,9,9
Junka,bleeding-hollow,860,hunter,marksmanship,18,9,9
Illt,blackrock,860,hunter,marksmanship,18,9,9
Loyalrely,tichondrius,859,hunter,marksmanship,18,9,9
Arzant,quelthalas,858,hunter,marksmanship,12,9,3
Coldhunger,uldum,857,hunter,marksmanship,12,9,3
Trikshot,magtheridon,855,hunter,marksmanship,18,10,8
Herroo,thrall,855,hunter,marksmanship,30,9,21
Azx,tichondrius,851,hunter,marksmanship,18,9,9
Avindal,greymane,850,hunter,marksmanship,18,9,9
Iililillilii,tichondrius,848,hunter,marksmanship,28,12,16
Kazzanval,sargeras,843,hunter,marksmanship,18,9,9
Zettl,eredar,843,hunter,marksmanship,78,32,46
Jvmr,azralon,842,hunter,marksmanship,38,17,21
Arbeis,area-52,841,hunter,marksmanship,42,11,31
Apochuntz,greymane,839,hunter,marksmanship,24,11,13
Zelanst,illidan,838,hunter,marksmanship,18,9,9
Muggzzy,malygos,824,hunter,marksmanship,18,9,9
Iamtotoro,area-52,809,hunter,marksmanship,28,9,19
Richihunt,ragnaros,802,hunter,marksmanship,32,10,22
Ciils,sargeras,798,hunter,marksmanship,22,9,13
Fian,lightnings-blade,797,hunter,marksmanship,22,9,13
Skyloss,illidan,775,hunter,marksmanship,42,12,30
Tamsynn,stormrage,769,hunter,marksmanship,54,15,39
Entrapment,stormrage,768,hunter,marksmanship,12,8,4
Doves,wyrmrest-accord,768,hunter,marksmanship,12,8,4
Ashx,nemesis,768,hunter,marksmanship,12,8,4
Ragshunt,stormrage,768,hunter,marksmanship,12,8,4
Achillez,bleeding-hollow,768,hunter,marksmanship,18,8,10
Soul,sargeras,768,hunter,marksmanship,24,8,16
Tharlor,aegwynn,768,hunter,marksmanship,24,8,16
Woeisyou,stormrage,768,hunter,marksmanship,24,8,16
Civvo,dalaran,768,hunter,marksmanship,24,8,16
Shootybooty,arygos,768,hunter,marksmanship,24,8,16
Suyesh,tichondrius,767,hunter,marksmanship,12,8,4
Cimotsw,stormrage,767,hunter,marksmanship,12,8,4
Huntnmaster,thrall,767,hunter,marksmanship,12,8,4
Mensita,quelthalas,767,hunter,marksmanship,18,8,10
Zengrin,quelthalas,767,hunter,marksmanship,18,8,10
Cufless,proudmoore,767,hunter,marksmanship,18,8,10
Ravanskull,burning-blade,767,hunter,marksmanship,18,8,10
Xtina,drakkari,767,hunter,marksmanship,18,8,10
Aewyn,malganis,767,hunter,marksmanship,18,8,10
Vileplumè,stormrage,767,hunter,marksmanship,18,8,10
Yory,tol-barad,767,hunter,marksmanship,18,8,10
Runethkape,kelthuzad,767,hunter,marksmanship,18,8,10
Waqz,tichondrius,767,hunter,marksmanship,18,8,10
Diertz,area-52,767,hunter,marksmanship,18,8,10
Rickshaw,frostmourne,767,hunter,marksmanship,18,8,10
Tarah,lightbringer,767,hunter,marksmanship,24,8,16
Mööky,frostmourne,766,hunter,marksmanship,12,8,4
Saltz,tichondrius,766,hunter,marksmanship,12,8,4
Ramdy,quelthalas,766,hunter,marksmanship,12,8,4
Zèd,azralon,766,hunter,marksmanship,18,8,10
Ladright,altar-of-storms,766,hunter,marksmanship,18,8,10
Trochillidae,dragonmaw,766,hunter,marksmanship,18,8,10
Raiku,aggramar,766,hunter,marksmanship,18,8,10
Noeffort,frostmourne,766,hunter,marksmanship,18,8,10
Deathspot,thrall,766,hunter,marksmanship,18,8,10
Zindula,malganis,766,hunter,marksmanship,19,8,11
Kìkìjiki,emerald-dream,765,hunter,marksmanship,18,8,10
Kòng,quelthalas,765,hunter,marksmanship,24,8,16
Daahm,malganis,765,hunter,marksmanship,25,8,17
Taynen,azralon,764,hunter,marksmanship,18,8,10
Myciri,proudmoore,764,hunter,marksmanship,18,8,10
Rattrap,proudmoore,763,hunter,marksmanship,24,8,16
Kluako,stormreaver,762,hunter,marksmanship,12,8,4
Deathwynd,malfurion,762,hunter,marksmanship,12,8,4
Thisguÿ,arthas,762,hunter,marksmanship,18,8,10
Sorid,medivh,761,hunter,marksmanship,12,8,4
Enonoa,thunderlord,760,hunter,marksmanship,12,8,4
Porta,zuljin,757,hunter,marksmanship,16,9,7
Heapstack,stormrage,753,hunter,marksmanship,18,8,10
Huntercry,ragnaros,751,hunter,marksmanship,12,8,4
Niceshotboi,azgalor,751,hunter,marksmanship,24,8,16
Arshuntica,blackrock,750,hunter,marksmanship,18,8,10
Lynnì,khadgar,750,hunter,marksmanship,18,8,10
Returners,emerald-dream,750,hunter,marksmanship,18,8,10
Xshadowdemon,korgath,749,hunter,marksmanship,12,8,4
Aksalaz,area-52,749,hunter,marksmanship,17,8,9
Belieli,ragnaros,740,hunter,marksmanship,22,8,14
Mackin,maelstrom,740,hunter,marksmanship,24,8,16
Volga,haomarush,733,hunter,marksmanship,16,8,8
Mayohater,sargeras,714,hunter,marksmanship,33,9,24
Andalora,malganis,703,hunter,marksmanship,11,8,3
Llachiip,zuljin,702,hunter,marksmanship,17,9,8
Dasvydanya,illidan,702,hunter,marksmanship,19,9,10
Qúin,frostmourne,702,hunter,marksmanship,23,9,14
Fizzleshot,malganis,699,hunter,marksmanship,18,8,10
Felkrozzul,kalecgos,672,hunter,marksmanship,9,8,1
Neyith,frostmourne,672,hunter,marksmanship,12,7,5
Hyrus,shadowmoon,672,hunter,marksmanship,12,7,5
Snipezone,kelthuzad,672,hunter,marksmanship,12,7,5
Goosejuicer,emerald-dream,672,hunter,marksmanship,12,7,5
Keboks,alleria,672,hunter,marksmanship,12,7,5
Kaptincrunch,skywall,672,hunter,marksmanship,12,7,5
Neverhunter,azralon,672,hunter,marksmanship,12,7,5
Mms,frostmourne,672,hunter,marksmanship,12,7,5
Kaznik,ragnaros,672,hunter,marksmanship,12,7,5
Ehnub,stormrage,672,hunter,marksmanship,12,7,5
Mörgoth,quelthalas,672,hunter,marksmanship,12,7,5
Shotmaster,tichondrius,672,hunter,marksmanship,12,7,5
Enty,khazgoroth,672,hunter,marksmanship,12,7,5
Kookh,area-52,672,hunter,marksmanship,12,7,5
Drupert,tichondrius,672,hunter,marksmanship,12,7,5
Mochaxd,stormrage,672,hunter,marksmanship,14,7,7
Tirrill,malganis,672,hunter,marksmanship,18,7,11
Jimryl,illidan,672,hunter,marksmanship,18,7,11
Focusfire,khazgoroth,672,hunter,marksmanship,18,7,11
Ping,tol-barad,672,hunter,marksmanship,18,7,11
Bombanodos,kelthuzad,672,hunter,marksmanship,18,7,11
Bigzane,darkspear,672,hunter,marksmanship,24,7,17
Datbigbowdoe,illidan,672,hunter,marksmanship,24,7,17
Larree,kelthuzad,671,hunter,marksmanship,12,7,5
Getnukedbud,emerald-dream,671,hunter,marksmanship,12,7,5
Kneecrippler,proudmoore,671,hunter,marksmanship,12,7,5
Geraldson,proudmoore,671,hunter,marksmanship,12,7,5
Vatits,dalaran,671,hunter,marksmanship,12,7,5
Neoxbow,wyrmrest-accord,671,hunter,marksmanship,12,7,5
Ocui,ragnaros,671,hunter,marksmanship,12,7,5
Ethne,garithos,671,hunter,marksmanship,12,7,5
Xhare,stormrage,671,hunter,marksmanship,12,7,5
Zhions,ragnaros,671,hunter,marksmanship,12,7,5
Sunyourmom,proudmoore,671,hunter,marksmanship,12,7,5
Texploto,area-52,671,hunter,marksmanship,12,7,5
Dest,azralon,671,hunter,marksmanship,12,7,5
Hannover,ragnaros,671,hunter,marksmanship,12,7,5
Jackrandall,frostmourne,671,hunter,marksmanship,18,7,11
Lyricly,lightbringer,671,hunter,marksmanship,18,7,11
Löbo,quelthalas,671,hunter,marksmanship,18,7,11
Glittergun,sargeras,671,hunter,marksmanship,18,7,11
Sáns,sargeras,671,hunter,marksmanship,18,7,11
Kalizra,quelthalas,671,hunter,marksmanship,18,7,11
Obsol,hyjal,671,hunter,marksmanship,18,7,11
Kaeuljua,tichondrius,671,hunter,marksmanship,18,7,11
Såvagehunter,malganis,671,hunter,marksmanship,18,7,11
Toesgoes,thrall,671,hunter,marksmanship,18,7,11
Schbaltz,tichondrius,671,hunter,marksmanship,18,7,11
Navagee,tichondrius,671,hunter,marksmanship,18,7,11
Wij,turalyon,671,hunter,marksmanship,24,8,16
Cullowhee,proudmoore,671,hunter,marksmanship,23,7,16
Soljer,kiljaeden,671,hunter,marksmanship,24,7,17
Temara,icecrown,671,hunter,marksmanship,24,7,17
Valane,ragnaros,671,hunter,marksmanship,24,7,17
Untermench,tichondrius,670,hunter,marksmanship,12,7,5
Joogeenda,kaelthas,670,hunter,marksmanship,12,7,5
Clutchxx,tichondrius,670,hunter,marksmanship,12,7,5
Kìngjaybroni,sargeras,670,hunter,marksmanship,12,7,5
Cócaine,tichondrius,670,hunter,marksmanship,19,8,11
Gagau,stormrage,670,hunter,marksmanship,18,7,11
Wolfyyxx,stormrage,670,hunter,marksmanship,18,7,11
Westbrooke,illidan,669,hunter,marksmanship,18,7,11
Lilzoomer,barthilas,668,hunter,marksmanship,12,7,5
Minzuki,drakkari,668,hunter,marksmanship,18,7,11
Ues,shuhalo,667,hunter,marksmanship,13,7,6
Mahty,stormrage,665,hunter,marksmanship,12,7,5
Infamousorc,chogall,654,hunter,marksmanship,23,7,16
Righthole,area-52,640,hunter,marksmanship,22,7,15
Mawlotov,barthilas,639,hunter,marksmanship,23,7,16
Øparin,azralon,633,hunter,marksmanship,11,7,4
Grukar,tichondrius,623,hunter,marksmanship,17,7,10
Muerteaterry,ragnaros,618,hunter,marksmanship,18,8,10
Mesiauzx,stormrage,618,hunter,marksmanship,22,9,13
Butimbutters,bleeding-hollow,617,hunter,marksmanship,22,8,14
Dsizzle,tichondrius,617,hunter,marksmanship,26,8,18
Maveraxx,executus,616,hunter,marksmanship,21,7,14
Kushminion,zuljin,607,hunter,marksmanship,14,9,5
Typh,saurfang,607,hunter,marksmanship,11,7,4
Ekzoo,tichondrius,607,hunter,marksmanship,11,7,4
Hokutoxx,tichondrius,607,hunter,marksmanship,20,7,13
Krossx,thrall,591,hunter,marksmanship,12,7,5
Póra,stormrage,582,hunter,marksmanship,17,8,9
Drewshot,sargeras,576,hunter,marksmanship,6,6,0
Summerrain,illidan,576,hunter,marksmanship,6,6,0
Deejwithabow,frostmourne,576,hunter,marksmanship,6,6,0
Donotrunaway,ragnaros,576,hunter,marksmanship,12,6,6
Elmozz,thrall,576,hunter,marksmanship,12,6,6
Rizzbow,dalvengyr,576,hunter,marksmanship,12,6,6
Mhd,stormrage,576,hunter,marksmanship,12,6,6
Êlautismo,wyrmrest-accord,576,hunter,marksmanship,12,6,6
Juwannaaim,lethon,576,hunter,marksmanship,12,6,6
Mochigelato,kelthuzad,576,hunter,marksmanship,12,6,6
Murderone,undermine,576,hunter,marksmanship,12,6,6
Groomme,area-52,576,hunter,marksmanship,12,6,6
Xohzabu,wyrmrest-accord,576,hunter,marksmanship,12,6,6
Nerfmeplezz,area-52,576,hunter,marksmanship,12,6,6
Zaamsa,ragnaros,576,hunter,marksmanship,12,6,6
Birbwatcher,moon-guard,576,hunter,marksmanship,12,6,6
Ozarks,kiljaeden,576,hunter,marksmanship,12,6,6
Pulso,illidan,576,hunter,marksmanship,12,6,6
Aoti,nerzhul,576,hunter,marksmanship,12,6,6
Kimbaa,tichondrius,576,hunter,marksmanship,12,6,6
Aurzwraek,proudmoore,576,hunter,marksmanship,12,6,6
Laurenx,illidan,576,hunter,marksmanship,12,6,6
Throre,bleeding-hollow,576,hunter,marksmanship,12,6,6
Gritzix,frostmourne,576,hunter,marksmanship,12,6,6
Mdizzly,zuljin,576,hunter,marksmanship,12,6,6
Gugubird,proudmoore,576,hunter,marksmanship,12,6,6
Cù,frostmourne,576,hunter,marksmanship,12,6,6
Spanerd,moon-guard,576,hunter,marksmanship,12,6,6
Kyudo,moon-guard,576,hunter,marksmanship,12,6,6
Rangêr,frostmourne,576,hunter,marksmanship,12,6,6
Vicecheney,illidan,576,hunter,marksmanship,12,6,6
Nightgecko,elune,576,hunter,marksmanship,12,6,6
Ssds,sargeras,576,hunter,marksmanship,12,6,6
Vårelse,sargeras,576,hunter,marksmanship,12,6,6
Tokez,moon-guard,576,hunter,marksmanship,14,6,8
Cloudzbow,moon-guard,576,hunter,marksmanship,18,6,12
Skillkiting,area-52,576,hunter,marksmanship,18,6,12
Bigkolache,zuljin,576,hunter,marksmanship,18,6,12
Shcrimps,proudmoore,576,hunter,marksmanship,18,6,12
Gnometoprace,illidan,576,hunter,marksmanship,18,6,12
Aaggros,sargeras,576,hunter,marksmanship,18,6,12
Tandope,sargeras,576,hunter,marksmanship,18,6,12
Shotfromhell,sargeras,576,hunter,marksmanship,21,6,15
Jônathan,tichondrius,576,hunter,marksmanship,24,6,18
Cerrundan,icecrown,575,hunter,marksmanship,12,6,6
Lagginwaggin,azgalor,575,hunter,marksmanship,12,6,6
Kazes,stormrage,575,hunter,marksmanship,12,6,6
Cobrag,tichondrius,575,hunter,marksmanship,12,6,6
Thehunturd,dalaran,575,hunter,marksmanship,12,6,6
Sylvaethas,lightninghoof,575,hunter,marksmanship,12,6,6
Alinûs,stormrage,575,hunter,marksmanship,12,6,6
Hobbës,kelthuzad,575,hunter,marksmanship,12,6,6
Doug,illidan,575,hunter,marksmanship,12,6,6
Brosk,drakthul,575,hunter,marksmanship,12,6,6
Taphh,moon-guard,575,hunter,marksmanship,12,6,6
Aragörnn,azralon,575,hunter,marksmanship,12,6,6
Littlespike,queldorei,575,hunter,marksmanship,12,6,6
Projectilez,sargeras,575,hunter,marksmanship,12,6,6
Gresga,dalaran,575,hunter,marksmanship,12,6,6
Chipsncheese,korgath,575,hunter,marksmanship,12,6,6
Dirtbagchaz,illidan,575,hunter,marksmanship,12,6,6
Silentzkill,tichondrius,575,hunter,marksmanship,12,6,6
Onlyfeìgns,frostmourne,575,hunter,marksmanship,12,6,6
Lahyanhou,azjolnerub,575,hunter,marksmanship,18,6,12
Tazmaniak,gorefiend,575,hunter,marksmanship,18,6,12
Ididntdoit,blackhand,575,hunter,marksmanship,18,6,12
Youngpo,thunderlord,575,hunter,marksmanship,18,6,12
Arbclimbs,frostmane,575,hunter,marksmanship,18,6,12
Marcusrarnis,zuljin,574,hunter,marksmanship,12,6,6
Zeddunn,stormrage,574,hunter,marksmanship,12,6,6
Hildihunt,stormrage,574,hunter,marksmanship,12,6,6
Folgadoo,azralon,574,hunter,marksmanship,18,6,12
Blåckhat,frostmourne,573,hunter,marksmanship,30,6,24
Recebaa,barthilas,572,hunter,marksmanship,12,6,6
Jogoran,thunderlord,571,hunter,marksmanship,12,6,6
Àlëxx,aegwynn,571,hunter,marksmanship,24,6,18
Scoundrella,sargeras,570,hunter,marksmanship,12,6,6
Tungles,tichondrius,570,hunter,marksmanship,24,6,18
Lennfear,frostmourne,568,hunter,marksmanship,18,6,12
Vaelanor,destromath,566,hunter,marksmanship,12,6,6
Beastmodeqt,blood-furnace,566,hunter,marksmanship,18,6,12
Nickhell,azralon,565,hunter,marksmanship,12,6,6
Neef,mannoroth,564,hunter,marksmanship,24,6,18
Ratspit,chogall,557,hunter,marksmanship,11,6,5
Erudraugdin,quelthalas,545,hunter,marksmanship,24,6,18
Gymli,destromath,543,hunter,marksmanship,11,6,5
Jaydemo,thunderhorn,527,hunter,marksmanship,17,6,11
Remixjy,burning-blade,522,hunter,marksmanship,16,7,9
Cns,tichondrius,521,hunter,marksmanship,20,7,13
Jonsnow,lightnings-blade,519,hunter,marksmanship,15,6,9
Dainsleif,perenolde,512,hunter,marksmanship,10,6,4
Pogcheddar,tichondrius,511,hunter,marksmanship,14,6,8
Tracershot,malganis,511,hunter,marksmanship,14,6,8
Gemky,ragnaros,511,hunter,marksmanship,14,6,8
Cplski,kelthuzad,511,hunter,marksmanship,16,6,10
Stepbroski,moon-guard,510,hunter,marksmanship,14,6,8
Brainzz,emerald-dream,509,hunter,marksmanship,16,7,9
Chickenzzack,tichondrius,480,hunter,marksmanship,6,5,1
Knerf,silvermoon,480,hunter,marksmanship,6,5,1
Thrandrial,smolderthorn,480,hunter,marksmanship,6,5,1
Shootandloot,zuljin,480,hunter,marksmanship,6,5,1
Kimchishotxo,tichondrius,480,hunter,marksmanship,6,5,1
Chasseür,quelthalas,480,hunter,marksmanship,6,5,1
Johhnweed,ragnaros,480,hunter,marksmanship,6,5,1
Taije,arthas,480,hunter,marksmanship,6,5,1
Zmghost,nathrezim,480,hunter,marksmanship,6,5,1
Bendotexe,stormrage,480,hunter,marksmanship,6,5,1
Qthunterr,dalaran,480,hunter,marksmanship,6,5,1
Idtrapthat,nordrassil,480,hunter,marksmanship,9,5,4
Thewïld,tichondrius,480,hunter,marksmanship,12,5,7
Ongorn,lightninghoof,480,hunter,marksmanship,12,5,7
Teaks,aggramar,480,hunter,marksmanship,12,5,7
Baehydra,frostmourne,480,hunter,marksmanship,12,5,7
Kattarry,moon-guard,480,hunter,marksmanship,12,5,7
Stephkurryz,tichondrius,480,hunter,marksmanship,12,5,7
Thejessiah,tichondrius,480,hunter,marksmanship,12,5,7
Arraza,ragnaros,480,hunter,marksmanship,12,5,7
Duckpow,frostmourne,480,hunter,marksmanship,12,5,7
Bullzeyê,kelthuzad,480,hunter,marksmanship,12,5,7
Valro,hyjal,480,hunter,marksmanship,12,5,7
Fjdominador,azralon,480,hunter,marksmanship,12,5,7
Xísa,proudmoore,480,hunter,marksmanship,12,5,7
Josyv,quelthalas,480,hunter,marksmanship,12,5,7
Soloshuffle,kelthuzad,480,hunter,marksmanship,12,5,7
Ownshot,kiljaeden,480,hunter,marksmanship,12,5,7
Qqshot,emerald-dream,480,hunter,marksmanship,12,5,7
Eldotbrod,quelthalas,480,hunter,marksmanship,12,5,7
Hunt,the-underbog,480,hunter,marksmanship,12,5,7
Jaywuz,tichondrius,480,hunter,marksmanship,12,5,7
Lagshots,kelthuzad,480,hunter,marksmanship,12,5,7
Snoplow,illidan,480,hunter,marksmanship,12,5,7
Kyujin,ragnaros,480,hunter,marksmanship,12,5,7
Boomheadshot,blood-furnace,480,hunter,marksmanship,12,5,7
Rorijii,tichondrius,480,hunter,marksmanship,12,5,7
Hyü,hyjal,480,hunter,marksmanship,12,5,7
Stingyshot,thrall,480,hunter,marksmanship,12,5,7
Lianm,stormrage,480,hunter,marksmanship,12,5,7
Aloa,nagrand,480,hunter,marksmanship,12,5,7
Davidbowey,bonechewer,480,hunter,marksmanship,12,5,7
Omniquiver,sargeras,480,hunter,marksmanship,12,5,7
Connora,stormrage,480,hunter,marksmanship,12,5,7
Slobon,tichondrius,480,hunter,marksmanship,12,5,7
Kaelhim,warsong,480,hunter,marksmanship,12,5,7
Lilbowbigdam,emerald-dream,480,hunter,marksmanship,12,5,7
Reys,bonechewer,480,hunter,marksmanship,15,6,9
Regretful,kelthuzad,480,hunter,marksmanship,13,5,8
Hhappy,tichondrius,480,hunter,marksmanship,18,5,13
Shootybootìe,tichondrius,480,hunter,marksmanship,18,5,13
Eurekasl,ragnaros,480,hunter,marksmanship,18,5,13
Jahir,tichondrius,480,hunter,marksmanship,18,5,13
Blickys,area-52,480,hunter,marksmanship,18,5,13
Absinther,emerald-dream,480,hunter,marksmanship,18,5,13
Ikiteforfood,zuljin,480,hunter,marksmanship,18,5,13
Ownyoufast,darkspear,480,hunter,marksmanship,24,5,19
Guntrïx,stormrage,480,hunter,marksmanship,24,5,19
Runimurder,zuljin,479,hunter,marksmanship,6,5,1
Ritrune,anvilmar,479,hunter,marksmanship,6,5,1
Hishamo,aggramar,479,hunter,marksmanship,6,5,1
Lws,ragnaros,479,hunter,marksmanship,6,5,1
Globalhunter,emerald-dream,479,hunter,marksmanship,12,5,7
Peitowyn,illidan,479,hunter,marksmanship,12,5,7
Hunchback,emerald-dream,479,hunter,marksmanship,12,5,7
Ëz,ragnaros,479,hunter,marksmanship,12,5,7
Rykbad,area-52,479,hunter,marksmanship,12,5,7
Papiquezo,nagrand,479,hunter,marksmanship,12,5,7
Logonman,rexxar,479,hunter,marksmanship,12,5,7
Blurrí,area-52,479,hunter,marksmanship,12,5,7
Alluminant,gilneas,479,hunter,marksmanship,12,5,7
Momomomo,draka,479,hunter,marksmanship,12,5,7
Pathius,uldaman,479,hunter,marksmanship,12,5,7
Ohhsnaapp,blood-furnace,479,hunter,marksmanship,12,5,7
Mayhunter,ragnaros,479,hunter,marksmanship,13,5,8
Diur,ragnaros,479,hunter,marksmanship,15,5,10
Enzym,archimonde,479,hunter,marksmanship,18,5,13
Mulnaaj,zuljin,479,hunter,marksmanship,18,5,13
Ashaelyn,wyrmrest-accord,479,hunter,marksmanship,18,5,13
Seyd,barthilas,479,hunter,marksmanship,18,5,13
Guarambare,ragnaros,479,hunter,marksmanship,18,5,13
Johar,nerzhul,479,hunter,marksmanship,18,5,13
Lyssavirhus,azralon,478,hunter,marksmanship,12,5,7
Ozzoty,tol-barad,478,hunter,marksmanship,12,5,7
Damnnicebutt,borean-tundra,478,hunter,marksmanship,20,7,13
Tularac,sentinels,477,hunter,marksmanship,12,5,7
Cio,fizzcrank,477,hunter,marksmanship,12,5,7
Survival,dentarg,477,hunter,marksmanship,12,5,7
Darkmaximus,echo-isles,477,hunter,marksmanship,18,5,13
Puttry,stormrage,476,hunter,marksmanship,12,5,7
Àrsha,gallywix,475,hunter,marksmanship,12,5,7
Lanney,firetree,473,hunter,marksmanship,12,5,7
Hartman,frostwolf,473,hunter,marksmanship,18,5,13
Oorudun,hellscream,472,hunter,marksmanship,12,5,7
Raun,anvilmar,453,hunter,marksmanship,17,5,12
Againzt,tichondrius,447,hunter,marksmanship,12,6,6
Diavál,area-52,447,hunter,marksmanship,11,5,6
Zøkøtrøkø,ragnaros,446,hunter,marksmanship,22,5,17
Mukeru,stormrage,432,hunter,marksmanship,9,5,4
Jud,thunderlord,432,hunter,marksmanship,21,5,16
Wook,hyjal,431,hunter,marksmanship,11,5,6
Noriee,destromath,431,hunter,marksmanship,15,5,10
Nirika,moon-guard,416,hunter,marksmanship,10,5,5
Beatnass,cairne,384,hunter,marksmanship,6,4,2
Gunstorms,dalaran,384,hunter,marksmanship,6,4,2
Aimbôt,frostmourne,384,hunter,marksmanship,6,4,2
Côckblocked,tichondrius,384,hunter,marksmanship,6,4,2
Trapwiz,firetree,384,hunter,marksmanship,6,4,2
Seyu,tichondrius,384,hunter,marksmanship,6,4,2
Infatuatedx,moon-guard,384,hunter,marksmanship,6,4,2
Cornstalk,area-52,384,hunter,marksmanship,6,4,2
Huataran,stormrage,384,hunter,marksmanship,6,4,2
Anecko,zuljin,384,hunter,marksmanship,6,4,2
Huumpoutine,burning-blade,384,hunter,marksmanship,6,4,2
Junmuxiao,ragnaros,384,hunter,marksmanship,6,4,2
Gogey,area-52,384,hunter,marksmanship,6,4,2
Tdarknet,quelthalas,384,hunter,marksmanship,6,4,2
Llhopital,ragnaros,384,hunter,marksmanship,6,4,2
Wellerman,firetree,384,hunter,marksmanship,6,4,2
Subdue,tichondrius,384,hunter,marksmanship,6,4,2
Relapse,dreadmaul,384,hunter,marksmanship,6,4,2
Blamethenaga,sargeras,384,hunter,marksmanship,6,4,2
Swish,burning-legion,384,hunter,marksmanship,6,4,2
Malcab,tichondrius,384,hunter,marksmanship,6,4,2
Smokabonbon,eredar,384,hunter,marksmanship,6,4,2
Silvertokay,ragnaros,384,hunter,marksmanship,6,4,2
Maidán,azralon,384,hunter,marksmanship,6,4,2
Archetype,bladefist,384,hunter,marksmanship,6,4,2
Hyjix,stormrage,384,hunter,marksmanship,6,4,2
Sylos,moon-guard,384,hunter,marksmanship,6,4,2
Déwi,tichondrius,384,hunter,marksmanship,6,4,2
Frîck,bleeding-hollow,384,hunter,marksmanship,6,4,2
Cashisabeast,zuljin,384,hunter,marksmanship,6,4,2
Stfd,illidan,384,hunter,marksmanship,6,4,2
Venj,proudmoore,384,hunter,marksmanship,6,4,2
Shootbert,malganis,384,hunter,marksmanship,6,4,2
Swoljashotxp,area-52,384,hunter,marksmanship,6,4,2
Muckenfoose,frostmourne,384,hunter,marksmanship,6,4,2
Rektarrow,area-52,384,hunter,marksmanship,6,4,2
Hitemup,bleeding-hollow,384,hunter,marksmanship,6,4,2
Folf,turalyon,384,hunter,marksmanship,6,4,2
Lexodream,bleeding-hollow,384,hunter,marksmanship,6,4,2
Arteene,illidan,384,hunter,marksmanship,6,4,2
Raevon,kelthuzad,384,hunter,marksmanship,6,4,2
Bärney,frostmourne,384,hunter,marksmanship,6,4,2
Zendarae,tichondrius,384,hunter,marksmanship,6,4,2
Emilysamuels,tichondrius,384,hunter,marksmanship,6,4,2
Balaria,tichondrius,384,hunter,marksmanship,6,4,2
Hordworld,tichondrius,384,hunter,marksmanship,6,4,2
Moyria,quelthalas,384,hunter,marksmanship,6,4,2
Hyyz,proudmoore,384,hunter,marksmanship,6,4,2
Foxyevermew,tichondrius,384,hunter,marksmanship,6,4,2
Jojojobo,tichondrius,384,hunter,marksmanship,6,4,2
Oromís,dalaran,384,hunter,marksmanship,6,4,2
Elmerfuddx,terokkar,384,hunter,marksmanship,6,4,2
Malthiz,antonidas,384,hunter,marksmanship,8,4,4
Limpnoodle,nerzhul,384,hunter,marksmanship,12,4,8
Zipzyup,tichondrius,384,hunter,marksmanship,12,4,8
Skillvanas,stormrage,384,hunter,marksmanship,12,4,8
Robobop,stormrage,384,hunter,marksmanship,12,4,8
Dropflag,stormrage,384,hunter,marksmanship,12,4,8
Bowsbéforhos,stormrage,384,hunter,marksmanship,12,4,8
Kumari,lothar,384,hunter,marksmanship,12,4,8
Dmasterbiter,zuljin,384,hunter,marksmanship,12,4,8
Lilbic,bleeding-hollow,384,hunter,marksmanship,12,4,8
Sylvanâs,bleeding-hollow,384,hunter,marksmanship,12,4,8
Hywhan,stormrage,384,hunter,marksmanship,12,4,8
Ojmo,arthas,384,hunter,marksmanship,12,4,8
Trippyhunter,akama,384,hunter,marksmanship,12,4,8
Xeriife,stormrage,384,hunter,marksmanship,12,4,8
Revö,area-52,384,hunter,marksmanship,12,4,8
Ningiiwose,garona,384,hunter,marksmanship,12,4,8
Samsin,sargeras,384,hunter,marksmanship,12,4,8
Percision,bonechewer,384,hunter,marksmanship,12,4,8
Msghunter,sargeras,384,hunter,marksmanship,12,4,8
Vion,mannoroth,384,hunter,marksmanship,12,4,8
Bleedwolf,tichondrius,384,hunter,marksmanship,12,4,8
Crimsonmm,ragnaros,384,hunter,marksmanship,12,4,8
Taurenseason,sargeras,384,hunter,marksmanship,12,4,8
Enchantras,jaedenar,384,hunter,marksmanship,12,4,8
Joton,tichondrius,384,hunter,marksmanship,12,4,8
Karev,area-52,384,hunter,marksmanship,12,4,8
Ganzilla,aerie-peak,384,hunter,marksmanship,12,4,8
Emérr,drakkari,384,hunter,marksmanship,12,4,8
Shottz,blackhand,384,hunter,marksmanship,12,4,8
Junglar,eitrigg,384,hunter,marksmanship,12,4,8
Yønkøu,azralon,384,hunter,marksmanship,12,4,8
Sabo,nemesis,384,hunter,marksmanship,12,4,8
Patroclo,azralon,384,hunter,marksmanship,12,4,8
Aaron,jubeithos,384,hunter,marksmanship,12,4,8
Gstygodx,frostmourne,384,hunter,marksmanship,12,4,8
Braindeadorc,illidan,384,hunter,marksmanship,12,4,8
Mabaku,tichondrius,384,hunter,marksmanship,12,4,8
Vélos,illidan,384,hunter,marksmanship,12,4,8
Saralli,thrall,384,hunter,marksmanship,12,4,8
Crackshotzz,illidan,384,hunter,marksmanship,12,4,8
Artemisagro,greymane,384,hunter,marksmanship,12,4,8
Lánárhóádés,tichondrius,384,hunter,marksmanship,12,4,8
Ðïanä,azralon,384,hunter,marksmanship,12,4,8
Whatalexa,tichondrius,384,hunter,marksmanship,12,4,8
Bowtech,kelthuzad,384,hunter,marksmanship,13,4,9
Kiteftw,tichondrius,384,hunter,marksmanship,18,4,14
Abloodelf,zuljin,384,hunter,marksmanship,18,4,14
Peashooter,sargeras,384,hunter,marksmanship,19,4,15
Comtambisuon,frostmourne,383,hunter,marksmanship,6,4,2
Snäpträp,stormrage,383,hunter,marksmanship,6,4,2
Meriah,bleeding-hollow,383,hunter,marksmanship,6,4,2
Soulbutter,malganis,383,hunter,marksmanship,6,4,2
Dathronin,chogall,383,hunter,marksmanship,6,4,2
Getkited,tichondrius,383,hunter,marksmanship,6,4,2
Essya,frostmourne,383,hunter,marksmanship,6,4,2
Franzkafka,azralon,383,hunter,marksmanship,6,4,2
Euphylesz,garrosh,383,hunter,marksmanship,10,4,6
Juanita,laughing-skull,383,hunter,marksmanship,12,4,8
Zenwrath,illidan,383,hunter,marksmanship,12,4,8
Djpwnz,bladefist,383,hunter,marksmanship,12,4,8
Amsalja,tichondrius,383,hunter,marksmanship,12,4,8
Rottinghood,hyjal,383,hunter,marksmanship,12,4,8
Aridan,area-52,383,hunter,marksmanship,12,4,8
Shootingjaem,tichondrius,383,hunter,marksmanship,12,4,8
Brody,eitrigg,383,hunter,marksmanship,12,4,8
Mynnokyr,gallywix,383,hunter,marksmanship,12,4,8
Diacachimbaa,ragnaros,383,hunter,marksmanship,12,4,8
Zérõ,area-52,383,hunter,marksmanship,12,4,8
Fermra,dunemaul,383,hunter,marksmanship,12,4,8
Minibrö,tichondrius,383,hunter,marksmanship,12,4,8
Nevon,azralon,383,hunter,marksmanship,18,4,14
Oohuntsoo,emerald-dream,382,hunter,marksmanship,6,4,2
Rzan,fenris,382,hunter,marksmanship,6,4,2
Eaudelune,vashj,382,hunter,marksmanship,12,4,8
Twofeathers,wyrmrest-accord,381,hunter,marksmanship,12,4,8
Skatenos,tortheldrin,381,hunter,marksmanship,12,4,8
Murozz,malganis,379,hunter,marksmanship,12,4,8
Äzrael,elune,379,hunter,marksmanship,12,4,8
Venessie,moon-guard,379,hunter,marksmanship,12,4,8
Arighthunt,frostmourne,367,hunter,marksmanship,17,4,13
Hyesik,tichondrius,362,hunter,marksmanship,21,7,14
Bloodarrow,tichondrius,351,hunter,marksmanship,11,4,7
Rnger,aerie-peak,350,hunter,marksmanship,12,5,7
Trappxy,sargeras,336,hunter,marksmanship,9,4,5
Zucarita,tichondrius,330,hunter,marksmanship,9,5,4
Nubcaks,nerzhul,330,hunter,marksmanship,21,5,16
Pérséús,ragnaros,320,hunter,marksmanship,10,4,6
Stupïd,tichondrius,319,hunter,marksmanship,5,4,1
Aimian,frostmourne,319,hunter,marksmanship,8,4,4
Kazug,destromath,319,hunter,marksmanship,12,5,7
Berkhof,tichondrius,319,hunter,marksmanship,14,4,10
Dagre,the-forgotten-coast,304,hunter,marksmanship,13,4,9
Canadïan,stormrage,288,hunter,marksmanship,6,3,3
Skum,tichondrius,288,hunter,marksmanship,6,3,3
Azairxd,tichondrius,288,hunter,marksmanship,6,3,3
Tobroken,perenolde,288,hunter,marksmanship,6,3,3
Weegnomie,wyrmrest-accord,288,hunter,marksmanship,6,3,3
Trænquility,tichondrius,288,hunter,marksmanship,6,3,3
Uc,khadgar,288,hunter,marksmanship,6,3,3
Racoon,spinebreaker,288,hunter,marksmanship,6,3,3
Wonshawt,tichondrius,288,hunter,marksmanship,6,3,3
Brumbuh,tichondrius,288,hunter,marksmanship,6,3,3
Vashra,stormrage,288,hunter,marksmanship,6,3,3
Eatmybow,nemesis,288,hunter,marksmanship,6,3,3
Mikey,exodar,288,hunter,marksmanship,6,3,3
Chootembro,thunderlord,288,hunter,marksmanship,6,3,3
Wannakill,stormrage,288,hunter,marksmanship,6,3,3
Vinksy,sargeras,288,hunter,marksmanship,6,3,3
Silvershot,emerald-dream,288,hunter,marksmanship,6,3,3
Traphouse,blackrock,288,hunter,marksmanship,6,3,3
Stupedhunter,tichondrius,288,hunter,marksmanship,6,3,3
Sosaho,sargeras,288,hunter,marksmanship,6,3,3
Javoj,drakkari,288,hunter,marksmanship,6,3,3
Cyboreg,stormrage,288,hunter,marksmanship,6,3,3
Dranel,nordrassil,288,hunter,marksmanship,6,3,3
Bamfhunt,darkspear,288,hunter,marksmanship,6,3,3
Muffhuntér,blackrock,288,hunter,marksmanship,6,3,3
Starsabov,emerald-dream,288,hunter,marksmanship,6,3,3
Mtuanwm,tichondrius,288,hunter,marksmanship,6,3,3
Physical,destromath,288,hunter,marksmanship,6,3,3
Baoßun,thrall,288,hunter,marksmanship,6,3,3
Gunshow,wyrmrest-accord,288,hunter,marksmanship,6,3,3
Bloodyman,korgath,288,hunter,marksmanship,6,3,3
Tìnker,stormrage,288,hunter,marksmanship,6,3,3
Zym,the-forgotten-coast,288,hunter,marksmanship,6,3,3
Waldrom,arathor,288,hunter,marksmanship,6,3,3
Grimdrakk,zuljin,288,hunter,marksmanship,6,3,3
Xtremesnipez,frostmourne,288,hunter,marksmanship,6,3,3
Alliestrasza,azralon,288,hunter,marksmanship,6,3,3
Iannieht,illidan,288,hunter,marksmanship,6,3,3
Perfectcrit,area-52,288,hunter,marksmanship,6,3,3
Sabanna,proudmoore,288,hunter,marksmanship,6,3,3
Daggétt,zuljin,288,hunter,marksmanship,6,3,3
Dandogg,tichondrius,288,hunter,marksmanship,6,3,3
Carot,dalaran,288,hunter,marksmanship,6,3,3
Allondra,proudmoore,288,hunter,marksmanship,6,3,3
Bernelli,kelthuzad,288,hunter,marksmanship,6,3,3
Tichong,tichondrius,288,hunter,marksmanship,6,3,3
Buzzkiller,sargeras,288,hunter,marksmanship,6,3,3
Worewolf,lightninghoof,288,hunter,marksmanship,6,3,3
Goatshots,lightninghoof,288,hunter,marksmanship,6,3,3
Konungr,zuljin,288,hunter,marksmanship,6,3,3
Antily,kelthuzad,288,hunter,marksmanship,6,3,3
Rivs,detheroc,288,hunter,marksmanship,6,3,3
Plastera,zuljin,288,hunter,marksmanship,6,3,3
Ligmubhole,queldorei,288,hunter,marksmanship,6,3,3
Ÿöskë,tichondrius,288,hunter,marksmanship,6,3,3
Auset,aegwynn,288,hunter,marksmanship,6,3,3
Eforas,ragnaros,288,hunter,marksmanship,6,3,3
Ropivacaine,illidan,288,hunter,marksmanship,6,3,3
Maxifier,tichondrius,288,hunter,marksmanship,6,3,3
Halosucks,sargeras,288,hunter,marksmanship,6,3,3
Wolfmilkers,illidan,288,hunter,marksmanship,6,3,3
Ròllinafatty,dark-iron,288,hunter,marksmanship,6,3,3
Kynigi,bleeding-hollow,288,hunter,marksmanship,6,3,3
Wasteyou,tichondrius,288,hunter,marksmanship,6,3,3
Kansolly,tichondrius,288,hunter,marksmanship,6,3,3
Kormas,illidan,288,hunter,marksmanship,6,3,3
Sereom,frostmourne,288,hunter,marksmanship,6,3,3
Luckynoodlle,frostmourne,288,hunter,marksmanship,6,3,3
Candîce,moon-guard,288,hunter,marksmanship,6,3,3
Exabyssus,bleeding-hollow,288,hunter,marksmanship,6,3,3
Zeonas,tichondrius,288,hunter,marksmanship,6,3,3
Madjango,illidan,288,hunter,marksmanship,6,3,3
Casadora,dark-iron,288,hunter,marksmanship,6,3,3
Internade,frostmourne,288,hunter,marksmanship,6,3,3
Evilslaug,tichondrius,288,hunter,marksmanship,6,3,3
Humiliation,mugthol,288,hunter,marksmanship,6,3,3
Deepbowjob,sargeras,288,hunter,marksmanship,6,3,3
Gorhound,tichondrius,288,hunter,marksmanship,6,3,3
Cloakedninja,illidan,288,hunter,marksmanship,6,3,3
Khasu,ragnaros,288,hunter,marksmanship,6,3,3
Thugbeast,tichondrius,288,hunter,marksmanship,6,3,3
Playnogames,moon-guard,288,hunter,marksmanship,6,3,3
Kong,tichondrius,288,hunter,marksmanship,6,3,3
Innerhunt,aegwynn,288,hunter,marksmanship,6,3,3
Arithrawn,area-52,288,hunter,marksmanship,6,3,3
Chimpx,moon-guard,288,hunter,marksmanship,6,3,3
Ytsejammer,eonar,288,hunter,marksmanship,6,3,3
Inked,frostmourne,288,hunter,marksmanship,6,3,3
Fruitenveg,frostmourne,288,hunter,marksmanship,6,3,3
Triggamikê,tichondrius,288,hunter,marksmanship,6,3,3
Wolftracer,sargeras,288,hunter,marksmanship,6,3,3
Hawkeyees,ragnaros,288,hunter,marksmanship,6,3,3
Krelas,eldrethalas,288,hunter,marksmanship,6,3,3
Zzackchicken,tichondrius,288,hunter,marksmanship,6,3,3
Sindain,bloodscalp,288,hunter,marksmanship,6,3,3
Tetz,kelthuzad,288,hunter,marksmanship,6,3,3
Kallindo,sargeras,288,hunter,marksmanship,6,3,3
Kaitoo,tichondrius,288,hunter,marksmanship,6,3,3
Tugh,maiev,288,hunter,marksmanship,6,3,3
Chapushoot,ragnaros,288,hunter,marksmanship,6,3,3
Blakespace,area-52,288,hunter,marksmanship,6,3,3
Quondo,boulderfist,288,hunter,marksmanship,6,3,3
Tajo,sargeras,288,hunter,marksmanship,6,3,3
Keliara,dunemaul,288,hunter,marksmanship,6,3,3
Mojopojo,tichondrius,288,hunter,marksmanship,12,4,8
Segfault,korgath,288,hunter,marksmanship,10,3,7
Snigskytte,dreadmaul,288,hunter,marksmanship,11,3,8
Prpl,sargeras,288,hunter,marksmanship,15,4,11
Sliperysaly,tichondrius,288,hunter,marksmanship,12,3,9
Zeedii,dalaran,288,hunter,marksmanship,12,3,9
Hefty,azuremyst,288,hunter,marksmanship,12,3,9
Alyzza,sargeras,288,hunter,marksmanship,12,3,9
Ryhew,emerald-dream,288,hunter,marksmanship,12,3,9
Blarck,shattered-halls,288,hunter,marksmanship,12,3,9
Oua,queldorei,288,hunter,marksmanship,12,3,9
Peña,trollbane,288,hunter,marksmanship,12,3,9
Skywrecker,bleeding-hollow,288,hunter,marksmanship,12,3,9
Gustavitch,executus,288,hunter,marksmanship,12,3,9
Fatehunter,bleeding-hollow,288,hunter,marksmanship,12,3,9
Sparkco,area-52,288,hunter,marksmanship,12,3,9
Drysst,tichondrius,288,hunter,marksmanship,12,3,9
Strixx,emerald-dream,288,hunter,marksmanship,12,3,9
Boltflux,nemesis,288,hunter,marksmanship,12,3,9
Shablagoosh,zuljin,288,hunter,marksmanship,12,3,9
Xsparkys,kargath,288,hunter,marksmanship,12,3,9
Princssdaizy,zuljin,288,hunter,marksmanship,12,3,9
Exiun,sargeras,288,hunter,marksmanship,12,3,9
Wadadly,malganis,288,hunter,marksmanship,12,3,9
Shifted,quelthalas,288,hunter,marksmanship,12,3,9
Hatara,quelthalas,288,hunter,marksmanship,12,3,9
Tmd,thrall,288,hunter,marksmanship,12,3,9
Blaisian,frostmourne,288,hunter,marksmanship,12,3,9
Aerefix,frostmourne,288,hunter,marksmanship,12,3,9
Lumbygoblin,illidan,288,hunter,marksmanship,13,3,10
Huntdawgg,illidan,288,hunter,marksmanship,18,3,15
Winstônwolf,spinebreaker,288,hunter,marksmanship,18,3,15
Demolitions,kelthuzad,288,hunter,marksmanship,18,3,15
Lapelada,ragnaros,287,hunter,marksmanship,6,3,3
Slayemz,barthilas,287,hunter,marksmanship,6,3,3
Steelfeather,hellscream,287,hunter,marksmanship,6,3,3
Multicereal,quelthalas,287,hunter,marksmanship,6,3,3
Downtimes,illidan,287,hunter,marksmanship,6,3,3
Drâgônâr,stormrage,287,hunter,marksmanship,6,3,3
Ghazzghkuull,ragnaros,287,hunter,marksmanship,6,3,3
Lulaladraun,azralon,287,hunter,marksmanship,12,3,9
Divinee,undermine,287,hunter,marksmanship,12,3,9
Tarbabies,mannoroth,287,hunter,marksmanship,12,3,9
Darthwillie,cenarius,287,hunter,marksmanship,12,3,9
Bumbow,tichondrius,287,hunter,marksmanship,12,3,9
Lorelåii,tichondrius,286,hunter,marksmanship,6,3,3
Axtlas,moonrunner,286,hunter,marksmanship,6,3,3
Irishnia,bleeding-hollow,286,hunter,marksmanship,6,3,3
Weirdjeff,alexstrasza,286,hunter,marksmanship,6,3,3
Aeclpysis,dark-iron,281,hunter,marksmanship,12,5,7
Mythman,area-52,255,hunter,marksmanship,14,4,10
Setepalms,azralon,239,hunter,marksmanship,5,3,2
Brorc,kul-tiras,239,hunter,marksmanship,5,3,2
Glôck,dalaran,239,hunter,marksmanship,11,3,8
Knowtraps,area-52,234,hunter,marksmanship,7,4,3
Druskritag,moon-guard,234,hunter,marksmanship,10,4,6
Demongirl,arathor,231,hunter,marksmanship,25,4,21
Almighty,trollbane,229,hunter,marksmanship,29,6,23
Downworlder,darkspear,223,hunter,marksmanship,8,3,5
Andrømeda,frostmourne,208,hunter,marksmanship,7,3,4
Lamb,undermine,202,hunter,marksmanship,11,4,7
Farverr,area-52,192,hunter,marksmanship,4,3,1
Traitorously,daggerspine,192,hunter,marksmanship,9,3,6
Ramchi,burning-blade,192,hunter,marksmanship,6,2,4
Sogeki,kelthuzad,192,hunter,marksmanship,6,2,4
Muscletooth,moon-guard,192,hunter,marksmanship,6,2,4
Mtq,thrall,192,hunter,marksmanship,6,2,4
Gadorim,kelthuzad,192,hunter,marksmanship,6,2,4
Salvatiel,stormrage,192,hunter,marksmanship,6,2,4
Lulafourdedo,stormrage,192,hunter,marksmanship,6,2,4
Shoccka,thrall,192,hunter,marksmanship,6,2,4
Blowedazchit,bonechewer,192,hunter,marksmanship,6,2,4
Deletedyou,tichondrius,192,hunter,marksmanship,6,2,4
Áppóló,spinebreaker,192,hunter,marksmanship,6,2,4
Lorgor,eonar,192,hunter,marksmanship,6,2,4
Blury,tichondrius,192,hunter,marksmanship,6,2,4
Inurah,malganis,192,hunter,marksmanship,6,2,4
Desdee,icecrown,192,hunter,marksmanship,6,2,4
Zhona,moon-guard,192,hunter,marksmanship,6,2,4
Erebor,malganis,192,hunter,marksmanship,6,2,4
Thiccshawts,moon-guard,192,hunter,marksmanship,6,2,4
Tus,tichondrius,192,hunter,marksmanship,6,2,4
Fleshfeast,tichondrius,192,hunter,marksmanship,6,2,4
Lukara,darkspear,192,hunter,marksmanship,6,2,4
Bstic,quelthalas,192,hunter,marksmanship,6,2,4
Bôdon,illidan,192,hunter,marksmanship,6,2,4
Xpyroshot,area-52,192,hunter,marksmanship,6,2,4
Kahtniss,quelthalas,192,hunter,marksmanship,6,2,4
Hideontrap,malganis,192,hunter,marksmanship,6,2,4
Geeshot,area-52,192,hunter,marksmanship,6,2,4
Commonbuck,area-52,192,hunter,marksmanship,6,2,4
Àngèl,malganis,192,hunter,marksmanship,6,2,4
Pumpydumpy,malganis,192,hunter,marksmanship,6,2,4
Ensnare,wyrmrest-accord,192,hunter,marksmanship,6,2,4
Yembohi,queldorei,192,hunter,marksmanship,6,2,4
Lanarhoades,firetree,192,hunter,marksmanship,6,2,4
Cazaaires,quelthalas,192,hunter,marksmanship,6,2,4
Hfn,stormrage,192,hunter,marksmanship,6,2,4
Bowzørx,tichondrius,192,hunter,marksmanship,6,2,4
Warsh,anubarak,192,hunter,marksmanship,6,2,4
Huntugz,frostmourne,192,hunter,marksmanship,6,2,4
Percival,firetree,192,hunter,marksmanship,6,2,4
Dikbender,tichondrius,192,hunter,marksmanship,6,2,4
Camorcaist,stormrage,192,hunter,marksmanship,6,2,4
Petmydog,aegwynn,192,hunter,marksmanship,6,2,4
Terapista,area-52,192,hunter,marksmanship,6,2,4
Tyraelias,kaelthas,192,hunter,marksmanship,6,2,4
Yonzo,area-52,192,hunter,marksmanship,6,2,4
Anilora,wyrmrest-accord,192,hunter,marksmanship,6,2,4
Whitemàne,dalaran,192,hunter,marksmanship,6,2,4
Jebote,frostmourne,192,hunter,marksmanship,6,2,4
Wartoz,dragonblight,192,hunter,marksmanship,6,2,4
Leeshaarrow,moon-guard,192,hunter,marksmanship,6,2,4
Kïwwï,tichondrius,192,hunter,marksmanship,6,2,4
Xxunderoath,frostwolf,192,hunter,marksmanship,6,2,4
Rëxx,moon-guard,192,hunter,marksmanship,6,2,4
Alssong,tichondrius,192,hunter,marksmanship,6,2,4
Penelòpe,wyrmrest-accord,192,hunter,marksmanship,6,2,4
Léfty,nagrand,192,hunter,marksmanship,6,2,4
Ctrlaltdel,gundrak,192,hunter,marksmanship,6,2,4
Huntbodom,drakkari,192,hunter,marksmanship,6,2,4
Zumythriel,stormrage,192,hunter,marksmanship,6,2,4
Nord,draka,192,hunter,marksmanship,6,2,4
Haki,gallywix,192,hunter,marksmanship,6,2,4
Córnell,tichondrius,192,hunter,marksmanship,6,2,4
Huntingyou,destromath,192,hunter,marksmanship,6,2,4
Ayrana,tichondrius,192,hunter,marksmanship,6,2,4
Yortrox,ragnaros,192,hunter,marksmanship,6,2,4
Xuxoo,nemesis,192,hunter,marksmanship,6,2,4
Stormjin,arthas,192,hunter,marksmanship,6,2,4
Otirrub,deathwing,192,hunter,marksmanship,6,2,4
Cuchulláin,area-52,192,hunter,marksmanship,6,2,4
Knator,area-52,192,hunter,marksmanship,6,2,4
Torvauk,bleeding-hollow,192,hunter,marksmanship,6,2,4
Ilîiìîìiilil,bleeding-hollow,192,hunter,marksmanship,6,2,4
Vitae,shattered-halls,192,hunter,marksmanship,6,2,4
Hárd,illidan,192,hunter,marksmanship,6,2,4
Angrypepe,bleeding-hollow,192,hunter,marksmanship,6,2,4
Cornbreadfed,gorgonnash,192,hunter,marksmanship,6,2,4
Huntkillerx,illidan,192,hunter,marksmanship,6,2,4
Dreezzy,bleeding-hollow,192,hunter,marksmanship,6,2,4
Rumnaheim,nemesis,192,hunter,marksmanship,6,2,4
Crownchild,illidan,192,hunter,marksmanship,6,2,4
Ðevil,ragnaros,192,hunter,marksmanship,6,2,4
Ragar,korialstrasz,192,hunter,marksmanship,6,2,4
Latherel,bleeding-hollow,192,hunter,marksmanship,6,2,4
Kanta,bleeding-hollow,192,hunter,marksmanship,6,2,4
Namøscä,nemesis,192,hunter,marksmanship,6,2,4
Jathriel,zuljin,192,hunter,marksmanship,6,2,4
Huntgar,earthen-ring,192,hunter,marksmanship,6,2,4
Íkíte,zuljin,192,hunter,marksmanship,6,2,4
Gotskill,lethon,192,hunter,marksmanship,6,2,4
Magvez,tichondrius,192,hunter,marksmanship,6,2,4
Symz,ragnaros,192,hunter,marksmanship,6,2,4
Ramblin,ragnaros,192,hunter,marksmanship,6,2,4
Illweedx,kiljaeden,192,hunter,marksmanship,6,2,4
Holytrap,destromath,192,hunter,marksmanship,6,2,4
Justhunter,moknathal,192,hunter,marksmanship,6,2,4
Geldyn,stormreaver,192,hunter,marksmanship,6,2,4
Doopers,kiljaeden,192,hunter,marksmanship,6,2,4
Amptx,tichondrius,192,hunter,marksmanship,6,2,4
Zaghoward,fenris,192,hunter,marksmanship,6,2,4
Cefla,illidan,192,hunter,marksmanship,6,2,4
Arantir,drakkari,192,hunter,marksmanship,6,2,4
Isitrng,aggramar,192,hunter,marksmanship,6,2,4
Sinsix,akama,192,hunter,marksmanship,6,2,4
Mohz,kiljaeden,192,hunter,marksmanship,6,2,4
Voodoohunter,blood-furnace,192,hunter,marksmanship,6,2,4
Fizzleegear,area-52,192,hunter,marksmanship,6,2,4
Sobala,azralon,192,hunter,marksmanship,6,2,4
Zackmorris,kelthuzad,192,hunter,marksmanship,6,2,4
Bloodrainia,ravencrest,192,hunter,marksmanship,6,2,4
Firskin,frostmourne,192,hunter,marksmanship,6,2,4
Skolzero,azralon,192,hunter,marksmanship,6,2,4
Jgodsslayer,tichondrius,192,hunter,marksmanship,6,2,4
Pichsolika,frostmourne,192,hunter,marksmanship,6,2,4
Stormwardenx,turalyon,192,hunter,marksmanship,6,2,4
Tarkovs,area-52,192,hunter,marksmanship,6,2,4
Pandaslayr,garrosh,192,hunter,marksmanship,6,2,4
Zeaks,emerald-dream,192,hunter,marksmanship,6,2,4
Baruz,tichondrius,192,hunter,marksmanship,6,2,4
Ðecarlis,azralon,192,hunter,marksmanship,6,2,4
Bionix,sargeras,192,hunter,marksmanship,6,2,4
Gangstashot,burning-legion,192,hunter,marksmanship,6,2,4
Bendoon,sargeras,192,hunter,marksmanship,6,2,4
Lemmiewînkzz,sargeras,192,hunter,marksmanship,6,2,4
Regerts,sargeras,192,hunter,marksmanship,6,2,4
Nubberton,sargeras,192,hunter,marksmanship,6,2,4
Thugio,sargeras,192,hunter,marksmanship,6,2,4
Kreaytion,sargeras,192,hunter,marksmanship,6,2,4
Happyhunting,sargeras,192,hunter,marksmanship,6,2,4
Mickyluvin,emerald-dream,192,hunter,marksmanship,6,2,4
Brindlë,kelthuzad,192,hunter,marksmanship,11,3,8
Sevitham,dalaran,192,hunter,marksmanship,12,2,10
Thunderox,tichondrius,192,hunter,marksmanship,12,2,10
Killdred,bonechewer,192,hunter,marksmanship,12,2,10
Zarknoth,cenarius,192,hunter,marksmanship,12,2,10
Shafttrapper,queldorei,192,hunter,marksmanship,12,2,10
Littleagu,proudmoore,192,hunter,marksmanship,12,2,10
Dojaqat,frostmourne,192,hunter,marksmanship,12,2,10
Roboputa,quelthalas,192,hunter,marksmanship,12,2,10
Warpedshots,malganis,192,hunter,marksmanship,12,2,10
Seekem,destromath,192,hunter,marksmanship,12,2,10
Sharpzy,jubeithos,192,hunter,marksmanship,12,2,10
Luvtits,bonechewer,192,hunter,marksmanship,12,2,10
Stïinck,azralon,192,hunter,marksmanship,12,2,10
Eaglesx,skullcrusher,192,hunter,marksmanship,12,2,10
Warrioress,illidan,192,hunter,marksmanship,12,2,10
Xulag,tichondrius,192,hunter,marksmanship,12,2,10
Najmoira,area-52,192,hunter,marksmanship,12,2,10
Hunterish,area-52,192,hunter,marksmanship,12,2,10
Johnwayne,alterac-mountains,192,hunter,marksmanship,12,2,10
Josthar,thrall,192,hunter,marksmanship,12,2,10
Findbind,altar-of-storms,192,hunter,marksmanship,12,2,10
Larts,fenris,192,hunter,marksmanship,12,2,10
Chinchompas,bleeding-hollow,192,hunter,marksmanship,18,2,16
Sylviannas,frostmourne,191,hunter,marksmanship,6,2,4
Wörg,elune,191,hunter,marksmanship,6,2,4
Goofyfingers,illidan,191,hunter,marksmanship,12,2,10
ßonßon,stormrage,160,hunter,marksmanship,10,2,8
Amorial,barthilas,159,hunter,marksmanship,5,2,3
Hunntard,veknilash,159,hunter,marksmanship,5,2,3
Wike,hyjal,159,hunter,marksmanship,5,2,3
Thesloott,azshara,159,hunter,marksmanship,5,2,3
Clintbartun,shadowsong,159,hunter,marksmanship,5,2,3
Ryonel,moon-guard,159,hunter,marksmanship,11,2,9
Tanneritez,bleeding-hollow,144,hunter,marksmanship,11,2,9
Dusle,azralon,138,hunter,marksmanship,8,3,5
Darthski,drenden,138,hunter,marksmanship,12,4,8
Pvrisxoxo,frostmourne,138,hunter,marksmanship,9,3,6
Ünknown,sargeras,138,hunter,marksmanship,10,3,7
Plsnobanmee,frostmourne,137,hunter,marksmanship,9,5,4
Ifeignalot,stormscale,128,hunter,marksmanship,4,2,2
Yarthax,illidan,128,hunter,marksmanship,4,2,2
Darance,sargeras,128,hunter,marksmanship,4,2,2
Lúthiel,azralon,127,hunter,marksmanship,8,2,6
Razer,anvilmar,96,hunter,marksmanship,3,2,1
Ïmprîsôñ,dalaran,96,hunter,marksmanship,3,2,1
Shootr,darkspear,96,hunter,marksmanship,3,2,1
Bensonlmn,tichondrius,96,hunter,marksmanship,9,2,7
Drakkoniss,spinebreaker,96,hunter,marksmanship,6,1,5
Wolfmastera,zuljin,96,hunter,marksmanship,6,1,5
Cowboytroy,exodar,96,hunter,marksmanship,6,1,5
Hunternao,nemesis,96,hunter,marksmanship,6,1,5
Hellcry,khadgar,96,hunter,marksmanship,6,1,5
Zirstorm,altar-of-storms,96,hunter,marksmanship,6,1,5
Keelif,arthas,96,hunter,marksmanship,6,1,5
Smackadoodlé,illidan,96,hunter,marksmanship,6,1,5
Beldhur,archimonde,96,hunter,marksmanship,6,1,5
Infinitý,zuljin,96,hunter,marksmanship,6,1,5
Traxêx,nemesis,96,hunter,marksmanship,6,1,5
Gabitoqt,gallywix,96,hunter,marksmanship,6,1,5
Jaidev,nemesis,96,hunter,marksmanship,6,1,5
Desarus,archimonde,96,hunter,marksmanship,6,1,5
Ethùg,area-52,96,hunter,marksmanship,6,1,5
Siimmplicitz,area-52,96,hunter,marksmanship,6,1,5
Ashner,illidan,96,hunter,marksmanship,6,1,5
Wellfaír,area-52,96,hunter,marksmanship,6,1,5
Vilguz,illidan,96,hunter,marksmanship,6,1,5
Hyena,kelthuzad,96,hunter,marksmanship,6,1,5
Sarutovy,kelthuzad,96,hunter,marksmanship,6,1,5
Arawnz,emerald-dream,96,hunter,marksmanship,6,1,5
Minnervva,malganis,96,hunter,marksmanship,6,1,5
Lesley,illidan,96,hunter,marksmanship,6,1,5
Boongtokes,illidan,96,hunter,marksmanship,6,1,5
Shootdogg,mannoroth,96,hunter,marksmanship,6,1,5
Laudion,quelthalas,96,hunter,marksmanship,6,1,5
Deadlyattack,barthilas,96,hunter,marksmanship,6,1,5
Artilleria,quelthalas,96,hunter,marksmanship,6,1,5
Dogtagluke,stormrage,96,hunter,marksmanship,6,1,5
Ikiteforgold,zuljin,96,hunter,marksmanship,6,1,5
Derenit,ragnaros,96,hunter,marksmanship,6,1,5
Evemae,sargeras,96,hunter,marksmanship,6,1,5
Panchovill,ragnaros,96,hunter,marksmanship,6,1,5
Mirãbel,drakkari,96,hunter,marksmanship,6,1,5
Crazyshot,drakkari,96,hunter,marksmanship,6,1,5
Pilk,daggerspine,96,hunter,marksmanship,6,1,5
Rämbow,frostmourne,96,hunter,marksmanship,6,1,5
Hopsmatei,azralon,96,hunter,marksmanship,6,1,5
Brutalhit,bonechewer,96,hunter,marksmanship,6,1,5
Cocobage,destromath,96,hunter,marksmanship,6,1,5
Garkia,hyjal,96,hunter,marksmanship,6,1,5
Exitwoundz,hyjal,96,hunter,marksmanship,6,1,5
Longshott,azralon,96,hunter,marksmanship,6,1,5
Darkarcher,hyjal,96,hunter,marksmanship,6,1,5
Necroshotz,kul-tiras,96,hunter,marksmanship,6,1,5
Faceshots,tichondrius,96,hunter,marksmanship,6,1,5
Rockehm,frostmourne,96,hunter,marksmanship,6,1,5
Seizedhunt,frostmourne,96,hunter,marksmanship,6,1,5
Shootermgavn,frostmourne,96,hunter,marksmanship,6,1,5
Nodar,quelthalas,96,hunter,marksmanship,6,1,5
Samanta,blood-furnace,96,hunter,marksmanship,6,1,5
Htcrazykofwa,tichondrius,96,hunter,marksmanship,6,1,5
Narukín,tichondrius,96,hunter,marksmanship,6,1,5
Anndaria,tichondrius,96,hunter,marksmanship,6,1,5
Fingamyquill,tichondrius,96,hunter,marksmanship,6,1,5
Rensv,frostmourne,96,hunter,marksmanship,6,1,5
Terezhunt,tichondrius,96,hunter,marksmanship,6,1,5
Insönnia,azralon,96,hunter,marksmanship,6,1,5
Biehuixin,tichondrius,96,hunter,marksmanship,6,1,5
Autaila,thunderlord,96,hunter,marksmanship,6,1,5
Solderboi,tichondrius,96,hunter,marksmanship,6,1,5
Dreygar,dawnbringer,96,hunter,marksmanship,6,1,5
Puppyghoul,malganis,96,hunter,marksmanship,6,1,5
Maquire,tichondrius,96,hunter,marksmanship,6,1,5
Zünma,tichondrius,96,hunter,marksmanship,6,1,5
Ruhak,windrunner,96,hunter,marksmanship,6,1,5
Elknut,sargeras,96,hunter,marksmanship,6,1,5
Arin,suramar,96,hunter,marksmanship,6,1,5
Blaptz,wyrmrest-accord,96,hunter,marksmanship,6,1,5
Lailyann,sargeras,96,hunter,marksmanship,6,1,5
Hovahdo,proudmoore,96,hunter,marksmanship,6,1,5
Fleshfair,kiljaeden,96,hunter,marksmanship,6,1,5
Ruvathir,wyrmrest-accord,96,hunter,marksmanship,6,1,5
Kiatus,nesingwary,96,hunter,marksmanship,6,1,5
Zral,dragonmaw,96,hunter,marksmanship,6,1,5
Clacktar,wyrmrest-accord,96,hunter,marksmanship,6,1,5
Gunwalk,azjolnerub,96,hunter,marksmanship,6,1,5
Tastysauce,wyrmrest-accord,96,hunter,marksmanship,6,1,5
Fawn,moon-guard,96,hunter,marksmanship,6,1,5
Coppersnout,wyrmrest-accord,96,hunter,marksmanship,6,1,5
Citizen,dragonmaw,96,hunter,marksmanship,6,1,5
Surfbum,lightbringer,96,hunter,marksmanship,6,1,5
Jumeog,stormscale,96,hunter,marksmanship,6,1,5
Nickaz,frostmourne,96,hunter,marksmanship,8,1,7
Bophadeaz,sargeras,96,hunter,marksmanship,12,1,11
Missedshot,frostmourne,96,hunter,marksmanship,12,1,11
Kofan,darkspear,96,hunter,marksmanship,12,1,11
Tarapandas,kilrogg,96,hunter,marksmanship,12,1,11
Hawneyduo,skullcrusher,96,hunter,marksmanship,12,1,11
Cerébro,illidan,96,hunter,marksmanship,12,1,11
Jacobsladder,illidan,96,hunter,marksmanship,12,1,11
Xalmoinmybow,illidan,96,hunter,marksmanship,12,1,11
Elanor,feathermoon,96,hunter,marksmanship,18,1,17
Strixis,blood-furnace,95,hunter,marksmanship,6,1,5
Setbackhunt,illidan,79,hunter,marksmanship,5,1,4
Trionias,malfurion,79,hunter,marksmanship,5,1,4
Dashing,magtheridon,79,hunter,marksmanship,5,1,4
Raymose,tichondrius,64,hunter,marksmanship,4,1,3
Huntsmate,tichondrius,64,hunter,marksmanship,4,1,3
Nyloc,dalvengyr,64,hunter,marksmanship,4,1,3
Killarth,quelthalas,48,hunter,marksmanship,3,1,2
Ahncheolsoo,tichondrius,42,hunter,marksmanship,11,2,9
Dapoosyx,tichondrius,31,hunter,marksmanship,2,1,1
Suntail,dalaran,2208,hunter,survival,111,58,53
Saiiph,bleeding-hollow,2169,hunter,survival,144,74,70
Cëb,stormrage,2157,hunter,survival,168,84,84
Disciple,darkspear,2152,hunter,survival,74,43,31
Cadencex,stormrage,2131,hunter,survival,135,69,66
Buffmm,kelthuzad,2130,hunter,survival,90,46,44
Hotmuscleman,tichondrius,2127,hunter,survival,74,45,29
Malukaca,azralon,2121,hunter,survival,137,69,68
Capncams,emerald-dream,2120,hunter,survival,130,68,62
Aimbotmir,zuljin,2065,hunter,survival,74,35,39
Pridefulz,stormrage,2062,hunter,survival,170,85,85
Gloomy,dark-iron,2054,hunter,survival,54,41,13
Legoelass,emerald-dream,2040,hunter,survival,191,105,86
Kansolly,tichondrius,2040,hunter,survival,105,54,51
Missedmytrap,draenor,2018,hunter,survival,60,38,22
Djtraphouse,stormrage,2013,hunter,survival,132,67,65
Ungrella,malganis,2001,hunter,survival,81,44,37
Noimnotokay,tichondrius,1992,hunter,survival,113,57,56
Wmsgs,tichondrius,1992,hunter,survival,129,63,66
Maxiam,frostmourne,1989,hunter,survival,71,37,34
Nearly,wyrmrest-accord,1987,hunter,survival,79,40,39
Koupon,tichondrius,1987,hunter,survival,95,48,47
Dijhoni,moon-guard,1985,hunter,survival,119,63,56
Veyronnx,stormrage,1980,hunter,survival,108,62,46
Hamslapper,shattered-hand,1971,hunter,survival,135,66,69
Bicmex,sargeras,1970,hunter,survival,42,29,13
Ynoit,sargeras,1968,hunter,survival,82,44,38
Pokìmane,tichondrius,1961,hunter,survival,98,62,36
Galavant,frostmourne,1960,hunter,survival,98,52,46
Ferex,tichondrius,1953,hunter,survival,57,36,21
Lèkïnhø,azralon,1953,hunter,survival,72,36,36
Foxyhood,ragnaros,1941,hunter,survival,125,67,58
Sikhunt,frostmourne,1939,hunter,survival,60,35,25
Neverturtlex,tichondrius,1929,hunter,survival,42,24,18
Aurelx,tichondrius,1920,hunter,survival,42,30,12
Dwx,bleeding-hollow,1911,hunter,survival,66,35,31
Leonilc,tichondrius,1907,hunter,survival,78,36,42
Kubu,emerald-dream,1898,hunter,survival,91,58,33
Briggsx,sargeras,1894,hunter,survival,48,26,22
Effyh,emerald-dream,1889,hunter,survival,152,79,73
Ruskö,tichondrius,1888,hunter,survival,31,20,11
Dyucol,tichondrius,1883,hunter,survival,113,65,48
Runecrossbow,barthilas,1882,hunter,survival,144,71,73
Drasen,deathwing,1874,hunter,survival,54,30,24
Bergy,thrall,1873,hunter,survival,54,30,24
Anisphia,tichondrius,1873,hunter,survival,204,109,95
Queríde,emerald-dream,1871,hunter,survival,59,41,18
Kzmo,gnomeregan,1870,hunter,survival,30,23,7
Coggenda,sargeras,1866,hunter,survival,156,88,68
Jalinhabbei,azralon,1862,hunter,survival,53,28,25
Hwslol,tichondrius,1861,hunter,survival,136,71,65
Dirtysoap,tichondrius,1861,hunter,survival,63,31,32
Covlol,illidan,1857,hunter,survival,42,21,21
Destrumz,zuljin,1855,hunter,survival,66,31,35
Notnunca,tichondrius,1850,hunter,survival,60,33,27
Ikiteforfood,zuljin,1847,hunter,survival,32,20,12
Kelarcia,moon-guard,1846,hunter,survival,65,29,36
Pylorih,area-52,1842,hunter,survival,51,35,16
Finito,bladefist,1841,hunter,survival,151,75,76
Neonjz,ragnaros,1841,hunter,survival,66,31,35
Sartel,tichondrius,1837,hunter,survival,178,92,86
Pathofsexile,tichondrius,1835,hunter,survival,123,63,60
Ssds,sargeras,1834,hunter,survival,42,26,16
Queride,area-52,1833,hunter,survival,54,27,27
Endsnear,stormrage,1830,hunter,survival,66,31,35
Gvoo,tichondrius,1829,hunter,survival,30,24,6
Exhausted,blackrock,1829,hunter,survival,90,38,52
Sobit,tichondrius,1827,hunter,survival,36,23,13
Goonsh,tichondrius,1826,hunter,survival,48,32,16
Mlemily,stormrage,1826,hunter,survival,47,31,16
Otii,tichondrius,1826,hunter,survival,126,57,69
Gabiña,tichondrius,1822,hunter,survival,232,115,117
Angrybow,ragnaros,1821,hunter,survival,36,25,11
Thoromel,wyrmrest-accord,1820,hunter,survival,66,33,33
Chimeralol,area-52,1815,hunter,survival,102,65,37
Kisuke,khaz-modan,1815,hunter,survival,54,34,20
Trapula,tichondrius,1814,hunter,survival,84,46,38
Joón,moon-guard,1808,hunter,survival,43,26,17
Jagaerz,emerald-dream,1808,hunter,survival,42,23,19
Krømatik,tichondrius,1807,hunter,survival,42,23,19
Raef,azralon,1804,hunter,survival,60,32,28
Ratonh,ragnaros,1801,hunter,survival,156,88,68
Fizzleegear,area-52,1801,hunter,survival,171,82,89
Huntmon,nemesis,1800,hunter,survival,48,31,17
Jîñßæçhïñæ,sargeras,1800,hunter,survival,66,29,37
Moroally,sargeras,1799,hunter,survival,42,25,17
Carnidon,area-52,1796,hunter,survival,193,97,96
Concur,frostmourne,1792,hunter,survival,126,65,61
Misogynistaf,tichondrius,1785,hunter,survival,34,20,14
Terapista,area-52,1783,hunter,survival,72,35,37
Leaku,illidan,1775,hunter,survival,52,34,18
Sniffler,barthilas,1772,hunter,survival,42,19,23
Percival,firetree,1770,hunter,survival,36,19,17
Acres,emerald-dream,1765,hunter,survival,66,32,34
Pathed,azralon,1761,hunter,survival,54,31,23
Woriath,quelthalas,1761,hunter,survival,96,50,46
Skàdii,tichondrius,1754,hunter,survival,91,50,41
Sensator,barthilas,1753,hunter,survival,58,33,25
Vlf,tichondrius,1753,hunter,survival,60,30,30
Shootin,frostmourne,1749,hunter,survival,42,22,20
Xyzv,tichondrius,1744,hunter,survival,36,19,17
Saltstream,tichondrius,1744,hunter,survival,96,40,56
Nishinos,tichondrius,1739,hunter,survival,170,85,85
Sylvanne,sargeras,1737,hunter,survival,42,20,22
Caiodluffy,malganis,1729,hunter,survival,60,30,30
Hibyexo,illidan,1728,hunter,survival,36,22,14
Peppancini,wyrmrest-accord,1725,hunter,survival,53,34,19
Alphaqt,dethecus,1721,hunter,survival,36,19,17
Róckzero,quelthalas,1714,hunter,survival,163,81,82
Fictìon,kelthuzad,1712,hunter,survival,35,21,14
Stevemonday,stormrage,1711,hunter,survival,96,53,43
Yeahimsad,tichondrius,1709,hunter,survival,24,18,6
Blåker,bleeding-hollow,1709,hunter,survival,72,38,34
Töxic,dalaran,1707,hunter,survival,37,25,12
Dirtysoap,sargeras,1707,hunter,survival,42,18,24
Názzul,area-52,1705,hunter,survival,30,18,12
Partz,darkspear,1702,hunter,survival,56,35,21
Scytsbow,illidan,1700,hunter,survival,48,26,22
Samcro,rivendare,1700,hunter,survival,65,33,32
Yip,moon-guard,1698,hunter,survival,39,20,19
Kyujin,ragnaros,1697,hunter,survival,102,56,46
Bbaronsamedi,darkspear,1693,hunter,survival,51,27,24
Svhunt,frostmourne,1692,hunter,survival,32,18,14
Gnarwallz,stormrage,1691,hunter,survival,60,32,28
Henhøuse,illidan,1691,hunter,survival,48,24,24
Táká,quelthalas,1689,hunter,survival,60,38,22
Knewbee,emerald-dream,1689,hunter,survival,69,37,32
Noxtis,kiljaeden,1689,hunter,survival,36,18,18
Axezul,tichondrius,1688,hunter,survival,42,23,19
Arrów,duskwood,1688,hunter,survival,36,18,18
Boogiemas,akama,1686,hunter,survival,30,20,10
Budgetben,stormrage,1682,hunter,survival,33,19,14
Truckrsaurus,tichondrius,1681,hunter,survival,87,45,42
Spinze,stormrage,1677,hunter,survival,24,18,6
Bjornwald,thrall,1675,hunter,survival,304,156,148
Shablagoosh,zuljin,1672,hunter,survival,45,23,22
Réxon,quelthalas,1672,hunter,survival,105,51,54
Snowynightt,proudmoore,1671,hunter,survival,132,65,67
Arsk,ragnaros,1670,hunter,survival,45,19,26
Ingridaniela,aegwynn,1668,hunter,survival,30,20,10
Poston,ragnaros,1666,hunter,survival,63,30,33
Crypy,illidan,1664,hunter,survival,48,24,24
Iyne,stormrage,1663,hunter,survival,24,18,6
Trapgodxo,moon-guard,1658,hunter,survival,27,19,8
Fleche,aggramar,1658,hunter,survival,30,20,10
Blackdevil,magtheridon,1656,hunter,survival,48,24,24
Ganemdar,sargeras,1653,hunter,survival,57,22,35
Ajacs,zuljin,1647,hunter,survival,35,24,11
Undien,area-52,1647,hunter,survival,60,35,25
Henroyer,quelthalas,1646,hunter,survival,30,19,11
Reeiko,ragnaros,1641,hunter,survival,36,22,14
Ryukotsu,tichondrius,1641,hunter,survival,49,24,25
Liekis,darkspear,1641,hunter,survival,60,26,34
Vigon,stormrage,1640,hunter,survival,99,53,46
Bendotexe,stormrage,1638,hunter,survival,36,21,15
Asarden,jubeithos,1637,hunter,survival,60,35,25
Killshøtß,tichondrius,1634,hunter,survival,84,43,41
Covloltrap,illidan,1633,hunter,survival,24,21,3
Vhelkan,senjin,1632,hunter,survival,36,23,13
Kaitoo,tichondrius,1632,hunter,survival,47,27,20
Nimeer,tichondrius,1632,hunter,survival,82,45,37
Tyjes,stormrage,1632,hunter,survival,45,23,22
Moartraps,zuljin,1631,hunter,survival,36,21,15
Dooper,malfurion,1628,hunter,survival,87,45,42
Dju,stormrage,1628,hunter,survival,48,23,25
Voidarrows,area-52,1626,hunter,survival,41,24,17
Warhog,wyrmrest-accord,1626,hunter,survival,61,34,27
Hazzeth,thrall,1625,hunter,survival,30,19,11
Bigbillx,tichondrius,1623,hunter,survival,30,17,13
Viòlenc,tichondrius,1621,hunter,survival,41,24,17
Skyland,tichondrius,1621,hunter,survival,60,32,28
Køjo,emerald-dream,1620,hunter,survival,50,31,19
Shooting,sargeras,1619,hunter,survival,76,44,32
Mxabyycc,tichondrius,1619,hunter,survival,54,30,24
Buffnac,tichondrius,1618,hunter,survival,42,17,25
Cuddlestomp,magtheridon,1614,hunter,survival,46,24,22
Triplethreat,bleeding-hollow,1612,hunter,survival,77,42,35
Mmx,whisperwind,1611,hunter,survival,67,40,27
Nandorius,proudmoore,1606,hunter,survival,60,29,31
Haemøphilus,area-52,1605,hunter,survival,30,18,12
Uhm,laughing-skull,1604,hunter,survival,82,47,35
Tøkÿöghøül,agamaggan,1603,hunter,survival,30,19,11
Schurk,illidan,1602,hunter,survival,120,64,56
Swordshot,moon-guard,1601,hunter,survival,85,41,44
Limpingspoon,kelthuzad,1600,hunter,survival,114,64,50
Imapacifist,barthilas,1600,hunter,survival,69,37,32
Fkurrules,frostmourne,1596,hunter,survival,103,56,47
Mckim,tichondrius,1595,hunter,survival,47,23,24
Yolloswag,tichondrius,1591,hunter,survival,72,40,32
Stylebende,tichondrius,1588,hunter,survival,42,22,20
Titanaxis,tichondrius,1588,hunter,survival,185,95,90
Noxickk,sargeras,1587,hunter,survival,30,19,11
Randël,nemesis,1582,hunter,survival,36,23,13
Soyos,sargeras,1581,hunter,survival,59,30,29
Xtina,drakkari,1577,hunter,survival,71,40,31
Helïos,drakkari,1576,hunter,survival,42,23,19
Bigiesmalls,moon-guard,1572,hunter,survival,54,28,26
Xebbec,sargeras,1571,hunter,survival,80,43,37
Drifting,bleeding-hollow,1569,hunter,survival,60,34,26
Dazarrow,burning-blade,1569,hunter,survival,41,17,24
Interleukin,frostwolf,1568,hunter,survival,173,93,80
Lenacraft,frostmourne,1568,hunter,survival,36,18,18
Arazian,stormrage,1566,hunter,survival,40,22,18
Fabfilter,tichondrius,1564,hunter,survival,40,21,19
Xenonviper,bleeding-hollow,1563,hunter,survival,66,33,33
Vinnieone,kiljaeden,1561,hunter,survival,30,20,10
Mckennagrace,tichondrius,1558,hunter,survival,54,29,25
Ripsurvival,area-52,1554,hunter,survival,40,24,16
Equilibrium,tol-barad,1554,hunter,survival,74,40,34
Berenal,moon-guard,1554,hunter,survival,144,69,75
Lfg,bleeding-hollow,1553,hunter,survival,53,31,22
Huntasaurus,saurfang,1553,hunter,survival,66,32,34
Kimbaa,tichondrius,1552,hunter,survival,48,23,25
Nicochan,senjin,1551,hunter,survival,66,28,38
Viólenc,tichondrius,1548,hunter,survival,36,18,18
Kurnos,hyjal,1547,hunter,survival,24,18,6
Krouno,ragnaros,1543,hunter,survival,36,18,18
Dephobius,azralon,1540,hunter,survival,71,37,34
Mateko,amanthul,1538,hunter,survival,44,21,23
Trapdaddyx,thrall,1534,hunter,survival,24,16,8
Garfieldbb,tichondrius,1531,hunter,survival,36,16,20
Robotwo,illidan,1529,hunter,survival,24,16,8
Viiu,sargeras,1528,hunter,survival,24,16,8
Exh,tichondrius,1527,hunter,survival,107,52,55
Pivott,wyrmrest-accord,1526,hunter,survival,186,96,90
Kukulkan,haomarush,1525,hunter,survival,123,64,59
Sativ,moknathal,1524,hunter,survival,54,27,27
Dorkins,azralon,1521,hunter,survival,75,35,40
Meowtard,kaelthas,1520,hunter,survival,66,31,35
Hildebald,moon-guard,1517,hunter,survival,58,33,25
Brewster,burning-legion,1517,hunter,survival,30,16,14
Ronnïn,proudmoore,1517,hunter,survival,42,21,21
Opsi,ragnaros,1516,hunter,survival,52,23,29
Lyler,tichondrius,1514,hunter,survival,40,23,17
Met,dentarg,1514,hunter,survival,50,24,26
Trap,vashj,1512,hunter,survival,36,21,15
Ceejaee,tichondrius,1511,hunter,survival,66,31,35
Jubulba,frostwolf,1502,hunter,survival,24,16,8
Hrywnn,azralon,1501,hunter,survival,206,114,92
Spromix,ragnaros,1500,hunter,survival,42,23,19
Pfizershot,tichondrius,1496,hunter,survival,54,28,26
Fâmôûs,tichondrius,1495,hunter,survival,36,19,17
Tharoks,tichondrius,1494,hunter,survival,54,27,27
Darkèlfo,azralon,1483,hunter,survival,64,39,25
Rooman,ragnaros,1477,hunter,survival,48,24,24
Evilfury,tichondrius,1475,hunter,survival,148,73,75
Nussyo,tichondrius,1474,hunter,survival,30,17,13
Rúdrá,area-52,1468,hunter,survival,145,76,69
Eliandriss,quelthalas,1468,hunter,survival,70,33,37
Altarare,ragnaros,1467,hunter,survival,279,135,144
Gadorim,kelthuzad,1465,hunter,survival,115,54,61
Dudemanyeah,black-dragonflight,1464,hunter,survival,106,52,54
Weedhoof,barthilas,1463,hunter,survival,60,35,25
Alby,deathwing,1459,hunter,survival,67,33,34
Kaawhii,stormrage,1457,hunter,survival,24,18,6
Kyoü,drakkari,1457,hunter,survival,64,41,23
Tuohnosaj,sargeras,1454,hunter,survival,72,33,39
Dversive,nagrand,1452,hunter,survival,33,18,15
Shadeckz,stormrage,1451,hunter,survival,80,36,44
Volkr,bleeding-hollow,1450,hunter,survival,102,51,51
Sukr,korgath,1450,hunter,survival,45,22,23
Civvo,dalaran,1447,hunter,survival,63,32,31
Legalt,tichondrius,1445,hunter,survival,68,33,35
Shtealo,ragnaros,1443,hunter,survival,60,31,29
Core,gorefiend,1442,hunter,survival,45,21,24
Cndavyjones,akama,1439,hunter,survival,30,15,15
Hunterdemond,ragnaros,1439,hunter,survival,95,47,48
Seanpennis,barthilas,1437,hunter,survival,24,15,9
Krimzus,hyjal,1436,hunter,survival,42,21,21
Jawbreakër,tichondrius,1434,hunter,survival,44,22,22
Jarhar,nesingwary,1432,hunter,survival,96,44,52
Kensho,illidan,1432,hunter,survival,36,15,21
Raiku,aggramar,1427,hunter,survival,36,17,19
Kula,haomarush,1424,hunter,survival,52,24,28
Grandpopjim,illidan,1423,hunter,survival,30,15,15
Pdg,ragnaros,1422,hunter,survival,54,31,23
Grizzlydeath,stormrage,1421,hunter,survival,54,33,21
Shinhyez,tichondrius,1419,hunter,survival,30,15,15
Soulwarden,haomarush,1417,hunter,survival,36,17,19
Huntranger,malganis,1416,hunter,survival,35,17,18
Exxonerous,sargeras,1414,hunter,survival,72,37,35
Mayamia,ragnaros,1413,hunter,survival,54,24,30
Ivansotes,quelthalas,1409,hunter,survival,39,18,21
Gildthorn,frostmourne,1406,hunter,survival,42,22,20
Aniraza,ragnaros,1404,hunter,survival,33,18,15
Audiofly,tichondrius,1400,hunter,survival,62,35,27
Darkarrow,hyjal,1399,hunter,survival,55,30,25
Rayuwa,azralon,1398,hunter,survival,85,42,43
Kenjipoo,tichondrius,1395,hunter,survival,30,15,15
Apokryph,stormrage,1394,hunter,survival,48,35,13
Zakorai,thrall,1392,hunter,survival,66,36,30
Shytshot,dalaran,1391,hunter,survival,55,26,29
Zänich,tichondrius,1387,hunter,survival,36,18,18
Toross,stormscale,1379,hunter,survival,73,29,44
Bolognã,tichondrius,1378,hunter,survival,29,15,14
Rirand,dalaran,1376,hunter,survival,53,26,27
Xfo,bleeding-hollow,1374,hunter,survival,36,23,13
Luckboy,tichondrius,1372,hunter,survival,136,69,67
Killconfirm,sargeras,1369,hunter,survival,59,24,35
Fìebs,queldorei,1368,hunter,survival,53,25,28
Navagee,tichondrius,1364,hunter,survival,47,25,22
Gichiwalrus,emerald-dream,1362,hunter,survival,72,40,32
Fallacies,moon-guard,1360,hunter,survival,120,59,61
Wetpeach,frostmourne,1357,hunter,survival,58,29,29
Gunka,illidan,1349,hunter,survival,35,17,18
Liñcoln,sargeras,1346,hunter,survival,28,15,13
Lamerpvp,tichondrius,1343,hunter,survival,18,14,4
Cocobread,stormreaver,1343,hunter,survival,96,41,55
Htniss,tichondrius,1343,hunter,survival,36,15,21
Ickstab,illidan,1342,hunter,survival,18,14,4
Tumerok,barthilas,1342,hunter,survival,24,14,10
Animityx,illidan,1340,hunter,survival,39,18,21
Champjones,senjin,1339,hunter,survival,24,14,10
Wingclippin,stormrage,1338,hunter,survival,24,16,8
Jollycraze,spirestone,1337,hunter,survival,18,14,4
Zêrø,moon-guard,1336,hunter,survival,18,14,4
Åpe,illidan,1334,hunter,survival,24,14,10
Clinteastwoo,ragnaros,1334,hunter,survival,30,14,16
Thalrae,quelthalas,1334,hunter,survival,48,22,26
Bowzørx,tichondrius,1331,hunter,survival,30,14,16
Hawkethorn,moon-guard,1331,hunter,survival,86,37,49
Pedropete,barthilas,1331,hunter,survival,36,14,22
Extremis,emerald-dream,1329,hunter,survival,42,20,22
Bigsexi,kiljaeden,1329,hunter,survival,62,27,35
Viró,sargeras,1325,hunter,survival,27,15,12
Huntardadoo,nemesis,1325,hunter,survival,29,14,15
Hankjr,thunderlord,1319,hunter,survival,59,37,22
Taiberianrex,khazgoroth,1317,hunter,survival,48,28,20
Buggyhuntz,stormrage,1317,hunter,survival,42,16,26
Zorht,ragnaros,1316,hunter,survival,152,77,75
Nippoc,aerie-peak,1314,hunter,survival,18,14,4
Chiad,kargath,1313,hunter,survival,36,22,14
Ryonel,moon-guard,1313,hunter,survival,167,81,86
Inheart,khazgoroth,1313,hunter,survival,42,16,26
Henesis,sargeras,1312,hunter,survival,42,18,24
Mypeach,frostmourne,1310,hunter,survival,60,30,30
Draban,stormrage,1305,hunter,survival,30,14,16
Bredys,quelthalas,1295,hunter,survival,42,15,27
Vilguz,illidan,1294,hunter,survival,28,14,14
Dreebizz,gorefiend,1294,hunter,survival,62,25,37
Hovahdo,proudmoore,1287,hunter,survival,35,14,21
Rogaldornn,thrall,1280,hunter,survival,47,23,24
Lashga,wyrmrest-accord,1279,hunter,survival,45,17,28
Ajira,stormrage,1277,hunter,survival,30,14,16
Vongard,wyrmrest-accord,1277,hunter,survival,52,24,28
Orgpopeyes,illidan,1275,hunter,survival,37,15,22
Vanthel,ragnaros,1274,hunter,survival,50,22,28
Nanotorque,moon-guard,1273,hunter,survival,84,44,40
Lorethor,kaelthas,1270,hunter,survival,36,15,21
Gxswow,tichondrius,1268,hunter,survival,66,30,36
Vhan,azralon,1266,hunter,survival,81,42,39
Ghuntcassh,quelthalas,1262,hunter,survival,30,18,12
Félíx,ragnaros,1251,hunter,survival,42,16,26
Skriill,tichondrius,1249,hunter,survival,48,21,27
Budika,ragnaros,1247,hunter,survival,18,13,5
Fancyox,frostmourne,1247,hunter,survival,18,13,5
Duckpow,frostmourne,1247,hunter,survival,60,24,36
Hawkem,illidan,1246,hunter,survival,24,13,11
Ariädne,sargeras,1239,hunter,survival,72,27,45
Fangtreason,sargeras,1233,hunter,survival,24,13,11
Ropivacaine,illidan,1232,hunter,survival,30,13,17
Wharble,illidan,1230,hunter,survival,24,13,11
Azx,tichondrius,1230,hunter,survival,30,13,17
Offensive,dragonmaw,1222,hunter,survival,31,14,17
Nucleosome,stormrage,1219,hunter,survival,24,13,11
Rojpube,frostmourne,1215,hunter,survival,29,13,16
Daymanaahh,malfurion,1209,hunter,survival,42,19,23
Cufless,proudmoore,1204,hunter,survival,36,13,23
Arkeryn,azralon,1203,hunter,survival,18,13,5
Firesail,kelthuzad,1199,hunter,survival,73,33,40
Rykbad,area-52,1195,hunter,survival,24,13,11
Tinsho,drakkari,1191,hunter,survival,36,17,19
Wartoz,dragonblight,1190,hunter,survival,59,40,19
Rairin,tichondrius,1190,hunter,survival,47,20,27
Bangerzx,stormrage,1185,hunter,survival,24,13,11
Awârz,drakkari,1178,hunter,survival,20,13,7
Nigthunt,quelthalas,1176,hunter,survival,27,13,14
Gruì,malganis,1168,hunter,survival,26,13,13
Kukulkán,muradin,1164,hunter,survival,28,13,15
Banai,the-underbog,1164,hunter,survival,49,17,32
Trapordie,stormrage,1162,hunter,survival,30,13,17
Gigabigly,wyrmrest-accord,1152,hunter,survival,18,12,6
Drunknachos,bleeding-hollow,1150,hunter,survival,24,12,12
Broskina,stormrage,1150,hunter,survival,24,12,12
Laralodge,stormrage,1150,hunter,survival,78,32,46
Barnbougle,sargeras,1149,hunter,survival,18,12,6
Crimsoncoast,tichondrius,1149,hunter,survival,18,12,6
Giraffetrap,zuljin,1147,hunter,survival,18,12,6
Freebeë,area-52,1147,hunter,survival,24,12,12
Rhyzen,drenden,1146,hunter,survival,18,12,6
Kekkww,hyjal,1146,hunter,survival,24,12,12
Fälke,stormrage,1146,hunter,survival,24,12,12
Arcos,emerald-dream,1138,hunter,survival,18,12,6
Xitara,stormrage,1137,hunter,survival,24,12,12
Chopsley,feathermoon,1136,hunter,survival,71,30,41
Eastera,tichondrius,1119,hunter,survival,68,30,38
Rayhuntard,tichondrius,1115,hunter,survival,23,12,11
Expskippy,darkspear,1110,hunter,survival,44,27,17
Allahakbar,ragnaros,1110,hunter,survival,30,12,18
Eithelleta,frostmourne,1106,hunter,survival,42,15,27
Kimchishotxo,tichondrius,1103,hunter,survival,23,12,11
Chicall,kalecgos,1096,hunter,survival,31,13,18
Vansatih,azralon,1080,hunter,survival,82,45,37
Lesseneth,aegwynn,1072,hunter,survival,48,20,28
Scythedom,tichondrius,1056,hunter,survival,18,11,7
Yiyixx,tichondrius,1056,hunter,survival,18,11,7
Toxarch,aggramar,1055,hunter,survival,18,11,7
Plsbepatient,wyrmrest-accord,1054,hunter,survival,18,11,7
Shakeasaurus,sargeras,1054,hunter,survival,24,11,13
Reignwolf,nemesis,1053,hunter,survival,18,11,7
Jaw,hakkar,1053,hunter,survival,18,11,7
Thoriden,amanthul,1051,hunter,survival,54,14,40
Aheefeog,proudmoore,1050,hunter,survival,21,12,9
Zhafiro,drakkari,1037,hunter,survival,24,14,10
Panm,runetotem,1034,hunter,survival,27,12,15
Akigga,arthas,1033,hunter,survival,18,11,7
Kaïmsael,kelthuzad,1016,hunter,survival,71,40,31
Gairkill,area-52,999,hunter,survival,95,50,45
Lucarcher,stormrage,988,hunter,survival,17,11,6
Thrandrial,smolderthorn,985,hunter,survival,20,11,9
Hellrayserr,azralon,970,hunter,survival,24,11,13
Virindi,barthilas,960,hunter,survival,12,10,2
Sbgrv,dalaran,960,hunter,survival,18,10,8
Chiline,frostmourne,960,hunter,survival,18,10,8
Corpo,area-52,960,hunter,survival,24,10,14
Covlolzz,illidan,960,hunter,survival,24,10,14
Emart,bloodhoof,960,hunter,survival,24,10,14
Zipzyo,tichondrius,960,hunter,survival,24,10,14
Snipin,ragnaros,960,hunter,survival,30,10,20
Kêdokî,sargeras,959,hunter,survival,12,10,2
Piñg,tichondrius,959,hunter,survival,18,10,8
Tyleraq,area-52,959,hunter,survival,18,10,8
Zizilio,kelthuzad,959,hunter,survival,18,10,8
Anêmos,ragnaros,959,hunter,survival,18,10,8
Egurl,firetree,959,hunter,survival,18,10,8
Ifoxs,bleeding-hollow,959,hunter,survival,18,10,8
Stepzback,malganis,959,hunter,survival,18,10,8
Rickybobby,warsong,959,hunter,survival,18,10,8
Plainrain,tichondrius,959,hunter,survival,18,10,8
Venoc,bleeding-hollow,959,hunter,survival,24,10,14
Downer,antonidas,958,hunter,survival,24,10,14
Kimchimaster,tichondrius,958,hunter,survival,26,10,16
Fanikita,azralon,957,hunter,survival,15,11,4
Wouow,tichondrius,957,hunter,survival,18,10,8
Huntingjutsu,kelthuzad,957,hunter,survival,18,10,8
Tempistworg,greymane,957,hunter,survival,52,25,27
Snoopinator,malganis,957,hunter,survival,24,10,14
Daréz,blackrock,956,hunter,survival,16,11,5
Figurinet,sargeras,955,hunter,survival,18,10,8
Syvarris,medivh,943,hunter,survival,17,10,7
Demtings,dark-iron,925,hunter,survival,32,11,21
Ogamì,aegwynn,923,hunter,survival,16,10,6
Lavo,borean-tundra,923,hunter,survival,25,10,15
Survïvalïst,bleeding-hollow,911,hunter,survival,17,10,7
Cybella,darkspear,910,hunter,survival,23,10,13
Narakara,stormreaver,896,hunter,survival,17,10,7
Crapshot,daggerspine,885,hunter,survival,33,10,23
Jaywaz,tichondrius,864,hunter,survival,12,9,3
Weedzy,tichondrius,864,hunter,survival,12,9,3
Hunterguyy,tichondrius,864,hunter,survival,12,9,3
Tigglyjits,tichondrius,864,hunter,survival,12,9,3
Puffcopeak,illidan,864,hunter,survival,12,9,3
Adobo,garona,864,hunter,survival,12,9,3
Desari,thunderhorn,864,hunter,survival,18,9,9
Arcobaleno,tichondrius,864,hunter,survival,18,9,9
Frêäkk,ragnaros,864,hunter,survival,21,10,11
Scottmeyers,proudmoore,864,hunter,survival,24,9,15
Sharkzooka,illidan,864,hunter,survival,24,9,15
Serpantsting,moon-guard,863,hunter,survival,18,9,9
Sarvaxagar,tichondrius,863,hunter,survival,18,9,9
Ganderion,sargeras,863,hunter,survival,21,10,11
Landscape,kiljaeden,863,hunter,survival,24,9,15
Lovoo,sargeras,862,hunter,survival,12,9,3
Vulkru,azralon,862,hunter,survival,18,9,9
Vietnrg,doomhammer,862,hunter,survival,18,9,9
Packlead,sargeras,861,hunter,survival,18,9,9
Tejodite,thrall,860,hunter,survival,24,9,15
Éygon,sargeras,860,hunter,survival,24,9,15
Zotahunterx,ragnaros,859,hunter,survival,24,9,15
Mabaku,tichondrius,858,hunter,survival,12,9,3
Nowê,azralon,857,hunter,survival,24,9,15
Obsididan,aerie-peak,855,hunter,survival,24,9,15
Prettysure,nesingwary,851,hunter,survival,25,12,13
Lisbboax,stormrage,844,hunter,survival,27,11,16
Shukucingjr,illidan,842,hunter,survival,18,9,9
Blaymorrd,senjin,839,hunter,survival,18,9,9
Jaykwan,boulderfist,829,hunter,survival,17,9,8
Elccid,tichondrius,768,hunter,survival,12,8,4
Toozz,frostmourne,768,hunter,survival,12,8,4
Árröw,arygos,768,hunter,survival,12,8,4
Iizerd,illidan,768,hunter,survival,12,8,4
Envoltorio,ragnaros,768,hunter,survival,12,8,4
Yøske,tichondrius,768,hunter,survival,12,8,4
Eain,wyrmrest-accord,768,hunter,survival,12,8,4
Anooß,tichondrius,768,hunter,survival,15,9,6
Fineye,illidan,768,hunter,survival,14,8,6
Diddycombe,stormrage,768,hunter,survival,18,8,10
Kimssis,tichondrius,768,hunter,survival,18,8,10
Madival,ragnaros,768,hunter,survival,18,8,10
Buttercocoa,kelthuzad,768,hunter,survival,18,8,10
Maxlol,stormrage,768,hunter,survival,18,8,10
Eref,sargeras,768,hunter,survival,24,8,16
Bicflop,azralon,767,hunter,survival,12,8,4
Korasaya,area-52,767,hunter,survival,18,8,10
Trixster,lethon,767,hunter,survival,18,8,10
Dogwoöd,emerald-dream,767,hunter,survival,18,8,10
Rummaker,mugthol,767,hunter,survival,18,8,10
Wakkå,mugthol,767,hunter,survival,21,9,12
Mmchode,zuljin,767,hunter,survival,24,8,16
Chokemescara,stormrage,767,hunter,survival,30,8,22
Greyh,madoran,766,hunter,survival,12,8,4
Ariran,illidan,766,hunter,survival,18,8,10
Segulah,dalaran,766,hunter,survival,18,8,10
Hunfor,anubarak,766,hunter,survival,18,8,10
Lohse,emerald-dream,765,hunter,survival,18,8,10
Loochlin,sargeras,765,hunter,survival,21,8,13
Wìllòw,khazgoroth,765,hunter,survival,24,8,16
Sterge,maiev,764,hunter,survival,18,8,10
Haumer,wyrmrest-accord,763,hunter,survival,12,8,4
Riivali,quelthalas,763,hunter,survival,24,8,16
Emiri,dalaran,763,hunter,survival,24,8,16
Querosushi,ragnaros,760,hunter,survival,18,8,10
Rensv,frostmourne,759,hunter,survival,18,8,10
Iraxium,illidan,735,hunter,survival,14,9,5
Khaoskills,thunderlord,732,hunter,survival,25,11,14
Dirtypolee,bleeding-hollow,719,hunter,survival,17,8,9
Thrakgor,wyrmrest-accord,713,hunter,survival,23,10,13
Kalgorn,emerald-dream,697,hunter,survival,16,8,8
Superiorkill,arathor,686,hunter,survival,13,8,5
Mattyhuntz,tichondrius,672,hunter,survival,12,7,5
Seratoninx,malganis,672,hunter,survival,12,7,5
Fannypacks,dragonmaw,672,hunter,survival,12,7,5
Jamesön,sargeras,672,hunter,survival,12,7,5
Vânillaice,stormrage,672,hunter,survival,12,7,5
Onécare,bleeding-hollow,672,hunter,survival,12,7,5
Ozzsimp,stormrage,672,hunter,survival,12,7,5
Endxworld,tichondrius,672,hunter,survival,12,7,5
Magvez,tichondrius,672,hunter,survival,12,7,5
Pfheign,area-52,672,hunter,survival,12,7,5
Glediator,tichondrius,672,hunter,survival,12,7,5
Huntbay,destromath,672,hunter,survival,12,7,5
Joree,medivh,672,hunter,survival,12,7,5
Twodoobies,ghostlands,672,hunter,survival,12,7,5
Trenbolone,frostmourne,672,hunter,survival,12,7,5
Zouzu,area-52,672,hunter,survival,12,7,5
Lovevv,frostmourne,672,hunter,survival,12,7,5
Negligent,sargeras,672,hunter,survival,12,7,5
Bowowner,aggramar,672,hunter,survival,12,7,5
Oronir,frostmourne,672,hunter,survival,12,7,5
Arraza,ragnaros,672,hunter,survival,12,7,5
Bombbot,zuljin,672,hunter,survival,18,7,11
Meowimadog,spinebreaker,672,hunter,survival,18,7,11
Porrainga,auchindoun,672,hunter,survival,18,7,11
Trumpmerica,illidan,672,hunter,survival,18,7,11
Pablita,drakkari,671,hunter,survival,12,7,5
Sarqis,lightbringer,671,hunter,survival,12,7,5
Ziaxel,bleeding-hollow,671,hunter,survival,12,7,5
Genocell,thunderlord,671,hunter,survival,12,7,5
Gaezangsu,tichondrius,671,hunter,survival,24,7,17
Turquesaa,wyrmrest-accord,670,hunter,survival,12,7,5
Catboikilla,altar-of-storms,639,hunter,survival,17,7,10
Cagooggo,moon-guard,638,hunter,survival,16,7,9
Rotthem,ragnaros,638,hunter,survival,20,8,12
Trappin,malganis,623,hunter,survival,11,7,4
Éshen,illidan,623,hunter,survival,11,7,4
Lartrius,bleeding-hollow,621,hunter,survival,15,8,7
Arrebol,tichondrius,608,hunter,survival,16,7,9
Primez,sargeras,607,hunter,survival,11,7,4
Crissy,crushridge,606,hunter,survival,14,7,7
Odynshowl,stormrage,605,hunter,survival,11,7,4
Drees,nerzhul,576,hunter,survival,6,6,0
Garkia,hyjal,576,hunter,survival,6,6,0
Ðevil,ragnaros,576,hunter,survival,6,6,0
Ÿöskë,tichondrius,576,hunter,survival,6,6,0
Ivanjackenov,illidan,576,hunter,survival,10,7,3
Turkshot,area-52,576,hunter,survival,12,6,6
Wezkerh,ragnaros,576,hunter,survival,12,6,6
Traponomics,stormrage,576,hunter,survival,12,6,6
Kelx,azralon,576,hunter,survival,12,6,6
Tazsic,mannoroth,576,hunter,survival,12,6,6
Carnosynn,sargeras,576,hunter,survival,12,6,6
Woeisyou,stormrage,576,hunter,survival,12,6,6
Mctrapturds,tichondrius,576,hunter,survival,12,6,6
Imbrokenlol,kiljaeden,576,hunter,survival,12,6,6
Jésús,dalaran,576,hunter,survival,12,6,6
Yoske,tichondrius,576,hunter,survival,12,6,6
Walterwhite,trollbane,576,hunter,survival,12,6,6
Drupert,tichondrius,576,hunter,survival,12,6,6
Mythfive,stormrage,576,hunter,survival,12,6,6
Amhavgun,tichondrius,576,hunter,survival,12,6,6
Zerark,kelthuzad,576,hunter,survival,13,6,7
Lahinch,darkspear,576,hunter,survival,21,7,14
Pilesofpoop,sargeras,576,hunter,survival,18,6,12
Bôwbafett,sargeras,575,hunter,survival,12,6,6
Xeiana,proudmoore,575,hunter,survival,12,6,6
Zepplin,medivh,575,hunter,survival,12,6,6
Týrak,illidan,575,hunter,survival,12,6,6
Jathriel,zuljin,575,hunter,survival,12,6,6
Vortann,proudmoore,575,hunter,survival,18,6,12
Bushytails,illidan,573,hunter,survival,18,6,12
Tyrokk,barthilas,543,hunter,survival,18,6,12
Dräkö,tichondrius,527,hunter,survival,15,7,8
Hediilyan,azralon,522,hunter,survival,16,7,9
Pxry,drenden,511,hunter,survival,11,6,5
Tmzsteezy,tichondrius,480,hunter,survival,6,5,1
Fiftyyddash,tichondrius,480,hunter,survival,6,5,1
Ewife,illidan,480,hunter,survival,6,5,1
Selenis,khadgar,480,hunter,survival,6,5,1
Gufanyaun,tichondrius,480,hunter,survival,6,5,1
Lawyerpbj,tichondrius,480,hunter,survival,6,5,1
Joeexotíc,moknathal,480,hunter,survival,6,5,1
Kanta,bleeding-hollow,480,hunter,survival,6,5,1
Jäger,zuljin,480,hunter,survival,6,5,1
Keenai,moon-guard,480,hunter,survival,6,5,1
Jonah,sargeras,480,hunter,survival,6,5,1
Grimbrew,garona,480,hunter,survival,6,5,1
Honorola,twisting-nether,480,hunter,survival,6,5,1
Poorapple,tichondrius,480,hunter,survival,6,5,1
Narukín,tichondrius,480,hunter,survival,6,5,1
Casadega,sargeras,480,hunter,survival,10,6,4
Jumpkick,azralon,480,hunter,survival,12,5,7
Elmoon,zuljin,480,hunter,survival,12,5,7
Downrange,stonemaul,480,hunter,survival,12,5,7
Goromi,tichondrius,480,hunter,survival,12,5,7
Luckione,destromath,480,hunter,survival,12,5,7
Alansho,tichondrius,480,hunter,survival,12,5,7
Minxed,sargeras,480,hunter,survival,12,5,7
Brissy,sargeras,480,hunter,survival,12,5,7
Bastÿ,area-52,480,hunter,survival,12,5,7
Mambothehunt,stormrage,480,hunter,survival,12,5,7
Mìtáng,moon-guard,480,hunter,survival,12,5,7
Firskin,frostmourne,480,hunter,survival,12,5,7
Droj,stormrage,480,hunter,survival,12,5,7
Shootnoscore,vashj,480,hunter,survival,15,6,9
Ashtron,trollbane,480,hunter,survival,18,5,13
Sealteamrick,frostmourne,479,hunter,survival,12,5,7
Belvhar,skullcrusher,479,hunter,survival,12,5,7
Villainshunt,stormrage,479,hunter,survival,12,5,7
Pastelitoz,tichondrius,479,hunter,survival,21,6,15
Calvarîam,korgath,479,hunter,survival,18,5,13
Javlinz,thrall,478,hunter,survival,10,6,4
Sitalces,ragnaros,474,hunter,survival,12,5,7
Crumpit,moon-guard,426,hunter,survival,22,6,16
Cinnybunz,malganis,415,hunter,survival,16,6,10
Rinehart,dalaran,415,hunter,survival,14,5,9
Cptx,kelthuzad,384,hunter,survival,6,4,2
Ehhee,twisting-nether,384,hunter,survival,6,4,2
Bigpets,azralon,384,hunter,survival,6,4,2
Pulso,illidan,384,hunter,survival,6,4,2
Junglefever,skywall,384,hunter,survival,6,4,2
Trapful,illidan,384,hunter,survival,6,4,2
Nastoid,area-52,384,hunter,survival,6,4,2
Ikitefordmt,zuljin,384,hunter,survival,6,4,2
Ethxx,emerald-dream,384,hunter,survival,6,4,2
Bendoon,sargeras,384,hunter,survival,6,4,2
Chasseür,quelthalas,384,hunter,survival,6,4,2
Petstun,moon-guard,384,hunter,survival,6,4,2
Litchi,illidan,384,hunter,survival,6,4,2
Swagprince,skullcrusher,384,hunter,survival,6,4,2
Spitballa,emerald-dream,384,hunter,survival,6,4,2
Virgim,kelthuzad,384,hunter,survival,6,4,2
Mokuraak,emerald-dream,384,hunter,survival,6,4,2
Pumpkinovo,tichondrius,384,hunter,survival,6,4,2
Ðfac,moon-guard,384,hunter,survival,6,4,2
Equalizér,sargeras,384,hunter,survival,6,4,2
Prêd,malganis,384,hunter,survival,6,4,2
Rankonee,area-52,384,hunter,survival,6,4,2
Huntardxo,moon-guard,384,hunter,survival,6,4,2
Pokeahuntasz,frostmourne,384,hunter,survival,6,4,2
Alfaan,moon-guard,384,hunter,survival,6,4,2
Riram,stormrage,384,hunter,survival,6,4,2
Hunterlolxd,altar-of-storms,384,hunter,survival,6,4,2
Pouncedgg,sargeras,384,hunter,survival,6,4,2
Malkuri,medivh,384,hunter,survival,6,4,2
Mameikilled,saurfang,384,hunter,survival,6,4,2
Ratherbully,tichondrius,384,hunter,survival,6,4,2
Thefanbus,tichondrius,384,hunter,survival,6,4,2
Volbz,barthilas,384,hunter,survival,6,4,2
Æßç,ragnaros,384,hunter,survival,6,4,2
Wapnonymous,mugthol,384,hunter,survival,6,4,2
Boomseed,nagrand,384,hunter,survival,6,4,2
Arrowmatic,frostmourne,384,hunter,survival,6,4,2
Thalyxion,moon-guard,384,hunter,survival,6,4,2
Hyena,kelthuzad,384,hunter,survival,9,5,4
Gunicks,illidan,384,hunter,survival,12,4,8
Braindeadorc,illidan,384,hunter,survival,12,4,8
Leftty,illidan,384,hunter,survival,12,4,8
Camfeed,illidan,384,hunter,survival,12,4,8
Àngèl,malganis,384,hunter,survival,12,4,8
Malikyr,moon-guard,384,hunter,survival,12,4,8
Golorn,malganis,384,hunter,survival,12,4,8
Michaeljfox,area-52,384,hunter,survival,12,4,8
Fâpple,stormrage,384,hunter,survival,12,4,8
Stupidgodx,tichondrius,384,hunter,survival,12,4,8
Aaggros,sargeras,384,hunter,survival,12,4,8
Keenz,frostmourne,384,hunter,survival,12,4,8
Goonlmao,hyjal,384,hunter,survival,12,4,8
Oatmeallover,stormrage,384,hunter,survival,12,4,8
Eforas,ragnaros,384,hunter,survival,12,4,8
Bambii,fizzcrank,384,hunter,survival,12,4,8
Wolfsok,norgannon,384,hunter,survival,12,4,8
Blizhunt,thunderlord,384,hunter,survival,12,4,8
Lasagnadaddy,maiev,384,hunter,survival,12,4,8
Wkx,tichondrius,384,hunter,survival,12,4,8
Cakeislife,kelthuzad,384,hunter,survival,18,4,14
Onehitrip,illidan,383,hunter,survival,6,4,2
Berzxd,stormrage,383,hunter,survival,6,4,2
Tydee,nagrand,383,hunter,survival,18,4,14
Rukkora,deathwing,382,hunter,survival,12,4,8
Platonium,stormrage,351,hunter,survival,8,5,3
Gaahl,aggramar,351,hunter,survival,8,5,3
Acidhunt,tichondrius,320,hunter,survival,16,4,12
Adamariss,stormrage,319,hunter,survival,16,4,12
Zà,sargeras,288,hunter,survival,6,3,3
Loogan,sargeras,288,hunter,survival,6,3,3
Petkd,frostmourne,288,hunter,survival,6,3,3
Hazzersk,ragnaros,288,hunter,survival,6,3,3
Seiber,quelthalas,288,hunter,survival,6,3,3
Mistrj,frostmourne,288,hunter,survival,6,3,3
Soul,sargeras,288,hunter,survival,6,3,3
Pridefulzjr,stormrage,288,hunter,survival,6,3,3
Sniperælite,korgath,288,hunter,survival,6,3,3
Twom,area-52,288,hunter,survival,6,3,3
Furipoon,stormrage,288,hunter,survival,6,3,3
Samsin,sargeras,288,hunter,survival,6,3,3
Whitemàne,dalaran,288,hunter,survival,6,3,3
Pistolon,quelthalas,288,hunter,survival,6,3,3
Cantantie,tichondrius,288,hunter,survival,6,3,3
Troglav,drakkari,288,hunter,survival,6,3,3
Badseedz,kargath,288,hunter,survival,6,3,3
Lemmetrap,illidan,288,hunter,survival,6,3,3
Ünitedi,nemesis,288,hunter,survival,6,3,3
Cuervostreet,ragnaros,288,hunter,survival,6,3,3
Slowdamage,ragnaros,288,hunter,survival,6,3,3
Rustyspork,muradin,288,hunter,survival,6,3,3
Moistbooger,emerald-dream,288,hunter,survival,6,3,3
Gorgrokk,area-52,288,hunter,survival,6,3,3
Goodtimez,sargeras,288,hunter,survival,6,3,3
Slowhunterr,tichondrius,288,hunter,survival,6,3,3
Makeastinky,malfurion,288,hunter,survival,6,3,3
Dirtymongrel,barthilas,288,hunter,survival,6,3,3
Arigon,frostmane,288,hunter,survival,6,3,3
Shootdogg,mannoroth,288,hunter,survival,6,3,3
Calidian,moon-guard,288,hunter,survival,6,3,3
Lowlore,moon-guard,288,hunter,survival,6,3,3
Trapmasterx,tichondrius,288,hunter,survival,6,3,3
Slimshadie,kiljaeden,288,hunter,survival,6,3,3
Wooftoof,frostmourne,288,hunter,survival,6,3,3
Thesniperx,sargeras,288,hunter,survival,6,3,3
Trapirl,tichondrius,288,hunter,survival,6,3,3
Fearna,destromath,288,hunter,survival,6,3,3
Spårrow,alleria,288,hunter,survival,6,3,3
Soukken,ragnaros,288,hunter,survival,6,3,3
Rûff,azralon,288,hunter,survival,6,3,3
Glockin,zuljin,288,hunter,survival,6,3,3
Hackerman,tichondrius,288,hunter,survival,6,3,3
Embaçado,bleeding-hollow,288,hunter,survival,6,3,3
Runecbow,eonar,288,hunter,survival,12,3,9
Daxar,ragnaros,288,hunter,survival,12,3,9
Kalibah,azralon,288,hunter,survival,12,3,9
Aiyanafox,moon-guard,288,hunter,survival,12,3,9
Gutshott,tichondrius,288,hunter,survival,12,3,9
Wildhùnt,tichondrius,288,hunter,survival,12,3,9
Lixniqua,tichondrius,288,hunter,survival,12,3,9
Kowabungy,tichondrius,288,hunter,survival,12,3,9
Kharñe,tichondrius,288,hunter,survival,12,3,9
Iol,blades-edge,288,hunter,survival,12,3,9
Vizkha,azralon,287,hunter,survival,6,3,3
Waylòn,moon-guard,287,hunter,survival,12,3,9
Drunkbunny,tichondrius,271,hunter,survival,11,3,8
Mokaonly,wildhammer,256,hunter,survival,8,4,4
Crèpes,bleeding-hollow,239,hunter,survival,5,3,2
Yogurtti,zuljin,239,hunter,survival,5,3,2
Violénc,tichondrius,234,hunter,survival,16,4,12
Raeshots,area-52,233,hunter,survival,15,5,10
Moscato,cenarion-circle,232,hunter,survival,14,4,10
Cumman,sargeras,208,hunter,survival,7,3,4
Rifomen,illidan,192,hunter,survival,9,3,6
Woobinman,tichondrius,192,hunter,survival,6,2,4
Dobuu,tichondrius,192,hunter,survival,6,2,4
Yukisong,bleeding-hollow,192,hunter,survival,6,2,4
Achilles,twisting-nether,192,hunter,survival,6,2,4
Gobygobbs,magtheridon,192,hunter,survival,6,2,4
Razzldazzlbb,thrall,192,hunter,survival,6,2,4
Légölás,tichondrius,192,hunter,survival,6,2,4
Sharpster,zuljin,192,hunter,survival,6,2,4
Toruhagakure,tichondrius,192,hunter,survival,6,2,4
Côckblocked,tichondrius,192,hunter,survival,6,2,4
Gunudown,haomarush,192,hunter,survival,6,2,4
Xoxono,frostmourne,192,hunter,survival,6,2,4
Imraghorn,sargeras,192,hunter,survival,6,2,4
Gomrog,gurubashi,192,hunter,survival,6,2,4
Kravern,ragnaros,192,hunter,survival,6,2,4
Harposmash,trollbane,192,hunter,survival,6,2,4
Clampula,sargeras,192,hunter,survival,6,2,4
Pint,madoran,192,hunter,survival,6,2,4
Cosmodome,daggerspine,192,hunter,survival,6,2,4
Dfnhdft,stormrage,192,hunter,survival,6,2,4
Bboo,bonechewer,192,hunter,survival,6,2,4
Araghrn,draktharon,192,hunter,survival,6,2,4
Ishotmydog,malganis,192,hunter,survival,6,2,4
Gaim,dalaran,192,hunter,survival,6,2,4
Traptations,sargeras,192,hunter,survival,6,2,4
Oattes,daggerspine,192,hunter,survival,6,2,4
Ryohlin,sargeras,192,hunter,survival,6,2,4
Sunchea,arygos,192,hunter,survival,6,2,4
Nelandris,tichondrius,192,hunter,survival,6,2,4
Zellor,wyrmrest-accord,192,hunter,survival,6,2,4
Thazen,sargeras,192,hunter,survival,6,2,4
Blackjesu,blackrock,192,hunter,survival,6,2,4
Nahzah,stormrage,192,hunter,survival,6,2,4
Saelym,arthas,192,hunter,survival,6,2,4
Slipox,sargeras,192,hunter,survival,6,2,4
Sebastian,blackhand,192,hunter,survival,6,2,4
Viio,sargeras,192,hunter,survival,6,2,4
Splewsh,area-52,192,hunter,survival,6,2,4
Zèd,azralon,192,hunter,survival,6,2,4
Eclipsie,aerie-peak,192,hunter,survival,6,2,4
Pedropete,frostmourne,192,hunter,survival,6,2,4
Rainzs,stormrage,192,hunter,survival,6,2,4
Zackèse,area-52,192,hunter,survival,6,2,4
Pooshot,kelthuzad,192,hunter,survival,6,2,4
Cio,fizzcrank,192,hunter,survival,6,2,4
Lenyuecf,proudmoore,192,hunter,survival,6,2,4
Comebacks,ragnaros,192,hunter,survival,6,2,4
Spizsnipes,malganis,192,hunter,survival,6,2,4
Gswag,malganis,192,hunter,survival,6,2,4
Qua,perenolde,192,hunter,survival,6,2,4
Rimbar,ysera,192,hunter,survival,6,2,4
Shaftgravy,area-52,192,hunter,survival,6,2,4
Trígger,azshara,192,hunter,survival,6,2,4
Shïndow,ragnaros,192,hunter,survival,6,2,4
Eekbarbadrkl,frostmourne,192,hunter,survival,6,2,4
Mirdous,moon-guard,192,hunter,survival,6,2,4
Raythør,area-52,192,hunter,survival,12,2,10
Zhona,moon-guard,192,hunter,survival,12,2,10
Linova,stormrage,192,hunter,survival,12,2,10
Skrìms,tichondrius,192,hunter,survival,12,2,10
Kaldrool,frostmourne,192,hunter,survival,12,2,10
Lawafla,area-52,138,hunter,survival,8,3,5
Xradû,dawnbringer,138,hunter,survival,9,3,6
Morganson,moon-guard,138,hunter,survival,22,4,18
Bránn,quelthalas,128,hunter,survival,4,2,2
Fenrock,cenarius,96,hunter,survival,3,2,1
Whitecake,area-52,96,hunter,survival,3,2,1
Critz,undermine,96,hunter,survival,6,1,5
Taofang,emerald-dream,96,hunter,survival,6,1,5
Fearlesarrow,suramar,96,hunter,survival,6,1,5
Kölhberg,azralon,96,hunter,survival,6,1,5
Esser,mannoroth,96,hunter,survival,6,1,5
Feignqt,illidan,96,hunter,survival,6,1,5
Floorislava,durotan,96,hunter,survival,6,1,5
Legosshi,darrowmere,96,hunter,survival,6,1,5
Feorbxl,proudmoore,96,hunter,survival,6,1,5
Killerxzxz,stormrage,96,hunter,survival,6,1,5
Nevertraps,tichondrius,96,hunter,survival,6,1,5
Shottz,aerie-peak,96,hunter,survival,6,1,5
Survbot,malganis,96,hunter,survival,6,1,5
Jîlt,aerie-peak,96,hunter,survival,6,1,5
Sobala,azralon,96,hunter,survival,6,1,5
Dusle,azralon,96,hunter,survival,6,1,5
Tezlekhan,haomarush,96,hunter,survival,6,1,5
Terrabytés,kelthuzad,96,hunter,survival,6,1,5
Bloodarrow,tichondrius,96,hunter,survival,6,1,5
Weegnomie,wyrmrest-accord,96,hunter,survival,6,1,5
Skybourne,nemesis,96,hunter,survival,6,1,5
Lammy,bleeding-hollow,96,hunter,survival,6,1,5
Elroyjetson,arthas,96,hunter,survival,6,1,5
Lance,darrowmere,96,hunter,survival,6,1,5
Montakka,illidan,79,hunter,survival,5,1,4
Luangg,tichondrius,31,hunter,survival,2,1,1
Therealpafo,tichondrius,31,hunter,survival,8,1,7
Saiiph,bleeding-hollow,2274,hunter,beastmastery,136,76,60
Sphericsnow,shuhalo,2210,hunter,beastmastery,95,51,44
Missedmytrap,agamaggan,2149,hunter,beastmastery,80,46,34
Zujo,emerald-dream,2134,hunter,beastmastery,173,89,84
Traptations,sargeras,2132,hunter,beastmastery,72,39,33
Ucl,tichondrius,2125,hunter,beastmastery,90,45,45
Eref,sargeras,2116,hunter,beastmastery,78,42,36
Wmsgs,tichondrius,2116,hunter,beastmastery,129,64,65
Studiosx,tichondrius,2105,hunter,beastmastery,88,46,42
Warpath,ursin,2088,hunter,beastmastery,114,63,51
Maiyev,quelthalas,2074,hunter,beastmastery,95,52,43
Fish,darkspear,2070,hunter,beastmastery,90,45,45
Hfn,stormrage,2058,hunter,beastmastery,70,37,33
Outz,anvilmar,2049,hunter,beastmastery,300,153,147
Pãrzival,tichondrius,2042,hunter,beastmastery,60,30,30
Manyu,tichondrius,2035,hunter,beastmastery,69,34,35
Hazzersk,ragnaros,2023,hunter,beastmastery,161,78,83
Cannondale,tichondrius,1993,hunter,beastmastery,36,21,15
Trapful,illidan,1989,hunter,beastmastery,78,40,38
Beastmunster,frostmourne,1984,hunter,beastmastery,72,34,38
Antø,tichondrius,1978,hunter,beastmastery,129,62,67
Pokìmane,tichondrius,1968,hunter,beastmastery,104,60,44
Genom,tichondrius,1957,hunter,beastmastery,336,171,165
Vëëv,proudmoore,1953,hunter,beastmastery,89,47,42
Arcobaleno,tichondrius,1952,hunter,beastmastery,89,44,45
Edarkness,gurubashi,1941,hunter,beastmastery,109,56,53
Axlee,tichondrius,1941,hunter,beastmastery,237,116,121
Zeddead,magtheridon,1935,hunter,beastmastery,142,74,68
Øverdose,ragnaros,1935,hunter,beastmastery,54,28,26
Arsk,ragnaros,1934,hunter,beastmastery,136,70,66
Zugbrained,illidan,1925,hunter,beastmastery,142,78,64
Blackathena,tichondrius,1922,hunter,beastmastery,126,65,61
Lenacraft,frostmourne,1917,hunter,beastmastery,66,41,25
Wodhunterxdd,sargeras,1915,hunter,beastmastery,70,34,36
Headshotzplz,tichondrius,1912,hunter,beastmastery,62,34,28
Mhter,tichondrius,1893,hunter,beastmastery,61,31,30
Nyxus,tichondrius,1887,hunter,beastmastery,125,63,62
Lamerpvp,tichondrius,1885,hunter,beastmastery,50,31,19
Perawantua,frostmourne,1878,hunter,beastmastery,61,35,26
Ashenga,cairne,1878,hunter,beastmastery,126,69,57
Mugiwara,frostwolf,1877,hunter,beastmastery,42,25,17
Taterballs,illidan,1873,hunter,beastmastery,72,37,35
Argryta,azralon,1872,hunter,beastmastery,47,22,25
Graar,tichondrius,1871,hunter,beastmastery,48,25,23
Notvn,illidan,1869,hunter,beastmastery,53,29,24
Lilstinstin,tichondrius,1867,hunter,beastmastery,42,23,19
Dekestei,bleeding-hollow,1867,hunter,beastmastery,65,27,38
Veevx,proudmoore,1862,hunter,beastmastery,71,46,25
Hogx,sargeras,1862,hunter,beastmastery,72,32,40
Lkw,tichondrius,1859,hunter,beastmastery,62,29,33
Nelay,ragnaros,1857,hunter,beastmastery,106,59,47
Trapandclap,tichondrius,1857,hunter,beastmastery,71,33,38
Orber,stormrage,1856,hunter,beastmastery,266,135,131
Koridelse,nemesis,1854,hunter,beastmastery,126,62,64
Somethinggo,tichondrius,1854,hunter,beastmastery,70,34,36
Faniquitinha,stormrage,1854,hunter,beastmastery,54,25,29
Ñotorious,frostmane,1852,hunter,beastmastery,53,27,26
Trappxy,sargeras,1851,hunter,beastmastery,48,27,21
Cashisabeast,zuljin,1851,hunter,beastmastery,46,25,21
Nutellacrepe,kelthuzad,1851,hunter,beastmastery,200,101,99
Nollzey,frostmourne,1847,hunter,beastmastery,45,22,23
Bolanite,illidan,1846,hunter,beastmastery,48,27,21
Bogen,nemesis,1846,hunter,beastmastery,70,38,32
Inktray,durotan,1844,hunter,beastmastery,37,22,15
Kensho,illidan,1844,hunter,beastmastery,148,71,77
Ðeatheater,tichondrius,1843,hunter,beastmastery,41,21,20
Aqq,moon-guard,1842,hunter,beastmastery,98,58,40
Monffbe,tichondrius,1842,hunter,beastmastery,60,28,32
Benay,emerald-dream,1838,hunter,beastmastery,42,28,14
Auwstin,tichondrius,1837,hunter,beastmastery,55,31,24
Bowrockobama,illidan,1836,hunter,beastmastery,69,37,32
Ârtæmïs,stormrage,1835,hunter,beastmastery,48,24,24
Sxra,area-52,1834,hunter,beastmastery,58,32,26
Mørodox,sargeras,1834,hunter,beastmastery,54,24,30
Hollymarie,nazjatar,1832,hunter,beastmastery,48,31,17
Absinther,emerald-dream,1829,hunter,beastmastery,66,41,25
Nerfthepet,blackrock,1828,hunter,beastmastery,66,42,24
Dju,stormrage,1828,hunter,beastmastery,95,51,44
Playnogames,moon-guard,1828,hunter,beastmastery,42,21,21
Negãn,tichondrius,1826,hunter,beastmastery,80,41,39
Sosaho,sargeras,1825,hunter,beastmastery,41,21,20
Sniperælite,korgath,1824,hunter,beastmastery,55,32,23
Phatshiet,anvilmar,1823,hunter,beastmastery,50,31,19
Jeffersan,illidan,1823,hunter,beastmastery,149,72,77
Zumago,tichondrius,1823,hunter,beastmastery,118,54,64
Kenshaunter,azralon,1823,hunter,beastmastery,65,28,37
Zefbaby,quelthalas,1822,hunter,beastmastery,66,31,35
Tyreu,tichondrius,1820,hunter,beastmastery,59,30,29
Torolol,tichondrius,1819,hunter,beastmastery,126,73,53
Grimrokk,malganis,1819,hunter,beastmastery,78,40,38
Songhammer,tichondrius,1818,hunter,beastmastery,82,47,35
Phayzd,sargeras,1818,hunter,beastmastery,66,34,32
Scuffedshots,tichondrius,1817,hunter,beastmastery,74,43,31
Flitt,zuljin,1815,hunter,beastmastery,36,19,17
Audeline,tichondrius,1815,hunter,beastmastery,69,33,36
Comebacks,ragnaros,1814,hunter,beastmastery,72,41,31
Goonsh,tichondrius,1813,hunter,beastmastery,40,25,15
Asukaw,barthilas,1813,hunter,beastmastery,57,28,29
Mythxplosive,ragnaros,1813,hunter,beastmastery,73,32,41
Drektorath,bleeding-hollow,1812,hunter,beastmastery,66,34,32
Logjohn,frostmourne,1811,hunter,beastmastery,40,20,20
Kybelís,dalaran,1810,hunter,beastmastery,110,61,49
Hogd,sargeras,1810,hunter,beastmastery,54,26,28
Robinhooz,illidan,1807,hunter,beastmastery,187,102,85
Wilmaßallfit,malganis,1807,hunter,beastmastery,65,29,36
Hurak,elune,1805,hunter,beastmastery,65,35,30
Swang,kiljaeden,1805,hunter,beastmastery,49,24,25
Sobewan,staghelm,1805,hunter,beastmastery,92,42,50
Twopumphunt,tichondrius,1804,hunter,beastmastery,30,19,11
Kytan,shadowmoon,1804,hunter,beastmastery,168,82,86
Sarutobi,black-dragonflight,1804,hunter,beastmastery,66,29,37
Lenalena,tichondrius,1803,hunter,beastmastery,59,33,26
Kabalaku,moon-guard,1802,hunter,beastmastery,130,72,58
Warcher,azralon,1802,hunter,beastmastery,60,32,28
Hg,illidan,1800,hunter,beastmastery,38,25,13
Kangarookyle,illidan,1800,hunter,beastmastery,96,58,38
Shafttrapper,queldorei,1800,hunter,beastmastery,119,64,55
Fernn,illidan,1800,hunter,beastmastery,94,48,46
Funkyjunk,arthas,1800,hunter,beastmastery,72,35,37
Easonl,tichondrius,1795,hunter,beastmastery,113,48,65
Pathofsexile,tichondrius,1783,hunter,beastmastery,93,43,50
Xgoh,sargeras,1782,hunter,beastmastery,42,22,20
Liarael,illidan,1779,hunter,beastmastery,95,46,49
Hunterphil,hyjal,1777,hunter,beastmastery,66,39,27
Mckim,tichondrius,1775,hunter,beastmastery,48,28,20
Kyló,sargeras,1774,hunter,beastmastery,54,26,28
Zå,dalaran,1772,hunter,beastmastery,63,33,30
Quietqt,ragnaros,1770,hunter,beastmastery,106,54,52
Savagerko,illidan,1766,hunter,beastmastery,57,27,30
Tytonic,bleeding-hollow,1765,hunter,beastmastery,54,28,26
Skywvlker,illidan,1764,hunter,beastmastery,65,29,36
Perffect,sargeras,1763,hunter,beastmastery,57,24,33
Infinit,onyxia,1761,hunter,beastmastery,64,27,37
Yucca,drenden,1760,hunter,beastmastery,36,20,16
Spizsnipes,malganis,1756,hunter,beastmastery,48,24,24
Tracershot,malganis,1754,hunter,beastmastery,83,49,34
Datbigbowdoe,illidan,1752,hunter,beastmastery,36,23,13
Tembaktytyd,barthilas,1751,hunter,beastmastery,49,24,25
Fockewulf,dragonmaw,1750,hunter,beastmastery,90,40,50
Airpodpro,emerald-dream,1747,hunter,beastmastery,36,21,15
Cuchulláin,area-52,1744,hunter,beastmastery,114,59,55
Wodhunterxdd,tichondrius,1743,hunter,beastmastery,26,19,7
Madbéê,tichondrius,1741,hunter,beastmastery,41,19,22
Austelos,moon-guard,1738,hunter,beastmastery,71,38,33
Livelovelaff,tichondrius,1736,hunter,beastmastery,48,26,22
Deathtomyfoe,sargeras,1735,hunter,beastmastery,54,21,33
Pineapplees,tichondrius,1733,hunter,beastmastery,54,29,25
Dahmer,greymane,1732,hunter,beastmastery,62,29,33
Melov,frostmourne,1730,hunter,beastmastery,64,30,34
Kidao,emerald-dream,1729,hunter,beastmastery,54,30,24
Skysmile,tichondrius,1726,hunter,beastmastery,42,24,18
Krunkz,frostmourne,1724,hunter,beastmastery,53,33,20
Turtlegirl,tichondrius,1724,hunter,beastmastery,41,20,21
Reparcero,quelthalas,1723,hunter,beastmastery,42,20,22
Bootydoo,illidan,1721,hunter,beastmastery,124,64,60
Twixzorz,boulderfist,1716,hunter,beastmastery,60,28,32
Survivalists,kelthuzad,1715,hunter,beastmastery,30,22,8
Lucki,blades-edge,1715,hunter,beastmastery,60,34,26
Acres,emerald-dream,1714,hunter,beastmastery,27,19,8
Çute,moon-guard,1714,hunter,beastmastery,48,29,19
Revalay,emerald-dream,1711,hunter,beastmastery,54,32,22
Edelyysa,arthas,1711,hunter,beastmastery,180,89,91
Raymose,tichondrius,1709,hunter,beastmastery,40,20,20
Flanzo,illidan,1708,hunter,beastmastery,48,25,23
Shablagoosh,zuljin,1706,hunter,beastmastery,37,25,12
Sbplayshunt,akama,1706,hunter,beastmastery,48,19,29
Parnicyon,frostmourne,1705,hunter,beastmastery,164,90,74
Hyjax,darkspear,1701,hunter,beastmastery,43,26,17
Killshøtß,tichondrius,1701,hunter,beastmastery,65,30,35
Fatalshots,bonechewer,1699,hunter,beastmastery,42,24,18
Wodunaz,stormrage,1698,hunter,beastmastery,71,45,26
Thtswap,moon-guard,1697,hunter,beastmastery,36,26,10
Nobito,quelthalas,1694,hunter,beastmastery,109,60,49
Jfkd,sargeras,1694,hunter,beastmastery,52,21,31
Diegoshotz,zuljin,1689,hunter,beastmastery,46,23,23
Shadowfangs,tichondrius,1689,hunter,beastmastery,66,31,35
Cresselia,drakkari,1686,hunter,beastmastery,53,29,24
Fabbs,frostmourne,1686,hunter,beastmastery,52,26,26
Biehuixin,tichondrius,1685,hunter,beastmastery,50,27,23
Kenpachie,jubeithos,1684,hunter,beastmastery,29,20,9
Lilskill,lightnings-blade,1682,hunter,beastmastery,30,18,12
Sniper,area-52,1680,hunter,beastmastery,133,64,69
Kapukapu,illidan,1679,hunter,beastmastery,30,18,12
Silverbite,garona,1678,hunter,beastmastery,92,51,41
Coopshot,darkspear,1675,hunter,beastmastery,69,40,29
Saiiphz,bleeding-hollow,1675,hunter,beastmastery,40,22,18
Illsugoi,frostwolf,1675,hunter,beastmastery,93,46,47
Tuân,azgalor,1674,hunter,beastmastery,36,23,13
Alaurys,moon-guard,1674,hunter,beastmastery,35,18,17
Bowreckage,malganis,1673,hunter,beastmastery,66,27,39
Facerolled,area-52,1670,hunter,beastmastery,75,45,30
Lemmetrap,illidan,1667,hunter,beastmastery,30,18,12
Koalahunter,area-52,1667,hunter,beastmastery,76,31,45
Junglefever,skywall,1664,hunter,beastmastery,34,20,14
Hokutoxx,tichondrius,1663,hunter,beastmastery,61,25,36
Warrccjr,steamwheedle-cartel,1661,hunter,beastmastery,35,18,17
Cw,gorefiend,1660,hunter,beastmastery,36,20,16
Dj,arygos,1658,hunter,beastmastery,36,21,15
Squeekin,sargeras,1657,hunter,beastmastery,27,22,5
Showmakerc,proudmoore,1656,hunter,beastmastery,77,35,42
Gufanyaun,tichondrius,1654,hunter,beastmastery,34,18,16
Gumbro,malganis,1653,hunter,beastmastery,72,43,29
Rndx,sargeras,1653,hunter,beastmastery,46,20,26
Sylviai,hyjal,1652,hunter,beastmastery,77,40,37
Kwinoah,zuljin,1652,hunter,beastmastery,174,84,90
Mukbangbj,terenas,1651,hunter,beastmastery,78,42,36
Tyrokk,barthilas,1649,hunter,beastmastery,45,21,24
Eastwood,tichondrius,1648,hunter,beastmastery,92,41,51
Camhaanes,area-52,1646,hunter,beastmastery,119,67,52
Ipickmynose,tichondrius,1645,hunter,beastmastery,45,27,18
Mauklindaufe,fenris,1644,hunter,beastmastery,85,43,42
Mlemily,stormrage,1643,hunter,beastmastery,63,36,27
Cachín,ragnaros,1642,hunter,beastmastery,54,26,28
Montakka,illidan,1638,hunter,beastmastery,48,26,22
Andalora,malganis,1638,hunter,beastmastery,61,27,34
Elad,tichondrius,1637,hunter,beastmastery,60,35,25
Publicpooper,tichondrius,1637,hunter,beastmastery,36,21,15
Energiser,stormrage,1637,hunter,beastmastery,58,29,29
Dreygar,dawnbringer,1636,hunter,beastmastery,105,55,50
Mcclintock,executus,1636,hunter,beastmastery,41,21,20
Drakarth,khazgoroth,1635,hunter,beastmastery,47,22,25
Kahll,azralon,1634,hunter,beastmastery,54,24,30
Montano,area-52,1633,hunter,beastmastery,32,22,10
Lexandr,tichondrius,1633,hunter,beastmastery,90,51,39
Airhunt,thrall,1632,hunter,beastmastery,42,19,23
Axxll,tichondrius,1629,hunter,beastmastery,55,25,30
Dpdóugh,illidan,1628,hunter,beastmastery,106,55,51
Dirtymongrel,barthilas,1628,hunter,beastmastery,72,35,37
Cocoapuffs,cenarius,1627,hunter,beastmastery,36,17,19
Vox,tichondrius,1626,hunter,beastmastery,30,20,10
Onemoreshot,bleeding-hollow,1626,hunter,beastmastery,84,44,40
Layloww,thrall,1626,hunter,beastmastery,36,18,18
Ryûkø,quelthalas,1626,hunter,beastmastery,48,23,25
Phiyuh,stormrage,1624,hunter,beastmastery,60,36,24
Liadrelle,proudmoore,1624,hunter,beastmastery,57,24,33
Whitecake,area-52,1623,hunter,beastmastery,40,25,15
Grimbrew,garona,1623,hunter,beastmastery,41,24,17
Svsnipe,tichondrius,1623,hunter,beastmastery,58,33,25
Mojopotato,stormrage,1623,hunter,beastmastery,53,24,29
Illweedx,kiljaeden,1623,hunter,beastmastery,101,42,59
Shootsb,tichondrius,1623,hunter,beastmastery,58,24,34
Zakalla,malganis,1622,hunter,beastmastery,62,33,29
Trickshotss,illidan,1621,hunter,beastmastery,106,63,43
Metrallon,black-dragonflight,1621,hunter,beastmastery,53,29,24
Shootnskoot,icecrown,1618,hunter,beastmastery,24,17,7
Consanguin,sargeras,1618,hunter,beastmastery,36,22,14
Casperonni,illidan,1618,hunter,beastmastery,78,42,36
Rürü,illidan,1618,hunter,beastmastery,40,21,19
Sambucca,daggerspine,1617,hunter,beastmastery,42,21,21
Oblivîon,illidan,1616,hunter,beastmastery,59,38,21
Huntinpuss,tichondrius,1616,hunter,beastmastery,32,18,14
Terpa,nemesis,1616,hunter,beastmastery,161,83,78
Telånnas,illidan,1616,hunter,beastmastery,42,21,21
Skytrooper,boulderfist,1616,hunter,beastmastery,59,26,33
Wøden,draka,1614,hunter,beastmastery,72,38,34
Legoflaiz,drakkari,1614,hunter,beastmastery,48,23,25
Apøllö,kilrogg,1614,hunter,beastmastery,262,123,139
Ecl,azralon,1613,hunter,beastmastery,48,27,21
Häm,dalaran,1613,hunter,beastmastery,114,63,51
Skarasha,tichondrius,1610,hunter,beastmastery,42,22,20
Mambothehunt,stormrage,1610,hunter,beastmastery,59,27,32
Razor,destromath,1610,hunter,beastmastery,54,24,30
Yughii,stormrage,1609,hunter,beastmastery,36,17,19
Cobrakhan,tichondrius,1608,hunter,beastmastery,66,42,24
Bertimus,sargeras,1608,hunter,beastmastery,132,61,71
Focusfire,khazgoroth,1607,hunter,beastmastery,66,32,34
Mordriva,azjolnerub,1607,hunter,beastmastery,53,25,28
Shootnoscore,vashj,1606,hunter,beastmastery,83,46,37
Sissleto,tichondrius,1606,hunter,beastmastery,239,116,123
Legacyhunter,nazgrel,1605,hunter,beastmastery,30,17,13
Ðfac,moon-guard,1604,hunter,beastmastery,60,26,34
Légölás,tichondrius,1603,hunter,beastmastery,72,41,31
Beasting,moon-guard,1603,hunter,beastmastery,36,20,16
Bamfhunt,darkspear,1603,hunter,beastmastery,46,25,21
Jillypoo,azralon,1602,hunter,beastmastery,30,21,9
Axis,mugthol,1601,hunter,beastmastery,85,45,40
Aazua,frostmourne,1601,hunter,beastmastery,45,22,23
Snewfly,tichondrius,1600,hunter,beastmastery,54,36,18
Kenji,sargeras,1599,hunter,beastmastery,56,23,33
Vanero,eonar,1598,hunter,beastmastery,48,22,26
Asurvivor,suramar,1596,hunter,beastmastery,157,81,76
Zyzzmirin,illidan,1596,hunter,beastmastery,66,30,36
Pinêapplê,bleeding-hollow,1595,hunter,beastmastery,30,18,12
Sñïpêr,tichondrius,1595,hunter,beastmastery,36,19,17
Hofftimus,tichondrius,1591,hunter,beastmastery,71,47,24
Spídër,maiev,1591,hunter,beastmastery,38,20,18
Killwill,illidan,1587,hunter,beastmastery,54,28,26
Xionos,wyrmrest-accord,1587,hunter,beastmastery,78,39,39
Sashagreen,frostmourne,1585,hunter,beastmastery,83,43,40
Toxarch,aggramar,1585,hunter,beastmastery,78,39,39
Nooche,bleeding-hollow,1582,hunter,beastmastery,30,20,10
Partz,darkspear,1580,hunter,beastmastery,30,19,11
Teneightt,tichondrius,1578,hunter,beastmastery,62,30,32
Mournebow,tichondrius,1574,hunter,beastmastery,267,144,123
Fkkroglash,barthilas,1573,hunter,beastmastery,36,23,13
Zennifi,bleeding-hollow,1573,hunter,beastmastery,73,36,37
Kopula,illidan,1569,hunter,beastmastery,55,30,25
Rëxx,moon-guard,1565,hunter,beastmastery,68,39,29
Sonichunterr,illidan,1563,hunter,beastmastery,64,38,26
Icecaffemoca,tichondrius,1562,hunter,beastmastery,45,19,26
Assbow,kiljaeden,1561,hunter,beastmastery,36,18,18
Nalasdottirh,moon-guard,1559,hunter,beastmastery,30,17,13
Lasix,burning-blade,1559,hunter,beastmastery,107,52,55
Urzoth,tichondrius,1556,hunter,beastmastery,42,26,16
Kniightjayyx,kelthuzad,1552,hunter,beastmastery,78,32,46
Keboks,alleria,1551,hunter,beastmastery,33,18,15
Reay,frostmourne,1551,hunter,beastmastery,36,19,17
Tinyted,nathrezim,1550,hunter,beastmastery,42,21,21
Scythedom,tichondrius,1550,hunter,beastmastery,42,17,25
Bigolekack,tichondrius,1547,hunter,beastmastery,36,19,17
Gernon,frostmourne,1546,hunter,beastmastery,39,20,19
Nitroxl,illidan,1545,hunter,beastmastery,54,29,25
Kushaddict,lightnings-blade,1545,hunter,beastmastery,150,64,86
Despairius,moon-guard,1543,hunter,beastmastery,44,25,19
Outfazed,tichondrius,1543,hunter,beastmastery,81,45,36
Limcross,drakkari,1543,hunter,beastmastery,50,27,23
Ungoliánt,cairne,1541,hunter,beastmastery,54,28,26
Rektarrow,area-52,1541,hunter,beastmastery,41,19,22
Dôntlosmebro,stormrage,1540,hunter,beastmastery,66,37,29
Ñðñdêsçrípt,frostmourne,1540,hunter,beastmastery,69,35,34
Varka,area-52,1539,hunter,beastmastery,36,20,16
Petkd,frostmourne,1538,hunter,beastmastery,42,23,19
Cerébro,illidan,1538,hunter,beastmastery,78,31,47
Laurenx,illidan,1537,hunter,beastmastery,33,20,13
Kaizong,hyjal,1537,hunter,beastmastery,29,17,12
Runforthehil,barthilas,1537,hunter,beastmastery,60,30,30
Yandralen,kiljaeden,1533,hunter,beastmastery,69,37,32
Getrekt,azralon,1533,hunter,beastmastery,45,20,25
Freebeë,area-52,1531,hunter,beastmastery,85,49,36
Tsuro,area-52,1529,hunter,beastmastery,29,17,12
Teaks,aggramar,1527,hunter,beastmastery,30,16,14
Breezekeeper,area-52,1527,hunter,beastmastery,78,40,38
Shadowtensai,stormrage,1527,hunter,beastmastery,78,34,44
Snipin,ragnaros,1527,hunter,beastmastery,42,16,26
Robnhunt,tichondrius,1526,hunter,beastmastery,30,16,14
Sindragostra,tichondrius,1526,hunter,beastmastery,123,62,61
Kript,dragonmaw,1526,hunter,beastmastery,325,156,169
Tus,tichondrius,1526,hunter,beastmastery,36,16,20
Phindo,agamaggan,1525,hunter,beastmastery,30,17,13
Uzpak,tichondrius,1524,hunter,beastmastery,59,34,25
Overshot,tichondrius,1522,hunter,beastmastery,60,23,37
Smullik,wyrmrest-accord,1521,hunter,beastmastery,36,16,20
Mortalz,barthilas,1519,hunter,beastmastery,155,76,79
Readtitle,malganis,1518,hunter,beastmastery,54,31,23
Clinteastwoo,ragnaros,1517,hunter,beastmastery,48,16,32
Hazzeth,thrall,1516,hunter,beastmastery,30,21,9
Bonnèy,zuljin,1516,hunter,beastmastery,48,31,17
Existential,moon-guard,1513,hunter,beastmastery,36,19,17
Cyrsmen,ragnaros,1511,hunter,beastmastery,162,80,82
Gamestopceo,tichondrius,1511,hunter,beastmastery,84,41,43
Selhort,quelthalas,1511,hunter,beastmastery,72,31,41
Internade,frostmourne,1509,hunter,beastmastery,54,25,29
Myladyy,zuljin,1509,hunter,beastmastery,59,24,35
Sanchode,tichondrius,1508,hunter,beastmastery,48,20,28
Bustyredhead,kelthuzad,1508,hunter,beastmastery,41,16,25
Velhokoira,illidan,1507,hunter,beastmastery,54,31,23
Diavál,area-52,1506,hunter,beastmastery,42,24,18
Chaw,nathrezim,1506,hunter,beastmastery,74,39,35
Volbz,barthilas,1505,hunter,beastmastery,36,16,20
Shockwave,velen,1504,hunter,beastmastery,182,93,89
Emilysamuels,tichondrius,1503,hunter,beastmastery,24,16,8
Pankyrangs,kelthuzad,1503,hunter,beastmastery,48,24,24
Stalkstride,destromath,1503,hunter,beastmastery,72,35,37
Brokiînn,aegwynn,1503,hunter,beastmastery,105,51,54
Rcman,tichondrius,1501,hunter,beastmastery,36,27,9
Chrest,sargeras,1500,hunter,beastmastery,76,39,37
Irøneye,sargeras,1499,hunter,beastmastery,55,20,35
Yaisk,tichondrius,1498,hunter,beastmastery,62,35,27
Statistic,black-dragonflight,1496,hunter,beastmastery,36,17,19
Ramchi,burning-blade,1494,hunter,beastmastery,61,33,28
Reloadz,shattered-hand,1494,hunter,beastmastery,34,18,16
Xuorias,area-52,1494,hunter,beastmastery,47,24,23
Luckshot,destromath,1494,hunter,beastmastery,42,21,21
Pavlovik,ragnaros,1491,hunter,beastmastery,60,25,35
ßoness,area-52,1491,hunter,beastmastery,48,18,30
Sereom,frostmourne,1490,hunter,beastmastery,95,55,40
Wredd,nemesis,1488,hunter,beastmastery,35,20,15
Bootylickin,tichondrius,1487,hunter,beastmastery,30,17,13
Szone,tichondrius,1487,hunter,beastmastery,88,43,45
Laras,blades-edge,1484,hunter,beastmastery,36,22,14
Chizhi,tichondrius,1484,hunter,beastmastery,90,45,45
Horcnbeans,bleeding-hollow,1484,hunter,beastmastery,105,51,54
Ullr,gurubashi,1484,hunter,beastmastery,60,19,41
Jjack,muradin,1482,hunter,beastmastery,54,29,25
Chowyunfatss,proudmoore,1481,hunter,beastmastery,112,53,59
Rengarok,emerald-dream,1480,hunter,beastmastery,44,23,21
Grànd,tortheldrin,1480,hunter,beastmastery,66,33,33
Scourgesurge,kiljaeden,1478,hunter,beastmastery,145,71,74
Mopgodxqt,nemesis,1478,hunter,beastmastery,42,19,23
Josyv,quelthalas,1477,hunter,beastmastery,36,21,15
Garzb,area-52,1476,hunter,beastmastery,42,22,20
Aguntur,ragnaros,1474,hunter,beastmastery,99,59,40
Virolac,tichondrius,1469,hunter,beastmastery,32,16,16
Oceandoom,tichondrius,1468,hunter,beastmastery,93,52,41
Crounzz,sargeras,1468,hunter,beastmastery,54,16,38
Caetomon,kiljaeden,1467,hunter,beastmastery,29,18,11
Zaetor,ragnaros,1466,hunter,beastmastery,78,43,35
Tacos,kelthuzad,1465,hunter,beastmastery,36,22,14
Sootgarbage,sargeras,1464,hunter,beastmastery,72,42,30
Dlabio,emerald-dream,1461,hunter,beastmastery,90,46,44
Unrealpewpew,lightbringer,1461,hunter,beastmastery,72,32,40
Danncer,alexstrasza,1459,hunter,beastmastery,102,56,46
Yager,kalecgos,1456,hunter,beastmastery,28,17,11
Punjisticks,tichondrius,1454,hunter,beastmastery,104,49,55
Kleankilla,malganis,1453,hunter,beastmastery,38,22,16
Dontmissz,tichondrius,1449,hunter,beastmastery,42,24,18
Limpnoodle,nerzhul,1445,hunter,beastmastery,113,55,58
Kouandjio,area-52,1444,hunter,beastmastery,36,18,18
Recha,emerald-dream,1442,hunter,beastmastery,30,17,13
Zanahoria,stormscale,1442,hunter,beastmastery,43,19,24
Ehnó,illidan,1441,hunter,beastmastery,33,17,16
Daarrk,thrall,1441,hunter,beastmastery,82,39,43
Junmuxiao,ragnaros,1441,hunter,beastmastery,48,22,26
Shedowhunter,azralon,1439,hunter,beastmastery,24,17,7
Lashga,wyrmrest-accord,1439,hunter,beastmastery,47,22,25
Yugno,wildhammer,1437,hunter,beastmastery,30,16,14
Aristæos,kelthuzad,1436,hunter,beastmastery,77,40,37
Sungoro,tichondrius,1436,hunter,beastmastery,78,35,43
Squírtle,ragnaros,1436,hunter,beastmastery,36,15,21
Tânsøxøxø,tichondrius,1436,hunter,beastmastery,42,15,27
Sarahbeara,moonrunner,1435,hunter,beastmastery,24,15,9
Scirfreez,ragnaros,1435,hunter,beastmastery,60,25,35
Seatback,arathor,1432,hunter,beastmastery,76,33,43
Kkoner,illidan,1431,hunter,beastmastery,24,15,9
Fames,shuhalo,1431,hunter,beastmastery,49,22,27
Zemphoths,eredar,1429,hunter,beastmastery,33,15,18
Ddänz,kiljaeden,1429,hunter,beastmastery,45,16,29
Sharpster,zuljin,1427,hunter,beastmastery,61,30,31
Wolfarms,area-52,1427,hunter,beastmastery,69,32,37
Critterz,gorgonnash,1427,hunter,beastmastery,65,28,37
Iyne,stormrage,1427,hunter,beastmastery,36,15,21
Munyshotz,tichondrius,1426,hunter,beastmastery,86,50,36
Sasorï,nemesis,1424,hunter,beastmastery,24,15,9
Skeetslinger,illidan,1424,hunter,beastmastery,39,16,23
Syldris,proudmoore,1423,hunter,beastmastery,24,15,9
ßutter,thunderlord,1423,hunter,beastmastery,38,17,21
Boomseed,nagrand,1420,hunter,beastmastery,34,16,18
Mukeru,stormrage,1418,hunter,beastmastery,24,15,9
Taelen,aegwynn,1417,hunter,beastmastery,47,24,23
Araghrn,draktharon,1417,hunter,beastmastery,111,54,57
Gannidema,illidan,1416,hunter,beastmastery,30,17,13
Eldlichi,proudmoore,1416,hunter,beastmastery,48,20,28
Belime,korgath,1415,hunter,beastmastery,96,53,43
Sülivan,zuljin,1415,hunter,beastmastery,49,27,22
Terminatôr,malganis,1415,hunter,beastmastery,36,15,21
Drunkhunter,malygos,1414,hunter,beastmastery,24,15,9
Blackspit,ragnaros,1411,hunter,beastmastery,41,23,18
Hobbléfoot,proudmoore,1409,hunter,beastmastery,36,15,21
Drig,korgath,1409,hunter,beastmastery,47,19,28
Morganson,moon-guard,1407,hunter,beastmastery,174,83,91
Cyboreg,stormrage,1403,hunter,beastmastery,41,23,18
Sioul,bleeding-hollow,1403,hunter,beastmastery,30,15,15
Darthski,drenden,1402,hunter,beastmastery,51,24,27
Sliturthroat,barthilas,1402,hunter,beastmastery,50,20,30
Thezeus,barthilas,1402,hunter,beastmastery,41,15,26
Lilpoots,warsong,1401,hunter,beastmastery,59,28,31
Orcanjo,azralon,1400,hunter,beastmastery,42,19,23
Overshot,barthilas,1397,hunter,beastmastery,24,16,8
Jyttrg,tichondrius,1396,hunter,beastmastery,65,34,31
Timmee,bleeding-hollow,1392,hunter,beastmastery,36,15,21
Liillilliil,tichondrius,1391,hunter,beastmastery,31,16,15
Paganfinn,tichondrius,1391,hunter,beastmastery,66,29,37
Tentoontrey,emerald-dream,1390,hunter,beastmastery,42,20,22
Legolasbow,tichondrius,1386,hunter,beastmastery,52,26,26
Tearsofnoobs,tichondrius,1381,hunter,beastmastery,33,16,17
Viperstng,area-52,1380,hunter,beastmastery,70,40,30
Fruitenveg,frostmourne,1374,hunter,beastmastery,36,18,18
Tearsofrogue,tichondrius,1373,hunter,beastmastery,30,16,14
Chrise,darkspear,1371,hunter,beastmastery,24,18,6
Phaction,tichondrius,1369,hunter,beastmastery,60,26,34
Jangle,mannoroth,1368,hunter,beastmastery,34,19,15
Lilbic,bleeding-hollow,1367,hunter,beastmastery,27,18,9
Cottonshots,dalaran,1367,hunter,beastmastery,60,27,33
Hillside,frostmourne,1364,hunter,beastmastery,23,15,8
Boward,illidan,1362,hunter,beastmastery,67,36,31
Revbubs,darkspear,1360,hunter,beastmastery,54,26,28
Ryukuzen,tichondrius,1359,hunter,beastmastery,35,15,20
Femonemos,nemesis,1358,hunter,beastmastery,30,17,13
Cigâro,thrall,1358,hunter,beastmastery,123,60,63
Shlandy,frostmourne,1356,hunter,beastmastery,32,18,14
Keknine,gnomeregan,1356,hunter,beastmastery,66,29,37
Reallybroke,stormrage,1355,hunter,beastmastery,33,16,17
Tokendaily,sargeras,1353,hunter,beastmastery,72,40,32
Vruul,sargeras,1352,hunter,beastmastery,64,30,34
Fleetfox,tichondrius,1351,hunter,beastmastery,49,23,26
Pokérap,dalaran,1347,hunter,beastmastery,42,17,25
Borudin,stormrage,1344,hunter,beastmastery,161,71,90
Spèedbump,stormrage,1342,hunter,beastmastery,63,29,34
Lilien,khazgoroth,1341,hunter,beastmastery,30,18,12
Goongarg,frostmourne,1341,hunter,beastmastery,24,14,10
Bro,malorne,1341,hunter,beastmastery,72,34,38
Tergls,illidan,1341,hunter,beastmastery,73,33,40
Kârân,tichondrius,1341,hunter,beastmastery,60,27,33
Choclit,scilla,1341,hunter,beastmastery,42,14,28
Mitulla,wyrmrest-accord,1339,hunter,beastmastery,44,22,22
Clydebarro,sargeras,1339,hunter,beastmastery,30,14,16
Oatmeallover,stormrage,1339,hunter,beastmastery,30,14,16
Peterming,tichondrius,1339,hunter,beastmastery,108,49,59
Euclase,bleeding-hollow,1338,hunter,beastmastery,46,23,23
Damadar,tichondrius,1338,hunter,beastmastery,30,14,16
Aiollus,stormreaver,1338,hunter,beastmastery,30,14,16
Pvrisxoxo,frostmourne,1337,hunter,beastmastery,31,15,16
Crownchild,illidan,1336,hunter,beastmastery,24,14,10
Skulgor,zuljin,1336,hunter,beastmastery,66,34,32
Psychiatry,bonechewer,1336,hunter,beastmastery,70,35,35
Azx,tichondrius,1336,hunter,beastmastery,42,19,23
Stel,tichondrius,1335,hunter,beastmastery,33,17,16
Bubbzar,frostmourne,1334,hunter,beastmastery,24,14,10
Shootiepie,hyjal,1333,hunter,beastmastery,24,14,10
Aggargh,baelgun,1332,hunter,beastmastery,33,18,15
Daken,ysera,1330,hunter,beastmastery,24,14,10
Mvpwonder,frostmourne,1330,hunter,beastmastery,42,14,28
Khaydarin,sargeras,1329,hunter,beastmastery,30,14,16
Luprikus,maelstrom,1328,hunter,beastmastery,29,14,15
Jaysuper,zuljin,1328,hunter,beastmastery,36,14,22
Oblíviion,stormrage,1327,hunter,beastmastery,44,23,21
Frostyarrow,moon-guard,1325,hunter,beastmastery,55,28,27
Bulleitrye,illidan,1325,hunter,beastmastery,58,28,30
Starsworn,moon-guard,1323,hunter,beastmastery,30,16,14
Finalshot,barthilas,1323,hunter,beastmastery,33,15,18
Bowna,stormscale,1323,hunter,beastmastery,54,20,34
Xonios,frostwolf,1320,hunter,beastmastery,24,15,9
Fusionrpg,quelthalas,1320,hunter,beastmastery,30,17,13
Eightbeers,bleeding-hollow,1320,hunter,beastmastery,56,29,27
Jesticles,zuljin,1320,hunter,beastmastery,60,30,30
Bingdat,area-52,1319,hunter,beastmastery,31,16,15
Pingaamarela,nemesis,1319,hunter,beastmastery,138,70,68
Petmayo,tichondrius,1318,hunter,beastmastery,18,14,4
Doug,illidan,1317,hunter,beastmastery,30,14,16
Wulfgeng,azgalor,1313,hunter,beastmastery,80,39,41
Jetzy,illidan,1311,hunter,beastmastery,65,30,35
Narus,whisperwind,1310,hunter,beastmastery,48,26,22
Hoboh,illidan,1310,hunter,beastmastery,66,32,34
Lizymcguire,malganis,1308,hunter,beastmastery,42,23,19
Varthurg,ragnaros,1308,hunter,beastmastery,30,15,15
Kamikazey,tichondrius,1304,hunter,beastmastery,36,18,18
Bluebow,tichondrius,1302,hunter,beastmastery,96,46,50
Javoz,drakkari,1302,hunter,beastmastery,36,14,22
Bacatran,darkspear,1301,hunter,beastmastery,58,32,26
Sunchea,arygos,1300,hunter,beastmastery,30,14,16
Trailbreaker,trollbane,1299,hunter,beastmastery,69,43,26
Zzsocrateszz,dragonmaw,1298,hunter,beastmastery,104,52,52
Jacobsladder,illidan,1293,hunter,beastmastery,113,51,62
Darksector,nemesis,1290,hunter,beastmastery,41,14,27
Alitharia,nerzhul,1288,hunter,beastmastery,153,67,86
Voodoohunter,blood-furnace,1286,hunter,beastmastery,30,15,15
Vaettai,barthilas,1286,hunter,beastmastery,72,32,40
Mikey,exodar,1284,hunter,beastmastery,27,15,12
Airtight,area-52,1281,hunter,beastmastery,53,24,29
Bepee,auchindoun,1279,hunter,beastmastery,89,48,41
Huukend,azjolnerub,1277,hunter,beastmastery,48,23,25
Thiccit,illidan,1276,hunter,beastmastery,42,21,21
Alexbm,amanthul,1271,hunter,beastmastery,44,27,17
Iar,tichondrius,1270,hunter,beastmastery,30,18,12
Glediator,tichondrius,1269,hunter,beastmastery,45,21,24
Fallenfates,stormrage,1268,hunter,beastmastery,78,36,42
Trapz,hellscream,1267,hunter,beastmastery,96,48,48
Rnger,aerie-peak,1267,hunter,beastmastery,55,25,30
Therooth,bleeding-hollow,1262,hunter,beastmastery,24,14,10
Bubbz,bloodscalp,1261,hunter,beastmastery,66,33,33
Scattertrap,ragnaros,1260,hunter,beastmastery,19,14,5
Lastanar,amanthul,1258,hunter,beastmastery,90,45,45
Vesity,tichondrius,1249,hunter,beastmastery,50,23,27
Broydiesnipe,illidan,1247,hunter,beastmastery,18,13,5
Alexxspewpew,ragnaros,1247,hunter,beastmastery,23,13,10
Frankabingle,area-52,1247,hunter,beastmastery,30,13,17
Wastdpenguin,area-52,1247,hunter,beastmastery,30,13,17
Slowhunterr,tichondrius,1247,hunter,beastmastery,36,13,23
Carlitocool,tichondrius,1246,hunter,beastmastery,18,13,5
Refinedx,sargeras,1246,hunter,beastmastery,18,13,5
Gabulmenina,nemesis,1245,hunter,beastmastery,24,13,11
Reeload,tichondrius,1244,hunter,beastmastery,24,13,11
Tyleraq,area-52,1244,hunter,beastmastery,24,13,11
Shotmieye,thunderhorn,1244,hunter,beastmastery,60,30,30
Ascer,gurubashi,1244,hunter,beastmastery,98,48,50
Maquire,tichondrius,1244,hunter,beastmastery,36,17,19
Digitizoid,tichondrius,1244,hunter,beastmastery,30,13,17
Craftarrow,tichondrius,1243,hunter,beastmastery,41,21,20
Wickyz,malganis,1243,hunter,beastmastery,30,13,17
Heparinqt,area-52,1242,hunter,beastmastery,36,13,23
Mmeep,illidan,1241,hunter,beastmastery,24,13,11
Angrypepe,bleeding-hollow,1240,hunter,beastmastery,30,13,17
Wadadly,malganis,1239,hunter,beastmastery,138,66,72
Ioioi,tichondrius,1238,hunter,beastmastery,34,16,18
Fistbirtdor,illidan,1237,hunter,beastmastery,24,13,11
Nebulahaze,stormrage,1236,hunter,beastmastery,38,18,20
Timogen,illidan,1236,hunter,beastmastery,36,16,20
Nogaro,nemesis,1235,hunter,beastmastery,42,20,22
Hynathios,azralon,1233,hunter,beastmastery,30,13,17
Bobbysmurica,cenarion-circle,1233,hunter,beastmastery,48,20,28
Honeygold,tichondrius,1233,hunter,beastmastery,51,19,32
Rbtz,illidan,1231,hunter,beastmastery,17,13,4
Xtop,draktharon,1231,hunter,beastmastery,23,15,8
Mithrandiel,blood-furnace,1229,hunter,beastmastery,87,45,42
Snypêr,tichondrius,1229,hunter,beastmastery,30,13,17
Highdroe,tichondrius,1228,hunter,beastmastery,48,25,23
Luoca,shuhalo,1227,hunter,beastmastery,24,13,11
Angdre,tichondrius,1227,hunter,beastmastery,30,13,17
Skywrecker,bleeding-hollow,1226,hunter,beastmastery,24,13,11
Hovahdo,proudmoore,1224,hunter,beastmastery,23,13,10
Hughneutron,kirin-tor,1224,hunter,beastmastery,147,76,71
Urimiel,daggerspine,1223,hunter,beastmastery,36,16,20
Wrècked,kiljaeden,1222,hunter,beastmastery,30,13,17
Bromance,kaelthas,1221,hunter,beastmastery,36,18,18
Grands,tortheldrin,1219,hunter,beastmastery,29,14,15
Havymetal,andorhal,1219,hunter,beastmastery,48,20,28
Machiko,gorefiend,1218,hunter,beastmastery,30,13,17
Anaiset,hyjal,1217,hunter,beastmastery,24,13,11
Xxo,frostmourne,1215,hunter,beastmastery,34,13,21
Norcklow,ragnaros,1211,hunter,beastmastery,46,18,28
Deirrë,saurfang,1209,hunter,beastmastery,41,17,24
Hairyhype,malganis,1207,hunter,beastmastery,42,19,23
Artilleria,quelthalas,1207,hunter,beastmastery,42,18,24
Hitts,kelthuzad,1206,hunter,beastmastery,25,14,11
Desydn,draenor,1206,hunter,beastmastery,143,72,71
Ydaine,alexstrasza,1206,hunter,beastmastery,75,33,42
Gejagt,sargeras,1201,hunter,beastmastery,25,14,11
Winchestyr,lightbringer,1201,hunter,beastmastery,30,14,16
Tmac,winterhoof,1198,hunter,beastmastery,53,28,25
Kathoey,wyrmrest-accord,1198,hunter,beastmastery,48,19,29
Rypunzul,proudmoore,1196,hunter,beastmastery,24,13,11
Ownyoufast,darkspear,1193,hunter,beastmastery,30,13,17
Shootaids,illidan,1192,hunter,beastmastery,44,22,22
Gaktog,area-52,1189,hunter,beastmastery,27,13,14
Chetta,ragnaros,1187,hunter,beastmastery,66,28,38
Kaxer,illidan,1182,hunter,beastmastery,65,33,32
Genx,frostmane,1182,hunter,beastmastery,35,15,20
Alaranel,kiljaeden,1181,hunter,beastmastery,48,20,28
Shneedle,illidan,1180,hunter,beastmastery,54,22,32
Thetrickyone,area-52,1180,hunter,beastmastery,52,20,32
Aztrappin,illidan,1177,hunter,beastmastery,63,24,39
Fixnoone,moon-guard,1176,hunter,beastmastery,38,18,20
Warsh,anubarak,1173,hunter,beastmastery,34,19,15
Tiraa,kelthuzad,1170,hunter,beastmastery,42,15,27
Itsdoom,sargeras,1169,hunter,beastmastery,24,16,8
Thiccshawts,moon-guard,1162,hunter,beastmastery,24,13,11
Frenzyfire,whisperwind,1162,hunter,beastmastery,39,16,23
Iffy,dentarg,1161,hunter,beastmastery,24,14,10
Nightfal,emerald-dream,1158,hunter,beastmastery,42,15,27
Arucedd,frostmourne,1156,hunter,beastmastery,59,25,34
Chrønic,khadgar,1155,hunter,beastmastery,24,13,11
Lustblitz,illidan,1152,hunter,beastmastery,18,12,6
Wildlifezoo,tichondrius,1152,hunter,beastmastery,24,12,12
Malvnfresh,tichondrius,1152,hunter,beastmastery,24,12,12
Shot,shuhalo,1151,hunter,beastmastery,18,12,6
Survenant,zuljin,1151,hunter,beastmastery,24,12,12
Xorian,frostmourne,1151,hunter,beastmastery,24,12,12
Urukkz,goldrinn,1151,hunter,beastmastery,24,12,12
Fxsb,tichondrius,1151,hunter,beastmastery,30,12,18
Shrian,illidan,1150,hunter,beastmastery,25,12,13
Fanikita,azralon,1150,hunter,beastmastery,36,12,24
Kroozeh,illidan,1149,hunter,beastmastery,24,12,12
Squishasf,tichondrius,1148,hunter,beastmastery,18,12,6
Topshunter,sargeras,1148,hunter,beastmastery,82,45,37
Funnk,tichondrius,1148,hunter,beastmastery,24,12,12
Sax,stormreaver,1147,hunter,beastmastery,24,12,12
Puffcopeak,illidan,1147,hunter,beastmastery,24,12,12
Suetyic,tichondrius,1147,hunter,beastmastery,24,12,12
Yembohi,queldorei,1145,hunter,beastmastery,18,12,6
Cuteorcgirl,sargeras,1145,hunter,beastmastery,38,15,23
Ragnarlobkk,ragnaros,1144,hunter,beastmastery,148,71,77
Dooper,malfurion,1141,hunter,beastmastery,30,12,18
Nøtsurê,llane,1140,hunter,beastmastery,30,12,18
Gratmuk,ragnaros,1139,hunter,beastmastery,30,12,18
Floopze,burning-legion,1138,hunter,beastmastery,24,12,12
Alwaysblazed,hyjal,1138,hunter,beastmastery,24,12,12
Dyz,ragnaros,1137,hunter,beastmastery,28,13,15
Karev,area-52,1134,hunter,beastmastery,24,12,12
Blury,tichondrius,1131,hunter,beastmastery,29,13,16
Blimpbooty,stormrage,1130,hunter,beastmastery,41,20,21
Revö,area-52,1129,hunter,beastmastery,30,12,18
Juicedhunter,tichondrius,1128,hunter,beastmastery,24,12,12
Camperbill,borean-tundra,1127,hunter,beastmastery,25,14,11
Huñté,stormrage,1127,hunter,beastmastery,24,12,12
Kälec,quelthalas,1127,hunter,beastmastery,66,32,34
Neverhunter,azralon,1127,hunter,beastmastery,30,13,17
Xarmozao,nemesis,1127,hunter,beastmastery,39,14,25
Qpoc,tichondrius,1120,hunter,beastmastery,44,20,24
Mvpbunny,tichondrius,1117,hunter,beastmastery,46,21,25
Exitwoundz,hyjal,1114,hunter,beastmastery,23,12,11
Argent,altar-of-storms,1113,hunter,beastmastery,24,12,12
Hetaya,haomarush,1111,hunter,beastmastery,93,41,52
Brokenstars,illidan,1108,hunter,beastmastery,146,70,76
Vegamax,illidan,1106,hunter,beastmastery,24,14,10
Ukamau,ragnaros,1105,hunter,beastmastery,30,17,13
Rhonishot,tichondrius,1104,hunter,beastmastery,43,15,28
Merkidy,illidan,1099,hunter,beastmastery,17,12,5
Arrowae,sargeras,1098,hunter,beastmastery,44,22,22
Setepalms,azralon,1097,hunter,beastmastery,21,12,9
Shmurda,duskwood,1095,hunter,beastmastery,94,37,57
Omegalulzxd,kelthuzad,1092,hunter,beastmastery,105,45,60
Funwell,dalaran,1090,hunter,beastmastery,29,14,15
Zalyssavara,aerie-peak,1085,hunter,beastmastery,27,12,15
Morenarösa,nemesis,1078,hunter,beastmastery,36,14,22
Eithelleta,frostmourne,1078,hunter,beastmastery,48,18,30
Quigfoot,area-52,1077,hunter,beastmastery,63,25,38
Riivali,quelthalas,1076,hunter,beastmastery,59,23,36
Buyaga,stormreaver,1073,hunter,beastmastery,72,37,35
Brendenhunt,area-52,1071,hunter,beastmastery,17,12,5
Dracð,malganis,1071,hunter,beastmastery,30,14,16
Dadhatesme,stormrage,1066,hunter,beastmastery,27,12,15
Hog,darkspear,1056,hunter,beastmastery,18,11,7
Jawnhunter,tichondrius,1056,hunter,beastmastery,24,11,13
Nodougaelark,dalaran,1056,hunter,beastmastery,24,11,13
Prêd,malganis,1056,hunter,beastmastery,27,12,15
Unicom,malganis,1056,hunter,beastmastery,30,11,19
Darkoshuntar,tichondrius,1055,hunter,beastmastery,18,11,7
Ryutiz,fizzcrank,1055,hunter,beastmastery,18,11,7
Tashio,aerie-peak,1055,hunter,beastmastery,24,11,13
Emmihunt,tichondrius,1055,hunter,beastmastery,24,11,13
Undeadroach,tichondrius,1055,hunter,beastmastery,24,11,13
Datadyne,stormrage,1054,hunter,beastmastery,12,11,1
Selljzs,zuljin,1054,hunter,beastmastery,18,11,7
Qlbl,tichondrius,1054,hunter,beastmastery,18,11,7
Ispamtraps,emerald-dream,1054,hunter,beastmastery,18,11,7
Anastasia,gorgonnash,1052,hunter,beastmastery,18,11,7
Sagadegêmeos,stormrage,1052,hunter,beastmastery,30,11,19
Asynic,blades-edge,1052,hunter,beastmastery,30,11,19
Cummis,skullcrusher,1051,hunter,beastmastery,18,11,7
Hohohohahah,gallywix,1051,hunter,beastmastery,30,11,19
Lunarlunar,khadgar,1051,hunter,beastmastery,30,11,19
Zünma,tichondrius,1050,hunter,beastmastery,24,11,13
Gølin,aerie-peak,1049,hunter,beastmastery,30,11,19
Memënto,barthilas,1049,hunter,beastmastery,30,11,19
Freeside,emerald-dream,1048,hunter,beastmastery,18,11,7
Wingclipped,kelthuzad,1048,hunter,beastmastery,18,11,7
Computer,darkspear,1048,hunter,beastmastery,24,11,13
ßaelon,malganis,1047,hunter,beastmastery,12,11,1
Kynagidas,korgath,1047,hunter,beastmastery,24,11,13
Vord,frostmourne,1046,hunter,beastmastery,24,11,13
Conizle,sargeras,1045,hunter,beastmastery,24,11,13
Cilnolm,moon-guard,1045,hunter,beastmastery,24,11,13
Gandson,fizzcrank,1045,hunter,beastmastery,29,12,17
Wogolas,barthilas,1044,hunter,beastmastery,18,11,7
Youngteflon,bonechewer,1043,hunter,beastmastery,24,11,13
Jijiyoyo,tichondrius,1041,hunter,beastmastery,41,13,28
Zooker,tichondrius,1039,hunter,beastmastery,29,11,18
Faldran,earthen-ring,1038,hunter,beastmastery,94,39,55
Frenzygirl,azralon,1036,hunter,beastmastery,18,11,7
More,khadgar,1035,hunter,beastmastery,30,11,19
Vicluvv,stormrage,1034,hunter,beastmastery,23,11,12
Hatteras,drakthul,1032,hunter,beastmastery,44,12,32
Caytano,quelthalas,1031,hunter,beastmastery,24,15,9
Erik,nemesis,1028,hunter,beastmastery,135,65,70
Huntercry,ragnaros,1026,hunter,beastmastery,18,11,7
Puhpsy,azralon,1024,hunter,beastmastery,42,24,18
Robingear,baelgun,1024,hunter,beastmastery,123,58,65
Elisen,frostmourne,1021,hunter,beastmastery,42,13,29
Spitballa,emerald-dream,1020,hunter,beastmastery,28,11,17
Bolbathefett,shadowsong,1020,hunter,beastmastery,30,11,19
Taedulos,azralon,1019,hunter,beastmastery,36,19,17
Fifie,azgalor,1011,hunter,beastmastery,31,12,19
Jônathan,tichondrius,1010,hunter,beastmastery,18,11,7
Hunterjim,tichondrius,1005,hunter,beastmastery,26,12,14
Rairin,tichondrius,1004,hunter,beastmastery,65,33,32
Sylriynn,moon-guard,1004,hunter,beastmastery,23,11,12
Håwkeye,hyjal,1003,hunter,beastmastery,109,53,56
Antihero,norgannon,1001,hunter,beastmastery,20,12,8
Eddyholiday,tichondrius,1001,hunter,beastmastery,26,13,13
Falesta,sargeras,999,hunter,beastmastery,28,12,16
Flexxbow,thrall,994,hunter,beastmastery,23,13,10
Robobrain,area-52,993,hunter,beastmastery,23,11,12
Londen,tichondrius,987,hunter,beastmastery,30,15,15
Onihanzo,thrall,987,hunter,beastmastery,25,12,13
Zullypewpew,stormrage,982,hunter,beastmastery,17,11,6
Brendie,thrall,973,hunter,beastmastery,166,76,90
Dayneryz,quelthalas,971,hunter,beastmastery,32,11,21
Erovianoria,silver-hand,968,hunter,beastmastery,57,29,28
Maveraxx,executus,961,hunter,beastmastery,36,14,22
Bliv,tichondrius,960,hunter,beastmastery,12,10,2
Ahhpash,tichondrius,960,hunter,beastmastery,16,11,5
Gööber,hyjal,960,hunter,beastmastery,18,10,8
Dualp,tichondrius,960,hunter,beastmastery,18,10,8
Sniperfx,lightbringer,960,hunter,beastmastery,18,10,8
Wovow,tichondrius,960,hunter,beastmastery,18,10,8
Worsthunt,tichondrius,960,hunter,beastmastery,18,10,8
Yná,azralon,960,hunter,beastmastery,18,10,8
Lilprimary,tichondrius,960,hunter,beastmastery,18,10,8
Shinhyez,tichondrius,960,hunter,beastmastery,18,10,8
Pumplum,kiljaeden,960,hunter,beastmastery,18,10,8
Fishxxo,frostmourne,960,hunter,beastmastery,24,10,14
Willdey,frostmourne,960,hunter,beastmastery,24,10,14
Focús,laughing-skull,960,hunter,beastmastery,24,10,14
Justforfunxx,tichondrius,960,hunter,beastmastery,30,10,20
Rosebullets,bleeding-hollow,959,hunter,beastmastery,18,10,8
Tmnarcanttv,tichondrius,959,hunter,beastmastery,18,10,8
Geregaux,sargeras,959,hunter,beastmastery,18,10,8
Evolushun,kiljaeden,959,hunter,beastmastery,21,11,10
Stonehard,mugthol,959,hunter,beastmastery,24,10,14
Cantcatchtin,tichondrius,959,hunter,beastmastery,24,10,14
Yangthekhunt,tichondrius,959,hunter,beastmastery,24,10,14
Vigon,stormrage,959,hunter,beastmastery,24,10,14
Orgpopeyes,illidan,959,hunter,beastmastery,24,10,14
Lrnb,tichondrius,959,hunter,beastmastery,24,10,14
Huntfaceguy,agamaggan,959,hunter,beastmastery,24,10,14
Leyliann,quelthalas,959,hunter,beastmastery,27,11,16
Kimbaa,tichondrius,959,hunter,beastmastery,30,10,20
Aquabat,wildhammer,958,hunter,beastmastery,18,10,8
Quickfyre,stormrage,958,hunter,beastmastery,18,10,8
Askelon,firetree,958,hunter,beastmastery,21,11,10
Celarla,tichondrius,958,hunter,beastmastery,21,11,10
Tazer,area-52,958,hunter,beastmastery,24,10,14
Marexx,tichondrius,958,hunter,beastmastery,24,10,14
Pafäcïle,tichondrius,958,hunter,beastmastery,24,10,14
Imthaböss,nazjatar,957,hunter,beastmastery,23,10,13
Tanarin,bleeding-hollow,957,hunter,beastmastery,24,10,14
Mikly,ragnaros,957,hunter,beastmastery,24,10,14
Terrygross,sargeras,957,hunter,beastmastery,24,10,14
Sumom,darrowmere,957,hunter,beastmastery,44,18,26
Littledougie,boulderfist,957,hunter,beastmastery,30,10,20
Hyena,kelthuzad,955,hunter,beastmastery,24,10,14
Piu,illidan,955,hunter,beastmastery,24,10,14
Kaliaraan,bleeding-hollow,955,hunter,beastmastery,24,10,14
Trim,tichondrius,954,hunter,beastmastery,18,10,8
Murdaugh,icecrown,954,hunter,beastmastery,18,10,8
Rocchettâ,kirin-tor,954,hunter,beastmastery,18,10,8
Elyssandrá,thrall,954,hunter,beastmastery,24,10,14
Deepcarver,tichondrius,954,hunter,beastmastery,24,10,14
Gïzmo,malganis,953,hunter,beastmastery,18,10,8
Rezkiin,tichondrius,953,hunter,beastmastery,18,10,8
Rotokrim,emerald-dream,952,hunter,beastmastery,160,77,83
Huntertimes,ragnaros,951,hunter,beastmastery,12,10,2
Raikuu,skullcrusher,951,hunter,beastmastery,36,18,18
Steelaeon,moon-guard,951,hunter,beastmastery,24,10,14
Easypoacher,tichondrius,948,hunter,beastmastery,18,10,8
Namikawa,stormrage,948,hunter,beastmastery,18,10,8
Flacidhunter,kelthuzad,948,hunter,beastmastery,24,10,14
Böuntyhuntêr,area-52,948,hunter,beastmastery,24,10,14
ßaeløn,malganis,947,hunter,beastmastery,15,11,4
Leaii,thrall,944,hunter,beastmastery,43,24,19
Jezoo,frostmourne,937,hunter,beastmastery,30,10,20
Shootyurshot,stormrage,927,hunter,beastmastery,20,11,9
Finol,azralon,926,hunter,beastmastery,14,11,3
Entrapment,emerald-dream,924,hunter,beastmastery,23,10,13
Çhexmix,kiljaeden,910,hunter,beastmastery,15,10,5
Actehón,ragnaros,909,hunter,beastmastery,36,18,18
Thiccphat,sargeras,908,hunter,beastmastery,17,10,7
Coyner,tichondrius,907,hunter,beastmastery,21,10,11
Wael,perenolde,905,hunter,beastmastery,17,10,7
Glizzys,cairne,904,hunter,beastmastery,29,12,17
Saltz,tichondrius,901,hunter,beastmastery,21,11,10
Loktarnum,illidan,894,hunter,beastmastery,20,10,10
Ketulirantle,azralon,891,hunter,beastmastery,46,13,33
Foh,kelthuzad,888,hunter,beastmastery,17,10,7
Wkg,azgalor,886,hunter,beastmastery,18,10,8
Naestrá,bleeding-hollow,864,hunter,beastmastery,12,9,3
Huntations,sargeras,864,hunter,beastmastery,12,9,3
Lubze,bleeding-hollow,864,hunter,beastmastery,12,9,3
Bmhuntlol,illidan,864,hunter,beastmastery,12,9,3
Slipox,sargeras,864,hunter,beastmastery,12,9,3
Petattack,barthilas,864,hunter,beastmastery,12,9,3
Lilsynchfyb,sargeras,864,hunter,beastmastery,18,9,9
Yatyegatchun,illidan,864,hunter,beastmastery,18,9,9
Nflmaster,malganis,864,hunter,beastmastery,18,9,9
Deutêr,quelthalas,864,hunter,beastmastery,18,9,9
Zizilio,kelthuzad,864,hunter,beastmastery,18,9,9
Airlol,tichondrius,864,hunter,beastmastery,18,9,9
Flor,boulderfist,864,hunter,beastmastery,18,9,9
Déwi,tichondrius,864,hunter,beastmastery,18,9,9
Xbloody,tichondrius,864,hunter,beastmastery,18,9,9
Esstark,bleeding-hollow,864,hunter,beastmastery,18,9,9
Hagadinn,frostmourne,864,hunter,beastmastery,18,9,9
Balrröt,malganis,864,hunter,beastmastery,24,9,15
Dirtyytroll,area-52,864,hunter,beastmastery,24,9,15
Arteene,illidan,864,hunter,beastmastery,24,9,15
Scurvypete,perenolde,864,hunter,beastmastery,24,9,15
Katiepie,frostmourne,864,hunter,beastmastery,30,9,21
Reic,kiljaeden,863,hunter,beastmastery,15,10,5
Twoshotzz,darkspear,863,hunter,beastmastery,15,10,5
Khels,stormreaver,863,hunter,beastmastery,16,10,6
Jamzlol,frostmourne,863,hunter,beastmastery,18,9,9
Nikronos,quelthalas,863,hunter,beastmastery,18,9,9
Hendó,korgath,863,hunter,beastmastery,18,9,9
Snowjin,stormrage,863,hunter,beastmastery,18,9,9
Viral,grizzly-hills,863,hunter,beastmastery,18,9,9
Tethro,zuljin,863,hunter,beastmastery,18,9,9
Drivebyjuju,dentarg,863,hunter,beastmastery,18,9,9
Booffmeister,area-52,863,hunter,beastmastery,18,9,9
Akoshi,illidan,863,hunter,beastmastery,18,9,9
Xernen,thrall,863,hunter,beastmastery,18,9,9
Tarah,lightbringer,863,hunter,beastmastery,24,9,15
Nubberton,sargeras,863,hunter,beastmastery,24,9,15
Bleedwish,tichondrius,863,hunter,beastmastery,31,9,22
Seáhawk,kiljaeden,862,hunter,beastmastery,12,9,3
Loriandel,proudmoore,862,hunter,beastmastery,14,9,5
Strongene,aegwynn,862,hunter,beastmastery,18,9,9
Kinete,proudmoore,862,hunter,beastmastery,18,9,9
Qúin,frostmourne,862,hunter,beastmastery,18,9,9
Toross,stormscale,862,hunter,beastmastery,18,9,9
Puppe,sargeras,862,hunter,beastmastery,21,10,11
Hawkeye,boulderfist,862,hunter,beastmastery,24,9,15
Artemisa,warsong,862,hunter,beastmastery,24,9,15
Korasaurus,tichondrius,861,hunter,beastmastery,12,9,3
Hrodvitnir,quelthalas,861,hunter,beastmastery,24,9,15
Exotichunter,the-underbog,861,hunter,beastmastery,24,9,15
Trápngap,barthilas,861,hunter,beastmastery,24,9,15
Jahir,tichondrius,860,hunter,beastmastery,18,9,9
Goinghuntin,frostmourne,859,hunter,beastmastery,18,9,9
Xeriife,stormrage,858,hunter,beastmastery,19,9,10
Chuphunts,tichondrius,857,hunter,beastmastery,12,9,3
Vexxør,bleeding-hollow,856,hunter,beastmastery,18,9,9
Kalekros,tichondrius,856,hunter,beastmastery,30,9,21
Galerius,illidan,855,hunter,beastmastery,30,9,21
Sagittarion,malfurion,854,hunter,beastmastery,19,10,9
Shiztec,malganis,854,hunter,beastmastery,24,9,15
Hunterdps,gurubashi,851,hunter,beastmastery,18,9,9
Survival,dentarg,851,hunter,beastmastery,24,9,15
Eggsquatch,emerald-dream,844,hunter,beastmastery,12,9,3
Noahxkhalel,azralon,832,hunter,beastmastery,29,9,20
Åspect,aegwynn,831,hunter,beastmastery,17,9,8
Spunky,zuluhed,830,hunter,beastmastery,17,9,8
Flamenco,arthas,830,hunter,beastmastery,17,9,8
Vastiks,dalaran,829,hunter,beastmastery,26,9,17
Coletrickle,chogall,822,hunter,beastmastery,32,10,22
Monatre,fizzcrank,816,hunter,beastmastery,21,9,12
Rawspits,kiljaeden,814,hunter,beastmastery,29,9,20
Vyalaris,emerald-dream,813,hunter,beastmastery,21,9,12
Smallsouljah,demon-soul,810,hunter,beastmastery,21,9,12
Trianthel,azralon,803,hunter,beastmastery,18,10,8
Bagurgur,tichondrius,799,hunter,beastmastery,16,9,7
Jonyvi,stormrage,798,hunter,beastmastery,19,10,9
Anya,proudmoore,789,hunter,beastmastery,36,13,23
Puns,stormreaver,768,hunter,beastmastery,12,8,4
Meshunt,tichondrius,768,hunter,beastmastery,12,8,4
Ogstrutt,zuljin,768,hunter,beastmastery,12,8,4
Bowzørx,tichondrius,768,hunter,beastmastery,12,8,4
Seljzs,zuljin,768,hunter,beastmastery,12,8,4
Chippendales,illidan,768,hunter,beastmastery,12,8,4
Jsrhuntz,sargeras,768,hunter,beastmastery,12,8,4
Flub,shadow-council,768,hunter,beastmastery,12,8,4
Turbows,proudmoore,768,hunter,beastmastery,12,8,4
Urukah,gallywix,768,hunter,beastmastery,18,8,10
Yonzo,area-52,768,hunter,beastmastery,18,8,10
Tigglyjits,tichondrius,768,hunter,beastmastery,18,8,10
Heädshöt,malorne,768,hunter,beastmastery,18,8,10
Kolosaltraps,tichondrius,768,hunter,beastmastery,18,8,10
Oblitus,zuljin,768,hunter,beastmastery,18,8,10
Kellsier,nordrassil,768,hunter,beastmastery,18,8,10
Ddukgue,tichondrius,768,hunter,beastmastery,18,8,10
Bicas,emerald-dream,768,hunter,beastmastery,18,8,10
Teammatescba,tichondrius,768,hunter,beastmastery,18,8,10
Seongnam,tichondrius,768,hunter,beastmastery,18,8,10
Trapordíe,tichondrius,768,hunter,beastmastery,18,8,10
Katherìnelol,tichondrius,768,hunter,beastmastery,21,9,12
Aamoody,bloodhoof,768,hunter,beastmastery,24,8,16
Flacidpasta,sargeras,767,hunter,beastmastery,12,8,4
Remièl,frostmourne,767,hunter,beastmastery,12,8,4
Hackerman,tichondrius,767,hunter,beastmastery,12,8,4
Cxnt,saurfang,767,hunter,beastmastery,15,9,6
Gorgoon,sargeras,767,hunter,beastmastery,16,9,7
Morbow,proudmoore,767,hunter,beastmastery,18,8,10
Bowjingles,blackrock,767,hunter,beastmastery,18,8,10
Thehunturd,dalaran,767,hunter,beastmastery,18,8,10
Picapaul,stormrage,767,hunter,beastmastery,18,8,10
Jesselos,stormrage,767,hunter,beastmastery,18,8,10
Flîp,daggerspine,767,hunter,beastmastery,18,8,10
Jímmycorn,sargeras,767,hunter,beastmastery,18,8,10
Zephanno,sargeras,767,hunter,beastmastery,18,8,10
Raphgun,stormrage,767,hunter,beastmastery,18,8,10
Brickgrimes,illidan,767,hunter,beastmastery,19,8,11
Lûrtz,aegwynn,767,hunter,beastmastery,21,8,13
Folf,turalyon,767,hunter,beastmastery,24,8,16
Blanar,quelthalas,767,hunter,beastmastery,30,8,22
Laudion,quelthalas,766,hunter,beastmastery,12,8,4
Traps,deathwing,766,hunter,beastmastery,18,8,10
Atheranni,azralon,766,hunter,beastmastery,18,8,10
Satours,quelthalas,766,hunter,beastmastery,18,8,10
Hideontrap,malganis,766,hunter,beastmastery,18,8,10
Thirtyeight,blades-edge,766,hunter,beastmastery,18,8,10
Byrdh,zuljin,766,hunter,beastmastery,21,9,12
Crumpit,moon-guard,766,hunter,beastmastery,27,8,19
Calbone,stormrage,765,hunter,beastmastery,12,8,4
Ivix,sargeras,765,hunter,beastmastery,12,8,4
Handicrap,tichondrius,765,hunter,beastmastery,16,9,7
Hunt,akama,765,hunter,beastmastery,24,8,16
Gigawrench,darkspear,763,hunter,beastmastery,12,8,4
Skarioth,azralon,763,hunter,beastmastery,18,8,10
Grøøves,dalaran,763,hunter,beastmastery,18,8,10
Ashantii,hakkar,762,hunter,beastmastery,12,8,4
Shamtus,bladefist,762,hunter,beastmastery,12,8,4
Halberick,quelthalas,762,hunter,beastmastery,12,8,4
Jayker,illidan,762,hunter,beastmastery,12,8,4
Werekluetus,sargeras,762,hunter,beastmastery,18,8,10
Élmérfudd,tichondrius,762,hunter,beastmastery,24,8,16
Bakharnabi,azralon,760,hunter,beastmastery,18,8,10
Ophiela,shuhalo,759,hunter,beastmastery,36,8,28
Shikago,wyrmrest-accord,758,hunter,beastmastery,24,8,16
Massivattack,skullcrusher,758,hunter,beastmastery,24,8,16
Blankshot,doomhammer,757,hunter,beastmastery,18,8,10
Bblsallday,illidan,754,hunter,beastmastery,12,8,4
Androki,stormrage,752,hunter,beastmastery,12,8,4
Raevenah,dalaran,747,hunter,beastmastery,12,8,4
Stimpblimp,jubeithos,736,hunter,beastmastery,16,8,8
Vendortrash,aggramar,733,hunter,beastmastery,17,8,9
Timberex,drenden,715,hunter,beastmastery,15,8,7
Kysii,burning-blade,714,hunter,beastmastery,21,8,13
Cloxygen,moon-guard,713,hunter,beastmastery,22,9,13
Popster,cenarius,704,hunter,beastmastery,16,8,8
Plastera,zuljin,704,hunter,beastmastery,28,8,20
Petpenguin,kelthuzad,703,hunter,beastmastery,11,8,3
Yozomoto,nordrassil,703,hunter,beastmastery,14,8,6
Jinchuriki,shadow-council,703,hunter,beastmastery,28,8,20
Snoozee,emerald-dream,702,hunter,beastmastery,20,8,12
Pheijaumn,azralon,687,hunter,beastmastery,13,8,5
Mylaqt,malganis,672,hunter,beastmastery,12,7,5
Sakedji,area-52,672,hunter,beastmastery,12,7,5
Snapyaf,area-52,672,hunter,beastmastery,12,7,5
Mehontar,area-52,672,hunter,beastmastery,12,7,5
Alfentanil,thrall,672,hunter,beastmastery,12,7,5
Akirarika,wyrmrest-accord,672,hunter,beastmastery,12,7,5
Mauiies,sargeras,672,hunter,beastmastery,12,7,5
Yolotraps,thrall,672,hunter,beastmastery,12,7,5
Pmø,sargeras,672,hunter,beastmastery,12,7,5
Gotrap,saurfang,672,hunter,beastmastery,12,7,5
Gentledream,dalaran,672,hunter,beastmastery,12,7,5
Wellerman,firetree,672,hunter,beastmastery,12,7,5
Gunbladez,burning-blade,672,hunter,beastmastery,12,7,5
Litchi,illidan,672,hunter,beastmastery,12,7,5
Mhters,tichondrius,672,hunter,beastmastery,12,7,5
Starkhaven,firetree,672,hunter,beastmastery,12,7,5
Cumman,sargeras,672,hunter,beastmastery,12,7,5
Handmemygun,aggramar,672,hunter,beastmastery,12,7,5
Gun,shadowsong,672,hunter,beastmastery,12,7,5
Balldik,bleeding-hollow,672,hunter,beastmastery,12,7,5
Barainto,tichondrius,672,hunter,beastmastery,12,7,5
Skippyh,zuluhed,672,hunter,beastmastery,12,7,5
Xerosa,emerald-dream,672,hunter,beastmastery,12,7,5
Snowmnz,tichondrius,672,hunter,beastmastery,12,7,5
Downor,malganis,672,hunter,beastmastery,12,7,5
Jsr,tichondrius,672,hunter,beastmastery,12,7,5
Grannygatya,tichondrius,672,hunter,beastmastery,12,7,5
Jawnhunterii,tichondrius,672,hunter,beastmastery,12,7,5
Buzzkilla,mannoroth,672,hunter,beastmastery,12,7,5
Cinnybunz,malganis,672,hunter,beastmastery,12,7,5
Crimsoncoast,tichondrius,672,hunter,beastmastery,12,7,5
Csantana,sargeras,672,hunter,beastmastery,12,7,5
Hollowhunt,sentinels,672,hunter,beastmastery,12,7,5
Beabalm,dalaran,672,hunter,beastmastery,12,7,5
Tusxx,tichondrius,672,hunter,beastmastery,12,7,5
Shaytime,proudmoore,672,hunter,beastmastery,16,8,8
Houdan,frostmourne,672,hunter,beastmastery,16,7,9
Ðevil,ragnaros,672,hunter,beastmastery,18,7,11
Souperman,malganis,672,hunter,beastmastery,18,7,11
Sylpheous,bleeding-hollow,672,hunter,beastmastery,18,7,11
Geeshot,area-52,672,hunter,beastmastery,18,7,11
Joerogan,hydraxis,672,hunter,beastmastery,18,7,11
Chunco,ragnaros,672,hunter,beastmastery,18,7,11
Antares,dalaran,672,hunter,beastmastery,18,7,11
Dreagneal,ragnaros,672,hunter,beastmastery,18,7,11
Clowntown,illidan,672,hunter,beastmastery,18,7,11
Sunsinfour,proudmoore,672,hunter,beastmastery,24,7,17
Titanaxis,tichondrius,672,hunter,beastmastery,24,7,17
Melinda,kilrogg,671,hunter,beastmastery,12,7,5
Anniefuchsia,stormrage,671,hunter,beastmastery,12,7,5
Winzip,whisperwind,671,hunter,beastmastery,12,7,5
Scrubmastery,emerald-dream,671,hunter,beastmastery,12,7,5
Pillarington,tichondrius,671,hunter,beastmastery,12,7,5
Valintine,the-scryers,671,hunter,beastmastery,12,7,5
Mannypew,kelthuzad,671,hunter,beastmastery,12,7,5
Deadlyarrows,ragnaros,671,hunter,beastmastery,12,7,5
Minkô,tichondrius,671,hunter,beastmastery,12,7,5
Óriion,zuljin,671,hunter,beastmastery,12,7,5
Jendell,area-52,671,hunter,beastmastery,12,7,5
Spunkked,tichondrius,671,hunter,beastmastery,12,7,5
Exploits,stormrage,671,hunter,beastmastery,12,7,5
Lavo,borean-tundra,671,hunter,beastmastery,12,7,5
Wook,hyjal,671,hunter,beastmastery,12,7,5
Beardedeagle,tichondrius,671,hunter,beastmastery,15,8,7
Shdwhntrclub,wyrmrest-accord,671,hunter,beastmastery,18,7,11
Heylenny,area-52,671,hunter,beastmastery,18,7,11
Threethirty,thrall,671,hunter,beastmastery,18,7,11
Nephewblasty,nagrand,671,hunter,beastmastery,18,7,11
Peiching,proudmoore,671,hunter,beastmastery,18,7,11
Mooséhunt,wyrmrest-accord,671,hunter,beastmastery,18,7,11
Genowin,sargeras,671,hunter,beastmastery,18,7,11
Amortiz,illidan,671,hunter,beastmastery,18,7,11
Cotó,stormrage,671,hunter,beastmastery,18,7,11
Ratfood,tichondrius,671,hunter,beastmastery,23,7,16
Enigmer,area-52,670,hunter,beastmastery,12,7,5
Yanzz,spinebreaker,670,hunter,beastmastery,12,7,5
Bittitan,frostmourne,670,hunter,beastmastery,12,7,5
Topgun,laughing-skull,670,hunter,beastmastery,12,7,5
Madness,zuljin,670,hunter,beastmastery,12,7,5
Myrfes,ragnaros,670,hunter,beastmastery,18,7,11
Fawn,moon-guard,670,hunter,beastmastery,18,7,11
Spaeth,borean-tundra,670,hunter,beastmastery,24,7,17
Aybeara,area-52,669,hunter,beastmastery,18,7,11
Fynnigan,shandris,669,hunter,beastmastery,18,7,11
Neurosurgery,azralon,669,hunter,beastmastery,18,7,11
Terusa,ragnaros,667,hunter,beastmastery,24,7,17
Strafenshoot,darkspear,666,hunter,beastmastery,12,7,5
Badboyzcry,deathwing,666,hunter,beastmastery,12,7,5
Eastera,tichondrius,663,hunter,beastmastery,27,8,19
Cbramatacera,drakkari,661,hunter,beastmastery,12,7,5
Ruthgarth,akama,661,hunter,beastmastery,18,7,11
Theprovider,burning-blade,659,hunter,beastmastery,12,7,5
Benryats,area-52,657,hunter,beastmastery,21,8,13
Legendhunter,quelthalas,655,hunter,beastmastery,12,8,4
Lyduc,barthilas,655,hunter,beastmastery,17,7,10
Pewpew,gallywix,649,hunter,beastmastery,23,7,16
Boomsprocket,khazgoroth,639,hunter,beastmastery,8,8,0
Hikkupz,tichondrius,639,hunter,beastmastery,17,7,10
Hawkkeye,thunderlord,639,hunter,beastmastery,17,7,10
Scaredcrow,azshara,639,hunter,beastmastery,28,7,21
Sleepywrld,area-52,638,hunter,beastmastery,17,7,10
Hunbatz,dalaran,634,hunter,beastmastery,19,9,10
Árescarries,shuhalo,623,hunter,beastmastery,15,7,8
Ashx,nemesis,623,hunter,beastmastery,17,7,10
Lieolaste,area-52,618,hunter,beastmastery,17,7,10
Danion,aerie-peak,607,hunter,beastmastery,16,7,9
Supdawg,aggramar,607,hunter,beastmastery,17,7,10
Shootdogg,mannoroth,607,hunter,beastmastery,20,7,13
Shanghunt,cenarius,604,hunter,beastmastery,14,7,7
Oshosiwar,ragnaros,588,hunter,beastmastery,21,7,14
Igotapvpness,tichondrius,576,hunter,beastmastery,6,6,0
Drwíggles,smolderthorn,576,hunter,beastmastery,6,6,0
Rekkis,area-52,576,hunter,beastmastery,6,6,0
Gassmask,area-52,576,hunter,beastmastery,6,6,0
Jjaro,area-52,576,hunter,beastmastery,6,6,0
Píps,maelstrom,576,hunter,beastmastery,6,6,0
Shøz,wyrmrest-accord,576,hunter,beastmastery,12,6,6
Jonah,sargeras,576,hunter,beastmastery,12,6,6
Jagare,tichondrius,576,hunter,beastmastery,12,6,6
Thoridhal,quelthalas,576,hunter,beastmastery,12,6,6
Ordius,azralon,576,hunter,beastmastery,12,6,6
Raadun,terokkar,576,hunter,beastmastery,12,6,6
Hunterpk,lightbringer,576,hunter,beastmastery,12,6,6
Zookeepah,tichondrius,576,hunter,beastmastery,12,6,6
Khanittus,area-52,576,hunter,beastmastery,12,6,6
Ahncheolsoo,tichondrius,576,hunter,beastmastery,12,6,6
Jalinhabbei,azralon,576,hunter,beastmastery,12,6,6
Toniic,moon-guard,576,hunter,beastmastery,12,6,6
Despise,frostmourne,576,hunter,beastmastery,12,6,6
Invisabootz,hyjal,576,hunter,beastmastery,12,6,6
Pikabow,tichondrius,576,hunter,beastmastery,12,6,6
Recklaw,frostmourne,576,hunter,beastmastery,12,6,6
Ærês,ysondre,576,hunter,beastmastery,12,6,6
Thebush,dragonmaw,576,hunter,beastmastery,12,6,6
Retaâáàäãart,tichondrius,576,hunter,beastmastery,12,6,6
Alochol,vashj,576,hunter,beastmastery,12,6,6
Orqism,tichondrius,576,hunter,beastmastery,12,6,6
Huntncheekz,kelthuzad,576,hunter,beastmastery,12,6,6
Vindication,ysera,576,hunter,beastmastery,12,6,6
Tangoda,tichondrius,576,hunter,beastmastery,12,6,6
Jboogie,malganis,576,hunter,beastmastery,12,6,6
Evilblammo,thorium-brotherhood,576,hunter,beastmastery,12,6,6
Jockitch,wildhammer,576,hunter,beastmastery,12,6,6
Drdill,gorefiend,576,hunter,beastmastery,12,6,6
Peregrin,burning-legion,576,hunter,beastmastery,12,6,6
Dbrickashaw,proudmoore,576,hunter,beastmastery,12,6,6
Hxnry,barthilas,576,hunter,beastmastery,12,6,6
Somethinglit,sargeras,576,hunter,beastmastery,12,6,6
Spottedoger,burning-legion,576,hunter,beastmastery,12,6,6
Actioh,stormrage,576,hunter,beastmastery,12,6,6
Raerdun,bonechewer,576,hunter,beastmastery,12,6,6
Balboa,tortheldrin,576,hunter,beastmastery,12,6,6
Daylilycoast,emerald-dream,576,hunter,beastmastery,12,6,6
Jwzz,tichondrius,576,hunter,beastmastery,12,6,6
Gennaro,ragnaros,576,hunter,beastmastery,12,6,6
Huntard,stormrage,576,hunter,beastmastery,12,6,6
Nytefell,skullcrusher,576,hunter,beastmastery,12,6,6
Wongy,tichondrius,576,hunter,beastmastery,12,6,6
Gravshot,zuljin,576,hunter,beastmastery,12,6,6
Zertkal,undermine,576,hunter,beastmastery,12,6,6
Wapnonymous,mugthol,576,hunter,beastmastery,12,6,6
Skyfel,aggramar,576,hunter,beastmastery,12,6,6
Zeedii,dalaran,576,hunter,beastmastery,12,6,6
Robitur,sargeras,576,hunter,beastmastery,12,6,6
Kånade,ragnaros,576,hunter,beastmastery,12,6,6
Fma,stormrage,576,hunter,beastmastery,12,6,6
Bloodymalik,tichondrius,576,hunter,beastmastery,12,6,6
Kyoü,drakkari,576,hunter,beastmastery,12,6,6
Shyck,ragnaros,576,hunter,beastmastery,12,6,6
Misakilr,illidan,576,hunter,beastmastery,13,6,7
Arraza,ragnaros,576,hunter,beastmastery,16,7,9
Ljai,gilneas,576,hunter,beastmastery,18,6,12
Nishinos,tichondrius,576,hunter,beastmastery,18,6,12
Kanta,bleeding-hollow,576,hunter,beastmastery,18,6,12
Mørødox,sargeras,576,hunter,beastmastery,18,6,12
Virgim,kelthuzad,576,hunter,beastmastery,18,6,12
Pieman,azuremyst,576,hunter,beastmastery,18,6,12
Bighuntz,bleeding-hollow,576,hunter,beastmastery,24,6,18
Sniffler,barthilas,576,hunter,beastmastery,24,6,18
Yolloswag,tichondrius,576,hunter,beastmastery,24,6,18
Beastbaal,sargeras,576,hunter,beastmastery,24,6,18
Lulafourdedo,stormrage,575,hunter,beastmastery,7,6,1
Noitrag,azralon,575,hunter,beastmastery,11,6,5
Míbu,lightbringer,575,hunter,beastmastery,12,6,6
Mindbreaker,illidan,575,hunter,beastmastery,12,6,6
Gammaraven,dalaran,575,hunter,beastmastery,12,6,6
Drimhuzzah,velen,575,hunter,beastmastery,12,6,6
Eastwake,stormrage,575,hunter,beastmastery,12,6,6
Recoyl,proudmoore,575,hunter,beastmastery,12,6,6
Ovî,area-52,575,hunter,beastmastery,12,6,6
Burtone,aegwynn,575,hunter,beastmastery,12,6,6
Wdb,tichondrius,575,hunter,beastmastery,12,6,6
Yobby,area-52,575,hunter,beastmastery,12,6,6
Fireshots,tichondrius,575,hunter,beastmastery,12,6,6
Gwarnar,stormrage,575,hunter,beastmastery,12,6,6
Asuryakha,darkspear,575,hunter,beastmastery,12,6,6
Jayken,gnomeregan,575,hunter,beastmastery,12,6,6
Rankhor,darkspear,575,hunter,beastmastery,12,6,6
Sabanna,proudmoore,575,hunter,beastmastery,12,6,6
Horsegirl,chogall,575,hunter,beastmastery,12,6,6
Galadrieel,magtheridon,575,hunter,beastmastery,18,6,12
Aliciaomg,andorhal,575,hunter,beastmastery,18,6,12
Balsagoth,azralon,575,hunter,beastmastery,18,6,12
Mouthymerc,zuljin,575,hunter,beastmastery,18,6,12
Tozier,destromath,575,hunter,beastmastery,18,6,12
Camorcaist,stormrage,575,hunter,beastmastery,18,6,12
Chimpx,moon-guard,575,hunter,beastmastery,18,6,12
Trionias,malfurion,575,hunter,beastmastery,24,6,18
Arcticuz,aegwynn,574,hunter,beastmastery,12,6,6
Nekrongar,agamaggan,574,hunter,beastmastery,12,6,6
Kalibah,azralon,574,hunter,beastmastery,18,6,12
Sapphie,frostmourne,574,hunter,beastmastery,24,6,18
Rikitiki,bleeding-hollow,573,hunter,beastmastery,12,6,6
Foffy,darkspear,573,hunter,beastmastery,12,6,6
Elfinballz,khadgar,573,hunter,beastmastery,18,6,12
Dakirell,drakkari,573,hunter,beastmastery,18,6,12
Dethh,dunemaul,572,hunter,beastmastery,12,6,6
Drpenatrator,barthilas,572,hunter,beastmastery,12,6,6
Pewpewd,tichondrius,572,hunter,beastmastery,12,6,6
Dragonman,grizzly-hills,572,hunter,beastmastery,30,6,24
Katmang,frostmourne,571,hunter,beastmastery,18,6,12
Speirs,tichondrius,570,hunter,beastmastery,18,6,12
Daréz,blackrock,569,hunter,beastmastery,19,8,11
Kargathx,ragnaros,569,hunter,beastmastery,20,8,12
Bluehead,emerald-dream,566,hunter,beastmastery,12,6,6
Skullgrain,eitrigg,559,hunter,beastmastery,17,6,11
Parâsite,kelthuzad,559,hunter,beastmastery,23,6,17
Jîa,tichondrius,544,hunter,beastmastery,16,6,10
Squeeb,frostmourne,543,hunter,beastmastery,14,7,7
Habanero,anetheron,543,hunter,beastmastery,14,7,7
Tezlekhan,haomarush,543,hunter,beastmastery,17,6,11
Viserysll,azralon,542,hunter,beastmastery,11,6,5
Trycen,bleeding-hollow,527,hunter,beastmastery,11,6,5
Rachetbutt,tichondrius,527,hunter,beastmastery,11,6,5
Pikepounder,tichondrius,527,hunter,beastmastery,15,6,9
Socrato,tichondrius,526,hunter,beastmastery,11,6,5
Ataxyus,area-52,512,hunter,beastmastery,10,6,4
Bowjobs,stormscale,511,hunter,beastmastery,14,6,8
Aluminumfoil,kelthuzad,510,hunter,beastmastery,11,6,5
Bagodonuts,malganis,510,hunter,beastmastery,17,7,10
Malthiz,antonidas,507,hunter,beastmastery,22,8,14
Jackcoügh,frostmourne,496,hunter,beastmastery,13,6,7
Zock,lothar,494,hunter,beastmastery,19,6,13
Zansnipes,dalaran,480,hunter,beastmastery,6,5,1
Tukki,quelthalas,480,hunter,beastmastery,6,5,1
Unloaded,illidan,480,hunter,beastmastery,6,5,1
Oeoeoeoeoeoe,alterac-mountains,480,hunter,beastmastery,6,5,1
Bluez,tichondrius,480,hunter,beastmastery,6,5,1
Cojáx,dalaran,480,hunter,beastmastery,6,5,1
Slêv,frostmourne,480,hunter,beastmastery,6,5,1
Hitx,tichondrius,480,hunter,beastmastery,6,5,1
Laoai,tichondrius,480,hunter,beastmastery,6,5,1
Nsjp,darkspear,480,hunter,beastmastery,6,5,1
Añtø,tichondrius,480,hunter,beastmastery,6,5,1
Traptrinket,sargeras,480,hunter,beastmastery,6,5,1
Berkhof,tichondrius,480,hunter,beastmastery,6,5,1
Linkolnn,sargeras,480,hunter,beastmastery,6,5,1
Plsnobanmee,frostmourne,480,hunter,beastmastery,6,5,1
Yajr,black-dragonflight,480,hunter,beastmastery,6,5,1
Brokensnipez,area-52,480,hunter,beastmastery,6,5,1
Wopper,moon-guard,480,hunter,beastmastery,6,5,1
Arrebol,tichondrius,480,hunter,beastmastery,6,5,1
Tèrrabite,sargeras,480,hunter,beastmastery,6,5,1
Chimeralol,area-52,480,hunter,beastmastery,6,5,1
Nokda,tichondrius,480,hunter,beastmastery,6,5,1
Darylovejr,destromath,480,hunter,beastmastery,6,5,1
Kkoduckk,tichondrius,480,hunter,beastmastery,6,5,1
Arthäsxd,azralon,480,hunter,beastmastery,6,5,1
Dankshunt,arthas,480,hunter,beastmastery,6,5,1
Megahuntard,bleeding-hollow,480,hunter,beastmastery,6,5,1
Airoh,gorefiend,480,hunter,beastmastery,10,6,4
Grizmin,sargeras,480,hunter,beastmastery,12,5,7
Skillvanas,stormrage,480,hunter,beastmastery,12,5,7
Sunflwerdawn,emerald-dream,480,hunter,beastmastery,12,5,7
Lissavi,tichondrius,480,hunter,beastmastery,12,5,7
Drakku,zuljin,480,hunter,beastmastery,12,5,7
Wønky,stormrage,480,hunter,beastmastery,12,5,7
Imperatrix,emerald-dream,480,hunter,beastmastery,12,5,7
Chouklak,zuljin,480,hunter,beastmastery,12,5,7
Silveraero,ghostlands,480,hunter,beastmastery,12,5,7
Oblio,silvermoon,480,hunter,beastmastery,12,5,7
Killaseason,akama,480,hunter,beastmastery,12,5,7
Pichsolika,frostmourne,480,hunter,beastmastery,12,5,7
Sinvat,tichondrius,480,hunter,beastmastery,12,5,7
Tosila,tichondrius,480,hunter,beastmastery,12,5,7
Lindsang,illidan,480,hunter,beastmastery,12,5,7
Hitcompleted,moon-guard,480,hunter,beastmastery,12,5,7
Thejw,firetree,480,hunter,beastmastery,12,5,7
Orcbeast,illidan,480,hunter,beastmastery,12,5,7
Twoshotz,stormrage,480,hunter,beastmastery,12,5,7
Nashi,burning-blade,480,hunter,beastmastery,12,5,7
Yesterday,draka,480,hunter,beastmastery,12,5,7
Roostersauce,durotan,480,hunter,beastmastery,12,5,7
Nj,kiljaeden,480,hunter,beastmastery,12,5,7
Mostmanly,tichondrius,480,hunter,beastmastery,12,5,7
Kurmojo,hyjal,480,hunter,beastmastery,12,5,7
Køk,agamaggan,480,hunter,beastmastery,12,5,7
Chipsncheese,korgath,480,hunter,beastmastery,12,5,7
Àthenaa,malygos,480,hunter,beastmastery,12,5,7
Banai,the-underbog,480,hunter,beastmastery,12,5,7
Mojopojo,tichondrius,480,hunter,beastmastery,12,5,7
Fallacies,moon-guard,480,hunter,beastmastery,12,5,7
Valeous,azjolnerub,480,hunter,beastmastery,12,5,7
Ariais,zangarmarsh,480,hunter,beastmastery,12,5,7
Survchris,bleeding-hollow,480,hunter,beastmastery,12,5,7
Ferex,tichondrius,480,hunter,beastmastery,12,5,7
Michaeljfox,area-52,480,hunter,beastmastery,12,5,7
Smexyhunter,moon-guard,480,hunter,beastmastery,12,5,7
Taphh,moon-guard,480,hunter,beastmastery,12,5,7
Alssong,tichondrius,480,hunter,beastmastery,12,5,7
Bowzza,area-52,480,hunter,beastmastery,12,5,7
Powdersoak,area-52,480,hunter,beastmastery,12,5,7
Mav,dragonmaw,480,hunter,beastmastery,14,5,9
Bøl,ragnaros,480,hunter,beastmastery,16,5,11
Chetxs,bleeding-hollow,480,hunter,beastmastery,18,5,13
Trycaza,ragnaros,480,hunter,beastmastery,18,5,13
Motegi,illidan,480,hunter,beastmastery,18,5,13
Grindal,drakkari,480,hunter,beastmastery,18,5,13
Soulshots,malganis,480,hunter,beastmastery,18,5,13
Prierhunt,frostmourne,480,hunter,beastmastery,18,5,13
Cophunter,tichondrius,480,hunter,beastmastery,18,5,13
Blockbusters,sargeras,480,hunter,beastmastery,18,5,13
Kaitoo,tichondrius,480,hunter,beastmastery,18,5,13
Amoreiene,stormrage,480,hunter,beastmastery,18,5,13
Semiautmatic,thrall,480,hunter,beastmastery,18,5,13
Snoogen,illidan,480,hunter,beastmastery,18,5,13
Sizzimus,area-52,479,hunter,beastmastery,6,5,1
Mafghine,malganis,479,hunter,beastmastery,6,5,1
Segulah,dalaran,479,hunter,beastmastery,6,5,1
Zpax,area-52,479,hunter,beastmastery,6,5,1
Zhanzu,quelthalas,479,hunter,beastmastery,12,5,7
Kairoke,azralon,479,hunter,beastmastery,12,5,7
Traxêx,nemesis,479,hunter,beastmastery,12,5,7
Mecatrón,quelthalas,479,hunter,beastmastery,12,5,7
Chosan,sargeras,479,hunter,beastmastery,12,5,7
Equipmunk,arthas,479,hunter,beastmastery,12,5,7
Shoya,nerzhul,479,hunter,beastmastery,12,5,7
Deadlyattack,barthilas,479,hunter,beastmastery,12,5,7
Trushôtz,tichondrius,479,hunter,beastmastery,17,5,12
Boomup,tichondrius,479,hunter,beastmastery,21,6,15
Snipershot,blackrock,479,hunter,beastmastery,18,5,13
Smider,magtheridon,479,hunter,beastmastery,18,5,13
Starkmeister,stormrage,479,hunter,beastmastery,18,5,13
Seenobody,stormrage,479,hunter,beastmastery,23,5,18
Zarrockk,emerald-dream,478,hunter,beastmastery,12,5,7
Fiznits,nerzhul,478,hunter,beastmastery,18,5,13
Slowbear,kiljaeden,477,hunter,beastmastery,12,5,7
Feralhuntard,muradin,477,hunter,beastmastery,12,5,7
Mehtcurious,ragnaros,470,hunter,beastmastery,18,5,13
Gunther,korgath,447,hunter,beastmastery,11,5,6
Travisshot,tichondrius,447,hunter,beastmastery,11,5,6
Verzatyle,frostwolf,447,hunter,beastmastery,11,5,6
Revenantz,stormrage,447,hunter,beastmastery,11,5,6
Vuur,korialstrasz,447,hunter,beastmastery,19,6,13
Rástakhan,ragnaros,431,hunter,beastmastery,11,5,6
Hazzlôk,cairne,426,hunter,beastmastery,20,7,13
Malgar,zuljin,415,hunter,beastmastery,11,5,6
Resonators,tichondrius,400,hunter,beastmastery,13,5,8
Fizzpow,blackrock,384,hunter,beastmastery,6,4,2
Naxhunter,stormrage,384,hunter,beastmastery,6,4,2
Silvershot,emerald-dream,384,hunter,beastmastery,6,4,2
Terezhunt,tichondrius,384,hunter,beastmastery,6,4,2
Dcousins,tichondrius,384,hunter,beastmastery,6,4,2
Bmobepip,malganis,384,hunter,beastmastery,6,4,2
Yosra,frostmourne,384,hunter,beastmastery,6,4,2
Ashevan,stormrage,384,hunter,beastmastery,6,4,2
Szeh,tichondrius,384,hunter,beastmastery,6,4,2
Sôuleater,moon-guard,384,hunter,beastmastery,6,4,2
Ithanna,quelthalas,384,hunter,beastmastery,6,4,2
Gorillafart,spirestone,384,hunter,beastmastery,6,4,2
Markymarc,tichondrius,384,hunter,beastmastery,6,4,2
Bigkolache,zuljin,384,hunter,beastmastery,6,4,2
Baconzola,dalaran,384,hunter,beastmastery,6,4,2
Jerso,zuljin,384,hunter,beastmastery,6,4,2
Bodangel,galakrond,384,hunter,beastmastery,6,4,2
Reilerhunt,stormrage,384,hunter,beastmastery,6,4,2
Redzic,tichondrius,384,hunter,beastmastery,6,4,2
Kong,tichondrius,384,hunter,beastmastery,6,4,2
Ragerab,trollbane,384,hunter,beastmastery,6,4,2
Bufluu,bleeding-hollow,384,hunter,beastmastery,6,4,2
Moash,spinebreaker,384,hunter,beastmastery,6,4,2
Coolbeanz,boulderfist,384,hunter,beastmastery,6,4,2
Eglon,bleeding-hollow,384,hunter,beastmastery,6,4,2
Küky,ragnaros,384,hunter,beastmastery,6,4,2
Malcab,tichondrius,384,hunter,beastmastery,6,4,2
Zubo,tichondrius,384,hunter,beastmastery,6,4,2
Dd,frostmourne,384,hunter,beastmastery,6,4,2
Splosiv,stormrage,384,hunter,beastmastery,6,4,2
Tezcâtlipocâ,sargeras,384,hunter,beastmastery,6,4,2
Sindshai,onyxia,384,hunter,beastmastery,6,4,2
Skað,lightbringer,384,hunter,beastmastery,6,4,2
Mexishots,tichondrius,384,hunter,beastmastery,6,4,2
Zarnick,frostwolf,384,hunter,beastmastery,6,4,2
Tupirani,azralon,384,hunter,beastmastery,6,4,2
Chichi,korgath,384,hunter,beastmastery,6,4,2
Probo,aegwynn,384,hunter,beastmastery,6,4,2
Dexh,frostmourne,384,hunter,beastmastery,6,4,2
Whatfoxsay,tichondrius,384,hunter,beastmastery,6,4,2
Skytah,darkspear,384,hunter,beastmastery,6,4,2
Shiki,icecrown,384,hunter,beastmastery,6,4,2
Lowlore,moon-guard,384,hunter,beastmastery,6,4,2
Infatuatedx,moon-guard,384,hunter,beastmastery,6,4,2
Yeaheh,area-52,384,hunter,beastmastery,6,4,2
Föcker,emerald-dream,384,hunter,beastmastery,6,4,2
Chikkynuggy,destromath,384,hunter,beastmastery,6,4,2
Dayquillx,illidan,384,hunter,beastmastery,6,4,2
Chokemescara,stormrage,384,hunter,beastmastery,6,4,2
Eazyaimz,thrall,384,hunter,beastmastery,6,4,2
Drinktodrown,moon-guard,384,hunter,beastmastery,6,4,2
Berreydingle,norgannon,384,hunter,beastmastery,6,4,2
Coppersnout,wyrmrest-accord,384,hunter,beastmastery,6,4,2
Snipingmilfs,zuluhed,384,hunter,beastmastery,6,4,2
Ziêg,eonar,384,hunter,beastmastery,6,4,2
Nakyash,ragnaros,384,hunter,beastmastery,9,5,4
Jeonghun,tichondrius,384,hunter,beastmastery,9,5,4
Anteróz,tichondrius,384,hunter,beastmastery,9,4,5
Rycksanches,quelthalas,384,hunter,beastmastery,10,4,6
Kok,andorhal,384,hunter,beastmastery,12,4,8
Macabre,scilla,384,hunter,beastmastery,12,4,8
Xcisiion,nagrand,384,hunter,beastmastery,12,4,8
Iililillilii,tichondrius,384,hunter,beastmastery,12,4,8
Grimshot,boulderfist,384,hunter,beastmastery,12,4,8
Calypso,chromaggus,384,hunter,beastmastery,12,4,8
Vencc,tichondrius,384,hunter,beastmastery,12,4,8
Cndavyjones,akama,384,hunter,beastmastery,12,4,8
Bangerzx,stormrage,384,hunter,beastmastery,12,4,8
Noxura,illidan,384,hunter,beastmastery,12,4,8
Rogshunt,sargeras,384,hunter,beastmastery,12,4,8
Dampteeth,sargeras,384,hunter,beastmastery,12,4,8
Moùrningwood,stormrage,384,hunter,beastmastery,12,4,8
Softhunter,tichondrius,384,hunter,beastmastery,12,4,8
Withoutraps,quelthalas,384,hunter,beastmastery,12,4,8
Devastavi,proudmoore,384,hunter,beastmastery,12,4,8
Arcuz,quelthalas,384,hunter,beastmastery,12,4,8
Mingsomnia,kiljaeden,384,hunter,beastmastery,12,4,8
Bówjòb,nordrassil,384,hunter,beastmastery,12,4,8
Bazanguita,tichondrius,384,hunter,beastmastery,12,4,8
Saharä,illidan,384,hunter,beastmastery,12,4,8
Dangerclam,barthilas,384,hunter,beastmastery,12,4,8
Bowsauce,khadgar,384,hunter,beastmastery,12,4,8
Tigerswood,sargeras,384,hunter,beastmastery,12,4,8
Elywen,alexstrasza,384,hunter,beastmastery,12,4,8
Gaydin,zuljin,384,hunter,beastmastery,12,4,8
Valrosan,stormrage,384,hunter,beastmastery,12,4,8
Päinal,area-52,384,hunter,beastmastery,12,4,8
Vandescar,illidan,384,hunter,beastmastery,12,4,8
Seanpaì,tichondrius,384,hunter,beastmastery,12,4,8
Oztroza,grizzly-hills,384,hunter,beastmastery,12,4,8
Pirateninja,illidan,384,hunter,beastmastery,12,4,8
Grumaku,area-52,384,hunter,beastmastery,12,4,8
Shatterwax,area-52,384,hunter,beastmastery,12,4,8
Lookoutt,tichondrius,384,hunter,beastmastery,12,4,8
Oddangel,azuremyst,384,hunter,beastmastery,12,4,8
Odb,kelthuzad,384,hunter,beastmastery,12,4,8
Throwadox,malganis,384,hunter,beastmastery,12,4,8
Miansi,tichondrius,384,hunter,beastmastery,12,4,8
Inetpub,stormrage,384,hunter,beastmastery,12,4,8
Alkynabm,kelthuzad,384,hunter,beastmastery,12,4,8
Skycaptaín,lightbringer,384,hunter,beastmastery,12,4,8
Shaevie,lothar,384,hunter,beastmastery,12,4,8
Cluhaywood,zuljin,384,hunter,beastmastery,12,4,8
Doves,wyrmrest-accord,384,hunter,beastmastery,12,4,8
Thugio,sargeras,384,hunter,beastmastery,12,4,8
Teddybowschi,sargeras,384,hunter,beastmastery,12,4,8
Twopawshunta,tichondrius,384,hunter,beastmastery,12,4,8
Killatrap,malganis,384,hunter,beastmastery,12,4,8
Zylen,tichondrius,384,hunter,beastmastery,12,4,8
Sèasons,tichondrius,384,hunter,beastmastery,15,4,11
Atheos,gallywix,384,hunter,beastmastery,18,4,14
Ruffini,tichondrius,384,hunter,beastmastery,18,4,14
Löö,arthas,384,hunter,beastmastery,23,4,19
Gichiwalrus,emerald-dream,383,hunter,beastmastery,6,4,2
Eeremm,drakkari,383,hunter,beastmastery,6,4,2
Bboo,bonechewer,383,hunter,beastmastery,6,4,2
Paulayork,drakthul,383,hunter,beastmastery,12,4,8
Lamper,emerald-dream,383,hunter,beastmastery,12,4,8
Àléç,mannoroth,383,hunter,beastmastery,12,4,8
Lazygnome,azshara,383,hunter,beastmastery,12,4,8
Beatnyou,tichondrius,383,hunter,beastmastery,12,4,8
Böwjøb,illidan,383,hunter,beastmastery,12,4,8
Huntmeplz,proudmoore,383,hunter,beastmastery,18,4,14
Fiury,hyjal,382,hunter,beastmastery,6,4,2
Etb,bleeding-hollow,382,hunter,beastmastery,12,4,8
Wuzi,echo-isles,380,hunter,beastmastery,12,4,8
Ire,kelthuzad,367,hunter,beastmastery,11,4,7
Nalsa,tichondrius,367,hunter,beastmastery,11,4,7
Sylaris,arathor,366,hunter,beastmastery,11,4,7
Linszsz,nemesis,361,hunter,beastmastery,17,6,11
Kemper,dragonmaw,351,hunter,beastmastery,11,4,7
Clinkz,chogall,351,hunter,beastmastery,11,4,7
Vínçent,blood-furnace,351,hunter,beastmastery,17,4,13
Sadarrow,frostmourne,334,hunter,beastmastery,11,4,7
Hediilyan,azralon,330,hunter,beastmastery,11,6,5
Bugsßunny,sargeras,330,hunter,beastmastery,16,5,11
Punkrockguy,illidan,319,hunter,beastmastery,14,4,10
Seeq,illidan,288,hunter,beastmastery,6,3,3
Tremobbin,kelthuzad,288,hunter,beastmastery,6,3,3
Terrabytés,kelthuzad,288,hunter,beastmastery,6,3,3
Jungling,kelthuzad,288,hunter,beastmastery,6,3,3
Moyria,quelthalas,288,hunter,beastmastery,6,3,3
Mogradme,shadowsong,288,hunter,beastmastery,6,3,3
Tetzuo,illidan,288,hunter,beastmastery,6,3,3
Gupples,frostwolf,288,hunter,beastmastery,6,3,3
Miraclez,nerzhul,288,hunter,beastmastery,6,3,3
Cefla,illidan,288,hunter,beastmastery,6,3,3
Saynice,warsong,288,hunter,beastmastery,6,3,3
Backa,jubeithos,288,hunter,beastmastery,6,3,3
Ironova,illidan,288,hunter,beastmastery,6,3,3
Grayføxx,twisting-nether,288,hunter,beastmastery,6,3,3
Worewolf,lightninghoof,288,hunter,beastmastery,6,3,3
Mastasnipa,illidan,288,hunter,beastmastery,6,3,3
Kite,dathremar,288,hunter,beastmastery,6,3,3
Mcfibers,malganis,288,hunter,beastmastery,6,3,3
Latrampoza,quelthalas,288,hunter,beastmastery,6,3,3
Schumann,ursin,288,hunter,beastmastery,6,3,3
Bountybud,kiljaeden,288,hunter,beastmastery,6,3,3
Bmsurvmm,tichondrius,288,hunter,beastmastery,6,3,3
Billcsbyswtr,sargeras,288,hunter,beastmastery,6,3,3
Herroo,thrall,288,hunter,beastmastery,6,3,3
Limpingspoon,kelthuzad,288,hunter,beastmastery,6,3,3
Beastmodex,quelthalas,288,hunter,beastmastery,6,3,3
Karumä,thrall,288,hunter,beastmastery,6,3,3
Doubletappz,stormrage,288,hunter,beastmastery,6,3,3
Yoyoletsgo,malganis,288,hunter,beastmastery,6,3,3
Scolhunter,scarlet-crusade,288,hunter,beastmastery,6,3,3
Mulnaaj,zuljin,288,hunter,beastmastery,6,3,3
Braxigarr,area-52,288,hunter,beastmastery,6,3,3
Nyloc,dalvengyr,288,hunter,beastmastery,6,3,3
Chadbowsman,tichondrius,288,hunter,beastmastery,6,3,3
Blastinnagas,tichondrius,288,hunter,beastmastery,6,3,3
Euamomilfs,azralon,288,hunter,beastmastery,6,3,3
Wolfzburg,moon-guard,288,hunter,beastmastery,6,3,3
Sotsöl,ragnaros,288,hunter,beastmastery,6,3,3
Hellbow,ragnaros,288,hunter,beastmastery,6,3,3
Ballistik,area-52,288,hunter,beastmastery,6,3,3
Anatric,illidan,288,hunter,beastmastery,6,3,3
Deahtgab,ragnaros,288,hunter,beastmastery,6,3,3
Salvatiel,stormrage,288,hunter,beastmastery,6,3,3
Leadblaster,gorefiend,288,hunter,beastmastery,6,3,3
Vikshen,illidan,288,hunter,beastmastery,6,3,3
Realzanderr,antonidas,288,hunter,beastmastery,6,3,3
Kathelvia,area-52,288,hunter,beastmastery,6,3,3
Toxicbowjobs,tichondrius,288,hunter,beastmastery,6,3,3
Trailed,dalaran,288,hunter,beastmastery,6,3,3
Redthedeer,warsong,288,hunter,beastmastery,6,3,3
Harosh,azralon,288,hunter,beastmastery,6,3,3
Siimmplicitz,area-52,288,hunter,beastmastery,6,3,3
Relaxnerd,antonidas,288,hunter,beastmastery,6,3,3
Goraku,dalaran,288,hunter,beastmastery,6,3,3
Perfectcrit,area-52,288,hunter,beastmastery,6,3,3
Viavii,barthilas,288,hunter,beastmastery,6,3,3
Norgalys,proudmoore,288,hunter,beastmastery,6,3,3
Huntmon,nemesis,288,hunter,beastmastery,6,3,3
Therealgam,the-underbog,288,hunter,beastmastery,6,3,3
Zeroday,emerald-dream,288,hunter,beastmastery,6,3,3
Firskin,frostmourne,288,hunter,beastmastery,6,3,3
Gudlukk,stormrage,288,hunter,beastmastery,6,3,3
Teaa,dalaran,288,hunter,beastmastery,6,3,3
Raainha,stormrage,288,hunter,beastmastery,6,3,3
Guacmec,tichondrius,288,hunter,beastmastery,6,3,3
Longshott,azralon,288,hunter,beastmastery,6,3,3
Díllý,area-52,288,hunter,beastmastery,6,3,3
Deuzebuk,azralon,288,hunter,beastmastery,6,3,3
Burguir,ragnaros,288,hunter,beastmastery,6,3,3
Nexxa,muradin,288,hunter,beastmastery,6,3,3
Makeastinky,malfurion,288,hunter,beastmastery,6,3,3
Vinksy,sargeras,288,hunter,beastmastery,6,3,3
Gugubird,proudmoore,288,hunter,beastmastery,6,3,3
Wannakill,stormrage,288,hunter,beastmastery,6,3,3
Emart,bloodhoof,288,hunter,beastmastery,6,3,3
Chrisp,bloodhoof,288,hunter,beastmastery,6,3,3
Georgigeo,turalyon,288,hunter,beastmastery,6,3,3
Vicarnam,uldum,288,hunter,beastmastery,6,3,3
Crinkx,arthas,288,hunter,beastmastery,6,3,3
Añto,tichondrius,288,hunter,beastmastery,6,3,3
Britannian,moon-guard,288,hunter,beastmastery,6,3,3
Lelreisw,goldrinn,288,hunter,beastmastery,6,3,3
Jellyleg,bleeding-hollow,288,hunter,beastmastery,6,3,3
Cernos,malganis,288,hunter,beastmastery,6,3,3
Çrimson,frostmourne,288,hunter,beastmastery,6,3,3
Pewpewbang,muradin,288,hunter,beastmastery,6,3,3
Brorc,kul-tiras,288,hunter,beastmastery,6,3,3
Hahahahahaha,frostmourne,288,hunter,beastmastery,6,3,3
Trixex,darkspear,288,hunter,beastmastery,6,3,3
Enonoa,thunderlord,288,hunter,beastmastery,6,3,3
Nightstålkër,moon-guard,288,hunter,beastmastery,6,3,3
Comtambisuon,frostmourne,288,hunter,beastmastery,6,3,3
Tibineids,stormrage,288,hunter,beastmastery,6,3,3
Shikay,frostmourne,288,hunter,beastmastery,6,3,3
Ontop,draka,288,hunter,beastmastery,6,3,3
Mynds,stormrage,288,hunter,beastmastery,6,3,3
Aldurion,wyrmrest-accord,288,hunter,beastmastery,6,3,3
Trickshot,hakkar,288,hunter,beastmastery,6,3,3
Archetype,bladefist,288,hunter,beastmastery,6,3,3
Venj,proudmoore,288,hunter,beastmastery,6,3,3
Radat,stormscale,288,hunter,beastmastery,6,3,3
Bagofsnit,frostmourne,288,hunter,beastmastery,6,3,3
Adapted,proudmoore,288,hunter,beastmastery,6,3,3
Barrohunt,tichondrius,288,hunter,beastmastery,6,3,3
Wiittig,hyjal,288,hunter,beastmastery,6,3,3
Wanshöt,tichondrius,288,hunter,beastmastery,6,3,3
Exabyssus,bleeding-hollow,288,hunter,beastmastery,6,3,3
Harmfulwang,emerald-dream,288,hunter,beastmastery,6,3,3
Lyler,tichondrius,288,hunter,beastmastery,6,3,3
Shallwe,frostmourne,288,hunter,beastmastery,6,3,3
Kahoykeso,frostmourne,288,hunter,beastmastery,6,3,3
Lelantos,stonemaul,288,hunter,beastmastery,6,3,3
Soberish,bleeding-hollow,288,hunter,beastmastery,6,3,3
Fakerz,stormrage,288,hunter,beastmastery,6,3,3
Popshotz,khazgoroth,288,hunter,beastmastery,6,3,3
Sibbleiv,boulderfist,288,hunter,beastmastery,6,3,3
Onahai,tichondrius,288,hunter,beastmastery,6,3,3
Hannes,boulderfist,288,hunter,beastmastery,6,3,3
Orangegummy,frostmourne,288,hunter,beastmastery,9,4,5
Llachiip,zuljin,288,hunter,beastmastery,10,4,6
Brewster,burning-legion,288,hunter,beastmastery,12,3,9
Autismo,garithos,288,hunter,beastmastery,12,3,9
Ruckq,stormrage,288,hunter,beastmastery,12,3,9
Rinasonline,sargeras,288,hunter,beastmastery,12,3,9
Johnwïck,moon-guard,288,hunter,beastmastery,12,3,9
Harÿn,nemesis,288,hunter,beastmastery,12,3,9
Rice,veknilash,288,hunter,beastmastery,12,3,9
Nikå,ragnaros,288,hunter,beastmastery,12,3,9
Auset,aegwynn,288,hunter,beastmastery,12,3,9
Fistbèk,bleeding-hollow,288,hunter,beastmastery,12,3,9
Rooman,ragnaros,288,hunter,beastmastery,12,3,9
Dunkam,quelthalas,288,hunter,beastmastery,12,3,9
Jgalth,chogall,288,hunter,beastmastery,12,3,9
Zhona,moon-guard,288,hunter,beastmastery,12,3,9
Dodirty,laughing-skull,288,hunter,beastmastery,12,3,9
Bowflëx,zuljin,288,hunter,beastmastery,12,3,9
Wargodthor,blades-edge,288,hunter,beastmastery,12,3,9
Neríne,drakkari,288,hunter,beastmastery,12,3,9
Delanooch,rexxar,288,hunter,beastmastery,12,3,9
Kharthorin,moon-guard,288,hunter,beastmastery,12,3,9
Thiande,zuljin,288,hunter,beastmastery,12,3,9
Icculus,norgannon,288,hunter,beastmastery,12,3,9
Gunwalk,azjolnerub,288,hunter,beastmastery,12,3,9
Leggodex,caelestrasz,288,hunter,beastmastery,12,3,9
Ryanderanged,wyrmrest-accord,288,hunter,beastmastery,12,3,9
Reachme,moon-guard,288,hunter,beastmastery,12,3,9
Grlzzlyadams,norgannon,288,hunter,beastmastery,12,3,9
Digsites,emerald-dream,288,hunter,beastmastery,12,3,9
Dieplox,thunderhorn,288,hunter,beastmastery,12,3,9
Tanrith,dark-iron,288,hunter,beastmastery,12,3,9
Natnat,sargeras,288,hunter,beastmastery,12,3,9
Toozz,frostmourne,288,hunter,beastmastery,12,3,9
ßloodmain,tichondrius,288,hunter,beastmastery,12,3,9
Prowd,staghelm,288,hunter,beastmastery,12,3,9
Yiyixx,tichondrius,288,hunter,beastmastery,18,3,15
Kango,azgalor,288,hunter,beastmastery,18,3,15
Bëcäüsë,proudmoore,288,hunter,beastmastery,18,3,15
Ledan,lightnings-blade,287,hunter,beastmastery,6,3,3
Euroniimus,ragnaros,287,hunter,beastmastery,6,3,3
Luzyfer,quelthalas,287,hunter,beastmastery,6,3,3
Wolftracer,sargeras,287,hunter,beastmastery,6,3,3
Pureguava,gorefiend,287,hunter,beastmastery,6,3,3
Braindeadly,malganis,287,hunter,beastmastery,6,3,3
Arin,suramar,287,hunter,beastmastery,12,3,9
Acotas,blades-edge,286,hunter,beastmastery,6,3,3
Darkally,blades-edge,285,hunter,beastmastery,12,3,9
Salurian,destromath,271,hunter,beastmastery,11,3,8
Bulszeye,azgalor,255,hunter,beastmastery,8,4,4
Pokeyourbutt,hydraxis,240,hunter,beastmastery,15,3,12
Kaelhim,warsong,239,hunter,beastmastery,5,3,2
Vicecheney,illidan,239,hunter,beastmastery,5,3,2
Diisdik,tichondrius,239,hunter,beastmastery,5,3,2
Léfty,nagrand,239,hunter,beastmastery,11,3,8
Djcummyfeet,stormrage,234,hunter,beastmastery,17,6,11
Feralcat,nazjatar,208,hunter,beastmastery,13,3,10
Powerful,aerie-peak,192,hunter,beastmastery,6,2,4
Cufless,proudmoore,192,hunter,beastmastery,6,2,4
Hollee,turalyon,192,hunter,beastmastery,6,2,4
Slobon,tichondrius,192,hunter,beastmastery,6,2,4
Darksniper,proudmoore,192,hunter,beastmastery,6,2,4
Diacachimbaa,ragnaros,192,hunter,beastmastery,6,2,4
Zoopdapoop,dalaran,192,hunter,beastmastery,6,2,4
Alikay,ragnaros,192,hunter,beastmastery,6,2,4
Neverwipes,frostmourne,192,hunter,beastmastery,6,2,4
Munrrack,ragnaros,192,hunter,beastmastery,6,2,4
Defacecilth,dalaran,192,hunter,beastmastery,6,2,4
Purpreynolds,tichondrius,192,hunter,beastmastery,6,2,4
Ivanjackenov,illidan,192,hunter,beastmastery,6,2,4
Frìtz,barthilas,192,hunter,beastmastery,6,2,4
Tichong,tichondrius,192,hunter,beastmastery,6,2,4
Nanotorque,moon-guard,192,hunter,beastmastery,6,2,4
Elivivia,tichondrius,192,hunter,beastmastery,6,2,4
Kaloh,daggerspine,192,hunter,beastmastery,6,2,4
Verzoz,illidan,192,hunter,beastmastery,6,2,4
Hectorbuñue,quelthalas,192,hunter,beastmastery,6,2,4
Gilv,frostmourne,192,hunter,beastmastery,6,2,4
Stfd,illidan,192,hunter,beastmastery,6,2,4
Ellishunter,frostmourne,192,hunter,beastmastery,6,2,4
Gohan,jubeithos,192,hunter,beastmastery,6,2,4
Pickshot,boulderfist,192,hunter,beastmastery,6,2,4
Presleyjane,tichondrius,192,hunter,beastmastery,6,2,4
Illrannevian,garrosh,192,hunter,beastmastery,6,2,4
Antwonziezz,tichondrius,192,hunter,beastmastery,6,2,4
Chømp,tichondrius,192,hunter,beastmastery,6,2,4
Rhyzen,drenden,192,hunter,beastmastery,6,2,4
Barrelsofrum,illidan,192,hunter,beastmastery,6,2,4
Etarie,malganis,192,hunter,beastmastery,6,2,4
Twocranes,tichondrius,192,hunter,beastmastery,6,2,4
Dreadrahl,deathwing,192,hunter,beastmastery,6,2,4
Rsttlegore,stormscale,192,hunter,beastmastery,6,2,4
Magvez,tichondrius,192,hunter,beastmastery,6,2,4
Smokiiganja,proudmoore,192,hunter,beastmastery,6,2,4
Hötdôg,kiljaeden,192,hunter,beastmastery,6,2,4
Capnjack,hyjal,192,hunter,beastmastery,6,2,4
Jbahh,hyjal,192,hunter,beastmastery,6,2,4
Gruì,malganis,192,hunter,beastmastery,6,2,4
Öops,hyjal,192,hunter,beastmastery,6,2,4
Kudzue,illidan,192,hunter,beastmastery,6,2,4
Sativ,moknathal,192,hunter,beastmastery,6,2,4
Kansolly,tichondrius,192,hunter,beastmastery,6,2,4
Varianhunter,kelthuzad,192,hunter,beastmastery,6,2,4
Shootermgavn,frostmourne,192,hunter,beastmastery,6,2,4
Hìrcine,nesingwary,192,hunter,beastmastery,6,2,4
Pressbro,tichondrius,192,hunter,beastmastery,6,2,4
Bloodstark,dreadmaul,192,hunter,beastmastery,6,2,4
Kaptincrunch,skywall,192,hunter,beastmastery,6,2,4
Wooftoof,frostmourne,192,hunter,beastmastery,6,2,4
Zeront,garona,192,hunter,beastmastery,6,2,4
Critaclyzm,moon-guard,192,hunter,beastmastery,6,2,4
Solderboi,tichondrius,192,hunter,beastmastery,6,2,4
Vanpeltz,illidan,192,hunter,beastmastery,6,2,4
Camfeed,illidan,192,hunter,beastmastery,6,2,4
Skolzero,azralon,192,hunter,beastmastery,6,2,4
Mojito,frostmourne,192,hunter,beastmastery,6,2,4
Rúdrá,area-52,192,hunter,beastmastery,6,2,4
Nevon,azralon,192,hunter,beastmastery,6,2,4
Thunderbúll,tichondrius,192,hunter,beastmastery,6,2,4
Åî,tichondrius,192,hunter,beastmastery,6,2,4
Castíèl,thrall,192,hunter,beastmastery,6,2,4
Notoffended,sargeras,192,hunter,beastmastery,6,2,4
Caligar,tichondrius,192,hunter,beastmastery,6,2,4
Søapbubble,tichondrius,192,hunter,beastmastery,6,2,4
Fjdominador,azralon,192,hunter,beastmastery,6,2,4
Xavííer,tichondrius,192,hunter,beastmastery,6,2,4
Graatata,shandris,192,hunter,beastmastery,6,2,4
Sukr,korgath,192,hunter,beastmastery,6,2,4
Halaruka,area-52,192,hunter,beastmastery,6,2,4
Chaseurnoir,exodar,192,hunter,beastmastery,6,2,4
Autoshotxprt,frostmourne,192,hunter,beastmastery,6,2,4
Rämbow,frostmourne,192,hunter,beastmastery,6,2,4
Jacss,azralon,192,hunter,beastmastery,6,2,4
Bluntcrushed,area-52,192,hunter,beastmastery,6,2,4
Zarknoth,cenarius,192,hunter,beastmastery,6,2,4
Dynith,sargeras,192,hunter,beastmastery,6,2,4
Hüh,area-52,192,hunter,beastmastery,6,2,4
Harrowin,area-52,192,hunter,beastmastery,6,2,4
Mídnîght,azralon,192,hunter,beastmastery,6,2,4
Behavior,nemesis,192,hunter,beastmastery,6,2,4
Titzyø,area-52,192,hunter,beastmastery,6,2,4
Survbot,malganis,192,hunter,beastmastery,6,2,4
Monffbc,tichondrius,192,hunter,beastmastery,6,2,4
Csadark,nemesis,192,hunter,beastmastery,6,2,4
Tarkovs,area-52,192,hunter,beastmastery,6,2,4
Nubcaks,nerzhul,192,hunter,beastmastery,6,2,4
Ussy,area-52,192,hunter,beastmastery,6,2,4
Rostter,azralon,192,hunter,beastmastery,6,2,4
Shådé,stormrage,192,hunter,beastmastery,6,2,4
Nfo,lightbringer,192,hunter,beastmastery,6,2,4
Pfheign,area-52,192,hunter,beastmastery,6,2,4
Zaydenm,sargeras,192,hunter,beastmastery,6,2,4
Blakespace,area-52,192,hunter,beastmastery,6,2,4
Clütch,darkspear,192,hunter,beastmastery,6,2,4
Equalizér,sargeras,192,hunter,beastmastery,6,2,4
Greasyboi,tichondrius,192,hunter,beastmastery,6,2,4
Arrowbadoors,azralon,192,hunter,beastmastery,6,2,4
Dsizzle,tichondrius,192,hunter,beastmastery,6,2,4
Madsniper,thunderlord,192,hunter,beastmastery,6,2,4
Islapuwitaro,azjolnerub,192,hunter,beastmastery,6,2,4
Warplaquee,zuljin,192,hunter,beastmastery,6,2,4
Fova,wyrmrest-accord,192,hunter,beastmastery,6,2,4
Estilingada,azralon,192,hunter,beastmastery,6,2,4
Jojojobo,tichondrius,192,hunter,beastmastery,6,2,4
Bernice,darrowmere,192,hunter,beastmastery,6,2,4
Ratbasterrd,darkspear,192,hunter,beastmastery,6,2,4
Jxbupx,tichondrius,192,hunter,beastmastery,6,2,4
Shootr,darkspear,192,hunter,beastmastery,6,2,4
Kenhay,wyrmrest-accord,192,hunter,beastmastery,6,2,4
Zellor,wyrmrest-accord,192,hunter,beastmastery,6,2,4
Nahzah,stormrage,192,hunter,beastmastery,6,2,4
Juicyfruit,bleeding-hollow,192,hunter,beastmastery,6,2,4
Impërïum,zuljin,192,hunter,beastmastery,6,2,4
Ganderion,sargeras,192,hunter,beastmastery,6,2,4
Blickymon,wyrmrest-accord,192,hunter,beastmastery,6,2,4
Dnicee,stormrage,192,hunter,beastmastery,6,2,4
Revengexyz,zuljin,192,hunter,beastmastery,6,2,4
Garble,darkspear,192,hunter,beastmastery,6,2,4
Budget,emerald-dream,192,hunter,beastmastery,6,2,4
Aaggros,sargeras,192,hunter,beastmastery,6,2,4
Ikiteforfood,zuljin,192,hunter,beastmastery,6,2,4
Totolol,trollbane,192,hunter,beastmastery,6,2,4
Thazen,sargeras,192,hunter,beastmastery,6,2,4
Singer,lothar,192,hunter,beastmastery,6,2,4
Viracha,stormrage,192,hunter,beastmastery,6,2,4
Snaken,the-forgotten-coast,192,hunter,beastmastery,6,2,4
Expskippy,darkspear,192,hunter,beastmastery,6,2,4
Jämmëdclïp,emerald-dream,192,hunter,beastmastery,6,2,4
Skillhunter,tichondrius,192,hunter,beastmastery,6,2,4
Rockoutt,emerald-dream,192,hunter,beastmastery,6,2,4
Seratoninx,malganis,192,hunter,beastmastery,9,2,7
Meetdmonster,illidan,192,hunter,beastmastery,12,2,10
Aeriladin,moon-guard,192,hunter,beastmastery,12,2,10
Carloslaun,drakkari,192,hunter,beastmastery,12,2,10
Lhax,stormrage,192,hunter,beastmastery,12,2,10
Tánsøxøxø,tichondrius,192,hunter,beastmastery,12,2,10
Ãmi,moon-guard,192,hunter,beastmastery,12,2,10
Ijii,tichondrius,192,hunter,beastmastery,12,2,10
Bjj,eonar,192,hunter,beastmastery,12,2,10
Mphunter,azralon,192,hunter,beastmastery,12,2,10
Arrowzpeckt,tichondrius,192,hunter,beastmastery,12,2,10
Hughboner,illidan,192,hunter,beastmastery,12,2,10
Gunnpowder,malganis,192,hunter,beastmastery,12,2,10
Thyladaern,kiljaeden,192,hunter,beastmastery,12,2,10
Khabul,area-52,192,hunter,beastmastery,12,2,10
Sojun,jaedenar,192,hunter,beastmastery,14,2,12
Gilonate,tichondrius,192,hunter,beastmastery,18,2,16
Moapax,azralon,191,hunter,beastmastery,6,2,4
Recebaa,barthilas,191,hunter,beastmastery,6,2,4
Aiilton,gallywix,191,hunter,beastmastery,6,2,4
Tuvasa,blood-furnace,191,hunter,beastmastery,6,2,4
Stoneforged,ragnaros,191,hunter,beastmastery,6,2,4
Kolarius,emerald-dream,191,hunter,beastmastery,6,2,4
Enrage,queldorei,191,hunter,beastmastery,12,2,10
Drakarÿs,drakkari,191,hunter,beastmastery,12,2,10
Kelgar,the-scryers,191,hunter,beastmastery,12,2,10
Maximum,tichondrius,159,hunter,beastmastery,5,2,3
Stèlla,frostmourne,159,hunter,beastmastery,5,2,3
Helikaon,deathwing,159,hunter,beastmastery,5,2,3
Skrìms,tichondrius,159,hunter,beastmastery,5,2,3
Luckione,destromath,144,hunter,beastmastery,9,2,7
Lele,stormrage,138,hunter,beastmastery,8,4,4
Pikochon,illidan,138,hunter,beastmastery,12,3,9
Twatshót,burning-legion,131,hunter,beastmastery,16,5,11
Piñg,tichondrius,128,hunter,beastmastery,4,2,2
Beastmastr,garrosh,128,hunter,beastmastery,4,2,2
Owoonisan,illidan,128,hunter,beastmastery,4,2,2
Laviè,tichondrius,112,hunter,beastmastery,4,3,1
Predatðr,frostmourne,96,hunter,beastmastery,6,1,5
Singletap,barthilas,96,hunter,beastmastery,6,1,5
Varag,amanthul,96,hunter,beastmastery,6,1,5
Sõulhunter,frostmourne,96,hunter,beastmastery,6,1,5
Wârhunt,frostmourne,96,hunter,beastmastery,6,1,5
Birggitte,the-venture-co,96,hunter,beastmastery,6,1,5
Justin,agamaggan,96,hunter,beastmastery,6,1,5
Muckenfoose,frostmourne,96,hunter,beastmastery,6,1,5
Baehydra,frostmourne,96,hunter,beastmastery,6,1,5
Taumelz,sargeras,96,hunter,beastmastery,6,1,5
Xcopel,azralon,96,hunter,beastmastery,6,1,5
Jootuber,barthilas,96,hunter,beastmastery,6,1,5
Slipperyqt,frostmourne,96,hunter,beastmastery,6,1,5
Tybierious,illidan,96,hunter,beastmastery,6,1,5
Ghostone,sargeras,96,hunter,beastmastery,6,1,5
Patcherson,kargath,96,hunter,beastmastery,6,1,5
Jaboe,thrall,96,hunter,beastmastery,6,1,5
Shoccka,thrall,96,hunter,beastmastery,6,1,5
Squiik,wildhammer,96,hunter,beastmastery,6,1,5
Fadingtrapz,jubeithos,96,hunter,beastmastery,6,1,5
Cynasia,maelstrom,96,hunter,beastmastery,6,1,5
Bosshunt,whisperwind,96,hunter,beastmastery,6,1,5
Cocobread,stormreaver,96,hunter,beastmastery,6,1,5
Jiawoweixin,illidan,96,hunter,beastmastery,6,1,5
Physical,destromath,96,hunter,beastmastery,6,1,5
Frenchhtoast,sargeras,96,hunter,beastmastery,6,1,5
Henhøuse,illidan,96,hunter,beastmastery,6,1,5
Dusle,azralon,96,hunter,beastmastery,6,1,5
Sobala,azralon,96,hunter,beastmastery,6,1,5
Carot,dalaran,96,hunter,beastmastery,6,1,5
Bertiebott,zuljin,96,hunter,beastmastery,6,1,5
Bellaphonte,stormrage,96,hunter,beastmastery,6,1,5
Shadeckz,stormrage,96,hunter,beastmastery,6,1,5
Panm,runetotem,96,hunter,beastmastery,6,1,5
Taurenseason,sargeras,96,hunter,beastmastery,6,1,5
Oldmandave,stormrage,96,hunter,beastmastery,6,1,5
Nachtcloverr,stormrage,96,hunter,beastmastery,6,1,5
Slimetime,tichondrius,96,hunter,beastmastery,6,1,5
Boido,ghostlands,96,hunter,beastmastery,6,1,5
Foakus,zuljin,96,hunter,beastmastery,6,1,5
Båttousai,kiljaeden,96,hunter,beastmastery,6,1,5
Wamion,zuljin,96,hunter,beastmastery,6,1,5
Jabbar,bleeding-hollow,96,hunter,beastmastery,6,1,5
Ilîiìîìiilil,bleeding-hollow,96,hunter,beastmastery,6,1,5
Ferrettss,bleeding-hollow,96,hunter,beastmastery,6,1,5
Murk,spirestone,96,hunter,beastmastery,6,1,5
Percival,firetree,96,hunter,beastmastery,6,1,5
Nearsightedd,area-52,96,hunter,beastmastery,6,1,5
Arthanyz,quelthalas,96,hunter,beastmastery,6,1,5
Boyarsky,area-52,96,hunter,beastmastery,6,1,5
Appä,lightnings-blade,96,hunter,beastmastery,6,1,5
Tarakii,moon-guard,96,hunter,beastmastery,6,1,5
Allgasnocap,kelthuzad,96,hunter,beastmastery,6,1,5
Marksmanpain,malganis,96,hunter,beastmastery,6,1,5
Warpedshots,malganis,96,hunter,beastmastery,6,1,5
Bithiáh,quelthalas,96,hunter,beastmastery,6,1,5
Pampas,darkspear,96,hunter,beastmastery,6,1,5
Penelòpe,wyrmrest-accord,96,hunter,beastmastery,6,1,5
Opsi,ragnaros,96,hunter,beastmastery,6,1,5
Mtuanwm,tichondrius,96,hunter,beastmastery,6,1,5
Soulreaperts,ragnaros,96,hunter,beastmastery,6,1,5
Rexxiga,kiljaeden,96,hunter,beastmastery,6,1,5
Poonbaddy,kiljaeden,96,hunter,beastmastery,6,1,5
Xclaw,llane,96,hunter,beastmastery,6,1,5
Nimbioth,proudmoore,96,hunter,beastmastery,6,1,5
Darkhunterr,tichondrius,96,hunter,beastmastery,6,1,5
Wixyy,aegwynn,96,hunter,beastmastery,6,1,5
Bigpie,daggerspine,96,hunter,beastmastery,6,1,5
Huntardness,moon-guard,96,hunter,beastmastery,6,1,5
Audiofly,tichondrius,96,hunter,beastmastery,6,1,5
Robious,tichondrius,96,hunter,beastmastery,6,1,5
Derekscrow,tichondrius,96,hunter,beastmastery,6,1,5
Espaada,tichondrius,96,hunter,beastmastery,6,1,5
Sóggybóxers,tichondrius,96,hunter,beastmastery,6,1,5
Brody,eitrigg,96,hunter,beastmastery,6,1,5
Ballinpotato,tichondrius,96,hunter,beastmastery,6,1,5
Globlauncher,tichondrius,96,hunter,beastmastery,6,1,5
Twistedx,tichondrius,96,hunter,beastmastery,6,1,5
Bendotexe,stormrage,96,hunter,beastmastery,7,1,6
Ferdphin,dalaran,96,hunter,beastmastery,12,1,11
Blackstaur,illidan,96,hunter,beastmastery,12,1,11
Arielma,illidan,96,hunter,beastmastery,12,1,11
Rekows,stormrage,96,hunter,beastmastery,12,1,11
Tstormzz,stormrage,96,hunter,beastmastery,12,1,11
Sylvanãs,ragnaros,96,hunter,beastmastery,12,1,11
Divineseraph,dentarg,96,hunter,beastmastery,12,1,11
Tydee,nagrand,96,hunter,beastmastery,12,1,11
Desoh,kelthuzad,96,hunter,beastmastery,12,1,11
Tinsho,drakkari,96,hunter,beastmastery,12,1,11
Newdanni,barthilas,95,hunter,beastmastery,18,1,17
Alby,daggerspine,79,hunter,beastmastery,5,1,4
Muffkick,illidan,64,hunter,beastmastery,4,1,3
Kölhberg,azralon,64,hunter,beastmastery,10,1,9
Triggamikê,tichondrius,63,hunter,beastmastery,2,2,0
Memorypet,proudmoore,48,hunter,beastmastery,3,1,2
Yory,tol-barad,48,hunter,beastmastery,3,1,2
Falsifier,ragnaros,48,hunter,beastmastery,3,1,2
Wonshawt,tichondrius,48,hunter,beastmastery,3,1,2
Jumeog,stormscale,42,hunter,beastmastery,7,2,5
Bowjoblul,stormrage,42,hunter,beastmastery,9,2,7
Gasslight,area-52,31,hunter,beastmastery,2,1,1
Khillin,destromath,31,hunter,beastmastery,2,1,1
Timesteal,tichondrius,31,hunter,beastmastery,2,1,1
Voladren,moon-guard,31,hunter,beastmastery,2,1,1
Numbing,sargeras,2233,mage,arcane,100,54,46
Juicemage,tichondrius,2207,mage,arcane,95,52,43
Venruki,tichondrius,2137,mage,arcane,78,44,34
Cvark,sargeras,2123,mage,arcane,76,45,31
Ktp,tichondrius,2118,mage,arcane,84,50,34
Junglejape,tichondrius,1967,mage,arcane,54,35,19
Oneschool,sargeras,1963,mage,arcane,60,33,27
Arcanemagek,tichondrius,1907,mage,arcane,48,32,16
Bambambilly,kelthuzad,1893,mage,arcane,96,53,43
Whiterice,zuljin,1879,mage,arcane,50,31,19
Bíscuít,illidan,1864,mage,arcane,139,76,63
Birdfather,tichondrius,1861,mage,arcane,48,33,15
Snortmeth,area-52,1841,mage,arcane,90,58,32
Vampìrelolz,tichondrius,1809,mage,arcane,48,26,22
Delibro,tichondrius,1786,mage,arcane,64,35,29
Elfmage,tichondrius,1777,mage,arcane,30,19,11
Mokelovin,sargeras,1763,mage,arcane,59,30,29
Hallat,archimonde,1735,mage,arcane,338,166,172
Ezchallenger,undermine,1724,mage,arcane,78,33,45
Lmaginedying,illidan,1715,mage,arcane,30,24,6
Dawitchery,illidan,1712,mage,arcane,52,23,29
Zps,illidan,1706,mage,arcane,72,40,32
Badboykilla,dentarg,1704,mage,arcane,39,33,6
Arianark,sargeras,1697,mage,arcane,90,55,35
Hocusjokus,frostmourne,1691,mage,arcane,30,21,9
Edgkey,illidan,1688,mage,arcane,50,25,25
Spart,runetotem,1676,mage,arcane,45,20,25
Clutchy,gorefiend,1672,mage,arcane,42,29,13
Ligmmah,stormrage,1672,mage,arcane,36,21,15
Nyj,tichondrius,1668,mage,arcane,59,33,26
Maegwynah,jaedenar,1665,mage,arcane,40,20,20
Bananappeal,kelthuzad,1661,mage,arcane,46,22,24
Shwaysted,burning-blade,1657,mage,arcane,42,22,20
Tbkz,amanthul,1656,mage,arcane,42,20,22
Exterminatüs,tichondrius,1652,mage,arcane,81,41,40
Höövalt,illidan,1641,mage,arcane,30,20,10
Spitemage,tichondrius,1638,mage,arcane,103,49,54
Xialing,tichondrius,1631,mage,arcane,40,24,16
Spellsteål,malganis,1627,mage,arcane,53,31,22
Magecombe,thrall,1617,mage,arcane,30,17,13
Dmgperseç,tichondrius,1612,mage,arcane,30,20,10
Proximalol,tichondrius,1610,mage,arcane,36,20,16
Ject,ragnaros,1606,mage,arcane,155,84,71
Hööva,illidan,1604,mage,arcane,30,17,13
Rhythmdog,tichondrius,1603,mage,arcane,45,21,24
Primearcanis,tol-barad,1601,mage,arcane,48,22,26
Höövaltx,illidan,1600,mage,arcane,36,19,17
Sestren,zuljin,1591,mage,arcane,73,34,39
Felsparkles,area-52,1589,mage,arcane,54,30,24
Waisted,kelthuzad,1563,mage,arcane,33,20,13
Clernlol,emerald-dream,1548,mage,arcane,60,27,33
Kickpollyplx,lothar,1547,mage,arcane,65,43,22
Perrc,area-52,1546,mage,arcane,174,88,86
Zhanna,nazjatar,1535,mage,arcane,96,47,49
Prosperoh,burning-legion,1526,mage,arcane,48,25,23
Dbox,stormscale,1525,mage,arcane,82,44,38
Agoniey,illidan,1525,mage,arcane,138,69,69
Étel,nemesis,1524,mage,arcane,36,17,19
Vênsêr,emerald-dream,1523,mage,arcane,36,17,19
Lucidaze,daggerspine,1502,mage,arcane,133,65,68
Cyphen,proudmoore,1500,mage,arcane,30,16,14
Alode,moon-guard,1498,mage,arcane,48,29,19
Maplemage,akama,1494,mage,arcane,172,91,81
Beerbelly,tichondrius,1486,mage,arcane,65,39,26
Hustle,frostmourne,1483,mage,arcane,102,53,49
Wretchy,ragnaros,1473,mage,arcane,61,33,28
Linkolni,azralon,1462,mage,arcane,111,59,52
Hennimage,sargeras,1459,mage,arcane,146,84,62
Missile,frostmourne,1454,mage,arcane,36,17,19
Swàn,stormrage,1444,mage,arcane,42,23,19
Sáron,quelthalas,1431,mage,arcane,78,41,37
Lünå,onyxia,1429,mage,arcane,42,28,14
Balencii,kiljaeden,1419,mage,arcane,24,15,9
Somariais,illidan,1399,mage,arcane,42,20,22
Söngs,goldrinn,1387,mage,arcane,24,15,9
Frozonnee,aggramar,1379,mage,arcane,24,15,9
Wizzyx,illidan,1373,mage,arcane,40,21,19
Castarcane,nordrassil,1370,mage,arcane,36,17,19
Avandal,proudmoore,1362,mage,arcane,71,29,42
Astrojrue,sargeras,1353,mage,arcane,41,21,20
Melkdud,wyrmrest-accord,1341,mage,arcane,24,14,10
Magnesiium,illidan,1330,mage,arcane,28,15,13
Themagicman,whisperwind,1324,mage,arcane,42,17,25
Coôler,illidan,1313,mage,arcane,39,16,23
Szrp,stormrage,1306,mage,arcane,51,23,28
Ruzam,area-52,1303,mage,arcane,186,91,95
Draell,drakkari,1301,mage,arcane,54,30,24
Véyda,emerald-dream,1300,mage,arcane,60,30,30
Airbnb,area-52,1299,mage,arcane,46,26,20
Valrendor,nazjatar,1298,mage,arcane,96,54,42
Zayth,silvermoon,1297,mage,arcane,42,21,21
Gin,nemesis,1296,mage,arcane,48,24,24
Oharvestero,illidan,1290,mage,arcane,31,16,15
Chezzmasterx,misha,1289,mage,arcane,69,34,35
Jedamere,proudmoore,1260,mage,arcane,48,23,25
Strêss,kelthuzad,1255,mage,arcane,123,60,63
Skywalkerino,azralon,1254,mage,arcane,139,72,67
Gessin,area-52,1245,mage,arcane,100,50,50
Nedrin,nemesis,1244,mage,arcane,66,32,34
Aosin,wyrmrest-accord,1240,mage,arcane,18,13,5
Unlike,sargeras,1235,mage,arcane,71,29,42
Antifreezex,tichondrius,1223,mage,arcane,70,39,31
Kevymarts,tichondrius,1210,mage,arcane,36,14,22
Chëryl,proudmoore,1197,mage,arcane,142,67,75
Dereliction,nagrand,1185,mage,arcane,102,52,50
Holbrook,greymane,1175,mage,arcane,90,41,49
Greenwise,illidan,1170,mage,arcane,54,28,26
Gryd,area-52,1165,mage,arcane,90,47,43
Yonzho,area-52,1160,mage,arcane,20,13,7
Fearhades,drakkari,1159,mage,arcane,24,13,11
Nekrobear,nemesis,1150,mage,arcane,36,16,20
Thewizârd,stormrage,1143,mage,arcane,234,119,115
Caseyjelly,tichondrius,1142,mage,arcane,24,12,12
Allýria,stormrage,1138,mage,arcane,30,12,18
Firehawk,azralon,1133,mage,arcane,24,15,9
Cokézero,frostmourne,1128,mage,arcane,49,24,25
Nunezz,mannoroth,1117,mage,arcane,36,18,18
Badwoman,tichondrius,1111,mage,arcane,36,13,23
Oyagi,moon-guard,1097,mage,arcane,89,42,47
Cassanara,moon-guard,1090,mage,arcane,30,13,17
Klausgc,sargeras,1084,mage,arcane,20,12,8
Tsarevich,fizzcrank,1069,mage,arcane,48,22,26
Flaux,sargeras,1055,mage,arcane,18,11,7
Tommagic,tichondrius,1055,mage,arcane,30,11,19
Wïzarduous,mannoroth,1053,mage,arcane,18,11,7
Enthy,frostmourne,1052,mage,arcane,24,11,13
Zukoprince,azralon,1051,mage,arcane,12,11,1
Shmage,dragonmaw,1050,mage,arcane,24,11,13
Celciius,stormrage,1035,mage,arcane,38,12,26
Melkra,tichondrius,1033,mage,arcane,24,11,13
Sceledrus,quelthalas,1017,mage,arcane,24,11,13
Kittikk,tichondrius,1005,mage,arcane,119,53,66
Maiddan,azralon,1000,mage,arcane,20,12,8
Smoks,stormrage,973,mage,arcane,26,12,14
Raeign,frostmourne,972,mage,arcane,141,67,74
Nightsaber,blackrock,960,mage,arcane,12,10,2
Sorankim,tichondrius,960,mage,arcane,18,10,8
Windwìtch,quelthalas,960,mage,arcane,18,10,8
Gachaguy,bleeding-hollow,960,mage,arcane,30,10,20
Velvetlurker,sargeras,959,mage,arcane,24,10,14
Zerathremar,proudmoore,958,mage,arcane,18,10,8
Haze,hyjal,955,mage,arcane,18,10,8
Tagere,moon-guard,954,mage,arcane,24,10,14
Orderlight,alexstrasza,954,mage,arcane,24,10,14
Wizfajita,malganis,951,mage,arcane,24,10,14
Wøogles,sargeras,946,mage,arcane,24,10,14
Morkleen,korgath,943,mage,arcane,30,10,20
Shadows,exodar,934,mage,arcane,24,10,14
Akagamix,sargeras,924,mage,arcane,36,17,19
Dietdeww,borean-tundra,913,mage,arcane,18,10,8
Khierlana,hellscream,903,mage,arcane,66,27,39
Mastablastar,windrunner,899,mage,arcane,23,10,13
Søkø,tichondrius,868,mage,arcane,30,11,19
Jazzgroyper,sargeras,864,mage,arcane,18,9,9
Viôlentj,area-52,863,mage,arcane,12,9,3
Arcalìte,illidan,863,mage,arcane,15,10,5
Harshx,bleeding-hollow,863,mage,arcane,18,9,9
Pandazed,proudmoore,863,mage,arcane,18,9,9
Blaxmagic,stormrage,862,mage,arcane,18,9,9
Edisia,moon-guard,862,mage,arcane,18,9,9
Instataterz,eonar,833,mage,arcane,29,9,20
Sherian,queldorei,832,mage,arcane,18,9,9
Drainbamage,coilfang,810,mage,arcane,54,10,44
Jackson,altar-of-storms,809,mage,arcane,60,17,43
Kirayu,gilneas,798,mage,arcane,16,9,7
Unmix,tichondrius,794,mage,arcane,20,9,11
Spellstéal,tichondrius,768,mage,arcane,12,8,4
Lewpithy,area-52,768,mage,arcane,12,8,4
Glaciated,the-forgotten-coast,768,mage,arcane,12,8,4
Cinnamon,boulderfist,768,mage,arcane,12,8,4
Eludin,aegwynn,768,mage,arcane,18,8,10
Jööz,deathwing,768,mage,arcane,18,8,10
Mageboy,bonechewer,768,mage,arcane,18,8,10
Watchmepog,tichondrius,767,mage,arcane,12,8,4
Crøwgawd,tichondrius,767,mage,arcane,12,8,4
Fakebusiness,area-52,767,mage,arcane,18,8,10
Delana,darkspear,766,mage,arcane,24,8,16
Boredmoomoo,thunderlord,765,mage,arcane,12,8,4
Archtype,azralon,764,mage,arcane,24,8,16
Christensen,stormrage,761,mage,arcane,18,8,10
Randalf,dragonmaw,755,mage,arcane,12,8,4
Aycc,tichondrius,735,mage,arcane,17,8,9
Failedwizard,frostmourne,714,mage,arcane,34,10,24
Perkaset,turalyon,703,mage,arcane,17,8,9
Noescaping,illidan,687,mage,arcane,19,8,11
Rof,sargeras,672,mage,arcane,12,7,5
Valériemeow,tichondrius,672,mage,arcane,18,7,11
Zezima,spirestone,671,mage,arcane,12,7,5
Murr,boulderfist,671,mage,arcane,12,7,5
Ankidar,quelthalas,671,mage,arcane,18,7,11
Warthormage,stormrage,670,mage,arcane,12,7,5
Austere,boulderfist,670,mage,arcane,12,7,5
Derkrìeger,turalyon,670,mage,arcane,18,7,11
Zimzum,bladefist,666,mage,arcane,12,7,5
Cubanarox,gallywix,661,mage,arcane,24,7,17
Karamzov,zuljin,652,mage,arcane,24,7,17
Softbody,barthilas,634,mage,arcane,27,7,20
Arcanochillz,ghostlands,621,mage,arcane,21,8,13
Fryry,dalaran,576,mage,arcane,12,6,6
Astroner,frostmourne,576,mage,arcane,12,6,6
Aeghis,stormrage,576,mage,arcane,12,6,6
Nazmagus,hydraxis,576,mage,arcane,18,6,12
Cicciozi,sargeras,576,mage,arcane,24,6,18
Moond,drakkari,575,mage,arcane,12,6,6
Zulugara,barthilas,575,mage,arcane,18,6,12
Mageyoulooks,kelthuzad,575,mage,arcane,18,6,12
Lacouet,lightnings-blade,575,mage,arcane,24,6,18
Ispell,tichondrius,573,mage,arcane,24,6,18
Enfuegoe,tichondrius,571,mage,arcane,12,6,6
Waef,quelthalas,571,mage,arcane,12,6,6
Esien,tichondrius,522,mage,arcane,20,7,13
Skillsbro,arthas,480,mage,arcane,6,5,1
Zeró,frostmourne,480,mage,arcane,6,5,1
Wauzcrol,quelthalas,480,mage,arcane,12,5,7
Dagreatone,malganis,480,mage,arcane,12,5,7
Shäräpova,zuljin,480,mage,arcane,12,5,7
Hansol,farstriders,480,mage,arcane,12,5,7
Maxtorgar,quelthalas,480,mage,arcane,12,5,7
Diamondx,ragnaros,480,mage,arcane,12,5,7
Hogdog,illidan,480,mage,arcane,18,5,13
Kosiris,tichondrius,480,mage,arcane,18,5,13
Humpadumplin,wyrmrest-accord,478,mage,arcane,24,5,19
Merlon,dalaran,476,mage,arcane,12,5,7
Culours,stormrage,472,mage,arcane,12,5,7
Squishymage,moon-guard,446,mage,arcane,17,5,12
Baskal,area-52,431,mage,arcane,17,5,12
Larouse,quelthalas,415,mage,arcane,8,5,3
Asalumm,quelthalas,398,mage,arcane,13,6,7
Garrieto,sargeras,384,mage,arcane,6,4,2
Rositajonez,terenas,384,mage,arcane,6,4,2
Imbusting,kiljaeden,384,mage,arcane,6,4,2
Gelokay,tichondrius,384,mage,arcane,6,4,2
Wanming,tichondrius,384,mage,arcane,6,4,2
Magicos,frostmourne,384,mage,arcane,6,4,2
Tuggernaug,malganis,384,mage,arcane,6,4,2
Lightsoran,tichondrius,384,mage,arcane,6,4,2
Hasteboy,kelthuzad,384,mage,arcane,6,4,2
Cømbust,frostmourne,384,mage,arcane,6,4,2
Jordèb,sargeras,384,mage,arcane,6,4,2
Dogmagetw,tichondrius,384,mage,arcane,6,4,2
Fredcouples,tichondrius,384,mage,arcane,6,4,2
Skoals,thrall,384,mage,arcane,6,4,2
Chilléd,tichondrius,384,mage,arcane,6,4,2
Parapio,tichondrius,384,mage,arcane,6,4,2
Lavaera,illidan,384,mage,arcane,6,4,2
Azeroth,boulderfist,384,mage,arcane,7,4,3
Nesomage,destromath,384,mage,arcane,12,4,8
Gobbstoppers,dalaran,384,mage,arcane,12,4,8
Billzeye,dalaran,384,mage,arcane,12,4,8
Biotic,kiljaeden,384,mage,arcane,12,4,8
Forestella,tichondrius,384,mage,arcane,12,4,8
Bigbuttangel,borean-tundra,384,mage,arcane,12,4,8
Scxut,tichondrius,384,mage,arcane,12,4,8
Khaldyn,tichondrius,384,mage,arcane,12,4,8
Inmylife,tichondrius,384,mage,arcane,12,4,8
Granmago,azralon,384,mage,arcane,12,4,8
Hogslop,saurfang,384,mage,arcane,12,4,8
Döömsage,hydraxis,384,mage,arcane,12,4,8
Frozorfs,tichondrius,384,mage,arcane,18,4,14
Thetodd,emerald-dream,382,mage,arcane,6,4,2
Preckwinkle,moon-guard,382,mage,arcane,12,4,8
Ærtai,black-dragonflight,304,mage,arcane,7,4,3
Moogician,aerie-peak,304,mage,arcane,7,4,3
Grarg,stormrage,301,mage,arcane,7,4,3
Kârén,aggramar,288,mage,arcane,6,3,3
Xythros,stormrage,288,mage,arcane,6,3,3
Vengefuly,tichondrius,288,mage,arcane,6,3,3
Unknownblast,kul-tiras,288,mage,arcane,6,3,3
Milfmaster,aerie-peak,288,mage,arcane,6,3,3
Kogin,thrall,288,mage,arcane,6,3,3
Sazza,tichondrius,288,mage,arcane,6,3,3
Koro,tichondrius,288,mage,arcane,6,3,3
Pwnstarx,proudmoore,288,mage,arcane,6,3,3
Snoogma,illidan,288,mage,arcane,6,3,3
Natzue,sargeras,288,mage,arcane,6,3,3
Bobbyyx,sargeras,288,mage,arcane,6,3,3
Xzude,korgath,288,mage,arcane,6,3,3
Madpoondog,frostmourne,288,mage,arcane,6,3,3
Zerodium,sargeras,288,mage,arcane,6,3,3
Neverbroke,illidan,288,mage,arcane,6,3,3
Adrazell,sargeras,288,mage,arcane,6,3,3
Overratedxd,moon-guard,288,mage,arcane,6,3,3
Jizzlez,tichondrius,288,mage,arcane,6,3,3
Myrondor,tichondrius,288,mage,arcane,6,3,3
Watchmesleep,tichondrius,288,mage,arcane,6,3,3
Levalol,aggramar,288,mage,arcane,10,4,6
Arçanemage,tichondrius,288,mage,arcane,12,3,9
Elux,whisperwind,288,mage,arcane,12,3,9
Toknsmoke,tichondrius,288,mage,arcane,12,3,9
Heflash,azralon,288,mage,arcane,12,3,9
Fasttwitch,kiljaeden,288,mage,arcane,12,3,9
Skittels,azshara,288,mage,arcane,12,3,9
Matmagic,drakkari,288,mage,arcane,13,3,10
Freehoñgkong,tichondrius,288,mage,arcane,18,3,15
Calcaster,aegwynn,287,mage,arcane,6,3,3
Kryptekk,area-52,287,mage,arcane,6,3,3
Ìgnìtìöñ,whisperwind,287,mage,arcane,12,3,9
Prosperoo,aerie-peak,286,mage,arcane,6,3,3
Arcanin,thunderlord,285,mage,arcane,12,3,9
Etyx,tichondrius,239,mage,arcane,5,3,2
Pay,nordrassil,223,mage,arcane,9,3,6
Røcco,azralon,192,mage,arcane,4,3,1
Opiumlord,tichondrius,192,mage,arcane,6,2,4
Emden,khadgar,192,mage,arcane,6,2,4
Sheepshot,dentarg,192,mage,arcane,6,2,4
Ferdabombs,tichondrius,192,mage,arcane,6,2,4
Mershon,tichondrius,192,mage,arcane,6,2,4
Maguín,tichondrius,192,mage,arcane,6,2,4
Alìv,tichondrius,192,mage,arcane,6,2,4
Chinkins,illidan,192,mage,arcane,6,2,4
Vensyr,stormrage,192,mage,arcane,6,2,4
Pullmefingy,illidan,192,mage,arcane,6,2,4
Vengx,tichondrius,192,mage,arcane,6,2,4
Xpez,stormrage,192,mage,arcane,6,2,4
Furrblock,tichondrius,192,mage,arcane,6,2,4
Amoredis,the-venture-co,192,mage,arcane,6,2,4
Akunimon,ragnaros,192,mage,arcane,6,2,4
Burna,amanthul,192,mage,arcane,6,2,4
Frostecho,moon-guard,192,mage,arcane,6,2,4
Blastgodx,stormrage,192,mage,arcane,6,2,4
Xunalatu,frostmourne,192,mage,arcane,6,2,4
Crinkit,frostmourne,192,mage,arcane,6,2,4
Icebish,skullcrusher,192,mage,arcane,6,2,4
Caimil,echo-isles,192,mage,arcane,6,2,4
Umber,dreadmaul,192,mage,arcane,6,2,4
Xannymancan,tichondrius,192,mage,arcane,6,2,4
Mymaage,andorhal,192,mage,arcane,6,2,4
Fakelovè,area-52,192,mage,arcane,6,2,4
Duffs,hyjal,192,mage,arcane,6,2,4
Highafrn,area-52,192,mage,arcane,6,2,4
Shimmerpoly,sargeras,192,mage,arcane,6,2,4
Sweetypie,fenris,192,mage,arcane,6,2,4
Compactor,emerald-dream,192,mage,arcane,12,2,10
Mcshwackin,area-52,192,mage,arcane,12,2,10
Barbarabush,hellscream,192,mage,arcane,12,2,10
Gatka,quelthalas,192,mage,arcane,12,2,10
Vires,kelthuzad,159,mage,arcane,5,2,3
Respektwaman,tichondrius,128,mage,arcane,4,2,2
Purpledrank,nagrand,96,mage,arcane,9,2,7
Nachtt,sargeras,96,mage,arcane,6,1,5
Flomin,tichondrius,96,mage,arcane,6,1,5
Nazztwren,bleeding-hollow,96,mage,arcane,6,1,5
Darthez,darkspear,96,mage,arcane,6,1,5
Genozyde,elune,96,mage,arcane,6,1,5
Coldrin,tichondrius,96,mage,arcane,6,1,5
Singheart,tichondrius,96,mage,arcane,6,1,5
Pollybot,tichondrius,96,mage,arcane,6,1,5
Gôøglëlòl,nemesis,96,mage,arcane,6,1,5
Burrbon,area-52,96,mage,arcane,6,1,5
Xlordpagan,sargeras,96,mage,arcane,6,1,5
Sahaquiel,tichondrius,96,mage,arcane,6,1,5
Casarenarrus,staghelm,96,mage,arcane,6,1,5
Trippy,senjin,96,mage,arcane,6,1,5
Needmyvape,moon-guard,96,mage,arcane,6,1,5
Hvnlyfathr,stormrage,96,mage,arcane,6,1,5
Smôl,emerald-dream,96,mage,arcane,6,1,5
Krazsus,tichondrius,96,mage,arcane,6,1,5
Elemenopi,thrall,96,mage,arcane,6,1,5
Mageki,ragnaros,96,mage,arcane,6,1,5
Quinnfreeze,boulderfist,96,mage,arcane,6,1,5
Ignit,stormrage,96,mage,arcane,6,1,5
Telkham,tichondrius,96,mage,arcane,6,1,5
Octané,illidan,96,mage,arcane,6,1,5
Illúmi,moon-guard,96,mage,arcane,6,1,5
Greaterbust,tichondrius,96,mage,arcane,12,1,11
Nikittomage,echo-isles,96,mage,arcane,12,1,11
Poofnpass,malorne,95,mage,arcane,6,1,5
Kralien,dalaran,95,mage,arcane,6,1,5
Sausage,boulderfist,84,mage,arcane,10,4,6
Scribe,anvilmar,79,mage,arcane,5,1,4
Frostmaul,dreadmaul,79,mage,arcane,11,1,10
Keepinitnoob,tichondrius,63,mage,arcane,2,2,0
Privilege,dragonmaw,31,mage,arcane,8,1,7
Setback,illidan,2122,mage,fire,138,69,69
Hansol,farstriders,2120,mage,fire,84,42,42
Valériemeow,tichondrius,2097,mage,fire,115,57,58
Xiaoxiaochu,tichondrius,2062,mage,fire,176,108,68
Dáddyshark,sargeras,2057,mage,fire,127,64,63
Talibandzx,sargeras,2042,mage,fire,159,77,82
Asetback,illidan,2035,mage,fire,120,58,62
Kyphosis,illidan,2022,mage,fire,107,64,43
Taylorlol,tichondrius,2019,mage,fire,135,64,71
Horoba,sargeras,2011,mage,fire,186,90,96
Adjudicatory,tichondrius,2003,mage,fire,69,34,35
Kasperkar,illidan,1991,mage,fire,245,124,121
Vcamusorz,tichondrius,1970,mage,fire,166,87,79
Gohonn,emerald-dream,1964,mage,fire,132,76,56
Bigfirebat,tichondrius,1964,mage,fire,119,60,59
Aeghis,stormrage,1958,mage,fire,48,26,22
Getmaged,bleeding-hollow,1943,mage,fire,64,40,24
Udmx,zuljin,1928,mage,fire,79,47,32
Peachygamer,stormscale,1921,mage,fire,198,99,99
Starxen,tichondrius,1915,mage,fire,54,31,23
Purpscurp,illidan,1914,mage,fire,130,74,56
Ranj,tichondrius,1913,mage,fire,73,35,38
Poundcakezx,tichondrius,1905,mage,fire,54,28,26
Vazlgs,tichondrius,1902,mage,fire,72,42,30
Benisp,stormrage,1898,mage,fire,68,35,33
Sorankim,tichondrius,1893,mage,fire,54,30,24
Nightsaber,blackrock,1869,mage,fire,42,26,16
Sunskim,tichondrius,1864,mage,fire,65,32,33
Sorcerous,bloodhoof,1861,mage,fire,151,89,62
Ròÿ,area-52,1861,mage,fire,72,37,35
Opisop,kelthuzad,1858,mage,fire,60,32,28
Degen,laughing-skull,1842,mage,fire,46,31,15
Ksmackm,illidan,1842,mage,fire,65,34,31
Undeadmerlin,zuljin,1834,mage,fire,54,30,24
Rmxd,malganis,1833,mage,fire,90,46,44
Wanming,tichondrius,1832,mage,fire,60,35,25
Vampìrelolz,tichondrius,1828,mage,fire,47,25,22
Csx,turalyon,1826,mage,fire,132,73,59
Cinnablast,darkspear,1824,mage,fire,26,20,6
Fwooshinator,malganis,1823,mage,fire,71,56,15
Såni,tichondrius,1819,mage,fire,67,39,28
Kraxos,stormrage,1814,mage,fire,108,62,46
Yaya,kargath,1811,mage,fire,105,51,54
Wiredcc,illidan,1805,mage,fire,30,20,10
Notini,azralon,1805,mage,fire,131,63,68
Epod,illidan,1801,mage,fire,60,28,32
Juju,tichondrius,1796,mage,fire,75,44,31
Zoryack,azralon,1791,mage,fire,96,50,46
Pinkmagetko,tichondrius,1775,mage,fire,36,19,17
Volkazar,sargeras,1766,mage,fire,39,21,18
Käxs,ragnaros,1762,mage,fire,42,21,21
Yorgøs,ragnaros,1736,mage,fire,60,31,29
Formi,frostmourne,1734,mage,fire,54,29,25
Highms,stormrage,1727,mage,fire,54,28,26
Icetomeetyu,bleeding-hollow,1726,mage,fire,185,92,93
Dropdeadlol,bonechewer,1725,mage,fire,78,48,30
Deepgodsz,azralon,1725,mage,fire,42,23,19
Wizarts,ragnaros,1725,mage,fire,60,27,33
Stergenutfr,tichondrius,1720,mage,fire,42,27,15
Englavian,frostmane,1709,mage,fire,54,28,26
Háté,ragnaros,1709,mage,fire,114,47,67
Snoogma,illidan,1702,mage,fire,35,25,10
Mângo,frostmourne,1699,mage,fire,24,18,6
Likebutter,tichondrius,1695,mage,fire,30,22,8
Younghehe,tichondrius,1692,mage,fire,148,77,71
Dagreatone,malganis,1687,mage,fire,46,24,22
Banquetmeal,emerald-dream,1686,mage,fire,42,27,15
Farragan,ragnaros,1686,mage,fire,42,18,24
Alenikus,blackhand,1680,mage,fire,98,50,48
Nickioxox,tichondrius,1674,mage,fire,24,18,6
Bighot,tichondrius,1673,mage,fire,90,53,37
Ligmmah,stormrage,1669,mage,fire,66,39,27
Ööf,emerald-dream,1667,mage,fire,66,30,36
Daddymayhem,proudmoore,1653,mage,fire,54,24,30
Magibe,thrall,1652,mage,fire,36,24,12
Itshug,area-52,1652,mage,fire,53,27,26
Lycheeoolong,frostmourne,1649,mage,fire,38,22,16
Varroc,quelthalas,1647,mage,fire,124,58,66
Pootysmooch,sargeras,1639,mage,fire,54,33,21
Oi,frostwolf,1636,mage,fire,75,48,27
Chionê,velen,1634,mage,fire,30,18,12
Tuniepop,sargeras,1631,mage,fire,89,44,45
Rockoe,tichondrius,1630,mage,fire,76,44,32
Trippy,senjin,1630,mage,fire,60,30,30
Vcamus,tichondrius,1629,mage,fire,24,17,7
Ârcano,ragnaros,1628,mage,fire,53,29,24
Gigatuts,stormrage,1625,mage,fire,42,22,20
Enthy,frostmourne,1623,mage,fire,60,30,30
Tweydey,tichondrius,1621,mage,fire,30,17,13
Thxo,hyjal,1620,mage,fire,87,41,46
Dexpy,tichondrius,1619,mage,fire,37,20,17
Myrondor,tichondrius,1611,mage,fire,78,43,35
Creaystar,area-52,1611,mage,fire,202,97,105
Wotl,tichondrius,1610,mage,fire,181,94,87
Chainpoly,area-52,1609,mage,fire,37,25,12
Muztaccio,tichondrius,1608,mage,fire,59,31,28
Fruitdealerr,tichondrius,1607,mage,fire,48,29,19
Torched,stormreaver,1605,mage,fire,42,21,21
Zarkanis,tichondrius,1604,mage,fire,49,25,24
Mushys,stormrage,1601,mage,fire,35,22,13
Jardz,area-52,1597,mage,fire,42,21,21
Sakurai,tichondrius,1593,mage,fire,48,28,20
Djpolymorph,stormrage,1587,mage,fire,102,58,44
Murcury,tichondrius,1584,mage,fire,238,122,116
Pzaz,moon-guard,1582,mage,fire,50,30,20
Sandylove,zuljin,1582,mage,fire,36,17,19
Hpthewizard,deathwing,1579,mage,fire,89,52,37
Iceward,frostmourne,1579,mage,fire,66,30,36
Magicmaghar,area-52,1577,mage,fire,42,24,18
Garbagemage,barthilas,1572,mage,fire,78,41,37
Firewreckage,malganis,1566,mage,fire,68,31,37
Kev,sentinels,1559,mage,fire,102,55,47
Marrioo,tichondrius,1555,mage,fire,42,22,20
Audacy,sargeras,1551,mage,fire,138,69,69
Wickymorph,barthilas,1549,mage,fire,53,25,28
Trolson,sargeras,1546,mage,fire,54,26,28
Lilbabyx,stormrage,1538,mage,fire,74,39,35
Xs,stormrage,1534,mage,fire,120,67,53
Teetems,sargeras,1530,mage,fire,116,59,57
Fifthelëment,emerald-dream,1529,mage,fire,119,65,54
Squantanimo,shadowmoon,1527,mage,fire,53,26,27
Kindle,malorne,1525,mage,fire,33,18,15
Lolololololo,kelthuzad,1525,mage,fire,198,100,98
Magekylex,proudmoore,1522,mage,fire,99,58,41
Pyroshima,barthilas,1522,mage,fire,89,44,45
Biscobush,turalyon,1519,mage,fire,30,18,12
Crazytime,tichondrius,1519,mage,fire,42,23,19
Albbano,tichondrius,1518,mage,fire,24,16,8
Fookz,malganis,1515,mage,fire,60,32,28
Imannoyingha,darkspear,1510,mage,fire,71,37,34
Mager,dentarg,1508,mage,fire,62,40,22
Ultrá,stormscale,1504,mage,fire,72,42,30
Skryte,mannoroth,1504,mage,fire,40,22,18
Coneofkony,bleeding-hollow,1503,mage,fire,30,20,10
Bajaoreily,zangarmarsh,1501,mage,fire,36,17,19
Anuub,kelthuzad,1497,mage,fire,36,20,16
Pòlly,illidan,1495,mage,fire,42,25,17
Wïzarduous,mannoroth,1494,mage,fire,48,30,18
Mariomario,tichondrius,1494,mage,fire,60,35,25
Juul,emerald-dream,1492,mage,fire,126,62,64
Mirimida,ragnaros,1490,mage,fire,105,61,44
Beerandmagic,zuljin,1487,mage,fire,30,16,14
Coolhandz,tichondrius,1487,mage,fire,47,24,23
Dârkus,sargeras,1487,mage,fire,122,60,62
Grynthwzrd,stormrage,1484,mage,fire,42,24,18
Streetember,nemesis,1483,mage,fire,78,35,43
Toastedoats,hyjal,1482,mage,fire,85,46,39
Jojomage,thrall,1473,mage,fire,138,71,67
Chickenspank,stormrage,1473,mage,fire,36,18,18
Nazmagus,hydraxis,1470,mage,fire,93,51,42
Anàrchy,emerald-dream,1469,mage,fire,51,29,22
Leonr,tichondrius,1464,mage,fire,65,39,26
Smallbrainz,emerald-dream,1462,mage,fire,60,34,26
Ferdabombs,tichondrius,1460,mage,fire,90,50,40
Frostpimp,anubarak,1460,mage,fire,60,22,38
Singheart,tichondrius,1457,mage,fire,162,80,82
Pyroflinger,stormrage,1453,mage,fire,90,46,44
Worldonfire,ragnaros,1450,mage,fire,160,80,80
Sparklepoof,tichondrius,1449,mage,fire,29,17,12
Bettybonk,cenarius,1449,mage,fire,42,20,22
Firèballin,tichondrius,1441,mage,fire,31,17,14
Sabrita,proudmoore,1440,mage,fire,36,16,20
Xanthan,runetotem,1437,mage,fire,39,21,18
Swaglo,illidan,1435,mage,fire,40,18,22
Sahala,frostmourne,1424,mage,fire,42,19,23
Sydrol,area-52,1423,mage,fire,129,68,61
Jööz,deathwing,1423,mage,fire,45,20,25
Yooyar,barthilas,1422,mage,fire,130,60,70
Snanth,black-dragonflight,1420,mage,fire,51,29,22
Øzmage,area-52,1416,mage,fire,21,16,5
Mudohir,stormrage,1415,mage,fire,34,16,18
Skoffla,executus,1411,mage,fire,42,22,20
Eekzlol,illidan,1409,mage,fire,30,16,14
Snuurf,ragnaros,1406,mage,fire,60,31,29
Ålmøst,tichondrius,1405,mage,fire,65,36,29
Dreadparadox,bleeding-hollow,1405,mage,fire,34,16,18
Yeetcannøn,illidan,1403,mage,fire,30,15,15
Marajaade,tichondrius,1403,mage,fire,80,38,42
Mayumî,moon-guard,1401,mage,fire,34,18,16
Whiteyx,saurfang,1399,mage,fire,52,29,23
Wakkaflame,stormrage,1398,mage,fire,48,19,29
Ruzam,area-52,1394,mage,fire,66,31,35
Jundead,dalaran,1393,mage,fire,79,46,33
Hööva,illidan,1392,mage,fire,71,35,36
Jizzlez,tichondrius,1392,mage,fire,48,23,25
Eazzybaby,eredar,1388,mage,fire,424,217,207
Coôler,illidan,1388,mage,fire,84,40,44
Gasolína,stormrage,1385,mage,fire,48,28,20
Purpledrank,nagrand,1385,mage,fire,85,39,46
Leaso,tichondrius,1384,mage,fire,45,22,23
Neglect,moknathal,1375,mage,fire,30,16,14
Wzrdxz,tichondrius,1370,mage,fire,36,17,19
Mageonthc,korgath,1368,mage,fire,23,15,8
Melkra,tichondrius,1367,mage,fire,52,26,26
Garungar,antonidas,1361,mage,fire,24,15,9
Coltrip,azralon,1359,mage,fire,83,38,45
Elwyn,dunemaul,1358,mage,fire,60,29,31
Zstyle,frostmourne,1355,mage,fire,37,22,15
Elysõna,area-52,1349,mage,fire,72,35,37
Prinseza,quelthalas,1345,mage,fire,55,27,28
Badaszbich,tichondrius,1344,mage,fire,36,20,16
Sikeyzlol,bleeding-hollow,1343,mage,fire,24,14,10
Coldcaster,mugthol,1340,mage,fire,74,40,34
Dearasian,ragnaros,1335,mage,fire,60,32,28
Búrsting,kelthuzad,1334,mage,fire,31,16,15
Adrazell,sargeras,1333,mage,fire,42,21,21
Gødvana,frostmourne,1331,mage,fire,30,18,12
Charkoalzz,moon-guard,1323,mage,fire,29,14,15
Holbrook,greymane,1316,mage,fire,49,24,25
Quizzard,blackrock,1310,mage,fire,28,15,13
Raynark,nemesis,1307,mage,fire,30,18,12
Waffles,ravencrest,1307,mage,fire,62,29,33
Kevymarts,tichondrius,1304,mage,fire,30,15,15
Jjijuns,tichondrius,1302,mage,fire,40,18,22
Carnelius,bleeding-hollow,1292,mage,fire,63,32,31
Rudeswizard,area-52,1291,mage,fire,73,32,41
Adronicus,tichondrius,1287,mage,fire,60,31,29
Magination,frostmourne,1284,mage,fire,42,18,24
Hypernova,vashj,1277,mage,fire,41,19,22
Kronicblast,bleeding-hollow,1270,mage,fire,57,24,33
Abzy,sargeras,1264,mage,fire,60,29,31
Helcarwen,area-52,1261,mage,fire,60,30,30
Christjan,tichondrius,1260,mage,fire,138,72,66
Zulugara,barthilas,1258,mage,fire,36,19,17
Hositonet,malganis,1257,mage,fire,63,35,28
Reddfire,proudmoore,1253,mage,fire,42,15,27
Smigui,azralon,1252,mage,fire,152,71,81
Babysharky,uther,1249,mage,fire,34,14,20
Glaucus,illidan,1247,mage,fire,18,13,5
Fíery,blades-edge,1243,mage,fire,72,34,38
Alzagen,ragnaros,1241,mage,fire,56,26,30
Subscribe,malganis,1238,mage,fire,36,14,22
Feogato,proudmoore,1237,mage,fire,60,29,31
Polymedaddi,tichondrius,1236,mage,fire,36,13,23
Politeness,tichondrius,1233,mage,fire,24,13,11
Christensen,stormrage,1231,mage,fire,30,17,13
Slumpgodd,frostmourne,1230,mage,fire,30,13,17
Gadgítte,moon-guard,1229,mage,fire,24,13,11
Aerligar,area-52,1225,mage,fire,24,13,11
Dragonie,nordrassil,1224,mage,fire,45,23,22
Cymbalta,azralon,1219,mage,fire,29,20,9
Zinnos,tichondrius,1218,mage,fire,30,13,17
Archtype,azralon,1217,mage,fire,18,13,5
Genthruz,ragnaros,1215,mage,fire,48,22,26
Mongomike,stormrage,1205,mage,fire,63,26,37
Hadlly,tichondrius,1197,mage,fire,23,13,10
Sorrenton,sargeras,1186,mage,fire,41,23,18
Burist,illidan,1185,mage,fire,38,19,19
Esfire,frostmourne,1185,mage,fire,48,23,25
Zonmague,drakkari,1177,mage,fire,36,17,19
Iguanodon,proudmoore,1159,mage,fire,56,29,27
Tamarolfrost,illidan,1158,mage,fire,19,13,6
Gradmage,proudmoore,1156,mage,fire,50,20,30
Maxvila,kelthuzad,1152,mage,fire,18,12,6
Snaregodx,area-52,1151,mage,fire,18,12,6
Kjuuler,moon-guard,1151,mage,fire,24,12,12
Dmgdaddy,zuljin,1150,mage,fire,30,12,18
Rhykx,malganis,1149,mage,fire,18,12,6
Frostymart,arthas,1149,mage,fire,18,12,6
Coldsnapy,frostmourne,1148,mage,fire,24,12,12
Balmunc,proudmoore,1147,mage,fire,18,12,6
Chumpp,tichondrius,1147,mage,fire,18,12,6
Dorkski,bleeding-hollow,1147,mage,fire,115,49,66
Absentbrain,stormrage,1145,mage,fire,24,12,12
Eatnu,tichondrius,1142,mage,fire,24,12,12
Arrcadia,darkspear,1142,mage,fire,30,12,18
Grymorum,ragnaros,1141,mage,fire,30,12,18
Fleët,tichondrius,1139,mage,fire,18,12,6
Usirfail,bleeding-hollow,1133,mage,fire,30,12,18
Gnarwallx,stormrage,1132,mage,fire,30,12,18
Wawakun,ragnaros,1127,mage,fire,30,14,16
Magalí,nemesis,1122,mage,fire,36,16,20
Xzilence,aerie-peak,1118,mage,fire,30,12,18
Sánzunokawa,quelthalas,1109,mage,fire,27,16,11
Noescaping,illidan,1102,mage,fire,24,12,12
Saladguy,thrall,1101,mage,fire,42,14,28
Gempette,tichondrius,1095,mage,fire,23,12,11
Wazzerd,moon-guard,1093,mage,fire,27,12,15
Guccilaflur,proudmoore,1082,mage,fire,27,12,15
Crnomage,area-52,1081,mage,fire,23,12,11
Pikoda,azralon,1066,mage,fire,28,12,16
Lightsoran,tichondrius,1055,mage,fire,18,11,7
Flaux,sargeras,1055,mage,fire,18,11,7
Alorae,wyrmrest-accord,1054,mage,fire,18,11,7
Avicci,shattered-halls,1054,mage,fire,30,11,19
Blinksz,korgath,1053,mage,fire,18,11,7
Cinns,moon-guard,1051,mage,fire,24,11,13
Radakos,emerald-dream,1050,mage,fire,24,11,13
Snoü,proudmoore,1049,mage,fire,30,11,19
Harlloo,the-underbog,1049,mage,fire,30,11,19
Kryptekk,area-52,1048,mage,fire,24,11,13
Erlendr,moon-guard,1041,mage,fire,44,22,22
Shashyta,drakkari,1031,mage,fire,54,14,40
Flame,arthas,1028,mage,fire,30,11,19
Putridìty,thrall,1024,mage,fire,24,11,13
Ispell,tichondrius,1024,mage,fire,72,29,43
Psycles,dragonmaw,1022,mage,fire,36,11,25
Asönia,illidan,1020,mage,fire,30,11,19
Ops,frostmourne,1009,mage,fire,117,62,55
Hotjazzfarts,sargeras,1003,mage,fire,61,35,26
Minerves,tichondrius,1001,mage,fire,28,13,15
Grandpapi,arthas,997,mage,fire,23,11,12
Amge,uldum,991,mage,fire,20,11,9
Coldblooded,zuljin,991,mage,fire,41,14,27
Absolutepowa,bleeding-hollow,986,mage,fire,20,11,9
Bàttlemage,nagrand,982,mage,fire,36,21,15
Sasghengis,frostmourne,981,mage,fire,36,16,20
Lilmj,kelthuzad,970,mage,fire,25,11,14
Endmepls,ysera,965,mage,fire,96,40,56
Skaq,tichondrius,960,mage,fire,12,10,2
Tupactopus,tichondrius,960,mage,fire,18,10,8
Mokelovin,sargeras,959,mage,fire,18,10,8
Squidio,stormrage,959,mage,fire,18,10,8
Zakume,stormrage,958,mage,fire,18,10,8
Osh,malorne,957,mage,fire,24,10,14
Preceptør,azralon,957,mage,fire,24,10,14
Alunarassra,tichondrius,956,mage,fire,24,10,14
Dårks,area-52,955,mage,fire,24,10,14
Ripburn,stormrage,953,mage,fire,47,20,27
Etyx,tichondrius,953,mage,fire,30,10,20
Flavaflame,mugthol,952,mage,fire,18,10,8
Hýdro,ghostlands,951,mage,fire,30,16,14
Clapsyou,illidan,951,mage,fire,24,10,14
Zukoprince,azralon,950,mage,fire,12,10,2
Abstractgoat,tichondrius,946,mage,fire,30,15,15
Vamkari,ragnaros,942,mage,fire,18,10,8
Coldarei,nagrand,928,mage,fire,27,12,15
Dojacute,frostmourne,910,mage,fire,17,10,7
Senegau,azralon,902,mage,fire,51,23,28
Coldrin,tichondrius,897,mage,fire,28,11,17
Alywgard,sargeras,894,mage,fire,22,10,12
Beji,frostmourne,894,mage,fire,38,17,21
Alaramaria,sargeras,886,mage,fire,18,10,8
Jaysaucetv,tichondrius,878,mage,fire,19,10,9
Squishymage,frostmourne,877,mage,fire,25,10,15
Tungstentoes,shuhalo,875,mage,fire,21,12,9
Nakana,area-52,875,mage,fire,52,25,27
Strêss,kelthuzad,870,mage,fire,22,12,10
Béssie,area-52,869,mage,fire,44,20,24
Bigpøppapump,tichondrius,864,mage,fire,24,9,15
Ddouble,tichondrius,863,mage,fire,18,9,9
Dabsx,moon-guard,863,mage,fire,18,9,9
Shimmerpoly,sargeras,863,mage,fire,24,9,15
Scmage,exodar,862,mage,fire,18,9,9
Desfunz,mugthol,862,mage,fire,18,9,9
Unknownblast,kul-tiras,862,mage,fire,26,9,17
Nachtt,sargeras,861,mage,fire,18,9,9
Ingrumatig,tichondrius,861,mage,fire,24,9,15
Fryry,dalaran,860,mage,fire,24,9,15
Baelthezer,moon-guard,858,mage,fire,21,12,9
Halfsquad,malfurion,858,mage,fire,18,9,9
Product,mugthol,858,mage,fire,18,9,9
Freez,garona,858,mage,fire,21,10,11
Gadalka,frostmourne,857,mage,fire,18,9,9
Othokk,tichondrius,852,mage,fire,24,9,15
Dánó,lightbringer,843,mage,fire,62,26,36
Umber,dreadmaul,829,mage,fire,17,9,8
Ljaie,lightbringer,813,mage,fire,17,9,8
Phantose,sargeras,808,mage,fire,22,10,12
Arcanemain,kargath,799,mage,fire,42,18,24
Pyrotactics,sargeras,796,mage,fire,28,9,19
Mágos,stormrage,768,mage,fire,12,8,4
Pherixsw,stormrage,768,mage,fire,12,8,4
Dandrix,sargeras,768,mage,fire,12,8,4
Castana,tichondrius,768,mage,fire,18,8,10
Avócadó,malganis,768,mage,fire,18,8,10
Salvick,emerald-dream,768,mage,fire,18,8,10
Cumbus,stormrage,768,mage,fire,24,8,16
Kawailenard,tichondrius,767,mage,fire,12,8,4
Ogfresh,area-52,767,mage,fire,12,8,4
Raisonmage,tichondrius,767,mage,fire,12,8,4
Isendra,bleeding-hollow,767,mage,fire,12,8,4
Ashenlad,moon-guard,766,mage,fire,18,8,10
Tarmiel,quelthalas,765,mage,fire,24,8,16
Isoicast,moon-guard,759,mage,fire,22,11,11
Brànd,antonidas,758,mage,fire,12,8,4
Orianne,windrunner,750,mage,fire,12,8,4
Pyrlos,terokkar,738,mage,fire,24,9,15
Orionmage,frostmourne,720,mage,fire,15,8,7
Dìus,malganis,719,mage,fire,17,8,9
Letitgoo,azralon,715,mage,fire,25,9,16
Drewann,draenor,704,mage,fire,16,8,8
Shmagee,azralon,684,mage,fire,13,8,5
Sos,kelthuzad,672,mage,fire,12,7,5
Xythros,stormrage,672,mage,fire,12,7,5
Tuggernaug,malganis,672,mage,fire,12,7,5
Vamplol,tichondrius,672,mage,fire,12,7,5
Warpfactor,malganis,672,mage,fire,12,7,5
Osirax,frostmane,672,mage,fire,12,7,5
Belven,proudmoore,672,mage,fire,12,7,5
Silimage,area-52,672,mage,fire,12,7,5
Strumms,tichondrius,672,mage,fire,18,7,11
Vastlord,stormrage,672,mage,fire,18,7,11
Bigdjohnson,dalaran,672,mage,fire,18,7,11
Blastfire,stormrage,671,mage,fire,12,7,5
Diewnuts,zuljin,671,mage,fire,12,7,5
Mymrmage,mannoroth,671,mage,fire,12,7,5
Allhitz,ragnaros,671,mage,fire,12,7,5
Aulle,whisperwind,671,mage,fire,12,7,5
Lucidaze,daggerspine,671,mage,fire,12,7,5
Ásune,moon-guard,671,mage,fire,12,7,5
Keileon,tichondrius,671,mage,fire,12,7,5
Alàh,stormscale,671,mage,fire,18,7,11
Dreaming,draktharon,670,mage,fire,12,7,5
Fanshen,tichondrius,670,mage,fire,17,7,10
Supermajor,frostmourne,670,mage,fire,18,7,11
Tmo,mannoroth,670,mage,fire,24,7,17
Boptimus,moonrunner,666,mage,fire,12,7,5
Vonfrmdao,illidan,624,mage,fire,15,8,7
Slipqt,tichondrius,607,mage,fire,22,7,15
Chumleyson,eonar,606,mage,fire,14,7,7
Mômö,argent-dawn,606,mage,fire,22,7,15
Mzr,proudmoore,576,mage,fire,6,6,0
Strdelmaker,tichondrius,576,mage,fire,6,6,0
Itizar,frostmourne,576,mage,fire,6,6,0
Eludin,aegwynn,576,mage,fire,12,6,6
Cuterthanyou,sargeras,576,mage,fire,12,6,6
Tearsfórgód,kelthuzad,576,mage,fire,12,6,6
Laradria,kiljaeden,576,mage,fire,12,6,6
Myfamilygpie,nazgrel,576,mage,fire,12,6,6
Shmoked,kelthuzad,576,mage,fire,12,6,6
Mageboy,bonechewer,576,mage,fire,12,6,6
Omagawd,tichondrius,576,mage,fire,12,6,6
Fakewarlockk,illidan,576,mage,fire,12,6,6
Kaylemage,tichondrius,576,mage,fire,12,6,6
Fredcouples,tichondrius,576,mage,fire,12,6,6
Herzthroh,stormrage,576,mage,fire,12,6,6
Ghili,tichondrius,576,mage,fire,12,6,6
Gtown,kelthuzad,576,mage,fire,12,6,6
Sourpatchkds,emerald-dream,576,mage,fire,12,6,6
Leakyboots,illidan,576,mage,fire,12,6,6
Frostboy,borean-tundra,576,mage,fire,12,6,6
Toteypotter,frostmourne,576,mage,fire,12,6,6
Magicmidget,malganis,576,mage,fire,12,6,6
Wakamage,area-52,576,mage,fire,12,6,6
Plutón,tichondrius,576,mage,fire,12,6,6
Darkisfrosty,tichondrius,576,mage,fire,12,6,6
Jonboym,illidan,576,mage,fire,12,6,6
Magicmichel,malganis,576,mage,fire,12,6,6
Velvetlurker,tichondrius,576,mage,fire,12,6,6
Aangx,stormrage,576,mage,fire,16,7,9
Stimml,blood-furnace,576,mage,fire,18,6,12
Pecs,kiljaeden,576,mage,fire,18,6,12
Linkolni,azralon,576,mage,fire,18,6,12
Choccoeu,illidan,576,mage,fire,20,6,14
Insightæ,frostmourne,575,mage,fire,10,7,3
Magja,bloodhoof,575,mage,fire,12,6,6
Minuswizard,dalaran,575,mage,fire,12,6,6
Astroblasty,tichondrius,575,mage,fire,18,6,12
Eraticmage,illidan,575,mage,fire,24,6,18
Calínico,quelthalas,575,mage,fire,24,6,18
Pellemus,malganis,574,mage,fire,12,6,6
Spellpowa,khaz-modan,574,mage,fire,12,6,6
Calcaster,aegwynn,573,mage,fire,18,6,12
Xannymancan,tichondrius,573,mage,fire,30,6,24
Zendrix,bonechewer,571,mage,fire,18,6,12
Ashex,moon-guard,559,mage,fire,18,7,11
Thragè,sargeras,543,mage,fire,11,6,5
Glacier,firetree,543,mage,fire,11,6,5
Magicke,azgalor,542,mage,fire,22,6,16
Sossmage,jaedenar,528,mage,fire,9,6,3
Ghostrr,tichondrius,511,mage,fire,8,6,2
Maxmie,sargeras,480,mage,fire,6,5,1
Youezdawg,tichondrius,480,mage,fire,6,5,1
Shaabby,shadowmoon,480,mage,fire,6,5,1
Slavic,sargeras,480,mage,fire,6,5,1
Ject,ragnaros,480,mage,fire,6,5,1
Hocusjokus,frostmourne,480,mage,fire,6,5,1
Ñïz,bleeding-hollow,480,mage,fire,6,5,1
Polypolypoly,kiljaeden,480,mage,fire,10,6,4
Dbsheep,kul-tiras,480,mage,fire,12,5,7
Icestory,tichondrius,480,mage,fire,12,5,7
Arishasis,tichondrius,480,mage,fire,12,5,7
Espyy,area-52,480,mage,fire,12,5,7
Quikcast,archimonde,480,mage,fire,12,5,7
Numbing,sargeras,480,mage,fire,12,5,7
Honeydutchss,black-dragonflight,480,mage,fire,12,5,7
Pugsmugg,icecrown,480,mage,fire,12,5,7
Baida,kelthuzad,480,mage,fire,12,5,7
Diamondx,ragnaros,480,mage,fire,12,5,7
Covín,malganis,480,mage,fire,12,5,7
Marxeflamer,ragnaros,480,mage,fire,12,5,7
Entomas,quelthalas,480,mage,fire,12,5,7
Jikario,zuljin,480,mage,fire,12,5,7
Cnumlab,proudmoore,480,mage,fire,12,5,7
Magicalbuns,illidan,480,mage,fire,12,5,7
Kushjointz,tichondrius,480,mage,fire,12,5,7
Imhotboi,illidan,480,mage,fire,12,5,7
Kqlyy,tichondrius,480,mage,fire,12,5,7
Skillcap,nagrand,480,mage,fire,12,5,7
Zerosaspect,thrall,480,mage,fire,12,5,7
Connorq,stormrage,480,mage,fire,12,5,7
Marther,whisperwind,480,mage,fire,12,5,7
Bxgs,tichondrius,480,mage,fire,12,5,7
Kyriê,darkspear,480,mage,fire,12,5,7
Lambsalsa,tichondrius,480,mage,fire,12,5,7
Aapple,tichondrius,480,mage,fire,17,5,12
Mageyoulooks,kelthuzad,480,mage,fire,18,5,13
Siayo,stormscale,480,mage,fire,18,5,13
Tunax,tichondrius,480,mage,fire,18,5,13
Finanahs,sargeras,479,mage,fire,12,5,7
Mescudi,bonechewer,479,mage,fire,12,5,7
Xunalatu,frostmourne,479,mage,fire,12,5,7
Shadowgalaxy,arthas,479,mage,fire,12,5,7
Apolarus,bonechewer,478,mage,fire,12,5,7
Frogpapi,illidan,478,mage,fire,12,5,7
Gwenage,tichondrius,472,mage,fire,12,5,7
Shotö,skullcrusher,463,mage,fire,17,5,12
Søkø,tichondrius,451,mage,fire,20,7,13
Roastbeefxd,tichondrius,447,mage,fire,11,5,6
Prepcook,dalaran,447,mage,fire,11,5,6
Licklix,tichondrius,446,mage,fire,10,5,5
Jazen,quelthalas,432,mage,fire,15,6,9
Myelvenlady,proudmoore,431,mage,fire,11,5,6
Certifried,emerald-dream,415,mage,fire,14,5,9
Molassess,illidan,400,mage,fire,13,5,8
Fullsheep,emerald-dream,384,mage,fire,6,4,2
Mithràndìr,tichondrius,384,mage,fire,6,4,2
Crøwgawd,tichondrius,384,mage,fire,6,4,2
Pollybot,tichondrius,384,mage,fire,6,4,2
Sifr,tichondrius,384,mage,fire,6,4,2
Refreshments,bleeding-hollow,384,mage,fire,6,4,2
Haze,hyjal,384,mage,fire,6,4,2
Jasmine,moon-guard,384,mage,fire,6,4,2
Zokorzik,area-52,384,mage,fire,6,4,2
Cømbust,frostmourne,384,mage,fire,6,4,2
Floatyz,tichondrius,384,mage,fire,6,4,2
Jazzgroyper,sargeras,384,mage,fire,6,4,2
Keepv,tichondrius,384,mage,fire,6,4,2
Gíldrin,proudmoore,384,mage,fire,6,4,2
Majjix,illidan,384,mage,fire,6,4,2
Frozonnee,aggramar,384,mage,fire,6,4,2
Chapelrat,sargeras,384,mage,fire,6,4,2
Poonfarmer,zangarmarsh,384,mage,fire,6,4,2
Fïtz,quelthalas,384,mage,fire,6,4,2
Burstyboi,frostmourne,384,mage,fire,6,4,2
Frankkie,mugthol,384,mage,fire,6,4,2
Extremeways,tichondrius,384,mage,fire,6,4,2
Pyröz,kelthuzad,384,mage,fire,6,4,2
Gominsi,tichondrius,384,mage,fire,6,4,2
Frogbum,fizzcrank,384,mage,fire,10,5,5
Dytonie,moon-guard,384,mage,fire,9,4,5
Aquralina,moon-guard,384,mage,fire,12,4,8
Elfmage,tichondrius,384,mage,fire,12,4,8
Felsparkles,area-52,384,mage,fire,12,4,8
Spookydookie,dark-iron,384,mage,fire,12,4,8
Dasanimomo,sargeras,384,mage,fire,12,4,8
Droppinbombs,draka,384,mage,fire,12,4,8
Cacaushow,stormrage,384,mage,fire,12,4,8
Tìnkerspell,stormrage,384,mage,fire,12,4,8
Aeg,stormrage,384,mage,fire,12,4,8
Cam,kul-tiras,384,mage,fire,12,4,8
Uwuwhatnow,tichondrius,384,mage,fire,12,4,8
Arialla,mannoroth,384,mage,fire,12,4,8
Percivaltp,scarlet-crusade,384,mage,fire,12,4,8
Hogslop,saurfang,384,mage,fire,12,4,8
Sarahbeth,khadgar,384,mage,fire,12,4,8
Ejzok,dreadmaul,384,mage,fire,12,4,8
Thiio,tichondrius,384,mage,fire,12,4,8
Udó,proudmoore,384,mage,fire,12,4,8
Galsola,bronzebeard,384,mage,fire,12,4,8
Pigdancel,tichondrius,384,mage,fire,12,4,8
Gôøglëlòl,nemesis,384,mage,fire,18,4,14
Neferpitøu,tichondrius,383,mage,fire,6,4,2
Noyade,illidan,383,mage,fire,6,4,2
Drewzz,tichondrius,383,mage,fire,8,4,4
Chuggin,emerald-dream,383,mage,fire,15,5,10
Wetguuch,area-52,383,mage,fire,12,4,8
Hockisonz,moon-guard,383,mage,fire,12,4,8
Soulwiper,illidan,383,mage,fire,17,5,12
Smoney,icecrown,383,mage,fire,18,4,14
Pyromidget,khazgoroth,382,mage,fire,12,4,8
Kopke,ragnaros,381,mage,fire,13,4,9
Hollfz,nemesis,367,mage,fire,11,4,7
Vixm,stormrage,352,mage,fire,10,5,5
Tmharp,tichondrius,336,mage,fire,9,5,4
Gö,tichondrius,288,mage,fire,6,3,3
Azuriex,tichondrius,288,mage,fire,6,3,3
Ancientmagik,area-52,288,mage,fire,6,3,3
Gandrich,drakkari,288,mage,fire,6,3,3
Zerathremar,proudmoore,288,mage,fire,6,3,3
Globglob,tichondrius,288,mage,fire,6,3,3
Urbadxd,llane,288,mage,fire,6,3,3
Síra,firetree,288,mage,fire,6,3,3
Bhalec,kelthuzad,288,mage,fire,6,3,3
Easyfreeze,sargeras,288,mage,fire,6,3,3
Hasteboy,kelthuzad,288,mage,fire,6,3,3
Kylar,icecrown,288,mage,fire,6,3,3
Polyenjoyerx,ysera,288,mage,fire,6,3,3
Emvepee,sargeras,288,mage,fire,6,3,3
Kuther,draenor,288,mage,fire,6,3,3
Thecorruptor,malorne,288,mage,fire,6,3,3
Mindthegap,tichondrius,288,mage,fire,6,3,3
Ave,anetheron,288,mage,fire,6,3,3
Bergan,sargeras,288,mage,fire,6,3,3
Rhoadies,malfurion,288,mage,fire,6,3,3
Shírley,tichondrius,288,mage,fire,6,3,3
Jimmyhendrix,wildhammer,288,mage,fire,6,3,3
Novice,barthilas,288,mage,fire,6,3,3
Wqnmlgbdy,tichondrius,288,mage,fire,6,3,3
Botoslàp,dragonmaw,288,mage,fire,6,3,3
Bombr,sargeras,288,mage,fire,6,3,3
Whyze,malganis,288,mage,fire,6,3,3
Chilléd,tichondrius,288,mage,fire,6,3,3
Garion,moon-guard,288,mage,fire,6,3,3
Bøfa,tichondrius,288,mage,fire,6,3,3
Polyburst,darkspear,288,mage,fire,6,3,3
Vengefuly,tichondrius,288,mage,fire,6,3,3
Blinkinghobo,sargeras,288,mage,fire,6,3,3
Gåndalf,ragnaros,288,mage,fire,6,3,3
Kyliec,tichondrius,288,mage,fire,6,3,3
Zenzoh,azuremyst,288,mage,fire,6,3,3
Rhunón,dalaran,288,mage,fire,6,3,3
Zuhbo,moon-guard,288,mage,fire,6,3,3
Chez,tichondrius,288,mage,fire,6,3,3
Kassekx,area-52,288,mage,fire,6,3,3
Mntaindew,bleeding-hollow,288,mage,fire,6,3,3
Slinkyslink,area-52,288,mage,fire,6,3,3
Yòkai,tichondrius,288,mage,fire,6,3,3
Svips,illidan,288,mage,fire,6,3,3
Boorster,illidan,288,mage,fire,6,3,3
Pollylol,proudmoore,288,mage,fire,6,3,3
Lampert,tichondrius,288,mage,fire,6,3,3
Missingxx,silvermoon,288,mage,fire,6,3,3
Tráshmage,zuljin,288,mage,fire,6,3,3
Rích,tichondrius,288,mage,fire,6,3,3
Frostkage,tichondrius,288,mage,fire,6,3,3
Nuzzle,boulderfist,288,mage,fire,8,3,5
Turbogeo,shuhalo,288,mage,fire,12,3,9
Fatalexo,tichondrius,288,mage,fire,12,3,9
Nilla,hyjal,288,mage,fire,12,3,9
Danggurl,tichondrius,288,mage,fire,12,3,9
Funkeoto,thrall,288,mage,fire,12,3,9
Orkinekek,frostmourne,288,mage,fire,12,3,9
Mendittorosa,tichondrius,288,mage,fire,12,3,9
Keionti,dalaran,288,mage,fire,12,3,9
Gnomegeddons,dalaran,288,mage,fire,24,3,21
Frostyii,stonemaul,287,mage,fire,6,3,3
Harlen,quelthalas,287,mage,fire,6,3,3
Aphazia,kiljaeden,287,mage,fire,6,3,3
Baelzharon,hellscream,287,mage,fire,12,3,9
Kittikk,tichondrius,284,mage,fire,18,3,15
Nesomage,destromath,256,mage,fire,10,3,7
Rossanopolis,tichondrius,255,mage,fire,17,3,14
Nephalem,moknathal,240,mage,fire,9,3,6
Orderlight,alexstrasza,239,mage,fire,5,3,2
Genozyde,elune,239,mage,fire,5,3,2
Fizario,barthilas,239,mage,fire,5,3,2
Feenìx,tichondrius,234,mage,fire,6,4,2
Wabï,tichondrius,234,mage,fire,9,4,5
Flomin,tichondrius,234,mage,fire,16,6,10
Cînderellas,proudmoore,234,mage,fire,13,4,9
Vakina,tichondrius,223,mage,fire,12,3,9
Rennifer,malganis,192,mage,fire,9,3,6
Trollsita,thrall,192,mage,fire,6,2,4
Arianark,sargeras,192,mage,fire,6,2,4
Kymowiz,sargeras,192,mage,fire,6,2,4
Pòpsmóke,tichondrius,192,mage,fire,6,2,4
Privilege,dragonmaw,192,mage,fire,6,2,4
Akephálos,drakkari,192,mage,fire,6,2,4
Notria,illidan,192,mage,fire,6,2,4
Gotya,tichondrius,192,mage,fire,6,2,4
Yellowfevrz,thrall,192,mage,fire,6,2,4
Elhechizero,quelthalas,192,mage,fire,6,2,4
Avandal,proudmoore,192,mage,fire,6,2,4
Zënith,quelthalas,192,mage,fire,6,2,4
Karameltart,barthilas,192,mage,fire,6,2,4
Burna,amanthul,192,mage,fire,6,2,4
Dustychill,illidan,192,mage,fire,6,2,4
Thedodgex,sargeras,192,mage,fire,6,2,4
Dohnutt,tichondrius,192,mage,fire,6,2,4
Preplex,thrall,192,mage,fire,6,2,4
Shardgodx,kelthuzad,192,mage,fire,6,2,4
Massivepoo,barthilas,192,mage,fire,6,2,4
Wauzcrol,quelthalas,192,mage,fire,6,2,4
Tannbone,illidan,192,mage,fire,6,2,4
Jinglehz,frostmourne,192,mage,fire,6,2,4
Gódsfather,kelthuzad,192,mage,fire,6,2,4
Defaultx,turalyon,192,mage,fire,6,2,4
Trízín,frostmourne,192,mage,fire,6,2,4
Alïce,kelthuzad,192,mage,fire,6,2,4
Bojackal,illidan,192,mage,fire,6,2,4
Stooki,tichondrius,192,mage,fire,6,2,4
Zuqo,sargeras,192,mage,fire,6,2,4
Emìlia,malygos,192,mage,fire,6,2,4
Naimi,malganis,192,mage,fire,6,2,4
Aquafiona,garona,192,mage,fire,6,2,4
Valodrin,tichondrius,192,mage,fire,6,2,4
Juniel,bleeding-hollow,192,mage,fire,6,2,4
Cradic,tichondrius,192,mage,fire,6,2,4
Ghostblaze,blackhand,192,mage,fire,6,2,4
Trebbiano,illidan,192,mage,fire,6,2,4
Killemz,dragonmaw,192,mage,fire,6,2,4
Magifish,malganis,192,mage,fire,6,2,4
Variex,tichondrius,192,mage,fire,6,2,4
Iludron,aegwynn,192,mage,fire,6,2,4
Pendrake,sargeras,192,mage,fire,6,2,4
Yonzho,area-52,192,mage,fire,6,2,4
Juicemage,tichondrius,192,mage,fire,6,2,4
Snowday,nerzhul,192,mage,fire,6,2,4
Gunzz,aegwynn,192,mage,fire,6,2,4
Natzue,sargeras,192,mage,fire,6,2,4
Khelzter,area-52,192,mage,fire,6,2,4
Kaboodlz,stormrage,192,mage,fire,6,2,4
Missile,frostmourne,192,mage,fire,6,2,4
Itension,tichondrius,192,mage,fire,6,2,4
Chadicewayne,tichondrius,192,mage,fire,6,2,4
Magiër,tichondrius,192,mage,fire,6,2,4
Sogood,tanaris,192,mage,fire,6,2,4
Burrbon,area-52,192,mage,fire,6,2,4
Orangemilk,hyjal,192,mage,fire,6,2,4
Quickwizard,tichondrius,192,mage,fire,6,2,4
Coldnuke,stormrage,192,mage,fire,6,2,4
Maddoggs,tichondrius,192,mage,fire,6,2,4
Piratecaster,kargath,192,mage,fire,6,2,4
Chillstep,dark-iron,192,mage,fire,6,2,4
Ignitex,bleeding-hollow,192,mage,fire,6,2,4
Telkham,tichondrius,192,mage,fire,6,2,4
Randommagi,area-52,192,mage,fire,6,2,4
Faeylyn,stormrage,192,mage,fire,6,2,4
Remana,anvilmar,192,mage,fire,6,2,4
Ellywizzle,tichondrius,192,mage,fire,6,2,4
Xoese,illidan,192,mage,fire,6,2,4
Clickhard,suramar,192,mage,fire,6,2,4
Starguy,terenas,192,mage,fire,6,2,4
Ðfuego,azralon,192,mage,fire,6,2,4
Rbn,tichondrius,192,mage,fire,6,2,4
Josephaqil,tichondrius,192,mage,fire,6,2,4
Friézá,stormrage,192,mage,fire,6,2,4
Xxnova,moon-guard,192,mage,fire,6,2,4
Likelyhard,tichondrius,192,mage,fire,6,2,4
Pipeguzzler,zuljin,192,mage,fire,6,2,4
Roggitman,emerald-dream,192,mage,fire,6,2,4
Parruka,warsong,192,mage,fire,6,2,4
Abrácadaver,frostwolf,192,mage,fire,10,3,7
Flamiohotman,illidan,192,mage,fire,7,2,5
Arnx,tichondrius,192,mage,fire,11,2,9
Driel,illidan,192,mage,fire,12,2,10
Spellbrker,stormrage,192,mage,fire,12,2,10
Flippendicus,stormrage,192,mage,fire,12,2,10
Bic,darrowmere,192,mage,fire,12,2,10
Granmago,azralon,192,mage,fire,12,2,10
Skatas,barthilas,192,mage,fire,12,2,10
Saydar,stormrage,192,mage,fire,12,2,10
Chelseâ,emerald-dream,192,mage,fire,12,2,10
Abruaa,area-52,192,mage,fire,12,2,10
Mageymeows,dalaran,191,mage,fire,6,2,4
Magemajor,uldum,191,mage,fire,12,2,10
Prosperoo,aerie-peak,191,mage,fire,12,2,10
Neroclover,ysera,191,mage,fire,24,2,22
Madalon,nemesis,160,mage,fire,10,2,8
Razaklov,tichondrius,159,mage,fire,5,2,3
Kindlin,frostmourne,159,mage,fire,5,2,3
Zezima,spirestone,159,mage,fire,5,2,3
Fingerblaste,malganis,138,mage,fire,16,3,13
Yeweiliang,tichondrius,128,mage,fire,4,2,2
Eromir,dawnbringer,128,mage,fire,4,2,2
Dwayniewayni,tichondrius,128,mage,fire,4,2,2
Ratfather,the-forgotten-coast,128,mage,fire,4,2,2
Supremeboxer,tichondrius,127,mage,fire,8,2,6
Neltar,dalaran,112,mage,fire,7,2,5
Mxdeez,tichondrius,96,mage,fire,3,2,1
Haliax,bronzebeard,96,mage,fire,3,2,1
Édika,area-52,96,mage,fire,6,1,5
Iamsol,area-52,96,mage,fire,6,1,5
Jaçkjaçk,moon-guard,96,mage,fire,6,1,5
Merreda,sargeras,96,mage,fire,6,1,5
Caldian,wyrmrest-accord,96,mage,fire,6,1,5
Pyroeuphoria,dark-iron,96,mage,fire,6,1,5
Prosperoh,burning-legion,96,mage,fire,6,1,5
Truewinter,tichondrius,96,mage,fire,6,1,5
Pyrophobia,mannoroth,96,mage,fire,6,1,5
Dildope,frostmourne,96,mage,fire,6,1,5
Ignit,stormrage,96,mage,fire,6,1,5
Magicmooman,thunderlord,96,mage,fire,6,1,5
Hyndoriann,azgalor,96,mage,fire,6,1,5
Tabuta,ravenholdt,96,mage,fire,6,1,5
Eldrielle,frostmourne,96,mage,fire,6,1,5
Nazztwren,bleeding-hollow,96,mage,fire,6,1,5
Brayni,wyrmrest-accord,96,mage,fire,6,1,5
Nomidian,area-52,96,mage,fire,6,1,5
Pyromaniac,stormscale,96,mage,fire,6,1,5
Miapolyafoo,stormrage,96,mage,fire,6,1,5
Clutchy,gorefiend,96,mage,fire,6,1,5
Arkuran,proudmoore,96,mage,fire,6,1,5
Jarethleon,ragnaros,96,mage,fire,6,1,5
Muted,frostmourne,96,mage,fire,6,1,5
Firemids,thrall,96,mage,fire,6,1,5
Lv,stormscale,96,mage,fire,6,1,5
Dâzk,sargeras,96,mage,fire,6,1,5
Phrana,tichondrius,96,mage,fire,6,1,5
Bbaxter,stormrage,96,mage,fire,6,1,5
Elemenopi,thrall,96,mage,fire,6,1,5
Trojay,malganis,96,mage,fire,6,1,5
Djp,tichondrius,96,mage,fire,6,1,5
Couto,tichondrius,96,mage,fire,6,1,5
Rolypolyman,tichondrius,96,mage,fire,6,1,5
Memnor,amanthul,96,mage,fire,6,1,5
Ssmurfett,dalaran,96,mage,fire,6,1,5
Tonydippin,illidan,96,mage,fire,6,1,5
Clickersz,sargeras,96,mage,fire,6,1,5
Rieltar,barthilas,96,mage,fire,6,1,5
Somnuss,barthilas,96,mage,fire,7,1,6
Zuroz,dathremar,96,mage,fire,12,1,11
Duhquarius,warsong,96,mage,fire,12,1,11
Allesanda,sargeras,96,mage,fire,12,1,11
Mideon,whisperwind,95,mage,fire,6,1,5
Jarvase,mugthol,79,mage,fire,5,1,4
Savanali,kelthuzad,79,mage,fire,5,1,4
Noquemacuuh,ragnaros,79,mage,fire,5,1,4
Jaked,frostmourne,79,mage,fire,5,1,4
Redeyez,arthas,48,mage,fire,9,1,8
Juicemage,tichondrius,2239,mage,frost,144,79,65
Valériemeow,tichondrius,2061,mage,frost,88,46,42
Cremgotrockd,blackrock,2032,mage,frost,107,58,49
Stonedmonkeý,tichondrius,2016,mage,frost,131,63,68
Lawuera,quelthalas,2011,mage,frost,96,48,48
Easyfreeze,sargeras,1996,mage,frost,48,27,21
Juicechanel,tichondrius,1996,mage,frost,64,34,30
Backjing,tichondrius,1969,mage,frost,87,42,45
Koro,tichondrius,1956,mage,frost,121,63,58
Ghostrr,tichondrius,1949,mage,frost,160,86,74
Zerodium,sargeras,1938,mage,frost,83,44,39
Hogmantwo,illidan,1935,mage,frost,54,29,25
Smuky,stormrage,1916,mage,frost,101,49,52
Douyuweifa,tichondrius,1911,mage,frost,65,31,34
Elkiador,area-52,1909,mage,frost,30,21,9
Joe,llane,1901,mage,frost,129,65,64
Grumpyòlfart,tichondrius,1898,mage,frost,132,67,65
Kassmage,skullcrusher,1897,mage,frost,120,57,63
Vazlgs,tichondrius,1896,mage,frost,82,47,35
Faynet,dalaran,1891,mage,frost,117,64,53
Yeweiliang,tichondrius,1891,mage,frost,330,173,157
Ams,aerie-peak,1890,mage,frost,60,33,27
Snaregodx,area-52,1885,mage,frost,59,31,28
Gôøglëlòl,nemesis,1864,mage,frost,235,125,110
Tupactopus,tichondrius,1861,mage,frost,54,27,27
Flaux,sargeras,1859,mage,frost,52,36,16
Theydeadx,illidan,1858,mage,frost,47,31,16
Pigdancell,tichondrius,1858,mage,frost,60,25,35
Corgim,thrall,1857,mage,frost,65,33,32
Fròzt,ragnaros,1857,mage,frost,72,31,41
Mcdfries,tichondrius,1853,mage,frost,60,32,28
Miilky,tichondrius,1852,mage,frost,60,30,30
Xanthilia,chogall,1849,mage,frost,96,49,47
Hideongp,barthilas,1842,mage,frost,108,54,54
Maebalim,tichondrius,1835,mage,frost,48,27,21
Evilnuts,quelthalas,1832,mage,frost,61,34,27
Dahp,thrall,1831,mage,frost,47,23,24
Stöpwatch,hyjal,1830,mage,frost,60,39,21
Cunzhang,tichondrius,1824,mage,frost,54,24,30
Gelokay,tichondrius,1821,mage,frost,42,25,17
Chrisxo,azuremyst,1820,mage,frost,42,24,18
Miketao,tichondrius,1820,mage,frost,67,31,36
Evilear,andorhal,1819,mage,frost,66,33,33
Chez,tichondrius,1818,mage,frost,30,19,11
Bamx,stormrage,1817,mage,frost,48,26,22
Cømbust,frostmourne,1816,mage,frost,72,50,22
Hunchojack,tichondrius,1814,mage,frost,60,24,36
Quippy,kiljaeden,1813,mage,frost,309,156,153
Leakyboots,illidan,1812,mage,frost,47,25,22
Ribot,sargeras,1812,mage,frost,60,28,32
Koozay,kelthuzad,1805,mage,frost,65,38,27
Maegwynah,stormrage,1804,mage,frost,66,29,37
Aapple,tichondrius,1803,mage,frost,60,32,28
Instincts,uldum,1796,mage,frost,42,25,17
Ligmmah,stormrage,1792,mage,frost,110,61,49
Kissradiox,tichondrius,1791,mage,frost,132,63,69
Dtbmar,misha,1788,mage,frost,76,35,41
Theetwotime,area-52,1786,mage,frost,142,73,69
Drewdy,stormreaver,1783,mage,frost,30,19,11
Valtessa,stormrage,1781,mage,frost,54,32,22
Endymiòn,tichondrius,1780,mage,frost,48,24,24
Sheepgodx,malganis,1779,mage,frost,35,20,15
Kleinz,quelthalas,1776,mage,frost,91,54,37
Sestren,zuljin,1766,mage,frost,54,25,29
Covil,tichondrius,1765,mage,frost,48,24,24
Factszxy,area-52,1761,mage,frost,41,29,12
Rhythmdog,tichondrius,1758,mage,frost,60,25,35
Hogdog,illidan,1751,mage,frost,54,28,26
Dace,tichondrius,1745,mage,frost,47,26,21
Mokelovin,sargeras,1744,mage,frost,47,30,17
Téfy,ragnaros,1744,mage,frost,59,34,25
Srinshi,sargeras,1736,mage,frost,142,68,74
Jerawokee,undermine,1735,mage,frost,67,30,37
Laserface,bleeding-hollow,1733,mage,frost,60,34,26
Ingcho,tichondrius,1730,mage,frost,72,32,40
Castana,tichondrius,1729,mage,frost,116,54,62
Illumià,illidan,1719,mage,frost,26,20,6
Traelol,blades-edge,1715,mage,frost,114,58,56
Golfirl,doomhammer,1715,mage,frost,42,21,21
Sifr,tichondrius,1713,mage,frost,36,18,18
Riddickl,malfurion,1708,mage,frost,96,46,50
Headbake,malganis,1705,mage,frost,42,24,18
Luckysir,illidan,1704,mage,frost,42,21,21
Feener,stormreaver,1704,mage,frost,36,18,18
Pitball,area-52,1702,mage,frost,103,51,52
Polyenjoyerx,ysera,1701,mage,frost,106,55,51
Rizke,tichondrius,1701,mage,frost,35,18,17
Glaciated,the-forgotten-coast,1699,mage,frost,74,38,36
Fromcanadaqc,stormrage,1689,mage,frost,41,24,17
Zinnos,tichondrius,1684,mage,frost,214,105,109
Pichorrá,quelthalas,1683,mage,frost,80,46,34
Persia,illidan,1683,mage,frost,53,24,29
Sabrita,proudmoore,1680,mage,frost,92,47,45
Stealing,barthilas,1680,mage,frost,36,18,18
Jtizzlè,tichondrius,1679,mage,frost,59,33,26
Deallus,tichondrius,1677,mage,frost,82,40,42
Alurion,moon-guard,1673,mage,frost,32,21,11
Factsx,area-52,1669,mage,frost,42,22,20
Chrislongtv,tichondrius,1669,mage,frost,533,271,262
Kymowiz,sargeras,1669,mage,frost,42,19,23
Tommagic,tichondrius,1666,mage,frost,40,23,17
Bravden,area-52,1664,mage,frost,48,27,21
Stimml,blood-furnace,1662,mage,frost,66,38,28
Arcayne,tichondrius,1662,mage,frost,121,66,55
Baleiabranca,stormrage,1662,mage,frost,82,37,45
Tatertots,bladefist,1658,mage,frost,47,18,29
Bmuafgfe,tichondrius,1655,mage,frost,33,20,13
Dexd,laughing-skull,1655,mage,frost,54,32,22
Bambambilly,kelthuzad,1655,mage,frost,75,35,40
Minverces,tichondrius,1653,mage,frost,40,23,17
Arcánè,velen,1652,mage,frost,29,19,10
Dve,frostmourne,1651,mage,frost,84,51,33
Entm,burning-blade,1651,mage,frost,42,22,20
Tjofmajik,stormrage,1651,mage,frost,42,20,22
Magecombe,thrall,1649,mage,frost,49,25,24
Zhangxiaowu,tichondrius,1648,mage,frost,50,32,18
Luxør,aegwynn,1647,mage,frost,30,18,12
Zorexx,area-52,1643,mage,frost,61,30,31
Lemmiwïnks,area-52,1640,mage,frost,32,21,11
Scarablast,bleeding-hollow,1639,mage,frost,49,25,24
Gûmbÿ,illidan,1636,mage,frost,36,28,8
Charmed,black-dragonflight,1635,mage,frost,86,45,41
Venachi,emerald-dream,1633,mage,frost,146,83,63
Mayumî,moon-guard,1632,mage,frost,42,21,21
Lambsalsa,tichondrius,1631,mage,frost,42,18,24
Atra,spinebreaker,1629,mage,frost,48,23,25
Zssy,tichondrius,1626,mage,frost,41,29,12
Zezima,spirestone,1625,mage,frost,36,23,13
Elyandria,proudmoore,1625,mage,frost,42,23,19
Xialing,tichondrius,1625,mage,frost,35,18,17
Erîol,ragnaros,1623,mage,frost,80,45,35
Mashii,kiljaeden,1620,mage,frost,36,17,19
Fgnb,sargeras,1619,mage,frost,36,23,13
Triuneward,tichondrius,1619,mage,frost,42,22,20
Neverblockx,kirin-tor,1618,mage,frost,30,17,13
Animatronic,moon-guard,1618,mage,frost,177,89,88
Gwyn,nemesis,1614,mage,frost,54,29,25
Hüz,frostmourne,1611,mage,frost,35,27,8
Whosdismage,illidan,1608,mage,frost,36,22,14
Syntacks,lightnings-blade,1608,mage,frost,231,115,116
Snoogensftw,tichondrius,1602,mage,frost,36,17,19
Preceptør,azralon,1601,mage,frost,61,33,28
Fawcett,khazgoroth,1598,mage,frost,78,40,38
Savanali,kelthuzad,1596,mage,frost,48,26,22
Blinkbow,tichondrius,1595,mage,frost,102,46,56
Dorsia,jaedenar,1594,mage,frost,28,20,8
Frostpimp,anubarak,1594,mage,frost,62,27,35
Flâvor,illidan,1593,mage,frost,54,29,25
Praestigium,barthilas,1583,mage,frost,74,39,35
Mageonthcc,korgath,1583,mage,frost,98,49,49
Axecap,tichondrius,1578,mage,frost,72,38,34
Enflame,tichondrius,1576,mage,frost,36,27,9
Squidio,stormrage,1570,mage,frost,125,68,57
Eldrielle,frostmourne,1569,mage,frost,312,162,150
Crithappy,baelgun,1568,mage,frost,48,26,22
Alùcârd,tichondrius,1567,mage,frost,58,31,27
Frizbee,sargeras,1567,mage,frost,39,19,20
Orderlight,alexstrasza,1567,mage,frost,108,49,59
Nickioxox,tichondrius,1567,mage,frost,41,17,24
Pocsermage,drakkari,1562,mage,frost,34,17,17
Icestory,tichondrius,1560,mage,frost,75,26,49
Affewxd,lothar,1557,mage,frost,126,65,61
Deathrøll,moon-guard,1552,mage,frost,84,48,36
Sheepu,bladefist,1551,mage,frost,106,59,47
Marisadaze,tichondrius,1546,mage,frost,57,23,34
Maagin,zuljin,1540,mage,frost,140,75,65
Nairmage,tichondrius,1540,mage,frost,38,20,18
Frostitutex,illidan,1538,mage,frost,37,17,20
Toaststrudel,tichondrius,1537,mage,frost,58,27,31
Biglance,frostmourne,1533,mage,frost,36,17,19
Frostqt,area-52,1532,mage,frost,132,71,61
Yorgøs,ragnaros,1530,mage,frost,30,16,14
Littlejay,kelthuzad,1528,mage,frost,30,16,14
Priyel,hyjal,1526,mage,frost,56,29,27
Fakebusiness,area-52,1524,mage,frost,162,84,78
Lorlene,frostmourne,1524,mage,frost,175,78,97
Couto,tichondrius,1522,mage,frost,35,17,18
Qsc,barthilas,1521,mage,frost,135,67,68
Galacticslug,tichondrius,1519,mage,frost,48,28,20
Magetherian,frostmourne,1519,mage,frost,78,39,39
Slipqt,tichondrius,1519,mage,frost,77,38,39
Sheepshot,dentarg,1517,mage,frost,30,16,14
Floofies,moon-guard,1516,mage,frost,133,65,68
Soulberg,emerald-dream,1515,mage,frost,83,38,45
Yourefat,emerald-dream,1514,mage,frost,72,48,24
Icegiants,tichondrius,1507,mage,frost,53,30,23
Deverror,frostmourne,1507,mage,frost,189,89,100
Dillor,tichondrius,1505,mage,frost,153,77,76
Playsfrost,skullcrusher,1501,mage,frost,106,62,44
Khadberry,aerie-peak,1501,mage,frost,71,34,37
Sáron,quelthalas,1499,mage,frost,69,37,32
Zeshilol,stormrage,1499,mage,frost,45,19,26
Wolfgangvn,stormrage,1495,mage,frost,43,20,23
Kazmir,area-52,1494,mage,frost,41,16,25
Burritsacold,bleeding-hollow,1491,mage,frost,54,26,28
Ehcos,stormrage,1490,mage,frost,54,23,31
Guyza,frostmourne,1489,mage,frost,41,18,23
Datazonfire,illidan,1488,mage,frost,36,22,14
Kabonkle,drakthul,1487,mage,frost,56,24,32
Genswift,thrall,1486,mage,frost,60,27,33
Corruptionz,nemesis,1485,mage,frost,48,25,23
Song,sargeras,1485,mage,frost,83,42,41
Emetah,ysera,1485,mage,frost,60,27,33
Omnislasher,terenas,1482,mage,frost,115,53,62
Hermanmiller,tichondrius,1480,mage,frost,78,41,37
Pibb,rivendare,1480,mage,frost,48,25,23
Léstat,quelthalas,1479,mage,frost,36,21,15
Frussy,blood-furnace,1479,mage,frost,72,39,33
Clm,lightnings-blade,1479,mage,frost,113,59,54
Cubanmage,drakkari,1477,mage,frost,42,19,23
Osnapmage,malganis,1475,mage,frost,249,124,125
Tris,malganis,1475,mage,frost,45,20,25
Fbd,bloodscalp,1473,mage,frost,30,16,14
Ado,zuluhed,1471,mage,frost,114,59,55
Kitenic,proudmoore,1470,mage,frost,59,33,26
Enterthevoid,proudmoore,1463,mage,frost,36,21,15
Noescaping,illidan,1463,mage,frost,41,19,22
Revised,sargeras,1462,mage,frost,94,52,42
Gtó,sargeras,1462,mage,frost,95,44,51
Somnix,emerald-dream,1462,mage,frost,36,16,20
Kh,stormrage,1460,mage,frost,81,44,37
Umber,dreadmaul,1457,mage,frost,174,84,90
Megladon,tichondrius,1452,mage,frost,29,21,8
Tifrodo,azralon,1452,mage,frost,70,39,31
Raisonmage,tichondrius,1452,mage,frost,36,20,16
Coôler,illidan,1451,mage,frost,160,90,70
Kfortyone,kiljaeden,1450,mage,frost,30,16,14
Myxzz,barthilas,1450,mage,frost,252,130,122
Jikario,zuljin,1450,mage,frost,36,18,18
Nereidan,drakkari,1448,mage,frost,56,26,30
Minerves,tichondrius,1446,mage,frost,42,20,22
Trebbiano,illidan,1444,mage,frost,151,77,74
Tylers,moon-guard,1443,mage,frost,42,23,19
Bettybonk,cenarius,1441,mage,frost,59,26,33
Wienerjeff,area-52,1439,mage,frost,30,22,8
Pvpbilly,tichondrius,1439,mage,frost,24,15,9
Ciaooh,tichondrius,1438,mage,frost,30,16,14
Fròzen,moon-guard,1436,mage,frost,74,35,39
Forged,tichondrius,1436,mage,frost,48,19,29
Snowmassive,illidan,1435,mage,frost,36,17,19
Sesshomaru,emerald-dream,1433,mage,frost,51,18,33
Vornz,sargeras,1432,mage,frost,61,28,33
Mkudos,ragnaros,1431,mage,frost,77,38,39
Mmine,tichondrius,1430,mage,frost,30,15,15
Trolson,sargeras,1425,mage,frost,102,45,57
Scrúmp,tichondrius,1421,mage,frost,60,29,31
Mclanda,frostmourne,1418,mage,frost,98,47,51
Gazzuu,ragnaros,1413,mage,frost,42,22,20
Valtaira,wyrmrest-accord,1412,mage,frost,77,49,28
Jaked,frostmourne,1412,mage,frost,42,15,27
Vecna,tichondrius,1411,mage,frost,103,47,56
Paü,illidan,1409,mage,frost,76,31,45
Perrc,area-52,1407,mage,frost,128,56,72
Canva,barthilas,1406,mage,frost,41,25,16
Nate,black-dragonflight,1404,mage,frost,128,65,63
Gualter,nemesis,1403,mage,frost,141,79,62
Gunzup,lightnings-blade,1403,mage,frost,30,15,15
Gasolína,stormrage,1401,mage,frost,100,47,53
Archewing,azjolnerub,1399,mage,frost,42,16,26
Respectx,nemesis,1398,mage,frost,64,27,37
Zirkur,mannoroth,1395,mage,frost,38,17,21
Starscreamm,ragnaros,1394,mage,frost,34,20,14
Azhim,tichondrius,1394,mage,frost,54,25,29
Yulian,tichondrius,1392,mage,frost,91,48,43
Crymachine,garrosh,1391,mage,frost,33,17,16
Boejanglz,frostmourne,1390,mage,frost,28,17,11
Affinitty,zuljin,1389,mage,frost,42,24,18
Kahili,stormrage,1389,mage,frost,71,32,39
Hhappier,tichondrius,1388,mage,frost,53,26,27
Maguín,tichondrius,1384,mage,frost,30,15,15
Kouks,tichondrius,1383,mage,frost,23,15,8
Froshar,ragnaros,1380,mage,frost,36,15,21
Zoidy,bleeding-hollow,1377,mage,frost,35,15,20
Phoenixic,frostmourne,1376,mage,frost,132,60,72
Shatturd,sargeras,1376,mage,frost,48,17,31
Tagere,moon-guard,1370,mage,frost,80,38,42
Roseofsharon,tichondrius,1368,mage,frost,36,15,21
Creatïne,stormrage,1367,mage,frost,89,43,46
Rrite,tichondrius,1366,mage,frost,29,15,14
Icybanter,emerald-dream,1363,mage,frost,36,18,18
Kevymarts,tichondrius,1358,mage,frost,54,31,23
Moyuu,proudmoore,1358,mage,frost,174,81,93
Koulder,zuljin,1357,mage,frost,30,18,12
Starkp,ragnaros,1357,mage,frost,177,86,91
Chadyus,illidan,1356,mage,frost,36,15,21
Tentaçao,stormrage,1352,mage,frost,68,34,34
Mëlkart,ragnaros,1351,mage,frost,60,29,31
Asparagoose,stormrage,1347,mage,frost,29,15,14
Radiku,blood-furnace,1347,mage,frost,31,16,15
Freez,garona,1346,mage,frost,40,18,22
Anarista,wyrmrest-accord,1345,mage,frost,24,15,9
Cheesebuns,proudmoore,1345,mage,frost,43,16,27
Vampìrelolz,tichondrius,1344,mage,frost,24,14,10
Icyspring,tichondrius,1343,mage,frost,18,14,4
Osh,malorne,1343,mage,frost,26,15,11
Mâsterkush,tichondrius,1343,mage,frost,46,23,23
Cryogeniks,illidan,1343,mage,frost,30,14,16
Milambehr,elune,1340,mage,frost,30,16,14
Mageyoulooks,kelthuzad,1340,mage,frost,36,17,19
Safety,stormreaver,1337,mage,frost,106,57,49
Plainblaine,illidan,1337,mage,frost,98,47,51
Krabby,malganis,1337,mage,frost,66,26,40
Clownspocket,tichondrius,1336,mage,frost,83,46,37
Frøzzen,quelthalas,1336,mage,frost,129,59,70
Luckysix,illidan,1336,mage,frost,36,14,22
Safu,bleeding-hollow,1335,mage,frost,120,63,57
Tarmiel,quelthalas,1335,mage,frost,42,22,20
Ruzam,area-52,1334,mage,frost,97,48,49
Rích,tichondrius,1330,mage,frost,126,56,70
Juul,emerald-dream,1328,mage,frost,237,109,128
Selless,zuljin,1325,mage,frost,66,33,33
Vorass,kelthuzad,1325,mage,frost,30,15,15
Lachawr,stormrage,1324,mage,frost,95,51,44
Lucyphilis,stormrage,1323,mage,frost,74,40,34
Warmweather,nagrand,1323,mage,frost,30,14,16
Soia,ragnaros,1318,mage,frost,108,55,53
Andorlin,barthilas,1315,mage,frost,47,22,25
Ragemage,borean-tundra,1311,mage,frost,59,20,39
Mntaindew,bleeding-hollow,1309,mage,frost,35,14,21
Numz,sargeras,1302,mage,frost,94,42,52
Kryliak,ragnaros,1301,mage,frost,54,31,23
Frostítute,alterac-mountains,1299,mage,frost,60,28,32
Xárdas,quelthalas,1298,mage,frost,82,44,38
Jugobomb,madoran,1297,mage,frost,30,17,13
Merkkinz,thrall,1296,mage,frost,59,30,29
Linhny,tichondrius,1295,mage,frost,51,24,27
Frostitutå,eonar,1293,mage,frost,118,54,64
Magicbunny,andorhal,1284,mage,frost,183,90,93
Alìv,tichondrius,1281,mage,frost,148,65,83
Thergon,kul-tiras,1279,mage,frost,32,17,15
Derpmanjr,area-52,1277,mage,frost,60,39,21
Skynhet,ragnaros,1277,mage,frost,36,16,20
Somethinglos,sargeras,1273,mage,frost,106,47,59
Cheapsects,drakthul,1272,mage,frost,32,17,15
Feogato,proudmoore,1271,mage,frost,147,73,74
Meer,stonemaul,1270,mage,frost,30,17,13
Ignit,stormrage,1269,mage,frost,34,17,17
Throatdemon,hakkar,1269,mage,frost,36,15,21
Luckysi,illidan,1268,mage,frost,38,15,23
Hotpeachpie,zuljin,1266,mage,frost,68,35,33
Vengefuly,tichondrius,1264,mage,frost,34,17,17
Samuoa,tichondrius,1261,mage,frost,30,17,13
Satív,moknathal,1258,mage,frost,42,25,17
Degenhours,illidan,1253,mage,frost,51,25,26
Unleáshed,moonrunner,1252,mage,frost,123,61,62
Marrioo,tichondrius,1243,mage,frost,30,13,17
Isellstuff,thrall,1243,mage,frost,30,13,17
Kabrax,nerzhul,1243,mage,frost,36,13,23
Burstage,destromath,1238,mage,frost,30,13,17
Aosin,wyrmrest-accord,1238,mage,frost,30,13,17
Agniih,azralon,1236,mage,frost,66,31,35
Epifeni,blackrock,1235,mage,frost,39,14,25
Rankryman,quelthalas,1231,mage,frost,58,29,29
Frostzadan,quelthalas,1228,mage,frost,56,23,33
Dumblexgamer,ragnaros,1224,mage,frost,66,28,38
Rossanopolis,tichondrius,1223,mage,frost,24,13,11
Jobar,malganis,1221,mage,frost,24,13,11
Magifish,malganis,1220,mage,frost,44,25,19
Jagmag,area-52,1219,mage,frost,18,14,4
Jejihev,drakkari,1219,mage,frost,35,17,18
Makén,illidan,1218,mage,frost,48,32,16
Wowenjoyer,area-52,1213,mage,frost,82,39,43
Kromeus,illidan,1210,mage,frost,36,16,20
Ejzok,dreadmaul,1210,mage,frost,57,19,38
Cìfel,quelthalas,1209,mage,frost,25,15,10
Ràmdas,hyjal,1208,mage,frost,24,13,11
Canassa,azralon,1208,mage,frost,113,58,55
Akagamix,sargeras,1205,mage,frost,47,20,27
Numaïr,kiljaeden,1205,mage,frost,62,25,37
Acarilla,stormrage,1199,mage,frost,54,20,34
Iceehott,kargath,1198,mage,frost,61,32,29
Giovannie,zuluhed,1195,mage,frost,24,13,11
Layolis,area-52,1195,mage,frost,56,29,27
Valrendor,nazjatar,1191,mage,frost,79,36,43
Dooie,sargeras,1188,mage,frost,28,19,9
Whyammage,dalaran,1185,mage,frost,71,40,31
Who,emerald-dream,1185,mage,frost,46,24,22
Copperfield,dreadmaul,1185,mage,frost,80,33,47
Palruki,tichondrius,1185,mage,frost,54,19,35
Alatria,frostmourne,1183,mage,frost,42,14,28
Sølem,frostmourne,1182,mage,frost,36,16,20
Maigoddess,proudmoore,1180,mage,frost,71,29,42
Twinklestars,sargeras,1179,mage,frost,72,40,32
Trippy,senjin,1178,mage,frost,26,13,13
Featherboo,stormrage,1178,mage,frost,35,16,19
Chade,dunemaul,1178,mage,frost,53,22,31
Sahir,thaurissan,1173,mage,frost,30,14,16
Defarefa,frostmourne,1173,mage,frost,70,31,39
Pendrake,sargeras,1170,mage,frost,34,13,21
Gsr,nerzhul,1169,mage,frost,34,14,20
Darkrukia,tichondrius,1168,mage,frost,63,32,31
Zlint,quelthalas,1167,mage,frost,25,13,12
Aquariusmoon,bonechewer,1166,mage,frost,54,28,26
Toesuckerlol,tichondrius,1164,mage,frost,33,16,17
Gatka,quelthalas,1164,mage,frost,245,116,129
Esun,moon-guard,1160,mage,frost,30,17,13
Devlux,area-52,1158,mage,frost,104,50,54
Khaldyn,tichondrius,1156,mage,frost,132,65,67
Tyrecgosa,tichondrius,1155,mage,frost,54,26,28
Guji,area-52,1154,mage,frost,29,14,15
Cavit,wyrmrest-accord,1153,mage,frost,63,29,34
Iceward,frostmourne,1151,mage,frost,18,12,6
Czq,tichondrius,1150,mage,frost,18,12,6
Damage,skullcrusher,1150,mage,frost,31,13,18
Pëpz,emerald-dream,1150,mage,frost,30,12,18
Seeu,tichondrius,1149,mage,frost,42,12,30
Zaddyx,whisperwind,1147,mage,frost,24,12,12
Rekonx,tichondrius,1145,mage,frost,37,15,22
Sturmrevenge,lightnings-blade,1144,mage,frost,114,56,58
Yungice,hyjal,1144,mage,frost,36,14,22
Harrypothead,senjin,1143,mage,frost,17,13,4
Corrmic,winterhoof,1142,mage,frost,42,21,21
Vasthrash,bleeding-hollow,1142,mage,frost,78,33,45
Diixynormus,illidan,1141,mage,frost,30,17,13
Tsuchek,tichondrius,1139,mage,frost,24,12,12
Ibalyn,khazgoroth,1138,mage,frost,95,47,48
Thatotherguy,lightnings-blade,1137,mage,frost,22,13,9
Magicmooman,thunderlord,1137,mage,frost,24,12,12
Eriktherod,maelstrom,1136,mage,frost,30,12,18
Skdonkay,nerzhul,1131,mage,frost,65,34,31
Mageeoh,bleeding-hollow,1128,mage,frost,41,14,27
Fatum,ragnaros,1124,mage,frost,32,14,18
Elwyn,dunemaul,1123,mage,frost,27,13,14
Nazneen,elune,1122,mage,frost,73,31,42
Gunzz,aegwynn,1122,mage,frost,30,12,18
Paidemago,azralon,1121,mage,frost,24,14,10
Coldfrønt,moon-guard,1120,mage,frost,48,21,27
Bellåtrîx,quelthalas,1115,mage,frost,18,12,6
Drumzter,ragnaros,1114,mage,frost,35,19,16
Quietusllil,gurubashi,1111,mage,frost,66,37,29
Osda,azralon,1111,mage,frost,36,19,17
Corucia,echo-isles,1111,mage,frost,202,96,106
Levitaine,bleeding-hollow,1110,mage,frost,38,19,19
Shäräpova,zuljin,1109,mage,frost,24,12,12
Castingmommy,moon-guard,1108,mage,frost,73,37,36
Discoinferno,kelthuzad,1107,mage,frost,21,13,8
Gryd,area-52,1102,mage,frost,76,38,38
Twirkin,proudmoore,1102,mage,frost,36,18,18
Cocmagic,kelthuzad,1101,mage,frost,27,13,14
Hollerin,whisperwind,1098,mage,frost,18,12,6
Memnor,amanthul,1098,mage,frost,24,12,12
Aherom,ragnaros,1095,mage,frost,21,13,8
Magedango,bleeding-hollow,1095,mage,frost,35,14,21
Moonfhang,azralon,1094,mage,frost,215,103,112
Littlebeth,azjolnerub,1091,mage,frost,60,30,30
Azzurn,doomhammer,1090,mage,frost,24,13,11
Pizzle,perenolde,1086,mage,frost,30,16,14
Ralzarek,zuluhed,1085,mage,frost,30,15,15
Helcarwen,area-52,1081,mage,frost,31,13,18
Magekingz,shattered-halls,1080,mage,frost,54,27,27
Mindthegap,tichondrius,1079,mage,frost,45,25,20
Därkmägician,tichondrius,1075,mage,frost,26,12,14
Arkoz,tichondrius,1071,mage,frost,18,12,6
Evierix,illidan,1065,mage,frost,81,36,45
Mageolisious,kelthuzad,1063,mage,frost,30,12,18
Boldwarp,dalaran,1061,mage,frost,23,12,11
Smáckington,tichondrius,1060,mage,frost,81,35,46
Icebboxx,tichondrius,1057,mage,frost,24,13,11
Lildabpen,tichondrius,1057,mage,frost,86,34,52
Dealzy,malganis,1056,mage,frost,18,11,7
Cayoux,darkspear,1055,mage,frost,18,11,7
Xuxä,stormrage,1055,mage,frost,18,11,7
Janchi,moon-guard,1055,mage,frost,24,11,13
Cumbustyomom,illidan,1055,mage,frost,24,11,13
Pivnert,boulderfist,1055,mage,frost,24,11,13
Angerfrost,khazgoroth,1054,mage,frost,36,22,14
Babyspise,nathrezim,1054,mage,frost,18,11,7
Renoria,norgannon,1054,mage,frost,24,11,13
Gadogear,draka,1054,mage,frost,30,11,19
Doubledown,kiljaeden,1053,mage,frost,18,11,7
Wickednoob,malganis,1053,mage,frost,120,55,65
Xannymancan,tichondrius,1052,mage,frost,60,23,37
Walrusxo,kelthuzad,1052,mage,frost,30,11,19
Auralyn,wyrmrest-accord,1051,mage,frost,25,11,14
Zuqo,sargeras,1050,mage,frost,18,11,7
Zibbo,ragnaros,1046,mage,frost,18,11,7
Ceadruk,darkspear,1046,mage,frost,30,14,16
Deadsayru,drakkari,1046,mage,frost,24,11,13
Skywalkerino,azralon,1045,mage,frost,24,11,13
Keahiláni,area-52,1043,mage,frost,27,13,14
Magicke,azgalor,1042,mage,frost,23,14,9
Gradivous,emerald-dream,1042,mage,frost,88,39,49
Devoh,dunemaul,1040,mage,frost,20,11,9
Khrixa,illidan,1036,mage,frost,114,55,59
Supergun,tichondrius,1036,mage,frost,23,11,12
Pugsmugg,icecrown,1032,mage,frost,49,13,36
Sluagh,terenas,1031,mage,frost,52,24,28
Ispell,tichondrius,1025,mage,frost,18,14,4
Chinye,tichondrius,1022,mage,frost,20,12,8
Drbloodmuscl,black-dragonflight,1020,mage,frost,36,15,21
Trollsita,thrall,1013,mage,frost,18,11,7
Sènding,sargeras,1010,mage,frost,42,11,31
Diegoneally,bleeding-hollow,1009,mage,frost,24,11,13
Rizzbot,sargeras,1005,mage,frost,75,27,48
Jaymage,agamaggan,994,mage,frost,37,13,24
Worknlurk,malganis,992,mage,frost,24,12,12
Mystics,dawnbringer,991,mage,frost,70,25,45
Megapasta,illidan,989,mage,frost,23,11,12
Superoirity,trollbane,988,mage,frost,48,24,24
Drfrostie,anvilmar,987,mage,frost,20,11,9
Prometheus,crushridge,986,mage,frost,52,27,25
Thatlejund,tichondrius,986,mage,frost,28,11,17
Jayfunk,sargeras,984,mage,frost,23,11,12
Bòóyah,muradin,980,mage,frost,40,21,19
Grudel,archimonde,979,mage,frost,41,21,20
Bigpinkies,korgath,976,mage,frost,36,13,23
Deadmarley,blackhand,975,mage,frost,24,11,13
Dejavuh,dalaran,972,mage,frost,54,25,29
Xoxmage,frostmourne,965,mage,frost,60,29,31
Torthie,burning-blade,960,mage,frost,12,10,2
Hadlly,tichondrius,960,mage,frost,18,10,8
Kassody,kelthuzad,959,mage,frost,12,10,2
Legendkiller,bleeding-hollow,959,mage,frost,18,10,8
Nukedat,proudmoore,959,mage,frost,18,10,8
Qcomberoo,frostmane,959,mage,frost,27,11,16
Aluce,frostmourne,958,mage,frost,18,10,8
Bigmêan,boulderfist,958,mage,frost,18,10,8
Pyroshima,barthilas,958,mage,frost,34,11,23
Hylord,tichondrius,957,mage,frost,18,10,8
Zunyu,tichondrius,957,mage,frost,18,10,8
Aurumpaleas,moon-guard,956,mage,frost,24,11,13
Trízín,frostmourne,954,mage,frost,18,10,8
Nnenna,bonechewer,952,mage,frost,18,10,8
Imoen,zangarmarsh,951,mage,frost,36,15,21
Keelaron,proudmoore,949,mage,frost,24,10,14
Rasmin,greymane,948,mage,frost,40,22,18
Shírley,tichondrius,948,mage,frost,30,10,20
Sciona,suramar,947,mage,frost,21,10,11
Tyning,blood-furnace,947,mage,frost,24,10,14
Misfyre,malganis,946,mage,frost,28,11,17
Onlyfansme,dalaran,939,mage,frost,18,10,8
Tristania,archimonde,935,mage,frost,62,32,30
Bubbleblower,hakkar,935,mage,frost,24,10,14
Briélla,area-52,934,mage,frost,18,10,8
Crankweigth,rivendare,933,mage,frost,78,36,42
Trollings,azralon,925,mage,frost,63,30,33
Fireace,emerald-dream,922,mage,frost,17,10,7
Trentos,illidan,922,mage,frost,36,16,20
Peetufo,whisperwind,920,mage,frost,23,10,13
Marschubas,drakthul,917,mage,frost,65,28,37
Åquå,area-52,912,mage,frost,20,11,9
Aramire,drakkari,911,mage,frost,21,11,10
Mongera,bonechewer,909,mage,frost,38,19,19
Ultrá,stormscale,909,mage,frost,21,10,11
Moesel,emerald-dream,908,mage,frost,15,11,4
Redeyez,arthas,908,mage,frost,48,20,28
Leocius,daggerspine,906,mage,frost,23,10,13
Critique,malorne,894,mage,frost,54,27,27
Mageboy,bonechewer,894,mage,frost,29,10,19
Scár,blackrock,873,mage,frost,14,10,4
Lilpolyx,illidan,864,mage,frost,12,9,3
Rositajonez,terenas,864,mage,frost,12,9,3
Benzos,eitrigg,864,mage,frost,12,9,3
Furisheep,stormrage,864,mage,frost,12,9,3
Nalabb,illidan,864,mage,frost,12,9,3
Kaylemage,tichondrius,864,mage,frost,12,9,3
Hyoonsfeet,stormrage,864,mage,frost,18,9,9
Fromcanada,eitrigg,864,mage,frost,18,9,9
Weathersmell,tichondrius,864,mage,frost,18,9,9
Saydar,stormrage,864,mage,frost,24,9,15
Messiaah,tichondrius,864,mage,frost,24,9,15
Skoals,thrall,864,mage,frost,29,10,19
Nicemangoes,proudmoore,863,mage,frost,12,9,3
Blinkbotx,proudmoore,863,mage,frost,18,9,9
Lastiari,wyrmrest-accord,863,mage,frost,18,9,9
Blinkharder,stormrage,863,mage,frost,24,9,15
Boredomkïlls,burning-legion,862,mage,frost,18,9,9
Cryyo,queldorei,862,mage,frost,18,9,9
Skillcap,nagrand,862,mage,frost,18,9,9
Åøe,tichondrius,862,mage,frost,18,9,9
Jodebabss,dalaran,862,mage,frost,18,9,9
Tunax,tichondrius,862,mage,frost,24,9,15
Haruká,ragnaros,862,mage,frost,27,10,17
Shenme,moon-guard,861,mage,frost,20,9,11
Fruza,emerald-dream,860,mage,frost,16,10,6
Zaxrie,malganis,860,mage,frost,18,9,9
Remana,anvilmar,859,mage,frost,18,9,9
Plunks,bleeding-hollow,859,mage,frost,39,10,29
Vallet,ragnaros,858,mage,frost,12,9,3
Cuoreforte,moon-guard,858,mage,frost,24,9,15
Cùrtiñ,tichondrius,858,mage,frost,30,9,21
Cransmage,illidan,856,mage,frost,18,9,9
Kaboozles,area-52,853,mage,frost,24,9,15
Soya,sargeras,852,mage,frost,24,9,15
Naoz,ragnaros,851,mage,frost,18,9,9
Bandagris,garrosh,840,mage,frost,21,10,11
Jarethleon,ragnaros,837,mage,frost,21,11,10
Âürõrâ,firetree,834,mage,frost,24,9,15
Dannyyoo,blackrock,831,mage,frost,17,9,8
Craftin,sargeras,827,mage,frost,18,9,9
Hiiamtay,azralon,826,mage,frost,14,10,4
Itoncruxy,tichondrius,825,mage,frost,69,30,39
Erykk,mugthol,810,mage,frost,33,10,23
Zionist,earthen-ring,796,mage,frost,14,9,5
Hirune,ragnaros,782,mage,frost,22,10,12
Taylorrain,arthas,779,mage,frost,30,10,20
Frightmare,sargeras,768,mage,frost,12,8,4
Tonystonerz,lightnings-blade,768,mage,frost,12,8,4
Wiztopher,frostmourne,768,mage,frost,12,8,4
Dearyuanmage,tichondrius,768,mage,frost,12,8,4
Pandazed,stormscale,768,mage,frost,12,8,4
Eyesofrage,tichondrius,768,mage,frost,12,8,4
Nefm,frostmourne,768,mage,frost,12,8,4
Arrokoth,malganis,768,mage,frost,12,8,4
Lycheeoolong,frostmourne,768,mage,frost,18,8,10
Dead,nemesis,768,mage,frost,18,8,10
Mcdude,kiljaeden,768,mage,frost,18,8,10
Zstyle,frostmourne,768,mage,frost,18,8,10
Yeetcannøn,illidan,768,mage,frost,18,8,10
Magibe,thrall,768,mage,frost,18,8,10
Pigdancel,tichondrius,768,mage,frost,18,8,10
Bigdjohnson,dalaran,767,mage,frost,12,8,4
Frosttwoop,moon-guard,767,mage,frost,12,8,4
Seeumaybe,proudmoore,767,mage,frost,12,8,4
Neomage,elune,767,mage,frost,12,8,4
Arcaneshally,area-52,767,mage,frost,12,8,4
Mempool,darkspear,767,mage,frost,12,8,4
Nôtôrious,thrall,767,mage,frost,12,8,4
Staytrill,stormreaver,767,mage,frost,18,8,10
Nargine,tichondrius,767,mage,frost,18,8,10
Wickymorph,barthilas,767,mage,frost,18,8,10
Numb,trollbane,767,mage,frost,18,8,10
Qtqq,malganis,767,mage,frost,18,8,10
Vamplol,tichondrius,767,mage,frost,18,8,10
Badboykilla,dentarg,767,mage,frost,21,9,12
Gardes,tichondrius,767,mage,frost,24,8,16
Aqcamus,illidan,766,mage,frost,12,8,4
Travarra,terenas,766,mage,frost,18,8,10
Rmprmp,tichondrius,764,mage,frost,18,8,10
Nynalith,area-52,764,mage,frost,18,8,10
Snowjôb,illidan,764,mage,frost,24,8,16
Marvelcuck,sargeras,763,mage,frost,12,8,4
Frenk,moon-guard,763,mage,frost,24,8,16
Syndra,korialstrasz,763,mage,frost,24,8,16
Crizzpy,tichondrius,762,mage,frost,18,8,10
Vantus,tichondrius,757,mage,frost,14,8,6
Ratrider,dreadmaul,752,mage,frost,12,8,4
Fizario,barthilas,751,mage,frost,23,9,14
Artruis,detheroc,748,mage,frost,12,8,4
Brynach,trollbane,744,mage,frost,18,8,10
Bandmaid,emerald-dream,736,mage,frost,16,9,7
Comaner,frostmourne,735,mage,frost,17,8,9
Omegablink,sargeras,734,mage,frost,17,8,9
Letitgoo,azralon,733,mage,frost,34,17,17
Heca,tichondrius,719,mage,frost,11,8,3
Stankfreezer,thrall,719,mage,frost,11,8,3
Hambürglar,garrosh,719,mage,frost,15,9,6
Ìgnìtìöñ,whisperwind,718,mage,frost,21,8,13
Myfamilygpie,nazgrel,672,mage,frost,12,7,5
Mângo,frostmourne,672,mage,frost,12,7,5
Kujousara,stormrage,672,mage,frost,12,7,5
Stinkyblinky,bleeding-hollow,672,mage,frost,12,7,5
Sylendron,area-52,672,mage,frost,12,7,5
Mushys,stormrage,672,mage,frost,12,7,5
Tofusmell,illidan,672,mage,frost,12,7,5
Proximalol,tichondrius,672,mage,frost,12,7,5
Reptär,demon-soul,672,mage,frost,12,7,5
Georgian,malfurion,672,mage,frost,12,7,5
Elfvis,deathwing,672,mage,frost,12,7,5
Toteypotter,frostmourne,672,mage,frost,12,7,5
Emvepee,sargeras,672,mage,frost,12,7,5
Neovim,stormrage,672,mage,frost,12,7,5
Kygores,tichondrius,672,mage,frost,12,7,5
Tibbit,kelthuzad,672,mage,frost,12,7,5
Crnomage,area-52,672,mage,frost,12,7,5
Snôz,malganis,672,mage,frost,12,7,5
Hugostiglets,dreadmaul,672,mage,frost,12,7,5
Ntys,frostmourne,672,mage,frost,12,7,5
Tynka,drakkari,672,mage,frost,12,7,5
Ankidar,quelthalas,672,mage,frost,12,7,5
Lillb,bleeding-hollow,672,mage,frost,18,7,11
Licklix,tichondrius,672,mage,frost,18,7,11
Privilege,burning-legion,672,mage,frost,18,7,11
Coldshouldér,nerzhul,672,mage,frost,18,7,11
Xàr,ragnaros,672,mage,frost,18,7,11
Chunzhangfs,tichondrius,672,mage,frost,18,7,11
Betrian,quelthalas,672,mage,frost,18,7,11
Fortemage,tichondrius,672,mage,frost,24,7,17
Burist,illidan,671,mage,frost,12,7,5
Snoogma,illidan,671,mage,frost,12,7,5
Rekys,black-dragonflight,671,mage,frost,12,7,5
Khaziiong,scilla,671,mage,frost,12,7,5
Nihilitý,malganis,671,mage,frost,12,7,5
Nhinsanity,ghostlands,671,mage,frost,12,7,5
Solusek,garona,671,mage,frost,12,7,5
Dairian,whisperwind,671,mage,frost,12,7,5
Blinksz,korgath,671,mage,frost,12,7,5
Tokiaro,tortheldrin,671,mage,frost,12,7,5
Üman,bleeding-hollow,671,mage,frost,12,7,5
Zedroçk,shadowmoon,671,mage,frost,12,7,5
Bruxelejolie,twisting-nether,671,mage,frost,12,7,5
Annalee,ragnaros,671,mage,frost,18,7,11
Baemers,tichondrius,671,mage,frost,18,7,11
Optic,chogall,671,mage,frost,18,7,11
Oharvestero,illidan,671,mage,frost,18,7,11
Kasparhausar,garithos,671,mage,frost,18,7,11
Elemenopi,thrall,671,mage,frost,18,7,11
Nickygift,tichondrius,671,mage,frost,18,7,11
Elegantbroth,illidan,671,mage,frost,18,7,11
Ranje,kiljaeden,670,mage,frost,12,7,5
Syura,ragnaros,670,mage,frost,12,7,5
Tchass,skullcrusher,670,mage,frost,12,7,5
Aulie,burning-blade,670,mage,frost,12,7,5
Kidfurry,wyrmrest-accord,670,mage,frost,12,7,5
Putosucio,nordrassil,670,mage,frost,18,7,11
Sparklmotion,cenarius,670,mage,frost,18,7,11
Starguy,laughing-skull,670,mage,frost,18,7,11
Cäelüm,area-52,670,mage,frost,24,7,17
Criticalness,illidan,669,mage,frost,12,7,5
Zalatirix,bleeding-hollow,669,mage,frost,12,7,5
Scorgasm,thrall,669,mage,frost,12,7,5
Banída,stormrage,669,mage,frost,12,7,5
Icelordd,ragnaros,669,mage,frost,13,7,6
Nohealani,dragonmaw,667,mage,frost,15,8,7
Iesca,ragnaros,665,mage,frost,12,7,5
Evieril,tichondrius,665,mage,frost,12,7,5
Leets,mugthol,664,mage,frost,12,7,5
Dánó,lightbringer,663,mage,frost,24,7,17
Tigoditties,emerald-dream,662,mage,frost,12,7,5
Vendizzle,malganis,654,mage,frost,23,7,16
Slaash,barthilas,639,mage,frost,14,8,6
Dohnutt,tichondrius,638,mage,frost,11,7,4
Shaynna,tichondrius,624,mage,frost,15,7,8
Leeandroo,quelthalas,623,mage,frost,17,7,10
Ghostblaze,blackhand,621,mage,frost,15,8,7
Kandyperreo,ragnaros,617,mage,frost,23,8,15
Ghili,tichondrius,607,mage,frost,11,7,4
Ghrámz,stormrage,607,mage,frost,16,7,9
Gralnur,kelthuzad,606,mage,frost,14,7,7
Ineedashave,shandris,606,mage,frost,20,7,13
Parruka,warsong,605,mage,frost,26,7,19
Blinkmind,stormrage,576,mage,frost,6,6,0
Fakewizard,frostmane,576,mage,frost,6,6,0
Iceqube,drenden,576,mage,frost,6,6,0
Redhell,dalaran,576,mage,frost,6,6,0
Vamage,goldrinn,576,mage,frost,12,6,6
Moogician,aerie-peak,576,mage,frost,12,6,6
Arynnwyll,chogall,576,mage,frost,12,6,6
Alludèd,illidan,576,mage,frost,12,6,6
Fireguard,azralon,576,mage,frost,12,6,6
Pollylol,proudmoore,576,mage,frost,12,6,6
Faire,stonemaul,576,mage,frost,12,6,6
Phuzadd,tichondrius,576,mage,frost,12,6,6
Mägë,kirin-tor,576,mage,frost,12,6,6
Saymenre,tichondrius,576,mage,frost,12,6,6
Hýdramist,sargeras,576,mage,frost,12,6,6
Johncxvii,sargeras,576,mage,frost,12,6,6
Fromcanada,tichondrius,576,mage,frost,18,6,12
Maxtorgar,quelthalas,576,mage,frost,18,6,12
Fatalexo,tichondrius,576,mage,frost,18,6,12
Soukidiot,sargeras,576,mage,frost,18,6,12
Bustercraft,kelthuzad,576,mage,frost,18,6,12
Twiztidwitch,burning-legion,576,mage,frost,24,6,18
Tundraga,malganis,575,mage,frost,12,6,6
Dchee,nerzhul,575,mage,frost,12,6,6
Baultery,moon-guard,575,mage,frost,12,6,6
Highafrn,area-52,575,mage,frost,12,6,6
Casual,arthas,575,mage,frost,12,6,6
Smoney,icecrown,575,mage,frost,12,6,6
Bootygoats,emerald-dream,575,mage,frost,12,6,6
Oogabooga,lethon,575,mage,frost,12,6,6
Bloodpumper,thrall,575,mage,frost,12,6,6
Fakewarlockk,illidan,575,mage,frost,18,6,12
Hasty,emerald-dream,575,mage,frost,18,6,12
Fabled,stonemaul,575,mage,frost,18,6,12
Lucidgaze,bonechewer,575,mage,frost,18,6,12
Aarne,thrall,575,mage,frost,18,6,12
Skywarp,blackhand,575,mage,frost,23,6,17
Kalzak,hyjal,574,mage,frost,12,6,6
Kaël,area-52,574,mage,frost,12,6,6
Tonepedo,zuljin,574,mage,frost,18,6,12
Gelile,tichondrius,574,mage,frost,18,6,12
Lincepotter,quelthalas,574,mage,frost,18,6,12
Srloko,azralon,574,mage,frost,24,6,18
Zehlks,garrosh,573,mage,frost,12,6,6
Sohotritenow,malganis,573,mage,frost,18,6,12
Crimpster,illidan,573,mage,frost,24,6,18
Avers,frostwolf,572,mage,frost,18,6,12
Ärià,sargeras,571,mage,frost,12,6,6
Sodrezinn,illidan,571,mage,frost,12,6,6
Freyia,mugthol,569,mage,frost,18,6,12
Silverstrza,gnomeregan,567,mage,frost,12,6,6
Meliam,tichondrius,557,mage,frost,29,6,23
Arckayne,zuljin,543,mage,frost,11,6,5
Ozwauld,emerald-dream,526,mage,frost,11,6,5
Triambukh,grizzly-hills,525,mage,frost,20,7,13
Iladiin,malganis,521,mage,frost,16,7,9
Jooss,quelthalas,521,mage,frost,18,7,11
Pidge,aggramar,519,mage,frost,22,6,16
Tatersmaccs,sargeras,517,mage,frost,20,7,13
Emieralol,tichondrius,512,mage,frost,10,6,4
Aycc,tichondrius,512,mage,frost,10,6,4
Ereblink,proudmoore,511,mage,frost,11,6,5
Maac,nemesis,511,mage,frost,11,6,5
Zabaione,stormrage,508,mage,frost,16,6,10
Fromcanadaqc,zuljin,480,mage,frost,6,5,1
Elwynnforest,sargeras,480,mage,frost,6,5,1
Hansol,farstriders,480,mage,frost,6,5,1
Moonpie,frostmane,480,mage,frost,6,5,1
Matchstickk,tichondrius,480,mage,frost,6,5,1
Flavaflame,mugthol,480,mage,frost,6,5,1
Jarvase,mugthol,480,mage,frost,10,6,4
Juniel,bleeding-hollow,480,mage,frost,10,6,4
Veritas,wildhammer,480,mage,frost,10,6,4
Zime,moon-guard,480,mage,frost,12,5,7
Cinns,moon-guard,480,mage,frost,12,5,7
Polymurph,terenas,480,mage,frost,12,5,7
Arcaninez,bleeding-hollow,480,mage,frost,12,5,7
Lewpithy,area-52,480,mage,frost,12,5,7
Skizzlés,bleeding-hollow,480,mage,frost,12,5,7
Kayenri,area-52,480,mage,frost,12,5,7
Harlloo,the-underbog,480,mage,frost,12,5,7
Siobhána,moon-guard,480,mage,frost,12,5,7
Frostytoez,firetree,480,mage,frost,12,5,7
Starguy,terenas,480,mage,frost,12,5,7
Garbagemage,barthilas,480,mage,frost,12,5,7
Isömetrics,tichondrius,480,mage,frost,12,5,7
Hustle,frostmourne,480,mage,frost,12,5,7
Låvazza,tichondrius,480,mage,frost,12,5,7
Gadwick,alexstrasza,480,mage,frost,12,5,7
Tëy,zuljin,480,mage,frost,12,5,7
Legendary,deathwing,480,mage,frost,12,5,7
Mcshwackin,area-52,480,mage,frost,12,5,7
Icetomeetyu,bleeding-hollow,480,mage,frost,12,5,7
Adronicus,tichondrius,480,mage,frost,12,5,7
Arendelle,kiljaeden,480,mage,frost,12,5,7
Puvö,tichondrius,480,mage,frost,12,5,7
Vires,kelthuzad,480,mage,frost,12,5,7
Dreddpool,barthilas,480,mage,frost,18,5,13
Coolbuts,area-52,480,mage,frost,18,5,13
Mikwam,proudmoore,479,mage,frost,6,5,1
Piixxiie,sargeras,479,mage,frost,6,5,1
Odinzz,azralon,479,mage,frost,12,5,7
Édika,area-52,479,mage,frost,12,5,7
Dimmershnitz,draka,479,mage,frost,12,5,7
Phazora,suramar,479,mage,frost,12,5,7
Kevdra,kelthuzad,479,mage,frost,12,5,7
Loa,hydraxis,479,mage,frost,12,5,7
Cezax,frostmourne,479,mage,frost,12,5,7
Kpoppin,stormrage,479,mage,frost,12,5,7
Limeade,ursin,479,mage,frost,12,5,7
Brokser,quelthalas,479,mage,frost,12,5,7
Grimreefer,trollbane,479,mage,frost,12,5,7
Daddyplease,bleeding-hollow,479,mage,frost,12,5,7
Inumano,laughing-skull,479,mage,frost,12,5,7
Ehduh,onyxia,477,mage,frost,12,5,7
Claddagh,kelthuzad,473,mage,frost,12,5,7
Magusia,emerald-dream,447,mage,frost,11,5,6
Barkäi,ragnaros,432,mage,frost,15,5,10
Cerisium,kiljaeden,431,mage,frost,11,5,6
Summey,tichondrius,431,mage,frost,11,5,6
Lillbean,thunderlord,425,mage,frost,13,6,7
Quinnfreeze,boulderfist,414,mage,frost,11,5,6
Powder,lightninghoof,400,mage,frost,15,7,8
Gai,lightnings-blade,384,mage,frost,6,4,2
Zzyuh,proudmoore,384,mage,frost,6,4,2
Kutulu,aerie-peak,384,mage,frost,6,4,2
Voiddude,proudmoore,384,mage,frost,6,4,2
Lohkey,darkspear,384,mage,frost,6,4,2
Zgodspeedz,stormrage,384,mage,frost,6,4,2
Frostkage,tichondrius,384,mage,frost,6,4,2
Myrondor,tichondrius,384,mage,frost,6,4,2
Hocusjokus,frostmourne,384,mage,frost,6,4,2
Ratfather,the-forgotten-coast,384,mage,frost,6,4,2
Dashdoor,stormrage,384,mage,frost,6,4,2
Froznpizza,zuljin,384,mage,frost,6,4,2
Frobo,mannoroth,384,mage,frost,6,4,2
Vixm,stormrage,384,mage,frost,6,4,2
Bçøløñápûðgé,illidan,384,mage,frost,6,4,2
Cewchí,tichondrius,384,mage,frost,6,4,2
Hammed,dalaran,384,mage,frost,6,4,2
Kälis,zuljin,384,mage,frost,6,4,2
Brobo,chogall,384,mage,frost,6,4,2
Poonfarmer,zangarmarsh,384,mage,frost,6,4,2
Irrandina,moon-guard,384,mage,frost,6,4,2
Danbì,ragnaros,384,mage,frost,6,4,2
Frðstítutè,tichondrius,384,mage,frost,6,4,2
Unlike,sargeras,384,mage,frost,6,4,2
Pzaz,moon-guard,384,mage,frost,6,4,2
Çhíllßrõ,tichondrius,384,mage,frost,6,4,2
Arillius,malganis,384,mage,frost,6,4,2
Fromcanadaqc,tichondrius,384,mage,frost,6,4,2
Rieltar,barthilas,384,mage,frost,6,4,2
Arkane,barthilas,384,mage,frost,6,4,2
Aigam,hyjal,384,mage,frost,6,4,2
Finnese,medivh,384,mage,frost,6,4,2
Neverbroke,illidan,384,mage,frost,6,4,2
Jamesper,tichondrius,384,mage,frost,6,4,2
Polymedaddi,tichondrius,384,mage,frost,6,4,2
Variex,tichondrius,384,mage,frost,6,4,2
Zolix,malganis,384,mage,frost,6,4,2
Snipymagus,shattered-hand,384,mage,frost,9,5,4
Horizons,moon-guard,384,mage,frost,12,4,8
Dallamar,frostwolf,384,mage,frost,12,4,8
Yippmagus,area-52,384,mage,frost,12,4,8
Themageguy,eitrigg,384,mage,frost,12,4,8
Novokaine,area-52,384,mage,frost,12,4,8
Yeuxbleus,tichondrius,384,mage,frost,12,4,8
Splocke,azralon,384,mage,frost,12,4,8
Artty,velen,384,mage,frost,12,4,8
Jorzan,kelthuzad,384,mage,frost,12,4,8
Gemaicy,sargeras,384,mage,frost,12,4,8
Darthez,darkspear,384,mage,frost,12,4,8
Nexttmage,area-52,384,mage,frost,12,4,8
Coldcaster,mugthol,384,mage,frost,12,4,8
Bluedustfart,illidan,384,mage,frost,12,4,8
Fantabulous,korgath,384,mage,frost,12,4,8
Perkaset,turalyon,384,mage,frost,12,4,8
Hhavok,scarlet-crusade,384,mage,frost,12,4,8
Badaszbich,tichondrius,384,mage,frost,12,4,8
Aloredron,illidan,384,mage,frost,12,4,8
Caseyjelly,tichondrius,384,mage,frost,12,4,8
Unmix,tichondrius,384,mage,frost,12,4,8
Klinkr,illidan,384,mage,frost,12,4,8
Meduka,proudmoore,384,mage,frost,12,4,8
Astería,ragnaros,384,mage,frost,14,4,10
Rolypolyman,tichondrius,384,mage,frost,18,4,14
Snanth,black-dragonflight,384,mage,frost,18,4,14
Fullmetal,jaedenar,384,mage,frost,18,4,14
Rastafarix,ragnaros,384,mage,frost,18,4,14
Floopse,agamaggan,383,mage,frost,6,4,2
Brôcolîni,zuljin,383,mage,frost,6,4,2
Gaduri,tichondrius,383,mage,frost,12,4,8
Robinesque,moon-guard,383,mage,frost,12,4,8
Cynafox,moon-guard,383,mage,frost,12,4,8
Rkbj,korgath,383,mage,frost,18,4,14
Dieselonfire,the-venture-co,382,mage,frost,6,4,2
Brezman,tichondrius,382,mage,frost,12,4,8
Neacel,tichondrius,382,mage,frost,12,4,8
Kuni,ghostlands,382,mage,frost,12,4,8
Killerflaco,drakkari,381,mage,frost,24,4,20
Homodilf,blackrock,379,mage,frost,12,4,8
Eirwan,illidan,379,mage,frost,12,4,8
Magicginger,barthilas,352,mage,frost,16,4,12
Cowwboydan,malganis,351,mage,frost,8,5,3
Lirahmi,quelthalas,351,mage,frost,11,4,7
Freezeup,area-52,349,mage,frost,14,7,7
Titsncoke,proudmoore,336,mage,frost,9,4,5
Mugiara,azralon,335,mage,frost,9,4,5
Coldrin,tichondrius,330,mage,frost,15,5,10
Devkek,area-52,330,mage,frost,22,7,15
Icëblöck,ysera,329,mage,frost,6,5,1
Lezafort,area-52,320,mage,frost,16,4,12
Crøwgawd,tichondrius,304,mage,frost,7,4,3
Cruxx,ragnaros,288,mage,frost,6,3,3
Quinnc,tichondrius,288,mage,frost,6,3,3
Percivaltp,scarlet-crusade,288,mage,frost,6,3,3
Kogin,thrall,288,mage,frost,6,3,3
Gobstpper,nagrand,288,mage,frost,6,3,3
Natallyn,stormrage,288,mage,frost,6,3,3
Urbadxd,llane,288,mage,frost,6,3,3
Botoslàp,dragonmaw,288,mage,frost,6,3,3
Dotznsheep,zuljin,288,mage,frost,6,3,3
Índís,ragnaros,288,mage,frost,6,3,3
Nksbluedeath,area-52,288,mage,frost,6,3,3
Blinkinghobo,sargeras,288,mage,frost,6,3,3
Killemz,dragonmaw,288,mage,frost,6,3,3
Eraticmage,illidan,288,mage,frost,6,3,3
Mäz,malorne,288,mage,frost,6,3,3
Pyroseraph,bleeding-hollow,288,mage,frost,6,3,3
Magicianqt,tichondrius,288,mage,frost,6,3,3
Frostytits,spirestone,288,mage,frost,6,3,3
Kryptekk,area-52,288,mage,frost,6,3,3
Ingrumatig,tichondrius,288,mage,frost,6,3,3
Kazimìr,tichondrius,288,mage,frost,6,3,3
Ðontßlink,illidan,288,mage,frost,6,3,3
Thxo,hyjal,288,mage,frost,6,3,3
Hékate,moon-guard,288,mage,frost,6,3,3
Aurumium,illidan,288,mage,frost,6,3,3
Coneofkony,bleeding-hollow,288,mage,frost,6,3,3
Fredcouples,tichondrius,288,mage,frost,6,3,3
Betaduck,bleeding-hollow,288,mage,frost,6,3,3
Orangemilk,hyjal,288,mage,frost,6,3,3
Illúmi,moon-guard,288,mage,frost,6,3,3
Krililin,stormrage,288,mage,frost,6,3,3
Címegripe,stormrage,288,mage,frost,6,3,3
Lilsake,sargeras,288,mage,frost,6,3,3
Bigchilly,malganis,288,mage,frost,6,3,3
Missingxx,silvermoon,288,mage,frost,6,3,3
Youngwiz,arthas,288,mage,frost,6,3,3
Kaïdis,nemesis,288,mage,frost,6,3,3
Kqlyy,tichondrius,288,mage,frost,6,3,3
Honchó,velen,288,mage,frost,6,3,3
Abruaa,area-52,288,mage,frost,6,3,3
Linsz,nemesis,288,mage,frost,6,3,3
Oomoo,malganis,288,mage,frost,6,3,3
Isuikido,nemesis,288,mage,frost,6,3,3
Zukoprince,azralon,288,mage,frost,6,3,3
Bønemage,azralon,288,mage,frost,6,3,3
Toastmg,tichondrius,288,mage,frost,6,3,3
Atwyxn,illidan,288,mage,frost,6,3,3
Personah,darkspear,288,mage,frost,6,3,3
Chriglol,black-dragonflight,288,mage,frost,6,3,3
Murcury,tichondrius,288,mage,frost,6,3,3
Icetooseeyou,barthilas,288,mage,frost,6,3,3
Dragonie,nordrassil,288,mage,frost,6,3,3
Bound,emerald-dream,288,mage,frost,6,3,3
Léras,stormrage,288,mage,frost,6,3,3
Maelista,tichondrius,288,mage,frost,6,3,3
Trozkov,dalaran,288,mage,frost,6,3,3
Murderlin,tichondrius,288,mage,frost,6,3,3
Ariezx,kelthuzad,288,mage,frost,6,3,3
Nalla,nerzhul,288,mage,frost,6,3,3
Packaged,emerald-dream,288,mage,frost,6,3,3
Blâzer,nazjatar,288,mage,frost,6,3,3
Etyx,tichondrius,288,mage,frost,10,4,6
Vague,tichondrius,288,mage,frost,9,3,6
Voidera,wyrmrest-accord,288,mage,frost,12,3,9
Ezchallenger,undermine,288,mage,frost,12,3,9
Fracxure,area-52,288,mage,frost,12,3,9
Fingeredx,zuljin,288,mage,frost,12,3,9
Littleguzto,garrosh,288,mage,frost,12,3,9
Albbano,tichondrius,288,mage,frost,12,3,9
Hqscoltt,azralon,288,mage,frost,12,3,9
Frostcakes,quelthalas,288,mage,frost,12,3,9
Grynthwzrd,stormrage,288,mage,frost,12,3,9
Steefers,arygos,288,mage,frost,12,3,9
Bartholomew,lothar,288,mage,frost,12,3,9
Worldonfire,ragnaros,288,mage,frost,12,3,9
Linadeslayer,chogall,288,mage,frost,12,3,9
Daydreamz,lightnings-blade,288,mage,frost,12,3,9
Calcaster,aegwynn,288,mage,frost,12,3,9
Draell,drakkari,288,mage,frost,12,3,9
Bootyclapper,shadowmoon,288,mage,frost,12,3,9
Houdiinii,illidan,288,mage,frost,12,3,9
Radakos,emerald-dream,288,mage,frost,12,3,9
Rabeiro,tichondrius,288,mage,frost,12,3,9
Anuub,kelthuzad,288,mage,frost,12,3,9
Argyron,fizzcrank,288,mage,frost,12,3,9
Queimabixo,azralon,287,mage,frost,6,3,3
Applemage,ragnaros,287,mage,frost,6,3,3
Icehero,tichondrius,287,mage,frost,6,3,3
Shimotama,malganis,287,mage,frost,6,3,3
Gufi,drakkari,287,mage,frost,6,3,3
Clausolas,ragnaros,287,mage,frost,6,3,3
Cawyro,caelestrasz,287,mage,frost,12,3,9
Colddevil,hyjal,287,mage,frost,13,3,10
Lünâliä,bleeding-hollow,286,mage,frost,6,3,3
Mideon,whisperwind,286,mage,frost,6,3,3
Grausum,tichondrius,256,mage,frost,10,3,7
Taevy,tichondrius,256,mage,frost,10,3,7
Chuekona,ragnaros,256,mage,frost,10,3,7
Cheyz,onyxia,239,mage,frost,5,3,2
Unydae,frostmourne,239,mage,frost,5,3,2
Drewann,draenor,239,mage,frost,5,3,2
Kizran,frostmourne,239,mage,frost,5,3,2
Itsoveryo,jubeithos,239,mage,frost,11,3,8
Saski,nathrezim,234,mage,frost,6,4,2
Gtown,kelthuzad,234,mage,frost,11,4,7
Thaldarian,emerald-dream,234,mage,frost,13,4,9
Skerei,azralon,234,mage,frost,19,4,15
Rayricefan,blood-furnace,192,mage,frost,4,3,1
Abracadaver,greymane,192,mage,frost,4,3,1
Xar,guldan,192,mage,frost,6,2,4
Pyröz,kelthuzad,192,mage,frost,6,2,4
Undersky,tichondrius,192,mage,frost,6,2,4
Muskybiggie,bleeding-hollow,192,mage,frost,6,2,4
Strêss,kelthuzad,192,mage,frost,6,2,4
Nunezz,mannoroth,192,mage,frost,6,2,4
Audacy,sargeras,192,mage,frost,6,2,4
Vyyp,echo-isles,192,mage,frost,6,2,4
Afknz,frostmourne,192,mage,frost,6,2,4
Makius,area-52,192,mage,frost,6,2,4
Magiaguarra,ragnaros,192,mage,frost,6,2,4
Manadart,quelthalas,192,mage,frost,6,2,4
Duhquarius,warsong,192,mage,frost,6,2,4
Xenagozs,antonidas,192,mage,frost,6,2,4
Westii,illidan,192,mage,frost,6,2,4
Biillionaire,frostmourne,192,mage,frost,6,2,4
Kickpollyplx,lothar,192,mage,frost,6,2,4
Cradic,tichondrius,192,mage,frost,6,2,4
Drdocx,frostmourne,192,mage,frost,6,2,4
Jayma,moon-guard,192,mage,frost,6,2,4
Bluishhue,thrall,192,mage,frost,6,2,4
Elvin,frostmourne,192,mage,frost,6,2,4
Eretik,ragnaros,192,mage,frost,6,2,4
Agoniey,illidan,192,mage,frost,6,2,4
Echoz,frostmourne,192,mage,frost,6,2,4
Vailor,whisperwind,192,mage,frost,6,2,4
Cottonmage,malganis,192,mage,frost,6,2,4
Rapidmage,malganis,192,mage,frost,6,2,4
Mageethot,moon-guard,192,mage,frost,6,2,4
Choctøp,frostmourne,192,mage,frost,6,2,4
Sophrates,burning-blade,192,mage,frost,6,2,4
Abstractgoat,tichondrius,192,mage,frost,6,2,4
Mager,dentarg,192,mage,frost,6,2,4
Cantblocklul,baelgun,192,mage,frost,6,2,4
Suprido,illidan,192,mage,frost,6,2,4
Winstonchill,zuljin,192,mage,frost,6,2,4
Tanedos,tichondrius,192,mage,frost,6,2,4
Ryusuke,thrall,192,mage,frost,6,2,4
Yellowfevrz,thrall,192,mage,frost,6,2,4
Fineous,kalecgos,192,mage,frost,6,2,4
Vortex,fenris,192,mage,frost,6,2,4
Vallfire,malganis,192,mage,frost,6,2,4
Drewzz,tichondrius,192,mage,frost,6,2,4
Avicci,shattered-halls,192,mage,frost,6,2,4
Gradmage,proudmoore,192,mage,frost,6,2,4
Korky,dalvengyr,192,mage,frost,6,2,4
Smók,ragnaros,192,mage,frost,6,2,4
Sparqablink,tichondrius,192,mage,frost,6,2,4
Fïtz,quelthalas,192,mage,frost,6,2,4
Dinklord,azuremyst,192,mage,frost,6,2,4
Arkuran,proudmoore,192,mage,frost,6,2,4
Stìnkfîst,tichondrius,192,mage,frost,6,2,4
Elhechizero,quelthalas,192,mage,frost,6,2,4
Whiteyx,saurfang,192,mage,frost,6,2,4
Rbn,tichondrius,192,mage,frost,6,2,4
Raynark,nemesis,192,mage,frost,6,2,4
Aangx,stormrage,192,mage,frost,6,2,4
Jainamommy,emerald-dream,192,mage,frost,6,2,4
Kammany,thrall,192,mage,frost,6,2,4
Getmaged,bleeding-hollow,192,mage,frost,6,2,4
Roarly,stonemaul,192,mage,frost,6,2,4
Quesomancer,illidan,192,mage,frost,6,2,4
Ironwolft,tichondrius,192,mage,frost,6,2,4
Crazytime,tichondrius,192,mage,frost,6,2,4
Fleët,tichondrius,192,mage,frost,6,2,4
Ayci,velen,192,mage,frost,6,2,4
Nachtt,sargeras,192,mage,frost,6,2,4
Vênsêr,emerald-dream,192,mage,frost,6,2,4
Wyss,azralon,192,mage,frost,6,2,4
Xü,stormrage,192,mage,frost,6,2,4
Anyahs,tichondrius,192,mage,frost,6,2,4
Chelseâ,emerald-dream,192,mage,frost,6,2,4
Karameltart,barthilas,192,mage,frost,6,2,4
Iguanodon,proudmoore,192,mage,frost,6,2,4
Ess,tichondrius,192,mage,frost,6,2,4
Undeadmager,nerzhul,192,mage,frost,6,2,4
Icebish,skullcrusher,192,mage,frost,6,2,4
Granmago,azralon,192,mage,frost,6,2,4
Viccluvin,stormrage,192,mage,frost,6,2,4
Earff,kiljaeden,192,mage,frost,6,2,4
Herzthroh,stormrage,192,mage,frost,6,2,4
Airsickjet,kiljaeden,192,mage,frost,6,2,4
Clickhard,suramar,192,mage,frost,9,2,7
Joare,area-52,192,mage,frost,12,2,10
Excentral,tichondrius,192,mage,frost,12,2,10
Sîmply,zuljin,192,mage,frost,12,2,10
Bossmage,tichondrius,192,mage,frost,12,2,10
Mendittorosa,tichondrius,192,mage,frost,12,2,10
Rán,spirestone,192,mage,frost,12,2,10
Converseqt,stormrage,192,mage,frost,12,2,10
Mageyoulooks,shattered-hand,192,mage,frost,12,2,10
Hositonet,malganis,192,mage,frost,12,2,10
Tracemaker,emerald-dream,192,mage,frost,12,2,10
Adxion,quelthalas,192,mage,frost,12,2,10
Dylanpickles,darkspear,192,mage,frost,12,2,10
Zerg,fenris,192,mage,frost,12,2,10
Mônstâ,thrall,192,mage,frost,12,2,10
Èvilmage,blackrock,192,mage,frost,12,2,10
Wqnmlgbdy,tichondrius,192,mage,frost,18,2,16
Kahldyn,stormrage,191,mage,frost,4,3,1
Alladen,anubarak,191,mage,frost,6,2,4
Rathrizar,emerald-dream,191,mage,frost,6,2,4
Hense,stormrage,191,mage,frost,6,2,4
Bittérs,tichondrius,191,mage,frost,6,2,4
Cheapped,emerald-dream,175,mage,frost,6,3,3
Blakus,tichondrius,159,mage,frost,6,3,3
Frosteddiks,shattered-halls,159,mage,frost,5,2,3
Erudit,tichondrius,144,mage,frost,15,2,13
Shardgodx,kelthuzad,138,mage,frost,8,4,4
Vìllyn,boulderfist,138,mage,frost,12,4,8
Máximus,illidan,128,mage,frost,4,2,2
Idamnedu,crushridge,128,mage,frost,4,2,2
Firèballin,tichondrius,128,mage,frost,4,2,2
Goingmassive,frostmourne,127,mage,frost,4,2,2
Proviet,frostmourne,127,mage,frost,8,2,6
Sillycole,emerald-dream,96,mage,frost,3,2,1
Thôrsena,ursin,96,mage,frost,3,2,1
Bigsplosions,kiljaeden,96,mage,frost,3,2,1
Neverworks,tichondrius,96,mage,frost,6,1,5
Fadedfire,area-52,96,mage,frost,6,1,5
Michaelbust,tichondrius,96,mage,frost,6,1,5
Oring,tichondrius,96,mage,frost,6,1,5
Fookz,malganis,96,mage,frost,6,1,5
Truewinter,tichondrius,96,mage,frost,6,1,5
Pyrofrost,stonemaul,96,mage,frost,6,1,5
Litiria,burning-blade,96,mage,frost,6,1,5
Stormfrieza,tichondrius,96,mage,frost,6,1,5
Furrblock,tichondrius,96,mage,frost,6,1,5
Exonerate,mannoroth,96,mage,frost,6,1,5
Politeness,tichondrius,96,mage,frost,6,1,5
Pblastdatass,stormrage,96,mage,frost,6,1,5
Ogfresh,area-52,96,mage,frost,6,1,5
Coolhandz,tichondrius,96,mage,frost,6,1,5
Naviator,tichondrius,96,mage,frost,6,1,5
Gíldrin,proudmoore,96,mage,frost,6,1,5
Magicmom,wyrmrest-accord,96,mage,frost,6,1,5
Thiccness,hydraxis,96,mage,frost,6,1,5
Yeonmok,tichondrius,96,mage,frost,6,1,5
Soulbite,barthilas,96,mage,frost,6,1,5
Dathoe,laughing-skull,96,mage,frost,6,1,5
Jizzlez,tichondrius,96,mage,frost,6,1,5
Trevihl,malganis,96,mage,frost,6,1,5
Alode,moon-guard,96,mage,frost,6,1,5
Freezze,malganis,96,mage,frost,6,1,5
Wuzzo,tichondrius,96,mage,frost,6,1,5
Ichirou,stormrage,96,mage,frost,6,1,5
Professor,khadgar,96,mage,frost,6,1,5
Gnòmêrcy,kelthuzad,96,mage,frost,6,1,5
Geekm,frostmourne,96,mage,frost,6,1,5
Åpollous,frostmourne,96,mage,frost,6,1,5
Mïzzfreeze,haomarush,96,mage,frost,6,1,5
Ricter,hyjal,96,mage,frost,6,1,5
Aerodynamiq,area-52,96,mage,frost,6,1,5
Themose,sargeras,96,mage,frost,6,1,5
Mastacombust,illidan,96,mage,frost,6,1,5
Beerandmagic,zuljin,96,mage,frost,6,1,5
Majx,eldrethalas,96,mage,frost,6,1,5
Adrazell,sargeras,96,mage,frost,6,1,5
Ârcano,ragnaros,96,mage,frost,6,1,5
Ñõxx,sargeras,96,mage,frost,6,1,5
Pizzatest,area-52,96,mage,frost,12,1,11
Taladas,suramar,96,mage,frost,12,1,11
Ldc,kelthuzad,96,mage,frost,12,1,11
Vensyr,stormrage,96,mage,frost,12,1,11
Badiatorr,alterac-mountains,96,mage,frost,12,1,11
Voxbluvine,hakkar,96,mage,frost,12,1,11
Zei,bleeding-hollow,96,mage,frost,12,1,11
Pyrophobia,mannoroth,96,mage,frost,12,1,11
Thebraveonee,frostmourne,95,mage,frost,6,1,5
Icemaker,destromath,95,mage,frost,18,1,17
Notria,illidan,79,mage,frost,5,1,4
Buckybever,illidan,79,mage,frost,11,1,10
Frostybihh,bonechewer,64,mage,frost,4,1,3
Unclekyle,skullcrusher,48,mage,frost,3,1,2
Lv,stormscale,48,mage,frost,9,1,8
Kushjointz,tichondrius,42,mage,frost,11,3,8
Dazby,tichondrius,42,mage,frost,11,3,8
Hoecakez,tichondrius,31,mage,frost,2,1,1
Dãnwun,tichondrius,2284,monk,mistweaver,96,60,36
Meepmonk,tichondrius,2283,monk,mistweaver,96,60,36
Dannycarey,tichondrius,2278,monk,mistweaver,78,55,23
Garbagemonk,scilla,2277,monk,mistweaver,191,120,71
Woezx,stormreaver,2264,monk,mistweaver,68,47,21
Mysticallx,sargeras,2259,monk,mistweaver,84,53,31
Sharkpiglet,illidan,2249,monk,mistweaver,90,57,33
Boogstyle,malganis,2245,monk,mistweaver,130,76,54
Linlol,tichondrius,2240,monk,mistweaver,472,274,198
Weavied,sargeras,2215,monk,mistweaver,156,84,72
Zenjj,thorium-brotherhood,2211,monk,mistweaver,158,92,66
Jep,tichondrius,2190,monk,mistweaver,138,88,50
Hernameplz,proudmoore,2179,monk,mistweaver,117,64,53
Cool,crushridge,2167,monk,mistweaver,126,75,51
Idiotgriefer,tichondrius,2160,monk,mistweaver,78,48,30
Sharkpiggie,illidan,2159,monk,mistweaver,78,45,33
Mãsterpõ,tichondrius,2155,monk,mistweaver,295,156,139
Emoeres,kelthuzad,2151,monk,mistweaver,104,55,49
Flarks,area-52,2151,monk,mistweaver,155,80,75
Oliveirarr,tichondrius,2150,monk,mistweaver,144,81,63
Moonym,nagrand,2144,monk,mistweaver,80,48,32
Oblivæon,tichondrius,2143,monk,mistweaver,72,45,27
Sloppyroppy,tichondrius,2143,monk,mistweaver,107,62,45
Dro,khadgar,2141,monk,mistweaver,66,39,27
Moremoretea,tichondrius,2140,monk,mistweaver,87,53,34
Illify,tichondrius,2139,monk,mistweaver,66,52,14
Cuteballs,tichondrius,2138,monk,mistweaver,81,50,31
Oldmanswirl,mugthol,2137,monk,mistweaver,84,50,34
Dowsk,tichondrius,2136,monk,mistweaver,88,52,36
Jetnoob,sargeras,2136,monk,mistweaver,108,60,48
Crunchyrollx,tichondrius,2135,monk,mistweaver,66,49,17
Xeus,darkspear,2133,monk,mistweaver,60,38,22
Hydroz,dethecus,2131,monk,mistweaver,77,46,31
Parodies,illidan,2131,monk,mistweaver,103,53,50
Woggitie,jubeithos,2129,monk,mistweaver,68,45,23
Igriefidiots,tichondrius,2129,monk,mistweaver,71,40,31
Ringofpeace,sargeras,2128,monk,mistweaver,60,40,20
Griefgodx,tichondrius,2127,monk,mistweaver,88,49,39
Vaen,kelthuzad,2126,monk,mistweaver,78,47,31
Wheatsli,malganis,2126,monk,mistweaver,138,81,57
Yangroumo,tichondrius,2123,monk,mistweaver,125,76,49
Vaemonka,stormrage,2123,monk,mistweaver,201,120,81
Babyfaceqt,skullcrusher,2123,monk,mistweaver,184,103,81
Canghaigg,tichondrius,2122,monk,mistweaver,150,94,56
Purgenm,tichondrius,2122,monk,mistweaver,90,52,38
Secdog,tichondrius,2118,monk,mistweaver,84,44,40
Kicub,emerald-dream,2115,monk,mistweaver,84,44,40
Itzokinlol,malganis,2113,monk,mistweaver,114,70,44
Firewatches,emerald-dream,2113,monk,mistweaver,72,42,30
Akiramenaide,tichondrius,2112,monk,mistweaver,60,43,17
Akkiira,sargeras,2112,monk,mistweaver,72,42,30
Sintifissti,sargeras,2111,monk,mistweaver,62,41,21
Gsdfjskpx,sargeras,2107,monk,mistweaver,306,165,141
Drdabz,illidan,2105,monk,mistweaver,60,35,25
Glqjkglbfgdl,zuljin,2105,monk,mistweaver,150,84,66
Raddxd,illidan,2101,monk,mistweaver,71,44,27
Waggìes,moon-guard,2101,monk,mistweaver,83,50,33
Melonmuncher,duskwood,2101,monk,mistweaver,135,79,56
Heywhatsup,emerald-dream,2097,monk,mistweaver,102,50,52
Proghouse,illidan,2089,monk,mistweaver,90,47,43
Nezly,sargeras,2077,monk,mistweaver,78,41,37
Drracaryss,sargeras,2060,monk,mistweaver,203,125,78
Gabîmaru,area-52,2058,monk,mistweaver,135,80,55
Strugglebus,sargeras,2056,monk,mistweaver,42,31,11
Huaren,tichondrius,2048,monk,mistweaver,137,78,59
Ðrägønéyèz,malygos,2047,monk,mistweaver,193,104,89
Breadweaver,malganis,2046,monk,mistweaver,96,47,49
Wagfu,moon-guard,2045,monk,mistweaver,70,40,30
Originull,darkspear,2045,monk,mistweaver,95,53,42
Heha,tichondrius,2036,monk,mistweaver,305,156,149
Zuhak,tichondrius,2033,monk,mistweaver,66,36,30
Nohandslost,blackrock,2033,monk,mistweaver,206,103,103
Fizzlefarmer,moon-guard,2031,monk,mistweaver,89,54,35
Millé,frostmourne,2025,monk,mistweaver,60,36,24
Brazfu,skullcrusher,2023,monk,mistweaver,123,74,49
Zhoku,tichondrius,2020,monk,mistweaver,58,34,24
Triixxy,thrall,2018,monk,mistweaver,101,64,37
Gameníne,tichondrius,2012,monk,mistweaver,60,36,24
Mcoos,tichondrius,2011,monk,mistweaver,186,112,74
Punchgodx,greymane,2010,monk,mistweaver,78,46,32
Nfm,cairne,2006,monk,mistweaver,143,79,64
Chadweave,moon-guard,2004,monk,mistweaver,279,151,128
Voidstate,stormrage,2001,monk,mistweaver,131,71,60
Sypìì,stormrage,2000,monk,mistweaver,108,58,50
Àvríam,stormrage,1999,monk,mistweaver,95,45,50
Leetcoder,tichondrius,1998,monk,mistweaver,189,117,72
Tekuto,tichondrius,1996,monk,mistweaver,91,63,28
Orbgodx,darkspear,1996,monk,mistweaver,66,39,27
Thèwy,tichondrius,1995,monk,mistweaver,47,30,17
Taeeun,tichondrius,1994,monk,mistweaver,57,38,19
Kris,llane,1994,monk,mistweaver,89,51,38
Tyrfan,sargeras,1994,monk,mistweaver,154,84,70
Bhoredom,kiljaeden,1992,monk,mistweaver,146,80,66
Natalié,caelestrasz,1991,monk,mistweaver,60,37,23
Sevymonk,stormrage,1990,monk,mistweaver,102,62,40
Thet,sargeras,1989,monk,mistweaver,177,90,87
Wingchungus,sargeras,1987,monk,mistweaver,42,30,12
Moldboy,area-52,1987,monk,mistweaver,63,38,25
Jiwå,terenas,1985,monk,mistweaver,648,328,320
Danarolls,spirestone,1982,monk,mistweaver,83,40,43
Nesoween,tichondrius,1979,monk,mistweaver,110,65,45
Bungfist,stormrage,1977,monk,mistweaver,35,25,10
Vinnyd,tichondrius,1976,monk,mistweaver,39,27,12
Speedcapped,area-52,1974,monk,mistweaver,132,65,67
Martiálfarts,malganis,1973,monk,mistweaver,42,30,12
Liltuna,icecrown,1968,monk,mistweaver,42,26,16
Assez,tichondrius,1966,monk,mistweaver,74,37,37
Físterxd,bleeding-hollow,1965,monk,mistweaver,164,93,71
Pragma,kiljaeden,1964,monk,mistweaver,66,37,29
Venfuki,tichondrius,1963,monk,mistweaver,60,35,25
Jakethegreat,moknathal,1963,monk,mistweaver,187,108,79
Canghaimonk,tichondrius,1957,monk,mistweaver,84,42,42
Wetchickennz,tichondrius,1955,monk,mistweaver,148,84,64
Hafezassad,illidan,1954,monk,mistweaver,48,23,25
Swurvex,bleeding-hollow,1953,monk,mistweaver,72,34,38
Qtmonk,emerald-dream,1950,monk,mistweaver,159,93,66
Vongg,tichondrius,1950,monk,mistweaver,66,36,30
Zamist,sargeras,1949,monk,mistweaver,84,52,32
Morzmyth,nemesis,1945,monk,mistweaver,166,86,80
Poscom,tichondrius,1944,monk,mistweaver,155,104,51
Grif,nazjatar,1942,monk,mistweaver,207,108,99
Yasysy,tichondrius,1938,monk,mistweaver,42,25,17
Xcrispy,scilla,1936,monk,mistweaver,55,38,17
Ilovekok,sargeras,1933,monk,mistweaver,84,64,20
Xzeer,illidan,1933,monk,mistweaver,53,36,17
Beez,balnazzar,1931,monk,mistweaver,69,35,34
Pandacottoco,azralon,1924,monk,mistweaver,78,44,34
Imdabes,velen,1923,monk,mistweaver,72,39,33
Postmark,tichondrius,1922,monk,mistweaver,60,34,26
Vethosis,illidan,1921,monk,mistweaver,43,27,16
Lmhs,tichondrius,1920,monk,mistweaver,54,32,22
Ònó,quelthalas,1919,monk,mistweaver,67,39,28
Brewsome,bloodhoof,1919,monk,mistweaver,82,43,39
Michæ,quelthalas,1917,monk,mistweaver,232,130,102
Watersheep,darkspear,1916,monk,mistweaver,60,33,27
Wolf,shattered-hand,1915,monk,mistweaver,42,24,18
Soprà,zuljin,1914,monk,mistweaver,63,39,24
Nuriva,tichondrius,1913,monk,mistweaver,70,50,20
Abellmonk,tichondrius,1910,monk,mistweaver,203,117,86
Paperfist,stormrage,1906,monk,mistweaver,126,87,39
Benneroy,moon-guard,1906,monk,mistweaver,30,20,10
Neuron,spirestone,1906,monk,mistweaver,44,23,21
Wrxx,kelthuzad,1905,monk,mistweaver,328,163,165
Basedbuck,dalaran,1904,monk,mistweaver,36,23,13
Mavvi,tichondrius,1904,monk,mistweaver,128,71,57
Sillyguy,stormrage,1901,monk,mistweaver,107,69,38
Cardrik,thrall,1901,monk,mistweaver,149,79,70
Toyotasupra,emerald-dream,1898,monk,mistweaver,72,46,26
Kansú,ragnaros,1898,monk,mistweaver,94,49,45
Liteup,smolderthorn,1897,monk,mistweaver,444,226,218
Furiousfrank,stormrage,1894,monk,mistweaver,30,20,10
Worldhopperx,area-52,1894,monk,mistweaver,89,57,32
Zukki,zuljin,1894,monk,mistweaver,130,73,57
Kristië,stormrage,1891,monk,mistweaver,42,30,12
Taichí,tichondrius,1891,monk,mistweaver,65,35,30
Nakedidiot,kelthuzad,1888,monk,mistweaver,54,35,19
Suamw,tichondrius,1888,monk,mistweaver,115,55,60
Actualcrime,tichondrius,1886,monk,mistweaver,54,29,25
Fenriranger,tichondrius,1885,monk,mistweaver,90,63,27
Zengriff,ysondre,1885,monk,mistweaver,72,44,28
Rokkon,sargeras,1885,monk,mistweaver,78,45,33
Zuhakmw,tichondrius,1885,monk,mistweaver,100,47,53
Zeçe,tichondrius,1879,monk,mistweaver,36,23,13
Suhjoon,bleeding-hollow,1878,monk,mistweaver,160,80,80
Toozmania,stormrage,1876,monk,mistweaver,52,31,21
Nilox,sargeras,1876,monk,mistweaver,120,65,55
Vramonk,area-52,1875,monk,mistweaver,47,27,20
Sifu,bleeding-hollow,1873,monk,mistweaver,59,36,23
Discurzed,barthilas,1873,monk,mistweaver,175,99,76
Spicyx,kiljaeden,1871,monk,mistweaver,30,24,6
Xdfu,stormrage,1870,monk,mistweaver,54,35,19
Canadá,bleeding-hollow,1869,monk,mistweaver,54,37,17
Robocto,area-52,1869,monk,mistweaver,102,61,41
Timermørk,kalecgos,1867,monk,mistweaver,92,57,35
Shùù,tichondrius,1866,monk,mistweaver,65,37,28
Dalillama,stormreaver,1865,monk,mistweaver,48,31,17
Logtich,moon-guard,1864,monk,mistweaver,78,42,36
Okchat,emerald-dream,1862,monk,mistweaver,119,76,43
Søpra,zuljin,1861,monk,mistweaver,120,71,49
Lexxbtw,thrall,1860,monk,mistweaver,131,73,58
Papermade,barthilas,1860,monk,mistweaver,48,26,22
Monktease,tichondrius,1860,monk,mistweaver,66,34,32
Aegea,illidan,1859,monk,mistweaver,55,30,25
Quitw,tichondrius,1859,monk,mistweaver,61,32,29
Cmonktwo,turalyon,1858,monk,mistweaver,54,31,23
Meepmonk,kilrogg,1858,monk,mistweaver,39,21,18
Sevenmonk,tichondrius,1857,monk,mistweaver,54,36,18
Tokol,tichondrius,1857,monk,mistweaver,168,90,78
Esqu,sargeras,1856,monk,mistweaver,36,22,14
Cmonk,turalyon,1856,monk,mistweaver,40,24,16
Threefanandy,kelthuzad,1855,monk,mistweaver,36,23,13
Piilsburry,sargeras,1855,monk,mistweaver,48,26,22
Praggers,proudmoore,1855,monk,mistweaver,107,53,54
Slunka,tichondrius,1854,monk,mistweaver,48,27,21
Shad,frostmourne,1853,monk,mistweaver,102,58,44
Zdeg,tichondrius,1852,monk,mistweaver,51,28,23
Ileffsinll,illidan,1851,monk,mistweaver,107,60,47
Velzarria,zuljin,1850,monk,mistweaver,48,32,16
Fluval,moon-guard,1850,monk,mistweaver,71,47,24
Celerein,illidan,1850,monk,mistweaver,112,60,52
Damogen,spinebreaker,1849,monk,mistweaver,54,28,26
Zipmw,tichondrius,1848,monk,mistweaver,66,36,30
Proxy,ragnaros,1846,monk,mistweaver,46,31,15
Senseipwnda,stormrage,1846,monk,mistweaver,71,43,28
Tonyboloney,tichondrius,1845,monk,mistweaver,42,25,17
Dampdampdamp,tichondrius,1844,monk,mistweaver,24,20,4
Fîstweave,emerald-dream,1844,monk,mistweaver,77,45,32
Yujiro,draktharon,1843,monk,mistweaver,36,23,13
Dwánesan,tichondrius,1843,monk,mistweaver,72,44,28
Crabfest,zuljin,1843,monk,mistweaver,60,35,25
Sniffinsteak,laughing-skull,1842,monk,mistweaver,36,29,7
Xinergy,illidan,1840,monk,mistweaver,98,65,33
Stonemists,ragnaros,1840,monk,mistweaver,65,40,25
Nabunaga,illidan,1837,monk,mistweaver,42,34,8
Hinåta,thrall,1837,monk,mistweaver,40,26,14
Baychiz,sargeras,1837,monk,mistweaver,42,25,17
Irraeine,malganis,1836,monk,mistweaver,48,31,17
Zarenki,tichondrius,1835,monk,mistweaver,73,33,40
Spacebar,ysondre,1834,monk,mistweaver,54,31,23
Blackoutmonk,stormreaver,1833,monk,mistweaver,131,80,51
Gogumamonk,tichondrius,1833,monk,mistweaver,48,24,24
Guarantee,tichondrius,1832,monk,mistweaver,182,102,80
Cmonkey,turalyon,1831,monk,mistweaver,48,31,17
Carzzy,sargeras,1829,monk,mistweaver,35,23,12
Drunkenfist,chogall,1829,monk,mistweaver,71,32,39
Tirionx,area-52,1828,monk,mistweaver,215,125,90
Baoma,tichondrius,1827,monk,mistweaver,95,55,40
Monklike,illidan,1827,monk,mistweaver,60,30,30
Gentleuncle,tichondrius,1826,monk,mistweaver,125,72,53
Macrobrewski,tichondrius,1825,monk,mistweaver,41,32,9
Jackouse,frostmourne,1824,monk,mistweaver,50,31,19
Harkwind,azralon,1824,monk,mistweaver,151,89,62
Hugdealer,warsong,1823,monk,mistweaver,80,47,33
Gtmdyjs,illidan,1822,monk,mistweaver,29,20,9
Ekn,tichondrius,1822,monk,mistweaver,30,20,10
Jojostar,shadowsong,1822,monk,mistweaver,54,32,22
Copula,illidan,1822,monk,mistweaver,272,141,131
Tazi,chromaggus,1821,monk,mistweaver,84,50,34
Mackiechan,kelthuzad,1821,monk,mistweaver,134,77,57
Voltio,frostmane,1820,monk,mistweaver,103,68,35
Chaddington,malorne,1820,monk,mistweaver,48,30,18
Monknutt,tichondrius,1819,monk,mistweaver,56,32,24
Mð,vashj,1819,monk,mistweaver,174,91,83
Ilovefrogs,stormrage,1819,monk,mistweaver,60,30,30
Bootÿmagic,tichondrius,1818,monk,mistweaver,102,70,32
Malibrew,proudmoore,1817,monk,mistweaver,42,29,13
Ándi,barthilas,1817,monk,mistweaver,53,28,25
Bubblepony,illidan,1817,monk,mistweaver,313,164,149
Spook,kalecgos,1816,monk,mistweaver,49,35,14
Chaihard,sargeras,1816,monk,mistweaver,45,25,20
Yobeel,tichondrius,1816,monk,mistweaver,54,23,31
Qup,lightbringer,1815,monk,mistweaver,66,49,17
Xhilong,quelthalas,1815,monk,mistweaver,48,28,20
Phunkymonkey,mannoroth,1814,monk,mistweaver,90,50,40
Dancah,eitrigg,1813,monk,mistweaver,30,19,11
Mixon,archimonde,1813,monk,mistweaver,30,19,11
Aviee,illidan,1813,monk,mistweaver,162,72,90
Intra,exodar,1812,monk,mistweaver,150,79,71
Mistpump,tichondrius,1811,monk,mistweaver,48,26,22
Cangry,area-52,1809,monk,mistweaver,60,31,29
Epî,tichondrius,1809,monk,mistweaver,247,122,125
Phattea,thrall,1808,monk,mistweaver,48,31,17
Djkungfu,thrall,1808,monk,mistweaver,156,95,61
Yokuu,thunderlord,1808,monk,mistweaver,54,29,25
Jaja,kiljaeden,1807,monk,mistweaver,48,28,20
Abeldra,moon-guard,1807,monk,mistweaver,82,42,40
Sayflight,tichondrius,1807,monk,mistweaver,72,31,41
Itdreams,illidan,1806,monk,mistweaver,42,25,17
Timed,shuhalo,1806,monk,mistweaver,49,26,23
Shiinobi,area-52,1806,monk,mistweaver,140,74,66
Astrino,zuljin,1805,monk,mistweaver,42,29,13
Chimaekrush,tichondrius,1805,monk,mistweaver,36,24,12
Briàr,area-52,1805,monk,mistweaver,48,27,21
Strongmandan,twisting-nether,1805,monk,mistweaver,42,23,19
Onlyfansx,ragnaros,1805,monk,mistweaver,256,139,117
Cenfu,malganis,1805,monk,mistweaver,72,29,43
Imdabes,destromath,1804,monk,mistweaver,87,38,49
Vrieden,illidan,1804,monk,mistweaver,99,42,57
Keshir,sargeras,1803,monk,mistweaver,69,45,24
Zundor,ghostlands,1802,monk,mistweaver,32,25,7
Kungfoocious,tichondrius,1802,monk,mistweaver,57,33,24
ßullsack,barthilas,1802,monk,mistweaver,108,57,51
Mixflo,bleeding-hollow,1802,monk,mistweaver,39,20,19
Wootzhu,zuljin,1802,monk,mistweaver,122,62,60
Mistweave,aerie-peak,1801,monk,mistweaver,54,34,20
Vanmonk,eonar,1801,monk,mistweaver,54,33,21
Squalicorax,area-52,1801,monk,mistweaver,47,24,23
Jiucho,dalaran,1800,monk,mistweaver,35,23,12
Monjimen,ragnaros,1800,monk,mistweaver,185,107,78
Mekawa,gurubashi,1799,monk,mistweaver,40,26,14
Hawainpunch,stormscale,1799,monk,mistweaver,42,27,15
Tiptea,stormrage,1799,monk,mistweaver,42,23,19
Caffeinated,barthilas,1798,monk,mistweaver,244,118,126
Toonington,sargeras,1797,monk,mistweaver,57,39,18
Cromulent,saurfang,1792,monk,mistweaver,134,70,64
Sqmw,tichondrius,1791,monk,mistweaver,36,22,14
Roypoker,illidan,1785,monk,mistweaver,48,34,14
Fingies,whisperwind,1784,monk,mistweaver,54,32,22
Oppsimop,frostmourne,1783,monk,mistweaver,72,38,34
Rexfiend,tichondrius,1782,monk,mistweaver,24,19,5
Hepp,stormrage,1781,monk,mistweaver,48,32,16
Triarcs,area-52,1781,monk,mistweaver,36,24,12
Ttvchickchau,tichondrius,1779,monk,mistweaver,125,75,50
Valhira,kiljaeden,1779,monk,mistweaver,66,39,27
Coomweaver,stormrage,1778,monk,mistweaver,42,22,20
Gummycat,bonechewer,1776,monk,mistweaver,186,100,86
Fistinator,blackrock,1774,monk,mistweaver,54,35,19
Lgee,kelthuzad,1774,monk,mistweaver,30,19,11
Akkiraa,sargeras,1769,monk,mistweaver,36,23,13
Femalejam,darkspear,1768,monk,mistweaver,54,33,21
Trackstarx,area-52,1767,monk,mistweaver,30,25,5
Daito,jubeithos,1767,monk,mistweaver,110,62,48
Iightning,dentarg,1762,monk,mistweaver,66,40,26
Wigglygiggly,mannoroth,1762,monk,mistweaver,66,38,28
Jayvex,illidan,1762,monk,mistweaver,72,37,35
Itspoils,illidan,1759,monk,mistweaver,55,41,14
Crypomunkz,malganis,1758,monk,mistweaver,35,23,12
Manggi,tichondrius,1758,monk,mistweaver,121,76,45
Ïtächï,illidan,1758,monk,mistweaver,48,22,26
Lovehate,zuljin,1756,monk,mistweaver,66,34,32
Mikamonk,illidan,1755,monk,mistweaver,75,45,30
Monkeymonk,eonar,1755,monk,mistweaver,36,19,17
Rîce,burning-blade,1754,monk,mistweaver,42,29,13
Elvenmonk,frostmane,1754,monk,mistweaver,42,26,16
Rokk,rivendare,1754,monk,mistweaver,78,44,34
Onecoolmonk,tichondrius,1753,monk,mistweaver,45,31,14
Grabbitz,kelthuzad,1751,monk,mistweaver,42,27,15
Bouncycheeks,frostmourne,1751,monk,mistweaver,90,50,40
Dræmwalker,malygos,1751,monk,mistweaver,621,310,311
Spinharder,stormrage,1750,monk,mistweaver,65,38,27
Ensaymada,frostmourne,1750,monk,mistweaver,138,71,67
Callmekoldi,dalaran,1748,monk,mistweaver,93,52,41
Gamesuxlol,the-underbog,1747,monk,mistweaver,96,55,41
Tippity,stormrage,1746,monk,mistweaver,37,24,13
Bebuu,proudmoore,1744,monk,mistweaver,65,44,21
Chonmist,darkspear,1743,monk,mistweaver,74,48,26
Mxf,tichondrius,1743,monk,mistweaver,36,23,13
Mistpowaz,stormrage,1742,monk,mistweaver,143,84,59
Sixesm,dalaran,1742,monk,mistweaver,36,20,16
Elesm,area-52,1741,monk,mistweaver,84,31,53
Beerflow,stormrage,1740,monk,mistweaver,103,53,50
Vernki,laughing-skull,1738,monk,mistweaver,59,36,23
Bobbytheorc,tichondrius,1738,monk,mistweaver,35,21,14
Starçandy,tichondrius,1737,monk,mistweaver,108,58,50
Soö,tichondrius,1737,monk,mistweaver,48,25,23
Decompress,illidan,1734,monk,mistweaver,93,55,38
Antriai,icecrown,1734,monk,mistweaver,60,26,34
Sleeks,bonechewer,1733,monk,mistweaver,114,64,50
Ricearolli,area-52,1731,monk,mistweaver,36,26,10
Shlunks,illidan,1730,monk,mistweaver,217,120,97
Doomstroller,aegwynn,1728,monk,mistweaver,123,64,59
Cystweaver,dalaran,1726,monk,mistweaver,65,41,24
Toxicbeans,tichondrius,1726,monk,mistweaver,72,39,33
Fistofchanny,tichondrius,1725,monk,mistweaver,104,57,47
Ajizzaÿ,saurfang,1725,monk,mistweaver,92,46,46
Onepunçhman,stormreaver,1724,monk,mistweaver,78,48,30
Flavier,illidan,1724,monk,mistweaver,48,25,23
Smoovhoov,kiljaeden,1723,monk,mistweaver,30,19,11
Supbro,hyjal,1723,monk,mistweaver,30,18,12
Smallboots,area-52,1722,monk,mistweaver,30,24,6
Steelcase,frostmourne,1722,monk,mistweaver,47,26,21
Ðescubra,stormrage,1721,monk,mistweaver,80,44,36
Moushindeiru,sargeras,1719,monk,mistweaver,42,35,7
Deathsteel,emerald-dream,1718,monk,mistweaver,29,19,10
Gramazen,tichondrius,1718,monk,mistweaver,42,25,17
Phtarded,stormreaver,1715,monk,mistweaver,128,66,62
Alexìn,sargeras,1712,monk,mistweaver,79,50,29
Alphamist,thrall,1711,monk,mistweaver,30,18,12
Buhmonk,thrall,1710,monk,mistweaver,60,34,26
Noremaç,frostmourne,1709,monk,mistweaver,36,21,15
Gauche,arygos,1709,monk,mistweaver,168,88,80
Betasquadxd,bleeding-hollow,1707,monk,mistweaver,43,25,18
Gundamfish,tichondrius,1707,monk,mistweaver,42,22,20
Misthealz,black-dragonflight,1705,monk,mistweaver,89,57,32
Gnappyy,tichondrius,1705,monk,mistweaver,30,18,12
Knuqz,stormrage,1705,monk,mistweaver,36,18,18
Røllitup,illidan,1704,monk,mistweaver,54,34,20
Yamatoqt,frostmourne,1704,monk,mistweaver,48,29,19
Bouncymoo,frostmourne,1704,monk,mistweaver,30,18,12
Omihli,sargeras,1704,monk,mistweaver,48,28,20
Bloodyxmonk,firetree,1704,monk,mistweaver,55,31,24
Spot,kelthuzad,1704,monk,mistweaver,48,24,24
Turbokíll,proudmoore,1703,monk,mistweaver,36,22,14
Ellesig,ragnaros,1702,monk,mistweaver,184,94,90
Mexii,hellscream,1702,monk,mistweaver,203,98,105
Kawali,thrall,1701,monk,mistweaver,72,40,32
Sparksgamer,ragnaros,1701,monk,mistweaver,36,18,18
Badonkadonk,kiljaeden,1701,monk,mistweaver,66,27,39
Hansul,tichondrius,1700,monk,mistweaver,83,38,45
Qarmax,azralon,1699,monk,mistweaver,30,18,12
Qxt,tichondrius,1699,monk,mistweaver,52,31,21
Krömbopulos,magtheridon,1696,monk,mistweaver,36,24,12
Zaqqari,wyrmrest-accord,1695,monk,mistweaver,48,24,24
Rizzdriver,moon-guard,1694,monk,mistweaver,60,37,23
Greenstar,bleeding-hollow,1692,monk,mistweaver,175,94,81
Linsey,frostmourne,1691,monk,mistweaver,36,20,16
Jiubak,dalaran,1691,monk,mistweaver,48,26,22
Snuggubae,moon-guard,1691,monk,mistweaver,84,44,40
Babychi,frostmourne,1690,monk,mistweaver,51,29,22
Mariabaraks,darkspear,1690,monk,mistweaver,102,56,46
Greenbrews,area-52,1690,monk,mistweaver,192,100,92
Wildfists,tichondrius,1690,monk,mistweaver,559,288,271
Gujunpyó,sargeras,1688,monk,mistweaver,78,48,30
Roogymw,emerald-dream,1688,monk,mistweaver,70,39,31
Hyori,saurfang,1688,monk,mistweaver,42,23,19
Colbz,barthilas,1687,monk,mistweaver,42,27,15
Bromonster,zuljin,1687,monk,mistweaver,36,18,18
Cohenn,tichondrius,1686,monk,mistweaver,24,18,6
Botweaver,proudmoore,1686,monk,mistweaver,80,45,35
Proventos,azralon,1686,monk,mistweaver,252,139,113
Spencere,hyjal,1686,monk,mistweaver,84,44,40
Victuskk,tichondrius,1685,monk,mistweaver,28,23,5
Unclety,tichondrius,1685,monk,mistweaver,42,24,18
Ropturttlê,tichondrius,1684,monk,mistweaver,36,24,12
Confa,ragnaros,1684,monk,mistweaver,154,65,89
Aráshicage,malganis,1681,monk,mistweaver,48,29,19
Vïolët,moon-guard,1681,monk,mistweaver,202,118,84
Fisetèrr,kelthuzad,1680,monk,mistweaver,59,35,24
Motogp,tichondrius,1680,monk,mistweaver,128,61,67
Yeji,altar-of-storms,1680,monk,mistweaver,103,48,55
Dwãrf,tichondrius,1678,monk,mistweaver,36,25,11
Stepfistz,aegwynn,1677,monk,mistweaver,66,36,30
Zenox,rexxar,1675,monk,mistweaver,90,46,44
Xblingtron,malganis,1675,monk,mistweaver,59,24,35
Brewy,bloodhoof,1674,monk,mistweaver,24,19,5
Zawlp,sargeras,1674,monk,mistweaver,48,30,18
Drunkentoker,illidan,1673,monk,mistweaver,48,26,22
Takugava,illidan,1671,monk,mistweaver,60,40,20
Stonymcblaze,malganis,1671,monk,mistweaver,42,25,17
Tezcatyo,malganis,1671,monk,mistweaver,54,32,22
Djuice,tichondrius,1670,monk,mistweaver,42,25,17
Fisticufs,bleeding-hollow,1670,monk,mistweaver,42,23,19
Quitschi,tichondrius,1669,monk,mistweaver,42,26,16
Alekun,quelthalas,1669,monk,mistweaver,146,75,71
Loudpäck,dalaran,1666,monk,mistweaver,41,26,15
Nahr,tichondrius,1666,monk,mistweaver,39,22,17
Nugskis,dalaran,1666,monk,mistweaver,263,135,128
Twoshero,tichondrius,1665,monk,mistweaver,34,22,12
Mememories,tichondrius,1665,monk,mistweaver,74,46,28
Ichiros,cenarion-circle,1665,monk,mistweaver,214,124,90
Cherep,kiljaeden,1665,monk,mistweaver,93,49,44
Winfred,bleeding-hollow,1663,monk,mistweaver,54,36,18
Rektral,ragnaros,1663,monk,mistweaver,58,32,26
Dirtyde,sargeras,1663,monk,mistweaver,130,63,67
Mistweaverxo,malganis,1662,monk,mistweaver,116,65,51
Zuen,ragnaros,1662,monk,mistweaver,200,101,99
Gomon,terenas,1661,monk,mistweaver,29,20,9
Èmacs,barthilas,1661,monk,mistweaver,35,24,11
Jeskâi,tichondrius,1660,monk,mistweaver,45,26,19
Crispeel,tichondrius,1660,monk,mistweaver,42,24,18
Seokdenam,tichondrius,1660,monk,mistweaver,84,47,37
Chessyx,ragnaros,1660,monk,mistweaver,42,20,22
Rectus,proudmoore,1659,monk,mistweaver,30,22,8
Teewin,area-52,1659,monk,mistweaver,83,57,26
Séthrogèn,tichondrius,1659,monk,mistweaver,30,20,10
Dupaweaver,stormrage,1659,monk,mistweaver,59,26,33
Cheetosnmilk,malganis,1658,monk,mistweaver,35,20,15
Damndaniel,hyjal,1658,monk,mistweaver,106,53,53
Serikko,frostmourne,1657,monk,mistweaver,44,26,18
Carlyjepsen,shadowmoon,1657,monk,mistweaver,85,45,40
Cööked,illidan,1656,monk,mistweaver,63,33,30
Greenrice,thrall,1655,monk,mistweaver,52,33,19
Velenious,tichondrius,1655,monk,mistweaver,113,68,45
Inalambrico,quelthalas,1654,monk,mistweaver,30,18,12
Moonhealsyou,moon-guard,1653,monk,mistweaver,88,55,33
Zachxd,onyxia,1653,monk,mistweaver,42,26,16
Tonytornado,proudmoore,1651,monk,mistweaver,84,40,44
Udderpunch,barthilas,1650,monk,mistweaver,53,30,23
Chadmw,illidan,1649,monk,mistweaver,24,18,6
Rexzilla,tichondrius,1648,monk,mistweaver,36,25,11
Notblakexo,tichondrius,1647,monk,mistweaver,35,19,16
Lilsloptop,moon-guard,1646,monk,mistweaver,149,90,59
Swuseng,tichondrius,1646,monk,mistweaver,36,21,15
Grublord,stormrage,1646,monk,mistweaver,41,21,20
Calvana,tichondrius,1645,monk,mistweaver,129,53,76
Miillkz,zuljin,1644,monk,mistweaver,47,25,22
Ahnlev,ragnaros,1643,monk,mistweaver,116,66,50
Ææøææôææôææô,illidan,1642,monk,mistweaver,138,88,50
Xhangtu,thrall,1642,monk,mistweaver,94,59,35
Swoleypoley,tichondrius,1642,monk,mistweaver,36,21,15
Tenoseven,area-52,1640,monk,mistweaver,21,19,2
Centalink,barthilas,1640,monk,mistweaver,56,38,18
Rhorkfist,frostmourne,1640,monk,mistweaver,43,23,20
Djux,zuljin,1639,monk,mistweaver,30,20,10
Versachi,stormreaver,1639,monk,mistweaver,78,44,34
Pichau,zuljin,1638,monk,mistweaver,33,22,11
Blasê,frostmourne,1638,monk,mistweaver,30,18,12
Starryysky,illidan,1637,monk,mistweaver,30,24,6
Liké,tichondrius,1636,monk,mistweaver,54,32,22
Paralee,tichondrius,1635,monk,mistweaver,48,34,14
Ropgobbler,muradin,1634,monk,mistweaver,30,18,12
Gellindra,malganis,1633,monk,mistweaver,24,18,6
Tazermw,sargeras,1633,monk,mistweaver,62,36,26
Sixsticks,tichondrius,1633,monk,mistweaver,70,37,33
Ermac,kiljaeden,1632,monk,mistweaver,47,32,15
Minaffection,tichondrius,1632,monk,mistweaver,36,19,17
Avm,azralon,1632,monk,mistweaver,60,31,29
Ludan,eredar,1629,monk,mistweaver,160,85,75
Místme,tichondrius,1629,monk,mistweaver,78,41,37
Baldbutcute,darkspear,1627,monk,mistweaver,28,19,9
Gooncave,stormrage,1627,monk,mistweaver,52,24,28
Avãrîce,stormrage,1626,monk,mistweaver,24,17,7
Wittymonk,illidan,1625,monk,mistweaver,99,57,42
Bodhisattvax,bleeding-hollow,1625,monk,mistweaver,42,24,18
Stinkycok,tichondrius,1625,monk,mistweaver,30,17,13
Tyforprecog,kelthuzad,1625,monk,mistweaver,36,20,16
Monke,onyxia,1625,monk,mistweaver,42,23,19
Innerchii,tichondrius,1624,monk,mistweaver,24,17,7
Rañga,caelestrasz,1624,monk,mistweaver,66,37,29
Revivalol,dragonmaw,1624,monk,mistweaver,47,25,22
Fistergand,frostwolf,1623,monk,mistweaver,37,30,7
Röshi,kelthuzad,1623,monk,mistweaver,54,35,19
Liteup,korgath,1623,monk,mistweaver,96,59,37
Zhíu,ragnaros,1623,monk,mistweaver,54,33,21
Nicotinetap,tichondrius,1623,monk,mistweaver,30,18,12
Kaylux,stormrage,1623,monk,mistweaver,30,17,13
Timbomist,kelthuzad,1622,monk,mistweaver,39,22,17
Ywingtsuan,frostmourne,1622,monk,mistweaver,41,21,20
Whaes,thrall,1621,monk,mistweaver,24,17,7
Diobrando,illidan,1621,monk,mistweaver,63,40,23
Valian,tichondrius,1621,monk,mistweaver,42,22,20
Gabaan,azralon,1620,monk,mistweaver,30,17,13
Monkwalker,tichondrius,1620,monk,mistweaver,66,35,31
Barelroll,proudmoore,1619,monk,mistweaver,69,49,20
Swolington,proudmoore,1619,monk,mistweaver,41,26,15
Swiftm,thrall,1619,monk,mistweaver,207,120,87
Intertwine,frostmourne,1619,monk,mistweaver,30,17,13
Avz,azralon,1618,monk,mistweaver,30,21,9
Brews,black-dragonflight,1618,monk,mistweaver,31,17,14
Stormpounder,proudmoore,1616,monk,mistweaver,60,40,20
Locusta,tichondrius,1616,monk,mistweaver,30,19,11
Drinkkin,bleeding-hollow,1616,monk,mistweaver,114,68,46
Mwgodqtxtko,nazjatar,1616,monk,mistweaver,54,32,22
Sebsws,proudmoore,1616,monk,mistweaver,100,59,41
Wpola,tichondrius,1616,monk,mistweaver,30,17,13
Nekzí,sargeras,1615,monk,mistweaver,30,20,10
Bréwmaster,stormrage,1615,monk,mistweaver,36,17,19
Mukboo,tichondrius,1615,monk,mistweaver,36,17,19
Hitaru,azralon,1614,monk,mistweaver,54,35,19
Xtacie,sargeras,1614,monk,mistweaver,66,30,36
Furyjames,quelthalas,1614,monk,mistweaver,91,40,51
Keiirah,zuluhed,1614,monk,mistweaver,60,24,36
Pacee,deathwing,1613,monk,mistweaver,24,17,7
Greenvan,tichondrius,1613,monk,mistweaver,24,17,7
Kûshi,stormrage,1613,monk,mistweaver,35,23,12
Kendro,trollbane,1613,monk,mistweaver,59,38,21
Somebodym,illidan,1613,monk,mistweaver,36,22,14
Yunmen,blades-edge,1613,monk,mistweaver,113,61,52
Toastsmonk,tichondrius,1612,monk,mistweaver,30,21,9
Qords,tichondrius,1612,monk,mistweaver,148,77,71
Snoodle,korgath,1610,monk,mistweaver,114,67,47
Sudury,tichondrius,1610,monk,mistweaver,96,55,41
Pingpang,stormreaver,1610,monk,mistweaver,81,46,35
Korata,frostwolf,1610,monk,mistweaver,42,23,19
Samzo,barthilas,1609,monk,mistweaver,45,24,21
Hîbîscus,illidan,1609,monk,mistweaver,32,17,15
Planetariumz,bleeding-hollow,1608,monk,mistweaver,320,168,152
Mîstchievous,sargeras,1607,monk,mistweaver,28,21,7
Jadestørmz,illidan,1607,monk,mistweaver,30,20,10
Santiaguiño,ragnaros,1607,monk,mistweaver,71,27,44
Cryptmist,frostmourne,1606,monk,mistweaver,36,25,11
Mýthik,hyjal,1606,monk,mistweaver,66,37,29
Slipperybobs,tichondrius,1605,monk,mistweaver,71,46,25
Tarkir,quelthalas,1605,monk,mistweaver,89,55,34
Tamingpanda,wildhammer,1605,monk,mistweaver,60,33,27
Pandaiax,area-52,1605,monk,mistweaver,59,31,28
Luvdeluxe,skullcrusher,1605,monk,mistweaver,61,30,31
Eppsmonk,tichondrius,1604,monk,mistweaver,30,18,12
Oblivion,wildhammer,1604,monk,mistweaver,61,36,25
Xtramist,tichondrius,1604,monk,mistweaver,30,17,13
Gnetic,nemesis,1604,monk,mistweaver,86,46,40
Azahri,sargeras,1603,monk,mistweaver,35,23,12
Goochtickles,bleeding-hollow,1602,monk,mistweaver,128,79,49
Gess,stormscale,1602,monk,mistweaver,108,54,54
Showshoway,tichondrius,1602,monk,mistweaver,95,47,48
Docpalpatine,tichondrius,1602,monk,mistweaver,36,17,19
Xuenws,tichondrius,1602,monk,mistweaver,84,36,48
Bowstâff,lightbringer,1601,monk,mistweaver,36,22,14
Boomtac,moon-guard,1601,monk,mistweaver,51,28,23
Zeroxe,area-52,1600,monk,mistweaver,42,30,12
Manchu,stormrage,1599,monk,mistweaver,30,18,12
Ramisan,barthilas,1598,monk,mistweaver,47,29,18
Vynchi,area-52,1596,monk,mistweaver,35,26,9
Suntzulml,quelthalas,1596,monk,mistweaver,94,46,48
Monkney,tichondrius,1595,monk,mistweaver,72,48,24
Whoonmonk,tichondrius,1595,monk,mistweaver,63,38,25
Hunkymonky,thrall,1595,monk,mistweaver,69,40,29
Bobbybiz,bleeding-hollow,1595,monk,mistweaver,128,74,54
Lightskinmon,area-52,1595,monk,mistweaver,42,23,19
Tamonger,stormrage,1595,monk,mistweaver,194,106,88
Ccop,kelthuzad,1594,monk,mistweaver,30,21,9
Integrity,durotan,1594,monk,mistweaver,112,58,54
Senseii,dathremar,1592,monk,mistweaver,54,35,19
Onees,tichondrius,1590,monk,mistweaver,99,49,50
Pp,icecrown,1589,monk,mistweaver,31,27,4
Merkey,tichondrius,1588,monk,mistweaver,66,35,31
Brosiedon,sargeras,1588,monk,mistweaver,148,71,77
Coralys,sargeras,1587,monk,mistweaver,42,36,6
Songwei,barthilas,1587,monk,mistweaver,89,50,39
Cisneros,doomhammer,1587,monk,mistweaver,201,110,91
Neonep,stormrage,1586,monk,mistweaver,130,72,58
Kwoon,hyjal,1585,monk,mistweaver,52,30,22
Lickthefist,sargeras,1582,monk,mistweaver,24,17,7
Musachi,barthilas,1582,monk,mistweaver,84,41,43
Yepcocc,lightbringer,1581,monk,mistweaver,29,17,12
Patfu,area-52,1581,monk,mistweaver,29,17,12
Adop,dark-iron,1581,monk,mistweaver,84,46,38
Crypslegacy,tichondrius,1579,monk,mistweaver,138,69,69
Pandacottoca,azralon,1578,monk,mistweaver,36,20,16
Waataafaak,malganis,1578,monk,mistweaver,92,47,45
Pumakicks,tichondrius,1576,monk,mistweaver,70,37,33
Lozza,jubeithos,1574,monk,mistweaver,54,32,22
Chevvyy,azshara,1573,monk,mistweaver,36,18,18
Beboté,quelthalas,1573,monk,mistweaver,205,97,108
Sodamint,sargeras,1572,monk,mistweaver,48,23,25
Mistastep,tichondrius,1572,monk,mistweaver,84,40,44
Buffmonkdmg,tichondrius,1571,monk,mistweaver,90,48,42
Ckqt,stormrage,1569,monk,mistweaver,41,23,18
Boneykicks,tichondrius,1569,monk,mistweaver,42,21,21
Ghðst,ragnaros,1566,monk,mistweaver,36,20,16
Mvqws,tichondrius,1564,monk,mistweaver,32,24,8
Bebess,moon-guard,1564,monk,mistweaver,51,28,23
Eatmykïtty,dalaran,1563,monk,mistweaver,36,23,13
Frogsarecool,stormrage,1563,monk,mistweaver,40,20,20
Hatsu,madoran,1562,monk,mistweaver,155,79,76
Tiduskies,crushridge,1562,monk,mistweaver,54,25,29
Fistuhcuffs,sargeras,1561,monk,mistweaver,87,49,38
Wide,scarlet-crusade,1560,monk,mistweaver,30,17,13
Spaazz,tichondrius,1559,monk,mistweaver,83,53,30
Iovegõd,tichondrius,1559,monk,mistweaver,66,41,25
Bøkky,frostmourne,1558,monk,mistweaver,96,59,37
Buoymoose,bleeding-hollow,1557,monk,mistweaver,53,35,18
Bunnygal,thaurissan,1557,monk,mistweaver,143,73,70
Aramonk,tichondrius,1554,monk,mistweaver,64,37,27
Mistysweep,sargeras,1553,monk,mistweaver,67,34,33
Zerker,nagrand,1552,monk,mistweaver,55,26,29
Nelly,grizzly-hills,1552,monk,mistweaver,36,17,19
Zugroi,frostmourne,1551,monk,mistweaver,30,25,5
Jackphan,azralon,1551,monk,mistweaver,100,58,42
Nailtech,tichondrius,1550,monk,mistweaver,66,37,29
Sabersatin,sargeras,1550,monk,mistweaver,42,21,21
Statue,cenarius,1549,monk,mistweaver,29,17,12
Frenchfries,dragonmaw,1547,monk,mistweaver,72,34,38
Chopschtichs,kiljaeden,1543,monk,mistweaver,41,24,17
Haiyà,malganis,1542,monk,mistweaver,30,17,13
Zettelkasten,tichondrius,1541,monk,mistweaver,36,17,19
Bruceki,bleeding-hollow,1540,monk,mistweaver,47,26,21
Dragonwhirl,stormrage,1540,monk,mistweaver,65,35,30
Omii,darkspear,1540,monk,mistweaver,34,17,17
Miniswag,arthas,1540,monk,mistweaver,42,18,24
Ghim,frostmourne,1540,monk,mistweaver,61,26,35
Notfw,tichondrius,1540,monk,mistweaver,64,27,37
Viralpog,bleeding-hollow,1539,monk,mistweaver,60,32,28
Hiiyaa,tichondrius,1537,monk,mistweaver,110,56,54
Scrapfu,proudmoore,1536,monk,mistweaver,83,44,39
Snoozzy,kelthuzad,1536,monk,mistweaver,36,17,19
Roloyolo,illidan,1536,monk,mistweaver,52,19,33
Grizzm,sargeras,1535,monk,mistweaver,60,34,26
Squaanched,emerald-dream,1535,monk,mistweaver,48,17,31
Forgèt,kelthuzad,1534,monk,mistweaver,30,16,14
Lonebamboo,tichondrius,1534,monk,mistweaver,50,24,26
Keileas,moon-guard,1534,monk,mistweaver,94,43,51
Titanus,chogall,1533,monk,mistweaver,24,19,5
Prisonike,bleeding-hollow,1533,monk,mistweaver,48,25,23
Monkybidness,tichondrius,1533,monk,mistweaver,45,23,22
Fehthermane,area-52,1531,monk,mistweaver,82,51,31
Dryungpwnz,zuljin,1530,monk,mistweaver,72,44,28
Ekèl,tichondrius,1530,monk,mistweaver,101,53,48
Brucechez,tichondrius,1529,monk,mistweaver,24,16,8
Chiban,misha,1529,monk,mistweaver,30,18,12
Dlysezzic,tichondrius,1529,monk,mistweaver,65,33,32
Banterx,sargeras,1528,monk,mistweaver,79,39,40
Carzo,area-52,1527,monk,mistweaver,38,23,15
Kariwanji,tichondrius,1527,monk,mistweaver,251,132,119
Turbofist,bleeding-hollow,1526,monk,mistweaver,35,17,18
Lépøissøn,tichondrius,1525,monk,mistweaver,30,16,14
Atsugin,khazgoroth,1525,monk,mistweaver,36,16,20
Rockemsockem,gorefiend,1524,monk,mistweaver,72,41,31
Sóntix,sargeras,1523,monk,mistweaver,29,17,12
Mistohh,kiljaeden,1522,monk,mistweaver,24,16,8
Metakillër,ragnaros,1522,monk,mistweaver,76,37,39
Marsha,tichondrius,1522,monk,mistweaver,72,31,41
Dedracula,quelthalas,1521,monk,mistweaver,45,33,12
Jitsu,frostmane,1521,monk,mistweaver,105,64,41
Kaelastra,stormrage,1520,monk,mistweaver,102,60,42
Yuï,bleeding-hollow,1519,monk,mistweaver,24,16,8
Muzzye,frostmourne,1519,monk,mistweaver,218,124,94
Kiqz,stormrage,1519,monk,mistweaver,30,16,14
Yurm,moon-guard,1518,monk,mistweaver,54,38,16
Ghorb,boulderfist,1518,monk,mistweaver,81,44,37
Aledal,agamaggan,1517,monk,mistweaver,66,41,25
Mymissteak,darkspear,1516,monk,mistweaver,37,20,17
Ophibrew,zuljin,1516,monk,mistweaver,30,16,14
Romdansik,tichondrius,1515,monk,mistweaver,136,73,63
Zeroskil,thrall,1514,monk,mistweaver,33,19,14
Jlowbob,tichondrius,1514,monk,mistweaver,42,22,20
Soothinn,tichondrius,1513,monk,mistweaver,54,37,17
Bussyweaver,sargeras,1513,monk,mistweaver,123,74,49
Chelada,sargeras,1513,monk,mistweaver,48,22,26
Themonkfunk,bleeding-hollow,1511,monk,mistweaver,36,25,11
Josciel,ragnaros,1511,monk,mistweaver,403,201,202
Äncient,quelthalas,1509,monk,mistweaver,89,56,33
Aioffe,emerald-dream,1509,monk,mistweaver,30,16,14
Oakleet,bleeding-hollow,1507,monk,mistweaver,48,27,21
Aokuâng,malganis,1506,monk,mistweaver,90,55,35
Bastilaqt,korgath,1506,monk,mistweaver,127,70,57
Cranekicks,moon-guard,1505,monk,mistweaver,227,121,106
Greenpigo,tichondrius,1504,monk,mistweaver,18,17,1
Zarma,stormrage,1502,monk,mistweaver,76,44,32
Jerumay,tichondrius,1502,monk,mistweaver,52,29,23
Axellrod,tichondrius,1500,monk,mistweaver,60,38,22
Kungfused,frostmourne,1500,monk,mistweaver,36,18,18
Rakia,moon-guard,1500,monk,mistweaver,172,83,89
Xomonik,borean-tundra,1499,monk,mistweaver,66,39,27
Ferrarí,quelthalas,1499,monk,mistweaver,281,153,128
Lekrosa,thrall,1499,monk,mistweaver,71,38,33
Xenitate,bleeding-hollow,1497,monk,mistweaver,30,17,13
Fissg,frostmourne,1496,monk,mistweaver,30,17,13
Märthä,azralon,1496,monk,mistweaver,143,74,69
Tinypunch,emerald-dream,1496,monk,mistweaver,72,34,38
Igaku,windrunner,1495,monk,mistweaver,30,16,14
Närza,kelthuzad,1492,monk,mistweaver,42,24,18
Vorikson,stormrage,1492,monk,mistweaver,198,96,102
Seung,duskwood,1492,monk,mistweaver,255,121,134
Juchiyosamu,illidan,1491,monk,mistweaver,27,16,11
Lýøp,illidan,1491,monk,mistweaver,30,16,14
Tirêd,sargeras,1488,monk,mistweaver,96,51,45
Fistnanweavn,dawnbringer,1488,monk,mistweaver,132,62,70
Slashsmack,caelestrasz,1487,monk,mistweaver,54,26,28
Conormonk,tichondrius,1486,monk,mistweaver,24,18,6
Jugies,emerald-dream,1486,monk,mistweaver,42,26,16
Warzsong,azralon,1486,monk,mistweaver,54,33,21
Saeloon,frostmourne,1486,monk,mistweaver,77,36,41
Buddhabud,sargeras,1485,monk,mistweaver,54,28,26
Wohrfnok,illidan,1484,monk,mistweaver,30,20,10
Grandpå,tichondrius,1484,monk,mistweaver,42,23,19
Swiftyboi,tichondrius,1483,monk,mistweaver,132,64,68
Gsv,sargeras,1482,monk,mistweaver,138,80,58
Pagtuk,daggerspine,1482,monk,mistweaver,60,28,32
Slothman,nagrand,1481,monk,mistweaver,48,27,21
Âfrika,ysondre,1480,monk,mistweaver,65,31,34
Florla,illidan,1479,monk,mistweaver,28,17,11
Clipping,tichondrius,1478,monk,mistweaver,48,29,19
Talented,azuremyst,1477,monk,mistweaver,63,41,22
Fister,garithos,1476,monk,mistweaver,58,38,20
Monkpowaz,stormrage,1476,monk,mistweaver,42,26,16
Lasagnacàt,moon-guard,1475,monk,mistweaver,30,18,12
Bruceteå,area-52,1473,monk,mistweaver,29,19,10
Mòñk,shattered-halls,1473,monk,mistweaver,42,26,16
Missweaver,sargeras,1473,monk,mistweaver,62,31,31
Wheygodx,lothar,1471,monk,mistweaver,42,28,14
Tuss,tichondrius,1471,monk,mistweaver,46,18,28
Willowa,frostmourne,1470,monk,mistweaver,50,30,20
Xxgonchi,quelthalas,1469,monk,mistweaver,122,72,50
Hadryan,proudmoore,1469,monk,mistweaver,80,43,37
Dareelyst,arygos,1469,monk,mistweaver,36,16,20
Rockcalm,malganis,1468,monk,mistweaver,62,28,34
Brewmanchew,frostmourne,1466,monk,mistweaver,42,26,16
Dovhug,draenor,1465,monk,mistweaver,66,30,36
Gotmonk,aggramar,1464,monk,mistweaver,30,19,11
Iamamonk,kelthuzad,1461,monk,mistweaver,26,20,6
Himah,area-52,1460,monk,mistweaver,36,16,20
Gnomepuncher,dalaran,1459,monk,mistweaver,48,25,23
Iluvthugnmcz,sargeras,1459,monk,mistweaver,112,58,54
Fistea,frostmourne,1459,monk,mistweaver,45,21,24
Fisthealz,area-52,1458,monk,mistweaver,24,19,5
Kazov,proudmoore,1458,monk,mistweaver,178,92,86
Fidgetspinna,zuljin,1457,monk,mistweaver,38,18,20
Guïnness,tichondrius,1455,monk,mistweaver,30,18,12
Pcyesh,nemesis,1455,monk,mistweaver,70,37,33
Americå,zuljin,1453,monk,mistweaver,60,39,21
Bobthedrag,illidan,1453,monk,mistweaver,69,36,33
Fairyeflora,wyrmrest-accord,1452,monk,mistweaver,48,31,17
Baee,cairne,1451,monk,mistweaver,43,17,26
Pomonk,nazjatar,1450,monk,mistweaver,69,45,24
Reque,illidan,1450,monk,mistweaver,206,116,90
Endér,tichondrius,1450,monk,mistweaver,157,82,75
Xtrememisty,frostmourne,1449,monk,mistweaver,66,35,31
Lunarc,mannoroth,1445,monk,mistweaver,81,46,35
Lidela,sargeras,1445,monk,mistweaver,52,27,25
Göat,emerald-dream,1445,monk,mistweaver,45,22,23
Meshugah,quelthalas,1445,monk,mistweaver,90,42,48
Puoll,gallywix,1443,monk,mistweaver,99,55,44
Toastage,tichondrius,1443,monk,mistweaver,30,16,14
Sshri,illidan,1442,monk,mistweaver,131,60,71
Sorowblade,lothar,1441,monk,mistweaver,32,20,12
Sangthos,darkspear,1441,monk,mistweaver,150,66,84
Nerf,malganis,1438,monk,mistweaver,24,15,9
Elcidx,tichondrius,1438,monk,mistweaver,24,15,9
Bigs,duskwood,1438,monk,mistweaver,35,15,20
Pinkgucci,thrall,1438,monk,mistweaver,53,21,32
Kynalla,thunderlord,1435,monk,mistweaver,24,15,9
Outhume,eredar,1435,monk,mistweaver,30,15,15
Themys,zuljin,1434,monk,mistweaver,30,19,11
Hogarg,emerald-dream,1434,monk,mistweaver,24,15,9
Dhomonk,rexxar,1434,monk,mistweaver,29,17,12
Benex,tichondrius,1434,monk,mistweaver,35,19,16
Monktor,dalaran,1433,monk,mistweaver,72,38,34
Fartknocker,magtheridon,1433,monk,mistweaver,30,15,15
Safiel,proudmoore,1433,monk,mistweaver,118,51,67
Softer,frostmane,1432,monk,mistweaver,24,15,9
Mungka,tichondrius,1432,monk,mistweaver,94,47,47
Gotosleepkid,dalaran,1432,monk,mistweaver,50,25,25
Glad,stormscale,1431,monk,mistweaver,294,154,140
Akván,ragnaros,1430,monk,mistweaver,31,18,13
Fuqame,kiljaeden,1428,monk,mistweaver,42,19,23
Ashamah,bleeding-hollow,1427,monk,mistweaver,18,15,3
Chiang,chogall,1426,monk,mistweaver,23,17,6
Abdoolah,illidan,1426,monk,mistweaver,81,41,40
Poundmedaddi,tichondrius,1425,monk,mistweaver,111,69,42
Fistlord,zuljin,1425,monk,mistweaver,32,18,14
Tenshu,runetotem,1425,monk,mistweaver,93,48,45
Pøkemonk,malganis,1424,monk,mistweaver,24,15,9
Tobyblack,illidan,1424,monk,mistweaver,87,45,42
Bergoth,bleeding-hollow,1422,monk,mistweaver,24,15,9
Friskyfister,tichondrius,1422,monk,mistweaver,30,15,15
Leemîn,tichondrius,1421,monk,mistweaver,36,24,12
Brüce,ragnaros,1421,monk,mistweaver,57,33,24
Mustaf,stormrage,1421,monk,mistweaver,114,56,58
Jasonmonk,sargeras,1420,monk,mistweaver,31,19,12
Taijutzu,darkspear,1419,monk,mistweaver,24,15,9
Comonk,area-52,1416,monk,mistweaver,24,15,9
Ralphiex,tichondrius,1411,monk,mistweaver,101,53,48
Ninetrigrams,illidan,1411,monk,mistweaver,32,15,17
Shoumi,turalyon,1410,monk,mistweaver,30,17,13
Healzpapi,tichondrius,1408,monk,mistweaver,148,76,72
Nelda,gorgonnash,1407,monk,mistweaver,66,39,27
Sobuu,wyrmrest-accord,1406,monk,mistweaver,30,24,6
Ojiin,wyrmrest-accord,1405,monk,mistweaver,197,105,92
Bbyyoda,illidan,1404,monk,mistweaver,46,26,20
Ggjudo,sargeras,1404,monk,mistweaver,30,15,15
Thirteendads,turalyon,1403,monk,mistweaver,35,17,18
Saulgóòdman,tichondrius,1402,monk,mistweaver,36,15,21
Xiang,dreadmaul,1401,monk,mistweaver,48,29,19
Güwop,tichondrius,1401,monk,mistweaver,48,25,23
Bbunglee,tichondrius,1400,monk,mistweaver,41,27,14
Phatcheeks,aegwynn,1400,monk,mistweaver,66,37,29
Carlosm,tichondrius,1398,monk,mistweaver,30,19,11
Jèricho,thrall,1397,monk,mistweaver,60,32,28
Janeil,wyrmrest-accord,1397,monk,mistweaver,228,119,109
Zoltwo,sargeras,1395,monk,mistweaver,30,15,15
Edbtz,illidan,1394,monk,mistweaver,24,18,6
Bresmeatfore,barthilas,1394,monk,mistweaver,42,25,17
Kemmy,ravencrest,1393,monk,mistweaver,31,17,14
Mcfisted,area-52,1393,monk,mistweaver,57,25,32
Odindad,tichondrius,1392,monk,mistweaver,42,21,21
Htm,barthilas,1392,monk,mistweaver,41,16,25
Mcfluffey,area-52,1391,monk,mistweaver,89,49,40
Zonianman,tichondrius,1391,monk,mistweaver,95,51,44
Vum,quelthalas,1385,monk,mistweaver,21,16,5
Mightbweavin,bleeding-hollow,1385,monk,mistweaver,108,48,60
Drama,tichondrius,1384,monk,mistweaver,26,18,8
Bârcõdë,tichondrius,1384,monk,mistweaver,36,23,13
Justsidiousm,sargeras,1383,monk,mistweaver,24,16,8
Telospateo,ragnaros,1383,monk,mistweaver,36,19,17
Redweave,moon-guard,1383,monk,mistweaver,36,17,19
Flixz,stormrage,1382,monk,mistweaver,48,25,23
Docwang,malganis,1381,monk,mistweaver,42,27,15
Riokhan,ragnaros,1381,monk,mistweaver,54,31,23
Exuperjun,emerald-dream,1381,monk,mistweaver,34,16,18
Valiantroar,shandris,1381,monk,mistweaver,38,16,22
Noodalie,moon-guard,1378,monk,mistweaver,24,18,6
Manicata,tichondrius,1378,monk,mistweaver,75,41,34
Shandaspanda,rivendare,1378,monk,mistweaver,54,26,28
Monkeynut,whisperwind,1377,monk,mistweaver,89,51,38
Vegoku,moon-guard,1377,monk,mistweaver,84,45,39
Pablojám,ragnaros,1375,monk,mistweaver,42,23,19
Mystafista,tichondrius,1375,monk,mistweaver,29,15,14
Afabled,drakkari,1373,monk,mistweaver,48,26,22
Ozen,burning-blade,1373,monk,mistweaver,74,38,36
Baroon,chogall,1373,monk,mistweaver,93,40,53
Metalmønk,nerzhul,1372,monk,mistweaver,43,29,14
Sinistuhm,tichondrius,1371,monk,mistweaver,47,25,22
Rhynoo,lothar,1371,monk,mistweaver,96,51,45
Kylièjenner,gilneas,1370,monk,mistweaver,70,39,31
Thyfist,frostmourne,1369,monk,mistweaver,28,16,12
Lanifear,area-52,1364,monk,mistweaver,35,20,15
Vonn,drakkari,1364,monk,mistweaver,72,36,36
Tianji,malganis,1363,monk,mistweaver,42,26,16
Tert,aerie-peak,1363,monk,mistweaver,146,83,63
ßrewslèè,tichondrius,1363,monk,mistweaver,86,48,38
Lõgan,azralon,1362,monk,mistweaver,46,24,22
Chuks,nerzhul,1358,monk,mistweaver,164,91,73
Ataxic,illidan,1355,monk,mistweaver,29,15,14
Pandalee,skullcrusher,1353,monk,mistweaver,36,26,10
Ninjagordu,nemesis,1353,monk,mistweaver,118,57,61
Goocn,tichondrius,1351,monk,mistweaver,36,17,19
Ragemore,emerald-dream,1349,monk,mistweaver,25,15,10
Pandemikmonk,turalyon,1349,monk,mistweaver,48,22,26
Cdeez,malganis,1347,monk,mistweaver,36,23,13
Monkqi,lightbringer,1344,monk,mistweaver,30,23,7
Veejaex,stormreaver,1343,monk,mistweaver,18,14,4
Onegai,tichondrius,1343,monk,mistweaver,18,14,4
Itsnoozes,illidan,1343,monk,mistweaver,18,14,4
Rylens,draka,1343,monk,mistweaver,40,25,15
Jiskweaver,sargeras,1343,monk,mistweaver,24,14,10
Siserfister,sargeras,1343,monk,mistweaver,24,14,10
Khylu,kelthuzad,1342,monk,mistweaver,18,14,4
Cnww,tichondrius,1342,monk,mistweaver,24,14,10
Cilantrõ,malorne,1341,monk,mistweaver,30,21,9
Coldridge,bleeding-hollow,1341,monk,mistweaver,24,14,10
Emporertrump,bleeding-hollow,1341,monk,mistweaver,151,71,80
Meâghân,bladefist,1340,monk,mistweaver,18,14,4
Evyllyn,bleeding-hollow,1340,monk,mistweaver,18,14,4
Alternatives,sargeras,1339,monk,mistweaver,18,14,4
Azurro,jubeithos,1339,monk,mistweaver,18,14,4
Catmonk,the-forgotten-coast,1338,monk,mistweaver,24,14,10
Inkar,tichondrius,1338,monk,mistweaver,30,14,16
Dblfistez,stormreaver,1337,monk,mistweaver,46,18,28
Zenmasta,exodar,1336,monk,mistweaver,30,17,13
Ðamntaiyo,sargeras,1336,monk,mistweaver,35,19,16
Ryantiger,tichondrius,1336,monk,mistweaver,30,14,16
Chainwax,korgath,1335,monk,mistweaver,36,20,16
Lazeekick,sargeras,1335,monk,mistweaver,30,14,16
Iielia,wyrmrest-accord,1335,monk,mistweaver,35,16,19
Hoggs,sargeras,1333,monk,mistweaver,55,34,21
Chañi,ragnaros,1333,monk,mistweaver,59,33,26
Chongal,whisperwind,1332,monk,mistweaver,24,14,10
Inebriated,auchindoun,1329,monk,mistweaver,24,14,10
Donnieyen,area-52,1328,monk,mistweaver,30,14,16
Waxxi,barthilas,1327,monk,mistweaver,109,62,47
Tenzing,azgalor,1324,monk,mistweaver,24,14,10
Bradyfour,moon-guard,1324,monk,mistweaver,40,17,23
Momochi,malygos,1323,monk,mistweaver,30,16,14
Nerfmonk,spirestone,1322,monk,mistweaver,24,14,10
Jeffdagnome,moon-guard,1320,monk,mistweaver,96,48,48
Turkspin,smolderthorn,1319,monk,mistweaver,24,19,5
Gerranni,wyrmrest-accord,1318,monk,mistweaver,24,16,8
Bullët,tichondrius,1317,monk,mistweaver,30,18,12
Lotusdream,argent-dawn,1317,monk,mistweaver,72,37,35
Shon,frostmourne,1316,monk,mistweaver,24,14,10
Albusventos,azralon,1315,monk,mistweaver,35,21,14
Brewswayne,argent-dawn,1315,monk,mistweaver,24,14,10
Smackdat,azjolnerub,1315,monk,mistweaver,58,29,29
Johnkreese,andorhal,1313,monk,mistweaver,30,14,16
Tanskee,sargeras,1312,monk,mistweaver,35,20,15
Naxanax,area-52,1312,monk,mistweaver,60,29,31
Breezymist,doomhammer,1311,monk,mistweaver,30,14,16
Nuubchi,stormrage,1310,monk,mistweaver,24,14,10
Ric,gundrak,1310,monk,mistweaver,69,38,31
Dashenna,illidan,1310,monk,mistweaver,84,32,52
Punch,lothar,1309,monk,mistweaver,31,18,13
Odogin,tichondrius,1307,monk,mistweaver,65,41,24
Sweatweaver,frostmourne,1306,monk,mistweaver,94,43,51
Hafu,wildhammer,1305,monk,mistweaver,54,29,25
Dextr,arthas,1302,monk,mistweaver,27,14,13
Hirahxx,frostmourne,1301,monk,mistweaver,27,16,11
Keyszz,tichondrius,1301,monk,mistweaver,182,80,102
Alianli,tichondrius,1301,monk,mistweaver,59,14,45
Kickbone,tichondrius,1300,monk,mistweaver,60,30,30
Chitacos,trollbane,1300,monk,mistweaver,30,14,16
Damemasduro,ragnaros,1299,monk,mistweaver,415,197,218
Szuka,tichondrius,1297,monk,mistweaver,36,20,16
Kocksnapper,stormreaver,1297,monk,mistweaver,76,42,34
Lawroadp,tichondrius,1295,monk,mistweaver,57,33,24
Izolatedrin,tichondrius,1293,monk,mistweaver,17,14,3
Ymiron,smolderthorn,1292,monk,mistweaver,42,15,27
Monkisses,bonechewer,1290,monk,mistweaver,65,36,29
Gomey,bleeding-hollow,1287,monk,mistweaver,26,15,11
Teil,illidan,1287,monk,mistweaver,42,23,19
Gallorex,frostmourne,1286,monk,mistweaver,42,24,18
Baittor,proudmoore,1283,monk,mistweaver,27,15,12
Boozebear,spirestone,1282,monk,mistweaver,136,68,68
Kìmjungheal,tichondrius,1281,monk,mistweaver,41,21,20
Ungankable,sargeras,1281,monk,mistweaver,130,63,67
Chnzhs,tichondrius,1281,monk,mistweaver,58,18,40
Zeiana,proudmoore,1280,monk,mistweaver,38,22,16
Holdmychi,stormrage,1279,monk,mistweaver,55,29,26
Iloki,shuhalo,1279,monk,mistweaver,81,40,41
Miçrosoft,area-52,1278,monk,mistweaver,66,40,26
Valapan,tichondrius,1278,monk,mistweaver,48,25,23
Byakugan,moon-guard,1277,monk,mistweaver,41,23,18
Börg,bleeding-hollow,1277,monk,mistweaver,38,19,19
Giatzo,barthilas,1263,monk,mistweaver,55,25,30
Onekickman,dalaran,1262,monk,mistweaver,66,37,29
Moltenbeard,trollbane,1261,monk,mistweaver,24,17,7
Makimä,stormrage,1260,monk,mistweaver,54,28,26
Zenquadz,elune,1259,monk,mistweaver,36,25,11
Marimonkori,stormscale,1258,monk,mistweaver,63,32,31
Ninjatoots,aerie-peak,1255,monk,mistweaver,79,42,37
Omimonk,sargeras,1251,monk,mistweaver,56,24,32
Donnieyen,aerie-peak,1250,monk,mistweaver,19,14,5
Maiitoguy,illidan,1250,monk,mistweaver,48,24,24
Verelaana,moon-guard,1249,monk,mistweaver,23,14,9
Shefcurry,boulderfist,1248,monk,mistweaver,24,13,11
Mwomegalul,sargeras,1248,monk,mistweaver,30,13,17
Fatnugly,sargeras,1247,monk,mistweaver,18,13,5
Annisokay,bleeding-hollow,1247,monk,mistweaver,18,13,5
Beefyteet,tichondrius,1247,monk,mistweaver,18,13,5
Friendshipx,emerald-dream,1247,monk,mistweaver,18,13,5
Ticmonk,frostmourne,1247,monk,mistweaver,18,13,5
Feel,frostmourne,1247,monk,mistweaver,18,13,5
Gothamonk,tichondrius,1247,monk,mistweaver,24,13,11
Evilstep,tichondrius,1247,monk,mistweaver,60,31,29
Ojarax,bleeding-hollow,1246,monk,mistweaver,18,13,5
Steadfastsr,black-dragonflight,1246,monk,mistweaver,18,13,5
Mirokushan,skywall,1246,monk,mistweaver,117,65,52
Floka,bleeding-hollow,1245,monk,mistweaver,18,13,5
Hîddëncløùdx,tichondrius,1245,monk,mistweaver,18,13,5
Afw,moon-guard,1245,monk,mistweaver,32,18,14
Kênpächi,rexxar,1245,monk,mistweaver,24,13,11
Ieatshrooms,malfurion,1245,monk,mistweaver,60,25,35
Drunkgiraffe,zuljin,1244,monk,mistweaver,18,13,5
Ironfistorm,stormrage,1244,monk,mistweaver,36,24,12
Shilakamesn,tichondrius,1244,monk,mistweaver,24,13,11
Mis,tichondrius,1243,monk,mistweaver,24,13,11
Karynia,illidan,1243,monk,mistweaver,56,26,30
Psypalm,zuljin,1242,monk,mistweaver,18,13,5
React,frostwolf,1242,monk,mistweaver,18,13,5
Raígon,ragnaros,1242,monk,mistweaver,24,13,11
Kreacher,ravencrest,1242,monk,mistweaver,71,37,34
Rehder,barthilas,1241,monk,mistweaver,24,13,11
Poppyharlow,saurfang,1240,monk,mistweaver,24,17,7
Noogiie,barthilas,1238,monk,mistweaver,22,14,8
Originalmonk,tichondrius,1237,monk,mistweaver,18,13,5
Madkickzack,blades-edge,1237,monk,mistweaver,30,13,17
Oyyo,tichondrius,1237,monk,mistweaver,95,35,60
Lolkungfu,spirestone,1234,monk,mistweaver,24,13,11
Kodrik,tichondrius,1234,monk,mistweaver,84,44,40
Midfrie,ghostlands,1233,monk,mistweaver,24,15,9
Knaveus,frostmourne,1233,monk,mistweaver,54,30,24
Bossmonk,tichondrius,1233,monk,mistweaver,24,13,11
Siddlez,frostmourne,1231,monk,mistweaver,34,25,9
Lothnälar,ragnaros,1231,monk,mistweaver,36,26,10
Taichichuan,tichondrius,1231,monk,mistweaver,40,22,18
Azizyzz,barthilas,1231,monk,mistweaver,42,20,22
Shinarri,thrall,1230,monk,mistweaver,132,71,61
Shizunô,stormrage,1229,monk,mistweaver,30,14,16
Hymasterlol,tichondrius,1229,monk,mistweaver,30,13,17
Fkedyourwife,dalaran,1227,monk,mistweaver,30,13,17
Gôrr,tichondrius,1226,monk,mistweaver,42,23,19
Zefta,moon-guard,1226,monk,mistweaver,42,18,24
Petsëmatary,bleeding-hollow,1224,monk,mistweaver,41,16,25
Trüa,stormrage,1222,monk,mistweaver,18,13,5
Cheesemónk,tichondrius,1222,monk,mistweaver,30,13,17
Habuba,eredar,1221,monk,mistweaver,18,13,5
Binghe,illidan,1221,monk,mistweaver,63,35,28
Ninjahogan,azgalor,1221,monk,mistweaver,32,15,17
Cammy,aerie-peak,1219,monk,mistweaver,32,20,12
Troutline,bonechewer,1218,monk,mistweaver,84,50,34
Zarakna,sargeras,1217,monk,mistweaver,133,66,67
Xulieng,tichondrius,1215,monk,mistweaver,331,169,162
Monxellius,moon-guard,1215,monk,mistweaver,93,45,48
Purging,draka,1214,monk,mistweaver,71,49,22
Sedition,emerald-dream,1213,monk,mistweaver,317,159,158
Mortimir,echo-isles,1213,monk,mistweaver,30,14,16
Phoenixspark,gnomeregan,1211,monk,mistweaver,18,13,5
Genjen,bleeding-hollow,1210,monk,mistweaver,22,13,9
Monktyson,barthilas,1206,monk,mistweaver,42,27,15
Karatechawp,bleeding-hollow,1206,monk,mistweaver,22,14,8
Biggoosie,korgath,1206,monk,mistweaver,76,47,29
Chunkynorris,stormscale,1206,monk,mistweaver,38,18,20
Michaeljordn,destromath,1199,monk,mistweaver,44,16,28
Pepperoncini,korgath,1199,monk,mistweaver,54,17,37
Menadraene,wyrmrest-accord,1198,monk,mistweaver,26,14,12
Puffpuffp,nazgrel,1196,monk,mistweaver,24,13,11
Zsalcior,jaedenar,1195,monk,mistweaver,36,24,12
Darkheälzz,sargeras,1194,monk,mistweaver,93,44,49
Drexlla,barthilas,1191,monk,mistweaver,38,23,15
Poppinbrews,thrall,1191,monk,mistweaver,28,15,13
Vardeh,stormscale,1191,monk,mistweaver,30,14,16
Titofresh,quelthalas,1191,monk,mistweaver,33,15,18
Raphzen,stormrage,1189,monk,mistweaver,33,17,16
Soapy,moon-guard,1188,monk,mistweaver,35,16,19
Soderbergh,ysera,1185,monk,mistweaver,36,13,23
Orenj,boulderfist,1182,monk,mistweaver,30,16,14
Ratioed,moon-guard,1181,monk,mistweaver,47,32,15
Miretunie,arathor,1181,monk,mistweaver,54,32,22
Galiplays,zangarmarsh,1180,monk,mistweaver,29,16,13
Ludafist,whisperwind,1179,monk,mistweaver,66,33,33
Blackthorne,illidan,1179,monk,mistweaver,30,14,16
Anthuri,frostmourne,1178,monk,mistweaver,41,28,13
Soothem,tichondrius,1178,monk,mistweaver,24,16,8
Kreezoo,tichondrius,1178,monk,mistweaver,51,24,27
Haruko,baelgun,1178,monk,mistweaver,40,13,27
Kromkwando,burning-blade,1177,monk,mistweaver,42,13,29
Iseeyouqt,tichondrius,1176,monk,mistweaver,20,13,7
Puya,nemesis,1174,monk,mistweaver,30,14,16
Raidenmnx,tichondrius,1174,monk,mistweaver,30,13,17
Mongénoio,nemesis,1172,monk,mistweaver,26,13,13
Hamandchi,sargeras,1169,monk,mistweaver,23,16,7
Evílryü,quelthalas,1168,monk,mistweaver,27,16,11
Darrhon,illidan,1166,monk,mistweaver,113,54,59
Hie,laughing-skull,1166,monk,mistweaver,90,38,52
Shwankeesha,thrall,1165,monk,mistweaver,28,14,14
Monkoala,illidan,1160,monk,mistweaver,30,17,13
Madmint,illidan,1159,monk,mistweaver,60,26,34
Valdosta,bloodscalp,1158,monk,mistweaver,48,25,23
Callibella,amanthul,1155,monk,mistweaver,26,13,13
Xaurian,firetree,1153,monk,mistweaver,22,13,9
Austinm,tichondrius,1152,monk,mistweaver,18,12,6
Magmuruk,garrosh,1152,monk,mistweaver,18,12,6
Miley,lethon,1151,monk,mistweaver,18,12,6
Kungpaofish,tichondrius,1151,monk,mistweaver,24,12,12
Enfoque,quelthalas,1150,monk,mistweaver,47,26,21
Dreamscapexo,kelthuzad,1150,monk,mistweaver,24,12,12
Musedz,barthilas,1149,monk,mistweaver,30,12,18
Lartridia,malganis,1148,monk,mistweaver,18,12,6
Onlythumbs,area-52,1148,monk,mistweaver,18,12,6
Santhz,ragnaros,1148,monk,mistweaver,18,12,6
Trojanz,malganis,1148,monk,mistweaver,24,12,12
Strixx,silvermoon,1147,monk,mistweaver,18,14,4
Zallie,frostmourne,1147,monk,mistweaver,18,12,6
Nazvik,quelthalas,1146,monk,mistweaver,18,12,6
Oochi,illidan,1146,monk,mistweaver,24,12,12
Kaniou,proudmoore,1146,monk,mistweaver,29,13,16
Azenia,barthilas,1146,monk,mistweaver,30,12,18
Jagichan,area-52,1145,monk,mistweaver,18,12,6
Monkaveli,ursin,1145,monk,mistweaver,78,37,41
Taipanni,sargeras,1143,monk,mistweaver,30,12,18
Lørðjimmy,sargeras,1142,monk,mistweaver,18,12,6
Antimoine,saurfang,1142,monk,mistweaver,36,22,14
Bibibi,moon-guard,1140,monk,mistweaver,24,12,12
Calmemaybe,darkspear,1138,monk,mistweaver,18,12,6
Drfoochi,tichondrius,1138,monk,mistweaver,30,12,18
Lumïnous,moon-guard,1136,monk,mistweaver,30,14,16
Selfhealings,korgath,1135,monk,mistweaver,24,12,12
Kexti,wyrmrest-accord,1135,monk,mistweaver,45,18,27
Affrika,ragnaros,1133,monk,mistweaver,47,21,26
Trapeez,kelthuzad,1132,monk,mistweaver,18,12,6
Herbivorous,sargeras,1131,monk,mistweaver,24,12,12
Modelman,area-52,1130,monk,mistweaver,26,14,12
Gobfu,emerald-dream,1130,monk,mistweaver,65,26,39
Fitmonje,drakkari,1126,monk,mistweaver,43,22,21
Boostmonk,terenas,1126,monk,mistweaver,78,34,44
Fistmeister,tichondrius,1125,monk,mistweaver,30,19,11
Ursorcen,frostmourne,1122,monk,mistweaver,33,16,17
Honjada,tichondrius,1121,monk,mistweaver,18,12,6
Fluffykitty,deathwing,1119,monk,mistweaver,45,19,26
Whiteknight,tichondrius,1118,monk,mistweaver,14,13,1
Hastle,windrunner,1116,monk,mistweaver,66,37,29
Tinze,bonechewer,1115,monk,mistweaver,35,14,21
Orbí,tichondrius,1111,monk,mistweaver,48,32,16
Halfaling,tichondrius,1109,monk,mistweaver,18,12,6
Smokee,blackhand,1107,monk,mistweaver,24,12,12
Lolcutie,shandris,1105,monk,mistweaver,37,21,16
Dokfu,tichondrius,1105,monk,mistweaver,159,86,73
Emenboats,zuljin,1096,monk,mistweaver,70,44,26
Kimonk,proudmoore,1095,monk,mistweaver,36,21,15
Gentle,cenarius,1093,monk,mistweaver,26,12,14
Shoguns,zuljin,1091,monk,mistweaver,48,24,24
Brewamp,zuljin,1091,monk,mistweaver,29,13,16
Fonnf,nemesis,1086,monk,mistweaver,20,12,8
Focalors,proudmoore,1085,monk,mistweaver,20,12,8
Rowbur,thrall,1077,monk,mistweaver,33,22,11
Harryrichard,sargeras,1073,monk,mistweaver,23,12,11
Lita,barthilas,1071,monk,mistweaver,17,12,5
Keeanuweaves,tichondrius,1069,monk,mistweaver,13,12,1
Shaolyyn,zuljin,1068,monk,mistweaver,54,29,25
Muzzen,fizzcrank,1068,monk,mistweaver,28,13,15
Hakushin,ragnaros,1067,monk,mistweaver,36,20,16
Razod,stormrage,1066,monk,mistweaver,154,74,80
Kfpanda,hellscream,1065,monk,mistweaver,72,35,37
Duelist,the-scryers,1056,monk,mistweaver,12,11,1
Lustymonk,kelthuzad,1056,monk,mistweaver,12,11,1
Jmanownz,stormrage,1056,monk,mistweaver,12,11,1
Haren,gundrak,1056,monk,mistweaver,18,11,7
Mistussy,sargeras,1056,monk,mistweaver,18,11,7
Solidww,moon-guard,1055,monk,mistweaver,12,11,1
Gooseoba,tichondrius,1055,monk,mistweaver,12,11,1
Axibar,tichondrius,1055,monk,mistweaver,18,11,7
Iplus,thrall,1055,monk,mistweaver,18,11,7
Fkinbis,area-52,1055,monk,mistweaver,18,11,7
Stephenia,tichondrius,1055,monk,mistweaver,18,11,7
Undertickle,illidan,1055,monk,mistweaver,18,11,7
Alandis,spinebreaker,1055,monk,mistweaver,18,11,7
Bubear,stormreaver,1055,monk,mistweaver,18,11,7
Lemmetouch,illidan,1055,monk,mistweaver,24,11,13
Chillionaíre,proudmoore,1055,monk,mistweaver,24,11,13
Taelinn,moonrunner,1055,monk,mistweaver,30,11,19
Evilbit,boulderfist,1054,monk,mistweaver,18,11,7
Cungflu,crushridge,1054,monk,mistweaver,24,11,13
Dreadknotz,hyjal,1054,monk,mistweaver,42,17,25
Tisafister,kelthuzad,1053,monk,mistweaver,18,11,7
Zoochans,tichondrius,1053,monk,mistweaver,67,40,27
Hache,azjolnerub,1053,monk,mistweaver,80,34,46
Theymistbuda,kelthuzad,1052,monk,mistweaver,12,11,1
Djslimweaver,stormrage,1052,monk,mistweaver,14,11,3
Havasupai,turalyon,1052,monk,mistweaver,18,11,7
Wungpo,the-forgotten-coast,1052,monk,mistweaver,18,11,7
Karnbroo,frostmourne,1052,monk,mistweaver,24,11,13
Rileyreidfan,azjolnerub,1051,monk,mistweaver,18,11,7
Pappaya,tichondrius,1051,monk,mistweaver,18,11,7
Superbae,area-52,1051,monk,mistweaver,24,11,13
Fistful,destromath,1050,monk,mistweaver,12,11,1
Hazelbazel,bleeding-hollow,1050,monk,mistweaver,18,11,7
Eldrik,stormrage,1050,monk,mistweaver,18,11,7
Dégg,thrall,1050,monk,mistweaver,18,11,7
Caellum,quelthalas,1048,monk,mistweaver,18,11,7
Cooltran,tichondrius,1048,monk,mistweaver,18,11,7
Ilani,malganis,1047,monk,mistweaver,18,11,7
Proctology,tichondrius,1047,monk,mistweaver,18,11,7
Gngrbeardman,tichondrius,1047,monk,mistweaver,27,12,15
Wraithfire,uldum,1047,monk,mistweaver,30,12,18
Shaolinmists,malganis,1045,monk,mistweaver,12,11,1
Pimpolhona,nemesis,1045,monk,mistweaver,30,11,19
Steenkk,tichondrius,1042,monk,mistweaver,54,25,29
Gguldduk,tichondrius,1038,monk,mistweaver,16,12,4
Thors,gorgonnash,1038,monk,mistweaver,24,13,11
Teancrumpets,wyrmrest-accord,1038,monk,mistweaver,48,20,28
Leësin,ragnaros,1037,monk,mistweaver,18,11,7
Tadaku,dalaran,1033,monk,mistweaver,37,17,20
Reinah,malganis,1033,monk,mistweaver,30,11,19
Merand,tichondrius,1031,monk,mistweaver,36,20,16
Baiji,gorefiend,1030,monk,mistweaver,12,11,1
Mahhnaga,tichondrius,1030,monk,mistweaver,89,36,53
Marnartou,zuljin,1026,monk,mistweaver,12,11,1
Hapgido,deathwing,1025,monk,mistweaver,56,26,30
Ambuinc,burning-blade,1024,monk,mistweaver,18,11,7
Dalillamas,sargeras,1023,monk,mistweaver,14,12,2
Schein,sargeras,1023,monk,mistweaver,17,11,6
Grizzchan,sargeras,1017,monk,mistweaver,17,11,6
Ainz,nagrand,1016,monk,mistweaver,30,15,15
Vitcheztein,ragnaros,1007,monk,mistweaver,17,11,6
Twizzurp,magtheridon,1007,monk,mistweaver,21,12,9
Bigjuicers,bleeding-hollow,1006,monk,mistweaver,17,11,6
Deadlyzz,gilneas,1006,monk,mistweaver,87,47,40
Vencö,tichondrius,1001,monk,mistweaver,33,11,22
Clutchinmist,malganis,1000,monk,mistweaver,40,12,28
Wmo,tichondrius,997,monk,mistweaver,17,11,6
Joeyfists,frostwolf,997,monk,mistweaver,24,11,13
Sonicenergy,tichondrius,997,monk,mistweaver,27,12,15
Zendemic,thrall,996,monk,mistweaver,30,17,13
Telrande,ysondre,994,monk,mistweaver,35,24,11
Sukrit,darkspear,993,monk,mistweaver,40,19,21
Hinudhera,barthilas,993,monk,mistweaver,69,32,37
Chopy,dragonblight,991,monk,mistweaver,48,21,27
Mintbear,illidan,984,monk,mistweaver,14,11,3
Monkgringo,azralon,983,monk,mistweaver,48,27,21
Kpeste,tichondrius,981,monk,mistweaver,60,30,30
Bomer,moknathal,980,monk,mistweaver,49,29,20
Winniethepoo,borean-tundra,975,monk,mistweaver,19,11,8
Ogsimpsonn,tichondrius,972,monk,mistweaver,20,11,9
Whitepotato,bleeding-hollow,969,monk,mistweaver,126,65,61
Sipu,wyrmrest-accord,969,monk,mistweaver,41,20,21
Klanianhere,sargeras,960,monk,mistweaver,12,10,2
Drizzywow,arathor,960,monk,mistweaver,12,10,2
Woes,stormreaver,960,monk,mistweaver,12,10,2
Hype,ursin,960,monk,mistweaver,12,10,2
Mywave,bleeding-hollow,960,monk,mistweaver,18,10,8
Agilities,sargeras,960,monk,mistweaver,18,10,8
Mauvem,tichondrius,960,monk,mistweaver,18,10,8
Chignar,dathremar,960,monk,mistweaver,18,10,8
Milkshayx,kiljaeden,960,monk,mistweaver,18,10,8
Greenfriend,illidan,960,monk,mistweaver,18,10,8
Titti,korgath,960,monk,mistweaver,18,10,8
Fheng,emerald-dream,960,monk,mistweaver,18,10,8
Mlngo,illidan,960,monk,mistweaver,18,10,8
Dapperdabz,illidan,960,monk,mistweaver,18,10,8
Barlyfe,tichondrius,960,monk,mistweaver,24,10,14
Shâdòw,ragnaros,959,monk,mistweaver,12,10,2
Mïstyfïsty,moon-guard,959,monk,mistweaver,12,10,2
Hanlover,tichondrius,959,monk,mistweaver,12,10,2
Sharpstorm,darkspear,959,monk,mistweaver,12,10,2
Melpaine,frostmourne,959,monk,mistweaver,18,10,8
Insidedog,frostmourne,959,monk,mistweaver,18,10,8
Cymonka,sargeras,959,monk,mistweaver,18,10,8
Battlecruise,tichondrius,959,monk,mistweaver,18,10,8
Chanîng,frostmourne,959,monk,mistweaver,18,10,8
Anabolicx,khazgoroth,959,monk,mistweaver,24,10,14
Trazmold,emerald-dream,958,monk,mistweaver,18,10,8
Lostinmistz,tichondrius,958,monk,mistweaver,18,10,8
Monkgov,illidan,958,monk,mistweaver,18,10,8
Inkers,detheroc,957,monk,mistweaver,18,10,8
Oldfashheals,tichondrius,957,monk,mistweaver,24,10,14
Mizzycash,malganis,957,monk,mistweaver,26,10,16
Hashìba,kiljaeden,956,monk,mistweaver,12,10,2
Kungfumika,ragnaros,955,monk,mistweaver,24,10,14
Diligentmonk,illidan,955,monk,mistweaver,27,11,16
Chìforce,sargeras,955,monk,mistweaver,35,10,25
Wessex,sargeras,954,monk,mistweaver,18,10,8
Bojflow,dalaran,954,monk,mistweaver,18,10,8
Kailzchi,area-52,951,monk,mistweaver,18,10,8
Asliam,undermine,951,monk,mistweaver,18,10,8
Brewtalitops,illidan,950,monk,mistweaver,18,10,8
Shinobui,jubeithos,950,monk,mistweaver,18,10,8
Dirtyshef,deathwing,949,monk,mistweaver,45,11,34
Gazzoxsan,chogall,946,monk,mistweaver,25,10,15
Jæmz,moon-guard,944,monk,mistweaver,36,13,23
Chugs,malorne,938,monk,mistweaver,36,10,26
Polofasho,illidan,934,monk,mistweaver,17,10,7
Boojaa,silvermoon,931,monk,mistweaver,54,20,34
Ultramaga,dentarg,927,monk,mistweaver,28,10,18
Siamack,illidan,920,monk,mistweaver,14,11,3
Karkata,sargeras,914,monk,mistweaver,48,20,28
Kangeroo,tichondrius,912,monk,mistweaver,21,11,10
Sensey,veknilash,910,monk,mistweaver,17,10,7
Xbrewtal,tichondrius,909,monk,mistweaver,30,17,13
Lovechabill,darkspear,906,monk,mistweaver,17,10,7
Ægo,sargeras,906,monk,mistweaver,22,11,11
Chavbrew,stormrage,894,monk,mistweaver,17,10,7
Delassian,moon-guard,894,monk,mistweaver,37,16,21
Inbu,tichondrius,893,monk,mistweaver,26,10,16
Stickbundle,illidan,888,monk,mistweaver,15,11,4
Edj,drenden,884,monk,mistweaver,75,37,38
Monkgyfatso,tichondrius,878,monk,mistweaver,11,10,1
Galyndra,darkspear,877,monk,mistweaver,13,10,3
Imnumberone,alterac-mountains,864,monk,mistweaver,12,9,3
Jonnymon,sargeras,864,monk,mistweaver,12,9,3
Ggonext,wyrmrest-accord,864,monk,mistweaver,12,9,3
Franqx,tichondrius,864,monk,mistweaver,12,9,3
Sâx,stormreaver,864,monk,mistweaver,12,9,3
Pisswalker,area-52,864,monk,mistweaver,12,9,3
Horndog,skullcrusher,864,monk,mistweaver,12,9,3
Flicksx,arthas,864,monk,mistweaver,12,9,3
Mistyfisty,laughing-skull,864,monk,mistweaver,14,9,5
Wizlee,tichondrius,864,monk,mistweaver,18,9,9
Kármah,emerald-dream,864,monk,mistweaver,18,9,9
Gottí,sargeras,864,monk,mistweaver,18,9,9
Pinkfairy,wyrmrest-accord,864,monk,mistweaver,18,9,9
Kriticalkush,kelthuzad,864,monk,mistweaver,18,9,9
Paraíba,azralon,864,monk,mistweaver,24,9,15
Hulkhogan,mugthol,863,monk,mistweaver,14,11,3
Theminivan,sargeras,863,monk,mistweaver,12,9,3
Maicuta,thrall,863,monk,mistweaver,12,9,3
Tubby,eredar,863,monk,mistweaver,12,9,3
Brewley,thrall,863,monk,mistweaver,12,9,3
Kazzichi,area-52,863,monk,mistweaver,12,9,3
Brewtillis,tichondrius,863,monk,mistweaver,12,9,3
Ztalian,moon-guard,863,monk,mistweaver,12,9,3
Fistfreak,stormrage,863,monk,mistweaver,12,9,3
Tjab,kiljaeden,863,monk,mistweaver,18,9,9
Julipz,tichondrius,863,monk,mistweaver,18,9,9
Madmoose,smolderthorn,863,monk,mistweaver,24,10,14
Icytoned,kelthuzad,863,monk,mistweaver,24,9,15
Ørçhid,ravenholdt,862,monk,mistweaver,12,9,3
Masamunes,thrall,862,monk,mistweaver,12,9,3
Zac,veknilash,862,monk,mistweaver,12,9,3
Madussy,zuljin,862,monk,mistweaver,24,9,15
Kromrax,stormrage,862,monk,mistweaver,24,9,15
Kungupanda,nesingwary,862,monk,mistweaver,24,9,15
Jhaded,tichondrius,862,monk,mistweaver,24,9,15
Kaølin,azralon,861,monk,mistweaver,12,9,3
Kirshta,kelthuzad,861,monk,mistweaver,12,9,3
Rosellina,kelthuzad,861,monk,mistweaver,18,9,9
Snuzzao,darkspear,861,monk,mistweaver,20,9,11
Palomagozzu,ragnaros,860,monk,mistweaver,12,9,3
Mintÿ,wyrmrest-accord,860,monk,mistweaver,18,9,9
Håzê,kul-tiras,860,monk,mistweaver,18,9,9
Moonkers,tichondrius,860,monk,mistweaver,18,9,9
Yudrin,zuljin,859,monk,mistweaver,24,9,15
Fludz,burning-blade,859,monk,mistweaver,24,9,15
Monkism,warsong,855,monk,mistweaver,12,9,3
Winwakamank,sargeras,855,monk,mistweaver,24,9,15
Eago,sargeras,852,monk,mistweaver,24,9,15
Bullshido,aerie-peak,851,monk,mistweaver,18,9,9
Epptwo,aggramar,851,monk,mistweaver,30,9,21
Ragepalm,aegwynn,848,monk,mistweaver,18,9,9
Lilbee,azjolnerub,845,monk,mistweaver,18,9,9
Sìrtankallot,stormrage,837,monk,mistweaver,32,9,23
Kimchimaj,tichondrius,832,monk,mistweaver,18,9,9
Twinktoez,bleeding-hollow,831,monk,mistweaver,14,10,4
Tcoon,frostmourne,830,monk,mistweaver,20,10,10
Sihgriid,tichondrius,826,monk,mistweaver,20,10,10
Seaja,malganis,823,monk,mistweaver,99,26,73
Kyndrïa,tichondrius,819,monk,mistweaver,65,26,39
Goodluck,madoran,809,monk,mistweaver,27,10,17
Tokkyo,frostmourne,804,monk,mistweaver,66,15,51
Picoree,frostmourne,799,monk,mistweaver,15,10,5
Gino,proudmoore,799,monk,mistweaver,154,69,85
Jeolmyung,tichondrius,798,monk,mistweaver,14,9,5
Mastahp,tichondrius,797,monk,mistweaver,22,9,13
Akfourseven,barthilas,795,monk,mistweaver,71,32,39
Qlispe,bloodscalp,784,monk,mistweaver,76,35,41
Dreamy,mugthol,773,monk,mistweaver,42,12,30
Scrypter,proudmoore,768,monk,mistweaver,12,8,4
Garg,malganis,768,monk,mistweaver,12,8,4
Tubescreamer,barthilas,768,monk,mistweaver,12,8,4
Anandamayi,emerald-dream,768,monk,mistweaver,12,8,4
Tuladura,tichondrius,768,monk,mistweaver,12,8,4
Zxenn,tichondrius,768,monk,mistweaver,12,8,4
Torakigai,ghostlands,768,monk,mistweaver,12,8,4
Bralex,black-dragonflight,768,monk,mistweaver,12,8,4
Ninjachavez,tichondrius,768,monk,mistweaver,12,8,4
Kaystorm,stormrage,768,monk,mistweaver,12,8,4
Monkzilla,tichondrius,768,monk,mistweaver,12,8,4
Pantypirate,tichondrius,768,monk,mistweaver,12,8,4
Picklefartjr,malfurion,768,monk,mistweaver,12,8,4
Sainlaurent,tichondrius,768,monk,mistweaver,12,8,4
Udmonk,tichondrius,768,monk,mistweaver,12,8,4
Cuckoon,malganis,768,monk,mistweaver,12,8,4
Sàìñtàsønìà,kelthuzad,768,monk,mistweaver,12,8,4
Shquiz,sargeras,768,monk,mistweaver,12,8,4
Funkmunk,aegwynn,768,monk,mistweaver,12,8,4
Omnly,stormrage,768,monk,mistweaver,12,8,4
Kaskã,tichondrius,768,monk,mistweaver,12,8,4
Mmrmonkey,tichondrius,768,monk,mistweaver,18,8,10
Kwatann,bonechewer,768,monk,mistweaver,18,8,10
Backflip,nemesis,768,monk,mistweaver,18,8,10
Imafqnbaby,tichondrius,768,monk,mistweaver,18,8,10
Pumpsx,area-52,768,monk,mistweaver,18,8,10
Erwynz,tichondrius,768,monk,mistweaver,24,8,16
Blitzcombo,thrall,767,monk,mistweaver,12,8,4
Lenee,frostmourne,767,monk,mistweaver,12,8,4
Abird,tichondrius,767,monk,mistweaver,12,8,4
Zenspice,stormrage,767,monk,mistweaver,12,8,4
Mightbewôrth,thunderhorn,767,monk,mistweaver,12,8,4
Chicheez,sargeras,767,monk,mistweaver,12,8,4
Rolybones,boulderfist,767,monk,mistweaver,12,8,4
Voltekkor,tichondrius,767,monk,mistweaver,14,8,6
Barleygar,tichondrius,767,monk,mistweaver,18,8,10
Dabnhash,emerald-dream,767,monk,mistweaver,18,8,10
Bogez,area-52,767,monk,mistweaver,18,8,10
Elfass,bleeding-hollow,767,monk,mistweaver,18,8,10
Selfiestíck,tichondrius,766,monk,mistweaver,12,8,4
Artomist,stormrage,766,monk,mistweaver,12,8,4
Apexian,kelthuzad,766,monk,mistweaver,12,8,4
Barnåcle,darkspear,766,monk,mistweaver,12,8,4
Karaka,ysera,766,monk,mistweaver,12,8,4
Feynzen,frostmourne,766,monk,mistweaver,12,8,4
Wzzi,tichondrius,765,monk,mistweaver,18,8,10
Slinger,kalecgos,764,monk,mistweaver,16,9,7
Scips,fizzcrank,764,monk,mistweaver,18,8,10
Kushmintz,whisperwind,762,monk,mistweaver,18,8,10
Fufu,terokkar,761,monk,mistweaver,18,8,10
Fusionspell,stormrage,747,monk,mistweaver,24,8,16
Prddoss,quelthalas,745,monk,mistweaver,12,8,4
Sätsu,bleeding-hollow,735,monk,mistweaver,17,8,9
Áasuna,ragnaros,734,monk,mistweaver,20,9,11
Thaliondor,stormrage,720,monk,mistweaver,15,9,6
Kryflex,frostmourne,720,monk,mistweaver,15,9,6
Bombshellxo,illidan,719,monk,mistweaver,11,8,3
Cloq,kelthuzad,719,monk,mistweaver,17,8,9
Rektfu,emerald-dream,708,monk,mistweaver,21,9,12
Diagrams,tichondrius,703,monk,mistweaver,11,8,3
Djwushu,blackhand,698,monk,mistweaver,20,8,12
Crãsh,quelthalas,697,monk,mistweaver,16,8,8
Hirav,khazgoroth,697,monk,mistweaver,21,9,12
Shortbuss,aegwynn,696,monk,mistweaver,14,8,6
Minttea,kiljaeden,690,monk,mistweaver,28,9,19
Ammonk,bloodhoof,672,monk,mistweaver,12,7,5
Aniwhy,tichondrius,672,monk,mistweaver,12,7,5
Kelstrike,sargeras,672,monk,mistweaver,12,7,5
Kegwalker,earthen-ring,672,monk,mistweaver,12,7,5
Tuesdây,wyrmrest-accord,672,monk,mistweaver,12,7,5
Brimhildaa,tichondrius,672,monk,mistweaver,12,7,5
Pandatrainer,drakkari,672,monk,mistweaver,12,7,5
Laggytoodope,kelthuzad,672,monk,mistweaver,12,7,5
Valelarus,doomhammer,672,monk,mistweaver,12,7,5
Zbell,sargeras,672,monk,mistweaver,12,7,5
Kyrap,stormscale,672,monk,mistweaver,12,7,5
Mundane,sargeras,672,monk,mistweaver,12,7,5
Yangzai,tichondrius,672,monk,mistweaver,12,7,5
Missclickx,azralon,672,monk,mistweaver,12,7,5
Synpunch,tichondrius,672,monk,mistweaver,12,7,5
Notrof,korgath,672,monk,mistweaver,12,7,5
Saiyañ,proudmoore,672,monk,mistweaver,12,7,5
Galeindra,whisperwind,672,monk,mistweaver,12,7,5
Boorams,tichondrius,672,monk,mistweaver,12,7,5
Mwr,frostmourne,672,monk,mistweaver,12,7,5
Rookere,malganis,672,monk,mistweaver,12,7,5
Copamine,dalaran,672,monk,mistweaver,12,7,5
Lynio,area-52,672,monk,mistweaver,12,7,5
Darong,tichondrius,672,monk,mistweaver,12,7,5
Truefists,stormrage,672,monk,mistweaver,12,7,5
Toothpick,blackrock,672,monk,mistweaver,12,7,5
Moönk,tichondrius,672,monk,mistweaver,12,7,5
Jaxvisto,dalaran,672,monk,mistweaver,12,7,5
Ashmisty,kelthuzad,672,monk,mistweaver,12,7,5
Fistay,burning-legion,672,monk,mistweaver,15,8,7
Beejae,tichondrius,672,monk,mistweaver,14,7,7
Èxpèrtisè,jubeithos,672,monk,mistweaver,14,7,7
Sjw,icecrown,672,monk,mistweaver,14,7,7
Zkingmonk,stormrage,672,monk,mistweaver,18,7,11
Thevy,area-52,672,monk,mistweaver,18,7,11
Monktu,frostmourne,672,monk,mistweaver,18,7,11
Audrun,frostmourne,672,monk,mistweaver,18,7,11
Caliroll,gorefiend,672,monk,mistweaver,18,7,11
Hoofweaver,proudmoore,672,monk,mistweaver,24,7,17
Iwonson,mugthol,671,monk,mistweaver,12,7,5
Touzin,bleeding-hollow,671,monk,mistweaver,12,7,5
Delightni,area-52,671,monk,mistweaver,12,7,5
Monkydoo,blackhand,671,monk,mistweaver,12,7,5
Kurtall,area-52,671,monk,mistweaver,12,7,5
Decha,skywall,671,monk,mistweaver,12,7,5
Crankxx,malganis,671,monk,mistweaver,12,7,5
Jbonk,hyjal,671,monk,mistweaver,12,7,5
Tigraxus,proudmoore,671,monk,mistweaver,12,7,5
Alisoly,tichondrius,671,monk,mistweaver,12,7,5
Rôbo,emerald-dream,671,monk,mistweaver,12,7,5
Fìst,hyjal,671,monk,mistweaver,12,7,5
Hornymonkale,thrall,671,monk,mistweaver,12,7,5
Shórtlived,skullcrusher,671,monk,mistweaver,13,7,6
Táishen,wyrmrest-accord,671,monk,mistweaver,16,8,8
Metapôd,tichondrius,671,monk,mistweaver,15,7,8
Divaweaver,sargeras,671,monk,mistweaver,18,7,11
Aotd,tichondrius,671,monk,mistweaver,18,7,11
Bükki,ragnaros,671,monk,mistweaver,18,7,11
Atiantian,proudmoore,671,monk,mistweaver,24,7,17
Cosetteb,proudmoore,670,monk,mistweaver,12,7,5
Kongpoo,kelthuzad,670,monk,mistweaver,12,7,5
Microdose,blackrock,670,monk,mistweaver,18,7,11
Khaldi,tichondrius,670,monk,mistweaver,19,7,12
Tusil,tichondrius,670,monk,mistweaver,24,7,17
Pandaranga,saurfang,670,monk,mistweaver,28,8,20
Unlemike,runetotem,669,monk,mistweaver,12,7,5
Nymchi,stormrage,669,monk,mistweaver,12,7,5
Melyodis,thrall,669,monk,mistweaver,18,7,11
Ghostmk,nagrand,667,monk,mistweaver,18,7,11
Balooballs,frostmourne,667,monk,mistweaver,18,7,11
Wetspaghetti,malganis,661,monk,mistweaver,18,7,11
Munchan,hyjal,654,monk,mistweaver,11,9,2
Matchuh,stormrage,643,monk,mistweaver,25,8,17
Karu,barthilas,639,monk,mistweaver,18,8,10
Rènh,ragnaros,639,monk,mistweaver,17,7,10
Reflexsivex,malganis,638,monk,mistweaver,11,7,4
Sourcandyx,area-52,624,monk,mistweaver,15,7,8
Blessedbalor,tichondrius,624,monk,mistweaver,21,7,14
Praydoh,tichondrius,623,monk,mistweaver,11,7,4
Jetchi,proudmoore,623,monk,mistweaver,11,7,4
Dasubb,crushridge,623,monk,mistweaver,11,7,4
Azz,barthilas,623,monk,mistweaver,11,7,4
Aerona,stormreaver,617,monk,mistweaver,12,8,4
Coachputmein,barthilas,607,monk,mistweaver,11,7,4
Robochöp,emerald-dream,606,monk,mistweaver,14,7,7
Larkssmw,zuljin,576,monk,mistweaver,6,6,0
Watty,zuljin,576,monk,mistweaver,6,6,0
Kruxx,anvilmar,576,monk,mistweaver,6,6,0
Minivanmom,illidan,576,monk,mistweaver,6,6,0
Monkmarz,malygos,576,monk,mistweaver,6,6,0
Ezqueue,area-52,576,monk,mistweaver,6,6,0
Nevercranex,kirin-tor,576,monk,mistweaver,6,6,0
Anagark,barthilas,576,monk,mistweaver,6,6,0
Munkï,tichondrius,576,monk,mistweaver,6,6,0
Chrîstmas,proudmoore,576,monk,mistweaver,6,6,0
Bdâwg,frostmourne,576,monk,mistweaver,6,6,0
Brujitsu,thrall,576,monk,mistweaver,12,6,6
Wuwei,onyxia,576,monk,mistweaver,12,6,6
Jieterchan,malganis,576,monk,mistweaver,12,6,6
Lumiän,area-52,576,monk,mistweaver,12,6,6
Raonoc,sargeras,576,monk,mistweaver,12,6,6
Khungfeu,area-52,576,monk,mistweaver,12,6,6
Transcend,nerzhul,576,monk,mistweaver,12,6,6
Meisterbrew,garona,576,monk,mistweaver,12,6,6
Sekushî,kelthuzad,576,monk,mistweaver,12,6,6
Bearmode,wyrmrest-accord,576,monk,mistweaver,12,6,6
Underpants,skullcrusher,576,monk,mistweaver,12,6,6
Krob,bleeding-hollow,576,monk,mistweaver,12,6,6
Saitamâ,tichondrius,576,monk,mistweaver,12,6,6
Imakeplaysyo,illidan,576,monk,mistweaver,12,6,6
Kaztíel,ragnaros,576,monk,mistweaver,12,6,6
Fïish,stormrage,576,monk,mistweaver,12,6,6
Gnomshini,proudmoore,576,monk,mistweaver,12,6,6
Ñightingale,queldorei,576,monk,mistweaver,12,6,6
Xitearith,ragnaros,576,monk,mistweaver,12,6,6
Nukeproof,stormreaver,576,monk,mistweaver,12,6,6
Cerrado,emerald-dream,576,monk,mistweaver,12,6,6
Grimaku,tichondrius,576,monk,mistweaver,12,6,6
Dungfish,mugthol,576,monk,mistweaver,12,6,6
Vayce,barthilas,576,monk,mistweaver,12,6,6
Peachtea,burning-legion,576,monk,mistweaver,12,6,6
Shaqkobe,stormrage,576,monk,mistweaver,12,6,6
Aerlin,tichondrius,576,monk,mistweaver,12,6,6
Demisodax,tichondrius,576,monk,mistweaver,12,6,6
Aiswalle,illidan,576,monk,mistweaver,12,6,6
Magnustavick,bleeding-hollow,576,monk,mistweaver,12,6,6
Janim,illidan,576,monk,mistweaver,12,6,6
Danceofchiji,tichondrius,576,monk,mistweaver,12,6,6
Karrigwyn,tichondrius,576,monk,mistweaver,12,6,6
Mtsalt,bleeding-hollow,576,monk,mistweaver,12,6,6
Até,azralon,576,monk,mistweaver,12,6,6
Boppweave,tichondrius,576,monk,mistweaver,12,6,6
Wèave,tichondrius,576,monk,mistweaver,12,6,6
Eightpoint,illidan,576,monk,mistweaver,12,6,6
Dreamfist,emerald-dream,576,monk,mistweaver,12,6,6
Dracc,zuljin,576,monk,mistweaver,12,6,6
Pai,sargeras,576,monk,mistweaver,12,6,6
Faccemelter,illidan,576,monk,mistweaver,12,6,6
Sumaran,hydraxis,576,monk,mistweaver,12,6,6
Billycobham,tichondrius,576,monk,mistweaver,12,6,6
Steyi,nazjatar,576,monk,mistweaver,12,6,6
Broyoulined,spirestone,576,monk,mistweaver,12,6,6
Mwgapper,sargeras,576,monk,mistweaver,18,6,12
Simarity,kelthuzad,576,monk,mistweaver,18,6,12
Tragictea,zuljin,576,monk,mistweaver,18,6,12
Fistweebin,area-52,576,monk,mistweaver,18,6,12
Philthyjutsu,moon-guard,575,monk,mistweaver,6,6,0
Littlegeorge,moon-guard,575,monk,mistweaver,6,6,0
Kafuru,quelthalas,575,monk,mistweaver,10,7,3
Putisucia,nordrassil,575,monk,mistweaver,12,6,6
Biglinky,sargeras,575,monk,mistweaver,12,6,6
Itsjohnnylol,azuremyst,575,monk,mistweaver,12,6,6
Glitchi,area-52,575,monk,mistweaver,12,6,6
Medge,kelthuzad,575,monk,mistweaver,12,6,6
Clytpuncher,emerald-dream,575,monk,mistweaver,12,6,6
Nf,zuljin,575,monk,mistweaver,12,6,6
Kung,tichondrius,575,monk,mistweaver,12,6,6
Soysaucë,malganis,575,monk,mistweaver,12,6,6
Laopow,area-52,575,monk,mistweaver,12,6,6
Misha,akama,575,monk,mistweaver,12,6,6
Hibìscus,tichondrius,575,monk,mistweaver,12,6,6
Xinn,kiljaeden,575,monk,mistweaver,12,6,6
Fânnybâws,stormrage,575,monk,mistweaver,12,6,6
Morhe,the-forgotten-coast,575,monk,mistweaver,12,6,6
Ormchi,stormrage,575,monk,mistweaver,13,6,7
Freepunchz,frostmourne,575,monk,mistweaver,18,6,12
Opmother,elune,575,monk,mistweaver,18,6,12
Neww,tichondrius,575,monk,mistweaver,18,6,12
Blorkk,area-52,574,monk,mistweaver,12,6,6
Touchkarma,stormrage,574,monk,mistweaver,12,6,6
Yanedin,dalaran,574,monk,mistweaver,12,6,6
Shihfu,azralon,574,monk,mistweaver,18,6,12
Monjepa,illidan,574,monk,mistweaver,18,6,12
Tubbytiph,ghostlands,574,monk,mistweaver,24,6,18
Bluemyselph,tichondrius,573,monk,mistweaver,18,6,12
Mënace,skullcrusher,572,monk,mistweaver,12,6,6
Dokuho,silvermoon,572,monk,mistweaver,12,6,6
Gaturis,tichondrius,572,monk,mistweaver,21,7,14
Bógus,tichondrius,571,monk,mistweaver,12,6,6
Samanosukee,illidan,571,monk,mistweaver,12,6,6
Paladinei,tichondrius,571,monk,mistweaver,12,6,6
Keekismonk,gorefiend,566,monk,mistweaver,12,6,6
Dejohnette,quelthalas,565,monk,mistweaver,12,6,6
Boofie,perenolde,559,monk,mistweaver,11,6,5
Gyunyumanjuu,proudmoore,559,monk,mistweaver,11,6,5
Sohéi,proudmoore,559,monk,mistweaver,17,6,11
Monkeybooze,sargeras,543,monk,mistweaver,14,7,7
Yookho,tichondrius,527,monk,mistweaver,11,7,4
Domisalamii,sargeras,527,monk,mistweaver,11,6,5
Mfmiscreant,illidan,522,monk,mistweaver,22,7,15
Mastamonksta,illidan,512,monk,mistweaver,16,6,10
Räyè,tichondrius,511,monk,mistweaver,8,6,2
Immamonkey,tichondrius,511,monk,mistweaver,10,6,4
Oldmanwalker,mannoroth,511,monk,mistweaver,11,6,5
Tbrew,area-52,511,monk,mistweaver,14,6,8
Çät,frostmourne,511,monk,mistweaver,14,6,8
Healyboi,bronzebeard,511,monk,mistweaver,16,6,10
Figurines,sargeras,496,monk,mistweaver,19,6,13
Roskoh,area-52,493,monk,mistweaver,19,6,13
Koyon,sargeras,480,monk,mistweaver,6,5,1
Rivnn,sargeras,480,monk,mistweaver,6,5,1
Zbhm,illidan,480,monk,mistweaver,6,5,1
Meepz,arthas,480,monk,mistweaver,6,5,1
Spirits,dreadmaul,480,monk,mistweaver,6,5,1
Zammymonk,area-52,480,monk,mistweaver,6,5,1
Chingwang,frostmourne,480,monk,mistweaver,6,5,1
Donatello,arthas,480,monk,mistweaver,6,5,1
Jaige,illidan,480,monk,mistweaver,6,5,1
Kayflock,tichondrius,480,monk,mistweaver,6,5,1
Yuldaddy,tichondrius,480,monk,mistweaver,6,5,1
Swiixm,frostmourne,480,monk,mistweaver,6,5,1
Elcidw,tichondrius,480,monk,mistweaver,6,5,1
Getswept,area-52,480,monk,mistweaver,6,5,1
Yajirobei,area-52,480,monk,mistweaver,6,5,1
Satiremaster,frostmourne,480,monk,mistweaver,6,5,1
Møzy,darkspear,480,monk,mistweaver,6,5,1
Prf,ragnaros,480,monk,mistweaver,6,5,1
Pungeebi,tichondrius,480,monk,mistweaver,6,5,1
Siddharthä,barthilas,480,monk,mistweaver,6,5,1
Genia,ragnaros,480,monk,mistweaver,6,5,1
Stepfíster,tichondrius,480,monk,mistweaver,6,5,1
Dragonwarior,zuluhed,480,monk,mistweaver,6,5,1
Jurassaf,illidan,480,monk,mistweaver,6,5,1
Pinot,dragonmaw,480,monk,mistweaver,6,5,1
Alvinete,tichondrius,480,monk,mistweaver,6,5,1
Zhuangnimane,tichondrius,480,monk,mistweaver,6,5,1
Theodôn,dalaran,480,monk,mistweaver,6,5,1
Fangerlia,moon-guard,480,monk,mistweaver,6,5,1
Pyoapple,tichondrius,480,monk,mistweaver,6,5,1
Møzy,tichondrius,480,monk,mistweaver,6,5,1
Ceronash,dalaran,480,monk,mistweaver,6,5,1
Mistwalk,tichondrius,480,monk,mistweaver,6,5,1
Grumpî,tichondrius,480,monk,mistweaver,6,5,1
Pandatong,tichondrius,480,monk,mistweaver,6,5,1
Tamagotchi,emerald-dream,480,monk,mistweaver,6,5,1
Choibaedal,tichondrius,480,monk,mistweaver,7,5,2
Kaiøken,tichondrius,480,monk,mistweaver,12,5,7
Vashnir,lothar,480,monk,mistweaver,12,5,7
Otzyy,turalyon,480,monk,mistweaver,12,5,7
Chronost,sargeras,480,monk,mistweaver,12,5,7
Bigolbootay,tichondrius,480,monk,mistweaver,12,5,7
Onak,illidan,480,monk,mistweaver,12,5,7
Fortyozkilla,thrall,480,monk,mistweaver,12,5,7
Nîxs,frostmourne,480,monk,mistweaver,12,5,7
Kungfused,antonidas,480,monk,mistweaver,12,5,7
Piece,blackrock,480,monk,mistweaver,12,5,7
Crìstiano,malganis,480,monk,mistweaver,12,5,7
Palumorww,deathwing,480,monk,mistweaver,12,5,7
Judo,khadgar,480,monk,mistweaver,12,5,7
Palden,blackrock,480,monk,mistweaver,12,5,7
Duckpond,nerzhul,480,monk,mistweaver,12,5,7
Eraticmonk,illidan,480,monk,mistweaver,12,5,7
Rockyßalboa,sargeras,480,monk,mistweaver,12,5,7
Xavelha,tichondrius,480,monk,mistweaver,12,5,7
Ouibaguette,kelthuzad,480,monk,mistweaver,12,5,7
Nawzhy,emerald-dream,480,monk,mistweaver,12,5,7
Amybaby,sargeras,480,monk,mistweaver,12,5,7
Masonn,kiljaeden,480,monk,mistweaver,12,5,7
Catchmemaybe,stormscale,480,monk,mistweaver,12,5,7
Whipllash,tichondrius,480,monk,mistweaver,12,5,7
Paradissô,tichondrius,480,monk,mistweaver,12,5,7
Gnarmony,malganis,480,monk,mistweaver,12,5,7
Btipton,tichondrius,480,monk,mistweaver,12,5,7
Biggyballs,tichondrius,480,monk,mistweaver,12,5,7
Danceschi,area-52,480,monk,mistweaver,12,5,7
Ocmonk,hyjal,480,monk,mistweaver,12,5,7
Màngø,ragnaros,480,monk,mistweaver,18,5,13
Bruiseu,illidan,480,monk,mistweaver,18,5,13
Blackflag,queldorei,480,monk,mistweaver,18,5,13
Cckknckr,sargeras,480,monk,mistweaver,24,5,19
Patman,nazjatar,479,monk,mistweaver,6,5,1
Badkarmasix,tichondrius,479,monk,mistweaver,6,5,1
Monqq,tichondrius,479,monk,mistweaver,6,5,1
Bitrau,destromath,479,monk,mistweaver,12,5,7
Tianhu,sargeras,479,monk,mistweaver,12,5,7
Angrybrewski,tichondrius,479,monk,mistweaver,12,5,7
Paticus,area-52,479,monk,mistweaver,12,5,7
Wisepaw,tichondrius,479,monk,mistweaver,12,5,7
Stephani,turalyon,479,monk,mistweaver,12,5,7
Jayjaybrew,area-52,479,monk,mistweaver,12,5,7
Annara,tichondrius,479,monk,mistweaver,12,5,7
Tigmo,alleria,479,monk,mistweaver,12,5,7
Troutz,sargeras,479,monk,mistweaver,12,5,7
Satchelgizmo,tichondrius,479,monk,mistweaver,18,5,13
Ltsneaky,bladefist,479,monk,mistweaver,30,5,25
Shmello,akama,478,monk,mistweaver,6,5,1
Sahalee,emerald-dream,478,monk,mistweaver,12,5,7
Cahuun,baelgun,478,monk,mistweaver,12,5,7
Safigirl,doomhammer,478,monk,mistweaver,12,5,7
Tutulee,tichondrius,477,monk,mistweaver,6,5,1
Yungsun,ragnaros,463,monk,mistweaver,13,6,7
Drgigglez,tichondrius,463,monk,mistweaver,11,5,6
Whatdaheal,darkspear,451,monk,mistweaver,36,9,27
Foomanshoes,shandris,448,monk,mistweaver,22,5,17
Bengal,arthas,447,monk,mistweaver,11,5,6
Onlyhands,whisperwind,446,monk,mistweaver,11,5,6
Beefdadyfist,tichondrius,440,monk,mistweaver,24,8,16
Supmybrew,frostmourne,431,monk,mistweaver,11,5,6
Indrazzxx,jubeithos,426,monk,mistweaver,11,7,4
Bellátíx,quelthalas,426,monk,mistweaver,17,9,8
Obàma,tichondrius,426,monk,mistweaver,13,6,7
Matsakaicin,azralon,426,monk,mistweaver,16,6,10
Durath,burning-blade,415,monk,mistweaver,10,5,5
Danie,nerzhul,384,monk,mistweaver,6,4,2
Tinyboots,area-52,384,monk,mistweaver,6,4,2
Ufs,illidan,384,monk,mistweaver,6,4,2
Snoogiee,khazgoroth,384,monk,mistweaver,6,4,2
Avendare,tichondrius,384,monk,mistweaver,6,4,2
Srgtbingo,azgalor,384,monk,mistweaver,6,4,2
Globalmonk,emerald-dream,384,monk,mistweaver,6,4,2
Bamboozile,arthas,384,monk,mistweaver,6,4,2
Zamzae,tichondrius,384,monk,mistweaver,6,4,2
Jmonks,stormrage,384,monk,mistweaver,6,4,2
Dude,tichondrius,384,monk,mistweaver,6,4,2
Brantkicks,tichondrius,384,monk,mistweaver,6,4,2
Kokochiggy,tichondrius,384,monk,mistweaver,6,4,2
Nipfuu,maelstrom,384,monk,mistweaver,6,4,2
Teddybéar,illidan,384,monk,mistweaver,6,4,2
Blpkosher,tichondrius,384,monk,mistweaver,6,4,2
Lyla,aegwynn,384,monk,mistweaver,6,4,2
Monkatron,arthas,384,monk,mistweaver,6,4,2
Freeoni,sargeras,384,monk,mistweaver,6,4,2
Jâzze,zuljin,384,monk,mistweaver,6,4,2
Kobuya,tichondrius,384,monk,mistweaver,6,4,2
Mêlon,tichondrius,384,monk,mistweaver,6,4,2
Ericfu,tichondrius,384,monk,mistweaver,6,4,2
Treysongz,illidan,384,monk,mistweaver,6,4,2
Kwazinator,area-52,384,monk,mistweaver,6,4,2
Crentist,mannoroth,384,monk,mistweaver,6,4,2
Kharazina,azralon,384,monk,mistweaver,6,4,2
Lingerer,aerie-peak,384,monk,mistweaver,6,4,2
Macnia,frostmourne,384,monk,mistweaver,6,4,2
Justamönk,moon-guard,384,monk,mistweaver,6,4,2
Renzin,gilneas,384,monk,mistweaver,6,4,2
Brucetea,chogall,384,monk,mistweaver,6,4,2
Dontchattome,sargeras,384,monk,mistweaver,6,4,2
Balduglybaby,tichondrius,384,monk,mistweaver,6,4,2
Rizzjutsu,stormrage,384,monk,mistweaver,6,4,2
Jellobag,frostmane,384,monk,mistweaver,6,4,2
Keepcryin,gorefiend,384,monk,mistweaver,6,4,2
Keyndanlamor,sargeras,384,monk,mistweaver,6,4,2
Talker,stormrage,384,monk,mistweaver,6,4,2
Howziexd,tichondrius,384,monk,mistweaver,6,4,2
Shakeweightt,blackrock,384,monk,mistweaver,6,4,2
Nakiki,cenarion-circle,384,monk,mistweaver,6,4,2
Dakism,sargeras,384,monk,mistweaver,6,4,2
Doodoodookie,thunderhorn,384,monk,mistweaver,6,4,2
Nikitip,tichondrius,384,monk,mistweaver,6,4,2
Nezkabad,frostmourne,384,monk,mistweaver,6,4,2
Mõnk,illidan,384,monk,mistweaver,12,4,8
Mccoy,quelthalas,384,monk,mistweaver,12,4,8
Manxxin,illidan,384,monk,mistweaver,12,4,8
Argoholic,proudmoore,384,monk,mistweaver,12,4,8
Nutbag,norgannon,384,monk,mistweaver,12,4,8
Pax,boulderfist,384,monk,mistweaver,12,4,8
Hoyocochino,quelthalas,384,monk,mistweaver,12,4,8
Fistorcstar,daggerspine,384,monk,mistweaver,12,4,8
Sim,frostmourne,384,monk,mistweaver,12,4,8
Tanipto,tichondrius,384,monk,mistweaver,12,4,8
Zënløvë,tichondrius,384,monk,mistweaver,12,4,8
Pandàmonium,frostmourne,384,monk,mistweaver,12,4,8
Valkana,kelthuzad,384,monk,mistweaver,12,4,8
Neversweep,tichondrius,384,monk,mistweaver,12,4,8
Shredmw,tichondrius,384,monk,mistweaver,12,4,8
Crakgirl,malganis,384,monk,mistweaver,12,4,8
Sprinkli,sargeras,384,monk,mistweaver,12,4,8
Rxtea,darkspear,384,monk,mistweaver,12,4,8
Darkeiji,stormrage,384,monk,mistweaver,12,4,8
Darylphilbin,emerald-dream,384,monk,mistweaver,12,4,8
Macktickle,zuljin,384,monk,mistweaver,12,4,8
Migchi,sargeras,384,monk,mistweaver,12,4,8
Fluffykaboom,destromath,384,monk,mistweaver,12,4,8
Windwalken,sargeras,384,monk,mistweaver,12,4,8
Jincíe,area-52,384,monk,mistweaver,12,4,8
Jimbojenkins,bleeding-hollow,384,monk,mistweaver,12,4,8
Eqoy,moon-guard,384,monk,mistweaver,12,4,8
Nicolascåge,destromath,384,monk,mistweaver,12,4,8
Mockz,dentarg,384,monk,mistweaver,12,4,8
Iamapotato,tichondrius,384,monk,mistweaver,18,4,14
Åvå,emerald-dream,384,monk,mistweaver,18,4,14
Zyemell,tichondrius,383,monk,mistweaver,12,4,8
Jigong,bleeding-hollow,383,monk,mistweaver,12,4,8
Esleif,moonrunner,383,monk,mistweaver,12,4,8
Izgoku,frostmane,383,monk,mistweaver,18,4,14
Rollbot,kelthuzad,382,monk,mistweaver,6,4,2
Lushona,ragnaros,382,monk,mistweaver,6,4,2
Drzoid,thrall,382,monk,mistweaver,12,4,8
Sence,lightnings-blade,382,monk,mistweaver,18,4,14
Saltyone,firetree,351,monk,mistweaver,8,5,3
Sáble,stormrage,351,monk,mistweaver,11,4,7
Lenakai,malganis,351,monk,mistweaver,11,4,7
Bakus,tichondrius,336,monk,mistweaver,11,5,6
ßiggiesmallz,barthilas,330,monk,mistweaver,12,5,7
Kimchidelite,gorefiend,319,monk,mistweaver,5,4,1
Drkeen,frostmourne,288,monk,mistweaver,10,5,5
Aphrodîîte,area-52,288,monk,mistweaver,6,3,3
Ryukenshin,proudmoore,288,monk,mistweaver,6,3,3
Bosschops,illidan,288,monk,mistweaver,6,3,3
Fistër,area-52,288,monk,mistweaver,6,3,3
Berzerk,dalvengyr,288,monk,mistweaver,6,3,3
Notcheez,area-52,288,monk,mistweaver,6,3,3
Kotonnoha,quelthalas,288,monk,mistweaver,6,3,3
Orgrrim,area-52,288,monk,mistweaver,6,3,3
Lundch,tichondrius,288,monk,mistweaver,6,3,3
Maybeyooshi,kelthuzad,288,monk,mistweaver,6,3,3
Foxjade,thrall,288,monk,mistweaver,6,3,3
Ðreadhot,malganis,288,monk,mistweaver,6,3,3
Darkjab,tichondrius,288,monk,mistweaver,6,3,3
Sterow,kiljaeden,288,monk,mistweaver,6,3,3
Macproblem,malganis,288,monk,mistweaver,6,3,3
Ighostgirls,thrall,288,monk,mistweaver,6,3,3
Seii,ravenholdt,288,monk,mistweaver,6,3,3
Tambher,lightbringer,288,monk,mistweaver,6,3,3
Grogio,wyrmrest-accord,288,monk,mistweaver,6,3,3
Gguldduck,tichondrius,288,monk,mistweaver,6,3,3
Teclas,ragnaros,288,monk,mistweaver,6,3,3
Mystï,silvermoon,288,monk,mistweaver,6,3,3
Arinix,tichondrius,288,monk,mistweaver,6,3,3
Maripaulita,ragnaros,288,monk,mistweaver,6,3,3
Imisswodxo,illidan,288,monk,mistweaver,6,3,3
Fistin,laughing-skull,288,monk,mistweaver,6,3,3
Zeelos,kelthuzad,288,monk,mistweaver,6,3,3
Möösê,moon-guard,288,monk,mistweaver,6,3,3
Phlexz,jubeithos,288,monk,mistweaver,6,3,3
Streetcreds,bleeding-hollow,288,monk,mistweaver,6,3,3
Hundski,bleeding-hollow,288,monk,mistweaver,6,3,3
Chingu,ragnaros,288,monk,mistweaver,6,3,3
Greenteafrãp,bleeding-hollow,288,monk,mistweaver,6,3,3
Graoul,thaurissan,288,monk,mistweaver,6,3,3
Rzeznik,boulderfist,288,monk,mistweaver,6,3,3
Loppjr,tichondrius,288,monk,mistweaver,6,3,3
Vidrus,gorefiend,288,monk,mistweaver,6,3,3
Kayla,ursin,288,monk,mistweaver,6,3,3
Austaar,frostmourne,288,monk,mistweaver,6,3,3
Monaks,barthilas,288,monk,mistweaver,6,3,3
Madson,darkspear,288,monk,mistweaver,6,3,3
Ase,frostwolf,288,monk,mistweaver,6,3,3
Rasgacrú,stormrage,288,monk,mistweaver,6,3,3
Zchi,zuljin,288,monk,mistweaver,6,3,3
Giggacuck,frostmourne,288,monk,mistweaver,6,3,3
Shadowbringr,proudmoore,288,monk,mistweaver,6,3,3
Mythsmonkx,barthilas,288,monk,mistweaver,6,3,3
Lindraice,illidan,288,monk,mistweaver,6,3,3
Abevx,bonechewer,288,monk,mistweaver,6,3,3
Stunnedheals,arthas,288,monk,mistweaver,6,3,3
Mingfei,uther,288,monk,mistweaver,6,3,3
Feelsogöod,tichondrius,288,monk,mistweaver,6,3,3
Yaloon,stormrage,288,monk,mistweaver,6,3,3
Lemeta,tichondrius,288,monk,mistweaver,6,3,3
Zzizzi,tichondrius,288,monk,mistweaver,6,3,3
Növa,alterac-mountains,288,monk,mistweaver,6,3,3
Zaçh,frostmane,288,monk,mistweaver,6,3,3
Polyphia,lothar,288,monk,mistweaver,6,3,3
Lyántrying,korgath,288,monk,mistweaver,6,3,3
Furrykisser,tichondrius,288,monk,mistweaver,6,3,3
Fammi,stormrage,288,monk,mistweaver,6,3,3
Cädemaddöx,stormrage,288,monk,mistweaver,6,3,3
Fysicalx,stormrage,288,monk,mistweaver,6,3,3
Spacoli,stormrage,288,monk,mistweaver,6,3,3
Densíty,kiljaeden,288,monk,mistweaver,6,3,3
Stigzz,stormrage,288,monk,mistweaver,6,3,3
Voguex,area-52,288,monk,mistweaver,6,3,3
Quartztiger,sargeras,288,monk,mistweaver,6,3,3
Droppinfast,sargeras,288,monk,mistweaver,6,3,3
Cannenmonk,sargeras,288,monk,mistweaver,6,3,3
Omnivò,emerald-dream,288,monk,mistweaver,6,3,3
Monkêy,ghostlands,288,monk,mistweaver,6,3,3
Spiritmist,sargeras,288,monk,mistweaver,6,3,3
Miýagi,sargeras,288,monk,mistweaver,6,3,3
ßöe,sargeras,288,monk,mistweaver,6,3,3
Swansational,sargeras,288,monk,mistweaver,6,3,3
Thatfknguy,sargeras,288,monk,mistweaver,6,3,3
Slimweaver,stormrage,288,monk,mistweaver,11,4,7
Kúrios,azralon,288,monk,mistweaver,10,3,7
Fitofryfitof,aegwynn,288,monk,mistweaver,12,3,9
Øtpp,sargeras,288,monk,mistweaver,12,3,9
Chilliweaver,frostmourne,288,monk,mistweaver,12,3,9
Korvishka,malganis,288,monk,mistweaver,12,3,9
Mwtouch,nemesis,288,monk,mistweaver,12,3,9
Selfîe,ysera,288,monk,mistweaver,12,3,9
Absolutvodca,nemesis,288,monk,mistweaver,12,3,9
Awwchi,tichondrius,288,monk,mistweaver,12,3,9
Vchii,tichondrius,288,monk,mistweaver,12,3,9
Wørm,emerald-dream,288,monk,mistweaver,12,3,9
Wizcaulifa,stormrage,288,monk,mistweaver,12,3,9
Katalina,alexstrasza,288,monk,mistweaver,12,3,9
Deyseddia,azgalor,287,monk,mistweaver,6,3,3
Rosinhood,illidan,287,monk,mistweaver,6,3,3
Gatsbi,arthas,287,monk,mistweaver,6,3,3
Holandri,moon-guard,287,monk,mistweaver,6,3,3
Alanimistw,khadgar,287,monk,mistweaver,6,3,3
Starskreem,tichondrius,287,monk,mistweaver,6,3,3
Fistidmi,area-52,287,monk,mistweaver,11,4,7
Shlumpuh,tichondrius,287,monk,mistweaver,16,4,12
Uninvited,perenolde,286,monk,mistweaver,6,3,3
Lilpielover,zuljin,286,monk,mistweaver,15,4,11
Braindi,arathor,271,monk,mistweaver,11,3,8
Fiztingfaded,area-52,265,monk,mistweaver,20,6,14
Lildae,burning-legion,256,monk,mistweaver,4,4,0
Koragro,tichondrius,239,monk,mistweaver,5,3,2
Zeisei,wyrmrest-accord,234,monk,mistweaver,10,4,6
Friedpanda,kelthuzad,234,monk,mistweaver,16,4,12
Hirado,kelthuzad,234,monk,mistweaver,16,4,12
Raymond,malganis,192,monk,mistweaver,4,3,1
Hunchojack,undermine,192,monk,mistweaver,4,3,1
Furryfisttin,illidan,192,monk,mistweaver,8,3,5
Fäded,trollbane,192,monk,mistweaver,6,2,4
Flagreturned,illidan,192,monk,mistweaver,6,2,4
Aquamonk,tichondrius,192,monk,mistweaver,6,2,4
Monky,black-dragonflight,192,monk,mistweaver,6,2,4
Iililiililil,stormrage,192,monk,mistweaver,6,2,4
Hugerichard,wyrmrest-accord,192,monk,mistweaver,6,2,4
Theriní,stormrage,192,monk,mistweaver,6,2,4
Silkymoves,tichondrius,192,monk,mistweaver,6,2,4
Privm,moonrunner,192,monk,mistweaver,6,2,4
Skadouch,wyrmrest-accord,192,monk,mistweaver,6,2,4
Jittersx,silvermoon,192,monk,mistweaver,6,2,4
Prodigious,illidan,192,monk,mistweaver,6,2,4
Hitchslapz,tichondrius,192,monk,mistweaver,6,2,4
Rubntug,zuljin,192,monk,mistweaver,6,2,4
Odradek,thunderlord,192,monk,mistweaver,6,2,4
Banidiin,moon-guard,192,monk,mistweaver,6,2,4
Melocotonn,goldrinn,192,monk,mistweaver,6,2,4
Zengoku,zuljin,192,monk,mistweaver,6,2,4
Sebasu,perenolde,192,monk,mistweaver,6,2,4
Selocke,bleeding-hollow,192,monk,mistweaver,6,2,4
Foxmacleod,bleeding-hollow,192,monk,mistweaver,6,2,4
Tigerlust,sargeras,192,monk,mistweaver,6,2,4
Caralia,exodar,192,monk,mistweaver,6,2,4
Kîkû,moon-guard,192,monk,mistweaver,6,2,4
Lilknucks,bonechewer,192,monk,mistweaver,6,2,4
Bamboøzled,daggerspine,192,monk,mistweaver,6,2,4
Tàekwondo,drakkari,192,monk,mistweaver,6,2,4
Tarae,nagrand,192,monk,mistweaver,6,2,4
Streetjezus,bloodhoof,192,monk,mistweaver,6,2,4
Kåelarayn,moon-guard,192,monk,mistweaver,6,2,4
Dustyweaver,illidan,192,monk,mistweaver,6,2,4
Feihung,executus,192,monk,mistweaver,6,2,4
Jaybum,sargeras,192,monk,mistweaver,6,2,4
Mistbeard,aggramar,192,monk,mistweaver,6,2,4
Zåz,nazgrel,192,monk,mistweaver,6,2,4
Dreadneck,sargeras,192,monk,mistweaver,6,2,4
Ashenn,area-52,192,monk,mistweaver,6,2,4
Wamii,tichondrius,192,monk,mistweaver,6,2,4
Fïstbeaver,malganis,192,monk,mistweaver,6,2,4
Bodyshot,area-52,192,monk,mistweaver,6,2,4
Fortnight,emerald-dream,192,monk,mistweaver,6,2,4
Xanzee,area-52,192,monk,mistweaver,6,2,4
Lackofsleep,tichondrius,192,monk,mistweaver,6,2,4
Drfistyfingr,malganis,192,monk,mistweaver,6,2,4
Acena,stormrage,192,monk,mistweaver,6,2,4
Apparent,lightnings-blade,192,monk,mistweaver,6,2,4
Nilonsso,sargeras,192,monk,mistweaver,6,2,4
Onepunch,exodar,192,monk,mistweaver,7,2,5
Coffeek,area-52,192,monk,mistweaver,8,2,6
Whtnyhuston,sargeras,192,monk,mistweaver,8,2,6
Glowsgreenby,area-52,192,monk,mistweaver,8,2,6
Jooshy,tichondrius,192,monk,mistweaver,12,2,10
Mung,boulderfist,192,monk,mistweaver,12,2,10
Kick,dragonmaw,192,monk,mistweaver,12,2,10
Whynotec,tichondrius,192,monk,mistweaver,12,2,10
Ðetroitsmash,sargeras,192,monk,mistweaver,12,2,10
Missmagda,darkspear,192,monk,mistweaver,12,2,10
Hellcow,frostmourne,192,monk,mistweaver,12,2,10
Bubblekit,nerzhul,192,monk,mistweaver,12,2,10
Tacoma,sargeras,192,monk,mistweaver,12,2,10
Ixport,moon-guard,192,monk,mistweaver,12,2,10
Monkik,laughing-skull,192,monk,mistweaver,12,2,10
Sanytea,sargeras,192,monk,mistweaver,12,2,10
Chuggernaut,illidan,192,monk,mistweaver,15,2,13
Fatde,daggerspine,192,monk,mistweaver,18,2,16
Senzmist,lightbringer,191,monk,mistweaver,6,2,4
Jeme,tichondrius,191,monk,mistweaver,6,2,4
Realisthands,barthilas,191,monk,mistweaver,6,2,4
Honestworkz,area-52,191,monk,mistweaver,6,2,4
Rorik,deathwing,191,monk,mistweaver,12,2,10
Varlena,wyrmrest-accord,180,monk,mistweaver,15,6,9
Phystweaver,malganis,175,monk,mistweaver,11,2,9
Hyugga,azralon,159,monk,mistweaver,5,2,3
Craziediemon,malganis,138,monk,mistweaver,8,3,5
ßøøstêðçhåñ,illidan,138,monk,mistweaver,9,3,6
Fijiwater,stormrage,138,monk,mistweaver,9,3,6
Vyostao,ragnaros,138,monk,mistweaver,11,3,8
Averagéjoe,tichondrius,127,monk,mistweaver,8,2,6
Charrek,zuljin,96,monk,mistweaver,6,1,5
Notthefather,area-52,96,monk,mistweaver,6,1,5
Mënmä,ragnaros,96,monk,mistweaver,6,1,5
Kaÿñ,area-52,96,monk,mistweaver,6,1,5
Fatboyswag,tichondrius,96,monk,mistweaver,6,1,5
Kiawe,zuljin,96,monk,mistweaver,6,1,5
Samaera,uther,96,monk,mistweaver,6,1,5
Danicah,altar-of-storms,96,monk,mistweaver,6,1,5
Kimmyfists,tichondrius,96,monk,mistweaver,6,1,5
Ünarù,area-52,96,monk,mistweaver,6,1,5
Yunei,tichondrius,96,monk,mistweaver,6,1,5
Súprä,stormrage,96,monk,mistweaver,6,1,5
Brewtalìty,tichondrius,96,monk,mistweaver,6,1,5
Naveex,bleeding-hollow,96,monk,mistweaver,6,1,5
Ogmonk,skullcrusher,96,monk,mistweaver,6,1,5
Farmerstan,sargeras,96,monk,mistweaver,6,1,5
Lomist,nazjatar,96,monk,mistweaver,6,1,5
Zrza,tichondrius,96,monk,mistweaver,6,1,5
Voodubrew,area-52,96,monk,mistweaver,6,1,5
Ezpzmonk,bloodscalp,96,monk,mistweaver,6,1,5
Raylá,kelthuzad,96,monk,mistweaver,6,1,5
Monkuxe,zuljin,96,monk,mistweaver,6,1,5
Hedgefrogs,stormrage,96,monk,mistweaver,6,1,5
Frankènmonk,illidan,96,monk,mistweaver,6,1,5
Stickyloads,illidan,96,monk,mistweaver,6,1,5
Ruion,moon-guard,96,monk,mistweaver,6,1,5
Rockfu,illidan,96,monk,mistweaver,6,1,5
Shrimptown,dalaran,96,monk,mistweaver,6,1,5
Onegai,illidan,96,monk,mistweaver,6,1,5
Daeio,burning-legion,96,monk,mistweaver,6,1,5
Lainerya,moon-guard,96,monk,mistweaver,6,1,5
Kenvuki,emerald-dream,96,monk,mistweaver,6,1,5
Kungfucheeks,illidan,96,monk,mistweaver,6,1,5
Turkeydinner,frostmourne,96,monk,mistweaver,6,1,5
Findorato,windrunner,96,monk,mistweaver,6,1,5
Dankestkhan,korialstrasz,96,monk,mistweaver,6,1,5
Froggie,illidan,96,monk,mistweaver,6,1,5
Jamesboong,illidan,96,monk,mistweaver,6,1,5
Squidbillie,moon-guard,96,monk,mistweaver,6,1,5
Kayakpunch,moon-guard,96,monk,mistweaver,6,1,5
Faméd,stormrage,96,monk,mistweaver,8,1,7
Ghostsofur,tichondrius,96,monk,mistweaver,12,1,11
Nornangus,sargeras,96,monk,mistweaver,12,1,11
Eliwenn,ragnaros,96,monk,mistweaver,12,1,11
Zenmidget,kelthuzad,96,monk,mistweaver,12,1,11
Selectra,malfurion,95,monk,mistweaver,6,1,5
Sputnîk,nemesis,84,monk,mistweaver,16,6,10
Excitable,moon-guard,84,monk,mistweaver,11,4,7
Fairymonk,frostwolf,79,monk,mistweaver,5,1,4
Clixstermonk,area-52,79,monk,mistweaver,5,1,4
Thalreyzian,vashj,64,monk,mistweaver,4,1,3
Majinyooshi,kelthuzad,64,monk,mistweaver,4,1,3
Deethnutth,bleeding-hollow,63,monk,mistweaver,2,2,0
Mindengo,sargeras,42,monk,mistweaver,9,3,6
Fumoo,sargeras,42,monk,mistweaver,10,3,7
Sivedrafely,arthas,42,monk,mistweaver,17,2,15
Epucphail,kelthuzad,1221,monk,brewmaster,78,33,45
Worldpvp,nerzhul,1049,monk,brewmaster,33,12,21
Omgar,frostmourne,1046,monk,brewmaster,44,17,27
Daesun,quelthalas,672,monk,brewmaster,12,7,5
Morpheous,whisperwind,383,monk,brewmaster,6,4,2
Doughboy,skullcrusher,383,monk,brewmaster,12,4,8
Robbo,tichondrius,288,monk,brewmaster,6,3,3
Quaria,moon-guard,288,monk,brewmaster,18,3,15
Rín,dalaran,192,monk,brewmaster,6,2,4
Drunkfight,zuljin,192,monk,brewmaster,18,2,16
Encry,zuljin,191,monk,brewmaster,6,2,4
Ferrarí,quelthalas,79,monk,brewmaster,11,1,10
Iminglee,area-52,2280,monk,windwalker,106,57,49
Neighbors,sargeras,2265,monk,windwalker,103,58,45
Keyam,illidan,2208,monk,windwalker,101,54,47
Yerky,stormrage,2151,monk,windwalker,77,44,33
Sean,nazjatar,2143,monk,windwalker,72,38,34
Senseiww,sargeras,2143,monk,windwalker,126,64,62
Pacmankr,tichondrius,2135,monk,windwalker,153,80,73
Thewy,tichondrius,2132,monk,windwalker,108,55,53
Fueld,burning-legion,2130,monk,windwalker,306,157,149
Droguex,tichondrius,2128,monk,windwalker,222,111,111
Cmx,sargeras,2125,monk,windwalker,172,88,84
Judo,agamaggan,2123,monk,windwalker,81,43,38
Primez,frostmourne,2115,monk,windwalker,71,40,31
Riversøng,frostmourne,2115,monk,windwalker,84,46,38
Flattsww,tichondrius,2111,monk,windwalker,274,140,134
Stárset,illidan,2104,monk,windwalker,96,54,42
Iílílílílílí,area-52,2101,monk,windwalker,84,43,41
Catgallery,tichondrius,2100,monk,windwalker,203,105,98
Homun,tichondrius,2071,monk,windwalker,83,43,40
Fatal,bonechewer,2059,monk,windwalker,118,65,53
Rickybobbyx,vashj,2057,monk,windwalker,113,56,57
Chyx,tichondrius,2035,monk,windwalker,76,37,39
Liamllama,barthilas,2023,monk,windwalker,164,86,78
Hypnøtìze,frostmourne,2019,monk,windwalker,143,76,67
Fínzy,tichondrius,2017,monk,windwalker,167,88,79
Nehji,illidan,2008,monk,windwalker,99,52,47
Blackpandax,tichondrius,2008,monk,windwalker,107,55,52
Larryjonés,area-52,2003,monk,windwalker,161,80,81
Rytes,moon-guard,1993,monk,windwalker,159,83,76
Touchofdeáth,stormrage,1989,monk,windwalker,137,76,61
Baddi,uldum,1984,monk,windwalker,124,66,58
Cuteirl,tichondrius,1970,monk,windwalker,84,53,31
Lodbork,tichondrius,1970,monk,windwalker,371,193,178
Spotifyfan,ysera,1966,monk,windwalker,159,87,72
Crashandflow,zuljin,1961,monk,windwalker,60,33,27
Shïvïr,azralon,1961,monk,windwalker,147,77,70
Mikephoenix,tichondrius,1956,monk,windwalker,42,26,16
Bdw,tichondrius,1955,monk,windwalker,142,84,58
Bigherosixx,tichondrius,1941,monk,windwalker,66,36,30
Chopt,zuljin,1940,monk,windwalker,78,36,42
Repbrew,sargeras,1934,monk,windwalker,81,40,41
Vybïn,tichondrius,1932,monk,windwalker,264,135,129
Wondý,quelthalas,1931,monk,windwalker,173,86,87
Frootsmoothi,thrall,1929,monk,windwalker,77,38,39
Madtiger,scilla,1928,monk,windwalker,102,50,52
Wwlékinhø,azralon,1924,monk,windwalker,54,33,21
Sínsayer,tichondrius,1920,monk,windwalker,78,34,44
Serthean,illidan,1919,monk,windwalker,158,81,77
Marçi,moon-guard,1917,monk,windwalker,85,41,44
Edenx,sargeras,1906,monk,windwalker,48,27,21
Dzq,stormrage,1906,monk,windwalker,87,48,39
Weathermanxv,kelthuzad,1896,monk,windwalker,123,56,67
Xanaxåddict,sargeras,1893,monk,windwalker,179,94,85
Threnody,malganis,1891,monk,windwalker,82,39,43
Maozhën,tichondrius,1882,monk,windwalker,60,31,29
Jaxvisto,dalaran,1868,monk,windwalker,101,51,50
Screwz,tichondrius,1867,monk,windwalker,67,33,34
Artam,thrall,1859,monk,windwalker,65,40,25
Torkscrew,bleeding-hollow,1850,monk,windwalker,36,21,15
Syerzie,dalaran,1849,monk,windwalker,81,40,41
Guylian,tichondrius,1845,monk,windwalker,58,30,28
Tschi,illidan,1844,monk,windwalker,42,29,13
Helvectius,tichondrius,1843,monk,windwalker,192,90,102
Smokechief,hyjal,1841,monk,windwalker,48,27,21
Züdo,area-52,1841,monk,windwalker,105,55,50
Omnly,stormrage,1841,monk,windwalker,50,26,24
Allmight,wyrmrest-accord,1839,monk,windwalker,105,58,47
Absurd,mannoroth,1836,monk,windwalker,33,21,12
Kuranchi,sargeras,1836,monk,windwalker,42,23,19
Sunfistway,sargeras,1835,monk,windwalker,80,48,32
Karmerr,proudmoore,1835,monk,windwalker,66,35,31
Yuujitsu,sargeras,1827,monk,windwalker,114,59,55
Monkatron,arthas,1827,monk,windwalker,101,52,49
Lopez,sargeras,1825,monk,windwalker,54,35,19
Nelariah,wyrmrest-accord,1822,monk,windwalker,59,28,31
Sylash,ragnaros,1821,monk,windwalker,36,21,15
Sentomaru,bleeding-hollow,1820,monk,windwalker,66,33,33
Inbu,tichondrius,1820,monk,windwalker,87,39,48
Fátë,tichondrius,1819,monk,windwalker,96,42,54
Micai,thrall,1813,monk,windwalker,42,25,17
Jamut,stormrage,1812,monk,windwalker,54,23,31
Turbofist,bleeding-hollow,1803,monk,windwalker,42,25,17
Vai,korgath,1801,monk,windwalker,82,43,39
Accidntprone,zangarmarsh,1801,monk,windwalker,54,28,26
Muhli,kiljaeden,1800,monk,windwalker,42,22,20
Conngaline,stormreaver,1794,monk,windwalker,281,136,145
Brewceo,area-52,1787,monk,windwalker,66,34,32
Lahri,silvermoon,1786,monk,windwalker,68,41,27
Alps,darkspear,1780,monk,windwalker,48,24,24
Unhappyclown,tichondrius,1776,monk,windwalker,125,70,55
Rockyßalboa,sargeras,1774,monk,windwalker,85,50,35
Zionk,tichondrius,1768,monk,windwalker,96,68,28
Monkgyatso,drakthul,1761,monk,windwalker,114,60,54
Tristantwo,sargeras,1761,monk,windwalker,96,47,49
Furiamvp,stormrage,1759,monk,windwalker,48,26,22
Haharetsdead,illidan,1758,monk,windwalker,125,71,54
Jümmy,area-52,1757,monk,windwalker,54,26,28
Jåðëðrägøñ,sargeras,1745,monk,windwalker,61,36,25
Kagebunshin,kelthuzad,1744,monk,windwalker,42,25,17
Bruceteå,area-52,1744,monk,windwalker,36,19,17
Zynflex,tichondrius,1743,monk,windwalker,59,27,32
Lker,sargeras,1740,monk,windwalker,60,31,29
Snebyos,tichondrius,1739,monk,windwalker,72,43,29
Pandagirlw,tichondrius,1735,monk,windwalker,72,43,29
Ambal,hellscream,1734,monk,windwalker,55,32,23
Kárma,malganis,1731,monk,windwalker,42,24,18
Robbo,tichondrius,1730,monk,windwalker,54,25,29
Gigached,zuljin,1730,monk,windwalker,63,28,35
Jasey,area-52,1729,monk,windwalker,29,21,8
Jükedx,stormrage,1728,monk,windwalker,91,54,37
Mechamonk,aerie-peak,1728,monk,windwalker,105,46,59
Raphåel,area-52,1722,monk,windwalker,35,18,17
Percentx,tichondrius,1722,monk,windwalker,36,18,18
Khawai,sargeras,1720,monk,windwalker,36,23,13
Boostedww,bloodscalp,1720,monk,windwalker,48,25,23
Lhiri,moon-guard,1718,monk,windwalker,48,22,26
Takkeya,zuljin,1713,monk,windwalker,42,25,17
Zenluckydo,grizzly-hills,1712,monk,windwalker,71,41,30
Orkmonk,tichondrius,1708,monk,windwalker,42,28,14
Tenooki,illidan,1707,monk,windwalker,41,19,22
Tippytap,bleeding-hollow,1707,monk,windwalker,54,23,31
Setback,tichondrius,1706,monk,windwalker,24,18,6
Hiurge,tichondrius,1706,monk,windwalker,36,21,15
Tôpsônworld,tichondrius,1700,monk,windwalker,66,39,27
Titanus,chogall,1700,monk,windwalker,343,177,166
Pankekz,tichondrius,1698,monk,windwalker,132,69,63
Wolffangfist,sargeras,1695,monk,windwalker,75,45,30
Daracus,kelthuzad,1694,monk,windwalker,38,24,14
Napbox,bleeding-hollow,1694,monk,windwalker,92,44,48
Shírÿu,azralon,1691,monk,windwalker,41,24,17
Maomaogun,tichondrius,1687,monk,windwalker,30,23,7
Bamron,fizzcrank,1686,monk,windwalker,101,52,49
Shids,barthilas,1686,monk,windwalker,47,22,25
Watercowz,tichondrius,1684,monk,windwalker,24,18,6
Thåi,anubarak,1682,monk,windwalker,48,19,29
Vanmonk,eonar,1681,monk,windwalker,36,18,18
Ghooch,illidan,1676,monk,windwalker,48,27,21
Zhoku,tichondrius,1674,monk,windwalker,30,19,11
Jdanîel,ragnaros,1671,monk,windwalker,42,21,21
Zenigma,area-52,1670,monk,windwalker,45,24,21
Dea,thrall,1670,monk,windwalker,84,43,41
Rakije,barthilas,1669,monk,windwalker,66,40,26
Bigpoppap,tichondrius,1668,monk,windwalker,54,29,25
Madtigon,scilla,1668,monk,windwalker,42,22,20
Hèllòkîttý,illidan,1666,monk,windwalker,30,19,11
Hæt,stormrage,1665,monk,windwalker,48,23,25
Rigi,stormrage,1661,monk,windwalker,95,43,52
Bussÿ,area-52,1659,monk,windwalker,43,25,18
Hotwatertank,area-52,1658,monk,windwalker,48,29,19
Thuyvan,barthilas,1657,monk,windwalker,42,23,19
Adamthemonk,proudmoore,1654,monk,windwalker,39,26,13
Rockxtv,illidan,1651,monk,windwalker,42,18,24
Phistea,area-52,1648,monk,windwalker,36,19,17
Dumplíngs,emerald-dream,1647,monk,windwalker,59,27,32
Bearface,blades-edge,1646,monk,windwalker,82,33,49
Capiirotta,nemesis,1645,monk,windwalker,104,61,43
Mists,velen,1645,monk,windwalker,54,31,23
Oxli,emerald-dream,1645,monk,windwalker,46,26,20
Ludanford,eitrigg,1643,monk,windwalker,48,22,26
Öñlýfåñs,tichondrius,1642,monk,windwalker,35,20,15
Foxchik,zuljin,1641,monk,windwalker,76,42,34
Sonsia,arthas,1639,monk,windwalker,94,56,38
Galaxystrike,illidan,1638,monk,windwalker,36,20,16
Akumà,tichondrius,1636,monk,windwalker,48,19,29
Lidä,tichondrius,1636,monk,windwalker,48,18,30
Jaspier,quelthalas,1633,monk,windwalker,48,24,24
Ranchy,zuljin,1631,monk,windwalker,78,41,37
Kungpóa,sargeras,1628,monk,windwalker,39,23,16
Senritsuh,drakkari,1625,monk,windwalker,40,18,22
Ddoongmonk,tichondrius,1625,monk,windwalker,48,21,27
Plucky,tichondrius,1624,monk,windwalker,37,18,19
Tnsnow,illidan,1623,monk,windwalker,36,21,15
Saucyfists,silvermoon,1622,monk,windwalker,48,26,22
Fistyuh,illidan,1621,monk,windwalker,30,20,10
Fuqmeh,darkspear,1621,monk,windwalker,84,42,42
Jigong,bleeding-hollow,1620,monk,windwalker,42,23,19
Karelio,wyrmrest-accord,1619,monk,windwalker,48,22,26
Aidenww,area-52,1618,monk,windwalker,24,17,7
Jerax,thunderlord,1617,monk,windwalker,97,55,42
Fimeu,kiljaeden,1617,monk,windwalker,54,28,26
Corsan,illidan,1616,monk,windwalker,42,30,12
Hadoukeñ,thrall,1616,monk,windwalker,41,22,19
Jbills,muradin,1615,monk,windwalker,71,41,30
Singao,malganis,1614,monk,windwalker,38,21,17
Zeati,tichondrius,1613,monk,windwalker,24,17,7
Azizyzz,barthilas,1613,monk,windwalker,30,20,10
Euman,sargeras,1613,monk,windwalker,36,21,15
Shaszx,zuljin,1613,monk,windwalker,41,22,19
Themanski,area-52,1612,monk,windwalker,46,24,22
Cpapi,sargeras,1612,monk,windwalker,60,30,30
Fapmonk,illidan,1611,monk,windwalker,59,39,20
Xradu,dawnbringer,1611,monk,windwalker,66,41,25
Mastâ,kelthuzad,1610,monk,windwalker,98,50,48
Fistnu,aggramar,1608,monk,windwalker,83,49,34
Bakedmonk,smolderthorn,1608,monk,windwalker,46,22,24
Windmónk,tichondrius,1606,monk,windwalker,120,56,64
Shisama,area-52,1605,monk,windwalker,24,17,7
Daeio,burning-legion,1605,monk,windwalker,31,19,12
Rennafgc,stormrage,1605,monk,windwalker,36,20,16
Flyingfury,illidan,1604,monk,windwalker,54,25,29
Chongzly,frostmourne,1602,monk,windwalker,54,28,26
Hím,garrosh,1601,monk,windwalker,70,43,27
Bruhmesoftly,thrall,1601,monk,windwalker,60,34,26
Pepeloser,illidan,1601,monk,windwalker,48,23,25
Ronk,the-forgotten-coast,1600,monk,windwalker,30,17,13
Dirtypunch,proudmoore,1598,monk,windwalker,42,19,23
Windwalker,blackhand,1597,monk,windwalker,35,19,16
Mitras,dragonblight,1594,monk,windwalker,30,19,11
Lingerer,aerie-peak,1593,monk,windwalker,110,57,53
Marcusm,bleeding-hollow,1592,monk,windwalker,33,20,13
Surgarush,moon-guard,1592,monk,windwalker,106,64,42
Druta,illidan,1589,monk,windwalker,42,32,10
Xas,sentinels,1585,monk,windwalker,36,19,17
Reprap,elune,1582,monk,windwalker,58,33,25
Kogoli,frostwolf,1580,monk,windwalker,101,47,54
Råii,sargeras,1579,monk,windwalker,30,20,10
Wonderx,darkspear,1579,monk,windwalker,30,20,10
Toyotatacoma,bleeding-hollow,1578,monk,windwalker,36,23,13
Copenfist,black-dragonflight,1578,monk,windwalker,36,21,15
Yogiji,proudmoore,1577,monk,windwalker,36,20,16
Mhmmzz,sargeras,1575,monk,windwalker,36,17,19
Xìðñ,moon-guard,1574,monk,windwalker,66,44,22
Pinot,dragonmaw,1572,monk,windwalker,42,17,25
Panduh,moon-guard,1568,monk,windwalker,78,40,38
Meatwrap,mugthol,1566,monk,windwalker,52,26,26
Ehdunno,kelthuzad,1560,monk,windwalker,38,22,16
Banyasong,tichondrius,1555,monk,windwalker,102,57,45
Kómugi,area-52,1554,monk,windwalker,131,70,61
Gøgeta,stormrage,1554,monk,windwalker,119,58,61
Altaidm,ragnaros,1554,monk,windwalker,42,17,25
Dïsturbedtko,azralon,1552,monk,windwalker,120,58,62
Fistnafurry,tichondrius,1550,monk,windwalker,42,21,21
Chucksandmk,barthilas,1548,monk,windwalker,54,25,29
Nagato,nemesis,1545,monk,windwalker,23,17,6
Borekkar,emerald-dream,1544,monk,windwalker,41,22,19
Chingu,ragnaros,1543,monk,windwalker,123,59,64
Therapeutics,moon-guard,1543,monk,windwalker,102,47,55
Healzpapi,tichondrius,1541,monk,windwalker,84,55,29
Pokinpooters,stormrage,1536,monk,windwalker,129,65,64
Xyän,bleeding-hollow,1534,monk,windwalker,30,16,14
Katsübooy,azralon,1534,monk,windwalker,273,142,131
Çraßsßùrgêr,bonechewer,1533,monk,windwalker,24,16,8
Zaabuza,azralon,1528,monk,windwalker,60,39,21
Drakfu,tichondrius,1527,monk,windwalker,45,26,19
Brewbaker,hyjal,1527,monk,windwalker,74,41,33
Napoleonic,vashj,1524,monk,windwalker,30,20,10
Peacefulpaco,malganis,1524,monk,windwalker,36,19,17
Hagano,drakkari,1523,monk,windwalker,107,55,52
Muritors,ragnaros,1523,monk,windwalker,36,17,19
Byakugun,wyrmrest-accord,1522,monk,windwalker,36,21,15
Naagg,tichondrius,1521,monk,windwalker,30,16,14
Yoshifistsu,malganis,1521,monk,windwalker,54,26,28
Odogin,tichondrius,1520,monk,windwalker,65,42,23
Göllyjee,tichondrius,1517,monk,windwalker,84,36,48
Bløødÿ,ragnaros,1516,monk,windwalker,21,17,4
Wartenja,frostmourne,1516,monk,windwalker,84,41,43
Kutz,proudmoore,1512,monk,windwalker,81,40,41
Unlike,tichondrius,1510,monk,windwalker,96,44,52
Odi,stonemaul,1509,monk,windwalker,101,48,53
Sgarbossa,tortheldrin,1509,monk,windwalker,42,16,26
Dabzin,stormrage,1508,monk,windwalker,79,41,38
Arizøna,illidan,1507,monk,windwalker,80,44,36
Shishosenin,quelthalas,1507,monk,windwalker,182,88,94
Hòlygòd,dalaran,1505,monk,windwalker,64,33,31
Geekweek,frostmourne,1503,monk,windwalker,30,17,13
Npepper,khadgar,1503,monk,windwalker,52,23,29
Daddyrugburn,area-52,1502,monk,windwalker,77,38,39
Varn,frostmourne,1500,monk,windwalker,95,46,49
ßlesséd,tichondrius,1497,monk,windwalker,54,22,32
Ascilica,firetree,1495,monk,windwalker,24,16,8
Tigerstrikes,sargeras,1494,monk,windwalker,30,19,11
Harde,thrall,1492,monk,windwalker,65,29,36
Rocketfist,bleeding-hollow,1487,monk,windwalker,66,32,34
Simonb,tichondrius,1487,monk,windwalker,54,24,30
Rockemsockem,gorefiend,1485,monk,windwalker,90,48,42
Kiulang,kelthuzad,1483,monk,windwalker,93,44,49
Nject,malganis,1479,monk,windwalker,36,23,13
Aubiemonk,malygos,1479,monk,windwalker,30,16,14
Broomooster,bleeding-hollow,1479,monk,windwalker,47,20,27
Sivedrafely,arthas,1475,monk,windwalker,60,30,30
Ökami,tichondrius,1473,monk,windwalker,48,24,24
Shôckley,tichondrius,1468,monk,windwalker,105,54,51
Ohgiddyttv,dalaran,1466,monk,windwalker,77,40,37
Jegann,tichondrius,1463,monk,windwalker,110,51,59
Tyroneßanks,stormrage,1457,monk,windwalker,36,20,16
Mastahp,tichondrius,1457,monk,windwalker,42,23,19
Killmachine,farstriders,1454,monk,windwalker,144,72,72
Showshoway,tichondrius,1450,monk,windwalker,59,26,33
PlayerHHQLNK,moon-guard,1448,monk,windwalker,60,30,30
Lickthefist,sargeras,1445,monk,windwalker,24,16,8
Mikeyx,area-52,1439,monk,windwalker,24,15,9
Ahrk,emerald-dream,1439,monk,windwalker,58,20,38
Kawasakii,tichondrius,1438,monk,windwalker,148,76,72
Lavinci,area-52,1437,monk,windwalker,30,15,15
Rocketfrogg,bleeding-hollow,1434,monk,windwalker,36,15,21
Duhäst,sargeras,1433,monk,windwalker,24,15,9
Fistys,area-52,1433,monk,windwalker,117,60,57
Izu,senjin,1433,monk,windwalker,30,15,15
Heiwei,stormrage,1432,monk,windwalker,24,15,9
Elfoverde,stormrage,1430,monk,windwalker,24,15,9
Xølik,draenor,1429,monk,windwalker,24,15,9
Xuenws,tichondrius,1429,monk,windwalker,24,15,9
Yamoshì,stormrage,1425,monk,windwalker,48,25,23
Domiik,ragnaros,1421,monk,windwalker,30,15,15
Wind,misha,1419,monk,windwalker,49,31,18
Miýagi,sargeras,1419,monk,windwalker,24,15,9
Dazzler,ragnaros,1419,monk,windwalker,66,35,31
Convectuoso,illidan,1414,monk,windwalker,24,15,9
Sleýin,tichondrius,1412,monk,windwalker,112,59,53
Daslow,quelthalas,1412,monk,windwalker,146,75,71
Gesir,tichondrius,1408,monk,windwalker,30,15,15
Butjaum,stormrage,1407,monk,windwalker,58,26,32
Smoothboxing,tichondrius,1405,monk,windwalker,110,62,48
Sodamint,sargeras,1403,monk,windwalker,44,16,28
Creonus,proudmoore,1400,monk,windwalker,56,24,32
Bunnygal,thaurissan,1396,monk,windwalker,38,16,22
Bhodie,zuljin,1395,monk,windwalker,53,20,33
Milkychi,frostmourne,1392,monk,windwalker,40,15,25
Eavale,destromath,1391,monk,windwalker,71,37,34
Tacofox,tichondrius,1391,monk,windwalker,66,32,34
Shlumpuh,tichondrius,1385,monk,windwalker,42,18,24
Onepunchman,quelthalas,1384,monk,windwalker,39,16,23
Backfliptime,ragnaros,1383,monk,windwalker,34,19,15
Callae,dreadmaul,1383,monk,windwalker,36,17,19
Gún,ragnaros,1381,monk,windwalker,83,41,42
Pepepunch,bleeding-hollow,1381,monk,windwalker,36,15,21
Astrofu,tichondrius,1373,monk,windwalker,64,26,38
Bradyfour,moon-guard,1372,monk,windwalker,65,33,32
Brewmaker,sargeras,1372,monk,windwalker,46,22,24
Shianjuo,ragnaros,1372,monk,windwalker,42,20,22
Sarious,lightbringer,1368,monk,windwalker,172,91,81
Kungxxl,kiljaeden,1368,monk,windwalker,73,37,36
Tassmonk,hyjal,1367,monk,windwalker,36,17,19
Rïggen,thrall,1360,monk,windwalker,23,15,8
Dakenprime,tichondrius,1359,monk,windwalker,58,28,30
Screwballz,blackrock,1354,monk,windwalker,75,32,43
Kriticalkush,kelthuzad,1353,monk,windwalker,24,17,7
Owned,dreadmaul,1349,monk,windwalker,36,23,13
Sultanofwind,malganis,1344,monk,windwalker,24,14,10
Nyofu,moon-guard,1343,monk,windwalker,24,14,10
Hîddènsõündx,tichondrius,1343,monk,windwalker,30,14,16
Zuì,sargeras,1342,monk,windwalker,24,14,10
Garmakasmonk,skullcrusher,1341,monk,windwalker,34,19,15
Bluntdoctor,stormreaver,1340,monk,windwalker,66,24,42
Facekandy,tichondrius,1338,monk,windwalker,28,15,13
Sterow,kiljaeden,1338,monk,windwalker,30,14,16
Skymonge,stormrage,1338,monk,windwalker,104,48,56
Tingum,kelthuzad,1337,monk,windwalker,34,15,19
Ghaelessi,senjin,1336,monk,windwalker,77,42,35
Novoctek,quelthalas,1336,monk,windwalker,30,14,16
Feelsogöod,tichondrius,1332,monk,windwalker,28,15,13
Jdkick,sargeras,1331,monk,windwalker,36,14,22
Resolver,stormscale,1327,monk,windwalker,46,24,22
Trapeez,kelthuzad,1326,monk,windwalker,58,32,26
Saltystepbro,illidan,1323,monk,windwalker,24,14,10
Omimonk,sargeras,1314,monk,windwalker,24,14,10
Acharä,tichondrius,1305,monk,windwalker,36,20,16
Madbuffz,nemesis,1305,monk,windwalker,60,26,34
Goonkeg,frostmourne,1304,monk,windwalker,30,14,16
Xøxo,trollbane,1303,monk,windwalker,30,15,15
Sedition,emerald-dream,1299,monk,windwalker,88,45,43
Xiaowën,nemesis,1298,monk,windwalker,57,28,29
Tino,kelthuzad,1295,monk,windwalker,66,35,31
Slapstun,barthilas,1295,monk,windwalker,48,18,30
Jacquelline,moon-guard,1294,monk,windwalker,36,19,17
Anarska,thrall,1291,monk,windwalker,96,46,50
Dodried,ragnaros,1290,monk,windwalker,52,24,28
Yrn,crushridge,1287,monk,windwalker,60,32,28
Fanetö,stormrage,1283,monk,windwalker,48,15,33
Wutangkillaß,kiljaeden,1266,monk,windwalker,48,18,30
Okoh,wyrmrest-accord,1264,monk,windwalker,26,15,11
Weezzyboi,tichondrius,1263,monk,windwalker,42,22,20
Natus,greymane,1262,monk,windwalker,36,18,18
Kungfüsed,stormrage,1260,monk,windwalker,24,14,10
Udderpunch,barthilas,1259,monk,windwalker,25,14,11
Supremekick,frostmourne,1254,monk,windwalker,43,27,16
Opmother,elune,1252,monk,windwalker,35,19,16
Pangpoong,tichondrius,1249,monk,windwalker,99,44,55
Djjackyd,stormrage,1247,monk,windwalker,24,13,11
Hamyu,illidan,1247,monk,windwalker,30,15,15
Baconbiscuit,area-52,1247,monk,windwalker,30,13,17
Prostotak,area-52,1246,monk,windwalker,18,13,5
Pamii,quelthalas,1246,monk,windwalker,36,13,23
Båshkin,terenas,1245,monk,windwalker,42,19,23
Bükki,ragnaros,1243,monk,windwalker,18,13,5
Bowlbreak,sargeras,1243,monk,windwalker,36,20,16
Nuclearpunch,tichondrius,1242,monk,windwalker,24,13,11
Nightww,area-52,1241,monk,windwalker,24,13,11
Tianhu,sargeras,1239,monk,windwalker,30,15,15
Slapcîty,bleeding-hollow,1238,monk,windwalker,30,13,17
Razielic,frostmourne,1233,monk,windwalker,48,21,27
Zettelkasten,tichondrius,1232,monk,windwalker,72,35,37
Ráchez,tichondrius,1231,monk,windwalker,22,14,8
Finesse,frostwolf,1227,monk,windwalker,18,13,5
Rbs,tichondrius,1226,monk,windwalker,54,17,37
Ruckm,stormrage,1225,monk,windwalker,24,13,11
Stickyloads,illidan,1220,monk,windwalker,72,33,39
Highku,drenden,1219,monk,windwalker,24,14,10
Gurda,wyrmrest-accord,1203,monk,windwalker,72,34,38
Ofn,moon-guard,1202,monk,windwalker,96,45,51
Xéia,area-52,1201,monk,windwalker,60,23,37
Rufaso,sargeras,1199,monk,windwalker,54,24,30
Akanq,tichondrius,1194,monk,windwalker,27,13,14
Marstol,bleeding-hollow,1186,monk,windwalker,53,31,22
Silvopanda,azralon,1185,monk,windwalker,107,55,52
Hinakii,dalaran,1172,monk,windwalker,120,50,70
Sleepÿ,area-52,1171,monk,windwalker,84,34,50
Milktank,medivh,1167,monk,windwalker,69,40,29
Mommysalamii,moon-guard,1167,monk,windwalker,25,13,12
Moopdahoop,stormrage,1162,monk,windwalker,73,41,32
Kandinarra,jubeithos,1156,monk,windwalker,52,28,24
Leehofook,azshara,1154,monk,windwalker,66,30,36
Linkya,daggerspine,1152,monk,windwalker,22,14,8
Xedou,azralon,1151,monk,windwalker,18,12,6
Soprà,zuljin,1151,monk,windwalker,24,12,12
Alshee,nagrand,1151,monk,windwalker,27,13,14
Hybrid,stormrage,1150,monk,windwalker,18,12,6
Pikotaro,tichondrius,1150,monk,windwalker,24,12,12
Antiherox,sargeras,1149,monk,windwalker,18,12,6
Excalibrew,malganis,1149,monk,windwalker,24,12,12
Allure,frostmourne,1147,monk,windwalker,24,12,12
Phistycuffs,bleeding-hollow,1147,monk,windwalker,30,12,18
Jajabelugeng,tichondrius,1144,monk,windwalker,18,12,6
Anavara,drakkari,1144,monk,windwalker,36,18,18
Tenshu,runetotem,1141,monk,windwalker,24,12,12
Mechabre,stormrage,1140,monk,windwalker,18,12,6
Delorenzi,hellscream,1137,monk,windwalker,24,12,12
Chihad,stormrage,1135,monk,windwalker,18,12,6
Kfpeeves,sargeras,1134,monk,windwalker,30,15,15
Shinjiki,tichondrius,1134,monk,windwalker,29,12,17
Bigxthaplug,moon-guard,1132,monk,windwalker,30,12,18
Boldyr,sargeras,1128,monk,windwalker,24,12,12
Shinaniganz,chogall,1128,monk,windwalker,42,17,25
Stigzz,stormrage,1118,monk,windwalker,23,12,11
Jimothydab,lightbringer,1117,monk,windwalker,23,12,11
Gorton,lightbringer,1114,monk,windwalker,24,12,12
Haco,malganis,1114,monk,windwalker,29,12,17
Imonkalot,destromath,1111,monk,windwalker,55,23,32
Lyfegiver,blackrock,1110,monk,windwalker,20,13,7
Jinpo,lightninghoof,1110,monk,windwalker,60,32,28
Loadedfries,frostmourne,1110,monk,windwalker,24,12,12
Fitmonje,drakkari,1108,monk,windwalker,28,13,15
Bonflur,quelthalas,1105,monk,windwalker,286,144,142
Angerday,illidan,1097,monk,windwalker,30,12,18
Tzidkiyahu,barthilas,1090,monk,windwalker,18,13,5
Deadlyfist,stormrage,1089,monk,windwalker,47,19,28
Astteell,proudmoore,1089,monk,windwalker,39,13,26
Drektarz,area-52,1085,monk,windwalker,75,33,42
Ojiin,wyrmrest-accord,1079,monk,windwalker,24,13,11
Quanon,stormreaver,1071,monk,windwalker,33,14,19
Calmpunchman,mannoroth,1070,monk,windwalker,25,12,13
Veso,tichondrius,1056,monk,windwalker,12,11,1
Yavaxye,stormrage,1056,monk,windwalker,24,11,13
Abenobashi,malganis,1055,monk,windwalker,18,11,7
Whitepandax,tichondrius,1055,monk,windwalker,18,11,7
Hate,korialstrasz,1055,monk,windwalker,18,11,7
Rubntug,zuljin,1055,monk,windwalker,18,11,7
Kungfupurk,bleeding-hollow,1055,monk,windwalker,18,11,7
Gaslighterr,tichondrius,1055,monk,windwalker,18,11,7
Songokusan,thrall,1055,monk,windwalker,18,11,7
Sockem,arthas,1055,monk,windwalker,24,11,13
Powerfisterr,stormrage,1054,monk,windwalker,18,11,7
Monkamax,tichondrius,1054,monk,windwalker,18,11,7
Wimdrewk,quelthalas,1053,monk,windwalker,39,12,27
Kristiana,aegwynn,1052,monk,windwalker,18,11,7
Hira,zuljin,1052,monk,windwalker,30,11,19
Píñg,area-52,1051,monk,windwalker,30,11,19
Niked,tichondrius,1050,monk,windwalker,30,11,19
Sandii,azralon,1049,monk,windwalker,51,29,22
Whtnyhuston,sargeras,1049,monk,windwalker,24,11,13
Chowlaos,coilfang,1048,monk,windwalker,18,11,7
Senseî,altar-of-storms,1048,monk,windwalker,30,11,19
Chaosrose,area-52,1044,monk,windwalker,18,11,7
Lexivixi,khazgoroth,1044,monk,windwalker,24,12,12
Tremonk,kelthuzad,1043,monk,windwalker,18,11,7
Monkii,bonechewer,1041,monk,windwalker,21,14,7
Jnx,emerald-dream,1038,monk,windwalker,24,11,13
Arshavin,skullcrusher,1038,monk,windwalker,30,11,19
Currycooker,tichondrius,1037,monk,windwalker,23,11,12
Mcnipple,moonrunner,1036,monk,windwalker,18,11,7
Shocclol,stormrage,1036,monk,windwalker,21,12,9
Natintell,drakkari,1032,monk,windwalker,71,33,38
Abboo,hyjal,1030,monk,windwalker,24,12,12
Blackychan,scilla,1027,monk,windwalker,36,15,21
Steenkk,tichondrius,1023,monk,windwalker,24,11,13
Kuffy,kelthuzad,1021,monk,windwalker,17,11,6
Sébástián,drakkari,1021,monk,windwalker,52,28,24
Åsurã,stormrage,1021,monk,windwalker,34,11,23
Leafondawind,boulderfist,1020,monk,windwalker,29,11,18
Rosarìolover,stormrage,1008,monk,windwalker,36,18,18
Averagewang,sargeras,1007,monk,windwalker,30,16,14
Brewzllee,tichondrius,1000,monk,windwalker,66,34,32
Fatde,daggerspine,991,monk,windwalker,47,27,20
Rollsroycist,trollbane,974,monk,windwalker,43,24,19
Tobearus,stormscale,974,monk,windwalker,29,13,16
Fettywhopper,kaelthas,960,monk,windwalker,12,10,2
Shadmtwo,tichondrius,960,monk,windwalker,12,10,2
Aýre,ravencrest,960,monk,windwalker,12,10,2
Bumbleechi,azralon,960,monk,windwalker,18,10,8
Afrosamurai,thrall,960,monk,windwalker,18,10,8
Telospateo,ragnaros,960,monk,windwalker,18,10,8
Innerverse,tichondrius,960,monk,windwalker,18,10,8
Kinkykyle,emerald-dream,960,monk,windwalker,24,10,14
Dwarfmonk,tichondrius,960,monk,windwalker,24,10,14
Lolqtxd,sargeras,960,monk,windwalker,24,10,14
Tazermw,sargeras,959,monk,windwalker,12,10,2
Quanyaozu,ragnaros,959,monk,windwalker,18,10,8
Stendari,moon-guard,959,monk,windwalker,18,10,8
Goldfornudez,area-52,959,monk,windwalker,18,10,8
Gelgameks,eredar,959,monk,windwalker,24,10,14
Squidie,tichondrius,959,monk,windwalker,30,10,20
Thäiländiä,bleeding-hollow,958,monk,windwalker,30,18,12
Mattyj,darkspear,958,monk,windwalker,24,10,14
Sxywind,azgalor,957,monk,windwalker,18,10,8
Mônkdunk,daggerspine,957,monk,windwalker,18,10,8
Avz,azralon,957,monk,windwalker,24,10,14
Skyvaan,barthilas,956,monk,windwalker,18,10,8
Ezpzmonk,bloodscalp,956,monk,windwalker,21,11,10
Thalreyzian,vashj,954,monk,windwalker,24,10,14
Megatraun,tichondrius,953,monk,windwalker,18,10,8
Alcaquito,goldrinn,950,monk,windwalker,18,10,8
Chigang,deathwing,949,monk,windwalker,24,10,14
Hehex,bleeding-hollow,943,monk,windwalker,23,10,13
Madmint,illidan,941,monk,windwalker,23,11,12
Mynamegeorge,area-52,941,monk,windwalker,40,17,23
Lööpér,tichondrius,939,monk,windwalker,18,10,8
Nutcrakerz,tichondrius,935,monk,windwalker,24,13,11
Ryucko,azralon,933,monk,windwalker,18,10,8
Mcwallets,moon-guard,933,monk,windwalker,78,33,45
Captnmurphy,tichondrius,927,monk,windwalker,17,10,7
Hylithia,proudmoore,923,monk,windwalker,18,10,8
Metios,aggramar,916,monk,windwalker,29,10,19
Ipmán,moon-guard,892,monk,windwalker,41,18,23
Whizz,frostmane,879,monk,windwalker,19,10,9
Veganbacon,mannoroth,875,monk,windwalker,14,10,4
Rhyskrispiez,sargeras,864,monk,windwalker,12,9,3
Peachcactus,sargeras,864,monk,windwalker,12,9,3
Poormanx,illidan,864,monk,windwalker,12,9,3
Gucchimane,illidan,864,monk,windwalker,12,9,3
Reeperfist,area-52,864,monk,windwalker,12,9,3
Danimalz,stormrage,864,monk,windwalker,12,9,3
Garypool,emerald-dream,864,monk,windwalker,15,9,6
Molta,tichondrius,864,monk,windwalker,18,9,9
Jaige,illidan,864,monk,windwalker,18,9,9
Tmjojo,tichondrius,864,monk,windwalker,24,9,15
Chiang,chogall,864,monk,windwalker,24,9,15
Lalpu,tichondrius,864,monk,windwalker,24,9,15
Headsmasher,wyrmrest-accord,863,monk,windwalker,18,9,9
Mannkin,zuluhed,863,monk,windwalker,18,9,9
Azzmane,bronzebeard,863,monk,windwalker,18,9,9
Stepsista,sargeras,863,monk,windwalker,18,9,9
Helicopter,borean-tundra,863,monk,windwalker,18,9,9
Röllup,area-52,863,monk,windwalker,18,9,9
Kahpital,azralon,863,monk,windwalker,18,9,9
Tomatosaucin,area-52,863,monk,windwalker,18,9,9
Honkbazz,illidan,863,monk,windwalker,24,9,15
Somethingre,sargeras,862,monk,windwalker,12,9,3
Chingwang,frostmourne,862,monk,windwalker,12,9,3
Blumpfu,thrall,862,monk,windwalker,18,9,9
Duwhack,wyrmrest-accord,862,monk,windwalker,18,9,9
Yeawe,tichondrius,862,monk,windwalker,18,9,9
Mapaly,ragnaros,862,monk,windwalker,18,9,9
Fornoraisin,thrall,862,monk,windwalker,36,9,27
Kaishya,emerald-dream,861,monk,windwalker,12,9,3
Æeeæ,hakkar,861,monk,windwalker,12,9,3
Kentodne,stormrage,861,monk,windwalker,18,9,9
Zackesé,area-52,861,monk,windwalker,24,9,15
Ryútt,illidan,860,monk,windwalker,24,9,15
Romeonjuliet,tichondrius,859,monk,windwalker,18,9,9
Dynamo,blackrock,859,monk,windwalker,24,9,15
Selfless,gilneas,858,monk,windwalker,18,9,9
Wwmonks,sargeras,857,monk,windwalker,12,9,3
Felgolos,azralon,857,monk,windwalker,15,10,5
Acena,stormrage,856,monk,windwalker,24,9,15
Acindian,malganis,853,monk,windwalker,18,9,9
Agroétudo,azralon,838,monk,windwalker,18,9,9
Scarlos,tichondrius,832,monk,windwalker,175,84,91
Thekilla,aegwynn,827,monk,windwalker,18,9,9
Yeonguo,drakthul,795,monk,windwalker,16,9,7
Rykouu,area-52,784,monk,windwalker,19,9,10
Allmother,area-52,784,monk,windwalker,25,9,16
Hitchslapz,tichondrius,783,monk,windwalker,13,9,4
Raskalnikov,kelthuzad,777,monk,windwalker,20,10,10
Khungfeu,area-52,768,monk,windwalker,12,8,4
Hitman,thrall,768,monk,windwalker,12,8,4
Livitsu,aerie-peak,768,monk,windwalker,12,8,4
Mcbluffin,onyxia,768,monk,windwalker,12,8,4
Iremía,azralon,768,monk,windwalker,12,8,4
Zoomerxd,stormrage,768,monk,windwalker,12,8,4
Twichyling,tichondrius,768,monk,windwalker,12,8,4
Slimcognito,zuljin,768,monk,windwalker,18,8,10
Dobsy,bleeding-hollow,768,monk,windwalker,18,8,10
Richywayne,bleeding-hollow,768,monk,windwalker,18,8,10
Stepfistz,aegwynn,768,monk,windwalker,18,8,10
Ojii,tichondrius,768,monk,windwalker,18,8,10
Rerolled,moon-guard,768,monk,windwalker,18,8,10
Lørdjåshïn,azjolnerub,768,monk,windwalker,18,8,10
Mahatmä,dalaran,768,monk,windwalker,18,8,10
Gnomepuncher,dalaran,768,monk,windwalker,18,8,10
Hitt,barthilas,768,monk,windwalker,18,8,10
Ballok,bleeding-hollow,768,monk,windwalker,18,8,10
Güwop,tichondrius,768,monk,windwalker,18,8,10
Taggz,thunderlord,768,monk,windwalker,18,8,10
Monke,onyxia,768,monk,windwalker,24,8,16
Raikou,frostmourne,767,monk,windwalker,12,8,4
Tews,quelthalas,767,monk,windwalker,12,8,4
Prickhead,sargeras,767,monk,windwalker,15,9,6
Metalmønk,nerzhul,767,monk,windwalker,18,8,10
Silkzy,frostwolf,767,monk,windwalker,18,8,10
Pipochen,ragnaros,767,monk,windwalker,18,8,10
Punchiboi,thrall,767,monk,windwalker,18,8,10
Supernam,sargeras,767,monk,windwalker,18,8,10
Faashbae,illidan,767,monk,windwalker,18,8,10
Zukki,zuljin,767,monk,windwalker,18,8,10
Suspicious,malfurion,767,monk,windwalker,18,8,10
Saiyajinsoul,ragnaros,767,monk,windwalker,18,8,10
Biggyballs,tichondrius,767,monk,windwalker,18,8,10
Luckystrike,area-52,767,monk,windwalker,24,8,16
Yoshimotto,area-52,766,monk,windwalker,12,8,4
Nf,zuljin,766,monk,windwalker,12,8,4
Anatomyx,kelthuzad,766,monk,windwalker,12,8,4
Ragraxx,quelthalas,766,monk,windwalker,18,8,10
Extinctión,stormscale,762,monk,windwalker,12,8,4
Sprinkli,sargeras,761,monk,windwalker,24,8,16
Iamanangel,illidan,759,monk,windwalker,12,8,4
Kylièjenner,gilneas,755,monk,windwalker,18,8,10
Kilabit,azshara,742,monk,windwalker,22,9,13
Misery,stormscale,719,monk,windwalker,11,8,3
Raninn,bleeding-hollow,704,monk,windwalker,16,8,8
Chaipie,kelthuzad,703,monk,windwalker,11,8,3
Bakha,illidan,703,monk,windwalker,11,8,3
Onepunch,exodar,702,monk,windwalker,14,8,6
Kryptikkyt,gilneas,672,monk,windwalker,12,7,5
Garofalo,tichondrius,672,monk,windwalker,12,7,5
Incaustik,ragnaros,672,monk,windwalker,12,7,5
Adilm,illidan,672,monk,windwalker,12,7,5
Gigagirth,emerald-dream,672,monk,windwalker,12,7,5
Porxhub,tichondrius,672,monk,windwalker,12,7,5
Goldx,ragnaros,672,monk,windwalker,12,7,5
Wizcaulifa,stormrage,672,monk,windwalker,12,7,5
Tokyozesty,area-52,672,monk,windwalker,12,7,5
Bibis,sargeras,672,monk,windwalker,12,7,5
Shiphappens,barthilas,672,monk,windwalker,12,7,5
Touchbot,tichondrius,672,monk,windwalker,12,7,5
Dragonwhirl,stormrage,672,monk,windwalker,12,7,5
Dkdakìng,stormrage,672,monk,windwalker,12,7,5
Yoojimin,kiljaeden,672,monk,windwalker,12,7,5
Ristion,moon-guard,672,monk,windwalker,12,7,5
Ganjäsmoke,skullcrusher,672,monk,windwalker,12,7,5
Kudrix,frostwolf,672,monk,windwalker,12,7,5
Dublefist,draktharon,672,monk,windwalker,12,7,5
Ázão,stormrage,672,monk,windwalker,12,7,5
Jowtaro,azralon,672,monk,windwalker,12,7,5
Shry,kiljaeden,672,monk,windwalker,12,7,5
Atengie,stormrage,672,monk,windwalker,12,7,5
Jxyfist,illidan,672,monk,windwalker,12,7,5
Lilpøøter,tichondrius,672,monk,windwalker,12,7,5
Bramicaye,malganis,672,monk,windwalker,12,7,5
Vuadeira,azralon,672,monk,windwalker,12,7,5
Gothamonk,tichondrius,672,monk,windwalker,12,7,5
Ftxyolo,azralon,672,monk,windwalker,12,7,5
Iol,whisperwind,672,monk,windwalker,12,7,5
Buffmonkdmg,tichondrius,672,monk,windwalker,15,8,7
Stevezee,barthilas,672,monk,windwalker,18,7,11
Verizani,stormrage,672,monk,windwalker,18,7,11
Popchi,stormrage,672,monk,windwalker,18,7,11
Tapzm,area-52,672,monk,windwalker,18,7,11
Grocerymonk,malganis,672,monk,windwalker,18,7,11
Atsuyuki,nemesis,672,monk,windwalker,18,7,11
Awcfanboy,bleeding-hollow,672,monk,windwalker,21,8,13
Judgevr,frostmourne,672,monk,windwalker,23,8,15
Monkyun,tichondrius,672,monk,windwalker,24,7,17
Zenkam,ragnaros,672,monk,windwalker,24,7,17
Quietbegger,sargeras,671,monk,windwalker,12,7,5
Bauddor,ragnaros,671,monk,windwalker,12,7,5
Caulífla,barthilas,671,monk,windwalker,12,7,5
Asaltofsorts,tichondrius,671,monk,windwalker,12,7,5
Reckin,frostmourne,671,monk,windwalker,12,7,5
Keys,earthen-ring,671,monk,windwalker,12,7,5
Jackboi,the-underbog,671,monk,windwalker,18,7,11
Leozen,skullcrusher,671,monk,windwalker,18,7,11
Chuchinga,tichondrius,670,monk,windwalker,13,8,5
Minusmonk,dalaran,670,monk,windwalker,12,7,5
Cryptique,tichondrius,670,monk,windwalker,12,7,5
Owenxdd,stormrage,670,monk,windwalker,12,7,5
Gentlefists,sargeras,670,monk,windwalker,18,7,11
Samaelsin,emerald-dream,670,monk,windwalker,24,7,17
Kuungfoo,tichondrius,667,monk,windwalker,12,7,5
Hyun,stormrage,666,monk,windwalker,12,7,5
Kush,dalvengyr,665,monk,windwalker,12,7,5
Traxshin,kelthuzad,664,monk,windwalker,18,7,11
Aedale,emerald-dream,661,monk,windwalker,18,7,11
Pastarasta,malganis,658,monk,windwalker,12,7,5
Liänä,quelthalas,658,monk,windwalker,18,7,11
Léesin,stormrage,655,monk,windwalker,17,7,10
Kurha,queldorei,644,monk,windwalker,18,7,11
Mùnkey,nagrand,638,monk,windwalker,17,7,10
Sistafistaa,akama,606,monk,windwalker,14,7,7
Sckmonk,tichondrius,606,monk,windwalker,16,7,9
Aizu,ragnaros,576,monk,windwalker,6,6,0
Selfîe,ysera,576,monk,windwalker,6,6,0
Srýbrø,illidan,576,monk,windwalker,6,6,0
Griswolld,ragnaros,576,monk,windwalker,6,6,0
Goblinitto,archimonde,576,monk,windwalker,6,6,0
Twïst,tichondrius,576,monk,windwalker,6,6,0
Wwrizz,frostmane,576,monk,windwalker,6,6,0
Makgøra,malganis,576,monk,windwalker,6,6,0
Grimpossible,malganis,576,monk,windwalker,6,6,0
Aveium,moon-guard,576,monk,windwalker,6,6,0
Monkfy,moon-guard,576,monk,windwalker,6,6,0
Xua,sargeras,576,monk,windwalker,12,6,6
Bvndio,ragnaros,576,monk,windwalker,12,6,6
Gójó,tichondrius,576,monk,windwalker,12,6,6
Tulalong,area-52,576,monk,windwalker,12,6,6
Syffer,sargeras,576,monk,windwalker,12,6,6
Xuenfu,tichondrius,576,monk,windwalker,12,6,6
Creamchop,stormreaver,576,monk,windwalker,12,6,6
Affected,lightninghoof,576,monk,windwalker,12,6,6
Vandamme,durotan,576,monk,windwalker,12,6,6
Yimmy,zuluhed,576,monk,windwalker,12,6,6
Silvyrx,boulderfist,576,monk,windwalker,12,6,6
Läôtzu,fizzcrank,576,monk,windwalker,12,6,6
Xoir,tichondrius,576,monk,windwalker,12,6,6
Monksoon,tichondrius,576,monk,windwalker,12,6,6
Pinkgucci,thrall,576,monk,windwalker,12,6,6
Neejitsu,malganis,576,monk,windwalker,12,6,6
Xinghao,tichondrius,576,monk,windwalker,12,6,6
Bakacia,ragnaros,576,monk,windwalker,12,6,6
Tahs,azralon,576,monk,windwalker,12,6,6
Hèàvy,stormrage,576,monk,windwalker,12,6,6
Tinypunch,emerald-dream,576,monk,windwalker,12,6,6
Forthekicks,tichondrius,576,monk,windwalker,19,8,11
Monjimen,ragnaros,576,monk,windwalker,18,6,12
Awsmonk,malygos,576,monk,windwalker,18,6,12
Káizen,area-52,576,monk,windwalker,18,6,12
Jatzai,emerald-dream,576,monk,windwalker,28,6,22
Ipnam,kelthuzad,575,monk,windwalker,10,7,3
Weewalker,wyrmrest-accord,575,monk,windwalker,12,6,6
Atulzo,emerald-dream,575,monk,windwalker,12,6,6
Kalrsk,frostmourne,575,monk,windwalker,12,6,6
Rowenoa,tichondrius,575,monk,windwalker,18,6,12
Kajjou,illidan,575,monk,windwalker,20,6,14
Linwong,garithos,574,monk,windwalker,12,6,6
Dragorovich,aerie-peak,574,monk,windwalker,12,6,6
Fistidmi,area-52,573,monk,windwalker,12,6,6
Tøxicø,quelthalas,572,monk,windwalker,16,7,9
Nedpanders,nagrand,564,monk,windwalker,12,6,6
Phuumyn,llane,543,monk,windwalker,11,6,5
Wft,frostmourne,527,monk,windwalker,11,6,5
Shindoro,bonechewer,521,monk,windwalker,16,10,6
Nitrobrewed,stormrage,480,monk,windwalker,6,5,1
Poem,grizzly-hills,480,monk,windwalker,6,5,1
Akir,zuljin,480,monk,windwalker,6,5,1
Pikadejegue,nemesis,480,monk,windwalker,6,5,1
Pleasetouch,emerald-dream,480,monk,windwalker,6,5,1
Miresa,kelthuzad,480,monk,windwalker,6,5,1
Shevchenkô,quelthalas,480,monk,windwalker,6,5,1
Xunzao,emerald-dream,480,monk,windwalker,6,5,1
Yenjung,azralon,480,monk,windwalker,6,5,1
Koochies,aegwynn,480,monk,windwalker,6,5,1
Doczen,malganis,480,monk,windwalker,6,5,1
Pandagendon,quelthalas,480,monk,windwalker,6,5,1
Zakaza,kelthuzad,480,monk,windwalker,6,5,1
Danksweaver,malganis,480,monk,windwalker,6,5,1
Monkskiiz,tichondrius,480,monk,windwalker,6,5,1
Kimmyfists,tichondrius,480,monk,windwalker,6,5,1
Varimå,area-52,480,monk,windwalker,6,5,1
Drunkmaster,frostmourne,480,monk,windwalker,6,5,1
Hennyww,dalaran,480,monk,windwalker,6,5,1
Iflykites,zuljin,480,monk,windwalker,6,5,1
Iloveabby,sargeras,480,monk,windwalker,6,5,1
Kuranchi,illidan,480,monk,windwalker,6,5,1
Blazebeast,blackhand,480,monk,windwalker,9,6,3
Tyrus,kelthuzad,480,monk,windwalker,9,5,4
Mepepegaclap,malganis,480,monk,windwalker,12,5,7
Ilvory,tichondrius,480,monk,windwalker,12,5,7
Ferknights,moon-guard,480,monk,windwalker,12,5,7
Smigz,area-52,480,monk,windwalker,12,5,7
Flattswwjr,tichondrius,480,monk,windwalker,12,5,7
Tripster,wyrmrest-accord,480,monk,windwalker,12,5,7
Suntzuvius,tichondrius,480,monk,windwalker,12,5,7
Plagai,fizzcrank,480,monk,windwalker,12,5,7
Gêrôx,sargeras,480,monk,windwalker,12,5,7
Valdur,sargeras,480,monk,windwalker,12,5,7
Zhíu,ragnaros,480,monk,windwalker,12,5,7
Bokchoii,sargeras,480,monk,windwalker,12,5,7
Kickkick,burning-blade,480,monk,windwalker,12,5,7
Antril,bleeding-hollow,480,monk,windwalker,12,5,7
Lokimana,zuljin,480,monk,windwalker,12,5,7
Rozlynnww,tichondrius,480,monk,windwalker,12,5,7
Zadaa,alleria,480,monk,windwalker,12,5,7
Xueyu,malganis,480,monk,windwalker,12,5,7
Aydowon,illidan,480,monk,windwalker,12,5,7
Idonthustle,area-52,480,monk,windwalker,12,5,7
Tenkix,zuljin,480,monk,windwalker,12,5,7
Miuss,illidan,480,monk,windwalker,12,5,7
Akrethar,medivh,480,monk,windwalker,12,5,7
Maisoftheart,barthilas,480,monk,windwalker,18,5,13
Gabaan,azralon,480,monk,windwalker,18,5,13
Vinndz,azralon,480,monk,windwalker,18,5,13
Zmajevratnik,illidan,479,monk,windwalker,6,5,1
Shà,kelthuzad,479,monk,windwalker,12,5,7
Søuei,skullcrusher,479,monk,windwalker,12,5,7
Kiukiukiu,tichondrius,479,monk,windwalker,12,5,7
Tamonk,veknilash,478,monk,windwalker,6,5,1
Leisa,jaedenar,463,monk,windwalker,11,5,6
Mcmaplol,tichondrius,447,monk,windwalker,11,5,6
Clytpuncher,emerald-dream,447,monk,windwalker,11,5,6
Chisuschrist,hyjal,432,monk,windwalker,15,5,10
Ighostgirls,thrall,431,monk,windwalker,11,5,6
Prettyflacko,thrall,416,monk,windwalker,10,5,5
Gorblox,emerald-dream,384,monk,windwalker,6,4,2
Stevìl,medivh,384,monk,windwalker,6,4,2
Korgark,tichondrius,384,monk,windwalker,6,4,2
Saitamami,tichondrius,384,monk,windwalker,6,4,2
Ðøhkø,nemesis,384,monk,windwalker,6,4,2
Wørm,emerald-dream,384,monk,windwalker,6,4,2
Barleygar,tichondrius,384,monk,windwalker,6,4,2
Cowsgonuts,gorefiend,384,monk,windwalker,6,4,2
Kiggo,bonechewer,384,monk,windwalker,6,4,2
Trembull,gurubashi,384,monk,windwalker,6,4,2
Arunaa,tichondrius,384,monk,windwalker,6,4,2
Preceptonk,azralon,384,monk,windwalker,6,4,2
Xulieng,tichondrius,384,monk,windwalker,6,4,2
Castiwhite,quelthalas,384,monk,windwalker,6,4,2
Liucang,archimonde,384,monk,windwalker,6,4,2
Cowhoe,icecrown,384,monk,windwalker,6,4,2
Imperio,stormrage,384,monk,windwalker,6,4,2
Satchelgizmo,tichondrius,384,monk,windwalker,6,4,2
Pathad,stormrage,384,monk,windwalker,6,4,2
Monkespin,stormrage,384,monk,windwalker,6,4,2
Ezpumpm,azralon,384,monk,windwalker,6,4,2
Delaî,dalaran,384,monk,windwalker,6,4,2
Research,frostmourne,384,monk,windwalker,6,4,2
Molific,gurubashi,384,monk,windwalker,6,4,2
Karatay,tichondrius,384,monk,windwalker,6,4,2
Iarw,tichondrius,384,monk,windwalker,6,4,2
Illiea,cenarius,384,monk,windwalker,6,4,2
Vetting,stormrage,384,monk,windwalker,6,4,2
Fistedby,nesingwary,384,monk,windwalker,6,4,2
Coldridge,bleeding-hollow,384,monk,windwalker,6,4,2
Beverage,frostmourne,384,monk,windwalker,6,4,2
Sistuhfista,tichondrius,384,monk,windwalker,6,4,2
Lowkn,sargeras,384,monk,windwalker,6,4,2
Kame,moon-guard,384,monk,windwalker,6,4,2
Orbgodx,darkspear,384,monk,windwalker,6,4,2
Punchbuggy,frostmourne,384,monk,windwalker,6,4,2
Aedalithe,stormrage,384,monk,windwalker,6,4,2
Champoo,executus,384,monk,windwalker,6,4,2
Thewyjr,illidan,384,monk,windwalker,6,4,2
Fiddletix,stormrage,384,monk,windwalker,6,4,2
Hazed,lightbringer,384,monk,windwalker,6,4,2
Evanyfist,proudmoore,384,monk,windwalker,6,4,2
Fivebears,blackwing-lair,384,monk,windwalker,6,4,2
Vernki,laughing-skull,384,monk,windwalker,6,4,2
Eçua,tichondrius,384,monk,windwalker,7,4,3
Serenitys,tanaris,384,monk,windwalker,9,4,5
Jxytwo,arygos,384,monk,windwalker,12,4,8
Jayr,bleeding-hollow,384,monk,windwalker,12,4,8
Paracetamonk,kelthuzad,384,monk,windwalker,12,4,8
Wheresmyjuul,malganis,384,monk,windwalker,12,4,8
Inko,ragnaros,384,monk,windwalker,12,4,8
Fluffykitty,deathwing,384,monk,windwalker,12,4,8
Xinvictus,frostmourne,384,monk,windwalker,12,4,8
Evilstep,tichondrius,384,monk,windwalker,12,4,8
Kfp,gorefiend,384,monk,windwalker,12,4,8
Ramisan,barthilas,384,monk,windwalker,12,4,8
Machita,spirestone,384,monk,windwalker,12,4,8
Mysticzen,tichondrius,384,monk,windwalker,12,4,8
Chijinx,area-52,384,monk,windwalker,12,4,8
Cranjis,agamaggan,384,monk,windwalker,12,4,8
Piece,blackrock,384,monk,windwalker,12,4,8
Ohtani,frostwolf,384,monk,windwalker,12,4,8
Raekwan,area-52,384,monk,windwalker,12,4,8
Ferrarí,quelthalas,384,monk,windwalker,12,4,8
Fruitpünch,tichondrius,384,monk,windwalker,12,4,8
Solrise,wyrmrest-accord,384,monk,windwalker,12,4,8
Giorhno,ragnaros,384,monk,windwalker,12,4,8
Rookz,drakthul,384,monk,windwalker,12,4,8
Merçeÿ,tichondrius,384,monk,windwalker,12,4,8
Merand,tichondrius,384,monk,windwalker,12,4,8
Talondien,dalaran,384,monk,windwalker,12,4,8
Cudzingtin,dalaran,384,monk,windwalker,12,4,8
Threnz,magtheridon,384,monk,windwalker,12,4,8
Zanmonk,moon-guard,383,monk,windwalker,6,4,2
Chugs,malorne,383,monk,windwalker,18,4,14
Miyage,emerald-dream,382,monk,windwalker,6,4,2
Viko,llane,382,monk,windwalker,6,4,2
Liw,quelthalas,362,monk,windwalker,21,7,14
Broxxenidas,quelthalas,351,monk,windwalker,11,4,7
Nakuang,tichondrius,339,monk,windwalker,24,7,17
Atreia,malganis,330,monk,windwalker,8,5,3
Pånkekz,tichondrius,319,monk,windwalker,5,4,1
Sahhalea,sargeras,319,monk,windwalker,14,4,10
Lackofsleep,tichondrius,288,monk,windwalker,6,3,3
Harvex,area-52,288,monk,windwalker,6,3,3
Choibaedal,tichondrius,288,monk,windwalker,6,3,3
Cráne,duskwood,288,monk,windwalker,6,3,3
Tababtz,illidan,288,monk,windwalker,6,3,3
ßluedream,dalaran,288,monk,windwalker,6,3,3
Raires,tichondrius,288,monk,windwalker,6,3,3
Brewtool,tichondrius,288,monk,windwalker,6,3,3
Bakicaa,dalaran,288,monk,windwalker,6,3,3
Zexana,gorefiend,288,monk,windwalker,6,3,3
Rafyww,tichondrius,288,monk,windwalker,6,3,3
Giatzo,barthilas,288,monk,windwalker,6,3,3
Evilbit,boulderfist,288,monk,windwalker,6,3,3
Reflexsivex,malganis,288,monk,windwalker,6,3,3
Smalltall,area-52,288,monk,windwalker,6,3,3
Imasterl,proudmoore,288,monk,windwalker,6,3,3
Pusily,tichondrius,288,monk,windwalker,6,3,3
Gulmokk,tichondrius,288,monk,windwalker,6,3,3
Slurrpslutt,proudmoore,288,monk,windwalker,6,3,3
Lomist,nazjatar,288,monk,windwalker,6,3,3
Trunkx,area-52,288,monk,windwalker,6,3,3
Atezo,tichondrius,288,monk,windwalker,6,3,3
Mlngo,illidan,288,monk,windwalker,6,3,3
Röllö,tichondrius,288,monk,windwalker,6,3,3
Legolos,runetotem,288,monk,windwalker,6,3,3
Bromonster,zuljin,288,monk,windwalker,6,3,3
Frimayadri,area-52,288,monk,windwalker,6,3,3
Mistérfister,blackrock,288,monk,windwalker,6,3,3
Highaskite,tichondrius,288,monk,windwalker,6,3,3
Kuafu,illidan,288,monk,windwalker,6,3,3
Iilmachoggy,stormrage,288,monk,windwalker,6,3,3
Swurvex,bleeding-hollow,288,monk,windwalker,6,3,3
Daspmonk,nagrand,288,monk,windwalker,6,3,3
Redami,gnomeregan,288,monk,windwalker,6,3,3
Oyyo,tichondrius,288,monk,windwalker,6,3,3
Monklad,malganis,288,monk,windwalker,6,3,3
Dripharder,tichondrius,288,monk,windwalker,6,3,3
Maserati,azjolnerub,288,monk,windwalker,6,3,3
Triixxy,thrall,288,monk,windwalker,6,3,3
Sýññ,illidan,288,monk,windwalker,6,3,3
Gngrbeardman,tichondrius,288,monk,windwalker,6,3,3
Pandaforlife,area-52,288,monk,windwalker,6,3,3
Goodluck,madoran,288,monk,windwalker,6,3,3
Momkisserl,sargeras,288,monk,windwalker,6,3,3
Tigerlust,sargeras,288,monk,windwalker,6,3,3
Dorander,frostmourne,288,monk,windwalker,6,3,3
Hábìtz,area-52,288,monk,windwalker,6,3,3
Skippa,emerald-dream,288,monk,windwalker,6,3,3
Mcfluffey,area-52,288,monk,windwalker,6,3,3
Detox,sargeras,288,monk,windwalker,6,3,3
Tonkchi,khaz-modan,288,monk,windwalker,6,3,3
Fistay,burning-legion,288,monk,windwalker,6,3,3
Gageismonk,mugthol,288,monk,windwalker,6,3,3
Tictox,sargeras,288,monk,windwalker,6,3,3
Rhonco,quelthalas,288,monk,windwalker,6,3,3
Jubei,dragonmaw,288,monk,windwalker,6,3,3
Karkata,sargeras,288,monk,windwalker,6,3,3
Burash,frostwolf,288,monk,windwalker,6,3,3
Bogez,area-52,288,monk,windwalker,6,3,3
Hellcow,frostmourne,288,monk,windwalker,6,3,3
Silestial,sargeras,288,monk,windwalker,6,3,3
Heavytrain,azralon,288,monk,windwalker,6,3,3
Sosm,kelthuzad,288,monk,windwalker,6,3,3
Muffinz,shattered-halls,288,monk,windwalker,6,3,3
Spaaca,kelthuzad,288,monk,windwalker,6,3,3
Apølon,azralon,288,monk,windwalker,6,3,3
Kallandron,thunderhorn,288,monk,windwalker,6,3,3
Hanzøu,ragnaros,288,monk,windwalker,6,3,3
Mgzx,kelthuzad,288,monk,windwalker,6,3,3
Rumlee,sargeras,288,monk,windwalker,6,3,3
Rampant,anubarak,288,monk,windwalker,9,4,5
Siddharthä,barthilas,288,monk,windwalker,12,3,9
Raviolipolie,sargeras,288,monk,windwalker,12,3,9
Chunlee,tichondrius,288,monk,windwalker,12,3,9
Shizzyowoxd,bleeding-hollow,288,monk,windwalker,12,3,9
Bujiburger,frostmourne,288,monk,windwalker,12,3,9
Vova,bleeding-hollow,288,monk,windwalker,12,3,9
Senseixww,sargeras,288,monk,windwalker,12,3,9
Jãe,stormrage,288,monk,windwalker,12,3,9
Paramendic,frostwolf,288,monk,windwalker,12,3,9
Joreg,moon-guard,288,monk,windwalker,12,3,9
Meatcleave,kiljaeden,288,monk,windwalker,12,3,9
Mistyfist,bleeding-hollow,288,monk,windwalker,12,3,9
Dmhsaint,sargeras,288,monk,windwalker,12,3,9
Atarii,emerald-dream,288,monk,windwalker,12,3,9
Wwx,whisperwind,288,monk,windwalker,12,3,9
Tofugoku,area-52,288,monk,windwalker,12,3,9
Breakbonez,dalaran,288,monk,windwalker,18,3,15
Brewmooser,area-52,287,monk,windwalker,6,3,3
Pandalex,draenor,287,monk,windwalker,6,3,3
Ogre,the-venture-co,287,monk,windwalker,6,3,3
Thedeäd,stormrage,287,monk,windwalker,12,3,9
Gaziee,tichondrius,271,monk,windwalker,11,3,8
Dafuqk,stormrage,256,monk,windwalker,16,3,13
Hellrosennin,area-52,239,monk,windwalker,5,3,2
Rockfu,illidan,239,monk,windwalker,5,3,2
Kfchi,tichondrius,192,monk,windwalker,4,3,1
Mùk,tichondrius,192,monk,windwalker,4,3,1
Dangodxz,quelthalas,192,monk,windwalker,4,3,1
Klamfu,thrall,192,monk,windwalker,4,3,1
Jadiel,quelthalas,192,monk,windwalker,6,2,4
Privix,tichondrius,192,monk,windwalker,6,2,4
Averagéjoe,tichondrius,192,monk,windwalker,6,2,4
Imafqnbaby,tichondrius,192,monk,windwalker,6,2,4
Bhoredom,kiljaeden,192,monk,windwalker,6,2,4
Fuchizaki,ragnaros,192,monk,windwalker,6,2,4
Takazawas,bonechewer,192,monk,windwalker,6,2,4
Lonebamboo,tichondrius,192,monk,windwalker,6,2,4
Heävenly,kelthuzad,192,monk,windwalker,6,2,4
Ãcé,ragnaros,192,monk,windwalker,6,2,4
Xarra,bleeding-hollow,192,monk,windwalker,6,2,4
Fistpumps,thrall,192,monk,windwalker,6,2,4
Prf,ragnaros,192,monk,windwalker,6,2,4
Akiiko,draenor,192,monk,windwalker,6,2,4
Grëyfox,sargeras,192,monk,windwalker,6,2,4
Robocto,area-52,192,monk,windwalker,6,2,4
Troutz,sargeras,192,monk,windwalker,6,2,4
Flicksx,arthas,192,monk,windwalker,6,2,4
Dragoro,exodar,192,monk,windwalker,6,2,4
Boeingair,kelthuzad,192,monk,windwalker,6,2,4
Monkbro,altar-of-storms,192,monk,windwalker,6,2,4
Spirits,dreadmaul,192,monk,windwalker,6,2,4
Wât,bleeding-hollow,192,monk,windwalker,6,2,4
Théwy,tichondrius,192,monk,windwalker,6,2,4
Bakusao,bleeding-hollow,192,monk,windwalker,6,2,4
Ludenz,emerald-dream,192,monk,windwalker,6,2,4
Ked,ragnaros,192,monk,windwalker,6,2,4
Sickbanga,barthilas,192,monk,windwalker,6,2,4
Transcend,nerzhul,192,monk,windwalker,6,2,4
Induhca,area-52,192,monk,windwalker,6,2,4
Mîstchievous,sargeras,192,monk,windwalker,6,2,4
Brëwslee,twisting-nether,192,monk,windwalker,6,2,4
Jüdo,barthilas,192,monk,windwalker,6,2,4
Tadaku,dalaran,192,monk,windwalker,6,2,4
Furrykisser,tichondrius,192,monk,windwalker,6,2,4
Zengawd,magtheridon,192,monk,windwalker,6,2,4
Deyasth,zuljin,192,monk,windwalker,6,2,4
Monkuban,destromath,192,monk,windwalker,6,2,4
Thöran,ragnaros,192,monk,windwalker,6,2,4
Pvptone,bleeding-hollow,192,monk,windwalker,6,2,4
Strongmandan,twisting-nether,192,monk,windwalker,6,2,4
Toxicaff,dalaran,192,monk,windwalker,6,2,4
Icesmoker,frostmourne,192,monk,windwalker,6,2,4
Streetcreds,bleeding-hollow,192,monk,windwalker,6,2,4
Gumrag,illidan,192,monk,windwalker,6,2,4
Epî,tichondrius,192,monk,windwalker,6,2,4
Hutmok,dalaran,192,monk,windwalker,6,2,4
Puraimu,sargeras,192,monk,windwalker,6,2,4
Homunculusx,bleeding-hollow,192,monk,windwalker,6,2,4
Coomerww,kelthuzad,192,monk,windwalker,6,2,4
Möösê,moon-guard,192,monk,windwalker,6,2,4
Romeoe,muradin,192,monk,windwalker,6,2,4
Taringa,drakkari,192,monk,windwalker,6,2,4
Lìpz,zuljin,192,monk,windwalker,6,2,4
Upcoming,moon-guard,192,monk,windwalker,6,2,4
Deathgoku,norgannon,192,monk,windwalker,6,2,4
Hydraoxy,moon-guard,192,monk,windwalker,6,2,4
Fumoo,sargeras,192,monk,windwalker,6,2,4
Kitfisty,kiljaeden,192,monk,windwalker,6,2,4
Hossdelgadoe,kiljaeden,192,monk,windwalker,6,2,4
Youngnudy,sargeras,192,monk,windwalker,6,2,4
Defacen,illidan,192,monk,windwalker,6,2,4
Gøldéngødx,tichondrius,192,monk,windwalker,6,2,4
Salanzoww,bleeding-hollow,192,monk,windwalker,6,2,4
Saywha,windrunner,192,monk,windwalker,6,2,4
Sinistuhm,tichondrius,192,monk,windwalker,6,2,4
Merrell,area-52,192,monk,windwalker,6,2,4
Keloxx,ragnaros,192,monk,windwalker,6,2,4
Çhëèch,tichondrius,192,monk,windwalker,11,2,9
Pongo,kelthuzad,192,monk,windwalker,12,2,10
Xinpa,quelthalas,192,monk,windwalker,12,2,10
Razekahl,wyrmrest-accord,192,monk,windwalker,12,2,10
Eliwenn,ragnaros,192,monk,windwalker,12,2,10
Dankestkhan,korialstrasz,192,monk,windwalker,12,2,10
Bruceflea,gurubashi,192,monk,windwalker,18,2,16
Fistermus,tichondrius,192,monk,windwalker,18,2,16
Hontaruk,ragnaros,175,monk,windwalker,11,2,9
Punch,agamaggan,175,monk,windwalker,11,2,9
Wheatsli,malganis,159,monk,windwalker,5,2,3
Stellae,emerald-dream,159,monk,windwalker,5,2,3
Lazy,shattered-halls,159,monk,windwalker,5,2,3
Habzz,tichondrius,159,monk,windwalker,5,2,3
Goku,frostmourne,159,monk,windwalker,5,2,3
Fendi,stormrage,159,monk,windwalker,5,2,3
Heartsies,sargeras,128,monk,windwalker,4,2,2
Versuri,azralon,128,monk,windwalker,10,2,8
Jayjaybrew,area-52,96,monk,windwalker,3,2,1
Neaxain,tichondrius,96,monk,windwalker,3,2,1
Monkwayz,emerald-dream,96,monk,windwalker,3,2,1
Teewin,area-52,96,monk,windwalker,6,1,5
Giriom,thrall,96,monk,windwalker,6,1,5
Æsir,moon-guard,96,monk,windwalker,6,1,5
Buddaba,tichondrius,96,monk,windwalker,6,1,5
Bwan,kelthuzad,96,monk,windwalker,6,1,5
Lainerya,moon-guard,96,monk,windwalker,6,1,5
Banidiin,moon-guard,96,monk,windwalker,6,1,5
Quaria,moon-guard,96,monk,windwalker,6,1,5
Nbatrap,stormrage,96,monk,windwalker,6,1,5
Alkaholik,stormrage,96,monk,windwalker,6,1,5
Forestweaver,area-52,96,monk,windwalker,6,1,5
Okuraseru,bleeding-hollow,96,monk,windwalker,6,1,5
Imingleejr,illidan,96,monk,windwalker,6,1,5
Plotting,tichondrius,96,monk,windwalker,6,1,5
Cerocool,hyjal,96,monk,windwalker,6,1,5
Saruyo,frostmourne,96,monk,windwalker,6,1,5
Netang,emerald-dream,96,monk,windwalker,6,1,5
Monkanome,gilneas,96,monk,windwalker,6,1,5
Ischys,kelthuzad,96,monk,windwalker,6,1,5
Jh,korgath,96,monk,windwalker,6,1,5
Munnk,stormreaver,96,monk,windwalker,6,1,5
Piccolo,emerald-dream,96,monk,windwalker,6,1,5
Zinque,emerald-dream,96,monk,windwalker,6,1,5
Omoplàta,illidan,96,monk,windwalker,6,1,5
Tmtricks,tichondrius,96,monk,windwalker,6,1,5
Windlordx,illidan,96,monk,windwalker,6,1,5
Kablam,frostmourne,96,monk,windwalker,6,1,5
Srshy,drakkari,96,monk,windwalker,6,1,5
Gablle,tol-barad,96,monk,windwalker,6,1,5
Obiiwan,tichondrius,96,monk,windwalker,6,1,5
Sanemi,amanthul,96,monk,windwalker,6,1,5
Friëden,quelthalas,96,monk,windwalker,6,1,5
Yípman,uldum,96,monk,windwalker,6,1,5
Srgtbingo,azgalor,96,monk,windwalker,6,1,5
Pléb,kelthuzad,96,monk,windwalker,6,1,5
Shinobiww,area-52,96,monk,windwalker,6,1,5
Legsweeps,tichondrius,96,monk,windwalker,6,1,5
Memurk,bleeding-hollow,96,monk,windwalker,6,1,5
Xhu,kelthuzad,96,monk,windwalker,6,1,5
Chipócluda,ragnaros,96,monk,windwalker,6,1,5
Molsonicee,tichondrius,96,monk,windwalker,6,1,5
Comical,malygos,96,monk,windwalker,6,1,5
Cmon,icecrown,96,monk,windwalker,12,1,11
Tuskytwofist,kargath,96,monk,windwalker,12,1,11
Yosisoy,zuljin,79,monk,windwalker,5,1,4
Zhatafaq,ragnaros,48,monk,windwalker,3,1,2
Kreese,rivendare,42,monk,windwalker,9,2,7
Cosetteb,proudmoore,31,monk,windwalker,2,1,1
Notamønk,bonechewer,31,monk,windwalker,2,1,1
Laggyfist,frostmourne,16,monk,windwalker,1,1,0
Rèxpéi,area-52,2157,paladin,holy,84,48,36
Overwhelm,muradin,2125,paladin,holy,64,39,25
Sunita,arthas,2116,paladin,holy,189,99,90
Pattar,area-52,2107,paladin,holy,66,37,29
Dreathhammer,muradin,2093,paladin,holy,96,48,48
Holylolz,ragnaros,2042,paladin,holy,198,99,99
Bubblebuddyx,tichondrius,2037,paladin,holy,71,34,37
Tmborn,tichondrius,2035,paladin,holy,89,40,49
Digglesx,area-52,2012,paladin,holy,78,35,43
Braindeadrsj,anetheron,1990,paladin,holy,161,90,71
Bilmurii,zuljin,1981,paladin,holy,96,51,45
Nickimahoj,tichondrius,1943,paladin,holy,81,42,39
Eskerda,azralon,1939,paladin,holy,160,77,83
Bombboyoz,area-52,1936,paladin,holy,84,44,40
Flõw,gnomeregan,1919,paladin,holy,84,52,32
Hamsti,sargeras,1909,paladin,holy,125,63,62
Baelsimp,illidan,1898,paladin,holy,96,50,46
Flashv,barthilas,1896,paladin,holy,62,32,30
Pelletbrain,emerald-dream,1892,paladin,holy,192,103,89
Saacbot,area-52,1890,paladin,holy,75,29,46
Angrycubanx,black-dragonflight,1887,paladin,holy,50,25,25
Thejustice,tichondrius,1875,paladin,holy,138,69,69
Bravepala,tichondrius,1862,paladin,holy,78,35,43
Thejustices,tichondrius,1860,paladin,holy,36,22,14
Curator,emerald-dream,1859,paladin,holy,56,29,27
Sde,kelthuzad,1855,paladin,holy,132,61,71
Sojupapi,area-52,1842,paladin,holy,108,54,54
Dýstopia,stormrage,1841,paladin,holy,41,21,20
Skillenjoyer,tichondrius,1839,paladin,holy,78,49,29
Csupremacy,tichondrius,1839,paladin,holy,64,30,34
Bushyy,tichondrius,1838,paladin,holy,54,26,28
Duallkore,stormrage,1835,paladin,holy,78,42,36
Insthy,illidan,1831,paladin,holy,66,38,28
Nyctemavanna,ragnaros,1831,paladin,holy,94,50,44
Cynthianna,tichondrius,1830,paladin,holy,206,108,98
Ðáx,sargeras,1828,paladin,holy,75,39,36
Ppgdx,azralon,1826,paladin,holy,78,34,44
Caveyodeler,zuluhed,1822,paladin,holy,47,28,19
Cyphinx,darkspear,1822,paladin,holy,103,48,55
Memnoche,frostmane,1821,paladin,holy,89,53,36
Sacbubldead,area-52,1820,paladin,holy,126,79,47
Truluck,area-52,1820,paladin,holy,111,56,55
Perfect,crushridge,1820,paladin,holy,56,28,28
Deadlyassian,sargeras,1819,paladin,holy,100,54,46
Fonypally,tichondrius,1815,paladin,holy,332,171,161
Uxe,zuljin,1812,paladin,holy,60,30,30
Judgejim,barthilas,1812,paladin,holy,144,66,78
Fukndibs,kiljaeden,1811,paladin,holy,172,85,87
Sd,kelthuzad,1811,paladin,holy,123,59,64
Bubblist,tichondrius,1811,paladin,holy,68,28,40
Jaywalker,baelgun,1810,paladin,holy,36,21,15
Bravepl,tichondrius,1808,paladin,holy,73,28,45
Dracfire,zuljin,1807,paladin,holy,45,24,21
Zetsubõ,stormrage,1806,paladin,holy,54,24,30
Ængelic,barthilas,1803,paladin,holy,202,107,95
Dyppally,moon-guard,1803,paladin,holy,102,51,51
Wtbmana,frostmourne,1801,paladin,holy,72,39,33
Tylennis,archimonde,1801,paladin,holy,172,82,90
Richpiana,nathrezim,1800,paladin,holy,106,60,46
Hongwoosang,tichondrius,1795,paladin,holy,188,89,99
Amourranth,stormrage,1785,paladin,holy,52,30,22
Airbad,tichondrius,1785,paladin,holy,53,23,30
Scrubbinton,zuljin,1784,paladin,holy,90,43,47
Reverbz,malganis,1781,paladin,holy,84,31,53
Veejayx,tichondrius,1775,paladin,holy,44,21,23
Zilea,kiljaeden,1768,paladin,holy,48,24,24
Hps,argent-dawn,1759,paladin,holy,42,22,20
Scamlikely,tichondrius,1758,paladin,holy,96,49,47
Colepal,zuljin,1754,paladin,holy,66,25,41
Defensezone,tichondrius,1749,paladin,holy,74,36,38
Chenzo,exodar,1746,paladin,holy,184,95,89
Boomda,tichondrius,1740,paladin,holy,176,96,80
Ihaveajob,zuluhed,1730,paladin,holy,42,23,19
Mercedez,bleeding-hollow,1724,paladin,holy,54,28,26
Brynnhild,stormrage,1722,paladin,holy,102,55,47
Kustp,tichondrius,1718,paladin,holy,183,105,78
Fixyouz,mannoroth,1718,paladin,holy,118,55,63
Beyondsausag,malganis,1718,paladin,holy,89,41,48
Ckaïnë,stormrage,1714,paladin,holy,68,36,32
Softsister,tichondrius,1713,paladin,holy,42,22,20
Kevinthecube,nerzhul,1705,paladin,holy,42,31,11
Heaven,gurubashi,1705,paladin,holy,47,22,25
Careless,malganis,1704,paladin,holy,36,18,18
Taargaryenn,tichondrius,1701,paladin,holy,60,32,28
Holymooie,frostmourne,1692,paladin,holy,30,18,12
Fortold,bloodhoof,1692,paladin,holy,54,23,31
Virabelle,gurubashi,1690,paladin,holy,48,25,23
Evylinn,burning-legion,1684,paladin,holy,126,69,57
Hats,icecrown,1676,paladin,holy,165,80,85
Tenêbrae,area-52,1674,paladin,holy,52,33,19
Thorfinaa,moon-guard,1673,paladin,holy,41,24,17
Sàga,hyjal,1671,paladin,holy,53,29,24
Mvpj,medivh,1669,paladin,holy,153,78,75
Cheerleader,bleeding-hollow,1668,paladin,holy,138,62,76
Imshmackedd,darkspear,1663,paladin,holy,84,35,49
Tiernoo,illidan,1662,paladin,holy,98,46,52
Landrysdad,malorne,1660,paladin,holy,54,26,28
Ivan,tichondrius,1659,paladin,holy,136,62,74
Sacridas,fizzcrank,1657,paladin,holy,36,20,16
Zunit,laughing-skull,1656,paladin,holy,46,22,24
Avengom,tichondrius,1653,paladin,holy,357,179,178
Xciss,kiljaeden,1652,paladin,holy,246,119,127
Mayru,ragnaros,1651,paladin,holy,39,20,19
Pallice,queldorei,1651,paladin,holy,96,43,53
Bombboyozjr,area-52,1649,paladin,holy,30,20,10
Lalatinaford,amanthul,1647,paladin,holy,76,44,32
Ppgddxx,azralon,1643,paladin,holy,30,18,12
Nerfretpls,area-52,1642,paladin,holy,42,20,22
Citylights,tichondrius,1640,paladin,holy,27,19,8
Dazargeros,moon-guard,1638,paladin,holy,132,66,66
Bpalaayo,kelthuzad,1636,paladin,holy,94,37,57
Ellyarian,emerald-dream,1635,paladin,holy,42,22,20
Teenytoots,burning-legion,1635,paladin,holy,69,26,43
Yuuichi,moon-guard,1634,paladin,holy,64,29,35
Gwok,thrall,1633,paladin,holy,136,76,60
Enzõ,illidan,1632,paladin,holy,42,23,19
Rhönin,sargeras,1632,paladin,holy,54,22,32
Rhunon,dalaran,1631,paladin,holy,78,41,37
Shazuwu,illidan,1630,paladin,holy,30,17,13
Xcuse,tichondrius,1630,paladin,holy,84,43,41
Bopthebomb,sargeras,1628,paladin,holy,65,32,33
Pála,dalaran,1625,paladin,holy,164,80,84
Deepnasty,galakrond,1624,paladin,holy,215,110,105
Barcie,lothar,1624,paladin,holy,54,18,36
Mangoflash,malganis,1622,paladin,holy,48,18,30
Bopbotx,area-52,1621,paladin,holy,49,17,32
Gospel,duskwood,1617,paladin,holy,65,37,28
Scoopzi,frostmourne,1616,paladin,holy,47,27,20
Rhönin,illidan,1616,paladin,holy,42,22,20
Ascion,tichondrius,1614,paladin,holy,119,58,61
Caitthegreat,malorne,1613,paladin,holy,42,23,19
Sekitar,ragnaros,1611,paladin,holy,155,79,76
Zergmé,executus,1610,paladin,holy,42,21,21
Ricopal,frostmourne,1610,paladin,holy,36,17,19
Jealp,sargeras,1608,paladin,holy,42,26,16
Roundhere,area-52,1608,paladin,holy,30,18,12
Larryhoova,malganis,1608,paladin,holy,36,20,16
Crâfty,bleeding-hollow,1608,paladin,holy,83,45,38
Forsakenlite,sargeras,1606,paladin,holy,90,41,49
Ddeuk,tichondrius,1603,paladin,holy,373,189,184
Minefujiko,tichondrius,1603,paladin,holy,377,191,186
Erikx,smolderthorn,1601,paladin,holy,120,66,54
Orphandog,zuljin,1600,paladin,holy,29,21,8
Sevenword,tichondrius,1600,paladin,holy,52,31,21
Gjoker,azralon,1600,paladin,holy,42,25,17
Chonsic,darkspear,1599,paladin,holy,64,28,36
Jiraya,nemesis,1598,paladin,holy,79,39,40
Saveursavior,bleeding-hollow,1597,paladin,holy,129,64,65
Wuhbp,illidan,1596,paladin,holy,88,44,44
Bushys,tichondrius,1596,paladin,holy,36,18,18
Guerrer,hyjal,1594,paladin,holy,404,208,196
Asherm,moon-guard,1590,paladin,holy,98,48,50
Retsincewod,zuluhed,1586,paladin,holy,54,28,26
Molki,tichondrius,1583,paladin,holy,99,59,40
Thelac,dalaran,1575,paladin,holy,72,39,33
Regivän,azralon,1575,paladin,holy,78,39,39
Pasda,frostmourne,1575,paladin,holy,53,22,31
Dodgeandhoj,nerzhul,1572,paladin,holy,36,19,17
Aluríel,quelthalas,1568,paladin,holy,56,28,28
Peelmeree,kelthuzad,1565,paladin,holy,36,18,18
Beejae,stormreaver,1565,paladin,holy,41,17,24
Quertz,sargeras,1564,paladin,holy,62,44,18
Hônòr,thrall,1564,paladin,holy,51,29,22
Naxzy,quelthalas,1564,paladin,holy,36,20,16
Sprjustice,frostmourne,1562,paladin,holy,36,18,18
Raigha,stormrage,1558,paladin,holy,36,19,17
Gazapal,thrall,1556,paladin,holy,150,83,67
Drägonmynuts,tichondrius,1556,paladin,holy,103,43,60
Montageflav,illidan,1554,paladin,holy,56,27,29
Gorgona,illidan,1551,paladin,holy,107,53,54
Crabsaladpal,illidan,1550,paladin,holy,112,62,50
Handsomedan,twisting-nether,1550,paladin,holy,54,26,28
Jiberish,illidan,1548,paladin,holy,110,53,57
Blarr,azshara,1541,paladin,holy,60,25,35
Riptonix,stormrage,1540,paladin,holy,121,66,55
Discordnitro,illidan,1539,paladin,holy,36,20,16
Runihaveaids,stormrage,1538,paladin,holy,154,78,76
Shagalaga,tichondrius,1534,paladin,holy,78,37,41
Baitur,zuljin,1530,paladin,holy,31,17,14
Avahir,moon-guard,1528,paladin,holy,60,30,30
Solfire,stormreaver,1526,paladin,holy,74,32,42
Rodrigo,frostmourne,1524,paladin,holy,69,34,35
Kidstable,nathrezim,1523,paladin,holy,70,27,43
Songminsu,proudmoore,1522,paladin,holy,70,28,42
Beyönd,quelthalas,1520,paladin,holy,78,39,39
Pandahorn,tichondrius,1520,paladin,holy,54,23,31
Dageraad,tichondrius,1519,paladin,holy,30,16,14
Bigoldman,tichondrius,1519,paladin,holy,72,37,35
Drisx,sargeras,1514,paladin,holy,78,35,43
Maeyz,sargeras,1511,paladin,holy,126,67,59
Bushÿ,tichondrius,1508,paladin,holy,94,52,42
Humañ,tichondrius,1507,paladin,holy,60,32,28
Cjqcjq,tichondrius,1507,paladin,holy,41,21,20
Buqi,barthilas,1506,paladin,holy,39,17,22
Kdex,tichondrius,1505,paladin,holy,84,37,47
Ageroÿ,sargeras,1503,paladin,holy,61,31,30
Doofum,stormrage,1503,paladin,holy,131,58,73
Serendipidy,bleeding-hollow,1503,paladin,holy,98,43,55
Brumm,quelthalas,1501,paladin,holy,77,39,38
Vitabro,bleeding-hollow,1500,paladin,holy,101,56,45
Wokeinator,malganis,1500,paladin,holy,231,125,106
Rarth,nemesis,1497,paladin,holy,47,20,27
Rg,nerzhul,1496,paladin,holy,179,86,93
Jeromee,area-52,1496,paladin,holy,48,19,29
Haitishammer,stormrage,1494,paladin,holy,78,37,41
Lightkillerx,thrall,1494,paladin,holy,84,37,47
Wonpai,frostmourne,1490,paladin,holy,36,18,18
Xinqingle,tichondrius,1489,paladin,holy,329,162,167
Nickiminhoj,stormrage,1488,paladin,holy,51,29,22
Donkeydumper,wyrmrest-accord,1486,paladin,holy,118,67,51
Allitharis,tichondrius,1486,paladin,holy,97,53,44
Condone,earthen-ring,1484,paladin,holy,90,41,49
Leónrey,stormrage,1484,paladin,holy,57,20,37
Regivan,nemesis,1479,paladin,holy,42,16,26
Senorbaxter,emerald-dream,1478,paladin,holy,48,17,31
Dewlight,zuljin,1477,paladin,holy,161,77,84
Jorik,lightbringer,1477,paladin,holy,42,20,22
Granklol,tichondrius,1476,paladin,holy,50,25,25
Percüles,sargeras,1473,paladin,holy,66,38,28
Prettylightx,kelthuzad,1473,paladin,holy,164,79,85
Ibury,quelthalas,1472,paladin,holy,131,60,71
Ryhigh,sargeras,1471,paladin,holy,48,19,29
Droopyz,quelthalas,1468,paladin,holy,60,26,34
Judgemode,the-scryers,1468,paladin,holy,96,41,55
Varies,kelthuzad,1466,paladin,holy,34,16,18
Daenrahh,azralon,1465,paladin,holy,164,84,80
Gotomars,tichondrius,1465,paladin,holy,71,34,37
Glørythrives,tichondrius,1465,paladin,holy,57,25,32
Konvi,tichondrius,1464,paladin,holy,60,24,36
Traumaboy,terenas,1463,paladin,holy,57,28,29
Cohesion,draenor,1461,paladin,holy,77,35,42
Bebebig,tichondrius,1460,paladin,holy,60,35,25
Indemnity,wildhammer,1457,paladin,holy,69,40,29
Nume,nesingwary,1456,paladin,holy,90,47,43
Gankstapwn,tichondrius,1455,paladin,holy,53,24,29
Devöut,aggramar,1453,paladin,holy,103,48,55
Holyterror,dentarg,1451,paladin,holy,42,23,19
Zakath,the-underbog,1449,paladin,holy,72,31,41
Zoeyxo,tichondrius,1448,paladin,holy,80,42,38
Noback,ragnaros,1448,paladin,holy,66,31,35
Handyandy,kelthuzad,1447,paladin,holy,100,52,48
Kihluxo,frostmourne,1446,paladin,holy,101,56,45
Wálker,ragnaros,1446,paladin,holy,74,39,35
Holyknight,veknilash,1446,paladin,holy,71,32,39
Celsica,kelthuzad,1443,paladin,holy,153,73,80
Chowdar,proudmoore,1443,paladin,holy,78,36,42
Holyprotectr,tichondrius,1442,paladin,holy,30,17,13
Danyuel,zuljin,1441,paladin,holy,86,39,47
Sigmapepe,quelthalas,1436,paladin,holy,96,52,44
Cynical,dalvengyr,1435,paladin,holy,108,59,49
Zephyrvalor,sargeras,1430,paladin,holy,42,18,24
Kriegmeister,amanthul,1429,paladin,holy,48,24,24
Rezmefool,tichondrius,1428,paladin,holy,115,54,61
Sinfolly,whisperwind,1427,paladin,holy,66,33,33
Omfgitsyang,tichondrius,1426,paladin,holy,30,18,12
Nrpzy,stormrage,1425,paladin,holy,83,39,44
Lothnalar,ragnaros,1424,paladin,holy,54,23,31
Mabia,tichondrius,1421,paladin,holy,215,111,104
Graceyrae,tichondrius,1419,paladin,holy,50,30,20
Jpwx,barthilas,1419,paladin,holy,30,15,15
Amadeo,hyjal,1418,paladin,holy,95,44,51
Decalli,tichondrius,1417,paladin,holy,69,35,34
Danpros,azralon,1417,paladin,holy,66,24,42
Bosat,drakkari,1416,paladin,holy,36,15,21
Xuanxingchai,tichondrius,1413,paladin,holy,72,30,42
Vodokus,area-52,1412,paladin,holy,48,17,31
Piïls,sargeras,1410,paladin,holy,36,15,21
Jezëbel,azralon,1408,paladin,holy,24,15,9
Vasar,tichondrius,1406,paladin,holy,37,26,11
Wonpaiv,frostmourne,1404,paladin,holy,35,15,20
Moonmi,tichondrius,1403,paladin,holy,115,61,54
Nxkita,sargeras,1403,paladin,holy,54,28,26
Oralen,daggerspine,1402,paladin,holy,48,24,24
Nanøha,frostmourne,1402,paladin,holy,88,26,62
Delilahxoxo,mugthol,1400,paladin,holy,45,18,27
Talantyr,zuljin,1398,paladin,holy,48,23,25
Uprise,chogall,1397,paladin,holy,66,33,33
Fabîan,guldan,1395,paladin,holy,42,22,20
Vêgenace,proudmoore,1394,paladin,holy,39,19,20
Dadcantsac,frostmourne,1391,paladin,holy,81,38,43
Anea,kelthuzad,1388,paladin,holy,32,17,15
Summercarma,area-52,1387,paladin,holy,27,15,12
Luminainre,zuljin,1384,paladin,holy,149,66,83
Liå,frostmourne,1383,paladin,holy,84,43,41
Ricemang,kiljaeden,1380,paladin,holy,53,24,29
Samaze,tichondrius,1378,paladin,holy,99,46,53
Twck,hyjal,1374,paladin,holy,114,55,59
Lu,the-venture-co,1371,paladin,holy,34,15,19
Fiate,azralon,1370,paladin,holy,36,16,20
Jimmipepe,quelthalas,1369,paladin,holy,42,24,18
Shaidd,bleeding-hollow,1368,paladin,holy,77,34,43
Zacháry,sargeras,1367,paladin,holy,176,87,89
Saeranella,moon-guard,1366,paladin,holy,106,44,62
Granitei,quelthalas,1365,paladin,holy,39,18,21
Paladinaa,lothar,1364,paladin,holy,104,41,63
Odiinn,stormscale,1363,paladin,holy,73,32,41
Gorilla,kiljaeden,1362,paladin,holy,59,15,44
Holyhades,auchindoun,1360,paladin,holy,85,46,39
Rengen,frostmourne,1360,paladin,holy,42,22,20
Choonsly,tichondrius,1356,paladin,holy,69,36,33
Bakoø,tichondrius,1354,paladin,holy,53,24,29
Holyramen,illidan,1354,paladin,holy,146,66,80
Palapoxi,arygos,1353,paladin,holy,54,23,31
Splashleyy,bleeding-hollow,1353,paladin,holy,96,40,56
Saphri,kiljaeden,1353,paladin,holy,63,26,37
Brioc,tichondrius,1352,paladin,holy,30,17,13
Galabanja,malganis,1350,paladin,holy,42,24,18
Hawtwangs,proudmoore,1349,paladin,holy,48,26,22
Flippo,sargeras,1346,paladin,holy,36,17,19
Quadrifoglio,moon-guard,1344,paladin,holy,199,100,99
Airbusx,tichondrius,1343,paladin,holy,24,14,10
Miswalkpally,ragnaros,1342,paladin,holy,30,14,16
Censy,tichondrius,1341,paladin,holy,24,14,10
Dartpuncher,frostmourne,1340,paladin,holy,42,21,21
Chunzhangsqs,tichondrius,1339,paladin,holy,36,14,22
Therealdeal,sargeras,1338,paladin,holy,51,28,23
Htmlar,tichondrius,1338,paladin,holy,75,41,34
Xiaoladin,frostmourne,1337,paladin,holy,25,16,9
Güido,stormrage,1337,paladin,holy,42,23,19
Minereth,quelthalas,1337,paladin,holy,59,30,29
Leonrey,stormrage,1337,paladin,holy,43,21,22
Dwarrior,quelthalas,1337,paladin,holy,33,15,18
Donoph,blades-edge,1336,paladin,holy,42,20,22
Finerkane,quelthalas,1334,paladin,holy,138,62,76
Alphanerd,burning-blade,1333,paladin,holy,55,27,28
Hawianbread,stormrage,1331,paladin,holy,60,33,27
Buri,tichondrius,1330,paladin,holy,42,17,25
Maleguz,azralon,1328,paladin,holy,220,112,108
Syrenz,khazgoroth,1327,paladin,holy,42,24,18
Castleknight,tichondrius,1327,paladin,holy,36,14,22
Catechism,laughing-skull,1325,paladin,holy,44,24,20
Jordenz,bonechewer,1324,paladin,holy,30,14,16
Consecrated,daggerspine,1324,paladin,holy,75,30,45
Ryhighh,sargeras,1324,paladin,holy,81,32,49
Mcllovin,kiljaeden,1323,paladin,holy,60,28,32
Dimior,quelthalas,1322,paladin,holy,54,29,25
Paladinaiko,nemesis,1322,paladin,holy,111,56,55
Zantdemption,frostmourne,1322,paladin,holy,30,15,15
Kektrixia,tichondrius,1318,paladin,holy,24,15,9
Ùnholypally,jubeithos,1316,paladin,holy,71,42,29
Valandiel,proudmoore,1315,paladin,holy,61,15,46
Holyslapy,illidan,1313,paladin,holy,59,34,25
Hodl,barthilas,1311,paladin,holy,95,49,46
Kenric,quelthalas,1309,paladin,holy,43,18,25
Solanin,frostmourne,1307,paladin,holy,57,30,27
Ramphastoz,quelthalas,1307,paladin,holy,60,26,34
Ozpal,burning-blade,1305,paladin,holy,38,24,14
Errant,bonechewer,1305,paladin,holy,53,31,22
Santiadin,ragnaros,1304,paladin,holy,20,15,5
Jestiny,amanthul,1302,paladin,holy,73,39,34
Dreadrot,azralon,1302,paladin,holy,50,24,26
Unbreakable,antonidas,1301,paladin,holy,30,21,9
Sorkar,tichondrius,1301,paladin,holy,129,66,63
Ironpaladin,sargeras,1297,paladin,holy,90,39,51
Jaenus,azralon,1296,paladin,holy,54,25,29
Vurian,uther,1295,paladin,holy,90,36,54
Malakor,thrall,1293,paladin,holy,63,32,31
Goodwood,ghostlands,1293,paladin,holy,90,41,49
Thiccholy,deathwing,1289,paladin,holy,122,70,52
Theebus,tichondrius,1287,paladin,holy,47,15,32
Blessthfall,bleeding-hollow,1286,paladin,holy,51,14,37
Mawning,kelthuzad,1277,paladin,holy,122,61,61
Phinnik,tichondrius,1276,paladin,holy,178,91,87
Imabandagins,bleeding-hollow,1274,paladin,holy,30,15,15
Swordstrikes,tichondrius,1271,paladin,holy,29,14,15
Galeras,norgannon,1271,paladin,holy,121,52,69
Lilfingered,malganis,1267,paladin,holy,36,19,17
Merll,ragnaros,1265,paladin,holy,115,55,60
Affrika,ysondre,1264,paladin,holy,104,52,52
Pallin,sargeras,1264,paladin,holy,90,41,49
Quarall,blackhand,1263,paladin,holy,52,25,27
Psuito,ragnaros,1258,paladin,holy,48,25,23
Salipally,dalaran,1258,paladin,holy,101,46,55
Brenenk,quelthalas,1257,paladin,holy,65,32,33
Vithar,bleeding-hollow,1257,paladin,holy,116,56,60
Babylonfive,zuluhed,1257,paladin,holy,51,21,30
Holysplonk,stonemaul,1255,paladin,holy,72,30,42
Swazanaseger,frostmourne,1252,paladin,holy,36,19,17
Wukongsunn,dalaran,1251,paladin,holy,30,14,16
Sinay,azshara,1250,paladin,holy,40,23,17
Holyredx,bleeding-hollow,1250,paladin,holy,96,52,44
Chewiipal,dalaran,1248,paladin,holy,45,26,19
Röniin,ragnaros,1248,paladin,holy,262,134,128
Whitekao,illidan,1247,paladin,holy,18,13,5
Colbroggins,crushridge,1246,paladin,holy,36,18,18
Everrlasting,tichondrius,1245,paladin,holy,30,13,17
Darkbringer,frostmourne,1244,paladin,holy,63,31,32
Stephon,area-52,1244,paladin,holy,30,13,17
Cewekmbek,barthilas,1244,paladin,holy,36,13,23
Kensyzs,tichondrius,1244,paladin,holy,36,13,23
Bubblepigo,tichondrius,1243,paladin,holy,36,22,14
Nikopala,tichondrius,1242,paladin,holy,30,17,13
Sologriefer,sargeras,1242,paladin,holy,30,13,17
Abellpally,tichondrius,1241,paladin,holy,30,13,17
Herroprease,frostmane,1241,paladin,holy,30,13,17
Aulty,sargeras,1241,paladin,holy,30,13,17
Scarlet,skywall,1241,paladin,holy,30,13,17
Denthus,dragonmaw,1240,paladin,holy,30,13,17
Bërzerk,zuluhed,1239,paladin,holy,36,13,23
Kristienna,boulderfist,1236,paladin,holy,35,16,19
Hughmyron,stormrage,1235,paladin,holy,18,13,5
Cbm,tichondrius,1235,paladin,holy,23,14,9
Fuzed,frostmourne,1234,paladin,holy,159,80,79
Judgynomnom,the-underbog,1234,paladin,holy,36,13,23
Neurôtoxins,frostmourne,1233,paladin,holy,24,13,11
Kencyxx,tichondrius,1233,paladin,holy,30,13,17
Oldgrumpster,stormrage,1232,paladin,holy,93,43,50
Harryhui,tichondrius,1231,paladin,holy,24,13,11
Diebeatus,zuljin,1231,paladin,holy,54,25,29
Amiigo,tichondrius,1231,paladin,holy,36,13,23
Aoishie,bleeding-hollow,1229,paladin,holy,84,38,46
Justizz,vashj,1228,paladin,holy,65,35,30
Enuug,malfurion,1226,paladin,holy,42,23,19
Mundomaloo,quelthalas,1226,paladin,holy,59,31,28
Crocfacex,tichondrius,1226,paladin,holy,46,18,28
Negodoskate,nemesis,1225,paladin,holy,189,91,98
Szsfstnoob,tichondrius,1224,paladin,holy,30,13,17
Aellithiene,tichondrius,1221,paladin,holy,30,13,17
Elizzabeth,skullcrusher,1220,paladin,holy,35,21,14
Cudiskush,tichondrius,1219,paladin,holy,42,23,19
Ramspartan,drakkari,1218,paladin,holy,106,52,54
Whangsta,tichondrius,1217,paladin,holy,48,21,27
Boarfarmer,tichondrius,1215,paladin,holy,81,35,46
Saffranzord,azralon,1214,paladin,holy,73,35,38
Undefeatæd,korgath,1214,paladin,holy,42,20,22
Tandury,tichondrius,1214,paladin,holy,60,28,32
Kamaelyn,proudmoore,1211,paladin,holy,133,68,65
Capedcrusade,area-52,1208,paladin,holy,24,13,11
Hobbsone,trollbane,1208,paladin,holy,113,43,70
Yérn,barthilas,1208,paladin,holy,42,15,27
Xq,aegwynn,1205,paladin,holy,38,18,20
Lightleadsme,sargeras,1205,paladin,holy,36,15,21
Randuir,proudmoore,1204,paladin,holy,48,26,22
Burgalveist,azgalor,1202,paladin,holy,25,15,10
Chopsparks,khadgar,1201,paladin,holy,147,75,72
Maaxxee,zuljin,1200,paladin,holy,27,13,14
Mörphêus,tichondrius,1197,paladin,holy,54,30,24
Encantado,thrall,1196,paladin,holy,31,15,16
Shorthordeon,kelthuzad,1194,paladin,holy,54,30,24
Dreemie,tichondrius,1194,paladin,holy,54,20,34
Dbolpala,frostmourne,1192,paladin,holy,48,26,22
Pemodyne,illidan,1189,paladin,holy,54,16,38
Pallythre,proudmoore,1187,paladin,holy,54,23,31
Faileeria,malganis,1185,paladin,holy,36,25,11
Sixtynine,nathrezim,1180,paladin,holy,78,35,43
Prosykt,sargeras,1179,paladin,holy,36,14,22
Myrthedara,kargath,1178,paladin,holy,33,16,17
Barbaluzz,quelthalas,1174,paladin,holy,257,123,134
Stemi,kelthuzad,1171,paladin,holy,41,15,26
Cowladino,tichondrius,1169,paladin,holy,36,15,21
Bárdokø,ragnaros,1168,paladin,holy,60,28,32
Coltlocks,sargeras,1168,paladin,holy,36,14,22
Clehley,turalyon,1162,paladin,holy,36,16,20
Hammercy,tichondrius,1155,paladin,holy,73,39,34
Chewyjitsu,tichondrius,1155,paladin,holy,42,15,27
Onecmpeter,kelthuzad,1152,paladin,holy,67,38,29
Boxjang,tichondrius,1149,paladin,holy,24,12,12
Savagegirlz,tichondrius,1147,paladin,holy,76,33,43
Bubblebooty,drakthul,1146,paladin,holy,54,33,21
Kënsi,quelthalas,1146,paladin,holy,140,71,69
Zenkk,sargeras,1146,paladin,holy,28,13,15
Toesy,area-52,1146,paladin,holy,64,27,37
Renteria,sargeras,1144,paladin,holy,24,12,12
Sinara,detheroc,1143,paladin,holy,119,56,63
Repèntance,stormrage,1142,paladin,holy,24,12,12
Dazztrain,barthilas,1139,paladin,holy,24,12,12
Deepsearide,illidan,1139,paladin,holy,54,26,28
Exxin,turalyon,1139,paladin,holy,90,40,50
Elogant,mannoroth,1138,paladin,holy,58,33,25
Flareous,moon-guard,1138,paladin,holy,30,12,18
Massivesac,frostmourne,1135,paladin,holy,18,12,6
Crüst,proudmoore,1135,paladin,holy,24,12,12
Daik,proudmoore,1134,paladin,holy,24,15,9
Toroke,nemesis,1133,paladin,holy,54,29,25
Alarter,azralon,1128,paladin,holy,36,13,23
Dóminos,quelthalas,1127,paladin,holy,24,12,12
Belmonte,greymane,1125,paladin,holy,18,12,6
Kentö,area-52,1123,paladin,holy,30,14,16
Bonz,ragnaros,1121,paladin,holy,24,12,12
Sloppybobby,zuljin,1119,paladin,holy,30,16,14
Ziggzag,hyjal,1117,paladin,holy,78,34,44
Dawnhammer,mugthol,1115,paladin,holy,52,25,27
Biwi,zuljin,1115,paladin,holy,61,25,36
Ëd,moon-guard,1110,paladin,holy,168,83,85
Zowolf,quelthalas,1108,paladin,holy,65,33,32
Acori,azralon,1108,paladin,holy,39,18,21
Kelthor,azralon,1104,paladin,holy,36,18,18
Lovehan,tichondrius,1103,paladin,holy,27,12,15
Holysols,zuljin,1102,paladin,holy,24,12,12
Moogmodular,malganis,1100,paladin,holy,39,15,24
Lavarball,tichondrius,1098,paladin,holy,41,14,27
Rykeran,warsong,1096,paladin,holy,96,55,41
Balanoriaa,azralon,1092,paladin,holy,62,29,33
Lobõ,ragnaros,1086,paladin,holy,48,18,30
Maín,tichondrius,1085,paladin,holy,22,12,10
Liadrin,sentinels,1085,paladin,holy,29,12,17
Teloniow,quelthalas,1084,paladin,holy,38,19,19
Hivers,stormrage,1081,paladin,holy,48,22,26
Spikele,barthilas,1079,paladin,holy,30,13,17
Joeboomers,tichondrius,1078,paladin,holy,60,33,27
Shocka,norgannon,1078,paladin,holy,90,48,42
Maldobarr,stormrage,1075,paladin,holy,30,12,18
Resio,illidan,1068,paladin,holy,36,13,23
Lycheelz,illidan,1064,paladin,holy,48,26,22
Unworn,proudmoore,1064,paladin,holy,36,17,19
Júpiter,kiljaeden,1064,paladin,holy,40,17,23
Justeight,stormrage,1063,paladin,holy,35,16,19
Vidalia,barthilas,1062,paladin,holy,23,12,11
Buckybarnes,gorefiend,1061,paladin,holy,42,26,16
Cephadrome,proudmoore,1058,paladin,holy,42,20,22
Mèdic,illidan,1057,paladin,holy,62,34,28
Mctacos,proudmoore,1056,paladin,holy,12,11,1
Odriew,sargeras,1056,paladin,holy,18,11,7
Narcissism,emerald-dream,1056,paladin,holy,18,11,7
Babe,crushridge,1056,paladin,holy,24,11,13
Twichy,tichondrius,1055,paladin,holy,18,11,7
Waifu,area-52,1055,paladin,holy,18,11,7
Lazio,frostmourne,1055,paladin,holy,24,11,13
Holodecoy,bleeding-hollow,1055,paladin,holy,27,12,15
Lickmysacx,tichondrius,1055,paladin,holy,30,11,19
Roundbutts,stormrage,1054,paladin,holy,18,11,7
Aldrion,stormrage,1054,paladin,holy,24,11,13
Beerüs,crushridge,1053,paladin,holy,48,22,26
Eldessia,wyrmrest-accord,1052,paladin,holy,24,11,13
Malakk,zuljin,1051,paladin,holy,47,25,22
Tigranes,proudmoore,1051,paladin,holy,24,11,13
Ramhammerz,sargeras,1051,paladin,holy,54,23,31
Nilin,tichondrius,1050,paladin,holy,18,11,7
Overthrrow,kelthuzad,1050,paladin,holy,138,71,67
Kolmourn,deathwing,1048,paladin,holy,30,11,19
Palooma,area-52,1047,paladin,holy,72,29,43
Notdjalex,zuljin,1046,paladin,holy,18,11,7
Hybbo,runetotem,1042,paladin,holy,24,12,12
Tyriam,stormscale,1038,paladin,holy,18,11,7
Yadiyadiyada,barthilas,1038,paladin,holy,18,11,7
Mcduss,proudmoore,1037,paladin,holy,18,11,7
Jacobhowda,tichondrius,1037,paladin,holy,30,11,19
Nugsbunne,tichondrius,1035,paladin,holy,115,49,66
Pheriox,agamaggan,1032,paladin,holy,24,11,13
Starfaith,illidan,1032,paladin,holy,67,27,40
Lukas,vashj,1030,paladin,holy,132,65,67
Va,onyxia,1029,paladin,holy,54,26,28
Wrathmatics,arthas,1028,paladin,holy,35,14,21
Palqq,tichondrius,1025,paladin,holy,24,11,13
Kipow,proudmoore,1024,paladin,holy,24,11,13
Klansey,magtheridon,1023,paladin,holy,54,30,24
Ahundo,stonemaul,1022,paladin,holy,35,18,17
Center,ragnaros,1022,paladin,holy,23,11,12
Tylnish,hyjal,1021,paladin,holy,24,11,13
Troxnar,ragnaros,1020,paladin,holy,34,22,12
Palaadiin,sargeras,1019,paladin,holy,48,24,24
Xöchïqüëtzäl,tichondrius,1016,paladin,holy,23,11,12
Varenka,stormrage,1015,paladin,holy,83,36,47
Iamholyman,dragonmaw,1014,paladin,holy,29,14,15
Vamir,magtheridon,1014,paladin,holy,30,13,17
Ihr,kiljaeden,1013,paladin,holy,63,28,35
Jazzmatic,dalaran,1012,paladin,holy,23,11,12
Paladinomoto,sargeras,1011,paladin,holy,29,12,17
Rajava,gallywix,1008,paladin,holy,54,26,28
Kbot,zuljin,1005,paladin,holy,15,11,4
Tarnak,kelthuzad,1005,paladin,holy,33,11,22
Paulx,malganis,999,paladin,holy,87,46,41
Gigadunker,tichondrius,999,paladin,holy,29,13,16
Minouther,area-52,996,paladin,holy,68,25,43
Caobobby,tichondrius,996,paladin,holy,39,12,27
Ðß,arthas,995,paladin,holy,30,15,15
Westlysñipes,tichondrius,995,paladin,holy,92,44,48
Hzo,tichondrius,989,paladin,holy,17,11,6
Kaina,wildhammer,987,paladin,holy,53,22,31
Colombía,illidan,986,paladin,holy,54,27,27
Agravaine,moon-guard,986,paladin,holy,23,11,12
Ckemosabe,emerald-dream,985,paladin,holy,32,11,21
Dispirit,the-forgotten-coast,981,paladin,holy,17,11,6
Shanvo,tichondrius,977,paladin,holy,34,21,13
Adventholy,tichondrius,970,paladin,holy,36,15,21
Huijji,illidan,967,paladin,holy,24,15,9
Photons,emerald-dream,966,paladin,holy,24,13,11
Seonghwa,kelthuzad,964,paladin,holy,52,28,24
Romeoo,silver-hand,964,paladin,holy,66,26,40
Hammerabi,moon-guard,963,paladin,holy,21,13,8
Imajeala,thrall,961,paladin,holy,40,21,19
Thoryin,tichondrius,960,paladin,holy,12,10,2
Síríús,malganis,960,paladin,holy,15,11,4
Svitanie,bleeding-hollow,960,paladin,holy,80,38,42
Showtíme,steamwheedle-cartel,959,paladin,holy,18,10,8
Arevia,stormrage,959,paladin,holy,18,10,8
Kencyz,tichondrius,959,paladin,holy,18,10,8
Boundric,emerald-dream,959,paladin,holy,18,10,8
Madorian,bleeding-hollow,959,paladin,holy,24,10,14
Bubblet,bleeding-hollow,958,paladin,holy,18,10,8
Klam,kelthuzad,958,paladin,holy,24,10,14
Vajuicy,dalaran,957,paladin,holy,24,10,14
Lightswitchx,stormrage,957,paladin,holy,24,10,14
Jdxqt,darkspear,957,paladin,holy,30,10,20
Viviana,shadowmoon,955,paladin,holy,24,10,14
Marklite,area-52,955,paladin,holy,24,10,14
Raenilil,area-52,955,paladin,holy,30,12,18
Evanlina,bleeding-hollow,953,paladin,holy,18,10,8
Avasti,proudmoore,953,paladin,holy,24,10,14
Dragonchaos,ragnaros,953,paladin,holy,27,11,16
Sanasana,spirestone,952,paladin,holy,18,10,8
Palladomal,azralon,952,paladin,holy,30,10,20
Snnow,stormrage,951,paladin,holy,30,19,11
Motoa,stormrage,951,paladin,holy,18,10,8
Sventyn,frostmourne,951,paladin,holy,25,11,14
Paladam,burning-blade,948,paladin,holy,24,10,14
Holydood,thunderhorn,947,paladin,holy,18,10,8
Stompcomp,tichondrius,945,paladin,holy,63,29,34
Tolliver,area-52,944,paladin,holy,18,11,7
Lazygamerr,sargeras,944,paladin,holy,18,10,8
Blackiron,frostmourne,941,paladin,holy,23,10,13
Doidyph,frostmourne,935,paladin,holy,24,10,14
Eradrae,mannoroth,933,paladin,holy,18,10,8
Gênji,eldrethalas,930,paladin,holy,54,20,34
Saìdelia,moon-guard,929,paladin,holy,71,24,47
Swamprat,zuljin,922,paladin,holy,23,10,13
Shâka,stormrage,919,paladin,holy,45,22,23
Mianheyo,quelthalas,919,paladin,holy,35,14,21
Hentaiangel,kiljaeden,918,paladin,holy,39,19,20
Rogrmurtaugh,sargeras,912,paladin,holy,20,11,9
Psychorino,tichondrius,906,paladin,holy,27,10,17
Grumpybubble,sargeras,905,paladin,holy,19,11,8
Zhahira,hakkar,905,paladin,holy,24,10,14
Gillgamesh,sentinels,901,paladin,holy,18,11,7
Thaedrun,hydraxis,896,paladin,holy,54,26,28
Fedpowell,tichondrius,894,paladin,holy,23,10,13
Monad,nazjatar,893,paladin,holy,36,15,21
Shananakin,azshara,892,paladin,holy,29,13,16
Stormzy,zuljin,890,paladin,holy,23,10,13
Takodaddy,elune,889,paladin,holy,16,10,6
Lennon,stormrage,885,paladin,holy,78,35,43
Zakh,proudmoore,882,paladin,holy,26,11,15
Papakatsu,proudmoore,878,paladin,holy,48,22,26
Ascension,amanthul,866,paladin,holy,120,44,76
Bobthemad,proudmoore,864,paladin,holy,12,9,3
Trâshcårt,sargeras,864,paladin,holy,12,9,3
Sovice,illidan,864,paladin,holy,12,9,3
Deadry,ysera,864,paladin,holy,18,9,9
Adrizzyx,barthilas,864,paladin,holy,18,9,9
Rachaelucky,malganis,864,paladin,holy,18,9,9
Zilzag,moon-guard,864,paladin,holy,23,9,14
Diamondwater,tichondrius,864,paladin,holy,24,9,15
Racketyman,illidan,863,paladin,holy,12,9,3
Superzero,area-52,863,paladin,holy,12,9,3
Sutadansa,doomhammer,863,paladin,holy,77,42,35
Onlycams,sargeras,863,paladin,holy,24,9,15
Lhpal,ragnaros,862,paladin,holy,12,9,3
Holymorph,tichondrius,862,paladin,holy,18,9,9
Msheen,azralon,861,paladin,holy,12,9,3
Kusotarão,nemesis,861,paladin,holy,18,9,9
Palltard,illidan,861,paladin,holy,24,9,15
Atelva,moon-guard,859,paladin,holy,17,9,8
Hopeyouheal,sargeras,859,paladin,holy,18,9,9
Chånïng,frostmourne,859,paladin,holy,24,9,15
Herakleitos,firetree,858,paladin,holy,18,9,9
Mobitz,dalvengyr,858,paladin,holy,24,9,15
Stricken,kul-tiras,857,paladin,holy,24,9,15
Spamsalot,malganis,857,paladin,holy,24,9,15
Holyiseasy,alleria,853,paladin,holy,29,11,18
Nedorshock,stormrage,853,paladin,holy,24,9,15
Lafasíta,ragnaros,852,paladin,holy,24,9,15
Veronica,sentinels,852,paladin,holy,42,9,33
Vëlar,tichondrius,851,paladin,holy,18,9,9
Mytolo,malganis,851,paladin,holy,24,9,15
Nualrossan,veknilash,848,paladin,holy,53,21,32
Maalik,thrall,844,paladin,holy,18,9,9
Andormu,wyrmrest-accord,841,paladin,holy,18,9,9
Vaalbara,fizzcrank,834,paladin,holy,24,9,15
Jaok,tichondrius,831,paladin,holy,21,10,11
Bainn,nerzhul,822,paladin,holy,73,31,42
Alltoohuman,nagrand,821,paladin,holy,23,9,14
Nea,argent-dawn,811,paladin,holy,77,29,48
Praisin,zuljin,805,paladin,holy,18,9,9
Palaknight,tichondrius,804,paladin,holy,54,18,36
Davinity,senjin,799,paladin,holy,23,9,14
Athanaiëll,proudmoore,792,paladin,holy,16,10,6
Holyfrénzy,thrall,776,paladin,holy,25,9,16
Swellowsx,tichondrius,768,paladin,holy,12,8,4
Archerxx,ragnaros,768,paladin,holy,12,8,4
Alkyna,kelthuzad,768,paladin,holy,12,8,4
Kritzyx,stormrage,768,paladin,holy,12,8,4
Lòuisvuttion,tichondrius,768,paladin,holy,12,8,4
Denke,thrall,768,paladin,holy,18,8,10
Pality,illidan,768,paladin,holy,18,8,10
Artús,ragnaros,768,paladin,holy,18,8,10
Zero,anetheron,768,paladin,holy,18,8,10
Voladis,malganis,768,paladin,holy,30,8,22
Usebandage,sargeras,767,paladin,holy,12,8,4
Bestpally,alterac-mountains,767,paladin,holy,12,8,4
Mhera,sargeras,767,paladin,holy,12,8,4
Kriegstier,scarlet-crusade,767,paladin,holy,12,8,4
Linaiah,moon-guard,767,paladin,holy,12,8,4
Wonpai,barthilas,767,paladin,holy,18,8,10
Miniweiner,proudmoore,767,paladin,holy,18,8,10
Trancelancer,kelthuzad,767,paladin,holy,18,8,10
Lanzzelot,goldrinn,767,paladin,holy,18,8,10
Hruuhwa,wyrmrest-accord,766,paladin,holy,12,8,4
Caike,frostmourne,766,paladin,holy,12,8,4
Bulgecranker,tichondrius,766,paladin,holy,12,8,4
Palawun,nerzhul,766,paladin,holy,24,8,16
Thonar,stormrage,765,paladin,holy,12,8,4
Revenere,tichondrius,765,paladin,holy,36,8,28
Grumpy,the-forgotten-coast,764,paladin,holy,12,8,4
Instaded,illidan,764,paladin,holy,18,8,10
Pambam,thrall,763,paladin,holy,18,9,9
Jereth,kelthuzad,763,paladin,holy,18,8,10
Etlas,windrunner,763,paladin,holy,18,8,10
Porkwatchy,eonar,762,paladin,holy,24,8,16
Sweettartts,zuljin,762,paladin,holy,30,8,22
Blacktemplar,area-52,755,paladin,holy,18,8,10
Darkwingdad,illidan,752,paladin,holy,33,13,20
Willycrow,nordrassil,740,paladin,holy,18,8,10
Møcha,moon-guard,732,paladin,holy,20,9,11
Mirotchburns,illidan,724,paladin,holy,16,9,7
Ashera,amanthul,722,paladin,holy,26,9,17
Kirilx,vashj,718,paladin,holy,15,9,6
Mfn,tichondrius,714,paladin,holy,18,9,9
Salivan,darkspear,710,paladin,holy,21,9,12
Ilovecanada,sargeras,672,paladin,holy,12,7,5
Shxz,illidan,672,paladin,holy,12,7,5
Imsuffering,zuljin,672,paladin,holy,12,7,5
Cheers,garona,672,paladin,holy,12,7,5
Gimmethéloot,stormrage,672,paladin,holy,12,7,5
Fredward,bleeding-hollow,672,paladin,holy,12,7,5
Oîn,area-52,672,paladin,holy,12,7,5
Bigolbittiez,tichondrius,672,paladin,holy,12,7,5
Xiaoholy,barthilas,672,paladin,holy,12,7,5
Crinject,sargeras,672,paladin,holy,12,7,5
Mlpx,stormrage,672,paladin,holy,12,7,5
Loganholy,tichondrius,672,paladin,holy,12,7,5
Busdid,sargeras,672,paladin,holy,12,7,5
Orekilol,stormrage,672,paladin,holy,18,7,11
Emmipal,tichondrius,672,paladin,holy,18,7,11
Paintthinner,frostmourne,672,paladin,holy,18,7,11
Zayiro,eonar,672,paladin,holy,24,7,17
Stompedlawl,illidan,672,paladin,holy,24,7,17
Sensible,sargeras,672,paladin,holy,24,7,17
Boraz,bleeding-hollow,672,paladin,holy,36,7,29
Doktavius,lightbringer,671,paladin,holy,12,7,5
Thin,ragnaros,671,paladin,holy,12,7,5
Lördnextdoor,tichondrius,671,paladin,holy,12,7,5
Cirillah,quelthalas,671,paladin,holy,12,7,5
Loguto,stormrage,671,paladin,holy,18,7,11
Virkas,area-52,671,paladin,holy,18,7,11
Lemmiéwinkzz,sargeras,671,paladin,holy,18,7,11
Animal,korialstrasz,671,paladin,holy,18,7,11
Shoppee,jubeithos,671,paladin,holy,18,7,11
Sýteck,sargeras,671,paladin,holy,24,7,17
Éætûgýäëí,area-52,671,paladin,holy,42,8,34
Korvén,area-52,670,paladin,holy,12,7,5
Meatburger,stormrage,670,paladin,holy,18,7,11
Rebelion,nagrand,670,paladin,holy,24,7,17
Drgn,azgalor,670,paladin,holy,30,7,23
Pluto,the-underbog,669,paladin,holy,12,7,5
Saxmurderz,tichondrius,669,paladin,holy,12,7,5
Solef,stormrage,669,paladin,holy,18,7,11
Røusseff,azralon,669,paladin,holy,18,7,11
Stationarity,frostmourne,669,paladin,holy,18,7,11
Kimahri,anvilmar,669,paladin,holy,36,7,29
Voxoen,bleeding-hollow,668,paladin,holy,12,7,5
Madcandy,illidan,667,paladin,holy,12,7,5
Mikeawk,tichondrius,667,paladin,holy,30,7,23
Geroden,tichondrius,665,paladin,holy,18,7,11
Bangerzzx,sargeras,663,paladin,holy,18,7,11
Chaós,queldorei,657,paladin,holy,18,7,11
Snowdawg,blackhand,654,paladin,holy,24,7,17
Ryuzu,arathor,640,paladin,holy,16,8,8
Emojunz,ragnaros,638,paladin,holy,11,7,4
Mycow,tichondrius,638,paladin,holy,17,7,10
Lucciuzz,tichondrius,638,paladin,holy,23,7,16
Mamothman,barthilas,622,paladin,holy,18,9,9
Jonfox,stormrage,621,paladin,holy,13,8,5
Mojiberus,wyrmrest-accord,606,paladin,holy,14,7,7
Heniou,tichondrius,605,paladin,holy,19,8,11
Erán,quelthalas,600,paladin,holy,14,7,7
Turnevil,wyrmrest-accord,591,paladin,holy,19,7,12
Wonpait,frostmourne,576,paladin,holy,9,7,2
Holymomia,blackrock,576,paladin,holy,12,6,6
Goldensmile,frostmourne,576,paladin,holy,12,6,6
Amadin,winterhoof,576,paladin,holy,12,6,6
Eskerda,nemesis,576,paladin,holy,12,6,6
Fadiez,sargeras,576,paladin,holy,12,6,6
Squarehammer,blackrock,576,paladin,holy,12,6,6
Dequincy,tichondrius,576,paladin,holy,12,6,6
Tríno,malganis,576,paladin,holy,12,6,6
Drossp,illidan,576,paladin,holy,12,6,6
Piura,stormreaver,576,paladin,holy,12,6,6
Tolentino,elune,576,paladin,holy,12,6,6
Catharsis,tichondrius,576,paladin,holy,12,6,6
Ironjudge,hakkar,576,paladin,holy,17,6,11
Mânz,stormrage,576,paladin,holy,18,6,12
Remibear,tichondrius,576,paladin,holy,18,6,12
Marleigh,kelthuzad,576,paladin,holy,18,6,12
Lindnerxo,malganis,576,paladin,holy,18,6,12
Okcheon,tichondrius,576,paladin,holy,18,6,12
Bopsamdi,barthilas,576,paladin,holy,18,6,12
Nikxx,tichondrius,576,paladin,holy,18,6,12
Marien,kelthuzad,576,paladin,holy,18,6,12
Kelosia,bonechewer,576,paladin,holy,18,6,12
Santiagolol,ragnaros,576,paladin,holy,24,6,18
Acpally,tichondrius,576,paladin,holy,24,6,18
Ooppa,proudmoore,576,paladin,holy,25,6,19
Okx,illidan,575,paladin,holy,6,6,0
Cassiel,barthilas,575,paladin,holy,12,6,6
Mendes,stormrage,575,paladin,holy,12,6,6
Bigpal,area-52,575,paladin,holy,12,6,6
Nochance,queldorei,575,paladin,holy,12,6,6
Roachpally,area-52,575,paladin,holy,12,6,6
Nøzawkalypse,kelthuzad,575,paladin,holy,12,6,6
Emptyjump,eredar,575,paladin,holy,12,6,6
Auralyon,tichondrius,575,paladin,holy,12,6,6
Leatherfase,dalaran,575,paladin,holy,12,6,6
Vänhélsing,tichondrius,575,paladin,holy,13,6,7
Hojadin,area-52,575,paladin,holy,18,6,12
Tig,alleria,575,paladin,holy,18,6,12
Asunä,bloodscalp,575,paladin,holy,18,6,12
Theprimus,darkspear,574,paladin,holy,6,6,0
Rhonielson,tichondrius,574,paladin,holy,12,6,6
Freyr,deathwing,574,paladin,holy,12,6,6
Mcpuffin,aggramar,574,paladin,holy,12,6,6
Hitsilent,warsong,574,paladin,holy,12,6,6
Sixthycent,kiljaeden,574,paladin,holy,12,6,6
Ahsys,tichondrius,574,paladin,holy,18,6,12
Kilion,illidan,574,paladin,holy,18,6,12
Boostsixty,proudmoore,573,paladin,holy,18,6,12
Iluvitar,kiljaeden,573,paladin,holy,18,6,12
Mitshuki,ragnaros,573,paladin,holy,18,6,12
Ducii,stormrage,571,paladin,holy,18,6,12
Cloûd,tichondrius,570,paladin,holy,13,6,7
Maplleafs,kelthuzad,560,paladin,holy,24,6,18
Orleenz,zuljin,559,paladin,holy,18,6,12
Fayernaa,proudmoore,557,paladin,holy,10,7,3
Powtilted,thrall,543,paladin,holy,11,6,5
Redpally,emerald-dream,543,paladin,holy,16,6,10
Eboi,daggerspine,542,paladin,holy,26,7,19
Biggestkritz,frostmourne,511,paladin,holy,14,6,8
Trivana,durotan,496,paladin,holy,7,6,1
Holythunderx,tichondrius,496,paladin,holy,19,6,13
Badboí,azralon,480,paladin,holy,6,5,1
Zanduncy,stormrage,480,paladin,holy,6,5,1
Dlt,frostmourne,480,paladin,holy,6,5,1
Yogafire,kelthuzad,480,paladin,holy,6,5,1
Zenastra,moon-guard,480,paladin,holy,6,5,1
Saintus,proudmoore,480,paladin,holy,12,5,7
Beila,illidan,480,paladin,holy,12,5,7
Drunknbum,area-52,480,paladin,holy,12,5,7
Velline,tichondrius,480,paladin,holy,12,5,7
Vicentê,ragnaros,480,paladin,holy,12,5,7
Garethorne,illidan,480,paladin,holy,12,5,7
Leddie,stormrage,480,paladin,holy,12,5,7
Lyticmartyr,bleeding-hollow,480,paladin,holy,12,5,7
Gøldenlight,illidan,480,paladin,holy,12,5,7
Vaerume,sargeras,480,paladin,holy,12,5,7
Tèhflip,tichondrius,480,paladin,holy,12,5,7
Twoshockz,stormrage,480,paladin,holy,12,5,7
Subotai,frostmourne,480,paladin,holy,12,5,7
Timeparadox,illidan,480,paladin,holy,12,5,7
Alessan,nemesis,480,paladin,holy,12,5,7
Hamen,frostwolf,480,paladin,holy,12,5,7
Zhangliyi,tichondrius,480,paladin,holy,12,5,7
Gareyn,moon-guard,480,paladin,holy,12,5,7
Mightypally,area-52,480,paladin,holy,12,5,7
Trycider,lightninghoof,480,paladin,holy,12,5,7
Fartburger,saurfang,480,paladin,holy,12,5,7
Inmortall,illidan,480,paladin,holy,12,5,7
Bíteme,sargeras,480,paladin,holy,15,6,9
Chimp,kiljaeden,480,paladin,holy,18,5,13
Trevmagoosey,tichondrius,480,paladin,holy,18,5,13
Chrisgrin,malganis,480,paladin,holy,18,5,13
Flow,spinebreaker,480,paladin,holy,18,5,13
Wêsleypipes,crushridge,480,paladin,holy,18,5,13
Aberos,stonemaul,480,paladin,holy,23,5,18
Mootumba,boulderfist,480,paladin,holy,24,5,19
Annii,aegwynn,479,paladin,holy,6,5,1
Bubbleosèven,tichondrius,479,paladin,holy,6,5,1
Joelsama,area-52,479,paladin,holy,12,5,7
Marcopolo,azralon,479,paladin,holy,12,5,7
Mileihot,quelthalas,479,paladin,holy,12,5,7
Mightythorxx,tichondrius,479,paladin,holy,12,5,7
Holyshasha,tichondrius,479,paladin,holy,12,5,7
Gyle,stormrage,479,paladin,holy,12,5,7
Tankgreed,quelthalas,479,paladin,holy,12,5,7
Goksuu,ragnaros,479,paladin,holy,12,5,7
Loabandit,malorne,479,paladin,holy,12,5,7
Meistyr,thrall,479,paladin,holy,18,5,13
Healadelphia,illidan,479,paladin,holy,18,5,13
Yobnai,zuljin,478,paladin,holy,12,5,7
Whosharted,area-52,478,paladin,holy,12,5,7
Boiducéu,azralon,478,paladin,holy,12,5,7
Duecesz,area-52,478,paladin,holy,26,5,21
Sovereignt,aggramar,477,paladin,holy,12,5,7
Goingturbo,wyrmrest-accord,477,paladin,holy,12,5,7
Thaeldan,archimonde,477,paladin,holy,18,5,13
Bullivan,sisters-of-elune,477,paladin,holy,18,5,13
Visanth,bonechewer,474,paladin,holy,15,5,10
Redentor,dalaran,473,paladin,holy,12,5,7
Parts,aerie-peak,468,paladin,holy,30,5,25
Fleshoflíght,azjolnerub,463,paladin,holy,11,5,6
Toastedheals,stormreaver,463,paladin,holy,17,5,12
Blancaflór,ragnaros,447,paladin,holy,11,5,6
Ziggerqt,stormrage,432,paladin,holy,15,5,10
Nivie,moon-guard,430,paladin,holy,15,5,10
Rashell,garrosh,426,paladin,holy,16,7,9
Retribution,mannoroth,426,paladin,holy,23,6,17
Monts,azralon,425,paladin,holy,20,7,13
Ziti,bonechewer,415,paladin,holy,8,5,3
Cyandra,moon-guard,400,paladin,holy,7,5,2
Dewagon,area-52,398,paladin,holy,25,5,20
Kigz,illidan,384,paladin,holy,6,4,2
Eladore,hakkar,384,paladin,holy,6,4,2
Decree,rexxar,384,paladin,holy,6,4,2
Ladanthal,barthilas,384,paladin,holy,6,4,2
Icac,stormrage,384,paladin,holy,6,4,2
Ùthèr,tichondrius,384,paladin,holy,6,4,2
Auraingraham,stormscale,384,paladin,holy,6,4,2
Volphorix,illidan,384,paladin,holy,6,4,2
Rc,tichondrius,384,paladin,holy,6,4,2
Ohthatguy,sargeras,384,paladin,holy,6,4,2
Arleos,mannoroth,384,paladin,holy,6,4,2
Immensepower,tichondrius,384,paladin,holy,6,4,2
Mywifeisbad,tichondrius,384,paladin,holy,6,4,2
Ceeten,tichondrius,384,paladin,holy,6,4,2
Îcandy,stormrage,384,paladin,holy,6,4,2
Dumpytrucks,sargeras,384,paladin,holy,6,4,2
Lightwerk,frostmourne,384,paladin,holy,6,4,2
Respect,black-dragonflight,384,paladin,holy,6,4,2
Kymosolopal,sargeras,384,paladin,holy,6,4,2
Pradå,tichondrius,384,paladin,holy,6,4,2
Penpal,sargeras,384,paladin,holy,12,4,8
Swolsus,illidan,384,paladin,holy,12,4,8
Cadap,bleeding-hollow,384,paladin,holy,12,4,8
Ajlol,thrall,384,paladin,holy,12,4,8
Devsrdumb,bonechewer,384,paladin,holy,12,4,8
Klamindor,emerald-dream,384,paladin,holy,12,4,8
Floweezy,thrall,384,paladin,holy,12,4,8
Alicethemad,aerie-peak,384,paladin,holy,12,4,8
Wangzu,wildhammer,384,paladin,holy,12,4,8
Bighardshock,aggramar,384,paladin,holy,12,4,8
Lesauceboss,tichondrius,384,paladin,holy,12,4,8
Dimix,sargeras,384,paladin,holy,12,4,8
Bigtimepali,tichondrius,384,paladin,holy,12,4,8
Daflash,emerald-dream,384,paladin,holy,12,4,8
Sacratess,area-52,384,paladin,holy,12,4,8
Ðáxø,sargeras,384,paladin,holy,12,4,8
Nontheism,malganis,384,paladin,holy,12,4,8
Purdicks,emerald-dream,384,paladin,holy,12,4,8
Nikkixo,ysera,384,paladin,holy,12,4,8
Alkina,kelthuzad,384,paladin,holy,12,4,8
Nerfrets,stormrage,384,paladin,holy,12,4,8
Contémpt,kelthuzad,384,paladin,holy,12,4,8
Derbizzle,darkspear,384,paladin,holy,12,4,8
Saintcassi,wyrmrest-accord,384,paladin,holy,12,4,8
Holygutzz,barthilas,384,paladin,holy,12,4,8
Gotredwings,proudmoore,384,paladin,holy,12,4,8
Waldir,silver-hand,384,paladin,holy,12,4,8
Doorii,tichondrius,384,paladin,holy,18,4,14
Hímüra,nemesis,384,paladin,holy,18,4,14
Cutebtw,zuljin,384,paladin,holy,18,4,14
Beebopper,illidan,384,paladin,holy,18,4,14
Bloodangelz,sargeras,384,paladin,holy,18,4,14
Retholyprot,tichondrius,384,paladin,holy,18,4,14
Ardrider,emerald-dream,384,paladin,holy,18,4,14
Kaminasol,quelthalas,384,paladin,holy,18,4,14
Scah,illidan,383,paladin,holy,6,4,2
Holyflux,winterhoof,383,paladin,holy,6,4,2
Vorex,ragnaros,383,paladin,holy,12,4,8
Thulamon,zuljin,383,paladin,holy,12,4,8
Guççi,thunderlord,383,paladin,holy,12,4,8
Akromma,drakkari,383,paladin,holy,12,4,8
Lightbeard,feathermoon,383,paladin,holy,12,4,8
Lunchmoney,aggramar,383,paladin,holy,12,4,8
Gokzurah,dragonmaw,383,paladin,holy,18,4,14
Anjøs,azralon,383,paladin,holy,18,4,14
Cooldbrew,frostmourne,383,paladin,holy,18,4,14
Alyosya,barthilas,383,paladin,holy,24,4,20
Unsungherø,skywall,382,paladin,holy,6,4,2
Rustacian,area-52,380,paladin,holy,12,4,8
Gnomeslapper,frostmourne,351,paladin,holy,11,4,7
Palewan,kiljaeden,351,paladin,holy,11,4,7
Aärøn,stormrage,351,paladin,holy,11,4,7
Nabora,aggramar,351,paladin,holy,11,4,7
Nvgesus,undermine,329,paladin,holy,16,5,11
Veeve,emerald-dream,304,paladin,holy,7,4,3
Nulric,moon-guard,304,paladin,holy,13,4,9
Holzinger,quelthalas,288,paladin,holy,6,3,3
Grimmey,azjolnerub,288,paladin,holy,6,3,3
Árrest,tichondrius,288,paladin,holy,6,3,3
Sadamell,tichondrius,288,paladin,holy,6,3,3
Ingrìd,ragnaros,288,paladin,holy,6,3,3
Iamguess,stormscale,288,paladin,holy,6,3,3
Zpsychotycx,tichondrius,288,paladin,holy,6,3,3
Lachaple,illidan,288,paladin,holy,6,3,3
Madsama,quelthalas,288,paladin,holy,6,3,3
Lànd,tichondrius,288,paladin,holy,6,3,3
Laythoz,hyjal,288,paladin,holy,6,3,3
Sixty,sargeras,288,paladin,holy,6,3,3
Sigfriéd,tichondrius,288,paladin,holy,6,3,3
Kusunoki,kelthuzad,288,paladin,holy,6,3,3
Hazkal,sargeras,288,paladin,holy,6,3,3
Kaleroenin,cenarius,288,paladin,holy,6,3,3
Jackywacky,malganis,288,paladin,holy,6,3,3
Supercutee,malganis,288,paladin,holy,6,3,3
Repgodx,illidan,288,paladin,holy,6,3,3
Schwârts,blackrock,288,paladin,holy,6,3,3
Loyantal,tichondrius,288,paladin,holy,6,3,3
Datguysname,illidan,288,paladin,holy,6,3,3
Alîcë,wyrmrest-accord,288,paladin,holy,6,3,3
Feelsögood,tichondrius,288,paladin,holy,6,3,3
Killmoth,illidan,288,paladin,holy,6,3,3
Thyedron,azralon,288,paladin,holy,6,3,3
Lamas,kelthuzad,288,paladin,holy,6,3,3
Mindfoolness,sargeras,288,paladin,holy,6,3,3
Breesh,nerzhul,288,paladin,holy,6,3,3
Kharissia,proudmoore,288,paladin,holy,6,3,3
Twodkittyy,kelthuzad,288,paladin,holy,6,3,3
Soapgirl,area-52,288,paladin,holy,6,3,3
Holysheesh,cenarion-circle,288,paladin,holy,6,3,3
Nipon,stormrage,288,paladin,holy,6,3,3
Wonpæi,frostmourne,288,paladin,holy,6,3,3
Psalms,lightnings-blade,288,paladin,holy,6,3,3
Dayatthespa,stormrage,288,paladin,holy,6,3,3
Brightcore,stormrage,288,paladin,holy,6,3,3
Phut,stormrage,288,paladin,holy,6,3,3
Clare,burning-blade,288,paladin,holy,6,3,3
Miggsy,stormrage,288,paladin,holy,6,3,3
Botburger,stormrage,288,paladin,holy,6,3,3
Yacè,moon-guard,288,paladin,holy,6,3,3
Leronos,zuljin,288,paladin,holy,6,3,3
Gutzzx,frostmourne,288,paladin,holy,6,3,3
Paen,area-52,288,paladin,holy,6,3,3
Gothsick,zuljin,288,paladin,holy,6,3,3
Aduhrawl,moon-guard,288,paladin,holy,6,3,3
Odinns,proudmoore,288,paladin,holy,6,3,3
Quits,tichondrius,288,paladin,holy,12,3,9
Milonus,frostmourne,288,paladin,holy,12,3,9
Dartherion,shandris,288,paladin,holy,12,3,9
Imabigkidnow,emerald-dream,288,paladin,holy,12,3,9
Dráugus,azralon,288,paladin,holy,12,3,9
Kommuna,stormscale,288,paladin,holy,12,3,9
Picorii,frostmourne,288,paladin,holy,12,3,9
Hemmyr,deathwing,288,paladin,holy,12,3,9
Yanggongru,sargeras,288,paladin,holy,12,3,9
Ahkairee,whisperwind,288,paladin,holy,12,3,9
Thichammer,frostmourne,288,paladin,holy,12,3,9
Drippinheals,eitrigg,288,paladin,holy,12,3,9
Serca,khadgar,288,paladin,holy,12,3,9
Prâytorian,illidan,288,paladin,holy,12,3,9
Palazin,frostmourne,288,paladin,holy,12,3,9
Repths,illidan,288,paladin,holy,12,3,9
Teerblood,illidan,288,paladin,holy,12,3,9
Holycowisroy,illidan,288,paladin,holy,12,3,9
Haldry,wyrmrest-accord,288,paladin,holy,12,3,9
Bigboppapump,lightnings-blade,288,paladin,holy,18,3,15
Flarisic,kelthuzad,288,paladin,holy,18,3,15
Hugokpz,quelthalas,288,paladin,holy,18,3,15
Alogagain,frostmourne,288,paladin,holy,18,3,15
Mathalt,area-52,288,paladin,holy,18,3,15
Holyslapz,nazjatar,287,paladin,holy,6,3,3
Avantasias,sargeras,287,paladin,holy,12,3,9
Fokatayew,korialstrasz,287,paladin,holy,12,3,9
Spacebacon,thunderlord,287,paladin,holy,12,3,9
Rost,jaedenar,287,paladin,holy,24,3,21
Callmeweazy,arathor,286,paladin,holy,12,3,9
Hehealsyou,alleria,285,paladin,holy,12,3,9
Schnabdain,exodar,285,paladin,holy,18,3,15
Cristineth,tanaris,255,paladin,holy,8,4,4
Antivaxer,frostmourne,255,paladin,holy,11,3,8
Iradruidz,tichondrius,255,paladin,holy,11,3,8
Holywoof,agamaggan,234,paladin,holy,11,5,6
Itheternal,dalaran,234,paladin,holy,9,4,5
Tyygore,nagrand,234,paladin,holy,13,5,8
Inarit,thrall,232,paladin,holy,22,5,17
Ronnierawdog,frostmourne,192,paladin,holy,6,2,4
Jastella,illidan,192,paladin,holy,6,2,4
Bigdmcgee,frostmourne,192,paladin,holy,6,2,4
Jiaofu,illidan,192,paladin,holy,6,2,4
Toonchies,barthilas,192,paladin,holy,6,2,4
Raywhite,kelthuzad,192,paladin,holy,6,2,4
Gnomesexer,illidan,192,paladin,holy,6,2,4
Kagranac,moon-guard,192,paladin,holy,6,2,4
Pallydeen,illidan,192,paladin,holy,6,2,4
Flexxborn,thrall,192,paladin,holy,6,2,4
Borngood,tichondrius,192,paladin,holy,6,2,4
Smôres,sargeras,192,paladin,holy,6,2,4
Elchupalibre,tichondrius,192,paladin,holy,6,2,4
Gilazhar,eldrethalas,192,paladin,holy,6,2,4
Zhula,nerzhul,192,paladin,holy,6,2,4
Goldieg,tichondrius,192,paladin,holy,6,2,4
Hitabull,hyjal,192,paladin,holy,6,2,4
Iolwhat,sargeras,192,paladin,holy,6,2,4
Papaa,nemesis,192,paladin,holy,6,2,4
Rawpaladin,blackrock,192,paladin,holy,6,2,4
Pearlx,ragnaros,192,paladin,holy,6,2,4
Turnipfãrmer,tichondrius,192,paladin,holy,6,2,4
Veguê,ragnaros,192,paladin,holy,6,2,4
Eicke,malganis,192,paladin,holy,6,2,4
Bakapal,tichondrius,192,paladin,holy,6,2,4
Stormwinter,azralon,192,paladin,holy,6,2,4
Gabs,quelthalas,192,paladin,holy,6,2,4
Antoniano,ragnaros,192,paladin,holy,6,2,4
Lazydin,tichondrius,192,paladin,holy,6,2,4
Sainttom,sargeras,192,paladin,holy,6,2,4
Numenor,kiljaeden,192,paladin,holy,6,2,4
Svane,thunderlord,192,paladin,holy,6,2,4
Mangchì,tichondrius,192,paladin,holy,6,2,4
Trâgedy,azjolnerub,192,paladin,holy,6,2,4
Chinaballoon,moonrunner,192,paladin,holy,6,2,4
Tumatauenga,burning-blade,192,paladin,holy,6,2,4
Lovinglight,zuljin,192,paladin,holy,6,2,4
Kimbr,gallywix,192,paladin,holy,6,2,4
Romaztlan,area-52,192,paladin,holy,6,2,4
Lørdthemar,azralon,192,paladin,holy,6,2,4
Irêsha,quelthalas,192,paladin,holy,6,2,4
Razzypal,sargeras,192,paladin,holy,6,2,4
Raiel,aegwynn,192,paladin,holy,6,2,4
Akj,tichondrius,192,paladin,holy,6,2,4
Goldirock,quelthalas,192,paladin,holy,6,2,4
Breach,blades-edge,192,paladin,holy,6,2,4
Naxzero,shadowsong,192,paladin,holy,8,2,6
Anderentonso,tichondrius,192,paladin,holy,9,2,7
Piupiubiu,stormrage,192,paladin,holy,12,2,10
Willywønka,azgalor,192,paladin,holy,12,2,10
Bighausse,thrall,192,paladin,holy,12,2,10
Gavril,kirin-tor,192,paladin,holy,12,2,10
Dwemeor,azuremyst,192,paladin,holy,12,2,10
Carmiínha,azralon,192,paladin,holy,12,2,10
Dissident,stormrage,192,paladin,holy,12,2,10
Einheilagr,stormrage,192,paladin,holy,12,2,10
Märdrius,tichondrius,192,paladin,holy,12,2,10
Cehart,windrunner,192,paladin,holy,12,2,10
Murkpal,frostmourne,192,paladin,holy,12,2,10
Trojani,malganis,192,paladin,holy,12,2,10
Minzyy,frostmourne,192,paladin,holy,12,2,10
Hxnny,kiljaeden,192,paladin,holy,12,2,10
Milkovir,quelthalas,192,paladin,holy,18,2,16
Shoresy,terokkar,192,paladin,holy,18,2,16
Waifupaladin,azralon,192,paladin,holy,18,2,16
Levarious,thunderlord,192,paladin,holy,18,2,16
Holygota,nemesis,191,paladin,holy,6,2,4
Holymomo,malganis,191,paladin,holy,6,2,4
Prh,frostmourne,191,paladin,holy,6,2,4
Splyts,stormrage,191,paladin,holy,16,3,13
Arobelse,sargeras,191,paladin,holy,12,2,10
Itsoverninek,emerald-dream,159,paladin,holy,17,2,15
Hearthledger,ragnaros,144,paladin,holy,3,3,0
Whitedozer,darkspear,138,paladin,holy,10,4,6
Luxsit,tichondrius,138,paladin,holy,11,3,8
Guelmin,azralon,112,paladin,holy,7,2,5
Myû,korgath,112,paladin,holy,7,2,5
Tetulia,quelthalas,96,paladin,holy,6,1,5
Traditionalp,area-52,96,paladin,holy,6,1,5
Badnold,area-52,96,paladin,holy,6,1,5
Sevina,twisting-nether,96,paladin,holy,6,1,5
Deadlyassian,ysera,96,paladin,holy,6,1,5
Kamí,elune,96,paladin,holy,6,1,5
Therëv,zuljin,96,paladin,holy,6,1,5
Chakris,wyrmrest-accord,96,paladin,holy,6,1,5
Crosjudge,zuljin,96,paladin,holy,6,1,5
Tfcpaladin,the-forgotten-coast,96,paladin,holy,6,1,5
Lgbtq,trollbane,96,paladin,holy,6,1,5
Vîxey,ragnaros,96,paladin,holy,6,1,5
Criaharn,turalyon,96,paladin,holy,6,1,5
Wings,arygos,96,paladin,holy,6,1,5
Netéro,skywall,96,paladin,holy,6,1,5
Combidin,garrosh,96,paladin,holy,6,1,5
Cathraga,moknathal,96,paladin,holy,6,1,5
Silreck,ragnaros,96,paladin,holy,6,1,5
Rhinno,lothar,96,paladin,holy,6,1,5
Lightsòut,frostmourne,96,paladin,holy,6,1,5
Elrecka,stormrage,96,paladin,holy,6,1,5
Elronda,malganis,96,paladin,holy,6,1,5
Ploppers,sargeras,96,paladin,holy,6,1,5
Oncehumanoid,stormrage,96,paladin,holy,6,1,5
Cremefraichè,tichondrius,96,paladin,holy,6,1,5
Boppal,tichondrius,96,paladin,holy,6,1,5
Greddlok,rivendare,96,paladin,holy,6,1,5
Yikyok,stormrage,96,paladin,holy,6,1,5
Trixzthot,barthilas,96,paladin,holy,6,1,5
Wrekster,tichondrius,96,paladin,holy,6,1,5
Krypton,tichondrius,96,paladin,holy,6,1,5
ßls,illidan,96,paladin,holy,6,1,5
Burgasari,tichondrius,96,paladin,holy,6,1,5
Parzsival,blood-furnace,96,paladin,holy,6,1,5
Jeffylolmar,sargeras,96,paladin,holy,6,1,5
Luxs,tichondrius,96,paladin,holy,6,1,5
Syrenadrel,hydraxis,96,paladin,holy,6,1,5
Owllii,frostwolf,96,paladin,holy,6,1,5
Keltheas,rivendare,96,paladin,holy,6,1,5
Obllivionn,wildhammer,96,paladin,holy,6,1,5
Evilpallie,illidan,96,paladin,holy,6,1,5
Kurook,moon-guard,96,paladin,holy,6,1,5
Mfpink,thrall,96,paladin,holy,6,1,5
Zwilliam,frostmourne,96,paladin,holy,6,1,5
Sherrill,nagrand,96,paladin,holy,6,1,5
Palabora,kelthuzad,96,paladin,holy,6,1,5
Kaynè,senjin,96,paladin,holy,6,1,5
Khaosactual,proudmoore,96,paladin,holy,6,1,5
Arturias,kiljaeden,96,paladin,holy,6,1,5
Ripadin,dunemaul,96,paladin,holy,11,1,10
Grîshnâkh,ragnaros,96,paladin,holy,11,1,10
Ordained,moonrunner,96,paladin,holy,12,1,11
Dapallytroll,area-52,96,paladin,holy,12,1,11
Midnightboto,dragonmaw,96,paladin,holy,12,1,11
Nickpala,bleeding-hollow,96,paladin,holy,12,1,11
Soloist,tichondrius,96,paladin,holy,12,1,11
Elladan,illidan,96,paladin,holy,12,1,11
Zentrick,whisperwind,96,paladin,holy,12,1,11
Jwilks,black-dragonflight,96,paladin,holy,12,1,11
Lafawndah,blackhand,96,paladin,holy,12,1,11
Vanquishyr,stormrage,96,paladin,holy,12,1,11
Vexe,emerald-dream,96,paladin,holy,12,1,11
Granada,kirin-tor,95,paladin,holy,6,1,5
Arlé,stormrage,95,paladin,holy,6,1,5
Ååron,thrall,89,paladin,holy,11,3,8
Tmzoeyqt,tichondrius,84,paladin,holy,9,4,5
Emilywilis,sargeras,84,paladin,holy,17,5,12
Athenia,moon-guard,63,paladin,holy,6,3,3
Jkethuhsnake,ghostlands,48,paladin,holy,21,1,20
Alpinestârs,tichondrius,42,paladin,holy,9,2,7
Justinbebr,tichondrius,42,paladin,holy,14,3,11
Durendin,bonechewer,31,paladin,holy,2,1,1
Kziwei,stormrage,31,paladin,holy,2,1,1
Shkafell,ragnaros,9,paladin,holy,8,2,6
Oghal,frostmourne,9,paladin,holy,23,3,20
Vanguards,tichondrius,2192,paladin,retribution,78,43,35
Imitlol,alexstrasza,2154,paladin,retribution,181,91,90
Hamburgeryu,tichondrius,2119,paladin,retribution,100,49,51
Coolvelic,tichondrius,2110,paladin,retribution,156,79,77
Picachü,ragnaros,2104,paladin,retribution,125,63,62
Yuji,darkspear,2102,paladin,retribution,108,54,54
Hollyflame,tichondrius,2086,paladin,retribution,149,76,73
Tramatic,sargeras,2076,paladin,retribution,78,42,36
Quitzz,tichondrius,2050,paladin,retribution,117,58,59
Venguards,azralon,2049,paladin,retribution,97,50,47
Shôtgun,tichondrius,2047,paladin,retribution,90,45,45
Aldda,azralon,2047,paladin,retribution,128,62,66
Evanguards,tichondrius,2046,paladin,retribution,184,91,93
Xexe,stormreaver,2030,paladin,retribution,150,74,76
Lanteranth,drenden,2024,paladin,retribution,198,96,102
Wasteddwolf,tichondrius,2022,paladin,retribution,117,60,57
Angryvelic,tichondrius,2019,paladin,retribution,87,41,46
Alicê,moon-guard,2018,paladin,retribution,84,41,43
Dreamcastx,tichondrius,2016,paladin,retribution,149,74,75
Slíckhuman,spinebreaker,2009,paladin,retribution,60,41,19
Furylolz,tichondrius,2009,paladin,retribution,70,35,35
Condiments,earthen-ring,2007,paladin,retribution,90,47,43
Xiaoqingye,tichondrius,1995,paladin,retribution,78,41,37
Caperx,tichondrius,1994,paladin,retribution,48,21,27
Notvelic,tichondrius,1993,paladin,retribution,99,46,53
Genericuser,sargeras,1984,paladin,retribution,82,44,38
Ryuseiblade,ragnaros,1983,paladin,retribution,120,56,64
Smortain,tichondrius,1973,paladin,retribution,84,39,45
Bigdickrick,ragnaros,1972,paladin,retribution,54,32,22
Maledraenei,sargeras,1970,paladin,retribution,113,54,59
Ämoureux,bleeding-hollow,1970,paladin,retribution,141,67,74
Theblèss,tichondrius,1969,paladin,retribution,121,56,65
Alpinestârs,tichondrius,1967,paladin,retribution,122,60,62
Memorisë,ragnaros,1965,paladin,retribution,171,92,79
Caveyodeler,zuluhed,1962,paladin,retribution,66,31,35
Kubota,sargeras,1958,paladin,retribution,60,36,24
Mashbringer,moon-guard,1958,paladin,retribution,60,33,27
Dreamcastz,tichondrius,1957,paladin,retribution,48,33,15
Vânguards,tichondrius,1957,paladin,retribution,48,29,19
Mwqyyds,tichondrius,1953,paladin,retribution,90,44,46
Asukaba,sargeras,1950,paladin,retribution,68,33,35
Xuantianchai,tichondrius,1944,paladin,retribution,60,36,24
Dratzq,ragnaros,1938,paladin,retribution,90,49,41
Bestowed,moon-guard,1933,paladin,retribution,87,44,43
Bartharious,malganis,1932,paladin,retribution,78,37,41
Nbtv,tichondrius,1931,paladin,retribution,78,36,42
Daxxj,akama,1929,paladin,retribution,146,68,78
Indivisionxp,tichondrius,1928,paladin,retribution,55,34,21
Xxwitcherxx,stormrage,1928,paladin,retribution,99,55,44
Omnnii,tichondrius,1928,paladin,retribution,71,38,33
Damionblade,proudmoore,1928,paladin,retribution,217,116,101
Simplybést,zuljin,1927,paladin,retribution,129,61,68
Lvladen,sargeras,1927,paladin,retribution,72,32,40
Yccorz,frostmourne,1917,paladin,retribution,190,96,94
Mürlin,illidan,1915,paladin,retribution,159,83,76
Ozzium,ragnaros,1912,paladin,retribution,131,65,66
Monkeypala,dathremar,1911,paladin,retribution,54,30,24
Metallíka,nemesis,1910,paladin,retribution,77,36,41
Conndiment,earthen-ring,1909,paladin,retribution,78,37,41
Hammrekt,illidan,1905,paladin,retribution,48,25,23
Furgalicious,area-52,1904,paladin,retribution,125,60,65
Bøgård,sargeras,1901,paladin,retribution,201,100,101
Ohuo,tichondrius,1900,paladin,retribution,286,151,135
Angelguards,tichondrius,1900,paladin,retribution,60,30,30
Parlore,moon-guard,1895,paladin,retribution,162,87,75
Bullmarket,tichondrius,1895,paladin,retribution,161,73,88
Danceholy,tichondrius,1894,paladin,retribution,81,39,42
Swurvezx,bleeding-hollow,1892,paladin,retribution,41,25,16
Cønk,khadgar,1892,paladin,retribution,170,100,70
Kamadonezuko,illidan,1892,paladin,retribution,89,44,45
Fuchí,tichondrius,1891,paladin,retribution,182,90,92
Lazypally,frostmourne,1890,paladin,retribution,48,25,23
Attkdmgcurry,illidan,1890,paladin,retribution,71,34,37
Dtaitou,tichondrius,1889,paladin,retribution,60,28,32
Dankrachet,thrall,1888,paladin,retribution,72,35,37
Vendatha,darkspear,1887,paladin,retribution,30,25,5
Hellsingwolf,zuljin,1885,paladin,retribution,30,20,10
Pécorino,malganis,1884,paladin,retribution,52,31,21
Kurôsh,kalecgos,1883,paladin,retribution,90,46,44
Pomboxd,stormrage,1881,paladin,retribution,72,45,27
Iäl,tichondrius,1881,paladin,retribution,71,31,40
Zeldoul,magtheridon,1879,paladin,retribution,71,36,35
Retxsilver,thrall,1875,paladin,retribution,124,64,60
Roushex,sargeras,1875,paladin,retribution,72,35,37
Mcconnell,sargeras,1873,paladin,retribution,54,33,21
Voidaz,stormscale,1873,paladin,retribution,60,31,29
Zanur,tichondrius,1869,paladin,retribution,154,78,76
Koyoikonan,tichondrius,1867,paladin,retribution,42,28,14
Fairgame,dathremar,1867,paladin,retribution,48,22,26
Alexjones,stormrage,1866,paladin,retribution,78,43,35
Xilio,tichondrius,1865,paladin,retribution,72,36,36
Peledin,azralon,1864,paladin,retribution,77,41,36
Juffury,illidan,1861,paladin,retribution,66,32,34
Getmeabag,tichondrius,1861,paladin,retribution,54,25,29
Talymra,ragnaros,1860,paladin,retribution,72,38,34
Víkk,zuljin,1860,paladin,retribution,182,94,88
Vip,frostmourne,1859,paladin,retribution,78,41,37
Chuoo,proudmoore,1859,paladin,retribution,46,22,24
Draenkz,quelthalas,1858,paladin,retribution,51,31,20
Younghova,kelthuzad,1857,paladin,retribution,78,38,40
Clapstick,illidan,1857,paladin,retribution,66,30,36
Zyzzftw,stormrage,1856,paladin,retribution,53,31,22
Ðiviñe,zuluhed,1854,paladin,retribution,102,56,46
Retroreq,tichondrius,1854,paladin,retribution,166,88,78
Ðori,tichondrius,1854,paladin,retribution,65,31,34
Homelanderp,tichondrius,1851,paladin,retribution,75,37,38
Foofs,shadowmoon,1851,paladin,retribution,53,26,27
Solanin,frostmourne,1849,paladin,retribution,35,20,15
Burnning,tichondrius,1849,paladin,retribution,57,30,27
Hurv,area-52,1848,paladin,retribution,53,30,23
Mixz,bleeding-hollow,1843,paladin,retribution,60,36,24
Nishru,sargeras,1843,paladin,retribution,60,32,28
Auxilio,arathor,1843,paladin,retribution,60,29,31
Divinehammer,proudmoore,1843,paladin,retribution,66,31,35
Saakero,illidan,1841,paladin,retribution,36,22,14
Mikhàël,stormscale,1840,paladin,retribution,52,37,15
Truthkeeper,moon-guard,1840,paladin,retribution,47,23,24
Luosiding,tichondrius,1840,paladin,retribution,155,68,87
Chuckvandam,illidan,1839,paladin,retribution,54,36,18
Popje,zuljin,1839,paladin,retribution,36,20,16
Grifnballs,agamaggan,1839,paladin,retribution,56,31,25
Immobilized,frostmourne,1839,paladin,retribution,58,29,29
Mvpj,medivh,1839,paladin,retribution,48,23,25
Kushsessions,zuljin,1837,paladin,retribution,42,20,22
Holychris,shadowmoon,1837,paladin,retribution,72,31,41
Alodorx,tichondrius,1836,paladin,retribution,36,23,13
Kangsang,illidan,1835,paladin,retribution,70,33,37
Lolcraftv,tichondrius,1834,paladin,retribution,60,30,30
Dkdldkdld,tichondrius,1833,paladin,retribution,36,27,9
Lilglick,illidan,1833,paladin,retribution,36,21,15
Masqadin,tichondrius,1832,paladin,retribution,36,26,10
Leonilx,tichondrius,1832,paladin,retribution,48,21,27
Kaitúr,stormrage,1831,paladin,retribution,56,29,27
ßò,area-52,1830,paladin,retribution,46,31,15
Awbie,moon-guard,1830,paladin,retribution,60,30,30
Eldenblade,moon-guard,1829,paladin,retribution,54,31,23
Coldzerox,ragnaros,1829,paladin,retribution,161,82,79
Honeydutchtv,black-dragonflight,1829,paladin,retribution,174,79,95
Hammrekt,kelthuzad,1829,paladin,retribution,47,20,27
Chainsapally,stormrage,1828,paladin,retribution,54,38,16
Palabora,kelthuzad,1828,paladin,retribution,53,28,25
Bornterrible,queldorei,1828,paladin,retribution,54,25,29
Idenline,moon-guard,1827,paladin,retribution,59,30,29
Wolfs,firetree,1826,paladin,retribution,66,29,37
Monchmon,tichondrius,1824,paladin,retribution,47,24,23
Praysnblaze,zuljin,1824,paladin,retribution,55,28,27
Apollidin,malganis,1824,paladin,retribution,57,23,34
Bohring,bleeding-hollow,1823,paladin,retribution,48,26,22
Zozo,zuljin,1823,paladin,retribution,59,29,30
Saradomin,kelthuzad,1822,paladin,retribution,129,66,63
Mikeqiaodan,tichondrius,1822,paladin,retribution,102,47,55
Olixx,blackrock,1821,paladin,retribution,54,30,24
Kíngkáísér,azralon,1820,paladin,retribution,29,20,9
Malakor,thrall,1820,paladin,retribution,150,79,71
Blackcandle,tichondrius,1819,paladin,retribution,48,29,19
Yorøchi,azralon,1819,paladin,retribution,57,31,26
Geöspäwn,tichondrius,1819,paladin,retribution,39,20,19
Anbivilent,moon-guard,1819,paladin,retribution,48,23,25
Cardynivans,tichondrius,1819,paladin,retribution,67,25,42
Hargol,stormrage,1818,paladin,retribution,90,43,47
Zett,jubeithos,1818,paladin,retribution,97,45,52
Dorex,moon-guard,1817,paladin,retribution,111,72,39
Dazargeros,moon-guard,1817,paladin,retribution,30,19,11
Nr,blood-furnace,1817,paladin,retribution,54,32,22
Dwimberlike,ragnaros,1816,paladin,retribution,56,37,19
Chadsteroid,sargeras,1816,paladin,retribution,48,29,19
Kooi,illidan,1816,paladin,retribution,78,35,43
Tyrillian,aerie-peak,1816,paladin,retribution,48,21,27
Kíngkáiser,azralon,1815,paladin,retribution,46,27,19
Zulmay,malganis,1814,paladin,retribution,156,78,78
Beautiful,proudmoore,1813,paladin,retribution,129,67,62
Dorktanian,stormrage,1813,paladin,retribution,78,40,38
Toughxguy,sargeras,1813,paladin,retribution,86,44,42
Sukilol,tichondrius,1813,paladin,retribution,78,39,39
Rethumtv,tichondrius,1812,paladin,retribution,72,30,42
Arkadiano,drakkari,1812,paladin,retribution,78,29,49
Animepower,moon-guard,1811,paladin,retribution,94,56,38
Triston,area-52,1810,paladin,retribution,120,66,54
Lilcyans,ragnaros,1810,paladin,retribution,66,34,32
Primaryee,tichondrius,1810,paladin,retribution,121,53,68
Ladeon,proudmoore,1809,paladin,retribution,72,44,28
Dréveleth,quelthalas,1809,paladin,retribution,95,41,54
Fussyotter,stormreaver,1808,paladin,retribution,103,59,44
Sweetfish,kiljaeden,1808,paladin,retribution,53,29,24
Màli,akama,1808,paladin,retribution,52,20,32
Savøx,sargeras,1807,paladin,retribution,136,78,58
Stêvêts,tichondrius,1807,paladin,retribution,36,20,16
Downways,sargeras,1807,paladin,retribution,73,39,34
Profundity,area-52,1807,paladin,retribution,70,37,33
Ratg,frostmourne,1807,paladin,retribution,46,24,22
Velstadt,sargeras,1807,paladin,retribution,66,29,37
Gelosagrado,illidan,1807,paladin,retribution,113,48,65
Jhasøn,quelthalas,1806,paladin,retribution,60,40,20
Pornenjoyer,dalaran,1806,paladin,retribution,30,19,11
Darcobs,ragnaros,1806,paladin,retribution,172,90,82
Pambeazley,bronzebeard,1806,paladin,retribution,46,23,23
Pramethious,sargeras,1806,paladin,retribution,72,34,38
Erodan,moon-guard,1806,paladin,retribution,88,38,50
Annihilàtion,frostmourne,1805,paladin,retribution,42,30,12
Antlkd,quelthalas,1805,paladin,retribution,59,31,28
Koketsu,ragnaros,1805,paladin,retribution,219,109,110
Panncakeman,tichondrius,1804,paladin,retribution,60,33,27
Ironblade,zuljin,1804,paladin,retribution,54,29,25
Palli,moon-guard,1804,paladin,retribution,60,31,29
Lumbersnack,moon-guard,1804,paladin,retribution,75,36,39
Thantore,scilla,1804,paladin,retribution,76,34,42
Justicejosh,frostmourne,1803,paladin,retribution,42,25,17
Reypally,dalaran,1803,paladin,retribution,132,66,66
Niubcjq,tichondrius,1803,paladin,retribution,42,19,23
Lucy,sargeras,1803,paladin,retribution,72,32,40
Disappearing,stormrage,1802,paladin,retribution,48,31,17
Sâdê,bleeding-hollow,1802,paladin,retribution,36,19,17
Gunderbok,emerald-dream,1801,paladin,retribution,63,33,30
Mabia,tichondrius,1801,paladin,retribution,72,37,35
Sôck,zuljin,1800,paladin,retribution,44,22,22
Ha,bleeding-hollow,1800,paladin,retribution,64,26,38
Angelicwhim,stormrage,1799,paladin,retribution,42,24,18
Lyrz,sargeras,1796,paladin,retribution,109,65,44
Teknik,stormscale,1795,paladin,retribution,124,63,61
Dúrnir,stormscale,1794,paladin,retribution,30,19,11
Kádabrak,tichondrius,1794,paladin,retribution,54,34,20
Traize,kelthuzad,1787,paladin,retribution,36,24,12
Zeyrox,stormrage,1787,paladin,retribution,48,24,24
Iqt,moon-guard,1784,paladin,retribution,90,37,53
Andelko,tichondrius,1783,paladin,retribution,36,21,15
Giørther,ragnaros,1783,paladin,retribution,57,29,28
Retsaíyan,tichondrius,1782,paladin,retribution,60,28,32
Mortaine,moon-guard,1782,paladin,retribution,87,40,47
Judgejudyx,sargeras,1781,paladin,retribution,31,21,10
Therëv,zuljin,1781,paladin,retribution,77,35,42
Naverpay,tichondrius,1779,paladin,retribution,40,22,18
Dampenedxd,bleeding-hollow,1779,paladin,retribution,98,45,53
Zakladchick,illidan,1778,paladin,retribution,48,26,22
Nhsvikings,bleeding-hollow,1777,paladin,retribution,59,31,28
Marthellus,quelthalas,1774,paladin,retribution,63,28,35
Rasler,stormrage,1773,paladin,retribution,144,73,71
Thebless,tichondrius,1770,paladin,retribution,47,27,20
Holyfused,illidan,1770,paladin,retribution,47,24,23
Promethèus,jubeithos,1769,paladin,retribution,60,30,30
Syleith,shadow-council,1768,paladin,retribution,115,54,61
Rahkinishu,khaz-modan,1766,paladin,retribution,189,109,80
Jonathein,barthilas,1766,paladin,retribution,132,67,65
Talivar,kelthuzad,1765,paladin,retribution,126,74,52
Pallehx,tichondrius,1765,paladin,retribution,59,28,31
Thørmento,azralon,1765,paladin,retribution,105,47,58
Ópsv,quelthalas,1758,paladin,retribution,167,96,71
Fylerz,blackhand,1758,paladin,retribution,84,47,37
Christtel,stormrage,1757,paladin,retribution,60,31,29
Teniale,moon-guard,1756,paladin,retribution,48,23,25
Lejeñd,stormrage,1756,paladin,retribution,53,25,28
Berryblast,shadowmoon,1755,paladin,retribution,48,32,16
Neonblade,illidan,1752,paladin,retribution,88,42,46
Lunalunar,quelthalas,1750,paladin,retribution,53,28,25
Whosyadaddy,tichondrius,1750,paladin,retribution,84,44,40
Scarotv,malganis,1750,paladin,retribution,60,29,31
Litium,frostmourne,1746,paladin,retribution,48,27,21
Soverejgn,bleeding-hollow,1746,paladin,retribution,286,135,151
Traceless,emerald-dream,1745,paladin,retribution,111,66,45
Thebubbajay,illidan,1743,paladin,retribution,54,31,23
Wing,frostwolf,1743,paladin,retribution,84,45,39
Xiddin,frostmourne,1743,paladin,retribution,60,31,29
Htnhy,aegwynn,1743,paladin,retribution,60,24,36
Rashbringer,azgalor,1742,paladin,retribution,67,34,33
Galeatus,tichondrius,1742,paladin,retribution,58,22,36
Josxth,stormrage,1741,paladin,retribution,54,29,25
Alxndrr,area-52,1741,paladin,retribution,66,34,32
Lundor,ragnaros,1740,paladin,retribution,119,57,62
Helldevil,zuljin,1739,paladin,retribution,48,25,23
Luzoscura,quelthalas,1738,paladin,retribution,72,41,31
Johnmacclane,azralon,1738,paladin,retribution,135,72,63
Popwings,azralon,1738,paladin,retribution,52,27,25
Handyandy,kelthuzad,1738,paladin,retribution,96,42,54
Arkcadius,frostmourne,1737,paladin,retribution,72,37,35
Dippedxd,tichondrius,1735,paladin,retribution,60,32,28
Gellehar,barthilas,1735,paladin,retribution,36,19,17
Siire,darkspear,1734,paladin,retribution,48,29,19
Remethea,sargeras,1733,paladin,retribution,129,67,62
Konesky,dalaran,1732,paladin,retribution,40,21,19
Lilthroatbby,malganis,1732,paladin,retribution,114,49,65
Galatus,tichondrius,1729,paladin,retribution,47,23,24
Alduur,aggramar,1728,paladin,retribution,48,30,18
Loisterly,bladefist,1728,paladin,retribution,110,58,52
Thrax,spirestone,1727,paladin,retribution,129,59,70
Cristø,stormrage,1727,paladin,retribution,72,30,42
Quinnzel,barthilas,1726,paladin,retribution,68,37,31
Coleta,stormrage,1725,paladin,retribution,42,28,14
Nah,emerald-dream,1725,paladin,retribution,57,30,27
Avenging,wyrmrest-accord,1724,paladin,retribution,44,26,18
Bigdaddysdic,illidan,1724,paladin,retribution,96,48,48
Nume,nesingwary,1724,paladin,retribution,58,23,35
Riseandgrind,tichondrius,1723,paladin,retribution,36,18,18
Çestlavie,korgath,1722,paladin,retribution,60,33,27
Puredecuy,ragnaros,1722,paladin,retribution,42,19,23
Mihawk,drenden,1721,paladin,retribution,30,21,9
Raxadin,stormrage,1720,paladin,retribution,48,25,23
Elegan,frostmourne,1719,paladin,retribution,60,30,30
Mmbakes,shadowsong,1718,paladin,retribution,30,19,11
Holywaffle,nemesis,1718,paladin,retribution,109,57,52
Retrachet,thrall,1717,paladin,retribution,42,21,21
Notae,icecrown,1717,paladin,retribution,42,21,21
Slaneesh,ragnaros,1717,paladin,retribution,36,18,18
Vanath,bleeding-hollow,1716,paladin,retribution,54,30,24
Éætûgýäëí,area-52,1716,paladin,retribution,42,18,24
Kaithen,quelthalas,1714,paladin,retribution,197,101,96
Ssjlimit,tichondrius,1713,paladin,retribution,53,27,26
Áldin,ragnaros,1711,paladin,retribution,40,23,17
Nqe,area-52,1710,paladin,retribution,64,39,25
Imcomingbro,blackrock,1710,paladin,retribution,56,27,29
Svinadin,emerald-dream,1708,paladin,retribution,36,21,15
Watchamebaba,malganis,1708,paladin,retribution,54,21,33
Whathehell,black-dragonflight,1707,paladin,retribution,123,60,63
Miktley,area-52,1707,paladin,retribution,48,22,26
Nitemareforu,stormreaver,1706,paladin,retribution,72,44,28
Triginhall,moon-guard,1706,paladin,retribution,59,27,32
Lokâr,lightbringer,1706,paladin,retribution,66,30,36
Egirlret,tichondrius,1706,paladin,retribution,48,21,27
Oneaßoveall,azralon,1705,paladin,retribution,73,42,31
Dippedlol,tichondrius,1705,paladin,retribution,42,23,19
Genovah,sargeras,1703,paladin,retribution,36,22,14
Bakafish,tichondrius,1702,paladin,retribution,24,18,6
Beaconlol,proudmoore,1701,paladin,retribution,55,37,18
Buckey,kilrogg,1699,paladin,retribution,52,28,24
Lepirate,emerald-dream,1699,paladin,retribution,36,18,18
Joeschmo,area-52,1697,paladin,retribution,42,24,18
Yérn,barthilas,1697,paladin,retribution,36,18,18
Voodoovon,tichondrius,1697,paladin,retribution,89,42,47
Bubblemark,tichondrius,1697,paladin,retribution,91,39,52
Agamemnom,tichondrius,1696,paladin,retribution,160,85,75
Zèrà,thunderhorn,1696,paladin,retribution,42,20,22
Bizzaz,moon-guard,1696,paladin,retribution,72,30,42
Evangelìne,darkspear,1695,paladin,retribution,36,23,13
Paladincane,sargeras,1695,paladin,retribution,120,61,59
Axcvnz,draka,1694,paladin,retribution,42,23,19
Vapanor,ragnaros,1694,paladin,retribution,48,25,23
Strøngkiing,bleeding-hollow,1694,paladin,retribution,48,24,24
Practícal,moon-guard,1693,paladin,retribution,66,35,31
Dazn,tichondrius,1693,paladin,retribution,78,26,52
Keltar,burning-blade,1692,paladin,retribution,30,18,12
Lalatinx,quelthalas,1692,paladin,retribution,72,37,35
Justnikop,tichondrius,1692,paladin,retribution,115,56,59
Galedance,tichondrius,1692,paladin,retribution,46,21,25
Dârkk,tichondrius,1691,paladin,retribution,36,20,16
Clownfister,barthilas,1690,paladin,retribution,54,29,25
Xeldar,tichondrius,1689,paladin,retribution,72,37,35
Pickleret,emerald-dream,1689,paladin,retribution,108,51,57
Rédbarön,illidan,1689,paladin,retribution,51,24,27
Usdacertifed,lightnings-blade,1688,paladin,retribution,155,75,80
ßountystrike,sargeras,1687,paladin,retribution,60,26,34
Goldnhart,wyrmrest-accord,1686,paladin,retribution,72,37,35
Arquidea,tichondrius,1686,paladin,retribution,66,33,33
Titannious,stormrage,1686,paladin,retribution,107,52,55
Shiryn,illidan,1685,paladin,retribution,48,24,24
Incubus,rexxar,1683,paladin,retribution,54,24,30
Nizzy,caelestrasz,1683,paladin,retribution,42,18,24
Hînøkåmí,tichondrius,1681,paladin,retribution,42,24,18
Bravepala,tichondrius,1680,paladin,retribution,54,20,34
Sasorï,stormrage,1679,paladin,retribution,90,41,49
Griffïth,thrall,1678,paladin,retribution,30,18,12
Konsentrate,tichondrius,1678,paladin,retribution,156,80,76
Clee,sargeras,1678,paladin,retribution,87,44,43
Mordirhar,tichondrius,1678,paladin,retribution,54,23,31
Hólyélf,illidan,1678,paladin,retribution,84,35,49
Ashkandi,tichondrius,1675,paladin,retribution,84,40,44
Roguesmoker,zuljin,1674,paladin,retribution,36,20,16
Kuico,ragnaros,1674,paladin,retribution,48,24,24
Tagex,malganis,1673,paladin,retribution,137,69,68
Chriskriego,frostmourne,1671,paladin,retribution,60,24,36
Pantufä,stormrage,1670,paladin,retribution,41,21,20
Zarrakra,daggerspine,1669,paladin,retribution,93,51,42
Pumperjer,tichondrius,1669,paladin,retribution,53,26,27
Boarfarmer,tichondrius,1669,paladin,retribution,48,23,25
Galeast,tichondrius,1668,paladin,retribution,60,24,36
Powermonster,tichondrius,1666,paladin,retribution,42,19,23
Lidranas,sargeras,1665,paladin,retribution,51,31,20
Haiden,goldrinn,1665,paladin,retribution,55,23,32
Ibullyourmom,tichondrius,1664,paladin,retribution,53,24,29
Jxke,barthilas,1663,paladin,retribution,41,20,21
Stompëd,proudmoore,1663,paladin,retribution,62,29,33
Finaljustice,sargeras,1661,paladin,retribution,30,19,11
Xenk,moon-guard,1659,paladin,retribution,34,18,16
Crismj,tichondrius,1659,paladin,retribution,78,41,37
Bigjiba,proudmoore,1658,paladin,retribution,48,25,23
Alyxandr,dalaran,1658,paladin,retribution,48,24,24
Midheaven,moon-guard,1656,paladin,retribution,59,36,23
Slashnroses,tichondrius,1656,paladin,retribution,44,19,25
Sabotsaint,tichondrius,1656,paladin,retribution,49,20,29
Relentless,magtheridon,1655,paladin,retribution,71,41,30
Djdiogø,azralon,1655,paladin,retribution,98,46,52
Reckcowning,area-52,1655,paladin,retribution,48,20,28
Lillm,malganis,1654,paladin,retribution,36,21,15
Paladinomg,darkspear,1654,paladin,retribution,130,74,56
Forthestreet,tichondrius,1654,paladin,retribution,88,48,40
Iggÿ,illidan,1654,paladin,retribution,70,30,40
Itzcupcake,illidan,1653,paladin,retribution,120,69,51
Duffnroses,tichondrius,1653,paladin,retribution,60,27,33
Palimedic,sargeras,1653,paladin,retribution,84,37,47
Hozna,andorhal,1652,paladin,retribution,61,36,25
Toguro,kelthuzad,1652,paladin,retribution,64,36,28
Backdrop,proudmoore,1652,paladin,retribution,133,67,66
Mazaltoff,proudmoore,1652,paladin,retribution,84,42,42
Rethir,illidan,1651,paladin,retribution,41,26,15
Lanach,lightbringer,1651,paladin,retribution,64,33,31
Orivia,spirestone,1651,paladin,retribution,54,26,28
Trixtur,tichondrius,1651,paladin,retribution,60,28,32
Malandru,darrowmere,1649,paladin,retribution,63,28,35
Matthrian,moon-guard,1649,paladin,retribution,60,22,38
Likzebawlz,tichondrius,1648,paladin,retribution,42,25,17
Comeuppance,wyrmrest-accord,1648,paladin,retribution,118,61,57
Divínos,area-52,1647,paladin,retribution,60,31,29
Nasnyl,stormrage,1646,paladin,retribution,42,20,22
Parkwons,tichondrius,1646,paladin,retribution,60,23,37
Bigolcriddys,barthilas,1645,paladin,retribution,36,21,15
Feannor,drakkari,1645,paladin,retribution,52,29,23
Geedee,ysera,1645,paladin,retribution,70,39,31
Eneraxx,proudmoore,1645,paladin,retribution,48,20,28
Trippën,tichondrius,1644,paladin,retribution,163,86,77
Tyirr,kelthuzad,1644,paladin,retribution,102,49,53
Semellem,bloodhoof,1644,paladin,retribution,48,23,25
Därth,azralon,1644,paladin,retribution,46,20,26
Palabeshar,area-52,1644,paladin,retribution,48,18,30
Beefjustice,velen,1643,paladin,retribution,48,27,21
Sevik,garithos,1643,paladin,retribution,66,35,31
Jackstank,dragonmaw,1642,paladin,retribution,53,33,20
Garlond,moon-guard,1642,paladin,retribution,42,25,17
Seraphini,illidan,1642,paladin,retribution,65,34,31
Oathen,proudmoore,1642,paladin,retribution,56,27,29
Kalgormoth,ragnaros,1641,paladin,retribution,53,21,32
Serås,silvermoon,1640,paladin,retribution,66,43,23
Shiadfang,tichondrius,1640,paladin,retribution,72,39,33
Lleo,nemesis,1640,paladin,retribution,118,54,64
Izidar,tichondrius,1639,paladin,retribution,36,24,12
Bakapal,tichondrius,1639,paladin,retribution,42,22,20
Dayuanzhong,tichondrius,1639,paladin,retribution,51,21,30
Theseusz,tichondrius,1638,paladin,retribution,36,26,10
Candysugar,tichondrius,1638,paladin,retribution,30,18,12
Notneo,zuljin,1638,paladin,retribution,53,31,22
Ceyh,ragnaros,1638,paladin,retribution,53,25,28
Benoít,zuljin,1637,paladin,retribution,84,48,36
Brightstar,azjolnerub,1637,paladin,retribution,71,39,32
Dimdabbin,malganis,1637,paladin,retribution,42,22,20
Palejandro,illidan,1637,paladin,retribution,95,49,46
Saccro,area-52,1637,paladin,retribution,114,57,57
Sosalo,sargeras,1637,paladin,retribution,51,23,28
Jud,frostmourne,1636,paladin,retribution,90,43,47
Palban,tichondrius,1635,paladin,retribution,60,31,29
Lightowen,draka,1634,paladin,retribution,46,22,24
Cyanss,ragnaros,1634,paladin,retribution,47,19,28
Beardy,emerald-dream,1633,paladin,retribution,60,36,24
Inmortall,illidan,1632,paladin,retribution,54,30,24
Mílkywayx,stormrage,1632,paladin,retribution,102,51,51
Mesmi,moon-guard,1631,paladin,retribution,66,31,35
Craq,alexstrasza,1631,paladin,retribution,56,26,30
Zayblade,dragonblight,1630,paladin,retribution,40,23,17
Tobaz,azralon,1630,paladin,retribution,85,48,37
Ulrah,moon-guard,1629,paladin,retribution,120,68,52
Hristian,tichondrius,1629,paladin,retribution,42,22,20
Thoreal,thrall,1629,paladin,retribution,78,37,41
Chancellor,azralon,1628,paladin,retribution,168,94,74
Varekaì,frostmourne,1628,paladin,retribution,147,78,69
Derigoth,quelthalas,1628,paladin,retribution,42,20,22
Ítsyôúñötmé,tichondrius,1627,paladin,retribution,68,38,30
Kíbá,malganis,1627,paladin,retribution,33,18,15
Sathandrä,sargeras,1627,paladin,retribution,63,27,36
Bastiion,stormrage,1626,paladin,retribution,64,32,32
Davinshki,stormrage,1625,paladin,retribution,43,25,18
Fluffnac,tichondrius,1625,paladin,retribution,30,17,13
Notbärry,area-52,1625,paladin,retribution,48,27,21
Renckay,ragnaros,1625,paladin,retribution,99,52,47
Aeterias,dalaran,1625,paladin,retribution,81,41,40
Chajaaro,ragnaros,1625,paladin,retribution,67,33,34
Apnea,ragnaros,1625,paladin,retribution,125,53,72
Moød,ragnaros,1624,paladin,retribution,53,27,26
Techno,tichondrius,1623,paladin,retribution,175,89,86
Radacos,emerald-dream,1623,paladin,retribution,160,80,80
Sugnidrom,frostmourne,1623,paladin,retribution,46,23,23
Joeyrat,area-52,1623,paladin,retribution,42,20,22
Retrodino,anvilmar,1623,paladin,retribution,48,21,27
Xuanxingchai,tichondrius,1623,paladin,retribution,42,17,25
Cyrenity,tichondrius,1623,paladin,retribution,59,19,40
Litler,tichondrius,1622,paladin,retribution,44,30,14
Gobblerr,blackrock,1622,paladin,retribution,30,20,10
Hazexd,illidan,1621,paladin,retribution,36,20,16
Dashhighborn,sargeras,1621,paladin,retribution,71,38,33
Faladrim,moon-guard,1621,paladin,retribution,160,84,76
Michaelsmith,frostmourne,1621,paladin,retribution,36,17,19
Rukkas,sargeras,1621,paladin,retribution,54,21,33
Alanthor,ragnaros,1620,paladin,retribution,120,58,62
Valytonz,wyrmrest-accord,1620,paladin,retribution,36,17,19
Marcêl,quelthalas,1619,paladin,retribution,36,22,14
Pinkies,frostmourne,1619,paladin,retribution,57,33,24
Bbtea,frostmourne,1619,paladin,retribution,48,20,28
Glørious,drakkari,1618,paladin,retribution,90,42,48
Tuuro,stormrage,1618,paladin,retribution,141,65,76
Outkas,area-52,1617,paladin,retribution,30,17,13
Aleríon,ragnaros,1617,paladin,retribution,175,89,86
Weike,barthilas,1617,paladin,retribution,70,28,42
Lawmower,sargeras,1616,paladin,retribution,54,32,22
Royalfather,tichondrius,1615,paladin,retribution,40,26,14
Drholypurp,tichondrius,1615,paladin,retribution,59,31,28
Outstrike,tichondrius,1615,paladin,retribution,36,17,19
Thenextx,illidan,1615,paladin,retribution,66,22,44
Raelan,icecrown,1614,paladin,retribution,71,49,22
Merculios,stormrage,1614,paladin,retribution,57,31,26
Healmeboi,tichondrius,1614,paladin,retribution,68,33,35
Stax,moon-guard,1614,paladin,retribution,42,17,25
Pockopea,arygos,1613,paladin,retribution,84,52,32
Bramot,moon-guard,1613,paladin,retribution,36,20,16
Xbloodknight,malganis,1613,paladin,retribution,50,27,23
Milizi,zuljin,1613,paladin,retribution,72,32,40
Galess,tichondrius,1613,paladin,retribution,48,17,31
Yusha,barthilas,1612,paladin,retribution,41,28,13
Tesak,emerald-dream,1612,paladin,retribution,102,53,49
Moolishous,frostmourne,1612,paladin,retribution,83,43,40
Telarøn,stormrage,1612,paladin,retribution,200,101,99
Jvbai,area-52,1612,paladin,retribution,87,39,48
Swiftskillz,bleeding-hollow,1611,paladin,retribution,127,69,58
Kevybevy,stormrage,1611,paladin,retribution,150,81,69
Accépting,sargeras,1611,paladin,retribution,84,40,44
Rahmie,kiljaeden,1611,paladin,retribution,96,41,55
Purejudgemnt,area-52,1610,paladin,retribution,54,33,21
Beeftink,tichondrius,1609,paladin,retribution,100,51,49
Allîe,malganis,1609,paladin,retribution,73,37,36
Battlepope,thrall,1609,paladin,retribution,59,27,32
Regivan,nemesis,1609,paladin,retribution,54,21,33
Sololeveling,malganis,1608,paladin,retribution,98,48,50
Golden,tichondrius,1608,paladin,retribution,42,20,22
Holyroro,area-52,1607,paladin,retribution,44,26,18
Yezzyll,korgath,1607,paladin,retribution,30,17,13
Wasembroder,ragnaros,1607,paladin,retribution,89,50,39
Gattís,stormrage,1607,paladin,retribution,54,29,25
Trolladin,rivendare,1607,paladin,retribution,110,51,59
Shakalot,illidan,1607,paladin,retribution,48,21,27
Marehk,thrall,1606,paladin,retribution,59,32,27
Southerly,tichondrius,1606,paladin,retribution,78,39,39
Aefuezar,earthen-ring,1606,paladin,retribution,56,28,28
Stônemôuntan,moon-guard,1606,paladin,retribution,72,26,46
Munaru,illidan,1605,paladin,retribution,30,21,9
Pçpaladin,stormrage,1605,paladin,retribution,36,21,15
Chrisader,stormrage,1605,paladin,retribution,36,19,17
Dïlly,area-52,1605,paladin,retribution,84,43,41
Getdiswork,malygos,1605,paladin,retribution,105,52,53
Virtuosi,area-52,1604,paladin,retribution,42,23,19
Xeniél,illidan,1604,paladin,retribution,36,19,17
Arreliya,sargeras,1604,paladin,retribution,78,41,37
Rycerzforge,ragnaros,1604,paladin,retribution,74,38,36
Actionb,aggramar,1604,paladin,retribution,90,41,49
Rhegyna,quelthalas,1603,paladin,retribution,48,26,22
Plophero,moon-guard,1603,paladin,retribution,54,28,26
Skylinator,bleeding-hollow,1603,paladin,retribution,59,26,33
Jowliet,stormrage,1601,paladin,retribution,36,17,19
Elcíd,quelthalas,1601,paladin,retribution,87,34,53
Aethelwulf,stormrage,1600,paladin,retribution,42,24,18
Minidin,kiljaeden,1599,paladin,retribution,36,17,19
Elëssar,ragnaros,1598,paladin,retribution,83,44,39
Samgonz,tichondrius,1597,paladin,retribution,54,32,22
Esçanór,darkspear,1597,paladin,retribution,49,25,24
Skilladin,zuljin,1596,paladin,retribution,48,24,24
Pandoro,tichondrius,1594,paladin,retribution,49,29,20
Kozk,quelthalas,1594,paladin,retribution,159,92,67
Happybubbles,tichondrius,1594,paladin,retribution,36,20,16
Layonhánd,ragnaros,1593,paladin,retribution,48,22,26
Amanzhul,quelthalas,1593,paladin,retribution,48,21,27
Alpengeist,turalyon,1591,paladin,retribution,36,19,17
Gimlias,kelthuzad,1591,paladin,retribution,42,21,21
Cøøkïë,frostmourne,1590,paladin,retribution,42,22,20
Torinel,illidan,1590,paladin,retribution,35,17,18
Auralyon,tichondrius,1590,paladin,retribution,42,17,25
Sinmca,moon-guard,1588,paladin,retribution,60,34,26
Eurekasret,ragnaros,1587,paladin,retribution,65,33,32
Hedilyan,azralon,1587,paladin,retribution,96,48,48
Sandokhán,ragnaros,1587,paladin,retribution,42,19,23
Ilovecl,tichondrius,1586,paladin,retribution,54,32,22
Yukíteru,illidan,1586,paladin,retribution,39,18,21
Cowsecration,ragnaros,1585,paladin,retribution,24,17,7
Whyta,azralon,1584,paladin,retribution,145,75,70
Fótm,bleeding-hollow,1583,paladin,retribution,72,36,36
Lightlana,frostwolf,1583,paladin,retribution,68,34,34
Marvallous,area-52,1583,paladin,retribution,52,25,27
Landeren,khazgoroth,1582,paladin,retribution,48,22,26
Taphos,icecrown,1581,paladin,retribution,53,30,23
Utherpendrag,bladefist,1581,paladin,retribution,72,28,44
Lucianz,ragnaros,1580,paladin,retribution,54,25,29
Borrus,malygos,1579,paladin,retribution,78,40,38
Lecheroø,tichondrius,1579,paladin,retribution,42,21,21
Danaimei,tichondrius,1577,paladin,retribution,36,19,17
Rimjobrachel,barthilas,1577,paladin,retribution,86,42,44
Fuknshané,area-52,1577,paladin,retribution,68,32,36
Malacriianza,quelthalas,1576,paladin,retribution,54,30,24
Leztatium,quelthalas,1576,paladin,retribution,42,21,21
Daddytoad,tichondrius,1576,paladin,retribution,54,24,30
Ellyee,jaedenar,1576,paladin,retribution,70,29,41
Syreqt,nemesis,1575,paladin,retribution,36,19,17
Neovincent,aggramar,1574,paladin,retribution,30,18,12
Fìlìgree,tichondrius,1574,paladin,retribution,55,30,25
Ruhn,eldrethalas,1574,paladin,retribution,36,18,18
Razneroka,ragnaros,1573,paladin,retribution,39,22,17
Daleroth,ragnaros,1573,paladin,retribution,39,22,17
Stackmymoney,kelthuzad,1572,paladin,retribution,50,22,28
Pocserpala,drakkari,1571,paladin,retribution,30,19,11
Ezael,crushridge,1570,paladin,retribution,42,21,21
Purdicks,emerald-dream,1569,paladin,retribution,142,71,71
Mormdring,fizzcrank,1569,paladin,retribution,59,26,33
Htmlar,tichondrius,1568,paladin,retribution,40,17,23
Guerrer,hyjal,1567,paladin,retribution,60,33,27
Obsolete,onyxia,1567,paladin,retribution,36,18,18
Coffeepal,tichondrius,1567,paladin,retribution,48,23,25
Cillessá,kelthuzad,1566,paladin,retribution,78,41,37
Émiluss,stormrage,1566,paladin,retribution,36,18,18
Xerobite,quelthalas,1566,paladin,retribution,36,18,18
Chiphazard,stormscale,1566,paladin,retribution,58,23,35
Ragarèn,emerald-dream,1565,paladin,retribution,36,17,19
Andrilsteh,malganis,1565,paladin,retribution,102,45,57
Fionno,quelthalas,1564,paladin,retribution,116,58,58
Tantradin,area-52,1564,paladin,retribution,48,20,28
Andallar,nordrassil,1562,paladin,retribution,36,23,13
Aiseyqt,frostmourne,1562,paladin,retribution,90,57,33
Lagwat,sargeras,1561,paladin,retribution,48,31,17
Rxes,frostmourne,1561,paladin,retribution,99,43,56
Baeflux,kelthuzad,1560,paladin,retribution,48,19,29
Luret,tichondrius,1557,paladin,retribution,34,17,17
Insideous,kelthuzad,1557,paladin,retribution,69,34,35
Redoubt,archimonde,1557,paladin,retribution,35,17,18
Vêgenace,proudmoore,1556,paladin,retribution,48,24,24
Missusomutch,azralon,1556,paladin,retribution,50,17,33
Lit,alexstrasza,1555,paladin,retribution,46,19,27
Ibustcheeks,sargeras,1554,paladin,retribution,35,17,18
Flykzu,azralon,1554,paladin,retribution,160,74,86
Crybátt,quelthalas,1553,paladin,retribution,68,35,33
Luminiscente,ragnaros,1553,paladin,retribution,58,29,29
Alexieus,wyrmrest-accord,1553,paladin,retribution,71,32,39
Filthyape,wyrmrest-accord,1552,paladin,retribution,66,39,27
Lumaros,wyrmrest-accord,1552,paladin,retribution,48,25,23
Thastrian,stormreaver,1552,paladin,retribution,60,31,29
Notoriouus,bleeding-hollow,1552,paladin,retribution,42,18,24
Yovan,proudmoore,1551,paladin,retribution,90,51,39
Holybirkkal,arthas,1551,paladin,retribution,47,25,22
Albïreo,drakkari,1550,paladin,retribution,54,28,26
Holyjoint,uther,1550,paladin,retribution,92,39,53
Mcholy,thrall,1549,paladin,retribution,50,27,23
Sàgadegemeós,stormrage,1548,paladin,retribution,54,31,23
Evilmerdoc,kelthuzad,1548,paladin,retribution,36,18,18
Caribourider,tichondrius,1548,paladin,retribution,65,29,36
Mordered,proudmoore,1548,paladin,retribution,46,18,28
Scrubble,thrall,1547,paladin,retribution,90,44,46
Varlip,wyrmrest-accord,1545,paladin,retribution,53,18,35
Ënfos,azralon,1541,paladin,retribution,36,17,19
Thaldun,wyrmrest-accord,1541,paladin,retribution,95,41,54
Ðoflamingo,area-52,1540,paladin,retribution,72,38,34
Quadrifoglio,moon-guard,1540,paladin,retribution,138,70,68
Brokeniron,wyrmrest-accord,1539,paladin,retribution,66,31,35
Frùglé,sargeras,1538,paladin,retribution,36,20,16
Zalndraeda,barthilas,1538,paladin,retribution,96,48,48
Celethor,wyrmrest-accord,1537,paladin,retribution,54,30,24
Tatakaicjq,tichondrius,1537,paladin,retribution,33,18,15
Thepinkdept,proudmoore,1537,paladin,retribution,38,20,18
Nilin,tichondrius,1537,paladin,retribution,54,27,27
Aberpal,illidan,1535,paladin,retribution,41,23,18
Dazedpal,tichondrius,1535,paladin,retribution,289,150,139
Greciâ,ragnaros,1535,paladin,retribution,42,18,24
Hammrekt,sargeras,1534,paladin,retribution,24,16,8
Tearet,tichondrius,1534,paladin,retribution,24,16,8
Álkair,ragnaros,1534,paladin,retribution,83,36,47
Jager,medivh,1533,paladin,retribution,71,41,30
Retcuzyaknow,illidan,1533,paladin,retribution,36,16,20
Ezcoatl,stormrage,1530,paladin,retribution,92,47,45
Arlanso,frostmourne,1530,paladin,retribution,40,18,22
Loyality,sargeras,1530,paladin,retribution,36,16,20
Beardedbrute,korgath,1529,paladin,retribution,30,16,14
Schankyy,stormrage,1529,paladin,retribution,36,19,17
Deepsearide,illidan,1529,paladin,retribution,119,61,58
Unfairness,skullcrusher,1528,paladin,retribution,63,33,30
Ástridr,moon-guard,1528,paladin,retribution,95,43,52
Arturias,kiljaeden,1527,paladin,retribution,77,38,39
Oneshotman,stormrage,1526,paladin,retribution,30,16,14
Ironcoco,ragnaros,1526,paladin,retribution,38,19,19
Kenpachí,doomhammer,1525,paladin,retribution,42,30,12
Venxpeita,azralon,1525,paladin,retribution,24,16,8
Rektwings,area-52,1525,paladin,retribution,30,16,14
Dragin,azralon,1525,paladin,retribution,41,21,20
Palaxoto,nemesis,1525,paladin,retribution,48,19,29
Shaidd,bleeding-hollow,1524,paladin,retribution,98,49,49
Mfgspally,kelthuzad,1523,paladin,retribution,54,31,23
Blitzzed,area-52,1522,paladin,retribution,35,18,17
Sneeber,stormrage,1520,paladin,retribution,72,34,38
Anjurus,moon-guard,1519,paladin,retribution,30,16,14
Castïël,area-52,1519,paladin,retribution,157,77,80
Tzakial,area-52,1519,paladin,retribution,42,16,26
Gude,sargeras,1518,paladin,retribution,30,16,14
Shartea,moon-guard,1518,paladin,retribution,58,29,29
Týrael,uldum,1517,paladin,retribution,48,28,20
Chewyjitsu,tichondrius,1517,paladin,retribution,30,17,13
Worshipmex,tichondrius,1517,paladin,retribution,36,20,16
Eustace,thunderhorn,1517,paladin,retribution,35,19,16
Sweetcandy,sargeras,1517,paladin,retribution,42,21,21
Souyiro,sargeras,1517,paladin,retribution,36,16,20
Ascetic,barthilas,1517,paladin,retribution,200,87,113
Lorenzinho,azralon,1516,paladin,retribution,80,42,38
Buddyolpally,proudmoore,1515,paladin,retribution,36,19,17
Tofuupal,tichondrius,1514,paladin,retribution,36,16,20
Poisson,wildhammer,1514,paladin,retribution,36,16,20
Kawkpaladin,kaelthas,1512,paladin,retribution,60,31,29
Pàladwarf,stormrage,1511,paladin,retribution,51,26,25
Sniper,uther,1510,paladin,retribution,30,16,14
Protein,magtheridon,1509,paladin,retribution,42,16,26
Mysticblade,sargeras,1508,paladin,retribution,54,31,23
Temote,anvilmar,1508,paladin,retribution,54,27,27
Cyreus,emerald-dream,1508,paladin,retribution,57,26,31
Miemiesage,illidan,1508,paladin,retribution,42,16,26
Yazuka,wyrmrest-accord,1506,paladin,retribution,54,30,24
Cókelol,zuljin,1506,paladin,retribution,78,42,36
Istril,ragnaros,1506,paladin,retribution,292,152,140
Preacherfudd,area-52,1506,paladin,retribution,42,21,21
Angrytitan,tichondrius,1504,paladin,retribution,42,17,25
Pvrisxx,frostmourne,1503,paladin,retribution,54,28,26
Bubblelol,bloodhoof,1503,paladin,retribution,51,17,34
Xk,kiljaeden,1502,paladin,retribution,30,16,14
Rhodela,illidan,1502,paladin,retribution,48,24,24
Kiritazuma,ravencrest,1502,paladin,retribution,78,37,41
Alphanerd,burning-blade,1501,paladin,retribution,42,26,16
Rohrn,firetree,1501,paladin,retribution,55,32,23
Notae,alexstrasza,1501,paladin,retribution,35,16,19
Norlannd,ragnaros,1499,paladin,retribution,30,16,14
Kookamønga,tichondrius,1498,paladin,retribution,67,32,35
Mäýhëm,sargeras,1497,paladin,retribution,36,22,14
Hinataa,illidan,1497,paladin,retribution,81,45,36
Audris,chogall,1497,paladin,retribution,65,29,36
Tøpbløke,frostmourne,1495,paladin,retribution,109,59,50
Hamertime,wyrmrest-accord,1495,paladin,retribution,92,47,45
Konthrus,azralon,1494,paladin,retribution,77,49,28
Schwârts,blackrock,1494,paladin,retribution,70,36,34
Emmastoned,bleeding-hollow,1493,paladin,retribution,54,27,27
Anivan,moon-guard,1493,paladin,retribution,42,21,21
Bogùs,tichondrius,1493,paladin,retribution,36,16,20
Ignasius,blood-furnace,1492,paladin,retribution,48,22,26
Yiqieyouwei,proudmoore,1492,paladin,retribution,42,18,24
Holdup,moon-guard,1491,paladin,retribution,35,25,10
Upaitaon,stormrage,1491,paladin,retribution,54,27,27
Holydiver,sargeras,1490,paladin,retribution,96,44,52
Nocomus,andorhal,1489,paladin,retribution,60,28,32
Mathieü,zuljin,1488,paladin,retribution,36,20,16
Dgâza,tichondrius,1488,paladin,retribution,36,17,19
Oppression,kul-tiras,1488,paladin,retribution,53,19,34
Dzx,nemesis,1487,paladin,retribution,263,135,128
Grîshnâkh,ragnaros,1487,paladin,retribution,119,61,58
Hägär,tichondrius,1487,paladin,retribution,54,23,31
Haunter,akama,1485,paladin,retribution,54,25,29
Dcountt,area-52,1484,paladin,retribution,47,22,25
Levian,spirestone,1483,paladin,retribution,90,46,44
Greasysteve,stormrage,1482,paladin,retribution,60,33,27
Lebowski,nordrassil,1482,paladin,retribution,36,19,17
Smallhammer,aegwynn,1482,paladin,retribution,66,28,38
Dalgren,quelthalas,1482,paladin,retribution,81,30,51
Sammyste,elune,1480,paladin,retribution,86,46,40
Ralo,khaz-modan,1480,paladin,retribution,30,16,14
Joltie,quelthalas,1480,paladin,retribution,155,82,73
Freiermoth,shadowmoon,1480,paladin,retribution,135,69,66
Gokuu,korgath,1480,paladin,retribution,84,42,42
Forlam,sargeras,1480,paladin,retribution,108,45,63
Areuss,tichondrius,1479,paladin,retribution,29,16,13
Ogholyhands,bleeding-hollow,1479,paladin,retribution,42,23,19
Janokaluo,wyrmrest-accord,1479,paladin,retribution,89,46,43
Killeralan,quelthalas,1477,paladin,retribution,74,34,40
Jøestar,proudmoore,1477,paladin,retribution,58,26,32
Jonfox,stormrage,1476,paladin,retribution,61,32,29
Sconci,whisperwind,1475,paladin,retribution,42,20,22
Azoruken,quelthalas,1475,paladin,retribution,71,31,40
Redemptiøn,nemesis,1475,paladin,retribution,60,20,40
Arecht,moon-guard,1474,paladin,retribution,30,19,11
Fressbee,nathrezim,1473,paladin,retribution,41,19,22
Alexese,area-52,1472,paladin,retribution,71,39,32
Chadatron,tichondrius,1472,paladin,retribution,36,17,19
Zuthora,alleria,1471,paladin,retribution,70,37,33
Ellanaria,thrall,1471,paladin,retribution,117,61,56
Beshiki,hakkar,1471,paladin,retribution,286,139,147
Piea,tichondrius,1471,paladin,retribution,48,22,26
Yoboyindahiz,stormrage,1471,paladin,retribution,57,23,34
Rykorth,moon-guard,1470,paladin,retribution,33,20,13
Carnagias,bleeding-hollow,1470,paladin,retribution,71,38,33
Charleyy,stormscale,1469,paladin,retribution,78,45,33
Pijbins,moon-guard,1469,paladin,retribution,66,34,32
Atterz,azralon,1469,paladin,retribution,40,18,22
Freddieroach,tichondrius,1469,paladin,retribution,36,16,20
Ezpzxd,arygos,1467,paladin,retribution,38,19,19
Vasharien,nerzhul,1467,paladin,retribution,74,35,39
Dimmadome,frostmourne,1465,paladin,retribution,78,50,28
Nicret,tichondrius,1464,paladin,retribution,24,18,6
Toughlife,tichondrius,1464,paladin,retribution,72,28,44
Nohpalli,kelthuzad,1463,paladin,retribution,79,43,36
Bañe,lightbringer,1463,paladin,retribution,81,35,46
Bronytime,illidan,1462,paladin,retribution,29,16,13
Dreyan,wyrmrest-accord,1462,paladin,retribution,47,23,24
Killmönger,tichondrius,1462,paladin,retribution,58,25,33
Sanguinata,shadowsong,1461,paladin,retribution,47,30,17
Snussp,emerald-dream,1461,paladin,retribution,69,32,37
Crayt,tichondrius,1461,paladin,retribution,97,40,57
Lasteroy,nemesis,1459,paladin,retribution,29,16,13
Konarik,stormrage,1459,paladin,retribution,46,25,21
Bapped,dalaran,1459,paladin,retribution,54,24,30
Athenauwu,illidan,1458,paladin,retribution,40,19,21
Valardaharis,thunderlord,1457,paladin,retribution,100,43,57
Theholysword,tichondrius,1457,paladin,retribution,41,16,25
Dentarg,garrosh,1456,paladin,retribution,54,29,25
Esixtytwoone,area-52,1455,paladin,retribution,30,21,9
Folgimar,moon-guard,1455,paladin,retribution,72,37,35
Orestis,stormrage,1455,paladin,retribution,39,20,19
Thalorian,azshara,1455,paladin,retribution,51,25,26
Astharor,nemesis,1454,paladin,retribution,70,40,30
Psadin,thunderlord,1454,paladin,retribution,48,23,25
Sovereignt,aggramar,1453,paladin,retribution,157,84,73
Monchy,bleeding-hollow,1453,paladin,retribution,52,27,25
Wwanntae,tichondrius,1453,paladin,retribution,60,26,34
Yamush,silver-hand,1452,paladin,retribution,36,18,18
Cammack,thrall,1452,paladin,retribution,63,25,38
Vexxa,nerzhul,1451,paladin,retribution,36,18,18
Murtag,bloodscalp,1451,paladin,retribution,36,18,18
Tacien,tichondrius,1451,paladin,retribution,112,54,58
Cyäbyë,frostmourne,1450,paladin,retribution,30,18,12
Drtom,mannoroth,1450,paladin,retribution,39,21,18
Liaadrin,azralon,1450,paladin,retribution,32,16,16
Solandiis,tichondrius,1450,paladin,retribution,67,32,35
Airplane,malygos,1449,paladin,retribution,24,16,8
Lustros,stormrage,1449,paladin,retribution,66,28,38
Avati,sargeras,1448,paladin,retribution,22,16,6
Californía,bleeding-hollow,1448,paladin,retribution,37,23,14
Bladetm,proudmoore,1448,paladin,retribution,62,28,34
Aoishie,bleeding-hollow,1444,paladin,retribution,96,45,51
Muffinknight,quelthalas,1443,paladin,retribution,55,36,19
Iluminadoor,nemesis,1442,paladin,retribution,29,19,10
Weskar,frostwolf,1440,paladin,retribution,42,24,18
Faowin,sargeras,1440,paladin,retribution,72,32,40
Awake,chogall,1439,paladin,retribution,24,15,9
Taeret,tichondrius,1439,paladin,retribution,24,15,9
Blulux,ragnaros,1439,paladin,retribution,71,39,32
Kkgame,tichondrius,1439,paladin,retribution,37,19,18
Bilbain,proudmoore,1439,paladin,retribution,203,103,100
Zadragon,sargeras,1438,paladin,retribution,54,27,27
Cesah,tichondrius,1436,paladin,retribution,24,15,9
Oppressive,moon-guard,1436,paladin,retribution,291,135,156
Xalø,ragnaros,1435,paladin,retribution,24,15,9
Zolktro,stormrage,1435,paladin,retribution,52,27,25
Mitchyc,stormrage,1435,paladin,retribution,66,33,33
Warmpôcket,proudmoore,1435,paladin,retribution,66,26,40
Whitearmor,draenor,1434,paladin,retribution,42,24,18
Lumíty,sargeras,1434,paladin,retribution,137,70,67
Gimli,mannoroth,1434,paladin,retribution,36,15,21
Onitenshi,stormscale,1432,paladin,retribution,85,41,44
Antarcticala,frostmourne,1432,paladin,retribution,48,20,28
Saakadin,illidan,1431,paladin,retribution,24,15,9
Perzeføne,quelthalas,1431,paladin,retribution,41,20,21
Rasc,barthilas,1431,paladin,retribution,42,18,24
Sprinkills,frostmourne,1430,paladin,retribution,27,19,8
Richiggaa,illidan,1430,paladin,retribution,47,29,18
Aztraseneco,ragnaros,1430,paladin,retribution,104,59,45
Lmd,tichondrius,1429,paladin,retribution,54,29,25
Supercharged,area-52,1429,paladin,retribution,30,15,15
Pugnosano,black-dragonflight,1429,paladin,retribution,36,17,19
Dawncröwn,stormrage,1429,paladin,retribution,53,17,36
Falaran,azralon,1428,paladin,retribution,62,32,30
Aiethyria,tichondrius,1427,paladin,retribution,24,15,9
Messeb,veknilash,1427,paladin,retribution,145,80,65
Wesdarian,jaedenar,1427,paladin,retribution,90,41,49
Donao,illidan,1426,paladin,retribution,66,35,31
Talantyr,zuljin,1426,paladin,retribution,78,36,42
Holiness,stormreaver,1426,paladin,retribution,42,15,27
Tribiani,lightbringer,1425,paladin,retribution,24,15,9
Dallyon,stormrage,1425,paladin,retribution,24,15,9
Mathalt,area-52,1425,paladin,retribution,51,26,25
Superpaladin,stormrage,1425,paladin,retribution,53,23,30
Floquiinhos,azralon,1425,paladin,retribution,36,15,21
Jursch,emerald-dream,1424,paladin,retribution,145,73,72
Tekar,altar-of-storms,1424,paladin,retribution,42,17,25
Modjytech,tichondrius,1422,paladin,retribution,66,24,42
Plniss,tichondrius,1421,paladin,retribution,36,15,21
Arahann,bleeding-hollow,1420,paladin,retribution,29,16,13
Palpinga,kelthuzad,1420,paladin,retribution,44,18,26
Tåine,suramar,1420,paladin,retribution,48,16,32
Annhette,sargeras,1418,paladin,retribution,31,15,16
Lolslikeomg,malganis,1418,paladin,retribution,96,39,57
Galanblack,dalaran,1417,paladin,retribution,56,31,25
Napstër,ragnaros,1417,paladin,retribution,36,15,21
Wagyou,skywall,1416,paladin,retribution,30,15,15
Yawnbringer,tichondrius,1416,paladin,retribution,108,52,56
Balrok,cenarius,1415,paladin,retribution,185,93,92
Hdmi,darkspear,1415,paladin,retribution,41,20,21
Andrinn,nemesis,1415,paladin,retribution,51,24,27
Minzyy,frostmourne,1414,paladin,retribution,24,15,9
Zadquel,ragnaros,1414,paladin,retribution,59,30,29
Lightcast,moon-guard,1414,paladin,retribution,66,33,33
Savagedemise,barthilas,1413,paladin,retribution,55,28,27
Justicierø,aegwynn,1413,paladin,retribution,42,21,21
Solgrïm,wyrmrest-accord,1412,paladin,retribution,42,21,21
Nuggetpusher,thunderlord,1410,paladin,retribution,31,16,15
Ödin,scarlet-crusade,1410,paladin,retribution,30,15,15
Bullzor,aerie-peak,1409,paladin,retribution,49,33,16
Smashnasty,area-52,1409,paladin,retribution,24,15,9
Tìg,proudmoore,1409,paladin,retribution,59,33,26
Releváncé,barthilas,1409,paladin,retribution,66,31,35
Vaqoh,ragnaros,1409,paladin,retribution,36,15,21
Kalboko,twisting-nether,1408,paladin,retribution,45,23,22
Reìarthur,stormrage,1408,paladin,retribution,72,32,40
Kulandis,stormrage,1408,paladin,retribution,57,24,33
Cloaxy,azgalor,1408,paladin,retribution,78,29,49
Anafensa,malganis,1408,paladin,retribution,42,15,27
Milke,chogall,1407,paladin,retribution,36,17,19
Szeq,tichondrius,1405,paladin,retribution,32,16,16
Outlivz,hyjal,1404,paladin,retribution,33,17,16
Fây,sargeras,1404,paladin,retribution,42,15,27
Kêrmit,zuljin,1403,paladin,retribution,25,16,9
Zimzob,stormscale,1403,paladin,retribution,30,15,15
Swietomierz,proudmoore,1403,paladin,retribution,48,20,28
Againstfilet,azralon,1403,paladin,retribution,60,17,43
Jdgmnt,sargeras,1401,paladin,retribution,72,33,39
Eamon,kelthuzad,1400,paladin,retribution,29,15,14
Viclovin,stormrage,1400,paladin,retribution,34,17,17
Holyham,fizzcrank,1398,paladin,retribution,48,27,21
Chuckman,skullcrusher,1397,paladin,retribution,30,16,14
Pvppaulx,moon-guard,1397,paladin,retribution,36,19,17
Kadbury,icecrown,1396,paladin,retribution,154,64,90
Rhodius,dalaran,1393,paladin,retribution,42,23,19
Tmac,azralon,1393,paladin,retribution,68,35,33
Belregn,illidan,1393,paladin,retribution,78,36,42
Öpäf,steamwheedle-cartel,1393,paladin,retribution,49,21,28
Emethala,windrunner,1392,paladin,retribution,36,19,17
Tooholy,kiljaeden,1391,paladin,retribution,64,42,22
Tronzyy,trollbane,1391,paladin,retribution,35,15,20
Judgmentor,malganis,1391,paladin,retribution,82,34,48
Droden,tichondrius,1390,paladin,retribution,55,29,26
Dannyram,zuljin,1390,paladin,retribution,51,25,26
Shampin,alexstrasza,1390,paladin,retribution,36,17,19
Uxd,tichondrius,1390,paladin,retribution,36,16,20
Industry,firetree,1389,paladin,retribution,27,16,11
Smorezz,bonechewer,1389,paladin,retribution,72,37,35
Cryptdog,illidan,1389,paladin,retribution,39,16,23
Damndoi,tichondrius,1388,paladin,retribution,30,15,15
Slowedreverb,stormrage,1387,paladin,retribution,81,42,39
Granisdh,aegwynn,1387,paladin,retribution,54,27,27
Pallytoot,aerie-peak,1386,paladin,retribution,60,35,25
Erowyn,tichondrius,1385,paladin,retribution,30,15,15
Simplesam,draenor,1385,paladin,retribution,36,15,21
Belgrieve,proudmoore,1384,paladin,retribution,48,22,26
Urfavxbf,baelgun,1383,paladin,retribution,104,56,48
Oschy,moon-guard,1382,paladin,retribution,91,45,46
Blindburn,ragnaros,1379,paladin,retribution,36,17,19
Sozmsjackson,barthilas,1379,paladin,retribution,39,17,22
Elsinore,senjin,1377,paladin,retribution,35,19,16
Kaelthasar,azralon,1376,paladin,retribution,30,15,15
Fabolouss,tichondrius,1375,paladin,retribution,78,43,35
Delanadras,kelthuzad,1375,paladin,retribution,47,19,28
Stdee,zuljin,1372,paladin,retribution,57,30,27
Kalendawn,moon-guard,1370,paladin,retribution,55,33,22
Bigdoosa,frostmourne,1370,paladin,retribution,34,18,16
Superzooted,sargeras,1370,paladin,retribution,34,15,19
Theretpally,kelthuzad,1370,paladin,retribution,48,21,27
Dfbattlepass,kelthuzad,1369,paladin,retribution,67,36,31
Sländers,sargeras,1369,paladin,retribution,65,29,36
Minitas,blackrock,1369,paladin,retribution,42,15,27
Kellissandra,aerie-peak,1368,paladin,retribution,84,34,50
Pal,blackhand,1366,paladin,retribution,36,20,16
Björñ,moon-guard,1366,paladin,retribution,33,16,17
Scubàlicous,magtheridon,1366,paladin,retribution,42,19,23
Wîckèd,tichondrius,1366,paladin,retribution,35,15,20
Bebopin,tichondrius,1365,paladin,retribution,34,16,18
Hurukpaly,azralon,1365,paladin,retribution,52,23,29
Honeybunza,area-52,1365,paladin,retribution,34,15,19
Áthz,ragnaros,1363,paladin,retribution,41,21,20
Hùck,alexstrasza,1363,paladin,retribution,110,51,59
Feelsögood,tichondrius,1363,paladin,retribution,33,15,18
Alvick,icecrown,1363,paladin,retribution,39,16,23
Akâme,kelthuzad,1361,paladin,retribution,22,15,7
PlayerHRFWDC,garrosh,1361,paladin,retribution,48,27,21
Carliitoz,quelthalas,1361,paladin,retribution,55,19,36
Cyniaria,moon-guard,1360,paladin,retribution,90,44,46
Sellenagomez,malganis,1359,paladin,retribution,48,21,27
Salaminhoo,azralon,1358,paladin,retribution,24,16,8
Clayban,stormrage,1358,paladin,retribution,36,20,16
Xoxoxoxoxoxo,aegwynn,1357,paladin,retribution,48,23,25
Tarnyb,illidan,1357,paladin,retribution,32,15,17
Wickedwingz,sargeras,1356,paladin,retribution,30,15,15
Hokkan,quelthalas,1353,paladin,retribution,47,24,23
Andronik,bleeding-hollow,1352,paladin,retribution,33,16,17
Keltec,bonechewer,1351,paladin,retribution,51,18,33
Tlahtoani,illidan,1350,paladin,retribution,23,15,8
Zantdemption,frostmourne,1349,paladin,retribution,29,15,14
Øxøxø,emerald-dream,1347,paladin,retribution,78,41,37
Hazmât,illidan,1347,paladin,retribution,81,32,49
Dwurim,moon-guard,1346,paladin,retribution,48,26,22
Ddeadwhisper,executus,1345,paladin,retribution,104,56,48
Chinsta,zuljin,1344,paladin,retribution,24,16,8
Retman,azuremyst,1344,paladin,retribution,42,17,25
Sophany,shattered-halls,1343,paladin,retribution,34,21,13
Bossmin,tichondrius,1343,paladin,retribution,24,14,10
Forzanapoli,tichondrius,1343,paladin,retribution,30,14,16
Kumdonia,illidan,1343,paladin,retribution,30,14,16
Worder,tichondrius,1342,paladin,retribution,24,15,9
Bigdogchief,stormrage,1342,paladin,retribution,24,14,10
Draidan,area-52,1342,paladin,retribution,68,32,36
Gabbynator,emerald-dream,1342,paladin,retribution,30,14,16
Xygra,stormrage,1342,paladin,retribution,30,14,16
Hefaista,ragnaros,1342,paladin,retribution,36,14,22
Bluerunebar,illidan,1340,paladin,retribution,24,14,10
Retsonictwo,tichondrius,1340,paladin,retribution,30,14,16
Samphlty,azralon,1340,paladin,retribution,30,14,16
Bubblestar,ragnaros,1340,paladin,retribution,56,23,33
Xandia,aegwynn,1340,paladin,retribution,42,14,28
Youguessedit,stormrage,1339,paladin,retribution,24,14,10
Stöneblood,moon-guard,1339,paladin,retribution,36,14,22
Bulioevn,emerald-dream,1338,paladin,retribution,39,18,21
Healsonyou,windrunner,1338,paladin,retribution,36,14,22
Amarnath,turalyon,1337,paladin,retribution,27,16,11
Palajeans,stormrage,1337,paladin,retribution,24,14,10
Erethonis,bladefist,1337,paladin,retribution,60,28,32
Neró,quelthalas,1337,paladin,retribution,55,25,30
Wlq,frostmourne,1336,paladin,retribution,71,29,42
Shecara,malygos,1335,paladin,retribution,72,40,32
Lyricism,tichondrius,1335,paladin,retribution,36,18,18
Avantasias,sargeras,1335,paladin,retribution,82,39,43
Waffletrain,tichondrius,1334,paladin,retribution,34,15,19
Jaikerino,emerald-dream,1334,paladin,retribution,36,14,22
Väkariän,quelthalas,1333,paladin,retribution,30,14,16
Gixpal,skullcrusher,1332,paladin,retribution,36,19,17
Malorian,azgalor,1332,paladin,retribution,48,21,27
Forged,steamwheedle-cartel,1332,paladin,retribution,108,47,61
Lüuz,area-52,1332,paladin,retribution,42,15,27
Heraolympian,black-dragonflight,1331,paladin,retribution,24,15,9
Trogdorpwn,bonechewer,1331,paladin,retribution,30,17,13
Mobitz,dalvengyr,1331,paladin,retribution,48,25,23
Allixis,wyrmrest-accord,1330,paladin,retribution,40,15,25
Däkh,sargeras,1329,paladin,retribution,24,14,10
Yree,ragnaros,1329,paladin,retribution,30,14,16
Brightsaber,tichondrius,1328,paladin,retribution,63,34,29
Adrockiller,quelthalas,1328,paladin,retribution,38,17,21
Øðyn,sargeras,1327,paladin,retribution,30,14,16
Snowcrow,tichondrius,1327,paladin,retribution,80,36,44
Melize,area-52,1325,paladin,retribution,118,57,61
Søøka,azralon,1325,paladin,retribution,48,16,32
Akabanee,ragnaros,1324,paladin,retribution,24,14,10
Athenariel,bleeding-hollow,1324,paladin,retribution,49,23,26
Christman,illidan,1323,paladin,retribution,78,33,45
Jizii,tichondrius,1322,paladin,retribution,24,14,10
Thankyouswen,tichondrius,1321,paladin,retribution,48,22,26
Rusinator,bonechewer,1320,paladin,retribution,24,14,10
Dralkou,kaelthas,1320,paladin,retribution,56,20,36
Sventyn,frostmourne,1320,paladin,retribution,41,14,27
Bennu,sargeras,1319,paladin,retribution,45,17,28
Lashlan,barthilas,1318,paladin,retribution,32,20,12
Taîno,thrall,1318,paladin,retribution,68,35,33
Arkanica,moon-guard,1318,paladin,retribution,41,16,25
Wésters,quelthalas,1317,paladin,retribution,103,44,59
Hwanko,tichondrius,1316,paladin,retribution,28,20,8
Morneau,malganis,1315,paladin,retribution,210,101,109
Critxx,tichondrius,1315,paladin,retribution,77,36,41
Hapii,tichondrius,1315,paladin,retribution,47,18,29
Bigpin,shattered-hand,1314,paladin,retribution,29,14,15
Siberios,stormrage,1313,paladin,retribution,30,14,16
Ludvigsen,hakkar,1313,paladin,retribution,36,14,22
Autoattacker,mannoroth,1312,paladin,retribution,24,14,10
Melloow,azralon,1311,paladin,retribution,91,43,48
Trg,azralon,1310,paladin,retribution,24,14,10
Shlaps,crushridge,1310,paladin,retribution,60,26,34
Sote,lightnings-blade,1309,paladin,retribution,27,15,12
Trainstorm,emerald-dream,1309,paladin,retribution,38,19,19
Snowcrest,cenarius,1309,paladin,retribution,48,22,26
Ajoladin,illidan,1308,paladin,retribution,51,22,29
Retrah,azralon,1306,paladin,retribution,24,14,10
Levarious,thunderlord,1305,paladin,retribution,78,36,42
Happywow,tichondrius,1302,paladin,retribution,59,30,29
Atrayeus,dawnbringer,1300,paladin,retribution,48,21,27
Saucepally,laughing-skull,1299,paladin,retribution,55,30,25
Oneminute,nerzhul,1299,paladin,retribution,42,21,21
Giulio,moon-guard,1298,paladin,retribution,59,30,29
Vtyr,nemesis,1297,paladin,retribution,51,23,28
Krinkin,illidan,1297,paladin,retribution,42,14,28
Verguetas,ragnaros,1296,paladin,retribution,40,17,23
Sunwrath,quelthalas,1296,paladin,retribution,72,29,43
Herrit,frostmourne,1295,paladin,retribution,120,65,55
Serran,durotan,1294,paladin,retribution,42,15,27
Jugheadqc,mugthol,1293,paladin,retribution,57,28,29
Paladingirl,darkspear,1292,paladin,retribution,92,50,42
Refulgent,moon-guard,1291,paladin,retribution,41,25,16
Walleis,moon-guard,1290,paladin,retribution,58,22,36
Vêndar,ragnaros,1289,paladin,retribution,78,33,45
Lawbandit,tichondrius,1287,paladin,retribution,28,16,12
Tutankhammer,stormrage,1286,paladin,retribution,58,28,30
Dedsxy,tichondrius,1286,paladin,retribution,30,14,16
Broxon,tichondrius,1285,paladin,retribution,58,30,28
Gainen,illidan,1285,paladin,retribution,47,24,23
Paliodin,dalaran,1284,paladin,retribution,36,15,21
Silvabac,illidan,1283,paladin,retribution,23,14,9
Ôdenswrath,stormscale,1283,paladin,retribution,92,44,48
Arnblass,magtheridon,1283,paladin,retribution,57,24,33
Nadrela,burning-blade,1281,paladin,retribution,42,25,17
Garcinddra,vashj,1281,paladin,retribution,28,15,13
Fossilz,sargeras,1279,paladin,retribution,29,14,15
Navicc,zuljin,1279,paladin,retribution,29,14,15
Kiergann,quelthalas,1277,paladin,retribution,54,23,31
Mikehawkhuge,area-52,1276,paladin,retribution,42,22,20
Yuccalicious,area-52,1275,paladin,retribution,53,23,30
Carolena,thaurissan,1274,paladin,retribution,74,31,43
Perfectgirl,maiev,1273,paladin,retribution,71,34,37
Throwable,illidan,1273,paladin,retribution,64,26,38
Webothhateme,tichondrius,1272,paladin,retribution,30,17,13
Khorgus,gundrak,1271,paladin,retribution,54,27,27
Såssy,moon-guard,1270,paladin,retribution,66,28,38
Synthetic,moon-guard,1268,paladin,retribution,78,40,38
Giltronix,thrall,1266,paladin,retribution,54,27,27
Imhardirl,area-52,1265,paladin,retribution,23,14,9
Formergf,crushridge,1265,paladin,retribution,60,29,31
Äeriah,fizzcrank,1265,paladin,retribution,36,16,20
Ðetroity,stormrage,1263,paladin,retribution,41,22,19
Tonnerre,silvermoon,1263,paladin,retribution,61,29,32
Gwendolyynn,moon-guard,1262,paladin,retribution,28,20,8
Bayaz,emerald-dream,1262,paladin,retribution,48,26,22
Galaxahan,bonechewer,1262,paladin,retribution,64,30,34
Punative,darkspear,1262,paladin,retribution,48,16,32
Garruckadin,dalaran,1261,paladin,retribution,25,14,11
Sïrenek,tichondrius,1260,paladin,retribution,55,27,28
Canadianeh,malganis,1260,paladin,retribution,66,28,38
Faaqmee,gorefiend,1259,paladin,retribution,24,15,9
Todesgott,tichondrius,1259,paladin,retribution,30,15,15
Fogonaventa,nemesis,1259,paladin,retribution,48,16,32
Toyotasupra,azgalor,1258,paladin,retribution,42,24,18
Dárí,stormrage,1258,paladin,retribution,108,51,57
Holyshôckz,stormrage,1258,paladin,retribution,35,16,19
Belena,jaedenar,1258,paladin,retribution,36,16,20
Quickthing,dalaran,1257,paladin,retribution,59,34,25
Minlarkwa,frostmourne,1257,paladin,retribution,30,16,14
Ozirus,frostmourne,1256,paladin,retribution,32,14,18
Soana,alexstrasza,1255,paladin,retribution,78,48,30
Aretwin,dalaran,1255,paladin,retribution,30,14,16
Balster,moon-guard,1254,paladin,retribution,43,18,25
Palacamâ,quelthalas,1252,paladin,retribution,32,14,18
Zanthus,shadow-council,1248,paladin,retribution,24,13,11
Venturep,azralon,1247,paladin,retribution,24,13,11
Hojdin,tichondrius,1247,paladin,retribution,30,13,17
Dubliner,garona,1247,paladin,retribution,30,13,17
Davinchi,laughing-skull,1246,paladin,retribution,41,24,17
Lainn,zuljin,1246,paladin,retribution,30,17,13
Steelbreaker,deathwing,1246,paladin,retribution,47,21,26
Beyönd,quelthalas,1246,paladin,retribution,30,13,17
Zephyrvalor,sargeras,1245,paladin,retribution,54,32,22
Paladinaa,lothar,1245,paladin,retribution,30,13,17
Pérona,tichondrius,1245,paladin,retribution,30,13,17
Onemassacre,spirestone,1245,paladin,retribution,36,13,23
Lvlone,sargeras,1244,paladin,retribution,24,15,9
Hammerina,antonidas,1244,paladin,retribution,35,16,19
Aduhrawl,moon-guard,1244,paladin,retribution,38,14,24
Goons,frostmourne,1244,paladin,retribution,36,13,23
Yugee,doomhammer,1243,paladin,retribution,24,13,11
Doktavius,lightbringer,1243,paladin,retribution,24,13,11
Gànnicus,korgath,1243,paladin,retribution,30,13,17
Cuteluna,tichondrius,1243,paladin,retribution,30,13,17
Deployed,kaelthas,1243,paladin,retribution,36,13,23
Tedward,emerald-dream,1242,paladin,retribution,24,13,11
Rockbell,kiljaeden,1242,paladin,retribution,24,13,11
Gareesa,wyrmrest-accord,1242,paladin,retribution,24,13,11
Bebitufiufiu,illidan,1242,paladin,retribution,24,13,11
Anastos,anvilmar,1241,paladin,retribution,24,13,11
Aurken,ragnaros,1241,paladin,retribution,30,13,17
Holychow,tichondrius,1240,paladin,retribution,24,13,11
Saintpower,stormscale,1239,paladin,retribution,24,13,11
Saphiraz,wildhammer,1239,paladin,retribution,30,13,17
Bawek,azralon,1239,paladin,retribution,36,13,23
Ziberax,chogall,1238,paladin,retribution,22,13,9
Sacredstella,illidan,1238,paladin,retribution,24,13,11
Deftonia,stormrage,1238,paladin,retribution,65,31,34
Rigotakp,illidan,1237,paladin,retribution,30,13,17
Siaaryn,darkspear,1237,paladin,retribution,30,13,17
Pristinne,darkspear,1237,paladin,retribution,82,34,48
Sconey,andorhal,1237,paladin,retribution,34,14,20
Ablunedion,illidan,1237,paladin,retribution,41,14,27
Carenye,thunderhorn,1235,paladin,retribution,37,16,21
Hammerzite,whisperwind,1234,paladin,retribution,24,13,11
Noblelight,saurfang,1233,paladin,retribution,29,17,12
Huitz,drakkari,1231,paladin,retribution,48,23,25
Krawmwell,lothar,1230,paladin,retribution,78,43,35
Uunjaaku,kiljaeden,1230,paladin,retribution,45,22,23
Luke,frostwolf,1230,paladin,retribution,29,13,16
Legible,tichondrius,1228,paladin,retribution,28,15,13
Narsys,tichondrius,1228,paladin,retribution,36,13,23
Heindallr,nemesis,1227,paladin,retribution,42,19,23
Thorsenâ,sargeras,1226,paladin,retribution,27,17,10
Thadose,bonechewer,1226,paladin,retribution,52,31,21
Hiikari,silver-hand,1225,paladin,retribution,30,14,16
Dankpaladin,frostwolf,1224,paladin,retribution,30,13,17
Amarith,queldorei,1224,paladin,retribution,76,31,45
Vanthor,emerald-dream,1223,paladin,retribution,24,13,11
Ulessys,bleeding-hollow,1223,paladin,retribution,54,27,27
Ekyu,sargeras,1222,paladin,retribution,25,15,10
Albion,sargeras,1222,paladin,retribution,36,13,23
Füriøsa,quelthalas,1221,paladin,retribution,59,29,30
Areaky,khazgoroth,1220,paladin,retribution,38,22,16
Gorriuke,wyrmrest-accord,1220,paladin,retribution,24,13,11
Demihoj,illidan,1220,paladin,retribution,36,13,23
Theuss,nerzhul,1219,paladin,retribution,47,17,30
Naghret,area-52,1218,paladin,retribution,24,13,11
Beastyone,tichondrius,1218,paladin,retribution,110,58,52
Uglymugz,area-52,1218,paladin,retribution,37,16,21
Gramaton,malfurion,1217,paladin,retribution,36,15,21
Redeviliu,tichondrius,1217,paladin,retribution,41,15,26
Brucedwal,moon-guard,1216,paladin,retribution,45,22,23
Aellâ,bloodscalp,1214,paladin,retribution,134,70,64
Mïkhael,nemesis,1214,paladin,retribution,74,26,48
Brsjak,frostmourne,1212,paladin,retribution,41,18,23
Pallynation,korgath,1211,paladin,retribution,30,13,17
Armstrongz,bleeding-hollow,1210,paladin,retribution,36,13,23
Hodne,blackhand,1208,paladin,retribution,24,13,11
Barbaluzz,quelthalas,1207,paladin,retribution,31,16,15
Xenagos,akama,1207,paladin,retribution,30,13,17
Longinus,eredar,1206,paladin,retribution,24,13,11
Amgirlinv,malganis,1206,paladin,retribution,26,14,12
Lostkanvas,azralon,1205,paladin,retribution,24,14,10
Rediems,drakkari,1203,paladin,retribution,42,21,21
Hellhawk,hellscream,1202,paladin,retribution,24,13,11
Mechelle,thrall,1202,paladin,retribution,74,37,37
Hibrael,azralon,1201,paladin,retribution,56,32,24
Stõnêdpimp,agamaggan,1201,paladin,retribution,29,13,16
Dewlight,zuljin,1200,paladin,retribution,36,22,14
Sturka,illidan,1199,paladin,retribution,60,29,31
Cexus,tichondrius,1198,paladin,retribution,23,13,10
Oathden,area-52,1198,paladin,retribution,34,18,16
Finishearlyx,kelthuzad,1198,paladin,retribution,35,13,22
Lucigiorna,stormrage,1197,paladin,retribution,50,22,28
Haiyaa,frostwolf,1197,paladin,retribution,48,18,30
Botïs,sargeras,1195,paladin,retribution,33,20,13
Canadapants,kelthuzad,1194,paladin,retribution,24,14,10
Irantir,drakkari,1194,paladin,retribution,47,18,29
Kittylickers,tichondrius,1193,paladin,retribution,96,54,42
Eetswaz,frostmourne,1193,paladin,retribution,36,20,16
Shusekki,drakkari,1192,paladin,retribution,96,46,50
Albagail,draka,1192,paladin,retribution,28,13,15
Spartus,area-52,1191,paladin,retribution,26,15,11
Avelane,caelestrasz,1191,paladin,retribution,52,24,28
Dynamais,barthilas,1190,paladin,retribution,42,15,27
Xalixxa,wyrmrest-accord,1189,paladin,retribution,36,14,22
Popwingzz,sargeras,1188,paladin,retribution,42,14,28
Pìerre,ragnaros,1186,paladin,retribution,116,59,57
Reptaur,bleeding-hollow,1185,paladin,retribution,64,31,33
Excalibur,amanthul,1185,paladin,retribution,31,14,17
Holycower,tichondrius,1182,paladin,retribution,24,15,9
Sweatylight,bleeding-hollow,1181,paladin,retribution,56,25,31
Páláx,stormrage,1181,paladin,retribution,51,22,29
Paim,tol-barad,1179,paladin,retribution,32,13,19
Noskill,moonrunner,1176,paladin,retribution,48,29,19
Mareaaturbo,azralon,1174,paladin,retribution,23,13,10
Bubbleöseven,agamaggan,1173,paladin,retribution,39,18,21
Greasy,quelthalas,1173,paladin,retribution,32,13,19
Schnabdain,exodar,1171,paladin,retribution,66,36,30
Crosshammer,quelthalas,1170,paladin,retribution,42,20,22
Linias,quelthalas,1169,paladin,retribution,21,14,7
Souljahgirl,demon-soul,1168,paladin,retribution,42,18,24
Suncrashkid,nerzhul,1166,paladin,retribution,127,70,57
Soopadupa,trollbane,1164,paladin,retribution,68,36,32
Skylexx,ragnaros,1164,paladin,retribution,30,13,17
Solomonss,frostmourne,1163,paladin,retribution,58,21,37
Ktwocrank,dalaran,1162,paladin,retribution,31,13,18
Thaly,shadowmoon,1161,paladin,retribution,49,20,29
Draerys,drakkari,1159,paladin,retribution,36,26,10
Procs,hyjal,1157,paladin,retribution,20,15,5
Meanlight,zuljin,1156,paladin,retribution,60,30,30
Statícx,ragnaros,1156,paladin,retribution,85,35,50
Kaysonso,thunderlord,1153,paladin,retribution,43,15,28
Hammrekt,dalaran,1152,paladin,retribution,18,12,6
Huavi,tichondrius,1152,paladin,retribution,18,12,6
Ghøjan,malganis,1152,paladin,retribution,23,15,8
Scathol,tichondrius,1152,paladin,retribution,24,12,12
Vânguârds,tichondrius,1152,paladin,retribution,24,12,12
Cöjax,dalaran,1151,paladin,retribution,18,12,6
Zhaslk,ragnaros,1151,paladin,retribution,24,12,12
ßrittany,gnomeregan,1151,paladin,retribution,24,12,12
Iloveqiqi,sargeras,1151,paladin,retribution,24,12,12
Sacredknight,kelthuzad,1151,paladin,retribution,24,12,12
Lhacius,drakkari,1151,paladin,retribution,28,13,15
Sukmyret,sargeras,1151,paladin,retribution,30,12,18
Geospawn,tichondrius,1151,paladin,retribution,30,12,18
Dragynfist,malganis,1151,paladin,retribution,30,12,18
Britanybich,area-52,1150,paladin,retribution,24,12,12
Nattandin,ragnaros,1150,paladin,retribution,24,12,12
Hurrîcane,illidan,1150,paladin,retribution,30,12,18
Thazadin,barthilas,1149,paladin,retribution,22,13,9
Blackpie,bleeding-hollow,1149,paladin,retribution,24,12,12
Yeeter,thrall,1149,paladin,retribution,24,12,12
Vaaga,quelthalas,1149,paladin,retribution,24,12,12
Tanishalfelf,stormrage,1149,paladin,retribution,24,12,12
Zcho,proudmoore,1149,paladin,retribution,24,12,12
Retosterone,stormrage,1149,paladin,retribution,30,12,18
Kadryck,drakkari,1148,paladin,retribution,18,12,6
Leennoox,quelthalas,1148,paladin,retribution,31,17,14
Cuchuflaiz,drakkari,1148,paladin,retribution,24,12,12
Sigmond,azralon,1148,paladin,retribution,27,13,14
Dontaylor,tichondrius,1148,paladin,retribution,30,12,18
Bigdpally,frostmourne,1148,paladin,retribution,36,12,24
Eskannór,quelthalas,1147,paladin,retribution,24,12,12
Arkoth,kelthuzad,1147,paladin,retribution,24,12,12
Blasstar,quelthalas,1147,paladin,retribution,24,12,12
Phanna,the-forgotten-coast,1147,paladin,retribution,24,12,12
Snoogans,korgath,1147,paladin,retribution,30,12,18
Dachenkov,tichondrius,1146,paladin,retribution,18,12,6
Barcar,area-52,1146,paladin,retribution,24,12,12
Røshea,hydraxis,1146,paladin,retribution,24,12,12
Véxv,emerald-dream,1146,paladin,retribution,36,12,24
Luminainre,zuljin,1145,paladin,retribution,24,12,12
Deosfires,ragnaros,1145,paladin,retribution,28,13,15
Xdiegox,stormrage,1145,paladin,retribution,30,12,18
Rafaela,alterac-mountains,1144,paladin,retribution,18,12,6
Lightshope,coilfang,1143,paladin,retribution,18,12,6
Thoti,tichondrius,1143,paladin,retribution,25,12,13
Scudstock,tichondrius,1143,paladin,retribution,71,34,37
Polypal,zuljin,1143,paladin,retribution,30,12,18
Seongje,tichondrius,1143,paladin,retribution,39,13,26
Stormwinter,azralon,1143,paladin,retribution,36,12,24
Ginbirdup,kelthuzad,1141,paladin,retribution,18,12,6
Dwk,thrall,1141,paladin,retribution,30,12,18
Holyskeeter,thunderhorn,1141,paladin,retribution,31,12,19
Beachyo,tichondrius,1140,paladin,retribution,18,12,6
Elbigboy,tichondrius,1140,paladin,retribution,83,42,41
Victidin,quelthalas,1138,paladin,retribution,24,12,12
Oopalaoo,azralon,1137,paladin,retribution,24,12,12
Areura,hellscream,1134,paladin,retribution,21,13,8
Pallyhealed,tichondrius,1134,paladin,retribution,27,12,15
Huuzhaa,tichondrius,1134,paladin,retribution,29,12,17
Dresdén,skullcrusher,1133,paladin,retribution,18,12,6
Meltedcheese,destromath,1132,paladin,retribution,30,15,15
Miitt,blackrock,1132,paladin,retribution,24,12,12
Ðß,arthas,1132,paladin,retribution,30,13,17
Tatánka,ragnaros,1130,paladin,retribution,24,12,12
Jdn,ysera,1130,paladin,retribution,60,29,31
Iceburg,shadowmoon,1128,paladin,retribution,24,12,12
Arun,arthas,1128,paladin,retribution,33,15,18
Pallypapa,galakrond,1127,paladin,retribution,18,12,6
Chbestafera,nemesis,1127,paladin,retribution,18,12,6
Ducii,stormrage,1126,paladin,retribution,46,22,24
Damorte,ragnaros,1125,paladin,retribution,30,15,15
Dirkadirkka,stormrage,1125,paladin,retribution,24,12,12
Sparkchaser,proudmoore,1125,paladin,retribution,24,12,12
Newerlight,tichondrius,1124,paladin,retribution,25,13,12
Grimhammer,the-scryers,1123,paladin,retribution,50,27,23
Dannoruk,ragnaros,1121,paladin,retribution,30,12,18
Aowynd,tichondrius,1118,paladin,retribution,73,37,36
Zaklehblue,daggerspine,1118,paladin,retribution,60,24,36
Shadowarius,aerie-peak,1117,paladin,retribution,54,24,30
Deathwyz,thunderlord,1116,paladin,retribution,36,14,22
Streetsaint,frostmourne,1114,paladin,retribution,66,32,34
Thal,silvermoon,1113,paladin,retribution,24,13,11
Vanillur,tichondrius,1113,paladin,retribution,49,22,27
Sandicang,azuremyst,1112,paladin,retribution,54,27,27
Eddardstark,agamaggan,1111,paladin,retribution,34,15,19
Drágons,stormrage,1109,paladin,retribution,72,30,42
Holyshoc,kiljaeden,1109,paladin,retribution,38,15,23
Drekgor,drakkari,1108,paladin,retribution,30,14,16
Greatgirthy,hyjal,1106,paladin,retribution,30,13,17
Thanatiel,area-52,1104,paladin,retribution,66,37,29
Savagefck,sargeras,1103,paladin,retribution,24,15,9
Fortueni,illidan,1103,paladin,retribution,88,51,37
Oraborra,area-52,1103,paladin,retribution,30,12,18
Gtate,azjolnerub,1102,paladin,retribution,23,12,11
Decareos,tichondrius,1102,paladin,retribution,29,12,17
Virrata,tichondrius,1098,paladin,retribution,20,13,7
Trappadin,sargeras,1098,paladin,retribution,30,14,16
Riggar,uther,1098,paladin,retribution,42,18,24
Velyssatha,moon-guard,1094,paladin,retribution,23,12,11
Joelanson,blood-furnace,1092,paladin,retribution,30,16,14
Traditionalp,area-52,1092,paladin,retribution,25,13,12
Omenix,laughing-skull,1091,paladin,retribution,29,12,17
Durothar,dalaran,1090,paladin,retribution,30,16,14
Cheesetitan,tichondrius,1090,paladin,retribution,52,22,30
Mcbraín,quelthalas,1089,paladin,retribution,30,12,18
Alairius,tichondrius,1087,paladin,retribution,23,15,8
Killumminati,tichondrius,1087,paladin,retribution,21,13,8
Soyafed,mugthol,1086,paladin,retribution,24,13,11
Mybadfoo,lethon,1085,paladin,retribution,18,13,5
Jinfandi,gurubashi,1079,paladin,retribution,30,12,18
Bubblegums,nagrand,1078,paladin,retribution,63,36,27
Uhklathel,quelthalas,1078,paladin,retribution,39,15,24
Eliasor,illidan,1077,paladin,retribution,18,13,5
Lízandor,ragnaros,1077,paladin,retribution,17,12,5
Zir,frostmourne,1077,paladin,retribution,47,24,23
Warswordz,stormrage,1077,paladin,retribution,40,16,24
Clefairy,arathor,1076,paladin,retribution,39,23,16
Zorkus,turalyon,1073,paladin,retribution,42,22,20
Vlandor,area-52,1067,paladin,retribution,23,12,11
Adelsman,quelthalas,1065,paladin,retribution,24,12,12
Diablosgrim,stormrage,1061,paladin,retribution,18,14,4
Billnighy,alleria,1061,paladin,retribution,42,18,24
Holygerp,darrowmere,1060,paladin,retribution,18,12,6
Andras,emerald-dream,1059,paladin,retribution,22,12,10
Chilenoman,ragnaros,1057,paladin,retribution,30,14,16
Rikkupìgu,sargeras,1056,paladin,retribution,18,11,7
Ashenhallow,alexstrasza,1056,paladin,retribution,18,11,7
Hardnow,emerald-dream,1056,paladin,retribution,24,11,13
Makayla,kiljaeden,1056,paladin,retribution,24,11,13
Thørîm,nazjatar,1056,paladin,retribution,30,12,18
Siq,arthas,1056,paladin,retribution,30,11,19
Bakednub,malganis,1056,paladin,retribution,35,11,24
Redarted,thrall,1055,paladin,retribution,18,11,7
Volcathos,moon-guard,1055,paladin,retribution,18,11,7
Reptila,bonechewer,1055,paladin,retribution,18,11,7
Subtilizer,tichondrius,1055,paladin,retribution,18,11,7
Pathalerix,eonar,1055,paladin,retribution,18,11,7
Ricocheto,ragnaros,1055,paladin,retribution,18,11,7
Pallysmack,stormrage,1055,paladin,retribution,24,11,13
Wde,zuljin,1055,paladin,retribution,31,12,19
Redspine,azralon,1055,paladin,retribution,30,11,19
Nightz,eonar,1055,paladin,retribution,30,11,19
Gannecus,bleeding-hollow,1054,paladin,retribution,18,11,7
Rexx,frostmourne,1054,paladin,retribution,18,11,7
Hrota,laughing-skull,1054,paladin,retribution,18,11,7
Keenos,frostmourne,1054,paladin,retribution,19,11,8
Pallyzo,zuljin,1054,paladin,retribution,24,11,13
Telvannî,sargeras,1054,paladin,retribution,24,11,13
Mattilla,tichondrius,1054,paladin,retribution,24,11,13
Zazaron,kiljaeden,1054,paladin,retribution,30,11,19
Varaben,sargeras,1054,paladin,retribution,36,11,25
Nest,stormrage,1053,paladin,retribution,18,11,7
Ðreschí,ragnaros,1053,paladin,retribution,22,11,11
Sancthia,area-52,1053,paladin,retribution,24,11,13
Mundomaloo,quelthalas,1053,paladin,retribution,24,11,13
Divineknight,moonrunner,1053,paladin,retribution,24,11,13
Dividin,stormrage,1053,paladin,retribution,24,11,13
Mixnut,tichondrius,1053,paladin,retribution,30,11,19
Cripplemakër,stormrage,1052,paladin,retribution,18,11,7
Vynesonia,emerald-dream,1052,paladin,retribution,21,12,9
Brolando,hyjal,1052,paladin,retribution,24,11,13
Xinqingle,tichondrius,1052,paladin,retribution,30,11,19
Iesous,kiljaeden,1051,paladin,retribution,18,11,7
Ragnore,shadow-council,1051,paladin,retribution,21,12,9
Exulta,illidan,1051,paladin,retribution,60,32,28
Libertylol,tichondrius,1051,paladin,retribution,28,12,16
Caonizumu,area-52,1051,paladin,retribution,30,11,19
Ranthoril,hydraxis,1050,paladin,retribution,12,11,1
Kaélthas,eonar,1050,paladin,retribution,24,11,13
Cowhair,tichondrius,1050,paladin,retribution,24,11,13
Ødin,turalyon,1049,paladin,retribution,18,11,7
Reaslovak,jubeithos,1049,paladin,retribution,18,11,7
Wickedpälly,kelthuzad,1049,paladin,retribution,18,11,7
Wasimodo,emerald-dream,1049,paladin,retribution,60,29,31
Mangguo,tichondrius,1049,paladin,retribution,24,11,13
Lïgma,dalaran,1048,paladin,retribution,18,11,7
Unknownplay,tichondrius,1048,paladin,retribution,18,11,7
Schalpy,illidan,1048,paladin,retribution,24,11,13
Jagehbombs,tichondrius,1047,paladin,retribution,24,11,13
Stonekey,warsong,1046,paladin,retribution,18,11,7
Kiboko,tichondrius,1046,paladin,retribution,19,11,8
Theldart,ragnaros,1046,paladin,retribution,24,11,13
Souiler,thunderlord,1045,paladin,retribution,22,12,10
Denhoward,proudmoore,1045,paladin,retribution,24,11,13
Guji,jubeithos,1045,paladin,retribution,24,11,13
Strobeyjr,tichondrius,1044,paladin,retribution,24,11,13
Rensvall,frostmourne,1043,paladin,retribution,24,13,11
Pldd,tichondrius,1043,paladin,retribution,25,12,13
Hyperforce,area-52,1043,paladin,retribution,24,11,13
Missoutale,aerie-peak,1043,paladin,retribution,76,31,45
Dorzwaz,draka,1042,paladin,retribution,18,11,7
Berthalas,stormrage,1042,paladin,retribution,18,11,7
Cuthroat,area-52,1042,paladin,retribution,204,104,100
Menaus,duskwood,1040,paladin,retribution,18,11,7
Neutroo,stormrage,1039,paladin,retribution,24,11,13
Mikezheng,tichondrius,1039,paladin,retribution,30,11,19
Willhookah,azralon,1034,paladin,retribution,54,25,29
Bainn,nerzhul,1033,paladin,retribution,49,28,21
Mortika,frostmourne,1033,paladin,retribution,30,14,16
Atreuss,moon-guard,1029,paladin,retribution,42,21,21
Asunima,wyrmrest-accord,1029,paladin,retribution,24,11,13
Bradoxx,thorium-brotherhood,1026,paladin,retribution,42,21,21
Soledad,tichondrius,1024,paladin,retribution,24,11,13
Theseuus,stormrage,1020,paladin,retribution,54,24,30
Furnost,drenden,1019,paladin,retribution,23,11,12
Stepurgameup,ghostlands,1018,paladin,retribution,18,11,7
Thorviim,azralon,1016,paladin,retribution,32,14,18
Volorick,dalaran,1016,paladin,retribution,38,13,25
Bigjwpb,illidan,1014,paladin,retribution,190,93,97
Jeinova,barthilas,1013,paladin,retribution,48,29,19
Thirtyfivemm,area-52,1013,paladin,retribution,52,27,25
Sisterbubble,dathremar,1013,paladin,retribution,29,11,18
Avlystein,wyrmrest-accord,1013,paladin,retribution,71,24,47
Alpine,nordrassil,1009,paladin,retribution,85,44,41
Nejie,nazjatar,1009,paladin,retribution,42,21,21
Kènjii,sargeras,1009,paladin,retribution,34,16,18
Tuff,ysera,1008,paladin,retribution,36,21,15
Sanctum,barthilas,1008,paladin,retribution,135,65,70
Keu,emerald-dream,1008,paladin,retribution,63,26,37
Salvations,queldorei,1001,paladin,retribution,48,21,27
Smithulu,kelthuzad,997,paladin,retribution,45,24,21
Tyrswrath,sargeras,992,paladin,retribution,36,19,17
Iammj,skywall,990,paladin,retribution,17,11,6
Shishoknight,quelthalas,989,paladin,retribution,26,11,15
Guanglong,malganis,989,paladin,retribution,26,11,15
Veroth,caelestrasz,988,paladin,retribution,26,11,15
Lêe,dalaran,987,paladin,retribution,15,12,3
Tharkeves,cenarius,987,paladin,retribution,22,11,11
Playandrunn,illidan,984,paladin,retribution,22,11,11
Layoya,aerie-peak,984,paladin,retribution,22,11,11
Vinjonc,drenden,977,paladin,retribution,54,27,27
Johnyfresh,jubeithos,977,paladin,retribution,33,12,21
Mikkylol,tichondrius,974,paladin,retribution,22,11,11
Loween,thunderlord,973,paladin,retribution,42,15,27
Hammerhitter,lightbringer,972,paladin,retribution,36,14,22
Anyatay,ragnaros,971,paladin,retribution,59,16,43
Reti,ursin,967,paladin,retribution,155,80,75
Follower,sargeras,967,paladin,retribution,71,31,40
Kmackk,tichondrius,960,paladin,retribution,18,10,8
Dreneisha,malganis,960,paladin,retribution,18,10,8
Holyshockss,stormrage,960,paladin,retribution,18,10,8
Meleegodx,darkspear,960,paladin,retribution,18,10,8
Eloinflated,malganis,960,paladin,retribution,18,10,8
Hasmere,tichondrius,960,paladin,retribution,18,10,8
Ienhova,area-52,960,paladin,retribution,18,10,8
Fumaçaa,nemesis,960,paladin,retribution,27,13,14
Friendfriend,proudmoore,960,paladin,retribution,24,10,14
Miketavius,moon-guard,960,paladin,retribution,24,10,14
Komonai,illidan,960,paladin,retribution,24,10,14
Talionz,illidan,960,paladin,retribution,24,10,14
Kikazaru,moon-guard,960,paladin,retribution,30,10,20
Demonissh,area-52,960,paladin,retribution,30,10,20
Bizaro,malganis,960,paladin,retribution,30,10,20
Dogf,tichondrius,960,paladin,retribution,35,10,25
Cryof,illidan,960,paladin,retribution,36,10,26
Kasoon,illidan,959,paladin,retribution,12,10,2
Jaimi,stormreaver,959,paladin,retribution,12,10,2
Atair,antonidas,959,paladin,retribution,12,10,2
Darguen,ragnaros,959,paladin,retribution,16,11,5
Daeyang,tichondrius,959,paladin,retribution,18,10,8
Shawra,moon-guard,959,paladin,retribution,18,10,8
Mesaa,illidan,959,paladin,retribution,18,10,8
ßöbby,sargeras,959,paladin,retribution,18,10,8
Kayaman,tichondrius,959,paladin,retribution,18,10,8
Déathkiing,area-52,959,paladin,retribution,24,10,14
Ponytail,dark-iron,959,paladin,retribution,24,10,14
Hôtt,kul-tiras,959,paladin,retribution,24,10,14
Roddaric,nerzhul,959,paladin,retribution,24,10,14
Lestaroth,goldrinn,959,paladin,retribution,30,10,20
Zensargge,tichondrius,959,paladin,retribution,36,10,26
Runö,frostmourne,959,paladin,retribution,37,10,27
Littlebadbad,tichondrius,958,paladin,retribution,12,10,2
Sathras,madoran,958,paladin,retribution,18,10,8
Lichkingdenn,stormrage,958,paladin,retribution,18,10,8
Ssparkk,stormrage,958,paladin,retribution,24,10,14
Umbrasanctus,daggerspine,958,paladin,retribution,24,10,14
Verdicts,moon-guard,958,paladin,retribution,30,10,20
Zoliz,tichondrius,958,paladin,retribution,30,10,20
Balango,azralon,957,paladin,retribution,18,10,8
Olsen,stormrage,957,paladin,retribution,18,10,8
Hurtmypp,stormrage,957,paladin,retribution,18,10,8
Grünt,ragnaros,957,paladin,retribution,18,10,8
Vallahad,emerald-dream,957,paladin,retribution,18,10,8
Luxord,ysera,957,paladin,retribution,22,11,11
Angriel,azralon,957,paladin,retribution,24,10,14
Dyskrazia,thrall,957,paladin,retribution,24,10,14
Vulkaros,azralon,956,paladin,retribution,12,10,2
Caylorn,illidan,956,paladin,retribution,18,10,8
Vejita,frostmourne,955,paladin,retribution,18,10,8
Heälmeñow,tichondrius,955,paladin,retribution,24,10,14
Winbott,sargeras,955,paladin,retribution,30,10,20
Lunchboxpaly,stormrage,954,paladin,retribution,18,10,8
Puresight,kelthuzad,954,paladin,retribution,18,10,8
Cacaine,goldrinn,954,paladin,retribution,21,11,10
Sòl,stormrage,954,paladin,retribution,24,10,14
Didymus,boulderfist,954,paladin,retribution,41,17,24
Justsmiteit,dalaran,953,paladin,retribution,18,10,8
Aura,stormreaver,952,paladin,retribution,18,10,8
Azëitona,azralon,952,paladin,retribution,18,10,8
Exeneyder,elune,952,paladin,retribution,25,10,15
Vassen,echo-isles,950,paladin,retribution,24,10,14
ßlððdyßðnez,malganis,949,paladin,retribution,18,10,8
Talvyr,icecrown,948,paladin,retribution,24,10,14
Xhotbutters,korgath,945,paladin,retribution,31,13,18
Gamber,frostmourne,944,paladin,retribution,24,10,14
Redyomi,drakkari,943,paladin,retribution,30,10,20
Pathed,aerie-peak,941,paladin,retribution,23,10,13
Deltajk,drakkari,932,paladin,retribution,36,18,18
Leona,stormrage,927,paladin,retribution,16,11,5
Nerfret,zuljin,926,paladin,retribution,14,11,3
Tonimâster,misha,926,paladin,retribution,23,10,13
Mehchelol,azgalor,923,paladin,retribution,24,14,10
Quotation,silvermoon,923,paladin,retribution,20,11,9
Diësëlsmoke,bronzebeard,917,paladin,retribution,18,10,8
Toepuller,doomhammer,917,paladin,retribution,42,21,21
Goldranger,hakkar,916,paladin,retribution,42,22,20
Kokuryuha,quelthalas,916,paladin,retribution,46,21,25
Rönän,sargeras,911,paladin,retribution,17,10,7
Stinaz,quelthalas,911,paladin,retribution,23,10,13
Rebukezz,dalaran,911,paladin,retribution,23,10,13
Stealhearsp,tichondrius,905,paladin,retribution,29,10,19
Zentrick,whisperwind,902,paladin,retribution,42,16,26
Lilsquirt,proudmoore,901,paladin,retribution,23,14,9
Kilidin,illidan,899,paladin,retribution,21,10,11
Elgigante,azshara,897,paladin,retribution,18,10,8
Kaharule,akama,896,paladin,retribution,22,10,12
Gorostas,kelthuzad,896,paladin,retribution,22,10,12
Denthor,lightbringer,894,paladin,retribution,20,10,10
Kaladini,jubeithos,893,paladin,retribution,16,10,6
Àmárìs,tichondrius,882,paladin,retribution,22,10,12
Allandaa,frostmourne,878,paladin,retribution,25,10,15
Noholy,nemesis,872,paladin,retribution,37,11,26
Arimae,turalyon,864,paladin,retribution,12,9,3
Kaetix,frostmourne,864,paladin,retribution,12,9,3
Arukan,ragnaros,864,paladin,retribution,12,9,3
Slivkoff,wyrmrest-accord,864,paladin,retribution,12,9,3
Chrigpal,tichondrius,864,paladin,retribution,12,9,3
Warstompgg,ragnaros,864,paladin,retribution,12,9,3
Swegswog,frostmourne,864,paladin,retribution,12,9,3
Raggnarokk,kelthuzad,864,paladin,retribution,12,9,3
Naughtygames,area-52,864,paladin,retribution,12,9,3
Mardùk,stormrage,864,paladin,retribution,12,9,3
Dublek,tichondrius,864,paladin,retribution,12,9,3
Pallyseeker,thrall,864,paladin,retribution,12,9,3
Wölfheärt,tichondrius,864,paladin,retribution,12,9,3
Emiaru,illidan,864,paladin,retribution,16,10,6
Moocowd,senjin,864,paladin,retribution,18,9,9
Marvinceo,stormreaver,864,paladin,retribution,18,9,9
Brohtato,area-52,864,paladin,retribution,18,9,9
Zzerox,ragnaros,864,paladin,retribution,18,9,9
Jelial,chogall,864,paladin,retribution,18,9,9
Bigdixss,tichondrius,864,paladin,retribution,18,9,9
Axeliee,kiljaeden,864,paladin,retribution,18,9,9
Héber,nemesis,864,paladin,retribution,18,9,9
Beefdaddyx,tichondrius,864,paladin,retribution,18,9,9
Enjoy,frostmourne,864,paladin,retribution,18,9,9
Talions,illidan,864,paladin,retribution,18,9,9
Attkdamdam,illidan,864,paladin,retribution,18,9,9
Rockdeath,sargeras,864,paladin,retribution,18,9,9
Wogyu,area-52,864,paladin,retribution,18,9,9
Miniell,tichondrius,864,paladin,retribution,18,9,9
Kishou,stormrage,864,paladin,retribution,21,10,11
Diebygcd,tichondrius,864,paladin,retribution,19,9,10
Yáhtzee,tichondrius,864,paladin,retribution,22,10,12
Justeight,stormrage,864,paladin,retribution,21,9,12
Stoof,arygos,864,paladin,retribution,24,9,15
Traevel,moon-guard,864,paladin,retribution,24,9,15
Pistis,kelthuzad,864,paladin,retribution,24,9,15
Fatkidslag,sargeras,864,paladin,retribution,24,9,15
Saintgeórge,frostmourne,864,paladin,retribution,25,9,16
Inquisídor,nemesis,863,paladin,retribution,12,9,3
Heathen,spirestone,863,paladin,retribution,12,9,3
Ultralord,dragonmaw,863,paladin,retribution,12,9,3
Glorious,drakkari,863,paladin,retribution,12,9,3
Pallyofhell,area-52,863,paladin,retribution,12,9,3
Mightythorxx,tichondrius,863,paladin,retribution,12,9,3
Utherparty,frostmourne,863,paladin,retribution,16,10,6
Sleekz,moon-guard,863,paladin,retribution,18,9,9
Enril,azgalor,863,paladin,retribution,18,9,9
Heizero,area-52,863,paladin,retribution,18,9,9
Ironprice,tichondrius,863,paladin,retribution,18,9,9
Loraven,wyrmrest-accord,863,paladin,retribution,18,9,9
Jhaann,tichondrius,863,paladin,retribution,18,9,9
Whackadin,illidan,863,paladin,retribution,18,9,9
Teewrecks,frostmourne,863,paladin,retribution,18,9,9
Sephiroth,hyjal,863,paladin,retribution,18,9,9
Lightballz,vashj,863,paladin,retribution,18,9,9
Avacii,illidan,863,paladin,retribution,18,9,9
Paliwarrior,illidan,863,paladin,retribution,18,9,9
Liquidkoala,lightbringer,863,paladin,retribution,18,9,9
Articilia,ragnaros,863,paladin,retribution,18,9,9
Amntir,sargeras,863,paladin,retribution,24,9,15
Thickdam,korgath,863,paladin,retribution,24,9,15
Nuuska,dalaran,863,paladin,retribution,24,9,15
Rivzx,tichondrius,863,paladin,retribution,24,9,15
Detrimentãl,nagrand,863,paladin,retribution,24,9,15
Galadriele,zuljin,863,paladin,retribution,24,9,15
Fokatayew,korialstrasz,863,paladin,retribution,24,9,15
Zerohöur,emerald-dream,863,paladin,retribution,30,9,21
Zrkoria,ragnaros,863,paladin,retribution,36,9,27
Ástedór,ragnaros,862,paladin,retribution,12,9,3
Keiora,sargeras,862,paladin,retribution,12,9,3
Badboí,azralon,862,paladin,retribution,12,9,3
Chàrron,garrosh,862,paladin,retribution,18,9,9
Illëst,stormrage,862,paladin,retribution,18,9,9
Athenax,area-52,862,paladin,retribution,18,9,9
Jajabola,zuljin,862,paladin,retribution,18,9,9
Lightblade,stormrage,862,paladin,retribution,18,9,9
Oniizuna,thrall,862,paladin,retribution,18,9,9
Rhoche,ysera,862,paladin,retribution,18,9,9
Pinelli,aegwynn,862,paladin,retribution,18,9,9
Omegaziion,garrosh,862,paladin,retribution,18,9,9
Kelthálas,illidan,862,paladin,retribution,24,9,15
Restitution,area-52,862,paladin,retribution,24,9,15
Boogerred,korialstrasz,862,paladin,retribution,24,9,15
Velarelan,moon-guard,862,paladin,retribution,24,9,15
Lightvader,illidan,862,paladin,retribution,24,9,15
Stevas,khazgoroth,861,paladin,retribution,12,9,3
Pikatripa,quelthalas,861,paladin,retribution,12,9,3
Borélock,kelthuzad,861,paladin,retribution,18,9,9
Kommuna,stormscale,861,paladin,retribution,18,9,9
Bojanglz,frostmourne,861,paladin,retribution,21,10,11
Rennalux,stormrage,861,paladin,retribution,24,9,15
Vaelinarys,ragnaros,860,paladin,retribution,12,9,3
Aeroßlaze,dragonmaw,860,paladin,retribution,18,9,9
Unholypally,suramar,860,paladin,retribution,24,9,15
Sona,jubeithos,860,paladin,retribution,24,9,15
Easiestcomp,sargeras,859,paladin,retribution,18,9,9
Khetzi,thunderhorn,859,paladin,retribution,18,9,9
Kylarha,stormrage,859,paladin,retribution,18,9,9
Layonthis,the-venture-co,859,paladin,retribution,18,9,9
Madalynn,quelthalas,859,paladin,retribution,24,9,15
Biggin,garona,859,paladin,retribution,108,36,72
Alysca,tichondrius,858,paladin,retribution,18,9,9
Derethen,emerald-dream,858,paladin,retribution,18,9,9
Irongiant,grizzly-hills,858,paladin,retribution,18,9,9
Vick,zuljin,857,paladin,retribution,12,9,3
Holyzeen,darkspear,857,paladin,retribution,17,11,6
Alerz,moon-guard,857,paladin,retribution,15,9,6
Atilas,ragnaros,856,paladin,retribution,18,9,9
Frostbitee,nerzhul,856,paladin,retribution,18,9,9
Zerolayer,proudmoore,855,paladin,retribution,12,9,3
Morddrohung,hyjal,855,paladin,retribution,12,9,3
Kaidao,black-dragonflight,854,paladin,retribution,18,9,9
Agonyss,quelthalas,853,paladin,retribution,18,9,9
Goldfînger,zuljin,853,paladin,retribution,24,9,15
Pallydin,smolderthorn,849,paladin,retribution,18,9,9
Rcon,khadgar,849,paladin,retribution,18,9,9
Leyon,alterac-mountains,847,paladin,retribution,18,9,9
Brahion,icecrown,846,paladin,retribution,18,9,9
Sycomaniac,illidan,846,paladin,retribution,23,9,14
Morthalos,moon-guard,845,paladin,retribution,23,9,14
Hotdgwatr,bleeding-hollow,843,paladin,retribution,24,10,14
Avaheal,dragonmaw,842,paladin,retribution,23,9,14
Pickypally,moon-guard,835,paladin,retribution,18,9,9
Brioc,tichondrius,832,paladin,retribution,22,9,13
Holyrump,bleeding-hollow,815,paladin,retribution,15,10,5
Fiate,azralon,815,paladin,retribution,23,9,14
Bigsamtp,laughing-skull,811,paladin,retribution,17,9,8
Cozzey,amanthul,810,paladin,retribution,17,9,8
Theboxx,frostmourne,810,paladin,retribution,28,11,17
Porterhousee,bleeding-hollow,807,paladin,retribution,23,11,12
Burstpink,zuljin,799,paladin,retribution,16,9,7
Lizzyz,illidan,799,paladin,retribution,20,9,11
Prosykt,sargeras,799,paladin,retribution,26,9,17
Witewolf,illidan,798,paladin,retribution,19,10,9
Erós,azralon,798,paladin,retribution,22,9,13
Lightfdre,rexxar,797,paladin,retribution,33,11,22
Kûrâmâ,ragnaros,796,paladin,retribution,16,9,7
Kiloalpha,area-52,791,paladin,retribution,22,9,13
Lítebearer,kelthuzad,787,paladin,retribution,17,9,8
Kletüs,quelthalas,784,paladin,retribution,13,9,4
Jdisco,bonechewer,782,paladin,retribution,19,9,10
Alexandros,nordrassil,768,paladin,retribution,12,8,4
Unicornslayr,antonidas,768,paladin,retribution,12,8,4
Franckz,ragnaros,768,paladin,retribution,12,8,4
Takinvcards,area-52,768,paladin,retribution,12,8,4
Schmïtty,tichondrius,768,paladin,retribution,12,8,4
Arellis,barthilas,768,paladin,retribution,12,8,4
Céllash,tichondrius,768,paladin,retribution,12,8,4
Eskynor,sargeras,768,paladin,retribution,12,8,4
Soymilkdrnka,sargeras,768,paladin,retribution,12,8,4
Mortalbeef,zuljin,768,paladin,retribution,12,8,4
Brotherjon,stormrage,768,paladin,retribution,12,8,4
Swellows,tichondrius,768,paladin,retribution,12,8,4
Tolliver,area-52,768,paladin,retribution,12,8,4
Pochanaw,wyrmrest-accord,768,paladin,retribution,12,8,4
Djangø,azuremyst,768,paladin,retribution,12,8,4
Bubblless,thrall,768,paladin,retribution,12,8,4
Laboøn,stormrage,768,paladin,retribution,12,8,4
Luzmu,azralon,768,paladin,retribution,12,8,4
Ennvy,nemesis,768,paladin,retribution,12,8,4
Nornix,fenris,768,paladin,retribution,12,8,4
Hatchet,skullcrusher,768,paladin,retribution,12,8,4
Liangguang,tichondrius,768,paladin,retribution,12,8,4
Dasp,nagrand,768,paladin,retribution,12,8,4
Rendyrend,frostmourne,768,paladin,retribution,12,8,4
Lightsheart,lightbringer,768,paladin,retribution,12,8,4
Cutebtw,zuljin,768,paladin,retribution,16,9,7
Grimreaperx,azralon,768,paladin,retribution,17,8,9
Duhvine,malganis,768,paladin,retribution,18,8,10
Dynamism,frostmourne,768,paladin,retribution,18,8,10
Torosagrado,drakkari,768,paladin,retribution,18,8,10
Nozfferatu,drakkari,768,paladin,retribution,18,8,10
Auranove,azralon,768,paladin,retribution,18,8,10
Jereth,kelthuzad,768,paladin,retribution,18,8,10
Bubbletaunt,frostmourne,768,paladin,retribution,18,8,10
Maanuel,ragnaros,768,paladin,retribution,18,8,10
Hge,proudmoore,768,paladin,retribution,18,8,10
Hamerfall,tichondrius,768,paladin,retribution,18,8,10
Kymmy,ragnaros,768,paladin,retribution,18,8,10
Jebpal,tichondrius,768,paladin,retribution,18,8,10
Howlerhead,illidan,768,paladin,retribution,18,8,10
Brifos,sargeras,768,paladin,retribution,18,8,10
Tævèn,tichondrius,768,paladin,retribution,18,8,10
Jachugz,tichondrius,768,paladin,retribution,18,8,10
Smiteup,sargeras,768,paladin,retribution,18,8,10
Roshord,quelthalas,768,paladin,retribution,18,8,10
Daion,quelthalas,768,paladin,retribution,18,8,10
Jakkatähn,malganis,768,paladin,retribution,18,8,10
Ratkiller,barthilas,768,paladin,retribution,18,8,10
Caution,rexxar,768,paladin,retribution,18,8,10
Bøble,thrall,768,paladin,retribution,18,8,10
Nadinebb,proudmoore,768,paladin,retribution,18,8,10
Gatzu,tichondrius,768,paladin,retribution,18,8,10
Vanquishy,burning-legion,768,paladin,retribution,18,8,10
Isayas,tichondrius,768,paladin,retribution,24,8,16
Cnret,tichondrius,768,paladin,retribution,24,8,16
Adamantïum,azralon,768,paladin,retribution,24,8,16
Bubbleblade,burning-blade,768,paladin,retribution,24,8,16
Jivvy,eredar,768,paladin,retribution,24,8,16
Marcopolo,azralon,768,paladin,retribution,24,8,16
Vibránium,tichondrius,768,paladin,retribution,24,8,16
Rexpeitaboot,azralon,768,paladin,retribution,24,8,16
Wantsome,frostmourne,768,paladin,retribution,25,8,17
Crasíus,quelthalas,768,paladin,retribution,30,8,22
Garethorne,illidan,768,paladin,retribution,30,8,22
Roundhere,area-52,768,paladin,retribution,30,8,22
Pallydestroy,stormrage,768,paladin,retribution,30,8,22
Noctisu,tichondrius,768,paladin,retribution,30,8,22
Mægenta,tichondrius,767,paladin,retribution,12,8,4
Smitetheweak,rivendare,767,paladin,retribution,12,8,4
Husurdaddy,dalaran,767,paladin,retribution,12,8,4
Greybrox,barthilas,767,paladin,retribution,12,8,4
Keit,moon-guard,767,paladin,retribution,12,8,4
Elhoj,illidan,767,paladin,retribution,12,8,4
Hqknight,moon-guard,767,paladin,retribution,12,8,4
Darkeclipse,area-52,767,paladin,retribution,12,8,4
Sowasred,emerald-dream,767,paladin,retribution,12,8,4
Gospel,duskwood,767,paladin,retribution,12,8,4
Doobiehigh,proudmoore,767,paladin,retribution,18,8,10
Dontsleep,magtheridon,767,paladin,retribution,18,8,10
Vindictacho,tichondrius,767,paladin,retribution,18,8,10
Nutsmashèr,illidan,767,paladin,retribution,18,8,10
Yurinos,illidan,767,paladin,retribution,18,8,10
Ashess,sargeras,767,paladin,retribution,18,8,10
Nightfallz,farstriders,767,paladin,retribution,18,8,10
Amlovích,quelthalas,767,paladin,retribution,18,8,10
Bruhstice,area-52,767,paladin,retribution,18,8,10
Sermon,moon-guard,767,paladin,retribution,18,8,10
Holytrev,tichondrius,767,paladin,retribution,18,8,10
Stroods,stormrage,767,paladin,retribution,18,8,10
Deafheavens,moon-guard,767,paladin,retribution,18,8,10
Rodsley,zuljin,767,paladin,retribution,18,8,10
Lygophobia,frostmourne,767,paladin,retribution,18,8,10
Yehdardi,frostmourne,767,paladin,retribution,18,8,10
Xytoken,tichondrius,767,paladin,retribution,18,8,10
Cathode,area-52,767,paladin,retribution,18,8,10
Nooplug,illidan,767,paladin,retribution,18,8,10
Hughkane,tichondrius,767,paladin,retribution,18,8,10
Saifollah,area-52,767,paladin,retribution,30,8,22
Malavon,azralon,766,paladin,retribution,12,8,4
Biblestomp,laughing-skull,766,paladin,retribution,12,8,4
Otorten,bladefist,766,paladin,retribution,12,8,4
Passion,wyrmrest-accord,766,paladin,retribution,12,8,4
Judgementalz,frostwolf,766,paladin,retribution,12,8,4
Deesqueezie,area-52,766,paladin,retribution,12,8,4
Egufro,frostwolf,766,paladin,retribution,13,8,5
Masho,skullcrusher,766,paladin,retribution,18,8,10
Chippo,aegwynn,766,paladin,retribution,18,8,10
Hanael,quelthalas,766,paladin,retribution,19,8,11
Torvus,bonechewer,766,paladin,retribution,22,9,13
Holyfilers,thunderlord,766,paladin,retribution,24,8,16
Nikinaki,stormrage,765,paladin,retribution,12,8,4
Cederas,sargeras,765,paladin,retribution,12,8,4
Zuljaboi,thrall,765,paladin,retribution,12,8,4
Kristary,ragnaros,765,paladin,retribution,12,8,4
Holyhammered,kelthuzad,765,paladin,retribution,12,8,4
Gírthbrooks,hyjal,765,paladin,retribution,12,8,4
Mothh,terokkar,765,paladin,retribution,12,8,4
Ichigò,sargeras,765,paladin,retribution,18,8,10
Gigadorff,stormrage,765,paladin,retribution,18,8,10
Butchur,area-52,765,paladin,retribution,30,8,22
Xanamun,magtheridon,764,paladin,retribution,18,8,10
Yenkmeilleur,zuljin,763,paladin,retribution,12,8,4
Deathblazer,blades-edge,763,paladin,retribution,18,8,10
Guccii,quelthalas,763,paladin,retribution,18,8,10
Palade,proudmoore,763,paladin,retribution,18,8,10
Amorimbr,area-52,763,paladin,retribution,24,8,16
Jebadia,proudmoore,762,paladin,retribution,12,8,4
Unicochori,drakkari,762,paladin,retribution,18,8,10
Gys,ragnaros,762,paladin,retribution,18,8,10
Eldirn,bleeding-hollow,761,paladin,retribution,12,8,4
Flisk,garona,761,paladin,retribution,12,8,4
Lucifuge,twisting-nether,760,paladin,retribution,12,8,4
Slar,emerald-dream,760,paladin,retribution,18,8,10
Darkknes,quelthalas,760,paladin,retribution,18,8,10
Mandragor,borean-tundra,759,paladin,retribution,12,8,4
Aladid,aggramar,758,paladin,retribution,12,8,4
Trodos,quelthalas,758,paladin,retribution,12,8,4
Appolas,shattered-hand,758,paladin,retribution,12,8,4
Nerfmehpls,ragnaros,755,paladin,retribution,18,8,10
Populate,tichondrius,752,paladin,retribution,12,8,4
Maverickxz,nemesis,751,paladin,retribution,23,8,15
Cleavix,tichondrius,751,paladin,retribution,35,8,27
Oogablah,wyrmrest-accord,749,paladin,retribution,12,8,4
Maelie,shadowmoon,749,paladin,retribution,12,8,4
Palavittar,azralon,749,paladin,retribution,17,9,8
Shanuslight,moon-guard,742,paladin,retribution,21,9,12
Yulasa,area-52,735,paladin,retribution,14,9,5
Hekki,ragnaros,735,paladin,retribution,19,8,11
Són,ragnaros,735,paladin,retribution,23,8,15
Xcream,nemesis,735,paladin,retribution,32,9,23
Swholly,senjin,733,paladin,retribution,21,10,11
Felordron,silvermoon,731,paladin,retribution,22,9,13
Retgasm,drakthul,729,paladin,retribution,16,8,8
Whisk,tichondrius,720,paladin,retribution,15,8,7
Bomdia,stormrage,720,paladin,retribution,15,8,7
Mádz,ragnaros,718,paladin,retribution,17,8,9
Juang,arthas,717,paladin,retribution,46,18,28
Romonite,bleeding-hollow,715,paladin,retribution,29,8,21
Lilbursty,tichondrius,714,paladin,retribution,19,9,10
Andorsi,elune,714,paladin,retribution,21,9,12
Ryanslover,kelthuzad,714,paladin,retribution,23,9,14
Exwars,moon-guard,713,paladin,retribution,14,9,5
Pantheeon,altar-of-storms,713,paladin,retribution,30,9,21
Connextion,terenas,704,paladin,retribution,16,8,8
Xandish,illidan,703,paladin,retribution,14,8,6
Làzårus,area-52,703,paladin,retribution,22,8,14
Wadalee,tichondrius,702,paladin,retribution,26,8,18
Palaðu,azralon,700,paladin,retribution,14,8,6
Paullokis,gallywix,686,paladin,retribution,13,8,5
Turtlehoof,thrall,684,paladin,retribution,19,8,11
Jackedx,sargeras,672,paladin,retribution,12,7,5
Montecrîsto,area-52,672,paladin,retribution,12,7,5
Steezyret,barthilas,672,paladin,retribution,12,7,5
Dabbicus,tichondrius,672,paladin,retribution,12,7,5
Thrandeill,bleeding-hollow,672,paladin,retribution,12,7,5
Armstrong,azralon,672,paladin,retribution,12,7,5
Shadoweelite,sargeras,672,paladin,retribution,12,7,5
Wèbb,burning-legion,672,paladin,retribution,12,7,5
Marhaus,emerald-dream,672,paladin,retribution,12,7,5
Zaxxous,hyjal,672,paladin,retribution,12,7,5
Chäinswellx,area-52,672,paladin,retribution,12,7,5
Supernampal,sargeras,672,paladin,retribution,12,7,5
Furylolx,tichondrius,672,paladin,retribution,12,7,5
Tmwesker,azralon,672,paladin,retribution,12,7,5
Darthhelios,illidan,672,paladin,retribution,12,7,5
Ÿøzsh,azralon,672,paladin,retribution,12,7,5
Aurðra,kiljaeden,672,paladin,retribution,12,7,5
Furdaddylant,drenden,672,paladin,retribution,12,7,5
Noitra,azralon,672,paladin,retribution,12,7,5
Griezadin,azgalor,672,paladin,retribution,12,7,5
Bootyfùnk,tichondrius,672,paladin,retribution,12,7,5
Iloveket,blackrock,672,paladin,retribution,12,7,5
Theehopper,shandris,672,paladin,retribution,12,7,5
Condign,moon-guard,672,paladin,retribution,12,7,5
Pals,bronzebeard,672,paladin,retribution,12,7,5
Zözo,zuljin,672,paladin,retribution,12,7,5
Trejetë,tichondrius,672,paladin,retribution,12,7,5
Vozy,bronzebeard,672,paladin,retribution,12,7,5
Rektributíon,area-52,672,paladin,retribution,12,7,5
Thephreak,madoran,672,paladin,retribution,12,7,5
Nosferätu,illidan,672,paladin,retribution,12,7,5
Paltarrd,bleeding-hollow,672,paladin,retribution,12,7,5
Safename,area-52,672,paladin,retribution,12,7,5
Qsx,bleeding-hollow,672,paladin,retribution,12,7,5
Fakesimp,illidan,672,paladin,retribution,12,7,5
Mikâel,cairne,672,paladin,retribution,12,7,5
Skuxxlord,khazgoroth,672,paladin,retribution,12,7,5
Hèlfar,wyrmrest-accord,672,paladin,retribution,12,7,5
Araguaney,bleeding-hollow,672,paladin,retribution,12,7,5
Steelemantle,moon-guard,672,paladin,retribution,12,7,5
Meridional,tichondrius,672,paladin,retribution,12,7,5
Popwingsz,nemesis,672,paladin,retribution,12,7,5
Âllmíght,quelthalas,672,paladin,retribution,12,7,5
Holycar,illidan,672,paladin,retribution,12,7,5
Greatwyrm,illidan,672,paladin,retribution,12,7,5
Montyer,ragnaros,672,paladin,retribution,12,7,5
Turner,skullcrusher,672,paladin,retribution,12,7,5
Kanaki,gilneas,672,paladin,retribution,12,7,5
Merkzz,arthas,672,paladin,retribution,12,7,5
Unitiss,velen,672,paladin,retribution,12,7,5
Holreshee,tichondrius,672,paladin,retribution,12,7,5
Bighoochie,moon-guard,672,paladin,retribution,12,7,5
Mes,dragonmaw,672,paladin,retribution,12,7,5
Ròwdy,area-52,672,paladin,retribution,12,7,5
Sonatas,ursin,672,paladin,retribution,15,8,7
Paladan,tichondrius,672,paladin,retribution,17,7,10
Trfreedomz,frostmourne,672,paladin,retribution,18,7,11
Bdaws,tichondrius,672,paladin,retribution,18,7,11
Cliftôn,illidan,672,paladin,retribution,18,7,11
Nerilliah,sargeras,672,paladin,retribution,18,7,11
Édzor,area-52,672,paladin,retribution,18,7,11
Orin,guldan,672,paladin,retribution,18,7,11
Hakson,stormrage,672,paladin,retribution,18,7,11
Drízzy,ragnaros,672,paladin,retribution,18,7,11
Moistbible,kelthuzad,672,paladin,retribution,18,7,11
Manryux,tichondrius,672,paladin,retribution,18,7,11
Kloud,sargeras,672,paladin,retribution,18,7,11
Gummybearz,doomhammer,672,paladin,retribution,18,7,11
Ziti,bonechewer,672,paladin,retribution,18,7,11
Eurthswrath,lightbringer,672,paladin,retribution,18,7,11
Nawwll,stonemaul,672,paladin,retribution,18,7,11
Anjocaído,nemesis,672,paladin,retribution,18,7,11
Pâpito,drakkari,672,paladin,retribution,18,7,11
Teamamerica,proudmoore,672,paladin,retribution,18,7,11
Hølyshyt,tichondrius,672,paladin,retribution,18,7,11
Aldhebarán,ragnaros,672,paladin,retribution,18,7,11
Wryly,mannoroth,672,paladin,retribution,18,7,11
Hulfsark,stormrage,672,paladin,retribution,18,7,11
Xvetis,thrall,672,paladin,retribution,18,7,11
Kipow,proudmoore,672,paladin,retribution,18,7,11
Atalzel,kiljaeden,672,paladin,retribution,18,7,11
Uoenò,moon-guard,672,paladin,retribution,18,7,11
Shoresy,terokkar,672,paladin,retribution,18,7,11
Rillumas,wyrmrest-accord,672,paladin,retribution,18,7,11
Geospawn,bleeding-hollow,672,paladin,retribution,18,7,11
Drriz,stormrage,672,paladin,retribution,18,7,11
Aledin,frostmourne,672,paladin,retribution,18,7,11
Tothegravetv,illidan,672,paladin,retribution,18,7,11
Neverwogx,kirin-tor,672,paladin,retribution,18,7,11
Bubbleblast,elune,672,paladin,retribution,18,7,11
Rakzan,nerzhul,672,paladin,retribution,18,7,11
Covidin,quelthalas,672,paladin,retribution,18,7,11
Pugnacity,stormrage,672,paladin,retribution,18,7,11
Kamí,elune,672,paladin,retribution,21,7,14
Kaupe,barthilas,672,paladin,retribution,23,7,16
Hayden,stormscale,672,paladin,retribution,24,7,17
Haimdallr,azralon,672,paladin,retribution,24,7,17
Ganan,frostmane,672,paladin,retribution,24,7,17
Ballsmcgee,bleeding-hollow,672,paladin,retribution,24,7,17
Ledster,kelthuzad,672,paladin,retribution,24,7,17
Heatyr,malganis,672,paladin,retribution,24,7,17
Kyuubî,bloodhoof,672,paladin,retribution,24,7,17
Goozlight,area-52,672,paladin,retribution,24,7,17
Goldmembër,malganis,672,paladin,retribution,24,7,17
Digider,area-52,672,paladin,retribution,24,7,17
Tanesdeline,area-52,671,paladin,retribution,12,7,5
Shadd,destromath,671,paladin,retribution,12,7,5
Dabnpaladin,kelthuzad,671,paladin,retribution,12,7,5
Koohny,stormrage,671,paladin,retribution,12,7,5
Darktank,malganis,671,paladin,retribution,12,7,5
Mhelyssa,goldrinn,671,paladin,retribution,12,7,5
Lystia,malfurion,671,paladin,retribution,12,7,5
Tonytoi,aegwynn,671,paladin,retribution,12,7,5
Jåy,nazjatar,671,paladin,retribution,12,7,5
Crematória,azralon,671,paladin,retribution,12,7,5
Zerofans,ragnaros,671,paladin,retribution,12,7,5
Ðrêâð,kirin-tor,671,paladin,retribution,12,7,5
Prophesied,zuljin,671,paladin,retribution,12,7,5
Torujo,drakkari,671,paladin,retribution,12,7,5
Elemezs,tichondrius,671,paladin,retribution,12,7,5
Ranknoob,khazgoroth,671,paladin,retribution,12,7,5
Smuglý,wyrmrest-accord,671,paladin,retribution,12,7,5
Ironpaladin,sargeras,671,paladin,retribution,12,7,5
Darawin,korgath,671,paladin,retribution,12,7,5
Holyretribut,tichondrius,671,paladin,retribution,12,7,5
Thorean,sargeras,671,paladin,retribution,12,7,5
Ruca,icecrown,671,paladin,retribution,12,7,5
Annii,aegwynn,671,paladin,retribution,12,7,5
Jaybbers,malganis,671,paladin,retribution,12,7,5
Showfet,dalaran,671,paladin,retribution,16,8,8
Auriol,azshara,671,paladin,retribution,14,7,7
Eutectic,moon-guard,671,paladin,retribution,18,7,11
Babyshuangs,illidan,671,paladin,retribution,18,7,11
Vaelicus,emerald-dream,671,paladin,retribution,18,7,11
Basslinee,quelthalas,671,paladin,retribution,18,7,11
Giorgyos,ragnaros,671,paladin,retribution,18,7,11
Kaidoz,aegwynn,671,paladin,retribution,18,7,11
Tyelca,zuljin,671,paladin,retribution,18,7,11
Blaeng,shandris,671,paladin,retribution,18,7,11
Contritus,kiljaeden,671,paladin,retribution,18,7,11
Gemutlich,khazgoroth,671,paladin,retribution,18,7,11
Misskilljoy,proudmoore,671,paladin,retribution,18,7,11
Valtariel,wyrmrest-accord,671,paladin,retribution,18,7,11
Golozzakum,tichondrius,671,paladin,retribution,18,7,11
Ane,gorefiend,671,paladin,retribution,18,7,11
Nibuwolfx,daggerspine,671,paladin,retribution,18,7,11
Släyèr,tichondrius,671,paladin,retribution,18,7,11
Imrahilaf,korialstrasz,671,paladin,retribution,24,7,17
Doraléous,illidan,671,paladin,retribution,24,7,17
Swissalami,proudmoore,670,paladin,retribution,12,7,5
Hanno,azshara,670,paladin,retribution,12,7,5
Biggwill,proudmoore,670,paladin,retribution,12,7,5
Itsapoc,sargeras,670,paladin,retribution,12,7,5
Tomaz,ragnaros,670,paladin,retribution,12,7,5
Holychach,tichondrius,670,paladin,retribution,12,7,5
Riek,sargeras,670,paladin,retribution,16,8,8
Mindfoolness,sargeras,670,paladin,retribution,18,7,11
Rampetos,mannoroth,670,paladin,retribution,18,7,11
Jorgevercilo,azralon,670,paladin,retribution,18,7,11
Augus,arygos,670,paladin,retribution,18,7,11
Tpane,kelthuzad,670,paladin,retribution,18,7,11
Murdameek,area-52,670,paladin,retribution,24,7,17
Terroll,bonechewer,669,paladin,retribution,13,7,6
Vargonha,azralon,669,paladin,retribution,18,9,9
Tpaartes,mannoroth,669,paladin,retribution,18,7,11
Sîegfried,moon-guard,669,paladin,retribution,18,7,11
Denstain,kul-tiras,669,paladin,retribution,18,7,11
Bingbingcd,tichondrius,669,paladin,retribution,18,7,11
Rynis,arthas,669,paladin,retribution,22,8,14
Salvø,tichondrius,669,paladin,retribution,24,7,17
Murtsza,ragnaros,669,paladin,retribution,24,7,17
Sponce,kirin-tor,669,paladin,retribution,30,7,23
Praisin,zuljin,668,paladin,retribution,12,7,5
Marshman,kelthuzad,668,paladin,retribution,12,7,5
Unsung,stormreaver,668,paladin,retribution,18,7,11
Holyrõller,malganis,668,paladin,retribution,18,7,11
Pengideath,barthilas,668,paladin,retribution,18,7,11
Bennygee,moonrunner,668,paladin,retribution,24,7,17
Kapaw,windrunner,667,paladin,retribution,12,7,5
Tacosmells,thunderlord,667,paladin,retribution,18,7,11
Mandow,tichondrius,667,paladin,retribution,22,8,14
Imsoosmall,sargeras,666,paladin,retribution,12,7,5
Calmador,proudmoore,666,paladin,retribution,12,7,5
Toogud,moon-guard,666,paladin,retribution,21,8,13
Jonnywick,duskwood,665,paladin,retribution,12,7,5
Chaosbubble,burning-legion,665,paladin,retribution,18,7,11
Palgiga,tichondrius,664,paladin,retribution,12,7,5
Dweezill,daggerspine,664,paladin,retribution,18,7,11
Tectorr,proudmoore,661,paladin,retribution,12,7,5
Nicepally,moon-guard,657,paladin,retribution,18,7,11
Blake,frostmourne,655,paladin,retribution,23,7,16
Palliful,runetotem,651,paladin,retribution,18,7,11
Reînhard,drakkari,639,paladin,retribution,18,8,10
Vietnomeez,tichondrius,639,paladin,retribution,17,7,10
Cherrypally,area-52,639,paladin,retribution,17,7,10
Epòc,frostmourne,639,paladin,retribution,20,8,12
Hanicon,dragonmaw,638,paladin,retribution,16,7,9
Fatalpally,antonidas,633,paladin,retribution,17,7,10
Taéyeon,quelthalas,624,paladin,retribution,15,7,8
Táçô,illidan,623,paladin,retribution,11,7,4
Wingalings,malganis,623,paladin,retribution,11,7,4
Krossfyre,kiljaeden,623,paladin,retribution,17,7,10
Strabic,stormrage,623,paladin,retribution,27,8,19
Jortesh,tichondrius,622,paladin,retribution,15,7,8
Shuckles,windrunner,618,paladin,retribution,26,8,18
Antoniano,ragnaros,617,paladin,retribution,13,8,5
Thorsmites,sargeras,616,paladin,retribution,29,11,18
Krixes,firetree,615,paladin,retribution,18,8,10
Frêyr,barthilas,608,paladin,retribution,22,7,15
Andelk,tichondrius,607,paladin,retribution,11,7,4
Chestbrah,nemesis,607,paladin,retribution,14,7,7
Tolkki,dalaran,607,paladin,retribution,26,7,19
Krønos,nordrassil,602,paladin,retribution,22,7,15
Ylilliana,illidan,592,paladin,retribution,19,7,12
Sixtynine,nathrezim,592,paladin,retribution,31,7,24
Warbird,lightnings-blade,591,paladin,retribution,13,7,6
Theomere,sargeras,586,paladin,retribution,27,10,17
Bubbledober,tichondrius,576,paladin,retribution,6,6,0
Liht,blood-furnace,576,paladin,retribution,6,6,0
Fierfox,moon-guard,576,paladin,retribution,6,6,0
Fibonaci,sargeras,576,paladin,retribution,6,6,0
Sneely,kelthuzad,576,paladin,retribution,6,6,0
Lucard,drakkari,576,paladin,retribution,6,6,0
Thøradin,moon-guard,576,paladin,retribution,6,6,0
Xandiê,sargeras,576,paladin,retribution,6,6,0
Damnhammer,tichondrius,576,paladin,retribution,10,7,3
Mikeyqt,nemesis,576,paladin,retribution,12,6,6
Ashbrînger,emerald-dream,576,paladin,retribution,12,6,6
Thuggrnaut,darkspear,576,paladin,retribution,12,6,6
Bloodeladin,deathwing,576,paladin,retribution,12,6,6
Emetselchs,tichondrius,576,paladin,retribution,12,6,6
Seeys,tichondrius,576,paladin,retribution,12,6,6
Cybopig,kelthuzad,576,paladin,retribution,12,6,6
Ashley,sargeras,576,paladin,retribution,12,6,6
Thaléros,tichondrius,576,paladin,retribution,12,6,6
Brpistol,azralon,576,paladin,retribution,12,6,6
Rhoruk,turalyon,576,paladin,retribution,12,6,6
Sonicblazer,darrowmere,576,paladin,retribution,12,6,6
Cübe,malganis,576,paladin,retribution,12,6,6
Rohad,thrall,576,paladin,retribution,12,6,6
Pudgë,bleeding-hollow,576,paladin,retribution,12,6,6
Hammerd,area-52,576,paladin,retribution,12,6,6
Cvpal,stormrage,576,paladin,retribution,12,6,6
Zägreus,moon-guard,576,paladin,retribution,12,6,6
Enj,stormrage,576,paladin,retribution,12,6,6
Lyà,area-52,576,paladin,retribution,12,6,6
Escanøor,stormrage,576,paladin,retribution,12,6,6
Margit,moon-guard,576,paladin,retribution,12,6,6
Shourins,tichondrius,576,paladin,retribution,12,6,6
Checkeettpal,sargeras,576,paladin,retribution,12,6,6
Badbad,icecrown,576,paladin,retribution,12,6,6
Lmac,frostmourne,576,paladin,retribution,12,6,6
Immensepower,tichondrius,576,paladin,retribution,12,6,6
Lebubbles,azuremyst,576,paladin,retribution,12,6,6
Tacohuntter,stormrage,576,paladin,retribution,12,6,6
Joeseph,stormrage,576,paladin,retribution,12,6,6
Onnakishi,azralon,576,paladin,retribution,12,6,6
Jabrohnie,sargeras,576,paladin,retribution,12,6,6
Snivasgo,ragnaros,576,paladin,retribution,12,6,6
Memepaladin,area-52,576,paladin,retribution,12,6,6
Banzz,azralon,576,paladin,retribution,12,6,6
Klamindor,emerald-dream,576,paladin,retribution,12,6,6
Holycrp,proudmoore,576,paladin,retribution,12,6,6
Accept,frostmourne,576,paladin,retribution,12,6,6
Cinacalcet,dalaran,576,paladin,retribution,12,6,6
Aura,emerald-dream,576,paladin,retribution,12,6,6
Bigdig,stormrage,576,paladin,retribution,12,6,6
Proctrlx,tichondrius,576,paladin,retribution,12,6,6
Irushthots,tichondrius,576,paladin,retribution,12,6,6
Careyprice,area-52,576,paladin,retribution,12,6,6
Glynisir,sargeras,576,paladin,retribution,12,6,6
Sacerbelator,zuluhed,576,paladin,retribution,12,6,6
Germ,korgath,576,paladin,retribution,12,6,6
Skarlagen,moon-guard,576,paladin,retribution,12,6,6
Gronmpa,nemesis,576,paladin,retribution,12,6,6
Gambitdin,moon-guard,576,paladin,retribution,12,6,6
Xlnc,illidan,576,paladin,retribution,12,6,6
Panicbubblin,stormrage,576,paladin,retribution,12,6,6
Crtinsideyou,skullcrusher,576,paladin,retribution,12,6,6
Pállyho,tichondrius,576,paladin,retribution,12,6,6
Fallenp,hakkar,576,paladin,retribution,12,6,6
Troegenator,stormrage,576,paladin,retribution,12,6,6
Çløúdéd,area-52,576,paladin,retribution,12,6,6
Obeliskk,frostmourne,576,paladin,retribution,12,6,6
Venter,bleeding-hollow,576,paladin,retribution,12,6,6
Soapgirl,area-52,576,paladin,retribution,12,6,6
Zèró,terokkar,576,paladin,retribution,12,6,6
Trixzthot,barthilas,576,paladin,retribution,12,6,6
Alphali,quelthalas,576,paladin,retribution,12,6,6
Tazanian,aegwynn,576,paladin,retribution,12,6,6
Geesworld,nazjatar,576,paladin,retribution,12,6,6
Dýnamo,azralon,576,paladin,retribution,12,6,6
Gánico,ragnaros,576,paladin,retribution,12,6,6
Sabêr,mannoroth,576,paladin,retribution,12,6,6
Beluros,tichondrius,576,paladin,retribution,12,6,6
Valandur,kelthuzad,576,paladin,retribution,12,6,6
Koûtt,ragnaros,576,paladin,retribution,12,6,6
Kaïty,azralon,576,paladin,retribution,12,6,6
Arraladin,tichondrius,576,paladin,retribution,12,6,6
Shrektacular,malganis,576,paladin,retribution,12,6,6
Byebyetwinks,khaz-modan,576,paladin,retribution,12,6,6
Bigkspally,korgath,576,paladin,retribution,12,6,6
Seballedo,drakkari,576,paladin,retribution,12,6,6
Yungcheezy,illidan,576,paladin,retribution,12,6,6
Sparticuss,frostmane,576,paladin,retribution,12,6,6
Ltt,dalaran,576,paladin,retribution,12,6,6
Raywhite,kelthuzad,576,paladin,retribution,12,6,6
Retboy,archimonde,576,paladin,retribution,12,6,6
Vozy,shandris,576,paladin,retribution,12,6,6
Onixx,kargath,576,paladin,retribution,12,6,6
Avasti,proudmoore,576,paladin,retribution,12,6,6
Totalaustin,sargeras,576,paladin,retribution,12,6,6
Lumberjack,bloodhoof,576,paladin,retribution,12,6,6
Bloodyängel,emerald-dream,576,paladin,retribution,12,6,6
Çhñkzrèt,illidan,576,paladin,retribution,12,6,6
Glorgrim,emerald-dream,576,paladin,retribution,12,6,6
Vilert,balnazzar,576,paladin,retribution,12,6,6
Nyroxz,quelthalas,576,paladin,retribution,12,6,6
Crânkdât,frostmourne,576,paladin,retribution,12,6,6
Cause,farstriders,576,paladin,retribution,12,6,6
Bootcrusader,thrall,576,paladin,retribution,15,7,8
Sunwalker,tichondrius,576,paladin,retribution,17,6,11
Koreancannon,tichondrius,576,paladin,retribution,21,7,14
Respect,moon-guard,576,paladin,retribution,18,6,12
Nufi,magtheridon,576,paladin,retribution,18,6,12
Wreathy,sargeras,576,paladin,retribution,18,6,12
Slowmoshend,illidan,576,paladin,retribution,18,6,12
Felwythe,emerald-dream,576,paladin,retribution,18,6,12
Jucker,tichondrius,576,paladin,retribution,18,6,12
Kochinodin,ragnaros,576,paladin,retribution,18,6,12
Astolfo,tortheldrin,576,paladin,retribution,18,6,12
Retz,tichondrius,576,paladin,retribution,18,6,12
Kronicle,bleeding-hollow,576,paladin,retribution,18,6,12
Shiftybugar,tichondrius,576,paladin,retribution,18,6,12
Divineera,frostmourne,576,paladin,retribution,18,6,12
Goldskìn,sargeras,576,paladin,retribution,18,6,12
Exorcìst,tichondrius,576,paladin,retribution,18,6,12
Bergz,agamaggan,576,paladin,retribution,18,6,12
Niksilp,malfurion,576,paladin,retribution,18,6,12
Liandroa,stormrage,576,paladin,retribution,18,6,12
Riggen,thrall,576,paladin,retribution,18,6,12
Suro,moon-guard,576,paladin,retribution,18,6,12
Emaus,tichondrius,576,paladin,retribution,18,6,12
Hetodo,blood-furnace,576,paladin,retribution,18,6,12
Spala,tichondrius,576,paladin,retribution,18,6,12
Bageru,gnomeregan,576,paladin,retribution,18,6,12
Júdgedredd,illidan,576,paladin,retribution,18,6,12
Gogofisco,moonrunner,576,paladin,retribution,18,6,12
Terrordin,illidan,576,paladin,retribution,18,6,12
Iloveyouxoxo,tichondrius,576,paladin,retribution,18,6,12
Lightslion,stormrage,576,paladin,retribution,18,6,12
Pheonixpally,azralon,576,paladin,retribution,24,6,18
Pallyfreddyy,frostmourne,576,paladin,retribution,24,6,18
Dragrias,altar-of-storms,575,paladin,retribution,10,7,3
Yuzuru,mannoroth,575,paladin,retribution,12,6,6
Haziel,darkspear,575,paladin,retribution,12,6,6
Drágônbôrn,tichondrius,575,paladin,retribution,12,6,6
Angelz,garrosh,575,paladin,retribution,12,6,6
Toscadin,ragnaros,575,paladin,retribution,12,6,6
Skyangel,illidan,575,paladin,retribution,12,6,6
Laluce,malganis,575,paladin,retribution,12,6,6
Killmode,kelthuzad,575,paladin,retribution,12,6,6
Jovolur,dalaran,575,paladin,retribution,12,6,6
Sarkorius,moon-guard,575,paladin,retribution,12,6,6
Blëssëd,zuljin,575,paladin,retribution,12,6,6
Ikanacanyon,stormrage,575,paladin,retribution,12,6,6
Übermane,illidan,575,paladin,retribution,12,6,6
Llght,hydraxis,575,paladin,retribution,12,6,6
Potiguar,azralon,575,paladin,retribution,12,6,6
Crixius,eredar,575,paladin,retribution,12,6,6
Pocacoco,azralon,575,paladin,retribution,12,6,6
Shaggrilla,trollbane,575,paladin,retribution,12,6,6
Knobody,emerald-dream,575,paladin,retribution,12,6,6
Onecmpeter,kelthuzad,575,paladin,retribution,12,6,6
Willzaum,azralon,575,paladin,retribution,12,6,6
Heiinneken,queldorei,575,paladin,retribution,12,6,6
Karimpro,emerald-dream,575,paladin,retribution,15,7,8
Holyginger,barthilas,575,paladin,retribution,15,7,8
Trekpii,area-52,575,paladin,retribution,13,6,7
Vosailer,illidan,575,paladin,retribution,16,7,9
Bebedor,azralon,575,paladin,retribution,15,6,9
Killstien,illidan,575,paladin,retribution,18,6,12
Oceangal,illidan,575,paladin,retribution,18,6,12
Valdi,stonemaul,575,paladin,retribution,18,6,12
Cropcircles,whisperwind,575,paladin,retribution,18,6,12
Vecknilashx,quelthalas,575,paladin,retribution,24,6,18
Ihmperiuus,quelthalas,574,paladin,retribution,12,6,6
Palman,frostmourne,574,paladin,retribution,12,6,6
Akeero,khaz-modan,574,paladin,retribution,12,6,6
Halordriest,tichondrius,574,paladin,retribution,18,6,12
Tamahu,azralon,574,paladin,retribution,18,6,12
Darqtank,smolderthorn,574,paladin,retribution,18,6,12
Judgemèntal,illidan,574,paladin,retribution,20,6,14
Phankro,quelthalas,573,paladin,retribution,12,6,6
Tauyoshi,azjolnerub,573,paladin,retribution,12,6,6
Gämä,azralon,573,paladin,retribution,18,6,12
Chadrickk,tichondrius,572,paladin,retribution,12,6,6
Ajaex,area-52,571,paladin,retribution,12,6,6
Kalerien,wildhammer,571,paladin,retribution,12,6,6
Lucent,duskwood,571,paladin,retribution,18,6,12
Niáa,quelthalas,570,paladin,retribution,18,6,12
Palâdino,azralon,568,paladin,retribution,21,7,14
Halldhyr,quelthalas,566,paladin,retribution,12,6,6
Rëtribution,tichondrius,559,paladin,retribution,18,7,11
Bellamor,burning-blade,543,paladin,retribution,11,6,5
Gloren,garrosh,543,paladin,retribution,17,6,11
Buffalosaucé,illidan,543,paladin,retribution,17,6,11
Suslazin,area-52,543,paladin,retribution,20,7,13
Hadagoodlay,zuljin,528,paladin,retribution,15,6,9
Yulzypal,tichondrius,527,paladin,retribution,11,6,5
Rugay,sargeras,527,paladin,retribution,11,6,5
Vardrik,darkspear,527,paladin,retribution,15,6,9
Briaelyne,tichondrius,522,paladin,retribution,25,8,17
Nathaniel,galakrond,511,paladin,retribution,14,6,8
ßìgdám,bleeding-hollow,511,paladin,retribution,17,6,11
Javiermiléi,quelthalas,511,paladin,retribution,26,6,20
Dexko,silvermoon,509,paladin,retribution,12,7,5
Releváncé,frostmourne,496,paladin,retribution,27,6,21
Spàrhawke,stormrage,495,paladin,retribution,13,6,7
Fionax,frostmourne,495,paladin,retribution,21,6,15
Senorwang,dalaran,494,paladin,retribution,13,6,7
Mollymatt,drenden,480,paladin,retribution,6,5,1
Ganrof,mugthol,480,paladin,retribution,6,5,1
Mizumaru,sargeras,480,paladin,retribution,6,5,1
Chopsparks,khadgar,480,paladin,retribution,6,5,1
Anarkay,frostmourne,480,paladin,retribution,6,5,1
Divenelena,sargeras,480,paladin,retribution,6,5,1
Aurelea,frostmourne,480,paladin,retribution,6,5,1
Mandymuze,illidan,480,paladin,retribution,6,5,1
Stricken,kul-tiras,480,paladin,retribution,6,5,1
Mendaltv,dalaran,480,paladin,retribution,6,5,1
Fálko,azralon,480,paladin,retribution,6,5,1
Moozafa,kiljaeden,480,paladin,retribution,6,5,1
Solidifyxz,area-52,480,paladin,retribution,6,5,1
Kdym,azralon,480,paladin,retribution,6,5,1
Rangedmelee,stormrage,480,paladin,retribution,6,5,1
Capsiel,caelestrasz,480,paladin,retribution,6,5,1
Kelimir,dathremar,480,paladin,retribution,6,5,1
Oldlemon,tichondrius,480,paladin,retribution,6,5,1
Jianwen,kargath,480,paladin,retribution,6,5,1
Kimitail,tichondrius,480,paladin,retribution,6,5,1
Mmrdonator,icecrown,480,paladin,retribution,6,5,1
Mardrïus,tichondrius,480,paladin,retribution,6,5,1
Mcjudgin,kilrogg,480,paladin,retribution,6,5,1
Demetriusxy,tichondrius,480,paladin,retribution,6,5,1
Fistrozenemy,illidan,480,paladin,retribution,6,5,1
Gramsby,aggramar,480,paladin,retribution,6,5,1
Pickleparker,stormrage,480,paladin,retribution,6,5,1
Pallisix,barthilas,480,paladin,retribution,6,5,1
Zeprikito,nemesis,480,paladin,retribution,6,5,1
Devvn,laughing-skull,480,paladin,retribution,6,5,1
Speedlight,ragnaros,480,paladin,retribution,6,5,1
Adrieoss,stormrage,480,paladin,retribution,6,5,1
Overbet,area-52,480,paladin,retribution,9,6,3
Smaugg,boulderfist,480,paladin,retribution,9,6,3
Siamac,illidan,480,paladin,retribution,13,7,6
Shinymoo,laughing-skull,480,paladin,retribution,12,5,7
Sigismud,quelthalas,480,paladin,retribution,12,5,7
Lastal,kiljaeden,480,paladin,retribution,12,5,7
Brocolinî,zuljin,480,paladin,retribution,12,5,7
Addisen,malganis,480,paladin,retribution,12,5,7
Sabericdos,proudmoore,480,paladin,retribution,12,5,7
Flavor,cairne,480,paladin,retribution,12,5,7
Gavriel,quelthalas,480,paladin,retribution,12,5,7
Kuyueh,tichondrius,480,paladin,retribution,12,5,7
Wetterguuch,area-52,480,paladin,retribution,12,5,7
Faithkiller,garrosh,480,paladin,retribution,12,5,7
Hekcthor,ragnaros,480,paladin,retribution,12,5,7
Mateeka,malganis,480,paladin,retribution,12,5,7
Thrasheric,ragnaros,480,paladin,retribution,12,5,7
Rakkhalar,ragnaros,480,paladin,retribution,12,5,7
Vain,shuhalo,480,paladin,retribution,12,5,7
Abegáil,area-52,480,paladin,retribution,12,5,7
Runscapemain,feathermoon,480,paladin,retribution,12,5,7
Thickgirl,bleeding-hollow,480,paladin,retribution,12,5,7
Imperious,anetheron,480,paladin,retribution,12,5,7
Alecx,tichondrius,480,paladin,retribution,12,5,7
Retsupreme,tichondrius,480,paladin,retribution,12,5,7
Leaelda,wyrmrest-accord,480,paladin,retribution,12,5,7
Bettyböp,bleeding-hollow,480,paladin,retribution,12,5,7
Chenghisret,tichondrius,480,paladin,retribution,12,5,7
Zulyourmom,tichondrius,480,paladin,retribution,12,5,7
Toojazzyleah,proudmoore,480,paladin,retribution,12,5,7
Mikeawk,tichondrius,480,paladin,retribution,12,5,7
Gotenks,trollbane,480,paladin,retribution,12,5,7
Connore,stormrage,480,paladin,retribution,12,5,7
Xizzor,darkspear,480,paladin,retribution,12,5,7
Shiningtendi,aerie-peak,480,paladin,retribution,12,5,7
Raveen,veknilash,480,paladin,retribution,12,5,7
Valkaurus,drakkari,480,paladin,retribution,12,5,7
Pique,malganis,480,paladin,retribution,12,5,7
Joonzu,frostmane,480,paladin,retribution,12,5,7
Dinobe,arthas,480,paladin,retribution,12,5,7
Remorâ,blackrock,480,paladin,retribution,12,5,7
Jadedx,stormrage,480,paladin,retribution,12,5,7
Farmerzonly,tichondrius,480,paladin,retribution,12,5,7
Dawsonthebos,grizzly-hills,480,paladin,retribution,12,5,7
Namiiswan,area-52,480,paladin,retribution,12,5,7
Uneazyxx,tichondrius,480,paladin,retribution,12,5,7
Héathèn,area-52,480,paladin,retribution,12,5,7
Shadomourne,arthas,480,paladin,retribution,12,5,7
Daddyspit,arthas,480,paladin,retribution,12,5,7
ßraveheart,zuljin,480,paladin,retribution,12,5,7
Wonas,ragnaros,480,paladin,retribution,12,5,7
Ravage,lothar,480,paladin,retribution,12,5,7
Liadryn,kiljaeden,480,paladin,retribution,12,5,7
Níngjìngy,tichondrius,480,paladin,retribution,12,5,7
Rikku,undermine,480,paladin,retribution,12,5,7
Gennara,ragnaros,480,paladin,retribution,12,5,7
Yoroding,tichondrius,480,paladin,retribution,12,5,7
Rùckûs,tichondrius,480,paladin,retribution,12,5,7
Noleyboo,proudmoore,480,paladin,retribution,12,5,7
Thin,ragnaros,480,paladin,retribution,12,5,7
Delaswing,quelthalas,480,paladin,retribution,12,5,7
Lücid,arthas,480,paladin,retribution,12,5,7
Soterios,daggerspine,480,paladin,retribution,12,5,7
Dalance,draka,480,paladin,retribution,12,5,7
Únhøly,aegwynn,480,paladin,retribution,12,5,7
Maxduo,bleeding-hollow,480,paladin,retribution,12,5,7
Randvi,sargeras,480,paladin,retribution,12,5,7
Littlemoses,exodar,480,paladin,retribution,12,5,7
Heamis,thunderlord,480,paladin,retribution,12,5,7
Callandør,illidan,480,paladin,retribution,12,5,7
Bullpaladin,barthilas,480,paladin,retribution,12,5,7
Shadòw,emerald-dream,480,paladin,retribution,12,5,7
Hegarth,archimonde,480,paladin,retribution,12,5,7
Jaenus,azralon,480,paladin,retribution,12,5,7
Jinuhn,illidan,480,paladin,retribution,12,5,7
Jaslexa,illidan,480,paladin,retribution,12,5,7
Aeoliá,moon-guard,480,paladin,retribution,12,5,7
Adrexious,dalaran,480,paladin,retribution,12,5,7
Dimsimbar,frostmourne,480,paladin,retribution,12,5,7
Beatman,blades-edge,480,paladin,retribution,12,5,7
Dipho,illidan,480,paladin,retribution,12,5,7
Malicia,malorne,480,paladin,retribution,12,5,7
Yellowmay,sargeras,480,paladin,retribution,12,5,7
Athamon,nemesis,480,paladin,retribution,12,5,7
Hallastus,stormrage,480,paladin,retribution,12,5,7
Dirtbagg,demon-soul,480,paladin,retribution,12,5,7
Cedwarlancy,sargeras,480,paladin,retribution,12,5,7
Delightt,sargeras,480,paladin,retribution,12,5,7
Jonbonholy,sargeras,480,paladin,retribution,12,5,7
Kirklandbeef,gorefiend,480,paladin,retribution,12,5,7
Itaghí,sargeras,480,paladin,retribution,12,5,7
Holytankadin,alleria,480,paladin,retribution,12,5,7
Amyrana,medivh,480,paladin,retribution,12,5,7
Ssawsy,illidan,480,paladin,retribution,12,5,7
Crucifuk,sargeras,480,paladin,retribution,12,5,7
Alequin,stormrage,480,paladin,retribution,12,5,7
Wahpop,sargeras,480,paladin,retribution,12,5,7
Dehya,sargeras,480,paladin,retribution,12,5,7
Minzyp,illidan,480,paladin,retribution,12,5,7
Kaelel,barthilas,480,paladin,retribution,12,5,7
Ganster,dreadmaul,480,paladin,retribution,12,5,7
Keelroi,sargeras,480,paladin,retribution,12,5,7
Bold,frostmourne,480,paladin,retribution,12,5,7
Bigolhammer,khadgar,480,paladin,retribution,12,5,7
Methor,thrall,480,paladin,retribution,12,5,7
Critadins,thrall,480,paladin,retribution,12,5,7
Dragomnnm,stormrage,480,paladin,retribution,12,5,7
Frepz,illidan,480,paladin,retribution,16,6,10
Exer,ragnaros,480,paladin,retribution,18,5,13
Holycots,stormrage,480,paladin,retribution,18,5,13
Chriscoz,korgath,480,paladin,retribution,18,5,13
Immunelf,azgalor,480,paladin,retribution,18,5,13
Kraggar,arthas,480,paladin,retribution,18,5,13
Tieberion,bleeding-hollow,480,paladin,retribution,18,5,13
Downs,tichondrius,480,paladin,retribution,18,5,13
Papazon,tichondrius,480,paladin,retribution,18,5,13
Reehzlol,stormrage,480,paladin,retribution,18,5,13
Valinorean,nemesis,480,paladin,retribution,18,5,13
Zightmare,azralon,480,paladin,retribution,18,5,13
Photons,emerald-dream,480,paladin,retribution,18,5,13
Ulcerà,azralon,480,paladin,retribution,18,5,13
Paradisso,tichondrius,480,paladin,retribution,18,5,13
Nidalee,kilrogg,480,paladin,retribution,18,5,13
Kurasi,frostmourne,480,paladin,retribution,18,5,13
Melgamis,quelthalas,480,paladin,retribution,18,5,13
Razuel,frostmourne,480,paladin,retribution,18,5,13
Ztpz,illidan,480,paladin,retribution,18,5,13
Purged,wyrmrest-accord,480,paladin,retribution,18,5,13
Midnightboto,dragonmaw,480,paladin,retribution,18,5,13
Typheuz,wyrmrest-accord,480,paladin,retribution,18,5,13
Møemøeda,illidan,480,paladin,retribution,18,5,13
Tikkun,area-52,480,paladin,retribution,18,5,13
Sakicc,dalaran,480,paladin,retribution,18,5,13
Deecompose,sargeras,480,paladin,retribution,18,5,13
Artherion,kelthuzad,480,paladin,retribution,27,6,21
Trapqueenlol,alterac-mountains,480,paladin,retribution,24,5,19
Spoelstra,dragonmaw,480,paladin,retribution,24,5,19
Zero,garona,480,paladin,retribution,30,5,25
Azdan,ragnaros,480,paladin,retribution,30,5,25
Abuenano,ragnaros,479,paladin,retribution,6,5,1
Kremation,zuljin,479,paladin,retribution,6,5,1
Dredberserk,stormrage,479,paladin,retribution,12,5,7
Calithia,destromath,479,paladin,retribution,12,5,7
Heneaz,quelthalas,479,paladin,retribution,12,5,7
Noctis,nerzhul,479,paladin,retribution,12,5,7
Reedeemer,bonechewer,479,paladin,retribution,12,5,7
Murderous,frostmourne,479,paladin,retribution,12,5,7
Mordrime,moon-guard,479,paladin,retribution,12,5,7
Ashera,amanthul,479,paladin,retribution,12,5,7
Zelrich,moon-guard,479,paladin,retribution,12,5,7
Robz,malygos,479,paladin,retribution,12,5,7
Memoríez,zuljin,479,paladin,retribution,12,5,7
Ðarksealz,laughing-skull,479,paladin,retribution,12,5,7
Cowsavior,terenas,479,paladin,retribution,12,5,7
Inqa,thunderlord,479,paladin,retribution,12,5,7
Onemorelight,sargeras,479,paladin,retribution,12,5,7
Khels,gilneas,479,paladin,retribution,12,5,7
Brightfire,dawnbringer,479,paladin,retribution,18,5,13
Provail,stormrage,479,paladin,retribution,18,5,13
Astralweed,quelthalas,479,paladin,retribution,18,5,13
Alluxian,zuljin,479,paladin,retribution,18,5,13
Griz,magtheridon,479,paladin,retribution,18,5,13
Kief,emerald-dream,479,paladin,retribution,18,5,13
Kajoruun,bleeding-hollow,479,paladin,retribution,24,5,19
Palypunchh,darrowmere,478,paladin,retribution,12,6,6
Neipala,ragnaros,478,paladin,retribution,12,5,7
Impia,tichondrius,478,paladin,retribution,12,5,7
Chengduqq,illidan,478,paladin,retribution,12,5,7
Lagun,wyrmrest-accord,478,paladin,retribution,12,5,7
Boomeers,emerald-dream,478,paladin,retribution,18,5,13
Vonfraud,lightbringer,478,paladin,retribution,18,5,13
Benzen,bleeding-hollow,477,paladin,retribution,12,5,7
Jammsheed,arthas,477,paladin,retribution,12,5,7
Kaminasol,quelthalas,477,paladin,retribution,18,5,13
Pedromuulos,misha,477,paladin,retribution,24,5,19
Solstein,dalaran,474,paladin,retribution,12,5,7
Vengecide,proudmoore,473,paladin,retribution,12,5,7
Dubaron,burning-blade,473,paladin,retribution,12,5,7
Kforty,kiljaeden,458,paladin,retribution,18,7,11
Pablito,fizzcrank,457,paladin,retribution,21,7,14
Thepallyx,silvermoon,448,paladin,retribution,16,5,11
Jireen,tichondrius,447,paladin,retribution,11,5,6
Árèz,frostmourne,441,paladin,retribution,17,7,10
Zzf,turalyon,431,paladin,retribution,11,5,6
Neverforgot,quelthalas,431,paladin,retribution,11,5,6
Naeamen,dragonmaw,430,paladin,retribution,9,6,3
Ahzreal,garona,426,paladin,retribution,16,8,8
Regivän,azralon,426,paladin,retribution,12,6,6
Hálløwéð,firetree,426,paladin,retribution,14,6,8
Stankylordz,sargeras,426,paladin,retribution,19,8,11
Rashrind,moon-guard,426,paladin,retribution,23,8,15
Kimochiyuh,illidan,425,paladin,retribution,17,7,10
Ææøææøææøææø,illidan,416,paladin,retribution,10,5,5
Yemotis,emerald-dream,416,paladin,retribution,10,5,5
Stahny,thrall,415,paladin,retribution,10,5,5
Saviorsavior,bleeding-hollow,415,paladin,retribution,11,5,6
Artaxerxes,stormrage,415,paladin,retribution,14,5,9
Epxilon,ragnaros,415,paladin,retribution,14,5,9
Wrekkin,stormrage,415,paladin,retribution,14,5,9
Waffulzz,moonrunner,415,paladin,retribution,20,5,15
Insîght,frostmourne,414,paladin,retribution,16,5,11
Rainingrets,tichondrius,404,paladin,retribution,28,10,18
Thechoseno,tichondrius,400,paladin,retribution,13,5,8
Iamriched,illidan,400,paladin,retribution,13,5,8
Tinithis,tichondrius,399,paladin,retribution,5,5,0
Rspect,trollbane,399,paladin,retribution,5,5,0
Sydnneeyy,kelthuzad,399,paladin,retribution,5,5,0
Crithealss,dalaran,384,paladin,retribution,6,4,2
Laurenlight,tichondrius,384,paladin,retribution,6,4,2
Vxm,illidan,384,paladin,retribution,6,4,2
Thottylight,stormrage,384,paladin,retribution,6,4,2
Täintcrusher,illidan,384,paladin,retribution,6,4,2
Inquísítor,stormrage,384,paladin,retribution,6,4,2
Slakyph,zuljin,384,paladin,retribution,6,4,2
Bloodrefuge,tichondrius,384,paladin,retribution,6,4,2
Babylonfive,zuluhed,384,paladin,retribution,6,4,2
Dillysdilly,zuljin,384,paladin,retribution,6,4,2
Ðorlie,malganis,384,paladin,retribution,6,4,2
Pray,thunderlord,384,paladin,retribution,6,4,2
Daylit,proudmoore,384,paladin,retribution,6,4,2
Anaxxie,azralon,384,paladin,retribution,6,4,2
Tayvar,stormrage,384,paladin,retribution,6,4,2
Rohlin,boulderfist,384,paladin,retribution,6,4,2
Dwarfineas,dalaran,384,paladin,retribution,6,4,2
Nikho,thunderlord,384,paladin,retribution,6,4,2
Tiduz,tichondrius,384,paladin,retribution,6,4,2
Raphaelo,tichondrius,384,paladin,retribution,6,4,2
Carneguisada,sargeras,384,paladin,retribution,6,4,2
Eduardoap,azralon,384,paladin,retribution,6,4,2
Rhaegorn,drakkari,384,paladin,retribution,6,4,2
Aohxmathoss,zuljin,384,paladin,retribution,6,4,2
Saîntpaul,shattered-halls,384,paladin,retribution,6,4,2
Legèndaïry,tichondrius,384,paladin,retribution,6,4,2
Masemune,bonechewer,384,paladin,retribution,6,4,2
Thüridan,azralon,384,paladin,retribution,6,4,2
Pappablanco,stormrage,384,paladin,retribution,6,4,2
Goontaa,staghelm,384,paladin,retribution,6,4,2
Westee,stormrage,384,paladin,retribution,6,4,2
Dazztrain,barthilas,384,paladin,retribution,6,4,2
Sasukee,quelthalas,384,paladin,retribution,6,4,2
Baladine,zuljin,384,paladin,retribution,6,4,2
Butterbeanz,tanaris,384,paladin,retribution,6,4,2
Gilgamesh,moonrunner,384,paladin,retribution,6,4,2
Robo,tichondrius,384,paladin,retribution,6,4,2
Pennywenny,barthilas,384,paladin,retribution,6,4,2
Wyrmblood,moon-guard,384,paladin,retribution,6,4,2
Dörisseline,tichondrius,384,paladin,retribution,6,4,2
Souldrainlol,quelthalas,384,paladin,retribution,6,4,2
Crewsade,sargeras,384,paladin,retribution,6,4,2
Shïnjïtsu,tichondrius,384,paladin,retribution,6,4,2
Pallyalli,burning-blade,384,paladin,retribution,6,4,2
Invictus,onyxia,384,paladin,retribution,6,4,2
Saulhudson,bleeding-hollow,384,paladin,retribution,6,4,2
Reclusiarch,tichondrius,384,paladin,retribution,6,4,2
Kaypross,area-52,384,paladin,retribution,6,4,2
Thadrian,nazgrel,384,paladin,retribution,6,4,2
Seven,blackwing-lair,384,paladin,retribution,6,4,2
Awsem,barthilas,384,paladin,retribution,6,4,2
Bubblebùtt,tichondrius,384,paladin,retribution,6,4,2
Hellcallerl,quelthalas,384,paladin,retribution,6,4,2
Farlayne,quelthalas,384,paladin,retribution,6,4,2
Navex,tichondrius,384,paladin,retribution,6,4,2
Shadp,frostmourne,384,paladin,retribution,6,4,2
Easiestclass,azshara,384,paladin,retribution,6,4,2
Grinzin,azralon,384,paladin,retribution,6,4,2
Mightymagnus,silvermoon,384,paladin,retribution,6,4,2
Pallyjs,anetheron,384,paladin,retribution,6,4,2
Taiffan,azralon,384,paladin,retribution,6,4,2
Anstyl,moon-guard,384,paladin,retribution,6,4,2
Coffiecup,frostmane,384,paladin,retribution,6,4,2
Bübbleboy,malganis,384,paladin,retribution,6,4,2
Notaefc,icecrown,384,paladin,retribution,6,4,2
Èmmà,stormrage,384,paladin,retribution,6,4,2
Leoros,blackrock,384,paladin,retribution,6,4,2
Ironpallyx,garrosh,384,paladin,retribution,6,4,2
Bruxx,twisting-nether,384,paladin,retribution,6,4,2
Tifalockhart,dathremar,384,paladin,retribution,6,4,2
Wosy,azralon,384,paladin,retribution,6,4,2
Strattaltork,ragnaros,384,paladin,retribution,6,4,2
Cenital,quelthalas,384,paladin,retribution,6,4,2
Doç,stormrage,384,paladin,retribution,6,4,2
Åphrodite,bleeding-hollow,384,paladin,retribution,6,4,2
Icepondpal,proudmoore,384,paladin,retribution,6,4,2
Fâmed,tichondrius,384,paladin,retribution,6,4,2
Dinapal,frostmourne,384,paladin,retribution,6,4,2
Mystictoast,area-52,384,paladin,retribution,6,4,2
Temptrez,bleeding-hollow,384,paladin,retribution,6,4,2
Xöchïqüëtzäl,tichondrius,384,paladin,retribution,6,4,2
Crocfacex,tichondrius,384,paladin,retribution,6,4,2
Merlinä,illidan,384,paladin,retribution,6,4,2
Rexinarr,area-52,384,paladin,retribution,6,4,2
Yuliu,magtheridon,384,paladin,retribution,6,4,2
Khanid,emerald-dream,384,paladin,retribution,6,4,2
Redempshun,drenden,384,paladin,retribution,6,4,2
Gåbrîel,emerald-dream,384,paladin,retribution,6,4,2
Luluwu,stormrage,384,paladin,retribution,6,4,2
Daylin,tichondrius,384,paladin,retribution,6,4,2
Bübbleqt,exodar,384,paladin,retribution,6,4,2
Plottwists,bleeding-hollow,384,paladin,retribution,6,4,2
Limitier,proudmoore,384,paladin,retribution,6,4,2
Shirael,ragnaros,384,paladin,retribution,6,4,2
Chunggus,eredar,384,paladin,retribution,6,4,2
Bisket,illidan,384,paladin,retribution,6,4,2
Prôphêt,stormrage,384,paladin,retribution,6,4,2
Couraegus,azgalor,384,paladin,retribution,6,4,2
Fxxku,tichondrius,384,paladin,retribution,6,4,2
Illustrata,illidan,384,paladin,retribution,6,4,2
Darkestday,hellscream,384,paladin,retribution,6,4,2
Minikalina,ragnaros,384,paladin,retribution,6,4,2
Ascencer,spirestone,384,paladin,retribution,6,4,2
Trisøn,area-52,384,paladin,retribution,6,4,2
Laventus,area-52,384,paladin,retribution,6,4,2
Sunraiz,tichondrius,384,paladin,retribution,6,4,2
Cratt,chromaggus,384,paladin,retribution,6,4,2
Reckoniing,moon-guard,384,paladin,retribution,6,4,2
Silreck,ragnaros,384,paladin,retribution,6,4,2
Cobaine,illidan,384,paladin,retribution,6,4,2
Bigddady,quelthalas,384,paladin,retribution,8,4,4
Thõre,frostmourne,384,paladin,retribution,15,5,10
Greenracer,kiljaeden,384,paladin,retribution,12,4,8
Andromëdä,hyjal,384,paladin,retribution,12,4,8
Ibull,stormscale,384,paladin,retribution,12,4,8
Varuul,nerzhul,384,paladin,retribution,12,4,8
Oppaladin,elune,384,paladin,retribution,12,4,8
Zøzø,zuljin,384,paladin,retribution,12,4,8
Tomcat,bladefist,384,paladin,retribution,12,4,8
Bracen,emerald-dream,384,paladin,retribution,12,4,8
Whoowhat,zuljin,384,paladin,retribution,12,4,8
Phattpump,tichondrius,384,paladin,retribution,12,4,8
Ridethispony,tichondrius,384,paladin,retribution,12,4,8
Dohsevèn,tichondrius,384,paladin,retribution,12,4,8
Aricen,thunderhorn,384,paladin,retribution,12,4,8
Humbubble,cairne,384,paladin,retribution,12,4,8
Ddawz,proudmoore,384,paladin,retribution,12,4,8
Delukk,azralon,384,paladin,retribution,12,4,8
Mikeelul,tichondrius,384,paladin,retribution,12,4,8
Aewynn,nemesis,384,paladin,retribution,12,4,8
Dmghack,tichondrius,384,paladin,retribution,12,4,8
Botch,drenden,384,paladin,retribution,12,4,8
Krypton,tichondrius,384,paladin,retribution,12,4,8
Inareus,agamaggan,384,paladin,retribution,12,4,8
Jimxeung,tichondrius,384,paladin,retribution,12,4,8
Goloh,shadowmoon,384,paladin,retribution,12,4,8
Roodictz,zuljin,384,paladin,retribution,12,4,8
Kratosq,tichondrius,384,paladin,retribution,12,4,8
Veshral,arthas,384,paladin,retribution,12,4,8
Tëmplar,bleeding-hollow,384,paladin,retribution,12,4,8
Remm,emerald-dream,384,paladin,retribution,12,4,8
Zexion,azralon,384,paladin,retribution,12,4,8
Illhaveacoke,moon-guard,384,paladin,retribution,12,4,8
Simpforomenx,emerald-dream,384,paladin,retribution,12,4,8
Kamianna,tichondrius,384,paladin,retribution,12,4,8
Sethy,feathermoon,384,paladin,retribution,12,4,8
Icekiss,tichondrius,384,paladin,retribution,12,4,8
Eettooko,aegwynn,384,paladin,retribution,12,4,8
Lunchboxz,nazjatar,384,paladin,retribution,12,4,8
Adapa,azralon,384,paladin,retribution,12,4,8
Lépéedophil,zuljin,384,paladin,retribution,12,4,8
Vynlorderan,area-52,384,paladin,retribution,12,4,8
Corrán,thrall,384,paladin,retribution,12,4,8
Kurook,moon-guard,384,paladin,retribution,12,4,8
Baptism,shattered-hand,384,paladin,retribution,12,4,8
Harke,drakkari,384,paladin,retribution,12,4,8
Kyrianjutsu,area-52,384,paladin,retribution,12,4,8
Lokkillos,drakkari,384,paladin,retribution,12,4,8
Hrrothgar,muradin,384,paladin,retribution,12,4,8
Dezul,stormscale,384,paladin,retribution,12,4,8
Tufybighamer,malganis,384,paladin,retribution,12,4,8
Petunias,malganis,384,paladin,retribution,12,4,8
Roländ,thrall,384,paladin,retribution,12,4,8
Holyflopper,malganis,384,paladin,retribution,12,4,8
Korijame,area-52,384,paladin,retribution,12,4,8
Glexann,sargeras,384,paladin,retribution,12,4,8
Blackmuu,malganis,384,paladin,retribution,12,4,8
Hisenberg,drakkari,384,paladin,retribution,12,4,8
Strugglèbus,thrall,384,paladin,retribution,12,4,8
Simonis,windrunner,384,paladin,retribution,12,4,8
Volphorix,illidan,384,paladin,retribution,12,4,8
Oroürke,stormrage,384,paladin,retribution,12,4,8
Dionysius,silvermoon,384,paladin,retribution,12,4,8
Crazysyco,proudmoore,384,paladin,retribution,12,4,8
Sahbabii,baelgun,384,paladin,retribution,12,4,8
Catuvalos,kiljaeden,384,paladin,retribution,12,4,8
Rusticles,aerie-peak,384,paladin,retribution,12,4,8
Lightahean,proudmoore,384,paladin,retribution,12,4,8
Grimmune,illidan,384,paladin,retribution,12,4,8
Juliusplzher,area-52,384,paladin,retribution,12,4,8
Pallyforeva,sargeras,384,paladin,retribution,12,4,8
Ippótis,sargeras,384,paladin,retribution,12,4,8
Holladrik,frostmourne,384,paladin,retribution,12,4,8
Sixty,sargeras,384,paladin,retribution,12,4,8
Uholypala,dalaran,384,paladin,retribution,12,4,8
Adauto,illidan,384,paladin,retribution,12,4,8
Aidillon,shadowsong,384,paladin,retribution,12,4,8
Drakensang,tichondrius,384,paladin,retribution,12,4,8
Senion,velen,384,paladin,retribution,12,4,8
Vhaun,cairne,384,paladin,retribution,12,4,8
Sigmapepe,quelthalas,384,paladin,retribution,12,4,8
Eddf,ursin,384,paladin,retribution,12,4,8
Grimdel,moon-guard,384,paladin,retribution,12,4,8
Leail,frostmourne,384,paladin,retribution,12,4,8
Picorii,frostmourne,384,paladin,retribution,12,4,8
Kreigvar,moon-guard,384,paladin,retribution,12,4,8
Heavener,tichondrius,384,paladin,retribution,12,4,8
Lânnâ,tichondrius,384,paladin,retribution,12,4,8
Àpolo,stormrage,384,paladin,retribution,12,4,8
Givinpowpows,korgath,384,paladin,retribution,12,4,8
Wards,thunderlord,384,paladin,retribution,12,4,8
Mashy,moon-guard,384,paladin,retribution,12,4,8
Dose,moon-guard,384,paladin,retribution,12,4,8
Gripadin,tichondrius,384,paladin,retribution,12,4,8
Blikzy,caelestrasz,384,paladin,retribution,12,4,8
Andrevz,ragnaros,384,paladin,retribution,12,4,8
Kiami,tichondrius,384,paladin,retribution,12,4,8
Theril,kelthuzad,384,paladin,retribution,12,4,8
Taelpalx,stormrage,384,paladin,retribution,12,4,8
Crystahlmeth,sargeras,384,paladin,retribution,12,4,8
Msjudged,blackrock,384,paladin,retribution,12,4,8
Adrn,tichondrius,384,paladin,retribution,12,4,8
Returdstrenf,illidan,384,paladin,retribution,12,4,8
Fragnum,barthilas,384,paladin,retribution,12,4,8
Ajulgedang,frostmourne,384,paladin,retribution,12,4,8
Jeddmaus,tichondrius,384,paladin,retribution,12,4,8
Hrizul,drakthul,384,paladin,retribution,12,4,8
Retspec,darkspear,384,paladin,retribution,12,4,8
Lenneth,nordrassil,384,paladin,retribution,12,4,8
Elflicious,illidan,384,paladin,retribution,12,4,8
Prettylightx,kelthuzad,384,paladin,retribution,12,4,8
Rocknpally,icecrown,384,paladin,retribution,12,4,8
Toxanator,frostmourne,384,paladin,retribution,12,4,8
Clariten,ghostlands,384,paladin,retribution,12,4,8
Niolite,ragnaros,384,paladin,retribution,12,4,8
Jimithing,senjin,384,paladin,retribution,12,4,8
Akiralons,ragnaros,384,paladin,retribution,12,4,8
Thaleros,tichondrius,384,paladin,retribution,12,4,8
Moltensilver,emerald-dream,384,paladin,retribution,12,4,8
Rightz,muradin,384,paladin,retribution,12,4,8
Smöke,frostmourne,384,paladin,retribution,12,4,8
Jade,black-dragonflight,384,paladin,retribution,12,4,8
Retneyspears,darkspear,384,paladin,retribution,12,4,8
Smontis,sargeras,384,paladin,retribution,12,4,8
Landryy,icecrown,384,paladin,retribution,12,4,8
Blargnarg,area-52,384,paladin,retribution,12,4,8
Bauldrin,moon-guard,384,paladin,retribution,12,4,8
Billystacks,illidan,384,paladin,retribution,12,4,8
Roundbutts,stormrage,384,paladin,retribution,12,4,8
Acquiesce,bleeding-hollow,384,paladin,retribution,16,5,11
Batmanp,quelthalas,384,paladin,retribution,13,4,9
Talurius,azralon,384,paladin,retribution,18,4,14
Tylnish,hyjal,384,paladin,retribution,18,4,14
Draknals,illidan,384,paladin,retribution,18,4,14
Ccpx,area-52,384,paladin,retribution,18,4,14
Powercelest,quelthalas,384,paladin,retribution,18,4,14
Theadona,runetotem,384,paladin,retribution,18,4,14
Indemnity,wildhammer,384,paladin,retribution,18,4,14
Hupa,crushridge,384,paladin,retribution,18,4,14
Essexqt,blackhand,384,paladin,retribution,18,4,14
Ongang,illidan,384,paladin,retribution,18,4,14
Caityaj,illidan,384,paladin,retribution,18,4,14
Malisaa,tichondrius,384,paladin,retribution,18,4,14
Chuizz,frostmourne,384,paladin,retribution,18,4,14
Mhakoi,bleeding-hollow,384,paladin,retribution,24,4,20
Iskándar,tichondrius,384,paladin,retribution,24,4,20
Hasla,tichondrius,384,paladin,retribution,24,4,20
Backfattammy,bleeding-hollow,384,paladin,retribution,24,4,20
Dabsmaster,dalaran,383,paladin,retribution,6,4,2
Pajjy,azralon,383,paladin,retribution,6,4,2
Sinficha,quelthalas,383,paladin,retribution,6,4,2
Themachon,stormrage,383,paladin,retribution,6,4,2
Brandforge,thunderlord,383,paladin,retribution,6,4,2
Mooroy,moon-guard,383,paladin,retribution,12,4,8
Kennysun,azralon,383,paladin,retribution,12,4,8
Holyqt,thunderlord,383,paladin,retribution,12,4,8
Ginwow,hakkar,383,paladin,retribution,12,4,8
Øexørcistta,nemesis,383,paladin,retribution,12,4,8
Hølydiver,rivendare,383,paladin,retribution,12,4,8
Holyburger,hakkar,383,paladin,retribution,12,4,8
Piojopaladin,quelthalas,383,paladin,retribution,13,4,9
Scyni,kelthuzad,383,paladin,retribution,13,4,9
Balnot,blackrock,383,paladin,retribution,18,4,14
Funkknight,sargeras,383,paladin,retribution,18,4,14
Hadrianus,azralon,383,paladin,retribution,24,4,20
Kenbad,aegwynn,382,paladin,retribution,6,4,2
Lailaa,balnazzar,382,paladin,retribution,12,4,8
Derpnstein,gorgonnash,382,paladin,retribution,12,4,8
Slædgæhæmmær,bonechewer,382,paladin,retribution,18,4,14
Caitlyn,nazjatar,381,paladin,retribution,12,4,8
Sparklepuss,turalyon,379,paladin,retribution,12,4,8
Amerok,malfurion,378,paladin,retribution,18,4,14
Novachrono,bladefist,367,paladin,retribution,9,5,4
Barzø,tichondrius,367,paladin,retribution,11,4,7
Mèdic,illidan,367,paladin,retribution,11,4,7
Goinglarge,frostmourne,367,paladin,retribution,11,4,7
Rétribution,farstriders,367,paladin,retribution,11,4,7
Crucifine,wyrmrest-accord,367,paladin,retribution,11,4,7
Kegmight,emerald-dream,367,paladin,retribution,17,4,13
Mop,eitrigg,367,paladin,retribution,17,4,13
Ssggk,proudmoore,366,paladin,retribution,11,4,7
Bibimbop,boulderfist,352,paladin,retribution,13,5,8
Gordonryan,bleeding-hollow,352,paladin,retribution,16,4,12
Páladian,quelthalas,351,paladin,retribution,11,4,7
Bruujqt,moon-guard,336,paladin,retribution,9,5,4
Titansnake,illidan,336,paladin,retribution,9,4,5
Meduselda,kelthuzad,335,paladin,retribution,9,5,4
Ethernaly,quelthalas,335,paladin,retribution,11,4,7
Kaallell,blackhand,329,paladin,retribution,16,5,11
Asolace,dark-iron,320,paladin,retribution,10,4,6
Wellowar,moon-guard,320,paladin,retribution,10,4,6
Junmá,tichondrius,319,paladin,retribution,5,4,1
Ruulight,tichondrius,319,paladin,retribution,5,4,1
Holyshasha,tichondrius,319,paladin,retribution,8,4,4
Karig,sargeras,319,paladin,retribution,8,4,4
Jadelong,azshara,319,paladin,retribution,8,4,4
Jnxzster,sargeras,319,paladin,retribution,8,4,4
Gryphin,moon-guard,319,paladin,retribution,8,4,4
Holynaps,malganis,319,paladin,retribution,9,4,5
Darkjewmagic,frostmourne,319,paladin,retribution,14,4,10
Torrthak,area-52,304,paladin,retribution,7,4,3
Pipay,proudmoore,288,paladin,retribution,6,3,3
Palinator,bleeding-hollow,288,paladin,retribution,6,3,3
Zakh,proudmoore,288,paladin,retribution,6,3,3
Rickadin,bleeding-hollow,288,paladin,retribution,6,3,3
Moox,wyrmrest-accord,288,paladin,retribution,6,3,3
Lomis,azgalor,288,paladin,retribution,6,3,3
Judgem,tichondrius,288,paladin,retribution,6,3,3
Shakemup,stormrage,288,paladin,retribution,6,3,3
Eleonorr,proudmoore,288,paladin,retribution,6,3,3
Kanachi,bleeding-hollow,288,paladin,retribution,6,3,3
Bíteme,sargeras,288,paladin,retribution,6,3,3
Coldverdict,tichondrius,288,paladin,retribution,6,3,3
Evelimash,bloodhoof,288,paladin,retribution,6,3,3
Borisdablade,bleeding-hollow,288,paladin,retribution,6,3,3
Svenn,eredar,288,paladin,retribution,6,3,3
Basstian,bleeding-hollow,288,paladin,retribution,6,3,3
Brahlix,area-52,288,paladin,retribution,6,3,3
Shibbz,illidan,288,paladin,retribution,6,3,3
Daigorro,illidan,288,paladin,retribution,6,3,3
Halnarran,area-52,288,paladin,retribution,6,3,3
Senisse,illidan,288,paladin,retribution,6,3,3
Purekiller,destromath,288,paladin,retribution,6,3,3
Everith,bleeding-hollow,288,paladin,retribution,6,3,3
Imposstopzc,chogall,288,paladin,retribution,6,3,3
Layson,uldum,288,paladin,retribution,6,3,3
Yugawn,maiev,288,paladin,retribution,6,3,3
Justsaiyen,bleeding-hollow,288,paladin,retribution,6,3,3
Konyfotm,bleeding-hollow,288,paladin,retribution,6,3,3
Astasia,laughing-skull,288,paladin,retribution,6,3,3
Ankhz,area-52,288,paladin,retribution,6,3,3
Pemodyne,illidan,288,paladin,retribution,6,3,3
Syvir,area-52,288,paladin,retribution,6,3,3
Sinhero,area-52,288,paladin,retribution,6,3,3
Varo,laughing-skull,288,paladin,retribution,6,3,3
Sâbër,moon-guard,288,paladin,retribution,6,3,3
Kahleesy,sargeras,288,paladin,retribution,6,3,3
Bigboytime,area-52,288,paladin,retribution,6,3,3
Bubblet,bleeding-hollow,288,paladin,retribution,6,3,3
Nhanless,tichondrius,288,paladin,retribution,6,3,3
Karwryn,magtheridon,288,paladin,retribution,6,3,3
Selivara,zuljin,288,paladin,retribution,6,3,3
Nerfretpls,area-52,288,paladin,retribution,6,3,3
Warchaos,skullcrusher,288,paladin,retribution,6,3,3
Ironboxer,tichondrius,288,paladin,retribution,6,3,3
Sóláris,moon-guard,288,paladin,retribution,6,3,3
Potatopasta,area-52,288,paladin,retribution,6,3,3
Finnthepally,proudmoore,288,paladin,retribution,6,3,3
Lasonil,zuljin,288,paladin,retribution,6,3,3
Valadinna,tichondrius,288,paladin,retribution,6,3,3
Nalenne,alexstrasza,288,paladin,retribution,6,3,3
Mòse,emerald-dream,288,paladin,retribution,6,3,3
Krackanut,kelthuzad,288,paladin,retribution,6,3,3
Leá,illidan,288,paladin,retribution,6,3,3
Buttflapster,proudmoore,288,paladin,retribution,6,3,3
Vynlen,uldaman,288,paladin,retribution,6,3,3
Danks,arthas,288,paladin,retribution,6,3,3
Itzon,proudmoore,288,paladin,retribution,6,3,3
Scamadin,tichondrius,288,paladin,retribution,6,3,3
Reiot,sargeras,288,paladin,retribution,6,3,3
Dfz,mannoroth,288,paladin,retribution,6,3,3
Vük,destromath,288,paladin,retribution,6,3,3
Kegman,thrall,288,paladin,retribution,6,3,3
Taynos,tichondrius,288,paladin,retribution,6,3,3
Nickotines,kelthuzad,288,paladin,retribution,6,3,3
Barbesacrer,zuljin,288,paladin,retribution,6,3,3
Camcam,thrall,288,paladin,retribution,6,3,3
Reallyfe,skullcrusher,288,paladin,retribution,6,3,3
Timu,suramar,288,paladin,retribution,6,3,3
Jeffprobstt,kelthuzad,288,paladin,retribution,6,3,3
Kloernstarr,sargeras,288,paladin,retribution,6,3,3
Rectaluse,dalaran,288,paladin,retribution,6,3,3
Pvar,stormrage,288,paladin,retribution,6,3,3
Brodyb,malganis,288,paladin,retribution,6,3,3
Tadaki,dalaran,288,paladin,retribution,6,3,3
Kyperion,stormrage,288,paladin,retribution,6,3,3
Supreme,farstriders,288,paladin,retribution,6,3,3
Mohrdeth,bonechewer,288,paladin,retribution,6,3,3
Misbah,stormrage,288,paladin,retribution,6,3,3
Doogo,cenarius,288,paladin,retribution,6,3,3
Apocryphx,stormrage,288,paladin,retribution,6,3,3
Berapal,tichondrius,288,paladin,retribution,6,3,3
Uver,tichondrius,288,paladin,retribution,6,3,3
Zeroret,tichondrius,288,paladin,retribution,6,3,3
Xbertiize,tichondrius,288,paladin,retribution,6,3,3
Mcfleye,malganis,288,paladin,retribution,6,3,3
Morlunè,tichondrius,288,paladin,retribution,6,3,3
Assaultron,dalaran,288,paladin,retribution,6,3,3
Zoroastrø,azralon,288,paladin,retribution,6,3,3
Pirofosfato,azralon,288,paladin,retribution,6,3,3
Merphy,tichondrius,288,paladin,retribution,6,3,3
Gloryholy,shattered-hand,288,paladin,retribution,6,3,3
Zugzorr,azralon,288,paladin,retribution,6,3,3
Freiror,azralon,288,paladin,retribution,6,3,3
Beepsmash,executus,288,paladin,retribution,6,3,3
Shaktii,ragnaros,288,paladin,retribution,6,3,3
Kôld,tichondrius,288,paladin,retribution,6,3,3
Lawdeedawh,tichondrius,288,paladin,retribution,6,3,3
Stamptime,emerald-dream,288,paladin,retribution,6,3,3
Marof,spirestone,288,paladin,retribution,6,3,3
Sadamell,tichondrius,288,paladin,retribution,6,3,3
Mvpp,dalaran,288,paladin,retribution,6,3,3
Boladosx,azralon,288,paladin,retribution,6,3,3
Avataar,blades-edge,288,paladin,retribution,6,3,3
Xupalaa,azralon,288,paladin,retribution,6,3,3
Theßest,baelgun,288,paladin,retribution,6,3,3
Dráugus,azralon,288,paladin,retribution,6,3,3
Bigdamham,tichondrius,288,paladin,retribution,6,3,3
Cocodog,kiljaeden,288,paladin,retribution,6,3,3
Lituation,sargeras,288,paladin,retribution,6,3,3
Bigdumpy,thaurissan,288,paladin,retribution,6,3,3
Menjo,malganis,288,paladin,retribution,6,3,3
Ýøg,tichondrius,288,paladin,retribution,6,3,3
Lêggy,moon-guard,288,paladin,retribution,6,3,3
Orangepa,dalaran,288,paladin,retribution,6,3,3
Hypheríon,ragnaros,288,paladin,retribution,6,3,3
Milkmemamma,nordrassil,288,paladin,retribution,6,3,3
Tyronethebbc,tichondrius,288,paladin,retribution,6,3,3
Nussaar,kelthuzad,288,paladin,retribution,6,3,3
Hybrix,tichondrius,288,paladin,retribution,6,3,3
Pauliss,sargeras,288,paladin,retribution,6,3,3
Edjr,stormrage,288,paladin,retribution,6,3,3
Bootacious,tichondrius,288,paladin,retribution,6,3,3
Vincentnero,runetotem,288,paladin,retribution,6,3,3
Wálker,ragnaros,288,paladin,retribution,6,3,3
Mki,kargath,288,paladin,retribution,6,3,3
Nohtu,quelthalas,288,paladin,retribution,6,3,3
Àxçël,hyjal,288,paladin,retribution,6,3,3
Gstbubble,hyjal,288,paladin,retribution,6,3,3
Varezion,vashj,288,paladin,retribution,6,3,3
Deadlyskills,arathor,288,paladin,retribution,6,3,3
Snippdeux,garrosh,288,paladin,retribution,6,3,3
Chiraqret,thunderhorn,288,paladin,retribution,6,3,3
Jojoboskies,aegwynn,288,paladin,retribution,6,3,3
Retsuxks,twisting-nether,288,paladin,retribution,6,3,3
Holyham,bonechewer,288,paladin,retribution,6,3,3
Nevanethus,frostmourne,288,paladin,retribution,6,3,3
Gapingpooter,shadowmoon,288,paladin,retribution,6,3,3
Shockdoctor,stormrage,288,paladin,retribution,6,3,3
Aëriy,moon-guard,288,paladin,retribution,6,3,3
Ulfsark,garrosh,288,paladin,retribution,6,3,3
Darthalion,quelthalas,288,paladin,retribution,6,3,3
Akain,tichondrius,288,paladin,retribution,6,3,3
Zercker,ragnaros,288,paladin,retribution,6,3,3
Rost,jaedenar,288,paladin,retribution,6,3,3
Beato,silvermoon,288,paladin,retribution,6,3,3
Jónò,tichondrius,288,paladin,retribution,6,3,3
Ximenita,ragnaros,288,paladin,retribution,6,3,3
Holyshrekt,frostmourne,288,paladin,retribution,6,3,3
Cairdk,ragnaros,288,paladin,retribution,6,3,3
Tisu,kiljaeden,288,paladin,retribution,6,3,3
Hadory,shattered-halls,288,paladin,retribution,6,3,3
Urpi,drakkari,288,paladin,retribution,6,3,3
Lencelia,deathwing,288,paladin,retribution,6,3,3
Dominance,blackrock,288,paladin,retribution,6,3,3
Lorainn,ragnaros,288,paladin,retribution,6,3,3
Funk,sargeras,288,paladin,retribution,6,3,3
Meith,ragnaros,288,paladin,retribution,6,3,3
Runebane,doomhammer,288,paladin,retribution,6,3,3
Flareous,moon-guard,288,paladin,retribution,6,3,3
Zenpally,doomhammer,288,paladin,retribution,6,3,3
Principe,queldorei,288,paladin,retribution,6,3,3
Nâtion,cenarius,288,paladin,retribution,6,3,3
Bleeked,emerald-dream,288,paladin,retribution,6,3,3
Kithrah,dathremar,288,paladin,retribution,6,3,3
Elri,ragnaros,288,paladin,retribution,6,3,3
Pahlevahn,stormrage,288,paladin,retribution,6,3,3
Luxuriousman,fizzcrank,288,paladin,retribution,6,3,3
Bigdmcgee,frostmourne,288,paladin,retribution,6,3,3
Rebelion,nagrand,288,paladin,retribution,6,3,3
Otame,quelthalas,288,paladin,retribution,6,3,3
Ulrìck,quelthalas,288,paladin,retribution,6,3,3
Nyxkithar,nagrand,288,paladin,retribution,6,3,3
Transwoman,frostmourne,288,paladin,retribution,6,3,3
Dev,frostwolf,288,paladin,retribution,6,3,3
Jestiny,amanthul,288,paladin,retribution,6,3,3
Obbzz,spirestone,288,paladin,retribution,6,3,3
Thortanous,icecrown,288,paladin,retribution,9,4,5
Hermacles,stormrage,288,paladin,retribution,7,3,4
Ivanko,dalaran,288,paladin,retribution,7,3,4
Xanaxlol,sargeras,288,paladin,retribution,10,4,6
Retattack,area-52,288,paladin,retribution,10,4,6
Asukaxt,illidan,288,paladin,retribution,12,3,9
Wälly,garona,288,paladin,retribution,12,3,9
Ucvnt,illidan,288,paladin,retribution,12,3,9
Gashlycrumb,tichondrius,288,paladin,retribution,12,3,9
Jafbe,mugthol,288,paladin,retribution,12,3,9
Gingibeno,tichondrius,288,paladin,retribution,12,3,9
Boopif,sargeras,288,paladin,retribution,12,3,9
Tíron,dalaran,288,paladin,retribution,12,3,9
Olorunn,tichondrius,288,paladin,retribution,12,3,9
Wasabipal,malganis,288,paladin,retribution,12,3,9
Vaaleria,dalaran,288,paladin,retribution,12,3,9
Bigplucker,kelthuzad,288,paladin,retribution,12,3,9
Donsagrado,quelthalas,288,paladin,retribution,12,3,9
Yeluh,malganis,288,paladin,retribution,12,3,9
Vanas,stormrage,288,paladin,retribution,12,3,9
Lungjuice,stormrage,288,paladin,retribution,12,3,9
Grindlimg,dalaran,288,paladin,retribution,12,3,9
Baconsock,kelthuzad,288,paladin,retribution,12,3,9
Bubblebooty,drakthul,288,paladin,retribution,12,3,9
Hahe,tichondrius,288,paladin,retribution,12,3,9
Quelite,sargeras,288,paladin,retribution,12,3,9
Chetmorton,emerald-dream,288,paladin,retribution,12,3,9
Tolleytrain,malganis,288,paladin,retribution,12,3,9
Cromsecrate,dalaran,288,paladin,retribution,12,3,9
Aenwyl,quelthalas,288,paladin,retribution,12,3,9
Dalden,trollbane,288,paladin,retribution,12,3,9
Palâdin,zuljin,288,paladin,retribution,12,3,9
Dárkness,blades-edge,288,paladin,retribution,12,3,9
Corni,kiljaeden,288,paladin,retribution,12,3,9
Geekpala,thrall,288,paladin,retribution,12,3,9
Marrike,moon-guard,288,paladin,retribution,12,3,9
Koltar,stormrage,288,paladin,retribution,12,3,9
Ultrah,area-52,288,paladin,retribution,12,3,9
Kuoch,shandris,288,paladin,retribution,12,3,9
Lue,boulderfist,288,paladin,retribution,12,3,9
Walkerbait,nazgrel,288,paladin,retribution,12,3,9
Spiritkeep,veknilash,288,paladin,retribution,12,3,9
Johnus,lightbringer,288,paladin,retribution,12,3,9
Dävis,ragnaros,288,paladin,retribution,12,3,9
Claudleon,drakkari,288,paladin,retribution,12,3,9
Bulbi,emerald-dream,288,paladin,retribution,12,3,9
Uzbadkhazad,ragnaros,288,paladin,retribution,12,3,9
Nik,the-underbog,288,paladin,retribution,12,3,9
Jontapally,stormrage,288,paladin,retribution,12,3,9
Rxxkiee,tichondrius,288,paladin,retribution,12,3,9
Thnannan,tichondrius,288,paladin,retribution,12,3,9
ßén,bleeding-hollow,288,paladin,retribution,12,3,9
Amega,bleeding-hollow,288,paladin,retribution,12,3,9
Sàber,tichondrius,288,paladin,retribution,12,3,9
Troyamat,nemesis,288,paladin,retribution,12,3,9
Calvary,stormscale,288,paladin,retribution,12,3,9
Sessybrexy,bleeding-hollow,288,paladin,retribution,12,3,9
Oilme,bleeding-hollow,288,paladin,retribution,12,3,9
Madworld,moon-guard,288,paladin,retribution,12,3,9
Unspankable,burning-legion,288,paladin,retribution,12,3,9
Säv,tichondrius,288,paladin,retribution,12,3,9
Homeboywill,hyjal,288,paladin,retribution,12,3,9
Flashstark,area-52,288,paladin,retribution,12,3,9
Tarkovkappa,illidan,288,paladin,retribution,12,3,9
Sivan,crushridge,288,paladin,retribution,12,3,9
Kreigan,hellscream,288,paladin,retribution,12,3,9
Aeltharix,blackwater-raiders,288,paladin,retribution,12,3,9
Mwanmwa,blades-edge,288,paladin,retribution,12,3,9
Kadabrak,area-52,288,paladin,retribution,12,3,9
Bigjoetheceo,mannoroth,288,paladin,retribution,12,3,9
Pallypòwer,garrosh,288,paladin,retribution,12,3,9
Smokeys,sargeras,288,paladin,retribution,12,3,9
Dragonbait,khadgar,288,paladin,retribution,12,3,9
Eljosco,nordrassil,288,paladin,retribution,12,3,9
Slania,area-52,288,paladin,retribution,12,3,9
Kaorah,drakkari,288,paladin,retribution,12,3,9
Aduynn,tichondrius,288,paladin,retribution,12,3,9
Ðeathguise,ysera,288,paladin,retribution,12,3,9
Paladatrox,ragnaros,288,paladin,retribution,12,3,9
Zaeris,proudmoore,288,paladin,retribution,12,3,9
Hardclimacks,frostmourne,288,paladin,retribution,12,3,9
Brutaldeath,area-52,288,paladin,retribution,12,3,9
Kentö,area-52,288,paladin,retribution,12,3,9
Fknnoath,frostmourne,288,paladin,retribution,12,3,9
Treezey,durotan,288,paladin,retribution,12,3,9
Leronos,zuljin,288,paladin,retribution,12,3,9
Theodrei,darrowmere,288,paladin,retribution,12,3,9
Varthinator,stormrage,288,paladin,retribution,12,3,9
Elpal,thrall,288,paladin,retribution,12,3,9
Kelleybelly,black-dragonflight,288,paladin,retribution,13,3,10
Fourchon,tichondrius,288,paladin,retribution,18,3,15
Pepepally,area-52,288,paladin,retribution,18,3,15
Bullworm,ragnaros,288,paladin,retribution,18,3,15
Divinedabs,stormrage,288,paladin,retribution,18,3,15
Whangsta,tichondrius,288,paladin,retribution,24,3,21
Iralyn,frostmane,287,paladin,retribution,6,3,3
Sweetpally,moonrunner,287,paladin,retribution,6,3,3
Kimbr,gallywix,287,paladin,retribution,6,3,3
Matøs,stormrage,287,paladin,retribution,6,3,3
Covidxlx,hakkar,287,paladin,retribution,6,3,3
Dragollias,anvilmar,287,paladin,retribution,12,3,9
Níka,turalyon,287,paladin,retribution,12,3,9
Reathe,llane,287,paladin,retribution,12,3,9
Laylee,anvilmar,287,paladin,retribution,12,3,9
Cruz,silver-hand,286,paladin,retribution,12,3,9
Hukah,darkspear,286,paladin,retribution,18,3,15
Milkmi,frostmourne,271,paladin,retribution,11,3,8
Ronatiú,tichondrius,271,paladin,retribution,11,3,8
Feelmenu,deathwing,271,paladin,retribution,11,3,8
Ôv,norgannon,256,paladin,retribution,4,4,0
Gabrielú,lightninghoof,256,paladin,retribution,10,3,7
Logaen,stormrage,256,paladin,retribution,16,3,13
Gusset,tichondrius,255,paladin,retribution,8,4,4
Wunderbread,dalaran,255,paladin,retribution,11,3,8
Lorgax,alterac-mountains,240,paladin,retribution,9,3,6
Fulgal,jubeithos,240,paladin,retribution,9,3,6
Helberth,stormrage,239,paladin,retribution,5,3,2
Sôsaboy,tichondrius,239,paladin,retribution,5,3,2
Badmix,tichondrius,239,paladin,retribution,5,3,2
Narthres,drakkari,239,paladin,retribution,5,3,2
Palitard,tichondrius,234,paladin,retribution,7,5,2
Swiftysh,ragnaros,234,paladin,retribution,9,4,5
Stinkystan,korgath,234,paladin,retribution,10,4,6
Filoz,ragnaros,234,paladin,retribution,17,5,12
Wainkywink,malganis,234,paladin,retribution,15,4,11
Livalil,chogall,224,paladin,retribution,16,3,13
Wabukis,twisting-nether,223,paladin,retribution,8,3,5
Argonis,shadowsong,223,paladin,retribution,8,3,5
Flynnee,illidan,223,paladin,retribution,8,3,5
Ráky,quelthalas,223,paladin,retribution,14,3,11
Moistsaiyan,blood-furnace,206,paladin,retribution,7,3,4
Keegân,area-52,192,paladin,retribution,4,3,1
Zhspeilian,tichondrius,192,paladin,retribution,11,4,7
Anonymvs,eredar,192,paladin,retribution,9,3,6
Achalius,queldorei,192,paladin,retribution,6,2,4
Moshio,nagrand,192,paladin,retribution,6,2,4
Whyurunning,area-52,192,paladin,retribution,6,2,4
Blessinofsac,nagrand,192,paladin,retribution,6,2,4
Cyliex,illidan,192,paladin,retribution,6,2,4
Issac,tichondrius,192,paladin,retribution,6,2,4
Diänë,ragnaros,192,paladin,retribution,6,2,4
Tyrack,ragnaros,192,paladin,retribution,6,2,4
Roity,proudmoore,192,paladin,retribution,6,2,4
Helioos,stormrage,192,paladin,retribution,6,2,4
Sgtskittles,aggramar,192,paladin,retribution,6,2,4
Outofholy,stormrage,192,paladin,retribution,6,2,4
Vengx,sargeras,192,paladin,retribution,6,2,4
Abivion,stormrage,192,paladin,retribution,6,2,4
Paladam,burning-blade,192,paladin,retribution,6,2,4
Trê,sargeras,192,paladin,retribution,6,2,4
Pushabuton,illidan,192,paladin,retribution,6,2,4
Pallypallyy,aerie-peak,192,paladin,retribution,6,2,4
Ret,onyxia,192,paladin,retribution,6,2,4
Ðuel,area-52,192,paladin,retribution,6,2,4
Felkor,caelestrasz,192,paladin,retribution,6,2,4
Haznthley,proudmoore,192,paladin,retribution,6,2,4
Holypumper,moon-guard,192,paladin,retribution,6,2,4
Legionret,thrall,192,paladin,retribution,6,2,4
Vindified,tichondrius,192,paladin,retribution,6,2,4
Farvadin,illidan,192,paladin,retribution,6,2,4
Réalg,area-52,192,paladin,retribution,6,2,4
Angelscrÿ,stormrage,192,paladin,retribution,6,2,4
Blastoise,drakkari,192,paladin,retribution,6,2,4
Joepepperoni,korgath,192,paladin,retribution,6,2,4
Inexcusable,wyrmrest-accord,192,paladin,retribution,6,2,4
Ezekìël,tichondrius,192,paladin,retribution,6,2,4
Ordinary,greymane,192,paladin,retribution,6,2,4
Juanvaldez,muradin,192,paladin,retribution,6,2,4
Tôhru,ragnaros,192,paladin,retribution,6,2,4
Disastroùs,frostmourne,192,paladin,retribution,6,2,4
Kanyewes,zuluhed,192,paladin,retribution,6,2,4
Xavorn,illidan,192,paladin,retribution,6,2,4
Gasunits,stormrage,192,paladin,retribution,6,2,4
Durotar,ragnaros,192,paladin,retribution,6,2,4
Majinpal,illidan,192,paladin,retribution,6,2,4
Ríf,sargeras,192,paladin,retribution,6,2,4
Octí,quelthalas,192,paladin,retribution,6,2,4
Bøzø,stormrage,192,paladin,retribution,6,2,4
Tysads,darkspear,192,paladin,retribution,6,2,4
Fizzlewig,malganis,192,paladin,retribution,6,2,4
Hølyknìght,tichondrius,192,paladin,retribution,6,2,4
Noscajj,tichondrius,192,paladin,retribution,6,2,4
Tyberas,wyrmrest-accord,192,paladin,retribution,6,2,4
Corthic,area-52,192,paladin,retribution,6,2,4
Baloria,stormrage,192,paladin,retribution,6,2,4
Mickelodeon,sargeras,192,paladin,retribution,6,2,4
Eull,skullcrusher,192,paladin,retribution,6,2,4
Xoppo,tichondrius,192,paladin,retribution,6,2,4
Alkon,quelthalas,192,paladin,retribution,6,2,4
Crânkz,blackrock,192,paladin,retribution,6,2,4
Fairbairn,tichondrius,192,paladin,retribution,6,2,4
Virisanctii,stormrage,192,paladin,retribution,6,2,4
Oxycleän,doomhammer,192,paladin,retribution,6,2,4
Juiicebox,darrowmere,192,paladin,retribution,6,2,4
Lightkillerx,thrall,192,paladin,retribution,6,2,4
Voro,barthilas,192,paladin,retribution,6,2,4
Hyphenated,frostmourne,192,paladin,retribution,6,2,4
Brucitenjr,illidan,192,paladin,retribution,6,2,4
Johnygoodboi,khazgoroth,192,paladin,retribution,6,2,4
Pallylyfe,wyrmrest-accord,192,paladin,retribution,6,2,4
Holypoizan,tichondrius,192,paladin,retribution,6,2,4
Motrîn,sargeras,192,paladin,retribution,6,2,4
Mexipaladin,thrall,192,paladin,retribution,6,2,4
Bigboynathan,frostmourne,192,paladin,retribution,6,2,4
Toto,sargeras,192,paladin,retribution,6,2,4
Crimsonjudge,sargeras,192,paladin,retribution,6,2,4
Aewein,ragnaros,192,paladin,retribution,6,2,4
Sinsy,moon-guard,192,paladin,retribution,6,2,4
Rochet,kiljaeden,192,paladin,retribution,6,2,4
Spanx,blackwing-lair,192,paladin,retribution,6,2,4
Izaacckk,hakkar,192,paladin,retribution,6,2,4
Herbzilla,haomarush,192,paladin,retribution,6,2,4
Ugotburstt,arthas,192,paladin,retribution,6,2,4
Svane,thunderlord,192,paladin,retribution,6,2,4
Retro,magtheridon,192,paladin,retribution,6,2,4
Rây,stormrage,192,paladin,retribution,6,2,4
Drintense,area-52,192,paladin,retribution,6,2,4
Thejüdge,malfurion,192,paladin,retribution,6,2,4
Piousgecko,illidan,192,paladin,retribution,6,2,4
Révolution,barthilas,192,paladin,retribution,6,2,4
Crijr,ragnaros,192,paladin,retribution,6,2,4
Kêy,the-venture-co,192,paladin,retribution,6,2,4
Aválerion,proudmoore,192,paladin,retribution,6,2,4
Omegabubble,garrosh,192,paladin,retribution,6,2,4
Thaidron,area-52,192,paladin,retribution,6,2,4
Oroth,ragnaros,192,paladin,retribution,6,2,4
Varianpally,kelthuzad,192,paladin,retribution,6,2,4
Stainless,magtheridon,192,paladin,retribution,6,2,4
Honeyduw,moon-guard,192,paladin,retribution,6,2,4
Blackflare,undermine,192,paladin,retribution,6,2,4
Vankaer,uldum,192,paladin,retribution,6,2,4
Sigurd,khadgar,192,paladin,retribution,6,2,4
Shanehere,thrall,192,paladin,retribution,6,2,4
Palåth,barthilas,192,paladin,retribution,6,2,4
Morcant,drakkari,192,paladin,retribution,6,2,4
Alphönsë,quelthalas,192,paladin,retribution,6,2,4
Liht,khazgoroth,192,paladin,retribution,6,2,4
Ryuuku,gilneas,192,paladin,retribution,6,2,4
Gordyn,khazgoroth,192,paladin,retribution,6,2,4
Zyden,hellscream,192,paladin,retribution,6,2,4
Stlthykilla,cenarion-circle,192,paladin,retribution,6,2,4
Angeluzlk,quelthalas,192,paladin,retribution,6,2,4
Litjoint,hyjal,192,paladin,retribution,6,2,4
Machoo,laughing-skull,192,paladin,retribution,6,2,4
Greatblade,barthilas,192,paladin,retribution,6,2,4
Mereoleona,elune,192,paladin,retribution,6,2,4
Shaqueefah,illidan,192,paladin,retribution,6,2,4
Hulc,ysera,192,paladin,retribution,6,2,4
Hopebreaker,spinebreaker,192,paladin,retribution,6,2,4
Schooiez,tichondrius,192,paladin,retribution,6,2,4
Lilpally,frostmourne,192,paladin,retribution,6,2,4
Domiet,bleeding-hollow,192,paladin,retribution,6,2,4
Gersin,azralon,192,paladin,retribution,6,2,4
Prèèd,frostmourne,192,paladin,retribution,6,2,4
Alexandros,the-underbog,192,paladin,retribution,6,2,4
Narcolepso,azralon,192,paladin,retribution,6,2,4
Rite,azralon,192,paladin,retribution,6,2,4
Misease,illidan,192,paladin,retribution,6,2,4
Criskaruz,ragnaros,192,paladin,retribution,6,2,4
Pelegroot,azralon,192,paladin,retribution,6,2,4
Adavinn,azjolnerub,192,paladin,retribution,6,2,4
Quinnl,dreadmaul,192,paladin,retribution,6,2,4
Nestus,shuhalo,192,paladin,retribution,6,2,4
Loocille,frostmourne,192,paladin,retribution,6,2,4
Bërzerk,zuluhed,192,paladin,retribution,6,2,4
Hinamattsuri,velen,192,paladin,retribution,6,2,4
Saamuus,quelthalas,192,paladin,retribution,6,2,4
Kigz,illidan,192,paladin,retribution,6,2,4
Gîmply,proudmoore,192,paladin,retribution,6,2,4
Theodden,tichondrius,192,paladin,retribution,6,2,4
Passinpeace,tichondrius,192,paladin,retribution,6,2,4
Parkhwi,tichondrius,192,paladin,retribution,6,2,4
Oxoslayeroxo,firetree,192,paladin,retribution,6,2,4
Snuggymuffin,barthilas,192,paladin,retribution,6,2,4
Mercuryx,tichondrius,192,paladin,retribution,6,2,4
Pállymán,proudmoore,192,paladin,retribution,6,2,4
Hogù,tichondrius,192,paladin,retribution,6,2,4
Zoeyxo,tichondrius,192,paladin,retribution,6,2,4
Forprophet,blackrock,192,paladin,retribution,6,2,4
Heartsend,nerzhul,192,paladin,retribution,6,2,4
Killerspally,area-52,192,paladin,retribution,6,2,4
Lightgasm,alterac-mountains,192,paladin,retribution,6,2,4
Jazzmatic,dalaran,192,paladin,retribution,6,2,4
Moohulk,ragnaros,192,paladin,retribution,6,2,4
Crazymikey,bleeding-hollow,192,paladin,retribution,6,2,4
Buri,tichondrius,192,paladin,retribution,6,2,4
Guelmin,azralon,192,paladin,retribution,6,2,4
Airane,sargeras,192,paladin,retribution,6,2,4
Treizen,frostmourne,192,paladin,retribution,6,2,4
Taddedpally,tichondrius,192,paladin,retribution,6,2,4
Yeshayah,dalaran,192,paladin,retribution,6,2,4
Lilby,lightbringer,192,paladin,retribution,6,2,4
Rekos,zuljin,192,paladin,retribution,6,2,4
Tomackin,quelthalas,192,paladin,retribution,6,2,4
Honeydews,zuljin,192,paladin,retribution,6,2,4
Wreckina,tichondrius,192,paladin,retribution,6,2,4
Ramises,nemesis,192,paladin,retribution,6,2,4
Reepr,tichondrius,192,paladin,retribution,6,2,4
Ohsoclose,bleeding-hollow,192,paladin,retribution,6,2,4
Thunddarr,stormrage,192,paladin,retribution,6,2,4
Repèntance,stormrage,192,paladin,retribution,6,2,4
Chrisqwa,sargeras,192,paladin,retribution,6,2,4
Überlin,whisperwind,192,paladin,retribution,6,2,4
Krabbiepatty,wyrmrest-accord,192,paladin,retribution,6,2,4
Stöny,illidan,192,paladin,retribution,6,2,4
Nicerice,dalaran,192,paladin,retribution,6,2,4
Whittia,wyrmrest-accord,192,paladin,retribution,6,2,4
Felourian,malganis,192,paladin,retribution,6,2,4
Rúdely,tichondrius,192,paladin,retribution,6,2,4
Exalter,malganis,192,paladin,retribution,6,2,4
Astrøworld,sargeras,192,paladin,retribution,6,2,4
Flexedonyou,sentinels,192,paladin,retribution,6,2,4
Granada,kirin-tor,192,paladin,retribution,6,2,4
Stunnaax,frostmourne,192,paladin,retribution,6,2,4
Twatiegodx,malganis,192,paladin,retribution,6,2,4
Cudiskush,tichondrius,192,paladin,retribution,6,2,4
Reivilly,azralon,192,paladin,retribution,6,2,4
Smolbeef,tichondrius,192,paladin,retribution,6,2,4
Dithfeo,tichondrius,192,paladin,retribution,6,2,4
Cïelo,dragonmaw,192,paladin,retribution,6,2,4
Invïctus,dalaran,192,paladin,retribution,6,2,4
Sweettartts,zuljin,192,paladin,retribution,6,2,4
Joshington,stormrage,192,paladin,retribution,6,2,4
Blackbeerd,stormrage,192,paladin,retribution,6,2,4
Gwff,tichondrius,192,paladin,retribution,6,2,4
Ookcoo,tichondrius,192,paladin,retribution,6,2,4
Desterro,quelthalas,192,paladin,retribution,6,2,4
Alasper,malganis,192,paladin,retribution,6,2,4
Hafra,zuljin,192,paladin,retribution,6,2,4
Guacamello,emerald-dream,192,paladin,retribution,6,2,4
Madnhairy,zuljin,192,paladin,retribution,6,2,4
Paintpumper,malganis,192,paladin,retribution,6,2,4
Shebas,kilrogg,192,paladin,retribution,6,2,4
Crosjudge,zuljin,192,paladin,retribution,6,2,4
Omensageiro,azralon,192,paladin,retribution,6,2,4
Ghatte,azralon,192,paladin,retribution,6,2,4
Malakk,zuljin,192,paladin,retribution,6,2,4
Jaok,tichondrius,192,paladin,retribution,6,2,4
Dynastyhero,area-52,192,paladin,retribution,6,2,4
Freslys,zuljin,192,paladin,retribution,6,2,4
Chombe,tichondrius,192,paladin,retribution,6,2,4
Verzuhazadon,tichondrius,192,paladin,retribution,6,2,4
Mazexd,illidan,192,paladin,retribution,6,2,4
Psychlight,quelthalas,192,paladin,retribution,6,2,4
Spyglas,quelthalas,192,paladin,retribution,6,2,4
Byonsay,zuljin,192,paladin,retribution,6,2,4
Neydisa,sargeras,192,paladin,retribution,6,2,4
Aleio,moon-guard,192,paladin,retribution,6,2,4
Sac,sargeras,192,paladin,retribution,6,2,4
Yedema,tichondrius,192,paladin,retribution,6,2,4
Capedcrusade,area-52,192,paladin,retribution,6,2,4
Bigdret,moon-guard,192,paladin,retribution,6,2,4
Grim,eonar,192,paladin,retribution,6,2,4
Armasexodus,barthilas,192,paladin,retribution,6,2,4
Quiznossubs,kelthuzad,192,paladin,retribution,6,2,4
Petsmacker,dalaran,192,paladin,retribution,6,2,4
Whataio,tichondrius,192,paladin,retribution,6,2,4
Mynnorath,emerald-dream,192,paladin,retribution,6,2,4
Roseheart,emerald-dream,192,paladin,retribution,6,2,4
Avengzeus,tichondrius,192,paladin,retribution,6,2,4
Brand,emerald-dream,192,paladin,retribution,6,2,4
Oynx,emerald-dream,192,paladin,retribution,6,2,4
Lxwd,tichondrius,192,paladin,retribution,6,2,4
Strîkes,emerald-dream,192,paladin,retribution,6,2,4
Solånar,bloodscalp,192,paladin,retribution,7,2,5
Jessecash,tichondrius,192,paladin,retribution,12,3,9
Takz,daggerspine,192,paladin,retribution,8,2,6
Murgly,tichondrius,192,paladin,retribution,8,2,6
Azajudgeman,nemesis,192,paladin,retribution,9,2,7
Sïncere,frostmourne,192,paladin,retribution,12,2,10
Dánteé,ragnaros,192,paladin,retribution,12,2,10
Cronodxl,quelthalas,192,paladin,retribution,12,2,10
Yawnday,farstriders,192,paladin,retribution,12,2,10
Seltzer,tichondrius,192,paladin,retribution,12,2,10
Supermetroid,vashj,192,paladin,retribution,12,2,10
Vantz,tichondrius,192,paladin,retribution,12,2,10
Ricopal,frostmourne,192,paladin,retribution,12,2,10
Rîf,malganis,192,paladin,retribution,12,2,10
Disconnect,azjolnerub,192,paladin,retribution,12,2,10
Rayli,dalaran,192,paladin,retribution,12,2,10
Twodkittyy,kelthuzad,192,paladin,retribution,12,2,10
Dirtfunk,illidan,192,paladin,retribution,12,2,10
Goomie,icecrown,192,paladin,retribution,12,2,10
Anahl,icecrown,192,paladin,retribution,12,2,10
Grimsfate,emerald-dream,192,paladin,retribution,12,2,10
Clrty,area-52,192,paladin,retribution,12,2,10
Arminhamer,sargeras,192,paladin,retribution,12,2,10
Xinoh,area-52,192,paladin,retribution,12,2,10
Seratox,illidan,192,paladin,retribution,12,2,10
Bubzfordubz,sargeras,192,paladin,retribution,12,2,10
Cabacarl,quelthalas,192,paladin,retribution,12,2,10
Lamer,proudmoore,192,paladin,retribution,12,2,10
Alyosya,barthilas,192,paladin,retribution,12,2,10
Holyshifts,exodar,192,paladin,retribution,12,2,10
Criixx,malganis,192,paladin,retribution,12,2,10
Renorhal,moon-guard,192,paladin,retribution,12,2,10
Sleepybiden,darkspear,192,paladin,retribution,12,2,10
Ghratadin,bleeding-hollow,192,paladin,retribution,12,2,10
Aetol,proudmoore,192,paladin,retribution,12,2,10
Elarilein,emerald-dream,192,paladin,retribution,12,2,10
Milfcrusader,tichondrius,192,paladin,retribution,12,2,10
Slithix,stormreaver,192,paladin,retribution,12,2,10
Trippierett,bloodscalp,192,paladin,retribution,12,2,10
Kaiyleigh,sargeras,192,paladin,retribution,12,2,10
Holyelfs,boulderfist,192,paladin,retribution,12,2,10
Fazoéli,stormrage,192,paladin,retribution,12,2,10
Goldfaith,sargeras,192,paladin,retribution,12,2,10
Paladocka,stormrage,192,paladin,retribution,12,2,10
Matrium,kiljaeden,192,paladin,retribution,18,2,16
Dorisseline,emerald-dream,192,paladin,retribution,18,2,16
Imnoracist,thrall,192,paladin,retribution,18,2,16
Runandhide,aerie-peak,192,paladin,retribution,18,2,16
Túss,khazgoroth,191,paladin,retribution,6,2,4
Vegetå,malganis,180,paladin,retribution,31,6,25
Thugmuffin,thrall,176,paladin,retribution,7,3,4
Wokeinator,malganis,175,paladin,retribution,11,3,8
Baalduru,borean-tundra,175,paladin,retribution,11,2,9
Laysonus,moon-guard,169,paladin,retribution,11,4,7
Bubbletop,tichondrius,169,paladin,retribution,11,4,7
Nalahra,moon-guard,159,paladin,retribution,5,2,3
Sorgeno,ursin,159,paladin,retribution,5,2,3
Zyllo,area-52,159,paladin,retribution,5,2,3
Ubbhe,quelthalas,159,paladin,retribution,5,2,3
Zoobro,tichondrius,159,paladin,retribution,5,2,3
Whoopsie,dragonmaw,159,paladin,retribution,5,2,3
Prïmavera,azralon,159,paladin,retribution,5,2,3
Beelzebøss,frostmourne,159,paladin,retribution,5,2,3
Kaorii,mannoroth,159,paladin,retribution,5,2,3
Bringbackrmp,tichondrius,159,paladin,retribution,5,2,3
Luðo,moon-guard,159,paladin,retribution,5,2,3
Pallydeen,illidan,159,paladin,retribution,5,2,3
Vero,agamaggan,159,paladin,retribution,17,2,15
Whiplashlol,frostwolf,144,paladin,retribution,3,3,0
Holeesheett,tichondrius,144,paladin,retribution,9,2,7
Ájummalukout,tichondrius,138,paladin,retribution,9,3,6
Åddict,kelthuzad,138,paladin,retribution,10,3,7
Iæl,stormrage,138,paladin,retribution,10,3,7
Dathromir,stormrage,138,paladin,retribution,15,3,12
Bubbleosèven,tichondrius,138,paladin,retribution,16,3,13
Modafinil,bonechewer,138,paladin,retribution,20,3,17
Sweetbunz,altar-of-storms,128,paladin,retribution,4,2,2
Mikwa,ragnaros,128,paladin,retribution,4,2,2
Stârfôx,area-52,128,paladin,retribution,4,2,2
Molodino,nemesis,128,paladin,retribution,4,2,2
Sofiora,thunderlord,128,paladin,retribution,10,2,8
Khileeha,sargeras,128,paladin,retribution,10,2,8
Celerios,stormreaver,127,paladin,retribution,8,2,6
Gaismagorm,ragnaros,96,paladin,retribution,3,2,1
Utho,wyrmrest-accord,96,paladin,retribution,3,2,1
Swordstrikes,tichondrius,96,paladin,retribution,3,2,1
Dazak,ragnaros,96,paladin,retribution,3,2,1
Tsunin,area-52,96,paladin,retribution,3,2,1
Shalith,thrall,96,paladin,retribution,3,2,1
Simple,ghostlands,96,paladin,retribution,16,3,13
Luiiguii,drakkari,96,paladin,retribution,6,1,5
Chakin,burning-legion,96,paladin,retribution,6,1,5
Aldwyn,deathwing,96,paladin,retribution,6,1,5
Minjikim,tichondrius,96,paladin,retribution,6,1,5
Carloss,drakkari,96,paladin,retribution,6,1,5
Rg,nerzhul,96,paladin,retribution,6,1,5
Meanervini,kiljaeden,96,paladin,retribution,6,1,5
Ariolo,baelgun,96,paladin,retribution,6,1,5
Tazzul,turalyon,96,paladin,retribution,6,1,5
Parts,aerie-peak,96,paladin,retribution,6,1,5
Këys,earthen-ring,96,paladin,retribution,6,1,5
Fistopain,staghelm,96,paladin,retribution,6,1,5
Sóapbubble,tichondrius,96,paladin,retribution,6,1,5
Tehbeasty,hyjal,96,paladin,retribution,6,1,5
Urudith,azralon,96,paladin,retribution,6,1,5
Chøcølatte,azralon,96,paladin,retribution,6,1,5
Wilmâ,ragnaros,96,paladin,retribution,6,1,5
Phokboi,shattered-hand,96,paladin,retribution,6,1,5
Lettuceprey,the-underbog,96,paladin,retribution,6,1,5
Lightmessiah,perenolde,96,paladin,retribution,6,1,5
Goksuu,ragnaros,96,paladin,retribution,6,1,5
Saffuki,frostmourne,96,paladin,retribution,6,1,5
Zwilliam,frostmourne,96,paladin,retribution,6,1,5
Smudgexy,frostmourne,96,paladin,retribution,6,1,5
Liongolden,azralon,96,paladin,retribution,6,1,5
Xkillz,korgath,96,paladin,retribution,6,1,5
Phelix,lightninghoof,96,paladin,retribution,6,1,5
Conámi,ragnaros,96,paladin,retribution,6,1,5
Ashlane,tichondrius,96,paladin,retribution,6,1,5
Adobro,tichondrius,96,paladin,retribution,6,1,5
Retsarro,frostmourne,96,paladin,retribution,6,1,5
Rodrigo,frostmourne,96,paladin,retribution,6,1,5
Kënsi,quelthalas,96,paladin,retribution,6,1,5
Partenna,quelthalas,96,paladin,retribution,6,1,5
Daukan,quelthalas,96,paladin,retribution,6,1,5
Acpally,tichondrius,96,paladin,retribution,6,1,5
Riçky,tichondrius,96,paladin,retribution,6,1,5
Coffeebean,quelthalas,96,paladin,retribution,6,1,5
Cots,azralon,96,paladin,retribution,6,1,5
Deviill,winterhoof,96,paladin,retribution,6,1,5
Fourwives,sargeras,96,paladin,retribution,6,1,5
Warhero,sargeras,96,paladin,retribution,6,1,5
Ashlïe,moon-guard,96,paladin,retribution,6,1,5
Daelann,moon-guard,96,paladin,retribution,6,1,5
Bravsirrobin,firetree,96,paladin,retribution,6,1,5
Maeyz,sargeras,96,paladin,retribution,6,1,5
Donoph,blades-edge,96,paladin,retribution,6,1,5
Retrib,tichondrius,96,paladin,retribution,6,1,5
Fpaladin,tichondrius,96,paladin,retribution,6,1,5
Giita,quelthalas,96,paladin,retribution,6,1,5
Dûälïpä,barthilas,96,paladin,retribution,6,1,5
Marcovk,quelthalas,96,paladin,retribution,6,1,5
Lòuisvuttion,tichondrius,96,paladin,retribution,6,1,5
Solambul,tichondrius,96,paladin,retribution,6,1,5
Tehgodofdmg,tichondrius,96,paladin,retribution,6,1,5
Erindor,emerald-dream,96,paladin,retribution,6,1,5
Brynleigh,malganis,96,paladin,retribution,6,1,5
Mentalíssues,moon-guard,96,paladin,retribution,6,1,5
Boundric,emerald-dream,96,paladin,retribution,6,1,5
Yesdaddyxo,emerald-dream,96,paladin,retribution,6,1,5
Yøu,tichondrius,96,paladin,retribution,6,1,5
Angusbeef,hyjal,96,paladin,retribution,6,1,5
Flashbubble,sargeras,96,paladin,retribution,6,1,5
Rodt,dalaran,96,paladin,retribution,6,1,5
Mugann,malganis,96,paladin,retribution,6,1,5
Desrexen,malganis,96,paladin,retribution,6,1,5
Cupidxbye,tichondrius,96,paladin,retribution,6,1,5
Scrubdin,illidan,96,paladin,retribution,6,1,5
Burom,kelthuzad,96,paladin,retribution,6,1,5
Krelya,ragnaros,96,paladin,retribution,6,1,5
Beebopper,illidan,96,paladin,retribution,6,1,5
Bosmoklikdat,moon-guard,96,paladin,retribution,6,1,5
Synnderilla,wyrmrest-accord,96,paladin,retribution,6,1,5
Kaylafell,kelthuzad,96,paladin,retribution,6,1,5
Zulzander,kelthuzad,96,paladin,retribution,6,1,5
Aragonns,illidan,96,paladin,retribution,6,1,5
Astraelon,bleeding-hollow,96,paladin,retribution,6,1,5
Asellusarc,kelthuzad,96,paladin,retribution,6,1,5
Slantee,illidan,96,paladin,retribution,6,1,5
Tradalia,illidan,96,paladin,retribution,6,1,5
Sneakycastro,bleeding-hollow,96,paladin,retribution,6,1,5
Nytto,lightnings-blade,96,paladin,retribution,6,1,5
Kytheon,zuluhed,96,paladin,retribution,6,1,5
Bubbllicious,thrall,96,paladin,retribution,6,1,5
Palajem,stormrage,96,paladin,retribution,6,1,5
Gazef,proudmoore,96,paladin,retribution,6,1,5
Shamashjoel,black-dragonflight,96,paladin,retribution,6,1,5
Sleyn,stormrage,96,paladin,retribution,6,1,5
Ownedcrazy,stormrage,96,paladin,retribution,6,1,5
Justtrollin,black-dragonflight,96,paladin,retribution,6,1,5
Ssjgodvy,illidan,96,paladin,retribution,6,1,5
Airndel,illidan,96,paladin,retribution,6,1,5
Chapichapi,illidan,96,paladin,retribution,6,1,5
Amazarak,stormrage,96,paladin,retribution,6,1,5
Thòrisòn,stormrage,96,paladin,retribution,6,1,5
Skeeta,area-52,96,paladin,retribution,6,1,5
Maldobarr,stormrage,96,paladin,retribution,6,1,5
Sunnix,illidan,96,paladin,retribution,6,1,5
Dafoq,stormrage,96,paladin,retribution,6,1,5
Chainjustice,area-52,96,paladin,retribution,6,1,5
Paldan,illidan,96,paladin,retribution,6,1,5
Thumos,sargeras,96,paladin,retribution,6,1,5
Skadooshh,illidan,96,paladin,retribution,6,1,5
Holyxsmokes,illidan,96,paladin,retribution,6,1,5
Orthín,stormrage,96,paladin,retribution,6,1,5
Scah,illidan,96,paladin,retribution,6,1,5
Serazan,moon-guard,96,paladin,retribution,6,1,5
Valadinn,tichondrius,96,paladin,retribution,6,1,5
Nvrbubble,area-52,96,paladin,retribution,6,1,5
Scarllye,illidan,96,paladin,retribution,6,1,5
Samsaratry,proudmoore,96,paladin,retribution,6,1,5
Franchy,stormrage,96,paladin,retribution,6,1,5
Tenethor,area-52,96,paladin,retribution,6,1,5
Terppy,stormrage,96,paladin,retribution,6,1,5
Kamakazê,sargeras,96,paladin,retribution,6,1,5
Smïthh,area-52,96,paladin,retribution,6,1,5
Chuggawhugga,area-52,96,paladin,retribution,6,1,5
Alk,windrunner,96,paladin,retribution,6,1,5
Duecesz,area-52,96,paladin,retribution,6,1,5
Chawbanger,proudmoore,96,paladin,retribution,6,1,5
Djset,blackhand,96,paladin,retribution,6,1,5
Tooshka,azshara,96,paladin,retribution,6,1,5
Retski,thrall,96,paladin,retribution,6,1,5
Zealotry,tichondrius,96,paladin,retribution,6,1,5
Ahrieze,moon-guard,96,paladin,retribution,6,1,5
Sanddor,moon-guard,96,paladin,retribution,6,1,5
Pipesmoke,dunemaul,96,paladin,retribution,6,1,5
Balloony,stormrage,96,paladin,retribution,6,1,5
Cyona,gallywix,96,paladin,retribution,6,1,5
Retx,arthas,96,paladin,retribution,6,1,5
Scuffedhoj,tichondrius,96,paladin,retribution,6,1,5
Krulu,thrall,96,paladin,retribution,6,1,5
Gressilin,arthas,96,paladin,retribution,6,1,5
Holyclapzy,stormrage,96,paladin,retribution,6,1,5
Darksaint,hellscream,96,paladin,retribution,6,1,5
Jüstice,tichondrius,96,paladin,retribution,6,1,5
Talahar,boulderfist,96,paladin,retribution,6,1,5
Holythanos,bleeding-hollow,96,paladin,retribution,6,1,5
Bruwdblood,bleeding-hollow,96,paladin,retribution,6,1,5
Gdesign,tichondrius,96,paladin,retribution,6,1,5
Coltoniac,kaelthas,96,paladin,retribution,6,1,5
Judgémental,bleeding-hollow,96,paladin,retribution,6,1,5
Goodwood,ghostlands,96,paladin,retribution,6,1,5
Shádøwy,nemesis,96,paladin,retribution,6,1,5
Ryudoshël,nemesis,96,paladin,retribution,6,1,5
Actionman,bleeding-hollow,96,paladin,retribution,6,1,5
Pùteduvilage,zuljin,96,paladin,retribution,6,1,5
Odos,zuljin,96,paladin,retribution,6,1,5
Momhips,bloodscalp,96,paladin,retribution,6,1,5
Laelias,lightbringer,96,paladin,retribution,6,1,5
Bigshaftt,gorgonnash,96,paladin,retribution,6,1,5
Lowther,bleeding-hollow,96,paladin,retribution,6,1,5
Càséy,zuljin,96,paladin,retribution,6,1,5
Brank,agamaggan,96,paladin,retribution,6,1,5
Poeboyz,stormrage,96,paladin,retribution,6,1,5
Kregar,kelthuzad,96,paladin,retribution,7,1,6
Lelythia,bleeding-hollow,96,paladin,retribution,7,1,6
Trinkysteve,frostmane,96,paladin,retribution,7,1,6
Zatoci,shadowsong,96,paladin,retribution,11,1,10
Shamo,stormreaver,96,paladin,retribution,12,1,11
Yoropal,tichondrius,96,paladin,retribution,12,1,11
Firexfist,gurubashi,96,paladin,retribution,12,1,11
Axiskai,gorgonnash,96,paladin,retribution,12,1,11
Lorenzojr,sargeras,96,paladin,retribution,12,1,11
Yobnai,zuljin,96,paladin,retribution,12,1,11
Séykän,ragnaros,96,paladin,retribution,12,1,11
Hojpocketx,tichondrius,96,paladin,retribution,12,1,11
Æpaldin,tichondrius,96,paladin,retribution,12,1,11
Hondacivicsi,mannoroth,96,paladin,retribution,12,1,11
Oshia,destromath,96,paladin,retribution,12,1,11
Catholica,tichondrius,96,paladin,retribution,12,1,11
Zalacar,azralon,96,paladin,retribution,12,1,11
Roosterface,azjolnerub,96,paladin,retribution,12,1,11
Whosyourdady,azjolnerub,96,paladin,retribution,12,1,11
Rimorse,illidan,96,paladin,retribution,12,1,11
Reinhardburm,quelthalas,96,paladin,retribution,12,1,11
Geykum,tichondrius,96,paladin,retribution,17,1,16
Hottest,wyrmrest-accord,84,paladin,retribution,13,5,8
Torms,illidan,79,paladin,retribution,3,3,0
Laydarus,frostmourne,79,paladin,retribution,5,1,4
Taego,tichondrius,79,paladin,retribution,5,1,4
Goldieg,tichondrius,79,paladin,retribution,5,1,4
Bowdown,wildhammer,79,paladin,retribution,5,1,4
Ryxxi,sargeras,79,paladin,retribution,5,1,4
Divinetoco,stormrage,79,paladin,retribution,5,1,4
Hivers,stormrage,79,paladin,retribution,11,1,10
Sondaar,madoran,73,paladin,retribution,17,3,14
Dronedròp,illidan,63,paladin,retribution,2,2,0
Piston,kiljaeden,63,paladin,retribution,2,2,0
Belenor,quelthalas,63,paladin,retribution,2,2,0
Jerseÿ,sargeras,48,paladin,retribution,3,1,2
Eljefee,emerald-dream,42,paladin,retribution,11,3,8
Thisissus,tichondrius,42,paladin,retribution,8,2,6
Dabakle,stormrage,42,paladin,retribution,8,2,6
Newwow,tichondrius,42,paladin,retribution,9,2,7
Pearlx,ragnaros,42,paladin,retribution,10,2,8
Voncruz,proudmoore,42,paladin,retribution,12,2,10
Patrious,moon-guard,31,paladin,retribution,2,1,1
Gorila,stormrage,31,paladin,retribution,2,1,1
Bluether,sargeras,16,paladin,retribution,1,1,0
Naizen,tichondrius,16,paladin,retribution,1,1,0
ßleider,quelthalas,1906,paladin,protection,55,39,16
Ëlmaster,nemesis,1831,paladin,protection,126,80,46
Degenratebri,moon-guard,1779,paladin,protection,53,39,14
Aluvia,malygos,1741,paladin,protection,70,50,20
Zhspeilian,tichondrius,1730,paladin,protection,84,47,37
Höpönpöppö,frostmourne,1729,paladin,protection,48,26,22
Crâfty,bleeding-hollow,1717,paladin,protection,101,55,46
Motates,malganis,1706,paladin,protection,93,48,45
Kierolechita,ragnaros,1677,paladin,protection,226,116,110
Uglyboyryan,sargeras,1666,paladin,protection,96,55,41
Eclipsor,bleeding-hollow,1657,paladin,protection,48,30,18
Vondonna,moon-guard,1655,paladin,protection,113,65,48
Aopidsfihjov,stormrage,1649,paladin,protection,48,34,14
Sôlux,quelthalas,1638,paladin,protection,56,31,25
Lxwd,tichondrius,1636,paladin,protection,131,66,65
Sutadansa,doomhammer,1632,paladin,protection,146,71,75
Jimmipepe,quelthalas,1622,paladin,protection,48,31,17
Bighardshock,aggramar,1610,paladin,protection,30,18,12
Sigmapepe,quelthalas,1605,paladin,protection,42,26,16
Zephyrvalor,sargeras,1601,paladin,protection,146,69,77
Blackmiya,tichondrius,1570,paladin,protection,31,20,11
Øziris,goldrinn,1567,paladin,protection,74,33,41
Rehtua,bleeding-hollow,1557,paladin,protection,83,35,48
Aeythyr,wyrmrest-accord,1495,paladin,protection,54,27,27
Chozverialyz,ysondre,1494,paladin,protection,68,32,36
Borrus,malygos,1480,paladin,protection,36,19,17
Modafinil,bonechewer,1455,paladin,protection,111,53,58
Zexion,azralon,1450,paladin,protection,45,19,26
Wowmike,sargeras,1434,paladin,protection,60,28,32
Íaan,drakkari,1433,paladin,protection,70,43,27
Domocho,azgalor,1417,paladin,protection,42,22,20
Cusino,tichondrius,1412,paladin,protection,44,22,22
Arcilys,illidan,1398,paladin,protection,60,29,31
Bt,quelthalas,1376,paladin,protection,41,25,16
Rakasho,azralon,1370,paladin,protection,60,23,37
Almeta,kelthuzad,1350,paladin,protection,36,18,18
Goldjade,khazgoroth,1344,paladin,protection,77,30,47
Goeun,destromath,1342,paladin,protection,31,15,16
Stormvikingx,darkspear,1336,paladin,protection,24,14,10
Khrome,cenarion-circle,1328,paladin,protection,134,44,90
Herimi,drakkari,1324,paladin,protection,71,27,44
Jkethuhsnake,ghostlands,1306,paladin,protection,51,31,20
Poorly,thorium-brotherhood,1292,paladin,protection,30,16,14
Lythos,dathremar,1286,paladin,protection,36,17,19
Thorsmites,sargeras,1273,paladin,protection,48,18,30
Dankerton,tichondrius,1259,paladin,protection,22,14,8
Ronor,thorium-brotherhood,1219,paladin,protection,30,14,16
Imthabromb,dragonblight,1206,paladin,protection,35,18,17
Lelythia,bleeding-hollow,1161,paladin,protection,65,25,40
Palahogx,sargeras,1150,paladin,protection,24,12,12
Gredo,queldorei,1070,paladin,protection,17,12,5
Zakh,proudmoore,1053,paladin,protection,18,11,7
Penitent,barthilas,1052,paladin,protection,18,11,7
Bullivan,sisters-of-elune,963,paladin,protection,40,14,26
Bubblemark,tichondrius,959,paladin,protection,24,10,14
Strontimus,moon-guard,958,paladin,protection,12,10,2
Ndnpaly,bonechewer,953,paladin,protection,12,10,2
Ratzon,dalaran,950,paladin,protection,18,10,8
Matadore,arygos,908,paladin,protection,22,11,11
Chanimalf,tichondrius,880,paladin,protection,13,10,3
Alexcydragon,quelthalas,863,paladin,protection,18,9,9
Hittit,thrall,859,paladin,protection,30,9,21
Negativeiq,moon-guard,798,paladin,protection,10,10,0
Protdream,tichondrius,768,paladin,protection,12,8,4
Courageousz,dalaran,768,paladin,protection,18,8,10
Crusâder,area-52,767,paladin,protection,24,8,16
Lothwrynn,senjin,762,paladin,protection,18,8,10
Kittié,proudmoore,760,paladin,protection,30,8,22
Halnoth,dethecus,702,paladin,protection,11,8,3
Valkaire,area-52,671,paladin,protection,12,7,5
Dirkdigglerz,bleeding-hollow,670,paladin,protection,18,7,11
Whëëls,stormreaver,576,paladin,protection,12,6,6
Sølis,alleria,576,paladin,protection,12,6,6
Danthorin,malfurion,575,paladin,protection,24,6,18
Gotankz,moon-guard,480,paladin,protection,12,5,7
Kiehui,lightbringer,480,paladin,protection,12,5,7
Bullmarket,tichondrius,480,paladin,protection,18,5,13
Lewstelamon,korialstrasz,446,paladin,protection,10,6,4
Typhoontravv,thrall,384,paladin,protection,6,4,2
Holyknight,veknilash,384,paladin,protection,14,5,9
Xbloodknight,malganis,384,paladin,protection,12,4,8
Gîmply,proudmoore,384,paladin,protection,12,4,8
Belmorlin,moon-guard,384,paladin,protection,12,4,8
Bullheaded,silvermoon,384,paladin,protection,12,4,8
Jahirie,aegwynn,351,paladin,protection,17,4,13
Isecretly,stormrage,335,paladin,protection,7,7,0
Trâgedy,azjolnerub,288,paladin,protection,6,3,3
Thortanous,icecrown,288,paladin,protection,6,3,3
Kooshh,thunderlord,288,paladin,protection,12,3,9
Urfavxbf,baelgun,288,paladin,protection,13,3,10
Saeranella,moon-guard,240,paladin,protection,9,3,6
Blâckhârt,saurfang,234,paladin,protection,9,4,5
Tankfest,sargeras,192,paladin,protection,6,2,4
Xinqingle,tichondrius,192,paladin,protection,6,2,4
Poppadock,veknilash,192,paladin,protection,6,2,4
Immensepower,tichondrius,192,paladin,protection,6,2,4
Consecrated,daggerspine,192,paladin,protection,12,2,10
Zifre,ragnaros,192,paladin,protection,12,2,10
Dwarvendude,sargeras,159,paladin,protection,11,2,9
Taillien,bonechewer,96,paladin,protection,6,1,5
Holykura,thrall,96,paladin,protection,6,1,5
Lasonil,zuljin,96,paladin,protection,6,1,5
Combidin,garrosh,96,paladin,protection,6,1,5
Chàrron,garrosh,79,paladin,protection,5,1,4
Garbagedisc,scilla,2139,priest,holy,114,56,58
Yötönyö,sargeras,2082,priest,holy,114,57,57
Priestlike,tichondrius,2010,priest,holy,127,68,59
Dogbutt,burning-legion,1996,priest,holy,222,111,111
Pickle,illidan,1974,priest,holy,86,49,37
Fusira,gurubashi,1941,priest,holy,48,25,23
Rustymvp,nagrand,1902,priest,holy,68,31,37
Tirrify,frostmourne,1899,priest,holy,54,29,25
Cokeheals,kelthuzad,1897,priest,holy,42,26,16
Fluent,emerald-dream,1895,priest,holy,192,91,101
Onemission,whisperwind,1889,priest,holy,72,27,45
Cinnalite,darkspear,1870,priest,holy,42,29,13
Pianohouse,illidan,1862,priest,holy,72,35,37
Teslashield,bleeding-hollow,1856,priest,holy,54,25,29
Ninbara,tichondrius,1851,priest,holy,102,49,53
Tookiex,stormrage,1847,priest,holy,61,29,32
Lilyxo,bleeding-hollow,1845,priest,holy,72,36,36
Hyouka,area-52,1844,priest,holy,268,143,125
Peat,hyjal,1844,priest,holy,54,27,27
Lëønë,nemesis,1842,priest,holy,148,93,55
Superduperr,illidan,1840,priest,holy,66,33,33
Saintjpii,tichondrius,1839,priest,holy,143,84,59
Vandalia,shadowsong,1837,priest,holy,181,89,92
Citrinesta,illidan,1835,priest,holy,197,121,76
Gerpe,stormrage,1830,priest,holy,189,106,83
Haruspex,azralon,1825,priest,holy,106,52,54
Lagemela,quelthalas,1825,priest,holy,101,47,54
Nickydamous,moon-guard,1817,priest,holy,66,38,28
Iniquitatem,tichondrius,1817,priest,holy,60,23,37
Tromnasty,area-52,1816,priest,holy,90,53,37
Whitetails,illidan,1816,priest,holy,54,31,23
Rootandboot,frostmourne,1815,priest,holy,49,29,20
Onikûdaki,sargeras,1814,priest,holy,86,37,49
Sweatynick,proudmoore,1813,priest,holy,227,109,118
Immthuggin,tichondrius,1813,priest,holy,120,53,67
Scyner,bleeding-hollow,1811,priest,holy,152,87,65
Dmgisop,illidan,1811,priest,holy,141,80,61
Clarifytwo,arathor,1809,priest,holy,48,29,19
Bloodlinex,malganis,1806,priest,holy,171,102,69
Pipelayerx,illidan,1804,priest,holy,50,25,25
Murkd,tichondrius,1804,priest,holy,145,68,77
Gill,proudmoore,1800,priest,holy,148,78,70
Whalexo,kelthuzad,1799,priest,holy,51,24,27
Jjmms,akama,1782,priest,holy,205,105,100
Turnipp,sargeras,1780,priest,holy,42,19,23
Dreckie,sargeras,1779,priest,holy,141,71,70
Zenelu,tichondrius,1775,priest,holy,482,239,243
Santyel,ragnaros,1768,priest,holy,72,43,29
Moonideli,moon-guard,1765,priest,holy,72,36,36
Mastuti,azralon,1763,priest,holy,77,34,43
Goodlife,frostmourne,1753,priest,holy,107,52,55
Heavyflo,kelthuzad,1746,priest,holy,96,49,47
Nanatoo,sargeras,1743,priest,holy,42,22,20
Pancakeboi,tichondrius,1739,priest,holy,95,46,49
Zazul,frostmane,1734,priest,holy,107,61,46
Icychain,area-52,1726,priest,holy,35,19,16
Soulghast,gorefiend,1720,priest,holy,42,24,18
Iloveethan,moon-guard,1717,priest,holy,53,32,21
Packet,zuluhed,1715,priest,holy,36,26,10
Cheekypriest,stormrage,1714,priest,holy,66,30,36
Eccentricx,sargeras,1712,priest,holy,30,18,12
Snowymooie,frostmourne,1697,priest,holy,54,25,29
Falsegodx,tichondrius,1688,priest,holy,108,56,52
Geoffrred,illidan,1686,priest,holy,54,21,33
Pws,azralon,1683,priest,holy,66,29,37
Candohp,frostmourne,1682,priest,holy,42,22,20
Soloqqt,tichondrius,1675,priest,holy,42,24,18
Gaudthree,tichondrius,1675,priest,holy,48,26,22
Minipriest,sargeras,1673,priest,holy,42,20,22
Óst,tichondrius,1673,priest,holy,42,18,24
ßsimp,darrowmere,1670,priest,holy,77,35,42
Cosmicyiff,area-52,1666,priest,holy,76,38,38
Clarify,arathor,1664,priest,holy,78,34,44
Cryptron,tichondrius,1660,priest,holy,114,50,64
Iluvthgnmicz,sargeras,1655,priest,holy,57,30,27
Illmindofmoo,sargeras,1645,priest,holy,41,18,23
Wøo,area-52,1643,priest,holy,169,89,80
Dream,kelthuzad,1639,priest,holy,60,27,33
Bopang,emerald-dream,1638,priest,holy,59,27,32
Wankenobi,stormrage,1634,priest,holy,280,140,140
Fäctor,bleeding-hollow,1633,priest,holy,44,23,21
Meatboxmoldy,blood-furnace,1630,priest,holy,46,25,21
Elbowbeans,tichondrius,1629,priest,holy,94,43,51
Hardiness,tichondrius,1627,priest,holy,66,45,21
Punkndrublic,sargeras,1625,priest,holy,165,83,82
Wisdumos,frostmourne,1625,priest,holy,72,36,36
Washdp,frostmourne,1621,priest,holy,48,21,27
Dgpriest,tichondrius,1620,priest,holy,48,23,25
Moosepriestx,sargeras,1619,priest,holy,36,17,19
Lickless,illidan,1611,priest,holy,42,20,22
Mynaevis,malganis,1610,priest,holy,30,17,13
Pigogo,tichondrius,1608,priest,holy,53,29,24
Leoshi,turalyon,1604,priest,holy,48,27,21
Dylbags,frostmourne,1600,priest,holy,35,21,14
Manbooty,illidan,1588,priest,holy,39,22,17
Alathea,elune,1586,priest,holy,189,88,101
Dypkillet,moon-guard,1582,priest,holy,150,71,79
ßeautiful,sargeras,1562,priest,holy,42,22,20
Krobs,bleeding-hollow,1559,priest,holy,48,20,28
Cerebrill,bleeding-hollow,1557,priest,holy,45,22,23
Tarlex,illidan,1555,priest,holy,94,43,51
Oyy,barthilas,1553,priest,holy,138,72,66
Avis,illidan,1539,priest,holy,110,54,56
Heluupa,illidan,1538,priest,holy,113,71,42
Tookz,stormrage,1530,priest,holy,24,16,8
Nielbomb,tichondrius,1527,priest,holy,414,206,208
Soaphia,kelthuzad,1525,priest,holy,130,65,65
Dispassion,stormrage,1523,priest,holy,182,90,92
Archbishop,stormscale,1514,priest,holy,79,42,37
Ducky,drakthul,1513,priest,holy,60,35,25
Saetia,drenden,1513,priest,holy,69,40,29
Sacrifer,moon-guard,1513,priest,holy,102,52,50
Joeschmoe,proudmoore,1512,priest,holy,42,22,20
Sooyáaa,illidan,1512,priest,holy,188,85,103
Boboxiao,illidan,1512,priest,holy,47,16,31
Cutiepriest,gnomeregan,1511,priest,holy,114,66,48
Noniok,blackrock,1507,priest,holy,50,31,19
Downturn,tichondrius,1507,priest,holy,42,18,24
Sukeena,malganis,1503,priest,holy,119,56,63
Chervz,chogall,1503,priest,holy,42,18,24
Handsumheals,kiljaeden,1500,priest,holy,49,27,22
Giveheadpats,moon-guard,1496,priest,holy,164,80,84
Tazzi,chromaggus,1494,priest,holy,79,35,44
Soleyxo,frostmourne,1489,priest,holy,54,31,23
Fyne,kelthuzad,1488,priest,holy,111,51,60
Cardinalpéll,frostmourne,1487,priest,holy,47,25,22
Chadopri,stormrage,1486,priest,holy,42,26,16
Kostantina,kelthuzad,1484,priest,holy,42,18,24
Cantheel,stormrage,1483,priest,holy,132,66,66
Tranquilty,tichondrius,1480,priest,holy,84,36,48
Goyimhealer,area-52,1476,priest,holy,53,23,30
Symbolofhope,moon-guard,1474,priest,holy,45,20,25
Illyasviel,terenas,1472,priest,holy,103,41,62
Edmen,stormrage,1464,priest,holy,90,44,46
Ayanamil,tichondrius,1460,priest,holy,79,57,22
Vampiric,laughing-skull,1460,priest,holy,68,38,30
Dawnside,wyrmrest-accord,1454,priest,holy,636,341,295
Plebiss,burning-blade,1450,priest,holy,190,100,90
Anguishment,stormrage,1448,priest,holy,165,80,85
Adrenalinn,illidan,1447,priest,holy,48,27,21
Griddly,alterac-mountains,1445,priest,holy,55,17,38
Owlchubz,mannoroth,1443,priest,holy,121,57,64
Artiannaa,bleeding-hollow,1436,priest,holy,63,39,24
Necroplasma,area-52,1433,priest,holy,55,31,24
Xedus,mannoroth,1433,priest,holy,74,32,42
Arçhángël,moon-guard,1431,priest,holy,72,38,34
Matthiass,thrall,1429,priest,holy,172,81,91
Pesca,proudmoore,1429,priest,holy,36,15,21
Wrinkletink,whisperwind,1426,priest,holy,49,24,25
Musashibo,kelthuzad,1426,priest,holy,57,19,38
Jiñx,destromath,1424,priest,holy,30,15,15
Stonemonkeyp,sargeras,1422,priest,holy,163,82,81
Gosilly,tichondrius,1417,priest,holy,24,15,9
Holyb,tichondrius,1413,priest,holy,77,41,36
Tòxìç,stormrage,1411,priest,holy,187,96,91
Mizzbehavn,tichondrius,1410,priest,holy,50,26,24
Kaelthos,quelthalas,1407,priest,holy,59,29,30
Kovaxx,frostmourne,1407,priest,holy,156,74,82
Berzum,chogall,1406,priest,holy,36,17,19
Bubbles,drakthul,1404,priest,holy,394,191,203
Bestgirlna,area-52,1404,priest,holy,114,50,64
Reverenced,stormrage,1401,priest,holy,84,48,36
Fenty,nemesis,1400,priest,holy,42,25,17
Sacredforce,sargeras,1400,priest,holy,66,21,45
Strivedaily,proudmoore,1397,priest,holy,216,101,115
Merellia,moon-guard,1395,priest,holy,72,37,35
Pettypriest,dalaran,1394,priest,holy,201,95,106
Floquii,area-52,1391,priest,holy,52,25,27
Soapfan,kelthuzad,1387,priest,holy,195,94,101
Rolence,tichondrius,1381,priest,holy,68,34,34
Rihen,tichondrius,1381,priest,holy,471,231,240
Plod,kelthuzad,1380,priest,holy,42,25,17
Etain,bloodscalp,1380,priest,holy,65,35,30
Akaneo,tichondrius,1380,priest,holy,36,18,18
Applepieyum,illidan,1380,priest,holy,78,30,48
Åutumn,tichondrius,1374,priest,holy,26,18,8
Doob,ghostlands,1374,priest,holy,42,22,20
Methodist,proudmoore,1374,priest,holy,78,28,50
Padrecarras,ragnaros,1373,priest,holy,36,15,21
Cruxave,aegwynn,1366,priest,holy,46,23,23
Sabene,greymane,1364,priest,holy,91,44,47
Holynug,stormrage,1361,priest,holy,30,16,14
Taashigi,frostmourne,1360,priest,holy,34,16,18
Mikeyxo,gnomeregan,1359,priest,holy,44,26,18
Cutensoft,moon-guard,1354,priest,holy,54,27,27
Quartzolio,azralon,1353,priest,holy,59,35,24
Maddrox,sargeras,1351,priest,holy,36,20,16
Xenatic,emerald-dream,1351,priest,holy,108,51,57
Shaldra,bleeding-hollow,1348,priest,holy,109,64,45
Preacherr,bonechewer,1348,priest,holy,36,20,16
Esvary,quelthalas,1347,priest,holy,116,62,54
Dispersed,thrall,1347,priest,holy,80,37,43
Holyshytt,tichondrius,1346,priest,holy,55,30,25
Sappes,area-52,1346,priest,holy,54,27,27
Dioecesis,moon-guard,1345,priest,holy,83,30,53
Holyfromrmp,tichondrius,1344,priest,holy,57,25,32
Klondikebar,whisperwind,1341,priest,holy,42,22,20
Ænußís,stormrage,1335,priest,holy,84,46,38
Spriest,kul-tiras,1332,priest,holy,74,41,33
Chemod,quelthalas,1331,priest,holy,41,22,19
Trufumthunzi,illidan,1330,priest,holy,26,17,9
Aisperwind,shadowsong,1323,priest,holy,78,37,41
Healztonic,dalaran,1323,priest,holy,85,38,47
Discospider,sargeras,1316,priest,holy,31,16,15
Operandi,sargeras,1315,priest,holy,29,16,13
Lexiié,area-52,1312,priest,holy,55,33,22
Mercý,zuljin,1309,priest,holy,60,34,26
Ksâh,bleeding-hollow,1309,priest,holy,36,17,19
Phearix,zuljin,1309,priest,holy,48,20,28
Arterrmis,barthilas,1307,priest,holy,53,26,27
Animè,zuluhed,1305,priest,holy,89,52,37
Xinferesia,sargeras,1305,priest,holy,61,25,36
Xrafa,azralon,1301,priest,holy,84,38,46
Priestlie,malganis,1301,priest,holy,70,28,42
Spïcÿ,frostmourne,1296,priest,holy,54,27,27
Duhàst,sargeras,1296,priest,holy,95,43,52
Xanky,frostmourne,1287,priest,holy,34,18,16
Hizha,tichondrius,1287,priest,holy,36,19,17
Gracarix,frostmourne,1285,priest,holy,30,17,13
Macko,wyrmrest-accord,1279,priest,holy,31,15,16
Amaristinaa,frostmourne,1279,priest,holy,46,21,25
Djdazzle,kargath,1278,priest,holy,29,14,15
Padreamarol,ragnaros,1274,priest,holy,48,23,25
Duskherald,zuljin,1274,priest,holy,96,45,51
Lilyanná,tichondrius,1270,priest,holy,42,20,22
Freshtodeath,malganis,1269,priest,holy,42,23,19
Raskreia,dragonmaw,1268,priest,holy,30,14,16
Mkenze,moon-guard,1268,priest,holy,156,69,87
Tegridyfarm,malganis,1265,priest,holy,35,19,16
Threesclass,tichondrius,1262,priest,holy,29,14,15
Tytusx,stormrage,1262,priest,holy,32,14,18
Alrüna,moon-guard,1253,priest,holy,62,30,32
Galadrael,quelthalas,1252,priest,holy,35,16,19
Iggyp,hyjal,1251,priest,holy,72,35,37
Zallstan,zuljin,1249,priest,holy,30,15,15
Bjorke,tichondrius,1247,priest,holy,30,13,17
Oxynor,zuljin,1246,priest,holy,24,13,11
Yyuan,tichondrius,1244,priest,holy,24,13,11
Holiermilk,demon-soul,1243,priest,holy,221,99,122
Irídium,area-52,1243,priest,holy,30,13,17
Fanseband,dalaran,1240,priest,holy,41,22,19
Manocloth,frostmourne,1239,priest,holy,25,15,10
Cléah,sargeras,1235,priest,holy,113,53,60
Junatoh,area-52,1231,priest,holy,55,29,26
Healgirls,dalaran,1230,priest,holy,59,28,31
Nowwow,tichondrius,1230,priest,holy,30,14,16
Aiwa,winterhoof,1229,priest,holy,18,13,5
Hatxsu,emerald-dream,1229,priest,holy,40,17,23
Valkur,aegwynn,1227,priest,holy,150,70,80
Littlebat,proudmoore,1226,priest,holy,76,39,37
Zerolimitzz,arthas,1225,priest,holy,48,22,26
Whitepigogo,tichondrius,1225,priest,holy,30,13,17
Giusep,tichondrius,1225,priest,holy,42,16,26
Edessa,lothar,1225,priest,holy,71,27,44
Celinsa,ragnaros,1223,priest,holy,36,18,18
Tïto,blackrock,1220,priest,holy,44,20,24
Leggoscams,tichondrius,1217,priest,holy,28,14,14
Titô,frostmourne,1215,priest,holy,53,28,25
Firewatcher,sisters-of-elune,1214,priest,holy,30,17,13
Akainuu,nazjatar,1207,priest,holy,55,22,33
Dóctóre,thrall,1205,priest,holy,61,24,37
Bismund,chogall,1203,priest,holy,42,22,20
Daisie,bleeding-hollow,1202,priest,holy,85,43,42
Stayhealed,tichondrius,1201,priest,holy,45,22,23
Akö,jubeithos,1200,priest,holy,30,14,16
Vernis,nazjatar,1200,priest,holy,36,15,21
Dagaen,thunderlord,1199,priest,holy,209,104,105
Pílí,drakkari,1198,priest,holy,60,28,32
Ukizeal,moknathal,1192,priest,holy,134,63,71
Theophobe,illidan,1190,priest,holy,85,45,40
Darkheals,azralon,1190,priest,holy,52,20,32
Qtasiangirl,emerald-dream,1190,priest,holy,39,14,25
Stennic,emerald-dream,1183,priest,holy,33,17,16
Dolandir,quelthalas,1181,priest,holy,30,18,12
Kazehanaa,ragnaros,1180,priest,holy,30,16,14
Kälashnikova,ragnaros,1180,priest,holy,104,51,53
Flemyth,eitrigg,1180,priest,holy,40,16,24
Ghostiepants,tichondrius,1177,priest,holy,35,13,22
Haushauha,azralon,1164,priest,holy,48,23,25
Suzzanna,frostmourne,1160,priest,holy,41,23,18
Etros,wyrmrest-accord,1156,priest,holy,90,38,52
Ranøth,deathwing,1155,priest,holy,74,31,43
Milkgulper,illidan,1152,priest,holy,24,12,12
Leonihpriest,nemesis,1151,priest,holy,30,12,18
Trompiscola,quelthalas,1151,priest,holy,30,12,18
Endure,moon-guard,1149,priest,holy,24,12,12
Mêgumin,area-52,1147,priest,holy,18,13,5
Maiyennefer,proudmoore,1146,priest,holy,34,13,21
Selket,stormscale,1145,priest,holy,96,42,54
Meiev,quelthalas,1139,priest,holy,24,12,12
Pottime,tichondrius,1139,priest,holy,76,33,43
Kasiry,ragnaros,1137,priest,holy,90,37,53
Tianqing,tichondrius,1126,priest,holy,34,12,22
Benjamints,thrall,1124,priest,holy,24,12,12
Voidthulhu,stormrage,1124,priest,holy,131,48,83
Dactylion,moon-guard,1119,priest,holy,24,12,12
Æsir,skullcrusher,1119,priest,holy,30,12,18
Niná,arathor,1114,priest,holy,20,13,7
Zojhira,khazgoroth,1114,priest,holy,66,32,34
Carray,goldrinn,1113,priest,holy,49,16,33
Anemonie,gorefiend,1111,priest,holy,112,46,66
Atlana,gilneas,1107,priest,holy,24,16,8
Mailboxxy,kelthuzad,1107,priest,holy,42,18,24
Karenpigbear,area-52,1091,priest,holy,215,95,120
Kytiana,blackwing-lair,1088,priest,holy,548,266,282
Sôlîånia,alterac-mountains,1081,priest,holy,39,27,12
Deathrina,moon-guard,1079,priest,holy,27,13,14
Beckzz,illidan,1070,priest,holy,26,17,9
Fayth,maiev,1070,priest,holy,29,15,14
Mavuiss,barthilas,1069,priest,holy,25,12,13
Floppytatas,illidan,1060,priest,holy,147,70,77
Badgoy,dalaran,1056,priest,holy,24,11,13
Pesian,dalaran,1055,priest,holy,22,12,10
Kernelious,illidan,1055,priest,holy,24,11,13
Iilmama,area-52,1054,priest,holy,18,11,7
Holypopocat,tichondrius,1052,priest,holy,21,12,9
Hypepriest,sargeras,1049,priest,holy,18,11,7
Dotdotdead,earthen-ring,1049,priest,holy,18,11,7
Soulhealer,shadowmoon,1048,priest,holy,24,13,11
Swrvlol,emerald-dream,1045,priest,holy,18,11,7
Dylirium,dathremar,1044,priest,holy,18,11,7
Zumnb,quelthalas,1042,priest,holy,24,11,13
Droneboy,moon-guard,1037,priest,holy,24,11,13
Sanaconda,sargeras,1035,priest,holy,30,11,19
Alicia,nazjatar,1032,priest,holy,18,13,5
Celani,gilneas,1026,priest,holy,24,11,13
Ninbará,stormrage,1023,priest,holy,26,12,14
Hälø,moon-guard,1019,priest,holy,27,12,15
Dreäveler,stormrage,1007,priest,holy,21,11,10
Pandamila,azralon,1004,priest,holy,19,11,8
Veltaxis,moon-guard,998,priest,holy,162,72,90
Sybenela,proudmoore,994,priest,holy,61,28,33
Yinaiteen,drakkari,985,priest,holy,64,33,31
Priesttess,skullcrusher,981,priest,holy,23,11,12
Seråphim,sargeras,979,priest,holy,66,36,30
Souljourner,stormrage,976,priest,holy,59,26,33
Vìxèn,zuljin,969,priest,holy,37,11,26
Ragekiller,lothar,968,priest,holy,48,23,25
Jameswarren,silvermoon,959,priest,holy,11,11,0
Pèrona,tichondrius,959,priest,holy,24,10,14
Trickyhobo,area-52,958,priest,holy,12,10,2
Iaptop,tichondrius,958,priest,holy,18,10,8
Folate,frostmourne,957,priest,holy,18,10,8
Bugshott,tichondrius,956,priest,holy,32,10,22
Noobepriest,thrall,955,priest,holy,18,10,8
Priestybear,illidan,955,priest,holy,18,10,8
Cappoo,tichondrius,955,priest,holy,36,10,26
Snuffsnorter,kelthuzad,953,priest,holy,29,10,19
Delthas,nagrand,952,priest,holy,124,60,64
Dovoso,kargath,951,priest,holy,26,10,16
Hycinamun,malganis,949,priest,holy,24,10,14
Novous,area-52,944,priest,holy,30,10,20
Holyfizzle,dethecus,936,priest,holy,30,14,16
Taylorsmites,emerald-dream,931,priest,holy,42,18,24
Eredwarraim,akama,930,priest,holy,36,13,23
Jol,aggramar,928,priest,holy,24,10,14
Dipanddøts,area-52,926,priest,holy,17,10,7
Thisistragic,frostmourne,905,priest,holy,14,11,3
Hpcando,frostmourne,905,priest,holy,20,12,8
Artemix,azralon,903,priest,holy,119,48,71
Veni,kiljaeden,885,priest,holy,23,10,13
Teheleopapi,quelthalas,877,priest,holy,69,16,53
Pharmacee,korgath,871,priest,holy,72,21,51
Dadcantdeath,frostmourne,864,priest,holy,18,9,9
Pej,emerald-dream,864,priest,holy,18,9,9
Rustymvpfan,nagrand,864,priest,holy,18,9,9
Holyxb,bleeding-hollow,863,priest,holy,18,9,9
Amayå,kelthuzad,863,priest,holy,18,9,9
Glöws,area-52,863,priest,holy,24,9,15
Çummiñs,malganis,862,priest,holy,18,9,9
Chaynal,proudmoore,859,priest,holy,18,9,9
Sondrak,doomhammer,846,priest,holy,41,16,25
Lieuwe,kelthuzad,846,priest,holy,24,9,15
Hamburgle,blackrock,831,priest,holy,16,10,6
Psïren,quelthalas,831,priest,holy,28,9,19
Ascian,daggerspine,809,priest,holy,18,10,8
Helgar,frostmourne,808,priest,holy,18,10,8
Illooj,eonar,797,priest,holy,25,10,15
Híkarí,windrunner,796,priest,holy,14,9,5
Gbumy,tichondrius,784,priest,holy,13,9,4
Fotmtrash,the-underbog,768,priest,holy,12,8,4
Lightwell,blackrock,768,priest,holy,12,8,4
Turnip,zuljin,768,priest,holy,12,8,4
Pmos,sargeras,768,priest,holy,18,8,10
Voidzx,tichondrius,768,priest,holy,18,8,10
Khalesî,ragnaros,767,priest,holy,12,8,4
Hynzor,barthilas,767,priest,holy,30,8,22
Ofmanyfaces,illidan,766,priest,holy,12,8,4
Prayzar,illidan,766,priest,holy,12,8,4
Cyelena,quelthalas,766,priest,holy,24,8,16
Kaelsgf,kaelthas,766,priest,holy,24,8,16
Zeroo,maiev,765,priest,holy,12,8,4
Gewbrr,malganis,765,priest,holy,12,8,4
Manatea,moon-guard,765,priest,holy,18,8,10
Zolpidem,quelthalas,765,priest,holy,18,8,10
Olivinpain,malganis,765,priest,holy,30,8,22
Lenlune,bloodscalp,763,priest,holy,18,8,10
Laj,proudmoore,763,priest,holy,30,8,22
Papergaruru,illidan,762,priest,holy,30,8,22
Bienhechora,quelthalas,760,priest,holy,12,8,4
Priestognic,azralon,759,priest,holy,16,9,7
Ishtana,bleeding-hollow,734,priest,holy,14,9,5
Fäñcÿ,tichondrius,734,priest,holy,17,8,9
Rylance,burning-blade,720,priest,holy,21,8,13
Bigmommyxo,whisperwind,718,priest,holy,21,9,12
Msdash,tichondrius,717,priest,holy,15,8,7
Saintfulsins,sargeras,716,priest,holy,15,8,7
Titoj,tichondrius,708,priest,holy,15,9,6
Jaytee,aggramar,703,priest,holy,14,9,5
Humz,ragnaros,703,priest,holy,14,8,6
Nwok,frostmourne,672,priest,holy,12,7,5
Pevis,thrall,672,priest,holy,12,7,5
Ímhotep,sargeras,672,priest,holy,12,7,5
Canibumsmoke,illidan,672,priest,holy,12,7,5
Lemmiewinkzx,sargeras,672,priest,holy,12,7,5
Hehehealyou,emerald-dream,672,priest,holy,12,7,5
Pgpriest,kelthuzad,672,priest,holy,12,7,5
Beliana,boulderfist,672,priest,holy,16,8,8
Nicksfury,stormrage,672,priest,holy,18,7,11
Tylexus,tichondrius,672,priest,holy,18,7,11
Sorrowful,mannoroth,672,priest,holy,18,7,11
Drelia,jubeithos,672,priest,holy,24,7,17
Yujawang,sargeras,671,priest,holy,12,7,5
Bradythree,moon-guard,671,priest,holy,12,7,5
Suppòrt,stormrage,671,priest,holy,12,7,5
Xoraya,proudmoore,671,priest,holy,12,7,5
Allaras,eldrethalas,671,priest,holy,12,7,5
Jordandoesnt,tichondrius,671,priest,holy,12,7,5
Deidre,illidan,671,priest,holy,16,8,8
Braevera,wyrmrest-accord,671,priest,holy,18,7,11
Dankpope,malganis,670,priest,holy,12,7,5
Qelient,proudmoore,670,priest,holy,12,7,5
Exlord,illidan,670,priest,holy,12,7,5
Salaknib,frostmourne,670,priest,holy,15,7,8
Arena,lothar,669,priest,holy,12,7,5
Dëâth,ghostlands,669,priest,holy,21,8,13
Uzakichan,arygos,669,priest,holy,24,7,17
Klassa,thrall,668,priest,holy,17,8,9
Kisstina,tichondrius,667,priest,holy,24,7,17
Jesaminealbe,quelthalas,666,priest,holy,18,7,11
Vichealer,firetree,660,priest,holy,12,7,5
Releknosleep,frostwolf,634,priest,holy,17,7,10
Yidra,illidan,623,priest,holy,17,7,10
Blackprez,dathremar,613,priest,holy,17,7,10
Punishing,illidan,606,priest,holy,16,7,9
Papadarkness,tichondrius,603,priest,holy,14,7,7
Pikachuwu,moon-guard,586,priest,holy,11,7,4
Didntâsk,arthas,576,priest,holy,12,6,6
Benedictiion,tichondrius,576,priest,holy,12,6,6
Becrixx,thunderlord,576,priest,holy,12,6,6
Runalor,zuljin,576,priest,holy,12,6,6
Bootleg,crushridge,576,priest,holy,12,6,6
Pics,emerald-dream,576,priest,holy,12,6,6
Shockterror,area-52,576,priest,holy,12,6,6
Hysteria,dalaran,576,priest,holy,12,6,6
Unsubbedd,sargeras,576,priest,holy,12,6,6
Feverx,tichondrius,576,priest,holy,12,6,6
Estaria,the-forgotten-coast,576,priest,holy,12,6,6
Praggy,proudmoore,576,priest,holy,12,6,6
Sigx,area-52,576,priest,holy,12,6,6
Linvial,moon-guard,576,priest,holy,12,6,6
Calissy,proudmoore,576,priest,holy,12,6,6
Valiann,lightbringer,576,priest,holy,12,6,6
Sìnz,area-52,576,priest,holy,12,6,6
Marïmba,azralon,576,priest,holy,12,6,6
Îcarus,tichondrius,576,priest,holy,12,6,6
Skylust,azralon,576,priest,holy,12,6,6
Archaellia,area-52,576,priest,holy,12,6,6
Jezebëll,nemesis,576,priest,holy,12,6,6
Fearnfaith,zuljin,576,priest,holy,18,6,12
Rdvark,stormrage,576,priest,holy,18,6,12
Suirr,tichondrius,576,priest,holy,18,6,12
Gustáv,sargeras,576,priest,holy,18,6,12
Xhirra,quelthalas,576,priest,holy,18,6,12
Mattkoster,mannoroth,575,priest,holy,12,6,6
Meowforheals,sargeras,575,priest,holy,12,6,6
Därkness,azralon,575,priest,holy,18,6,12
Kephrek,eonar,575,priest,holy,18,6,12
Sêtsunà,dalaran,575,priest,holy,36,6,30
Cassíopeía,blackhand,574,priest,holy,12,6,6
Aeoliana,laughing-skull,572,priest,holy,12,6,6
Aldryth,lightbringer,571,priest,holy,12,6,6
Zual,hakkar,569,priest,holy,12,6,6
Altara,malygos,569,priest,holy,12,6,6
Messra,dathremar,563,priest,holy,24,6,18
París,mannoroth,559,priest,holy,17,6,11
Satíva,dark-iron,543,priest,holy,11,6,5
Jüdaspriest,gorefiend,522,priest,holy,23,7,16
Trupriest,alleria,511,priest,holy,8,6,2
Jâmïè,gurubashi,511,priest,holy,11,6,5
Huxleypoo,boulderfist,480,priest,holy,6,5,1
Onion,garona,480,priest,holy,6,5,1
Jaaregis,area-52,480,priest,holy,6,5,1
Toje,korgath,480,priest,holy,13,6,7
Phatheals,proudmoore,480,priest,holy,12,5,7
Gad,moon-guard,480,priest,holy,12,5,7
Greytness,tichondrius,480,priest,holy,12,5,7
Maelei,ragnaros,480,priest,holy,12,5,7
Xeras,ravencrest,480,priest,holy,12,5,7
Steve,drakthul,480,priest,holy,12,5,7
Mëïsoön,quelthalas,480,priest,holy,12,5,7
Rysie,winterhoof,480,priest,holy,12,5,7
Snookp,kiljaeden,480,priest,holy,12,5,7
Secrèt,tichondrius,480,priest,holy,12,5,7
Selidri,proudmoore,480,priest,holy,12,5,7
Psytrance,proudmoore,480,priest,holy,12,5,7
Blackoss,sargeras,480,priest,holy,12,5,7
Timbobaloo,thrall,480,priest,holy,12,5,7
Írithyll,sargeras,480,priest,holy,12,5,7
Bunnykinz,moon-guard,480,priest,holy,12,5,7
Meehx,illidan,480,priest,holy,12,5,7
Halfsorrow,tichondrius,480,priest,holy,18,5,13
Holyharlot,sargeras,480,priest,holy,18,5,13
Nancynibbler,bleeding-hollow,480,priest,holy,24,5,19
Mythica,gurubashi,479,priest,holy,12,5,7
Tranith,jubeithos,479,priest,holy,12,5,7
Mímì,wyrmrest-accord,479,priest,holy,12,5,7
Miganmarkle,sargeras,479,priest,holy,12,5,7
Adjectives,nerzhul,479,priest,holy,12,5,7
Pactru,ragnaros,479,priest,holy,18,5,13
Unni,azralon,479,priest,holy,18,5,13
Amunsu,stormrage,475,priest,holy,12,5,7
Smellybox,area-52,463,priest,holy,13,6,7
Shadowchárm,bleeding-hollow,447,priest,holy,11,5,6
Lectra,firetree,447,priest,holy,11,5,6
Holyphodays,sargeras,400,priest,holy,25,5,20
Sizuré,frostmourne,399,priest,holy,5,5,0
Drkwispers,stormrage,384,priest,holy,6,4,2
Xusin,tichondrius,384,priest,holy,6,4,2
Zallp,sargeras,384,priest,holy,6,4,2
Halfdeath,sargeras,384,priest,holy,6,4,2
Cuaiminator,ragnaros,384,priest,holy,6,4,2
Yav,exodar,384,priest,holy,6,4,2
Arcmage,malganis,384,priest,holy,6,4,2
Schátten,spirestone,384,priest,holy,6,4,2
Ticheals,tichondrius,384,priest,holy,6,4,2
Patchyemoly,frostmourne,384,priest,holy,6,4,2
Chanyt,azralon,384,priest,holy,6,4,2
Morticiá,blackrock,384,priest,holy,6,4,2
Dookieate,destromath,384,priest,holy,6,4,2
Aurorias,burning-legion,384,priest,holy,6,4,2
Döyöuliftbro,tichondrius,384,priest,holy,12,4,8
Hoglet,moon-guard,384,priest,holy,12,4,8
Darknuzs,sargeras,384,priest,holy,12,4,8
Sätîvá,tichondrius,384,priest,holy,12,4,8
Zapix,tichondrius,384,priest,holy,12,4,8
Yumä,kiljaeden,384,priest,holy,12,4,8
Frozencherry,elune,384,priest,holy,12,4,8
Carti,bleeding-hollow,384,priest,holy,12,4,8
Mellow,tichondrius,384,priest,holy,12,4,8
Hazzang,tichondrius,384,priest,holy,12,4,8
Depressednun,moon-guard,384,priest,holy,12,4,8
Chambler,aegwynn,384,priest,holy,18,4,14
Aeøns,sargeras,384,priest,holy,18,4,14
Pavle,laughing-skull,384,priest,holy,19,4,15
Dyianah,wyrmrest-accord,383,priest,holy,12,4,8
Healia,tichondrius,383,priest,holy,12,4,8
Conno,thunderlord,379,priest,holy,12,4,8
Remixcandoit,malganis,379,priest,holy,12,4,8
Stradey,tichondrius,367,priest,holy,11,4,7
Sharkda,frostmourne,350,priest,holy,17,4,13
Santamuerte,agamaggan,336,priest,holy,15,4,11
Boogiedo,area-52,319,priest,holy,5,4,1
Vandamnation,barthilas,319,priest,holy,8,4,4
Kabutta,stormrage,318,priest,holy,14,4,10
ßugsy,illidan,288,priest,holy,6,3,3
Lullabya,tichondrius,288,priest,holy,6,3,3
Whitewalls,moonrunner,288,priest,holy,6,3,3
Dividëd,stormrage,288,priest,holy,6,3,3
Duonaiameng,illidan,288,priest,holy,6,3,3
Deeznuhh,tichondrius,288,priest,holy,6,3,3
Vynlanesh,illidan,288,priest,holy,6,3,3
Alwaystry,tichondrius,288,priest,holy,6,3,3
Ärchangél,tichondrius,288,priest,holy,6,3,3
Charbosan,gorgonnash,288,priest,holy,6,3,3
Raphan,stormrage,288,priest,holy,6,3,3
Healdog,thrall,288,priest,holy,6,3,3
Calvisper,thunderlord,288,priest,holy,6,3,3
Matiuca,stormrage,288,priest,holy,6,3,3
Smiteyducks,stormrage,288,priest,holy,6,3,3
Meatguzzler,tichondrius,288,priest,holy,6,3,3
Aardyx,frostmourne,288,priest,holy,6,3,3
Miamama,hydraxis,288,priest,holy,6,3,3
Cessar,proudmoore,288,priest,holy,6,3,3
Mucada,tichondrius,288,priest,holy,6,3,3
Tseirpyeroc,area-52,288,priest,holy,6,3,3
Whehaw,kelthuzad,288,priest,holy,6,3,3
Justjoekingh,gurubashi,288,priest,holy,6,3,3
Darkmoonsun,frostmourne,288,priest,holy,6,3,3
Bagoheals,area-52,288,priest,holy,6,3,3
Ñÿx,arthas,288,priest,holy,6,3,3
Plánemo,azralon,288,priest,holy,6,3,3
Madomie,bladefist,288,priest,holy,6,3,3
Sagapriest,hyjal,288,priest,holy,6,3,3
Xtcbtc,sargeras,288,priest,holy,6,3,3
Rottigus,skullcrusher,288,priest,holy,6,3,3
Smalltoad,lightnings-blade,288,priest,holy,6,3,3
Crypthion,emerald-dream,288,priest,holy,6,3,3
Nerfdisc,azralon,288,priest,holy,6,3,3
Laurens,fenris,288,priest,holy,6,3,3
Wubbi,blackrock,288,priest,holy,6,3,3
Trying,ysera,288,priest,holy,6,3,3
Zesho,firetree,288,priest,holy,6,3,3
Greet,hyjal,288,priest,holy,6,3,3
Discountay,burning-legion,288,priest,holy,6,3,3
Orderic,ragnaros,288,priest,holy,6,3,3
Grindr,ragnaros,288,priest,holy,6,3,3
Purgeoften,sargeras,288,priest,holy,6,3,3
Sarkozzlol,tichondrius,288,priest,holy,12,3,9
Smitepie,malganis,288,priest,holy,12,3,9
Hòwen,tichondrius,288,priest,holy,12,3,9
Disperse,vashj,288,priest,holy,12,3,9
Ísábella,ragnaros,288,priest,holy,12,3,9
Swis,area-52,288,priest,holy,12,3,9
Øliverxp,lightbringer,288,priest,holy,12,3,9
Lalight,tichondrius,288,priest,holy,12,3,9
Camedy,illidan,288,priest,holy,12,3,9
Jezuz,aerie-peak,288,priest,holy,12,3,9
Irilde,proudmoore,288,priest,holy,12,3,9
Cataline,emerald-dream,288,priest,holy,12,3,9
Healiûm,bleeding-hollow,288,priest,holy,12,3,9
Pringlés,suramar,288,priest,holy,18,3,15
Fertalize,maiev,288,priest,holy,18,3,15
Fìngerbanger,lightnings-blade,287,priest,holy,6,3,3
Korhíl,ragnaros,287,priest,holy,6,3,3
Auradaluz,stormrage,287,priest,holy,12,3,9
Meibuff,frostmourne,287,priest,holy,18,3,15
Albina,kelthuzad,239,priest,holy,5,3,2
Bofin,stormrage,234,priest,holy,16,4,12
Ftheman,tichondrius,234,priest,holy,17,4,13
Halö,doomhammer,223,priest,holy,14,3,11
Damokek,tichondrius,192,priest,holy,9,3,6
Mutedox,frostmourne,192,priest,holy,6,2,4
Daddyhammer,area-52,192,priest,holy,6,2,4
Nodorme,quelthalas,192,priest,holy,6,2,4
Yuritzi,duskwood,192,priest,holy,6,2,4
Faedre,smolderthorn,192,priest,holy,6,2,4
Belfortx,tichondrius,192,priest,holy,6,2,4
Pandap,dalaran,192,priest,holy,6,2,4
Saenax,area-52,192,priest,holy,6,2,4
Arodar,wyrmrest-accord,192,priest,holy,6,2,4
Silentprayer,area-52,192,priest,holy,6,2,4
Jonhey,tichondrius,192,priest,holy,6,2,4
Context,mannoroth,192,priest,holy,6,2,4
Visse,auchindoun,192,priest,holy,6,2,4
Gusho,frostmourne,192,priest,holy,6,2,4
Voltstein,dalaran,192,priest,holy,6,2,4
Aethriem,bleeding-hollow,192,priest,holy,6,2,4
Tuulipp,aegwynn,192,priest,holy,6,2,4
Whitelabel,proudmoore,192,priest,holy,6,2,4
Sensitive,eitrigg,192,priest,holy,6,2,4
Wagnerr,jubeithos,192,priest,holy,6,2,4
Gles,quelthalas,192,priest,holy,6,2,4
Igotubrah,malganis,192,priest,holy,6,2,4
Pûrplehaze,aegwynn,192,priest,holy,6,2,4
Mindgoblin,terokkar,192,priest,holy,6,2,4
Hypodontia,caelestrasz,192,priest,holy,6,2,4
Shemhazai,ragnaros,192,priest,holy,6,2,4
Mevix,firetree,192,priest,holy,6,2,4
Jilt,aerie-peak,192,priest,holy,6,2,4
Sinthe,stormrage,192,priest,holy,6,2,4
Dchi,tichondrius,192,priest,holy,6,2,4
Opas,rivendare,192,priest,holy,6,2,4
Verboden,kelthuzad,192,priest,holy,6,2,4
Felmnir,ragnaros,192,priest,holy,6,2,4
Twodxo,kelthuzad,192,priest,holy,6,2,4
ßræcher,black-dragonflight,192,priest,holy,6,2,4
Mitras,moon-guard,192,priest,holy,6,2,4
Mendx,tichondrius,192,priest,holy,6,2,4
Prescella,sargeras,192,priest,holy,6,2,4
Mommyafk,moon-guard,192,priest,holy,6,2,4
Ôp,sargeras,192,priest,holy,6,2,4
Speyside,medivh,192,priest,holy,6,2,4
Löstský,azralon,192,priest,holy,7,2,5
Saintguard,tichondrius,192,priest,holy,11,3,8
Langyi,tichondrius,192,priest,holy,10,2,8
Nevertelsp,malganis,192,priest,holy,12,2,10
Excellency,tichondrius,192,priest,holy,12,2,10
Pinoculus,illidan,192,priest,holy,12,2,10
Althir,ragnaros,192,priest,holy,12,2,10
Fraggydaddy,frostmourne,192,priest,holy,12,2,10
Påticus,area-52,192,priest,holy,13,2,11
Gillís,thrall,192,priest,holy,18,2,16
Krishpriest,azshara,191,priest,holy,6,2,4
Mikeliteo,blades-edge,190,priest,holy,12,2,10
Sneaks,frostmourne,159,priest,holy,5,2,3
Identìty,moon-guard,138,priest,holy,8,3,5
Pumpss,area-52,138,priest,holy,11,3,8
Bigvuqoffdam,area-52,138,priest,holy,16,3,13
Plzhelp,cairne,136,priest,holy,9,3,6
Exploded,moon-guard,96,priest,holy,6,1,5
Lerien,thrall,96,priest,holy,6,1,5
Thotsteal,lightbringer,96,priest,holy,6,1,5
Faithmelter,stormrage,96,priest,holy,6,1,5
Bloodcure,ysera,96,priest,holy,6,1,5
Hüde,stormrage,96,priest,holy,6,1,5
Bigboyadam,frostmourne,96,priest,holy,6,1,5
Hubbabubble,wyrmrest-accord,96,priest,holy,6,1,5
Alaskaa,moon-guard,96,priest,holy,6,1,5
Sarïya,moon-guard,96,priest,holy,6,1,5
Breathkeeper,proudmoore,96,priest,holy,6,1,5
Burtier,zuljin,96,priest,holy,6,1,5
Tammyone,emerald-dream,96,priest,holy,6,1,5
Haedn,azralon,96,priest,holy,6,1,5
Prayboy,aerie-peak,96,priest,holy,6,1,5
Sukmysplooge,queldorei,96,priest,holy,6,1,5
Qnarisha,tichondrius,96,priest,holy,6,1,5
Novoul,stormrage,96,priest,holy,6,1,5
Minamy,tichondrius,96,priest,holy,6,1,5
Alëssana,illidan,96,priest,holy,6,1,5
Rakel,nathrezim,96,priest,holy,6,1,5
Olassi,stormrage,96,priest,holy,6,1,5
Bunked,bleeding-hollow,96,priest,holy,6,1,5
Kagura,dunemaul,96,priest,holy,6,1,5
Lilpaprika,sargeras,96,priest,holy,6,1,5
Tichealstwo,tichondrius,96,priest,holy,6,1,5
Angelicduck,illidan,96,priest,holy,6,1,5
Deryus,dalaran,96,priest,holy,6,1,5
Majjic,proudmoore,96,priest,holy,6,1,5
Janova,tichondrius,96,priest,holy,6,1,5
Tuuros,wyrmrest-accord,96,priest,holy,6,1,5
Missjules,illidan,96,priest,holy,6,1,5
Shadyvoodoo,barthilas,96,priest,holy,6,1,5
Yungsherm,tichondrius,96,priest,holy,6,1,5
Bofuri,barthilas,96,priest,holy,6,1,5
Kastwalker,earthen-ring,96,priest,holy,6,1,5
Akami,tichondrius,96,priest,holy,6,1,5
Lasaldra,quelthalas,96,priest,holy,6,1,5
Hiroshikun,azshara,96,priest,holy,6,1,5
Jerkingit,tichondrius,96,priest,holy,12,1,11
Djriest,sargeras,96,priest,holy,12,1,11
Barryp,wyrmrest-accord,96,priest,holy,12,1,11
Gutrose,area-52,96,priest,holy,12,1,11
Brownsnooter,sargeras,79,priest,holy,5,1,4
Helorren,nagrand,79,priest,holy,11,1,10
Wiralyn,nathrezim,79,priest,holy,11,1,10
Undrcvr,sargeras,2273,priest,discipline,132,73,59
Èfflux,sargeras,2252,priest,discipline,97,56,41
Whammiez,tichondrius,2243,priest,discipline,84,50,34
Strickmaney,nathrezim,2237,priest,discipline,258,139,119
Gentlewoman,ragnaros,2174,priest,discipline,87,51,36
Pesian,dalaran,2153,priest,discipline,233,121,112
Yefri,ravencrest,2145,priest,discipline,177,102,75
Reedyjrrtv,tichondrius,2145,priest,discipline,168,88,80
Cinnamontage,illidan,2142,priest,discipline,114,64,50
Castsmite,tichondrius,2141,priest,discipline,99,52,47
Shikinomi,illidan,2133,priest,discipline,78,46,32
Wcnmb,blackrock,2123,priest,discipline,72,46,26
Jiangfeng,tichondrius,2120,priest,discipline,72,37,35
Celestiah,kelthuzad,2119,priest,discipline,72,37,35
Baldzx,sargeras,2116,priest,discipline,292,160,132
Nusrah,tichondrius,2114,priest,discipline,87,45,42
Frksake,area-52,2111,priest,discipline,192,114,78
Kovulol,area-52,2107,priest,discipline,126,67,59
Néylo,illidan,2106,priest,discipline,112,56,56
Psyches,dalaran,2106,priest,discipline,109,50,59
Amberturd,cenarius,2103,priest,discipline,102,48,54
Woolp,frostmourne,2102,priest,discipline,100,58,42
Changwongpk,kelthuzad,2101,priest,discipline,237,124,113
Søryn,madoran,2100,priest,discipline,102,52,50
Rukiyou,frostwolf,2098,priest,discipline,198,99,99
Veivei,tichondrius,2095,priest,discipline,59,38,21
Bholebender,tichondrius,2085,priest,discipline,89,47,42
Ante,stonemaul,2075,priest,discipline,108,59,49
Zxxkawaii,tichondrius,2075,priest,discipline,163,85,78
Pancakeboi,tichondrius,2070,priest,discipline,131,64,67
Rmpmeeper,kilrogg,2055,priest,discipline,72,42,30
Classmaster,stormrage,2054,priest,discipline,183,100,83
Kkelly,stormrage,2053,priest,discipline,250,126,124
Esqueue,illidan,2044,priest,discipline,54,26,28
Lemonmint,tichondrius,2040,priest,discipline,94,46,48
Shazdo,illidan,2039,priest,discipline,60,39,21
Sÿnpriest,illidan,2039,priest,discipline,408,202,206
Mauvex,stormrage,2033,priest,discipline,546,270,276
Instoway,illidan,2029,priest,discipline,150,89,61
Oogs,tichondrius,2028,priest,discipline,161,75,86
Crutched,blackhand,2022,priest,discipline,60,35,25
Zámmy,area-52,2021,priest,discipline,65,44,21
Redonkulos,shattered-hand,2021,priest,discipline,162,85,77
Idkmyname,proudmoore,2018,priest,discipline,58,29,29
Proxs,sargeras,2017,priest,discipline,213,108,105
Blessxo,ragnaros,2016,priest,discipline,96,45,51
Twocrshort,area-52,2013,priest,discipline,149,89,60
Cosmicyiff,area-52,2010,priest,discipline,100,57,43
Quaree,stormrage,2010,priest,discipline,536,278,258
Clearclouds,tichondrius,2004,priest,discipline,210,113,97
Reilacoste,moon-guard,2002,priest,discipline,83,41,42
Xajen,illidan,1996,priest,discipline,84,39,45
Nucypher,illidan,1993,priest,discipline,204,118,86
Hectorz,zuljin,1992,priest,discipline,106,50,56
Eluneslight,tichondrius,1990,priest,discipline,78,40,38
Markers,spinebreaker,1989,priest,discipline,130,64,66
Sonicboomsz,azralon,1985,priest,discipline,122,63,59
Crabsp,illidan,1981,priest,discipline,132,68,64
Smokezter,area-52,1981,priest,discipline,159,81,78
Crutch,blackhand,1980,priest,discipline,54,30,24
Praemal,tichondrius,1980,priest,discipline,96,42,54
Etharass,illidan,1976,priest,discipline,84,36,48
Dayx,malganis,1975,priest,discipline,102,51,51
Amine,tichondrius,1970,priest,discipline,60,34,26
Azzäm,tichondrius,1970,priest,discipline,90,48,42
Astüty,illidan,1967,priest,discipline,66,37,29
Supaflute,tichondrius,1967,priest,discipline,72,32,40
Abepriest,zuljin,1964,priest,discipline,204,106,98
Solecíto,ragnaros,1963,priest,discipline,89,60,29
Klydasoreass,malganis,1963,priest,discipline,59,38,21
Stepxo,sargeras,1963,priest,discipline,117,63,54
Praitne,tichondrius,1963,priest,discipline,113,59,54
Leorid,stormrage,1963,priest,discipline,148,71,77
Praeyer,area-52,1961,priest,discipline,380,194,186
Aratis,bleeding-hollow,1961,priest,discipline,90,44,46
Fannyny,tichondrius,1958,priest,discipline,132,83,49
Mimz,trollbane,1958,priest,discipline,65,37,28
Hospetal,tichondrius,1955,priest,discipline,146,74,72
Awàken,sargeras,1952,priest,discipline,57,35,22
Iilmama,area-52,1948,priest,discipline,105,55,50
Peruggia,tichondrius,1948,priest,discipline,72,36,36
Poporeborn,tichondrius,1948,priest,discipline,200,98,102
Gotdro,kelthuzad,1942,priest,discipline,68,36,32
Boykoz,zuljin,1942,priest,discipline,115,58,57
Mimikyú,tichondrius,1941,priest,discipline,96,41,55
Gosharbg,tichondrius,1940,priest,discipline,34,24,10
Devinere,tichondrius,1940,priest,discipline,515,276,239
Sarkozzlol,tichondrius,1938,priest,discipline,84,43,41
Goodlife,frostmourne,1936,priest,discipline,65,30,35
Astroverse,tichondrius,1933,priest,discipline,82,45,37
Plaedo,stormscale,1932,priest,discipline,52,28,24
Fádé,illidan,1932,priest,discipline,97,48,49
Namilol,tichondrius,1931,priest,discipline,54,30,24
Diabloluckie,tichondrius,1928,priest,discipline,108,56,52
Budings,tichondrius,1927,priest,discipline,143,77,66
Velftrixi,sargeras,1927,priest,discipline,180,94,86
Miamama,hydraxis,1926,priest,discipline,105,56,49
Curachon,darkspear,1926,priest,discipline,93,42,51
Invincible,ragnaros,1924,priest,discipline,80,45,35
Balsak,zuljin,1924,priest,discipline,152,72,80
Cklifer,tichondrius,1922,priest,discipline,46,26,20
Lovelike,tichondrius,1922,priest,discipline,74,41,33
Eyolo,tichondrius,1918,priest,discipline,78,40,38
Vinnydiesel,tichondrius,1918,priest,discipline,66,32,34
Fotmvark,stormrage,1916,priest,discipline,78,36,42
Frostinal,illidan,1915,priest,discipline,126,69,57
Høwtokill,azralon,1915,priest,discipline,89,36,53
Thefiveoh,malganis,1914,priest,discipline,27,23,4
Deathblind,kelthuzad,1912,priest,discipline,65,34,31
Anasuzana,stormrage,1911,priest,discipline,66,38,28
Muhfinx,tichondrius,1911,priest,discipline,53,30,23
Artíst,sargeras,1911,priest,discipline,119,64,55
Likethis,ragnaros,1911,priest,discipline,359,181,178
Varenon,stormrage,1910,priest,discipline,159,90,69
Evicereith,ragnaros,1910,priest,discipline,48,26,22
Aitri,hakkar,1910,priest,discipline,151,73,78
Penanceperry,bleeding-hollow,1910,priest,discipline,286,137,149
Snackermz,tichondrius,1909,priest,discipline,112,48,64
Chee,bleeding-hollow,1905,priest,discipline,60,34,26
Omhz,tichondrius,1905,priest,discipline,96,49,47
Ccgo,tichondrius,1902,priest,discipline,108,53,55
Candyshack,area-52,1900,priest,discipline,111,64,47
Riseandshine,illidan,1896,priest,discipline,54,38,16
Pølupoker,illidan,1895,priest,discipline,59,27,32
Boriz,frostmourne,1892,priest,discipline,79,44,35
Zerorizz,tichondrius,1890,priest,discipline,42,20,22
Ndzy,malganis,1890,priest,discipline,48,21,27
Mumrah,antonidas,1889,priest,discipline,130,64,66
Haunting,nerzhul,1886,priest,discipline,209,103,106
Discopenguin,kelthuzad,1885,priest,discipline,60,34,26
Khaoshealer,destromath,1884,priest,discipline,137,68,69
Usefirstaid,sargeras,1883,priest,discipline,42,26,16
Cupitan,tichondrius,1883,priest,discipline,62,27,35
Grimacê,sargeras,1882,priest,discipline,98,49,49
ßeyonder,tichondrius,1882,priest,discipline,122,58,64
Abt,proudmoore,1882,priest,discipline,66,31,35
Usedwrap,sargeras,1881,priest,discipline,78,43,35
Capcana,tichondrius,1881,priest,discipline,114,61,53
Jthealz,tichondrius,1881,priest,discipline,54,28,26
Throatgoated,moon-guard,1881,priest,discipline,47,21,26
Qipriest,tichondrius,1880,priest,discipline,66,28,38
Cremona,tichondrius,1878,priest,discipline,84,39,45
Breakmoon,tichondrius,1876,priest,discipline,78,33,45
Sñ,illidan,1874,priest,discipline,48,27,21
Rileymcgerr,tichondrius,1873,priest,discipline,42,24,18
Exdric,kiljaeden,1873,priest,discipline,72,36,36
Rawze,tichondrius,1873,priest,discipline,69,32,37
Dellaptop,sargeras,1871,priest,discipline,88,51,37
Nerfthedoc,blackrock,1869,priest,discipline,55,34,21
Reydehaiti,ragnaros,1869,priest,discipline,54,31,23
Montagehey,illidan,1868,priest,discipline,83,43,40
Lidoradra,zuljin,1867,priest,discipline,77,36,41
Notatk,tichondrius,1866,priest,discipline,221,99,122
Tiestô,tichondrius,1864,priest,discipline,48,29,19
Shallwedance,tichondrius,1864,priest,discipline,74,43,31
Jerkingit,tichondrius,1864,priest,discipline,88,44,44
Spoõks,darkspear,1862,priest,discipline,141,69,72
Cokeheals,tichondrius,1861,priest,discipline,60,29,31
Bubblekanush,tichondrius,1859,priest,discipline,36,22,14
Reecepack,moon-guard,1859,priest,discipline,53,31,22
Athênå,tichondrius,1859,priest,discipline,186,106,80
Usebindwound,sargeras,1857,priest,discipline,108,65,43
Highskrizzle,thrall,1857,priest,discipline,67,37,30
Duw,icecrown,1857,priest,discipline,151,75,76
Phludd,malganis,1856,priest,discipline,82,45,37
Vizzy,stormrage,1856,priest,discipline,96,51,45
Ravnica,kelthuzad,1856,priest,discipline,82,43,39
Presence,blood-furnace,1855,priest,discipline,42,23,19
Shadey,onyxia,1855,priest,discipline,54,26,28
Nayzoh,darkspear,1855,priest,discipline,78,37,41
Faeleath,emerald-dream,1855,priest,discipline,68,32,36
Vidzar,area-52,1854,priest,discipline,42,28,14
Drsquiddy,tichondrius,1854,priest,discipline,47,30,17
Stayspooked,moon-guard,1852,priest,discipline,54,31,23
Jtheals,illidan,1852,priest,discipline,35,20,15
Centalinkxo,frostmourne,1851,priest,discipline,72,36,36
Cardinaldave,frostmourne,1850,priest,discipline,48,26,22
Shieldspamx,tichondrius,1850,priest,discipline,89,41,48
Stinkiez,area-52,1849,priest,discipline,171,93,78
Lumies,tichondrius,1848,priest,discipline,42,21,21
Polarnight,zuljin,1848,priest,discipline,59,29,30
Bigshieldlol,illidan,1847,priest,discipline,60,39,21
Chromielol,tichondrius,1847,priest,discipline,54,31,23
Tzïñåçåñ,tichondrius,1847,priest,discipline,54,29,25
Voidnoodles,area-52,1846,priest,discipline,60,32,28
Ultradumb,ragnaros,1846,priest,discipline,42,21,21
Jmjeezy,tichondrius,1846,priest,discipline,48,22,26
Fordranger,frostmourne,1845,priest,discipline,58,30,28
Koalakazamzy,shadow-council,1845,priest,discipline,58,29,29
Cavityx,illidan,1844,priest,discipline,52,30,22
Steelcity,tichondrius,1843,priest,discipline,54,28,26
Dacine,illidan,1843,priest,discipline,60,30,30
Nickydamous,moon-guard,1843,priest,discipline,66,31,35
Jiangfenglol,tichondrius,1843,priest,discipline,54,24,30
Mcgg,tichondrius,1842,priest,discipline,158,76,82
Zelená,trollbane,1841,priest,discipline,128,77,51
Vampirê,tichondrius,1841,priest,discipline,66,35,31
Kck,sentinels,1841,priest,discipline,95,44,51
Meoveryou,stormrage,1840,priest,discipline,86,47,39
Syliva,frostmourne,1840,priest,discipline,65,30,35
Alisas,malganis,1840,priest,discipline,118,51,67
Donutpriest,kelthuzad,1839,priest,discipline,78,44,34
Koalakazamza,shadow-council,1839,priest,discipline,62,28,34
Tistapriest,proudmoore,1837,priest,discipline,70,41,29
Waggers,moon-guard,1837,priest,discipline,42,23,19
Lotion,icecrown,1837,priest,discipline,48,25,23
Katalad,wyrmrest-accord,1836,priest,discipline,48,31,17
Tiernocookie,illidan,1836,priest,discipline,335,170,165
Shamáng,tichondrius,1836,priest,discipline,80,39,41
Binipriest,tichondrius,1835,priest,discipline,67,40,27
Jamino,jubeithos,1835,priest,discipline,111,60,51
Tmeugene,tichondrius,1835,priest,discipline,40,21,19
Icychain,area-52,1835,priest,discipline,76,34,42
Bugweeb,sargeras,1834,priest,discipline,87,56,31
Layons,nemesis,1834,priest,discipline,134,86,48
Twopiece,blackrock,1834,priest,discipline,54,31,23
Rÿzo,tichondrius,1834,priest,discipline,111,63,48
Thottsteal,queldorei,1834,priest,discipline,60,31,29
Ameliarys,sargeras,1833,priest,discipline,103,51,52
Sons,zuljin,1832,priest,discipline,54,29,25
Meloxicamm,tichondrius,1832,priest,discipline,136,69,67
Oghealz,lightnings-blade,1832,priest,discipline,54,27,27
Oloriinn,stormrage,1831,priest,discipline,36,24,12
Antagzy,bleeding-hollow,1830,priest,discipline,108,69,39
Msai,tichondrius,1830,priest,discipline,114,68,46
Pregnantmale,area-52,1830,priest,discipline,49,29,20
Yotinha,stormrage,1830,priest,discipline,48,28,20
Strvnge,malganis,1830,priest,discipline,60,28,32
Xiaoqunzi,tichondrius,1830,priest,discipline,108,50,58
Joezyxz,tichondrius,1829,priest,discipline,133,67,66
Renfury,bleeding-hollow,1829,priest,discipline,48,22,26
Cpks,tichondrius,1828,priest,discipline,76,48,28
Baphomet,hyjal,1828,priest,discipline,88,53,35
Misatomori,tichondrius,1828,priest,discipline,54,28,26
Didy,dark-iron,1828,priest,discipline,58,27,31
Epitoh,bleeding-hollow,1828,priest,discipline,78,36,42
Sleetherp,barthilas,1827,priest,discipline,64,37,27
Bkwhopper,emerald-dream,1827,priest,discipline,143,81,62
Fracxured,sargeras,1827,priest,discipline,68,31,37
Bloodyxx,bleeding-hollow,1825,priest,discipline,34,23,11
Noted,aegwynn,1825,priest,discipline,104,70,34
Buffle,zuluhed,1825,priest,discipline,66,38,28
Yokuz,thunderlord,1825,priest,discipline,48,26,22
Mackulate,tichondrius,1825,priest,discipline,65,34,31
Cokeheals,kelthuzad,1825,priest,discipline,54,28,26
Aprîl,quelthalas,1825,priest,discipline,72,37,35
Däzzlë,quelthalas,1825,priest,discipline,72,35,37
Pnsp,perenolde,1824,priest,discipline,42,30,12
Xholyshietz,emerald-dream,1824,priest,discipline,71,48,23
Pervysaged,sargeras,1824,priest,discipline,60,40,20
Cya,deathwing,1824,priest,discipline,54,30,24
Mancito,mannoroth,1824,priest,discipline,144,74,70
Temérios,azralon,1824,priest,discipline,54,27,27
Tuxen,wyrmrest-accord,1823,priest,discipline,48,29,19
Swurvexo,bleeding-hollow,1823,priest,discipline,47,28,19
Barthol,malygos,1823,priest,discipline,225,115,110
Sprankels,bleeding-hollow,1823,priest,discipline,108,55,53
Luhkx,stormrage,1823,priest,discipline,54,25,29
Ohsop,chogall,1822,priest,discipline,49,33,16
Dairy,the-underbog,1822,priest,discipline,49,29,20
Lands,ragnaros,1822,priest,discipline,120,69,51
Memoria,emerald-dream,1822,priest,discipline,117,60,57
Bearfriend,malorne,1822,priest,discipline,47,24,23
Zachon,sargeras,1822,priest,discipline,54,27,27
Oohso,chogall,1821,priest,discipline,91,43,48
Rerollpriest,firetree,1821,priest,discipline,53,25,28
Chiot,tichondrius,1820,priest,discipline,61,48,13
Ultrà,ragnaros,1820,priest,discipline,71,44,27
Wreklol,tichondrius,1820,priest,discipline,60,34,26
Mindseye,azgalor,1820,priest,discipline,114,58,56
Dietcokee,stormrage,1820,priest,discipline,62,31,31
Ujelin,kiljaeden,1820,priest,discipline,48,24,24
Horzp,bleeding-hollow,1820,priest,discipline,66,31,35
Tophr,illidan,1819,priest,discipline,41,24,17
Wapriest,blades-edge,1819,priest,discipline,500,248,252
Chk,moon-guard,1819,priest,discipline,136,65,71
Soojwa,frostmourne,1819,priest,discipline,54,24,30
Novel,moon-guard,1817,priest,discipline,30,24,6
Despairx,tichondrius,1817,priest,discipline,102,66,36
Gaudthree,tichondrius,1817,priest,discipline,46,25,21
Akuzaki,illidan,1817,priest,discipline,54,25,29
Sliktrik,area-52,1817,priest,discipline,65,29,36
Dapp,barthilas,1817,priest,discipline,77,33,44
Cynthus,dalvengyr,1816,priest,discipline,102,60,42
Lichtschreit,zuljin,1816,priest,discipline,41,24,17
Juicyturon,moon-guard,1816,priest,discipline,77,45,32
Dispassion,dalaran,1816,priest,discipline,58,33,25
Woodowl,tichondrius,1816,priest,discipline,46,25,21
Bamboon,tanaris,1816,priest,discipline,102,55,47
Jackski,nemesis,1816,priest,discipline,48,25,23
Legendary,ragnaros,1816,priest,discipline,78,33,45
Quèénstar,tichondrius,1816,priest,discipline,79,33,46
Badrapture,sargeras,1815,priest,discipline,92,69,23
Mødilon,nemesis,1815,priest,discipline,47,29,18
Rythmzz,kiljaeden,1815,priest,discipline,108,59,49
Engle,arathor,1815,priest,discipline,42,22,20
Badnsweaty,sargeras,1815,priest,discipline,76,38,38
Ousïa,quelthalas,1815,priest,discipline,164,81,83
Mommyafk,moon-guard,1815,priest,discipline,54,25,29
Psyjes,stormrage,1814,priest,discipline,111,69,42
Diwara,ragnaros,1814,priest,discipline,60,37,23
Fullmetals,azralon,1814,priest,discipline,53,30,23
Zuwukey,kirin-tor,1814,priest,discipline,163,85,78
Tanmo,illidan,1814,priest,discipline,96,50,46
Syllè,area-52,1814,priest,discipline,48,24,24
Adûnaic,frostmourne,1814,priest,discipline,380,185,195
Fibbre,tichondrius,1814,priest,discipline,121,54,67
Razdaz,twisting-nether,1814,priest,discipline,66,29,37
Relicx,firetree,1813,priest,discipline,54,33,21
Youhealme,area-52,1813,priest,discipline,90,54,36
Hoonjojjyang,tichondrius,1813,priest,discipline,66,37,29
Morboo,proudmoore,1813,priest,discipline,78,43,35
Svzy,illidan,1813,priest,discipline,48,26,22
Sasha,muradin,1813,priest,discipline,142,70,72
Sixfourtank,tichondrius,1813,priest,discipline,53,26,27
Falsity,kelthuzad,1813,priest,discipline,66,32,34
Ahoy,sargeras,1812,priest,discipline,75,46,29
Abstention,area-52,1812,priest,discipline,66,35,31
Fatbellyx,sargeras,1812,priest,discipline,72,36,36
Sabalonely,tichondrius,1812,priest,discipline,42,19,23
Tyrrshadow,skywall,1811,priest,discipline,104,58,46
Tallïa,stormrage,1811,priest,discipline,155,82,73
Hungrybone,proudmoore,1811,priest,discipline,641,327,314
Wübbie,emerald-dream,1810,priest,discipline,72,40,32
Walterwhite,bleeding-hollow,1810,priest,discipline,42,19,23
Paytin,illidan,1810,priest,discipline,71,32,39
Arguseonp,proudmoore,1809,priest,discipline,54,37,17
Ãbelladanger,area-52,1809,priest,discipline,65,43,22
Jemine,tichondrius,1809,priest,discipline,108,64,44
Thepumps,sargeras,1809,priest,discipline,73,43,30
Paramour,laughing-skull,1809,priest,discipline,108,59,49
Jaquels,sargeras,1809,priest,discipline,130,65,65
Dabaojian,tichondrius,1809,priest,discipline,60,28,32
Aube,frostmourne,1809,priest,discipline,51,23,28
Nudithree,malganis,1808,priest,discipline,38,26,12
Antts,tichondrius,1808,priest,discipline,48,31,17
Vbear,dunemaul,1808,priest,discipline,71,39,32
Pkkdestiny,archimonde,1808,priest,discipline,71,37,34
Catbabyorz,tichondrius,1808,priest,discipline,84,41,43
Pns,perenolde,1808,priest,discipline,66,32,34
Buhroketwo,thrall,1807,priest,discipline,66,41,25
Dopeypriest,area-52,1807,priest,discipline,120,68,52
Indiglo,arthas,1807,priest,discipline,84,44,40
Gices,area-52,1806,priest,discipline,36,24,12
Exøtic,tichondrius,1806,priest,discipline,54,35,19
Ayakashi,frostmourne,1806,priest,discipline,75,46,29
Wormface,moon-guard,1806,priest,discipline,58,35,23
Senzy,tichondrius,1806,priest,discipline,150,81,69
Releriel,area-52,1806,priest,discipline,58,31,27
Inthemix,stormreaver,1806,priest,discipline,376,197,179
Yezhua,zuljin,1806,priest,discipline,84,44,40
Scrollozaddy,illidan,1805,priest,discipline,258,157,101
Purplebeauty,tichondrius,1805,priest,discipline,198,119,79
Leapofdoubt,zuljin,1805,priest,discipline,250,132,118
Rylla,illidan,1805,priest,discipline,66,34,32
Maghobou,tichondrius,1805,priest,discipline,66,30,36
Öxhö,tichondrius,1804,priest,discipline,44,31,13
Ðsco,tichondrius,1804,priest,discipline,36,24,12
Absorbs,stormrage,1804,priest,discipline,30,19,11
Fearmen,tichondrius,1804,priest,discipline,59,33,26
Selath,ragnaros,1804,priest,discipline,47,26,21
Angelumlucis,frostmane,1804,priest,discipline,145,80,65
Syrillia,wildhammer,1804,priest,discipline,142,78,64
Cln,bleeding-hollow,1804,priest,discipline,65,32,33
Taipriest,frostmourne,1804,priest,discipline,222,103,119
Yeeseafood,tichondrius,1804,priest,discipline,64,27,37
Thaldrum,tichondrius,1804,priest,discipline,79,30,49
Curney,stormrage,1803,priest,discipline,65,46,19
Jinais,zuluhed,1803,priest,discipline,48,33,15
Phillthevoid,sargeras,1803,priest,discipline,45,29,16
Applecare,illidan,1803,priest,discipline,102,60,42
Tarlex,illidan,1803,priest,discipline,168,94,74
Goldsunx,emerald-dream,1803,priest,discipline,152,85,67
Tjphess,zuljin,1803,priest,discipline,240,130,110
Luciuz,tichondrius,1803,priest,discipline,84,45,39
Cbalnom,tichondrius,1803,priest,discipline,70,37,33
Sußlime,frostwolf,1803,priest,discipline,90,47,43
Hotgirlshiit,dalaran,1803,priest,discipline,298,145,153
Manyhot,tichondrius,1802,priest,discipline,51,32,19
Yrñwiotøø,illidan,1802,priest,discipline,54,33,21
Reignen,tichondrius,1802,priest,discipline,183,101,82
Seifong,frostmourne,1802,priest,discipline,125,68,57
Deathallpoly,tichondrius,1802,priest,discipline,431,227,204
Retardèr,tichondrius,1801,priest,discipline,97,68,29
Reverendtun,area-52,1801,priest,discipline,83,55,28
Vànhendrix,tichondrius,1801,priest,discipline,53,29,24
Louisé,hydraxis,1801,priest,discipline,48,25,23
Wânda,tichondrius,1801,priest,discipline,111,57,54
Xtcbtc,sargeras,1801,priest,discipline,93,44,49
Lípjju,tichondrius,1801,priest,discipline,54,24,30
Geekynerd,frostmourne,1800,priest,discipline,151,98,53
Bigmomcook,tichondrius,1800,priest,discipline,215,125,90
Imissdave,dethecus,1800,priest,discipline,48,27,21
Narakku,sargeras,1800,priest,discipline,108,59,49
Bwgyx,area-52,1800,priest,discipline,42,22,20
Bibleblak,stormrage,1800,priest,discipline,102,53,49
Alola,illidan,1800,priest,discipline,135,69,66
Shenanígans,malganis,1800,priest,discipline,42,19,23
Anyra,stormrage,1799,priest,discipline,51,26,25
Bomí,tichondrius,1799,priest,discipline,84,41,43
Olark,durotan,1799,priest,discipline,286,139,147
Fearinoculúm,bleeding-hollow,1798,priest,discipline,24,19,5
Vaaynee,ragnaros,1797,priest,discipline,114,61,53
Comebaack,stormrage,1797,priest,discipline,98,51,47
Celestiah,illidan,1796,priest,discipline,54,28,26
Impvp,tichondrius,1795,priest,discipline,89,49,40
Zins,emerald-dream,1795,priest,discipline,90,44,46
Änanti,tichondrius,1794,priest,discipline,83,45,38
Niniua,tichondrius,1794,priest,discipline,36,19,17
Cellestine,aggramar,1792,priest,discipline,133,67,66
Selenitax,sargeras,1792,priest,discipline,92,45,47
Wormclergy,tichondrius,1791,priest,discipline,80,39,41
Shnozberry,tichondrius,1790,priest,discipline,102,43,59
Bublehead,zuljin,1789,priest,discipline,114,56,58
Ryno,cenarion-circle,1788,priest,discipline,74,40,34
Summersetisl,tichondrius,1787,priest,discipline,66,29,37
Euphorz,tichondrius,1786,priest,discipline,36,19,17
Hadoka,ragnaros,1786,priest,discipline,54,23,31
Priceléss,tichondrius,1784,priest,discipline,30,22,8
Deathwisher,illidan,1784,priest,discipline,181,93,88
Bellaelle,stormrage,1783,priest,discipline,57,29,28
Myeryc,frostmourne,1782,priest,discipline,47,19,28
Tmversace,tichondrius,1781,priest,discipline,112,56,56
Usedmedkit,sargeras,1780,priest,discipline,47,28,19
Ragretsxo,darkspear,1780,priest,discipline,96,51,45
Discflips,dalaran,1779,priest,discipline,210,106,104
Kóba,bleeding-hollow,1778,priest,discipline,48,33,15
Ritzzx,ragnaros,1777,priest,discipline,101,51,50
Ÿsk,tichondrius,1775,priest,discipline,138,80,58
Deathlullaby,malganis,1775,priest,discipline,42,21,21
Isilador,moon-guard,1775,priest,discipline,95,44,51
Whalexo,kelthuzad,1774,priest,discipline,155,82,73
Pesca,proudmoore,1774,priest,discipline,125,59,66
Crøws,ragnaros,1773,priest,discipline,112,58,54
Angelforcez,frostmourne,1773,priest,discipline,47,19,28
Pnub,aggramar,1772,priest,discipline,105,52,53
Zulazane,azralon,1769,priest,discipline,366,199,167
Canibumsmoke,illidan,1769,priest,discipline,75,40,35
Auxp,tichondrius,1769,priest,discipline,59,23,36
Dannycarrier,tichondrius,1768,priest,discipline,30,21,9
Kabugi,illidan,1768,priest,discipline,96,52,44
Rlzpriest,tichondrius,1768,priest,discipline,107,56,51
Írithyll,stormrage,1767,priest,discipline,59,33,26
Barley,chogall,1767,priest,discipline,42,22,20
Pibkac,stormrage,1767,priest,discipline,69,34,35
Healum,nemesis,1765,priest,discipline,106,59,47
Osis,rivendare,1764,priest,discipline,165,80,85
Sebpriest,proudmoore,1764,priest,discipline,42,20,22
Deathtones,barthilas,1763,priest,discipline,143,77,66
Deadpriesst,arthas,1763,priest,discipline,72,36,36
Hugemilkys,tichondrius,1762,priest,discipline,85,46,39
Darbybean,bleeding-hollow,1762,priest,discipline,54,28,26
Bonigan,sargeras,1761,priest,discipline,185,110,75
Gochuxx,tichondrius,1761,priest,discipline,66,34,32
Bloodyx,bleeding-hollow,1761,priest,discipline,172,88,84
Barrenbuffet,zuljin,1761,priest,discipline,206,103,103
Nearo,barthilas,1761,priest,discipline,60,26,34
Raysx,stormrage,1759,priest,discipline,83,37,46
Kaddy,mannoroth,1757,priest,discipline,130,60,70
Compxx,barthilas,1756,priest,discipline,66,38,28
Luciellis,sargeras,1755,priest,discipline,90,51,39
Probs,frostmourne,1755,priest,discipline,135,69,66
Papabrokuttv,sargeras,1755,priest,discipline,42,19,23
Jaytee,aggramar,1754,priest,discipline,72,33,39
Corvenna,zuljin,1751,priest,discipline,48,27,21
Mautmaut,quelthalas,1750,priest,discipline,65,42,23
Ukishizumi,tichondrius,1748,priest,discipline,143,75,68
Nyluh,deathwing,1748,priest,discipline,74,38,36
Raizy,stormrage,1748,priest,discipline,53,26,27
Ferguss,ragnaros,1747,priest,discipline,79,42,37
Fhinky,tichondrius,1746,priest,discipline,207,103,104
Alarin,whisperwind,1745,priest,discipline,60,30,30
Evilear,tichondrius,1745,priest,discipline,66,31,35
Ninbara,tichondrius,1745,priest,discipline,59,27,32
Onikûdaki,sargeras,1744,priest,discipline,53,24,29
Hamstip,sargeras,1743,priest,discipline,98,58,40
Moalboal,tichondrius,1743,priest,discipline,180,98,82
Natoshi,illidan,1742,priest,discipline,48,25,23
Demaholy,illidan,1742,priest,discipline,142,73,69
Cursèlol,tichondrius,1742,priest,discipline,90,45,45
Robdàwg,illidan,1742,priest,discipline,60,26,34
Toastspriest,tichondrius,1741,priest,discipline,101,60,41
Luwoona,tichondrius,1740,priest,discipline,90,41,49
Bennito,moon-guard,1739,priest,discipline,138,65,73
Aloxc,drakkari,1738,priest,discipline,36,19,17
Shadheda,andorhal,1738,priest,discipline,56,26,30
Jimmythedon,mugthol,1738,priest,discipline,72,33,39
Paidtowin,frostmourne,1738,priest,discipline,56,21,35
Trengodqt,destromath,1737,priest,discipline,205,110,95
Pgpriest,kelthuzad,1737,priest,discipline,90,44,46
Rigxy,arthas,1736,priest,discipline,123,76,47
Orderic,ragnaros,1736,priest,discipline,57,32,25
Marcìano,bleeding-hollow,1736,priest,discipline,64,35,29
Kelthax,sargeras,1736,priest,discipline,54,23,31
Niark,frostmourne,1736,priest,discipline,48,20,28
Envio,moon-guard,1735,priest,discipline,36,26,10
Maybedead,tichondrius,1734,priest,discipline,42,26,16
Guerisser,hyjal,1734,priest,discipline,140,83,57
Obscure,malygos,1734,priest,discipline,74,32,42
Holyster,tichondrius,1733,priest,discipline,44,20,24
Sinday,zuljin,1732,priest,discipline,60,29,31
Skunkbishop,sargeras,1731,priest,discipline,204,98,106
Saelom,frostmourne,1730,priest,discipline,78,49,29
Justafkoutpr,gorefiend,1729,priest,discipline,48,34,14
Murth,laughing-skull,1729,priest,discipline,47,30,17
Johanna,tichondrius,1729,priest,discipline,41,26,15
Hideonlight,barthilas,1729,priest,discipline,471,243,228
Neverbeen,tichondrius,1728,priest,discipline,473,250,223
Airelia,sargeras,1728,priest,discipline,54,28,26
Blasphêmy,malganis,1727,priest,discipline,86,52,34
Åpples,tichondrius,1727,priest,discipline,71,31,40
Apoorstudent,tichondrius,1726,priest,discipline,116,72,44
Mxfd,tichondrius,1726,priest,discipline,47,27,20
Dévore,dalaran,1726,priest,discipline,46,25,21
Analogxz,nemesis,1726,priest,discipline,168,81,87
Conifer,emerald-dream,1725,priest,discipline,60,35,25
Barthbelro,kiljaeden,1725,priest,discipline,87,49,38
Holyhõ,stormrage,1725,priest,discipline,48,27,21
Goneqt,illidan,1725,priest,discipline,60,29,31
Jezebëll,nemesis,1724,priest,discipline,192,99,93
Kebab,tichondrius,1723,priest,discipline,30,18,12
Dontlineme,tichondrius,1723,priest,discipline,142,64,78
Xidis,vashj,1723,priest,discipline,71,29,42
Sobamian,tichondrius,1723,priest,discipline,90,36,54
Mååxxee,zuljin,1722,priest,discipline,30,18,12
Sylvphrena,stormrage,1722,priest,discipline,30,18,12
Zaryx,wildhammer,1722,priest,discipline,42,24,18
Vegetable,suramar,1722,priest,discipline,36,18,18
Downturn,tichondrius,1722,priest,discipline,54,23,31
Leonilcx,tichondrius,1721,priest,discipline,733,367,366
Philmacrakn,stormrage,1721,priest,discipline,167,81,86
Kostantina,kelthuzad,1721,priest,discipline,154,69,85
Leticia,magtheridon,1719,priest,discipline,100,48,52
Jexso,tichondrius,1719,priest,discipline,163,78,85
Opriest,queldorei,1718,priest,discipline,54,27,27
Ooit,tichondrius,1717,priest,discipline,24,22,2
Wizpell,area-52,1717,priest,discipline,42,18,24
Pissfeet,tichondrius,1716,priest,discipline,30,18,12
Rotbaron,bleeding-hollow,1716,priest,discipline,108,48,60
Cody,magtheridon,1715,priest,discipline,72,49,23
Woobgasm,sargeras,1715,priest,discipline,72,46,26
Kragenn,malganis,1713,priest,discipline,165,83,82
Mygameslaggy,area-52,1713,priest,discipline,78,33,45
Pastapizza,zuljin,1712,priest,discipline,24,22,2
Rachell,emerald-dream,1712,priest,discipline,36,26,10
Kastep,tichondrius,1712,priest,discipline,88,44,44
Bakara,jubeithos,1712,priest,discipline,42,18,24
Smitelytius,tichondrius,1711,priest,discipline,30,18,12
Trebrooke,sargeras,1710,priest,discipline,161,88,73
Touchrr,tichondrius,1710,priest,discipline,108,58,50
Veejae,tichondrius,1710,priest,discipline,42,22,20
Valothrian,area-52,1710,priest,discipline,172,86,86
Dorgondra,wyrmrest-accord,1709,priest,discipline,48,26,22
Dippyboi,whisperwind,1709,priest,discipline,48,25,23
Meltmeltz,nerzhul,1708,priest,discipline,65,29,36
Andreslol,sargeras,1707,priest,discipline,54,32,22
Shiromar,tichondrius,1707,priest,discipline,66,38,28
Asthenia,saurfang,1706,priest,discipline,120,59,61
Sarïya,moon-guard,1706,priest,discipline,125,61,64
Byck,tichondrius,1706,priest,discipline,54,23,31
Sodezz,stormrage,1705,priest,discipline,36,21,15
Inquisitionx,frostmourne,1705,priest,discipline,223,120,103
Bfts,illidan,1705,priest,discipline,227,119,108
Mellow,tichondrius,1705,priest,discipline,170,89,81
Crypcanheal,sargeras,1705,priest,discipline,442,217,225
Forti,sargeras,1705,priest,discipline,156,74,82
Squaanchy,bleeding-hollow,1705,priest,discipline,129,61,68
Staars,ragnaros,1704,priest,discipline,66,37,29
Fancydisc,barthilas,1703,priest,discipline,30,18,12
Gfayde,sargeras,1702,priest,discipline,36,20,16
Nightcráwler,illidan,1702,priest,discipline,89,47,42
Irenesome,tichondrius,1701,priest,discipline,45,21,24
Ogneus,crushridge,1700,priest,discipline,51,22,29
Tanzen,andorhal,1699,priest,discipline,36,21,15
Beowulfy,stormrage,1699,priest,discipline,48,27,21
Séxgodx,tichondrius,1698,priest,discipline,53,24,29
Clydeington,illidan,1697,priest,discipline,49,29,20
Cryptron,tichondrius,1697,priest,discipline,54,28,26
Nancynibbler,bleeding-hollow,1697,priest,discipline,70,32,38
Saviorlol,tichondrius,1697,priest,discipline,53,23,30
Mixful,bleeding-hollow,1696,priest,discipline,40,27,13
Obsolete,area-52,1696,priest,discipline,48,23,25
Twêet,frostmourne,1696,priest,discipline,186,87,99
Vcainyfairy,stormrage,1695,priest,discipline,489,247,242
Nickzx,tichondrius,1694,priest,discipline,52,36,16
Rmxx,illidan,1694,priest,discipline,143,80,63
Geon,sargeras,1693,priest,discipline,107,53,54
Veiveilol,tichondrius,1693,priest,discipline,59,24,35
Acpriest,tichondrius,1692,priest,discipline,87,46,41
Fullfear,lothar,1691,priest,discipline,42,26,16
Bosspriest,tichondrius,1691,priest,discipline,48,23,25
Drethor,saurfang,1691,priest,discipline,76,36,40
Pigogo,tichondrius,1690,priest,discipline,45,26,19
Highprofile,proudmoore,1690,priest,discipline,36,18,18
Nxghtmares,tichondrius,1690,priest,discipline,360,175,185
Catonement,moon-guard,1690,priest,discipline,475,230,245
Slùm,barthilas,1689,priest,discipline,43,27,16
Mastaspell,illidan,1689,priest,discipline,31,18,13
Elybele,sargeras,1689,priest,discipline,114,61,53
Yobell,tichondrius,1688,priest,discipline,36,23,13
Argylemomo,emerald-dream,1688,priest,discipline,202,103,99
Sweetnipsbro,tichondrius,1688,priest,discipline,71,35,36
Wildsmite,hyjal,1688,priest,discipline,222,102,120
Cayleey,stormrage,1688,priest,discipline,78,35,43
Duubz,kelthuzad,1687,priest,discipline,96,51,45
Oopsy,bleeding-hollow,1687,priest,discipline,60,31,29
Prïestitute,zuljin,1686,priest,discipline,108,70,38
Persimmons,lightbringer,1686,priest,discipline,113,61,52
Andypr,illidan,1686,priest,discipline,66,25,41
Heart,misha,1685,priest,discipline,132,70,62
Salvation,tichondrius,1684,priest,discipline,60,27,33
Turtlez,area-52,1684,priest,discipline,78,35,43
Vandamnation,barthilas,1682,priest,discipline,128,61,67
Onineko,bleeding-hollow,1681,priest,discipline,57,32,25
Plaguebaby,stormrage,1681,priest,discipline,45,23,22
Melforn,moon-guard,1681,priest,discipline,59,28,31
Ieveling,skywall,1681,priest,discipline,65,30,35
Kujox,tichondrius,1681,priest,discipline,70,31,39
Lingdums,tichondrius,1680,priest,discipline,31,18,13
Mintadnade,nemesis,1679,priest,discipline,163,81,82
Poosydoodlez,malganis,1679,priest,discipline,105,48,57
Qtasiangirl,emerald-dream,1679,priest,discipline,109,47,62
Rámmstein,wyrmrest-accord,1678,priest,discipline,120,65,55
Derpmodé,staghelm,1678,priest,discipline,54,28,26
Nabukom,destromath,1678,priest,discipline,52,25,27
Danceslol,area-52,1678,priest,discipline,42,20,22
Charbosan,gorgonnash,1677,priest,discipline,638,332,306
Melshiesty,stormrage,1677,priest,discipline,42,20,22
Holyfall,sargeras,1676,priest,discipline,220,116,104
Gurgs,emerald-dream,1676,priest,discipline,38,19,19
Iyoui,tichondrius,1675,priest,discipline,30,20,10
Narodiz,nemesis,1675,priest,discipline,48,26,22
Bonehead,warsong,1675,priest,discipline,48,23,25
Starpass,illidan,1673,priest,discipline,42,31,11
Stoneflute,emerald-dream,1673,priest,discipline,153,87,66
Jammeslight,quelthalas,1673,priest,discipline,124,67,57
Holécriss,tichondrius,1672,priest,discipline,143,77,66
Merit,emerald-dream,1672,priest,discipline,144,76,68
Aco,tichondrius,1672,priest,discipline,150,79,71
Scab,anetheron,1672,priest,discipline,130,62,68
Claverr,stormrage,1670,priest,discipline,33,20,13
Serakiki,nemesis,1670,priest,discipline,72,41,31
Pawnza,tichondrius,1670,priest,discipline,102,50,52
Dachenchen,tichondrius,1669,priest,discipline,36,27,9
Kagemetsu,sargeras,1669,priest,discipline,152,74,78
Boostedpi,tichondrius,1669,priest,discipline,44,21,23
Jmlz,tichondrius,1668,priest,discipline,36,23,13
Elilium,tichondrius,1668,priest,discipline,80,48,32
Alomari,zuljin,1668,priest,discipline,32,19,13
Milkkz,zuljin,1668,priest,discipline,54,30,24
Trollpreist,tichondrius,1668,priest,discipline,136,70,66
Klitarus,barthilas,1668,priest,discipline,48,23,25
Mcfref,tichondrius,1667,priest,discipline,135,70,65
Wonpaipri,frostmourne,1667,priest,discipline,65,31,34
Clockwororan,tichondrius,1666,priest,discipline,36,21,15
Muffingal,tichondrius,1666,priest,discipline,36,19,17
Nelpesh,tichondrius,1666,priest,discipline,60,27,33
Shrimpouh,illidan,1665,priest,discipline,72,39,33
Purged,shadowmoon,1665,priest,discipline,367,198,169
Góndhi,tichondrius,1664,priest,discipline,42,25,17
Crysknife,korgath,1664,priest,discipline,35,20,15
Swagraptor,stormreaver,1663,priest,discipline,138,76,62
Størmy,kiljaeden,1663,priest,discipline,246,132,114
Shocklol,stormrage,1662,priest,discipline,29,22,7
Apathist,sargeras,1662,priest,discipline,66,44,22
Eetsqt,barthilas,1662,priest,discipline,114,71,43
Hallucinogen,kelthuzad,1662,priest,discipline,95,51,44
Fisp,moon-guard,1661,priest,discipline,72,33,39
Resisted,gorefiend,1660,priest,discipline,238,120,118
Marejaynez,tichondrius,1659,priest,discipline,139,63,76
Drtyror,area-52,1658,priest,discipline,54,34,20
Muffinboy,illidan,1658,priest,discipline,54,20,34
Yunnan,executus,1657,priest,discipline,78,43,35
Caveron,tichondrius,1657,priest,discipline,42,23,19
Chaner,scarlet-crusade,1657,priest,discipline,72,28,44
Syo,dreadmaul,1656,priest,discipline,95,48,47
Toopriestly,deathwing,1656,priest,discipline,65,32,33
Yaz,emerald-dream,1656,priest,discipline,71,34,37
Silkydeath,frostmourne,1655,priest,discipline,42,24,18
Theravus,moon-guard,1655,priest,discipline,124,67,57
Hermanmiller,frostmourne,1655,priest,discipline,48,25,23
Dojacatx,frostmourne,1655,priest,discipline,66,32,34
Naranjitá,ragnaros,1654,priest,discipline,66,42,24
Tinyheal,sargeras,1654,priest,discipline,110,57,53
Darknuz,sargeras,1654,priest,discipline,53,27,26
Zãrrãlis,arthas,1654,priest,discipline,198,99,99
Gibens,tichondrius,1654,priest,discipline,130,64,66
Marython,tichondrius,1654,priest,discipline,76,34,42
Perceptions,dalaran,1653,priest,discipline,36,23,13
Kathere,tichondrius,1653,priest,discipline,42,23,19
Caveria,emerald-dream,1653,priest,discipline,247,126,121
Astroluma,illidan,1653,priest,discipline,46,23,23
Zunitpriest,laughing-skull,1653,priest,discipline,36,18,18
Sanddglokta,tichondrius,1653,priest,discipline,290,142,148
Dpendant,frostmourne,1653,priest,discipline,66,31,35
Vtp,frostmourne,1652,priest,discipline,70,40,30
Dijkstracted,ragnaros,1652,priest,discipline,145,79,66
Glassbirds,stormrage,1652,priest,discipline,48,25,23
Opscurum,bleeding-hollow,1651,priest,discipline,48,28,20
Aleana,ragnaros,1651,priest,discipline,42,23,19
Brxddx,sargeras,1651,priest,discipline,113,59,54
Vanderbeek,frostmourne,1651,priest,discipline,66,33,33
Airalia,bleeding-hollow,1650,priest,discipline,36,23,13
Sêlbus,stormrage,1650,priest,discipline,228,121,107
Somefire,proudmoore,1650,priest,discipline,155,78,77
Nomsayin,stormrage,1649,priest,discipline,36,23,13
Hanley,tichondrius,1649,priest,discipline,85,48,37
Shastea,crushridge,1649,priest,discipline,70,37,33
Ixchelune,kelthuzad,1649,priest,discipline,237,119,118
Larry,tichondrius,1649,priest,discipline,65,31,34
Jatral,azralon,1649,priest,discipline,64,30,34
Nopang,tichondrius,1649,priest,discipline,167,77,90
Chañing,frostmourne,1649,priest,discipline,72,33,39
Lanäthel,sargeras,1648,priest,discipline,28,19,9
Wøo,area-52,1648,priest,discipline,81,48,33
Tanthsondis,illidan,1648,priest,discipline,48,27,21
Cixelpvp,area-52,1648,priest,discipline,47,22,25
Deadpla,ragnaros,1648,priest,discipline,83,36,47
Krewesin,ravencrest,1647,priest,discipline,43,22,21
Lòthnalar,ragnaros,1647,priest,discipline,60,29,31
Tryfekta,frostmourne,1647,priest,discipline,78,37,41
Dorazòn,bleeding-hollow,1647,priest,discipline,54,25,29
Liteztvp,tichondrius,1647,priest,discipline,156,72,84
Synsparks,tichondrius,1647,priest,discipline,60,25,35
Spx,frostmourne,1646,priest,discipline,48,30,18
Bushybush,darkspear,1646,priest,discipline,53,32,21
Twistynipple,malganis,1646,priest,discipline,42,25,17
Klttzz,sargeras,1646,priest,discipline,60,32,28
Khorium,stormrage,1646,priest,discipline,46,21,25
Rosaparksxo,sargeras,1645,priest,discipline,70,35,35
Cavatea,illidan,1645,priest,discipline,42,21,21
Adrio,malorne,1645,priest,discipline,290,140,150
Meepsw,stormrage,1644,priest,discipline,60,33,27
Honeyduutch,black-dragonflight,1644,priest,discipline,72,37,35
Itsmurphy,sargeras,1644,priest,discipline,120,57,63
Beelzebul,illidan,1644,priest,discipline,60,26,34
Toddmund,tichondrius,1644,priest,discipline,64,25,39
Tonydatiger,the-forgotten-coast,1643,priest,discipline,36,21,15
Kazuret,ragnaros,1643,priest,discipline,266,139,127
Kuell,ragnaros,1642,priest,discipline,53,29,24
Selfless,barthilas,1642,priest,discipline,60,26,34
Reiae,malganis,1642,priest,discipline,70,27,43
Haduth,area-52,1641,priest,discipline,154,82,72
Shadzx,andorhal,1641,priest,discipline,47,22,25
Googolplex,tichondrius,1640,priest,discipline,57,39,18
Lolcrafthd,ragnaros,1640,priest,discipline,64,36,28
Alguîen,ragnaros,1640,priest,discipline,115,61,54
Akëla,nemesis,1640,priest,discipline,96,50,46
Life,amanthul,1639,priest,discipline,143,84,59
Auras,boulderfist,1639,priest,discipline,52,30,22
Hypes,korgath,1639,priest,discipline,85,49,36
Randompreest,stormrage,1639,priest,discipline,42,23,19
Matin,frostmourne,1639,priest,discipline,39,21,18
Mealmassttr,frostmourne,1639,priest,discipline,84,38,46
Lunarina,hyjal,1638,priest,discipline,167,75,92
Bacpack,area-52,1637,priest,discipline,131,67,64
Evvylou,stormrage,1637,priest,discipline,42,19,23
Choochang,sargeras,1636,priest,discipline,35,27,8
Aethriem,bleeding-hollow,1636,priest,discipline,54,33,21
Perothon,garrosh,1636,priest,discipline,123,65,58
Ketapriest,frostmourne,1636,priest,discipline,136,67,69
Döllyy,illidan,1636,priest,discipline,48,22,26
Rmx,illidan,1635,priest,discipline,35,18,17
Grizzlysmite,stormrage,1635,priest,discipline,343,168,175
Batiatus,moon-guard,1635,priest,discipline,42,20,22
Beeffdaddy,tichondrius,1635,priest,discipline,123,57,66
Mangolatte,frostmourne,1634,priest,discipline,55,41,14
Ngin,queldorei,1634,priest,discipline,36,21,15
Beejaex,stormreaver,1634,priest,discipline,48,22,26
Benedictiion,tichondrius,1634,priest,discipline,86,38,48
Huxleypoo,boulderfist,1633,priest,discipline,42,22,20
Mclyte,whisperwind,1633,priest,discipline,149,77,72
Jâmïè,gurubashi,1632,priest,discipline,41,31,10
Buhroke,thrall,1632,priest,discipline,62,29,33
Jjmms,akama,1632,priest,discipline,270,126,144
Discgoddess,proudmoore,1631,priest,discipline,103,54,49
Chewey,tichondrius,1631,priest,discipline,48,23,25
Varbirttok,sargeras,1631,priest,discipline,43,19,24
Howiecakes,bloodhoof,1631,priest,discipline,57,25,32
Gödtier,frostwolf,1631,priest,discipline,42,18,24
Meip,illidan,1630,priest,discipline,24,17,7
Skadín,stormrage,1630,priest,discipline,155,92,63
Drully,moon-guard,1630,priest,discipline,113,62,51
Tastyloads,illidan,1629,priest,discipline,42,25,17
Samirah,arthas,1629,priest,discipline,42,23,19
Bluecho,tichondrius,1629,priest,discipline,48,25,23
Joeyslaps,frostwolf,1629,priest,discipline,58,30,28
Szx,akama,1629,priest,discipline,50,24,26
Powerwordwap,malganis,1629,priest,discipline,53,23,30
Bustit,azgalor,1628,priest,discipline,52,28,24
Stepsistér,ragnaros,1628,priest,discipline,36,19,17
Kazgry,illidan,1628,priest,discipline,42,22,20
Bhoyka,ragnaros,1628,priest,discipline,57,29,28
Winsforgoldd,area-52,1628,priest,discipline,40,20,20
Oesobagi,tichondrius,1627,priest,discipline,113,66,47
Peelforheals,nordrassil,1627,priest,discipline,60,27,33
Çammy,frostmourne,1626,priest,discipline,24,17,7
Andrew,sargeras,1626,priest,discipline,30,20,10
Discavow,bleeding-hollow,1626,priest,discipline,51,31,20
Tonybanderas,shattered-halls,1626,priest,discipline,108,58,50
Brothercarl,stormrage,1626,priest,discipline,95,51,44
Arianagrande,garona,1626,priest,discipline,95,50,45
Raxekk,stormrage,1626,priest,discipline,48,25,23
Slickwilly,bloodhoof,1626,priest,discipline,257,125,132
Mylo,azralon,1625,priest,discipline,48,28,20
Psycozis,hyjal,1625,priest,discipline,262,138,124
Kepp,korgath,1625,priest,discipline,51,23,28
Linarindil,hyjal,1624,priest,discipline,126,63,63
Vinvictus,tichondrius,1624,priest,discipline,225,108,117
Momorabbit,tichondrius,1624,priest,discipline,36,17,19
Ussmissouri,area-52,1624,priest,discipline,141,63,78
Caesus,sargeras,1623,priest,discipline,124,70,54
Illuminare,sargeras,1623,priest,discipline,154,82,72
Bonoo,tichondrius,1623,priest,discipline,335,175,160
Elbeefsteak,ragnaros,1622,priest,discipline,54,32,22
Dream,kelthuzad,1622,priest,discipline,30,17,13
Wickedpriest,malganis,1622,priest,discipline,54,25,29
Kûrtt,azralon,1622,priest,discipline,42,19,23
Spicer,eredar,1621,priest,discipline,41,25,16
Tuniepope,sargeras,1621,priest,discipline,75,45,30
Sätîvá,tichondrius,1621,priest,discipline,38,20,18
Deathsmoke,ragnaros,1621,priest,discipline,112,55,57
Vsat,illidan,1621,priest,discipline,48,23,25
Lilbaldjosh,frostmourne,1621,priest,discipline,114,52,62
Universe,spinebreaker,1620,priest,discipline,34,25,9
Tammyone,emerald-dream,1620,priest,discipline,66,42,24
Pigro,area-52,1620,priest,discipline,30,19,11
Darknuzs,sargeras,1620,priest,discipline,42,21,21
Halfcutt,tichondrius,1620,priest,discipline,48,23,25
Surfgang,tichondrius,1620,priest,discipline,41,19,22
Gosarix,tichondrius,1619,priest,discipline,24,17,7
Zombiz,tichondrius,1619,priest,discipline,41,25,16
Priestreto,zuljin,1619,priest,discipline,101,56,45
Daburnz,bleeding-hollow,1619,priest,discipline,102,53,49
Shesaidthat,stormrage,1619,priest,discipline,225,114,111
Baddmachine,illidan,1619,priest,discipline,47,21,26
Archìtects,wyrmrest-accord,1618,priest,discipline,42,25,17
Timbobaloo,thrall,1618,priest,discipline,58,33,25
Kälëy,ragnaros,1618,priest,discipline,172,96,76
Syrul,tichondrius,1618,priest,discipline,63,34,29
Nohéalforu,stormrage,1618,priest,discipline,48,25,23
Sacrify,ragnaros,1618,priest,discipline,105,54,51
Punisherror,area-52,1618,priest,discipline,52,22,30
Astrøpriest,tichondrius,1618,priest,discipline,54,22,32
Jmr,onyxia,1617,priest,discipline,24,17,7
Cazuex,ragnaros,1617,priest,discipline,30,20,10
Khathor,kargath,1617,priest,discipline,30,17,13
Bingleboi,area-52,1617,priest,discipline,226,123,103
Gurlyounasty,khazgoroth,1617,priest,discipline,103,55,48
Pedobearx,ragnaros,1617,priest,discipline,148,74,74
Cosenzza,tichondrius,1617,priest,discipline,48,20,28
Jönsnow,ghostlands,1616,priest,discipline,54,29,25
Prayussy,tichondrius,1616,priest,discipline,135,72,63
Anahka,tichondrius,1616,priest,discipline,48,21,27
Shaddäye,andorhal,1616,priest,discipline,48,20,28
Kraamur,area-52,1615,priest,discipline,96,57,39
Jîtters,silvermoon,1615,priest,discipline,84,45,39
Myles,alexstrasza,1615,priest,discipline,134,68,66
Bisholan,frostwolf,1615,priest,discipline,79,35,44
Catbabyeah,tichondrius,1614,priest,discipline,36,26,10
Buchöna,quelthalas,1614,priest,discipline,77,41,36
Hottymcdotty,black-dragonflight,1614,priest,discipline,42,21,21
Nanoboost,dark-iron,1614,priest,discipline,573,285,288
Galandora,kelthuzad,1614,priest,discipline,48,23,25
Iovedoctor,tichondrius,1614,priest,discipline,78,25,53
Sâsh,stormrage,1613,priest,discipline,72,40,32
Nolar,shadowmoon,1613,priest,discipline,36,20,16
Mudshadow,tichondrius,1613,priest,discipline,97,53,44
Trezz,hakkar,1613,priest,discipline,46,23,23
Aåurøra,stormrage,1613,priest,discipline,46,23,23
ßðßßÿ,area-52,1613,priest,discipline,42,21,21
Judis,barthilas,1613,priest,discipline,72,35,37
Alfié,kelthuzad,1612,priest,discipline,48,33,15
Kks,tichondrius,1612,priest,discipline,90,46,44
Gsek,nemesis,1611,priest,discipline,36,23,13
Scruge,frostmourne,1611,priest,discipline,55,32,23
Calientaeggs,drakkari,1611,priest,discipline,352,190,162
Littleshower,illidan,1611,priest,discipline,43,23,20
Vincejddp,zuljin,1611,priest,discipline,199,105,94
Haill,quelthalas,1611,priest,discipline,76,38,38
Shadoris,antonidas,1611,priest,discipline,48,23,25
Cinsare,moon-guard,1610,priest,discipline,84,49,35
Psychic,bladefist,1610,priest,discipline,124,72,52
Yidra,illidan,1610,priest,discipline,36,19,17
Swartzp,tichondrius,1610,priest,discipline,110,58,52
Frenezyz,ragnaros,1610,priest,discipline,42,22,20
Blathers,malganis,1610,priest,discipline,92,48,44
Interworld,illidan,1610,priest,discipline,50,24,26
Mortteus,agamaggan,1610,priest,discipline,60,28,32
Pleasant,dathremar,1610,priest,discipline,123,52,71
Dadcantdeath,frostmourne,1609,priest,discipline,44,23,21
Fõrcedtowipe,tichondrius,1609,priest,discipline,180,93,87
Krusheal,tichondrius,1609,priest,discipline,47,22,25
Oyy,barthilas,1609,priest,discipline,60,27,33
Gránd,emerald-dream,1609,priest,discipline,54,22,32
Ksâh,bleeding-hollow,1608,priest,discipline,30,19,11
Gsek,azralon,1608,priest,discipline,54,34,20
Alcázardeyo,area-52,1608,priest,discipline,150,84,66
Healbaby,illidan,1608,priest,discipline,193,99,94
Wrekkit,area-52,1608,priest,discipline,84,42,42
Dawgshiz,tichondrius,1608,priest,discipline,40,20,20
Ivf,darrowmere,1608,priest,discipline,47,22,25
Reginaa,nemesis,1608,priest,discipline,65,30,35
Buttfive,illidan,1608,priest,discipline,58,24,34
Supôrte,nemesis,1607,priest,discipline,65,37,28
Jiñx,destromath,1607,priest,discipline,278,147,131
Hootheals,illidan,1607,priest,discipline,46,24,22
Darknus,sargeras,1607,priest,discipline,78,37,41
Flagiddyflag,kelthuzad,1607,priest,discipline,36,17,19
Ggsaurusrex,area-52,1607,priest,discipline,36,17,19
Teewat,illidan,1606,priest,discipline,42,23,19
Lovesy,burning-legion,1606,priest,discipline,60,30,30
Darkispriest,tichondrius,1606,priest,discipline,36,17,19
Powerwordqt,kalecgos,1606,priest,discipline,60,26,34
Hoshx,sargeras,1605,priest,discipline,75,44,31
Trojanphobia,bleeding-hollow,1605,priest,discipline,36,20,16
Jennyle,sargeras,1605,priest,discipline,60,31,29
Yoggismydad,emerald-dream,1605,priest,discipline,185,95,90
Snakedoc,emerald-dream,1605,priest,discipline,66,33,33
Míkò,sargeras,1604,priest,discipline,18,17,1
Jagita,kelthuzad,1604,priest,discipline,31,20,11
Hoglet,moon-guard,1604,priest,discipline,65,39,26
Jzd,dreadmaul,1604,priest,discipline,54,29,25
Priestass,bleeding-hollow,1604,priest,discipline,78,37,41
Vern,laughing-skull,1604,priest,discipline,78,29,49
Lines,sargeras,1603,priest,discipline,70,38,32
Fukneasy,darkspear,1603,priest,discipline,37,20,17
Feymuhsjr,black-dragonflight,1603,priest,discipline,54,29,25
Iamgess,kilrogg,1603,priest,discipline,42,22,20
Fäctor,bleeding-hollow,1603,priest,discipline,78,36,42
Resortv,illidan,1602,priest,discipline,42,32,10
Aetyn,tichondrius,1602,priest,discipline,61,33,28
Arcalon,thrall,1602,priest,discipline,86,45,41
Gromkekz,area-52,1602,priest,discipline,73,38,35
Crizem,bleeding-hollow,1602,priest,discipline,242,119,123
Ünagi,thrall,1602,priest,discipline,77,34,43
Zymmie,moon-guard,1602,priest,discipline,102,45,57
Invicta,frostwolf,1601,priest,discipline,27,18,9
Fakechow,nathrezim,1601,priest,discipline,137,71,66
Bistek,bleeding-hollow,1601,priest,discipline,166,83,83
Jhivagosp,tichondrius,1600,priest,discipline,42,23,19
Mepisth,sargeras,1600,priest,discipline,66,36,30
Zarakonna,illidan,1600,priest,discipline,60,32,28
Nijoral,tichondrius,1600,priest,discipline,368,194,174
Eccentrixx,mannoroth,1600,priest,discipline,54,28,26
Catpictures,stormrage,1599,priest,discipline,36,18,18
Zunari,thrall,1599,priest,discipline,48,23,25
Memoriesorz,tichondrius,1598,priest,discipline,419,217,202
Bigsmart,tichondrius,1598,priest,discipline,56,25,31
Dupaforted,stormrage,1598,priest,discipline,71,26,45
Valeilah,illidan,1597,priest,discipline,126,80,46
Razledazzled,grizzly-hills,1597,priest,discipline,109,54,55
Pocserpriest,drakkari,1597,priest,discipline,44,21,23
Emytoty,ragnaros,1596,priest,discipline,138,75,63
Pettypriest,dalaran,1596,priest,discipline,79,39,40
Ivorytiger,bleeding-hollow,1596,priest,discipline,42,19,23
Serenewisp,tichondrius,1595,priest,discipline,101,48,53
Onezor,frostmourne,1594,priest,discipline,78,39,39
Gummachine,tichondrius,1594,priest,discipline,36,17,19
Comana,frostmourne,1594,priest,discipline,53,25,28
Luthiene,area-52,1593,priest,discipline,204,112,92
Ariês,tichondrius,1593,priest,discipline,60,22,38
Planchebois,zuljin,1592,priest,discipline,36,20,16
Kavxo,sargeras,1592,priest,discipline,48,24,24
Hm,the-scryers,1591,priest,discipline,30,21,9
Astalail,emerald-dream,1591,priest,discipline,40,21,19
Dellitor,illidan,1591,priest,discipline,65,33,32
Isteri,thrall,1590,priest,discipline,52,26,26
Woosanghong,tichondrius,1590,priest,discipline,90,44,46
Emotionally,sargeras,1589,priest,discipline,30,20,10
Daleyn,ragnaros,1588,priest,discipline,48,27,21
Raffimilk,tichondrius,1588,priest,discipline,45,22,23
Eggsdenny,illidan,1588,priest,discipline,36,17,19
Primael,tichondrius,1587,priest,discipline,40,18,22
Conezy,frostmourne,1586,priest,discipline,60,32,28
Doritonails,tichondrius,1586,priest,discipline,244,124,120
Rilad,icecrown,1586,priest,discipline,180,86,94
Alaran,magtheridon,1584,priest,discipline,35,21,14
Septmoon,tichondrius,1584,priest,discipline,36,20,16
Säcrilege,drakkari,1584,priest,discipline,183,96,87
Lovesthebox,frostmourne,1584,priest,discipline,108,47,61
Zerokool,moonrunner,1583,priest,discipline,42,25,17
Saintguard,tichondrius,1583,priest,discipline,85,44,41
Dotsfortots,malfurion,1583,priest,discipline,41,21,20
Indigojuly,sargeras,1582,priest,discipline,70,40,30
Rómmul,azralon,1582,priest,discipline,65,33,32
Maomaoangel,tichondrius,1581,priest,discipline,42,22,20
Djc,tichondrius,1581,priest,discipline,84,42,42
Shieldharder,stormrage,1581,priest,discipline,39,18,21
Puttles,tichondrius,1581,priest,discipline,66,24,42
Gus,the-venture-co,1580,priest,discipline,78,44,34
Cringepriest,area-52,1579,priest,discipline,54,33,21
Kaeda,drenden,1579,priest,discipline,60,31,29
Piils,sargeras,1579,priest,discipline,36,18,18
Bigwap,illidan,1579,priest,discipline,60,29,31
Esciel,ragnaros,1579,priest,discipline,92,40,52
Carti,bleeding-hollow,1578,priest,discipline,232,129,103
Zizziz,tichondrius,1577,priest,discipline,66,33,33
Weapestrong,tichondrius,1576,priest,discipline,42,21,21
Knucklesandy,tichondrius,1576,priest,discipline,35,17,18
Predolph,illidan,1575,priest,discipline,48,26,22
Gamist,area-52,1575,priest,discipline,176,90,86
Blindingstar,area-52,1574,priest,discipline,57,33,24
Guccigriimes,tichondrius,1574,priest,discipline,45,24,21
Brezi,azralon,1573,priest,discipline,53,32,21
Gankdez,kelthuzad,1573,priest,discipline,111,58,53
Endereth,skullcrusher,1573,priest,discipline,124,57,67
Kihlupr,frostmourne,1573,priest,discipline,58,25,33
Overpriest,ragnaros,1572,priest,discipline,40,22,18
Bubblebuddí,tichondrius,1572,priest,discipline,68,37,31
Tekneeq,barthilas,1572,priest,discipline,114,53,61
Holymagetv,tichondrius,1572,priest,discipline,39,18,21
Archeo,area-52,1572,priest,discipline,60,19,41
Hasby,area-52,1571,priest,discipline,90,52,38
Malpractíce,zuljin,1571,priest,discipline,95,50,45
Tokaru,frostmourne,1571,priest,discipline,56,26,30
Whitecaster,tichondrius,1570,priest,discipline,30,17,13
Aleykz,illidan,1570,priest,discipline,89,50,39
Valdurai,stormrage,1570,priest,discipline,41,23,18
Chookspriest,tichondrius,1570,priest,discipline,165,80,85
Badhabit,zuluhed,1570,priest,discipline,91,40,51
Ppsp,azralon,1569,priest,discipline,42,25,17
Ol,firetree,1569,priest,discipline,57,28,29
Kimjongdots,illidan,1568,priest,discipline,50,28,22
Itachî,ravencrest,1568,priest,discipline,36,19,17
Safetyy,bleeding-hollow,1567,priest,discipline,44,24,20
Feymuhs,blackrock,1567,priest,discipline,90,48,42
Fairlightpp,zuljin,1567,priest,discipline,78,39,39
Ayabae,illidan,1567,priest,discipline,680,331,349
Besó,proudmoore,1566,priest,discipline,120,71,49
Holyvoice,wyrmrest-accord,1566,priest,discipline,58,32,26
Shádowman,thrall,1566,priest,discipline,72,35,37
Ðiscipline,kelthuzad,1566,priest,discipline,117,56,61
Alexsp,amanthul,1565,priest,discipline,76,45,31
Incisions,moon-guard,1564,priest,discipline,96,52,44
Scarabless,bleeding-hollow,1564,priest,discipline,138,62,76
Soyul,tichondrius,1563,priest,discipline,47,19,28
Deadnyx,tichondrius,1562,priest,discipline,36,20,16
Hadtogothere,kelthuzad,1562,priest,discipline,209,103,106
Zenobiai,hyjal,1561,priest,discipline,157,85,72
Valyx,tichondrius,1561,priest,discipline,130,70,60
Jylertason,kelthuzad,1561,priest,discipline,58,26,32
Antifaithx,frostmourne,1560,priest,discipline,36,21,15
Verna,dunemaul,1560,priest,discipline,85,47,38
Tyksu,area-52,1560,priest,discipline,94,50,44
Babirygen,khaz-modan,1560,priest,discipline,42,21,21
Moustachío,stormrage,1559,priest,discipline,53,24,29
Spliffs,tichondrius,1559,priest,discipline,77,29,48
Melitele,magtheridon,1558,priest,discipline,36,21,15
Highasf,sargeras,1558,priest,discipline,72,41,31
Vanco,tichondrius,1558,priest,discipline,59,32,27
Twistinfate,hyjal,1558,priest,discipline,119,58,61
Qenq,tichondrius,1557,priest,discipline,30,17,13
Gucciflops,tichondrius,1557,priest,discipline,48,25,23
Sensaye,dalaran,1557,priest,discipline,75,37,38
Ropriest,frostmourne,1557,priest,discipline,59,29,30
Datdarnbéar,stormrage,1557,priest,discipline,54,25,29
Approved,moon-guard,1556,priest,discipline,180,89,91
Shadowgobbo,thrall,1556,priest,discipline,54,26,28
Playsoon,illidan,1555,priest,discipline,124,68,56
Zrn,bleeding-hollow,1555,priest,discipline,54,19,35
Karebenniian,area-52,1554,priest,discipline,96,48,48
Hiraa,frostmourne,1553,priest,discipline,36,23,13
Elysiana,wyrmrest-accord,1553,priest,discipline,48,26,22
Takethat,emerald-dream,1552,priest,discipline,72,47,25
Meditåtion,tichondrius,1552,priest,discipline,186,97,89
Gommacura,stormrage,1552,priest,discipline,190,99,91
Gilthðniel,quelthalas,1552,priest,discipline,225,108,117
Rexîfy,zuljin,1551,priest,discipline,41,25,16
Mfynch,sargeras,1551,priest,discipline,66,40,26
Grannieslove,sargeras,1551,priest,discipline,48,28,20
Zachlol,area-52,1551,priest,discipline,90,52,38
Leliane,tichondrius,1551,priest,discipline,66,35,31
Pilixil,bleeding-hollow,1551,priest,discipline,42,21,21
Nesx,azuremyst,1550,priest,discipline,42,28,14
Sorrowful,mannoroth,1550,priest,discipline,30,19,11
Sensitive,eitrigg,1550,priest,discipline,36,22,14
Unisia,tichondrius,1550,priest,discipline,98,41,57
Önagashøw,azralon,1549,priest,discipline,277,140,137
Keyoshe,altar-of-storms,1549,priest,discipline,274,138,136
Luhhx,sargeras,1549,priest,discipline,108,54,54
Hennywhite,sargeras,1549,priest,discipline,102,48,54
Fámóus,stormrage,1549,priest,discipline,83,30,53
Nisagerx,tichondrius,1548,priest,discipline,33,19,14
Azureslaps,tichondrius,1547,priest,discipline,212,106,106
Sâishâ,proudmoore,1547,priest,discipline,188,84,104
Mdibaxx,tichondrius,1547,priest,discipline,83,35,48
Jugeumx,proudmoore,1547,priest,discipline,48,19,29
Uriyel,quelthalas,1546,priest,discipline,119,62,57
Sacredlight,malygos,1546,priest,discipline,99,51,48
Rustypinball,bleeding-hollow,1545,priest,discipline,70,39,31
Notkim,zuljin,1545,priest,discipline,65,33,32
Shadöwtest,quelthalas,1545,priest,discipline,113,49,64
Goo,boulderfist,1544,priest,discipline,36,22,14
Lyrä,kiljaeden,1544,priest,discipline,79,44,35
Androalis,thaurissan,1544,priest,discipline,72,38,34
Rourk,medivh,1544,priest,discipline,131,65,66
Bloodify,azralon,1544,priest,discipline,101,48,53
Nutshotxx,skullcrusher,1544,priest,discipline,154,67,87
Herder,zuljin,1543,priest,discipline,41,25,16
Matics,tichondrius,1543,priest,discipline,62,33,29
Rhima,tichondrius,1543,priest,discipline,115,59,56
Played,dark-iron,1543,priest,discipline,62,24,38
Justashadow,zangarmarsh,1542,priest,discipline,103,59,44
Bigdaddios,dalaran,1542,priest,discipline,41,18,23
Metick,illidan,1542,priest,discipline,48,18,30
Benin,shattered-hand,1541,priest,discipline,36,22,14
Zórg,stormrage,1541,priest,discipline,56,30,26
Makuwu,area-52,1541,priest,discipline,93,49,44
Winss,tichondrius,1541,priest,discipline,220,114,106
Qmabayteckkl,tichondrius,1540,priest,discipline,42,23,19
Ärchangél,tichondrius,1540,priest,discipline,60,29,31
Alex,boulderfist,1540,priest,discipline,189,90,99
Dawnsy,arygos,1540,priest,discipline,50,23,27
Daddydoeet,zuljin,1539,priest,discipline,42,22,20
Avis,illidan,1538,priest,discipline,50,33,17
Life,thrall,1538,priest,discipline,101,50,51
Slipzie,sargeras,1537,priest,discipline,89,52,37
Shadowdaddy,barthilas,1537,priest,discipline,96,55,41
Croissånt,illidan,1536,priest,discipline,30,18,12
Luxah,bloodhoof,1536,priest,discipline,39,23,16
Phasmaaxd,tichondrius,1536,priest,discipline,71,39,32
Oiled,barthilas,1535,priest,discipline,59,38,21
Erinzdern,quelthalas,1535,priest,discipline,64,33,31
Wandynha,nemesis,1535,priest,discipline,81,39,42
Santhiel,ragnaros,1535,priest,discipline,42,18,24
Saxy,quelthalas,1534,priest,discipline,50,32,18
Highmoon,kelthuzad,1534,priest,discipline,30,16,14
Sevÿ,malygos,1534,priest,discipline,40,20,20
Yanye,tichondrius,1534,priest,discipline,157,77,80
Maid,demon-soul,1534,priest,discipline,63,28,35
Anastasiá,barthilas,1534,priest,discipline,48,21,27
Lolweedbro,illidan,1533,priest,discipline,70,43,27
Faithmelter,stormrage,1533,priest,discipline,89,48,41
Dëàthwîsh,tichondrius,1533,priest,discipline,30,16,14
Priesmatco,area-52,1533,priest,discipline,81,40,41
Suitoo,ragnaros,1533,priest,discipline,54,25,29
Hairyleg,kelthuzad,1533,priest,discipline,36,16,20
Soulcleave,dark-iron,1533,priest,discipline,48,18,30
Yeyoz,tichondrius,1532,priest,discipline,106,54,52
Cityboyy,tichondrius,1532,priest,discipline,37,17,20
Wbu,frostmourne,1531,priest,discipline,28,17,11
Pryst,bonechewer,1531,priest,discipline,54,28,26
Bryelx,ragnaros,1531,priest,discipline,108,55,53
Vañity,malganis,1531,priest,discipline,66,33,33
Rubymisfit,sargeras,1531,priest,discipline,36,16,20
Scræm,sargeras,1530,priest,discipline,97,44,53
Anastasìá,barthilas,1530,priest,discipline,52,18,34
Epijho,area-52,1529,priest,discipline,30,19,11
Joktips,proudmoore,1529,priest,discipline,150,84,66
Kaguyä,ragnaros,1529,priest,discipline,59,32,27
Aríola,frostmourne,1529,priest,discipline,69,37,32
Amayå,kelthuzad,1529,priest,discipline,48,19,29
Nexp,tichondrius,1528,priest,discipline,53,38,15
Vullena,moon-guard,1528,priest,discipline,84,43,41
Truce,moon-guard,1528,priest,discipline,77,39,38
Slippedadisc,kelthuzad,1527,priest,discipline,108,59,49
Aralia,ragnaros,1527,priest,discipline,105,50,55
Havocshadows,deathwing,1526,priest,discipline,180,111,69
Alëssana,illidan,1526,priest,discipline,122,60,62
Radackan,quelthalas,1525,priest,discipline,84,44,40
Umbrous,ysera,1525,priest,discipline,42,18,24
Marethelia,stonemaul,1524,priest,discipline,42,22,20
Lydra,ragnaros,1524,priest,discipline,213,99,114
Thedude,spirestone,1524,priest,discipline,36,16,20
Holyphodays,sargeras,1523,priest,discipline,91,50,41
Sonofbetch,emerald-dream,1523,priest,discipline,55,30,25
Bloodytears,kiljaeden,1523,priest,discipline,138,65,73
Zortkis,garithos,1523,priest,discipline,52,20,32
Ricopri,frostmourne,1522,priest,discipline,36,23,13
Madhairy,ragnaros,1522,priest,discipline,126,65,61
Niurouchuan,tichondrius,1522,priest,discipline,123,60,63
Triggaz,tichondrius,1521,priest,discipline,126,70,56
Draxxankou,tanaris,1521,priest,discipline,73,40,33
Pheener,stormreaver,1521,priest,discipline,198,97,101
Magpul,arthas,1521,priest,discipline,36,16,20
Jâldabaoth,area-52,1520,priest,discipline,48,29,19
Ezzy,bleeding-hollow,1520,priest,discipline,48,24,24
Voltstein,dalaran,1519,priest,discipline,116,61,55
Hideyason,area-52,1519,priest,discipline,60,31,29
Friendzonefw,illidan,1519,priest,discipline,144,71,73
Dædrà,stormrage,1519,priest,discipline,76,37,39
Blessrish,icecrown,1519,priest,discipline,66,31,35
Bobelgum,emerald-dream,1517,priest,discipline,36,26,10
Unholyhusky,sargeras,1517,priest,discipline,54,32,22
Joní,malganis,1517,priest,discipline,41,18,23
Swapsy,illidan,1516,priest,discipline,53,29,24
Blodwell,illidan,1516,priest,discipline,125,66,59
Bonnieron,frostmourne,1516,priest,discipline,77,39,38
Triangle,draka,1516,priest,discipline,36,17,19
Drupmonst,dalaran,1516,priest,discipline,60,26,34
Cexcexyomi,tichondrius,1515,priest,discipline,88,47,41
Weakwind,burning-blade,1514,priest,discipline,56,33,23
Davinatrans,azralon,1514,priest,discipline,75,43,32
Zenfromwish,frostmourne,1514,priest,discipline,68,37,31
Thranduil,kiljaeden,1514,priest,discipline,136,72,64
Tecnica,kelthuzad,1514,priest,discipline,155,75,80
Marantbourge,frostmourne,1514,priest,discipline,122,57,65
Arzaei,quelthalas,1513,priest,discipline,112,54,58
Inssania,ragnaros,1513,priest,discipline,60,28,32
Madpriest,blades-edge,1512,priest,discipline,30,16,14
Gustáv,sargeras,1512,priest,discipline,72,37,35
Absørptiøn,area-52,1511,priest,discipline,42,23,19
Mse,eonar,1511,priest,discipline,48,26,22
Galestick,illidan,1511,priest,discipline,30,16,14
Ulzaar,nerzhul,1511,priest,discipline,89,37,52
Luxury,blackrock,1510,priest,discipline,36,18,18
Manascythe,illidan,1510,priest,discipline,46,22,24
Zroheals,illidan,1510,priest,discipline,107,48,59
Agraheals,barthilas,1509,priest,discipline,42,22,20
Flatëarth,tichondrius,1509,priest,discipline,191,95,96
Ballzach,ysera,1508,priest,discipline,197,102,95
Luvenia,sargeras,1508,priest,discipline,120,60,60
Mandymuze,barthilas,1508,priest,discipline,77,37,40
Iinu,tichondrius,1507,priest,discipline,131,70,61
Euphotic,tichondrius,1507,priest,discipline,55,29,26
Hawtzp,stormrage,1506,priest,discipline,42,24,18
Ndz202933,malganis,1506,priest,discipline,30,16,14
Juckerr,tichondrius,1506,priest,discipline,209,107,102
Zerola,sargeras,1506,priest,discipline,47,24,23
Pinchevato,ragnaros,1506,priest,discipline,218,109,109
Zinnar,dalaran,1506,priest,discipline,96,38,58
Altarboy,agamaggan,1505,priest,discipline,62,30,32
Legó,illidan,1504,priest,discipline,60,29,31
Pootzy,malganis,1504,priest,discipline,87,36,51
Artista,quelthalas,1501,priest,discipline,100,54,46
Nerfdisc,azralon,1501,priest,discipline,142,75,67
Yoozi,sargeras,1501,priest,discipline,126,63,63
Ooft,tichondrius,1501,priest,discipline,34,17,17
Spacecowboyz,stormrage,1501,priest,discipline,54,25,29
Lelenia,tichondrius,1501,priest,discipline,49,22,27
Bailez,malganis,1500,priest,discipline,49,27,22
Djefe,tichondrius,1500,priest,discipline,102,52,50
Valtres,tichondrius,1499,priest,discipline,30,16,14
Shunio,illidan,1499,priest,discipline,60,25,35
Jpray,bleeding-hollow,1498,priest,discipline,115,62,53
Healther,firetree,1498,priest,discipline,30,16,14
Inkders,detheroc,1498,priest,discipline,58,26,32
Boundword,emerald-dream,1498,priest,discipline,54,22,32
Yorp,tichondrius,1497,priest,discipline,72,36,36
Thottee,bleeding-hollow,1497,priest,discipline,120,55,65
Valixia,sargeras,1497,priest,discipline,90,41,49
Prniss,tichondrius,1496,priest,discipline,41,25,16
Tajee,area-52,1496,priest,discipline,107,57,50
Namemetwo,malganis,1496,priest,discipline,48,23,25
Doutoodou,tichondrius,1495,priest,discipline,94,55,39
Amarexlol,stormrage,1495,priest,discipline,54,27,27
Zivn,tichondrius,1494,priest,discipline,588,306,282
Sgiath,alleria,1493,priest,discipline,42,30,12
Sleezi,emerald-dream,1493,priest,discipline,60,34,26
Healthreat,area-52,1493,priest,discipline,76,42,34
Bradythree,moon-guard,1493,priest,discipline,38,20,18
Weezyxo,tichondrius,1493,priest,discipline,46,19,27
Idolize,proudmoore,1493,priest,discipline,50,20,30
Zllik,illidan,1492,priest,discipline,95,48,47
Dbod,tichondrius,1492,priest,discipline,251,126,125
Bubblerwrapp,malganis,1492,priest,discipline,36,17,19
Constin,doomhammer,1491,priest,discipline,36,20,16
Delrey,sargeras,1491,priest,discipline,38,19,19
Saiyana,frostmourne,1491,priest,discipline,148,72,76
Frag,frostmourne,1490,priest,discipline,60,29,31
Kalilol,tichondrius,1490,priest,discipline,132,61,71
Alelith,quelthalas,1489,priest,discipline,59,27,32
Akayayuelol,tichondrius,1488,priest,discipline,24,19,5
Discobluntzz,tichondrius,1488,priest,discipline,54,31,23
Priestmode,garona,1488,priest,discipline,60,27,33
Labraidor,tichondrius,1488,priest,discipline,185,81,104
Wisher,tichondrius,1488,priest,discipline,122,52,70
Orzington,laughing-skull,1487,priest,discipline,74,40,34
Watchemeyolo,tichondrius,1487,priest,discipline,66,35,31
Luxyel,azralon,1487,priest,discipline,149,65,84
Windroseh,proudmoore,1486,priest,discipline,60,32,28
Blobble,tichondrius,1486,priest,discipline,102,45,57
Tëmpting,moon-guard,1485,priest,discipline,50,25,25
Zilah,ravencrest,1485,priest,discipline,72,33,39
Aerdaras,illidan,1485,priest,discipline,80,36,44
Ruminationz,stormrage,1485,priest,discipline,128,57,71
Bater,mugthol,1484,priest,discipline,34,18,16
Preacharóund,frostmourne,1484,priest,discipline,102,52,50
Griddly,alterac-mountains,1483,priest,discipline,108,57,51
Dingldangle,tichondrius,1483,priest,discipline,144,70,74
Toxictampax,azjolnerub,1483,priest,discipline,82,39,43
Nidüz,stormrage,1483,priest,discipline,144,68,76
Blacklightz,korgath,1483,priest,discipline,91,42,49
Prff,ragnaros,1483,priest,discipline,42,19,23
Fashion,bleeding-hollow,1482,priest,discipline,48,30,18
Rháényra,tichondrius,1482,priest,discipline,48,25,23
Carcoz,emerald-dream,1482,priest,discipline,87,43,44
Nottahealer,anvilmar,1482,priest,discipline,42,20,22
Zaemyn,dalaran,1482,priest,discipline,44,20,24
Tartapelle,zuljin,1481,priest,discipline,78,44,34
Vemilli,tichondrius,1481,priest,discipline,40,20,20
Aphrodìtë,tichondrius,1481,priest,discipline,127,62,65
Holypuffs,burning-legion,1481,priest,discipline,59,27,32
Aimeé,chromaggus,1481,priest,discipline,54,23,31
Pipete,frostmourne,1480,priest,discipline,174,98,76
Curemeste,illidan,1480,priest,discipline,126,66,60
Merkinhealz,darkspear,1480,priest,discipline,76,39,37
Blinxed,tichondrius,1480,priest,discipline,102,49,53
Hysteria,dalaran,1480,priest,discipline,70,33,37
Sstar,area-52,1479,priest,discipline,24,16,8
Takomochi,sargeras,1479,priest,discipline,35,16,19
Sibble,boulderfist,1479,priest,discipline,56,25,31
Hårper,area-52,1479,priest,discipline,45,18,27
Confesiional,area-52,1478,priest,discipline,68,31,37
Jinxaleyster,ragnaros,1477,priest,discipline,143,81,62
Klowdz,burning-blade,1477,priest,discipline,157,84,73
Manryu,tichondrius,1477,priest,discipline,72,30,42
Jjløver,tichondrius,1476,priest,discipline,24,16,8
Rëckful,area-52,1476,priest,discipline,599,303,296
Baìter,zuljin,1476,priest,discipline,82,41,41
Thadino,nagrand,1476,priest,discipline,126,61,65
Zsofi,rivendare,1476,priest,discipline,110,48,62
Imcringing,illidan,1475,priest,discipline,48,30,18
Luanwanx,tichondrius,1475,priest,discipline,91,51,40
Mightydrëk,malganis,1475,priest,discipline,29,16,13
Kflexx,hydraxis,1475,priest,discipline,128,46,82
ßlest,stormrage,1474,priest,discipline,126,73,53
Skillfull,chogall,1474,priest,discipline,240,128,112
Haizsu,tichondrius,1474,priest,discipline,77,38,39
Xîîaotong,tichondrius,1473,priest,discipline,37,23,14
Basisc,frostmourne,1473,priest,discipline,207,116,91
Ringofvalor,lightnings-blade,1473,priest,discipline,160,85,75
Travoidicus,wyrmrest-accord,1473,priest,discipline,95,48,47
Swagndragon,zuljin,1473,priest,discipline,86,42,44
Jabreez,illidan,1472,priest,discipline,30,18,12
Finnabustt,tichondrius,1472,priest,discipline,106,53,53
Ricekak,haomarush,1471,priest,discipline,66,37,29
Rufían,quelthalas,1471,priest,discipline,48,25,23
Brian,lightnings-blade,1471,priest,discipline,52,27,25
Feedya,tichondrius,1471,priest,discipline,375,184,191
Bigtimeplay,tichondrius,1470,priest,discipline,42,25,17
Yugewap,hyjal,1470,priest,discipline,102,60,42
Lavenderism,moon-guard,1470,priest,discipline,90,45,45
Emmelly,whisperwind,1470,priest,discipline,42,18,24
Doesine,area-52,1469,priest,discipline,42,25,17
Dorashadows,tichondrius,1467,priest,discipline,24,17,7
Sandfire,thrall,1467,priest,discipline,30,16,14
Stargoddess,illidan,1467,priest,discipline,168,84,84
Kafarmer,frostmourne,1466,priest,discipline,107,62,45
Famemolol,tichondrius,1466,priest,discipline,374,179,195
Betterheals,tichondrius,1465,priest,discipline,157,84,73
Azaradet,ragnaros,1465,priest,discipline,87,36,51
Akåsha,zuljin,1465,priest,discipline,62,24,38
Bobet,zuljin,1465,priest,discipline,61,23,38
Cobjr,frostmourne,1464,priest,discipline,30,17,13
Billymaays,azgalor,1464,priest,discipline,145,80,65
Apâthy,area-52,1464,priest,discipline,69,32,37
Dib,arathor,1463,priest,discipline,48,25,23
Dontstopxo,lightbringer,1463,priest,discipline,52,24,28
Frogfrompad,tichondrius,1462,priest,discipline,83,51,32
Gðttlich,stormrage,1462,priest,discipline,38,19,19
Fallenumbra,area-52,1461,priest,discipline,77,44,33
Chainsalight,stormrage,1461,priest,discipline,156,81,75
Priestsz,stormrage,1461,priest,discipline,151,78,73
Ínfocus,area-52,1461,priest,discipline,132,63,69
Forsakenz,jaedenar,1461,priest,discipline,66,30,36
Propagàndhi,daggerspine,1460,priest,discipline,134,58,76
Syfy,thrall,1460,priest,discipline,108,45,63
Growth,fizzcrank,1460,priest,discipline,60,24,36
Floratil,ragnaros,1459,priest,discipline,54,21,33
Darenlor,tichondrius,1458,priest,discipline,93,40,53
Fleshliight,area-52,1456,priest,discipline,51,31,20
Shykaii,azralon,1456,priest,discipline,108,61,47
Crashed,frostmourne,1456,priest,discipline,36,20,16
Sadnez,illidan,1456,priest,discipline,121,67,54
Sadistic,hyjal,1456,priest,discipline,118,59,59
Akovob,tichondrius,1456,priest,discipline,50,25,25
Sineater,zuljin,1456,priest,discipline,77,36,41
Tiannatrump,stormrage,1455,priest,discipline,53,31,22
Sappes,area-52,1455,priest,discipline,200,110,90
Lethalrosé,thrall,1454,priest,discipline,30,17,13
Huevos,blackwing-lair,1454,priest,discipline,144,76,68
Giveheadpats,moon-guard,1454,priest,discipline,101,47,54
Modotszilla,bleeding-hollow,1454,priest,discipline,36,16,20
Hermeneutic,illidan,1454,priest,discipline,39,17,22
Jaindoe,illidan,1453,priest,discipline,84,46,38
Grimspriest,moon-guard,1453,priest,discipline,47,23,24
Thoaxx,magtheridon,1453,priest,discipline,54,24,30
Zerfen,azralon,1452,priest,discipline,28,16,12
Ünarû,illidan,1452,priest,discipline,108,60,48
Puddín,area-52,1452,priest,discipline,84,42,42
Mistàclean,tichondrius,1452,priest,discipline,89,43,46
Prayf,area-52,1452,priest,discipline,135,64,71
Xeras,misha,1452,priest,discipline,47,21,26
Seriosity,kelthuzad,1452,priest,discipline,42,16,26
Sportsgloss,tichondrius,1451,priest,discipline,72,39,33
Billzerian,nemesis,1451,priest,discipline,63,34,29
Ems,dawnbringer,1451,priest,discipline,75,37,38
Mannius,tichondrius,1451,priest,discipline,61,30,31
Høllywood,nazgrel,1451,priest,discipline,57,28,29
Spookynun,moon-guard,1450,priest,discipline,216,122,94
Jubalie,guldan,1450,priest,discipline,52,27,25
Faxingberlin,sargeras,1450,priest,discipline,40,17,23
Bnn,arathor,1449,priest,discipline,23,16,7
Descubra,stormrage,1449,priest,discipline,36,20,16
Vampiric,laughing-skull,1449,priest,discipline,42,23,19
Doggyy,tichondrius,1449,priest,discipline,166,88,78
Eirua,proudmoore,1449,priest,discipline,78,35,43
Notfandy,tichondrius,1449,priest,discipline,48,19,29
Nek,malganis,1448,priest,discipline,103,61,42
Priøst,tichondrius,1446,priest,discipline,63,38,25
Newchaos,hakkar,1446,priest,discipline,40,24,16
Zäelly,moon-guard,1446,priest,discipline,192,98,94
Vezaxx,barthilas,1446,priest,discipline,132,67,65
Eavin,laughing-skull,1446,priest,discipline,303,152,151
Mileslol,azgalor,1446,priest,discipline,68,34,34
Zeusqt,azralon,1445,priest,discipline,180,94,86
Mamabless,quelthalas,1445,priest,discipline,460,238,222
Augustrox,ragnaros,1445,priest,discipline,164,78,86
Stynke,bleeding-hollow,1445,priest,discipline,54,16,38
Specialed,wildhammer,1443,priest,discipline,71,39,32
Cezure,stormrage,1443,priest,discipline,299,158,141
Yótecuro,quelthalas,1443,priest,discipline,66,31,35
Jeresh,sargeras,1443,priest,discipline,65,21,44
Bandèl,tichondrius,1442,priest,discipline,42,27,15
Rondrica,stormscale,1442,priest,discipline,30,17,13
Raisonpriest,tichondrius,1442,priest,discipline,84,44,40
Kiritomauti,ragnaros,1442,priest,discipline,42,18,24
Easypriest,tichondrius,1441,priest,discipline,96,50,46
Sreykalip,frostmourne,1441,priest,discipline,48,24,24
Shadowblax,thrall,1441,priest,discipline,160,75,85
Flatlining,illidan,1441,priest,discipline,48,22,26
Docmcstufins,darkspear,1440,priest,discipline,65,31,34
Kristyenna,boulderfist,1440,priest,discipline,42,20,22
Josquin,illidan,1440,priest,discipline,70,30,40
Goodvybes,tichondrius,1440,priest,discipline,54,23,31
Zhatfko,illidan,1440,priest,discipline,78,31,47
Tallshiraz,destromath,1439,priest,discipline,24,19,5
Eshimä,quelthalas,1439,priest,discipline,86,50,36
Cubski,darkspear,1439,priest,discipline,30,15,15
Umadcüzubad,azralon,1439,priest,discipline,115,54,61
Scrubx,malganis,1438,priest,discipline,18,15,3
Disperse,vashj,1438,priest,discipline,138,62,76
Rabbix,aggramar,1437,priest,discipline,30,19,11
Mason,winterhoof,1437,priest,discipline,24,15,9
Luffzie,barthilas,1437,priest,discipline,72,41,31
Fotmtrash,the-underbog,1437,priest,discipline,30,15,15
Lauretânia,nemesis,1437,priest,discipline,114,51,63
Joesus,kelthuzad,1437,priest,discipline,38,17,21
Arfaxad,quelthalas,1436,priest,discipline,18,15,3
Vivián,tichondrius,1436,priest,discipline,115,63,52
Compåctdisc,sargeras,1436,priest,discipline,36,18,18
Jacob,shadowmoon,1436,priest,discipline,153,74,79
Draazja,dalaran,1436,priest,discipline,126,60,66
Amãnita,illidan,1436,priest,discipline,35,15,20
Pphill,aegwynn,1436,priest,discipline,48,19,29
Eudog,zuljin,1435,priest,discipline,18,15,3
Madjak,lightnings-blade,1435,priest,discipline,102,58,44
Smashhley,bleeding-hollow,1435,priest,discipline,92,51,41
Murdock,the-forgotten-coast,1435,priest,discipline,56,31,25
Bootycough,malganis,1435,priest,discipline,63,32,31
Sliding,wyrmrest-accord,1435,priest,discipline,30,15,15
Nasser,tichondrius,1435,priest,discipline,30,15,15
Conorpriest,tichondrius,1435,priest,discipline,30,15,15
Lonpriest,stormrage,1435,priest,discipline,210,99,111
Miix,proudmoore,1434,priest,discipline,18,15,3
Baali,moon-guard,1434,priest,discipline,41,27,14
Evpray,area-52,1434,priest,discipline,54,35,19
Luminous,moon-guard,1434,priest,discipline,137,73,64
Detainedz,malganis,1434,priest,discipline,30,15,15
Vineller,malganis,1434,priest,discipline,36,15,21
Høðj,tichondrius,1433,priest,discipline,30,15,15
Amorus,illidan,1432,priest,discipline,60,40,20
Necrodiva,magtheridon,1432,priest,discipline,84,43,41
Rôôk,kiljaeden,1432,priest,discipline,56,26,30
Lullabya,tichondrius,1431,priest,discipline,24,15,9
Napzz,sargeras,1431,priest,discipline,45,27,18
Eridan,moon-guard,1429,priest,discipline,65,33,32
Aexdawg,malganis,1429,priest,discipline,48,24,24
Shadowglezy,area-52,1429,priest,discipline,36,18,18
Kwaremont,sargeras,1429,priest,discipline,30,15,15
Sacredmoon,dreadmaul,1429,priest,discipline,30,15,15
Jilt,aerie-peak,1428,priest,discipline,90,53,37
Tainna,quelthalas,1428,priest,discipline,78,44,34
Elexy,tichondrius,1428,priest,discipline,72,37,35
Axelrod,tichondrius,1428,priest,discipline,54,21,33
Linkolln,sargeras,1427,priest,discipline,30,18,12
Dominantz,khazgoroth,1427,priest,discipline,66,38,28
Femìnazzi,ragnaros,1427,priest,discipline,70,38,32
Minii,tichondrius,1427,priest,discipline,79,40,39
Cherryfuzz,sargeras,1427,priest,discipline,89,45,44
Braffuki,frostmourne,1427,priest,discipline,95,45,50
Beefoverload,durotan,1427,priest,discipline,129,60,69
Pumtootoot,tichondrius,1427,priest,discipline,36,15,21
Dreadpriate,emerald-dream,1426,priest,discipline,104,52,52
Aumsi,illidan,1426,priest,discipline,63,26,37
Covnite,bloodscalp,1425,priest,discipline,48,26,22
Voicekal,sargeras,1425,priest,discipline,77,41,36
Teeds,stormrage,1425,priest,discipline,69,34,35
Saentha,sargeras,1425,priest,discipline,54,25,29
Halö,area-52,1425,priest,discipline,114,51,63
Wíckéd,frostmourne,1425,priest,discipline,57,23,34
Langyi,tichondrius,1424,priest,discipline,72,41,31
Sauile,kelthuzad,1424,priest,discipline,114,64,50
Staysmall,stormrage,1424,priest,discipline,30,15,15
Shakky,queldorei,1423,priest,discipline,78,34,44
Sinthe,stormrage,1422,priest,discipline,24,16,8
Nolan,drakkari,1422,priest,discipline,47,27,20
Zørb,area-52,1422,priest,discipline,54,31,23
Ketaminè,tichondrius,1422,priest,discipline,48,25,23
Miaria,chogall,1422,priest,discipline,126,63,63
Wpj,barthilas,1422,priest,discipline,51,17,34
Bloatie,zuljin,1421,priest,discipline,42,28,14
Izikial,illidan,1421,priest,discipline,48,24,24
Kurobankai,tichondrius,1421,priest,discipline,51,25,26
Plumpkinn,kiljaeden,1421,priest,discipline,36,15,21
Holycast,arygos,1420,priest,discipline,24,15,9
Sackura,quelthalas,1420,priest,discipline,49,26,23
Inmotion,tichondrius,1420,priest,discipline,30,15,15
Machinecoach,stormrage,1419,priest,discipline,30,15,15
Tidbitsy,malganis,1419,priest,discipline,30,15,15
Brotatochip,andorhal,1419,priest,discipline,49,24,25
Malavidax,malganis,1419,priest,discipline,108,45,63
Yözsh,azralon,1419,priest,discipline,60,25,35
Zjqf,akama,1418,priest,discipline,179,89,90
Voyou,icecrown,1418,priest,discipline,106,48,58
Holyish,proudmoore,1418,priest,discipline,42,19,23
Vundead,tichondrius,1418,priest,discipline,36,16,20
Ekros,illidan,1417,priest,discipline,40,23,17
Spazmode,malganis,1417,priest,discipline,75,38,37
Aubieheal,malygos,1416,priest,discipline,42,23,19
Feorlar,tichondrius,1416,priest,discipline,90,43,47
Mäí,ragnaros,1415,priest,discipline,84,51,33
Shonkee,tichondrius,1415,priest,discipline,27,16,11
Sungji,tichondrius,1415,priest,discipline,30,15,15
Sasaberry,frostmourne,1415,priest,discipline,169,80,89
Dtsgx,tichondrius,1414,priest,discipline,27,16,11
Coldphobia,uldum,1414,priest,discipline,157,83,74
Fearnought,stormrage,1414,priest,discipline,82,41,41
Ankhxiety,area-52,1414,priest,discipline,71,33,38
Faerline,kelthuzad,1414,priest,discipline,35,15,20
Aubine,sargeras,1414,priest,discipline,41,15,26
Ananiel,moon-guard,1413,priest,discipline,24,15,9
Artiannaa,bleeding-hollow,1413,priest,discipline,42,24,18
Clancygilroy,thrall,1413,priest,discipline,90,44,46
Tbirdpriest,tichondrius,1413,priest,discipline,35,17,18
Daluu,tichondrius,1413,priest,discipline,51,18,33
Feløre,quelthalas,1412,priest,discipline,51,32,19
Bakøo,tichondrius,1412,priest,discipline,31,19,12
Accismus,khadgar,1412,priest,discipline,78,37,41
Raileight,illidan,1412,priest,discipline,56,25,31
Handyheals,frostmourne,1411,priest,discipline,113,62,51
Posabilties,bleeding-hollow,1411,priest,discipline,42,20,22
Karmatron,chogall,1411,priest,discipline,42,17,25
Dokthekim,frostmourne,1410,priest,discipline,32,19,13
Staywild,tichondrius,1410,priest,discipline,30,15,15
Iivelaughluv,kiljaeden,1409,priest,discipline,51,29,22
Buqisama,barthilas,1409,priest,discipline,72,29,43
Shelak,frostmourne,1408,priest,discipline,62,33,29
Eatmyfear,quelthalas,1408,priest,discipline,247,122,125
Blavkata,area-52,1408,priest,discipline,50,23,27
Midoopriest,proudmoore,1408,priest,discipline,36,15,21
Verchou,shattered-hand,1408,priest,discipline,36,15,21
Justanoutlaw,darkspear,1407,priest,discipline,36,21,15
Kawin,goldrinn,1407,priest,discipline,101,54,47
Sunenergy,tichondrius,1407,priest,discipline,78,41,37
Amaranth,the-forgotten-coast,1407,priest,discipline,30,15,15
Halliburton,illidan,1406,priest,discipline,176,92,84
Sleepiest,wyrmrest-accord,1405,priest,discipline,24,15,9
Seáoflions,aggramar,1405,priest,discipline,24,15,9
Dmlx,frostmourne,1405,priest,discipline,156,90,66
Creamedcorn,tichondrius,1405,priest,discipline,29,15,14
Mangueroide,quelthalas,1405,priest,discipline,111,57,54
Chimiechurro,proudmoore,1405,priest,discipline,90,45,45
Tryst,the-underbog,1404,priest,discipline,60,37,23
Kuriyasu,emerald-dream,1404,priest,discipline,149,78,71
Itsmaám,moon-guard,1403,priest,discipline,42,25,17
Pitayakiller,tichondrius,1403,priest,discipline,29,15,14
Gwyneth,whisperwind,1403,priest,discipline,80,35,45
Kjpriest,kelthuzad,1402,priest,discipline,54,34,20
Nicety,skywall,1402,priest,discipline,50,22,28
Jelzz,area-52,1401,priest,discipline,28,17,11
Dipadre,azralon,1401,priest,discipline,42,25,17
Trickyhobo,area-52,1401,priest,discipline,91,52,39
Lexaprö,moon-guard,1401,priest,discipline,62,33,29
Kaonn,frostmourne,1401,priest,discipline,251,133,118
Bubbahotep,laughing-skull,1401,priest,discipline,52,25,27
Whehaw,kelthuzad,1401,priest,discipline,132,63,69
Yishaarj,tichondrius,1401,priest,discipline,53,24,29
Khyonne,nemesis,1400,priest,discipline,68,37,31
Hunanbeef,kiljaeden,1400,priest,discipline,88,45,43
Peacewrench,moon-guard,1400,priest,discipline,30,15,15
Angusb,sargeras,1400,priest,discipline,113,51,62
Stormìst,korgath,1399,priest,discipline,30,18,12
Welovan,sargeras,1399,priest,discipline,70,36,34
Shnítzel,thrall,1399,priest,discipline,103,51,52
Smegmancer,korgath,1399,priest,discipline,54,24,30
Peristalsis,nesingwary,1399,priest,discipline,36,16,20
Coldvbs,barthilas,1398,priest,discipline,46,26,20
Palpitine,kiljaeden,1398,priest,discipline,60,33,27
Fanatic,nemesis,1397,priest,discipline,226,117,109
Diabiitus,stormrage,1396,priest,discipline,105,61,44
Ðohko,ragnaros,1395,priest,discipline,36,20,16
Karminha,azralon,1393,priest,discipline,24,17,7
Freck,stormrage,1393,priest,discipline,42,25,17
Icônz,malganis,1393,priest,discipline,59,31,28
Kasiry,ragnaros,1393,priest,discipline,66,34,32
Lilblackguys,stormrage,1393,priest,discipline,114,56,58
Scriptz,frostwolf,1393,priest,discipline,66,30,36
Raggasoca,malganis,1393,priest,discipline,99,44,55
Macnabber,malganis,1392,priest,discipline,30,20,10
Ðiplø,tichondrius,1392,priest,discipline,35,21,14
Smirkinlive,illidan,1392,priest,discipline,38,22,16
Donzorro,ragnaros,1392,priest,discipline,87,46,41
Soméone,sargeras,1392,priest,discipline,164,86,78
Tluoc,nemesis,1391,priest,discipline,47,25,22
Smittën,barthilas,1390,priest,discipline,72,40,32
Scortum,goldrinn,1390,priest,discipline,36,20,16
Phayzz,area-52,1390,priest,discipline,123,63,60
Jaeza,azralon,1390,priest,discipline,47,22,25
Chofis,nathrezim,1389,priest,discipline,36,24,12
Leviathanh,tichondrius,1389,priest,discipline,42,27,15
Såge,chogall,1389,priest,discipline,219,120,99
Shastyr,tichondrius,1389,priest,discipline,48,19,29
Zygotes,tichondrius,1388,priest,discipline,27,16,11
Xyló,area-52,1388,priest,discipline,118,65,53
Cathêlay,bleeding-hollow,1388,priest,discipline,91,44,47
Helibix,bleeding-hollow,1388,priest,discipline,114,53,61
Krukam,sargeras,1386,priest,discipline,66,40,26
Unholywizard,sargeras,1386,priest,discipline,66,37,29
Strawson,quelthalas,1386,priest,discipline,105,50,55
Kobayashy,ragnaros,1385,priest,discipline,48,29,19
Holyninfo,quelthalas,1385,priest,discipline,60,36,24
Vexyy,tichondrius,1385,priest,discipline,32,19,13
Mursey,sargeras,1385,priest,discipline,111,51,60
Laüren,ragnaros,1385,priest,discipline,103,46,57
Oprawinfree,tichondrius,1384,priest,discipline,94,54,40
Tungus,shadowsong,1384,priest,discipline,97,51,46
Icetraygang,suramar,1383,priest,discipline,386,204,182
Arkenes,dalaran,1383,priest,discipline,78,41,37
Wholeness,kelthuzad,1383,priest,discipline,48,21,27
Holykushed,tichondrius,1382,priest,discipline,38,19,19
Shrax,emerald-dream,1382,priest,discipline,149,68,81
Sukmysplooge,queldorei,1382,priest,discipline,66,28,38
Tiskka,magtheridon,1382,priest,discipline,68,28,40
Jamesxupttv,draenor,1381,priest,discipline,64,33,31
Sílvia,durotan,1381,priest,discipline,60,28,32
Therialjp,ragnaros,1380,priest,discipline,36,21,15
Jinniu,azralon,1380,priest,discipline,42,17,25
Helarix,malganis,1379,priest,discipline,127,58,69
Drhutchinson,illidan,1377,priest,discipline,30,16,14
Oldris,darkspear,1377,priest,discipline,47,25,22
Lexinalis,stormrage,1376,priest,discipline,29,17,12
Kallixprime,ragnaros,1376,priest,discipline,53,29,24
Fádéd,tichondrius,1376,priest,discipline,29,15,14
Sixfiggas,darkspear,1375,priest,discipline,24,17,7
Aldrych,malganis,1375,priest,discipline,61,35,26
Dlysexic,barthilas,1375,priest,discipline,66,35,31
Sistamaggie,bleeding-hollow,1375,priest,discipline,66,33,33
Drinkndrive,tichondrius,1374,priest,discipline,51,27,24
Zombieheals,gundrak,1373,priest,discipline,53,27,26
Halcyon,eonar,1372,priest,discipline,74,34,40
Mauriel,proudmoore,1372,priest,discipline,42,19,23
Karazhan,burning-legion,1371,priest,discipline,44,19,25
Glauga,azralon,1371,priest,discipline,42,17,25
Sinsuu,tichondrius,1370,priest,discipline,120,64,56
Jìtters,silvermoon,1370,priest,discipline,36,17,19
Devilwithin,moon-guard,1369,priest,discipline,47,28,19
Kyoku,tanaris,1369,priest,discipline,47,27,20
Aarei,stormrage,1369,priest,discipline,30,16,14
Onjah,kiljaeden,1369,priest,discipline,60,25,35
Rotass,hyjal,1368,priest,discipline,60,36,24
Vacyle,azralon,1368,priest,discipline,42,23,19
Pyta,frostmourne,1367,priest,discipline,62,32,30
Unholyhand,moon-guard,1367,priest,discipline,60,27,33
Solsano,stormrage,1365,priest,discipline,76,44,32
Poefosho,stormrage,1365,priest,discipline,58,29,29
Winnzhor,bonechewer,1364,priest,discipline,47,27,20
Bøness,area-52,1364,priest,discipline,118,61,57
Sermøn,azuremyst,1364,priest,discipline,135,67,68
Armî,ragnaros,1364,priest,discipline,36,16,20
Tazzi,chromaggus,1363,priest,discipline,36,20,16
Halfyo,dragonmaw,1363,priest,discipline,90,49,41
Füuzin,stormrage,1362,priest,discipline,66,34,32
Thorzan,eredar,1362,priest,discipline,30,15,15
Honypot,ysondre,1361,priest,discipline,60,34,26
Angelicus,ragnaros,1361,priest,discipline,156,83,73
Temkcalb,ragnaros,1361,priest,discipline,90,46,44
Sinnertitanz,quelthalas,1361,priest,discipline,90,46,44
Rakpriest,nerzhul,1360,priest,discipline,43,29,14
Curasia,drakkari,1360,priest,discipline,57,37,20
Happylonely,farstriders,1360,priest,discipline,27,15,12
Trummp,tichondrius,1359,priest,discipline,75,40,35
Powerwordzz,dragonmaw,1359,priest,discipline,72,36,36
Huck,khazgoroth,1359,priest,discipline,36,18,18
Itsme,quelthalas,1359,priest,discipline,71,32,39
Crucïfïx,stormrage,1358,priest,discipline,70,41,29
Nexoox,drakkari,1358,priest,discipline,42,23,19
Tyszie,sargeras,1358,priest,discipline,30,15,15
Tûbes,trollbane,1358,priest,discipline,101,42,59
Replacednewb,chogall,1357,priest,discipline,51,27,24
Eiju,proudmoore,1357,priest,discipline,42,19,23
Aerdune,dalaran,1356,priest,discipline,68,36,32
Empower,garrosh,1355,priest,discipline,45,29,16
Vhexz,sargeras,1355,priest,discipline,56,36,20
Saegusa,tichondrius,1354,priest,discipline,30,15,15
Kymmei,warsong,1354,priest,discipline,30,15,15
Msdash,tichondrius,1353,priest,discipline,42,23,19
Srwilly,ragnaros,1353,priest,discipline,87,47,40
Renews,azralon,1353,priest,discipline,52,28,24
Swolequadz,elune,1353,priest,discipline,30,16,14
Wtfamdoing,quelthalas,1353,priest,discipline,29,15,14
Misfyt,emerald-dream,1353,priest,discipline,66,33,33
Victrix,tichondrius,1353,priest,discipline,112,47,65
Mateekie,malganis,1352,priest,discipline,43,24,19
Chìbiusa,gurubashi,1352,priest,discipline,106,52,54
Ggums,tichondrius,1352,priest,discipline,84,40,44
Hootin,whisperwind,1351,priest,discipline,62,35,27
Risedead,azralon,1351,priest,discipline,132,70,62
Kantareller,tichondrius,1349,priest,discipline,99,60,39
Pagän,illidan,1349,priest,discipline,45,25,20
Aurajade,queldorei,1349,priest,discipline,30,15,15
Yeshùa,drakkari,1349,priest,discipline,125,59,66
Beñzi,sargeras,1348,priest,discipline,26,16,10
Oomed,bonechewer,1348,priest,discipline,118,59,59
Howdydoo,azshara,1348,priest,discipline,73,33,40
Dxskadi,stormrage,1348,priest,discipline,156,68,88
Zóe,eredar,1347,priest,discipline,58,32,26
Revreal,thrall,1346,priest,discipline,48,25,23
Helianna,whisperwind,1346,priest,discipline,114,50,64
Benedictüs,tichondrius,1345,priest,discipline,154,77,77
Pelagius,suramar,1345,priest,discipline,44,19,25
ßræcher,black-dragonflight,1344,priest,discipline,36,24,12
Hoppus,stormrage,1344,priest,discipline,90,44,46
Scaloni,proudmoore,1343,priest,discipline,29,18,11
Mthwz,tichondrius,1343,priest,discipline,24,14,10
Bohomagz,tichondrius,1343,priest,discipline,24,14,10
Magicßoy,magtheridon,1343,priest,discipline,152,79,73
Fadewench,sargeras,1343,priest,discipline,41,21,20
Lucsor,malganis,1343,priest,discipline,119,60,59
Míssdank,tichondrius,1343,priest,discipline,36,18,18
Jabberwolky,blackrock,1343,priest,discipline,36,14,22
Crazykitsune,thaurissan,1342,priest,discipline,42,27,15
Namî,barthilas,1342,priest,discipline,191,104,87
Lawroade,tichondrius,1342,priest,discipline,67,36,31
Notoriousmmä,illidan,1342,priest,discipline,30,15,15
Mitoloshi,ragnaros,1342,priest,discipline,120,58,62
Redcoolaid,moon-guard,1341,priest,discipline,24,14,10
Tyreliy,eitrigg,1341,priest,discipline,175,90,85
Zoap,stormrage,1341,priest,discipline,60,26,34
Bobbyrich,sargeras,1340,priest,discipline,18,14,4
Néy,illidan,1340,priest,discipline,18,14,4
Saintpleb,sargeras,1340,priest,discipline,18,14,4
Teiam,skullcrusher,1340,priest,discipline,24,14,10
Bionix,stormrage,1340,priest,discipline,72,37,35
Psÿçhë,stormrage,1340,priest,discipline,30,14,16
Storylord,malganis,1340,priest,discipline,30,14,16
Krindil,korgath,1339,priest,discipline,59,34,25
Fleckyy,tichondrius,1339,priest,discipline,36,14,22
Eddiethehead,zuljin,1338,priest,discipline,24,14,10
Bugsbright,tichondrius,1338,priest,discipline,125,69,56
Vehlind,quelthalas,1338,priest,discipline,101,52,49
Haquin,malganis,1338,priest,discipline,30,14,16
Knoskeezy,proudmoore,1337,priest,discipline,18,14,4
Muuq,frostmourne,1337,priest,discipline,221,110,111
Monâ,sargeras,1337,priest,discipline,30,14,16
Foxspritques,area-52,1337,priest,discipline,58,16,42
Lilazngirl,stormrage,1336,priest,discipline,30,19,11
Xxqq,illidan,1335,priest,discipline,24,14,10
Metagameswag,tichondrius,1335,priest,discipline,24,14,10
Shadina,gorefiend,1335,priest,discipline,36,14,22
Talbadontu,thrall,1334,priest,discipline,42,22,20
Erossenin,proudmoore,1334,priest,discipline,30,15,15
Slumpbusterx,bonechewer,1334,priest,discipline,169,75,94
Dederpriest,stormrage,1333,priest,discipline,18,14,4
Qoon,tichondrius,1333,priest,discipline,24,14,10
Cäpriestsunn,thrall,1333,priest,discipline,24,14,10
Rblood,emerald-dream,1332,priest,discipline,54,33,21
Ilickdeadppl,sargeras,1331,priest,discipline,28,17,11
Noveh,tichondrius,1331,priest,discipline,36,17,19
Bigskill,proudmoore,1331,priest,discipline,48,21,27
Lily,blackrock,1330,priest,discipline,18,14,4
Matchakatt,tichondrius,1330,priest,discipline,59,37,22
Pactosombrio,azralon,1330,priest,discipline,117,69,48
Bathenape,bleeding-hollow,1330,priest,discipline,40,23,17
Holyfromrmp,tichondrius,1330,priest,discipline,72,35,37
Decline,balnazzar,1330,priest,discipline,30,14,16
Náay,ragnaros,1329,priest,discipline,47,30,17
Xuun,illidan,1329,priest,discipline,71,42,29
Emotionless,bonechewer,1329,priest,discipline,140,75,65
Themoon,tichondrius,1328,priest,discipline,24,14,10
Jacksreturne,kelthuzad,1327,priest,discipline,413,207,206
Raydz,altar-of-storms,1327,priest,discipline,266,127,139
Nêrô,dalaran,1327,priest,discipline,66,29,37
Danrien,azralon,1326,priest,discipline,34,20,14
Aveil,bloodscalp,1326,priest,discipline,34,20,14
Rickjames,laughing-skull,1326,priest,discipline,86,47,39
Healmedaddyy,korgath,1326,priest,discipline,207,99,108
Juliusceazer,skywall,1325,priest,discipline,128,73,55
Zapix,tichondrius,1325,priest,discipline,36,15,21
Blessedelf,tichondrius,1325,priest,discipline,66,26,40
Edmust,black-dragonflight,1324,priest,discipline,24,14,10
Köto,dalaran,1324,priest,discipline,53,29,24
Rvxy,tichondrius,1324,priest,discipline,84,42,42
Xerzosh,area-52,1323,priest,discipline,154,81,73
Jaysontatum,gurubashi,1323,priest,discipline,33,17,16
Heltor,sargeras,1323,priest,discipline,66,25,41
Textmepls,barthilas,1322,priest,discipline,42,26,16
Kaeshia,proudmoore,1322,priest,discipline,30,18,12
Greif,garrosh,1322,priest,discipline,36,19,17
Burroviejo,quelthalas,1322,priest,discipline,40,17,23
Vandaley,tichondrius,1321,priest,discipline,24,17,7
Javox,drakkari,1321,priest,discipline,24,14,10
Warmth,moon-guard,1321,priest,discipline,45,26,19
Xtty,thrall,1321,priest,discipline,31,15,16
Sinnon,turalyon,1320,priest,discipline,30,17,13
Mkowns,tichondrius,1319,priest,discipline,24,14,10
Nadiaxo,moon-guard,1319,priest,discipline,65,35,30
Nøzmonica,kelthuzad,1319,priest,discipline,32,15,17
Ripscrew,area-52,1316,priest,discipline,24,14,10
Malevolently,illidan,1316,priest,discipline,137,62,75
Seniro,tichondrius,1315,priest,discipline,36,23,13
Wöödy,area-52,1315,priest,discipline,34,18,16
Chaøz,emerald-dream,1314,priest,discipline,41,24,17
Elixia,maiev,1314,priest,discipline,54,31,23
Thelondon,tichondrius,1314,priest,discipline,27,15,12
Flab,tichondrius,1314,priest,discipline,30,15,15
Haø,stormrage,1314,priest,discipline,278,137,141
Darkquinn,boulderfist,1314,priest,discipline,272,126,146
Blaydun,elune,1313,priest,discipline,114,66,48
Moontearss,tichondrius,1313,priest,discipline,48,25,23
Kms,sargeras,1313,priest,discipline,51,26,25
Eirenth,bleeding-hollow,1312,priest,discipline,34,26,8
Jsuschristix,zuljin,1311,priest,discipline,36,23,13
Médic,guldan,1311,priest,discipline,30,17,13
Goodwin,darkspear,1310,priest,discipline,48,29,19
Chîna,hyjal,1310,priest,discipline,126,76,50
Conney,mugthol,1310,priest,discipline,24,14,10
Anymoon,tichondrius,1310,priest,discipline,78,42,36
Leprêtre,hakkar,1310,priest,discipline,30,16,14
Eclìpsè,barthilas,1310,priest,discipline,44,20,24
Yürika,emerald-dream,1310,priest,discipline,60,21,39
Jestiann,aegwynn,1309,priest,discipline,207,109,98
Malarkie,sargeras,1309,priest,discipline,30,14,16
Jaskil,skywall,1308,priest,discipline,78,42,36
Booyâh,muradin,1308,priest,discipline,54,27,27
Peavzian,kiljaeden,1308,priest,discipline,52,24,28
Quinnx,tichondrius,1308,priest,discipline,36,16,20
Majesticar,moon-guard,1307,priest,discipline,30,20,10
Rompenepes,drakkari,1307,priest,discipline,24,14,10
Médíc,dalaran,1307,priest,discipline,63,32,31
Starshollow,ragnaros,1307,priest,discipline,75,38,37
Dominie,area-52,1306,priest,discipline,18,14,4
Aesudan,dalaran,1306,priest,discipline,51,27,24
Priestgobrr,emerald-dream,1305,priest,discipline,50,30,20
Ruthlèss,ragnaros,1305,priest,discipline,54,28,26
Exploded,moon-guard,1305,priest,discipline,85,34,51
Fairylìght,stormrage,1305,priest,discipline,61,22,39
Dahrwin,thrall,1303,priest,discipline,42,24,18
Paidessanto,azralon,1303,priest,discipline,98,55,43
Plznokill,tichondrius,1303,priest,discipline,36,18,18
ßoogey,tichondrius,1303,priest,discipline,47,22,25
Gustavustus,barthilas,1303,priest,discipline,42,14,28
Soaphia,kelthuzad,1302,priest,discipline,96,55,41
Rêvelation,trollbane,1302,priest,discipline,78,41,37
Poorass,sargeras,1301,priest,discipline,30,19,11
Aedarelyn,ysera,1301,priest,discipline,42,22,20
Evilnyllah,stormrage,1300,priest,discipline,32,20,12
Gäindalt,tichondrius,1300,priest,discipline,30,18,12
Atyourcervix,emerald-dream,1299,priest,discipline,26,15,11
Tarny,tichondrius,1298,priest,discipline,46,29,17
Krané,area-52,1298,priest,discipline,51,24,27
Bandagebabe,sargeras,1298,priest,discipline,36,15,21
Wildmanfrank,tichondrius,1297,priest,discipline,37,21,16
Timeglass,kelthuzad,1297,priest,discipline,47,26,21
Mechahomo,dalaran,1297,priest,discipline,52,28,24
Penetron,tichondrius,1297,priest,discipline,53,22,31
Volkova,quelthalas,1296,priest,discipline,48,26,22
Dabbinton,chogall,1296,priest,discipline,52,26,26
Hydramîst,ragnaros,1296,priest,discipline,36,15,21
Fenian,frostmourne,1295,priest,discipline,123,60,63
Yunganal,sargeras,1294,priest,discipline,24,14,10
Rrain,proudmoore,1294,priest,discipline,35,15,20
Moresex,azralon,1293,priest,discipline,36,20,16
Theheal,ragnaros,1293,priest,discipline,57,19,38
Dadthegreat,bonechewer,1292,priest,discipline,42,25,17
Usmond,azralon,1292,priest,discipline,48,23,25
Cyphrus,hyjal,1292,priest,discipline,35,15,20
Gnralways,andorhal,1292,priest,discipline,69,29,40
Unfriend,sargeras,1291,priest,discipline,48,22,26
Rakket,moon-guard,1291,priest,discipline,36,16,20
Soulclap,sargeras,1291,priest,discipline,35,14,21
Lyxx,kelthuzad,1290,priest,discipline,22,15,7
Rickitz,bleeding-hollow,1290,priest,discipline,36,17,19
Tempgnome,stonemaul,1288,priest,discipline,97,51,46
Troublmaker,illidan,1288,priest,discipline,46,24,22
Cathiah,darkspear,1288,priest,discipline,152,77,75
Xpera,dalaran,1288,priest,discipline,95,45,50
Bibops,area-52,1288,priest,discipline,37,15,22
Iwonthealu,senjin,1286,priest,discipline,30,16,14
Novous,area-52,1286,priest,discipline,56,26,30
Khaleth,suramar,1286,priest,discipline,48,20,28
Brounly,drakkari,1285,priest,discipline,72,36,36
Yayoo,exodar,1285,priest,discipline,33,16,17
Nenemsis,drakkari,1285,priest,discipline,38,16,22
Boibussy,tichondrius,1285,priest,discipline,36,15,21
Goingserious,frostmourne,1284,priest,discipline,135,77,58
Quickq,barthilas,1283,priest,discipline,36,22,14
Penancepapi,stormrage,1283,priest,discipline,30,14,16
Presto,kalecgos,1281,priest,discipline,24,19,5
Dismybracket,tichondrius,1281,priest,discipline,42,20,22
Lifeswap,area-52,1281,priest,discipline,54,21,33
Briefs,stormrage,1278,priest,discipline,21,15,6
Bloodsorrow,ragnaros,1278,priest,discipline,72,39,33
Souriel,tichondrius,1278,priest,discipline,78,41,37
Phonomena,malganis,1278,priest,discipline,102,53,49
Kakao,stormreaver,1278,priest,discipline,120,51,69
Lamont,archimonde,1277,priest,discipline,38,14,24
Nanabritches,moon-guard,1276,priest,discipline,116,62,54
Invocational,moon-guard,1276,priest,discipline,77,40,37
Lowkii,malfurion,1275,priest,discipline,35,17,18
Shaytyme,tichondrius,1275,priest,discipline,40,15,25
Nylaza,kiljaeden,1274,priest,discipline,71,28,43
Boocharni,wyrmrest-accord,1273,priest,discipline,48,28,20
Sòraka,tichondrius,1273,priest,discipline,80,39,41
Xavaat,nerzhul,1273,priest,discipline,60,26,34
Rando,shattered-halls,1272,priest,discipline,35,18,17
Discgolfsux,sargeras,1271,priest,discipline,50,19,31
Healmegently,bonechewer,1271,priest,discipline,45,15,30
Themøn,quelthalas,1270,priest,discipline,30,16,14
Markspell,stormrage,1270,priest,discipline,145,77,68
Derlanger,frostmourne,1270,priest,discipline,48,25,23
Twotimechamp,azshara,1269,priest,discipline,50,26,24
Phenic,aggramar,1269,priest,discipline,35,14,21
Snekboy,hakkar,1268,priest,discipline,66,41,25
Jjayleroux,hyjal,1268,priest,discipline,54,26,28
Aggravating,mugthol,1267,priest,discipline,176,89,87
Miraz,the-venture-co,1266,priest,discipline,53,29,24
Ahane,wyrmrest-accord,1266,priest,discipline,36,15,21
Sureno,muradin,1265,priest,discipline,30,18,12
Penitentrowr,illidan,1265,priest,discipline,77,40,37
Zenthaz,thrall,1264,priest,discipline,30,16,14
Capricornio,nemesis,1264,priest,discipline,36,18,18
Fumes,ghostlands,1264,priest,discipline,78,36,42
Keskima,malganis,1263,priest,discipline,81,51,30
Sheriff,lightbringer,1263,priest,discipline,54,33,21
Rashad,proudmoore,1262,priest,discipline,59,34,25
Wise,wildhammer,1262,priest,discipline,70,37,33
Saràh,stormscale,1262,priest,discipline,94,43,51
Reindharth,quelthalas,1262,priest,discipline,84,35,49
Kristt,thrall,1262,priest,discipline,41,16,25
Emlix,tichondrius,1262,priest,discipline,42,14,28
Fesix,akama,1261,priest,discipline,30,17,13
Aladelre,aerie-peak,1261,priest,discipline,56,26,30
Hideyourkids,stormreaver,1261,priest,discipline,42,18,24
Lìlí,tichondrius,1261,priest,discipline,42,17,25
Pico,spirestone,1260,priest,discipline,36,20,16
Hobbs,trollbane,1260,priest,discipline,42,22,20
Pêrsephône,tichondrius,1259,priest,discipline,117,55,62
Alawn,wyrmrest-accord,1259,priest,discipline,120,52,68
Atelios,azralon,1258,priest,discipline,30,20,10
Lildeen,area-52,1258,priest,discipline,26,15,11
Kymosolop,sargeras,1258,priest,discipline,25,14,11
Skall,kirin-tor,1258,priest,discipline,41,21,20
Saadboii,thrall,1257,priest,discipline,61,31,30
Dralaan,proudmoore,1257,priest,discipline,92,44,48
Kenzao,nemesis,1257,priest,discipline,64,30,34
Lge,kelthuzad,1257,priest,discipline,31,14,17
Dartonya,thrall,1257,priest,discipline,36,15,21
Xmasmiracle,korgath,1256,priest,discipline,94,54,40
Nìght,trollbane,1256,priest,discipline,102,54,48
Eleeira,zuljin,1256,priest,discipline,36,15,21
Knifê,moon-guard,1255,priest,discipline,108,54,54
Thotznprayrz,bleeding-hollow,1254,priest,discipline,36,23,13
Snowinvan,tichondrius,1254,priest,discipline,24,15,9
Mellerwine,azralon,1254,priest,discipline,312,160,152
Inferis,ragnaros,1254,priest,discipline,375,188,187
Nometh,emerald-dream,1254,priest,discipline,84,34,50
Chavkoraken,stormrage,1254,priest,discipline,38,15,23
Fatherßrian,draktharon,1253,priest,discipline,30,16,14
Ezelra,frostmourne,1253,priest,discipline,29,14,15
Kapriestun,tichondrius,1252,priest,discipline,60,35,25
Masochist,barthilas,1252,priest,discipline,127,71,56
Rbgeezus,lightnings-blade,1252,priest,discipline,113,57,56
Këyglock,kelthuzad,1252,priest,discipline,252,111,141
Boostvoid,terenas,1251,priest,discipline,72,42,30
Finake,kelthuzad,1251,priest,discipline,73,41,32
Dosarix,sargeras,1250,priest,discipline,40,23,17
Burpees,dalaran,1250,priest,discipline,28,15,13
Bröke,nemesis,1249,priest,discipline,90,48,42
Frikapp,stormrage,1248,priest,discipline,24,13,11
Lalaliza,kelthuzad,1248,priest,discipline,24,13,11
Allhubris,stormrage,1248,priest,discipline,24,13,11
Webbii,frostmourne,1248,priest,discipline,48,21,27
Curiosities,kiljaeden,1248,priest,discipline,30,13,17
Kayern,kelthuzad,1247,priest,discipline,18,13,5
Mswatermelon,malganis,1247,priest,discipline,22,14,8
Meatboxmoldy,blood-furnace,1247,priest,discipline,24,13,11
Iatemykids,tichondrius,1247,priest,discipline,24,13,11
Lvcia,thrall,1247,priest,discipline,70,35,35
Mastahspell,illidan,1247,priest,discipline,30,13,17
Criil,area-52,1247,priest,discipline,30,13,17
Pce,korialstrasz,1247,priest,discipline,34,13,21
Peacetreaty,bleeding-hollow,1246,priest,discipline,24,13,11
Iol,spinebreaker,1246,priest,discipline,24,13,11
Picurry,frostmourne,1246,priest,discipline,24,13,11
Docbek,illidan,1246,priest,discipline,47,23,24
Zumbaoqepdqt,quelthalas,1246,priest,discipline,48,21,27
Madmilesstv,zuljin,1246,priest,discipline,30,13,17
Akuhei,illidan,1245,priest,discipline,18,13,5
Alphôn,bleeding-hollow,1245,priest,discipline,30,13,17
Youaint,sargeras,1245,priest,discipline,30,13,17
Mommyshere,vashj,1244,priest,discipline,54,30,24
Lesx,tichondrius,1244,priest,discipline,24,13,11
Seí,barthilas,1244,priest,discipline,30,13,17
Bòngu,tichondrius,1244,priest,discipline,30,13,17
Bingoreferee,kelthuzad,1243,priest,discipline,24,13,11
Swaheally,frostmourne,1243,priest,discipline,24,13,11
Haetas,zuljin,1243,priest,discipline,30,13,17
Cyaja,moon-guard,1243,priest,discipline,31,13,18
Meiev,quelthalas,1243,priest,discipline,36,13,23
Velandrys,earthen-ring,1242,priest,discipline,24,13,11
Fleshsack,area-52,1242,priest,discipline,24,13,11
Toorshul,tichondrius,1242,priest,discipline,30,16,14
Sofhya,ragnaros,1242,priest,discipline,112,58,54
Grapës,jubeithos,1242,priest,discipline,48,23,25
Cuddly,shandris,1242,priest,discipline,119,54,65
Shrooks,frostmourne,1242,priest,discipline,30,13,17
Kukion,uldum,1242,priest,discipline,30,13,17
Tý,frostmourne,1242,priest,discipline,30,13,17
Skvmbag,tichondrius,1241,priest,discipline,16,14,2
Phaille,chromaggus,1241,priest,discipline,134,71,63
Vancake,quelthalas,1241,priest,discipline,180,82,98
Harborcoat,whisperwind,1241,priest,discipline,35,14,21
Creòle,area-52,1240,priest,discipline,24,13,11
Arodar,wyrmrest-accord,1240,priest,discipline,30,14,16
Dagónet,sargeras,1240,priest,discipline,36,15,21
Discobish,sargeras,1239,priest,discipline,30,13,17
Dics,barthilas,1238,priest,discipline,18,13,5
Cvstodia,tichondrius,1238,priest,discipline,30,16,14
Misaosan,azralon,1238,priest,discipline,60,29,31
Keliedeyn,emerald-dream,1238,priest,discipline,42,20,22
Jesstor,frostmourne,1237,priest,discipline,24,13,11
Karnival,aggramar,1237,priest,discipline,31,15,16
Xuxao,azralon,1237,priest,discipline,35,15,20
Tdmheals,zuluhed,1236,priest,discipline,36,25,11
Whitesharks,tichondrius,1236,priest,discipline,24,13,11
Holycoww,lightnings-blade,1236,priest,discipline,24,13,11
Holyren,sargeras,1236,priest,discipline,105,55,50
Cast,bronzebeard,1236,priest,discipline,48,22,26
Digop,azralon,1236,priest,discipline,36,13,23
Deadlydocc,illidan,1235,priest,discipline,39,23,16
Voidathon,sargeras,1235,priest,discipline,24,13,11
Muromsnel,proudmoore,1235,priest,discipline,24,13,11
Bonkerwaffle,kelthuzad,1235,priest,discipline,54,29,25
Betrthenadam,bleeding-hollow,1235,priest,discipline,66,32,34
Orìsel,wyrmrest-accord,1235,priest,discipline,105,49,56
Ickarus,anubarak,1233,priest,discipline,90,49,41
Kinkypriest,tichondrius,1233,priest,discipline,24,13,11
Scirzzy,tichondrius,1233,priest,discipline,24,13,11
Dårc,tichondrius,1233,priest,discipline,113,58,55
Anöa,emerald-dream,1233,priest,discipline,36,16,20
Ktqt,moon-guard,1232,priest,discipline,202,99,103
Chernota,kiljaeden,1232,priest,discipline,30,13,17
Gurkorr,boulderfist,1232,priest,discipline,51,22,29
Xora,frostmourne,1232,priest,discipline,36,13,23
Kuroyanagi,ragnaros,1232,priest,discipline,36,13,23
Theboogieman,magtheridon,1231,priest,discipline,54,25,29
Holyxb,bleeding-hollow,1231,priest,discipline,36,13,23
Shïtheals,frostmourne,1230,priest,discipline,42,25,17
Ón,tichondrius,1230,priest,discipline,30,13,17
Babino,illidan,1230,priest,discipline,60,25,35
Ingladforx,azralon,1230,priest,discipline,36,13,23
Tokoyo,sargeras,1229,priest,discipline,18,13,5
Riotgearmd,sargeras,1229,priest,discipline,30,17,13
Wanaatlarboy,dark-iron,1229,priest,discipline,41,23,18
Lichae,ragnaros,1229,priest,discipline,48,24,24
Eneco,alleria,1228,priest,discipline,204,113,91
Kurtsheals,destromath,1228,priest,discipline,60,31,29
Krypticus,tichondrius,1227,priest,discipline,48,28,20
Aape,frostmourne,1227,priest,discipline,24,13,11
Dispelbot,kelthuzad,1226,priest,discipline,124,71,53
Gurbooz,tichondrius,1225,priest,discipline,77,35,42
Bendoverbb,tichondrius,1225,priest,discipline,30,13,17
Goseoa,tichondrius,1225,priest,discipline,30,13,17
Somberr,dalaran,1223,priest,discipline,27,14,13
Fearufaraway,tichondrius,1223,priest,discipline,36,13,23
Ahitaro,ragnaros,1223,priest,discipline,60,18,42
Kosiris,stormrage,1222,priest,discipline,102,41,61
Hoffmanx,emerald-dream,1221,priest,discipline,24,13,11
Aynone,blood-furnace,1221,priest,discipline,126,60,66
Zadae,area-52,1220,priest,discipline,63,34,29
Pòba,malganis,1220,priest,discipline,30,13,17
Séraphin,proudmoore,1219,priest,discipline,37,16,21
Jic,barthilas,1219,priest,discipline,66,25,41
Nonamegame,sargeras,1218,priest,discipline,78,42,36
Pyper,medivh,1218,priest,discipline,29,14,15
Lanakill,hyjal,1218,priest,discipline,56,25,31
Cajl,dathremar,1218,priest,discipline,127,56,71
Yvága,ragnaros,1217,priest,discipline,48,27,21
Pacopriest,tichondrius,1217,priest,discipline,24,13,11
Methodist,proudmoore,1216,priest,discipline,67,24,43
Göats,emerald-dream,1215,priest,discipline,24,13,11
Aipata,stormrage,1215,priest,discipline,62,33,29
Mythica,gurubashi,1215,priest,discipline,132,69,63
Russbell,ragnaros,1215,priest,discipline,125,54,71
Eîr,tichondrius,1215,priest,discipline,72,29,43
Sojumike,proudmoore,1214,priest,discipline,36,18,18
Holyrotape,nemesis,1214,priest,discipline,30,13,17
Looneý,drakkari,1212,priest,discipline,73,42,31
Armspriest,stormrage,1212,priest,discipline,47,24,23
Nóin,tichondrius,1212,priest,discipline,72,33,39
Näme,frostmourne,1212,priest,discipline,36,16,20
Wísh,emerald-dream,1211,priest,discipline,60,35,25
Dotersacer,quelthalas,1211,priest,discipline,31,15,16
Abhu,quelthalas,1210,priest,discipline,71,38,33
Deckardkane,stormrage,1209,priest,discipline,32,14,18
Ariavish,area-52,1208,priest,discipline,48,25,23
Kodaks,frostmourne,1208,priest,discipline,75,37,38
Methodist,sargeras,1207,priest,discipline,24,13,11
Pixa,tichondrius,1207,priest,discipline,72,33,39
Kithlas,emerald-dream,1206,priest,discipline,18,13,5
Defilex,tichondrius,1206,priest,discipline,22,15,7
Nothinsexual,frostmourne,1206,priest,discipline,26,14,12
Dpshealer,azralon,1206,priest,discipline,66,29,37
Overshields,caelestrasz,1206,priest,discipline,40,13,27
Svrite,area-52,1204,priest,discipline,29,15,14
Visse,auchindoun,1204,priest,discipline,435,209,226
Rowman,frostmourne,1204,priest,discipline,47,22,25
Libationz,area-52,1204,priest,discipline,108,49,59
Psychiatrist,darkspear,1204,priest,discipline,58,25,33
Ithvedriel,moon-guard,1203,priest,discipline,67,32,35
Vorazzun,quelthalas,1203,priest,discipline,32,14,18
Ðelight,ragnaros,1202,priest,discipline,42,18,24
Kyrabon,ragnaros,1201,priest,discipline,30,17,13
Wrathchildd,azralon,1201,priest,discipline,84,42,42
Testament,greymane,1201,priest,discipline,147,69,78
Castnngcouch,tichondrius,1201,priest,discipline,205,96,109
Healzyew,dragonmaw,1201,priest,discipline,73,28,45
Moralism,moon-guard,1199,priest,discipline,44,26,18
Zephxd,illidan,1199,priest,discipline,64,31,33
Terenor,thrall,1199,priest,discipline,42,13,29
Anakou,emerald-dream,1198,priest,discipline,29,17,12
Jtewatch,zuljin,1197,priest,discipline,30,23,7
Sasafras,feathermoon,1196,priest,discipline,78,39,39
Fozil,area-52,1194,priest,discipline,62,33,29
Ricksanchez,moonrunner,1193,priest,discipline,30,13,17
Bladam,bleeding-hollow,1192,priest,discipline,27,13,14
Mchinder,tanaris,1191,priest,discipline,55,32,23
Tomseleck,frostmourne,1191,priest,discipline,29,13,16
Healyoudead,draenor,1191,priest,discipline,41,15,26
Rachia,barthilas,1190,priest,discipline,72,43,29
Sanitater,frostmourne,1190,priest,discipline,102,47,55
Dzpi,azralon,1190,priest,discipline,96,43,53
Protega,illidan,1189,priest,discipline,22,14,8
Holyycrit,kelthuzad,1189,priest,discipline,30,16,14
Menorsita,tichondrius,1189,priest,discipline,120,57,63
Karamapang,illidan,1189,priest,discipline,58,23,35
Rinmaru,dark-iron,1188,priest,discipline,24,14,10
Iltharaph,illidan,1188,priest,discipline,25,14,11
Yukih,tichondrius,1188,priest,discipline,41,17,24
Inarius,dragonblight,1188,priest,discipline,42,17,25
Kruciphix,tichondrius,1187,priest,discipline,29,20,9
Kaxleigh,emerald-dream,1187,priest,discipline,29,18,11
Sëv,stormrage,1187,priest,discipline,29,14,15
Zawi,zuljin,1185,priest,discipline,37,16,21
Tesserak,tichondrius,1184,priest,discipline,105,49,56
Unwòke,dalaran,1182,priest,discipline,24,14,10
Happydot,stormrage,1182,priest,discipline,30,14,16
Belletrael,wyrmrest-accord,1182,priest,discipline,70,32,38
Kßnstuff,area-52,1182,priest,discipline,37,15,22
Yea,shadow-council,1181,priest,discipline,21,13,8
Ödin,tichondrius,1181,priest,discipline,46,24,22
Doubtmyfaith,frostmourne,1181,priest,discipline,42,21,21
Qbanota,drakkari,1181,priest,discipline,84,28,56
Nadjika,moon-guard,1180,priest,discipline,45,20,25
Omgpeeldude,akama,1179,priest,discipline,33,13,20
Icyspicy,shadowsong,1177,priest,discipline,59,26,33
Aerîs,magtheridon,1177,priest,discipline,40,16,24
Iwillsaveyou,tichondrius,1177,priest,discipline,40,16,24
Damoclexz,area-52,1176,priest,discipline,72,38,34
Dittless,stormrage,1176,priest,discipline,36,16,20
Jagelclam,gorefiend,1175,priest,discipline,47,22,25
Kethseth,ragnaros,1175,priest,discipline,102,45,57
Onef,quelthalas,1175,priest,discipline,35,15,20
Hiheals,anvilmar,1174,priest,discipline,36,20,16
Slewt,aggramar,1173,priest,discipline,24,13,11
Súlfuro,quelthalas,1173,priest,discipline,89,41,48
Mindlames,bleeding-hollow,1173,priest,discipline,68,30,38
Minimelo,stormrage,1172,priest,discipline,23,13,10
Spyzz,gilneas,1172,priest,discipline,36,18,18
Aliciab,andorhal,1172,priest,discipline,78,36,42
Psïcopata,gallywix,1171,priest,discipline,54,16,38
Kerazul,sargeras,1169,priest,discipline,42,20,22
Ttakayasu,bleeding-hollow,1165,priest,discipline,72,43,29
Abalowpt,nemesis,1163,priest,discipline,48,22,26
Kafzial,zuljin,1162,priest,discipline,74,43,31
Priést,stormrage,1162,priest,discipline,36,13,23
Radgars,frostmourne,1161,priest,discipline,31,17,14
Goodbyekiss,illidan,1161,priest,discipline,83,41,42
Heallarious,stormrage,1160,priest,discipline,52,30,22
Tetha,fizzcrank,1160,priest,discipline,42,20,22
Semirg,moon-guard,1158,priest,discipline,30,13,17
Velinna,tichondrius,1158,priest,discipline,42,16,26
Gobnik,illidan,1156,priest,discipline,24,16,8
Toastanator,wyrmrest-accord,1156,priest,discipline,220,115,105
Khallmir,goldrinn,1156,priest,discipline,36,15,21
Xaerwolaeth,area-52,1155,priest,discipline,34,16,18
Maraagsdad,tichondrius,1152,priest,discipline,18,12,6
Fishondabeat,proudmoore,1152,priest,discipline,24,12,12
Souvlaki,amanthul,1152,priest,discipline,24,12,12
Teddyy,tichondrius,1152,priest,discipline,24,12,12
Swagdemøn,kelthuzad,1152,priest,discipline,24,12,12
Kalyndaxo,frostmourne,1152,priest,discipline,24,12,12
Ømegagødx,illidan,1152,priest,discipline,30,12,18
Addisonraee,tichondrius,1151,priest,discipline,12,12,0
Smyted,tichondrius,1151,priest,discipline,18,12,6
Faithbuild,emerald-dream,1151,priest,discipline,18,12,6
Woolly,tichondrius,1151,priest,discipline,18,12,6
Eluv,area-52,1151,priest,discipline,36,20,16
Hyoeun,dragonmaw,1151,priest,discipline,24,12,12
Randrimm,stormrage,1151,priest,discipline,24,12,12
Kiriko,mannoroth,1151,priest,discipline,24,12,12
Sshhaaddooww,tichondrius,1151,priest,discipline,24,12,12
Pewwpew,malganis,1151,priest,discipline,24,12,12
Marmintor,stormrage,1151,priest,discipline,24,12,12
Kaztorz,tichondrius,1151,priest,discipline,28,12,16
Yaksa,proudmoore,1151,priest,discipline,36,12,24
Attenea,illidan,1151,priest,discipline,36,12,24
Ilmx,illidan,1150,priest,discipline,12,12,0
Meren,kelthuzad,1150,priest,discipline,18,12,6
Aaff,tichondrius,1150,priest,discipline,18,12,6
Chkashaa,emerald-dream,1150,priest,discipline,42,21,21
Rhaist,sargeras,1150,priest,discipline,36,18,18
Glöws,area-52,1150,priest,discipline,24,12,12
Wartrix,bonechewer,1150,priest,discipline,24,12,12
Ahealer,alterac-mountains,1150,priest,discipline,24,12,12
Papafajita,area-52,1150,priest,discipline,24,12,12
Icesnowli,tichondrius,1150,priest,discipline,24,12,12
Crunchywater,stormrage,1150,priest,discipline,24,12,12
Cenrtrix,stormrage,1150,priest,discipline,24,12,12
Abercromby,malganis,1150,priest,discipline,25,12,13
Penancedeez,moon-guard,1150,priest,discipline,35,15,20
Maxximuss,bleeding-hollow,1150,priest,discipline,42,17,25
Dayquills,illidan,1150,priest,discipline,30,12,18
Troubler,tichondrius,1149,priest,discipline,18,12,6
Profpepper,tichondrius,1149,priest,discipline,18,12,6
Audacy,azuremyst,1149,priest,discipline,33,19,14
Pakc,tichondrius,1149,priest,discipline,24,12,12
Shadowchaos,malganis,1149,priest,discipline,24,12,12
Nerfholyplz,illidan,1149,priest,discipline,24,12,12
Kitenix,proudmoore,1149,priest,discipline,35,14,21
Dènalí,area-52,1148,priest,discipline,24,12,12
Gigaflex,sargeras,1148,priest,discipline,24,12,12
Luminatio,quelthalas,1148,priest,discipline,76,36,40
Fìngerbanger,lightnings-blade,1148,priest,discipline,117,53,64
Cigarillõ,thrall,1147,priest,discipline,24,12,12
Papergaruru,illidan,1147,priest,discipline,55,25,30
Nutsin,tichondrius,1147,priest,discipline,30,12,18
Scrubgames,garrosh,1146,priest,discipline,12,12,0
Bakerstr,tichondrius,1146,priest,discipline,18,12,6
Pushap,blood-furnace,1146,priest,discipline,102,56,46
Mindkilla,area-52,1146,priest,discipline,184,95,89
Smightful,garona,1146,priest,discipline,24,12,12
Zyklonova,frostmourne,1146,priest,discipline,24,12,12
Beansofdean,proudmoore,1145,priest,discipline,24,12,12
Mashpotato,aerie-peak,1144,priest,discipline,24,13,11
Hoochiemomma,kelthuzad,1144,priest,discipline,24,13,11
Notskynet,tichondrius,1144,priest,discipline,24,12,12
Nardhead,sargeras,1143,priest,discipline,42,24,18
Depressedboy,wyrmrest-accord,1143,priest,discipline,24,12,12
Mutilla,tichondrius,1142,priest,discipline,18,12,6
Raivn,illidan,1142,priest,discipline,24,12,12
Ferilla,illidan,1142,priest,discipline,24,12,12
Supski,destromath,1141,priest,discipline,24,12,12
Vanhealsing,tichondrius,1141,priest,discipline,24,12,12
Voodooloa,tichondrius,1140,priest,discipline,30,12,18
Jeffo,baelgun,1139,priest,discipline,36,17,19
Osombra,azralon,1139,priest,discipline,36,17,19
Kippin,frostmourne,1138,priest,discipline,18,12,6
Draniev,azralon,1138,priest,discipline,83,44,39
Elvspriesly,doomhammer,1138,priest,discipline,104,51,53
Drywàter,tichondrius,1137,priest,discipline,81,45,36
Lynnar,stormrage,1137,priest,discipline,81,44,37
Feelmyheels,frostmourne,1137,priest,discipline,48,24,24
Hanuroa,tichondrius,1136,priest,discipline,184,92,92
Brotherheals,nagrand,1136,priest,discipline,66,33,33
Holyhog,whisperwind,1136,priest,discipline,51,23,28
Sprinkling,sargeras,1136,priest,discipline,34,15,19
Inot,nemesis,1136,priest,discipline,41,12,29
Blessings,aerie-peak,1135,priest,discipline,66,34,32
Calliah,moknathal,1134,priest,discipline,35,19,16
Senumbra,tichondrius,1134,priest,discipline,24,12,12
Saviorsélf,tichondrius,1133,priest,discipline,126,55,71
Ayakoji,proudmoore,1132,priest,discipline,30,12,18
Ihealyoudeal,korgath,1130,priest,discipline,18,12,6
Melithor,frostmourne,1130,priest,discipline,24,12,12
Charybdis,bonechewer,1129,priest,discipline,92,56,36
Makkima,area-52,1129,priest,discipline,48,20,28
Corthien,thrall,1129,priest,discipline,30,12,18
Kerahk,drakkari,1129,priest,discipline,32,12,20
Hëstia,darkspear,1128,priest,discipline,30,18,12
Mäy,greymane,1128,priest,discipline,30,12,18
Cyrilien,tichondrius,1127,priest,discipline,52,29,23
Ragnarøk,warsong,1127,priest,discipline,30,12,18
Killían,darkspear,1126,priest,discipline,61,31,30
Zolibeth,azshara,1124,priest,discipline,24,15,9
Weregonnadie,stormrage,1123,priest,discipline,24,12,12
Yddwin,quelthalas,1122,priest,discipline,30,16,14
Voidwyrm,tichondrius,1122,priest,discipline,96,50,46
Ðåmìéñ,tichondrius,1122,priest,discipline,24,12,12
Fulldesire,dalaran,1121,priest,discipline,63,38,25
Londog,vashj,1121,priest,discipline,78,36,42
Primeevil,black-dragonflight,1119,priest,discipline,24,14,10
Priestøuchme,tichondrius,1119,priest,discipline,23,13,10
Deehilie,illidan,1119,priest,discipline,49,25,24
Tkawesome,area-52,1119,priest,discipline,36,13,23
Xinnie,illidan,1117,priest,discipline,90,37,53
Barrysanders,zuljin,1115,priest,discipline,30,17,13
Abbot,zangarmarsh,1115,priest,discipline,149,70,79
Sinnskløft,tichondrius,1115,priest,discipline,31,13,18
Puralux,balnazzar,1114,priest,discipline,36,22,14
Vitalizes,nagrand,1114,priest,discipline,30,13,17
Sadury,tichondrius,1113,priest,discipline,135,76,59
Celf,ragnaros,1113,priest,discipline,30,12,18
Deadäss,sargeras,1113,priest,discipline,54,14,40
Sístermary,stormrage,1112,priest,discipline,24,16,8
Steezyy,black-dragonflight,1112,priest,discipline,71,33,38
Foxyy,wildhammer,1112,priest,discipline,35,14,21
Ghostchant,thrall,1111,priest,discipline,29,12,17
Steck,illidan,1110,priest,discipline,45,22,23
Chroly,stormrage,1110,priest,discipline,59,27,32
Bedläm,kilrogg,1110,priest,discipline,36,12,24
Skeepsi,area-52,1109,priest,discipline,48,27,21
Rhayzel,ragnaros,1108,priest,discipline,30,15,15
Fushia,emerald-dream,1107,priest,discipline,45,16,29
Optîmuskrayt,tichondrius,1106,priest,discipline,83,40,43
Tootsieroll,dark-iron,1106,priest,discipline,53,25,28
Opri,andorhal,1104,priest,discipline,48,20,28
Mosher,zuluhed,1103,priest,discipline,18,12,6
Ataraksija,sargeras,1103,priest,discipline,21,13,8
Kloudypriest,moon-guard,1103,priest,discipline,47,24,23
Averli,moon-guard,1103,priest,discipline,42,18,24
Lytherina,aegwynn,1101,priest,discipline,24,15,9
Gumiho,drakkari,1100,priest,discipline,25,12,13
Khamata,kelthuzad,1100,priest,discipline,30,12,18
Wheresmyvape,tichondrius,1098,priest,discipline,20,13,7
Vákc,quelthalas,1096,priest,discipline,23,12,11
Darkxrp,bleeding-hollow,1096,priest,discipline,30,13,17
Draiger,quelthalas,1096,priest,discipline,36,14,22
Fistavert,stormreaver,1095,priest,discipline,24,12,12
Mcdizzle,bloodscalp,1093,priest,discipline,90,41,49
Annaphilaxis,sargeras,1090,priest,discipline,38,18,20
Valonar,emerald-dream,1090,priest,discipline,29,13,16
Zacksnotcool,sargeras,1090,priest,discipline,33,13,20
Benmem,illidan,1089,priest,discipline,64,30,34
Thinmintt,wyrmrest-accord,1089,priest,discipline,108,47,61
Bigdaddyku,hyjal,1088,priest,discipline,34,20,14
Holysmokesx,tichondrius,1087,priest,discipline,22,12,10
Antiraus,aerie-peak,1086,priest,discipline,24,13,11
Alizeë,illidan,1086,priest,discipline,119,63,56
Fatherfilth,frostwolf,1086,priest,discipline,30,14,16
Solkadp,tichondrius,1085,priest,discipline,28,12,16
Quavö,tichondrius,1085,priest,discipline,68,29,39
Kidha,stormrage,1085,priest,discipline,60,19,41
Todrecas,ragnaros,1084,priest,discipline,24,13,11
Painpaws,moon-guard,1084,priest,discipline,28,12,16
Enkognito,tichondrius,1083,priest,discipline,34,23,11
Vaddaru,kirin-tor,1083,priest,discipline,66,38,28
Cypress,dreadmaul,1082,priest,discipline,140,70,70
Spellpower,azralon,1081,priest,discipline,29,13,16
Zatroux,ragnaros,1081,priest,discipline,36,13,23
Synes,bleeding-hollow,1080,priest,discipline,34,12,22
Tmpriest,tichondrius,1080,priest,discipline,48,12,36
Fregè,ysera,1078,priest,discipline,30,12,18
Novoc,blackhand,1076,priest,discipline,36,17,19
Redchord,kiljaeden,1072,priest,discipline,33,13,20
Psïren,quelthalas,1070,priest,discipline,24,13,11
Berzap,frostmourne,1068,priest,discipline,30,18,12
Tricklee,tichondrius,1068,priest,discipline,23,12,11
Zhaann,kelthuzad,1067,priest,discipline,30,14,16
Twinkmuncher,proudmoore,1065,priest,discipline,25,12,13
Anäster,ragnaros,1064,priest,discipline,53,26,27
Mtito,drakkari,1063,priest,discipline,25,13,12
Vahlen,azralon,1062,priest,discipline,23,12,11
Chickadies,barthilas,1059,priest,discipline,18,12,6
Undevout,tichondrius,1056,priest,discipline,18,11,7
Trustheals,tichondrius,1056,priest,discipline,60,32,28
Lespaula,ragnaros,1056,priest,discipline,24,12,12
Seleniax,sargeras,1056,priest,discipline,24,11,13
Mattgarska,tichondrius,1056,priest,discipline,30,11,19
Lilbabynaga,stormrage,1056,priest,discipline,75,27,48
Naelsaze,tichondrius,1055,priest,discipline,12,11,1
Crucifer,proudmoore,1055,priest,discipline,12,11,1
Piftw,illidan,1055,priest,discipline,18,11,7
Ròen,tichondrius,1055,priest,discipline,18,11,7
Chawp,kelthuzad,1055,priest,discipline,18,11,7
Vehex,malganis,1055,priest,discipline,18,11,7
Rúbybest,tichondrius,1055,priest,discipline,24,11,13
Okiin,malganis,1055,priest,discipline,24,11,13
Jonesypriest,tichondrius,1055,priest,discipline,24,11,13
Ffej,bleeding-hollow,1055,priest,discipline,24,11,13
Tooziq,stormrage,1055,priest,discipline,24,11,13
Wintrow,sargeras,1055,priest,discipline,30,11,19
Lampvpgerl,illidan,1055,priest,discipline,36,11,25
Turrec,illidan,1054,priest,discipline,12,11,1
Aiss,malganis,1054,priest,discipline,16,12,4
Anneyann,fenris,1054,priest,discipline,30,19,11
Missyoung,tichondrius,1054,priest,discipline,18,11,7
Honeyweiss,cairne,1054,priest,discipline,24,12,12
Sentactic,illidan,1054,priest,discipline,27,13,14
Dpsmercy,sargeras,1054,priest,discipline,24,11,13
Abbydaddy,illidan,1054,priest,discipline,30,11,19
Velzirya,zuljin,1054,priest,discipline,30,11,19
Doubt,eredar,1053,priest,discipline,18,11,7
Whitepigogo,tichondrius,1053,priest,discipline,18,11,7
Lavazzå,tichondrius,1053,priest,discipline,18,11,7
Ayezex,tichondrius,1053,priest,discipline,48,21,27
Rezy,darkspear,1053,priest,discipline,30,11,19
Slavoj,gurubashi,1052,priest,discipline,41,19,22
Howdaw,tichondrius,1052,priest,discipline,24,11,13
ßlackøut,sargeras,1052,priest,discipline,24,11,13
Buffhpriest,tichondrius,1052,priest,discipline,24,11,13
Xävier,farstriders,1052,priest,discipline,30,11,19
Kerith,ragnaros,1051,priest,discipline,34,24,10
Cella,frostmourne,1051,priest,discipline,18,11,7
Efrem,tichondrius,1051,priest,discipline,63,30,33
Darkills,tichondrius,1051,priest,discipline,24,11,13
Saviorr,dalaran,1051,priest,discipline,30,11,19
Lumia,quelthalas,1051,priest,discipline,30,11,19
Moopha,zuljin,1050,priest,discipline,12,11,1
Zarfel,ragnaros,1050,priest,discipline,18,11,7
Silnetlee,tichondrius,1050,priest,discipline,18,11,7
Healdog,thrall,1050,priest,discipline,18,11,7
Darkmoonsun,frostmourne,1050,priest,discipline,24,11,13
Lalight,tichondrius,1050,priest,discipline,30,11,19
Alyndral,illidan,1049,priest,discipline,20,11,9
Inmortar,dalaran,1049,priest,discipline,30,11,19
Sajahsa,moon-guard,1048,priest,discipline,25,15,10
Nooice,dalaran,1048,priest,discipline,24,11,13
Jackflashh,hakkar,1047,priest,discipline,78,35,43
Feff,shuhalo,1046,priest,discipline,30,11,19
Aud,kiljaeden,1045,priest,discipline,12,11,1
Chastised,moon-guard,1043,priest,discipline,354,165,189
Lilbabe,stormrage,1043,priest,discipline,24,11,13
Panelopie,maiev,1042,priest,discipline,18,11,7
Barrieroflig,tichondrius,1042,priest,discipline,27,13,14
Flexeggette,illidan,1042,priest,discipline,31,14,17
Dottinu,area-52,1040,priest,discipline,12,11,1
Notdavido,illidan,1040,priest,discipline,18,11,7
Deeznuhh,tichondrius,1039,priest,discipline,29,11,18
Sendia,hydraxis,1038,priest,discipline,66,31,35
Dalowks,area-52,1038,priest,discipline,30,11,19
Haidees,akama,1037,priest,discipline,28,16,12
Gungagingong,queldorei,1035,priest,discipline,18,11,7
Saviorkaï,barthilas,1035,priest,discipline,27,12,15
Gongá,moon-guard,1035,priest,discipline,108,43,65
Shinomiko,frostmourne,1035,priest,discipline,114,35,79
Classifiedcc,illidan,1034,priest,discipline,109,59,50
Uljinoo,blackwing-lair,1034,priest,discipline,44,19,25
Donoras,ursin,1033,priest,discipline,18,11,7
Uchihalol,tichondrius,1032,priest,discipline,24,11,13
Geulis,illidan,1030,priest,discipline,65,30,35
Discotecno,tichondrius,1030,priest,discipline,24,11,13
Erelim,durotan,1029,priest,discipline,89,36,53
Egraner,drakkari,1027,priest,discipline,24,11,13
Chêrubim,arthas,1025,priest,discipline,24,11,13
Ketone,malganis,1024,priest,discipline,113,57,56
Elomszz,tichondrius,1024,priest,discipline,22,11,11
Naxiest,stormrage,1024,priest,discipline,29,11,18
Bakharftw,nemesis,1023,priest,discipline,28,17,11
Taedrid,stormrage,1023,priest,discipline,71,28,43
Touchmylight,suramar,1022,priest,discipline,12,11,1
Stunsilence,malganis,1022,priest,discipline,20,12,8
Watdahealydo,darkspear,1021,priest,discipline,18,11,7
Mxd,bleeding-hollow,1021,priest,discipline,20,12,8
Mgfoxxie,scarlet-crusade,1020,priest,discipline,30,12,18
Thadan,uldaman,1019,priest,discipline,24,11,13
Sofluffy,burning-blade,1018,priest,discipline,23,11,12
Sév,frostmane,1017,priest,discipline,190,89,101
Nightmxres,zuljin,1016,priest,discipline,30,11,19
Jèf,stormrage,1015,priest,discipline,23,11,12
Shaydeep,nagrand,1015,priest,discipline,28,12,16
Leoi,fenris,1014,priest,discipline,39,23,16
Profît,stormrage,1014,priest,discipline,24,12,12
Sublety,aerie-peak,1011,priest,discipline,36,17,19
Jeanmarc,aerie-peak,1011,priest,discipline,42,17,25
Bubblebuster,lightbringer,1010,priest,discipline,43,19,24
Drãith,magtheridon,1009,priest,discipline,24,12,12
Dynopriest,kelthuzad,1007,priest,discipline,29,11,18
Lesserfaith,sargeras,1006,priest,discipline,21,11,10
Clergy,arthas,1005,priest,discipline,18,11,7
Ioudas,ragnaros,1004,priest,discipline,35,11,24
Lördgrim,stormrage,1002,priest,discipline,25,13,12
Tikel,ragnaros,1001,priest,discipline,21,11,10
Stinkyfingr,frostmourne,1000,priest,discipline,42,15,27
Sharayu,madoran,999,priest,discipline,42,22,20
Deusthanatos,medivh,998,priest,discipline,64,32,32
Linarelitha,area-52,997,priest,discipline,50,22,28
Bårriër,darkspear,996,priest,discipline,23,12,11
Mottsarella,mugthol,994,priest,discipline,78,42,36
Robertsmurda,emerald-dream,992,priest,discipline,22,11,11
Norastanne,moon-guard,992,priest,discipline,27,12,15
Cilpri,emerald-dream,991,priest,discipline,16,11,5
Thrudarkness,thrall,990,priest,discipline,21,12,9
Carbonated,zuljin,986,priest,discipline,17,11,6
Diamontie,tichondrius,977,priest,discipline,26,16,10
Alurand,bleeding-hollow,976,priest,discipline,18,11,7
Hèáls,tichondrius,975,priest,discipline,66,29,37
Exsufficate,frostmourne,974,priest,discipline,22,12,10
Sölemn,barthilas,971,priest,discipline,53,21,32
Mikkik,zuljin,970,priest,discipline,30,18,12
Prlest,proudmoore,970,priest,discipline,36,15,21
Throwinshadê,stormrage,967,priest,discipline,108,56,52
Sharkda,frostmourne,965,priest,discipline,45,24,21
Moomagic,sargeras,964,priest,discipline,54,24,30
Cravex,stormrage,963,priest,discipline,36,18,18
Åphrødite,bonechewer,961,priest,discipline,22,12,10
Åz,quelthalas,961,priest,discipline,24,12,12
Cezanne,tichondrius,961,priest,discipline,125,52,73
Swaggie,skullcrusher,960,priest,discipline,12,10,2
Odealp,stormscale,960,priest,discipline,12,10,2
Charón,tichondrius,960,priest,discipline,12,10,2
Mxchsm,stormrage,960,priest,discipline,12,10,2
Harlei,tichondrius,960,priest,discipline,18,11,7
Ishyeboi,stormrage,960,priest,discipline,18,10,8
Likehisname,tichondrius,960,priest,discipline,18,10,8
Ggwizkaboo,tichondrius,960,priest,discipline,18,10,8
Epicp,sargeras,960,priest,discipline,18,10,8
Testzpriests,dalaran,960,priest,discipline,18,10,8
Bswagxx,illidan,960,priest,discipline,18,10,8
Belielosong,moon-guard,960,priest,discipline,57,29,28
Metaverse,lightbringer,960,priest,discipline,21,10,11
Fyne,kelthuzad,960,priest,discipline,21,10,11
Ajxoz,thrall,960,priest,discipline,24,10,14
Nobodystarx,steamwheedle-cartel,960,priest,discipline,24,10,14
Futuuncle,tichondrius,960,priest,discipline,30,10,20
Henchwoman,stormrage,959,priest,discipline,12,10,2
Kk,fizzcrank,959,priest,discipline,12,10,2
Jinforever,tichondrius,959,priest,discipline,12,10,2
Elimix,frostmourne,959,priest,discipline,12,10,2
Stickypriest,dreadmaul,959,priest,discipline,12,10,2
Krupticus,tichondrius,959,priest,discipline,16,11,5
Cigma,magtheridon,959,priest,discipline,18,10,8
Hundski,darkspear,959,priest,discipline,18,10,8
Tamzy,eredar,959,priest,discipline,18,10,8
Pocket,alleria,959,priest,discipline,18,10,8
Gutrìck,tichondrius,959,priest,discipline,18,10,8
Budlyy,dalaran,959,priest,discipline,18,10,8
Discs,detheroc,959,priest,discipline,18,10,8
Csjy,illidan,959,priest,discipline,18,10,8
Gamepass,tichondrius,959,priest,discipline,18,10,8
Oduum,tichondrius,959,priest,discipline,18,10,8
Azrïel,mannoroth,959,priest,discipline,29,16,13
Johadorr,shadowsong,959,priest,discipline,24,10,14
Feivalentine,illidan,959,priest,discipline,24,10,14
Tshik,ragnaros,959,priest,discipline,24,10,14
Stylébender,tichondrius,959,priest,discipline,24,10,14
Mosquito,tichondrius,959,priest,discipline,24,10,14
Tamtwo,the-forgotten-coast,959,priest,discipline,24,10,14
Lindsanp,illidan,959,priest,discipline,24,10,14
Grimoz,illidan,959,priest,discipline,36,10,26
Rebzyyx,tichondrius,958,priest,discipline,12,10,2
Janna,jubeithos,958,priest,discipline,18,10,8
Bombdevil,quelthalas,958,priest,discipline,18,10,8
Plasmax,ragnaros,958,priest,discipline,18,10,8
Phrìke,illidan,958,priest,discipline,18,10,8
Compromise,the-scryers,958,priest,discipline,18,10,8
Glitterballs,khazgoroth,958,priest,discipline,18,10,8
Tîg,nemesis,958,priest,discipline,21,10,11
Rhennythal,tichondrius,958,priest,discipline,24,10,14
Whateverbrah,tichondrius,958,priest,discipline,27,11,16
Falsegodxd,tichondrius,958,priest,discipline,30,10,20
Senpriest,ragnaros,957,priest,discipline,18,10,8
Bigchalupaz,sargeras,957,priest,discipline,18,10,8
Bubblebeasst,area-52,957,priest,discipline,18,10,8
Akkassha,zuljin,957,priest,discipline,18,10,8
Wilburre,sargeras,957,priest,discipline,18,10,8
Rescueherø,tichondrius,957,priest,discipline,38,20,18
Rellington,frostwolf,957,priest,discipline,24,10,14
Chanyt,azralon,956,priest,discipline,12,10,2
Rigityrekt,aggramar,956,priest,discipline,18,13,5
Alphe,sargeras,956,priest,discipline,18,10,8
Kissmyvoìd,frostmourne,956,priest,discipline,24,10,14
Galaxypepe,medivh,955,priest,discipline,23,10,13
Çõrlëøñè,illidan,955,priest,discipline,24,10,14
Bachaterah,skullcrusher,955,priest,discipline,24,10,14
Kauldër,illidan,955,priest,discipline,32,12,20
Felmnir,ragnaros,955,priest,discipline,30,10,20
Fidalus,stormrage,955,priest,discipline,38,10,28
Zènó,bleeding-hollow,954,priest,discipline,18,10,8
Hanklin,lightnings-blade,954,priest,discipline,18,10,8
Judgejudyx,tichondrius,954,priest,discipline,24,10,14
Acésnóf,stormrage,954,priest,discipline,24,10,14
Chinsta,tichondrius,954,priest,discipline,24,10,14
Piskel,vashj,954,priest,discipline,30,10,20
Discjuice,tichondrius,954,priest,discipline,36,10,26
Kajagoogoö,emerald-dream,953,priest,discipline,18,10,8
Anthoras,stormrage,953,priest,discipline,18,10,8
Lusch,stormscale,953,priest,discipline,70,37,33
Spõt,stormrage,953,priest,discipline,24,10,14
Flagged,azgalor,953,priest,discipline,24,10,14
Xenonfaith,bleeding-hollow,952,priest,discipline,17,12,5
Stennic,emerald-dream,952,priest,discipline,18,10,8
Worthy,runetotem,952,priest,discipline,18,10,8
Unholyio,barthilas,952,priest,discipline,18,10,8
Jessicä,malganis,952,priest,discipline,18,10,8
Bellack,emerald-dream,952,priest,discipline,61,27,34
Xiöm,quelthalas,952,priest,discipline,24,10,14
Daijoubu,lightnings-blade,951,priest,discipline,24,10,14
Ppinmuhbutt,tichondrius,951,priest,discipline,36,10,26
Discbubbles,moonrunner,950,priest,discipline,18,10,8
Artmend,malganis,950,priest,discipline,24,10,14
Zeas,moon-guard,950,priest,discipline,66,23,43
Senliastra,medivh,949,priest,discipline,18,10,8
Threlad,elune,949,priest,discipline,18,10,8
Zhadowbolts,thrall,949,priest,discipline,18,10,8
Dreamskull,aegwynn,949,priest,discipline,26,11,15
Filterz,korgath,948,priest,discipline,24,10,14
Samsunglions,tichondrius,947,priest,discipline,18,10,8
Whitezz,frostmourne,945,priest,discipline,18,10,8
Tapel,khazgoroth,943,priest,discipline,24,13,11
Emmarîl,sargeras,943,priest,discipline,29,10,19
Praiz,tichondrius,942,priest,discipline,24,15,9
Discyple,ysera,941,priest,discipline,24,10,14
Icemeilarda,illidan,940,priest,discipline,81,32,49
Sisterdeáth,area-52,938,priest,discipline,24,11,13
Neehow,hyjal,936,priest,discipline,12,10,2
Boosserbro,dawnbringer,936,priest,discipline,42,21,21
Macoa,zuljin,936,priest,discipline,66,29,37
Miel,kargath,935,priest,discipline,60,22,38
Preezoo,tichondrius,932,priest,discipline,30,10,20
Alexz,area-52,927,priest,discipline,14,11,3
Toastedheal,stormreaver,927,priest,discipline,20,11,9
Biggunsaint,icecrown,927,priest,discipline,20,11,9
Unholydomina,zuljin,927,priest,discipline,60,28,32
Lawbster,jubeithos,926,priest,discipline,22,10,12
Fenders,stormrage,926,priest,discipline,23,10,13
Serana,maelstrom,924,priest,discipline,112,60,52
Voidwulf,azgalor,924,priest,discipline,107,52,55
Shemhazai,ragnaros,921,priest,discipline,20,11,9
Rymzxx,ragnaros,918,priest,discipline,19,11,8
Thekingheals,draenor,918,priest,discipline,28,14,14
Matafuka,ragnaros,913,priest,discipline,22,11,11
Twistedead,illidan,911,priest,discipline,21,11,10
Priestrix,frostmourne,910,priest,discipline,55,22,33
Holdentudikz,area-52,909,priest,discipline,23,10,13
Brock,lightbringer,905,priest,discipline,27,11,16
Poilu,laughing-skull,904,priest,discipline,19,12,7
Ðanté,the-venture-co,904,priest,discipline,22,13,9
Eluko,tichondrius,904,priest,discipline,21,11,10
Ohashi,ragnaros,902,priest,discipline,18,11,7
Knez,ragnaros,895,priest,discipline,19,11,8
Plaedito,stormscale,895,priest,discipline,23,10,13
Blakalicious,illidan,894,priest,discipline,21,12,9
Fujinpriest,azralon,894,priest,discipline,28,10,18
Aladdinlol,tichondrius,894,priest,discipline,34,10,24
Chapitä,drakkari,893,priest,discipline,16,10,6
Malhotra,amanthul,892,priest,discipline,21,12,9
Kaizzen,gorgonnash,891,priest,discipline,17,10,7
Tezcatyo,area-52,891,priest,discipline,17,10,7
Pegwraith,sargeras,890,priest,discipline,17,10,7
Lunett,area-52,887,priest,discipline,34,10,24
Partypack,stormrage,878,priest,discipline,19,11,8
Gdessairmed,exodar,871,priest,discipline,25,10,15
Wingchick,azshara,865,priest,discipline,48,20,28
Märzy,thrall,864,priest,discipline,12,9,3
Náñí,area-52,864,priest,discipline,12,9,3
Gillette,thunderlord,864,priest,discipline,12,9,3
Trinaty,senjin,864,priest,discipline,12,9,3
Squiddyjr,tichondrius,864,priest,discipline,12,9,3
Photic,malganis,864,priest,discipline,12,9,3
Marcalus,garrosh,864,priest,discipline,15,9,6
June,dragonmaw,864,priest,discipline,18,9,9
Toteme,proudmoore,864,priest,discipline,18,9,9
Drbønghitmd,tichondrius,864,priest,discipline,18,9,9
Makdaddy,skullcrusher,864,priest,discipline,18,9,9
Norikoo,malganis,864,priest,discipline,18,9,9
Cinnalite,darkspear,864,priest,discipline,18,9,9
Shadooe,tichondrius,864,priest,discipline,18,9,9
Omgnerfz,zuljin,864,priest,discipline,18,9,9
Healthyadult,zuluhed,864,priest,discipline,18,9,9
Wv,kelthuzad,864,priest,discipline,18,9,9
Zlowbly,ragnaros,864,priest,discipline,18,9,9
Gekko,azgalor,864,priest,discipline,18,9,9
Arcmage,malganis,864,priest,discipline,18,9,9
Kencyx,tichondrius,864,priest,discipline,18,9,9
Challengerz,suramar,864,priest,discipline,18,9,9
Ilovedailies,frostmourne,864,priest,discipline,18,9,9
Rima,stormscale,864,priest,discipline,18,9,9
Phurbosjr,sargeras,864,priest,discipline,18,9,9
Easywins,sargeras,864,priest,discipline,24,9,15
Skylark,bronzebeard,864,priest,discipline,24,9,15
Physics,frostmane,864,priest,discipline,24,9,15
Dasaq,sargeras,864,priest,discipline,24,9,15
Rafers,tichondrius,864,priest,discipline,24,9,15
Voidgames,area-52,864,priest,discipline,24,9,15
Ninbará,stormrage,864,priest,discipline,24,9,15
Marminator,stormrage,864,priest,discipline,24,9,15
Lostmind,malganis,864,priest,discipline,24,9,15
Dakp,sargeras,864,priest,discipline,24,9,15
Hairypenance,sargeras,864,priest,discipline,30,9,21
Djxkidrock,moon-guard,863,priest,discipline,12,9,3
Neuro,barthilas,863,priest,discipline,12,9,3
Helleamh,tichondrius,863,priest,discipline,12,9,3
Boycrazy,nerzhul,863,priest,discipline,12,9,3
Thirdplace,tichondrius,863,priest,discipline,12,9,3
Maleklek,azralon,863,priest,discipline,12,9,3
Tigop,alleria,863,priest,discipline,12,9,3
Stroserous,hyjal,863,priest,discipline,12,9,3
Softqt,tichondrius,863,priest,discipline,12,9,3
Lemmiewinkzx,sargeras,863,priest,discipline,18,9,9
Frotters,kiljaeden,863,priest,discipline,18,9,9
Fugazy,barthilas,863,priest,discipline,18,9,9
Oprst,tichondrius,863,priest,discipline,18,9,9
Tarlonypp,malganis,863,priest,discipline,18,9,9
Iamrisen,tichondrius,863,priest,discipline,18,9,9
Marshpillow,barthilas,863,priest,discipline,24,9,15
Mindblasterx,kelthuzad,863,priest,discipline,24,9,15
Mäe,nemesis,863,priest,discipline,24,9,15
Mudbuttman,kelthuzad,863,priest,discipline,24,9,15
Bubblerenew,altar-of-storms,863,priest,discipline,24,9,15
Bugshott,tichondrius,863,priest,discipline,31,9,22
Mothra,ragnaros,862,priest,discipline,12,9,3
Gäindalf,tichondrius,862,priest,discipline,16,10,6
Drerrdaytv,kelthuzad,862,priest,discipline,18,9,9
Lacerating,illidan,862,priest,discipline,18,9,9
Redclover,tichondrius,862,priest,discipline,18,9,9
Sumrand,frostmourne,862,priest,discipline,18,9,9
Tyrea,kiljaeden,862,priest,discipline,18,9,9
Ppomx,tichondrius,862,priest,discipline,18,9,9
Neuroflex,proudmoore,862,priest,discipline,18,9,9
Satanshealer,terokkar,862,priest,discipline,18,9,9
Releknosleep,frostwolf,862,priest,discipline,19,9,10
Heelznfeelz,tichondrius,862,priest,discipline,21,9,12
Padragon,tichondrius,862,priest,discipline,24,9,15
Zil,spinebreaker,861,priest,discipline,12,9,3
Cremexo,tichondrius,861,priest,discipline,16,9,7
Discountay,burning-legion,861,priest,discipline,18,9,9
Ohgiddy,dalaran,861,priest,discipline,24,9,15
Pahdre,tichondrius,860,priest,discipline,12,9,3
Stusy,tichondrius,860,priest,discipline,12,9,3
Jeraphìm,tichondrius,860,priest,discipline,18,9,9
Mawlaana,frostmourne,860,priest,discipline,18,9,9
Discalaneous,tichondrius,860,priest,discipline,27,9,18
Griggleslol,tichondrius,859,priest,discipline,12,9,3
Forestpriest,area-52,859,priest,discipline,18,9,9
Moresbo,frostmourne,859,priest,discipline,18,9,9
Notahero,tichondrius,858,priest,discipline,12,9,3
Preachermang,laughing-skull,858,priest,discipline,18,9,9
Divinity,hellscream,858,priest,discipline,24,9,15
Ricflayer,lothar,858,priest,discipline,24,9,15
Mando,area-52,857,priest,discipline,62,31,31
Rugaru,emerald-dream,857,priest,discipline,21,10,11
Sipmemaster,tichondrius,856,priest,discipline,24,9,15
Caiitlynn,quelthalas,856,priest,discipline,24,9,15
Anddori,moknathal,855,priest,discipline,18,9,9
Jebadiia,tichondrius,855,priest,discipline,31,12,19
Amäo,illidan,855,priest,discipline,24,9,15
Maiyennefer,proudmoore,855,priest,discipline,24,9,15
Igotdots,scilla,854,priest,discipline,42,18,24
Coachbombae,tichondrius,853,priest,discipline,12,9,3
Sunayriah,illidan,853,priest,discipline,12,9,3
Mangoes,scilla,853,priest,discipline,20,9,11
Zathanel,ragnaros,852,priest,discipline,24,9,15
Whitegirlirl,blackrock,850,priest,discipline,12,9,3
Brahskeet,illidan,841,priest,discipline,30,9,21
Kiilltic,sargeras,838,priest,discipline,30,9,21
Thelonioüs,tichondrius,832,priest,discipline,55,20,35
Rockrock,zuljin,831,priest,discipline,14,11,3
Swu,tichondrius,830,priest,discipline,26,10,16
Lîghtsaber,illidan,829,priest,discipline,26,9,17
Delithara,tichondrius,826,priest,discipline,18,9,9
Holyshield,jubeithos,825,priest,discipline,19,10,9
Naniwa,ragnaros,825,priest,discipline,27,10,17
Mydranol,tichondrius,824,priest,discipline,29,9,20
Khinthazin,barthilas,815,priest,discipline,48,20,28
Arizztocrat,tichondrius,814,priest,discipline,17,9,8
Såx,stormreaver,814,priest,discipline,21,9,12
Eblis,the-underbog,814,priest,discipline,21,9,12
Nuvea,tichondrius,814,priest,discipline,21,9,12
Ipód,tichondrius,813,priest,discipline,15,10,5
Shadowdeathx,bleeding-hollow,813,priest,discipline,17,9,8
Wodturbo,bleeding-hollow,809,priest,discipline,19,10,9
Arianthe,darrowmere,809,priest,discipline,20,10,10
Wellheeled,norgannon,806,priest,discipline,21,9,12
Nepy,stormrage,805,priest,discipline,22,10,12
Slaac,malfurion,799,priest,discipline,17,9,8
Goldenfatty,blackrock,798,priest,discipline,20,9,11
Ðrip,burning-legion,796,priest,discipline,16,9,7
Jessikal,quelthalas,784,priest,discipline,19,9,10
Winston,tichondrius,784,priest,discipline,19,9,10
Fátima,tichondrius,783,priest,discipline,11,9,2
Nvroom,illidan,783,priest,discipline,13,9,4
Aupascamarad,tichondrius,783,priest,discipline,17,9,8
Caz,sargeras,775,priest,discipline,24,12,12
Xzliak,area-52,768,priest,discipline,12,8,4
Müsic,stormrage,768,priest,discipline,12,8,4
Fathersean,sargeras,768,priest,discipline,12,8,4
Ñightelf,area-52,768,priest,discipline,12,8,4
Discipline,the-scryers,768,priest,discipline,12,8,4
Fzz,queldorei,768,priest,discipline,12,8,4
Rdson,malganis,768,priest,discipline,12,8,4
Zeepew,tichondrius,768,priest,discipline,12,8,4
Chocopp,illidan,768,priest,discipline,12,8,4
Yansuanmu,tichondrius,768,priest,discipline,12,8,4
Criiltwo,area-52,768,priest,discipline,12,8,4
Nydrosia,frostmourne,768,priest,discipline,12,8,4
Blesstwo,ragnaros,768,priest,discipline,12,8,4
Censyz,tichondrius,768,priest,discipline,12,8,4
Heeka,kelthuzad,768,priest,discipline,12,8,4
Dabû,tichondrius,768,priest,discipline,12,8,4
Qohoo,tichondrius,768,priest,discipline,12,8,4
Myòvó,tichondrius,768,priest,discipline,12,8,4
Evèlyn,dathremar,768,priest,discipline,12,8,4
Voltekkeh,tichondrius,768,priest,discipline,12,8,4
Spriestbro,emerald-dream,768,priest,discipline,12,8,4
Vonpaolo,emerald-dream,768,priest,discipline,12,8,4
Sìkarìa,illidan,768,priest,discipline,12,8,4
Slpox,sargeras,768,priest,discipline,12,8,4
Bananass,sargeras,768,priest,discipline,12,8,4
Zenelu,tichondrius,768,priest,discipline,12,8,4
Soloqqt,tichondrius,768,priest,discipline,12,8,4
Bubbliez,frostmourne,768,priest,discipline,12,8,4
Soupbean,zuljin,768,priest,discipline,12,8,4
Sontïx,sargeras,768,priest,discipline,18,8,10
Sussywussy,stormrage,768,priest,discipline,18,8,10
Smiliebomb,tichondrius,768,priest,discipline,18,8,10
Aikinorz,tichondrius,768,priest,discipline,18,8,10
Melielectra,tichondrius,768,priest,discipline,18,8,10
Yosps,tichondrius,768,priest,discipline,18,8,10
Robinophelia,sargeras,768,priest,discipline,18,8,10
Troja,malganis,768,priest,discipline,18,8,10
Alcoric,illidan,768,priest,discipline,18,8,10
Tooeasy,vashj,768,priest,discipline,18,8,10
Jodaa,sargeras,768,priest,discipline,18,8,10
Abbyy,barthilas,768,priest,discipline,18,8,10
Jangma,tichondrius,768,priest,discipline,18,8,10
Dehf,bleeding-hollow,768,priest,discipline,18,8,10
Jacqueline,tichondrius,768,priest,discipline,18,8,10
Sotore,bleeding-hollow,768,priest,discipline,18,8,10
Manbelow,bleeding-hollow,768,priest,discipline,27,9,18
Hugeshield,stormrage,768,priest,discipline,24,8,16
Voidrisu,sargeras,768,priest,discipline,24,8,16
Minyeong,tichondrius,768,priest,discipline,24,8,16
Mavalie,zuljin,768,priest,discipline,24,8,16
Avipriest,area-52,768,priest,discipline,24,8,16
Dylan,shuhalo,768,priest,discipline,24,8,16
Chinstrap,zuljin,767,priest,discipline,12,8,4
Powerranger,senjin,767,priest,discipline,12,8,4
Urgetopurge,dunemaul,767,priest,discipline,12,8,4
Daegal,malfurion,767,priest,discipline,12,8,4
Piusxll,tichondrius,767,priest,discipline,12,8,4
Rainny,proudmoore,767,priest,discipline,12,8,4
Kencyy,tichondrius,767,priest,discipline,12,8,4
Iulu,doomhammer,767,priest,discipline,12,8,4
Ryuuka,sargeras,767,priest,discipline,12,8,4
Gawlas,azshara,767,priest,discipline,12,8,4
Elkies,area-52,767,priest,discipline,12,8,4
Cassiuss,kelthuzad,767,priest,discipline,12,8,4
Lucènt,frostmourne,767,priest,discipline,12,8,4
Yotinha,nemesis,767,priest,discipline,12,8,4
Spicey,korgath,767,priest,discipline,12,8,4
Alarisa,chogall,767,priest,discipline,12,8,4
Lelyna,stormrage,767,priest,discipline,12,8,4
Mariels,quelthalas,767,priest,discipline,12,8,4
Shinemyhead,stormrage,767,priest,discipline,12,8,4
Kynsias,stormrage,767,priest,discipline,15,8,7
Morningzz,tichondrius,767,priest,discipline,18,8,10
Grotti,ragnaros,767,priest,discipline,18,8,10
Hesus,deathwing,767,priest,discipline,18,8,10
Brakála,ragnaros,767,priest,discipline,18,8,10
Analiesa,moon-guard,767,priest,discipline,18,8,10
Hellsembrace,lightbringer,767,priest,discipline,18,8,10
Suekmydisc,frostmourne,767,priest,discipline,18,8,10
Datspice,stormrage,767,priest,discipline,18,8,10
Phobe,windrunner,767,priest,discipline,18,8,10
Jùdas,ravencrest,767,priest,discipline,18,8,10
Holyslap,nerzhul,767,priest,discipline,18,8,10
Fatherdan,blackrock,767,priest,discipline,24,8,16
Èuneekz,thrall,767,priest,discipline,24,8,16
Providennce,tichondrius,767,priest,discipline,24,8,16
Dawnside,wyrmrest-accord,767,priest,discipline,24,8,16
Oniizanagi,thrall,767,priest,discipline,24,8,16
Hl,dalaran,767,priest,discipline,24,8,16
Showakoi,ragnaros,767,priest,discipline,28,9,19
Snoog,tichondrius,767,priest,discipline,30,8,22
Shirley,skywall,767,priest,discipline,30,8,22
Mineral,sargeras,766,priest,discipline,12,8,4
Claireredfld,lightbringer,766,priest,discipline,12,8,4
Payperbuff,tichondrius,766,priest,discipline,12,8,4
Juniorfloyd,tichondrius,766,priest,discipline,12,8,4
Abzorbed,stormrage,766,priest,discipline,12,8,4
Moonarie,draka,766,priest,discipline,12,8,4
Kynnen,mannoroth,766,priest,discipline,12,8,4
Grizzblessed,sargeras,766,priest,discipline,12,8,4
Dorós,coilfang,766,priest,discipline,12,8,4
Spitefuldirk,dalaran,766,priest,discipline,12,8,4
Jerserra,emerald-dream,766,priest,discipline,12,8,4
Xhaajyh,area-52,766,priest,discipline,12,8,4
Shaerel,dalaran,766,priest,discipline,18,8,10
Invisapowa,hyjal,766,priest,discipline,18,8,10
Spriest,kul-tiras,766,priest,discipline,18,8,10
Gõd,zuluhed,766,priest,discipline,18,8,10
Via,chogall,766,priest,discipline,18,8,10
Pollyphia,kiljaeden,765,priest,discipline,12,8,4
Bandaidvibes,tichondrius,765,priest,discipline,12,8,4
Lasslìn,bonechewer,765,priest,discipline,12,8,4
Fhelurian,quelthalas,765,priest,discipline,18,8,10
Sahray,quelthalas,765,priest,discipline,18,8,10
Aybaby,kiljaeden,765,priest,discipline,18,8,10
Darrong,darkspear,764,priest,discipline,18,8,10
Healrat,thrall,764,priest,discipline,18,8,10
Itchybubble,emerald-dream,763,priest,discipline,12,8,4
Taiji,whisperwind,763,priest,discipline,12,8,4
Breeannà,doomhammer,763,priest,discipline,16,9,7
Lätöxïkä,alleria,763,priest,discipline,17,8,9
Yusarin,garona,763,priest,discipline,18,8,10
Rókue,silvermoon,763,priest,discipline,18,8,10
Ashlìe,moon-guard,763,priest,discipline,18,8,10
Deadheadfred,bonechewer,763,priest,discipline,18,8,10
Squatrack,tichondrius,763,priest,discipline,24,8,16
Nuell,malganis,762,priest,discipline,12,8,4
Badazzfrank,tichondrius,762,priest,discipline,18,8,10
Yamahaz,lethon,762,priest,discipline,18,8,10
Sunael,quelthalas,760,priest,discipline,12,8,4
Fluxus,sargeras,760,priest,discipline,12,8,4
Oniyuri,dark-iron,760,priest,discipline,12,8,4
Runemidgard,illidan,760,priest,discipline,18,8,10
Cheuksin,korgath,759,priest,discipline,12,8,4
Mynigajeff,zuljin,757,priest,discipline,26,10,16
Kasamm,nazjatar,756,priest,discipline,18,8,10
Theleena,malorne,755,priest,discipline,24,8,16
Flannigan,veknilash,753,priest,discipline,12,8,4
Whitepi,tichondrius,751,priest,discipline,21,9,12
Peacebewithu,echo-isles,749,priest,discipline,12,8,4
Healloween,stormrage,749,priest,discipline,12,8,4
Jahsheer,kiljaeden,748,priest,discipline,14,10,4
Iseeyoulookn,stormrage,743,priest,discipline,23,10,13
Braxxten,tichondrius,741,priest,discipline,24,8,16
Valith,bleeding-hollow,735,priest,discipline,16,9,7
Pokebox,frostmourne,735,priest,discipline,16,8,8
Unholyshield,frostmourne,734,priest,discipline,17,8,9
Itssehctap,chogall,732,priest,discipline,14,9,5
Aloragon,tichondrius,732,priest,discipline,17,8,9
Pochis,bleeding-hollow,728,priest,discipline,20,9,11
Alterboy,garrosh,724,priest,discipline,18,8,10
Itxo,quelthalas,723,priest,discipline,16,9,7
Invoice,bloodscalp,719,priest,discipline,17,8,9
Pðpë,area-52,718,priest,discipline,11,8,3
Clarity,arthas,718,priest,discipline,15,9,6
Inmøthep,ragnaros,713,priest,discipline,22,9,13
Nås,elune,711,priest,discipline,22,10,12
Trashdiscx,stormrage,707,priest,discipline,25,11,14
Aenbubble,tichondrius,703,priest,discipline,14,8,6
Lilflexi,lightbringer,703,priest,discipline,16,8,8
Mutedox,frostmourne,703,priest,discipline,17,8,9
Styléßéndérx,illidan,687,priest,discipline,11,8,3
Läsombra,area-52,684,priest,discipline,17,9,8
Termiina,hyjal,684,priest,discipline,25,8,17
Eneldz,quelthalas,672,priest,discipline,12,7,5
Giomoreno,tichondrius,672,priest,discipline,12,7,5
Kiloe,tichondrius,672,priest,discipline,12,7,5
Carboload,thrall,672,priest,discipline,12,7,5
Skcits,sargeras,672,priest,discipline,12,7,5
Xsy,stormrage,672,priest,discipline,12,7,5
Dances,emerald-dream,672,priest,discipline,12,7,5
Sùlyvahñ,tichondrius,672,priest,discipline,12,7,5
Thewaker,tichondrius,672,priest,discipline,12,7,5
Priesticules,illidan,672,priest,discipline,12,7,5
Jnglpriestx,thrall,672,priest,discipline,12,7,5
Marejayne,tichondrius,672,priest,discipline,12,7,5
Niik,tichondrius,672,priest,discipline,12,7,5
Omsi,emerald-dream,672,priest,discipline,12,7,5
Afflickzz,kelthuzad,672,priest,discipline,12,7,5
Secondes,azralon,672,priest,discipline,12,7,5
Yodud,tichondrius,672,priest,discipline,12,7,5
Littlehcl,tichondrius,672,priest,discipline,12,7,5
Healaryduff,skullcrusher,672,priest,discipline,12,7,5
Kencys,tichondrius,672,priest,discipline,12,7,5
Holyhand,auchindoun,672,priest,discipline,12,7,5
Vaticly,hyjal,672,priest,discipline,12,7,5
Aethestan,zuljin,672,priest,discipline,12,7,5
Carlita,ravenholdt,672,priest,discipline,12,7,5
Fäÿë,tichondrius,672,priest,discipline,12,7,5
Dráugr,ragnaros,672,priest,discipline,12,7,5
Deagled,tichondrius,672,priest,discipline,12,7,5
Anmu,illidan,672,priest,discipline,12,7,5
Sadsadge,sargeras,672,priest,discipline,12,7,5
Pavesarii,proudmoore,672,priest,discipline,12,7,5
Fialiadia,illidan,672,priest,discipline,12,7,5
Aeyde,proudmoore,672,priest,discipline,12,7,5
Greyx,moon-guard,672,priest,discipline,12,7,5
Bigolbush,moon-guard,672,priest,discipline,12,7,5
Whataday,tichondrius,672,priest,discipline,12,7,5
Tslacalls,malganis,672,priest,discipline,12,7,5
Wâtermelon,stormrage,672,priest,discipline,12,7,5
Washdp,frostmourne,672,priest,discipline,12,7,5
Scandi,tichondrius,672,priest,discipline,12,7,5
Meemó,area-52,672,priest,discipline,12,7,5
Holyshiiet,area-52,672,priest,discipline,12,7,5
Dirtydebbie,lightnings-blade,672,priest,discipline,12,7,5
Nerfdisc,elune,672,priest,discipline,12,7,5
Brehzy,zuljin,672,priest,discipline,12,7,5
Tòodles,stormrage,672,priest,discipline,12,7,5
Jenhawkinsx,frostmourne,672,priest,discipline,12,7,5
Artirie,darkspear,672,priest,discipline,12,7,5
Kymomeh,sargeras,672,priest,discipline,12,7,5
Taboogie,tichondrius,672,priest,discipline,12,7,5
Dudebanger,sargeras,672,priest,discipline,12,7,5
Vels,blackrock,672,priest,discipline,12,7,5
Walpurgis,skywall,672,priest,discipline,12,7,5
Clevelandboy,blackrock,672,priest,discipline,12,7,5
Interacts,darkspear,672,priest,discipline,12,7,5
Natahlia,area-52,672,priest,discipline,12,7,5
Celerisp,malganis,672,priest,discipline,12,7,5
Sentenel,duskwood,672,priest,discipline,12,7,5
Absorbn,barthilas,672,priest,discipline,12,7,5
Chknhealer,darkspear,672,priest,discipline,12,7,5
Ninielly,stormrage,672,priest,discipline,14,8,6
Siddhar,illidan,672,priest,discipline,13,7,6
Photicz,thrall,672,priest,discipline,17,8,9
Lidole,barthilas,672,priest,discipline,18,7,11
Tubrisildris,zuljin,672,priest,discipline,18,7,11
Tyzrapture,illidan,672,priest,discipline,18,7,11
Dxs,hydraxis,672,priest,discipline,18,7,11
Aryeinna,illidan,672,priest,discipline,18,7,11
Dingledot,sargeras,672,priest,discipline,18,7,11
Rigotakx,illidan,672,priest,discipline,18,7,11
Criminalsp,frostmourne,672,priest,discipline,18,7,11
Someonesxy,aggramar,672,priest,discipline,18,7,11
Burkett,sargeras,672,priest,discipline,18,7,11
Jagsp,area-52,672,priest,discipline,18,7,11
Manbooty,illidan,672,priest,discipline,18,7,11
Iwillrezguys,tichondrius,672,priest,discipline,18,7,11
Xayda,area-52,672,priest,discipline,18,7,11
Joeybats,frostwolf,672,priest,discipline,18,7,11
Döyöuliftbro,tichondrius,672,priest,discipline,18,7,11
Jugeum,proudmoore,672,priest,discipline,18,7,11
Løøtgoblin,skullcrusher,672,priest,discipline,18,7,11
Xalty,emerald-dream,672,priest,discipline,21,8,13
Diebetus,zuljin,672,priest,discipline,24,7,17
Gonchar,bleeding-hollow,672,priest,discipline,24,7,17
Remusha,dalaran,672,priest,discipline,24,7,17
Stríkes,emerald-dream,672,priest,discipline,24,7,17
Babymieo,illidan,672,priest,discipline,24,7,17
Polyesterp,frostmourne,672,priest,discipline,24,7,17
Pïque,proudmoore,672,priest,discipline,24,7,17
Zortroz,tichondrius,671,priest,discipline,10,8,2
Thalladori,area-52,671,priest,discipline,16,10,6
Skgangmm,tichondrius,671,priest,discipline,12,7,5
Debigheal,stormrage,671,priest,discipline,12,7,5
Popeofdope,queldorei,671,priest,discipline,12,7,5
Bombinburbon,durotan,671,priest,discipline,12,7,5
Fatherleem,tichondrius,671,priest,discipline,12,7,5
Demonwizard,sargeras,671,priest,discipline,12,7,5
Kaldric,korgath,671,priest,discipline,12,7,5
Clerkbum,emerald-dream,671,priest,discipline,12,7,5
Tassadaraiur,tichondrius,671,priest,discipline,12,7,5
Mahelet,drakkari,671,priest,discipline,12,7,5
Fatherjerry,kiljaeden,671,priest,discipline,12,7,5
Jeremey,darkspear,671,priest,discipline,12,7,5
Danílo,quelthalas,671,priest,discipline,12,7,5
Linlight,stormrage,671,priest,discipline,12,7,5
Saphet,draktharon,671,priest,discipline,12,7,5
Lightschosen,malganis,671,priest,discipline,12,7,5
Maenard,emerald-dream,671,priest,discipline,12,7,5
Travakel,proudmoore,671,priest,discipline,12,7,5
Dreaminz,tichondrius,671,priest,discipline,12,7,5
Esohpr,frostmourne,671,priest,discipline,12,7,5
Beocca,nerzhul,671,priest,discipline,12,7,5
Lumyra,malganis,671,priest,discipline,12,7,5
Zarfs,burning-blade,671,priest,discipline,12,7,5
Trinidy,illidan,671,priest,discipline,12,7,5
Epik,moknathal,671,priest,discipline,15,8,7
Steefe,arygos,671,priest,discipline,18,7,11
Hopanda,tichondrius,671,priest,discipline,18,7,11
Vania,tortheldrin,671,priest,discipline,18,7,11
Healznfeel,tichondrius,671,priest,discipline,18,7,11
Ganelm,vashj,671,priest,discipline,18,7,11
Mottomami,nemesis,671,priest,discipline,18,7,11
Randomheal,dunemaul,671,priest,discipline,18,7,11
Adofthealer,illidan,671,priest,discipline,18,7,11
Canharm,tichondrius,671,priest,discipline,18,7,11
Caeda,icecrown,671,priest,discipline,24,7,17
Malansuo,wyrmrest-accord,671,priest,discipline,30,7,23
Crackneesha,tichondrius,670,priest,discipline,12,7,5
Antìdote,tichondrius,670,priest,discipline,12,7,5
Susannahh,goldrinn,670,priest,discipline,12,7,5
Madskills,shadow-council,670,priest,discipline,12,7,5
Xð,jubeithos,670,priest,discipline,12,7,5
Lavvari,durotan,670,priest,discipline,12,7,5
Mortïmer,alleria,670,priest,discipline,12,7,5
Angelicduck,illidan,670,priest,discipline,12,7,5
Mitras,moon-guard,670,priest,discipline,12,7,5
Fatherhands,illidan,670,priest,discipline,12,7,5
Cromagnøn,dalaran,670,priest,discipline,12,7,5
Kastwalker,earthen-ring,670,priest,discipline,12,7,5
Hypnogypsy,malganis,670,priest,discipline,12,7,5
Donus,frostmane,670,priest,discipline,12,7,5
Jivita,lightbringer,670,priest,discipline,12,7,5
Spiceenjoyer,emerald-dream,670,priest,discipline,15,8,7
Xeras,ravencrest,670,priest,discipline,18,7,11
Râku,area-52,670,priest,discipline,18,7,11
Zgzz,stormrage,670,priest,discipline,24,7,17
Kerfos,azralon,669,priest,discipline,10,8,2
Dorst,bonechewer,669,priest,discipline,18,7,11
Gabryanna,emerald-dream,669,priest,discipline,18,7,11
Boojanglez,exodar,669,priest,discipline,18,7,11
Evelien,kiljaeden,669,priest,discipline,24,7,17
Jikoguu,stormscale,669,priest,discipline,24,7,17
Nielic,arygos,668,priest,discipline,12,7,5
Bubbleyo,shandris,668,priest,discipline,12,7,5
Meddyglyn,area-52,668,priest,discipline,12,7,5
Butterflyblu,ragnaros,668,priest,discipline,13,7,6
Albertth,ragnaros,668,priest,discipline,18,7,11
Butterblessr,thunderlord,668,priest,discipline,19,7,12
Tassik,dalaran,667,priest,discipline,18,7,11
Mortecraft,sargeras,666,priest,discipline,12,7,5
Glisserin,zuljin,666,priest,discipline,12,7,5
Tenet,stormscale,666,priest,discipline,18,7,11
Grapedraankk,kelthuzad,664,priest,discipline,12,7,5
Crossblesser,alleria,663,priest,discipline,12,7,5
Nikkazul,drakkari,659,priest,discipline,24,11,13
Terric,shattered-hand,658,priest,discipline,18,7,11
Neutrino,quelthalas,655,priest,discipline,17,7,10
Megz,zuljin,655,priest,discipline,17,7,10
Rcx,sargeras,655,priest,discipline,17,7,10
Sezyks,stormrage,655,priest,discipline,17,7,10
Plasticbag,frostmourne,654,priest,discipline,17,7,10
Oneinurdome,moknathal,648,priest,discipline,31,10,21
Ibangedaqt,malganis,647,priest,discipline,26,11,15
Youngboys,stormreaver,642,priest,discipline,36,18,18
Pridesp,tichondrius,639,priest,discipline,14,8,6
Gankchange,tichondrius,639,priest,discipline,14,8,6
Lalo,bleeding-hollow,638,priest,discipline,23,7,16
Rôxxy,thrall,636,priest,discipline,16,8,8
Futatsi,zuljin,634,priest,discipline,23,7,16
Swagacious,malganis,624,priest,discipline,13,8,5
Xhadow,sargeras,624,priest,discipline,15,8,7
Holysmegma,dreadmaul,623,priest,discipline,11,7,4
Ezpríest,kelthuzad,623,priest,discipline,11,7,4
Archcerion,stormreaver,621,priest,discipline,15,8,7
Mylkshakez,emerald-dream,621,priest,discipline,19,8,11
Càipirinha,tichondrius,608,priest,discipline,10,7,3
Elevatez,stormrage,608,priest,discipline,10,7,3
Meatguzzler,tichondrius,607,priest,discipline,11,7,4
Åffliction,sargeras,607,priest,discipline,11,7,4
Tigrania,proudmoore,607,priest,discipline,11,7,4
Coolzo,dethecus,607,priest,discipline,14,8,6
Jimyo,tichondrius,607,priest,discipline,15,7,8
Codiroli,tichondrius,606,priest,discipline,14,7,7
Forprophet,proudmoore,606,priest,discipline,22,7,15
Athzziry,ragnaros,599,priest,discipline,21,7,14
Hpalisdawg,malorne,592,priest,discipline,13,7,6
Blacklog,darkspear,592,priest,discipline,19,7,12
Syndrox,kelthuzad,576,priest,discipline,6,6,0
Porffy,malygos,576,priest,discipline,6,6,0
Pearl,chogall,576,priest,discipline,6,6,0
Càptain,moon-guard,576,priest,discipline,6,6,0
Eldoras,zuljin,576,priest,discipline,6,6,0
Healia,tichondrius,576,priest,discipline,6,6,0
Wizeau,dalaran,576,priest,discipline,6,6,0
Jerome,tichondrius,576,priest,discipline,6,6,0
Illmatíc,malganis,576,priest,discipline,6,6,0
Thirddps,illidan,576,priest,discipline,6,6,0
Delai,dalaran,576,priest,discipline,6,6,0
Yannigirl,area-52,576,priest,discipline,12,6,6
Bumps,zuljin,576,priest,discipline,12,6,6
Frankoizz,quelthalas,576,priest,discipline,12,6,6
Saelomism,frostmourne,576,priest,discipline,12,6,6
Ilovemia,zuljin,576,priest,discipline,12,6,6
Imfresh,illidan,576,priest,discipline,12,6,6
Dimebahg,mugthol,576,priest,discipline,12,6,6
Prostrat,deathwing,576,priest,discipline,12,6,6
Punchyxz,illidan,576,priest,discipline,12,6,6
Johnnysyns,frostmourne,576,priest,discipline,12,6,6
Chaotikx,kelthuzad,576,priest,discipline,12,6,6
Celypriest,moon-guard,576,priest,discipline,12,6,6
Scripture,stormreaver,576,priest,discipline,12,6,6
Bigsàd,proudmoore,576,priest,discipline,12,6,6
Shoepooper,kelthuzad,576,priest,discipline,12,6,6
Jackski,aerie-peak,576,priest,discipline,12,6,6
Skiza,stormrage,576,priest,discipline,12,6,6
Raichu,blackrock,576,priest,discipline,12,6,6
Nokzo,dalaran,576,priest,discipline,12,6,6
Syncope,garona,576,priest,discipline,12,6,6
Jakemies,arathor,576,priest,discipline,12,6,6
Degenerates,blood-furnace,576,priest,discipline,12,6,6
Fatherjohnny,azuremyst,576,priest,discipline,12,6,6
Keldrii,sentinels,576,priest,discipline,12,6,6
Nelfpriest,khadgar,576,priest,discipline,12,6,6
Napr,proudmoore,576,priest,discipline,12,6,6
Stankychimpo,malganis,576,priest,discipline,12,6,6
Metius,smolderthorn,576,priest,discipline,12,6,6
Lightsight,burning-blade,576,priest,discipline,12,6,6
Redkiwi,illidan,576,priest,discipline,12,6,6
Owlchubz,mannoroth,576,priest,discipline,12,6,6
Elfgasmic,blackwater-raiders,576,priest,discipline,12,6,6
Decades,moon-guard,576,priest,discipline,12,6,6
Joanoarc,destromath,576,priest,discipline,12,6,6
Hereges,azralon,576,priest,discipline,12,6,6
Treri,bleeding-hollow,576,priest,discipline,12,6,6
Shwayp,zuljin,576,priest,discipline,12,6,6
Pennumbra,barthilas,576,priest,discipline,12,6,6
Jopocket,bleeding-hollow,576,priest,discipline,12,6,6
Photicz,malganis,576,priest,discipline,12,6,6
Flarkyllama,area-52,576,priest,discipline,12,6,6
Datwunguy,sargeras,576,priest,discipline,12,6,6
Tcfx,bleeding-hollow,576,priest,discipline,12,6,6
Thelastfight,frostmourne,576,priest,discipline,12,6,6
Neep,turalyon,576,priest,discipline,12,6,6
Meshuggah,archimonde,576,priest,discipline,12,6,6
Moselol,tichondrius,576,priest,discipline,12,6,6
Kzo,gnomeregan,576,priest,discipline,12,6,6
Tranquilty,tichondrius,576,priest,discipline,12,6,6
Kawasakix,tichondrius,576,priest,discipline,12,6,6
Rin,ghostlands,576,priest,discipline,12,6,6
Ifortalot,lothar,576,priest,discipline,12,6,6
Moqoro,azralon,576,priest,discipline,12,6,6
Chicoryx,illidan,576,priest,discipline,12,6,6
Bloodfaith,stormrage,576,priest,discipline,12,6,6
Bernietopper,tichondrius,576,priest,discipline,12,6,6
Slobmygnob,illidan,576,priest,discipline,12,6,6
Irar,tichondrius,576,priest,discipline,12,6,6
Saintjpii,tichondrius,576,priest,discipline,12,6,6
Jpgpng,tichondrius,576,priest,discipline,12,6,6
Nethir,moon-guard,576,priest,discipline,12,6,6
Azurestorm,tichondrius,576,priest,discipline,12,6,6
Darkinfusion,illidan,576,priest,discipline,12,6,6
Ruinr,illidan,576,priest,discipline,12,6,6
Panikâ,thrall,576,priest,discipline,12,6,6
Brahp,frostmourne,576,priest,discipline,12,6,6
Bohomag,tichondrius,576,priest,discipline,12,6,6
Inukimi,sargeras,576,priest,discipline,12,6,6
Ariste,tichondrius,576,priest,discipline,12,6,6
Wodpriestx,stormrage,576,priest,discipline,12,6,6
Nineoneoneh,stormrage,576,priest,discipline,12,6,6
Padrë,tichondrius,576,priest,discipline,12,6,6
Wøah,stormrage,576,priest,discipline,12,6,6
Guccísandals,emerald-dream,576,priest,discipline,12,6,6
Seléne,tichondrius,576,priest,discipline,12,6,6
Boppdot,tichondrius,576,priest,discipline,12,6,6
Purpskurp,stormrage,576,priest,discipline,12,6,6
Cency,tichondrius,576,priest,discipline,12,6,6
Randyortonn,tichondrius,576,priest,discipline,12,6,6
Instaboned,sargeras,576,priest,discipline,12,6,6
Johnio,tichondrius,576,priest,discipline,12,6,6
Obstetrician,tichondrius,576,priest,discipline,12,6,6
Wabie,illidan,576,priest,discipline,12,6,6
Xiaochenchen,tichondrius,576,priest,discipline,12,6,6
Mediterranee,tichondrius,576,priest,discipline,12,6,6
Ahnassi,stormrage,576,priest,discipline,12,6,6
Lisau,tichondrius,576,priest,discipline,12,6,6
Kiddonia,whisperwind,576,priest,discipline,15,7,8
Bigfirebet,tichondrius,576,priest,discipline,15,7,8
Preyforme,tichondrius,576,priest,discipline,13,6,7
Peaky,moonrunner,576,priest,discipline,18,6,12
Çørrúptíøñz,tichondrius,576,priest,discipline,18,6,12
Jazmiine,ragnaros,576,priest,discipline,18,6,12
Scpzi,frostmourne,576,priest,discipline,18,6,12
Keepsleepin,stormrage,576,priest,discipline,18,6,12
Repriest,malganis,576,priest,discipline,18,6,12
Sandelios,aggramar,576,priest,discipline,18,6,12
Synaptikk,proudmoore,576,priest,discipline,18,6,12
Plztrainme,spinebreaker,576,priest,discipline,18,6,12
Giannis,garrosh,576,priest,discipline,18,6,12
Dgpriest,tichondrius,576,priest,discipline,18,6,12
Ershackleton,illidan,576,priest,discipline,18,6,12
Ancilx,area-52,576,priest,discipline,18,6,12
Lildes,tichondrius,576,priest,discipline,18,6,12
Komicks,tichondrius,576,priest,discipline,18,6,12
Shadlo,chogall,576,priest,discipline,18,6,12
Jiedx,tichondrius,576,priest,discipline,18,6,12
Fadedhalo,magtheridon,576,priest,discipline,18,6,12
Asmødeus,bleeding-hollow,576,priest,discipline,18,6,12
Starp,tichondrius,576,priest,discipline,18,6,12
Slthrysnake,area-52,576,priest,discipline,18,6,12
Fartnutts,dalaran,576,priest,discipline,18,6,12
Priestmass,dalaran,576,priest,discipline,18,6,12
Jarzo,thunderhorn,576,priest,discipline,18,6,12
Dots,tichondrius,576,priest,discipline,18,6,12
Vicara,moon-guard,576,priest,discipline,18,6,12
Junethegreat,tichondrius,576,priest,discipline,18,6,12
Oymay,illidan,576,priest,discipline,18,6,12
Mylà,ragnaros,576,priest,discipline,20,6,14
Cûrry,bleeding-hollow,576,priest,discipline,24,6,18
Drupith,dalaran,576,priest,discipline,24,6,18
Felixfire,moon-guard,576,priest,discipline,24,6,18
Nachòs,wildhammer,575,priest,discipline,6,6,0
Kephrek,eonar,575,priest,discipline,6,6,0
Astrìx,tichondrius,575,priest,discipline,6,6,0
Galastine,emerald-dream,575,priest,discipline,12,6,6
Lúçíd,sargeras,575,priest,discipline,12,6,6
Aanora,illidan,575,priest,discipline,12,6,6
Demimo,frostwolf,575,priest,discipline,12,6,6
Silveri,thrall,575,priest,discipline,12,6,6
Pulso,area-52,575,priest,discipline,12,6,6
Imhotap,illidan,575,priest,discipline,12,6,6
Pinaybebe,kiljaeden,575,priest,discipline,12,6,6
Moarhaste,kelthuzad,575,priest,discipline,12,6,6
Exanthrope,stormrage,575,priest,discipline,12,6,6
Nineoneone,kilrogg,575,priest,discipline,12,6,6
Chloangel,frostmourne,575,priest,discipline,12,6,6
What,moon-guard,575,priest,discipline,12,6,6
Mcfluffin,aggramar,575,priest,discipline,12,6,6
Gdrf,sargeras,575,priest,discipline,12,6,6
Wickedmoon,emerald-dream,575,priest,discipline,12,6,6
Gudnewsevone,illidan,575,priest,discipline,12,6,6
Sinzex,tichondrius,575,priest,discipline,12,6,6
Uncensøred,tichondrius,575,priest,discipline,12,6,6
Lobstersock,malganis,575,priest,discipline,12,6,6
Nevertelsp,malganis,575,priest,discipline,12,6,6
Mpshield,kiljaeden,575,priest,discipline,12,6,6
Brahmin,nazjatar,575,priest,discipline,12,6,6
Kreon,tichondrius,575,priest,discipline,12,6,6
Khaibit,stormrage,575,priest,discipline,12,6,6
Actiop,stormrage,575,priest,discipline,12,6,6
Forroc,stormrage,575,priest,discipline,12,6,6
Herzattacken,malganis,575,priest,discipline,12,6,6
Nejisaiyan,sargeras,575,priest,discipline,12,6,6
Swaptohealer,misha,575,priest,discipline,12,6,6
Peeinbottles,stormrage,575,priest,discipline,16,7,9
Biltpeter,tichondrius,575,priest,discipline,15,6,9
Runecarver,anvilmar,575,priest,discipline,18,6,12
Prelate,moon-guard,575,priest,discipline,18,6,12
Flexxwzkaboo,thrall,575,priest,discipline,18,6,12
Villageidiot,lightbringer,575,priest,discipline,18,6,12
Voidmaker,area-52,575,priest,discipline,18,6,12
Mortaroth,doomhammer,575,priest,discipline,18,6,12
Xyberius,barthilas,575,priest,discipline,18,6,12
Baldpate,tichondrius,575,priest,discipline,24,6,18
Mikol,eredar,574,priest,discipline,12,6,6
Mezervescent,thrall,574,priest,discipline,24,6,18
Papadarkness,tichondrius,574,priest,discipline,24,6,18
Ságrádá,area-52,573,priest,discipline,12,6,6
Reilean,sargeras,573,priest,discipline,12,6,6
Prebruisz,baelgun,573,priest,discipline,12,6,6
Pharaoh,deathwing,573,priest,discipline,12,6,6
Lookfig,frostmourne,573,priest,discipline,18,6,12
Bigchip,sargeras,573,priest,discipline,24,6,18
Aragingclue,burning-legion,572,priest,discipline,12,6,6
Dirtyone,dark-iron,572,priest,discipline,18,6,12
Marpi,quelthalas,572,priest,discipline,24,6,18
Voidlordd,kelthuzad,571,priest,discipline,12,6,6
Grandraf,dreadmaul,570,priest,discipline,12,6,6
Thøt,malganis,570,priest,discipline,12,6,6
Jaster,proudmoore,570,priest,discipline,14,6,8
Antipreist,bonechewer,567,priest,discipline,12,6,6
Crossbones,cenarion-circle,566,priest,discipline,12,6,6
Zerolyn,tichondrius,559,priest,discipline,17,6,11
Justfaith,barthilas,558,priest,discipline,17,6,11
Zeno,haomarush,557,priest,discipline,11,6,5
Gringotaco,tichondrius,554,priest,discipline,26,9,17
Preeste,stormrage,543,priest,discipline,14,7,7
Earface,blades-edge,543,priest,discipline,14,7,7
Awaken,nerzhul,543,priest,discipline,17,6,11
Mørbol,tichondrius,541,priest,discipline,14,7,7
Moonlightx,destromath,528,priest,discipline,9,7,2
Xiaz,lightbringer,528,priest,discipline,12,8,4
Randomprist,area-52,528,priest,discipline,15,6,9
Tealien,dalaran,527,priest,discipline,11,6,5
Azaleth,sargeras,527,priest,discipline,11,6,5
Pasquell,emerald-dream,526,priest,discipline,11,6,5
Nosgoróth,quelthalas,522,priest,discipline,13,7,6
Dotdotdead,earthen-ring,522,priest,discipline,16,7,9
Twistèr,zuljin,522,priest,discipline,26,7,19
Onahaihu,tichondrius,521,priest,discipline,20,7,13
Identìty,moon-guard,521,priest,discipline,28,7,21
Øçñæøæçñøñçæ,sargeras,520,priest,discipline,12,7,5
Ethari,crushridge,520,priest,discipline,21,7,14
Iamjakehill,area-52,511,priest,discipline,8,6,2
Enphý,quelthalas,511,priest,discipline,11,6,5
Bigtang,kiljaeden,511,priest,discipline,14,6,8
Lilmad,stormrage,511,priest,discipline,20,6,14
Moneymurph,blackrock,511,priest,discipline,26,6,20
Pavarotti,laughing-skull,510,priest,discipline,20,6,14
Aquandrelea,aegwynn,495,priest,discipline,7,6,1
Yait,tichondrius,495,priest,discipline,14,7,7
Silverspöön,bleeding-hollow,495,priest,discipline,13,6,7
Danawhitex,thrall,480,priest,discipline,6,5,1
Bulleitrye,emerald-dream,480,priest,discipline,6,5,1
Mercedés,alleria,480,priest,discipline,6,5,1
Sharkbones,tichondrius,480,priest,discipline,6,5,1
Hateutoo,sargeras,480,priest,discipline,6,5,1
Nawtyforever,tichondrius,480,priest,discipline,6,5,1
Dzikuss,aegwynn,480,priest,discipline,6,5,1
Xøspëélls,ragnaros,480,priest,discipline,6,5,1
Noite,azralon,480,priest,discipline,6,5,1
Uncletouchy,illidan,480,priest,discipline,6,5,1
Azari,illidan,480,priest,discipline,6,5,1
Laggytwodope,tichondrius,480,priest,discipline,6,5,1
Thugliffe,frostmourne,480,priest,discipline,6,5,1
Clerkpriest,dragonmaw,480,priest,discipline,6,5,1
Sixnoh,moonrunner,480,priest,discipline,6,5,1
Azuremissile,tichondrius,480,priest,discipline,6,5,1
Drée,zuljin,480,priest,discipline,6,5,1
Phantømz,zuljin,480,priest,discipline,6,5,1
Tegridyfarm,malganis,480,priest,discipline,6,5,1
Cxmplex,malganis,480,priest,discipline,6,5,1
Corov,korgath,480,priest,discipline,6,5,1
Mxst,frostmourne,480,priest,discipline,6,5,1
Stegp,kelthuzad,480,priest,discipline,6,5,1
Gäüge,burning-legion,480,priest,discipline,6,5,1
Kardinalkeso,frostmourne,480,priest,discipline,6,5,1
Káldorei,proudmoore,480,priest,discipline,6,5,1
Saviorsëlf,tichondrius,480,priest,discipline,6,5,1
Deacoderx,area-52,480,priest,discipline,6,5,1
Sierrastorms,moon-guard,480,priest,discipline,6,5,1
Velastirra,saurfang,480,priest,discipline,6,5,1
Lildubs,bloodhoof,480,priest,discipline,6,5,1
Hölymöly,moon-guard,480,priest,discipline,6,5,1
Alimony,chogall,480,priest,discipline,6,5,1
Aetonyx,anvilmar,480,priest,discipline,6,5,1
Xorriz,bleeding-hollow,480,priest,discipline,6,5,1
Dirtydickdan,sargeras,480,priest,discipline,6,5,1
Djd,frostmourne,480,priest,discipline,6,5,1
Çøçø,tichondrius,480,priest,discipline,6,5,1
Privx,bleeding-hollow,480,priest,discipline,6,5,1
Imwithham,tichondrius,480,priest,discipline,10,6,4
Alpacasama,illidan,480,priest,discipline,12,5,7
Yaheals,gorefiend,480,priest,discipline,12,5,7
Cw,wildhammer,480,priest,discipline,12,5,7
Feyns,illidan,480,priest,discipline,12,5,7
Ayani,khadgar,480,priest,discipline,12,5,7
Skwishee,illidan,480,priest,discipline,12,5,7
Nursébeardy,whisperwind,480,priest,discipline,12,5,7
Spîteful,illidan,480,priest,discipline,12,5,7
Xpenance,ragnaros,480,priest,discipline,12,5,7
Scyndar,bonechewer,480,priest,discipline,12,5,7
Tòxìç,stormrage,480,priest,discipline,12,5,7
Sabela,moon-guard,480,priest,discipline,12,5,7
Whosjoe,tichondrius,480,priest,discipline,12,5,7
Pumice,destromath,480,priest,discipline,12,5,7
Altaeres,tichondrius,480,priest,discipline,12,5,7
Alleeyy,tichondrius,480,priest,discipline,12,5,7
Canswersp,sargeras,480,priest,discipline,12,5,7
Drmattydubz,tichondrius,480,priest,discipline,12,5,7
Letkidscome,archimonde,480,priest,discipline,12,5,7
Deeply,tichondrius,480,priest,discipline,12,5,7
Takosoufflé,emerald-dream,480,priest,discipline,12,5,7
Wreklol,sargeras,480,priest,discipline,12,5,7
Drzz,tichondrius,480,priest,discipline,12,5,7
Lchcl,tichondrius,480,priest,discipline,12,5,7
Lourrdz,tichondrius,480,priest,discipline,12,5,7
Shädyönë,tichondrius,480,priest,discipline,12,5,7
Krazyapollo,tichondrius,480,priest,discipline,12,5,7
Kelelin,frostwolf,480,priest,discipline,12,5,7
Goonie,spirestone,480,priest,discipline,12,5,7
Piffbadar,tichondrius,480,priest,discipline,12,5,7
Htx,dunemaul,480,priest,discipline,12,5,7
Bluffzp,boulderfist,480,priest,discipline,12,5,7
Ptam,tichondrius,480,priest,discipline,12,5,7
Azngød,tichondrius,480,priest,discipline,12,5,7
Stambuff,tichondrius,480,priest,discipline,12,5,7
Justgoon,tichondrius,480,priest,discipline,12,5,7
Taikosqt,azralon,480,priest,discipline,12,5,7
Kovie,twisting-nether,480,priest,discipline,12,5,7
Äpriest,sargeras,480,priest,discipline,12,5,7
Vérse,stormrage,480,priest,discipline,12,5,7
Jmanhealz,stormrage,480,priest,discipline,12,5,7
Shayylii,stormrage,480,priest,discipline,12,5,7
Voidquil,bonechewer,480,priest,discipline,12,5,7
Raslin,bonechewer,480,priest,discipline,12,5,7
Rofrofmu,aegwynn,480,priest,discipline,12,5,7
Augus,velen,480,priest,discipline,12,5,7
Hotlink,daggerspine,480,priest,discipline,12,5,7
Robbailey,dalvengyr,480,priest,discipline,12,5,7
Lingt,drakkari,480,priest,discipline,12,5,7
Arcosis,turalyon,480,priest,discipline,12,5,7
Ophiuchus,jubeithos,480,priest,discipline,12,5,7
Dweem,stormrage,480,priest,discipline,12,5,7
Derisha,ragnaros,480,priest,discipline,12,5,7
Kideater,quelthalas,480,priest,discipline,12,5,7
Apbrady,sargeras,480,priest,discipline,12,5,7
Doublesix,malganis,480,priest,discipline,12,5,7
Câstiêl,malganis,480,priest,discipline,12,5,7
Mywifesaidno,sargeras,480,priest,discipline,12,5,7
Blackdeathx,tichondrius,480,priest,discipline,12,5,7
Inflate,frostmourne,480,priest,discipline,12,5,7
Soulbane,frostmourne,480,priest,discipline,12,5,7
Shôta,kelthuzad,480,priest,discipline,12,5,7
Amperx,wyrmrest-accord,480,priest,discipline,12,5,7
Zælya,stormrage,480,priest,discipline,12,5,7
Jackymv,kelthuzad,480,priest,discipline,12,5,7
Discogs,frostmourne,480,priest,discipline,12,5,7
Yujawang,sargeras,480,priest,discipline,12,5,7
Starzard,kelthuzad,480,priest,discipline,12,5,7
Vikks,tichondrius,480,priest,discipline,12,5,7
Humblemumble,barthilas,480,priest,discipline,12,5,7
Elexianpi,stormrage,480,priest,discipline,12,5,7
Vyrah,area-52,480,priest,discipline,12,5,7
Upsahl,area-52,480,priest,discipline,12,5,7
Aheneas,quelthalas,480,priest,discipline,12,5,7
Anellas,sargeras,480,priest,discipline,12,5,7
Icarryozz,darkspear,480,priest,discipline,12,5,7
Nars,draka,480,priest,discipline,12,5,7
Lastbubble,area-52,480,priest,discipline,12,5,7
Stubby,shadowsong,480,priest,discipline,12,5,7
Goosemongler,bleeding-hollow,480,priest,discipline,12,5,7
Nißirøux,sargeras,480,priest,discipline,12,5,7
Whiterhino,spirestone,480,priest,discipline,12,5,7
Supernamp,sargeras,480,priest,discipline,12,5,7
Healryyduff,barthilas,480,priest,discipline,12,5,7
Ajazz,zuljin,480,priest,discipline,12,5,7
Merxy,bleeding-hollow,480,priest,discipline,12,5,7
Shadowcrash,zuljin,480,priest,discipline,12,5,7
Makeshiftz,zuljin,480,priest,discipline,12,5,7
Giraffebaitt,zuljin,480,priest,discipline,12,5,7
Somethingkoo,sargeras,480,priest,discipline,17,7,10
Gatty,kiljaeden,480,priest,discipline,13,5,8
Cheekypriest,stormrage,480,priest,discipline,18,5,13
Sypii,stormrage,480,priest,discipline,18,5,13
Nuditwo,malganis,480,priest,discipline,18,5,13
Pasher,sargeras,480,priest,discipline,18,5,13
Kark,tichondrius,480,priest,discipline,18,5,13
Mangshadoom,silvermoon,480,priest,discipline,18,5,13
Fréákk,ragnaros,480,priest,discipline,18,5,13
Discpriestxo,malganis,480,priest,discipline,18,5,13
Ticheals,tichondrius,480,priest,discipline,18,5,13
Levingurt,darkspear,480,priest,discipline,18,5,13
Bebe,fizzcrank,480,priest,discipline,18,5,13
Aguadejamica,tichondrius,480,priest,discipline,18,5,13
Autogenic,malganis,480,priest,discipline,18,5,13
Vetisrx,thrall,480,priest,discipline,18,5,13
Healiesuwu,kiljaeden,480,priest,discipline,18,5,13
Klerick,kiljaeden,480,priest,discipline,18,5,13
Moc,jubeithos,480,priest,discipline,24,5,19
Georgepells,barthilas,480,priest,discipline,24,5,19
Ghettobarbie,kelthuzad,479,priest,discipline,6,5,1
Tonymòntana,area-52,479,priest,discipline,6,5,1
Sevioletté,wyrmrest-accord,479,priest,discipline,6,5,1
Remixcandoit,malganis,479,priest,discipline,6,5,1
Pretzah,barthilas,479,priest,discipline,6,5,1
Krisdavra,thrall,479,priest,discipline,6,5,1
Xojelas,quelthalas,479,priest,discipline,6,5,1
Viehweg,azralon,479,priest,discipline,12,5,7
Healzutwo,tichondrius,479,priest,discipline,12,5,7
Chadlyfe,tichondrius,479,priest,discipline,12,5,7
Chopstix,senjin,479,priest,discipline,12,5,7
Blackbubba,tichondrius,479,priest,discipline,12,5,7
Gaaq,stormrage,479,priest,discipline,12,5,7
Atheíst,tichondrius,479,priest,discipline,12,5,7
Xenedart,quelthalas,479,priest,discipline,12,5,7
Ibuyfeetpics,tichondrius,479,priest,discipline,12,5,7
Frazzysparks,stormrage,479,priest,discipline,12,5,7
Sublîme,sargeras,479,priest,discipline,12,5,7
Krynoobz,senjin,479,priest,discipline,12,5,7
Tubelight,sargeras,479,priest,discipline,12,5,7
Aalicya,tanaris,479,priest,discipline,12,5,7
Techninë,chogall,479,priest,discipline,12,5,7
Demished,zuljin,479,priest,discipline,12,5,7
Selea,frostwolf,479,priest,discipline,12,5,7
Wort,cairne,479,priest,discipline,12,5,7
Drayen,korgath,479,priest,discipline,12,5,7
Derowent,emerald-dream,479,priest,discipline,12,5,7
Goodboyyoshi,tichondrius,479,priest,discipline,15,5,10
Cxview,sargeras,479,priest,discipline,18,5,13
Crusifixx,tichondrius,479,priest,discipline,18,5,13
Healtomuch,nagrand,479,priest,discipline,18,5,13
Kaladaz,destromath,478,priest,discipline,12,5,7
Eumalfa,dalaran,477,priest,discipline,6,5,1
Pingleangel,tichondrius,477,priest,discipline,12,5,7
Goldenlilly,moon-guard,477,priest,discipline,18,5,13
Hazzang,tichondrius,476,priest,discipline,78,37,41
Lotzofhealz,wyrmrest-accord,476,priest,discipline,12,5,7
Forober,queldorei,466,priest,discipline,39,14,25
Shadowkr,tichondrius,447,priest,discipline,11,5,6
Hungzilla,malganis,447,priest,discipline,11,5,6
Faíthless,sargeras,447,priest,discipline,11,5,6
Darkascended,arthas,447,priest,discipline,14,6,8
Gnepe,sargeras,441,priest,discipline,17,7,10
Agrotothemax,tichondrius,432,priest,discipline,15,5,10
Fxxkdamn,tichondrius,432,priest,discipline,21,6,15
Nefastó,ragnaros,431,priest,discipline,12,6,6
Frenchfries,sargeras,431,priest,discipline,11,5,6
Texmix,stormrage,431,priest,discipline,21,6,15
Holyshart,stonemaul,430,priest,discipline,11,5,6
Leejungjae,tichondrius,426,priest,discipline,15,6,9
Discshady,tichondrius,416,priest,discipline,10,5,5
Mooray,thrall,415,priest,discipline,14,5,9
Melsebek,stormrage,415,priest,discipline,20,5,15
Elbowbeans,tichondrius,414,priest,discipline,16,5,11
Esredarksun,sargeras,412,priest,discipline,16,5,11
Whodatpriest,blackhand,399,priest,discipline,5,5,0
Normill,bonechewer,399,priest,discipline,7,5,2
Bunked,bleeding-hollow,392,priest,discipline,23,7,16
Gdlsheretic,sargeras,384,priest,discipline,6,4,2
Kàobeini,tichondrius,384,priest,discipline,6,4,2
Zaperama,tichondrius,384,priest,discipline,6,4,2
Feminizm,tichondrius,384,priest,discipline,6,4,2
Jjojae,illidan,384,priest,discipline,6,4,2
Sip,sargeras,384,priest,discipline,6,4,2
Merçy,zuljin,384,priest,discipline,6,4,2
Calamithus,illidan,384,priest,discipline,6,4,2
Soupbeanx,zuljin,384,priest,discipline,6,4,2
Dredgeflay,thrall,384,priest,discipline,6,4,2
Yunggawd,illidan,384,priest,discipline,6,4,2
Pprriieesst,tichondrius,384,priest,discipline,6,4,2
Granger,senjin,384,priest,discipline,6,4,2
Deathrina,moon-guard,384,priest,discipline,6,4,2
Leebow,tichondrius,384,priest,discipline,6,4,2
Miniambá,tichondrius,384,priest,discipline,6,4,2
Ranthrough,tichondrius,384,priest,discipline,6,4,2
Acenthe,sargeras,384,priest,discipline,6,4,2
Chü,dalaran,384,priest,discipline,6,4,2
Rillding,tichondrius,384,priest,discipline,6,4,2
Fûsoya,zuljin,384,priest,discipline,6,4,2
Dimedaddy,tichondrius,384,priest,discipline,6,4,2
Béépboop,tichondrius,384,priest,discipline,6,4,2
Sevros,moon-guard,384,priest,discipline,6,4,2
Tomp,tichondrius,384,priest,discipline,6,4,2
Vyndïllïn,tichondrius,384,priest,discipline,6,4,2
Vladlèna,moon-guard,384,priest,discipline,6,4,2
Scalpell,tichondrius,384,priest,discipline,6,4,2
Gardiancloun,sargeras,384,priest,discipline,6,4,2
Nightheals,sargeras,384,priest,discipline,6,4,2
Dioecesis,moon-guard,384,priest,discipline,6,4,2
Goobiesz,tichondrius,384,priest,discipline,6,4,2
Myds,sargeras,384,priest,discipline,6,4,2
Lavigne,tichondrius,384,priest,discipline,6,4,2
Crode,bleeding-hollow,384,priest,discipline,6,4,2
Nordheal,stormrage,384,priest,discipline,6,4,2
Babygsuss,tichondrius,384,priest,discipline,6,4,2
Remuni,tichondrius,384,priest,discipline,6,4,2
Jaxthree,illidan,384,priest,discipline,6,4,2
Discotec,stormrage,384,priest,discipline,6,4,2
Fadedyourgo,tichondrius,384,priest,discipline,6,4,2
Pillböx,tichondrius,384,priest,discipline,6,4,2
Orisons,bleeding-hollow,384,priest,discipline,6,4,2
Monkeyp,barthilas,384,priest,discipline,6,4,2
Brácho,ragnaros,384,priest,discipline,6,4,2
Rahmynpriest,tichondrius,384,priest,discipline,6,4,2
Djchickpea,chogall,384,priest,discipline,6,4,2
Altari,whisperwind,384,priest,discipline,6,4,2
Subscribe,khazgoroth,384,priest,discipline,6,4,2
Chemdawwg,aerie-peak,384,priest,discipline,6,4,2
Crueldotz,illidan,384,priest,discipline,6,4,2
Uglydiego,quelthalas,384,priest,discipline,6,4,2
Celanea,bleeding-hollow,384,priest,discipline,6,4,2
Bubbleboi,malganis,384,priest,discipline,6,4,2
Lithelin,frostmourne,384,priest,discipline,6,4,2
Goatedpriest,kelthuzad,384,priest,discipline,6,4,2
Frymii,frostmourne,384,priest,discipline,6,4,2
Batface,frostmourne,384,priest,discipline,6,4,2
Lebanese,frostmourne,384,priest,discipline,6,4,2
Onipapae,frostmourne,384,priest,discipline,6,4,2
Optimism,frostmane,384,priest,discipline,6,4,2
Packa,khaz-modan,384,priest,discipline,6,4,2
Gomer,stormrage,384,priest,discipline,6,4,2
Tristanp,frostmourne,384,priest,discipline,6,4,2
Celani,gilneas,384,priest,discipline,6,4,2
Febronia,aerie-peak,384,priest,discipline,6,4,2
Blzy,area-52,384,priest,discipline,6,4,2
Zhanay,ragnaros,384,priest,discipline,6,4,2
Metéora,nemesis,384,priest,discipline,6,4,2
Ðyluxx,blackwater-raiders,384,priest,discipline,6,4,2
Goyqqp,illidan,384,priest,discipline,6,4,2
Papaheal,runetotem,384,priest,discipline,6,4,2
Rïshloo,ragnaros,384,priest,discipline,6,4,2
Gnomelester,kiljaeden,384,priest,discipline,6,4,2
Rmpenjoyerx,area-52,384,priest,discipline,6,4,2
Dinar,tichondrius,384,priest,discipline,6,4,2
Spyderco,mugthol,384,priest,discipline,6,4,2
Noopnoop,burning-blade,384,priest,discipline,6,4,2
Faithx,frostmourne,384,priest,discipline,6,4,2
Chambler,aegwynn,384,priest,discipline,6,4,2
Hiphopanomis,arthas,384,priest,discipline,6,4,2
Flaytality,shadowsong,384,priest,discipline,6,4,2
Ruems,area-52,384,priest,discipline,6,4,2
Demongodtren,blackrock,384,priest,discipline,6,4,2
Tosbanned,barthilas,384,priest,discipline,6,4,2
Balikina,stormrage,384,priest,discipline,6,4,2
Ritalyn,korgath,384,priest,discipline,6,4,2
Äni,sargeras,384,priest,discipline,6,4,2
Gregorovich,ragnaros,384,priest,discipline,6,4,2
Popeachini,sargeras,384,priest,discipline,6,4,2
Stepbrohelp,barthilas,384,priest,discipline,6,4,2
Potatopriest,frostmourne,384,priest,discipline,6,4,2
Jixxersp,malganis,384,priest,discipline,6,4,2
Mettypws,tichondrius,384,priest,discipline,6,4,2
Aguavenditaa,quelthalas,384,priest,discipline,6,4,2
Runnow,area-52,384,priest,discipline,6,4,2
Wilita,drakkari,384,priest,discipline,6,4,2
Pandaniaco,drakkari,384,priest,discipline,6,4,2
Kwazshell,area-52,384,priest,discipline,7,4,3
Shadp,tichondrius,384,priest,discipline,9,5,4
Cruces,malorne,384,priest,discipline,9,4,5
Brodel,dark-iron,384,priest,discipline,9,4,5
Poonanixo,gundrak,384,priest,discipline,10,4,6
Nvøsuperstar,zuljin,384,priest,discipline,15,5,10
Srazul,azralon,384,priest,discipline,12,4,8
Ollarlamente,zuljin,384,priest,discipline,12,4,8
Eilana,tichondrius,384,priest,discipline,12,4,8
Valzzdor,zuljin,384,priest,discipline,12,4,8
Jonahas,sargeras,384,priest,discipline,12,4,8
Seyler,barthilas,384,priest,discipline,12,4,8
Akewnón,stormrage,384,priest,discipline,12,4,8
Lankyschlong,frostmourne,384,priest,discipline,12,4,8
Ophailea,thrall,384,priest,discipline,12,4,8
Suzono,hyjal,384,priest,discipline,12,4,8
Dirtydogma,zuljin,384,priest,discipline,12,4,8
Ranksix,area-52,384,priest,discipline,12,4,8
Larisa,moon-guard,384,priest,discipline,12,4,8
Covfefe,draka,384,priest,discipline,12,4,8
Barclan,destromath,384,priest,discipline,12,4,8
Exisa,stormrage,384,priest,discipline,12,4,8
Billiard,stormrage,384,priest,discipline,12,4,8
Vyvivienx,tichondrius,384,priest,discipline,12,4,8
Lucet,aegwynn,384,priest,discipline,12,4,8
Chaxiubao,stormrage,384,priest,discipline,12,4,8
Zaylahh,blackrock,384,priest,discipline,12,4,8
Danceofpales,bleeding-hollow,384,priest,discipline,12,4,8
Ritzien,jubeithos,384,priest,discipline,12,4,8
Thotsteal,lightbringer,384,priest,discipline,12,4,8
Echoos,proudmoore,384,priest,discipline,12,4,8
Killä,area-52,384,priest,discipline,12,4,8
Kuppel,tichondrius,384,priest,discipline,12,4,8
Stonemonkeyp,sargeras,384,priest,discipline,12,4,8
Spøokz,stormreaver,384,priest,discipline,12,4,8
Touchèr,sargeras,384,priest,discipline,12,4,8
Haruspex,azralon,384,priest,discipline,12,4,8
Jejer,moon-guard,384,priest,discipline,12,4,8
Revolki,azralon,384,priest,discipline,12,4,8
Nokhoron,eldrethalas,384,priest,discipline,12,4,8
Littlean,frostmourne,384,priest,discipline,12,4,8
Zaphfkiel,ragnaros,384,priest,discipline,12,4,8
Pearlwing,area-52,384,priest,discipline,12,4,8
Gothmidget,illidan,384,priest,discipline,12,4,8
Ludens,bleeding-hollow,384,priest,discipline,12,4,8
Holynova,nerzhul,384,priest,discipline,12,4,8
Disperse,sargeras,384,priest,discipline,12,4,8
Tangykiwi,dalaran,384,priest,discipline,12,4,8
Kikyo,antonidas,384,priest,discipline,12,4,8
Amys,kargath,384,priest,discipline,12,4,8
Mosarra,agamaggan,384,priest,discipline,12,4,8
Healbilli,archimonde,384,priest,discipline,12,4,8
Darkspearr,tichondrius,384,priest,discipline,12,4,8
Stilgeist,proudmoore,384,priest,discipline,12,4,8
Butdidudied,sargeras,384,priest,discipline,12,4,8
Auttø,area-52,384,priest,discipline,12,4,8
Gooseundead,tichondrius,384,priest,discipline,12,4,8
Holyshiitzz,illidan,384,priest,discipline,12,4,8
Kepptwo,korgath,384,priest,discipline,12,4,8
Laqqet,sargeras,384,priest,discipline,12,4,8
Wìd,khazgoroth,384,priest,discipline,12,4,8
Slenden,illidan,384,priest,discipline,12,4,8
Daryldeath,tichondrius,384,priest,discipline,12,4,8
Pontiffvelen,area-52,384,priest,discipline,12,4,8
Sìrena,tichondrius,384,priest,discipline,12,4,8
Biop,burning-blade,384,priest,discipline,12,4,8
Skydemons,malganis,384,priest,discipline,12,4,8
Plebiss,burning-blade,384,priest,discipline,12,4,8
Dabrat,darkspear,384,priest,discipline,12,4,8
Karmapi,malganis,384,priest,discipline,12,4,8
Vampriest,frostmourne,384,priest,discipline,13,4,9
Discpi,illidan,384,priest,discipline,13,4,9
Kibariyb,drakkari,384,priest,discipline,18,4,14
Kymohek,sargeras,384,priest,discipline,18,4,14
Mucgib,frostmourne,384,priest,discipline,18,4,14
Polythis,kelthuzad,384,priest,discipline,18,4,14
Rainms,sargeras,384,priest,discipline,18,4,14
Xiaozhui,tichondrius,384,priest,discipline,18,4,14
Disçxrespeçt,cairne,384,priest,discipline,18,4,14
Vikingkøng,ragnaros,384,priest,discipline,18,4,14
Shadowdroid,tichondrius,384,priest,discipline,18,4,14
Heilige,uldum,384,priest,discipline,24,4,20
Jonnycanuckz,duskwood,383,priest,discipline,6,4,2
Gabrieleron,quelthalas,383,priest,discipline,6,4,2
Fanaeth,arathor,383,priest,discipline,6,4,2
Discodork,bleeding-hollow,383,priest,discipline,6,4,2
Mirex,tichondrius,383,priest,discipline,6,4,2
Lifesavér,tichondrius,383,priest,discipline,6,4,2
Needalung,stormrage,383,priest,discipline,6,4,2
Darthvalak,illidan,383,priest,discipline,6,4,2
Coorslite,proudmoore,383,priest,discipline,6,4,2
Shén,barthilas,383,priest,discipline,6,4,2
Sybal,suramar,383,priest,discipline,12,4,8
Mangaloochi,amanthul,383,priest,discipline,12,4,8
Whatisholy,bleeding-hollow,383,priest,discipline,12,4,8
Cyberpriest,stormrage,383,priest,discipline,12,4,8
Sihua,illidan,383,priest,discipline,12,4,8
Fathergrey,emerald-dream,383,priest,discipline,12,4,8
Nikasaur,azgalor,383,priest,discipline,12,4,8
Uckuck,illidan,383,priest,discipline,12,4,8
Anoxic,kiljaeden,383,priest,discipline,12,4,8
Nocturnimal,grizzly-hills,382,priest,discipline,12,4,8
Väin,proudmoore,381,priest,discipline,12,4,8
Bunnychloe,sargeras,381,priest,discipline,12,4,8
Touchedbygud,frostmourne,381,priest,discipline,12,4,8
Divinebones,gurubashi,381,priest,discipline,12,4,8
Primela,sargeras,381,priest,discipline,12,4,8
Shenanigans,illidan,367,priest,discipline,11,4,7
Burtier,zuljin,367,priest,discipline,11,4,7
Llaarrkkss,tichondrius,351,priest,discipline,11,4,7
Scrïpt,thaurissan,351,priest,discipline,11,4,7
Kuwapre,proudmoore,336,priest,discipline,9,5,4
Proftimothy,tichondrius,336,priest,discipline,9,5,4
Elliepls,tichondrius,336,priest,discipline,9,4,5
Rosabell,ragnaros,336,priest,discipline,21,4,17
Grianné,mannoroth,335,priest,discipline,9,4,5
Causeoflife,eitrigg,335,priest,discipline,11,4,7
Siobhin,wyrmrest-accord,335,priest,discipline,11,4,7
Subvert,zuljin,330,priest,discipline,7,5,2
Tmnaarcanttv,tichondrius,330,priest,discipline,7,5,2
Lolkwtf,sargeras,330,priest,discipline,14,6,8
Prayanmantis,tichondrius,330,priest,discipline,14,5,9
Xiangjiao,tichondrius,330,priest,discipline,17,6,11
Takedisdisc,tichondrius,330,priest,discipline,17,6,11
Lilgeek,kelthuzad,330,priest,discipline,21,5,16
Maccten,tichondrius,319,priest,discipline,9,5,4
Smarttakka,emerald-dream,319,priest,discipline,8,4,4
Leviosa,bleeding-hollow,319,priest,discipline,8,4,4
Manachai,the-forgotten-coast,319,priest,discipline,14,4,10
Klizzy,tichondrius,319,priest,discipline,14,4,10
Rancidcookie,tichondrius,304,priest,discipline,13,4,9
Educated,tichondrius,303,priest,discipline,20,4,16
Unagidrop,malganis,288,priest,discipline,6,3,3
Numinous,wyrmrest-accord,288,priest,discipline,6,3,3
Krewed,ravencrest,288,priest,discipline,6,3,3
Madalôn,nemesis,288,priest,discipline,6,3,3
Mesuki,malganis,288,priest,discipline,6,3,3
Bestworldxz,illidan,288,priest,discipline,6,3,3
Zaradomin,kelthuzad,288,priest,discipline,6,3,3
Mks,barthilas,288,priest,discipline,6,3,3
Fure,mannoroth,288,priest,discipline,6,3,3
Îcecube,sargeras,288,priest,discipline,6,3,3
Killduran,hellscream,288,priest,discipline,6,3,3
Seyvyur,black-dragonflight,288,priest,discipline,6,3,3
Laneska,stormrage,288,priest,discipline,6,3,3
Anzulupriest,alexstrasza,288,priest,discipline,6,3,3
Synthas,tichondrius,288,priest,discipline,6,3,3
Kaiah,gorefiend,288,priest,discipline,6,3,3
Lovetotouch,malganis,288,priest,discipline,6,3,3
Merylstreepz,illidan,288,priest,discipline,6,3,3
Dudurr,zuluhed,288,priest,discipline,6,3,3
Nokizzgrizz,sargeras,288,priest,discipline,6,3,3
Eiricka,kelthuzad,288,priest,discipline,6,3,3
Damushi,frostmourne,288,priest,discipline,6,3,3
Alleviate,frostmourne,288,priest,discipline,6,3,3
Barackhobama,malganis,288,priest,discipline,6,3,3
Healyhaney,stormrage,288,priest,discipline,6,3,3
Kabutta,stormrage,288,priest,discipline,6,3,3
Mellisonant,stormrage,288,priest,discipline,6,3,3
Quefase,proudmoore,288,priest,discipline,6,3,3
Magicbus,blackrock,288,priest,discipline,6,3,3
Pwrwordthicc,illidan,288,priest,discipline,6,3,3
Skyfury,darkspear,288,priest,discipline,6,3,3
Illiteratex,sargeras,288,priest,discipline,6,3,3
Kleiâ,tichondrius,288,priest,discipline,6,3,3
Nikci,tichondrius,288,priest,discipline,6,3,3
Drewsies,anvilmar,288,priest,discipline,6,3,3
Kelody,zuljin,288,priest,discipline,6,3,3
Frye,bleeding-hollow,288,priest,discipline,6,3,3
Durgen,stormreaver,288,priest,discipline,6,3,3
Edmen,stormrage,288,priest,discipline,6,3,3
Heratic,malganis,288,priest,discipline,6,3,3
Grafîx,frostmourne,288,priest,discipline,6,3,3
Drrunk,bleeding-hollow,288,priest,discipline,6,3,3
Kirigäya,quelthalas,288,priest,discipline,6,3,3
Sölei,tichondrius,288,priest,discipline,6,3,3
Kaldoon,azjolnerub,288,priest,discipline,6,3,3
Diskope,kelthuzad,288,priest,discipline,6,3,3
Imagees,stormscale,288,priest,discipline,6,3,3
Oofx,darkspear,288,priest,discipline,6,3,3
Xuxu,frostmourne,288,priest,discipline,6,3,3
Germanica,area-52,288,priest,discipline,6,3,3
Iamsatan,illidan,288,priest,discipline,6,3,3
Tarwow,moon-guard,288,priest,discipline,6,3,3
Bambi,dunemaul,288,priest,discipline,6,3,3
Ayoheals,zuljin,288,priest,discipline,6,3,3
Ææae,nemesis,288,priest,discipline,6,3,3
Animityz,illidan,288,priest,discipline,6,3,3
Oxicontin,sargeras,288,priest,discipline,6,3,3
Popeofhope,queldorei,288,priest,discipline,6,3,3
Strokingmydx,illidan,288,priest,discipline,6,3,3
Vìxèn,zuljin,288,priest,discipline,6,3,3
Midget,darkspear,288,priest,discipline,6,3,3
Powerchucha,area-52,288,priest,discipline,6,3,3
Mongatzuya,illidan,288,priest,discipline,6,3,3
Triazolam,illidan,288,priest,discipline,6,3,3
Yogosun,dalaran,288,priest,discipline,6,3,3
Bigpoppapwn,darkspear,288,priest,discipline,6,3,3
Hopenä,dragonmaw,288,priest,discipline,6,3,3
Wakandafev,frostmourne,288,priest,discipline,6,3,3
Relianth,stormrage,288,priest,discipline,6,3,3
Thattpriest,thrall,288,priest,discipline,6,3,3
Calcifer,drakkari,288,priest,discipline,6,3,3
Xusin,tichondrius,288,priest,discipline,6,3,3
Zugzugheal,bleeding-hollow,288,priest,discipline,6,3,3
Ellipsiz,area-52,288,priest,discipline,6,3,3
Zuuji,frostmourne,288,priest,discipline,6,3,3
Tmall,tichondrius,288,priest,discipline,6,3,3
Kelime,azralon,288,priest,discipline,6,3,3
Kallenk,proudmoore,288,priest,discipline,6,3,3
Justinagnpr,tichondrius,288,priest,discipline,6,3,3
Idhealthat,tichondrius,288,priest,discipline,6,3,3
Spiritbear,thrall,288,priest,discipline,6,3,3
Kakera,tichondrius,288,priest,discipline,6,3,3
Illegalkill,tichondrius,288,priest,discipline,6,3,3
Éxploït,tichondrius,288,priest,discipline,6,3,3
Namecusein,ragnaros,288,priest,discipline,6,3,3
Dradinx,illidan,288,priest,discipline,6,3,3
Nutdrip,tichondrius,288,priest,discipline,6,3,3
Hellokuti,silvermoon,288,priest,discipline,6,3,3
Serenderpity,moon-guard,288,priest,discipline,6,3,3
Psyfriend,area-52,288,priest,discipline,6,3,3
Àneres,illidan,288,priest,discipline,6,3,3
Wiseguise,illidan,288,priest,discipline,6,3,3
Babburger,tichondrius,288,priest,discipline,6,3,3
Tempname,thunderhorn,288,priest,discipline,6,3,3
Buc,barthilas,288,priest,discipline,6,3,3
Nyxvoid,ragnaros,288,priest,discipline,6,3,3
Lyriczx,kelthuzad,288,priest,discipline,6,3,3
Banepriest,sargeras,288,priest,discipline,6,3,3
Adelda,nazjatar,288,priest,discipline,6,3,3
Puritykitty,zuljin,288,priest,discipline,6,3,3
Jinzp,area-52,288,priest,discipline,6,3,3
Nellìel,whisperwind,288,priest,discipline,6,3,3
Kiazma,zuljin,288,priest,discipline,6,3,3
Sabene,greymane,288,priest,discipline,6,3,3
Khaospriest,proudmoore,288,priest,discipline,6,3,3
Nevermyndz,bleeding-hollow,288,priest,discipline,6,3,3
Dredre,aggramar,288,priest,discipline,6,3,3
Ìdiot,saurfang,288,priest,discipline,6,3,3
Amoureuxz,bleeding-hollow,288,priest,discipline,6,3,3
Lostnthought,aggramar,288,priest,discipline,6,3,3
Swinee,tichondrius,288,priest,discipline,6,3,3
Paradoxbot,kelthuzad,288,priest,discipline,6,3,3
Awesomeguyx,tichondrius,288,priest,discipline,6,3,3
Hükk,kalecgos,288,priest,discipline,6,3,3
Kujoh,tichondrius,288,priest,discipline,6,3,3
Eirana,skywall,288,priest,discipline,6,3,3
Bgundy,sargeras,288,priest,discipline,6,3,3
Sivamint,aerie-peak,288,priest,discipline,6,3,3
Empyreanlite,dalaran,288,priest,discipline,6,3,3
Alladys,shattered-hand,288,priest,discipline,6,3,3
Pzx,zuljin,288,priest,discipline,6,3,3
Alucardibee,turalyon,288,priest,discipline,6,3,3
Burgersl,illidan,288,priest,discipline,6,3,3
Imb,nagrand,288,priest,discipline,6,3,3
Nazgúl,lothar,288,priest,discipline,6,3,3
Bessias,area-52,288,priest,discipline,6,3,3
Humps,sargeras,288,priest,discipline,6,3,3
Umbramortìs,tichondrius,288,priest,discipline,6,3,3
Magazíne,tichondrius,288,priest,discipline,6,3,3
Boogiê,illidan,288,priest,discipline,6,3,3
Sterycraiied,stormreaver,288,priest,discipline,6,3,3
Huckdaddy,tichondrius,288,priest,discipline,6,3,3
Swollenarms,kiljaeden,288,priest,discipline,6,3,3
Chowdä,kiljaeden,288,priest,discipline,6,3,3
Diamondz,emerald-dream,288,priest,discipline,6,3,3
Moirâ,silvermoon,288,priest,discipline,6,3,3
Mindmelts,gallywix,288,priest,discipline,6,3,3
Trezz,aegwynn,288,priest,discipline,6,3,3
Aspéct,aegwynn,288,priest,discipline,6,3,3
Dìngobaby,stormrage,288,priest,discipline,6,3,3
Sassygayboyx,bleeding-hollow,288,priest,discipline,6,3,3
Sæýfír,illidan,288,priest,discipline,6,3,3
Asleep,sargeras,288,priest,discipline,6,3,3
Kefkå,sargeras,288,priest,discipline,6,3,3
Liminality,illidan,288,priest,discipline,6,3,3
Haedn,azralon,288,priest,discipline,6,3,3
Filthmaster,moon-guard,288,priest,discipline,6,3,3
Sandreth,bonechewer,288,priest,discipline,6,3,3
Minzyx,tichondrius,288,priest,discipline,6,3,3
Pics,emerald-dream,288,priest,discipline,6,3,3
Wale,akama,288,priest,discipline,6,3,3
Sophistdew,proudmoore,288,priest,discipline,6,3,3
Dorlala,tichondrius,288,priest,discipline,6,3,3
Thenamesnorm,tichondrius,288,priest,discipline,6,3,3
Roseriela,moon-guard,288,priest,discipline,6,3,3
Ichheilen,thrall,288,priest,discipline,6,3,3
Havefaith,whisperwind,288,priest,discipline,6,3,3
Deezdotz,alterac-mountains,288,priest,discipline,6,3,3
Lifeswaplol,kelthuzad,288,priest,discipline,6,3,3
Shelfedelf,gurubashi,288,priest,discipline,6,3,3
Pumpkinpino,stormrage,288,priest,discipline,6,3,3
Callèèn,stormrage,288,priest,discipline,6,3,3
Rotnn,thrall,288,priest,discipline,6,3,3
Vanzera,thrall,288,priest,discipline,6,3,3
Zzavidwong,tichondrius,288,priest,discipline,6,3,3
Shadowform,illidan,288,priest,discipline,6,3,3
Elise,ravenholdt,288,priest,discipline,6,3,3
Decastro,silvermoon,288,priest,discipline,6,3,3
Furydos,zuljin,288,priest,discipline,6,3,3
Tubshark,moon-guard,288,priest,discipline,6,3,3
Crazyfinley,dalaran,288,priest,discipline,6,3,3
Fausto,kiljaeden,288,priest,discipline,6,3,3
Ashidox,proudmoore,288,priest,discipline,6,3,3
Keyohh,tichondrius,288,priest,discipline,6,3,3
Methandrial,hyjal,288,priest,discipline,6,3,3
Donkeycube,tichondrius,288,priest,discipline,6,3,3
Fouroneo,tichondrius,288,priest,discipline,6,3,3
Sasagui,bloodscalp,288,priest,discipline,6,3,3
Fackinheals,kelthuzad,288,priest,discipline,6,3,3
Ìhatermp,tichondrius,288,priest,discipline,6,3,3
Poøpoopeepee,tichondrius,288,priest,discipline,6,3,3
Zegron,rexxar,288,priest,discipline,6,3,3
Kawesha,emerald-dream,288,priest,discipline,6,3,3
Aia,frostwolf,288,priest,discipline,6,3,3
Mindgamez,stormreaver,288,priest,discipline,6,3,3
Dumbthott,illidan,288,priest,discipline,6,3,3
Maniacx,stormrage,288,priest,discipline,6,3,3
Chervz,chogall,288,priest,discipline,6,3,3
Bubblejunkie,lethon,288,priest,discipline,9,4,5
Whackagnome,kelthuzad,288,priest,discipline,9,4,5
Waterßoÿ,emerald-dream,288,priest,discipline,9,4,5
Onegil,tichondrius,288,priest,discipline,7,3,4
Catboynahj,dalaran,288,priest,discipline,8,3,5
Atheistbtw,sargeras,288,priest,discipline,16,5,11
Zodiá,dentarg,288,priest,discipline,14,4,10
Nogetget,frostmourne,288,priest,discipline,12,3,9
Quartzolio,azralon,288,priest,discipline,12,3,9
Phantoms,moon-guard,288,priest,discipline,12,3,9
Kustem,tichondrius,288,priest,discipline,12,3,9
Die,crushridge,288,priest,discipline,12,3,9
Toppers,bladefist,288,priest,discipline,12,3,9
Jahratu,tichondrius,288,priest,discipline,12,3,9
Disconelf,barthilas,288,priest,discipline,12,3,9
Lavéy,ragnaros,288,priest,discipline,12,3,9
Paztech,arthas,288,priest,discipline,12,3,9
Pedialyte,kiljaeden,288,priest,discipline,12,3,9
Devili,wyrmrest-accord,288,priest,discipline,12,3,9
Dumplolz,quelthalas,288,priest,discipline,12,3,9
Snupyfangirl,area-52,288,priest,discipline,12,3,9
Gwenoviere,whisperwind,288,priest,discipline,12,3,9
Bree,area-52,288,priest,discipline,12,3,9
Abefromann,sargeras,288,priest,discipline,12,3,9
Doomageddon,thorium-brotherhood,288,priest,discipline,12,3,9
Aaxahfon,moon-guard,288,priest,discipline,12,3,9
Manaburnout,blackhand,288,priest,discipline,12,3,9
Twohpriest,aerie-peak,288,priest,discipline,12,3,9
Zemms,tichondrius,288,priest,discipline,12,3,9
Spampws,aerie-peak,288,priest,discipline,12,3,9
Arkathus,stormrage,288,priest,discipline,12,3,9
Bewbeez,fizzcrank,288,priest,discipline,12,3,9
Shattgreen,malganis,288,priest,discipline,12,3,9
Virydian,stormrage,288,priest,discipline,12,3,9
Xìdís,vashj,288,priest,discipline,12,3,9
Hail,kaelthas,288,priest,discipline,12,3,9
Vandi,moon-guard,288,priest,discipline,12,3,9
Phillyrivers,area-52,288,priest,discipline,12,3,9
Bån,ragnaros,288,priest,discipline,12,3,9
Willica,stormrage,288,priest,discipline,12,3,9
Nsquared,illidan,288,priest,discipline,12,3,9
Aoeprophet,area-52,288,priest,discipline,12,3,9
Realheal,tichondrius,288,priest,discipline,12,3,9
Xalatath,stormrage,288,priest,discipline,12,3,9
Hokon,tortheldrin,288,priest,discipline,12,3,9
Lovebbw,sargeras,288,priest,discipline,12,3,9
Fitzop,frostmourne,288,priest,discipline,12,3,9
Lightshizzle,illidan,288,priest,discipline,12,3,9
Awøaqexs,area-52,288,priest,discipline,12,3,9
Chaddadbod,emerald-dream,288,priest,discipline,12,3,9
Asmitä,stormrage,288,priest,discipline,12,3,9
Itha,illidan,288,priest,discipline,12,3,9
Soleyxo,frostmourne,288,priest,discipline,12,3,9
Googus,bleeding-hollow,288,priest,discipline,12,3,9
Gloomswrath,illidan,288,priest,discipline,12,3,9
Ricxaw,frostmourne,288,priest,discipline,12,3,9
Skimpdubs,bleeding-hollow,288,priest,discipline,12,3,9
Slackinhealz,thrall,288,priest,discipline,12,3,9
Kurnak,arthas,288,priest,discipline,12,3,9
Muriaticacid,tichondrius,288,priest,discipline,12,3,9
Km,zuljin,288,priest,discipline,12,3,9
Decokim,tichondrius,288,priest,discipline,12,3,9
Ophindrip,zuljin,288,priest,discipline,12,3,9
Phantøms,zuljin,288,priest,discipline,12,3,9
Krewtoo,illidan,288,priest,discipline,12,3,9
Solestro,malganis,288,priest,discipline,12,3,9
Chirho,malganis,288,priest,discipline,18,3,15
Pravant,illidan,288,priest,discipline,18,3,15
Selson,stormrage,288,priest,discipline,18,3,15
Imgold,emerald-dream,287,priest,discipline,6,3,3
Wobbleskank,tichondrius,287,priest,discipline,6,3,3
Solzal,korgath,287,priest,discipline,6,3,3
Kagayaku,aegwynn,287,priest,discipline,12,3,9
Zarakih,azralon,287,priest,discipline,12,3,9
Priestkofwa,tichondrius,287,priest,discipline,12,3,9
Dorkulous,wyrmrest-accord,287,priest,discipline,12,3,9
Zanyp,akama,287,priest,discipline,12,3,9
Celticó,quelthalas,287,priest,discipline,12,3,9
Zeun,spinebreaker,287,priest,discipline,18,3,15
Sorros,cenarion-circle,286,priest,discipline,6,3,3
Kataró,tichondrius,286,priest,discipline,12,3,9
Álûcard,illidan,256,priest,discipline,7,4,3
Kagura,dunemaul,256,priest,discipline,22,3,19
Poodledad,wyrmrest-accord,255,priest,discipline,8,4,4
Priestcarry,tichondrius,255,priest,discipline,8,4,4
Toddo,trollbane,255,priest,discipline,8,4,4
Plaguepumper,sargeras,255,priest,discipline,11,3,8
Stormlighter,proudmoore,255,priest,discipline,11,3,8
Prèèst,proudmoore,255,priest,discipline,11,3,8
Imamu,tichondrius,251,priest,discipline,35,16,19
Fenty,nemesis,250,priest,discipline,12,5,7
Holycwap,stormrage,240,priest,discipline,9,3,6
Snevini,azralon,240,priest,discipline,15,3,12
Skruffles,black-dragonflight,239,priest,discipline,5,3,2
Canô,quelthalas,239,priest,discipline,5,3,2
Pohky,area-52,239,priest,discipline,5,3,2
Taram,ragnaros,239,priest,discipline,5,3,2
Murillio,moon-guard,239,priest,discipline,5,3,2
Mawwt,moon-guard,239,priest,discipline,5,3,2
Yumä,kiljaeden,239,priest,discipline,5,3,2
Sigurdr,muradin,234,priest,discipline,10,6,4
Johnnweedd,ragnaros,234,priest,discipline,8,4,4
Priêsty,stormrage,234,priest,discipline,9,4,5
Gloomyspp,illidan,234,priest,discipline,14,4,10
Islada,illidan,233,priest,discipline,18,4,14
Hycinamun,malganis,223,priest,discipline,8,3,5
Wagonss,stormrage,222,priest,discipline,25,7,18
Reâpêr,kelthuzad,201,priest,discipline,13,4,9
Cruxave,aegwynn,201,priest,discipline,14,4,10
Berzum,chogall,192,priest,discipline,4,3,1
Jedrick,malganis,192,priest,discipline,4,3,1
Deckx,khazgoroth,192,priest,discipline,6,4,2
Notthebappo,malganis,192,priest,discipline,11,4,7
Tedesq,stormrage,192,priest,discipline,9,3,6
Adeston,aggramar,192,priest,discipline,9,3,6
Cryptoccocus,zuljin,192,priest,discipline,6,2,4
Murkqz,azralon,192,priest,discipline,6,2,4
Victordaddy,illidan,192,priest,discipline,6,2,4
Jpandha,azralon,192,priest,discipline,6,2,4
Frojasensei,tichondrius,192,priest,discipline,6,2,4
Haushauha,azralon,192,priest,discipline,6,2,4
Corpsen,frostmourne,192,priest,discipline,6,2,4
Tulip,frostmourne,192,priest,discipline,6,2,4
Stepbroplzno,barthilas,192,priest,discipline,6,2,4
Liljunky,zuljin,192,priest,discipline,6,2,4
Meaning,tichondrius,192,priest,discipline,6,2,4
Goatedhp,dalaran,192,priest,discipline,6,2,4
Viictorea,barthilas,192,priest,discipline,6,2,4
Trienolone,emerald-dream,192,priest,discipline,6,2,4
Heartsblood,whisperwind,192,priest,discipline,6,2,4
Keepfit,proudmoore,192,priest,discipline,6,2,4
Aelap,malganis,192,priest,discipline,6,2,4
Novakaynersj,anetheron,192,priest,discipline,6,2,4
Hotdice,bleeding-hollow,192,priest,discipline,6,2,4
Mayzal,emerald-dream,192,priest,discipline,6,2,4
Jaq,altar-of-storms,192,priest,discipline,6,2,4
Holyshafted,kelthuzad,192,priest,discipline,6,2,4
Irixus,zuljin,192,priest,discipline,6,2,4
Davedawg,emerald-dream,192,priest,discipline,6,2,4
Mindgoblin,terokkar,192,priest,discipline,6,2,4
Wiccano,stormrage,192,priest,discipline,6,2,4
Mevix,firetree,192,priest,discipline,6,2,4
Zonozan,lightnings-blade,192,priest,discipline,6,2,4
Baldy,arthas,192,priest,discipline,6,2,4
Verboden,kelthuzad,192,priest,discipline,6,2,4
Penicilin,terokkar,192,priest,discipline,6,2,4
Bigmommyxo,whisperwind,192,priest,discipline,6,2,4
Faedre,smolderthorn,192,priest,discipline,6,2,4
Xeroxlivee,tichondrius,192,priest,discipline,6,2,4
Issaley,tichondrius,192,priest,discipline,6,2,4
Kaeruz,stormrage,192,priest,discipline,6,2,4
Qtpriestx,tichondrius,192,priest,discipline,6,2,4
Ansgar,eonar,192,priest,discipline,6,2,4
Evenly,tichondrius,192,priest,discipline,6,2,4
Plaguesus,dalaran,192,priest,discipline,6,2,4
Emptybody,tichondrius,192,priest,discipline,6,2,4
Mattkoster,mannoroth,192,priest,discipline,6,2,4
Redzwhotwo,kelthuzad,192,priest,discipline,6,2,4
Roivas,bleeding-hollow,192,priest,discipline,6,2,4
Ganapati,the-underbog,192,priest,discipline,6,2,4
Hankspank,hakkar,192,priest,discipline,6,2,4
Ocxpriest,azralon,192,priest,discipline,6,2,4
Benjamints,thrall,192,priest,discipline,6,2,4
Feelmydisc,bonechewer,192,priest,discipline,6,2,4
Tygrr,kelthuzad,192,priest,discipline,6,2,4
Infecte,illidan,192,priest,discipline,6,2,4
Rbmxp,barthilas,192,priest,discipline,6,2,4
Coldstone,bloodhoof,192,priest,discipline,6,2,4
Stilla,kelthuzad,192,priest,discipline,6,2,4
Mentiroso,kaelthas,192,priest,discipline,6,2,4
Gwenholy,hakkar,192,priest,discipline,6,2,4
Phatheals,norgannon,192,priest,discipline,6,2,4
Hrathren,caelestrasz,192,priest,discipline,6,2,4
Helorren,nagrand,192,priest,discipline,6,2,4
Halloweenx,area-52,192,priest,discipline,6,2,4
Dimanche,thunderlord,192,priest,discipline,6,2,4
Invain,executus,192,priest,discipline,6,2,4
Radikel,aerie-peak,192,priest,discipline,6,2,4
Lunarras,aggramar,192,priest,discipline,6,2,4
Genevieve,aggramar,192,priest,discipline,6,2,4
Gstvsrrn,tichondrius,192,priest,discipline,6,2,4
Zereht,ragnaros,192,priest,discipline,6,2,4
Pmsñ,tichondrius,192,priest,discipline,6,2,4
Anttila,ragnaros,192,priest,discipline,6,2,4
Keygodx,illidan,192,priest,discipline,6,2,4
Shalther,thrall,192,priest,discipline,6,2,4
Noobepriest,thrall,192,priest,discipline,6,2,4
Halfsorrow,tichondrius,192,priest,discipline,6,2,4
Ligthsoul,ragnaros,192,priest,discipline,6,2,4
Chazzwizz,area-52,192,priest,discipline,6,2,4
Mindfak,bleeding-hollow,192,priest,discipline,6,2,4
Apparìtions,khazgoroth,192,priest,discipline,6,2,4
Vivø,nemesis,192,priest,discipline,6,2,4
Shadowpáin,ragnaros,192,priest,discipline,6,2,4
Xedus,mannoroth,192,priest,discipline,6,2,4
Quasenada,stormrage,192,priest,discipline,6,2,4
Qnarisha,tichondrius,192,priest,discipline,6,2,4
Visìons,tichondrius,192,priest,discipline,6,2,4
Dinkk,stormrage,192,priest,discipline,6,2,4
Dontpvponme,illidan,192,priest,discipline,6,2,4
Patagoniabae,kelthuzad,192,priest,discipline,6,2,4
Brazen,emerald-dream,192,priest,discipline,6,2,4
Darkhel,stormrage,192,priest,discipline,6,2,4
Stiffmeister,bleeding-hollow,192,priest,discipline,6,2,4
Holytipz,stormrage,192,priest,discipline,6,2,4
Budheals,spirestone,192,priest,discipline,6,2,4
Saenax,area-52,192,priest,discipline,6,2,4
Aurilain,emerald-dream,192,priest,discipline,6,2,4
Kimbeloria,bleeding-hollow,192,priest,discipline,6,2,4
Skellieman,malorne,192,priest,discipline,6,2,4
Qmine,tichondrius,192,priest,discipline,6,2,4
Mordaren,arthas,192,priest,discipline,6,2,4
Disc,haomarush,192,priest,discipline,6,2,4
Thangthangin,icecrown,192,priest,discipline,6,2,4
Dilonpi,area-52,192,priest,discipline,6,2,4
Zanyxx,tichondrius,192,priest,discipline,6,2,4
Linaelinatia,area-52,192,priest,discipline,6,2,4
Keaina,malganis,192,priest,discipline,6,2,4
Riztwo,moon-guard,192,priest,discipline,6,2,4
Kharahealer,scilla,192,priest,discipline,6,2,4
Imcutejk,malganis,192,priest,discipline,6,2,4
Çherished,stormrage,192,priest,discipline,6,2,4
Psychonauts,arthas,192,priest,discipline,6,2,4
Amphion,skullcrusher,192,priest,discipline,6,2,4
Anthuss,illidan,192,priest,discipline,6,2,4
Stinkypinkÿ,bleeding-hollow,192,priest,discipline,6,2,4
Yoxxoo,tichondrius,192,priest,discipline,6,2,4
Jàxx,dawnbringer,192,priest,discipline,6,2,4
Skêptic,tichondrius,192,priest,discipline,6,2,4
Kìttý,cenarius,192,priest,discipline,6,2,4
Rickmason,frostmane,192,priest,discipline,6,2,4
Snowlily,illidan,192,priest,discipline,6,2,4
Insomnya,sargeras,192,priest,discipline,6,2,4
Halfdeath,sargeras,192,priest,discipline,6,2,4
Smallz,silvermoon,192,priest,discipline,6,2,4
Bmox,borean-tundra,192,priest,discipline,6,2,4
Downbadbrick,moon-guard,192,priest,discipline,6,2,4
Gwendalynne,tichondrius,192,priest,discipline,6,2,4
Soçks,proudmoore,192,priest,discipline,6,2,4
Roshank,illidan,192,priest,discipline,6,2,4
Rèvrin,sargeras,192,priest,discipline,6,2,4
Járngreipr,nerzhul,192,priest,discipline,6,2,4
Djratlordx,thrall,192,priest,discipline,6,2,4
Krossvoid,thrall,192,priest,discipline,6,2,4
Coffeek,sargeras,192,priest,discipline,6,2,4
Pimeharder,tichondrius,192,priest,discipline,6,2,4
Beymaxll,moon-guard,192,priest,discipline,6,2,4
Templár,dalaran,192,priest,discipline,6,2,4
Railly,skywall,192,priest,discipline,6,2,4
Holydrop,sargeras,192,priest,discipline,6,2,4
Nizama,moon-guard,192,priest,discipline,6,2,4
Meowforheals,sargeras,192,priest,discipline,6,2,4
Krevs,proudmoore,192,priest,discipline,6,2,4
Bestwizardx,tichondrius,192,priest,discipline,6,2,4
Cub,darkspear,192,priest,discipline,6,2,4
Dadin,nerzhul,192,priest,discipline,6,2,4
Fathersins,malganis,192,priest,discipline,6,2,4
Kaldrbock,sargeras,192,priest,discipline,6,2,4
Râven,proudmoore,192,priest,discipline,6,2,4
Machiomora,dunemaul,192,priest,discipline,6,2,4
Mhanaburn,nerzhul,192,priest,discipline,6,2,4
Schadên,wyrmrest-accord,192,priest,discipline,6,2,4
Djwienerbum,darkspear,192,priest,discipline,6,2,4
Castholy,nordrassil,192,priest,discipline,6,2,4
Bubblewrap,wyrmrest-accord,192,priest,discipline,6,2,4
Príest,nordrassil,192,priest,discipline,6,2,4
Ubbzy,illidan,192,priest,discipline,6,2,4
Ucksy,blackrock,192,priest,discipline,6,2,4
Trialla,medivh,192,priest,discipline,6,2,4
Noteenurse,blackrock,192,priest,discipline,6,2,4
Ôp,sargeras,192,priest,discipline,6,2,4
Brokennurse,area-52,192,priest,discipline,7,2,5
Lightski,thunderlord,192,priest,discipline,7,2,5
Patchyemoly,frostmourne,192,priest,discipline,8,2,6
Pragus,emerald-dream,192,priest,discipline,14,3,11
Bolognypony,norgannon,192,priest,discipline,12,2,10
Purpskuurp,malganis,192,priest,discipline,12,2,10
Nudibranch,malganis,192,priest,discipline,12,2,10
Deadmoron,illidan,192,priest,discipline,12,2,10
Vyvanse,azuremyst,192,priest,discipline,12,2,10
Sativacuity,malganis,192,priest,discipline,12,2,10
Meatbaoo,tichondrius,192,priest,discipline,12,2,10
Fiéstah,illidan,192,priest,discipline,12,2,10
Lûdløw,kelthuzad,192,priest,discipline,12,2,10
Grâfix,barthilas,192,priest,discipline,12,2,10
Kuazi,frostmourne,192,priest,discipline,12,2,10
Canyounaut,kelthuzad,192,priest,discipline,12,2,10
Ularim,tichondrius,192,priest,discipline,12,2,10
Theryan,ragnaros,192,priest,discipline,12,2,10
Häle,bloodscalp,192,priest,discipline,12,2,10
Skokie,area-52,192,priest,discipline,12,2,10
Capixaba,stormrage,192,priest,discipline,12,2,10
Toguol,stormrage,192,priest,discipline,12,2,10
Weston,bleeding-hollow,192,priest,discipline,12,2,10
Majiinbuu,maelstrom,192,priest,discipline,12,2,10
Rewena,silver-hand,192,priest,discipline,12,2,10
Jazminee,quelthalas,192,priest,discipline,12,2,10
Sukora,blades-edge,192,priest,discipline,12,2,10
Prilance,hyjal,192,priest,discipline,12,2,10
Bilian,dalvengyr,192,priest,discipline,12,2,10
Jordiest,dalaran,192,priest,discipline,12,2,10
Fearward,silvermoon,192,priest,discipline,12,2,10
Ergoproxy,barthilas,192,priest,discipline,18,2,16
Serraphinaa,tichondrius,191,priest,discipline,6,2,4
Charlie,azshara,191,priest,discipline,6,2,4
Myobi,tichondrius,191,priest,discipline,6,2,4
Frothyfran,icecrown,191,priest,discipline,12,2,10
Gabuncher,barthilas,175,priest,discipline,11,2,9
Rektinfull,bladefist,159,priest,discipline,5,2,3
Azrothlol,kul-tiras,159,priest,discipline,5,2,3
Priestmain,thrall,159,priest,discipline,5,2,3
Venzd,illidan,159,priest,discipline,5,2,3
Hotpockets,detheroc,159,priest,discipline,5,2,3
Pugadin,bleeding-hollow,159,priest,discipline,5,2,3
Strict,the-forgotten-coast,159,priest,discipline,5,2,3
Dinogingy,lightbringer,159,priest,discipline,5,2,3
Kloevu,stormrage,159,priest,discipline,5,2,3
Greybearded,korgath,159,priest,discipline,5,2,3
Yuhstin,sargeras,159,priest,discipline,8,3,5
ßßxßß,tichondrius,144,priest,discipline,3,3,0
Franku,quelthalas,143,priest,discipline,3,3,0
Mesiausx,stormrage,138,priest,discipline,8,3,5
Jjaeminkim,area-52,138,priest,discipline,11,4,7
Dreadxshadow,stormrage,138,priest,discipline,11,4,7
Desiree,emerald-dream,138,priest,discipline,13,4,9
Tylennin,hyjal,138,priest,discipline,13,4,9
Ariadneminos,illidan,138,priest,discipline,11,3,8
Theophobe,illidan,138,priest,discipline,19,5,14
Fadinglol,tichondrius,128,priest,discipline,4,2,2
Dangerhealz,frostmourne,128,priest,discipline,4,2,2
Strepsis,icecrown,128,priest,discipline,4,2,2
Voif,proudmoore,128,priest,discipline,4,2,2
Krathe,azralon,128,priest,discipline,4,2,2
Holyfieldx,stormrage,127,priest,discipline,8,2,6
Rustydisc,area-52,127,priest,discipline,8,2,6
Allaurah,thrall,96,priest,discipline,3,2,1
Juvell,illidan,96,priest,discipline,3,2,1
Standback,wyrmrest-accord,96,priest,discipline,3,2,1
Tmspongwo,tichondrius,96,priest,discipline,3,2,1
Fades,hellscream,96,priest,discipline,6,1,5
Radiance,aggramar,96,priest,discipline,6,1,5
Dchi,tichondrius,96,priest,discipline,6,1,5
Breathkeeper,proudmoore,96,priest,discipline,6,1,5
Atzuru,ragnaros,96,priest,discipline,6,1,5
Rahna,azralon,96,priest,discipline,6,1,5
Dirtysline,ragnaros,96,priest,discipline,6,1,5
Beanerall,quelthalas,96,priest,discipline,6,1,5
Drmuhammad,sargeras,96,priest,discipline,6,1,5
Tisifone,ragnaros,96,priest,discipline,6,1,5
Lifejuice,tichondrius,96,priest,discipline,6,1,5
Ugamie,proudmoore,96,priest,discipline,6,1,5
Lzzp,azralon,96,priest,discipline,6,1,5
Floofball,medivh,96,priest,discipline,6,1,5
Doobzy,proudmoore,96,priest,discipline,6,1,5
Halfcab,runetotem,96,priest,discipline,6,1,5
Worstpriest,stormscale,96,priest,discipline,6,1,5
Xiffs,malganis,96,priest,discipline,6,1,5
Stunsilence,tichondrius,96,priest,discipline,6,1,5
Nickerbocker,nazgrel,96,priest,discipline,6,1,5
Löstský,azralon,96,priest,discipline,6,1,5
Iggyp,hyjal,96,priest,discipline,6,1,5
Tabzorbing,illidan,96,priest,discipline,6,1,5
Kunof,ragnaros,96,priest,discipline,6,1,5
Spspsp,illidan,96,priest,discipline,6,1,5
Kireepilef,ragnaros,96,priest,discipline,6,1,5
Ivermectin,eredar,96,priest,discipline,6,1,5
Payforheals,malganis,96,priest,discipline,6,1,5
Nekkz,sargeras,96,priest,discipline,6,1,5
Kimmie,kelthuzad,96,priest,discipline,6,1,5
Necroshine,vashj,96,priest,discipline,6,1,5
Trupriest,alleria,96,priest,discipline,6,1,5
Keynnish,sargeras,96,priest,discipline,6,1,5
Raihn,garrosh,96,priest,discipline,6,1,5
Shaylari,kelthuzad,96,priest,discipline,6,1,5
Yogirabbit,kiljaeden,96,priest,discipline,6,1,5
Mykillakilla,wyrmrest-accord,96,priest,discipline,6,1,5
Religions,wyrmrest-accord,96,priest,discipline,6,1,5
Kalakbar,tichondrius,96,priest,discipline,6,1,5
Vayr,thrall,96,priest,discipline,6,1,5
Lenigrast,blackrock,96,priest,discipline,6,1,5
Prayforhealz,tichondrius,96,priest,discipline,6,1,5
Orethon,thrall,96,priest,discipline,6,1,5
Jaseyrae,emerald-dream,96,priest,discipline,6,1,5
Prayboy,aerie-peak,96,priest,discipline,6,1,5
Shåde,skullcrusher,96,priest,discipline,6,1,5
Baerybonds,kiljaeden,96,priest,discipline,6,1,5
Aeøns,sargeras,96,priest,discipline,6,1,5
Mistnamed,emerald-dream,96,priest,discipline,6,1,5
Gódriç,emerald-dream,96,priest,discipline,6,1,5
Drkwingduckz,area-52,96,priest,discipline,6,1,5
Ayzen,emerald-dream,96,priest,discipline,6,1,5
Aneresxo,illidan,96,priest,discipline,6,1,5
Spêc,frostmourne,96,priest,discipline,6,1,5
Djriest,sargeras,96,priest,discipline,6,1,5
Leach,darkspear,96,priest,discipline,6,1,5
Holddacheese,area-52,96,priest,discipline,6,1,5
Mynaevis,malganis,96,priest,discipline,6,1,5
Púrg,frostmourne,96,priest,discipline,6,1,5
Ripchadman,tichondrius,96,priest,discipline,6,1,5
Mïsstres,area-52,96,priest,discipline,6,1,5
Wilcarfegus,draka,96,priest,discipline,6,1,5
Thh,emerald-dream,96,priest,discipline,6,1,5
Trixor,area-52,96,priest,discipline,6,1,5
Blosinrosin,lightbringer,96,priest,discipline,6,1,5
Snotanygood,alleria,96,priest,discipline,6,1,5
Soliidsnake,area-52,96,priest,discipline,6,1,5
Rookieone,thrall,96,priest,discipline,6,1,5
Dáhealz,tichondrius,96,priest,discipline,6,1,5
Beeds,sargeras,96,priest,discipline,6,1,5
Pétt,amanthul,96,priest,discipline,6,1,5
Mêatpuppet,kiljaeden,96,priest,discipline,6,1,5
Sukeena,malganis,96,priest,discipline,6,1,5
Canklez,stormscale,96,priest,discipline,6,1,5
Galice,archimonde,96,priest,discipline,6,1,5
Clárke,tichondrius,96,priest,discipline,6,1,5
Shadeven,nagrand,96,priest,discipline,6,1,5
Cenzlyor,arthas,96,priest,discipline,6,1,5
Tooflyy,sargeras,96,priest,discipline,6,1,5
Common,tichondrius,96,priest,discipline,6,1,5
Ilikis,tichondrius,96,priest,discipline,6,1,5
Battlemage,magtheridon,96,priest,discipline,6,1,5
Minamy,tichondrius,96,priest,discipline,6,1,5
Saltedaddy,tichondrius,96,priest,discipline,6,1,5
Payan,barthilas,96,priest,discipline,6,1,5
Hordehealin,laughing-skull,96,priest,discipline,6,1,5
Billyscousin,chogall,96,priest,discipline,6,1,5
Notgoodatsp,bleeding-hollow,96,priest,discipline,6,1,5
Barelylegalx,tichondrius,96,priest,discipline,6,1,5
Terripriest,sargeras,96,priest,discipline,6,1,5
Skingraft,bleeding-hollow,96,priest,discipline,6,1,5
Mannybtuggin,kelthuzad,96,priest,discipline,6,1,5
Applekrisp,sargeras,96,priest,discipline,6,1,5
Shelleypin,bleeding-hollow,96,priest,discipline,6,1,5
Tichealstwo,tichondrius,96,priest,discipline,6,1,5
Hionlife,tichondrius,96,priest,discipline,6,1,5
Pastortee,sargeras,96,priest,discipline,6,1,5
Escence,jubeithos,96,priest,discipline,6,1,5
Shadowbuzz,barthilas,96,priest,discipline,6,1,5
Scenekîd,moon-guard,96,priest,discipline,6,1,5
Fatherwyatt,bleeding-hollow,96,priest,discipline,6,1,5
Holnderoth,malganis,96,priest,discipline,6,1,5
Legitgayirl,zuljin,96,priest,discipline,6,1,5
Moonideli,moon-guard,96,priest,discipline,6,1,5
Kryoff,illidan,96,priest,discipline,6,1,5
Commotion,dalaran,96,priest,discipline,6,1,5
Yarock,kelthuzad,96,priest,discipline,6,1,5
Pinoculus,illidan,96,priest,discipline,6,1,5
Edessa,lothar,96,priest,discipline,6,1,5
Hangingmeat,jubeithos,96,priest,discipline,6,1,5
Tatereh,illidan,96,priest,discipline,6,1,5
Nonbinary,trollbane,96,priest,discipline,6,1,5
Dwennalous,stormrage,96,priest,discipline,6,1,5
Throwshade,moon-guard,96,priest,discipline,6,1,5
Yessír,stormrage,96,priest,discipline,6,1,5
Priestmika,illidan,96,priest,discipline,6,1,5
Regzi,stormrage,96,priest,discipline,6,1,5
Hampy,illidan,96,priest,discipline,6,1,5
Thasar,azgalor,96,priest,discipline,6,1,5
Mêga,illidan,96,priest,discipline,6,1,5
Råd,illidan,96,priest,discipline,6,1,5
Torgasm,frostmourne,96,priest,discipline,12,1,11
Mallzahar,darkspear,96,priest,discipline,12,1,11
Touchoflife,dragonblight,96,priest,discipline,12,1,11
Chewboppa,zuljin,96,priest,discipline,12,1,11
Erinyn,area-52,96,priest,discipline,12,1,11
Sevenlions,stormrage,96,priest,discipline,12,1,11
Gusgp,tichondrius,96,priest,discipline,12,1,11
Invisibler,tichondrius,96,priest,discipline,12,1,11
Zathog,earthen-ring,96,priest,discipline,12,1,11
Punkndrublic,sargeras,96,priest,discipline,12,1,11
Sifts,proudmoore,96,priest,discipline,12,1,11
Ssmushi,tichondrius,96,priest,discipline,12,1,11
Timéo,zuljin,96,priest,discipline,18,1,17
Õdinson,sargeras,96,priest,discipline,30,1,29
Mixxd,shuhalo,95,priest,discipline,6,1,5
Sáito,area-52,79,priest,discipline,5,1,4
Oldmanlou,spirestone,63,priest,discipline,14,2,12
Wyldpiece,frostmourne,42,priest,discipline,7,3,4
Jqueryy,tichondrius,42,priest,discipline,11,3,8
Bigpimpnz,wildhammer,42,priest,discipline,14,3,11
Tamilu,terenas,42,priest,discipline,10,2,8
Küno,kelthuzad,42,priest,discipline,10,2,8
Londy,area-52,42,priest,discipline,16,3,13
Germies,moon-guard,42,priest,discipline,14,2,12
Alathan,sargeras,31,priest,discipline,2,1,1
Orchidp,tichondrius,2334,priest,shadow,300,185,115
Jennaôrtega,tichondrius,2312,priest,shadow,84,54,30
Yeazy,stormrage,2296,priest,shadow,108,62,46
Pboo,tichondrius,2281,priest,shadow,72,45,27
Ejr,altar-of-storms,2247,priest,shadow,103,55,48
Kishoengi,sargeras,2239,priest,shadow,90,56,34
Disembly,illidan,2223,priest,shadow,87,50,37
Edd,tichondrius,2215,priest,shadow,158,84,74
Yeona,tichondrius,2195,priest,shadow,101,60,41
Mearas,kelthuzad,2189,priest,shadow,88,52,36
Disemble,illidan,2186,priest,shadow,78,44,34
Techbadar,tichondrius,2185,priest,shadow,125,65,60
Eradication,frostmourne,2168,priest,shadow,99,64,35
Zçythe,tichondrius,2158,priest,shadow,84,51,33
Strwbrynaner,sargeras,2153,priest,shadow,180,96,84
Geovanni,barthilas,2147,priest,shadow,89,47,42
Amyyds,illidan,2143,priest,shadow,143,93,50
Moraver,kelthuzad,2141,priest,shadow,74,39,35
Targora,lightninghoof,2138,priest,shadow,96,56,40
Healingstats,tichondrius,2137,priest,shadow,71,38,33
Zyrith,sargeras,2137,priest,shadow,111,58,53
Welplayedman,emerald-dream,2130,priest,shadow,88,53,35
Apbrady,sargeras,2128,priest,shadow,96,52,44
Zlipz,frostmourne,2125,priest,shadow,66,42,24
Oohhmágáá,azralon,2120,priest,shadow,78,56,22
Scandi,tichondrius,2111,priest,shadow,66,39,27
Kottun,stormrage,2110,priest,shadow,66,38,28
Lìám,frostmourne,2110,priest,shadow,187,102,85
Pdfileclass,tichondrius,2106,priest,shadow,72,47,25
Bayter,frostmourne,2105,priest,shadow,181,97,84
Yenïza,illidan,2104,priest,shadow,178,96,82
Cozies,stormreaver,2092,priest,shadow,72,45,27
Dyrr,barthilas,2074,priest,shadow,155,79,76
Dream,tichondrius,2066,priest,shadow,150,73,77
Eunu,tichondrius,2058,priest,shadow,198,99,99
Vtp,frostmourne,2052,priest,shadow,116,66,50
Nekroscream,queldorei,2050,priest,shadow,95,53,42
Xiaozhui,tichondrius,2046,priest,shadow,75,41,34
Spamndam,tichondrius,2045,priest,shadow,54,32,22
Laundryday,korgath,2043,priest,shadow,96,51,45
Criminalsp,frostmourne,2041,priest,shadow,78,39,39
Omenx,emerald-dream,2034,priest,shadow,54,31,23
Shibuu,moon-guard,2024,priest,shadow,82,46,36
Heheheg,tichondrius,2017,priest,shadow,105,56,49
Expr,area-52,2016,priest,shadow,102,56,46
Knowknow,tichondrius,2013,priest,shadow,108,57,51
Maskali,tichondrius,2010,priest,shadow,226,110,116
Palumorp,deathwing,2008,priest,shadow,60,38,22
Zlips,frostmourne,2006,priest,shadow,75,37,38
Gâdzêd,kelthuzad,2003,priest,shadow,62,38,24
Sin,guldan,1999,priest,shadow,302,163,139
Alisasa,tichondrius,1998,priest,shadow,60,35,25
Babyh,tichondrius,1994,priest,shadow,77,41,36
Keygodx,illidan,1977,priest,shadow,59,36,23
Kiriko,mannoroth,1977,priest,shadow,101,56,45
Viyana,stormrage,1977,priest,shadow,204,104,100
Arobahn,tichondrius,1975,priest,shadow,118,62,56
Talbadar,tichondrius,1973,priest,shadow,66,42,24
Blax,stormscale,1972,priest,shadow,78,43,35
Stinkiez,area-52,1972,priest,shadow,259,137,122
Aro,tichondrius,1966,priest,shadow,60,32,28
Mamísonga,ragnaros,1965,priest,shadow,71,35,36
Ombravuota,blades-edge,1964,priest,shadow,207,106,101
Urelz,illidan,1956,priest,shadow,30,21,9
Soapee,illidan,1955,priest,shadow,221,113,108
Gromkekz,area-52,1953,priest,shadow,125,63,62
Greaterfade,stormrage,1952,priest,shadow,60,34,26
Maìden,sargeras,1950,priest,shadow,66,36,30
Louloudots,malganis,1950,priest,shadow,78,41,37
Metasp,sargeras,1947,priest,shadow,84,43,41
Luvkak,tichondrius,1942,priest,shadow,47,27,20
Helmsman,tichondrius,1942,priest,shadow,182,96,86
Yoggsarodney,tichondrius,1941,priest,shadow,43,30,13
Blackoss,sargeras,1933,priest,shadow,75,40,35
Ysuran,moon-guard,1930,priest,shadow,184,106,78
Katallyst,tichondrius,1926,priest,shadow,77,36,41
Kuraga,bleeding-hollow,1923,priest,shadow,338,180,158
Holydose,moon-guard,1921,priest,shadow,114,51,63
Ensanity,stormrage,1920,priest,shadow,126,66,60
Cheesëburg,illidan,1915,priest,shadow,54,28,26
Pbxx,tichondrius,1914,priest,shadow,52,31,21
Remixsp,malganis,1913,priest,shadow,48,28,20
Missyoung,tichondrius,1912,priest,shadow,73,42,31
Bibleblak,stormrage,1907,priest,shadow,84,48,36
Delasoul,malganis,1906,priest,shadow,69,41,28
Ousïa,quelthalas,1905,priest,shadow,88,44,44
Erebusz,tichondrius,1904,priest,shadow,102,51,51
Niark,frostmourne,1893,priest,shadow,52,27,25
Taylorsp,tichondrius,1892,priest,shadow,82,46,36
Meehx,illidan,1886,priest,shadow,102,65,37
Netheerix,tichondrius,1879,priest,shadow,51,30,21
Sênju,thrall,1875,priest,shadow,65,35,30
Marfas,illidan,1873,priest,shadow,74,34,40
Mythsnake,ragnaros,1872,priest,shadow,49,29,20
Soar,ravencrest,1872,priest,shadow,47,26,21
Stresscube,tichondrius,1871,priest,shadow,40,25,15
Emopriestqt,tichondrius,1871,priest,shadow,120,72,48
Atarri,illidan,1868,priest,shadow,54,31,23
Esteedees,bonechewer,1864,priest,shadow,96,55,41
Creapture,zuluhed,1864,priest,shadow,42,24,18
Xayp,kelthuzad,1863,priest,shadow,101,73,28
Keliarc,sargeras,1863,priest,shadow,60,34,26
Voidkay,tichondrius,1862,priest,shadow,42,35,7
Wizkxjwap,tichondrius,1862,priest,shadow,36,24,12
Puppyboyx,moon-guard,1861,priest,shadow,62,31,31
Christmasgal,uldum,1859,priest,shadow,30,27,3
Fungame,malganis,1855,priest,shadow,50,35,15
Evenly,tichondrius,1855,priest,shadow,138,76,62
Itkev,area-52,1854,priest,shadow,35,27,8
Ericzssp,tichondrius,1854,priest,shadow,63,36,27
Couldntbeme,sargeras,1852,priest,shadow,54,31,23
Yberisa,zuljin,1852,priest,shadow,107,54,53
Kattallyst,tichondrius,1851,priest,shadow,42,24,18
Asmødeus,bleeding-hollow,1851,priest,shadow,77,40,37
Echoos,proudmoore,1849,priest,shadow,42,28,14
Yoggismydad,emerald-dream,1847,priest,shadow,48,29,19
Wafflezsp,frostmourne,1847,priest,shadow,120,62,58
Sapoopettas,quelthalas,1845,priest,shadow,54,26,28
Griffsp,sargeras,1844,priest,shadow,203,101,102
Jugeumx,proudmoore,1838,priest,shadow,42,25,17
Soyul,tichondrius,1838,priest,shadow,114,64,50
Drmuhammad,sargeras,1837,priest,shadow,42,25,17
Stankychimpo,malganis,1834,priest,shadow,54,32,22
Estéve,wyrmrest-accord,1834,priest,shadow,113,58,55
Niurouchuan,tichondrius,1834,priest,shadow,62,31,31
Furbog,area-52,1833,priest,shadow,42,31,11
Phubar,stormreaver,1831,priest,shadow,78,34,44
Remedio,emerald-dream,1830,priest,shadow,33,21,12
Jojotwo,illidan,1830,priest,shadow,78,41,37
Cøtt,emerald-dream,1829,priest,shadow,48,30,18
Doma,malganis,1829,priest,shadow,43,26,17
Yb,kelthuzad,1829,priest,shadow,54,32,22
Auttø,area-52,1829,priest,shadow,45,26,19
Kalantris,ragnaros,1828,priest,shadow,64,41,23
Throwshade,moon-guard,1828,priest,shadow,89,56,33
Giriosp,thrall,1827,priest,shadow,31,22,9
Ilovevivien,spirestone,1826,priest,shadow,48,26,22
Celypriest,moon-guard,1825,priest,shadow,30,25,5
What,drakthul,1825,priest,shadow,54,35,19
Ptam,tichondrius,1825,priest,shadow,47,26,21
Silero,dalaran,1824,priest,shadow,116,76,40
Psyfiend,alterac-mountains,1824,priest,shadow,57,31,26
Idiotgarbage,moon-guard,1824,priest,shadow,48,26,22
Insanity,azuremyst,1823,priest,shadow,137,77,60
Snozberry,malganis,1822,priest,shadow,66,36,30
Samsypriest,frostmourne,1821,priest,shadow,64,38,26
Mindslips,tichondrius,1821,priest,shadow,144,82,62
Sodíum,wyrmrest-accord,1821,priest,shadow,65,33,32
Bearoom,frostmourne,1820,priest,shadow,66,39,27
Kydraah,ragnaros,1820,priest,shadow,47,27,20
Plaguesus,dalaran,1820,priest,shadow,64,35,29
Vil,lightnings-blade,1819,priest,shadow,90,50,40
Nevertelsp,malganis,1818,priest,shadow,122,79,43
Disxlyec,barthilas,1817,priest,shadow,142,79,63
Derisha,ragnaros,1817,priest,shadow,110,61,49
Dots,tichondrius,1816,priest,shadow,53,33,20
Katarot,area-52,1816,priest,shadow,51,30,21
Discipline,chogall,1816,priest,shadow,48,26,22
Hollister,illidan,1816,priest,shadow,246,132,114
Blissily,sargeras,1814,priest,shadow,75,47,28
Irasponsible,stormrage,1814,priest,shadow,42,23,19
Holytalk,tichondrius,1814,priest,shadow,60,30,30
Drupith,dalaran,1814,priest,shadow,54,27,27
Nawzyh,emerald-dream,1813,priest,shadow,48,26,22
Melonsoda,stormrage,1813,priest,shadow,48,26,22
Resonator,laughing-skull,1813,priest,shadow,46,22,24
Invain,executus,1812,priest,shadow,30,24,6
Brokenspc,tichondrius,1811,priest,shadow,118,65,53
Ðantex,thrall,1811,priest,shadow,296,155,141
Xannè,tichondrius,1811,priest,shadow,60,30,30
Vamp,proudmoore,1810,priest,shadow,52,34,18
Tomcruisé,zuljin,1810,priest,shadow,54,31,23
Llamabush,malganis,1809,priest,shadow,39,26,13
Doublesix,malganis,1809,priest,shadow,72,43,29
Krelaeren,tichondrius,1809,priest,shadow,65,33,32
Cixelpvp,area-52,1809,priest,shadow,54,26,28
Arthrix,sargeras,1807,priest,shadow,72,46,26
Bumps,zuljin,1807,priest,shadow,76,43,33
Inflate,frostmourne,1807,priest,shadow,114,62,52
Ussmissouri,area-52,1807,priest,shadow,200,107,93
Ericxd,area-52,1807,priest,shadow,77,38,39
Edai,malganis,1806,priest,shadow,229,124,105
Exoticfather,area-52,1806,priest,shadow,66,33,33
Ghostz,alleria,1805,priest,shadow,60,39,21
Jomm,area-52,1805,priest,shadow,69,37,32
Snookp,kiljaeden,1805,priest,shadow,255,132,123
Brickzyhehe,dalaran,1805,priest,shadow,113,58,55
Panndaz,tichondrius,1803,priest,shadow,30,19,11
Inmotion,tichondrius,1803,priest,shadow,30,19,11
Metricdotem,terenas,1803,priest,shadow,42,26,16
Euthanasìa,deathwing,1803,priest,shadow,70,31,39
Korrà,turalyon,1802,priest,shadow,30,19,11
Eclipsë,malganis,1800,priest,shadow,24,19,5
Garpd,tichondrius,1799,priest,shadow,102,57,45
Hástür,quelthalas,1797,priest,shadow,145,79,66
Snoog,tichondrius,1796,priest,shadow,48,25,23
Axelrod,tichondrius,1792,priest,shadow,48,29,19
Jthreetx,kelthuzad,1788,priest,shadow,40,23,17
Zhiwanam,tichondrius,1786,priest,shadow,59,34,25
Lillyp,malganis,1786,priest,shadow,42,21,21
Sleepynuj,stormrage,1784,priest,shadow,72,45,27
Jydge,tichondrius,1780,priest,shadow,39,22,17
Almycn,tichondrius,1776,priest,shadow,56,30,26
Plztrainme,spinebreaker,1776,priest,shadow,124,65,59
Zlowbly,ragnaros,1775,priest,shadow,94,49,45
Saintpleb,sargeras,1772,priest,shadow,113,73,40
Shadowforsho,sargeras,1771,priest,shadow,64,30,34
Tamajka,the-forgotten-coast,1769,priest,shadow,111,55,56
Mindgoblin,terokkar,1768,priest,shadow,60,29,31
Voidgodtko,tichondrius,1763,priest,shadow,36,21,15
Pengwinxl,agamaggan,1761,priest,shadow,42,24,18
Orgasmiq,frostmourne,1755,priest,shadow,84,45,39
Lauretânia,nemesis,1754,priest,shadow,66,35,31
Afromon,suramar,1750,priest,shadow,72,45,27
Mepisth,sargeras,1748,priest,shadow,72,46,26
Impérial,stormrage,1744,priest,shadow,179,107,72
Mindburn,nemesis,1742,priest,shadow,84,38,46
Krytical,illidan,1739,priest,shadow,160,95,65
Ticklefingrs,malganis,1734,priest,shadow,60,35,25
Laokele,tichondrius,1731,priest,shadow,48,29,19
Holyxb,bleeding-hollow,1730,priest,shadow,90,54,36
Dildocrates,darkspear,1730,priest,shadow,48,28,20
Felrynpr,malganis,1729,priest,shadow,41,24,17
Aristedes,thrall,1729,priest,shadow,35,20,15
Xmewo,sargeras,1728,priest,shadow,41,25,16
Lebronjâmes,tichondrius,1726,priest,shadow,42,25,17
Mscleo,lothar,1725,priest,shadow,66,29,37
Milan,dalaran,1724,priest,shadow,81,49,32
Bornagain,gundrak,1723,priest,shadow,41,19,22
Pesca,proudmoore,1721,priest,shadow,90,47,43
Nozp,stormrage,1720,priest,shadow,36,18,18
Voiders,area-52,1718,priest,shadow,187,109,78
Peggable,moon-guard,1718,priest,shadow,42,23,19
Brokentrojan,moon-guard,1718,priest,shadow,48,23,25
Crbandit,moon-guard,1716,priest,shadow,85,54,31
Saevita,area-52,1716,priest,shadow,42,24,18
Soný,stormrage,1715,priest,shadow,69,38,31
Girthed,bloodscalp,1713,priest,shadow,74,40,34
Naosoupriest,azralon,1711,priest,shadow,41,31,10
Bagjoe,illidan,1708,priest,shadow,141,72,69
Royx,stormreaver,1708,priest,shadow,36,18,18
Nishishabi,tichondrius,1707,priest,shadow,48,24,24
Ðemi,zuljin,1706,priest,shadow,78,42,36
Shwayp,zuljin,1702,priest,shadow,36,22,14
Invincible,ragnaros,1701,priest,shadow,48,28,20
Twoboo,bleeding-hollow,1701,priest,shadow,72,40,32
Aformoflove,tichondrius,1700,priest,shadow,41,21,20
Darkenside,moon-guard,1699,priest,shadow,48,28,20
Palmerin,ravencrest,1697,priest,shadow,102,53,49
Shadowblastx,sargeras,1696,priest,shadow,48,29,19
Cavaliersr,ragnaros,1696,priest,shadow,90,53,37
Nvøsuperstar,zuljin,1694,priest,shadow,54,28,26
Álvarez,tichondrius,1689,priest,shadow,98,49,49
Jeseck,quelthalas,1689,priest,shadow,64,31,33
Giveheadpats,moon-guard,1683,priest,shadow,216,118,98
Finfangfoom,laughing-skull,1681,priest,shadow,48,23,25
Himikko,illidan,1680,priest,shadow,40,19,21
Woodney,ragnaros,1676,priest,shadow,30,19,11
Littlewench,sargeras,1676,priest,shadow,86,49,37
Darkvagician,malganis,1676,priest,shadow,36,19,17
Crayon,stormrage,1676,priest,shadow,48,25,23
Cmg,sargeras,1673,priest,shadow,42,22,20
Evx,demon-soul,1673,priest,shadow,96,50,46
Clownface,tichondrius,1671,priest,shadow,42,24,18
Manic,skywall,1671,priest,shadow,144,79,65
Desaros,tichondrius,1668,priest,shadow,102,52,50
Griddly,alterac-mountains,1667,priest,shadow,54,32,22
Kovie,twisting-nether,1667,priest,shadow,194,110,84
Slasheal,caelestrasz,1666,priest,shadow,90,47,43
Nuggs,mannoroth,1665,priest,shadow,42,21,21
Ellindria,spinebreaker,1664,priest,shadow,71,39,32
Xdipi,proudmoore,1662,priest,shadow,44,25,19
Saintjudys,tichondrius,1661,priest,shadow,30,19,11
Dxsc,tichondrius,1661,priest,shadow,30,19,11
Swaggylee,tichondrius,1661,priest,shadow,40,22,18
Zachlol,area-52,1658,priest,shadow,66,36,30
Deadsp,thrall,1657,priest,shadow,115,58,57
Shadowkr,tichondrius,1656,priest,shadow,42,26,16
Uploading,moon-guard,1655,priest,shadow,30,19,11
Pluse,bonechewer,1655,priest,shadow,52,31,21
Ranthrough,tichondrius,1654,priest,shadow,72,47,25
Moonideli,moon-guard,1654,priest,shadow,30,19,11
Ilovealina,gorefiend,1653,priest,shadow,30,21,9
Ulqüiorra,azralon,1652,priest,shadow,30,21,9
Djcyrus,barthilas,1652,priest,shadow,54,28,26
Ayumihamaski,tichondrius,1650,priest,shadow,35,25,10
Nevermôre,area-52,1650,priest,shadow,54,36,18
Vaporachi,emerald-dream,1650,priest,shadow,42,28,14
Dovoso,kargath,1650,priest,shadow,54,30,24
Skrillô,emerald-dream,1650,priest,shadow,53,27,26
Caricius,ravenholdt,1649,priest,shadow,36,20,16
Iceveins,illidan,1649,priest,shadow,36,20,16
Tsmc,moon-guard,1648,priest,shadow,60,32,28
Moralism,moon-guard,1647,priest,shadow,229,129,100
Kultil,dalaran,1646,priest,shadow,72,42,30
Vicara,moon-guard,1646,priest,shadow,42,24,18
Madcaddies,bonechewer,1646,priest,shadow,48,22,26
Painful,malganis,1645,priest,shadow,62,36,26
Amarexlol,stormrage,1645,priest,shadow,60,34,26
Nexumbra,dunemaul,1644,priest,shadow,102,57,45
Sigx,area-52,1643,priest,shadow,30,21,9
Swungzebra,stormrage,1642,priest,shadow,140,83,57
Fantasía,moon-guard,1642,priest,shadow,108,50,58
Destta,stormrage,1641,priest,shadow,34,19,15
Voidazepam,zuljin,1641,priest,shadow,96,53,43
Trenbologni,illidan,1637,priest,shadow,156,90,66
Nullreferenc,frostmourne,1637,priest,shadow,75,42,33
Partypriest,tichondrius,1637,priest,shadow,66,36,30
Scarabless,bleeding-hollow,1637,priest,shadow,90,47,43
Dillydackx,sargeras,1634,priest,shadow,108,60,48
Priestine,dreadmaul,1634,priest,shadow,156,81,75
Alip,tichondrius,1633,priest,shadow,64,41,23
Dispèrsion,darkspear,1633,priest,shadow,52,23,29
Grimdox,tichondrius,1631,priest,shadow,48,36,12
Healingstat,tichondrius,1631,priest,shadow,24,17,7
Cixelp,area-52,1631,priest,shadow,42,23,19
Mushill,tichondrius,1631,priest,shadow,96,48,48
Safe,illidan,1629,priest,shadow,97,51,46
Sarâda,moon-guard,1626,priest,shadow,177,95,82
Fireballingg,tichondrius,1625,priest,shadow,30,18,12
Whysoserious,duskwood,1624,priest,shadow,30,17,13
Chazzwizz,area-52,1624,priest,shadow,36,17,19
Snuffp,sargeras,1623,priest,shadow,108,70,38
Shalla,blackrock,1623,priest,shadow,72,37,35
Bobbyvagene,area-52,1622,priest,shadow,36,17,19
Mêdúsa,area-52,1621,priest,shadow,58,30,28
Rhick,azralon,1619,priest,shadow,83,52,31
Dirtyysanta,tichondrius,1619,priest,shadow,29,18,11
Solstunn,moon-guard,1619,priest,shadow,48,24,24
Ilostmybible,quelthalas,1619,priest,shadow,46,23,23
Iogical,kelthuzad,1618,priest,shadow,116,70,46
Antìdote,tichondrius,1618,priest,shadow,134,77,57
Sînkaî,demon-soul,1617,priest,shadow,118,70,48
Dustnbonez,area-52,1617,priest,shadow,36,20,16
Drossv,shadowmoon,1614,priest,shadow,42,20,22
Scalpell,tichondrius,1613,priest,shadow,191,99,92
Vallfiresp,malganis,1612,priest,shadow,40,22,18
Cxrsed,illidan,1610,priest,shadow,42,22,20
Fxxkdamn,tichondrius,1609,priest,shadow,29,20,9
Sukes,korgath,1609,priest,shadow,49,27,22
Kwõnc,tichondrius,1609,priest,shadow,50,26,24
Adopted,wyrmrest-accord,1608,priest,shadow,66,37,29
Wenger,crushridge,1608,priest,shadow,138,70,68
Dí,illidan,1606,priest,shadow,30,17,13
Bandages,stormreaver,1606,priest,shadow,104,57,47
Shmage,malganis,1606,priest,shadow,54,28,26
Deuz,quelthalas,1606,priest,shadow,84,37,47
Manofmystery,dalaran,1605,priest,shadow,30,19,11
Moc,jubeithos,1605,priest,shadow,36,22,14
Fight,icecrown,1605,priest,shadow,60,33,27
Shadowdurps,area-52,1604,priest,shadow,66,36,30
Murkqz,stormrage,1604,priest,shadow,54,29,25
Clamchowdy,kiljaeden,1603,priest,shadow,27,18,9
Pumpss,area-52,1603,priest,shadow,49,28,21
Perfectz,stormrage,1603,priest,shadow,36,19,17
Shadork,area-52,1602,priest,shadow,49,31,18
Cloax,azgalor,1602,priest,shadow,48,29,19
Aspéct,aegwynn,1602,priest,shadow,30,17,13
Shelize,kirin-tor,1601,priest,shadow,205,100,105
Hotphoyou,moon-guard,1600,priest,shadow,60,39,21
Manifestor,illidan,1600,priest,shadow,86,51,35
Machinecoach,stormrage,1600,priest,shadow,40,20,20
Vyabl,thrall,1599,priest,shadow,42,24,18
Gusho,frostmourne,1599,priest,shadow,175,88,87
Wifegrip,tichondrius,1598,priest,shadow,42,19,23
Radicional,azralon,1596,priest,shadow,36,20,16
Minamy,tichondrius,1593,priest,shadow,30,17,13
Toddmund,tichondrius,1593,priest,shadow,119,62,57
Graviton,tichondrius,1591,priest,shadow,72,40,32
Thaumaturgy,chogall,1590,priest,shadow,36,19,17
Vashrapani,stormrage,1590,priest,shadow,243,124,119
Ayooblitz,guldan,1588,priest,shadow,36,22,14
Fenix,bloodhoof,1588,priest,shadow,40,21,19
Badbwoi,frostmourne,1588,priest,shadow,45,21,24
Ventusp,azralon,1586,priest,shadow,35,21,14
Healzium,blackwater-raiders,1585,priest,shadow,38,18,20
Occult,bloodscalp,1584,priest,shadow,99,48,51
Fâêlyn,wyrmrest-accord,1583,priest,shadow,70,33,37
Deeaann,tichondrius,1582,priest,shadow,251,133,118
Relicsa,proudmoore,1581,priest,shadow,35,20,15
Gineska,tichondrius,1580,priest,shadow,30,18,12
Folesian,tichondrius,1580,priest,shadow,36,20,16
Vaala,jubeithos,1580,priest,shadow,60,30,30
Nodoubt,barthilas,1580,priest,shadow,52,22,30
Ajazz,zuljin,1578,priest,shadow,36,22,14
Nizeurflayzz,tichondrius,1577,priest,shadow,44,26,18
Milkgrabber,bleeding-hollow,1577,priest,shadow,133,71,62
Akuvurá,nemesis,1576,priest,shadow,71,40,31
Brothercarl,stormrage,1576,priest,shadow,48,24,24
Çummiñs,malganis,1575,priest,shadow,36,21,15
Aqurielen,turalyon,1574,priest,shadow,47,31,16
Benjamints,thrall,1574,priest,shadow,66,41,25
Heàvenly,moon-guard,1573,priest,shadow,36,21,15
Raptorjésus,azjolnerub,1573,priest,shadow,36,18,18
Ratleen,malganis,1570,priest,shadow,212,103,109
Greyyan,wyrmrest-accord,1569,priest,shadow,202,113,89
Fancycorpse,tichondrius,1569,priest,shadow,48,19,29
Whitehandpr,tichondrius,1568,priest,shadow,284,144,140
Ddark,tichondrius,1566,priest,shadow,30,19,11
Marantbourge,frostmourne,1566,priest,shadow,75,45,30
Sorrentin,ragnaros,1566,priest,shadow,58,31,27
Pepps,proudmoore,1566,priest,shadow,363,189,174
Crazyherb,azralon,1565,priest,shadow,83,47,36
Iuka,emerald-dream,1565,priest,shadow,153,77,76
Delbringer,moon-guard,1562,priest,shadow,43,26,17
Iminyou,kelthuzad,1561,priest,shadow,84,50,34
Methandrial,hyjal,1561,priest,shadow,99,53,46
Chillypriest,azjolnerub,1560,priest,shadow,36,20,16
Imabeast,stormrage,1560,priest,shadow,58,30,28
Ethandryl,kelthuzad,1558,priest,shadow,39,23,16
Dahliá,frostmourne,1558,priest,shadow,83,45,38
Jojoxxz,illidan,1557,priest,shadow,43,25,18
Alex,boulderfist,1557,priest,shadow,54,31,23
Jeanbi,ragnaros,1556,priest,shadow,138,78,60
Sìnz,area-52,1555,priest,shadow,36,26,10
Hieken,nemesis,1555,priest,shadow,64,38,26
Pnub,aggramar,1555,priest,shadow,35,18,17
Fig,nazgrel,1554,priest,shadow,84,42,42
Nightcráwler,illidan,1553,priest,shadow,42,25,17
Seedisc,kelthuzad,1552,priest,shadow,36,23,13
Tënëbrë,nemesis,1552,priest,shadow,73,43,30
Krazé,tichondrius,1552,priest,shadow,78,39,39
Volkova,quelthalas,1549,priest,shadow,30,19,11
Softs,area-52,1549,priest,shadow,83,42,41
Cyanovoid,thrall,1549,priest,shadow,36,18,18
Dikdik,tichondrius,1547,priest,shadow,30,20,10
Dorraheals,tichondrius,1546,priest,shadow,35,18,17
Boogiê,illidan,1545,priest,shadow,84,48,36
Nøfaith,area-52,1544,priest,shadow,112,50,62
Khelleya,moon-guard,1543,priest,shadow,48,26,22
Suery,hyjal,1542,priest,shadow,84,37,47
Abientot,tichondrius,1539,priest,shadow,84,47,37
Stepho,dalaran,1539,priest,shadow,42,19,23
Bigboyadam,frostmourne,1538,priest,shadow,88,55,33
Púrg,frostmourne,1537,priest,shadow,30,19,11
Lilithice,moon-guard,1537,priest,shadow,48,25,23
Faeinia,elune,1534,priest,shadow,105,61,44
Csheweishan,aerie-peak,1533,priest,shadow,72,39,33
Aethestan,zuljin,1533,priest,shadow,83,37,46
Thenamesnorm,tichondrius,1532,priest,shadow,35,21,14
Dotdotwin,illidan,1531,priest,shadow,71,43,28
Jessticalz,frostmourne,1531,priest,shadow,30,16,14
Mealmassttr,frostmourne,1531,priest,shadow,36,18,18
Vtplz,bleeding-hollow,1530,priest,shadow,29,17,12
Nonamegame,sargeras,1527,priest,shadow,79,41,38
Voidshift,tichondrius,1527,priest,shadow,324,164,160
Sochron,stormrage,1526,priest,shadow,62,28,34
Purpskurp,stormrage,1525,priest,shadow,42,20,22
Ravinny,nemesis,1524,priest,shadow,40,20,20
Mellow,tichondrius,1523,priest,shadow,44,24,20
Beckðn,tichondrius,1523,priest,shadow,94,50,44
Creedence,jubeithos,1521,priest,shadow,53,28,25
Márceline,stormrage,1520,priest,shadow,64,40,24
Xannis,thrall,1517,priest,shadow,68,38,30
Elogant,frostmourne,1516,priest,shadow,48,20,28
Keepitlegal,sargeras,1515,priest,shadow,30,16,14
Èvil,tichondrius,1514,priest,shadow,24,16,8
Pettypriest,dalaran,1514,priest,shadow,60,29,31
Warklaw,frostmourne,1514,priest,shadow,49,20,29
Hurtfeet,sargeras,1507,priest,shadow,44,19,25
Amideus,dunemaul,1507,priest,shadow,42,18,24
Lowkii,malfurion,1505,priest,shadow,63,41,22
Wobbleskank,tichondrius,1505,priest,shadow,84,50,34
Shadylotion,stormrage,1505,priest,shadow,30,16,14
Krythe,laughing-skull,1505,priest,shadow,41,19,22
Ikillfast,tichondrius,1504,priest,shadow,60,34,26
Justfaith,barthilas,1504,priest,shadow,73,35,38
Shadowhazed,tichondrius,1503,priest,shadow,42,23,19
Iuvrainee,area-52,1503,priest,shadow,78,40,38
Frankeebutt,stormrage,1501,priest,shadow,36,22,14
Danoc,tichondrius,1500,priest,shadow,108,53,55
Emlix,tichondrius,1499,priest,shadow,62,33,29
Carniosso,azralon,1498,priest,shadow,116,58,58
Bullma,boulderfist,1494,priest,shadow,22,17,5
Agraciada,illidan,1493,priest,shadow,42,27,15
Dischaffy,shadowmoon,1491,priest,shadow,42,29,13
Azheel,stormrage,1490,priest,shadow,65,26,39
Teeprie,drakthul,1488,priest,shadow,42,27,15
Muurielle,quelthalas,1488,priest,shadow,93,52,41
Rhoku,nesingwary,1488,priest,shadow,42,23,19
Fïo,proudmoore,1488,priest,shadow,72,35,37
Ezrashade,tichondrius,1488,priest,shadow,83,40,43
Vynlanesh,illidan,1486,priest,shadow,102,48,54
Shadelink,tichondrius,1484,priest,shadow,36,16,20
Mockr,kiljaeden,1483,priest,shadow,30,16,14
Plebcakès,sargeras,1482,priest,shadow,49,26,23
Azagthøth,ravenholdt,1478,priest,shadow,239,122,117
Brothofnzoth,emerald-dream,1478,priest,shadow,53,25,28
Swp,sargeras,1476,priest,shadow,48,29,19
Lucael,durotan,1476,priest,shadow,42,23,19
Astoshan,moon-guard,1475,priest,shadow,125,73,52
Pestee,quelthalas,1475,priest,shadow,150,86,64
Rida,zuljin,1467,priest,shadow,50,31,19
Allsmite,aerie-peak,1467,priest,shadow,54,29,25
Flickmybick,sargeras,1466,priest,shadow,81,40,41
Londy,area-52,1464,priest,shadow,272,136,136
Cuaiminator,ragnaros,1463,priest,shadow,87,47,40
Shadeven,nagrand,1463,priest,shadow,39,18,21
Plzdontlos,hyjal,1461,priest,shadow,36,22,14
Xæl,tichondrius,1457,priest,shadow,58,35,23
Terranle,tichondrius,1457,priest,shadow,64,30,34
Fritzi,shattered-hand,1456,priest,shadow,30,17,13
Numinous,wyrmrest-accord,1456,priest,shadow,68,35,33
ßarracuda,illidan,1455,priest,shadow,54,36,18
Lelyna,stormrage,1454,priest,shadow,36,22,14
Øbara,frostmourne,1454,priest,shadow,52,29,23
Supremezx,frostmourne,1453,priest,shadow,30,19,11
Suicider,emerald-dream,1452,priest,shadow,141,67,74
Thelordx,barthilas,1450,priest,shadow,48,23,25
Spoõks,darkspear,1449,priest,shadow,50,21,29
Cpoppa,sargeras,1446,priest,shadow,36,19,17
Kilal,sargeras,1445,priest,shadow,36,24,12
Grizzlysmite,stormrage,1445,priest,shadow,37,17,20
Sezyks,stormrage,1444,priest,shadow,30,23,7
Kadralin,illidan,1443,priest,shadow,72,36,36
Kokai,area-52,1440,priest,shadow,18,15,3
Mentalprison,khazgoroth,1439,priest,shadow,30,15,15
Teddipriest,tichondrius,1438,priest,shadow,24,15,9
Secrèt,tichondrius,1438,priest,shadow,24,15,9
Pastortee,sargeras,1437,priest,shadow,59,33,26
Nüt,malganis,1437,priest,shadow,53,29,24
Hypochondria,moon-guard,1436,priest,shadow,33,20,13
Onegil,tichondrius,1436,priest,shadow,75,38,37
Gershwinner,daggerspine,1436,priest,shadow,30,15,15
Alvorr,ragnaros,1435,priest,shadow,59,36,23
Cathery,tichondrius,1435,priest,shadow,30,15,15
Powerwordcry,stormrage,1434,priest,shadow,48,22,26
Cloribestmom,tichondrius,1433,priest,shadow,24,15,9
Painpaws,moon-guard,1433,priest,shadow,30,15,15
Bbeaie,tichondrius,1433,priest,shadow,30,15,15
Ciem,tichondrius,1431,priest,shadow,24,15,9
Covidchamp,proudmoore,1431,priest,shadow,24,15,9
ßroßraßroski,sargeras,1431,priest,shadow,36,22,14
Sheiizy,azralon,1430,priest,shadow,24,15,9
Nightelffeet,stormrage,1428,priest,shadow,24,15,9
Sandrö,sargeras,1427,priest,shadow,24,15,9
Aguitardient,ragnaros,1426,priest,shadow,33,19,14
Theodorous,frostmourne,1426,priest,shadow,40,22,18
Stusy,tichondrius,1425,priest,shadow,71,44,27
Aedaki,garona,1424,priest,shadow,148,83,65
Mitoloshi,ragnaros,1424,priest,shadow,42,19,23
Corthien,thrall,1422,priest,shadow,18,15,3
Shadowzypher,wyrmrest-accord,1419,priest,shadow,24,15,9
Bigmollet,tichondrius,1418,priest,shadow,77,32,45
Lilmix,hydraxis,1417,priest,shadow,41,26,15
Bûdussy,bonechewer,1417,priest,shadow,31,17,14
Proudigy,lightninghoof,1413,priest,shadow,51,29,22
Strokkerx,azralon,1413,priest,shadow,89,48,41
Showakoi,ragnaros,1412,priest,shadow,54,29,25
Wongÿ,tichondrius,1408,priest,shadow,30,24,6
Sandelios,aggramar,1408,priest,shadow,42,28,14
Imhðtep,ragnaros,1408,priest,shadow,54,26,28
Voidscrypt,thrall,1406,priest,shadow,100,60,40
Chewthefat,darkspear,1406,priest,shadow,29,15,14
Anrop,illidan,1405,priest,shadow,24,16,8
Younext,sargeras,1404,priest,shadow,51,17,34
Bastét,skullcrusher,1402,priest,shadow,108,60,48
Shirubamoya,gurubashi,1401,priest,shadow,41,23,18
Frorgnence,stormrage,1400,priest,shadow,30,22,8
Mindboink,malganis,1399,priest,shadow,76,41,35
Wowgreatgame,tichondrius,1399,priest,shadow,53,27,26
Aghorï,sargeras,1399,priest,shadow,62,28,34
Kuazi,khazgoroth,1398,priest,shadow,125,59,66
Daysgone,bleeding-hollow,1397,priest,shadow,133,74,59
Malikeht,drakkari,1394,priest,shadow,48,25,23
Haø,stormrage,1393,priest,shadow,98,50,48
Ashtahius,ragnaros,1392,priest,shadow,113,65,48
Habann,frostmourne,1392,priest,shadow,140,71,69
Theorym,tichondrius,1391,priest,shadow,22,17,5
Dawnkìn,bleeding-hollow,1390,priest,shadow,132,67,65
Dipírex,azralon,1389,priest,shadow,84,40,44
Mindeas,the-forgotten-coast,1387,priest,shadow,32,15,17
Fäÿë,tichondrius,1386,priest,shadow,54,26,28
Vinasky,moon-guard,1386,priest,shadow,38,16,22
Achíllesheal,stormrage,1385,priest,shadow,101,53,48
Bloodify,azralon,1385,priest,shadow,53,26,27
Juicymist,moon-guard,1382,priest,shadow,196,106,90
Wdnmmd,proudmoore,1382,priest,shadow,91,41,50
Healztonic,dalaran,1380,priest,shadow,72,32,40
Shén,barthilas,1378,priest,shadow,89,59,30
Maynard,ragnaros,1378,priest,shadow,66,35,31
Tye,medivh,1378,priest,shadow,30,15,15
Lawgiva,thrall,1377,priest,shadow,30,19,11
Jadon,sargeras,1377,priest,shadow,38,22,16
Xammys,malganis,1376,priest,shadow,24,16,8
Tjxx,zuljin,1376,priest,shadow,48,28,20
Miniimenx,azralon,1375,priest,shadow,41,29,12
Ssupasonic,tichondrius,1372,priest,shadow,33,16,17
Deadcode,frostmane,1372,priest,shadow,39,16,23
Urspareparts,sargeras,1370,priest,shadow,89,48,41
Spõõky,illidan,1368,priest,shadow,26,15,11
Tyisanity,tichondrius,1368,priest,shadow,68,32,36
Whorticiå,area-52,1366,priest,shadow,101,43,58
Saphet,draktharon,1365,priest,shadow,88,55,33
Aránhell,ragnaros,1365,priest,shadow,48,28,20
Papadoll,malganis,1365,priest,shadow,32,16,16
Lolcrafthd,ragnaros,1364,priest,shadow,30,16,14
Heihunüwang,kargath,1363,priest,shadow,26,15,11
Niias,hyjal,1361,priest,shadow,66,37,29
Scadie,goldrinn,1360,priest,shadow,30,15,15
Duckdemon,ragnaros,1358,priest,shadow,35,16,19
Littlebagel,nesingwary,1357,priest,shadow,24,16,8
Bugsbright,tichondrius,1351,priest,shadow,75,36,39
Poague,area-52,1343,priest,shadow,24,14,10
Task,korgath,1343,priest,shadow,41,18,23
Ukishizumi,tichondrius,1342,priest,shadow,18,14,4
Flay,dragonmaw,1342,priest,shadow,18,14,4
Cixelp,tichondrius,1342,priest,shadow,30,14,16
Verbeka,nemesis,1338,priest,shadow,18,14,4
Aeonar,alleria,1338,priest,shadow,30,16,14
Xionys,sargeras,1336,priest,shadow,42,19,23
Cheez,tichondrius,1336,priest,shadow,64,28,36
Tidals,sargeras,1335,priest,shadow,24,14,10
Nobutter,archimonde,1335,priest,shadow,24,14,10
Scriptö,fizzcrank,1334,priest,shadow,66,44,22
Grianné,mannoroth,1334,priest,shadow,24,16,8
Hüde,stormrage,1334,priest,shadow,102,53,49
Boogle,frostmourne,1333,priest,shadow,59,26,33
Chenny,darkspear,1332,priest,shadow,72,40,32
Dreaminz,tichondrius,1331,priest,shadow,24,14,10
Shadyvoodoo,barthilas,1331,priest,shadow,80,42,38
Likesshadows,tichondrius,1330,priest,shadow,24,17,7
Leach,darkspear,1330,priest,shadow,71,30,41
Labraidor,tichondrius,1329,priest,shadow,77,30,47
Lirien,kelthuzad,1328,priest,shadow,42,15,27
Faedyspriest,sargeras,1327,priest,shadow,24,14,10
Voidork,tichondrius,1323,priest,shadow,24,14,10
Pandarue,tichondrius,1318,priest,shadow,57,30,27
Elam,ragnaros,1318,priest,shadow,42,17,25
Synkiz,darkspear,1316,priest,shadow,39,19,20
Chádeervas,nemesis,1315,priest,shadow,39,24,15
Rammstèin,sargeras,1314,priest,shadow,30,14,16
Phantomz,malganis,1311,priest,shadow,41,25,16
Timreaper,barthilas,1311,priest,shadow,35,21,14
Goodvybz,illidan,1310,priest,shadow,35,15,20
Alisaie,dalvengyr,1308,priest,shadow,52,27,25
Locjawbe,area-52,1307,priest,shadow,35,18,17
Uncletouches,thrall,1303,priest,shadow,30,14,16
Ed,crushridge,1299,priest,shadow,30,16,14
Sekhen,area-52,1298,priest,shadow,49,23,26
Bustmybubble,tichondrius,1297,priest,shadow,50,34,16
Mamofwar,arthas,1296,priest,shadow,66,29,37
Bobbeans,area-52,1295,priest,shadow,30,18,12
Onipapae,frostmourne,1295,priest,shadow,76,39,37
Øvøxø,emerald-dream,1295,priest,shadow,33,15,18
Beautifulgir,illidan,1294,priest,shadow,30,18,12
Reos,jubeithos,1294,priest,shadow,54,32,22
Ampela,dalaran,1293,priest,shadow,37,17,20
Xaneo,kelthuzad,1290,priest,shadow,23,14,9
Ancene,illidan,1290,priest,shadow,42,24,18
Àx,draka,1290,priest,shadow,32,18,14
Hervert,area-52,1289,priest,shadow,36,19,17
Nóin,tichondrius,1289,priest,shadow,65,27,38
Thotsndots,blood-furnace,1288,priest,shadow,26,15,11
Wetleaftx,chogall,1286,priest,shadow,24,15,9
Zeromisx,proudmoore,1279,priest,shadow,28,14,14
Valloren,kalecgos,1278,priest,shadow,26,15,11
Eklunð,proudmoore,1277,priest,shadow,23,14,9
Estelars,aggramar,1276,priest,shadow,115,61,54
Furìøns,nemesis,1275,priest,shadow,24,15,9
Marni,akama,1272,priest,shadow,91,42,49
Healixd,area-52,1271,priest,shadow,36,14,22
Layrissa,whisperwind,1266,priest,shadow,24,15,9
Puerquirri,quelthalas,1266,priest,shadow,30,16,14
Pozcas,blood-furnace,1265,priest,shadow,24,14,10
Shinyspriest,tichondrius,1265,priest,shadow,83,43,40
Lyriczx,kelthuzad,1265,priest,shadow,42,18,24
Festær,area-52,1258,priest,shadow,64,34,30
Shadøwheal,stormrage,1257,priest,shadow,24,16,8
Beneficium,nazjatar,1254,priest,shadow,30,20,10
Synergize,korgath,1254,priest,shadow,60,30,30
Lilpika,illidan,1254,priest,shadow,42,18,24
Stankylegz,tichondrius,1251,priest,shadow,30,16,14
Zolgeta,exodar,1250,priest,shadow,47,31,16
Badnfluence,kiljaeden,1250,priest,shadow,24,14,10
Ketchuslipin,illidan,1249,priest,shadow,34,15,19
Jwx,malganis,1248,priest,shadow,18,13,5
Shadowtreta,azralon,1248,priest,shadow,36,21,15
Madcuzyaknow,bleeding-hollow,1248,priest,shadow,24,13,11
Envyion,sargeras,1248,priest,shadow,24,13,11
Stellur,kelthuzad,1247,priest,shadow,23,14,9
Originull,emerald-dream,1247,priest,shadow,24,13,11
Carbsauce,tichondrius,1246,priest,shadow,18,13,5
Gelato,velen,1246,priest,shadow,24,13,11
Headbrake,malganis,1246,priest,shadow,24,13,11
Avraf,sargeras,1246,priest,shadow,24,13,11
Bubblepop,blackhand,1245,priest,shadow,18,13,5
Fanfansp,tichondrius,1244,priest,shadow,18,13,5
Goodlife,frostmourne,1244,priest,shadow,24,13,11
Yayonaise,tichondrius,1244,priest,shadow,24,13,11
Sakuraginero,illidan,1243,priest,shadow,24,13,11
Shadowjisha,emerald-dream,1243,priest,shadow,33,14,19
Pri,jubeithos,1242,priest,shadow,18,13,5
Amentia,area-52,1242,priest,shadow,24,13,11
Ashidox,proudmoore,1242,priest,shadow,27,14,13
Houzz,frostmourne,1241,priest,shadow,18,13,5
Xedus,mannoroth,1240,priest,shadow,74,37,37
Etan,thrall,1240,priest,shadow,30,15,15
Ascian,daggerspine,1239,priest,shadow,30,13,17
Dilly,tichondrius,1238,priest,shadow,21,14,7
Harisleidy,quelthalas,1237,priest,shadow,32,14,18
Nums,tichondrius,1236,priest,shadow,48,25,23
Chinchillin,demon-soul,1235,priest,shadow,126,67,59
Shadowyeti,illidan,1233,priest,shadow,18,13,5
Cykle,blackrock,1233,priest,shadow,42,13,29
Dockavok,bloodhoof,1232,priest,shadow,18,13,5
Jiedx,tichondrius,1230,priest,shadow,35,14,21
Vanisa,hellscream,1228,priest,shadow,41,20,21
Sempiternus,barthilas,1228,priest,shadow,34,16,18
Kaermor,stormrage,1227,priest,shadow,66,28,38
Simplyfaded,black-dragonflight,1226,priest,shadow,24,13,11
Pfl,area-52,1226,priest,shadow,113,55,58
Jeffgordo,tichondrius,1223,priest,shadow,24,13,11
Antoz,kelthuzad,1222,priest,shadow,49,28,21
Payan,barthilas,1222,priest,shadow,48,24,24
Vílja,moon-guard,1219,priest,shadow,94,41,53
Hephiron,area-52,1219,priest,shadow,59,22,37
Roylwcheese,illidan,1218,priest,shadow,18,13,5
Ramaven,arygos,1213,priest,shadow,36,14,22
Sorrowful,mannoroth,1208,priest,shadow,29,13,16
Zyræl,stormrage,1208,priest,shadow,95,41,54
Castnngcouch,tichondrius,1207,priest,shadow,42,21,21
Demples,darkspear,1202,priest,shadow,24,16,8
Discpi,illidan,1202,priest,shadow,78,34,44
Likeleela,azshara,1201,priest,shadow,33,14,19
Senumbra,tichondrius,1200,priest,shadow,36,16,20
Sècret,tichondrius,1199,priest,shadow,23,13,10
Irangara,gorefiend,1199,priest,shadow,32,14,18
Halselin,senjin,1197,priest,shadow,55,30,25
Messiahp,illidan,1195,priest,shadow,35,13,22
Dockani,sargeras,1192,priest,shadow,54,25,29
Holydarkness,quelthalas,1190,priest,shadow,47,17,30
Foli,zuljin,1187,priest,shadow,22,14,8
Aflstan,frostmourne,1185,priest,shadow,57,34,23
Saltheril,burning-blade,1183,priest,shadow,29,13,16
Pristoleiro,azralon,1182,priest,shadow,17,13,4
Mimósa,quelthalas,1181,priest,shadow,25,14,11
Fullfear,lothar,1178,priest,shadow,26,13,13
Darksheals,barthilas,1176,priest,shadow,30,22,8
Healtheze,kelthuzad,1175,priest,shadow,20,13,7
Abolita,korgath,1171,priest,shadow,84,43,41
Urmorphine,area-52,1168,priest,shadow,197,104,93
Slogger,illidan,1164,priest,shadow,29,13,16
Maricotä,azralon,1161,priest,shadow,24,13,11
Trollypriest,darkspear,1157,priest,shadow,94,44,50
Snakklè,illidan,1152,priest,shadow,18,13,5
Nadrii,illidan,1152,priest,shadow,34,15,19
Bubbyflay,area-52,1151,priest,shadow,18,12,6
Qadris,tichondrius,1150,priest,shadow,30,12,18
Bubbzy,daggerspine,1149,priest,shadow,18,12,6
Nucypher,illidan,1149,priest,shadow,24,12,12
Teccalil,tichondrius,1146,priest,shadow,24,12,12
Dayquills,illidan,1145,priest,shadow,24,12,12
Lidole,barthilas,1145,priest,shadow,30,12,18
Omnivoîd,tichondrius,1144,priest,shadow,24,12,12
Luokni,illidan,1143,priest,shadow,18,12,6
Îcecube,sargeras,1142,priest,shadow,24,12,12
Knglizward,stormrage,1140,priest,shadow,59,33,26
Icytaken,frostmourne,1139,priest,shadow,24,12,12
Kibariyb,drakkari,1139,priest,shadow,30,12,18
Uvebeendead,the-forgotten-coast,1137,priest,shadow,36,18,18
Stellaryn,moon-guard,1137,priest,shadow,30,12,18
Overcastedxo,kelthuzad,1135,priest,shadow,50,28,22
Unholyreáper,magtheridon,1132,priest,shadow,24,12,12
Bestwizardx,tichondrius,1131,priest,shadow,21,13,8
Anathamaz,stormrage,1131,priest,shadow,30,12,18
Faithhealing,zuljin,1128,priest,shadow,50,24,26
Vvti,quelthalas,1125,priest,shadow,28,15,13
Aeingel,amanthul,1124,priest,shadow,36,12,24
Alphawon,area-52,1111,priest,shadow,30,12,18
Võid,tichondrius,1103,priest,shadow,23,12,11
Dernièreplac,blackrock,1098,priest,shadow,21,13,8
Brownie,blackrock,1097,priest,shadow,23,14,9
Misslost,nerzhul,1081,priest,shadow,23,12,11
Scormm,runetotem,1073,priest,shadow,24,13,11
Manofmystery,drenden,1071,priest,shadow,17,12,5
Creata,frostmourne,1071,priest,shadow,19,12,7
Galice,archimonde,1065,priest,shadow,60,30,30
Khaibit,stormrage,1064,priest,shadow,24,15,9
Valeknun,stormrage,1060,priest,shadow,30,21,9
Freebolte,frostmourne,1056,priest,shadow,12,11,1
Lastbubble,area-52,1056,priest,shadow,24,11,13
Patagoniabae,kelthuzad,1055,priest,shadow,12,11,1
Pwrwordsquee,lightbringer,1055,priest,shadow,18,11,7
Spacethug,illidan,1055,priest,shadow,18,11,7
Eskettit,korgath,1054,priest,shadow,12,11,1
Sleezi,emerald-dream,1054,priest,shadow,18,11,7
Fouroneo,tichondrius,1054,priest,shadow,18,11,7
Büd,sargeras,1054,priest,shadow,18,11,7
Plenipotent,moon-guard,1054,priest,shadow,26,15,11
Voltétt,tichondrius,1053,priest,shadow,18,11,7
Eatmyspells,malganis,1053,priest,shadow,24,11,13
Darkshadows,ravenholdt,1052,priest,shadow,18,11,7
Bhruno,proudmoore,1052,priest,shadow,18,11,7
Tydïus,illidan,1052,priest,shadow,18,11,7
Féarlust,demon-soul,1051,priest,shadow,18,11,7
Shadowbee,kargath,1051,priest,shadow,18,11,7
Ivyslays,area-52,1050,priest,shadow,18,11,7
Semillion,tichondrius,1049,priest,shadow,24,11,13
Beeds,sargeras,1048,priest,shadow,66,29,37
Tinypuppyy,sargeras,1047,priest,shadow,37,14,23
Coors,lightnings-blade,1046,priest,shadow,24,11,13
Nocturnalx,moon-guard,1045,priest,shadow,18,11,7
Zeas,moon-guard,1044,priest,shadow,18,11,7
Kàiju,zuljin,1027,priest,shadow,30,11,19
Alzu,ragnaros,1023,priest,shadow,23,11,12
Shämus,dalaran,1014,priest,shadow,24,11,13
Oglilptown,thunderlord,1005,priest,shadow,60,33,27
Ipse,azshara,1002,priest,shadow,66,36,30
Sinkz,ragnaros,992,priest,shadow,16,11,5
Pocket,alleria,991,priest,shadow,22,11,11
Coolbie,korgath,990,priest,shadow,26,11,15
Jhivagosp,tichondrius,988,priest,shadow,22,11,11
Shadowlife,bonechewer,974,priest,shadow,20,11,9
Daemoon,deathwing,973,priest,shadow,20,12,8
Fedodesubaco,gallywix,973,priest,shadow,33,17,16
Discountay,burning-legion,965,priest,shadow,20,11,9
Insindious,sargeras,963,priest,shadow,15,12,3
Mmrassassin,stormrage,960,priest,shadow,12,10,2
Icarryozz,darkspear,960,priest,shadow,12,10,2
Yuhstin,sargeras,960,priest,shadow,12,10,2
Claudiosip,tichondrius,960,priest,shadow,12,10,2
Jugeum,proudmoore,960,priest,shadow,18,10,8
Evilgeniusx,area-52,960,priest,shadow,18,10,8
Anoumenon,tichondrius,960,priest,shadow,18,10,8
Kissmyvoìd,frostmourne,960,priest,shadow,18,10,8
Pèrona,tichondrius,960,priest,shadow,18,10,8
Míslead,kelthuzad,959,priest,shadow,12,10,2
Synergia,drakkari,959,priest,shadow,12,10,2
Rhima,tichondrius,959,priest,shadow,12,10,2
Inflìctìøn,frostmourne,959,priest,shadow,12,10,2
Bestpimp,frostmane,959,priest,shadow,18,10,8
Philmacrakn,stormrage,959,priest,shadow,18,10,8
Delai,dalaran,959,priest,shadow,18,10,8
Xtradotz,tichondrius,959,priest,shadow,18,10,8
Ayzen,emerald-dream,959,priest,shadow,18,10,8
Keepsleepin,stormrage,959,priest,shadow,24,10,14
Terý,dalaran,959,priest,shadow,24,10,14
Ightdoe,zuljin,958,priest,shadow,12,10,2
Vikingkøng,ragnaros,958,priest,shadow,12,10,2
Eraseme,bleeding-hollow,958,priest,shadow,18,10,8
Tatzis,frostmourne,958,priest,shadow,18,10,8
Fathersmits,area-52,958,priest,shadow,18,10,8
Porffy,malygos,958,priest,shadow,18,10,8
Exigyo,quelthalas,957,priest,shadow,23,13,10
Andso,azralon,957,priest,shadow,18,10,8
Maniwa,dentarg,957,priest,shadow,24,10,14
Prickled,zuljin,957,priest,shadow,24,10,14
Rizzle,emerald-dream,956,priest,shadow,18,10,8
Mortivore,azralon,956,priest,shadow,24,10,14
Gankdalf,draktharon,955,priest,shadow,18,10,8
Ralphiez,tichondrius,954,priest,shadow,24,10,14
Ragnálodbrok,ragnaros,953,priest,shadow,18,10,8
Xora,frostmourne,952,priest,shadow,18,10,8
Kflexx,hydraxis,948,priest,shadow,18,10,8
Eslaughter,twisting-nether,945,priest,shadow,18,11,7
Cymin,dalaran,943,priest,shadow,25,12,13
Farnkxd,bleeding-hollow,925,priest,shadow,32,11,21
Hairypenance,sargeras,910,priest,shadow,17,10,7
Thrageqt,sargeras,908,priest,shadow,20,11,9
Amestroada,nemesis,904,priest,shadow,21,11,10
Silmeriá,darkspear,904,priest,shadow,29,11,18
Ràvn,emerald-dream,903,priest,shadow,16,12,4
Ayniah,tichondrius,895,priest,shadow,17,10,7
Exen,moon-guard,894,priest,shadow,18,11,7
Romero,blood-furnace,885,priest,shadow,60,24,36
Berixa,stormscale,883,priest,shadow,11,10,1
Pootzy,malganis,880,priest,shadow,19,10,9
Csonka,stormrage,868,priest,shadow,38,13,25
Æë,area-52,864,priest,shadow,12,9,3
Mudkrab,gundrak,864,priest,shadow,12,9,3
Voidcult,area-52,864,priest,shadow,12,9,3
Taxzury,tichondrius,864,priest,shadow,12,9,3
Ellipses,bleeding-hollow,864,priest,shadow,12,9,3
Kurindrize,illidan,864,priest,shadow,12,9,3
Feverx,tichondrius,864,priest,shadow,12,9,3
Silkyx,tichondrius,864,priest,shadow,18,9,9
Tiernocookie,illidan,864,priest,shadow,18,9,9
Slimfo,sargeras,864,priest,shadow,18,9,9
Wololo,emerald-dream,864,priest,shadow,18,9,9
Stunsilence,sargeras,864,priest,shadow,18,9,9
Swurvexo,bleeding-hollow,864,priest,shadow,24,9,15
Plushys,emerald-dream,863,priest,shadow,12,9,3
Charity,maelstrom,863,priest,shadow,12,9,3
Abednego,area-52,863,priest,shadow,12,9,3
Beloriath,ragnaros,863,priest,shadow,12,9,3
Delrey,sargeras,863,priest,shadow,18,9,9
Küno,kelthuzad,863,priest,shadow,18,9,9
Woosanghong,tichondrius,863,priest,shadow,18,9,9
Ðecease,thrall,863,priest,shadow,18,9,9
Vizioz,tichondrius,863,priest,shadow,18,9,9
Xijinping,chogall,863,priest,shadow,18,9,9
Xiphoidz,frostmourne,863,priest,shadow,18,9,9
Xtcbtc,sargeras,863,priest,shadow,18,9,9
Efxsp,sargeras,863,priest,shadow,24,9,15
Shadhoee,sargeras,863,priest,shadow,30,9,21
ßluedreamx,tichondrius,862,priest,shadow,12,9,3
Everblack,executus,862,priest,shadow,12,9,3
Fadedvoid,malorne,862,priest,shadow,12,9,3
Suirr,tichondrius,862,priest,shadow,12,9,3
Constentien,tichondrius,862,priest,shadow,18,9,9
Vzell,kiljaeden,862,priest,shadow,18,9,9
Dóctóre,thrall,862,priest,shadow,18,9,9
Touchypriest,jaedenar,862,priest,shadow,18,9,9
Arzeuz,ragnaros,862,priest,shadow,18,9,9
Shadowflux,thunderlord,862,priest,shadow,30,9,21
Nekkz,sargeras,861,priest,shadow,12,9,3
Melas,stormrage,861,priest,shadow,24,9,15
Viejiyoh,ragnaros,860,priest,shadow,18,9,9
Wankenobi,stormrage,859,priest,shadow,18,9,9
Methodist,sargeras,859,priest,shadow,24,9,15
Sacerthu,goldrinn,858,priest,shadow,18,9,9
Beansontoast,wyrmrest-accord,857,priest,shadow,12,9,3
Lilmermaid,laughing-skull,857,priest,shadow,18,9,9
Zaxine,moon-guard,854,priest,shadow,30,9,21
Mazahr,stormrage,852,priest,shadow,12,9,3
Hibot,illidan,849,priest,shadow,24,9,15
Lightbanter,emerald-dream,846,priest,shadow,24,9,15
Kagamì,frostmane,843,priest,shadow,31,9,22
Pipiwiwi,tichondrius,831,priest,shadow,16,9,7
Maldicius,emerald-dream,830,priest,shadow,23,9,14
Mortemus,drenden,828,priest,shadow,14,10,4
Blonkie,azgalor,821,priest,shadow,24,10,14
Jeängrey,tichondrius,815,priest,shadow,15,10,5
Stylonious,hyjal,815,priest,shadow,15,9,6
Buc,barthilas,813,priest,shadow,15,9,6
Bobe,sisters-of-elune,810,priest,shadow,17,9,8
Fledgeling,frostmourne,799,priest,shadow,14,9,5
Dazull,bleeding-hollow,768,priest,shadow,12,8,4
Mindfulness,tichondrius,768,priest,shadow,12,8,4
Silentólògy,malganis,768,priest,shadow,12,8,4
Púrplenurple,area-52,768,priest,shadow,12,8,4
Oxycodex,thrall,768,priest,shadow,12,8,4
Voidariah,tichondrius,768,priest,shadow,12,8,4
Mitogen,malganis,768,priest,shadow,12,8,4
Stungods,frostmourne,768,priest,shadow,12,8,4
Nohealerhere,frostmourne,768,priest,shadow,12,8,4
Ruzhi,moon-guard,768,priest,shadow,12,8,4
Skraitbussin,tichondrius,768,priest,shadow,12,8,4
Snackabre,moon-guard,768,priest,shadow,12,8,4
Nutdrip,tichondrius,768,priest,shadow,12,8,4
Àústîn,moon-guard,768,priest,shadow,18,8,10
Enchantrez,frostmourne,768,priest,shadow,18,8,10
Ripchadman,tichondrius,768,priest,shadow,18,8,10
Skepix,lightbringer,768,priest,shadow,18,8,10
Madmelter,emerald-dream,768,priest,shadow,18,8,10
Deacoderx,area-52,768,priest,shadow,18,8,10
Heàl,akama,768,priest,shadow,18,8,10
Drosslolz,illidan,768,priest,shadow,18,8,10
Mydixi,stormrage,768,priest,shadow,18,8,10
Iluvwizkx,malganis,768,priest,shadow,18,8,10
Alucardibee,turalyon,768,priest,shadow,24,8,16
Viq,stormrage,767,priest,shadow,12,8,4
Shadowlords,emerald-dream,767,priest,shadow,12,8,4
Skgangmm,tichondrius,767,priest,shadow,12,8,4
Rogspriest,sargeras,767,priest,shadow,12,8,4
Mugiwarà,stormrage,767,priest,shadow,12,8,4
Sinning,kelthuzad,767,priest,shadow,12,8,4
Hairyboxx,frostmourne,767,priest,shadow,12,8,4
Dyé,hydraxis,767,priest,shadow,12,8,4
Tungus,shadowsong,767,priest,shadow,12,8,4
Oldmanlou,spirestone,767,priest,shadow,12,8,4
Sgssg,illidan,767,priest,shadow,12,8,4
Homonid,moon-guard,767,priest,shadow,12,8,4
Faithplusone,zuljin,767,priest,shadow,12,8,4
Easyrevenge,kelthuzad,767,priest,shadow,12,8,4
Priestzerath,azralon,767,priest,shadow,18,8,10
Valothrian,area-52,767,priest,shadow,18,8,10
Smitepie,malganis,767,priest,shadow,18,8,10
Badxjuju,frostmourne,767,priest,shadow,18,8,10
Twistedtéa,garrosh,767,priest,shadow,18,8,10
Barelylegalx,tichondrius,767,priest,shadow,18,8,10
Sãoleozinho,azralon,766,priest,shadow,12,8,4
Krypts,shadow-council,766,priest,shadow,12,8,4
Solrina,khazgoroth,766,priest,shadow,12,8,4
Jinzan,stormrage,766,priest,shadow,18,8,10
Chroma,amanthul,766,priest,shadow,18,8,10
Sadinho,azralon,766,priest,shadow,24,8,16
Floofball,medivh,765,priest,shadow,12,8,4
Rustinheber,stormscale,765,priest,shadow,12,8,4
Kumojorno,gilneas,765,priest,shadow,18,8,10
Bmô,stormrage,765,priest,shadow,18,8,10
Pactosombrio,azralon,763,priest,shadow,24,8,16
Drkwispers,stormrage,762,priest,shadow,18,8,10
Speckilz,area-52,762,priest,shadow,26,8,18
Sôuljah,skywall,760,priest,shadow,26,10,16
Battlepope,the-scryers,755,priest,shadow,20,9,11
Datcuban,illidan,752,priest,shadow,12,8,4
Memoria,emerald-dream,751,priest,shadow,15,9,6
Gedtemanager,dalaran,749,priest,shadow,12,8,4
Shadzie,sargeras,732,priest,shadow,22,8,14
Strazloraz,baelgun,719,priest,shadow,11,8,3
Meegoshy,azuremyst,718,priest,shadow,17,8,9
Mikó,dawnbringer,714,priest,shadow,29,10,19
Yrrep,kelthuzad,703,priest,shadow,16,8,8
Lucsor,malganis,688,priest,shadow,13,8,5
Bucksp,zuljin,672,priest,shadow,12,7,5
Diddlur,black-dragonflight,672,priest,shadow,12,7,5
Twítch,bonechewer,672,priest,shadow,12,7,5
Blackaries,frostmourne,672,priest,shadow,12,7,5
Didy,dark-iron,672,priest,shadow,12,7,5
Aeøns,sargeras,672,priest,shadow,12,7,5
Deawalker,khaz-modan,672,priest,shadow,12,7,5
Bugweeb,sargeras,672,priest,shadow,12,7,5
Naùtilus,icecrown,672,priest,shadow,12,7,5
Hårper,area-52,672,priest,shadow,12,7,5
Zuuji,frostmourne,672,priest,shadow,12,7,5
Kastwalker,earthen-ring,672,priest,shadow,12,7,5
Scøøb,malganis,672,priest,shadow,12,7,5
Fatzoid,the-forgotten-coast,672,priest,shadow,12,7,5
Jah,frostmourne,672,priest,shadow,12,7,5
Phéonìx,zuljin,672,priest,shadow,12,7,5
Airil,mugthol,672,priest,shadow,12,7,5
Chicoryx,illidan,672,priest,shadow,12,7,5
Duhpriest,frostmourne,672,priest,shadow,12,7,5
Wodturbo,bleeding-hollow,672,priest,shadow,12,7,5
Kwiksi,arthas,672,priest,shadow,12,7,5
Lontra,zangarmarsh,672,priest,shadow,12,7,5
Grëýmåttèr,moon-guard,672,priest,shadow,12,7,5
Mmys,tichondrius,672,priest,shadow,12,7,5
Såx,stormreaver,672,priest,shadow,12,7,5
Moonlightx,destromath,672,priest,shadow,12,7,5
Nazgúl,lothar,672,priest,shadow,12,7,5
Pikeysplol,illidan,672,priest,shadow,12,7,5
Gles,quelthalas,672,priest,shadow,13,7,6
Mòrbídìtý,area-52,672,priest,shadow,13,7,6
Nightious,malganis,672,priest,shadow,18,7,11
Fluttershÿ,ragnaros,672,priest,shadow,18,7,11
Tanzen,andorhal,672,priest,shadow,18,7,11
Synesis,bladefist,672,priest,shadow,18,7,11
Acpriest,tichondrius,672,priest,shadow,18,7,11
Evelën,azralon,672,priest,shadow,18,7,11
Aurilain,emerald-dream,672,priest,shadow,18,7,11
Veressà,quelthalas,672,priest,shadow,22,8,14
Chês,tichondrius,672,priest,shadow,24,7,17
Nastyyshadow,aegwynn,671,priest,shadow,12,7,5
Gaho,tichondrius,671,priest,shadow,12,7,5
Clayphace,darkspear,671,priest,shadow,12,7,5
Voltstein,dalaran,671,priest,shadow,12,7,5
Darkrics,barthilas,671,priest,shadow,12,7,5
Spshady,aegwynn,671,priest,shadow,12,7,5
Preyforme,tichondrius,671,priest,shadow,12,7,5
Ghedeloco,tichondrius,671,priest,shadow,12,7,5
Moonpenance,windrunner,671,priest,shadow,12,7,5
Deffaultz,turalyon,671,priest,shadow,18,7,11
Pottime,tichondrius,671,priest,shadow,18,7,11
Nachòs,wildhammer,671,priest,shadow,18,7,11
Pokeyoobutt,hydraxis,671,priest,shadow,18,7,11
Shimz,andorhal,671,priest,shadow,18,7,11
Heion,detheroc,671,priest,shadow,18,7,11
Torangi,tichondrius,671,priest,shadow,18,7,11
Havefaith,whisperwind,671,priest,shadow,18,7,11
Tonybromoo,kelthuzad,670,priest,shadow,12,7,5
Montcrief,tichondrius,670,priest,shadow,12,7,5
Nerfdisc,azralon,670,priest,shadow,12,7,5
Matafuka,ragnaros,670,priest,shadow,12,7,5
Iseeyoulookn,stormrage,670,priest,shadow,16,8,8
Lyxorr,area-52,670,priest,shadow,18,7,11
Demoñ,deathwing,669,priest,shadow,18,7,11
Gabryanna,emerald-dream,669,priest,shadow,24,7,17
Bellalugosi,auchindoun,667,priest,shadow,12,7,5
Lõkî,malganis,667,priest,shadow,12,7,5
Angro,ragnaros,665,priest,shadow,12,7,5
Lampshayd,sargeras,665,priest,shadow,12,7,5
Crashed,frostmourne,654,priest,shadow,17,7,10
Popejack,stormrage,654,priest,shadow,17,7,10
Metaila,aerie-peak,639,priest,shadow,11,7,4
Lucifena,darkspear,639,priest,shadow,11,7,4
Emmitson,scarlet-crusade,638,priest,shadow,28,7,21
Chiliy,frostmourne,623,priest,shadow,11,7,4
Lzzp,azralon,623,priest,shadow,17,7,10
Ëlliot,stormrage,620,priest,shadow,15,7,8
Kundalini,boulderfist,620,priest,shadow,17,7,10
Rigotakx,illidan,616,priest,shadow,21,8,13
Glek,tichondrius,608,priest,shadow,16,7,9
Propumper,dalaran,607,priest,shadow,11,7,4
Hölyfury,illidan,607,priest,shadow,17,7,10
Seniorpickle,emerald-dream,606,priest,shadow,14,7,7
Flowerpetals,emerald-dream,599,priest,shadow,21,7,14
Nylaza,kiljaeden,592,priest,shadow,19,7,12
Mastahmind,illidan,591,priest,shadow,13,7,6
Ìforted,zuljin,587,priest,shadow,19,7,12
Nayzarh,darkspear,576,priest,shadow,6,6,0
Blindingstar,area-52,576,priest,shadow,6,6,0
Holyfüry,ragnaros,576,priest,shadow,6,6,0
Applepiezz,tichondrius,576,priest,shadow,6,6,0
Sydgames,area-52,576,priest,shadow,6,6,0
Henrywhopper,fizzcrank,576,priest,shadow,6,6,0
Iamjakehill,area-52,576,priest,shadow,6,6,0
Innovate,dragonmaw,576,priest,shadow,6,6,0
Stromile,tichondrius,576,priest,shadow,6,6,0
Moonwald,moon-guard,576,priest,shadow,6,6,0
Zhadowbolts,thrall,576,priest,shadow,6,6,0
Deckx,khazgoroth,576,priest,shadow,10,7,3
Sacerdotick,gallywix,576,priest,shadow,12,6,6
Yeeko,kiljaeden,576,priest,shadow,12,6,6
Slpox,sargeras,576,priest,shadow,12,6,6
Saitii,dalaran,576,priest,shadow,12,6,6
Lostnlight,aggramar,576,priest,shadow,12,6,6
Whosjoe,tichondrius,576,priest,shadow,12,6,6
Rebdomine,magtheridon,576,priest,shadow,12,6,6
Tmspongwo,tichondrius,576,priest,shadow,12,6,6
Bipölar,area-52,576,priest,shadow,12,6,6
Luzira,stormrage,576,priest,shadow,12,6,6
Kk,fizzcrank,576,priest,shadow,12,6,6
Virsyti,area-52,576,priest,shadow,12,6,6
Rachelstarrx,hyjal,576,priest,shadow,12,6,6
Drognar,lightbringer,576,priest,shadow,12,6,6
Peedofile,frostmourne,576,priest,shadow,12,6,6
Imshadow,azralon,576,priest,shadow,12,6,6
Zonozan,lightnings-blade,576,priest,shadow,12,6,6
Faenzal,area-52,576,priest,shadow,12,6,6
Fitchbucker,sargeras,576,priest,shadow,12,6,6
Wheelson,wildhammer,576,priest,shadow,12,6,6
Kessavannell,frostwolf,576,priest,shadow,12,6,6
Valerift,moon-guard,576,priest,shadow,12,6,6
Mks,barthilas,576,priest,shadow,12,6,6
Jmanhealz,stormrage,576,priest,shadow,12,6,6
Bearuwu,frostmourne,576,priest,shadow,12,6,6
Jeremyissped,proudmoore,576,priest,shadow,12,6,6
Studiosxz,tichondrius,576,priest,shadow,12,6,6
Verbane,frostmourne,576,priest,shadow,12,6,6
Frúdgé,illidan,576,priest,shadow,12,6,6
Spookyman,malganis,576,priest,shadow,12,6,6
Froackey,agamaggan,576,priest,shadow,12,6,6
Ershackleton,illidan,576,priest,shadow,12,6,6
Rahtals,malganis,576,priest,shadow,12,6,6
Coral,stormscale,576,priest,shadow,12,6,6
Pønt,sargeras,576,priest,shadow,12,6,6
Ôverweight,sargeras,576,priest,shadow,12,6,6
Spriestbro,emerald-dream,576,priest,shadow,12,6,6
Voidhearted,tichondrius,576,priest,shadow,12,6,6
Yungjim,the-forgotten-coast,576,priest,shadow,12,6,6
Sped,saurfang,576,priest,shadow,12,6,6
Evansong,frostmane,576,priest,shadow,12,6,6
Toddo,trollbane,576,priest,shadow,12,6,6
Catmasters,area-52,576,priest,shadow,13,6,7
Fruitjuice,arthas,576,priest,shadow,18,6,12
Caeda,icecrown,576,priest,shadow,18,6,12
Osmatspriest,firetree,576,priest,shadow,18,6,12
Soulrulerx,tichondrius,576,priest,shadow,18,6,12
Mindgamez,stormreaver,576,priest,shadow,18,6,12
Jexso,tichondrius,576,priest,shadow,19,6,13
Xð,jubeithos,575,priest,shadow,12,6,6
Grympriest,wyrmrest-accord,575,priest,shadow,12,6,6
Xinthra,stormrage,575,priest,shadow,12,6,6
Debbie,cairne,575,priest,shadow,12,6,6
Drsonny,proudmoore,575,priest,shadow,12,6,6
Krooked,kelthuzad,575,priest,shadow,12,6,6
Mìdnìght,ragnaros,575,priest,shadow,12,6,6
Çovidònenine,tichondrius,575,priest,shadow,12,6,6
Thrilas,silver-hand,575,priest,shadow,12,6,6
Ricksanchez,moonrunner,575,priest,shadow,12,6,6
Unclelively,dragonmaw,575,priest,shadow,12,6,6
Luminous,moon-guard,575,priest,shadow,12,6,6
Vashyy,stormrage,575,priest,shadow,12,6,6
Nyktøs,quelthalas,575,priest,shadow,18,6,12
Vynardis,arygos,575,priest,shadow,18,6,12
Ðaddÿ,bleeding-hollow,574,priest,shadow,12,6,6
Moon,moonrunner,574,priest,shadow,12,6,6
Duhk,moon-guard,574,priest,shadow,12,6,6
Drkvagician,tichondrius,574,priest,shadow,18,6,12
Dhader,area-52,574,priest,shadow,20,6,14
Jamashud,mannoroth,571,priest,shadow,12,6,6
Raelintha,kelthuzad,571,priest,shadow,15,7,8
Shadowbishop,barthilas,570,priest,shadow,12,6,6
Holysheht,icecrown,566,priest,shadow,12,6,6
Rotass,hyjal,559,priest,shadow,11,6,5
Sarkozzlol,tichondrius,543,priest,shadow,8,7,1
Holydestroyr,dentarg,527,priest,shadow,21,6,15
Totorostarp,tichondrius,521,priest,shadow,22,8,14
Ceoofvoid,moon-guard,511,priest,shadow,8,6,2
Hoshx,sargeras,496,priest,shadow,13,6,7
Reignsp,malganis,496,priest,shadow,13,6,7
Nawtyforever,tichondrius,480,priest,shadow,6,5,1
Commotion,dalaran,480,priest,shadow,6,5,1
Rattyp,barthilas,480,priest,shadow,6,5,1
Rykispriest,tichondrius,480,priest,shadow,6,5,1
Jezebëll,nemesis,480,priest,shadow,6,5,1
Potatopriest,stormrage,480,priest,shadow,6,5,1
Kaidow,wyrmrest-accord,480,priest,shadow,6,5,1
Death,firetree,480,priest,shadow,6,5,1
Myòvó,tichondrius,480,priest,shadow,6,5,1
Gaymalenurse,sargeras,480,priest,shadow,6,5,1
Polarnight,zuljin,480,priest,shadow,6,5,1
Ahleven,tichondrius,480,priest,shadow,6,5,1
Bradythree,moon-guard,480,priest,shadow,6,5,1
Jâmïè,gurubashi,480,priest,shadow,6,5,1
Likelydapper,tichondrius,480,priest,shadow,6,5,1
Drteabaghaam,zuljin,480,priest,shadow,6,5,1
Flynni,bleeding-hollow,480,priest,shadow,6,5,1
Tensorflow,tichondrius,480,priest,shadow,6,5,1
Lillyspr,malganis,480,priest,shadow,6,5,1
Plaguepumper,sargeras,480,priest,shadow,6,5,1
Fiéstah,illidan,480,priest,shadow,6,5,1
Altera,drakkari,480,priest,shadow,6,5,1
Megamind,elune,480,priest,shadow,6,5,1
Chervz,chogall,480,priest,shadow,6,5,1
Komy,tichondrius,480,priest,shadow,6,5,1
Hadoka,ragnaros,480,priest,shadow,6,5,1
Diyel,area-52,480,priest,shadow,6,5,1
Ãbelladanger,area-52,480,priest,shadow,6,5,1
Spriesto,frostmourne,480,priest,shadow,6,5,1
Talkura,tichondrius,480,priest,shadow,6,5,1
Seanuts,emerald-dream,480,priest,shadow,6,5,1
Nås,elune,480,priest,shadow,12,5,7
Mookelina,stormrage,480,priest,shadow,12,5,7
Soulistic,arygos,480,priest,shadow,12,5,7
Senadori,azjolnerub,480,priest,shadow,12,5,7
Orderic,ragnaros,480,priest,shadow,12,5,7
Spriest,kul-tiras,480,priest,shadow,12,5,7
Lucariö,area-52,480,priest,shadow,12,5,7
Arataxx,area-52,480,priest,shadow,12,5,7
Moä,nemesis,480,priest,shadow,12,5,7
Littledog,velen,480,priest,shadow,12,5,7
Jenastreaux,wyrmrest-accord,480,priest,shadow,12,5,7
Flukex,tichondrius,480,priest,shadow,12,5,7
Hygeïa,lightbringer,480,priest,shadow,12,5,7
Minnowhead,kelthuzad,480,priest,shadow,12,5,7
Posest,darkspear,480,priest,shadow,12,5,7
Helleamh,tichondrius,480,priest,shadow,12,5,7
Holliebell,zuljin,480,priest,shadow,12,5,7
Kristt,thrall,480,priest,shadow,12,5,7
Optimism,frostmane,480,priest,shadow,12,5,7
Onizukakeiji,hyjal,480,priest,shadow,12,5,7
Haracka,quelthalas,480,priest,shadow,12,5,7
Goblindruid,bleeding-hollow,480,priest,shadow,12,5,7
Bunked,bleeding-hollow,480,priest,shadow,12,5,7
Fatzzbtw,illidan,480,priest,shadow,12,5,7
Yddwin,quelthalas,480,priest,shadow,12,5,7
Shádôws,blackhand,480,priest,shadow,12,5,7
Mdt,tichondrius,480,priest,shadow,12,5,7
Hriest,tichondrius,480,priest,shadow,12,5,7
Zhangtanchi,moon-guard,480,priest,shadow,12,5,7
Salvate,tichondrius,480,priest,shadow,12,5,7
Seraphims,moon-guard,480,priest,shadow,12,5,7
Cryptron,tichondrius,480,priest,shadow,12,5,7
Priestology,echo-isles,480,priest,shadow,12,5,7
Sársaukis,illidan,480,priest,shadow,12,5,7
Sohalexs,tichondrius,480,priest,shadow,12,5,7
Gorebones,emerald-dream,480,priest,shadow,12,5,7
Faydes,arthas,480,priest,shadow,13,5,8
Zerohoür,emerald-dream,480,priest,shadow,16,6,10
Stillmatick,tichondrius,480,priest,shadow,16,6,10
Nedajoon,tichondrius,480,priest,shadow,17,6,11
Astari,illidan,480,priest,shadow,18,5,13
Azrothlol,kul-tiras,480,priest,shadow,18,5,13
Drakracs,doomhammer,480,priest,shadow,18,5,13
Sybal,suramar,480,priest,shadow,19,5,14
Merlynaah,azralon,479,priest,shadow,6,5,1
Paradoxbot,kelthuzad,479,priest,shadow,6,5,1
Cptnrockwèll,dalaran,479,priest,shadow,12,5,7
Wolfeclipse,sargeras,479,priest,shadow,12,5,7
Knoxy,fizzcrank,479,priest,shadow,12,5,7
Rippmmr,frostmourne,479,priest,shadow,18,5,13
Noodloctopus,area-52,478,priest,shadow,10,6,4
Antiraus,aerie-peak,478,priest,shadow,12,5,7
Soonya,arygos,478,priest,shadow,15,5,10
Anttila,ragnaros,447,priest,shadow,11,5,6
Wiiuwiiu,malganis,447,priest,shadow,11,5,6
Forober,queldorei,446,priest,shadow,10,6,4
Aerena,anvilmar,442,priest,shadow,21,7,14
Ryanrealz,tichondrius,432,priest,shadow,9,6,3
Bernhard,azralon,431,priest,shadow,11,5,6
Sohalex,tichondrius,431,priest,shadow,11,5,6
Shietamazon,tichondrius,426,priest,shadow,16,6,10
Dioscura,malganis,416,priest,shadow,10,5,5
Shaurana,stormrage,412,priest,shadow,18,6,12
Nizr,bleeding-hollow,399,priest,shadow,5,5,0
Zeacho,proudmoore,384,priest,shadow,6,4,2
Comoli,tichondrius,384,priest,shadow,6,4,2
Adíos,malganis,384,priest,shadow,6,4,2
Shieldspamx,tichondrius,384,priest,shadow,6,4,2
Quartzolio,azralon,384,priest,shadow,6,4,2
Valtres,tichondrius,384,priest,shadow,6,4,2
Vengep,sargeras,384,priest,shadow,6,4,2
Balverix,tichondrius,384,priest,shadow,6,4,2
Schelleyyuki,tichondrius,384,priest,shadow,6,4,2
Mindflay,tichondrius,384,priest,shadow,6,4,2
Voidathon,sargeras,384,priest,shadow,6,4,2
Minarhy,moon-guard,384,priest,shadow,6,4,2
Iifa,medivh,384,priest,shadow,6,4,2
Shiikari,terenas,384,priest,shadow,6,4,2
Spôoky,illidan,384,priest,shadow,6,4,2
Haedn,azralon,384,priest,shadow,6,4,2
Kks,tichondrius,384,priest,shadow,6,4,2
Despairx,tichondrius,384,priest,shadow,6,4,2
Guillotine,azralon,384,priest,shadow,6,4,2
Chapyh,malganis,384,priest,shadow,6,4,2
Carosene,thrall,384,priest,shadow,6,4,2
Cheach,echo-isles,384,priest,shadow,6,4,2
Feminizm,tichondrius,384,priest,shadow,6,4,2
Dnn,malganis,384,priest,shadow,6,4,2
Ilumus,lightnings-blade,384,priest,shadow,6,4,2
Yuricksus,malganis,384,priest,shadow,6,4,2
Kynyssaelz,proudmoore,384,priest,shadow,6,4,2
Ðrip,burning-legion,384,priest,shadow,6,4,2
Killían,darkspear,384,priest,shadow,6,4,2
Ydonburi,tichondrius,384,priest,shadow,6,4,2
Píty,ragnaros,384,priest,shadow,6,4,2
Itha,illidan,384,priest,shadow,6,4,2
Káldorei,proudmoore,384,priest,shadow,6,4,2
Mygameslaggy,area-52,384,priest,shadow,6,4,2
Unclecam,tichondrius,384,priest,shadow,6,4,2
Rôss,tichondrius,384,priest,shadow,6,4,2
Didittouchme,sargeras,384,priest,shadow,6,4,2
Iemon,vashj,384,priest,shadow,6,4,2
Specter,duskwood,384,priest,shadow,6,4,2
Shådøw,destromath,384,priest,shadow,6,4,2
Ikiteforhash,zuljin,384,priest,shadow,6,4,2
Prostrat,deathwing,384,priest,shadow,6,4,2
Pootang,hyjal,384,priest,shadow,6,4,2
Mutedox,frostmourne,384,priest,shadow,6,4,2
Sungsh,zuljin,384,priest,shadow,6,4,2
Äni,sargeras,384,priest,shadow,6,4,2
Devinere,tichondrius,384,priest,shadow,6,4,2
Rustydisc,area-52,384,priest,shadow,6,4,2
Salanzosp,bleeding-hollow,384,priest,shadow,6,4,2
Diskordia,stormrage,384,priest,shadow,6,4,2
Bigskill,proudmoore,384,priest,shadow,6,4,2
Bax,kilrogg,384,priest,shadow,6,4,2
Shutkap,sargeras,384,priest,shadow,6,4,2
Härpocrates,area-52,384,priest,shadow,6,4,2
Judgejudyx,tichondrius,384,priest,shadow,6,4,2
Prydas,tichondrius,384,priest,shadow,6,4,2
Robertlee,stormrage,384,priest,shadow,6,4,2
Dzikuss,aegwynn,384,priest,shadow,6,4,2
Tethy,saurfang,384,priest,shadow,6,4,2
Tiinkerbell,moon-guard,384,priest,shadow,6,4,2
Mfn,deathwing,384,priest,shadow,11,4,7
Mïndgames,kelthuzad,384,priest,shadow,12,4,8
Mìçah,fizzcrank,384,priest,shadow,12,4,8
Grimmyreap,malygos,384,priest,shadow,12,4,8
Vaeryl,stormrage,384,priest,shadow,12,4,8
Junethegreat,tichondrius,384,priest,shadow,12,4,8
Tuggyp,tichondrius,384,priest,shadow,12,4,8
Influencing,moon-guard,384,priest,shadow,12,4,8
Aerith,barthilas,384,priest,shadow,12,4,8
Dipidorko,proudmoore,384,priest,shadow,12,4,8
Fhelurian,quelthalas,384,priest,shadow,12,4,8
Aliciari,illidan,384,priest,shadow,12,4,8
Brickzy,dalaran,384,priest,shadow,12,4,8
Holydrop,sargeras,384,priest,shadow,12,4,8
Nonbinary,trollbane,384,priest,shadow,12,4,8
Deathbyhot,gorefiend,384,priest,shadow,12,4,8
Nôtthehealer,sargeras,384,priest,shadow,12,4,8
Jxkep,frostmourne,384,priest,shadow,12,4,8
Lätöxïkä,alleria,384,priest,shadow,12,4,8
Reverendpope,tichondrius,384,priest,shadow,12,4,8
Fatäl,moon-guard,384,priest,shadow,12,4,8
Dialis,frostmourne,384,priest,shadow,12,4,8
Jikoguu,stormscale,384,priest,shadow,12,4,8
Oligan,quelthalas,384,priest,shadow,12,4,8
Tidbitsy,malganis,384,priest,shadow,12,4,8
Fáll,bleeding-hollow,384,priest,shadow,12,4,8
Mannyelf,ragnaros,384,priest,shadow,12,4,8
Aexdawg,malganis,384,priest,shadow,12,4,8
Tokaru,frostmourne,384,priest,shadow,12,4,8
Tenaebreu,tichondrius,384,priest,shadow,13,4,9
Temnah,sargeras,384,priest,shadow,18,4,14
Arca,cenarion-circle,384,priest,shadow,18,4,14
Skky,nagrand,383,priest,shadow,6,4,2
Khenshin,ragnaros,383,priest,shadow,6,4,2
Lùcìd,dalaran,383,priest,shadow,6,4,2
Unfriend,sargeras,383,priest,shadow,12,4,8
Rijonkulous,area-52,383,priest,shadow,12,4,8
Jammý,burning-legion,383,priest,shadow,12,4,8
Whisper,zuljin,383,priest,shadow,12,4,8
Hermïs,stormrage,383,priest,shadow,12,4,8
Zyte,stormrage,383,priest,shadow,14,4,10
Nocappappy,tichondrius,383,priest,shadow,18,4,14
Kkpriest,frostmourne,382,priest,shadow,6,4,2
Daisydux,emerald-dream,382,priest,shadow,6,4,2
Geulis,illidan,382,priest,shadow,12,4,8
Bwansandi,blackrock,370,priest,shadow,38,8,30
Sgiath,alleria,330,priest,shadow,15,6,9
Libationz,area-52,329,priest,shadow,19,7,12
Dtbündertree,nordrassil,319,priest,shadow,5,4,1
Peazyqt,tichondrius,304,priest,shadow,7,4,3
Oxytoxin,sargeras,304,priest,shadow,7,4,3
ßoy,amanthul,288,priest,shadow,6,3,3
Chewit,kargath,288,priest,shadow,6,3,3
Enaan,proudmoore,288,priest,shadow,6,3,3
Quantumgoat,tichondrius,288,priest,shadow,6,3,3
Sumrand,frostmourne,288,priest,shadow,6,3,3
Spspsp,illidan,288,priest,shadow,6,3,3
Menorsita,tichondrius,288,priest,shadow,6,3,3
Mhorkarion,quelthalas,288,priest,shadow,6,3,3
Eddysmokes,tichondrius,288,priest,shadow,6,3,3
Caiitlynn,quelthalas,288,priest,shadow,6,3,3
Xandir,kaelthas,288,priest,shadow,6,3,3
Alykus,emerald-dream,288,priest,shadow,6,3,3
Roommatethor,thaurissan,288,priest,shadow,6,3,3
Lucènt,frostmourne,288,priest,shadow,6,3,3
Shakarot,illidan,288,priest,shadow,6,3,3
Achllia,proudmoore,288,priest,shadow,6,3,3
Spõt,stormrage,288,priest,shadow,6,3,3
Oxxymoron,malganis,288,priest,shadow,6,3,3
Intheway,bleeding-hollow,288,priest,shadow,6,3,3
Evaldi,proudmoore,288,priest,shadow,6,3,3
Jaliera,malganis,288,priest,shadow,6,3,3
Exploded,moon-guard,288,priest,shadow,6,3,3
Lolsodacans,malganis,288,priest,shadow,6,3,3
Healiûm,bleeding-hollow,288,priest,shadow,6,3,3
Beibeihang,tichondrius,288,priest,shadow,6,3,3
Kellsyo,hyjal,288,priest,shadow,6,3,3
Monytrain,emerald-dream,288,priest,shadow,6,3,3
Pezziate,tichondrius,288,priest,shadow,6,3,3
Mallox,quelthalas,288,priest,shadow,6,3,3
Shaðows,malganis,288,priest,shadow,6,3,3
Ozzx,stormrage,288,priest,shadow,6,3,3
Toxictampax,azjolnerub,288,priest,shadow,6,3,3
Mightyp,malganis,288,priest,shadow,6,3,3
Vullena,moon-guard,288,priest,shadow,6,3,3
Moselol,tichondrius,288,priest,shadow,6,3,3
Egraner,drakkari,288,priest,shadow,6,3,3
Dispersed,thrall,288,priest,shadow,6,3,3
Runakk,stonemaul,288,priest,shadow,6,3,3
Ej,altar-of-storms,288,priest,shadow,6,3,3
Banmi,tichondrius,288,priest,shadow,6,3,3
Xxmewo,sargeras,288,priest,shadow,6,3,3
Ibringgears,tichondrius,288,priest,shadow,6,3,3
Darkascended,arthas,288,priest,shadow,6,3,3
Pics,emerald-dream,288,priest,shadow,6,3,3
Limèria,emerald-dream,288,priest,shadow,6,3,3
Valsong,argent-dawn,288,priest,shadow,6,3,3
Osarin,sargeras,288,priest,shadow,6,3,3
Nuclease,turalyon,288,priest,shadow,6,3,3
Dontpvponme,illidan,288,priest,shadow,6,3,3
Dumpesitwo,frostmourne,288,priest,shadow,6,3,3
Suki,alleria,288,priest,shadow,6,3,3
Judeath,area-52,288,priest,shadow,6,3,3
Elitë,frostmourne,288,priest,shadow,6,3,3
Soloqqt,tichondrius,288,priest,shadow,6,3,3
Worldhealer,area-52,288,priest,shadow,6,3,3
Aliciab,andorhal,288,priest,shadow,6,3,3
Müyrica,ragnaros,288,priest,shadow,6,3,3
Whalexo,kelthuzad,288,priest,shadow,6,3,3
Voidballs,tichondrius,288,priest,shadow,6,3,3
Xuxu,frostmourne,288,priest,shadow,6,3,3
Samio,area-52,288,priest,shadow,6,3,3
Reâpêr,kelthuzad,288,priest,shadow,6,3,3
Pengwu,moon-guard,288,priest,shadow,6,3,3
Nzuth,dalaran,288,priest,shadow,6,3,3
Russbell,ragnaros,288,priest,shadow,6,3,3
ßìrth,kelthuzad,288,priest,shadow,6,3,3
Ossirus,emerald-dream,288,priest,shadow,6,3,3
Scaadoosh,dalaran,288,priest,shadow,6,3,3
Deathzpirit,kiljaeden,288,priest,shadow,6,3,3
Auras,boulderfist,288,priest,shadow,6,3,3
Halleßerry,illidan,288,priest,shadow,6,3,3
Whittysp,tichondrius,288,priest,shadow,6,3,3
Empyreanlite,dalaran,288,priest,shadow,6,3,3
Bomanic,sargeras,288,priest,shadow,6,3,3
Drelia,jubeithos,288,priest,shadow,6,3,3
Crazchinkin,tichondrius,288,priest,shadow,6,3,3
Randyortonn,tichondrius,288,priest,shadow,6,3,3
Lnoh,area-52,288,priest,shadow,6,3,3
Studpriest,tichondrius,288,priest,shadow,6,3,3
Plumpkinn,kiljaeden,288,priest,shadow,6,3,3
Cappoo,tichondrius,288,priest,shadow,6,3,3
Caramelos,moon-guard,288,priest,shadow,6,3,3
Cerriôus,baelgun,288,priest,shadow,6,3,3
Wrathhealer,hellscream,288,priest,shadow,6,3,3
Sealife,kelthuzad,288,priest,shadow,6,3,3
Shadowp,shattered-halls,288,priest,shadow,6,3,3
Bubbleguppyx,tichondrius,288,priest,shadow,6,3,3
Webba,azshara,288,priest,shadow,6,3,3
Lisau,tichondrius,288,priest,shadow,6,3,3
Haransimongo,area-52,288,priest,shadow,6,3,3
Reginaa,nemesis,288,priest,shadow,6,3,3
Issaley,tichondrius,288,priest,shadow,6,3,3
Avadrah,tichondrius,288,priest,shadow,6,3,3
Lotros,area-52,288,priest,shadow,6,3,3
Synisteria,sargeras,288,priest,shadow,6,3,3
Lemmecastpls,sargeras,288,priest,shadow,6,3,3
Shadowpáin,ragnaros,288,priest,shadow,6,3,3
Earebus,dalaran,288,priest,shadow,6,3,3
Strokkerzin,azralon,288,priest,shadow,6,3,3
Döllyy,illidan,288,priest,shadow,6,3,3
Adelen,illidan,288,priest,shadow,6,3,3
Nizanz,illidan,288,priest,shadow,6,3,3
Mlkchocolate,kelthuzad,288,priest,shadow,6,3,3
Pogchamp,alterac-mountains,288,priest,shadow,6,3,3
Etherrion,area-52,288,priest,shadow,6,3,3
Leyspring,moon-guard,288,priest,shadow,6,3,3
Nellìel,whisperwind,288,priest,shadow,6,3,3
Mynameis,dethecus,288,priest,shadow,6,3,3
Halîth,terenas,288,priest,shadow,6,3,3
Kindyx,ragnaros,288,priest,shadow,6,3,3
Sìkarìa,illidan,288,priest,shadow,6,3,3
Onahaihu,tichondrius,288,priest,shadow,9,4,5
Juícifer,illidan,288,priest,shadow,12,3,9
Poppyp,stormrage,288,priest,shadow,12,3,9
Scaryspise,nathrezim,288,priest,shadow,12,3,9
Shadøwbølt,tichondrius,288,priest,shadow,12,3,9
Dunnbledore,area-52,288,priest,shadow,12,3,9
Mistmare,dalaran,288,priest,shadow,12,3,9
Tylored,zuljin,288,priest,shadow,12,3,9
Xeras,ravencrest,288,priest,shadow,12,3,9
Stantz,burning-legion,288,priest,shadow,12,3,9
Giantqid,malganis,288,priest,shadow,12,3,9
Sybenela,proudmoore,288,priest,shadow,12,3,9
Valuations,tichondrius,288,priest,shadow,12,3,9
Shadowpain,the-underbog,288,priest,shadow,12,3,9
Shadynasti,azshara,287,priest,shadow,6,3,3
Midboss,illidan,287,priest,shadow,6,3,3
Grímmz,veknilash,287,priest,shadow,7,3,4
Telamorstus,illidan,287,priest,shadow,12,3,9
Runswithrain,lethon,271,priest,shadow,17,3,14
Griffsp,stormrage,239,priest,shadow,5,3,2
Actiop,stormrage,223,priest,shadow,8,3,5
Donkeycube,tichondrius,192,priest,shadow,4,3,1
Holyhand,auchindoun,192,priest,shadow,4,3,1
Shadowblax,thrall,192,priest,shadow,4,3,1
Dagaen,thunderlord,192,priest,shadow,6,2,4
Jdcii,tichondrius,192,priest,shadow,6,2,4
Apâthy,area-52,192,priest,shadow,6,2,4
Slctivhealng,area-52,192,priest,shadow,6,2,4
Anxìetý,area-52,192,priest,shadow,6,2,4
Layons,nemesis,192,priest,shadow,6,2,4
Lolsithlord,tichondrius,192,priest,shadow,6,2,4
Vinatt,illidan,192,priest,shadow,6,2,4
Fleshliight,area-52,192,priest,shadow,6,2,4
Quinnx,tichondrius,192,priest,shadow,6,2,4
Bumbleedot,azralon,192,priest,shadow,6,2,4
Psychohazard,area-52,192,priest,shadow,6,2,4
Aliorixa,stormrage,192,priest,shadow,6,2,4
Alukel,moon-guard,192,priest,shadow,6,2,4
Ptheld,tichondrius,192,priest,shadow,6,2,4
Kabutta,stormrage,192,priest,shadow,6,2,4
Selspriest,kelthuzad,192,priest,shadow,6,2,4
Midget,darkspear,192,priest,shadow,6,2,4
Jjaeminkim,area-52,192,priest,shadow,6,2,4
Murkqz,azralon,192,priest,shadow,6,2,4
Clairvoyantt,tichondrius,192,priest,shadow,6,2,4
Voidnoodles,area-52,192,priest,shadow,6,2,4
Ateras,emerald-dream,192,priest,shadow,6,2,4
Nickdeath,tichondrius,192,priest,shadow,6,2,4
Onlyphantoms,kelthuzad,192,priest,shadow,6,2,4
Chellelia,stormrage,192,priest,shadow,6,2,4
Juliusceazer,skywall,192,priest,shadow,6,2,4
Pandiwoodney,ragnaros,192,priest,shadow,6,2,4
Sâltý,stormrage,192,priest,shadow,6,2,4
Detainedz,malganis,192,priest,shadow,6,2,4
Melithor,frostmourne,192,priest,shadow,6,2,4
Lifejuice,tichondrius,192,priest,shadow,6,2,4
Ariellie,area-52,192,priest,shadow,6,2,4
Vanzera,thrall,192,priest,shadow,6,2,4
Orethon,thrall,192,priest,shadow,6,2,4
Kälashnikova,ragnaros,192,priest,shadow,6,2,4
Löstský,azralon,192,priest,shadow,6,2,4
Horsegirls,kelthuzad,192,priest,shadow,6,2,4
Fatherleem,tichondrius,192,priest,shadow,6,2,4
Pugsmugglerr,icecrown,192,priest,shadow,6,2,4
Brounly,drakkari,192,priest,shadow,6,2,4
Rätcömpx,bleeding-hollow,192,priest,shadow,6,2,4
Aape,frostmourne,192,priest,shadow,6,2,4
Nodorme,quelthalas,192,priest,shadow,6,2,4
Notgoodatsp,bleeding-hollow,192,priest,shadow,6,2,4
Enochian,hyjal,192,priest,shadow,6,2,4
Geoat,barthilas,192,priest,shadow,6,2,4
Priést,stormrage,192,priest,shadow,6,2,4
Shrax,emerald-dream,192,priest,shadow,6,2,4
Rucati,cenarius,192,priest,shadow,6,2,4
Judis,barthilas,192,priest,shadow,6,2,4
Dotdotdead,earthen-ring,192,priest,shadow,6,2,4
Sâishâ,proudmoore,192,priest,shadow,6,2,4
Uikaren,tichondrius,192,priest,shadow,6,2,4
Scenekîd,moon-guard,192,priest,shadow,6,2,4
Legitgayirl,zuljin,192,priest,shadow,6,2,4
Sashatwo,proudmoore,192,priest,shadow,6,2,4
Cryptoccocus,zuljin,192,priest,shadow,6,2,4
Kryoff,illidan,192,priest,shadow,6,2,4
Sorojín,zuljin,192,priest,shadow,6,2,4
Beertriarch,frostmourne,192,priest,shadow,6,2,4
Hrathren,caelestrasz,192,priest,shadow,6,2,4
Innergee,aegwynn,192,priest,shadow,6,2,4
Purrpleelff,saurfang,192,priest,shadow,6,2,4
Furryoflife,suramar,192,priest,shadow,6,2,4
Avanise,blackrock,192,priest,shadow,6,2,4
Fruitbasketz,malganis,192,priest,shadow,6,2,4
Byungsik,terenas,192,priest,shadow,6,2,4
Laq,proudmoore,192,priest,shadow,6,2,4
Projectalice,ravencrest,192,priest,shadow,6,2,4
Hevnlyst,proudmoore,192,priest,shadow,6,2,4
Pipete,frostmourne,192,priest,shadow,6,2,4
Clistyn,quelthalas,192,priest,shadow,6,2,4
Hail,kaelthas,192,priest,shadow,6,2,4
Dogfrompark,illidan,192,priest,shadow,6,2,4
Apparìtions,khazgoroth,192,priest,shadow,6,2,4
Sshhaaddooww,tichondrius,192,priest,shadow,6,2,4
Cxmplex,malganis,192,priest,shadow,6,2,4
Shmmoie,frostmourne,192,priest,shadow,6,2,4
Dippyzs,alterac-mountains,192,priest,shadow,6,2,4
Clickbait,spirestone,192,priest,shadow,6,2,4
Tomriddlle,sargeras,192,priest,shadow,6,2,4
Prescella,sargeras,192,priest,shadow,6,2,4
Lemmiewinkzx,sargeras,192,priest,shadow,6,2,4
Kapriestsun,sargeras,192,priest,shadow,6,2,4
Ozztwo,tichondrius,192,priest,shadow,12,2,10
Alizhe,ragnaros,192,priest,shadow,12,2,10
Caristae,kelthuzad,192,priest,shadow,12,2,10
Kulrig,shuhalo,192,priest,shadow,12,2,10
Tmpriest,tichondrius,175,priest,shadow,11,2,9
Chü,dalaran,169,priest,shadow,12,5,7
Vorial,cenarion-circle,159,priest,shadow,5,2,3
Keser,kelthuzad,159,priest,shadow,5,2,3
Dekomori,quelthalas,159,priest,shadow,5,2,3
Tiizz,malganis,159,priest,shadow,5,2,3
Pugadin,bleeding-hollow,159,priest,shadow,5,2,3
Gobananas,bleeding-hollow,159,priest,shadow,5,2,3
Myndz,stormrage,159,priest,shadow,5,2,3
Gaeira,azralon,159,priest,shadow,11,2,9
Winss,tichondrius,128,priest,shadow,4,2,2
Cravex,stormrage,128,priest,shadow,4,2,2
Tanthdrel,proudmoore,128,priest,shadow,6,2,4
Omenous,area-52,128,priest,shadow,10,2,8
Sätîvá,tichondrius,96,priest,shadow,3,2,1
Priestthingz,area-52,96,priest,shadow,8,2,6
Shadowreck,malganis,96,priest,shadow,6,1,5
Shadowftw,illidan,96,priest,shadow,6,1,5
Powerwordwap,malganis,96,priest,shadow,6,1,5
Mangemoélqc,darkspear,96,priest,shadow,6,1,5
Voidrisu,sargeras,96,priest,shadow,6,1,5
Syrillia,wildhammer,96,priest,shadow,6,1,5
Wrinkletink,whisperwind,96,priest,shadow,6,1,5
Fámóus,stormrage,96,priest,shadow,6,1,5
Ibangedaqt,malganis,96,priest,shadow,6,1,5
Asmitä,stormrage,96,priest,shadow,6,1,5
Zymmie,moon-guard,96,priest,shadow,6,1,5
Jèf,stormrage,96,priest,shadow,6,1,5
Sprinkling,sargeras,96,priest,shadow,6,1,5
Icespice,anvilmar,96,priest,shadow,6,1,5
Galestick,illidan,96,priest,shadow,6,1,5
Cärdi,frostmourne,96,priest,shadow,6,1,5
Dadsalad,zuljin,96,priest,shadow,6,1,5
Kelody,zuljin,96,priest,shadow,6,1,5
Mandisa,skywall,96,priest,shadow,6,1,5
Nancynibbler,bleeding-hollow,96,priest,shadow,6,1,5
Oxyy,aerie-peak,96,priest,shadow,6,1,5
Vdip,illidan,96,priest,shadow,6,1,5
Sadury,tichondrius,96,priest,shadow,6,1,5
Tiskka,magtheridon,96,priest,shadow,6,1,5
Shädë,emerald-dream,96,priest,shadow,6,1,5
Rays,drakkari,96,priest,shadow,6,1,5
Baerybonds,kiljaeden,96,priest,shadow,6,1,5
Milliyakk,area-52,96,priest,shadow,6,1,5
Mauriel,proudmoore,96,priest,shadow,6,1,5
Fancyspork,illidan,96,priest,shadow,6,1,5
Releknosleep,frostwolf,96,priest,shadow,6,1,5
Tusket,black-dragonflight,96,priest,shadow,6,1,5
Lilskizz,dalaran,96,priest,shadow,6,1,5
Whatsittoya,tichondrius,96,priest,shadow,6,1,5
Irilde,proudmoore,96,priest,shadow,6,1,5
Bigdaddios,dalaran,96,priest,shadow,6,1,5
Amikam,barthilas,96,priest,shadow,6,1,5
Shadolord,illidan,96,priest,shadow,6,1,5
Dazzlems,tichondrius,96,priest,shadow,6,1,5
Vineller,malganis,96,priest,shadow,6,1,5
Lukaspriest,proudmoore,96,priest,shadow,6,1,5
Lôvecraft,frostmourne,96,priest,shadow,6,1,5
Voidlordx,jubeithos,96,priest,shadow,6,1,5
Omygawd,tichondrius,96,priest,shadow,6,1,5
Psyward,tichondrius,96,priest,shadow,6,1,5
Beliál,ragnaros,96,priest,shadow,6,1,5
Nightboxer,tichondrius,96,priest,shadow,6,1,5
Cultists,tichondrius,96,priest,shadow,6,1,5
Dmlx,frostmourne,96,priest,shadow,6,1,5
Jaquels,sargeras,96,priest,shadow,6,1,5
Paingivër,drakkari,96,priest,shadow,6,1,5
Kodaks,frostmourne,96,priest,shadow,6,1,5
Óst,tichondrius,96,priest,shadow,6,1,5
Slspookyx,tichondrius,96,priest,shadow,6,1,5
Zway,moon-guard,96,priest,shadow,6,1,5
Leliane,tichondrius,96,priest,shadow,6,1,5
Stunsilence,tichondrius,96,priest,shadow,6,1,5
Althlon,emerald-dream,96,priest,shadow,6,1,5
Vyndictus,shattered-hand,96,priest,shadow,6,1,5
Manryu,tichondrius,96,priest,shadow,6,1,5
Lleak,tichondrius,96,priest,shadow,6,1,5
Dawnbréaker,azralon,96,priest,shadow,6,1,5
Jpray,bleeding-hollow,96,priest,shadow,12,1,11
ßugsy,illidan,96,priest,shadow,12,1,11
Murdangus,moon-guard,96,priest,shadow,12,1,11
Bublethenrun,cenarius,79,priest,shadow,5,2,3
Estarì,proudmoore,79,priest,shadow,5,1,4
Xic,thrall,79,priest,shadow,5,1,4
Kunof,ragnaros,79,priest,shadow,5,1,4
Gorry,ragnaros,48,priest,shadow,6,2,4
Fadehojx,illidan,42,priest,shadow,9,2,7
Drpopepurp,tichondrius,31,priest,shadow,2,1,1
Pilixil,bleeding-hollow,16,priest,shadow,1,1,0
Trågédy,azjolnerub,16,priest,shadow,1,1,0
Yellowrose,kelthuzad,2108,rogue,outlaw,121,69,52
Weran,tichondrius,1890,rogue,outlaw,54,28,26
Dvn,stormrage,1844,rogue,outlaw,54,32,22
Welinth,thunderlord,1834,rogue,outlaw,426,219,207
Sadiator,illidan,1810,rogue,outlaw,59,31,28
Millspec,tichondrius,1762,rogue,outlaw,117,58,59
Millspec,zuljin,1730,rogue,outlaw,42,25,17
Dennerdz,tichondrius,1688,rogue,outlaw,47,19,28
Arena,uldum,1665,rogue,outlaw,59,27,32
Lycanthropî,illidan,1655,rogue,outlaw,80,37,43
Gothamzzing,tichondrius,1648,rogue,outlaw,37,20,17
Lardiconn,thrall,1628,rogue,outlaw,42,30,12
Deadracer,moon-guard,1627,rogue,outlaw,60,32,28
Lazeestab,sargeras,1618,rogue,outlaw,172,95,77
Supherr,sargeras,1608,rogue,outlaw,41,20,21
Càgil,stormrage,1607,rogue,outlaw,34,19,15
Jmaxx,tichondrius,1603,rogue,outlaw,51,32,19
Gnøver,ragnaros,1585,rogue,outlaw,88,45,43
Xylvána,kiljaeden,1584,rogue,outlaw,72,32,40
Swingonya,stormrage,1571,rogue,outlaw,36,18,18
Supine,illidan,1539,rogue,outlaw,109,58,51
Mirâge,illidan,1533,rogue,outlaw,50,28,22
Omnïslash,stormrage,1519,rogue,outlaw,48,22,26
Kentaki,tichondrius,1515,rogue,outlaw,60,33,27
Karambit,frostmourne,1486,rogue,outlaw,120,54,66
Blackmont,bleeding-hollow,1483,rogue,outlaw,53,32,21
Velskud,area-52,1456,rogue,outlaw,76,39,37
Jenaki,gurubashi,1442,rogue,outlaw,62,32,30
Jolly,frostmourne,1440,rogue,outlaw,53,22,31
Combo,norgannon,1426,rogue,outlaw,108,62,46
Mgzx,tichondrius,1424,rogue,outlaw,108,60,48
Trêl,velen,1416,rogue,outlaw,99,46,53
Gotosor,quelthalas,1415,rogue,outlaw,144,73,71
Shadowstryfe,tichondrius,1409,rogue,outlaw,47,22,25
Disrawen,ragnaros,1406,rogue,outlaw,359,174,185
Shindeiru,area-52,1399,rogue,outlaw,43,30,13
Luolan,kargath,1378,rogue,outlaw,44,16,28
Bleaklord,emerald-dream,1373,rogue,outlaw,48,17,31
Itsuksiko,quelthalas,1368,rogue,outlaw,63,30,33
Snakeblisken,emerald-dream,1352,rogue,outlaw,36,15,21
Hobblefoot,proudmoore,1340,rogue,outlaw,46,24,22
Dogeggs,area-52,1331,rogue,outlaw,30,14,16
Trillkage,tichondrius,1330,rogue,outlaw,24,14,10
Dross,shadowmoon,1325,rogue,outlaw,30,14,16
Chrisdorner,area-52,1316,rogue,outlaw,25,14,11
Jakamungo,area-52,1315,rogue,outlaw,46,22,24
Reyskywalker,kelthuzad,1303,rogue,outlaw,24,15,9
Shyzuku,drakkari,1303,rogue,outlaw,44,20,24
Ntrfighter,tichondrius,1258,rogue,outlaw,71,36,35
Wátchyoúrbák,wyrmrest-accord,1247,rogue,outlaw,30,14,16
Straite,area-52,1244,rogue,outlaw,24,13,11
Redimído,quelthalas,1244,rogue,outlaw,27,14,13
Houlton,moon-guard,1234,rogue,outlaw,24,13,11
Rynica,illidan,1197,rogue,outlaw,30,17,13
Corevis,moon-guard,1149,rogue,outlaw,24,12,12
Fastblast,wyrmrest-accord,1146,rogue,outlaw,24,12,12
Mabushi,sargeras,1135,rogue,outlaw,42,15,27
Cheddery,dalaran,1130,rogue,outlaw,63,30,33
Zogbu,stormrage,1128,rogue,outlaw,42,17,25
Vanorn,aerie-peak,1108,rogue,outlaw,54,17,37
Adevoir,hakkar,1095,rogue,outlaw,60,31,29
Zarthrox,bladefist,1086,rogue,outlaw,36,18,18
Johnnyelbows,tichondrius,1078,rogue,outlaw,27,13,14
Azarha,zuljin,1060,rogue,outlaw,66,34,32
Tanadoril,wyrmrest-accord,1051,rogue,outlaw,24,11,13
Wujn,tichondrius,1050,rogue,outlaw,24,11,13
Lumifer,quelthalas,1050,rogue,outlaw,54,18,36
Xyleth,azgalor,1048,rogue,outlaw,53,20,33
Thèory,sargeras,1044,rogue,outlaw,24,11,13
Valefarr,emerald-dream,1043,rogue,outlaw,29,13,16
Mechamind,draka,1034,rogue,outlaw,18,11,7
Slitherex,thunderlord,1031,rogue,outlaw,27,12,15
Fryphilip,dalaran,1023,rogue,outlaw,28,11,17
Abatoire,wyrmrest-accord,1020,rogue,outlaw,48,22,26
Thuganomics,dark-iron,1008,rogue,outlaw,27,12,15
Itricku,tichondrius,1008,rogue,outlaw,54,18,36
Lawyergamer,bonechewer,1005,rogue,outlaw,38,16,22
Emoond,ragnaros,989,rogue,outlaw,27,13,14
Farstrider,tichondrius,974,rogue,outlaw,84,33,51
Inhume,eredar,960,rogue,outlaw,24,10,14
Larmx,tichondrius,960,rogue,outlaw,24,10,14
Quapi,tichondrius,959,rogue,outlaw,18,10,8
Preceptor,azralon,956,rogue,outlaw,24,10,14
Nitroxy,quelthalas,950,rogue,outlaw,24,10,14
Badpatatas,proudmoore,913,rogue,outlaw,42,10,32
Shninzy,senjin,910,rogue,outlaw,31,11,20
Zeed,ragnaros,866,rogue,outlaw,66,30,36
Peteylee,stormrage,864,rogue,outlaw,18,9,9
Asdestroyerr,tichondrius,863,rogue,outlaw,18,9,9
Stabbythorus,stormrage,862,rogue,outlaw,18,9,9
Bebesita,sisters-of-elune,860,rogue,outlaw,18,9,9
Phraze,silvermoon,859,rogue,outlaw,30,14,16
Vîllâîn,tichondrius,859,rogue,outlaw,24,9,15
Coalie,tichondrius,816,rogue,outlaw,15,9,6
Deepsyo,frostmourne,768,rogue,outlaw,12,8,4
Lesty,kelthuzad,768,rogue,outlaw,12,8,4
Airi,darkspear,768,rogue,outlaw,18,8,10
Synj,frostmourne,767,rogue,outlaw,12,8,4
Tarnished,ravenholdt,766,rogue,outlaw,24,8,16
Thompson,bloodscalp,672,rogue,outlaw,12,7,5
Minuss,rivendare,671,rogue,outlaw,12,7,5
Drsinz,tichondrius,671,rogue,outlaw,18,7,11
Slowtime,quelthalas,671,rogue,outlaw,18,7,11
Evilkoreanz,tichondrius,670,rogue,outlaw,12,7,5
Cosmicò,trollbane,670,rogue,outlaw,12,7,5
Mhdz,tichondrius,669,rogue,outlaw,12,7,5
Jamesallen,silvermoon,659,rogue,outlaw,12,7,5
Fennick,tanaris,638,rogue,outlaw,25,7,18
Roxy,ghostlands,623,rogue,outlaw,17,7,10
Esky,tichondrius,576,rogue,outlaw,12,6,6
Cathat,area-52,576,rogue,outlaw,12,6,6
Deeppockets,sargeras,576,rogue,outlaw,12,6,6
Cidi,moon-guard,576,rogue,outlaw,18,6,12
Heliopolis,bleeding-hollow,576,rogue,outlaw,18,6,12
Zanith,wyrmrest-accord,575,rogue,outlaw,12,6,6
Sprork,kiljaeden,575,rogue,outlaw,18,6,12
Drakariano,ragnaros,575,rogue,outlaw,18,6,12
Deddyy,zuljin,574,rogue,outlaw,18,6,12
Bonizzi,stormrage,573,rogue,outlaw,12,6,6
Marraya,area-52,573,rogue,outlaw,12,6,6
Listrew,stormrage,571,rogue,outlaw,12,6,6
Maglove,nemesis,571,rogue,outlaw,12,6,6
Hokagesasuke,bleeding-hollow,570,rogue,outlaw,24,6,18
Furrykneecap,hyjal,567,rogue,outlaw,9,7,2
Tmpikaboo,tichondrius,480,rogue,outlaw,6,5,1
Sotypical,area-52,480,rogue,outlaw,6,5,1
Tsubamë,tichondrius,480,rogue,outlaw,6,5,1
Alexyy,blades-edge,480,rogue,outlaw,12,5,7
Galfuran,burning-legion,480,rogue,outlaw,12,5,7
Steviekìcks,frostmourne,480,rogue,outlaw,12,5,7
Bootypie,hyjal,480,rogue,outlaw,12,5,7
Sekkelx,moon-guard,480,rogue,outlaw,12,5,7
Dultz,tichondrius,480,rogue,outlaw,12,5,7
Spikiera,silvermoon,480,rogue,outlaw,18,5,13
Earthinhorn,frostmourne,480,rogue,outlaw,18,5,13
Kasharo,tichondrius,479,rogue,outlaw,12,5,7
Sasskei,malganis,479,rogue,outlaw,12,5,7
Stabbymcgee,duskwood,478,rogue,outlaw,12,5,7
Xzarfi,moon-guard,478,rogue,outlaw,30,5,25
Yerehmi,quelthalas,477,rogue,outlaw,6,5,1
Alerana,dathremar,474,rogue,outlaw,12,5,7
Darthkelso,arathor,465,rogue,outlaw,24,5,19
Flashmob,zuljin,384,rogue,outlaw,6,4,2
Xavar,malganis,384,rogue,outlaw,6,4,2
Krypticstab,malganis,384,rogue,outlaw,6,4,2
Xylvana,kiljaeden,384,rogue,outlaw,6,4,2
Cireene,proudmoore,384,rogue,outlaw,6,4,2
Uzell,sargeras,384,rogue,outlaw,6,4,2
Kents,tichondrius,384,rogue,outlaw,6,4,2
Alandoril,tichondrius,384,rogue,outlaw,6,4,2
Gnòme,frostmourne,384,rogue,outlaw,6,4,2
Shmoked,moon-guard,384,rogue,outlaw,12,4,8
Sazor,ysera,384,rogue,outlaw,12,4,8
Dayvanie,area-52,384,rogue,outlaw,12,4,8
Nestha,quelthalas,384,rogue,outlaw,12,4,8
Showclass,stormrage,384,rogue,outlaw,12,4,8
Blingtronx,malganis,384,rogue,outlaw,12,4,8
Subnini,kelthuzad,384,rogue,outlaw,18,4,14
Gheez,quelthalas,383,rogue,outlaw,6,4,2
Katanië,moon-guard,383,rogue,outlaw,12,4,8
Daftjack,bleeding-hollow,381,rogue,outlaw,12,4,8
Houdinilogic,skullcrusher,381,rogue,outlaw,12,4,8
Ningaturtle,korgath,376,rogue,outlaw,18,4,14
Siamés,quelthalas,319,rogue,outlaw,14,4,10
Nello,runetotem,288,rogue,outlaw,6,3,3
Twnk,stormrage,288,rogue,outlaw,6,3,3
Karmagoodttv,stormrage,288,rogue,outlaw,6,3,3
Instructor,area-52,288,rogue,outlaw,6,3,3
Homeschoolx,moon-guard,288,rogue,outlaw,6,3,3
Movze,area-52,288,rogue,outlaw,6,3,3
Bàndit,wyrmrest-accord,288,rogue,outlaw,6,3,3
Lacero,bonechewer,288,rogue,outlaw,6,3,3
Alexdelion,tichondrius,288,rogue,outlaw,6,3,3
Dookienotop,thunderhorn,288,rogue,outlaw,6,3,3
Skoalr,thrall,288,rogue,outlaw,6,3,3
Daehyun,moknathal,288,rogue,outlaw,6,3,3
Bigcolumn,tichondrius,288,rogue,outlaw,6,3,3
Hepatocyte,anvilmar,288,rogue,outlaw,6,3,3
Dicenslice,proudmoore,288,rogue,outlaw,6,3,3
Ghøstfäce,tichondrius,288,rogue,outlaw,6,3,3
Machos,azralon,288,rogue,outlaw,6,3,3
Rujkah,archimonde,288,rogue,outlaw,6,3,3
Pikartz,stormrage,288,rogue,outlaw,6,3,3
Hedillyan,azralon,288,rogue,outlaw,6,3,3
Whaazz,emerald-dream,288,rogue,outlaw,6,3,3
Amorfirion,frostmourne,288,rogue,outlaw,6,3,3
Drpibb,ghostlands,288,rogue,outlaw,12,3,9
Stabyou,sentinels,287,rogue,outlaw,6,3,3
Grimthorn,icecrown,285,rogue,outlaw,12,3,9
Hotboxthefox,illidan,253,rogue,outlaw,11,3,8
Sabbathe,kargath,206,rogue,outlaw,8,3,5
Creamcakepop,stormrage,192,rogue,outlaw,6,2,4
Riprorin,stormrage,192,rogue,outlaw,6,2,4
Violetrose,kelthuzad,192,rogue,outlaw,6,2,4
Mud,saurfang,192,rogue,outlaw,6,2,4
Nippsy,aerie-peak,192,rogue,outlaw,6,2,4
Slobernocker,stormrage,192,rogue,outlaw,6,2,4
Prisonshank,arthas,192,rogue,outlaw,6,2,4
Touchthetip,bleeding-hollow,192,rogue,outlaw,6,2,4
Kpr,sargeras,192,rogue,outlaw,6,2,4
Jebubs,tichondrius,192,rogue,outlaw,6,2,4
Nïck,korialstrasz,192,rogue,outlaw,6,2,4
Dillwilly,moon-guard,192,rogue,outlaw,6,2,4
ßuu,sargeras,192,rogue,outlaw,6,2,4
Remonezero,moon-guard,192,rogue,outlaw,6,2,4
Duskeron,cenarius,192,rogue,outlaw,6,2,4
Jsyn,kiljaeden,192,rogue,outlaw,6,2,4
Sxs,kiljaeden,192,rogue,outlaw,12,2,10
Nikosneako,tichondrius,192,rogue,outlaw,12,2,10
Òklahomie,frostwolf,191,rogue,outlaw,6,2,4
Landrik,trollbane,191,rogue,outlaw,6,2,4
Philliamson,azgalor,190,rogue,outlaw,12,2,10
Lu,lethon,96,rogue,outlaw,6,1,5
Dessenia,illidan,96,rogue,outlaw,6,1,5
Rinestiria,arthas,96,rogue,outlaw,6,1,5
Reginageorge,azuremyst,96,rogue,outlaw,6,1,5
Walyo,stormrage,96,rogue,outlaw,6,1,5
Fateapocryph,azralon,96,rogue,outlaw,6,1,5
Sindor,azralon,96,rogue,outlaw,6,1,5
Raimondo,frostmourne,96,rogue,outlaw,6,1,5
Downsix,sargeras,96,rogue,outlaw,6,1,5
Happyslice,stormrage,96,rogue,outlaw,6,1,5
Xm,sargeras,96,rogue,outlaw,6,1,5
Neilyo,barthilas,96,rogue,outlaw,6,1,5
Whatsåpp,gallywix,96,rogue,outlaw,6,1,5
Madge,area-52,96,rogue,outlaw,6,1,5
Hîzzÿ,ghostlands,96,rogue,outlaw,12,1,11
Culpera,undermine,95,rogue,outlaw,6,1,5
Aliasfaker,stormrage,16,rogue,outlaw,1,1,0
Erebüs,thunderlord,2312,rogue,subtlety,96,62,34
Alexdelion,tichondrius,2142,rogue,subtlety,90,47,43
Ymxxworld,tichondrius,2107,rogue,subtlety,96,49,47
Røgüë,malganis,2100,rogue,subtlety,96,53,43
Battzii,wyrmrest-accord,2032,rogue,subtlety,630,319,311
Lies,dalaran,2010,rogue,subtlety,87,43,44
Flashmob,zuljin,1991,rogue,subtlety,62,31,31
Ajl,drenden,1966,rogue,subtlety,130,67,63
Danrathm,sargeras,1955,rogue,subtlety,97,52,45
Fotg,tichondrius,1944,rogue,subtlety,54,31,23
Yázim,tichondrius,1935,rogue,subtlety,79,48,31
Vendettita,quelthalas,1924,rogue,subtlety,78,42,36
Stealthypoop,kelthuzad,1920,rogue,subtlety,95,49,46
Roguesparrow,illidan,1896,rogue,subtlety,152,84,68
Rangoons,tichondrius,1894,rogue,subtlety,60,36,24
Norbury,tichondrius,1893,rogue,subtlety,83,40,43
Wazowskiy,tichondrius,1886,rogue,subtlety,110,54,56
Cydonian,ragnaros,1885,rogue,subtlety,126,71,55
Slashthunder,blades-edge,1876,rogue,subtlety,54,29,25
Antoninez,tichondrius,1871,rogue,subtlety,48,28,20
Needbuff,tichondrius,1865,rogue,subtlety,54,25,29
Ulley,sargeras,1857,rogue,subtlety,126,71,55
Coopi,tichondrius,1853,rogue,subtlety,115,60,55
Scuffedjr,tichondrius,1852,rogue,subtlety,84,37,47
Kenpàchi,kelthuzad,1851,rogue,subtlety,104,56,48
Himitu,tichondrius,1849,rogue,subtlety,89,46,43
Wetit,illidan,1847,rogue,subtlety,84,56,28
Coregx,tichondrius,1842,rogue,subtlety,36,24,12
Wizlysnipz,tichondrius,1837,rogue,subtlety,66,39,27
Rõý,area-52,1837,rogue,subtlety,42,23,19
Shinigâmì,tichondrius,1836,rogue,subtlety,96,64,32
Stunsofpuns,sargeras,1833,rogue,subtlety,60,33,27
Æsshayádlay,tichondrius,1832,rogue,subtlety,46,23,23
Brucerogue,tichondrius,1830,rogue,subtlety,236,125,111
Maulline,tichondrius,1828,rogue,subtlety,42,20,22
Fátálíty,tichondrius,1827,rogue,subtlety,60,30,30
Smkgpvp,stormrage,1823,rogue,subtlety,68,43,25
Howton,kelthuzad,1822,rogue,subtlety,24,19,5
Clern,emerald-dream,1818,rogue,subtlety,65,35,30
Ðèãth,area-52,1818,rogue,subtlety,36,19,17
Celèphaïs,tichondrius,1817,rogue,subtlety,63,30,33
Okaylmao,tichondrius,1816,rogue,subtlety,68,39,29
Zerogh,tichondrius,1811,rogue,subtlety,129,75,54
Ideology,azgalor,1811,rogue,subtlety,52,26,26
Bigpump,lothar,1809,rogue,subtlety,60,33,27
Bruítzy,barthilas,1809,rogue,subtlety,156,82,74
Kellenx,moon-guard,1809,rogue,subtlety,139,71,68
Díor,azralon,1807,rogue,subtlety,124,70,54
Turtlespeed,thrall,1803,rogue,subtlety,123,74,49
Stabem,moon-guard,1800,rogue,subtlety,63,39,24
Yunggodmalik,whisperwind,1799,rogue,subtlety,48,19,29
Minaciki,tichondrius,1798,rogue,subtlety,60,32,28
Scuffedsr,tichondrius,1785,rogue,subtlety,36,19,17
Silentkush,arthas,1774,rogue,subtlety,48,28,20
Dvin,stormrage,1770,rogue,subtlety,54,30,24
Gyokkó,sargeras,1770,rogue,subtlety,36,20,16
Greyyfox,illidan,1754,rogue,subtlety,69,33,36
Kidcutti,proudmoore,1749,rogue,subtlety,62,29,33
Sasugay,sargeras,1748,rogue,subtlety,80,50,30
Aaronjlol,tichondrius,1747,rogue,subtlety,36,23,13
Assassìn,moon-guard,1746,rogue,subtlety,169,93,76
Esky,tichondrius,1742,rogue,subtlety,57,28,29
Lxw,frostmourne,1739,rogue,subtlety,61,29,32
Axtually,proudmoore,1727,rogue,subtlety,102,57,45
Baeruto,thunderlord,1726,rogue,subtlety,24,18,6
Ganknvanish,tichondrius,1725,rogue,subtlety,168,82,86
Bezeta,azralon,1724,rogue,subtlety,251,137,114
Saprìse,darkspear,1710,rogue,subtlety,48,32,16
Hiyõ,tichondrius,1705,rogue,subtlety,71,36,35
Pxb,sargeras,1705,rogue,subtlety,88,40,48
Poizzon,emerald-dream,1704,rogue,subtlety,67,37,30
Majk,eldrethalas,1703,rogue,subtlety,76,37,39
Whoox,khazgoroth,1695,rogue,subtlety,42,29,13
Beanlord,spinebreaker,1693,rogue,subtlety,69,39,30
Xiaozhi,tichondrius,1692,rogue,subtlety,52,26,26
Siyeong,tichondrius,1688,rogue,subtlety,48,33,15
Bobsaget,kiljaeden,1684,rogue,subtlety,94,48,46
Yesua,ragnaros,1674,rogue,subtlety,229,116,113
Dysxliec,dalaran,1672,rogue,subtlety,57,28,29
Jaos,tichondrius,1667,rogue,subtlety,42,22,20
Themosk,malganis,1656,rogue,subtlety,42,21,21
Camlaw,area-52,1655,rogue,subtlety,90,52,38
Zeiss,tichondrius,1652,rogue,subtlety,48,24,24
Blakezilla,tichondrius,1648,rogue,subtlety,48,29,19
Zipperx,tichondrius,1641,rogue,subtlety,65,34,31
Cuizhudi,tichondrius,1639,rogue,subtlety,32,23,9
Eekz,illidan,1638,rogue,subtlety,262,146,116
Steef,arygos,1636,rogue,subtlety,92,54,38
Îzu,ysera,1636,rogue,subtlety,63,36,27
Furt,frostmourne,1633,rogue,subtlety,44,25,19
Frusciante,nemesis,1630,rogue,subtlety,90,52,38
Haiev,tichondrius,1630,rogue,subtlety,72,36,36
Antos,tichondrius,1628,rogue,subtlety,24,17,7
Shreddér,tichondrius,1628,rogue,subtlety,41,20,21
Thèllè,sargeras,1625,rogue,subtlety,30,17,13
Swadeecup,nagrand,1624,rogue,subtlety,36,17,19
Vyrenn,destromath,1623,rogue,subtlety,87,43,44
Bruitzygg,barthilas,1619,rogue,subtlety,44,20,24
Preceptor,azralon,1614,rogue,subtlety,86,44,42
Kyubïx,ragnaros,1609,rogue,subtlety,78,48,30
Piscís,sargeras,1606,rogue,subtlety,60,31,29
Skoalr,thrall,1604,rogue,subtlety,64,43,21
Klawz,norgannon,1604,rogue,subtlety,48,29,19
Taidath,area-52,1603,rogue,subtlety,42,20,22
Runakó,kelthuzad,1603,rogue,subtlety,48,21,27
Techie,frostmane,1600,rogue,subtlety,68,38,30
Cahlee,sargeras,1600,rogue,subtlety,88,40,48
Trc,illidan,1599,rogue,subtlety,30,17,13
Hayzarc,malfurion,1598,rogue,subtlety,42,21,21
Kalvish,dalaran,1597,rogue,subtlety,29,17,12
Unshut,tichondrius,1588,rogue,subtlety,30,19,11
Gnøver,ragnaros,1587,rogue,subtlety,160,93,67
Wowamaze,aegwynn,1587,rogue,subtlety,82,46,36
Tarny,illidan,1579,rogue,subtlety,58,25,33
Plado,tichondrius,1574,rogue,subtlety,47,27,20
Revelationzz,turalyon,1572,rogue,subtlety,70,37,33
Chitovera,tichondrius,1566,rogue,subtlety,30,19,11
Trizin,frostmourne,1563,rogue,subtlety,84,45,39
Eekz,sargeras,1561,rogue,subtlety,167,84,83
Grelinho,stormrage,1554,rogue,subtlety,66,26,40
Kinbaal,bleeding-hollow,1544,rogue,subtlety,42,26,16
Eviscerator,moon-guard,1544,rogue,subtlety,66,28,38
Mirâge,illidan,1538,rogue,subtlety,39,23,16
Prrey,hydraxis,1538,rogue,subtlety,49,19,30
Dogpaws,moon-guard,1537,rogue,subtlety,34,22,12
Mayhemghost,rexxar,1535,rogue,subtlety,72,40,32
Mitsurí,sargeras,1534,rogue,subtlety,24,16,8
Fela,crushridge,1531,rogue,subtlety,132,67,65
Roguetrix,stormrage,1531,rogue,subtlety,120,54,66
Rosoma,kelthuzad,1530,rogue,subtlety,40,23,17
Asoj,tichondrius,1529,rogue,subtlety,36,16,20
Notty,kelthuzad,1528,rogue,subtlety,36,22,14
ßeep,windrunner,1525,rogue,subtlety,48,24,24
Åer,dalaran,1524,rogue,subtlety,105,54,51
Cut,ragnaros,1524,rogue,subtlety,100,50,50
Dissociated,stormrage,1523,rogue,subtlety,47,17,30
Acid,warsong,1520,rogue,subtlety,24,17,7
Worrglaive,dalaran,1517,rogue,subtlety,104,58,46
Killmebaby,lightnings-blade,1514,rogue,subtlety,48,26,22
Kainm,stormrage,1514,rogue,subtlety,248,130,118
Weenies,illidan,1513,rogue,subtlety,35,21,14
Neonjk,ragnaros,1508,rogue,subtlety,24,16,8
Mtvcribs,emerald-dream,1505,rogue,subtlety,24,16,8
Illmatíc,kelthuzad,1502,rogue,subtlety,29,16,13
Galaxybrain,icecrown,1498,rogue,subtlety,120,76,44
Sit,frostwolf,1492,rogue,subtlety,64,36,28
Rufian,ursin,1489,rogue,subtlety,54,28,26
Axiy,stormrage,1482,rogue,subtlety,42,24,18
Swanl,stormrage,1482,rogue,subtlety,59,33,26
Tigerinu,stormreaver,1479,rogue,subtlety,37,21,16
Jinglez,frostmourne,1478,rogue,subtlety,36,22,14
Pince,black-dragonflight,1475,rogue,subtlety,36,21,15
Lurios,rivendare,1475,rogue,subtlety,76,39,37
Mosedz,tichondrius,1474,rogue,subtlety,48,28,20
Brangs,ragnaros,1473,rogue,subtlety,42,23,19
Saraelith,moon-guard,1472,rogue,subtlety,33,20,13
Xleo,drakkari,1470,rogue,subtlety,149,75,74
Bombman,tichondrius,1470,rogue,subtlety,77,34,43
Pikabuu,bleeding-hollow,1468,rogue,subtlety,57,26,31
Nightcloud,tichondrius,1466,rogue,subtlety,29,16,13
Luradfate,dalaran,1464,rogue,subtlety,269,139,130
Tulis,frostmourne,1462,rogue,subtlety,164,96,68
Clownboots,tichondrius,1462,rogue,subtlety,53,23,30
Stankyx,bleeding-hollow,1460,rogue,subtlety,66,37,29
Vigílant,proudmoore,1460,rogue,subtlety,78,38,40
Toxsith,tichondrius,1459,rogue,subtlety,74,43,31
Kaliasteddin,area-52,1457,rogue,subtlety,70,34,36
Scenna,stormrage,1457,rogue,subtlety,72,30,42
Garrotte,tichondrius,1453,rogue,subtlety,86,33,53
Vyll,stormrage,1452,rogue,subtlety,31,16,15
Bugser,tichondrius,1451,rogue,subtlety,66,35,31
Pichichi,frostmourne,1450,rogue,subtlety,57,34,23
Trucidovaco,daggerspine,1449,rogue,subtlety,88,40,48
Murked,barthilas,1447,rogue,subtlety,42,25,17
Géminis,sargeras,1444,rogue,subtlety,30,17,13
Rougething,bleeding-hollow,1443,rogue,subtlety,72,35,37
ßaltø,bleeding-hollow,1437,rogue,subtlety,36,15,21
Calebrogue,illidan,1436,rogue,subtlety,24,15,9
Ricros,bleeding-hollow,1435,rogue,subtlety,43,20,23
Errorless,moon-guard,1434,rogue,subtlety,60,29,31
Smormu,bonechewer,1432,rogue,subtlety,36,17,19
Epipenqt,dark-iron,1431,rogue,subtlety,42,26,16
Hunchó,area-52,1431,rogue,subtlety,65,38,27
Chãlons,tichondrius,1431,rogue,subtlety,84,42,42
Brrant,tichondrius,1430,rogue,subtlety,24,15,9
Yoskit,tichondrius,1429,rogue,subtlety,24,15,9
Skitsöu,tichondrius,1429,rogue,subtlety,30,15,15
Greasybbsea,illidan,1428,rogue,subtlety,78,36,42
Gotto,icecrown,1424,rogue,subtlety,30,15,15
Kibbs,korgath,1422,rogue,subtlety,60,30,30
Eridian,tichondrius,1420,rogue,subtlety,85,40,45
Tolthe,hyjal,1418,rogue,subtlety,80,40,40
Jibdorf,destromath,1414,rogue,subtlety,18,15,3
Axerax,draka,1412,rogue,subtlety,30,15,15
Secrettecbot,barthilas,1411,rogue,subtlety,30,18,12
Fulkrem,wyrmrest-accord,1410,rogue,subtlety,74,34,40
Huskyi,dalaran,1408,rogue,subtlety,30,15,15
Cv,proudmoore,1404,rogue,subtlety,42,23,19
Quinity,wyrmrest-accord,1401,rogue,subtlety,186,94,92
Arakine,uldaman,1398,rogue,subtlety,38,27,11
Vaith,wyrmrest-accord,1398,rogue,subtlety,36,17,19
Fofree,hyjal,1396,rogue,subtlety,46,26,20
Seaki,illidan,1395,rogue,subtlety,23,15,8
Yanh,tichondrius,1395,rogue,subtlety,36,16,20
Superharry,tichondrius,1394,rogue,subtlety,42,22,20
Abacura,moon-guard,1392,rogue,subtlety,106,58,48
Speedboi,skullcrusher,1391,rogue,subtlety,110,65,45
Sapyalater,thrall,1390,rogue,subtlety,186,96,90
Bakedpotato,garithos,1390,rogue,subtlety,42,20,22
Klâng,tichondrius,1389,rogue,subtlety,49,22,27
Mistnazgul,quelthalas,1386,rogue,subtlety,94,53,41
Neuschurke,warsong,1386,rogue,subtlety,42,23,19
Sgtbuttfat,dalaran,1385,rogue,subtlety,41,20,21
Saintt,khaz-modan,1384,rogue,subtlety,24,16,8
Najohn,tichondrius,1384,rogue,subtlety,42,20,22
Usernameqtxo,kelthuzad,1376,rogue,subtlety,63,27,36
Ojibwe,tichondrius,1373,rogue,subtlety,28,15,13
Kolander,tichondrius,1373,rogue,subtlety,58,29,29
Ironfistofcn,tichondrius,1364,rogue,subtlety,60,32,28
Tapwaterx,illidan,1361,rogue,subtlety,66,26,40
Loquen,ragnaros,1358,rogue,subtlety,42,23,19
Fkrueger,thrall,1358,rogue,subtlety,48,24,24
Raymga,tichondrius,1355,rogue,subtlety,48,29,19
Søprøle,ragnaros,1355,rogue,subtlety,86,50,36
Emrogr,tichondrius,1354,rogue,subtlety,72,39,33
Toestumper,sargeras,1354,rogue,subtlety,33,15,18
Narcoleptic,dalaran,1346,rogue,subtlety,84,40,44
Deadguys,tichondrius,1344,rogue,subtlety,54,25,29
Corrier,tichondrius,1340,rogue,subtlety,24,14,10
Onîkudaki,sargeras,1340,rogue,subtlety,36,14,22
Lyfallah,proudmoore,1338,rogue,subtlety,121,66,55
Spacebase,illidan,1337,rogue,subtlety,24,14,10
Saltypwncake,illidan,1331,rogue,subtlety,30,14,16
Jawnrogue,tichondrius,1328,rogue,subtlety,18,14,4
Genève,dreadmaul,1327,rogue,subtlety,24,14,10
Dustt,stormrage,1322,rogue,subtlety,30,21,9
Gankolicious,nerzhul,1317,rogue,subtlety,18,14,4
Lagault,muradin,1316,rogue,subtlety,66,38,28
Tamsy,the-forgotten-coast,1315,rogue,subtlety,21,15,6
Pleodonis,tichondrius,1314,rogue,subtlety,59,27,32
Nicoaa,tichondrius,1312,rogue,subtlety,146,73,73
Pegglerogue,fizzcrank,1311,rogue,subtlety,106,50,56
Threeplates,silvermoon,1310,rogue,subtlety,30,14,16
Lisnp,tichondrius,1304,rogue,subtlety,206,98,108
Odelöt,drakkari,1302,rogue,subtlety,96,50,46
Khorgan,mugthol,1301,rogue,subtlety,36,18,18
Pocketman,barthilas,1299,rogue,subtlety,59,24,35
Vanvanlords,azralon,1291,rogue,subtlety,32,15,17
Turec,illidan,1290,rogue,subtlety,29,14,15
Nooz,thrall,1282,rogue,subtlety,54,32,22
Liryth,lightninghoof,1281,rogue,subtlety,51,29,22
Ikmagine,icecrown,1281,rogue,subtlety,42,17,25
Täy,thrall,1280,rogue,subtlety,47,23,24
Thugspice,stormrage,1279,rogue,subtlety,53,26,27
Flockavelli,zuljin,1275,rogue,subtlety,30,15,15
Ikerz,tichondrius,1272,rogue,subtlety,27,14,13
Pargo,quelthalas,1266,rogue,subtlety,67,30,37
Pinksleep,sargeras,1266,rogue,subtlety,48,20,28
Hollfex,nemesis,1265,rogue,subtlety,44,22,22
Orangez,malfurion,1260,rogue,subtlety,30,17,13
Lefteex,tichondrius,1260,rogue,subtlety,45,25,20
Kawagreen,tichondrius,1260,rogue,subtlety,51,27,24
Gothblade,malganis,1258,rogue,subtlety,30,15,15
Xoltin,tichondrius,1258,rogue,subtlety,80,36,44
Bloodraina,hyjal,1258,rogue,subtlety,52,23,29
Dionavelynn,area-52,1255,rogue,subtlety,30,14,16
Mcromance,khadgar,1253,rogue,subtlety,57,25,32
Hiarolson,stormrage,1250,rogue,subtlety,33,17,16
Twotimed,magtheridon,1250,rogue,subtlety,30,14,16
Arbitér,moonrunner,1250,rogue,subtlety,64,25,39
Tmpikaboo,tichondrius,1248,rogue,subtlety,18,13,5
Lxke,stormrage,1247,rogue,subtlety,18,13,5
Zurza,proudmoore,1247,rogue,subtlety,36,13,23
Notxerian,stormrage,1246,rogue,subtlety,18,13,5
Mirajoo,tichondrius,1245,rogue,subtlety,88,42,46
Mylovejunex,tichondrius,1244,rogue,subtlety,18,13,5
Termkilledu,moon-guard,1244,rogue,subtlety,36,21,15
Endlesswaltz,zuljin,1243,rogue,subtlety,30,13,17
Towncar,kelthuzad,1242,rogue,subtlety,24,13,11
Vlone,icecrown,1240,rogue,subtlety,24,13,11
Guiguzidr,illidan,1238,rogue,subtlety,64,35,29
Stealthkid,tichondrius,1237,rogue,subtlety,24,13,11
Lululee,tichondrius,1237,rogue,subtlety,36,13,23
Bríng,illidan,1235,rogue,subtlety,24,16,8
Variat,azralon,1235,rogue,subtlety,54,25,29
Oddblade,stormrage,1232,rogue,subtlety,24,14,10
Neilyo,barthilas,1230,rogue,subtlety,24,13,11
Sapùwú,stormrage,1224,rogue,subtlety,93,49,44
Gøblìn,tichondrius,1224,rogue,subtlety,33,14,19
Harlyfknquin,jubeithos,1223,rogue,subtlety,50,24,26
Noxik,blackrock,1217,rogue,subtlety,34,19,15
Drsinz,tichondrius,1217,rogue,subtlety,67,28,39
Frèyjä,bleeding-hollow,1216,rogue,subtlety,84,43,41
Trâshy,stormrage,1215,rogue,subtlety,25,14,11
Stanley,mugthol,1212,rogue,subtlety,24,13,11
Suñg,tichondrius,1211,rogue,subtlety,30,14,16
Dessenia,illidan,1208,rogue,subtlety,79,47,32
Quickxsilver,tichondrius,1204,rogue,subtlety,42,18,24
Maløkeirø,stormrage,1202,rogue,subtlety,67,29,38
Abatoire,wyrmrest-accord,1201,rogue,subtlety,36,18,18
Kylerxius,korgath,1192,rogue,subtlety,36,21,15
Shellby,tichondrius,1192,rogue,subtlety,68,34,34
Lilstab,hakkar,1191,rogue,subtlety,104,50,54
Hattrìck,area-52,1185,rogue,subtlety,44,21,23
Elmabrox,quelthalas,1183,rogue,subtlety,45,20,25
Roxeni,tichondrius,1181,rogue,subtlety,28,13,15
Eraticrogue,illidan,1178,rogue,subtlety,29,13,16
Linkzq,frostmourne,1173,rogue,subtlety,35,13,22
Abogansterr,ragnaros,1172,rogue,subtlety,122,65,57
Wokemeup,bleeding-hollow,1168,rogue,subtlety,30,15,15
Poohpants,frostmourne,1168,rogue,subtlety,75,36,39
Zarkans,proudmoore,1162,rogue,subtlety,66,34,32
Sabedoria,barthilas,1162,rogue,subtlety,84,43,41
Ambushr,tichondrius,1161,rogue,subtlety,30,16,14
Mendiant,azralon,1159,rogue,subtlety,59,26,33
Gyrfalcon,spirestone,1156,rogue,subtlety,154,72,82
Paulpitation,blood-furnace,1155,rogue,subtlety,39,15,24
Håkünämãtåtä,stormrage,1152,rogue,subtlety,18,12,6
Bèstworld,dalaran,1152,rogue,subtlety,24,12,12
Airi,darkspear,1150,rogue,subtlety,24,12,12
Gatõ,quelthalas,1150,rogue,subtlety,54,20,34
Stealthyxd,arthas,1150,rogue,subtlety,36,12,24
Itskanashi,frostmourne,1148,rogue,subtlety,75,33,42
Yurasick,lightbringer,1147,rogue,subtlety,24,12,12
Kaminokage,barthilas,1144,rogue,subtlety,45,15,30
Staba,tichondrius,1143,rogue,subtlety,34,19,15
Oilydaimon,tichondrius,1143,rogue,subtlety,61,29,32
Draculà,wyrmrest-accord,1142,rogue,subtlety,48,26,22
Hattorikun,proudmoore,1142,rogue,subtlety,24,12,12
Smokepipe,nerzhul,1139,rogue,subtlety,24,14,10
Rigotak,illidan,1139,rogue,subtlety,24,12,12
Smashol,barthilas,1136,rogue,subtlety,54,23,31
Imgunnacrumb,malganis,1131,rogue,subtlety,161,78,83
Lozion,malganis,1131,rogue,subtlety,30,12,18
Micromoon,windrunner,1131,rogue,subtlety,36,13,23
Vangroen,quelthalas,1129,rogue,subtlety,24,14,10
Hypermix,tichondrius,1129,rogue,subtlety,24,12,12
Ninjadoo,tichondrius,1128,rogue,subtlety,18,12,6
Miraclesap,stormrage,1127,rogue,subtlety,88,51,37
Meer,balnazzar,1125,rogue,subtlety,34,24,10
Studders,kiljaeden,1123,rogue,subtlety,24,12,12
Doklim,spinebreaker,1122,rogue,subtlety,74,42,32
Cutthroat,aegwynn,1121,rogue,subtlety,45,20,25
Ctrlfreak,hellscream,1120,rogue,subtlety,24,12,12
Winze,scilla,1115,rogue,subtlety,30,19,11
Jeri,gundrak,1113,rogue,subtlety,30,17,13
Harkknight,sargeras,1110,rogue,subtlety,204,108,96
Humphugull,skullcrusher,1108,rogue,subtlety,35,12,23
Stêf,zuljin,1107,rogue,subtlety,22,15,7
Venace,agamaggan,1104,rogue,subtlety,23,12,11
Jadier,emerald-dream,1103,rogue,subtlety,23,12,11
Sahima,tichondrius,1101,rogue,subtlety,161,78,83
Prisonshank,arthas,1093,rogue,subtlety,61,36,25
Shadownibba,illidan,1091,rogue,subtlety,48,26,22
Noriel,dathremar,1085,rogue,subtlety,30,13,17
Jaanmonty,frostmourne,1081,rogue,subtlety,24,12,12
Drapezz,kelthuzad,1077,rogue,subtlety,35,18,17
Hotcarl,kiljaeden,1077,rogue,subtlety,28,14,14
Riskgo,frostwolf,1071,rogue,subtlety,24,12,12
Aynrand,drakkari,1070,rogue,subtlety,39,14,25
Hahaurblind,perenolde,1068,rogue,subtlety,28,12,16
Vanishman,ragnaros,1063,rogue,subtlety,24,12,12
Larmx,tichondrius,1056,rogue,subtlety,12,11,1
Sixcombopts,area-52,1056,rogue,subtlety,18,11,7
Queuethunder,blades-edge,1055,rogue,subtlety,12,11,1
Ozzinton,kelthuzad,1055,rogue,subtlety,18,11,7
Tootsio,tichondrius,1054,rogue,subtlety,18,11,7
Esmeraldas,frostmourne,1054,rogue,subtlety,18,11,7
Danielsylerr,drakkari,1054,rogue,subtlety,24,11,13
Rabe,nagrand,1053,rogue,subtlety,24,11,13
Ninetaildfox,arthas,1051,rogue,subtlety,18,11,7
Xvds,tichondrius,1051,rogue,subtlety,24,11,13
Distract,quelthalas,1050,rogue,subtlety,18,11,7
Corntens,area-52,1050,rogue,subtlety,20,11,9
Cerut,illidan,1050,rogue,subtlety,24,11,13
Faxingberlin,skullcrusher,1049,rogue,subtlety,24,11,13
Hakuchi,tichondrius,1049,rogue,subtlety,24,11,13
Négrá,ragnaros,1048,rogue,subtlety,18,11,7
Nadari,cenarius,1048,rogue,subtlety,66,31,35
Mermm,burning-blade,1048,rogue,subtlety,24,11,13
Trolladrão,goldrinn,1048,rogue,subtlety,24,11,13
Ðarkrøøxs,stormrage,1048,rogue,subtlety,24,11,13
Santyno,ragnaros,1047,rogue,subtlety,120,56,64
Laotrec,nemesis,1045,rogue,subtlety,33,12,21
Olg,arathor,1043,rogue,subtlety,71,36,35
Hyperdexia,stormrage,1042,rogue,subtlety,88,47,41
Soulvex,barthilas,1040,rogue,subtlety,18,11,7
Allirra,ragnaros,1037,rogue,subtlety,30,19,11
Abaløne,tichondrius,1037,rogue,subtlety,55,22,33
Eryx,mugthol,1033,rogue,subtlety,18,11,7
Kachimodo,illidan,1029,rogue,subtlety,42,20,22
Topapple,mugthol,1021,rogue,subtlety,30,14,16
Esker,dragonmaw,1021,rogue,subtlety,30,12,18
Rarkalth,azralon,1020,rogue,subtlety,41,13,28
Maewyn,aerie-peak,1019,rogue,subtlety,25,11,14
Sneakyshots,emerald-dream,1017,rogue,subtlety,13,11,2
Slackness,bleeding-hollow,1015,rogue,subtlety,61,35,26
Fateapocryph,azralon,1014,rogue,subtlety,26,13,13
Indivisible,thunderlord,1009,rogue,subtlety,30,13,17
Korviz,area-52,1008,rogue,subtlety,60,30,30
Bloodwish,tichondrius,1007,rogue,subtlety,23,11,12
Ghost,shattered-halls,1006,rogue,subtlety,68,27,41
Log,blackhand,1004,rogue,subtlety,36,18,18
Onara,quelthalas,1003,rogue,subtlety,30,18,12
Relidria,thrall,1002,rogue,subtlety,30,18,12
Feragho,tichondrius,992,rogue,subtlety,34,11,23
Sadtears,thrall,990,rogue,subtlety,16,11,5
Oldgate,azralon,988,rogue,subtlety,17,11,6
Jalaroot,frostmourne,985,rogue,subtlety,23,13,10
Bubblesr,whisperwind,980,rogue,subtlety,48,22,26
Mcghanhain,aegwynn,971,rogue,subtlety,24,11,13
Lesliechow,sargeras,967,rogue,subtlety,52,28,24
Ascherx,veknilash,960,rogue,subtlety,12,10,2
ßuu,sargeras,960,rogue,subtlety,12,10,2
Spaca,kelthuzad,959,rogue,subtlety,18,10,8
Eazyg,tichondrius,959,rogue,subtlety,18,10,8
Caldø,tichondrius,958,rogue,subtlety,12,10,2
Zaszune,stormrage,958,rogue,subtlety,18,10,8
Lucki,tichondrius,958,rogue,subtlety,18,10,8
Aszombie,tichondrius,957,rogue,subtlety,12,10,2
Vavnmusic,illidan,957,rogue,subtlety,18,10,8
Rooke,draktharon,957,rogue,subtlety,24,10,14
Stuntedscamp,bleeding-hollow,957,rogue,subtlety,24,10,14
Shilaya,dreadmaul,957,rogue,subtlety,24,10,14
Reclusivexo,tichondrius,956,rogue,subtlety,24,10,14
Merkules,dalaran,955,rogue,subtlety,16,11,5
Înfêrnô,emerald-dream,955,rogue,subtlety,24,10,14
Poogodx,proudmoore,954,rogue,subtlety,12,10,2
Kilrogga,azshara,953,rogue,subtlety,24,12,12
Moufwash,sargeras,952,rogue,subtlety,24,10,14
Kahlx,azralon,952,rogue,subtlety,24,10,14
Uchihaputin,tichondrius,951,rogue,subtlety,24,10,14
Arwy,stormrage,948,rogue,subtlety,19,11,8
Definitioni,area-52,945,rogue,subtlety,19,10,9
Alrynik,stormrage,939,rogue,subtlety,18,10,8
Sildin,sargeras,938,rogue,subtlety,18,10,8
Undreas,kiljaeden,935,rogue,subtlety,243,118,125
Degrok,quelthalas,926,rogue,subtlety,35,18,17
Swayo,tichondrius,920,rogue,subtlety,18,10,8
Macsap,frostmourne,918,rogue,subtlety,30,10,20
Toe,boulderfist,912,rogue,subtlety,27,13,14
Misthios,chogall,911,rogue,subtlety,23,10,13
Kidcudi,bonechewer,905,rogue,subtlety,30,10,20
Silentmoralz,tichondrius,903,rogue,subtlety,35,10,25
Skallywagg,emerald-dream,902,rogue,subtlety,46,18,28
Ninjamf,bleeding-hollow,894,rogue,subtlety,14,10,4
Mhün,malganis,891,rogue,subtlety,22,10,12
Sxs,kiljaeden,878,rogue,subtlety,23,10,13
Bimbogirl,dalaran,865,rogue,subtlety,22,11,11
Votekanye,bleeding-hollow,864,rogue,subtlety,12,9,3
Yodiegang,tichondrius,864,rogue,subtlety,12,9,3
Chainsarogue,stormrage,864,rogue,subtlety,12,9,3
Ðankbud,barthilas,864,rogue,subtlety,21,10,11
Aghanaar,burning-legion,863,rogue,subtlety,18,9,9
Illoo,frostmourne,863,rogue,subtlety,24,9,15
Proddivus,stormrage,863,rogue,subtlety,30,9,21
Poolover,barthilas,862,rogue,subtlety,18,9,9
Cosmicò,trollbane,861,rogue,subtlety,12,9,3
Blitzree,thrall,861,rogue,subtlety,12,9,3
Filid,frostmourne,861,rogue,subtlety,18,9,9
Lanres,stormrage,860,rogue,subtlety,12,9,3
Biggisdiggis,tichondrius,860,rogue,subtlety,12,9,3
Woollord,frostmourne,860,rogue,subtlety,18,9,9
Larceny,emerald-dream,860,rogue,subtlety,24,9,15
Raqed,eredar,860,rogue,subtlety,24,9,15
Overzz,azralon,859,rogue,subtlety,21,9,12
Gannjalord,frostmane,858,rogue,subtlety,22,10,12
Krolczz,tichondrius,857,rogue,subtlety,18,9,9
Jhors,tichondrius,856,rogue,subtlety,18,9,9
Dizzm,area-52,847,rogue,subtlety,12,9,3
Aelnoor,ragnaros,846,rogue,subtlety,24,9,15
Ayo,exodar,845,rogue,subtlety,18,9,9
Cutindle,illidan,842,rogue,subtlety,18,9,9
Samllnuts,area-52,837,rogue,subtlety,24,11,13
Elßronkas,quelthalas,836,rogue,subtlety,48,21,27
Zamji,tichondrius,834,rogue,subtlety,20,9,11
Yellowdeep,tichondrius,831,rogue,subtlety,14,10,4
Alexon,wyrmrest-accord,828,rogue,subtlety,84,35,49
Trillkage,tichondrius,797,rogue,subtlety,26,9,17
Zelthy,frostmourne,790,rogue,subtlety,17,9,8
Redtvco,blackrock,789,rogue,subtlety,17,9,8
Astutý,illidan,768,rogue,subtlety,12,8,4
Tyrrantxo,agamaggan,768,rogue,subtlety,12,8,4
Wîzz,bleeding-hollow,768,rogue,subtlety,12,8,4
Lesty,kelthuzad,768,rogue,subtlety,12,8,4
Nicørøbin,tichondrius,768,rogue,subtlety,12,8,4
Czd,frostmourne,768,rogue,subtlety,12,8,4
Originalfake,sargeras,768,rogue,subtlety,12,8,4
Adept,whisperwind,768,rogue,subtlety,12,8,4
Decóm,zuljin,768,rogue,subtlety,16,9,7
Köfy,quelthalas,768,rogue,subtlety,17,8,9
Wowcode,tichondrius,768,rogue,subtlety,18,8,10
Zefeckz,tichondrius,768,rogue,subtlety,18,8,10
Heegawn,proudmoore,768,rogue,subtlety,18,8,10
Bungou,tichondrius,768,rogue,subtlety,18,8,10
Getfkdkid,tichondrius,768,rogue,subtlety,24,8,16
Donnice,area-52,767,rogue,subtlety,12,8,4
Kiingspade,tichondrius,767,rogue,subtlety,12,8,4
Gankbang,mugthol,767,rogue,subtlety,12,8,4
Writhes,sargeras,767,rogue,subtlety,12,8,4
Fence,moon-guard,767,rogue,subtlety,18,8,10
Ilesire,frostmourne,767,rogue,subtlety,18,8,10
Nítzy,quelthalas,767,rogue,subtlety,24,8,16
Chancelör,illidan,766,rogue,subtlety,12,8,4
Razmir,malfurion,766,rogue,subtlety,18,8,10
Ntshaav,illidan,766,rogue,subtlety,18,8,10
Glíz,bloodscalp,765,rogue,subtlety,18,8,10
Yato,mugthol,764,rogue,subtlety,12,8,4
Subtlepuddle,bleeding-hollow,764,rogue,subtlety,24,8,16
Vexyz,tichondrius,763,rogue,subtlety,18,8,10
Defaces,illidan,762,rogue,subtlety,12,8,4
Wolfmans,trollbane,762,rogue,subtlety,12,8,4
Shivlightnin,tichondrius,762,rogue,subtlety,24,8,16
Deathben,tichondrius,761,rogue,subtlety,30,8,22
Mhasto,azralon,759,rogue,subtlety,18,8,10
Kerimoynihan,barthilas,757,rogue,subtlety,28,11,17
Nijanari,wyrmrest-accord,754,rogue,subtlety,24,8,16
Nuff,emerald-dream,736,rogue,subtlety,16,8,8
Stunjunky,area-52,733,rogue,subtlety,17,8,9
Bladefang,quelthalas,732,rogue,subtlety,17,10,7
Fearnomore,destromath,729,rogue,subtlety,72,24,48
Brocolini,zuljin,706,rogue,subtlety,21,10,11
Syxs,sargeras,672,rogue,subtlety,12,7,5
Whoô,khazgoroth,672,rogue,subtlety,12,7,5
Yangsol,stormrage,672,rogue,subtlety,12,7,5
Coughsyrup,sargeras,672,rogue,subtlety,12,7,5
Joeyzord,stormrage,672,rogue,subtlety,12,7,5
Frooty,stormrage,672,rogue,subtlety,12,7,5
Sandorroguee,stormrage,672,rogue,subtlety,12,7,5
Bloodyhairy,area-52,672,rogue,subtlety,12,7,5
Nines,icecrown,672,rogue,subtlety,12,7,5
Feyahni,wyrmrest-accord,672,rogue,subtlety,12,7,5
Smang,mugthol,672,rogue,subtlety,12,7,5
Ythgie,altar-of-storms,672,rogue,subtlety,12,7,5
Bobfoonk,tichondrius,672,rogue,subtlety,12,7,5
Mesqeets,kelthuzad,672,rogue,subtlety,12,7,5
Wimpz,hyjal,672,rogue,subtlety,12,7,5
Flaremagnet,whisperwind,672,rogue,subtlety,12,7,5
Wowtheskill,illidan,672,rogue,subtlety,12,7,5
Àsgà,area-52,672,rogue,subtlety,12,7,5
Qq,doomhammer,672,rogue,subtlety,12,7,5
Memoríst,frostmourne,672,rogue,subtlety,18,7,11
Clicksbtns,area-52,672,rogue,subtlety,18,7,11
Jexy,barthilas,672,rogue,subtlety,18,7,11
Spytes,kiljaeden,672,rogue,subtlety,18,7,11
Niwbor,azralon,672,rogue,subtlety,24,7,17
Liquidmojo,tichondrius,671,rogue,subtlety,12,7,5
Christiaan,area-52,671,rogue,subtlety,12,7,5
Darkìs,tichondrius,671,rogue,subtlety,12,7,5
Keepitshadow,frostmourne,671,rogue,subtlety,12,7,5
Bloodylegend,altar-of-storms,671,rogue,subtlety,12,7,5
Xemnxnt,stormrage,671,rogue,subtlety,12,7,5
Kazzo,tichondrius,671,rogue,subtlety,12,7,5
Yurkarogue,tichondrius,671,rogue,subtlety,12,7,5
Salätzar,quelthalas,671,rogue,subtlety,15,8,7
Sapzz,tichondrius,671,rogue,subtlety,18,7,11
Nezumikami,malganis,671,rogue,subtlety,18,7,11
Calimari,frostmourne,671,rogue,subtlety,18,7,11
ßecomeðeath,tichondrius,671,rogue,subtlety,18,7,11
Brilliance,skywall,671,rogue,subtlety,18,7,11
Felistrien,wyrmrest-accord,671,rogue,subtlety,18,7,11
Vex,durotan,671,rogue,subtlety,24,7,17
Jdmg,azralon,670,rogue,subtlety,12,7,5
Burningfury,arthas,670,rogue,subtlety,18,7,11
Takamoto,windrunner,670,rogue,subtlety,18,7,11
Yunaka,grizzly-hills,670,rogue,subtlety,24,7,17
Rykojin,sargeras,669,rogue,subtlety,12,7,5
Anteccessor,tichondrius,669,rogue,subtlety,18,7,11
Jagó,malganis,667,rogue,subtlety,12,7,5
Chompycat,tichondrius,667,rogue,subtlety,18,7,11
Srmazakre,ragnaros,667,rogue,subtlety,18,7,11
Mercaderps,frostmourne,667,rogue,subtlety,24,7,17
Zapersapp,malygos,666,rogue,subtlety,24,7,17
Dogedealer,ragnaros,665,rogue,subtlety,12,7,5
Kody,dalaran,639,rogue,subtlety,17,7,10
Carpe,barthilas,618,rogue,subtlety,24,8,16
Lilshanker,tichondrius,617,rogue,subtlety,22,8,14
Lerosi,malganis,615,rogue,subtlety,29,7,22
Gptcodeplay,tichondrius,576,rogue,subtlety,6,6,0
Donçorleone,stormrage,576,rogue,subtlety,6,6,0
Manersi,akama,576,rogue,subtlety,6,6,0
Deadshank,bleeding-hollow,576,rogue,subtlety,6,6,0
Homarx,quelthalas,576,rogue,subtlety,10,7,3
Avelmire,sargeras,576,rogue,subtlety,12,6,6
Aleh,exodar,576,rogue,subtlety,12,6,6
Ãnimefãnx,moon-guard,576,rogue,subtlety,12,6,6
Popss,whisperwind,576,rogue,subtlety,12,6,6
Delphyax,azralon,576,rogue,subtlety,12,6,6
Tmpikaboo,mugthol,576,rogue,subtlety,12,6,6
Fkq,emerald-dream,576,rogue,subtlety,12,6,6
Topfloorboss,illidan,576,rogue,subtlety,12,6,6
Littlescrub,frostmourne,576,rogue,subtlety,12,6,6
Pamaaj,sargeras,576,rogue,subtlety,12,6,6
Nemoye,tichondrius,576,rogue,subtlety,12,6,6
Shadxr,tichondrius,576,rogue,subtlety,12,6,6
Unholydood,bonechewer,576,rogue,subtlety,12,6,6
Kindasorry,illidan,576,rogue,subtlety,12,6,6
Hykoo,tichondrius,576,rogue,subtlety,12,6,6
Pokekek,stormrage,576,rogue,subtlety,12,6,6
Dërpt,tichondrius,576,rogue,subtlety,12,6,6
Palumor,deathwing,576,rogue,subtlety,12,6,6
Lymon,azralon,576,rogue,subtlety,12,6,6
Jannie,rexxar,576,rogue,subtlety,12,6,6
Draiygo,nerzhul,576,rogue,subtlety,12,6,6
Lunatixz,emerald-dream,576,rogue,subtlety,12,6,6
Revila,bleeding-hollow,576,rogue,subtlety,12,6,6
Xedi,illidan,576,rogue,subtlety,12,6,6
Candren,area-52,576,rogue,subtlety,12,6,6
Cinnashank,darkspear,576,rogue,subtlety,18,6,12
Kents,tichondrius,576,rogue,subtlety,18,6,12
Saltymann,bleeding-hollow,576,rogue,subtlety,18,6,12
Swippz,tichondrius,576,rogue,subtlety,18,6,12
Drakariano,ragnaros,576,rogue,subtlety,18,6,12
Nihue,terenas,576,rogue,subtlety,18,6,12
Goopthicc,sargeras,576,rogue,subtlety,18,6,12
Jácket,area-52,576,rogue,subtlety,24,6,18
Struggle,sargeras,576,rogue,subtlety,24,6,18
Aitormenta,ragnaros,575,rogue,subtlety,6,6,0
Calvin,moon-guard,575,rogue,subtlety,12,6,6
Jinxkiller,tichondrius,575,rogue,subtlety,12,6,6
Maulgryve,frostwolf,575,rogue,subtlety,12,6,6
Mcnastier,dunemaul,575,rogue,subtlety,12,6,6
Azanax,area-52,575,rogue,subtlety,12,6,6
Gank,jubeithos,575,rogue,subtlety,12,6,6
Boredomkills,frostmane,575,rogue,subtlety,12,6,6
Whothekilla,tichondrius,575,rogue,subtlety,12,6,6
Dreamcatcher,azralon,575,rogue,subtlety,18,6,12
Ballflicker,malganis,575,rogue,subtlety,18,6,12
Zogbu,stormrage,575,rogue,subtlety,18,6,12
Poofus,vashj,575,rogue,subtlety,18,6,12
Píxíedúst,black-dragonflight,574,rogue,subtlety,18,6,12
Alttee,proudmoore,573,rogue,subtlety,12,6,6
Iapologize,area-52,572,rogue,subtlety,12,6,6
Supminty,stormrage,571,rogue,subtlety,12,6,6
Xylow,garona,571,rogue,subtlety,27,6,21
Confianzudo,ragnaros,567,rogue,subtlety,18,6,12
Hmmkek,frostmourne,527,rogue,subtlety,11,6,5
Cheapdeal,frostmourne,512,rogue,subtlety,10,6,4
Kwins,cenarion-circle,480,rogue,subtlety,6,5,1
Lowkn,tichondrius,480,rogue,subtlety,6,5,1
Ghoarie,sargeras,480,rogue,subtlety,6,5,1
Oceboomer,frostmourne,480,rogue,subtlety,6,5,1
Chakal,illidan,480,rogue,subtlety,6,5,1
Poonqtxo,frostmourne,480,rogue,subtlety,6,5,1
Feinting,moon-guard,480,rogue,subtlety,6,5,1
Scythix,firetree,480,rogue,subtlety,6,5,1
Deepsyo,frostmourne,480,rogue,subtlety,6,5,1
Natalya,stormreaver,480,rogue,subtlety,6,5,1
Nodeßurglar,kelthuzad,480,rogue,subtlety,6,5,1
Tmskitsou,tichondrius,480,rogue,subtlety,10,6,4
Liqwid,stormrage,480,rogue,subtlety,12,5,7
Scrubzz,barthilas,480,rogue,subtlety,12,5,7
Xandroesh,darkspear,480,rogue,subtlety,12,5,7
Tiladar,tichondrius,480,rogue,subtlety,12,5,7
Killdrunk,stormrage,480,rogue,subtlety,12,5,7
Aldessa,draka,480,rogue,subtlety,12,5,7
Dawkx,thrall,480,rogue,subtlety,12,5,7
Grinjuk,area-52,480,rogue,subtlety,12,5,7
Defthands,tichondrius,480,rogue,subtlety,12,5,7
Clayton,frostmourne,480,rogue,subtlety,12,5,7
Blakezillax,tichondrius,480,rogue,subtlety,12,5,7
Milafortnite,tichondrius,480,rogue,subtlety,12,5,7
Brendantko,arthas,480,rogue,subtlety,12,5,7
Drunknchaos,bleeding-hollow,480,rogue,subtlety,12,5,7
Wooluncle,tichondrius,480,rogue,subtlety,12,5,7
Jon,the-venture-co,480,rogue,subtlety,12,5,7
Söda,emerald-dream,480,rogue,subtlety,12,5,7
Chimpo,ravencrest,480,rogue,subtlety,12,5,7
Monkeykongr,lightnings-blade,480,rogue,subtlety,12,5,7
Shizz,tichondrius,480,rogue,subtlety,12,5,7
Orihimesz,azralon,480,rogue,subtlety,12,5,7
Pwnsauce,frostmourne,480,rogue,subtlety,12,5,7
Henya,magtheridon,480,rogue,subtlety,12,5,7
Glatzkaus,shattered-hand,480,rogue,subtlety,12,5,7
Pjh,sargeras,480,rogue,subtlety,12,5,7
Atulano,wyrmrest-accord,480,rogue,subtlety,12,5,7
Shadonas,maelstrom,480,rogue,subtlety,12,5,7
Twnice,tichondrius,480,rogue,subtlety,12,5,7
Blinky,blades-edge,480,rogue,subtlety,12,5,7
Arsènè,whisperwind,480,rogue,subtlety,13,5,8
Faelanna,stormrage,480,rogue,subtlety,13,5,8
Psychostabby,tichondrius,480,rogue,subtlety,18,5,13
Greasymario,kelthuzad,480,rogue,subtlety,18,5,13
Reinaldojr,azralon,480,rogue,subtlety,18,5,13
Tekrul,area-52,480,rogue,subtlety,24,5,19
Zitihait,amanthul,479,rogue,subtlety,6,5,1
Leprocy,tichondrius,479,rogue,subtlety,10,6,4
Qlog,tichondrius,479,rogue,subtlety,12,5,7
Deathbeacøn,sargeras,479,rogue,subtlety,12,5,7
Catoline,bleeding-hollow,479,rogue,subtlety,12,5,7
Toodlles,stormrage,479,rogue,subtlety,12,5,7
Arÿaa,azralon,479,rogue,subtlety,12,5,7
Kekdasneak,dragonmaw,479,rogue,subtlety,18,5,13
Stelarstop,drakkari,479,rogue,subtlety,18,5,13
Abdullahh,tichondrius,478,rogue,subtlety,12,5,7
Falra,wyrmrest-accord,478,rogue,subtlety,18,5,13
Muffens,alterac-mountains,476,rogue,subtlety,12,5,7
Liamoz,amanthul,475,rogue,subtlety,12,5,7
Backtoch,sargeras,447,rogue,subtlety,11,5,6
Fingolfin,terenas,447,rogue,subtlety,11,5,6
Notlim,azralon,432,rogue,subtlety,15,5,10
Akhila,stormrage,431,rogue,subtlety,11,5,6
Pangppy,tichondrius,431,rogue,subtlety,11,5,6
Sketchyweas,sargeras,426,rogue,subtlety,14,6,8
Vandalyze,sargeras,425,rogue,subtlety,13,6,7
Cayladin,tichondrius,416,rogue,subtlety,10,5,5
Luriél,stormrage,415,rogue,subtlety,10,5,5
Prepcoin,malganis,384,rogue,subtlety,6,4,2
Ateabug,wyrmrest-accord,384,rogue,subtlety,6,4,2
Coldkill,bleeding-hollow,384,rogue,subtlety,6,4,2
Sapntapx,malganis,384,rogue,subtlety,6,4,2
Suggmadi,stormrage,384,rogue,subtlety,6,4,2
Dåve,tichondrius,384,rogue,subtlety,6,4,2
Zapstr,bleeding-hollow,384,rogue,subtlety,6,4,2
Foreverioi,tichondrius,384,rogue,subtlety,6,4,2
Exacerbatê,mannoroth,384,rogue,subtlety,6,4,2
Nichala,tichondrius,384,rogue,subtlety,6,4,2
ßackshots,kelthuzad,384,rogue,subtlety,6,4,2
Djsyn,bleeding-hollow,384,rogue,subtlety,6,4,2
Chauva,zuljin,384,rogue,subtlety,6,4,2
Emvee,kelthuzad,384,rogue,subtlety,6,4,2
Invokesap,area-52,384,rogue,subtlety,6,4,2
Evasionx,tichondrius,384,rogue,subtlety,6,4,2
Deadopps,stormrage,384,rogue,subtlety,6,4,2
Sinary,cenarion-circle,384,rogue,subtlety,6,4,2
Dismayx,tichondrius,384,rogue,subtlety,6,4,2
Bilbobagginz,malganis,384,rogue,subtlety,6,4,2
Bootimus,illidan,384,rogue,subtlety,6,4,2
Unoshade,illidan,384,rogue,subtlety,6,4,2
Malgoria,tichondrius,384,rogue,subtlety,6,4,2
Pressuret,frostmourne,384,rogue,subtlety,6,4,2
Wrldstars,illidan,384,rogue,subtlety,6,4,2
Donpeon,hellscream,384,rogue,subtlety,6,4,2
Eversincee,illidan,384,rogue,subtlety,6,4,2
Memnõch,emerald-dream,384,rogue,subtlety,6,4,2
Altaureen,thrall,384,rogue,subtlety,6,4,2
Ghosted,thrall,384,rogue,subtlety,6,4,2
Asneakyfox,thunderlord,384,rogue,subtlety,12,4,8
Dions,ragnaros,384,rogue,subtlety,12,4,8
Seerenai,moon-guard,384,rogue,subtlety,12,4,8
Nevermoon,gallywix,384,rogue,subtlety,12,4,8
Tomas,bloodscalp,384,rogue,subtlety,12,4,8
Lazaruslong,stormrage,384,rogue,subtlety,12,4,8
Zzffqsm,tichondrius,384,rogue,subtlety,12,4,8
Morpheûs,tichondrius,384,rogue,subtlety,12,4,8
Denoms,area-52,384,rogue,subtlety,12,4,8
Restinpeacex,bleeding-hollow,384,rogue,subtlety,12,4,8
Miamiganster,lothar,384,rogue,subtlety,12,4,8
Muggzy,emerald-dream,384,rogue,subtlety,12,4,8
Dezly,tichondrius,384,rogue,subtlety,12,4,8
Blackstabyth,thrall,384,rogue,subtlety,12,4,8
Freshcakes,darkspear,384,rogue,subtlety,12,4,8
Flankks,sargeras,384,rogue,subtlety,12,4,8
Tàlion,emerald-dream,384,rogue,subtlety,12,4,8
Lolgoturbase,hyjal,384,rogue,subtlety,12,4,8
Seutobinhaa,stormrage,384,rogue,subtlety,12,4,8
Elishadowed,proudmoore,384,rogue,subtlety,12,4,8
Oksanaastan,tichondrius,384,rogue,subtlety,18,4,14
Gentlesaop,blackrock,383,rogue,subtlety,6,4,2
Freego,quelthalas,383,rogue,subtlety,6,4,2
Schnozz,lightbringer,383,rogue,subtlety,6,4,2
Suffêr,dalaran,383,rogue,subtlety,6,4,2
Morphina,gilneas,383,rogue,subtlety,6,4,2
Swisha,dathremar,383,rogue,subtlety,12,4,8
Betrayerz,darkspear,383,rogue,subtlety,12,4,8
Majimae,sargeras,383,rogue,subtlety,12,4,8
Ràinê,dalaran,383,rogue,subtlety,12,4,8
Blindedu,dalaran,383,rogue,subtlety,12,4,8
Hènnéssy,frostmourne,383,rogue,subtlety,12,4,8
Toxiccarnage,ghostlands,383,rogue,subtlety,14,4,10
Shadowpunx,nemesis,382,rogue,subtlety,6,4,2
Raylo,blackhand,382,rogue,subtlety,6,4,2
Knife,moon-guard,381,rogue,subtlety,12,4,8
Jjp,tichondrius,367,rogue,subtlety,11,4,7
Sinice,draka,351,rogue,subtlety,8,5,3
Samuraii,zuljin,335,rogue,subtlety,11,4,7
Idsapdat,illidan,330,rogue,subtlety,9,6,3
Peeryl,daggerspine,327,rogue,subtlety,15,5,10
Rawdawged,illidan,320,rogue,subtlety,16,4,12
Zaghat,ragnaros,320,rogue,subtlety,16,4,12
Grima,azralon,319,rogue,subtlety,14,4,10
Papiplunders,sargeras,304,rogue,subtlety,7,4,3
Junemylove,tichondrius,288,rogue,subtlety,6,3,3
Castsequence,khaz-modan,288,rogue,subtlety,6,3,3
Roguish,kiljaeden,288,rogue,subtlety,6,3,3
Jackcurtis,kelthuzad,288,rogue,subtlety,6,3,3
Lagula,ragnaros,288,rogue,subtlety,6,3,3
Snackable,tichondrius,288,rogue,subtlety,6,3,3
Leftyleaf,proudmoore,288,rogue,subtlety,6,3,3
Zarrth,malganis,288,rogue,subtlety,6,3,3
Horyx,zuljin,288,rogue,subtlety,6,3,3
Gongarn,thrall,288,rogue,subtlety,6,3,3
Isonlydosex,tichondrius,288,rogue,subtlety,6,3,3
Amatoxin,tichondrius,288,rogue,subtlety,6,3,3
Pingwii,ragnaros,288,rogue,subtlety,6,3,3
Projectx,tichondrius,288,rogue,subtlety,6,3,3
Saulgoodz,tichondrius,288,rogue,subtlety,6,3,3
Whispx,malganis,288,rogue,subtlety,6,3,3
Metalz,exodar,288,rogue,subtlety,6,3,3
Ralæriel,wyrmrest-accord,288,rogue,subtlety,6,3,3
Reverel,tichondrius,288,rogue,subtlety,6,3,3
Hemorrhages,tichondrius,288,rogue,subtlety,6,3,3
Valaq,tichondrius,288,rogue,subtlety,6,3,3
Dìngapoof,tichondrius,288,rogue,subtlety,6,3,3
Støné,azjolnerub,288,rogue,subtlety,6,3,3
Screwzx,tichondrius,288,rogue,subtlety,6,3,3
Sinfate,bleeding-hollow,288,rogue,subtlety,6,3,3
Athletik,tichondrius,288,rogue,subtlety,6,3,3
Schneric,stormrage,288,rogue,subtlety,6,3,3
Raidei,elune,288,rogue,subtlety,6,3,3
Antijax,stormrage,288,rogue,subtlety,6,3,3
Garnoghan,stormrage,288,rogue,subtlety,6,3,3
Seshtime,tichondrius,288,rogue,subtlety,6,3,3
Woundzx,tichondrius,288,rogue,subtlety,6,3,3
Gotkick,stormrage,288,rogue,subtlety,6,3,3
Commodore,arthas,288,rogue,subtlety,6,3,3
Dödoubleg,stormrage,288,rogue,subtlety,6,3,3
Creayuncle,area-52,288,rogue,subtlety,6,3,3
Thargal,tichondrius,288,rogue,subtlety,6,3,3
Beretta,nemesis,288,rogue,subtlety,6,3,3
Kidkillz,tichondrius,288,rogue,subtlety,6,3,3
Cron,arygos,288,rogue,subtlety,6,3,3
Tonjuras,uther,288,rogue,subtlety,6,3,3
Bumboklaat,bleeding-hollow,288,rogue,subtlety,6,3,3
Anbuartist,dalaran,288,rogue,subtlety,6,3,3
Bøbinette,sargeras,288,rogue,subtlety,6,3,3
Slilsp,sargeras,288,rogue,subtlety,6,3,3
Haeqn,azralon,288,rogue,subtlety,6,3,3
Gåñðøñ,stormscale,288,rogue,subtlety,6,3,3
Luolan,kargath,288,rogue,subtlety,6,3,3
Timat,emerald-dream,288,rogue,subtlety,6,3,3
Ricosap,frostmourne,288,rogue,subtlety,6,3,3
Shadowreapz,barthilas,288,rogue,subtlety,6,3,3
Vellkann,azralon,288,rogue,subtlety,6,3,3
Taraminkadot,sargeras,288,rogue,subtlety,9,4,5
Siniel,scarlet-crusade,288,rogue,subtlety,9,4,5
Ünaru,sargeras,288,rogue,subtlety,7,3,4
ßutthead,malganis,288,rogue,subtlety,7,3,4
Tigbits,frostmourne,288,rogue,subtlety,15,4,11
Corchô,moon-guard,288,rogue,subtlety,12,3,9
Kelelor,kelthuzad,288,rogue,subtlety,12,3,9
Miloandotis,malganis,288,rogue,subtlety,12,3,9
Veterån,tichondrius,288,rogue,subtlety,12,3,9
Yülia,skywall,288,rogue,subtlety,12,3,9
Foofz,kelthuzad,288,rogue,subtlety,12,3,9
Veatrix,zuljin,288,rogue,subtlety,12,3,9
Grinz,sargeras,288,rogue,subtlety,12,3,9
Zeetwntyeght,stormrage,288,rogue,subtlety,12,3,9
Hogstradamus,malganis,288,rogue,subtlety,12,3,9
Yottsu,proudmoore,288,rogue,subtlety,12,3,9
Yamillpgk,ragnaros,288,rogue,subtlety,12,3,9
Bumpamoose,aggramar,288,rogue,subtlety,12,3,9
Terala,perenolde,288,rogue,subtlety,12,3,9
Imbe,nagrand,288,rogue,subtlety,12,3,9
Relaxsingh,tichondrius,288,rogue,subtlety,18,3,15
Xsneakski,jubeithos,287,rogue,subtlety,6,3,3
Framsteg,kelthuzad,287,rogue,subtlety,6,3,3
Darkpaths,hyjal,287,rogue,subtlety,6,3,3
Urukzog,ragnaros,287,rogue,subtlety,6,3,3
Witherblade,area-52,287,rogue,subtlety,6,3,3
Heserth,ragnaros,287,rogue,subtlety,6,3,3
Bajeebus,azshara,287,rogue,subtlety,6,3,3
Namiic,thrall,287,rogue,subtlety,12,3,9
Minnicent,amanthul,287,rogue,subtlety,18,3,15
Teach,illidan,287,rogue,subtlety,18,3,15
Cerebrian,malygos,286,rogue,subtlety,6,3,3
Sodomh,aegwynn,286,rogue,subtlety,6,3,3
Tareduwu,area-52,286,rogue,subtlety,18,3,15
Uchihà,sargeras,284,rogue,subtlety,12,3,9
Uncleblinker,proudmoore,239,rogue,subtlety,5,3,2
Youngdraco,tichondrius,239,rogue,subtlety,5,3,2
Wulfcrest,moon-guard,239,rogue,subtlety,5,3,2
Radagon,fenris,234,rogue,subtlety,9,4,5
Twinkasz,nemesis,234,rogue,subtlety,16,5,11
Dillwilly,moon-guard,192,rogue,subtlety,6,2,4
Tìlt,whisperwind,192,rogue,subtlety,6,2,4
Swingonya,stormrage,192,rogue,subtlety,6,2,4
Elvesnknives,stormrage,192,rogue,subtlety,6,2,4
Buddymelon,thrall,192,rogue,subtlety,6,2,4
Anímosity,darkspear,192,rogue,subtlety,6,2,4
Åaron,thrall,192,rogue,subtlety,6,2,4
Chêckmatê,darkspear,192,rogue,subtlety,6,2,4
Stateless,kelthuzad,192,rogue,subtlety,6,2,4
Runescape,frostmourne,192,rogue,subtlety,6,2,4
Smertin,area-52,192,rogue,subtlety,6,2,4
Jsnlol,zuljin,192,rogue,subtlety,6,2,4
Sathrion,zuljin,192,rogue,subtlety,6,2,4
Coalie,tichondrius,192,rogue,subtlety,6,2,4
Terrorstrike,tichondrius,192,rogue,subtlety,6,2,4
Skorsh,wyrmrest-accord,192,rogue,subtlety,6,2,4
Meadview,bleeding-hollow,192,rogue,subtlety,6,2,4
Gzl,frostmourne,192,rogue,subtlety,6,2,4
Jeezy,shadowmoon,192,rogue,subtlety,6,2,4
Xyltann,bleeding-hollow,192,rogue,subtlety,6,2,4
Antmang,bleeding-hollow,192,rogue,subtlety,6,2,4
Shankmcganks,chogall,192,rogue,subtlety,6,2,4
Smakkey,tichondrius,192,rogue,subtlety,6,2,4
Chuckydoll,sargeras,192,rogue,subtlety,6,2,4
Lmorningstar,altar-of-storms,192,rogue,subtlety,6,2,4
Astroz,sargeras,192,rogue,subtlety,6,2,4
Mãtthew,tichondrius,192,rogue,subtlety,6,2,4
Slíçk,tichondrius,192,rogue,subtlety,6,2,4
Teribád,area-52,192,rogue,subtlety,6,2,4
Surplus,stormscale,192,rogue,subtlety,6,2,4
Icantsleep,tichondrius,192,rogue,subtlety,6,2,4
Rehze,area-52,192,rogue,subtlety,6,2,4
Vanishcdc,area-52,192,rogue,subtlety,6,2,4
Lennysnephew,tichondrius,192,rogue,subtlety,6,2,4
Joegamer,sargeras,192,rogue,subtlety,6,2,4
Grue,gundrak,192,rogue,subtlety,6,2,4
Sneakyt,shadow-council,192,rogue,subtlety,6,2,4
Wyyre,hyjal,192,rogue,subtlety,6,2,4
Jujudaddy,sargeras,192,rogue,subtlety,6,2,4
Tothegravetv,sargeras,192,rogue,subtlety,6,2,4
Nubes,illidan,192,rogue,subtlety,6,2,4
Macklittle,area-52,192,rogue,subtlety,6,2,4
Zôliath,tichondrius,192,rogue,subtlety,6,2,4
Bambooßobby,area-52,192,rogue,subtlety,6,2,4
ßroke,emerald-dream,192,rogue,subtlety,6,2,4
Lenik,azuremyst,192,rogue,subtlety,6,2,4
Wètdream,sargeras,192,rogue,subtlety,6,2,4
Shadowstryfe,tichondrius,192,rogue,subtlety,6,2,4
Pootymunchin,daggerspine,192,rogue,subtlety,6,2,4
Ghostdragons,tichondrius,192,rogue,subtlety,6,2,4
Yourhomieaj,tichondrius,192,rogue,subtlety,6,2,4
Taliwis,burning-blade,192,rogue,subtlety,6,2,4
Kami,kelthuzad,192,rogue,subtlety,6,2,4
Smolblade,nordrassil,192,rogue,subtlety,6,2,4
Rogsky,tichondrius,192,rogue,subtlety,6,2,4
Rujkah,archimonde,192,rogue,subtlety,6,2,4
Brustent,icecrown,192,rogue,subtlety,6,2,4
Badonka,aggramar,192,rogue,subtlety,6,2,4
Slycndice,tortheldrin,192,rogue,subtlety,6,2,4
Nlynn,veknilash,192,rogue,subtlety,6,2,4
Letsgobranon,sargeras,192,rogue,subtlety,6,2,4
Jâm,nerzhul,192,rogue,subtlety,6,2,4
Zzu,azralon,192,rogue,subtlety,6,2,4
Draef,illidan,192,rogue,subtlety,6,2,4
Picaropanda,quelthalas,192,rogue,subtlety,6,2,4
Harasna,emerald-dream,192,rogue,subtlety,6,2,4
Reflexiv,malganis,192,rogue,subtlety,6,2,4
Toomuchcap,aggramar,192,rogue,subtlety,6,2,4
Happyunhappy,illidan,192,rogue,subtlety,6,2,4
Bâerâ,bloodscalp,192,rogue,subtlety,8,2,6
Xenitech,bleeding-hollow,192,rogue,subtlety,8,2,6
Soupline,area-52,192,rogue,subtlety,12,2,10
Brickjohnson,illidan,192,rogue,subtlety,12,2,10
Flèè,illidan,192,rogue,subtlety,12,2,10
Ezmate,frostmourne,192,rogue,subtlety,12,2,10
Zabava,malganis,192,rogue,subtlety,12,2,10
Barmiah,stormrage,192,rogue,subtlety,12,2,10
Cerel,baelgun,192,rogue,subtlety,12,2,10
Trinktick,doomhammer,192,rogue,subtlety,12,2,10
Kestor,barthilas,192,rogue,subtlety,12,2,10
Onulyo,tichondrius,192,rogue,subtlety,12,2,10
Mitchrogue,barthilas,192,rogue,subtlety,12,2,10
Zeriek,stormrage,192,rogue,subtlety,12,2,10
Myhandisfull,tichondrius,192,rogue,subtlety,12,2,10
Krius,blood-furnace,192,rogue,subtlety,12,2,10
Jashyy,tichondrius,192,rogue,subtlety,12,2,10
Pouet,caelestrasz,192,rogue,subtlety,12,2,10
Diabsoule,amanthul,192,rogue,subtlety,12,2,10
Lancarlorïus,ragnaros,191,rogue,subtlety,6,2,4
Hayatö,ragnaros,191,rogue,subtlety,6,2,4
Mccarter,bonechewer,191,rogue,subtlety,12,2,10
Sheiv,shadow-council,190,rogue,subtlety,4,3,1
Eliasael,moon-guard,159,rogue,subtlety,5,2,3
Suhwooh,area-52,159,rogue,subtlety,5,2,3
Koobbo,tichondrius,159,rogue,subtlety,5,2,3
Opensap,tichondrius,159,rogue,subtlety,5,2,3
Khrezin,stonemaul,159,rogue,subtlety,5,2,3
Ganksterqt,dentarg,138,rogue,subtlety,10,3,7
Uhtrred,ragnaros,137,rogue,subtlety,10,3,7
Fadedx,darkspear,128,rogue,subtlety,4,2,2
Namig,cenarion-circle,128,rogue,subtlety,4,2,2
Mdrogue,sargeras,128,rogue,subtlety,4,2,2
Earthinhorn,frostmourne,127,rogue,subtlety,8,2,6
Swickwockdus,azralon,112,rogue,subtlety,7,2,5
Amonn,arthas,96,rogue,subtlety,3,2,1
Jasam,daggerspine,96,rogue,subtlety,3,2,1
Lásko,area-52,96,rogue,subtlety,3,2,1
Treasy,malganis,96,rogue,subtlety,6,1,5
Eimr,stormrage,96,rogue,subtlety,6,1,5
Bloodyblades,blackhand,96,rogue,subtlety,6,1,5
Cotuffa,drakkari,96,rogue,subtlety,6,1,5
Nevatell,malganis,96,rogue,subtlety,6,1,5
Crypblade,sargeras,96,rogue,subtlety,6,1,5
Sapstick,kiljaeden,96,rogue,subtlety,6,1,5
Wrin,sargeras,96,rogue,subtlety,6,1,5
Sawred,bonechewer,96,rogue,subtlety,6,1,5
Anadrol,sargeras,96,rogue,subtlety,6,1,5
Reurog,garrosh,96,rogue,subtlety,6,1,5
Valekk,stormscale,96,rogue,subtlety,6,1,5
Originkorean,terenas,96,rogue,subtlety,6,1,5
Bonizzi,stormrage,96,rogue,subtlety,6,1,5
Kidneyisntop,illidan,96,rogue,subtlety,6,1,5
Dragosha,antonidas,96,rogue,subtlety,6,1,5
Caalo,quelthalas,96,rogue,subtlety,6,1,5
Mídnìght,aegwynn,96,rogue,subtlety,6,1,5
Bubblesrr,whisperwind,96,rogue,subtlety,6,1,5
Páige,ragnaros,96,rogue,subtlety,6,1,5
Kizakuo,moon-guard,96,rogue,subtlety,6,1,5
Satanicrizz,tichondrius,96,rogue,subtlety,6,1,5
Bloodbrawl,caelestrasz,96,rogue,subtlety,6,1,5
Macc,khazgoroth,96,rogue,subtlety,6,1,5
Quackerjacks,lightnings-blade,96,rogue,subtlety,6,1,5
Zelzaramor,ravenholdt,96,rogue,subtlety,6,1,5
Jokerr,proudmoore,96,rogue,subtlety,6,1,5
Frootylol,stormrage,96,rogue,subtlety,6,1,5
Ivanapavlov,kelthuzad,96,rogue,subtlety,6,1,5
Anistreya,wyrmrest-accord,96,rogue,subtlety,6,1,5
Ironrod,shadowmoon,96,rogue,subtlety,6,1,5
Dedrater,shadowmoon,96,rogue,subtlety,6,1,5
Spöke,dalvengyr,96,rogue,subtlety,6,1,5
Illidin,executus,96,rogue,subtlety,6,1,5
Docheatt,dalaran,96,rogue,subtlety,6,1,5
Lawyergamer,bonechewer,96,rogue,subtlety,6,1,5
Slobernocker,stormrage,96,rogue,subtlety,6,1,5
Heimlichkeit,tichondrius,96,rogue,subtlety,6,1,5
Steffmaister,tichondrius,96,rogue,subtlety,6,1,5
Twinkrogue,firetree,96,rogue,subtlety,6,1,5
Penguineater,tichondrius,96,rogue,subtlety,6,1,5
Deepcutz,barthilas,96,rogue,subtlety,6,1,5
Rotbreath,bleeding-hollow,96,rogue,subtlety,6,1,5
Rolomon,tichondrius,96,rogue,subtlety,6,1,5
Dabrat,frostwolf,96,rogue,subtlety,6,1,5
Onetwostep,tichondrius,96,rogue,subtlety,6,1,5
Skinnymayne,laughing-skull,96,rogue,subtlety,6,1,5
Yoodoo,nemesis,96,rogue,subtlety,6,1,5
Flelfo,quelthalas,96,rogue,subtlety,12,1,11
Soultakerr,whisperwind,79,rogue,subtlety,5,1,4
Vùdõõ,area-52,64,rogue,subtlety,4,1,3
Drpibb,ghostlands,63,rogue,subtlety,2,2,0
Swøøpy,stormrage,48,rogue,subtlety,3,1,2
Rocanról,quelthalas,42,rogue,subtlety,6,2,4
Thenelis,dalaran,42,rogue,subtlety,11,2,9
Archazx,sargeras,42,rogue,subtlety,12,2,10
Betakong,quelthalas,31,rogue,subtlety,2,1,1
Traumashears,proudmoore,31,rogue,subtlety,2,1,1
Demonioverde,ragnaros,31,rogue,subtlety,2,1,1
Mirrorx,tichondrius,2229,rogue,assassination,174,90,84
Zarkk,kelthuzad,2219,rogue,assassination,168,88,80
Sllabymkcus,sargeras,2126,rogue,assassination,72,37,35
Larmx,tichondrius,2111,rogue,assassination,78,40,38
Ånko,tichondrius,2110,rogue,assassination,95,47,48
Xiaochulol,tichondrius,2097,rogue,assassination,96,51,45
Alethal,tichondrius,1971,rogue,assassination,78,42,36
Snortedgfuel,drenden,1871,rogue,assassination,48,23,25
Lemon,arygos,1851,rogue,assassination,47,20,27
Poonanixo,frostmourne,1846,rogue,assassination,78,38,40
Alterfate,wyrmrest-accord,1839,rogue,assassination,66,33,33
Feinting,moon-guard,1839,rogue,assassination,76,35,41
Jon,the-venture-co,1838,rogue,assassination,54,27,27
Sio,bleeding-hollow,1837,rogue,assassination,60,30,30
Köfy,quelthalas,1835,rogue,assassination,81,39,42
Ajúmma,tichondrius,1831,rogue,assassination,57,23,34
Jjp,tichondrius,1827,rogue,assassination,65,33,32
Niarzz,tichondrius,1808,rogue,assassination,74,45,29
Relän,ragnaros,1805,rogue,assassination,59,33,26
Sairak,tichondrius,1804,rogue,assassination,101,49,52
Plumblossomx,tichondrius,1803,rogue,assassination,54,24,30
Slickyo,malganis,1792,rogue,assassination,30,20,10
Bloodlessftw,azralon,1783,rogue,assassination,75,33,42
Thargal,tichondrius,1774,rogue,assassination,71,38,33
Beaconlight,tichondrius,1759,rogue,assassination,72,27,45
Stealthdeath,quelthalas,1728,rogue,assassination,42,24,18
Pkkrevolt,archimonde,1724,rogue,assassination,76,39,37
Omnìslash,area-52,1722,rogue,assassination,32,20,12
Ybby,tichondrius,1714,rogue,assassination,68,34,34
Bellamor,tichondrius,1710,rogue,assassination,90,54,36
Lunatixz,emerald-dream,1692,rogue,assassination,53,26,27
Vmoney,draenor,1685,rogue,assassination,30,18,12
Bukaboo,tichondrius,1681,rogue,assassination,42,33,9
Vél,blackrock,1674,rogue,assassination,42,22,20
Whooxx,khazgoroth,1673,rogue,assassination,66,29,37
Viicky,ghostlands,1668,rogue,assassination,48,20,28
Doraz,tichondrius,1664,rogue,assassination,108,55,53
Cutercarver,proudmoore,1662,rogue,assassination,75,33,42
Johnnycryp,barthilas,1652,rogue,assassination,53,27,26
Bellicoses,tichondrius,1651,rogue,assassination,155,84,71
Ivanrah,zuljin,1648,rogue,assassination,45,20,25
Shyzuku,drakkari,1644,rogue,assassination,36,18,18
Purplechil,garrosh,1643,rogue,assassination,126,63,63
Riventrix,zuljin,1640,rogue,assassination,101,47,54
Katovo,tichondrius,1638,rogue,assassination,42,25,17
Rapcher,illidan,1632,rogue,assassination,148,75,73
Josex,lightbringer,1632,rogue,assassination,48,20,28
Gyutaro,black-dragonflight,1629,rogue,assassination,288,146,142
Sheerlol,stormrage,1626,rogue,assassination,49,24,25
Impkasn,tichondrius,1623,rogue,assassination,72,24,48
Quefist,sargeras,1620,rogue,assassination,74,36,38
Assassìn,moon-guard,1618,rogue,assassination,48,27,21
Ultranumb,sargeras,1618,rogue,assassination,51,27,24
Isàputàp,tichondrius,1614,rogue,assassination,60,34,26
Osuba,proudmoore,1604,rogue,assassination,78,36,42
Foreverioi,tichondrius,1603,rogue,assassination,54,31,23
Elinarra,sargeras,1603,rogue,assassination,42,21,21
Nsns,drenden,1603,rogue,assassination,179,89,90
Katmira,tichondrius,1602,rogue,assassination,42,17,25
Sinepymkcus,illidan,1600,rogue,assassination,42,19,23
Replayz,stormrage,1595,rogue,assassination,84,39,45
Lucidstorm,tichondrius,1593,rogue,assassination,30,17,13
Seroth,tichondrius,1590,rogue,assassination,24,17,7
Sparqxx,tichondrius,1589,rogue,assassination,199,100,99
Chêckmatê,darkspear,1589,rogue,assassination,54,25,29
Devstrike,sargeras,1587,rogue,assassination,53,25,28
Htez,frostmourne,1580,rogue,assassination,42,22,20
Xagreth,illidan,1579,rogue,assassination,40,20,20
Ãnimefãnx,moon-guard,1574,rogue,assassination,165,81,84
Dairykeen,misha,1573,rogue,assassination,41,21,20
Nightdelphya,azralon,1572,rogue,assassination,48,19,29
Nhic,tichondrius,1569,rogue,assassination,45,20,25
Wxvi,tichondrius,1563,rogue,assassination,54,30,24
Zirkir,mannoroth,1558,rogue,assassination,44,22,22
Ulley,sargeras,1555,rogue,assassination,56,29,27
Vasherr,zuljin,1554,rogue,assassination,37,22,15
Miamiganster,lothar,1550,rogue,assassination,120,54,66
Kenyel,frostmourne,1543,rogue,assassination,90,40,50
Olé,azralon,1541,rogue,assassination,42,18,24
Nayle,dalaran,1535,rogue,assassination,47,20,27
Kidneyshiv,stormrage,1531,rogue,assassination,36,20,16
Ymxxlolz,tichondrius,1531,rogue,assassination,30,16,14
Yanhuaa,illidan,1524,rogue,assassination,103,56,47
Notjawn,arthas,1524,rogue,assassination,154,83,71
Garrotte,tichondrius,1519,rogue,assassination,187,87,100
Hickery,frostmourne,1518,rogue,assassination,96,42,54
Skeezy,vashj,1517,rogue,assassination,66,25,41
Spikiera,silvermoon,1513,rogue,assassination,63,31,32
Tryedge,moon-guard,1512,rogue,assassination,36,19,17
Bladä,area-52,1502,rogue,assassination,34,17,17
Xilorio,skullcrusher,1496,rogue,assassination,48,24,24
Valaq,tichondrius,1496,rogue,assassination,88,41,47
Staabzz,thrall,1493,rogue,assassination,71,29,42
Onetwostep,tichondrius,1492,rogue,assassination,39,17,22
Stabem,moon-guard,1487,rogue,assassination,153,82,71
Kiosh,tichondrius,1485,rogue,assassination,78,36,42
Paraisbae,tichondrius,1484,rogue,assassination,42,23,19
Sizka,sargeras,1483,rogue,assassination,102,48,54
Camlaw,area-52,1477,rogue,assassination,55,26,29
Gøblìn,tichondrius,1469,rogue,assassination,91,40,51
Coquìn,proudmoore,1460,rogue,assassination,86,43,43
Smkgpvp,stormrage,1456,rogue,assassination,29,16,13
Blackmont,bleeding-hollow,1456,rogue,assassination,60,26,34
Dianiss,ragnaros,1452,rogue,assassination,30,17,13
Creamypeach,stormrage,1450,rogue,assassination,63,29,34
Ezmate,frostmourne,1443,rogue,assassination,107,48,59
Shankeez,tichondrius,1437,rogue,assassination,36,17,19
Øsi,icecrown,1433,rogue,assassination,36,15,21
Cleam,darkspear,1432,rogue,assassination,36,19,17
Pirrow,moon-guard,1429,rogue,assassination,52,28,24
Wujn,tichondrius,1429,rogue,assassination,156,76,80
Leônhart,thrall,1428,rogue,assassination,54,25,29
Hypnothot,tichondrius,1425,rogue,assassination,108,36,72
Madge,area-52,1421,rogue,assassination,72,33,39
Happyslice,stormrage,1415,rogue,assassination,27,16,11
Youwho,kiljaeden,1410,rogue,assassination,87,42,45
Vendëttä,quelthalas,1399,rogue,assassination,48,27,21
Playmaker,frostwolf,1396,rogue,assassination,156,82,74
Pandrogue,shadowsong,1396,rogue,assassination,48,24,24
Galaily,proudmoore,1387,rogue,assassination,90,44,46
Lcl,proudmoore,1384,rogue,assassination,244,123,121
Itokuri,ysera,1379,rogue,assassination,42,19,23
Páïgèvêntürã,bleeding-hollow,1367,rogue,assassination,32,15,17
Boonee,frostmourne,1363,rogue,assassination,71,33,38
Apocalipto,barthilas,1362,rogue,assassination,65,28,37
Valråvn,bloodscalp,1359,rogue,assassination,23,15,8
Hiddencosts,proudmoore,1345,rogue,assassination,123,63,60
Wansuiye,tichondrius,1340,rogue,assassination,42,14,28
Strîkér,tichondrius,1339,rogue,assassination,31,15,16
Swexee,area-52,1339,rogue,assassination,60,26,34
Røgüë,malganis,1338,rogue,assassination,30,14,16
Kahlx,azralon,1335,rogue,assassination,95,45,50
Urukzog,ragnaros,1334,rogue,assassination,60,31,29
Wxva,tichondrius,1331,rogue,assassination,30,14,16
Driprat,area-52,1316,rogue,assassination,24,14,10
Rêdrum,illidan,1313,rogue,assassination,108,39,69
Vimit,tichondrius,1310,rogue,assassination,66,29,37
Powerjuicer,tichondrius,1300,rogue,assassination,66,31,35
Greenlemons,lightnings-blade,1297,rogue,assassination,54,30,24
Kindasorry,illidan,1290,rogue,assassination,54,23,31
Gorgdrake,illidan,1283,rogue,assassination,78,39,39
Aynrand,drakkari,1281,rogue,assassination,36,16,20
Morgoophh,azralon,1279,rogue,assassination,140,74,66
Keepitshadow,frostmourne,1279,rogue,assassination,89,45,44
Harlyquinn,barthilas,1279,rogue,assassination,90,45,45
Grasiel,tichondrius,1277,rogue,assassination,62,27,35
Doomcore,barthilas,1276,rogue,assassination,41,21,20
Blindfun,emerald-dream,1275,rogue,assassination,33,19,14
Vannisshh,shattered-halls,1267,rogue,assassination,147,68,79
Keylâ,thrall,1264,rogue,assassination,62,33,29
Seengivenchy,zuljin,1262,rogue,assassination,26,14,12
Engels,quelthalas,1262,rogue,assassination,72,33,39
Ninjadoo,tichondrius,1262,rogue,assassination,62,24,38
Sinnister,queldorei,1259,rogue,assassination,47,20,27
Regios,shadowmoon,1255,rogue,assassination,71,31,40
Lemonlemon,arygos,1247,rogue,assassination,24,13,11
Sênorita,tichondrius,1246,rogue,assassination,36,13,23
Lakeshark,stormrage,1246,rogue,assassination,36,13,23
Helecho,tichondrius,1244,rogue,assassination,30,13,17
Lyapunov,tichondrius,1242,rogue,assassination,24,13,11
Enyr,frostmourne,1241,rogue,assassination,54,23,31
Worm,demon-soul,1240,rogue,assassination,36,16,20
Roollz,nemesis,1240,rogue,assassination,33,14,19
Shninzy,senjin,1239,rogue,assassination,24,13,11
Spooky,bleeding-hollow,1229,rogue,assassination,100,48,52
Raskapashan,moon-guard,1229,rogue,assassination,36,13,23
Pst,spirestone,1227,rogue,assassination,24,14,10
Jarcus,aggramar,1225,rogue,assassination,36,13,23
Shinobick,kelthuzad,1222,rogue,assassination,30,15,15
Dismayx,tichondrius,1198,rogue,assassination,47,20,27
Zxytox,hyjal,1191,rogue,assassination,33,17,16
Jeshka,wyrmrest-accord,1189,rogue,assassination,42,20,22
Lórdx,illidan,1189,rogue,assassination,56,25,31
Fakie,quelthalas,1176,rogue,assassination,37,21,16
Riggie,turalyon,1170,rogue,assassination,29,14,15
Mìtsuru,proudmoore,1165,rogue,assassination,36,20,16
Evilsanta,sargeras,1164,rogue,assassination,34,14,20
Lycanthropì,illidan,1151,rogue,assassination,18,12,6
Peaches,akama,1151,rogue,assassination,24,12,12
Kenteenx,tichondrius,1151,rogue,assassination,30,12,18
Kriszov,moon-guard,1149,rogue,assassination,142,71,71
Lesentixd,stormrage,1149,rogue,assassination,30,12,18
Slycndice,tortheldrin,1148,rogue,assassination,78,45,33
Poisonous,emerald-dream,1147,rogue,assassination,30,12,18
Khrezin,stonemaul,1147,rogue,assassination,30,12,18
Odetodindel,nerzhul,1146,rogue,assassination,60,32,28
Sergioz,quelthalas,1143,rogue,assassination,54,23,31
Ixìa,vashj,1135,rogue,assassination,30,12,18
Peeryl,daggerspine,1129,rogue,assassination,130,74,56
Chakarr,stormrage,1127,rogue,assassination,18,12,6
Laotrec,nemesis,1126,rogue,assassination,24,12,12
Dothras,stormrage,1119,rogue,assassination,87,43,44
Copler,tichondrius,1110,rogue,assassination,48,17,31
Roguepvp,stormrage,1108,rogue,assassination,64,35,29
Nikhlaus,ragnaros,1107,rogue,assassination,24,13,11
Rodanheim,burning-blade,1107,rogue,assassination,54,24,30
Indivisible,thunderlord,1104,rogue,assassination,66,33,33
Altarys,ragnaros,1103,rogue,assassination,27,15,12
Chingado,kaelthas,1102,rogue,assassination,30,12,18
Dysxliec,dalaran,1101,rogue,assassination,35,12,23
Beedie,malganis,1096,rogue,assassination,87,38,49
Smoketoad,tichondrius,1081,rogue,assassination,30,15,15
Lilgoosie,korgath,1062,rogue,assassination,36,14,22
Osiriko,thunderlord,1061,rogue,assassination,114,61,53
Cashbigknife,area-52,1061,rogue,assassination,70,28,42
Aiden,burning-legion,1056,rogue,assassination,18,11,7
Lycanthropî,illidan,1056,rogue,assassination,24,11,13
Frez,amanthul,1056,rogue,assassination,30,11,19
Turec,illidan,1056,rogue,assassination,36,11,25
Ziggee,sargeras,1055,rogue,assassination,50,25,25
Grafting,tichondrius,1055,rogue,assassination,24,11,13
Wongcha,darkspear,1055,rogue,assassination,24,11,13
Vastørogue,azralon,1053,rogue,assassination,55,29,26
Zipperx,tichondrius,1053,rogue,assassination,30,11,19
Stuns,azshara,1052,rogue,assassination,18,11,7
Kazzo,tichondrius,1050,rogue,assassination,18,11,7
Torshe,sargeras,1046,rogue,assassination,18,11,7
Looprevil,andorhal,1043,rogue,assassination,24,14,10
Adrianstab,dalaran,1033,rogue,assassination,60,30,30
Oddblade,stormrage,1025,rogue,assassination,36,11,25
Tortador,quelthalas,1013,rogue,assassination,62,28,34
Snoopdrogado,sargeras,1010,rogue,assassination,52,27,25
Lambs,blackhand,1000,rogue,assassination,29,11,18
Sheinnér,ragnaros,998,rogue,assassination,25,12,13
Roguecity,tichondrius,995,rogue,assassination,130,52,78
Girio,thrall,991,rogue,assassination,23,11,12
Karing,onyxia,977,rogue,assassination,22,11,11
Pegglerogue,fizzcrank,977,rogue,assassination,84,37,47
Wolgan,nemesis,975,rogue,assassination,61,30,31
Headless,dragonmaw,968,rogue,assassination,70,36,34
Daggerback,bleeding-hollow,960,rogue,assassination,23,13,10
Jonuts,bleeding-hollow,960,rogue,assassination,18,10,8
Lakeshark,tichondrius,960,rogue,assassination,18,10,8
Gogothirteen,kiljaeden,960,rogue,assassination,32,15,17
Kents,tichondrius,960,rogue,assassination,24,10,14
Dizzymoods,stormrage,960,rogue,assassination,24,10,14
Shigoo,sargeras,958,rogue,assassination,18,10,8
Cerut,illidan,957,rogue,assassination,18,10,8
Vindzl,azralon,957,rogue,assassination,24,10,14
Average,burning-blade,954,rogue,assassination,27,10,17
Sangreale,nemesis,953,rogue,assassination,18,10,8
Pál,quelthalas,950,rogue,assassination,18,10,8
Ràinê,dalaran,949,rogue,assassination,18,10,8
Problemchild,rexxar,949,rogue,assassination,24,10,14
Vozzy,proudmoore,947,rogue,assassination,30,17,13
Xalsathoth,sargeras,946,rogue,assassination,36,10,26
Elithr,nemesis,944,rogue,assassination,18,10,8
Skoorbals,tichondrius,938,rogue,assassination,22,11,11
Atomicgoat,tichondrius,928,rogue,assassination,33,12,21
Peepoclown,illidan,927,rogue,assassination,22,10,12
Papadopolous,zuluhed,917,rogue,assassination,26,11,15
Endlesswaltz,zuljin,912,rogue,assassination,27,10,17
Kk,dalaran,904,rogue,assassination,20,13,7
Thenelis,dalaran,897,rogue,assassination,43,10,33
Criptoniø,azralon,883,rogue,assassination,28,13,15
Skigskag,shadowsong,883,rogue,assassination,109,47,62
Cjayy,bleeding-hollow,876,rogue,assassination,31,11,20
Unlucký,sargeras,864,rogue,assassination,12,9,3
Ahjii,malganis,864,rogue,assassination,30,9,21
Hookahrogue,area-52,863,rogue,assassination,18,9,9
Brendantko,arthas,863,rogue,assassination,18,9,9
Entropyphi,daggerspine,863,rogue,assassination,24,9,15
Whoox,khazgoroth,863,rogue,assassination,30,9,21
Mcskipa,sargeras,862,rogue,assassination,12,9,3
Stillsol,stormrage,861,rogue,assassination,12,9,3
Ballflicker,malganis,857,rogue,assassination,30,9,21
Wreatus,moon-guard,854,rogue,assassination,84,33,51
Teach,illidan,849,rogue,assassination,102,37,65
Luckycrit,frostwolf,840,rogue,assassination,30,13,17
Yenrab,illidan,831,rogue,assassination,23,9,14
Slickdude,stormrage,828,rogue,assassination,54,13,41
Píxíedúst,black-dragonflight,812,rogue,assassination,34,10,24
Chersy,tichondrius,810,rogue,assassination,32,10,22
Zamorant,emerald-dream,806,rogue,assassination,53,11,42
Zapersapp,malygos,803,rogue,assassination,28,10,18
Thepitt,stormrage,774,rogue,assassination,31,9,22
Ôñéèýèdkíñg,stormrage,768,rogue,assassination,12,8,4
Rîa,area-52,768,rogue,assassination,18,8,10
Downsix,sargeras,768,rogue,assassination,18,8,10
Clairered,tichondrius,768,rogue,assassination,18,8,10
Snakegødx,sargeras,768,rogue,assassination,21,9,12
Atulano,wyrmrest-accord,768,rogue,assassination,24,8,16
Kzx,illidan,767,rogue,assassination,12,8,4
Lyliym,frostmourne,767,rogue,assassination,12,8,4
Exeg,tichondrius,767,rogue,assassination,12,8,4
Dockside,stormrage,767,rogue,assassination,12,8,4
Gøblìn,stormrage,767,rogue,assassination,15,9,6
Darkdessoft,ragnaros,767,rogue,assassination,18,8,10
Shiddlesz,area-52,767,rogue,assassination,18,8,10
Sagatha,bleeding-hollow,767,rogue,assassination,18,8,10
Zetéra,ragnaros,767,rogue,assassination,18,8,10
Xshadowt,ragnaros,767,rogue,assassination,24,8,16
Sindor,azralon,767,rogue,assassination,30,8,22
Mylovejunex,tichondrius,766,rogue,assassination,12,8,4
ßackshots,kelthuzad,766,rogue,assassination,18,8,10
Lakki,chromaggus,766,rogue,assassination,18,8,10
Velsad,sargeras,764,rogue,assassination,23,8,15
Manersi,akama,764,rogue,assassination,24,8,16
Turyx,azralon,764,rogue,assassination,30,8,22
Hattrìck,area-52,763,rogue,assassination,24,8,16
Picaroxp,drakkari,762,rogue,assassination,12,8,4
Stepper,aegwynn,762,rogue,assassination,18,8,10
Zropi,quelthalas,762,rogue,assassination,24,8,16
Pikacuulo,ragnaros,760,rogue,assassination,31,9,22
Núm,tichondrius,756,rogue,assassination,32,12,20
Snoor,nemesis,753,rogue,assassination,21,9,12
Killua,dalaran,752,rogue,assassination,18,8,10
Ñovä,tichondrius,750,rogue,assassination,18,8,10
Anyiele,stormrage,747,rogue,assassination,18,8,10
Moardner,dalaran,739,rogue,assassination,42,10,32
Loligotyou,stormrage,725,rogue,assassination,34,8,26
Cruelworld,stormrage,713,rogue,assassination,30,10,20
Snub,aerie-peak,713,rogue,assassination,28,8,20
Alkal,stormreaver,712,rogue,assassination,22,10,12
Ghoulzer,tichondrius,704,rogue,assassination,10,8,2
Inaniss,tichondrius,703,rogue,assassination,14,8,6
Superharry,tichondrius,702,rogue,assassination,22,8,14
Lxw,frostmourne,672,rogue,assassination,12,7,5
Jaganz,stormrage,672,rogue,assassination,12,7,5
Sotypical,area-52,672,rogue,assassination,12,7,5
Skitsöu,tichondrius,672,rogue,assassination,12,7,5
Chriseanrock,illidan,672,rogue,assassination,12,7,5
Toxicplyer,malganis,672,rogue,assassination,12,7,5
Dzd,stormrage,672,rogue,assassination,12,7,5
Elwynë,tichondrius,672,rogue,assassination,18,7,11
Mydearest,tichondrius,672,rogue,assassination,18,7,11
Zaszune,stormrage,672,rogue,assassination,18,7,11
Sanozü,azralon,672,rogue,assassination,18,7,11
Nogodplsno,stormrage,672,rogue,assassination,18,7,11
Løgîc,tichondrius,671,rogue,assassination,12,7,5
Ambushr,tichondrius,671,rogue,assassination,12,7,5
Deepman,gorefiend,671,rogue,assassination,12,7,5
Gucciboo,sargeras,671,rogue,assassination,12,7,5
Slizard,boulderfist,671,rogue,assassination,12,7,5
Alizashea,stormrage,671,rogue,assassination,12,7,5
Johnthefum,malganis,671,rogue,assassination,18,7,11
Showclass,stormrage,671,rogue,assassination,18,7,11
Ezzdeath,tichondrius,671,rogue,assassination,18,7,11
Tìnkerton,wyrmrest-accord,671,rogue,assassination,24,7,17
Andreals,ragnaros,670,rogue,assassination,12,7,5
Habock,ragnaros,670,rogue,assassination,17,7,10
Timat,emerald-dream,670,rogue,assassination,18,7,11
Sap,garrosh,670,rogue,assassination,18,7,11
Anyiel,stormrage,670,rogue,assassination,24,7,17
Jagó,malganis,669,rogue,assassination,18,7,11
Sinistro,bleeding-hollow,667,rogue,assassination,12,7,5
Jakkov,blackrock,666,rogue,assassination,18,7,11
Kiorz,tichondrius,665,rogue,assassination,12,7,5
Orcwarhammer,tichondrius,662,rogue,assassination,12,7,5
Slootslayer,azshara,662,rogue,assassination,18,7,11
Muffens,alterac-mountains,662,rogue,assassination,18,7,11
Nikjawar,illidan,660,rogue,assassination,18,7,11
Tiptoez,bleeding-hollow,637,rogue,assassination,15,8,7
Runakó,kelthuzad,623,rogue,assassination,11,7,4
Pochomän,ragnaros,618,rogue,assassination,16,9,7
Onulyo,tichondrius,618,rogue,assassination,16,8,8
Twoheaded,frostmourne,576,rogue,assassination,12,6,6
Kayriss,antonidas,576,rogue,assassination,12,6,6
Nicknasty,kelthuzad,576,rogue,assassination,12,6,6
Cmòón,tichondrius,576,rogue,assassination,12,6,6
Mosedz,tichondrius,576,rogue,assassination,12,6,6
Stabasaurus,blood-furnace,576,rogue,assassination,12,6,6
Jaywas,tichondrius,576,rogue,assassination,12,6,6
Chipetan,hyjal,576,rogue,assassination,12,6,6
Luriél,stormrage,576,rogue,assassination,12,6,6
Bloodygoat,area-52,576,rogue,assassination,12,6,6
Tri,the-underbog,576,rogue,assassination,18,6,12
Slipperydog,jubeithos,576,rogue,assassination,18,6,12
Çõvìd,malganis,576,rogue,assassination,30,6,24
Cox,bleeding-hollow,575,rogue,assassination,6,6,0
Blaçkout,thrall,575,rogue,assassination,12,6,6
Theblindsap,dalaran,575,rogue,assassination,12,6,6
Robinsony,tichondrius,575,rogue,assassination,12,6,6
Arlom,daggerspine,575,rogue,assassination,12,6,6
Slain,dark-iron,575,rogue,assassination,15,6,9
Ethaniel,bronzebeard,575,rogue,assassination,15,6,9
Sgnome,quelthalas,575,rogue,assassination,18,6,12
Eldan,moon-guard,575,rogue,assassination,24,6,18
Aurrora,kiljaeden,574,rogue,assassination,17,6,11
Mcvillain,kelthuzad,573,rogue,assassination,12,6,6
Vegettaa,azralon,573,rogue,assassination,18,6,12
Escape,elune,571,rogue,assassination,12,6,6
Akalio,laughing-skull,571,rogue,assassination,18,6,12
Addvilpm,wyrmrest-accord,570,rogue,assassination,12,6,6
Annastasiya,moon-guard,568,rogue,assassination,18,6,12
Vitalz,bloodscalp,568,rogue,assassination,18,6,12
Euweu,azralon,567,rogue,assassination,18,6,12
Hellwolf,azgalor,565,rogue,assassination,13,6,7
Drpepzi,tichondrius,565,rogue,assassination,24,6,18
Sneakyfoot,gorgonnash,535,rogue,assassination,35,7,28
Genève,dreadmaul,526,rogue,assassination,11,6,5
Respia,proudmoore,518,rogue,assassination,22,8,14
Sìcarìus,tichondrius,512,rogue,assassination,22,6,16
Entrerí,illidan,480,rogue,assassination,6,5,1
Purcius,moon-guard,480,rogue,assassination,6,5,1
Mayyhem,caelestrasz,480,rogue,assassination,6,5,1
Lvx,frostmourne,480,rogue,assassination,6,5,1
Pwnsauce,frostmourne,480,rogue,assassination,7,5,2
Ahji,malganis,480,rogue,assassination,12,5,7
Ppdx,malganis,480,rogue,assassination,12,5,7
Vlayd,ragnaros,480,rogue,assassination,12,5,7
Bloore,fizzcrank,480,rogue,assassination,12,5,7
Fuzzyslow,stormrage,480,rogue,assassination,12,5,7
Depressedx,illidan,480,rogue,assassination,12,5,7
Tberg,emerald-dream,480,rogue,assassination,12,5,7
Gomma,stormrage,480,rogue,assassination,12,5,7
Surprises,azralon,480,rogue,assassination,12,5,7
Breakxcvii,bleeding-hollow,480,rogue,assassination,12,5,7
Kidneyisntop,illidan,480,rogue,assassination,12,5,7
Xm,sargeras,480,rogue,assassination,18,5,13
Yellowdawt,stormrage,480,rogue,assassination,18,5,13
Beartøøth,stormrage,479,rogue,assassination,6,5,1
Paradise,smolderthorn,479,rogue,assassination,6,5,1
Poofhottie,lightbringer,479,rogue,assassination,12,5,7
Mashad,moon-guard,479,rogue,assassination,12,5,7
Bigcolumn,tichondrius,479,rogue,assassination,12,5,7
Slayersama,ragnaros,479,rogue,assassination,12,5,7
Scarrog,wyrmrest-accord,479,rogue,assassination,12,5,7
Møfshanks,sargeras,479,rogue,assassination,12,5,7
Meilh,emerald-dream,479,rogue,assassination,12,5,7
Senpaifuta,proudmoore,479,rogue,assassination,12,5,7
Dessenia,illidan,479,rogue,assassination,12,5,7
Eliasael,moon-guard,479,rogue,assassination,15,6,9
Cynalia,sargeras,479,rogue,assassination,15,5,10
Rinestiria,arthas,479,rogue,assassination,18,5,13
Artymesia,medivh,478,rogue,assassination,6,5,1
Villainrogue,stormrage,478,rogue,assassination,12,5,7
Bonizzi,stormrage,478,rogue,assassination,12,5,7
Maison,ragnaros,478,rogue,assassination,12,5,7
Lethalist,whisperwind,476,rogue,assassination,12,5,7
Wìndrunner,dalaran,474,rogue,assassination,12,5,7
Killdead,warsong,473,rogue,assassination,12,5,7
Savagedeeps,stormreaver,472,rogue,assassination,12,5,7
Donamarillo,sargeras,462,rogue,assassination,11,5,6
Julius,malganis,447,rogue,assassination,8,6,2
Shizz,tichondrius,447,rogue,assassination,14,6,8
Minnicent,amanthul,413,rogue,assassination,10,5,5
Jxxs,zuljin,384,rogue,assassination,6,4,2
Fofree,hyjal,384,rogue,assassination,6,4,2
Elixera,sargeras,384,rogue,assassination,6,4,2
Schleazy,emerald-dream,384,rogue,assassination,6,4,2
Alavennian,tichondrius,384,rogue,assassination,6,4,2
Tmpikaboo,tichondrius,384,rogue,assassination,6,4,2
Betakong,quelthalas,384,rogue,assassination,6,4,2
Taessin,kelthuzad,384,rogue,assassination,6,4,2
Csguixuan,aerie-peak,384,rogue,assassination,6,4,2
Shaisty,malganis,384,rogue,assassination,6,4,2
Chokonet,gurubashi,384,rogue,assassination,6,4,2
Buckbreaker,stormrage,384,rogue,assassination,6,4,2
Colom,moon-guard,384,rogue,assassination,6,4,2
Venomsnáke,tichondrius,384,rogue,assassination,6,4,2
Sapmepapi,illidan,384,rogue,assassination,6,4,2
Brobrando,tichondrius,384,rogue,assassination,6,4,2
Kágé,ragnaros,384,rogue,assassination,6,4,2
Hollowtipzz,tichondrius,384,rogue,assassination,6,4,2
Pike,barthilas,384,rogue,assassination,6,4,2
Grima,azralon,384,rogue,assassination,6,4,2
Yurkarogue,tichondrius,384,rogue,assassination,6,4,2
Arcess,ragnaros,384,rogue,assassination,6,4,2
Kargargar,thrall,384,rogue,assassination,12,4,8
Sillikitti,tichondrius,384,rogue,assassination,12,4,8
Wolfsire,queldorei,384,rogue,assassination,12,4,8
Celèphaïs,tichondrius,384,rogue,assassination,12,4,8
Mansa,zangarmarsh,384,rogue,assassination,12,4,8
Gridisx,wyrmrest-accord,384,rogue,assassination,12,4,8
Shadøw,the-forgotten-coast,384,rogue,assassination,12,4,8
Ninjamf,bleeding-hollow,384,rogue,assassination,12,4,8
Stabbyboy,malganis,384,rogue,assassination,12,4,8
Cryoph,illidan,384,rogue,assassination,12,4,8
Cv,proudmoore,384,rogue,assassination,12,4,8
Sellers,tichondrius,384,rogue,assassination,12,4,8
Saiine,drenden,384,rogue,assassination,12,4,8
Mirâge,illidan,384,rogue,assassination,12,4,8
Drakariano,ragnaros,384,rogue,assassination,12,4,8
Psilocin,sargeras,384,rogue,assassination,12,4,8
Wowslayer,bleeding-hollow,384,rogue,assassination,12,4,8
Hirian,misha,384,rogue,assassination,12,4,8
Ðisappéar,ragnaros,384,rogue,assassination,17,4,13
Denoms,area-52,384,rogue,assassination,18,4,14
Kdrx,thrall,384,rogue,assassination,18,4,14
Skinnymayne,laughing-skull,384,rogue,assassination,18,4,14
Escurecer,azralon,384,rogue,assassination,18,4,14
Ssigma,tichondrius,384,rogue,assassination,18,4,14
Gladlol,stormrage,384,rogue,assassination,18,4,14
Azrek,sargeras,384,rogue,assassination,18,4,14
Bityellow,tichondrius,383,rogue,assassination,6,4,2
Steeldiesel,sargeras,383,rogue,assassination,12,4,8
Ñinjå,alleria,383,rogue,assassination,12,4,8
Corteleve,nemesis,383,rogue,assassination,12,4,8
Jestertyv,hyjal,383,rogue,assassination,12,4,8
Setsu,sargeras,383,rogue,assassination,13,4,9
Wrinklevoss,proudmoore,382,rogue,assassination,12,4,8
Tralisong,azshara,382,rogue,assassination,12,4,8
Hésta,moon-guard,382,rogue,assassination,12,4,8
Kalandar,moon-guard,382,rogue,assassination,12,4,8
Slobernocker,stormrage,381,rogue,assassination,12,4,8
Fllokii,arygos,381,rogue,assassination,12,4,8
Dragoonz,nemesis,351,rogue,assassination,11,4,7
Tolthe,hyjal,351,rogue,assassination,11,4,7
Siniel,scarlet-crusade,336,rogue,assassination,9,4,5
Gersonq,moon-guard,328,rogue,assassination,13,6,7
Whatsåpp,gallywix,320,rogue,assassination,10,4,6
Coopi,tichondrius,320,rogue,assassination,10,4,6
Pícáróóná,ragnaros,320,rogue,assassination,16,4,12
Suffêr,dalaran,319,rogue,assassination,8,4,4
Xvds,tichondrius,319,rogue,assassination,14,4,10
Ziedrich,frostmourne,318,rogue,assassination,10,4,6
Greasybbsea,illidan,288,rogue,assassination,6,3,3
Rýuu,bleeding-hollow,288,rogue,assassination,6,3,3
Cron,arygos,288,rogue,assassination,6,3,3
Uxaen,tichondrius,288,rogue,assassination,6,3,3
Inunofun,stormrage,288,rogue,assassination,6,3,3
Outsap,tichondrius,288,rogue,assassination,6,3,3
Jannie,rexxar,288,rogue,assassination,6,3,3
Mügi,ragnaros,288,rogue,assassination,6,3,3
Raj,blood-furnace,288,rogue,assassination,6,3,3
Brlsels,azralon,288,rogue,assassination,6,3,3
Alithileria,moon-guard,288,rogue,assassination,6,3,3
Skîttlês,kul-tiras,288,rogue,assassination,6,3,3
Wowamaze,aegwynn,288,rogue,assassination,6,3,3
Twinkasz,nemesis,288,rogue,assassination,6,3,3
Dïeb,zuljin,288,rogue,assassination,6,3,3
Esraxo,frostmourne,288,rogue,assassination,6,3,3
Saltypwncake,illidan,288,rogue,assassination,6,3,3
Steffmaister,tichondrius,288,rogue,assassination,6,3,3
Anímosity,darkspear,288,rogue,assassination,6,3,3
Maciota,area-52,288,rogue,assassination,6,3,3
Pusufox,tichondrius,288,rogue,assassination,6,3,3
Kehkoa,thrall,288,rogue,assassination,6,3,3
Ncb,bleeding-hollow,288,rogue,assassination,6,3,3
Drapezz,kelthuzad,288,rogue,assassination,6,3,3
Thâïßòÿgøóñ,jubeithos,288,rogue,assassination,6,3,3
Corrier,tichondrius,288,rogue,assassination,6,3,3
Sonymf,frostmourne,288,rogue,assassination,6,3,3
Akayod,tichondrius,288,rogue,assassination,6,3,3
Mcjagerx,darkspear,288,rogue,assassination,6,3,3
Prodixybn,illidan,288,rogue,assassination,6,3,3
Gulvzer,tichondrius,288,rogue,assassination,6,3,3
Deeshdosh,illidan,288,rogue,assassination,6,3,3
Syxs,sargeras,288,rogue,assassination,6,3,3
Calebrogue,illidan,288,rogue,assassination,6,3,3
Punkyass,azralon,288,rogue,assassination,6,3,3
Åmg,tichondrius,288,rogue,assassination,6,3,3
Emvee,kelthuzad,288,rogue,assassination,6,3,3
Bigtengu,tichondrius,288,rogue,assassination,6,3,3
Redlïne,tichondrius,288,rogue,assassination,12,3,9
Pintofwoc,area-52,288,rogue,assassination,12,3,9
Axm,azralon,288,rogue,assassination,12,3,9
Brudashmurda,tichondrius,288,rogue,assassination,12,3,9
Shortcut,khadgar,288,rogue,assassination,12,3,9
Arïa,drakkari,288,rogue,assassination,12,3,9
Finlander,area-52,288,rogue,assassination,12,3,9
Karmagoodttv,stormrage,288,rogue,assassination,12,3,9
Aevaela,duskwood,288,rogue,assassination,12,3,9
Bubbski,area-52,288,rogue,assassination,12,3,9
Flattsr,tichondrius,288,rogue,assassination,12,3,9
Joeyzord,stormrage,288,rogue,assassination,12,3,9
Tìlt,whisperwind,288,rogue,assassination,12,3,9
Cydonian,ragnaros,288,rogue,assassination,12,3,9
Benielfman,illidan,288,rogue,assassination,12,3,9
Elevorra,frostmourne,288,rogue,assassination,12,3,9
Brianä,quelthalas,288,rogue,assassination,12,3,9
Alttee,proudmoore,288,rogue,assassination,12,3,9
Trinktick,doomhammer,288,rogue,assassination,12,3,9
Sunshinezx,frostmourne,288,rogue,assassination,12,3,9
Ereshkigall,ragnaros,288,rogue,assassination,18,3,15
Diamondiâ,moon-guard,288,rogue,assassination,18,3,15
Revozy,azralon,287,rogue,assassination,6,3,3
Gilhela,bloodhoof,287,rogue,assassination,6,3,3
Shadownibba,illidan,287,rogue,assassination,6,3,3
Clipp,wildhammer,287,rogue,assassination,6,3,3
Stunedya,destromath,287,rogue,assassination,6,3,3
Moridra,demon-soul,287,rogue,assassination,6,3,3
Talinô,moknathal,287,rogue,assassination,12,3,9
Tracemakerr,emerald-dream,287,rogue,assassination,12,3,9
Lyndra,thunderlord,287,rogue,assassination,12,3,9
Chïdaruma,azralon,287,rogue,assassination,12,3,9
Anarusekkusu,wyrmrest-accord,287,rogue,assassination,12,3,9
Olg,arathor,287,rogue,assassination,12,3,9
Cricketts,kalecgos,287,rogue,assassination,16,3,13
Emrogue,ragnaros,286,rogue,assassination,6,3,3
Clothies,zuljin,285,rogue,assassination,12,3,9
Sanguinnar,nemesis,285,rogue,assassination,12,3,9
Synesh,moon-guard,255,rogue,assassination,11,3,8
Sneakoh,illidan,255,rogue,assassination,17,3,14
Thoxic,barthilas,239,rogue,assassination,5,3,2
Tamsy,the-forgotten-coast,239,rogue,assassination,5,3,2
Pitfirex,area-52,239,rogue,assassination,5,3,2
Walnutrog,area-52,234,rogue,assassination,11,5,6
Pãndã,stormrage,234,rogue,assassination,13,4,9
Skairipa,agamaggan,232,rogue,assassination,7,4,3
Gygáx,terenas,206,rogue,assassination,7,3,4
Roguegirl,alexstrasza,202,rogue,assassination,18,4,14
Dtelkham,tichondrius,192,rogue,assassination,4,3,1
Salätzar,quelthalas,192,rogue,assassination,6,2,4
Tagerung,malganis,192,rogue,assassination,6,2,4
Haeqn,nemesis,192,rogue,assassination,6,2,4
Swingonya,stormrage,192,rogue,assassination,6,2,4
Yoodoo,nemesis,192,rogue,assassination,6,2,4
Slashinsteev,dalaran,192,rogue,assassination,6,2,4
Historymaker,tichondrius,192,rogue,assassination,6,2,4
Novarra,tichondrius,192,rogue,assassination,6,2,4
Kazúmi,stormrage,192,rogue,assassination,6,2,4
Mermm,burning-blade,192,rogue,assassination,6,2,4
Märlboro,ragnaros,192,rogue,assassination,6,2,4
Gilbertgr,boulderfist,192,rogue,assassination,6,2,4
Kellthzard,goldrinn,192,rogue,assassination,6,2,4
Roguemain,smolderthorn,192,rogue,assassination,6,2,4
Karmakula,wildhammer,192,rogue,assassination,6,2,4
Zogbu,stormrage,192,rogue,assassination,6,2,4
Streetjesuz,barthilas,192,rogue,assassination,6,2,4
Yanh,tichondrius,192,rogue,assassination,6,2,4
Cktko,stormrage,192,rogue,assassination,6,2,4
Miloandotis,malganis,192,rogue,assassination,6,2,4
Heimlichkeit,tichondrius,192,rogue,assassination,6,2,4
Knav,destromath,192,rogue,assassination,6,2,4
Baalos,medivh,192,rogue,assassination,6,2,4
Lesty,kelthuzad,192,rogue,assassination,6,2,4
Apssal,tichondrius,192,rogue,assassination,6,2,4
Deathben,tichondrius,192,rogue,assassination,6,2,4
Shini,malganis,192,rogue,assassination,6,2,4
Poohkié,malganis,192,rogue,assassination,6,2,4
Quickflash,bloodhoof,192,rogue,assassination,6,2,4
Happyunhappy,illidan,192,rogue,assassination,6,2,4
Ryoushei,ragnaros,192,rogue,assassination,6,2,4
Poolover,barthilas,192,rogue,assassination,6,2,4
Someone,ravencrest,192,rogue,assassination,6,2,4
Vanishcdc,area-52,192,rogue,assassination,6,2,4
Ilesire,frostmourne,192,rogue,assassination,6,2,4
Kwins,cenarion-circle,192,rogue,assassination,6,2,4
Soizhiro,ragnaros,192,rogue,assassination,6,2,4
Støné,azjolnerub,192,rogue,assassination,6,2,4
Ganksterqt,dentarg,192,rogue,assassination,6,2,4
Sneakysharky,frostmourne,192,rogue,assassination,6,2,4
Itskanashi,frostmourne,192,rogue,assassination,6,2,4
Zaozaa,frostmourne,192,rogue,assassination,6,2,4
Corchô,moon-guard,192,rogue,assassination,6,2,4
Combo,norgannon,192,rogue,assassination,6,2,4
Thianir,emerald-dream,192,rogue,assassination,6,2,4
Jaanmonty,frostmourne,192,rogue,assassination,6,2,4
Swickwockdus,azralon,192,rogue,assassination,6,2,4
Ssjseem,sargeras,192,rogue,assassination,6,2,4
Gentlesaop,blackrock,192,rogue,assassination,6,2,4
Amysix,antonidas,192,rogue,assassination,6,2,4
Toestumper,sargeras,192,rogue,assassination,6,2,4
Darkfalleng,azralon,192,rogue,assassination,6,2,4
Frostheartyy,azralon,192,rogue,assassination,6,2,4
Karlemagne,blackrock,192,rogue,assassination,6,2,4
Ennmaa,azralon,192,rogue,assassination,6,2,4
Gabrielgray,firetree,192,rogue,assassination,6,2,4
Youngtugger,daggerspine,192,rogue,assassination,11,2,9
Liridor,quelthalas,192,rogue,assassination,11,2,9
Bloodwish,tichondrius,192,rogue,assassination,12,2,10
Slowtime,quelthalas,192,rogue,assassination,12,2,10
Nines,icecrown,192,rogue,assassination,12,2,10
Geradyn,stormrage,192,rogue,assassination,12,2,10
Alts,tichondrius,192,rogue,assassination,12,2,10
Nikosneako,tichondrius,192,rogue,assassination,12,2,10
Seltzie,bleeding-hollow,192,rogue,assassination,12,2,10
Subculture,emerald-dream,192,rogue,assassination,12,2,10
Triarc,area-52,192,rogue,assassination,12,2,10
Stabsmcslice,laughing-skull,192,rogue,assassination,12,2,10
Aghanaar,burning-legion,192,rogue,assassination,12,2,10
Pleodonis,tichondrius,192,rogue,assassination,12,2,10
Swiftbones,burning-blade,191,rogue,assassination,6,2,4
Diatonic,illidan,191,rogue,assassination,6,2,4
Chizza,frostmourne,191,rogue,assassination,6,2,4
Cretos,jaedenar,191,rogue,assassination,6,2,4
Cryptixx,blades-edge,191,rogue,assassination,6,2,4
Dabrat,frostwolf,191,rogue,assassination,12,2,10
Donpablò,area-52,175,rogue,assassination,11,2,9
ßalto,bleeding-hollow,160,rogue,assassination,10,2,8
Xavar,malganis,159,rogue,assassination,5,2,3
Gnaark,bleeding-hollow,159,rogue,assassination,5,2,3
Vandalyze,sargeras,159,rogue,assassination,5,2,3
Stâbitha,bloodscalp,138,rogue,assassination,20,4,16
Icantsleep,tichondrius,96,rogue,assassination,6,1,5
Wuzi,azralon,96,rogue,assassination,6,1,5
Scylas,stormrage,96,rogue,assassination,6,1,5
Ntshaav,illidan,96,rogue,assassination,6,1,5
Kiskapolyus,thrall,96,rogue,assassination,6,1,5
Flinchyy,dalaran,96,rogue,assassination,6,1,5
Assakiller,azralon,96,rogue,assassination,6,1,5
Rafikaa,ragnaros,96,rogue,assassination,6,1,5
Docheatt,dalaran,96,rogue,assassination,6,1,5
Combøz,tichondrius,96,rogue,assassination,6,1,5
Lululee,tichondrius,96,rogue,assassination,6,1,5
Slycraft,gorgonnash,96,rogue,assassination,6,1,5
Stêf,zuljin,96,rogue,assassination,6,1,5
Panamarojo,tichondrius,96,rogue,assassination,6,1,5
Bourrasque,frostmourne,96,rogue,assassination,6,1,5
Nebiroth,illidan,96,rogue,assassination,6,1,5
Khlapncheeks,emerald-dream,96,rogue,assassination,6,1,5
Deathxx,destromath,96,rogue,assassination,6,1,5
Lu,lethon,96,rogue,assassination,6,1,5
Canesuckr,stormrage,96,rogue,assassination,6,1,5
Zitihait,amanthul,96,rogue,assassination,6,1,5
Mõtaru,stormrage,96,rogue,assassination,6,1,5
Saintjon,bleeding-hollow,96,rogue,assassination,6,1,5
Rokkhan,blackrock,96,rogue,assassination,6,1,5
Nightmarës,frostmourne,96,rogue,assassination,6,1,5
Nubes,illidan,96,rogue,assassination,6,1,5
Twotimed,magtheridon,96,rogue,assassination,6,1,5
Greased,arthas,96,rogue,assassination,6,1,5
Vùdõõ,area-52,96,rogue,assassination,6,1,5
Sevrow,wyrmrest-accord,96,rogue,assassination,6,1,5
Preceptor,azralon,96,rogue,assassination,6,1,5
Clicksbtns,area-52,96,rogue,assassination,6,1,5
Touchthetip,bleeding-hollow,96,rogue,assassination,6,1,5
Buhuhbles,area-52,96,rogue,assassination,6,1,5
Diser,quelthalas,96,rogue,assassination,6,1,5
Sømeøne,malygos,96,rogue,assassination,6,1,5
Elbryán,ragnaros,96,rogue,assassination,6,1,5
Tmterminel,moon-guard,96,rogue,assassination,6,1,5
Moiatropos,ragnaros,96,rogue,assassination,6,1,5
Zeth,frostmourne,96,rogue,assassination,6,1,5
Burtonee,aegwynn,96,rogue,assassination,6,1,5
Twinkrogue,firetree,96,rogue,assassination,6,1,5
Deejey,frostmourne,96,rogue,assassination,6,1,5
Watto,ragnaros,96,rogue,assassination,6,1,5
Meritra,ragnaros,96,rogue,assassination,6,1,5
Yohigo,quelthalas,96,rogue,assassination,6,1,5
Rykojin,sargeras,96,rogue,assassination,6,1,5
Liesmith,kelthuzad,96,rogue,assassination,6,1,5
Tzs,sargeras,96,rogue,assassination,6,1,5
Xô,lothar,96,rogue,assassination,12,1,11
Voidbrain,area-52,96,rogue,assassination,12,1,11
Keljadian,black-dragonflight,96,rogue,assassination,12,1,11
Karparog,ragnaros,96,rogue,assassination,12,1,11
Vladtsepesh,stormrage,96,rogue,assassination,12,1,11
Véndéttá,area-52,96,rogue,assassination,12,1,11
Kistef,tichondrius,96,rogue,assassination,12,1,11
Rabidlynsane,deathwing,96,rogue,assassination,12,1,11
Irotanin,thrall,95,rogue,assassination,6,1,5
Averagepimpn,tichondrius,79,rogue,assassination,5,1,4
Radiantrogue,nordrassil,79,rogue,assassination,5,1,4
Botches,bonechewer,48,rogue,assassination,3,1,2
Stabbindude,illidan,48,rogue,assassination,3,1,2
Sûshì,tichondrius,48,rogue,assassination,9,1,8
Naoyuki,stormrage,42,rogue,assassination,7,2,5
Jerzs,tichondrius,42,rogue,assassination,11,2,9
Ajy,tichondrius,31,rogue,assassination,2,1,1
Najmoiran,area-52,31,rogue,assassination,2,1,1
Ascherx,illidan,16,rogue,assassination,1,1,0
Samyeh,tichondrius,2252,shaman,restoration,83,55,28
Orochisháman,stormrage,2222,shaman,restoration,96,55,41
Yooseafood,tichondrius,2219,shaman,restoration,83,51,32
Dyllbar,tichondrius,2215,shaman,restoration,127,68,59
Xtremeorc,area-52,2159,shaman,restoration,66,39,27
Plewt,zuljin,2150,shaman,restoration,142,76,66
Spagetje,tichondrius,2150,shaman,restoration,245,130,115
Aameng,tichondrius,2140,shaman,restoration,120,64,56
Tréway,area-52,2135,shaman,restoration,66,41,25
Skipperx,thrall,2134,shaman,restoration,72,43,29
Restobyte,moon-guard,2124,shaman,restoration,72,44,28
Svanteson,wyrmrest-accord,2110,shaman,restoration,126,67,59
Shamaen,kelthuzad,2107,shaman,restoration,86,51,35
Selketh,area-52,2107,shaman,restoration,79,46,33
Iissham,darkspear,2101,shaman,restoration,176,97,79
Madoka,llane,2100,shaman,restoration,78,44,34
Akwesy,stormrage,2092,shaman,restoration,107,59,48
Ttvfoxyllama,tichondrius,2083,shaman,restoration,64,31,33
Vicioushands,illidan,2047,shaman,restoration,66,37,29
Timpossible,tichondrius,2036,shaman,restoration,362,185,177
Jîneth,tichondrius,2035,shaman,restoration,66,38,28
Kantok,quelthalas,2031,shaman,restoration,77,48,29
Lötus,tichondrius,2010,shaman,restoration,110,61,49
Itsallgoodx,tichondrius,2008,shaman,restoration,114,55,59
Smlz,garrosh,1998,shaman,restoration,68,38,30
Sizure,frostmourne,1998,shaman,restoration,124,64,60
Bigbadsac,frostmourne,1997,shaman,restoration,173,91,82
Zavoky,tichondrius,1993,shaman,restoration,156,82,74
Boyfromhell,stormrage,1985,shaman,restoration,103,50,53
Nemix,barthilas,1984,shaman,restoration,54,34,20
Corianderism,tichondrius,1982,shaman,restoration,77,40,37
Ravaburst,sargeras,1975,shaman,restoration,72,36,36
Berquon,tichondrius,1974,shaman,restoration,78,40,38
Abovesky,proudmoore,1970,shaman,restoration,156,76,80
Üchihamadarâ,tichondrius,1968,shaman,restoration,67,37,30
Breuer,tichondrius,1966,shaman,restoration,128,64,64
Kurtcx,tichondrius,1943,shaman,restoration,186,95,91
Cruv,thrall,1936,shaman,restoration,96,47,49
Jangbi,malganis,1934,shaman,restoration,246,129,117
Ilavayoualot,malganis,1925,shaman,restoration,142,64,78
Menc,frostmourne,1924,shaman,restoration,114,56,58
Terapatrik,area-52,1921,shaman,restoration,164,84,80
Slimdavey,tichondrius,1916,shaman,restoration,155,86,69
Chairstain,kelthuzad,1912,shaman,restoration,97,56,41
Oryxx,kiljaeden,1912,shaman,restoration,78,36,42
Ogctkoy,illidan,1911,shaman,restoration,156,80,76
Plorenz,illidan,1905,shaman,restoration,54,34,20
Peyn,shadowsong,1905,shaman,restoration,72,34,38
Shamanese,emerald-dream,1901,shaman,restoration,42,20,22
Coreygunz,illidan,1897,shaman,restoration,48,26,22
Yungtooth,emerald-dream,1891,shaman,restoration,59,32,27
Nepos,dragonmaw,1891,shaman,restoration,66,34,32
Erwin,bonechewer,1887,shaman,restoration,166,98,68
Däbü,tichondrius,1887,shaman,restoration,84,40,44
Mandleman,tichondrius,1884,shaman,restoration,140,85,55
Smrtdeath,zuljin,1884,shaman,restoration,53,30,23
Stormtitan,malganis,1881,shaman,restoration,86,42,44
Tisaa,illidan,1876,shaman,restoration,30,20,10
Gragomga,area-52,1876,shaman,restoration,120,60,60
Esqueue,sargeras,1871,shaman,restoration,48,29,19
Hulan,tichondrius,1865,shaman,restoration,36,20,16
Kellogsz,malganis,1864,shaman,restoration,96,43,53
Ratedpvp,thrall,1862,shaman,restoration,165,96,69
Bômi,tichondrius,1861,shaman,restoration,184,96,88
Laydboiyo,tichondrius,1861,shaman,restoration,66,32,34
Badshock,tichondrius,1859,shaman,restoration,48,35,13
Hódoong,tichondrius,1857,shaman,restoration,46,24,22
Haedodae,tichondrius,1857,shaman,restoration,81,32,49
Cardïß,tichondrius,1854,shaman,restoration,48,26,22
Moistbeans,tichondrius,1854,shaman,restoration,48,26,22
Oridean,area-52,1854,shaman,restoration,42,22,20
Baodan,azshara,1847,shaman,restoration,83,42,41
Moldymeatbox,emerald-dream,1847,shaman,restoration,96,47,49
Bozzyy,illidan,1846,shaman,restoration,78,42,36
Helga,hellscream,1845,shaman,restoration,48,29,19
Upyourtotem,illidan,1842,shaman,restoration,30,22,8
Shamcena,the-scryers,1842,shaman,restoration,51,28,23
Shamanbini,tichondrius,1839,shaman,restoration,47,26,21
Chocopuff,bleeding-hollow,1838,shaman,restoration,66,33,33
Crazyshamañ,akama,1837,shaman,restoration,53,27,26
Conjunction,azjolnerub,1837,shaman,restoration,65,29,36
Caibeeshammy,tichondrius,1835,shaman,restoration,162,77,85
Muscleyuan,tichondrius,1835,shaman,restoration,53,25,28
Stylesp,tichondrius,1833,shaman,restoration,60,32,28
Splashz,illidan,1833,shaman,restoration,71,36,35
Kimflo,tichondrius,1833,shaman,restoration,309,152,157
Wanghaisham,kelthuzad,1830,shaman,restoration,123,63,60
Papatooties,tichondrius,1830,shaman,restoration,257,124,133
Chobawn,tichondrius,1829,shaman,restoration,60,32,28
Bluekid,barthilas,1828,shaman,restoration,54,30,24
Beyoncé,lethon,1826,shaman,restoration,53,30,23
Hathul,bleeding-hollow,1826,shaman,restoration,60,33,27
Vlly,tichondrius,1826,shaman,restoration,59,27,32
Tuskcrusher,dalaran,1825,shaman,restoration,72,30,42
Gjök,nemesis,1824,shaman,restoration,54,22,32
Dehsaw,illidan,1821,shaman,restoration,108,54,54
Cryochemist,tichondrius,1819,shaman,restoration,29,23,6
Bigspaghetti,thrall,1818,shaman,restoration,66,31,35
Totempack,stormrage,1817,shaman,restoration,54,26,28
Eboy,thrall,1816,shaman,restoration,67,33,34
Ogran,stormscale,1815,shaman,restoration,54,25,29
Immabòt,tichondrius,1813,shaman,restoration,59,36,23
Dadidun,tichondrius,1813,shaman,restoration,48,25,23
Ericzlassoz,tichondrius,1812,shaman,restoration,66,42,24
Dantheman,twisting-nether,1810,shaman,restoration,42,23,19
Waterbro,tichondrius,1809,shaman,restoration,101,57,44
Annte,stonemaul,1809,shaman,restoration,64,32,32
Meatballs,kirin-tor,1809,shaman,restoration,62,31,31
Desee,bleeding-hollow,1809,shaman,restoration,54,27,27
Ookmetide,bleeding-hollow,1807,shaman,restoration,52,29,23
Willy,icecrown,1807,shaman,restoration,87,44,43
Nediar,tichondrius,1805,shaman,restoration,30,23,7
Totemgripper,moon-guard,1804,shaman,restoration,65,39,26
Hydrocheck,tichondrius,1804,shaman,restoration,94,54,40
Astrøcyte,tichondrius,1804,shaman,restoration,96,46,50
Nanosec,tichondrius,1803,shaman,restoration,36,23,13
Cmsi,tichondrius,1803,shaman,restoration,42,23,19
Tolík,ragnaros,1803,shaman,restoration,54,26,28
Zoeyzour,illidan,1802,shaman,restoration,274,149,125
Oceangrown,emerald-dream,1802,shaman,restoration,51,22,29
Waymond,khadgar,1801,shaman,restoration,152,78,74
Nktx,tichondrius,1800,shaman,restoration,118,66,52
Holdmytotum,tichondrius,1800,shaman,restoration,52,29,23
Zaapi,dalaran,1800,shaman,restoration,108,60,48
Nazugresha,bleeding-hollow,1800,shaman,restoration,42,23,19
Baseballcap,sargeras,1800,shaman,restoration,78,37,41
Shockmematty,tichondrius,1798,shaman,restoration,36,25,11
Inmø,ragnaros,1797,shaman,restoration,36,19,17
Hodoongs,tichondrius,1797,shaman,restoration,49,23,26
Ghomragar,antonidas,1796,shaman,restoration,47,25,22
Cigaretter,tichondrius,1793,shaman,restoration,56,25,31
Mybbro,kiljaeden,1792,shaman,restoration,87,42,45
Fierymoo,frostmourne,1790,shaman,restoration,42,20,22
Qksilverz,nemesis,1789,shaman,restoration,47,32,15
Fluxxy,tichondrius,1787,shaman,restoration,66,27,39
Rollintotems,bleeding-hollow,1785,shaman,restoration,84,39,45
Chomang,stormreaver,1784,shaman,restoration,114,54,60
Kurtxc,tichondrius,1782,shaman,restoration,30,23,7
Booramqt,tichondrius,1780,shaman,restoration,47,27,20
Boxfour,tichondrius,1777,shaman,restoration,84,39,45
Blazingtotem,dunemaul,1775,shaman,restoration,125,64,61
Ryuubi,illidan,1774,shaman,restoration,48,31,17
Petzah,barthilas,1774,shaman,restoration,54,25,29
Suzhixie,akama,1771,shaman,restoration,118,51,67
Shanasty,bleeding-hollow,1769,shaman,restoration,60,31,29
Aureal,malganis,1767,shaman,restoration,93,60,33
Stórmstruck,area-52,1767,shaman,restoration,48,29,19
Blackpïnk,tichondrius,1764,shaman,restoration,173,88,85
Semtechs,tichondrius,1764,shaman,restoration,282,135,147
Gratiens,zuljin,1764,shaman,restoration,60,27,33
Julíp,tichondrius,1760,shaman,restoration,58,23,35
Itsyabøiwill,area-52,1759,shaman,restoration,54,35,19
Ðno,frostmourne,1754,shaman,restoration,81,41,40
Bobbybigdam,tichondrius,1752,shaman,restoration,93,50,43
Shawmen,zuljin,1748,shaman,restoration,208,110,98
Magma,spirestone,1747,shaman,restoration,96,61,35
Lavalavalava,eonar,1747,shaman,restoration,48,21,27
Gatorwavez,bleeding-hollow,1746,shaman,restoration,89,51,38
Warríed,sargeras,1746,shaman,restoration,59,29,30
Toazty,stormscale,1745,shaman,restoration,75,44,31
Mastashamsta,illidan,1745,shaman,restoration,48,25,23
Blackfancy,thrall,1744,shaman,restoration,56,32,24
Chonchastic,darkspear,1741,shaman,restoration,54,27,27
Chessyc,ragnaros,1739,shaman,restoration,48,21,27
Pookiexo,illidan,1736,shaman,restoration,41,25,16
Zeonard,ragnaros,1736,shaman,restoration,166,91,75
Illiteratex,tichondrius,1733,shaman,restoration,38,21,17
Rantòn,bleeding-hollow,1733,shaman,restoration,59,27,32
Cpplol,tichondrius,1726,shaman,restoration,47,27,20
Krazyc,sargeras,1726,shaman,restoration,90,47,43
Phxhouse,illidan,1722,shaman,restoration,324,159,165
Patzog,area-52,1718,shaman,restoration,30,18,12
Nayro,bleeding-hollow,1718,shaman,restoration,396,212,184
Epicthesloth,sargeras,1716,shaman,restoration,47,23,24
Inpantsment,barthilas,1714,shaman,restoration,151,78,73
Bizzarro,azgalor,1713,shaman,restoration,79,40,39
Fkwithme,burning-blade,1711,shaman,restoration,66,30,36
Duregar,tichondrius,1709,shaman,restoration,60,35,25
Gyrogg,scilla,1709,shaman,restoration,489,255,234
Chontastic,darkspear,1707,shaman,restoration,36,18,18
Shacewoman,altar-of-storms,1706,shaman,restoration,168,77,91
Sìxnìne,tichondrius,1706,shaman,restoration,62,28,34
Pèpé,sargeras,1705,shaman,restoration,38,23,15
Tobírama,bleeding-hollow,1705,shaman,restoration,54,23,31
Slm,bleeding-hollow,1704,shaman,restoration,24,18,6
Hustlenflow,tichondrius,1704,shaman,restoration,60,32,28
Kafkaesk,tichondrius,1704,shaman,restoration,54,21,33
Elementz,tichondrius,1703,shaman,restoration,222,116,106
Erbicklet,ragnaros,1701,shaman,restoration,154,80,74
Laji,cairne,1700,shaman,restoration,191,98,93
Groundingtot,hydraxis,1699,shaman,restoration,42,25,17
Uncleilli,tichondrius,1699,shaman,restoration,53,20,33
Renghostwolf,illidan,1698,shaman,restoration,36,18,18
Lingduacn,tichondrius,1698,shaman,restoration,36,18,18
Angelbie,tichondrius,1698,shaman,restoration,44,21,23
Bubbacheeks,area-52,1697,shaman,restoration,60,34,26
Vayces,barthilas,1697,shaman,restoration,193,101,92
Wtbtotem,tichondrius,1697,shaman,restoration,48,24,24
Xoweeknd,bleeding-hollow,1697,shaman,restoration,42,19,23
Mitchestic,illidan,1697,shaman,restoration,95,37,58
Wraethy,illidan,1695,shaman,restoration,109,60,49
Montageb,illidan,1694,shaman,restoration,39,29,10
Raeoki,area-52,1694,shaman,restoration,95,50,45
Trouvaille,tichondrius,1693,shaman,restoration,47,23,24
Ribbeye,tichondrius,1692,shaman,restoration,154,76,78
Vrom,whisperwind,1691,shaman,restoration,72,42,30
Texmawave,moon-guard,1690,shaman,restoration,113,68,45
Horizonsham,stormrage,1690,shaman,restoration,42,25,17
Xruok,kelthuzad,1689,shaman,restoration,39,24,15
Ittøki,tichondrius,1689,shaman,restoration,41,24,17
Sewerperson,zuljin,1689,shaman,restoration,42,23,19
Lilgeeh,kelthuzad,1689,shaman,restoration,46,24,22
Shamix,area-52,1688,shaman,restoration,42,23,19
Baern,thrall,1688,shaman,restoration,74,38,36
Kromgul,malfurion,1688,shaman,restoration,54,25,29
Rockzoa,tichondrius,1688,shaman,restoration,60,27,33
Bacon,lightninghoof,1687,shaman,restoration,108,45,63
Ozmats,malganis,1686,shaman,restoration,76,35,41
Hairyrichard,zuljin,1685,shaman,restoration,760,397,363
Suyy,tichondrius,1685,shaman,restoration,48,23,25
Solidhomme,tichondrius,1684,shaman,restoration,42,23,19
Bizzarra,azshara,1681,shaman,restoration,39,26,13
Ibreakanklez,bleeding-hollow,1681,shaman,restoration,42,20,22
Bogz,korgath,1679,shaman,restoration,119,54,65
Tanta,gurubashi,1678,shaman,restoration,57,25,32
Raywhiter,tichondrius,1676,shaman,restoration,62,29,33
Spiritry,tichondrius,1675,shaman,restoration,90,51,39
Nethyxsoy,frostmourne,1673,shaman,restoration,48,33,15
Urga,hyjal,1672,shaman,restoration,36,20,16
Namso,tichondrius,1671,shaman,restoration,36,22,14
Dingfu,sargeras,1670,shaman,restoration,187,108,79
Grymn,sargeras,1670,shaman,restoration,228,109,119
Tpokes,sargeras,1669,shaman,restoration,42,22,20
Mkyz,tichondrius,1667,shaman,restoration,94,51,43
Tokuma,illidan,1667,shaman,restoration,58,26,32
Drekkhal,area-52,1666,shaman,restoration,178,104,74
Scroogz,emerald-dream,1665,shaman,restoration,102,50,52
Sasgöb,illidan,1665,shaman,restoration,83,36,47
Isagii,stormrage,1664,shaman,restoration,48,29,19
Toxidizetkö,azralon,1664,shaman,restoration,48,26,22
Semnicktotem,area-52,1663,shaman,restoration,66,33,33
Reppinsix,sargeras,1662,shaman,restoration,58,24,34
Chazzwozza,area-52,1660,shaman,restoration,41,22,19
Bluepigo,tichondrius,1660,shaman,restoration,59,24,35
Diulama,tichondrius,1659,shaman,restoration,45,30,15
Belarix,emerald-dream,1659,shaman,restoration,205,96,109
Pingatronx,ragnaros,1659,shaman,restoration,42,19,23
Exshocks,tichondrius,1658,shaman,restoration,54,30,24
Imd,tichondrius,1658,shaman,restoration,42,21,21
Moocatpie,illidan,1657,shaman,restoration,82,46,36
Lingdusm,tichondrius,1657,shaman,restoration,36,20,16
Zuescannon,kelthuzad,1656,shaman,restoration,84,39,45
Meskthemage,barthilas,1654,shaman,restoration,47,23,24
Novoz,tichondrius,1653,shaman,restoration,42,24,18
Whameradetu,suramar,1653,shaman,restoration,71,31,40
Svondo,illidan,1652,shaman,restoration,31,21,10
Goobie,crushridge,1651,shaman,restoration,68,43,25
Win,blackwing-lair,1651,shaman,restoration,36,21,15
Devastaterr,bleeding-hollow,1650,shaman,restoration,90,46,44
Deephole,illidan,1649,shaman,restoration,85,37,48
Bolteon,malganis,1648,shaman,restoration,30,21,9
Jsell,zuljin,1646,shaman,restoration,56,28,28
Amdshaman,thrall,1645,shaman,restoration,67,37,30
Héadshot,bleeding-hollow,1645,shaman,restoration,83,38,45
Bigmontana,tichondrius,1644,shaman,restoration,36,21,15
Gabant,azralon,1644,shaman,restoration,42,19,23
Skipler,stormrage,1643,shaman,restoration,54,29,25
Weoo,doomhammer,1642,shaman,restoration,48,23,25
Ekss,tichondrius,1642,shaman,restoration,48,19,29
Thunderspark,tichondrius,1641,shaman,restoration,36,24,12
Gordonramsai,sargeras,1641,shaman,restoration,272,148,124
Singleorigin,tichondrius,1641,shaman,restoration,105,41,64
Akheeta,tichondrius,1639,shaman,restoration,63,44,19
Hoshwear,azralon,1639,shaman,restoration,48,31,17
Ethikas,tichondrius,1638,shaman,restoration,42,24,18
Beastofmagic,illidan,1638,shaman,restoration,125,68,57
Cheddaman,kiljaeden,1637,shaman,restoration,48,21,27
Krilick,blackrock,1635,shaman,restoration,104,57,47
Daddybeaarr,thrall,1635,shaman,restoration,55,25,30
Gjok,nemesis,1634,shaman,restoration,59,20,39
Quitnectar,aggramar,1633,shaman,restoration,48,24,24
Shortbusqt,hyjal,1631,shaman,restoration,42,23,19
Wawsham,tichondrius,1631,shaman,restoration,48,19,29
Worldx,barthilas,1630,shaman,restoration,108,57,51
Hamrok,moon-guard,1630,shaman,restoration,36,18,18
Flappygooch,illidan,1629,shaman,restoration,102,43,59
Lacid,tichondrius,1627,shaman,restoration,62,40,22
Lemmehex,illidan,1626,shaman,restoration,40,23,17
Grizze,bonechewer,1626,shaman,restoration,90,41,49
Goranzo,emerald-dream,1626,shaman,restoration,54,24,30
Peegee,zuluhed,1626,shaman,restoration,60,24,36
Sin,bleeding-hollow,1625,shaman,restoration,30,17,13
Drfentanylx,emerald-dream,1623,shaman,restoration,30,17,13
Oldguy,ragnaros,1623,shaman,restoration,119,60,59
Youliuhua,tichondrius,1622,shaman,restoration,30,17,13
Onagi,frostmourne,1621,shaman,restoration,30,22,8
Vanella,malganis,1621,shaman,restoration,42,25,17
Restosêxual,tichondrius,1621,shaman,restoration,36,18,18
Thuntard,bleeding-hollow,1621,shaman,restoration,48,23,25
Joyrex,spinebreaker,1620,shaman,restoration,45,20,25
Bigamez,azuremyst,1616,shaman,restoration,158,88,70
Durogh,darkspear,1616,shaman,restoration,60,23,37
Animus,dark-iron,1615,shaman,restoration,30,19,11
Sunyang,tichondrius,1615,shaman,restoration,36,17,19
Skoobasteeve,sargeras,1614,shaman,restoration,69,39,30
World,frostmourne,1614,shaman,restoration,47,25,22
Quendella,aggramar,1613,shaman,restoration,42,25,17
Harth,zuljin,1613,shaman,restoration,110,65,45
Polared,hyjal,1613,shaman,restoration,52,25,27
Yeamn,saurfang,1612,shaman,restoration,141,86,55
Harigomi,tichondrius,1611,shaman,restoration,243,128,115
Gunrose,proudmoore,1610,shaman,restoration,67,36,31
Ränton,bleeding-hollow,1610,shaman,restoration,42,20,22
Drammah,malganis,1610,shaman,restoration,48,19,29
Redds,tichondrius,1608,shaman,restoration,66,48,18
Ðoomed,kiljaeden,1608,shaman,restoration,30,19,11
Alett,arathor,1608,shaman,restoration,60,29,31
Plzdontlos,illidan,1607,shaman,restoration,113,69,44
Rainingheals,auchindoun,1607,shaman,restoration,44,19,25
Randomshammy,area-52,1606,shaman,restoration,30,17,13
Astrauk,nemesis,1606,shaman,restoration,76,43,33
Fujiyama,dark-iron,1606,shaman,restoration,120,65,55
Raxshock,stormrage,1606,shaman,restoration,42,22,20
Prêttylights,bleeding-hollow,1605,shaman,restoration,30,17,13
Hexrz,area-52,1605,shaman,restoration,42,21,21
Luckyscatter,frostmourne,1605,shaman,restoration,36,18,18
Sliditin,tichondrius,1604,shaman,restoration,36,25,11
Oninobu,sargeras,1604,shaman,restoration,28,18,10
Hurú,azralon,1604,shaman,restoration,36,21,15
Spampurge,blackwing-lair,1604,shaman,restoration,37,19,18
Polarities,malganis,1604,shaman,restoration,54,21,33
Kratór,kelthuzad,1603,shaman,restoration,47,31,16
Kimchimi,tichondrius,1603,shaman,restoration,144,85,59
Fernetbrança,ragnaros,1603,shaman,restoration,48,26,22
Mutaishammy,barthilas,1602,shaman,restoration,30,19,11
Telchar,quelthalas,1602,shaman,restoration,102,62,40
Asnalda,emerald-dream,1602,shaman,restoration,51,30,21
Purgebotx,bleeding-hollow,1601,shaman,restoration,114,70,44
Gweemextreme,tichondrius,1601,shaman,restoration,36,18,18
Belshiro,sargeras,1601,shaman,restoration,108,51,57
Huáxià,tichondrius,1601,shaman,restoration,77,36,41
Tzyorz,illidan,1600,shaman,restoration,72,40,32
Shocksauce,tichondrius,1600,shaman,restoration,94,51,43
Succmytotems,tichondrius,1600,shaman,restoration,93,47,46
Foilcap,bonechewer,1600,shaman,restoration,296,144,152
Ddogz,illidan,1600,shaman,restoration,48,21,27
Gulmuwu,zuljin,1599,shaman,restoration,38,22,16
Mastlau,tichondrius,1599,shaman,restoration,30,17,13
Tevya,dalvengyr,1598,shaman,restoration,83,47,36
Tideoverdose,tichondrius,1594,shaman,restoration,36,19,17
Dgshaman,tichondrius,1593,shaman,restoration,24,17,7
Charlesby,tichondrius,1593,shaman,restoration,126,73,53
Yehbeen,tichondrius,1590,shaman,restoration,30,18,12
Shamanceylol,barthilas,1590,shaman,restoration,57,30,27
Xzxz,sargeras,1588,shaman,restoration,115,63,52
Naweiv,caelestrasz,1586,shaman,restoration,36,19,17
Besylate,illidan,1586,shaman,restoration,80,39,41
Shamsom,tichondrius,1586,shaman,restoration,104,49,55
Kolanji,akama,1585,shaman,restoration,41,22,19
Muggz,sargeras,1585,shaman,restoration,42,19,23
Eletius,tichondrius,1583,shaman,restoration,23,20,3
Møp,spirestone,1583,shaman,restoration,119,61,58
Improvedx,akama,1583,shaman,restoration,41,21,20
Totesmcgoatz,arthas,1582,shaman,restoration,33,20,13
Bigdictuna,sargeras,1582,shaman,restoration,182,98,84
Miroen,tichondrius,1580,shaman,restoration,48,24,24
Turborundat,area-52,1579,shaman,restoration,201,115,86
Rugmat,tichondrius,1578,shaman,restoration,60,29,31
Pkx,eitrigg,1578,shaman,restoration,47,20,27
Colterr,thunderhorn,1577,shaman,restoration,36,20,16
Dduddaddu,tichondrius,1577,shaman,restoration,48,25,23
Prowdt,azralon,1577,shaman,restoration,394,203,191
Rynoh,dalaran,1575,shaman,restoration,109,54,55
Rainz,aggramar,1574,shaman,restoration,42,22,20
Arkerus,emerald-dream,1573,shaman,restoration,36,22,14
Dawnyshock,arygos,1573,shaman,restoration,41,19,22
Strives,icecrown,1573,shaman,restoration,48,21,27
Improvize,malganis,1571,shaman,restoration,53,25,28
Rogrim,malganis,1570,shaman,restoration,48,24,24
Brongar,bleeding-hollow,1569,shaman,restoration,66,26,40
Sikotics,area-52,1568,shaman,restoration,111,58,53
Moosk,zuluhed,1567,shaman,restoration,51,27,24
Funkesapien,tichondrius,1565,shaman,restoration,36,18,18
Foragorn,stormrage,1565,shaman,restoration,199,98,101
Spurske,emerald-dream,1564,shaman,restoration,78,32,46
Dreadxtotems,illidan,1563,shaman,restoration,59,31,28
Bigdampurge,illidan,1563,shaman,restoration,95,49,46
Waater,lightbringer,1562,shaman,restoration,86,49,37
Intruzionall,barthilas,1562,shaman,restoration,213,113,100
Gki,tichondrius,1560,shaman,restoration,37,26,11
Wilmar,ragnaros,1560,shaman,restoration,66,33,33
Stonetides,tichondrius,1560,shaman,restoration,78,33,45
Rulf,proudmoore,1558,shaman,restoration,90,34,56
Flamehorns,malganis,1555,shaman,restoration,30,20,10
Kayadee,stormrage,1554,shaman,restoration,75,37,38
Yoshìmìtsu,illidan,1554,shaman,restoration,71,35,36
Thunderphury,proudmoore,1554,shaman,restoration,59,25,34
Goatedsham,dalaran,1553,shaman,restoration,65,36,29
Eatmymeatbal,illidan,1551,shaman,restoration,65,26,39
Draidosh,area-52,1550,shaman,restoration,59,37,22
Pherolex,tichondrius,1550,shaman,restoration,42,23,19
Totemslol,ysera,1550,shaman,restoration,36,18,18
Hwyl,frostmourne,1549,shaman,restoration,72,33,39
Lanzero,chogall,1547,shaman,restoration,42,30,12
Mistarklean,malganis,1546,shaman,restoration,111,49,62
Steveyy,frostmourne,1544,shaman,restoration,27,17,10
Tyar,area-52,1543,shaman,restoration,137,64,73
Chainstuff,area-52,1541,shaman,restoration,29,17,12
Wolfsokar,emerald-dream,1537,shaman,restoration,102,39,63
Akubai,kelthuzad,1535,shaman,restoration,78,39,39
Bighaircut,darkspear,1534,shaman,restoration,78,35,43
Shocknrot,maelstrom,1533,shaman,restoration,26,17,9
Aguinha,azralon,1533,shaman,restoration,60,33,27
Bluedynamite,tichondrius,1533,shaman,restoration,60,30,30
Tides,skullcrusher,1533,shaman,restoration,42,18,24
Ftp,kelthuzad,1531,shaman,restoration,24,16,8
Purgenx,tichondrius,1531,shaman,restoration,30,18,12
Spongemama,tichondrius,1530,shaman,restoration,47,25,22
Rookieshaman,tichondrius,1528,shaman,restoration,24,16,8
Chacham,tichondrius,1528,shaman,restoration,36,22,14
Tarròò,bleeding-hollow,1526,shaman,restoration,24,16,8
Unbreakable,illidan,1525,shaman,restoration,55,21,34
Flubydont,icecrown,1524,shaman,restoration,66,32,34
Platewalrus,illidan,1523,shaman,restoration,30,16,14
Repang,tichondrius,1523,shaman,restoration,36,19,17
Hehew,kelthuzad,1523,shaman,restoration,122,61,61
Vexxs,shadowmoon,1522,shaman,restoration,30,16,14
Riptideafk,sargeras,1521,shaman,restoration,66,34,32
Kaytahn,proudmoore,1520,shaman,restoration,66,36,30
Dogecoincäsh,sargeras,1520,shaman,restoration,54,29,25
Rocyt,sargeras,1520,shaman,restoration,66,35,31
Aleforj,quelthalas,1519,shaman,restoration,55,27,28
Záheer,arthas,1517,shaman,restoration,75,38,37
Vywolf,frostmourne,1516,shaman,restoration,45,25,20
Freesolo,barthilas,1516,shaman,restoration,152,76,76
Zuralah,nemesis,1515,shaman,restoration,46,25,21
Jbalvi,ragnaros,1513,shaman,restoration,105,59,46
Killercam,maiev,1513,shaman,restoration,219,108,111
Draüguss,azralon,1513,shaman,restoration,131,64,67
Stylebenderx,frostmourne,1512,shaman,restoration,30,16,14
Heniu,tichondrius,1511,shaman,restoration,36,16,20
Shamansrock,tichondrius,1509,shaman,restoration,36,16,20
Gemoz,tichondrius,1508,shaman,restoration,24,16,8
Shamxrob,sargeras,1507,shaman,restoration,72,42,30
Plâto,stormrage,1507,shaman,restoration,30,16,14
Gattious,illidan,1507,shaman,restoration,48,25,23
Cultsulyvahn,tichondrius,1507,shaman,restoration,73,37,36
Trapghost,cenarius,1506,shaman,restoration,87,41,46
Thegil,tichondrius,1506,shaman,restoration,78,36,42
Shamankïng,proudmoore,1505,shaman,restoration,89,46,43
Packspiritqt,tichondrius,1505,shaman,restoration,42,21,21
Shulace,area-52,1505,shaman,restoration,36,17,19
Randomshammy,stormrage,1504,shaman,restoration,54,27,27
Pawbed,aegwynn,1503,shaman,restoration,117,64,53
Cokehealsx,tichondrius,1503,shaman,restoration,30,16,14
Agharn,moon-guard,1503,shaman,restoration,51,26,25
Papatreb,haomarush,1503,shaman,restoration,78,39,39
Shadowz,alexstrasza,1502,shaman,restoration,30,18,12
Ballistíc,boulderfist,1502,shaman,restoration,66,38,28
Voluptuous,mannoroth,1502,shaman,restoration,376,193,183
Rsdyxjh,tichondrius,1502,shaman,restoration,45,19,26
Ban,blackrock,1498,shaman,restoration,39,21,18
Yarl,ragnaros,1497,shaman,restoration,30,19,11
Lengin,bleeding-hollow,1497,shaman,restoration,36,21,15
Glocksitotem,malganis,1497,shaman,restoration,111,64,47
Sbrinz,thrall,1497,shaman,restoration,36,19,17
Elementàlius,quelthalas,1497,shaman,restoration,71,32,39
Ärtful,illidan,1496,shaman,restoration,60,34,26
Doubletåp,emerald-dream,1495,shaman,restoration,35,16,19
Køtømine,ragnaros,1491,shaman,restoration,106,67,39
Redek,sargeras,1491,shaman,restoration,196,105,91
Bwinthewomb,stormrage,1491,shaman,restoration,148,77,71
Vanklayser,ragnaros,1491,shaman,restoration,108,54,54
Mentyb,emerald-dream,1491,shaman,restoration,42,16,26
Koomrog,frostmourne,1489,shaman,restoration,32,21,11
Hexxercise,area-52,1488,shaman,restoration,41,31,10
Hyonkh,tichondrius,1487,shaman,restoration,77,45,32
Kaaying,tichondrius,1487,shaman,restoration,43,17,26
Chlckenx,tichondrius,1485,shaman,restoration,99,44,55
Jizzlewizwiz,tichondrius,1484,shaman,restoration,181,89,92
Sittinn,malganis,1484,shaman,restoration,66,31,35
ßread,illidan,1484,shaman,restoration,80,33,47
Benjaminx,tichondrius,1483,shaman,restoration,32,22,10
Mlpz,black-dragonflight,1482,shaman,restoration,66,38,28
Hachikø,frostmourne,1482,shaman,restoration,90,42,48
Trenhance,stormrage,1481,shaman,restoration,30,23,7
Krewesham,uldaman,1481,shaman,restoration,28,17,11
Abellone,tichondrius,1480,shaman,restoration,33,17,16
Sarkhanvol,aggramar,1478,shaman,restoration,30,22,8
Ryukims,tichondrius,1477,shaman,restoration,35,17,18
Ellgric,emerald-dream,1476,shaman,restoration,48,21,27
Defac,proudmoore,1475,shaman,restoration,72,42,30
Maxchungie,azshara,1475,shaman,restoration,30,16,14
Angelabaaby,proudmoore,1475,shaman,restoration,60,28,32
Yossarabi,bleeding-hollow,1475,shaman,restoration,54,23,31
Orkshammy,illidan,1474,shaman,restoration,28,19,9
Vewdew,guldan,1473,shaman,restoration,78,47,31
Brainal,sargeras,1472,shaman,restoration,60,25,35
Pissticles,bleeding-hollow,1471,shaman,restoration,150,75,75
Heebeegeebee,stormrage,1470,shaman,restoration,51,31,20
Neosham,frostwolf,1470,shaman,restoration,42,16,26
Szeav,tichondrius,1467,shaman,restoration,36,18,18
Keenie,shadow-council,1467,shaman,restoration,35,17,18
Gangzmmsk,tichondrius,1466,shaman,restoration,24,18,6
Philbert,boulderfist,1466,shaman,restoration,54,31,23
Ottoman,eredar,1466,shaman,restoration,45,21,24
Shockszz,onyxia,1466,shaman,restoration,108,50,58
Ãrthor,stormrage,1464,shaman,restoration,66,37,29
Damoclez,jubeithos,1464,shaman,restoration,39,17,22
Allcatraz,zuljin,1464,shaman,restoration,40,17,23
Santiagodx,ragnaros,1462,shaman,restoration,253,125,128
Hirah,frostmourne,1460,shaman,restoration,23,16,7
Smartakkar,emerald-dream,1460,shaman,restoration,57,36,21
Snakesoul,area-52,1460,shaman,restoration,54,26,28
Benta,zuljin,1459,shaman,restoration,72,36,36
Nilstorm,quelthalas,1458,shaman,restoration,72,38,34
Shocksfuker,stormrage,1458,shaman,restoration,38,19,19
Paoran,sargeras,1457,shaman,restoration,26,16,10
Hooldcool,tichondrius,1457,shaman,restoration,147,86,61
Kwzy,stormrage,1457,shaman,restoration,51,26,25
Goatpornbad,sargeras,1457,shaman,restoration,96,44,52
Tizz,quelthalas,1456,shaman,restoration,112,54,58
Totemgoddess,nemesis,1456,shaman,restoration,54,26,28
Whoshealing,lightninghoof,1455,shaman,restoration,66,35,31
Furrytotems,darkspear,1455,shaman,restoration,126,56,70
Wuruizec,illidan,1454,shaman,restoration,59,28,31
Ssaotizi,tichondrius,1454,shaman,restoration,196,91,105
Rinnan,malganis,1453,shaman,restoration,103,48,55
Carltonbanks,aggramar,1452,shaman,restoration,36,18,18
Splonkydonky,stonemaul,1450,shaman,restoration,30,18,12
Tidalstorm,ragnaros,1450,shaman,restoration,90,52,38
Onepunchsham,illidan,1450,shaman,restoration,93,45,48
Enalen,argent-dawn,1449,shaman,restoration,57,34,23
Buffduude,shadowsong,1449,shaman,restoration,48,22,26
Chitoss,gorgonnash,1448,shaman,restoration,122,59,63
Blowurbubble,tichondrius,1447,shaman,restoration,42,24,18
Circuits,malganis,1446,shaman,restoration,58,30,28
Erthshawk,wildhammer,1446,shaman,restoration,78,40,38
Joltik,area-52,1444,shaman,restoration,173,84,89
Rumkin,malganis,1443,shaman,restoration,72,40,32
Vzla,ragnaros,1443,shaman,restoration,78,41,37
Milkkshake,illidan,1443,shaman,restoration,250,116,134
Hruggol,bleeding-hollow,1442,shaman,restoration,48,22,26
Halfinha,nemesis,1441,shaman,restoration,187,92,95
Wuargh,area-52,1440,shaman,restoration,220,118,102
Tenyks,tichondrius,1439,shaman,restoration,57,29,28
Breadx,khaz-modan,1439,shaman,restoration,30,15,15
Praxis,tichondrius,1437,shaman,restoration,154,79,75
Miketheseal,bleeding-hollow,1437,shaman,restoration,36,15,21
Creatine,area-52,1436,shaman,restoration,71,37,34
Lustlolol,korgath,1435,shaman,restoration,111,51,60
Dawny,arygos,1435,shaman,restoration,36,15,21
Siyusm,illidan,1435,shaman,restoration,60,21,39
Wardruna,andorhal,1434,shaman,restoration,24,15,9
Geser,silvermoon,1432,shaman,restoration,44,26,18
Thormør,tichondrius,1432,shaman,restoration,31,15,16
Insertyzs,azralon,1431,shaman,restoration,66,36,30
Kabasan,illidan,1431,shaman,restoration,60,27,33
Totem,burning-legion,1431,shaman,restoration,36,16,20
Hugebrain,proudmoore,1431,shaman,restoration,124,50,74
Fatherrtime,illidan,1430,shaman,restoration,48,26,22
Totembarx,illidan,1428,shaman,restoration,42,29,13
Nanishock,area-52,1426,shaman,restoration,45,24,21
Xiwg,tichondrius,1425,shaman,restoration,60,23,37
Crittingbull,veknilash,1424,shaman,restoration,204,105,99
Torric,kalecgos,1424,shaman,restoration,66,31,35
Kelta,kelthuzad,1423,shaman,restoration,30,15,15
Kephax,eonar,1421,shaman,restoration,117,59,58
Reuxxe,area-52,1421,shaman,restoration,179,88,91
Boonno,tichondrius,1421,shaman,restoration,36,15,21
Samanl,tichondrius,1420,shaman,restoration,77,44,33
Cinematticz,tichondrius,1420,shaman,restoration,101,51,50
Pýe,bleeding-hollow,1420,shaman,restoration,42,21,21
Slothstorm,barthilas,1419,shaman,restoration,59,31,28
Kandshamy,azralon,1419,shaman,restoration,30,15,15
Skelesham,zuljin,1418,shaman,restoration,42,28,14
Edhance,area-52,1418,shaman,restoration,78,48,30
Mcwindyfists,zuljin,1418,shaman,restoration,36,15,21
Springtide,thrall,1417,shaman,restoration,59,29,30
Latorius,frostmourne,1416,shaman,restoration,61,38,23
Roostershama,tichondrius,1416,shaman,restoration,68,30,38
Psiexrcst,tichondrius,1415,shaman,restoration,54,22,32
Djshammy,barthilas,1414,shaman,restoration,80,42,38
Bearmanshrek,tichondrius,1414,shaman,restoration,72,26,46
Bitxxnumber,tichondrius,1412,shaman,restoration,229,124,105
Tawahka,hyjal,1412,shaman,restoration,179,87,92
Azumaa,tichondrius,1412,shaman,restoration,101,44,57
Subnôize,bleeding-hollow,1411,shaman,restoration,74,44,30
Alexustexas,tichondrius,1411,shaman,restoration,66,37,29
Enflexi,lightbringer,1411,shaman,restoration,53,26,27
Orkwa,bleeding-hollow,1410,shaman,restoration,68,32,36
Catchclause,eonar,1409,shaman,restoration,30,15,15
Xaltas,moon-guard,1407,shaman,restoration,52,33,19
Bazinguinha,azralon,1407,shaman,restoration,82,41,41
Fuzzymuzzy,illidan,1407,shaman,restoration,30,15,15
Zizö,barthilas,1404,shaman,restoration,42,19,23
Supdaug,vashj,1402,shaman,restoration,66,32,34
Buffdestru,azralon,1401,shaman,restoration,95,55,40
Sploosh,norgannon,1401,shaman,restoration,36,20,16
Bluetooth,stormrage,1401,shaman,restoration,89,39,50
Mäjorlazer,lightbringer,1400,shaman,restoration,24,15,9
Ironcrag,moon-guard,1398,shaman,restoration,200,102,98
Stylesp,area-52,1396,shaman,restoration,125,58,67
Drinkharder,stormrage,1395,shaman,restoration,34,16,18
Arginine,tichondrius,1395,shaman,restoration,42,15,27
Kakiscala,proudmoore,1393,shaman,restoration,30,16,14
ßøvîn,thrall,1393,shaman,restoration,71,36,35
Eggrollninja,illidan,1392,shaman,restoration,24,17,7
Windfrenzy,thrall,1392,shaman,restoration,36,15,21
Totemrack,tichondrius,1391,shaman,restoration,24,15,9
Largeshaman,zuljin,1391,shaman,restoration,30,15,15
Rizam,malganis,1389,shaman,restoration,42,33,9
Dazu,drakkari,1389,shaman,restoration,24,15,9
Shaquillius,tichondrius,1389,shaman,restoration,36,17,19
Kirawindu,zuljin,1387,shaman,restoration,69,39,30
Halloweenz,area-52,1387,shaman,restoration,30,16,14
Shämwow,agamaggan,1387,shaman,restoration,793,398,395
Soowecide,tichondrius,1387,shaman,restoration,60,23,37
Shazik,spirestone,1386,shaman,restoration,54,21,33
Kandin,icecrown,1385,shaman,restoration,82,42,40
Fungus,firetree,1384,shaman,restoration,42,23,19
Fishman,exodar,1382,shaman,restoration,101,45,56
Brosidan,anvilmar,1381,shaman,restoration,44,32,12
Çruces,illidan,1381,shaman,restoration,36,17,19
Thenextcdew,illidan,1380,shaman,restoration,36,20,16
Kaili,illidan,1379,shaman,restoration,47,28,19
Lanuur,moon-guard,1379,shaman,restoration,54,31,23
Mudlùst,moon-guard,1378,shaman,restoration,67,36,31
Hannamayzing,arathor,1377,shaman,restoration,36,16,20
Roxzid,area-52,1374,shaman,restoration,57,33,24
Hicys,azralon,1374,shaman,restoration,85,48,37
Jensenx,proudmoore,1374,shaman,restoration,82,38,44
Graymatterz,ysondre,1372,shaman,restoration,36,15,21
Blackoutsx,stormreaver,1369,shaman,restoration,28,15,13
Gromgrai,bleeding-hollow,1368,shaman,restoration,53,30,23
Amperage,spirestone,1366,shaman,restoration,52,24,28
Krevsham,proudmoore,1364,shaman,restoration,56,23,33
Ralinta,tichondrius,1364,shaman,restoration,77,27,50
Charmize,azralon,1363,shaman,restoration,91,47,44
Shamkack,kelthuzad,1363,shaman,restoration,53,24,29
Ryùko,proudmoore,1363,shaman,restoration,60,19,41
Unchaman,ragnaros,1362,shaman,restoration,104,47,57
Fwwrs,illidan,1359,shaman,restoration,25,16,9
Vibration,akama,1359,shaman,restoration,123,67,56
Sàuron,tichondrius,1359,shaman,restoration,37,20,17
Wyått,emerald-dream,1359,shaman,restoration,95,43,52
Kiojin,ragnaros,1357,shaman,restoration,186,99,87
Wooskier,tichondrius,1355,shaman,restoration,60,32,28
Libragirl,tichondrius,1354,shaman,restoration,54,25,29
Prøduce,tichondrius,1353,shaman,restoration,54,30,24
Atnaz,drakkari,1352,shaman,restoration,42,24,18
Tumble,frostmourne,1352,shaman,restoration,105,51,54
Noobcrits,tichondrius,1350,shaman,restoration,42,25,17
Fencepost,bleeding-hollow,1350,shaman,restoration,72,42,30
Nyathera,barthilas,1349,shaman,restoration,66,37,29
Chandye,proudmoore,1348,shaman,restoration,72,27,45
Orjamba,barthilas,1347,shaman,restoration,29,17,12
Daddyk,gnomeregan,1347,shaman,restoration,53,30,23
Lildunny,tichondrius,1346,shaman,restoration,36,15,21
Fàrrò,thrall,1345,shaman,restoration,66,39,27
Xajsham,tichondrius,1344,shaman,restoration,102,54,48
Kultirio,quelthalas,1344,shaman,restoration,61,32,29
Elemen,quelthalas,1344,shaman,restoration,97,48,49
Smniss,tichondrius,1344,shaman,restoration,49,23,26
Orochishaman,stormrage,1343,shaman,restoration,24,14,10
Squimbert,tichondrius,1343,shaman,restoration,30,14,16
Dwârf,tichondrius,1342,shaman,restoration,24,14,10
Bombadil,korgath,1342,shaman,restoration,30,14,16
Camer,sargeras,1341,shaman,restoration,18,14,4
Shockpanda,zuljin,1340,shaman,restoration,18,14,4
Fallhazard,malganis,1340,shaman,restoration,40,24,16
Kachupinsito,ragnaros,1339,shaman,restoration,91,45,46
Multiduelist,bleeding-hollow,1338,shaman,restoration,18,14,4
Orbys,illidan,1335,shaman,restoration,24,14,10
Shakrakhan,tichondrius,1335,shaman,restoration,30,14,16
Satrixss,ragnaros,1334,shaman,restoration,79,44,35
Aseew,drakkari,1334,shaman,restoration,66,31,35
Nerfmytotemz,frostmourne,1333,shaman,restoration,30,14,16
Zinns,dalaran,1332,shaman,restoration,30,15,15
Alátreon,azralon,1332,shaman,restoration,66,30,36
Ryeqt,illidan,1331,shaman,restoration,30,14,16
Edisto,darkspear,1331,shaman,restoration,30,14,16
Jazzlightnin,tichondrius,1331,shaman,restoration,36,14,22
Elementgodx,skullcrusher,1330,shaman,restoration,48,23,25
Tampíco,ragnaros,1330,shaman,restoration,36,14,22
Angron,barthilas,1328,shaman,restoration,34,21,13
Huroth,proudmoore,1328,shaman,restoration,42,14,28
Targhal,tichondrius,1326,shaman,restoration,29,15,14
Barbosina,stormrage,1326,shaman,restoration,226,116,110
Azhen,ragnaros,1326,shaman,restoration,138,69,69
Tchaishammy,tichondrius,1326,shaman,restoration,29,14,15
Meatballer,queldorei,1325,shaman,restoration,77,42,35
Ginkuma,illidan,1325,shaman,restoration,30,14,16
Afgoox,tichondrius,1324,shaman,restoration,84,47,37
Zuljiba,illidan,1322,shaman,restoration,60,35,25
Restosud,crushridge,1320,shaman,restoration,30,18,12
Infsham,hyjal,1320,shaman,restoration,60,27,33
Kisimi,proudmoore,1319,shaman,restoration,30,18,12
Cleanfossil,stormrage,1319,shaman,restoration,41,24,17
Eekumbokum,bleeding-hollow,1318,shaman,restoration,50,29,21
Bearlysober,draka,1318,shaman,restoration,56,30,26
Boggins,dalaran,1318,shaman,restoration,52,25,27
Clutchinbuds,malganis,1318,shaman,restoration,54,24,30
Badião,azralon,1318,shaman,restoration,131,58,73
Latosos,dalaran,1317,shaman,restoration,36,15,21
Yamazakì,nemesis,1317,shaman,restoration,36,14,22
Macdab,malganis,1316,shaman,restoration,30,15,15
Bluebones,frostmane,1314,shaman,restoration,24,14,10
Phtalid,dalaran,1314,shaman,restoration,82,42,40
Crazytotems,dalaran,1312,shaman,restoration,114,58,56
Elementorx,stormrage,1311,shaman,restoration,36,14,22
Ithappens,senjin,1310,shaman,restoration,30,16,14
Orlá,moon-guard,1310,shaman,restoration,54,18,36
Hefestos,nemesis,1309,shaman,restoration,30,14,16
Absorblife,barthilas,1309,shaman,restoration,69,31,38
Aelwydx,quelthalas,1307,shaman,restoration,239,124,115
Youneverknow,frostmourne,1307,shaman,restoration,161,81,80
Sparks,ragnaros,1306,shaman,restoration,89,41,48
Toteapole,malganis,1305,shaman,restoration,94,51,43
Torgah,tichondrius,1305,shaman,restoration,90,44,46
Fíxer,tichondrius,1304,shaman,restoration,85,44,41
Genjuu,proudmoore,1304,shaman,restoration,42,20,22
Leca,tichondrius,1304,shaman,restoration,84,36,48
Truemooin,wyrmrest-accord,1303,shaman,restoration,303,154,149
Wunderwaffe,the-underbog,1303,shaman,restoration,46,22,24
Hüsky,dalaran,1303,shaman,restoration,42,14,28
Tumble,barthilas,1302,shaman,restoration,52,26,26
Solaraa,proudmoore,1301,shaman,restoration,46,22,24
Badgeshock,area-52,1301,shaman,restoration,108,48,60
Cæl,azralon,1300,shaman,restoration,35,20,15
Tacho,bleeding-hollow,1300,shaman,restoration,96,48,48
Tedmosbe,tichondrius,1300,shaman,restoration,84,37,47
Yarockheal,malganis,1298,shaman,restoration,54,27,27
Joocer,emerald-dream,1297,shaman,restoration,72,35,37
Bigtoy,frostmane,1296,shaman,restoration,42,14,28
Uhd,malganis,1294,shaman,restoration,38,17,21
Defnotheals,kelthuzad,1293,shaman,restoration,90,42,48
Thunderborn,laughing-skull,1292,shaman,restoration,30,14,16
Slaggdaddy,durotan,1292,shaman,restoration,30,14,16
Murata,tichondrius,1291,shaman,restoration,30,16,14
Aceshamm,kelthuzad,1289,shaman,restoration,60,30,30
Graveman,illidan,1289,shaman,restoration,75,37,38
Mengemort,crushridge,1288,shaman,restoration,35,19,16
Aviator,muradin,1288,shaman,restoration,36,19,17
Belgrom,tichondrius,1287,shaman,restoration,42,23,19
Drazic,area-52,1286,shaman,restoration,49,28,21
Pushaheal,tichondrius,1285,shaman,restoration,48,27,21
Mynigabob,zuljin,1285,shaman,restoration,148,83,65
Shamorrhoids,frostmourne,1285,shaman,restoration,137,70,67
Nezzuk,quelthalas,1285,shaman,restoration,96,42,54
Ketaminedrip,illidan,1284,shaman,restoration,42,22,20
Stargun,korgath,1284,shaman,restoration,147,76,71
Feldstar,stormrage,1284,shaman,restoration,103,47,56
Sukthistotem,kelthuzad,1282,shaman,restoration,24,16,8
Alraxion,ragnaros,1281,shaman,restoration,84,41,43
Ulala,azshara,1280,shaman,restoration,72,31,41
Hasselshock,area-52,1280,shaman,restoration,94,40,54
Aemi,tichondrius,1279,shaman,restoration,102,45,57
Mudeng,tichondrius,1276,shaman,restoration,60,30,30
Klaital,boulderfist,1274,shaman,restoration,30,21,9
Trúnks,magtheridon,1273,shaman,restoration,102,48,54
Retgarr,tichondrius,1272,shaman,restoration,30,17,13
Foodlust,sargeras,1272,shaman,restoration,108,57,51
Sharmut,bleeding-hollow,1272,shaman,restoration,130,67,63
Tákhisis,darkspear,1271,shaman,restoration,72,33,39
Angelicrain,stormrage,1269,shaman,restoration,30,16,14
Derkx,thrall,1268,shaman,restoration,30,22,8
Thomastides,tichondrius,1268,shaman,restoration,78,36,42
Killdeaderer,barthilas,1266,shaman,restoration,136,79,57
Tundertotem,tichondrius,1266,shaman,restoration,74,42,32
Shiestys,tichondrius,1264,shaman,restoration,33,23,10
Shohzegky,azralon,1264,shaman,restoration,91,40,51
Êdge,quelthalas,1263,shaman,restoration,57,28,29
Lüca,wyrmrest-accord,1261,shaman,restoration,333,177,156
Kunio,proudmoore,1261,shaman,restoration,42,22,20
Menah,moon-guard,1260,shaman,restoration,36,20,16
Hauby,zuljin,1259,shaman,restoration,48,15,33
Sindury,tichondrius,1257,shaman,restoration,66,35,31
Woodrose,frostmourne,1257,shaman,restoration,52,24,28
Jru,tichondrius,1257,shaman,restoration,31,14,17
Massif,emerald-dream,1256,shaman,restoration,31,14,17
Ragerax,trollbane,1254,shaman,restoration,23,16,7
Ironcaulk,kelthuzad,1252,shaman,restoration,54,26,28
Luto,tichondrius,1251,shaman,restoration,130,71,59
Freyttreyn,garrosh,1251,shaman,restoration,54,29,25
Blodbar,kiljaeden,1249,shaman,restoration,36,24,12
Peppito,illidan,1249,shaman,restoration,45,27,18
Watchmytrem,ragnaros,1249,shaman,restoration,60,20,40
Evilabev,bonechewer,1248,shaman,restoration,24,13,11
Toroph,azralon,1248,shaman,restoration,30,16,14
Bigwave,zuluhed,1248,shaman,restoration,30,15,15
Tôôz,stormrage,1247,shaman,restoration,18,13,5
Hiermy,tichondrius,1247,shaman,restoration,24,13,11
Moorgl,tichondrius,1246,shaman,restoration,24,13,11
Momolagbbit,tichondrius,1246,shaman,restoration,24,13,11
Cónò,tichondrius,1246,shaman,restoration,84,39,45
Tays,tichondrius,1245,shaman,restoration,18,13,5
Tayictwo,tichondrius,1244,shaman,restoration,24,13,11
Nyf,khazgoroth,1243,shaman,restoration,24,13,11
Shoxx,wyrmrest-accord,1243,shaman,restoration,24,13,11
Jsoto,ghostlands,1243,shaman,restoration,30,13,17
Zetli,tichondrius,1243,shaman,restoration,54,19,35
Darkn,cenarion-circle,1242,shaman,restoration,36,18,18
Óompaloompa,frostmourne,1242,shaman,restoration,30,13,17
Chenguanxi,tichondrius,1240,shaman,restoration,18,13,5
Harbert,black-dragonflight,1240,shaman,restoration,36,17,19
Keekballx,tichondrius,1240,shaman,restoration,30,13,17
Nomediocur,moknathal,1240,shaman,restoration,61,24,37
Jnzz,area-52,1239,shaman,restoration,24,13,11
Shamfold,illidan,1239,shaman,restoration,24,13,11
Jaandar,saurfang,1239,shaman,restoration,98,48,50
Battleobobby,medivh,1239,shaman,restoration,41,13,28
Furiousnick,stormrage,1238,shaman,restoration,24,13,11
Beefstocks,area-52,1238,shaman,restoration,66,32,34
Mixxt,illidan,1238,shaman,restoration,30,13,17
Entropey,daggerspine,1238,shaman,restoration,65,28,37
Lastdwarf,tichondrius,1237,shaman,restoration,18,13,5
Milkmeforhp,frostmourne,1237,shaman,restoration,69,36,33
Quequin,quelthalas,1237,shaman,restoration,30,14,16
Shamakazi,tichondrius,1237,shaman,restoration,31,14,17
Sleepysham,kelthuzad,1237,shaman,restoration,36,13,23
Deathwards,frostmane,1236,shaman,restoration,36,13,23
Elex,frostmourne,1236,shaman,restoration,45,16,29
Chingobling,illidan,1234,shaman,restoration,24,13,11
Krolii,tichondrius,1234,shaman,restoration,80,33,47
Shimansham,aegwynn,1233,shaman,restoration,167,79,88
Shamicare,stormrage,1232,shaman,restoration,136,75,61
Kinjin,dragonmaw,1232,shaman,restoration,30,13,17
Quakess,zuljin,1232,shaman,restoration,36,13,23
Fênrisulfer,area-52,1231,shaman,restoration,89,37,52
Kikkóman,malganis,1230,shaman,restoration,48,25,23
Edemental,area-52,1229,shaman,restoration,129,61,68
Lhost,tanaris,1228,shaman,restoration,30,17,13
Krishshammy,azshara,1228,shaman,restoration,148,72,76
Dogood,tichondrius,1228,shaman,restoration,36,13,23
Terdsammich,malganis,1227,shaman,restoration,51,27,24
Ozzai,ragnaros,1225,shaman,restoration,42,15,27
Ogtrippleog,blackwing-lair,1224,shaman,restoration,30,13,17
Mishalla,tichondrius,1224,shaman,restoration,72,27,45
Ndz,anubarak,1220,shaman,restoration,48,24,24
Hammerme,barthilas,1220,shaman,restoration,107,40,67
Hoong,garrosh,1219,shaman,restoration,32,17,15
Thizzasta,blackhand,1219,shaman,restoration,40,18,22
Donmills,tichondrius,1218,shaman,restoration,54,23,31
Lavablurst,stormrage,1218,shaman,restoration,59,23,36
Exportgold,barthilas,1218,shaman,restoration,42,16,26
Vajoku,proudmoore,1217,shaman,restoration,37,17,20
Babytiramisu,stormrage,1217,shaman,restoration,36,16,20
Desgarcon,zuljin,1216,shaman,restoration,47,23,24
Ekuku,tichondrius,1215,shaman,restoration,40,19,21
Smashtheface,nagrand,1211,shaman,restoration,54,27,27
Klausnomi,jaedenar,1211,shaman,restoration,30,13,17
Dabmarinø,tichondrius,1209,shaman,restoration,30,18,12
Certz,dark-iron,1209,shaman,restoration,39,15,24
Voodoototems,frostmourne,1207,shaman,restoration,51,25,26
Kinshaman,lightnings-blade,1206,shaman,restoration,73,33,40
Paratroop,bonechewer,1206,shaman,restoration,63,27,36
Patoron,proudmoore,1204,shaman,restoration,34,17,17
Bluffin,stormrage,1200,shaman,restoration,18,14,4
Magnethor,frostmourne,1200,shaman,restoration,42,24,18
Thräll,shuhalo,1200,shaman,restoration,202,103,99
Redbulls,azralon,1198,shaman,restoration,96,54,42
Cruelface,sargeras,1196,shaman,restoration,26,14,12
Synkrona,tichondrius,1191,shaman,restoration,38,16,22
Furti,daggerspine,1190,shaman,restoration,34,16,18
Babibolo,duskwood,1187,shaman,restoration,24,13,11
Brislin,sargeras,1185,shaman,restoration,151,71,80
Lokhtar,zuljin,1184,shaman,restoration,36,17,19
Getwetand,quelthalas,1182,shaman,restoration,103,51,52
Stabix,tichondrius,1181,shaman,restoration,66,31,35
Rimmington,frostmourne,1179,shaman,restoration,54,24,30
Dcãicer,quelthalas,1178,shaman,restoration,25,15,10
Rajin,sentinels,1178,shaman,restoration,36,18,18
Churgarm,zuljin,1177,shaman,restoration,30,18,12
Mandinga,warsong,1177,shaman,restoration,71,33,38
Pedren,thrall,1176,shaman,restoration,21,14,7
Flametide,proudmoore,1176,shaman,restoration,35,20,15
Vanty,proudmoore,1170,shaman,restoration,29,13,16
Shammimane,tichondrius,1169,shaman,restoration,107,53,54
Hedbang,kiljaeden,1169,shaman,restoration,60,24,36
Wazöö,sargeras,1168,shaman,restoration,63,28,35
Oomshamm,area-52,1167,shaman,restoration,130,68,62
Shazikial,illidan,1167,shaman,restoration,38,18,20
Delíta,quelthalas,1167,shaman,restoration,36,13,23
Shaokhang,emerald-dream,1167,shaman,restoration,64,23,41
Restoramen,frostmourne,1166,shaman,restoration,24,13,11
Senzxlolxz,lightbringer,1165,shaman,restoration,45,29,16
Onpoint,frostmourne,1165,shaman,restoration,23,13,10
Grakkah,thrall,1162,shaman,restoration,30,13,17
Stahlman,blackhand,1160,shaman,restoration,48,17,31
Turblix,tichondrius,1155,shaman,restoration,34,21,13
Balsonz,zuljin,1155,shaman,restoration,25,13,12
Drboidzerg,tichondrius,1154,shaman,restoration,32,20,12
Yamishka,dalaran,1154,shaman,restoration,42,15,27
Dahmerjr,area-52,1153,shaman,restoration,78,43,35
Twinkolava,nemesis,1152,shaman,restoration,25,14,11
Dbmx,tichondrius,1152,shaman,restoration,24,12,12
Badjojò,ragnaros,1152,shaman,restoration,24,12,12
Rawdòggin,emerald-dream,1152,shaman,restoration,33,13,20
Owtyobwol,area-52,1151,shaman,restoration,18,12,6
Booramz,tichondrius,1151,shaman,restoration,18,12,6
Ruupaul,kiljaeden,1151,shaman,restoration,18,12,6
Lignipzyo,doomhammer,1151,shaman,restoration,24,12,12
Hoatboiz,magtheridon,1151,shaman,restoration,54,14,40
Gödöfbüdå,tichondrius,1150,shaman,restoration,18,12,6
Uglybastrd,stormrage,1150,shaman,restoration,24,12,12
Ixis,bleeding-hollow,1149,shaman,restoration,18,12,6
Noolube,barthilas,1148,shaman,restoration,24,12,12
Qitian,tichondrius,1148,shaman,restoration,24,12,12
Jineluki,emerald-dream,1148,shaman,restoration,53,23,30
Xiaoxiboy,tichondrius,1147,shaman,restoration,24,12,12
Ricn,tichondrius,1147,shaman,restoration,24,12,12
Tesle,illidan,1147,shaman,restoration,30,12,18
Branasou,emerald-dream,1147,shaman,restoration,30,12,18
Bitruff,tichondrius,1146,shaman,restoration,24,12,12
Yeeraldyn,quelthalas,1146,shaman,restoration,30,12,18
Nobiggy,tichondrius,1146,shaman,restoration,30,12,18
Orcstain,moknathal,1146,shaman,restoration,94,30,64
Boltadeez,tichondrius,1144,shaman,restoration,24,12,12
Lleonardo,tichondrius,1140,shaman,restoration,24,12,12
Laterallus,nagrand,1138,shaman,restoration,85,43,42
Peanutto,illidan,1136,shaman,restoration,125,67,58
Smooths,bloodscalp,1131,shaman,restoration,30,16,14
Meanbetty,illidan,1131,shaman,restoration,24,12,12
Lechaman,hakkar,1131,shaman,restoration,66,22,44
Cameltotêm,frostmourne,1130,shaman,restoration,30,17,13
Darrann,kiljaeden,1126,shaman,restoration,18,12,6
Dinaliia,lothar,1126,shaman,restoration,36,16,20
Käck,tichondrius,1122,shaman,restoration,62,28,34
Sephyros,ragnaros,1121,shaman,restoration,24,12,12
Bóòchainz,tichondrius,1120,shaman,restoration,22,13,9
Rocksteddy,area-52,1120,shaman,restoration,24,12,12
Twoflower,frostmourne,1120,shaman,restoration,136,63,73
Saxaboom,tichondrius,1115,shaman,restoration,30,12,18
Etherys,frostmourne,1114,shaman,restoration,36,21,15
Tartar,lightbringer,1112,shaman,restoration,29,18,11
Zhyrouvstorm,stormrage,1110,shaman,restoration,42,20,22
Taò,tichondrius,1109,shaman,restoration,84,38,46
Saicey,zuljin,1107,shaman,restoration,72,35,37
Shammyguy,stormreaver,1103,shaman,restoration,50,23,27
Ttass,dalaran,1102,shaman,restoration,35,13,22
Totemist,tichondrius,1100,shaman,restoration,36,12,24
Qüickeze,khazgoroth,1097,shaman,restoration,22,15,7
Chablez,shattered-hand,1096,shaman,restoration,30,13,17
Stormburst,sargeras,1092,shaman,restoration,42,20,22
Tremór,frostmourne,1091,shaman,restoration,24,14,10
Phira,tichondrius,1090,shaman,restoration,54,27,27
Gsync,tichondrius,1089,shaman,restoration,47,28,19
Taquitho,quelthalas,1088,shaman,restoration,75,32,43
Mikeisbadwow,tichondrius,1086,shaman,restoration,16,12,4
Grimmzhul,daggerspine,1077,shaman,restoration,90,43,47
Delayy,destromath,1075,shaman,restoration,77,32,45
Turbluscious,frostmourne,1074,shaman,restoration,49,26,23
Elharm,ragnaros,1072,shaman,restoration,36,13,23
Belínski,azralon,1070,shaman,restoration,30,16,14
Narikó,aggramar,1069,shaman,restoration,94,53,41
Hazorele,nagrand,1069,shaman,restoration,48,23,25
Maserati,korialstrasz,1067,shaman,restoration,58,24,34
Grullander,hakkar,1063,shaman,restoration,36,20,16
Eleshortal,azuremyst,1062,shaman,restoration,39,16,23
Sekkuo,kiljaeden,1061,shaman,restoration,60,28,32
Littledream,quelthalas,1061,shaman,restoration,58,26,32
Nickwoper,emerald-dream,1056,shaman,restoration,18,11,7
Lfgzookeeper,malganis,1056,shaman,restoration,18,11,7
Fàlc,stormrage,1056,shaman,restoration,18,11,7
Biofly,thrall,1056,shaman,restoration,18,11,7
Handzum,blades-edge,1056,shaman,restoration,18,11,7
Brocules,aerie-peak,1056,shaman,restoration,24,11,13
Censyzz,tichondrius,1056,shaman,restoration,24,11,13
Wegoagain,tichondrius,1056,shaman,restoration,24,11,13
Jukedlawl,illidan,1056,shaman,restoration,30,11,19
Specifyz,arathor,1055,shaman,restoration,18,11,7
Localxhero,stormrage,1055,shaman,restoration,24,11,13
Pericazo,sargeras,1055,shaman,restoration,24,11,13
Jtrxs,tichondrius,1055,shaman,restoration,24,11,13
Haard,area-52,1055,shaman,restoration,24,11,13
Sweetpotatoe,malganis,1055,shaman,restoration,24,11,13
Fluiid,tichondrius,1055,shaman,restoration,24,11,13
Mindgooblin,sargeras,1055,shaman,restoration,36,11,25
Sipo,tichondrius,1054,shaman,restoration,18,11,7
Ituma,tichondrius,1054,shaman,restoration,18,11,7
Earthfirex,ragnaros,1054,shaman,restoration,18,11,7
Keybordternr,tichondrius,1054,shaman,restoration,24,11,13
Vixeen,kelthuzad,1054,shaman,restoration,24,11,13
Nosekandyz,chogall,1054,shaman,restoration,24,11,13
Gorillox,chogall,1054,shaman,restoration,24,11,13
Elmonkeyloco,bleeding-hollow,1053,shaman,restoration,18,11,7
Murm,burning-blade,1053,shaman,restoration,24,11,13
Velesa,kiljaeden,1052,shaman,restoration,30,11,19
Urin,emerald-dream,1051,shaman,restoration,21,11,10
Tamzlol,the-forgotten-coast,1051,shaman,restoration,24,11,13
Glark,tichondrius,1051,shaman,restoration,24,11,13
Choochette,illidan,1051,shaman,restoration,30,11,19
Exussh,tichondrius,1050,shaman,restoration,12,11,1
Dragum,blackrock,1050,shaman,restoration,30,11,19
Paradigm,sargeras,1049,shaman,restoration,18,11,7
Groundded,tichondrius,1049,shaman,restoration,29,11,18
Galeswind,sargeras,1048,shaman,restoration,24,11,13
Ryuukas,illidan,1047,shaman,restoration,18,11,7
Mcstop,tanaris,1046,shaman,restoration,36,15,21
Zoodoo,nagrand,1046,shaman,restoration,48,16,32
Tràuma,caelestrasz,1045,shaman,restoration,45,13,32
Leogi,daggerspine,1044,shaman,restoration,27,11,16
Gl,nordrassil,1043,shaman,restoration,18,11,7
Fio,nerzhul,1043,shaman,restoration,194,92,102
Saraguthix,dalaran,1043,shaman,restoration,30,11,19
Mvpstorm,darkspear,1041,shaman,restoration,24,11,13
Pootergash,shadowmoon,1041,shaman,restoration,24,11,13
Zugzugthug,moon-guard,1040,shaman,restoration,84,33,51
Plop,tichondrius,1024,shaman,restoration,16,12,4
Anttoekneeoh,thrall,1024,shaman,restoration,24,12,12
Blaiserpub,tichondrius,1023,shaman,restoration,23,11,12
Mastrionilol,stormrage,1023,shaman,restoration,34,11,23
Slëvin,frostmourne,1023,shaman,restoration,42,13,29
Frizzie,barthilas,1023,shaman,restoration,71,14,57
Kulgur,ravenholdt,1022,shaman,restoration,24,16,8
Jìmmybuckets,tichondrius,1022,shaman,restoration,17,11,6
Dextex,azralon,1022,shaman,restoration,47,26,21
Lavatotem,stormrage,1021,shaman,restoration,41,20,21
Zonsham,drakkari,1017,shaman,restoration,24,11,13
Castte,ragnaros,1013,shaman,restoration,54,24,30
Nupi,thaurissan,1013,shaman,restoration,59,26,33
Lazi,frostmourne,1008,shaman,restoration,27,12,15
Volsdeep,illidan,1007,shaman,restoration,21,11,10
Centalinkxox,frostmourne,1006,shaman,restoration,27,11,16
Illeh,illidan,1005,shaman,restoration,42,19,23
Speedranger,stormrage,1004,shaman,restoration,42,15,27
Hoghlinn,stormrage,1003,shaman,restoration,14,12,2
Baygone,tichondrius,1002,shaman,restoration,24,11,13
Shamankie,tichondrius,999,shaman,restoration,40,13,27
Hentaistorm,kiljaeden,998,shaman,restoration,80,41,39
Woof,agamaggan,994,shaman,restoration,41,12,29
Wâgu,moon-guard,992,shaman,restoration,28,11,17
Kencyzz,tichondrius,991,shaman,restoration,17,11,6
Vogaz,ragnaros,991,shaman,restoration,28,11,17
Nottrhall,azralon,990,shaman,restoration,14,11,3
Teardrinker,korgath,988,shaman,restoration,30,11,19
Faegle,area-52,984,shaman,restoration,24,11,13
Doomgodx,tichondrius,983,shaman,restoration,36,16,20
Banterx,emerald-dream,979,shaman,restoration,35,12,23
Superchunk,shattered-hand,977,shaman,restoration,108,56,52
Andrastia,thrall,976,shaman,restoration,24,15,9
Shamadran,hyjal,971,shaman,restoration,23,11,12
Njjshamm,thrall,969,shaman,restoration,36,16,20
Tharapita,bleeding-hollow,968,shaman,restoration,33,12,21
Robis,thrall,966,shaman,restoration,125,61,64
Sagester,illidan,960,shaman,restoration,16,11,5
Dadbar,tichondrius,960,shaman,restoration,18,10,8
Burstekka,tichondrius,960,shaman,restoration,18,10,8
Hst,barthilas,960,shaman,restoration,18,10,8
Paperbot,barthilas,960,shaman,restoration,18,10,8
Yunotho,sargeras,960,shaman,restoration,18,10,8
Naisayyds,tichondrius,960,shaman,restoration,18,10,8
Freerath,tichondrius,960,shaman,restoration,22,10,12
Nisthesham,tichondrius,960,shaman,restoration,24,10,14
Enhancex,frostwolf,960,shaman,restoration,24,10,14
Terrasham,barthilas,960,shaman,restoration,29,10,19
Farfar,tichondrius,959,shaman,restoration,12,10,2
Service,llane,959,shaman,restoration,18,10,8
Lodekimm,tichondrius,959,shaman,restoration,18,10,8
Esoterikk,malganis,959,shaman,restoration,18,10,8
Zensarg,tichondrius,959,shaman,restoration,18,10,8
Valcn,moon-guard,959,shaman,restoration,24,10,14
Eccentrix,mannoroth,959,shaman,restoration,24,10,14
Matzuga,bleeding-hollow,959,shaman,restoration,24,10,14
Forcè,bleeding-hollow,959,shaman,restoration,24,10,14
Jisthexx,senjin,959,shaman,restoration,24,10,14
Cosmô,sargeras,959,shaman,restoration,30,10,20
Ggoong,tichondrius,959,shaman,restoration,36,10,26
Vinceshamwow,lightbringer,958,shaman,restoration,12,10,2
Shyva,frostmourne,958,shaman,restoration,18,10,8
Zechary,proudmoore,958,shaman,restoration,18,10,8
Kacham,nerzhul,958,shaman,restoration,18,10,8
Thundershade,deathwing,958,shaman,restoration,24,10,14
Lawlsham,korgath,957,shaman,restoration,12,10,2
Humpvack,tichondrius,957,shaman,restoration,18,10,8
Athayis,malorne,957,shaman,restoration,59,31,28
Maakasarg,tichondrius,956,shaman,restoration,24,10,14
Karaaka,ysera,956,shaman,restoration,30,10,20
Cameltótém,sargeras,955,shaman,restoration,18,10,8
Oohkillemm,silvermoon,955,shaman,restoration,18,10,8
Shammystic,quelthalas,955,shaman,restoration,54,19,35
Johnnyblue,frostmourne,954,shaman,restoration,30,10,20
Mythshaman,tichondrius,953,shaman,restoration,30,10,20
Raininwishes,aegwynn,952,shaman,restoration,18,10,8
Tequíla,quelthalas,952,shaman,restoration,18,10,8
Mikeyodinson,area-52,952,shaman,restoration,24,10,14
Uhfishuhl,bleeding-hollow,951,shaman,restoration,18,10,8
Bruhh,stormscale,951,shaman,restoration,18,10,8
Soulmiracle,tichondrius,951,shaman,restoration,24,10,14
Romcomx,tichondrius,951,shaman,restoration,24,10,14
Overcåst,barthilas,951,shaman,restoration,36,10,26
Problamatic,tichondrius,949,shaman,restoration,24,10,14
Tabby,emerald-dream,948,shaman,restoration,24,10,14
Daxetan,area-52,947,shaman,restoration,18,10,8
Recyclicrab,skullcrusher,945,shaman,restoration,12,10,2
Skippe,hyjal,943,shaman,restoration,18,10,8
Alphamael,lightbringer,941,shaman,restoration,31,10,21
Hatethetotem,bleeding-hollow,937,shaman,restoration,26,11,15
Boppshock,tichondrius,928,shaman,restoration,16,11,5
Mikeoxxgigg,kelthuzad,927,shaman,restoration,51,28,23
Haether,madoran,926,shaman,restoration,101,50,51
Colberton,dalaran,926,shaman,restoration,23,10,13
Rastablaze,darkspear,926,shaman,restoration,70,27,43
Artsha,tol-barad,925,shaman,restoration,18,11,7
Psilocypher,nazjatar,923,shaman,restoration,18,11,7
Mikeyshockus,hydraxis,922,shaman,restoration,47,19,28
Klev,frostmourne,921,shaman,restoration,33,12,21
Jorko,dathremar,918,shaman,restoration,26,16,10
Malløry,mugthol,917,shaman,restoration,30,12,18
Flexexpress,stormrage,911,shaman,restoration,17,10,7
Privxd,bleeding-hollow,910,shaman,restoration,17,10,7
Mainstreamx,sargeras,908,shaman,restoration,33,10,23
Bitflip,jubeithos,907,shaman,restoration,21,10,11
Jessestevens,kiljaeden,905,shaman,restoration,17,10,7
Alestorm,nemesis,899,shaman,restoration,28,12,16
Booz,caelestrasz,895,shaman,restoration,30,10,20
Imperiumrum,azuremyst,887,shaman,restoration,77,41,36
Jenniferlynn,tichondrius,886,shaman,restoration,48,15,33
Swifteyy,area-52,883,shaman,restoration,22,10,12
Astàròth,malganis,880,shaman,restoration,13,10,3
Washedupty,illidan,864,shaman,restoration,12,9,3
Luckalicious,proudmoore,864,shaman,restoration,12,9,3
Èmaxx,barthilas,864,shaman,restoration,12,9,3
Bakenquake,tichondrius,864,shaman,restoration,12,9,3
ßonevoyage,malganis,864,shaman,restoration,12,9,3
Seiunsky,area-52,864,shaman,restoration,12,9,3
Iadyboi,kiljaeden,864,shaman,restoration,12,9,3
Medullarum,suramar,864,shaman,restoration,18,9,9
Jhakrï,tichondrius,864,shaman,restoration,18,9,9
Flatt,uther,864,shaman,restoration,18,9,9
Spampurge,emerald-dream,864,shaman,restoration,18,9,9
Kirschblute,proudmoore,864,shaman,restoration,18,9,9
Hexcalibur,laughing-skull,864,shaman,restoration,18,9,9
Awyiss,dreadmaul,864,shaman,restoration,18,9,9
Neviahz,illidan,864,shaman,restoration,18,9,9
Wildmaster,ragnaros,864,shaman,restoration,30,9,21
Deosculation,tichondrius,863,shaman,restoration,12,9,3
Køre,tichondrius,863,shaman,restoration,12,9,3
Jaegertotem,stormrage,863,shaman,restoration,12,9,3
Kzxs,illidan,863,shaman,restoration,12,9,3
Darcheros,quelthalas,863,shaman,restoration,18,9,9
Snoff,burning-blade,863,shaman,restoration,18,9,9
Murica,area-52,863,shaman,restoration,18,9,9
Hoofpics,dalaran,863,shaman,restoration,18,9,9
Bakayarøu,tichondrius,863,shaman,restoration,18,9,9
Multran,stormscale,863,shaman,restoration,18,9,9
Mastrionilol,dragonmaw,863,shaman,restoration,24,9,15
Udungoofedd,the-underbog,862,shaman,restoration,12,9,3
Turtleinmud,frostmourne,862,shaman,restoration,18,9,9
Drünk,hyjal,862,shaman,restoration,18,9,9
Obrahma,burning-legion,862,shaman,restoration,18,9,9
Dùffman,jubeithos,862,shaman,restoration,22,10,12
Adventstrike,tichondrius,862,shaman,restoration,24,9,15
Soppin,bleeding-hollow,861,shaman,restoration,18,9,9
Milkstress,whisperwind,861,shaman,restoration,24,9,15
Esanim,tichondrius,860,shaman,restoration,18,9,9
Bacnbitz,hellscream,860,shaman,restoration,24,9,15
Wagesisdeath,illidan,859,shaman,restoration,24,9,15
Aargonos,tichondrius,858,shaman,restoration,12,9,3
Ironfart,destromath,858,shaman,restoration,18,9,9
Shockburst,dalaran,858,shaman,restoration,18,9,9
Blois,thunderlord,857,shaman,restoration,18,9,9
Chungie,laughing-skull,855,shaman,restoration,18,9,9
Yakella,trollbane,854,shaman,restoration,12,9,3
Siksika,bloodscalp,854,shaman,restoration,94,43,51
Mtnju,eredar,852,shaman,restoration,18,9,9
Çatastrophe,dalaran,849,shaman,restoration,18,9,9
Ayahuassca,illidan,847,shaman,restoration,44,19,25
Scrototëm,azralon,833,shaman,restoration,24,9,15
Deadlyshocks,gilneas,827,shaman,restoration,35,17,18
Sittingwolf,stormreaver,825,shaman,restoration,17,9,8
Aimiréal,nagrand,823,shaman,restoration,18,9,9
Insidetrader,illidan,815,shaman,restoration,15,10,5
Maloran,zuljin,815,shaman,restoration,23,9,14
Htsu,quelthalas,809,shaman,restoration,22,10,12
Shamjam,moon-guard,768,shaman,restoration,12,8,4
Stormlashx,sargeras,768,shaman,restoration,12,8,4
Xbk,tichondrius,768,shaman,restoration,12,8,4
Hexistential,tichondrius,768,shaman,restoration,12,8,4
Plznostepmom,tichondrius,768,shaman,restoration,12,8,4
Touchmytotmm,tichondrius,768,shaman,restoration,12,8,4
Longlivecrit,exodar,768,shaman,restoration,12,8,4
Hoonjojjyans,tichondrius,768,shaman,restoration,12,8,4
Ophitotem,zuljin,768,shaman,restoration,12,8,4
Shxl,zuljin,768,shaman,restoration,12,8,4
Lavamon,illidan,768,shaman,restoration,12,8,4
Xiaoshaman,frostmourne,768,shaman,restoration,12,8,4
Xiaoshaman,tichondrius,768,shaman,restoration,12,8,4
Vernzi,laughing-skull,768,shaman,restoration,12,8,4
Xannysnapper,zuljin,768,shaman,restoration,12,8,4
Steverz,daggerspine,768,shaman,restoration,12,8,4
Ggdumpy,tichondrius,768,shaman,restoration,12,8,4
Kensyz,tichondrius,768,shaman,restoration,12,8,4
Sgtsosix,zuljin,768,shaman,restoration,18,8,10
Taronì,zuljin,768,shaman,restoration,18,8,10
Songo,frostmane,768,shaman,restoration,18,8,10
Kaddya,mannoroth,768,shaman,restoration,18,8,10
Toastjr,frostmourne,768,shaman,restoration,18,8,10
Traumateam,tichondrius,768,shaman,restoration,18,8,10
Ändiroba,azralon,768,shaman,restoration,18,8,10
Fyc,wyrmrest-accord,768,shaman,restoration,18,8,10
Girthquake,agamaggan,768,shaman,restoration,18,8,10
Kwesy,tichondrius,768,shaman,restoration,18,8,10
Wolvez,tichondrius,768,shaman,restoration,18,8,10
Laodo,tichondrius,768,shaman,restoration,22,9,13
Earthuncle,illidan,768,shaman,restoration,24,8,16
Sokta,azgalor,768,shaman,restoration,24,8,16
Mymojo,tichondrius,767,shaman,restoration,12,8,4
Vernacks,area-52,767,shaman,restoration,12,8,4
Iarepotato,tichondrius,767,shaman,restoration,12,8,4
Squirtrussel,boulderfist,767,shaman,restoration,12,8,4
Maheva,ragnaros,767,shaman,restoration,12,8,4
Veeve,kelthuzad,767,shaman,restoration,12,8,4
Totemism,warsong,767,shaman,restoration,12,8,4
Vazlah,tichondrius,767,shaman,restoration,12,8,4
Klimax,tichondrius,767,shaman,restoration,12,8,4
Lepoow,illidan,767,shaman,restoration,12,8,4
Earthentotem,tichondrius,767,shaman,restoration,18,8,10
Zombaschamy,ragnaros,767,shaman,restoration,18,8,10
Zad,spinebreaker,767,shaman,restoration,18,8,10
Treasonreno,area-52,767,shaman,restoration,18,8,10
Nehpets,kiljaeden,767,shaman,restoration,18,8,10
Volzuna,wyrmrest-accord,767,shaman,restoration,18,8,10
Chrigshock,black-dragonflight,767,shaman,restoration,18,8,10
Thunderfucj,tichondrius,767,shaman,restoration,24,8,16
Agrîm,tichondrius,767,shaman,restoration,24,8,16
Karmatide,malganis,766,shaman,restoration,12,8,4
Plausibility,moon-guard,766,shaman,restoration,12,8,4
Skylet,azralon,766,shaman,restoration,18,8,10
Rapwnzel,tichondrius,766,shaman,restoration,18,8,10
Totemlord,lightnings-blade,766,shaman,restoration,18,8,10
Pickledegg,tichondrius,766,shaman,restoration,21,9,12
Santral,ragnaros,766,shaman,restoration,19,8,11
Nooch,malganis,766,shaman,restoration,27,9,18
Magatotem,sargeras,766,shaman,restoration,24,8,16
Bubbert,illidan,765,shaman,restoration,24,8,16
Zqshaman,tichondrius,764,shaman,restoration,18,8,10
Mochiko,frostmourne,764,shaman,restoration,18,8,10
Vulcanik,quelthalas,764,shaman,restoration,24,8,16
Tym,sargeras,763,shaman,restoration,18,8,10
Vínnie,tichondrius,763,shaman,restoration,18,8,10
Furbiddên,area-52,763,shaman,restoration,24,8,16
ßøn,altar-of-storms,762,shaman,restoration,12,8,4
Shamnnoodlez,area-52,762,shaman,restoration,18,8,10
Cremecheese,crushridge,760,shaman,restoration,12,8,4
Geoleo,stormrage,758,shaman,restoration,18,8,10
Shamanlesa,azralon,757,shaman,restoration,18,8,10
Kordir,kiljaeden,756,shaman,restoration,24,8,16
Smolder,magtheridon,753,shaman,restoration,12,8,4
Amonamarth,tichondrius,753,shaman,restoration,18,8,10
Getpurged,thrall,751,shaman,restoration,17,8,9
Shubba,thrall,747,shaman,restoration,12,8,4
Msooli,tichondrius,745,shaman,restoration,15,10,5
Kawixxi,ysondre,740,shaman,restoration,35,16,19
Ryforges,frostmourne,734,shaman,restoration,14,9,5
Interwebzz,tichondrius,734,shaman,restoration,66,17,49
Treris,bleeding-hollow,719,shaman,restoration,11,8,3
Jakjohnson,stormrage,719,shaman,restoration,15,8,7
Notragii,kelthuzad,719,shaman,restoration,17,8,9
Luxiaa,tichondrius,714,shaman,restoration,23,9,14
Kencysz,tichondrius,714,shaman,restoration,23,9,14
Kenithwest,tichondrius,703,shaman,restoration,11,8,3
Xinz,guldan,703,shaman,restoration,11,8,3
Purgelordx,proudmoore,703,shaman,restoration,11,8,3
Wasuwant,frostmourne,703,shaman,restoration,14,8,6
Garbagedump,burning-legion,703,shaman,restoration,14,8,6
Kikahna,stormreaver,683,shaman,restoration,22,9,13
Xueticsham,tichondrius,672,shaman,restoration,12,7,5
Symbox,tichondrius,672,shaman,restoration,12,7,5
Heckinpurges,area-52,672,shaman,restoration,12,7,5
Elîas,tichondrius,672,shaman,restoration,12,7,5
Kyma,black-dragonflight,672,shaman,restoration,12,7,5
Macksimas,tichondrius,672,shaman,restoration,12,7,5
Hexmix,muradin,672,shaman,restoration,12,7,5
Wumx,tichondrius,672,shaman,restoration,12,7,5
Dizzyswift,tichondrius,672,shaman,restoration,12,7,5
Joè,bleeding-hollow,672,shaman,restoration,12,7,5
Invokeesorin,area-52,672,shaman,restoration,12,7,5
Paaman,proudmoore,672,shaman,restoration,12,7,5
Crakmane,kelthuzad,672,shaman,restoration,12,7,5
Yusbe,ragnaros,672,shaman,restoration,12,7,5
Kencyi,tichondrius,672,shaman,restoration,12,7,5
Viprus,nerzhul,672,shaman,restoration,12,7,5
Zerwyn,senjin,672,shaman,restoration,12,7,5
Envy,korialstrasz,672,shaman,restoration,12,7,5
Boltekka,tichondrius,672,shaman,restoration,12,7,5
Dektide,zuljin,672,shaman,restoration,12,7,5
Sorgal,area-52,672,shaman,restoration,12,7,5
Daxotv,sargeras,672,shaman,restoration,12,7,5
Strykked,illidan,672,shaman,restoration,12,7,5
Flõp,dalaran,672,shaman,restoration,12,7,5
Bloodlustxo,frostmourne,672,shaman,restoration,12,7,5
Iliillililli,tichondrius,672,shaman,restoration,12,7,5
Gornu,nemesis,672,shaman,restoration,12,7,5
Abulailah,sargeras,672,shaman,restoration,12,7,5
Zrosurge,stormrage,672,shaman,restoration,14,7,7
Macavell,tichondrius,672,shaman,restoration,18,7,11
Hardlyfe,frostmourne,672,shaman,restoration,18,7,11
Trippzs,barthilas,672,shaman,restoration,18,7,11
Smeagles,ragnaros,672,shaman,restoration,18,7,11
Aromental,sargeras,672,shaman,restoration,18,7,11
Pjtremblay,frostmourne,672,shaman,restoration,18,7,11
Morphose,tichondrius,672,shaman,restoration,18,7,11
Juvîa,emerald-dream,672,shaman,restoration,18,7,11
Lindsanx,illidan,672,shaman,restoration,18,7,11
Weirdboi,area-52,672,shaman,restoration,18,7,11
Pakdis,sargeras,671,shaman,restoration,12,7,5
Thormodin,destromath,671,shaman,restoration,12,7,5
Winchi,stormrage,671,shaman,restoration,12,7,5
Shamiggels,sargeras,671,shaman,restoration,12,7,5
Arkilios,tichondrius,671,shaman,restoration,12,7,5
Lurue,tichondrius,671,shaman,restoration,12,7,5
Rokvahn,illidan,671,shaman,restoration,12,7,5
Chebbs,bleeding-hollow,671,shaman,restoration,12,7,5
Flekzs,blackhand,671,shaman,restoration,12,7,5
Otem,frostmourne,671,shaman,restoration,16,7,9
Dochavoc,tichondrius,671,shaman,restoration,18,7,11
Cheeziee,thrall,671,shaman,restoration,18,7,11
Hamshamwitch,shadowmoon,671,shaman,restoration,18,7,11
Lvcianrs,thrall,671,shaman,restoration,18,7,11
Caobuloso,azralon,671,shaman,restoration,18,7,11
Sphaerus,tichondrius,671,shaman,restoration,18,7,11
Stormcallerr,sargeras,670,shaman,restoration,12,7,5
Totori,stormscale,670,shaman,restoration,12,7,5
Shamanastic,tichondrius,670,shaman,restoration,12,7,5
Crynoobs,senjin,670,shaman,restoration,12,7,5
Bethorá,suramar,670,shaman,restoration,12,7,5
Shammysham,zuljin,670,shaman,restoration,18,7,11
Karrydoskftw,ragnaros,670,shaman,restoration,18,7,11
Víì,tichondrius,670,shaman,restoration,24,7,17
Toedims,bonechewer,669,shaman,restoration,12,7,5
Vulkova,illidan,669,shaman,restoration,18,7,11
Thordan,lothar,669,shaman,restoration,18,7,11
Cheliz,thrall,669,shaman,restoration,24,7,17
Evilraven,tichondrius,668,shaman,restoration,18,7,11
Waterspinach,tichondrius,668,shaman,restoration,18,7,11
Detropolis,illidan,668,shaman,restoration,48,7,41
Youngneal,sargeras,667,shaman,restoration,18,7,11
Elementium,azshara,667,shaman,restoration,23,7,16
Dennwoop,sargeras,666,shaman,restoration,22,8,14
PlayerHLFJNY,moon-guard,665,shaman,restoration,11,9,2
Ruadhri,moon-guard,665,shaman,restoration,12,7,5
Lamente,ragnaros,655,shaman,restoration,17,7,10
Mâyo,thrall,654,shaman,restoration,17,7,10
Slimcube,illidan,649,shaman,restoration,24,8,16
Stormsurgë,bleeding-hollow,640,shaman,restoration,10,8,2
Deacoderz,area-52,618,shaman,restoration,14,8,6
Royblue,illidan,618,shaman,restoration,14,8,6
Îvôry,bloodhoof,618,shaman,restoration,22,10,12
Mythruxx,sargeras,617,shaman,restoration,20,8,12
Tolvashoc,emerald-dream,608,shaman,restoration,16,7,9
Bigbrenx,tichondrius,607,shaman,restoration,14,7,7
Drfate,kargath,604,shaman,restoration,16,7,9
Matrìx,sargeras,594,shaman,restoration,26,8,18
Vaderung,emerald-dream,592,shaman,restoration,13,7,6
Jimmyapple,illidan,576,shaman,restoration,6,6,0
Creativemind,arathor,576,shaman,restoration,6,6,0
Pangniu,illidan,576,shaman,restoration,6,6,0
Vrangr,uther,576,shaman,restoration,6,6,0
Kassix,illidan,576,shaman,restoration,6,6,0
Jordnöt,moon-guard,576,shaman,restoration,9,6,3
Millionvoltz,tichondrius,576,shaman,restoration,12,6,6
Trewlolz,sargeras,576,shaman,restoration,12,6,6
Lunds,tichondrius,576,shaman,restoration,12,6,6
Joeschhmoe,tichondrius,576,shaman,restoration,12,6,6
Ataia,tichondrius,576,shaman,restoration,12,6,6
Sweatshirtz,tanaris,576,shaman,restoration,12,6,6
Ccmeifbald,moon-guard,576,shaman,restoration,12,6,6
Subhealth,tichondrius,576,shaman,restoration,12,6,6
Hhex,tichondrius,576,shaman,restoration,12,6,6
Nymrose,stormrage,576,shaman,restoration,12,6,6
Apathcat,the-forgotten-coast,576,shaman,restoration,12,6,6
Caprise,tichondrius,576,shaman,restoration,12,6,6
Cencyzz,tichondrius,576,shaman,restoration,12,6,6
Fatdixb,illidan,576,shaman,restoration,12,6,6
Vyy,perenolde,576,shaman,restoration,12,6,6
Biased,sargeras,576,shaman,restoration,12,6,6
Mazekheen,barthilas,576,shaman,restoration,12,6,6
Scadouche,korgath,576,shaman,restoration,12,6,6
Atsukaia,tichondrius,576,shaman,restoration,12,6,6
Abev,bonechewer,576,shaman,restoration,12,6,6
Rawdogginit,malfurion,576,shaman,restoration,12,6,6
Pex,sargeras,576,shaman,restoration,12,6,6
Aespeon,stormrage,576,shaman,restoration,12,6,6
Bravezf,tichondrius,576,shaman,restoration,12,6,6
Weqeqwqwqex,ragnaros,576,shaman,restoration,12,6,6
Mariansaurus,ragnaros,576,shaman,restoration,12,6,6
Tcurts,stormrage,576,shaman,restoration,12,6,6
Iamg,kilrogg,576,shaman,restoration,12,6,6
Xenvale,illidan,576,shaman,restoration,12,6,6
Motatos,malganis,576,shaman,restoration,12,6,6
Akamâ,stormrage,576,shaman,restoration,12,6,6
Gargrax,malganis,576,shaman,restoration,12,6,6
Chogramm,illidan,576,shaman,restoration,12,6,6
Fevolution,dreadmaul,576,shaman,restoration,12,6,6
Lindnerx,malganis,576,shaman,restoration,12,6,6
Todayqt,malganis,576,shaman,restoration,12,6,6
Tigs,alleria,576,shaman,restoration,12,6,6
Kuhdos,caelestrasz,576,shaman,restoration,12,6,6
Gullirachad,stormrage,576,shaman,restoration,12,6,6
Ajj,thrall,576,shaman,restoration,12,6,6
Icehole,kelthuzad,576,shaman,restoration,12,6,6
Potf,illidan,576,shaman,restoration,12,6,6
Pikapiko,tichondrius,576,shaman,restoration,12,6,6
Oppaswag,tichondrius,576,shaman,restoration,12,6,6
Earthside,ragnaros,576,shaman,restoration,12,6,6
Spiritbb,area-52,576,shaman,restoration,12,6,6
Oscer,tichondrius,576,shaman,restoration,18,6,12
Kÿlé,darkspear,576,shaman,restoration,18,6,12
Rubmytiki,skywall,576,shaman,restoration,18,6,12
Greensween,thrall,576,shaman,restoration,19,6,13
Blck,malorne,576,shaman,restoration,23,7,16
Shampowl,jaedenar,576,shaman,restoration,20,6,14
Slowpo,illidan,576,shaman,restoration,24,6,18
Anußis,stormrage,576,shaman,restoration,24,6,18
Sizbo,thrall,575,shaman,restoration,6,6,0
Donojo,zuljin,575,shaman,restoration,12,6,6
Todem,stormrage,575,shaman,restoration,12,6,6
Xhod,zuljin,575,shaman,restoration,12,6,6
Powerpress,thunderlord,575,shaman,restoration,12,6,6
Cùìó,barthilas,575,shaman,restoration,12,6,6
Ondra,frostmourne,575,shaman,restoration,12,6,6
Sarevoc,sargeras,575,shaman,restoration,12,6,6
Thuggliife,frostmourne,575,shaman,restoration,12,6,6
Väsain,wyrmrest-accord,575,shaman,restoration,12,6,6
Tagliatelle,kelthuzad,575,shaman,restoration,15,7,8
Numbreseven,frostmourne,575,shaman,restoration,14,6,8
Ragnarüz,ragnaros,575,shaman,restoration,19,7,12
Girafasuarx,korgath,575,shaman,restoration,18,6,12
Jetstream,shadow-council,575,shaman,restoration,18,6,12
Spiritwler,tichondrius,575,shaman,restoration,18,6,12
Stormblast,stormrage,575,shaman,restoration,24,6,18
Luciuzz,tichondrius,574,shaman,restoration,12,6,6
Shyeahmon,drenden,574,shaman,restoration,12,6,6
Killerphreak,mannoroth,574,shaman,restoration,12,6,6
Dodirt,laughing-skull,574,shaman,restoration,12,6,6
Kunshíí,bleeding-hollow,574,shaman,restoration,15,6,9
Wugmuk,illidan,573,shaman,restoration,18,6,12
Bombsb,tichondrius,572,shaman,restoration,18,6,12
Racsors,ragnaros,571,shaman,restoration,12,6,6
Gimlyman,madoran,567,shaman,restoration,12,6,6
Trustfall,rexxar,566,shaman,restoration,12,6,6
Bloodmoôn,frostmourne,566,shaman,restoration,18,6,12
Reddleman,stormrage,544,shaman,restoration,22,6,16
Earthnsky,bleeding-hollow,543,shaman,restoration,11,6,5
Saviørkai,barthilas,543,shaman,restoration,14,7,7
Tsunamic,sargeras,528,shaman,restoration,15,6,9
Galaxiya,blackhand,525,shaman,restoration,21,7,14
Shamyshame,quelthalas,522,shaman,restoration,12,7,5
Yeetle,gorefiend,521,shaman,restoration,16,7,9
Señordoge,malganis,511,shaman,restoration,14,6,8
Rikswordfire,wyrmrest-accord,509,shaman,restoration,16,6,10
Tigrains,proudmoore,495,shaman,restoration,11,7,4
Nuggsfxce,frostmourne,480,shaman,restoration,6,5,1
Esterosa,tichondrius,480,shaman,restoration,6,5,1
Cheddatotz,illidan,480,shaman,restoration,6,5,1
Msool,tichondrius,480,shaman,restoration,6,5,1
Oopy,icecrown,480,shaman,restoration,6,5,1
Scamgame,tichondrius,480,shaman,restoration,6,5,1
Biguaga,tichondrius,480,shaman,restoration,6,5,1
Binishaman,tichondrius,480,shaman,restoration,6,5,1
Elamentz,bleeding-hollow,480,shaman,restoration,6,5,1
Cantshear,zuljin,480,shaman,restoration,6,5,1
Boogiefever,area-52,480,shaman,restoration,6,5,1
Lazie,perenolde,480,shaman,restoration,6,5,1
Spekgawd,emerald-dream,480,shaman,restoration,6,5,1
Çhïcagø,aegwynn,480,shaman,restoration,6,5,1
Fastaslight,bleeding-hollow,480,shaman,restoration,6,5,1
Mahevagodx,ragnaros,480,shaman,restoration,6,5,1
Oprawinfuryy,thrall,480,shaman,restoration,6,5,1
Hexgodx,illidan,480,shaman,restoration,6,5,1
Shamamsx,illidan,480,shaman,restoration,6,5,1
Blueclass,akama,480,shaman,restoration,6,5,1
Dankestmemes,illidan,480,shaman,restoration,6,5,1
Azrlol,illidan,480,shaman,restoration,12,5,7
Daintydan,illidan,480,shaman,restoration,12,5,7
Chiggys,area-52,480,shaman,restoration,12,5,7
Nøzurbo,area-52,480,shaman,restoration,12,5,7
Dyllbat,illidan,480,shaman,restoration,12,5,7
Teftx,area-52,480,shaman,restoration,12,5,7
Ponyi,frostmourne,480,shaman,restoration,12,5,7
Hitchsláp,tichondrius,480,shaman,restoration,12,5,7
Devipersham,frostmourne,480,shaman,restoration,12,5,7
Totemfizzle,spirestone,480,shaman,restoration,12,5,7
Drcopafeel,stormrage,480,shaman,restoration,12,5,7
Juked,aegwynn,480,shaman,restoration,12,5,7
Specify,arathor,480,shaman,restoration,12,5,7
Elmoss,thrall,480,shaman,restoration,12,5,7
Derbain,caelestrasz,480,shaman,restoration,12,5,7
Weebzealot,kelthuzad,480,shaman,restoration,12,5,7
Cherryboy,illidan,480,shaman,restoration,12,5,7
Trizzeh,moon-guard,480,shaman,restoration,12,5,7
Juicypork,moon-guard,480,shaman,restoration,12,5,7
Baltarian,emerald-dream,480,shaman,restoration,12,5,7
Shämpäin,moon-guard,480,shaman,restoration,12,5,7
Sixtyninelol,thunderlord,480,shaman,restoration,12,5,7
Tmkaldärýs,tichondrius,480,shaman,restoration,12,5,7
Oriyani,sargeras,480,shaman,restoration,12,5,7
Boryndor,stormrage,480,shaman,restoration,12,5,7
Pohtayto,darkspear,480,shaman,restoration,12,5,7
Thonty,sargeras,480,shaman,restoration,12,5,7
Fidelityfx,sargeras,480,shaman,restoration,12,5,7
Hijodelrayo,drakkari,480,shaman,restoration,12,5,7
Sâxman,stormreaver,480,shaman,restoration,12,5,7
Astotems,tichondrius,480,shaman,restoration,12,5,7
Plotwave,bleeding-hollow,480,shaman,restoration,12,5,7
Huulu,blades-edge,480,shaman,restoration,12,5,7
Nøir,drakkari,480,shaman,restoration,12,5,7
Doop,kiljaeden,480,shaman,restoration,12,5,7
Shäman,anetheron,480,shaman,restoration,12,5,7
Flaggedname,frostmane,480,shaman,restoration,12,5,7
Devastian,quelthalas,480,shaman,restoration,12,5,7
Nagish,alexstrasza,480,shaman,restoration,12,5,7
Strohz,undermine,480,shaman,restoration,12,5,7
Victusk,tichondrius,480,shaman,restoration,12,5,7
Tingletotem,tichondrius,480,shaman,restoration,12,5,7
Goresx,tichondrius,480,shaman,restoration,12,5,7
Bröxigâr,tichondrius,480,shaman,restoration,12,5,7
Dókki,tichondrius,480,shaman,restoration,12,5,7
Enzÿte,tichondrius,480,shaman,restoration,12,5,7
Synkronaqt,tichondrius,480,shaman,restoration,12,5,7
Kupnicki,zuljin,480,shaman,restoration,12,5,7
Zingysham,tichondrius,480,shaman,restoration,12,5,7
Krupto,tichondrius,480,shaman,restoration,12,5,7
Larvabust,azralon,480,shaman,restoration,12,5,7
Bignutters,bleeding-hollow,480,shaman,restoration,12,5,7
Vegaslights,tichondrius,480,shaman,restoration,12,5,7
Deyodin,illidan,480,shaman,restoration,12,5,7
Trickyjf,dalaran,480,shaman,restoration,12,5,7
Stumpyjoe,terokkar,480,shaman,restoration,13,5,8
Elecpod,frostmourne,480,shaman,restoration,14,5,9
Yoloswage,tichondrius,480,shaman,restoration,21,6,15
Krisu,kelthuzad,480,shaman,restoration,18,5,13
Animac,bleeding-hollow,480,shaman,restoration,18,5,13
Oilburner,malganis,480,shaman,restoration,18,5,13
Rekashaki,illidan,480,shaman,restoration,18,5,13
Greenberry,bonechewer,479,shaman,restoration,10,6,4
Gagonmatotem,skullcrusher,479,shaman,restoration,9,5,4
Fläkky,tichondrius,479,shaman,restoration,12,5,7
Tattoö,elune,479,shaman,restoration,12,5,7
Bobaflexqt,korgath,479,shaman,restoration,12,5,7
Aimsely,area-52,479,shaman,restoration,12,5,7
Blkpowerfist,malganis,479,shaman,restoration,12,5,7
Sâvage,zuljin,479,shaman,restoration,12,5,7
Sannyasin,azralon,479,shaman,restoration,12,5,7
Highmountain,tichondrius,479,shaman,restoration,12,5,7
Arastour,bronzebeard,479,shaman,restoration,12,5,7
Josiahsham,kelthuzad,479,shaman,restoration,12,5,7
Monspiett,azralon,479,shaman,restoration,12,5,7
Killonsight,tichondrius,479,shaman,restoration,12,5,7
Beardedone,durotan,479,shaman,restoration,12,5,7
Turksham,tichondrius,479,shaman,restoration,12,5,7
Dragonsauce,grizzly-hills,479,shaman,restoration,18,5,13
Smearedbeard,bleeding-hollow,479,shaman,restoration,18,5,13
Nytestalker,sargeras,479,shaman,restoration,18,5,13
Ahaw,area-52,479,shaman,restoration,18,5,13
Typo,skullcrusher,478,shaman,restoration,6,5,1
Vaginix,tichondrius,478,shaman,restoration,18,5,13
Stahlye,proudmoore,477,shaman,restoration,6,5,1
Allegrata,sargeras,477,shaman,restoration,12,5,7
Timprecu,azralon,477,shaman,restoration,12,5,7
Pileef,thrall,473,shaman,restoration,13,7,6
Uderlol,tichondrius,448,shaman,restoration,10,5,5
Danil,emerald-dream,447,shaman,restoration,11,5,6
Brocklee,farstriders,447,shaman,restoration,16,5,11
Akhae,duskwood,445,shaman,restoration,14,6,8
Sidnii,tichondrius,432,shaman,restoration,9,5,4
Lampstand,wildhammer,431,shaman,restoration,11,5,6
Zelzus,moon-guard,431,shaman,restoration,11,5,6
Swampy,tanaris,426,shaman,restoration,15,6,9
Littleshasha,tichondrius,426,shaman,restoration,15,6,9
Ggezlmao,bleeding-hollow,426,shaman,restoration,16,6,10
Zio,akama,425,shaman,restoration,14,6,8
Wragnus,tichondrius,425,shaman,restoration,15,6,9
Hannibol,tichondrius,416,shaman,restoration,10,5,5
Lebs,barthilas,415,shaman,restoration,8,5,3
Shockjoy,malganis,415,shaman,restoration,11,5,6
Chûnk,tichondrius,400,shaman,restoration,13,5,8
Clapton,darkspear,400,shaman,restoration,19,5,14
Príde,ragnaros,384,shaman,restoration,6,4,2
Resonence,bleeding-hollow,384,shaman,restoration,6,4,2
Gotmolk,illidan,384,shaman,restoration,6,4,2
Zanderpla,kelthuzad,384,shaman,restoration,6,4,2
Kìttý,malganis,384,shaman,restoration,6,4,2
Idowhatcdont,kelthuzad,384,shaman,restoration,6,4,2
Kaîowas,malganis,384,shaman,restoration,6,4,2
Bigboorst,kelthuzad,384,shaman,restoration,6,4,2
Ârtík,tichondrius,384,shaman,restoration,6,4,2
Excaliburumb,tichondrius,384,shaman,restoration,6,4,2
Tisaa,tichondrius,384,shaman,restoration,6,4,2
Nepshock,stormrage,384,shaman,restoration,6,4,2
Omegalmao,sargeras,384,shaman,restoration,6,4,2
Xiaoya,tichondrius,384,shaman,restoration,6,4,2
Xillicit,sargeras,384,shaman,restoration,6,4,2
Foray,barthilas,384,shaman,restoration,6,4,2
Smeeza,frostmourne,384,shaman,restoration,6,4,2
Bhann,tichondrius,384,shaman,restoration,6,4,2
Jimmymaclroy,frostmourne,384,shaman,restoration,6,4,2
Cháningtotem,frostmourne,384,shaman,restoration,6,4,2
Éarl,sargeras,384,shaman,restoration,6,4,2
Acdc,zuljin,384,shaman,restoration,6,4,2
Telnos,emerald-dream,384,shaman,restoration,6,4,2
Weathersmell,sargeras,384,shaman,restoration,6,4,2
Hordeoeuvre,zuljin,384,shaman,restoration,6,4,2
Curador,nemesis,384,shaman,restoration,6,4,2
Castia,sargeras,384,shaman,restoration,6,4,2
Shamankofwa,tichondrius,384,shaman,restoration,6,4,2
Sylicious,barthilas,384,shaman,restoration,6,4,2
Winry,korgath,384,shaman,restoration,6,4,2
Kustum,tichondrius,384,shaman,restoration,6,4,2
Intravz,tichondrius,384,shaman,restoration,6,4,2
Freakytiki,azshara,384,shaman,restoration,6,4,2
Aletcheoddox,sargeras,384,shaman,restoration,6,4,2
Aeølus,tichondrius,384,shaman,restoration,6,4,2
Shåmwiches,tichondrius,384,shaman,restoration,6,4,2
Joryu,tichondrius,384,shaman,restoration,6,4,2
Piaopiao,skywall,384,shaman,restoration,6,4,2
Gumballin,sargeras,384,shaman,restoration,8,4,4
Shâmbulance,hyjal,384,shaman,restoration,12,4,8
Smashyz,nerzhul,384,shaman,restoration,12,4,8
Sheeno,blackrock,384,shaman,restoration,12,4,8
Boyyo,maiev,384,shaman,restoration,12,4,8
Ngentotem,frostmourne,384,shaman,restoration,12,4,8
Cgq,tichondrius,384,shaman,restoration,12,4,8
Misakism,sargeras,384,shaman,restoration,12,4,8
Lollzerz,the-forgotten-coast,384,shaman,restoration,12,4,8
Bayslaps,tichondrius,384,shaman,restoration,12,4,8
Haymaker,bleeding-hollow,384,shaman,restoration,12,4,8
Toobeastly,deathwing,384,shaman,restoration,12,4,8
Stackinheals,thrall,384,shaman,restoration,12,4,8
Celements,malganis,384,shaman,restoration,12,4,8
Xändra,ragnaros,384,shaman,restoration,12,4,8
Kobecoopper,sargeras,384,shaman,restoration,12,4,8
Healswin,sargeras,384,shaman,restoration,12,4,8
Saksa,garrosh,384,shaman,restoration,12,4,8
Hateshifter,kul-tiras,384,shaman,restoration,12,4,8
Pümba,azralon,384,shaman,restoration,12,4,8
Ayev,illidan,384,shaman,restoration,12,4,8
Naturasol,quelthalas,384,shaman,restoration,12,4,8
Bäsedgód,tichondrius,384,shaman,restoration,12,4,8
Porkbrains,emerald-dream,384,shaman,restoration,16,5,11
Kermut,frostmourne,384,shaman,restoration,18,4,14
Conductivity,frostmourne,384,shaman,restoration,18,4,14
Dukaman,malganis,384,shaman,restoration,18,4,14
Bøx,ragnaros,383,shaman,restoration,6,4,2
Rockyisback,illidan,383,shaman,restoration,6,4,2
Hexnation,frostmourne,383,shaman,restoration,6,4,2
Ctrlaltelite,burning-blade,383,shaman,restoration,12,4,8
Foogus,tichondrius,383,shaman,restoration,12,4,8
Huugsnkissez,sargeras,383,shaman,restoration,12,4,8
Sndtome,stormrage,383,shaman,restoration,12,4,8
Madvillainny,thrall,383,shaman,restoration,12,4,8
Tandarin,burning-legion,383,shaman,restoration,12,4,8
Ânûbis,sargeras,383,shaman,restoration,12,4,8
Galarix,nerzhul,383,shaman,restoration,30,4,26
Turbö,hyjal,382,shaman,restoration,12,4,8
Shockshow,zuljin,382,shaman,restoration,12,4,8
Huukron,emerald-dream,382,shaman,restoration,12,4,8
Caulkshock,tichondrius,382,shaman,restoration,12,4,8
Laveidem,frostmourne,382,shaman,restoration,18,4,14
Uggbootz,amanthul,379,shaman,restoration,25,4,21
Alwinaa,kiljaeden,367,shaman,restoration,11,4,7
Pche,tichondrius,367,shaman,restoration,11,4,7
Shamanakin,emerald-dream,351,shaman,restoration,8,5,3
Tineer,tichondrius,336,shaman,restoration,9,4,5
Avidas,malganis,331,shaman,restoration,15,4,11
Vudu,terokkar,330,shaman,restoration,13,5,8
Purgedubx,tichondrius,330,shaman,restoration,15,5,10
Stitchez,illidan,330,shaman,restoration,21,5,16
Intress,moon-guard,329,shaman,restoration,10,6,4
Elevatezxo,stormrage,304,shaman,restoration,7,4,3
Totumstroker,thrall,288,shaman,restoration,6,3,3
Sumyl,ragnaros,288,shaman,restoration,6,3,3
Chocothicc,bleeding-hollow,288,shaman,restoration,6,3,3
Illmental,kelthuzad,288,shaman,restoration,6,3,3
Bigbadpercy,frostmourne,288,shaman,restoration,6,3,3
Skrubbles,bleeding-hollow,288,shaman,restoration,6,3,3
Akupapu,illidan,288,shaman,restoration,6,3,3
Cloudsh,silvermoon,288,shaman,restoration,6,3,3
Taproots,ursin,288,shaman,restoration,6,3,3
Solitarysham,moon-guard,288,shaman,restoration,6,3,3
Digglr,tichondrius,288,shaman,restoration,6,3,3
Phinoi,tichondrius,288,shaman,restoration,6,3,3
Asskrap,daggerspine,288,shaman,restoration,6,3,3
Maana,dragonmaw,288,shaman,restoration,6,3,3
Thetotemtaco,tichondrius,288,shaman,restoration,6,3,3
Snowkingx,illidan,288,shaman,restoration,6,3,3
Rsham,dragonmaw,288,shaman,restoration,6,3,3
Teladoy,kelthuzad,288,shaman,restoration,6,3,3
Juicedbydad,kelthuzad,288,shaman,restoration,6,3,3
Restoele,tichondrius,288,shaman,restoration,6,3,3
Youngie,dathremar,288,shaman,restoration,6,3,3
Ghiscar,tichondrius,288,shaman,restoration,6,3,3
Spencêrf,illidan,288,shaman,restoration,6,3,3
Zoltide,sargeras,288,shaman,restoration,6,3,3
Puntress,barthilas,288,shaman,restoration,6,3,3
Betterthanya,tichondrius,288,shaman,restoration,6,3,3
Sonsii,tichondrius,288,shaman,restoration,6,3,3
Clytiae,arthas,288,shaman,restoration,6,3,3
Kazino,stormrage,288,shaman,restoration,6,3,3
Wulfey,sargeras,288,shaman,restoration,6,3,3
Curtrex,amanthul,288,shaman,restoration,6,3,3
Kanntok,quelthalas,288,shaman,restoration,6,3,3
Dylie,tichondrius,288,shaman,restoration,6,3,3
Dimitrio,azralon,288,shaman,restoration,6,3,3
Kamehamekazi,blackhand,288,shaman,restoration,6,3,3
Smackzs,sargeras,288,shaman,restoration,6,3,3
Stormsanta,emerald-dream,288,shaman,restoration,6,3,3
Megadabs,malganis,288,shaman,restoration,6,3,3
Pressyocds,darkspear,288,shaman,restoration,6,3,3
Eleresto,tichondrius,288,shaman,restoration,6,3,3
Gunx,darkspear,288,shaman,restoration,6,3,3
Sreve,malganis,288,shaman,restoration,6,3,3
Herpeaz,kelthuzad,288,shaman,restoration,6,3,3
Fruityrudyy,area-52,288,shaman,restoration,6,3,3
Rakkasham,blackrock,288,shaman,restoration,6,3,3
Cloudycloud,tichondrius,288,shaman,restoration,6,3,3
Siox,zuljin,288,shaman,restoration,6,3,3
Voron,kiljaeden,288,shaman,restoration,6,3,3
Gucciblunts,sargeras,288,shaman,restoration,6,3,3
Uwuxdlol,tichondrius,288,shaman,restoration,6,3,3
Danyax,malganis,288,shaman,restoration,6,3,3
Drwaters,lightnings-blade,288,shaman,restoration,6,3,3
Samac,ravencrest,288,shaman,restoration,6,3,3
Rollînçoàl,malganis,288,shaman,restoration,6,3,3
Nyroh,zuljin,288,shaman,restoration,6,3,3
Forloren,zuljin,288,shaman,restoration,6,3,3
Mudtide,tichondrius,288,shaman,restoration,6,3,3
Shearx,illidan,288,shaman,restoration,6,3,3
Drathos,azralon,288,shaman,restoration,6,3,3
Totemtots,illidan,288,shaman,restoration,6,3,3
Ñoobshaman,tichondrius,288,shaman,restoration,6,3,3
Sumdumshaman,illidan,288,shaman,restoration,6,3,3
Wreckaholic,alterac-mountains,288,shaman,restoration,6,3,3
Catnïp,maelstrom,288,shaman,restoration,6,3,3
Goongoon,zuljin,288,shaman,restoration,6,3,3
Wastedlink,tichondrius,288,shaman,restoration,6,3,3
Yunqboichay,kelthuzad,288,shaman,restoration,6,3,3
Daggonet,sargeras,288,shaman,restoration,6,3,3
Laucian,malganis,288,shaman,restoration,6,3,3
Squidazzle,tichondrius,288,shaman,restoration,8,3,5
Ðrunkentotem,tichondrius,288,shaman,restoration,11,4,7
Rebelutioni,lothar,288,shaman,restoration,11,3,8
Calliope,burning-legion,288,shaman,restoration,12,3,9
Loanomi,zuljin,288,shaman,restoration,12,3,9
Mondaymood,illidan,288,shaman,restoration,12,3,9
Sooweecide,tichondrius,288,shaman,restoration,12,3,9
Equinsuochha,silvermoon,288,shaman,restoration,12,3,9
Trysts,wyrmrest-accord,288,shaman,restoration,12,3,9
Chocobomb,burning-blade,288,shaman,restoration,12,3,9
Zéwel,tichondrius,288,shaman,restoration,12,3,9
Paniczone,madoran,288,shaman,restoration,12,3,9
Strawberryz,sargeras,288,shaman,restoration,12,3,9
Watoos,area-52,288,shaman,restoration,12,3,9
Sliccricc,doomhammer,288,shaman,restoration,12,3,9
Mochomò,ragnaros,288,shaman,restoration,12,3,9
Shamonalisa,altar-of-storms,288,shaman,restoration,12,3,9
Possessing,illidan,288,shaman,restoration,12,3,9
Makogo,earthen-ring,288,shaman,restoration,12,3,9
Sheariously,sargeras,288,shaman,restoration,12,3,9
Meatyball,tichondrius,288,shaman,restoration,12,3,9
Showkinho,azralon,288,shaman,restoration,12,3,9
Oomme,area-52,288,shaman,restoration,12,3,9
Scion,thaurissan,288,shaman,restoration,12,3,9
Bovinefever,kiljaeden,288,shaman,restoration,12,3,9
Oprawindfuri,whisperwind,288,shaman,restoration,12,3,9
Cositax,tichondrius,287,shaman,restoration,6,3,3
Trovac,azralon,287,shaman,restoration,6,3,3
Altryn,shuhalo,287,shaman,restoration,6,3,3
Valien,kiljaeden,287,shaman,restoration,6,3,3
Nottoshammy,dalaran,287,shaman,restoration,12,3,9
Garurt,daggerspine,286,shaman,restoration,12,6,6
Kider,drakkari,286,shaman,restoration,6,3,3
Donkeydrill,elune,286,shaman,restoration,6,3,3
Ranek,shuhalo,286,shaman,restoration,6,3,3
Tarlonygg,malganis,281,shaman,restoration,15,6,9
Eloquent,emerald-dream,273,shaman,restoration,19,6,13
Hilung,lightnings-blade,255,shaman,restoration,11,3,8
Shamanship,haomarush,239,shaman,restoration,5,3,2
Lickerman,stormreaver,239,shaman,restoration,5,3,2
Tyrión,aggramar,234,shaman,restoration,15,5,10
Succies,emerald-dream,234,shaman,restoration,16,4,12
Bigripnow,sargeras,234,shaman,restoration,20,4,16
Tokelahoma,stormrage,234,shaman,restoration,22,4,18
Keldara,aerie-peak,192,shaman,restoration,6,2,4
Dallìa,tichondrius,192,shaman,restoration,6,2,4
Raxxom,tichondrius,192,shaman,restoration,6,2,4
Aishel,area-52,192,shaman,restoration,6,2,4
Jamarcuss,tichondrius,192,shaman,restoration,6,2,4
Juraf,malganis,192,shaman,restoration,6,2,4
Oprawîndfury,tichondrius,192,shaman,restoration,6,2,4
Xlash,zuljin,192,shaman,restoration,6,2,4
Hottesthands,barthilas,192,shaman,restoration,6,2,4
Esqueue,tichondrius,192,shaman,restoration,6,2,4
Sid,frostmourne,192,shaman,restoration,6,2,4
Pandl,frostmourne,192,shaman,restoration,6,2,4
Birdizdawerd,shuhalo,192,shaman,restoration,6,2,4
Plutoshaker,tichondrius,192,shaman,restoration,6,2,4
Karnnages,cenarion-circle,192,shaman,restoration,6,2,4
Bekrogh,azralon,192,shaman,restoration,6,2,4
Yngvii,tichondrius,192,shaman,restoration,6,2,4
Ara,zuljin,192,shaman,restoration,6,2,4
Mangeegee,malganis,192,shaman,restoration,6,2,4
Mjxholland,aegwynn,192,shaman,restoration,6,2,4
Snapertun,tichondrius,192,shaman,restoration,6,2,4
Notviscent,illidan,192,shaman,restoration,6,2,4
Killuminatti,nathrezim,192,shaman,restoration,6,2,4
Nbax,tichondrius,192,shaman,restoration,6,2,4
Halfzugzug,sargeras,192,shaman,restoration,6,2,4
Shinydiglett,area-52,192,shaman,restoration,6,2,4
Nxboy,proudmoore,192,shaman,restoration,6,2,4
Lakeshow,tichondrius,192,shaman,restoration,6,2,4
Magwølfe,area-52,192,shaman,restoration,6,2,4
Chainandrain,frostmourne,192,shaman,restoration,6,2,4
Cheesepufs,illidan,192,shaman,restoration,6,2,4
Lolcàt,tichondrius,192,shaman,restoration,6,2,4
Zhangyider,illidan,192,shaman,restoration,6,2,4
Rykkar,kiljaeden,192,shaman,restoration,6,2,4
Cpkzlol,tichondrius,192,shaman,restoration,6,2,4
Duality,shattered-halls,192,shaman,restoration,6,2,4
Dabrat,lightnings-blade,192,shaman,restoration,6,2,4
Jimmybutler,tichondrius,192,shaman,restoration,6,2,4
Zugzugpurge,thrall,192,shaman,restoration,6,2,4
Torrentzx,sargeras,192,shaman,restoration,6,2,4
Aderra,garrosh,192,shaman,restoration,6,2,4
Thefurrybox,tichondrius,192,shaman,restoration,6,2,4
Gbe,tichondrius,192,shaman,restoration,6,2,4
Relâx,icecrown,192,shaman,restoration,6,2,4
Twistër,illidan,192,shaman,restoration,6,2,4
Hughwang,kelthuzad,192,shaman,restoration,6,2,4
Linkandwink,nerzhul,192,shaman,restoration,6,2,4
Ezeya,area-52,192,shaman,restoration,6,2,4
Konga,korialstrasz,192,shaman,restoration,6,2,4
Ioki,spirestone,192,shaman,restoration,6,2,4
Eternaltotem,darkspear,192,shaman,restoration,6,2,4
Lequandarius,sargeras,192,shaman,restoration,6,2,4
Gwenstifani,sargeras,192,shaman,restoration,6,2,4
Chungxs,illidan,192,shaman,restoration,6,2,4
Cawlin,stormrage,192,shaman,restoration,6,2,4
Firesurge,sargeras,192,shaman,restoration,6,2,4
Umadilia,area-52,192,shaman,restoration,6,2,4
Thundertusks,norgannon,192,shaman,restoration,6,2,4
Dhalishama,thrall,192,shaman,restoration,6,2,4
Zâppý,stormrage,192,shaman,restoration,6,2,4
Timbosteve,thrall,192,shaman,restoration,6,2,4
Mauiiei,sargeras,192,shaman,restoration,6,2,4
Shozen,bonechewer,192,shaman,restoration,6,2,4
Shamansz,stormrage,192,shaman,restoration,6,2,4
Purpose,nerzhul,192,shaman,restoration,6,2,4
Suspend,gorgonnash,192,shaman,restoration,9,2,7
Kitanoo,kiljaeden,192,shaman,restoration,12,2,10
Aoiiro,dentarg,192,shaman,restoration,12,2,10
Wasiri,illidan,192,shaman,restoration,12,2,10
Rhaksh,sargeras,192,shaman,restoration,12,2,10
Rueem,area-52,192,shaman,restoration,12,2,10
Actios,stormrage,192,shaman,restoration,12,2,10
Bizzy,black-dragonflight,192,shaman,restoration,12,2,10
Awool,lightbringer,192,shaman,restoration,12,2,10
Lomínark,stormrage,192,shaman,restoration,12,2,10
Soomer,frostmourne,192,shaman,restoration,12,2,10
Monchsham,area-52,192,shaman,restoration,13,2,11
Shockbot,stormscale,192,shaman,restoration,18,2,16
Bootsix,area-52,192,shaman,restoration,18,2,16
Kicksave,illidan,192,shaman,restoration,18,2,16
Doctermoo,daggerspine,192,shaman,restoration,28,3,25
Roogys,emerald-dream,192,shaman,restoration,22,2,20
Malsturm,stormrage,191,shaman,restoration,6,2,4
Fóurelements,malganis,191,shaman,restoration,6,2,4
Donix,destromath,191,shaman,restoration,6,2,4
Healcacatoi,zuljin,191,shaman,restoration,6,2,4
Vazan,arthas,191,shaman,restoration,6,2,4
Machalo,sargeras,191,shaman,restoration,6,2,4
Jammylol,frostmourne,180,shaman,restoration,21,6,15
Ambevsulfr,tichondrius,175,shaman,restoration,11,2,9
Nolij,sargeras,159,shaman,restoration,5,2,3
Restomilk,tichondrius,159,shaman,restoration,5,2,3
Llgll,tichondrius,159,shaman,restoration,5,2,3
Drowsbad,tichondrius,138,shaman,restoration,10,4,6
Uggerz,barthilas,138,shaman,restoration,9,3,6
Bigdaddyion,thrall,138,shaman,restoration,9,3,6
Ganvitchenko,illidan,138,shaman,restoration,13,4,9
Thelôpen,tichondrius,138,shaman,restoration,17,4,13
Bigbøss,stormrage,138,shaman,restoration,20,3,17
Aricer,proudmoore,112,shaman,restoration,13,2,11
Hueymagoo,firetree,112,shaman,restoration,13,2,11
Jbahr,hyjal,96,shaman,restoration,3,2,1
Shamtoots,aerie-peak,96,shaman,restoration,9,2,7
Cyberheler,quelthalas,96,shaman,restoration,6,1,5
Finnaburstt,tichondrius,96,shaman,restoration,6,1,5
Twizzhurp,bleeding-hollow,96,shaman,restoration,6,1,5
Restorates,tichondrius,96,shaman,restoration,6,1,5
Kwaztotem,area-52,96,shaman,restoration,6,1,5
Galiffa,area-52,96,shaman,restoration,6,1,5
Shamoover,kelthuzad,96,shaman,restoration,6,1,5
Meshugga,scarlet-crusade,96,shaman,restoration,6,1,5
Muruaic,dentarg,96,shaman,restoration,6,1,5
Tchamí,blackrock,96,shaman,restoration,6,1,5
Daku,tichondrius,96,shaman,restoration,6,1,5
Eleshamanz,tichondrius,96,shaman,restoration,6,1,5
Meattoilet,tichondrius,96,shaman,restoration,6,1,5
Mufflër,the-venture-co,96,shaman,restoration,6,1,5
Dodey,malganis,96,shaman,restoration,6,1,5
Hadèes,zuljin,96,shaman,restoration,6,1,5
Movemaker,shattered-hand,96,shaman,restoration,6,1,5
Sshhammann,tichondrius,96,shaman,restoration,6,1,5
Zorg,area-52,96,shaman,restoration,6,1,5
Camdoc,destromath,96,shaman,restoration,6,1,5
Billydreams,drakkari,96,shaman,restoration,6,1,5
Liltex,malganis,96,shaman,restoration,6,1,5
Meramin,illidan,96,shaman,restoration,6,1,5
Babehmakr,lightnings-blade,96,shaman,restoration,6,1,5
Asanako,illidan,96,shaman,restoration,6,1,5
Daiablo,barthilas,96,shaman,restoration,6,1,5
Knockedup,tichondrius,96,shaman,restoration,6,1,5
Statikrage,eonar,96,shaman,restoration,6,1,5
Nøtørious,thrall,96,shaman,restoration,6,1,5
Célty,moon-guard,96,shaman,restoration,6,1,5
Stickshaman,sargeras,96,shaman,restoration,6,1,5
Totempixie,barthilas,96,shaman,restoration,6,1,5
Cluffatty,tichondrius,96,shaman,restoration,6,1,5
Ogeez,area-52,96,shaman,restoration,6,1,5
Drmundo,icecrown,96,shaman,restoration,6,1,5
Ashamanist,barthilas,96,shaman,restoration,6,1,5
Sleepysham,anubarak,96,shaman,restoration,6,1,5
Slacken,kiljaeden,96,shaman,restoration,6,1,5
Thenewsherek,maelstrom,96,shaman,restoration,6,1,5
Average,bonechewer,96,shaman,restoration,6,1,5
Restoz,thrall,96,shaman,restoration,6,1,5
Iightning,frostwolf,96,shaman,restoration,6,1,5
Wannabecdeww,kelthuzad,96,shaman,restoration,6,1,5
Swartzqt,tichondrius,96,shaman,restoration,6,1,5
Churdoodle,area-52,96,shaman,restoration,6,1,5
Toyletpaper,mugthol,96,shaman,restoration,6,1,5
Schmutz,emerald-dream,96,shaman,restoration,6,1,5
Cavolt,stormrage,96,shaman,restoration,6,1,5
Dasckisham,area-52,96,shaman,restoration,6,1,5
Yaola,kiljaeden,96,shaman,restoration,6,1,5
Teathin,ragnaros,96,shaman,restoration,6,1,5
Shapaman,tichondrius,96,shaman,restoration,6,1,5
Eyris,dathremar,96,shaman,restoration,6,1,5
Erii,undermine,96,shaman,restoration,6,1,5
Swinginwilly,barthilas,96,shaman,restoration,6,1,5
Calicø,durotan,96,shaman,restoration,7,1,6
Finark,tichondrius,96,shaman,restoration,7,1,6
Akharis,frostmane,96,shaman,restoration,15,2,13
Tinytiddies,chogall,96,shaman,restoration,12,1,11
Njolmir,khazgoroth,96,shaman,restoration,12,1,11
Meatlog,dalaran,96,shaman,restoration,12,1,11
Hexpert,firetree,96,shaman,restoration,12,1,11
Tehbeast,khadgar,96,shaman,restoration,12,1,11
Latishas,alleria,96,shaman,restoration,18,1,17
Okdopey,area-52,95,shaman,restoration,6,1,5
Lupog,illidan,89,shaman,restoration,8,4,4
Dirtyshammy,mugthol,79,shaman,restoration,11,1,10
Totèm,tichondrius,64,shaman,restoration,4,1,3
Annöying,ysera,42,shaman,restoration,6,2,4
Applicable,tichondrius,42,shaman,restoration,9,2,7
Shamining,illidan,31,shaman,restoration,2,1,1
Snowtem,moonrunner,31,shaman,restoration,2,1,1
Ttvozzyxy,tichondrius,2385,shaman,elemental,139,89,50
Cashe,kiljaeden,2368,shaman,elemental,126,80,46
Bronzer,tichondrius,2325,shaman,elemental,75,53,22
Meatbeaterx,aggramar,2189,shaman,elemental,135,70,65
Luhz,tichondrius,2187,shaman,elemental,113,60,53
Thegloc,illidan,2168,shaman,elemental,59,36,23
Crøwgød,tichondrius,2156,shaman,elemental,109,65,44
Ranjeesh,frostmourne,2155,shaman,elemental,144,82,62
Bøøgaa,proudmoore,2155,shaman,elemental,125,67,58
Itzgucci,illidan,2143,shaman,elemental,80,46,34
Jimmysporty,malganis,2135,shaman,elemental,84,43,41
Jgmbs,dalaran,2134,shaman,elemental,106,64,42
Axelsteel,illidan,2132,shaman,elemental,66,45,21
Hitzz,malganis,2127,shaman,elemental,78,49,29
Lardaz,darkspear,2118,shaman,elemental,60,37,23
Benanderson,tichondrius,2111,shaman,elemental,110,61,49
Bøulderfist,tichondrius,2108,shaman,elemental,60,37,23
Shiggenbasta,tichondrius,2107,shaman,elemental,119,63,56
Hexecute,tichondrius,2106,shaman,elemental,84,42,42
Hollowbaby,tichondrius,2101,shaman,elemental,73,48,25
Jeasham,malganis,2056,shaman,elemental,125,64,61
Iavalash,bleeding-hollow,2044,shaman,elemental,178,89,89
Bujii,frostmourne,2033,shaman,elemental,131,69,62
Billycool,tichondrius,2032,shaman,elemental,60,38,22
Tisaa,tichondrius,2025,shaman,elemental,66,32,34
Dxxlol,tichondrius,2008,shaman,elemental,54,37,17
Zipzsham,maiev,1989,shaman,elemental,63,48,15
Trenzix,sargeras,1989,shaman,elemental,196,100,96
Reckfulq,proudmoore,1986,shaman,elemental,137,84,53
Yejinok,tichondrius,1969,shaman,elemental,102,53,49
Emppege,tichondrius,1967,shaman,elemental,121,60,61
Beyoncé,lethon,1966,shaman,elemental,54,32,22
Kaandel,azralon,1961,shaman,elemental,138,66,72
Chunchünmaru,area-52,1957,shaman,elemental,71,40,31
Depression,baelgun,1948,shaman,elemental,78,49,29
Bakenquake,tichondrius,1947,shaman,elemental,92,48,44
Manofsand,drenden,1940,shaman,elemental,167,85,82
Funuser,hellscream,1937,shaman,elemental,86,53,33
Joedna,tichondrius,1933,shaman,elemental,94,48,46
Kimkar,bleeding-hollow,1926,shaman,elemental,54,28,26
Johnsju,sargeras,1926,shaman,elemental,93,48,45
Foudre,malganis,1925,shaman,elemental,42,27,15
Safeword,nesingwary,1919,shaman,elemental,74,42,32
Sleepysham,kelthuzad,1910,shaman,elemental,108,59,49
Geodude,executus,1909,shaman,elemental,53,33,20
Zoeytur,sargeras,1905,shaman,elemental,60,31,29
Scaman,tichondrius,1903,shaman,elemental,36,23,13
Makazar,tichondrius,1901,shaman,elemental,42,26,16
Ultron,deathwing,1890,shaman,elemental,143,74,69
Molbeato,uldum,1888,shaman,elemental,102,51,51
Hedeadxs,illidan,1882,shaman,elemental,60,30,30
Bronzers,tichondrius,1879,shaman,elemental,42,25,17
Matikz,boulderfist,1878,shaman,elemental,142,78,64
Powerdown,blackrock,1878,shaman,elemental,65,32,33
Tremordrfear,lightbringer,1877,shaman,elemental,30,20,10
Orksham,tichondrius,1877,shaman,elemental,60,30,30
Tyar,area-52,1876,shaman,elemental,45,31,14
Blmqt,stormrage,1875,shaman,elemental,65,44,21
Juicébox,tichondrius,1874,shaman,elemental,62,35,27
Sasageyo,tichondrius,1873,shaman,elemental,93,51,42
Cùìó,barthilas,1868,shaman,elemental,54,25,29
Hexxás,bloodscalp,1865,shaman,elemental,45,27,18
Fàlç,stormrage,1863,shaman,elemental,54,32,22
Shockay,tichondrius,1861,shaman,elemental,56,30,26
Gangmembr,illidan,1857,shaman,elemental,42,25,17
Mazadu,malganis,1849,shaman,elemental,35,20,15
Snookìe,sargeras,1846,shaman,elemental,82,38,44
Hecstacy,dalaran,1842,shaman,elemental,66,42,24
Shøckys,tichondrius,1839,shaman,elemental,54,22,32
Illchayqt,frostmourne,1838,shaman,elemental,47,26,21
Utilitytotem,moon-guard,1838,shaman,elemental,154,83,71
Chemjenn,korgath,1838,shaman,elemental,84,37,47
Saphlare,tichondrius,1836,shaman,elemental,36,22,14
Zapmavz,area-52,1833,shaman,elemental,77,42,35
Starmaker,malganis,1833,shaman,elemental,44,23,21
Gaymakaí,sargeras,1828,shaman,elemental,48,27,21
Zzarit,tichondrius,1825,shaman,elemental,48,24,24
Donkeyteeth,bleeding-hollow,1822,shaman,elemental,72,43,29
Magtark,frostwolf,1820,shaman,elemental,61,38,23
Hotdogwaterx,tichondrius,1817,shaman,elemental,62,42,20
Wangyinanmin,tichondrius,1812,shaman,elemental,30,19,11
Mercs,frostmourne,1812,shaman,elemental,56,32,24
Whameradetu,suramar,1809,shaman,elemental,80,38,42
Elefusion,sargeras,1806,shaman,elemental,36,22,14
Swigadee,tichondrius,1806,shaman,elemental,72,33,39
Missedkick,tichondrius,1805,shaman,elemental,54,34,20
Bismarks,frostmourne,1805,shaman,elemental,66,38,28
Drazziqt,malganis,1803,shaman,elemental,45,27,18
Nonomori,frostmourne,1802,shaman,elemental,48,30,18
Torchic,drakkari,1801,shaman,elemental,60,31,29
Monkeysham,dathremar,1800,shaman,elemental,48,30,18
Elementàlius,quelthalas,1800,shaman,elemental,80,46,34
Mackq,tichondrius,1800,shaman,elemental,103,54,49
Scherzer,frostwolf,1800,shaman,elemental,90,42,48
Skkarz,malganis,1790,shaman,elemental,89,51,38
Meatyball,tichondrius,1786,shaman,elemental,59,38,21
Vkzz,sargeras,1784,shaman,elemental,49,23,26
Ralae,zuljin,1782,shaman,elemental,29,19,10
Ñîmåbè,tichondrius,1780,shaman,elemental,30,19,11
Ãmg,tichondrius,1779,shaman,elemental,36,24,12
Molerat,illidan,1774,shaman,elemental,152,69,83
Zqsyyds,illidan,1770,shaman,elemental,35,19,16
Meatbeaterx,bleeding-hollow,1768,shaman,elemental,42,23,19
Møp,spirestone,1766,shaman,elemental,66,39,27
Hadèes,zuljin,1750,shaman,elemental,186,100,86
Dampenedxx,bleeding-hollow,1749,shaman,elemental,121,66,55
Brezel,azralon,1740,shaman,elemental,42,27,15
Cepheí,bleeding-hollow,1740,shaman,elemental,59,30,29
Hexistential,tichondrius,1731,shaman,elemental,34,26,8
Uglymuger,tichondrius,1730,shaman,elemental,62,30,32
Taranís,sargeras,1730,shaman,elemental,54,25,29
Handzum,blades-edge,1728,shaman,elemental,54,28,26
Sshaman,tichondrius,1728,shaman,elemental,58,26,32
Däbü,tichondrius,1724,shaman,elemental,30,18,12
Baddaboom,sargeras,1724,shaman,elemental,79,42,37
Swiatek,ragnaros,1723,shaman,elemental,49,28,21
Deckìn,proudmoore,1721,shaman,elemental,136,75,61
Apyôn,tichondrius,1719,shaman,elemental,42,24,18
Liquidmagma,deathwing,1711,shaman,elemental,100,50,50
Ayumihamasai,tichondrius,1710,shaman,elemental,60,33,27
Flüke,tichondrius,1704,shaman,elemental,54,31,23
Notahappyone,area-52,1703,shaman,elemental,48,34,14
Osev,stormrage,1703,shaman,elemental,36,21,15
Carondes,proudmoore,1703,shaman,elemental,57,29,28
Kustys,tichondrius,1699,shaman,elemental,30,18,12
Mytotemisbig,lothar,1694,shaman,elemental,59,38,21
Notbpage,burning-blade,1694,shaman,elemental,102,51,51
Soyboyxxo,barthilas,1691,shaman,elemental,83,40,43
Shockyshock,emerald-dream,1683,shaman,elemental,46,29,17
Caserguy,sargeras,1683,shaman,elemental,58,24,34
Enkix,drakkari,1681,shaman,elemental,42,23,19
Cyhren,illidan,1679,shaman,elemental,54,33,21
Gorjun,stormrage,1679,shaman,elemental,81,38,43
Zugzugdogg,destromath,1674,shaman,elemental,42,23,19
Zeroclue,area-52,1673,shaman,elemental,40,22,18
Buffele,tichondrius,1672,shaman,elemental,42,18,24
Jerkdaddy,aggramar,1668,shaman,elemental,30,19,11
Buju,bleeding-hollow,1662,shaman,elemental,152,84,68
Loxshox,gnomeregan,1661,shaman,elemental,228,118,110
Sweatshock,frostmourne,1659,shaman,elemental,164,93,71
Ptee,tichondrius,1659,shaman,elemental,39,22,17
Illmental,kelthuzad,1658,shaman,elemental,85,44,41
Kawj,eonar,1652,shaman,elemental,36,21,15
Dyxlol,tichondrius,1652,shaman,elemental,56,25,31
Thaelia,azgalor,1650,shaman,elemental,40,23,17
Walabi,tichondrius,1649,shaman,elemental,50,22,28
Gravygumdrop,tichondrius,1648,shaman,elemental,80,39,41
Zeylhe,proudmoore,1647,shaman,elemental,54,26,28
Hexzy,moon-guard,1645,shaman,elemental,47,23,24
Smoketide,stormrage,1644,shaman,elemental,47,21,26
Shockisha,sisters-of-elune,1644,shaman,elemental,52,23,29
Shlmmyjimmy,tichondrius,1642,shaman,elemental,78,27,51
Streetmeat,crushridge,1640,shaman,elemental,125,64,61
Hüsky,dalaran,1637,shaman,elemental,41,21,20
Triknolov,dalaran,1636,shaman,elemental,47,22,25
Setò,quelthalas,1634,shaman,elemental,54,30,24
Billydreams,drakkari,1634,shaman,elemental,123,59,64
Illbuyurmom,tichondrius,1634,shaman,elemental,49,23,26
Imnumberl,sargeras,1630,shaman,elemental,78,51,27
Stormsage,jubeithos,1627,shaman,elemental,54,31,23
Tenyks,tichondrius,1627,shaman,elemental,40,22,18
Fiftybeers,frostmourne,1627,shaman,elemental,35,19,16
Lff,stormrage,1626,shaman,elemental,24,17,7
Shaymîn,malganis,1624,shaman,elemental,38,21,17
Chandye,proudmoore,1620,shaman,elemental,48,22,26
Fruityrudyy,area-52,1618,shaman,elemental,30,22,8
Eimear,kelthuzad,1618,shaman,elemental,33,20,13
Thunderfaker,tichondrius,1618,shaman,elemental,36,17,19
Mulak,frostmourne,1616,shaman,elemental,110,54,56
Duality,shattered-halls,1615,shaman,elemental,59,38,21
Ryukims,tichondrius,1615,shaman,elemental,46,24,22
Chajaa,ragnaros,1615,shaman,elemental,171,86,85
Gangstà,stormrage,1611,shaman,elemental,66,30,36
Nayro,bleeding-hollow,1610,shaman,elemental,30,20,10
Orkuss,illidan,1609,shaman,elemental,29,19,10
Thündermoose,tichondrius,1608,shaman,elemental,42,21,21
Roxxiggom,aggramar,1605,shaman,elemental,24,19,5
Taxd,sargeras,1605,shaman,elemental,40,21,19
Sonire,tichondrius,1605,shaman,elemental,204,97,107
Soo,kiljaeden,1605,shaman,elemental,84,39,45
Jaimenohex,illidan,1603,shaman,elemental,36,19,17
Nutty,dentarg,1602,shaman,elemental,42,24,18
Tulol,tichondrius,1602,shaman,elemental,114,54,60
Ssjgreen,illidan,1601,shaman,elemental,66,33,33
Opaltsing,tichondrius,1601,shaman,elemental,39,19,20
Daddykooll,tichondrius,1600,shaman,elemental,36,22,14
Datbigthing,frostmourne,1596,shaman,elemental,60,24,36
Igotu,tichondrius,1595,shaman,elemental,30,17,13
Letronix,azralon,1595,shaman,elemental,65,29,36
Honeybean,tichondrius,1591,shaman,elemental,96,50,46
Squealer,sargeras,1587,shaman,elemental,86,42,44
Zelthakaru,emerald-dream,1587,shaman,elemental,42,18,24
Moodizzle,tichondrius,1585,shaman,elemental,66,36,30
Imense,sargeras,1584,shaman,elemental,42,24,18
Cornivore,malganis,1582,shaman,elemental,36,19,17
Generators,area-52,1582,shaman,elemental,201,101,100
Zap,wyrmrest-accord,1576,shaman,elemental,78,39,39
ßævis,magtheridon,1572,shaman,elemental,24,17,7
Óompaloompa,frostmourne,1570,shaman,elemental,42,25,17
Topax,vashj,1568,shaman,elemental,35,21,14
Indika,stormrage,1560,shaman,elemental,30,18,12
Climhazard,senjin,1555,shaman,elemental,36,18,18
Stitchis,black-dragonflight,1554,shaman,elemental,69,41,28
Shellshocka,korgath,1554,shaman,elemental,38,20,18
Dtab,tichondrius,1552,shaman,elemental,36,18,18
Doodleburger,dathremar,1545,shaman,elemental,50,41,9
Talonga,moon-guard,1544,shaman,elemental,48,21,27
Drogues,tichondrius,1543,shaman,elemental,47,26,21
Univearth,emerald-dream,1542,shaman,elemental,66,34,32
Makocc,tichondrius,1541,shaman,elemental,73,39,34
Borheals,tichondrius,1537,shaman,elemental,44,21,23
Uglymugshock,tichondrius,1537,shaman,elemental,66,31,35
Pikopiko,tichondrius,1535,shaman,elemental,24,16,8
Ratson,ragnaros,1535,shaman,elemental,36,19,17
Robot,illidan,1534,shaman,elemental,30,16,14
Simada,tichondrius,1532,shaman,elemental,30,16,14
Harrypotqueu,zuljin,1527,shaman,elemental,30,16,14
Thundermatt,aegwynn,1525,shaman,elemental,81,39,42
Heavyboxer,tichondrius,1524,shaman,elemental,78,37,41
Caninius,sargeras,1521,shaman,elemental,30,16,14
Draghul,frostwolf,1520,shaman,elemental,43,24,19
Yasmiel,zuljin,1517,shaman,elemental,60,27,33
Clapton,darkspear,1515,shaman,elemental,47,21,26
Rss,barthilas,1507,shaman,elemental,47,25,22
Kakaaroto,nemesis,1506,shaman,elemental,45,28,17
Evilraven,tichondrius,1506,shaman,elemental,173,86,87
Faygodream,illidan,1499,shaman,elemental,84,46,38
Malosa,hyjal,1495,shaman,elemental,53,22,31
Tunegrote,ragnaros,1492,shaman,elemental,60,31,29
Keldinraz,stormrage,1492,shaman,elemental,48,22,26
Cowish,illidan,1487,shaman,elemental,42,23,19
Soulrak,tichondrius,1486,shaman,elemental,94,44,50
Groundme,malganis,1484,shaman,elemental,29,16,13
Huskër,tichondrius,1483,shaman,elemental,64,38,26
Innvious,sargeras,1483,shaman,elemental,60,28,32
Gloi,ragnaros,1481,shaman,elemental,31,19,12
Tuntar,ragnaros,1479,shaman,elemental,132,69,63
Defrout,kelthuzad,1469,shaman,elemental,68,32,36
Gahaa,tichondrius,1464,shaman,elemental,23,16,7
Joehogan,stormrage,1463,shaman,elemental,67,40,27
Washedupty,illidan,1460,shaman,elemental,118,56,62
Cavolt,stormrage,1459,shaman,elemental,41,21,20
Drazzella,arthas,1445,shaman,elemental,41,19,22
Lovesthegear,blackrock,1438,shaman,elemental,24,15,9
Kumer,tichondrius,1436,shaman,elemental,34,19,15
Biberom,kelthuzad,1434,shaman,elemental,57,32,25
Nøir,drakkari,1432,shaman,elemental,48,20,28
Pipesable,ragnaros,1430,shaman,elemental,24,15,9
Smiteums,sargeras,1429,shaman,elemental,30,15,15
Waterground,tichondrius,1428,shaman,elemental,31,16,15
Saraguthix,dalaran,1427,shaman,elemental,60,27,33
Earthclap,tichondrius,1427,shaman,elemental,39,16,23
Zugzugthug,moon-guard,1426,shaman,elemental,107,58,49
Cgq,tichondrius,1425,shaman,elemental,54,28,26
Hazzathxy,tichondrius,1420,shaman,elemental,29,15,14
Bramah,bonechewer,1420,shaman,elemental,36,16,20
Snapstr,illidan,1419,shaman,elemental,36,15,21
Hufflefluffs,kiljaeden,1418,shaman,elemental,38,23,15
Scryerman,area-52,1418,shaman,elemental,30,16,14
Blacklm,tichondrius,1413,shaman,elemental,24,15,9
Plotious,antonidas,1413,shaman,elemental,36,19,17
Dumpweed,stormscale,1413,shaman,elemental,42,21,21
Gumballin,sargeras,1412,shaman,elemental,85,41,44
Morluné,tichondrius,1407,shaman,elemental,54,26,28
Baodan,azshara,1406,shaman,elemental,41,20,21
Zappynips,frostmourne,1399,shaman,elemental,39,20,19
Liloggie,illidan,1385,shaman,elemental,23,15,8
Redlava,turalyon,1384,shaman,elemental,31,19,12
Golozok,zuljin,1382,shaman,elemental,35,16,19
Ceedlamb,kelthuzad,1381,shaman,elemental,66,34,32
Shuñk,frostmourne,1376,shaman,elemental,60,27,33
Chonkymilk,illidan,1373,shaman,elemental,44,18,26
Luvstospooj,thaurissan,1372,shaman,elemental,73,34,39
Zechary,proudmoore,1372,shaman,elemental,48,19,29
Venekk,shattered-hand,1366,shaman,elemental,29,17,12
Rythia,elune,1363,shaman,elemental,40,18,22
Telain,quelthalas,1360,shaman,elemental,84,42,42
Bycrax,ragnaros,1358,shaman,elemental,28,15,13
Isekai,alterac-mountains,1357,shaman,elemental,171,82,89
Boomsele,tichondrius,1356,shaman,elemental,19,15,4
Pepîllo,ragnaros,1356,shaman,elemental,66,20,46
Conductivity,frostmourne,1351,shaman,elemental,30,15,15
Stormsanta,emerald-dream,1349,shaman,elemental,35,15,20
Rinnobunen,wyrmrest-accord,1347,shaman,elemental,30,15,15
Snewboii,malganis,1346,shaman,elemental,30,15,15
Planetwaves,malganis,1344,shaman,elemental,18,14,4
Spoonforkorc,thrall,1342,shaman,elemental,24,14,10
Bagele,tichondrius,1342,shaman,elemental,30,14,16
Hurky,sargeras,1340,shaman,elemental,85,43,42
Oontuk,illidan,1337,shaman,elemental,66,31,35
Laelyk,kiljaeden,1336,shaman,elemental,30,14,16
Cocainbear,emerald-dream,1332,shaman,elemental,39,20,19
Hengler,emerald-dream,1330,shaman,elemental,30,14,16
Rolltìde,tichondrius,1328,shaman,elemental,129,72,57
Totem,burning-legion,1327,shaman,elemental,24,14,10
Mittss,sargeras,1324,shaman,elemental,88,45,43
Sheriffbj,emerald-dream,1324,shaman,elemental,36,14,22
Ekstasiel,azralon,1323,shaman,elemental,54,28,26
Ragnards,ragnaros,1323,shaman,elemental,79,35,44
Electriik,kiljaeden,1322,shaman,elemental,24,14,10
Pipelord,destromath,1321,shaman,elemental,24,14,10
Pacapinchhit,azgalor,1320,shaman,elemental,24,14,10
Lenin,nathrezim,1316,shaman,elemental,62,24,38
Endorovich,mannoroth,1309,shaman,elemental,30,14,16
Vktr,drakkari,1306,shaman,elemental,40,17,23
Tulnak,kelthuzad,1304,shaman,elemental,66,27,39
Hueymagoo,firetree,1295,shaman,elemental,24,14,10
Totempoke,frostmourne,1292,shaman,elemental,23,14,9
Wfb,sargeras,1291,shaman,elemental,24,14,10
Totemtown,darkspear,1286,shaman,elemental,60,28,32
Afw,darkspear,1282,shaman,elemental,41,17,24
Ffaísca,azralon,1279,shaman,elemental,38,19,19
Shamanzinh,azralon,1262,shaman,elemental,36,19,17
Sugirukifuja,stormrage,1258,shaman,elemental,23,16,7
Baltharzhard,saurfang,1257,shaman,elemental,36,16,20
Malrom,kelthuzad,1255,shaman,elemental,321,162,159
Jaapo,barthilas,1255,shaman,elemental,86,42,44
Everyst,darkspear,1253,shaman,elemental,35,20,15
Moacmathi,quelthalas,1253,shaman,elemental,60,27,33
Siò,barthilas,1247,shaman,elemental,15,14,1
Glochaswon,illidan,1247,shaman,elemental,18,13,5
Gambezee,kelthuzad,1247,shaman,elemental,30,13,17
Jazuul,zuljin,1247,shaman,elemental,30,13,17
Oldcregg,emerald-dream,1246,shaman,elemental,18,13,5
Lugak,ragnaros,1245,shaman,elemental,41,15,26
Clarix,quelthalas,1241,shaman,elemental,24,13,11
Lezzer,ragnaros,1238,shaman,elemental,66,29,37
Kkangsiki,tichondrius,1233,shaman,elemental,30,13,17
Edenorion,ragnaros,1232,shaman,elemental,48,23,25
Shampainn,demon-soul,1231,shaman,elemental,66,33,33
Ectomee,tichondrius,1230,shaman,elemental,24,13,11
Porkfririe,kelthuzad,1224,shaman,elemental,34,14,20
Yasuriyamile,illidan,1222,shaman,elemental,82,36,46
Chaposz,tichondrius,1221,shaman,elemental,30,13,17
Nírnez,ragnaros,1220,shaman,elemental,42,14,28
Engara,frostmane,1216,shaman,elemental,29,13,16
Øten,area-52,1214,shaman,elemental,30,20,10
Saulgudmon,area-52,1214,shaman,elemental,30,16,14
Beerofdoom,proudmoore,1214,shaman,elemental,30,15,15
Vulkuro,quelthalas,1214,shaman,elemental,30,13,17
Seinnome,azralon,1213,shaman,elemental,31,14,17
Mhaal,wyrmrest-accord,1213,shaman,elemental,106,42,64
Yippeekiyay,zuluhed,1212,shaman,elemental,33,14,19
Amonita,stonemaul,1210,shaman,elemental,18,13,5
Grezzkall,malganis,1207,shaman,elemental,39,19,20
Syile,stormrage,1206,shaman,elemental,26,14,12
Omegaman,lightninghoof,1204,shaman,elemental,69,35,34
Rafiki,haomarush,1198,shaman,elemental,48,19,29
Kanasya,quelthalas,1197,shaman,elemental,36,14,22
Alphamael,lightbringer,1195,shaman,elemental,41,21,20
Forgediniron,stormrage,1195,shaman,elemental,36,17,19
Hansolorz,tichondrius,1195,shaman,elemental,36,13,23
Hurìon,coilfang,1192,shaman,elemental,20,14,6
Synerggy,hakkar,1185,shaman,elemental,128,63,65
Eze,tichondrius,1182,shaman,elemental,34,20,14
Bazinguinha,azralon,1170,shaman,elemental,48,21,27
Srbski,emerald-dream,1167,shaman,elemental,26,13,13
Zhokal,quelthalas,1166,shaman,elemental,125,65,60
Cptnmagma,bleeding-hollow,1162,shaman,elemental,124,57,67
Jaycobb,area-52,1159,shaman,elemental,30,13,17
Firecracker,warsong,1158,shaman,elemental,76,42,34
Zugdabou,bonechewer,1155,shaman,elemental,66,30,36
Bovinebeauty,tichondrius,1152,shaman,elemental,18,12,6
Kebboz,frostmourne,1152,shaman,elemental,18,12,6
Dràgoon,thrall,1152,shaman,elemental,18,12,6
Pasto,bleeding-hollow,1152,shaman,elemental,18,12,6
Nanosec,tichondrius,1152,shaman,elemental,22,13,9
Krupto,tichondrius,1151,shaman,elemental,24,12,12
Minigible,tichondrius,1151,shaman,elemental,30,12,18
Kang,terenas,1150,shaman,elemental,18,12,6
Poonqtx,frostmourne,1149,shaman,elemental,18,12,6
Enhancers,sargeras,1144,shaman,elemental,24,12,12
Kowabounga,ragnaros,1140,shaman,elemental,24,12,12
Thunderblood,nerzhul,1138,shaman,elemental,24,12,12
Muggs,cairne,1137,shaman,elemental,18,12,6
Nuggitz,tichondrius,1136,shaman,elemental,31,20,11
Ayahuaskah,illidan,1132,shaman,elemental,25,12,13
Üchihamadarâ,tichondrius,1132,shaman,elemental,33,13,20
Yodahh,daggerspine,1131,shaman,elemental,27,15,12
Exoticz,barthilas,1131,shaman,elemental,38,12,26
Johnwilke,area-52,1123,shaman,elemental,43,17,26
Bravederp,kelthuzad,1120,shaman,elemental,63,31,32
Karashamy,ragnaros,1114,shaman,elemental,65,31,34
Skwiglz,tichondrius,1113,shaman,elemental,90,44,46
Shockazulu,vashj,1109,shaman,elemental,42,22,20
Afgoox,tichondrius,1105,shaman,elemental,36,24,12
Shamarock,stonemaul,1103,shaman,elemental,42,23,19
Xoelement,borean-tundra,1103,shaman,elemental,54,25,29
Yunow,ragnaros,1096,shaman,elemental,48,20,28
Shadowowl,tanaris,1085,shaman,elemental,27,12,15
Omnath,zuluhed,1083,shaman,elemental,35,19,16
Zappz,thunderlord,1082,shaman,elemental,60,34,26
Shammpain,barthilas,1072,shaman,elemental,53,28,25
Semasham,khazgoroth,1068,shaman,elemental,25,12,13
Bestshamus,sargeras,1056,shaman,elemental,18,11,7
Petrafk,illidan,1056,shaman,elemental,18,11,7
Redpocket,zuluhed,1056,shaman,elemental,18,11,7
Xpire,ragnaros,1056,shaman,elemental,18,11,7
Palcyon,eonar,1056,shaman,elemental,18,11,7
Miroen,tichondrius,1056,shaman,elemental,24,11,13
Pubechin,jubeithos,1056,shaman,elemental,24,11,13
Highsteakss,tichondrius,1055,shaman,elemental,12,11,1
Smooths,bloodscalp,1055,shaman,elemental,18,11,7
Ndndurkadurk,malganis,1055,shaman,elemental,18,11,7
Bootietootie,bleeding-hollow,1055,shaman,elemental,18,11,7
Kymo,tichondrius,1055,shaman,elemental,18,11,7
Thuntard,bleeding-hollow,1055,shaman,elemental,24,11,13
Ayetex,kelthuzad,1054,shaman,elemental,18,11,7
Kigoros,bleeding-hollow,1054,shaman,elemental,18,11,7
Sumnah,sargeras,1054,shaman,elemental,42,22,20
Blastuh,kiljaeden,1053,shaman,elemental,18,11,7
Dwarfdude,gorefiend,1051,shaman,elemental,16,12,4
Madmartiggen,scilla,1051,shaman,elemental,21,12,9
Ôprawindfury,mugthol,1050,shaman,elemental,18,11,7
Taeilendar,ragnaros,1050,shaman,elemental,24,11,13
Nazz,cenarion-circle,1048,shaman,elemental,18,11,7
Metlar,sargeras,1048,shaman,elemental,24,11,13
Shamans,zuljin,1047,shaman,elemental,18,11,7
Darizzler,bleeding-hollow,1047,shaman,elemental,18,11,7
Luxenor,kelthuzad,1046,shaman,elemental,18,11,7
Minzysm,illidan,1045,shaman,elemental,24,11,13
Bonevykin,area-52,1044,shaman,elemental,21,12,9
Enflexi,lightbringer,1044,shaman,elemental,24,11,13
Darkrock,echo-isles,1033,shaman,elemental,24,12,12
Rollypolli,gnomeregan,1022,shaman,elemental,72,36,36
Olani,nesingwary,1022,shaman,elemental,38,12,26
Treesntotemz,darkspear,1020,shaman,elemental,18,11,7
Geladoo,gallywix,1008,shaman,elemental,68,29,39
Mîkâ,area-52,1007,shaman,elemental,24,11,13
Wälee,sargeras,1004,shaman,elemental,77,37,40
Shambix,illidan,1002,shaman,elemental,19,12,7
Dizzytotem,dalaran,991,shaman,elemental,24,11,13
Rodbert,sargeras,990,shaman,elemental,20,11,9
Cheweydadawg,shandris,990,shaman,elemental,23,11,12
Soartotes,sargeras,987,shaman,elemental,22,11,11
Shamanic,dunemaul,984,shaman,elemental,83,31,52
Bronan,laughing-skull,976,shaman,elemental,54,20,34
Mistayl,bleeding-hollow,968,shaman,elemental,30,12,18
Destroçadorx,azralon,961,shaman,elemental,26,11,15
Asanako,illidan,961,shaman,elemental,64,26,38
Graveshocks,illidan,960,shaman,elemental,12,10,2
Smrtdeath,zuljin,960,shaman,elemental,12,10,2
Dewoverload,garithos,960,shaman,elemental,12,10,2
Smeagles,ragnaros,960,shaman,elemental,18,10,8
Hydroponicz,sargeras,960,shaman,elemental,18,10,8
Ryanxo,azjolnerub,960,shaman,elemental,18,10,8
Àspect,aegwynn,960,shaman,elemental,18,10,8
Folus,azjolnerub,960,shaman,elemental,18,10,8
Bigdaddyion,thrall,960,shaman,elemental,18,10,8
Deathblasts,zuljin,960,shaman,elemental,30,10,20
Everspell,lightnings-blade,959,shaman,elemental,18,10,8
Hexoffend,zuljin,959,shaman,elemental,18,10,8
Tawambji,kiljaeden,959,shaman,elemental,18,10,8
Kodyaj,illidan,959,shaman,elemental,18,10,8
Tidalstorm,thrall,959,shaman,elemental,18,10,8
Feetfungus,area-52,959,shaman,elemental,24,10,14
Ehhmacros,doomhammer,959,shaman,elemental,24,10,14
Aingry,darkspear,958,shaman,elemental,18,10,8
Arukz,tichondrius,958,shaman,elemental,24,10,14
Korlog,tichondrius,957,shaman,elemental,12,10,2
Moartotems,kelthuzad,957,shaman,elemental,12,10,2
Gerrkiing,amanthul,957,shaman,elemental,18,10,8
Xakaeri,hyjal,957,shaman,elemental,18,10,8
Charabon,ragnaros,957,shaman,elemental,18,10,8
Richode,burning-legion,956,shaman,elemental,18,10,8
Shockshammy,kiljaeden,956,shaman,elemental,18,10,8
Sanlu,tichondrius,955,shaman,elemental,65,30,35
Tinkd,stormrage,953,shaman,elemental,18,10,8
Izreborn,tichondrius,953,shaman,elemental,24,10,14
Discokid,norgannon,951,shaman,elemental,24,10,14
Tuksha,alleria,951,shaman,elemental,30,10,20
Saanrixa,jubeithos,946,shaman,elemental,84,29,55
Proignite,drakthul,934,shaman,elemental,35,17,18
Lavablaster,kelthuzad,932,shaman,elemental,12,10,2
Gorron,frostwolf,929,shaman,elemental,24,10,14
Dooman,area-52,927,shaman,elemental,30,10,20
Bulljay,bleeding-hollow,910,shaman,elemental,21,11,10
Bushdeedit,stormrage,910,shaman,elemental,23,10,13
Aragog,malygos,899,shaman,elemental,32,16,16
Threehandz,bleeding-hollow,886,shaman,elemental,55,20,35
Trilz,barthilas,880,shaman,elemental,19,10,9
Jer,tichondrius,864,shaman,elemental,12,9,3
Koalatricks,shadow-council,864,shaman,elemental,12,9,3
Notragii,kelthuzad,864,shaman,elemental,12,9,3
Helga,hellscream,864,shaman,elemental,12,9,3
Bikáchu,tichondrius,864,shaman,elemental,12,9,3
Zuescannon,kelthuzad,864,shaman,elemental,18,9,9
Shockjob,frostmourne,864,shaman,elemental,18,9,9
Councilman,illidan,864,shaman,elemental,18,9,9
Exceedër,ragnaros,864,shaman,elemental,18,9,9
Kilydily,destromath,864,shaman,elemental,18,9,9
Owtyobwol,area-52,864,shaman,elemental,18,9,9
Doorti,area-52,864,shaman,elemental,18,9,9
Ðomzy,tichondrius,863,shaman,elemental,12,9,3
Earthfirex,ragnaros,863,shaman,elemental,18,9,9
Blöw,tichondrius,863,shaman,elemental,18,9,9
Poseidon,kiljaeden,863,shaman,elemental,18,9,9
Onnyx,proudmoore,863,shaman,elemental,18,9,9
Hexellént,kiljaeden,863,shaman,elemental,18,9,9
Skyten,quelthalas,863,shaman,elemental,21,10,11
Dtrumpx,tichondrius,863,shaman,elemental,24,9,15
Thaél,proudmoore,863,shaman,elemental,24,9,15
Dehsaw,illidan,863,shaman,elemental,24,9,15
Xodeus,frostmourne,863,shaman,elemental,24,9,15
Tottemic,blackrock,862,shaman,elemental,18,9,9
Phagocytosis,illidan,861,shaman,elemental,18,9,9
Cónò,tichondrius,861,shaman,elemental,18,9,9
Grandwolf,ragnaros,861,shaman,elemental,18,9,9
Jensenx,proudmoore,861,shaman,elemental,24,9,15
Grukall,galakrond,860,shaman,elemental,12,9,3
Galabanjø,malganis,860,shaman,elemental,24,9,15
Lilmollet,tichondrius,859,shaman,elemental,18,9,9
Velekar,moon-guard,858,shaman,elemental,24,9,15
Gorakh,illidan,856,shaman,elemental,18,9,9
Battleshammy,nagrand,854,shaman,elemental,24,9,15
Dellnar,nagrand,847,shaman,elemental,18,9,9
Tideborn,azralon,845,shaman,elemental,22,10,12
Daiskei,nordrassil,838,shaman,elemental,18,9,9
Justballs,stormscale,835,shaman,elemental,18,9,9
Shàmpow,darkspear,823,shaman,elemental,17,9,8
Vegaslights,tichondrius,816,shaman,elemental,21,9,12
Thanwirn,ragnaros,809,shaman,elemental,24,9,15
Relâx,icecrown,779,shaman,elemental,19,9,10
Xammaa,illidan,768,shaman,elemental,12,8,4
Squidzy,tichondrius,768,shaman,elemental,12,8,4
Biggiechief,illidan,768,shaman,elemental,12,8,4
Coffinpls,illidan,768,shaman,elemental,12,8,4
Genesisz,tichondrius,768,shaman,elemental,12,8,4
Morabebi,tichondrius,768,shaman,elemental,12,8,4
Supbrø,zuluhed,768,shaman,elemental,12,8,4
Bagovs,tichondrius,768,shaman,elemental,12,8,4
Shocksrus,arthas,768,shaman,elemental,18,8,10
Storminlorka,sargeras,768,shaman,elemental,18,8,10
Scrymax,area-52,768,shaman,elemental,18,8,10
Ieeguen,tichondrius,768,shaman,elemental,18,8,10
Graymatterz,ysondre,767,shaman,elemental,12,8,4
Shockerfist,thunderlord,767,shaman,elemental,12,8,4
Tierrox,tichondrius,767,shaman,elemental,12,8,4
Strugs,area-52,767,shaman,elemental,12,8,4
Momothewolf,malganis,767,shaman,elemental,12,8,4
Mazdamundï,ragnaros,767,shaman,elemental,24,8,16
Krimzs,executus,767,shaman,elemental,24,8,16
Fênrisulfer,area-52,766,shaman,elemental,18,8,10
Cheddatotz,illidan,764,shaman,elemental,12,8,4
Pãníç,bladefist,764,shaman,elemental,18,8,10
Toho,ragnaros,764,shaman,elemental,18,8,10
Maldini,tol-barad,764,shaman,elemental,18,8,10
Neebon,jubeithos,763,shaman,elemental,12,8,4
Shachone,zuljin,763,shaman,elemental,18,8,10
Shammany,stormrage,763,shaman,elemental,18,8,10
Teekona,tichondrius,763,shaman,elemental,18,8,10
Lowiqpleb,tichondrius,719,shaman,elemental,17,8,9
Pileef,thrall,704,shaman,elemental,10,8,2
Dmt,exodar,704,shaman,elemental,22,8,14
Fwwrs,illidan,703,shaman,elemental,14,8,6
Makogo,earthen-ring,686,shaman,elemental,13,8,5
Afri,tichondrius,672,shaman,elemental,10,8,2
Xinz,guldan,672,shaman,elemental,12,7,5
Willy,icecrown,672,shaman,elemental,12,7,5
Merkal,illidan,672,shaman,elemental,12,7,5
Glizzyjamon,sargeras,672,shaman,elemental,12,7,5
Thoraq,bleeding-hollow,672,shaman,elemental,12,7,5
Shocks,alleria,672,shaman,elemental,12,7,5
Tatespeech,barthilas,672,shaman,elemental,12,7,5
Cuban,kelthuzad,672,shaman,elemental,12,7,5
Pericazo,sargeras,672,shaman,elemental,12,7,5
Shambergler,tichondrius,672,shaman,elemental,12,7,5
Humorlava,tichondrius,672,shaman,elemental,12,7,5
Chazzwozza,area-52,672,shaman,elemental,12,7,5
Ðøææøð,stormrage,672,shaman,elemental,12,7,5
Totemzie,illidan,672,shaman,elemental,12,7,5
Mesdew,tichondrius,672,shaman,elemental,12,7,5
Drmeatballmd,tichondrius,672,shaman,elemental,12,7,5
Rahkarg,korgath,672,shaman,elemental,12,7,5
Eravas,thrall,672,shaman,elemental,18,7,11
Alwaysbulkin,tichondrius,672,shaman,elemental,18,7,11
Shamigo,tichondrius,672,shaman,elemental,18,7,11
Tampíco,ragnaros,672,shaman,elemental,18,7,11
Zò,zuljin,672,shaman,elemental,18,7,11
Lovebody,zuljin,672,shaman,elemental,18,7,11
Neotrad,proudmoore,672,shaman,elemental,18,7,11
Desdìnova,tortheldrin,672,shaman,elemental,18,7,11
Pozcaster,tichondrius,672,shaman,elemental,24,7,17
Dansham,zuljin,672,shaman,elemental,24,7,17
Lenå,moon-guard,671,shaman,elemental,12,7,5
Hairyrichard,zuljin,671,shaman,elemental,12,7,5
Lilthrall,skullcrusher,671,shaman,elemental,12,7,5
Jacori,malganis,671,shaman,elemental,12,7,5
Bigway,area-52,671,shaman,elemental,18,7,11
Xantoor,area-52,670,shaman,elemental,12,7,5
Alariaa,sargeras,670,shaman,elemental,12,7,5
Neukims,nemesis,670,shaman,elemental,20,7,13
Grimlên,skullcrusher,669,shaman,elemental,18,7,11
Madeleines,goldrinn,667,shaman,elemental,12,7,5
Phuamya,dalaran,667,shaman,elemental,12,7,5
Jyster,area-52,664,shaman,elemental,24,7,17
Piloncho,ragnaros,660,shaman,elemental,30,7,23
Cardanø,illidan,652,shaman,elemental,29,7,22
Cheesewheelz,arthas,651,shaman,elemental,22,7,15
Aestheticsx,thrall,640,shaman,elemental,16,7,9
Megalithic,moon-guard,639,shaman,elemental,14,8,6
Koongram,area-52,623,shaman,elemental,11,7,4
Shizzänk,illidan,606,shaman,elemental,11,7,4
Adutchcowboy,tichondrius,576,shaman,elemental,6,6,0
Notsock,zuljin,576,shaman,elemental,6,6,0
Boltadeez,tichondrius,576,shaman,elemental,6,6,0
Kasparøv,tichondrius,576,shaman,elemental,6,6,0
Orkshammy,illidan,576,shaman,elemental,12,6,6
Deyodin,illidan,576,shaman,elemental,12,6,6
Mistysham,illidan,576,shaman,elemental,12,6,6
Jeffspicele,emerald-dream,576,shaman,elemental,12,6,6
Doommjölnir,sargeras,576,shaman,elemental,12,6,6
Chenjiawei,tichondrius,576,shaman,elemental,12,6,6
Jnzz,area-52,576,shaman,elemental,12,6,6
Darkcharles,illidan,576,shaman,elemental,12,6,6
Rubmytotêm,tichondrius,576,shaman,elemental,12,6,6
Rahtal,malganis,576,shaman,elemental,12,6,6
Getwetand,quelthalas,576,shaman,elemental,12,6,6
Zynt,illidan,576,shaman,elemental,12,6,6
Mcgraff,frostmourne,576,shaman,elemental,12,6,6
Finark,tichondrius,576,shaman,elemental,12,6,6
Bustinbooty,kiljaeden,576,shaman,elemental,12,6,6
Littz,malganis,576,shaman,elemental,12,6,6
Traindablue,illidan,576,shaman,elemental,12,6,6
Fuseillar,illidan,576,shaman,elemental,12,6,6
Deeznuts,the-forgotten-coast,576,shaman,elemental,12,6,6
Zlateral,malganis,576,shaman,elemental,12,6,6
Tairen,ragnaros,576,shaman,elemental,12,6,6
Mugumbo,frostmourne,576,shaman,elemental,13,6,7
Bitamin,frostmourne,576,shaman,elemental,18,6,12
Vixeen,kelthuzad,576,shaman,elemental,18,6,12
Adesaa,illidan,576,shaman,elemental,18,6,12
Cowtidetotem,thrall,576,shaman,elemental,18,6,12
Withinfinity,stormrage,576,shaman,elemental,18,6,12
Drewshammy,zuljin,575,shaman,elemental,12,6,6
Nemei,zuljin,575,shaman,elemental,12,6,6
Drzhong,frostmourne,575,shaman,elemental,12,6,6
Deggle,frostwolf,575,shaman,elemental,12,6,6
Moctezumma,area-52,575,shaman,elemental,12,6,6
Nuofu,illidan,575,shaman,elemental,12,6,6
Shøckolate,magtheridon,575,shaman,elemental,12,6,6
Skribblez,tichondrius,575,shaman,elemental,12,6,6
Procdepartme,area-52,575,shaman,elemental,12,6,6
Apocalypsehb,quelthalas,575,shaman,elemental,12,6,6
Grimitt,suramar,575,shaman,elemental,18,6,12
Nomahuata,cenarion-circle,575,shaman,elemental,18,6,12
Chanintotem,shattered-halls,574,shaman,elemental,12,6,6
Axelrose,ragnaros,574,shaman,elemental,12,6,6
Budgetseaan,stormrage,574,shaman,elemental,12,6,6
Coffee,mugthol,574,shaman,elemental,18,6,12
Bcs,lightbringer,573,shaman,elemental,12,6,6
Nezzuk,quelthalas,573,shaman,elemental,12,6,6
Thuggliife,frostmourne,573,shaman,elemental,18,6,12
Totempaul,frostmourne,570,shaman,elemental,18,6,12
Ryudark,stormrage,569,shaman,elemental,24,6,18
Asy,tichondrius,559,shaman,elemental,11,6,5
Aitex,kelthuzad,543,shaman,elemental,15,7,8
Thanen,the-scryers,541,shaman,elemental,16,6,10
Sarahfe,wyrmrest-accord,527,shaman,elemental,11,6,5
Zerium,nemesis,526,shaman,elemental,21,7,14
Aseew,drakkari,522,shaman,elemental,21,9,12
Maxchamo,ragnaros,522,shaman,elemental,25,7,18
Riptideafk,sargeras,480,shaman,elemental,6,5,1
Axaxaxaxaxax,illidan,480,shaman,elemental,6,5,1
Feuerbart,dalaran,480,shaman,elemental,6,5,1
Farku,illidan,480,shaman,elemental,6,5,1
Shamxrob,sargeras,480,shaman,elemental,6,5,1
Meatballsx,tichondrius,480,shaman,elemental,6,5,1
Josiahsham,kelthuzad,480,shaman,elemental,6,5,1
Shoxz,korgath,480,shaman,elemental,6,5,1
Spaceghost,illidan,480,shaman,elemental,6,5,1
Dook,ghostlands,480,shaman,elemental,6,5,1
Shinydiglett,area-52,480,shaman,elemental,6,5,1
Vulcansh,azralon,480,shaman,elemental,6,5,1
Totems,the-underbog,480,shaman,elemental,6,5,1
PlayerHLFJNY,moon-guard,480,shaman,elemental,6,5,1
Sxr,moon-guard,480,shaman,elemental,6,5,1
Windfurygød,tichondrius,480,shaman,elemental,7,5,2
Firedchips,tichondrius,480,shaman,elemental,17,8,9
Jaedrick,chogall,480,shaman,elemental,12,5,7
Mariarlee,proudmoore,480,shaman,elemental,12,5,7
Drakhe,proudmoore,480,shaman,elemental,12,5,7
Groundfaults,bleeding-hollow,480,shaman,elemental,12,5,7
Zeebouzy,illidan,480,shaman,elemental,12,5,7
Junkygreens,proudmoore,480,shaman,elemental,12,5,7
Zajashuna,malganis,480,shaman,elemental,12,5,7
Delement,ragnaros,480,shaman,elemental,12,5,7
Kissmywalnut,frostmourne,480,shaman,elemental,12,5,7
Boodissy,tichondrius,480,shaman,elemental,12,5,7
Vashidda,stormrage,480,shaman,elemental,12,5,7
Wobbleshock,tichondrius,480,shaman,elemental,12,5,7
Chomolungma,azralon,480,shaman,elemental,12,5,7
Daerönn,azralon,480,shaman,elemental,12,5,7
Conjury,tichondrius,480,shaman,elemental,12,5,7
Slumpinator,tichondrius,480,shaman,elemental,12,5,7
Stayz,tichondrius,480,shaman,elemental,12,5,7
Gjaj,tichondrius,480,shaman,elemental,12,5,7
Shamberheard,kelthuzad,480,shaman,elemental,12,5,7
Ferdi,kelthuzad,480,shaman,elemental,12,5,7
Twistedteas,tichondrius,480,shaman,elemental,12,5,7
Eluulne,silvermoon,480,shaman,elemental,12,5,7
Jènova,whisperwind,480,shaman,elemental,12,5,7
Rokogg,thrall,480,shaman,elemental,12,5,7
Flamestrife,illidan,480,shaman,elemental,12,5,7
Sgorr,illidan,480,shaman,elemental,12,5,7
Totemchucker,stormrage,480,shaman,elemental,15,6,9
Dwârf,tichondrius,480,shaman,elemental,18,5,13
Firesurge,sargeras,480,shaman,elemental,18,5,13
Helapoon,area-52,480,shaman,elemental,18,5,13
Arialial,hyjal,480,shaman,elemental,18,5,13
Advìl,area-52,480,shaman,elemental,18,5,13
Killdeaderer,barthilas,479,shaman,elemental,6,5,1
Shanão,nemesis,479,shaman,elemental,6,5,1
Aeromarius,ragnaros,479,shaman,elemental,9,6,3
Ðarkvolts,stormrage,479,shaman,elemental,12,5,7
Sparkyy,kelthuzad,479,shaman,elemental,12,5,7
Bigrider,nemesis,479,shaman,elemental,12,5,7
Doughboy,khadgar,478,shaman,elemental,14,6,8
Talraviebor,stormrage,478,shaman,elemental,12,5,7
Diokles,skywall,478,shaman,elemental,12,5,7
Totemsmacker,quelthalas,447,shaman,elemental,17,5,12
Novajersey,azralon,432,shaman,elemental,9,6,3
Kinjin,dragonmaw,415,shaman,elemental,14,5,9
Ripklanian,blood-furnace,400,shaman,elemental,13,5,8
Kromdag,dalaran,384,shaman,elemental,6,4,2
Trickyjf,dalaran,384,shaman,elemental,6,4,2
Zappithorus,stormrage,384,shaman,elemental,6,4,2
Zenan,stormreaver,384,shaman,elemental,6,4,2
Lukora,stonemaul,384,shaman,elemental,6,4,2
Nyroh,zuljin,384,shaman,elemental,6,4,2
Brickzilla,dalaran,384,shaman,elemental,6,4,2
Jimmyapple,illidan,384,shaman,elemental,6,4,2
Thorlottie,stormrage,384,shaman,elemental,6,4,2
Dgshaman,tichondrius,384,shaman,elemental,6,4,2
Oscarmike,auchindoun,384,shaman,elemental,6,4,2
Greensween,thrall,384,shaman,elemental,6,4,2
Badandbooshi,stormreaver,384,shaman,elemental,6,4,2
Borgmash,chogall,384,shaman,elemental,6,4,2
Muffïn,moon-guard,384,shaman,elemental,6,4,2
Olboy,thrall,384,shaman,elemental,6,4,2
Novoz,tichondrius,384,shaman,elemental,6,4,2
Dromus,dalvengyr,384,shaman,elemental,6,4,2
Coldbeer,frostmourne,384,shaman,elemental,6,4,2
Cduck,zuljin,384,shaman,elemental,6,4,2
Jashar,spinebreaker,384,shaman,elemental,6,4,2
Munchies,madoran,384,shaman,elemental,6,4,2
Boogiefever,area-52,384,shaman,elemental,6,4,2
Oukami,area-52,384,shaman,elemental,6,4,2
Seraøth,area-52,384,shaman,elemental,6,4,2
Simped,bleeding-hollow,384,shaman,elemental,6,4,2
Lasso,shattered-hand,384,shaman,elemental,6,4,2
Aishel,area-52,384,shaman,elemental,6,4,2
Blueku,tichondrius,384,shaman,elemental,6,4,2
Beibeihangh,tichondrius,384,shaman,elemental,6,4,2
Creativemind,ragnaros,384,shaman,elemental,6,4,2
Madelements,tichondrius,384,shaman,elemental,6,4,2
Hulan,tichondrius,384,shaman,elemental,6,4,2
Dingfu,sargeras,384,shaman,elemental,6,4,2
Checkmâte,emerald-dream,384,shaman,elemental,6,4,2
Shammyqua,tichondrius,384,shaman,elemental,6,4,2
Ruugo,malganis,384,shaman,elemental,6,4,2
Thandius,arygos,384,shaman,elemental,6,4,2
Weebdestroyr,illidan,384,shaman,elemental,6,4,2
Elebro,emerald-dream,384,shaman,elemental,6,4,2
Yshi,kelthuzad,384,shaman,elemental,6,4,2
Clamson,tichondrius,384,shaman,elemental,6,4,2
Zezlek,malganis,384,shaman,elemental,6,4,2
Dragaru,illidan,384,shaman,elemental,6,4,2
Kranif,tichondrius,384,shaman,elemental,6,4,2
Wodgodx,sargeras,384,shaman,elemental,6,4,2
Vodord,arathor,384,shaman,elemental,6,4,2
Ktom,runetotem,384,shaman,elemental,6,4,2
Sheman,galakrond,384,shaman,elemental,7,4,3
Super,azshara,384,shaman,elemental,14,5,9
Sjostrom,proudmoore,384,shaman,elemental,12,4,8
Jhivone,tichondrius,384,shaman,elemental,12,4,8
Ayatsu,thrall,384,shaman,elemental,12,4,8
Sin,bleeding-hollow,384,shaman,elemental,12,4,8
Shrektar,cenarius,384,shaman,elemental,12,4,8
Manitbaggins,earthen-ring,384,shaman,elemental,12,4,8
Kushnations,chogall,384,shaman,elemental,12,4,8
Yukishock,illidan,384,shaman,elemental,12,4,8
Oohkillemm,silvermoon,384,shaman,elemental,12,4,8
Fatherrtime,illidan,384,shaman,elemental,12,4,8
Lavasurge,area-52,384,shaman,elemental,12,4,8
Rudoboy,ragnaros,384,shaman,elemental,12,4,8
Anahvee,moon-guard,384,shaman,elemental,12,4,8
Popsoot,area-52,384,shaman,elemental,12,4,8
Zizö,barthilas,384,shaman,elemental,12,4,8
Duza,frostmourne,384,shaman,elemental,12,4,8
Naweiv,caelestrasz,384,shaman,elemental,12,4,8
Natorr,dalaran,384,shaman,elemental,12,4,8
Elryl,sargeras,384,shaman,elemental,12,4,8
Vjeze,frostmourne,384,shaman,elemental,18,4,14
Zevelynne,wyrmrest-accord,384,shaman,elemental,18,4,14
Enroks,greymane,383,shaman,elemental,12,4,8
Machalo,sargeras,383,shaman,elemental,12,4,8
Potatopirate,burning-legion,381,shaman,elemental,18,4,14
Coffeeblacc,magtheridon,379,shaman,elemental,12,4,8
Babyblake,malganis,351,shaman,elemental,8,5,3
Shk,illidan,351,shaman,elemental,11,4,7
Råys,turalyon,350,shaman,elemental,11,4,7
Stormfronts,kelthuzad,336,shaman,elemental,9,4,5
Trashaman,garona,336,shaman,elemental,9,4,5
Nondracil,ragnaros,336,shaman,elemental,14,4,10
Statikrage,eonar,330,shaman,elemental,16,5,11
Taraneh,garrosh,325,shaman,elemental,15,5,10
Shamankie,tichondrius,319,shaman,elemental,5,4,1
Orochishaman,stormrage,319,shaman,elemental,5,4,1
Sweetbabyraé,bleeding-hollow,304,shaman,elemental,7,4,3
Tsunamibrew,moon-guard,302,shaman,elemental,9,4,5
Doop,kiljaeden,288,shaman,elemental,6,3,3
Iloverina,stormrage,288,shaman,elemental,6,3,3
Groink,kiljaeden,288,shaman,elemental,6,3,3
Hedeadx,illidan,288,shaman,elemental,6,3,3
Dialtone,blackrock,288,shaman,elemental,6,3,3
Flowerchild,proudmoore,288,shaman,elemental,6,3,3
Mønønøke,tichondrius,288,shaman,elemental,6,3,3
Curtrex,amanthul,288,shaman,elemental,6,3,3
Oxforcefairy,tichondrius,288,shaman,elemental,6,3,3
Beatryx,the-scryers,288,shaman,elemental,6,3,3
Vanëssão,stormrage,288,shaman,elemental,6,3,3
Tokelahoma,stormrage,288,shaman,elemental,6,3,3
Spacemilk,stormrage,288,shaman,elemental,6,3,3
Trenhance,stormrage,288,shaman,elemental,6,3,3
Oingo,destromath,288,shaman,elemental,6,3,3
Raiden,gorgonnash,288,shaman,elemental,6,3,3
Gödöfbüdå,tichondrius,288,shaman,elemental,6,3,3
Blakki,barthilas,288,shaman,elemental,6,3,3
Applicable,tichondrius,288,shaman,elemental,6,3,3
Shajay,area-52,288,shaman,elemental,6,3,3
Floon,barthilas,288,shaman,elemental,6,3,3
Flukz,nazjatar,288,shaman,elemental,6,3,3
Shamyuna,dalaran,288,shaman,elemental,6,3,3
Awesomeus,barthilas,288,shaman,elemental,6,3,3
Exsh,area-52,288,shaman,elemental,6,3,3
Dì,barthilas,288,shaman,elemental,6,3,3
Improvize,malganis,288,shaman,elemental,6,3,3
Garalath,bleeding-hollow,288,shaman,elemental,6,3,3
Healingtime,nerzhul,288,shaman,elemental,6,3,3
Häzel,nerzhul,288,shaman,elemental,6,3,3
Daiablo,barthilas,288,shaman,elemental,6,3,3
Ggoong,tichondrius,288,shaman,elemental,6,3,3
Zon,laughing-skull,288,shaman,elemental,6,3,3
Éarl,sargeras,288,shaman,elemental,6,3,3
Shadeele,cenarius,288,shaman,elemental,6,3,3
Blaydin,elune,288,shaman,elemental,6,3,3
Mabite,frostmourne,288,shaman,elemental,6,3,3
Wabiex,illidan,288,shaman,elemental,6,3,3
Shàman,durotan,288,shaman,elemental,6,3,3
Axshaman,darkspear,288,shaman,elemental,6,3,3
Xhamankng,quelthalas,288,shaman,elemental,6,3,3
Altryn,shuhalo,288,shaman,elemental,6,3,3
Shizamm,hyjal,288,shaman,elemental,6,3,3
Autisty,sargeras,288,shaman,elemental,6,3,3
Fobb,area-52,288,shaman,elemental,6,3,3
Frenchy,hyjal,288,shaman,elemental,6,3,3
Vibration,akama,288,shaman,elemental,6,3,3
Malito,ursin,288,shaman,elemental,6,3,3
Shamtactic,thrall,288,shaman,elemental,6,3,3
Scarshamxn,frostmourne,288,shaman,elemental,6,3,3
Cvoa,bonechewer,288,shaman,elemental,6,3,3
Largerwang,sargeras,288,shaman,elemental,6,3,3
Aerôv,area-52,288,shaman,elemental,6,3,3
Talfur,area-52,288,shaman,elemental,6,3,3
Dazu,drakkari,288,shaman,elemental,6,3,3
Passion,sargeras,288,shaman,elemental,6,3,3
Fluffyhex,sargeras,288,shaman,elemental,6,3,3
Arckos,thrall,288,shaman,elemental,6,3,3
Malgrave,ragnaros,288,shaman,elemental,6,3,3
Moosk,zuluhed,288,shaman,elemental,6,3,3
Ragor,quelthalas,288,shaman,elemental,6,3,3
Bolteon,malganis,288,shaman,elemental,6,3,3
Niarkx,frostmourne,288,shaman,elemental,6,3,3
Ioki,spirestone,288,shaman,elemental,6,3,3
Fattizer,sargeras,288,shaman,elemental,6,3,3
Fanatix,moon-guard,288,shaman,elemental,6,3,3
Rampàge,ragnaros,288,shaman,elemental,6,3,3
Bens,malganis,288,shaman,elemental,6,3,3
Bizle,jaedenar,288,shaman,elemental,6,3,3
Earthfurÿ,quelthalas,288,shaman,elemental,6,3,3
Grimnur,bleeding-hollow,288,shaman,elemental,11,3,8
Winiethepoöh,stormrage,288,shaman,elemental,12,3,9
Olex,zuluhed,288,shaman,elemental,12,3,9
Oznog,bleeding-hollow,288,shaman,elemental,12,3,9
Emptee,area-52,288,shaman,elemental,12,3,9
Stormklepter,fizzcrank,288,shaman,elemental,12,3,9
Tawahka,hyjal,288,shaman,elemental,12,3,9
Sumyl,ragnaros,288,shaman,elemental,12,3,9
Bloodytotemz,emerald-dream,288,shaman,elemental,12,3,9
Lumpyshaman,tichondrius,288,shaman,elemental,12,3,9
Bitflip,jubeithos,288,shaman,elemental,12,3,9
Tdub,frostmourne,288,shaman,elemental,12,3,9
Káládin,malganis,288,shaman,elemental,12,3,9
Taquitho,quelthalas,288,shaman,elemental,12,3,9
Juanisan,stormrage,287,shaman,elemental,6,3,3
Arakye,stormrage,287,shaman,elemental,6,3,3
Mðna,zuluhed,287,shaman,elemental,6,3,3
Strikzjr,frostmourne,287,shaman,elemental,6,3,3
Slåpntickle,darkspear,287,shaman,elemental,12,3,9
Trabolta,hyjal,287,shaman,elemental,12,3,9
Balrog,vashj,287,shaman,elemental,12,3,9
Cropdustr,sargeras,286,shaman,elemental,6,3,3
Hexytimexoqt,thrall,255,shaman,elemental,11,3,8
Hannibol,tichondrius,255,shaman,elemental,11,3,8
Oxxnabatko,amanthul,240,shaman,elemental,9,3,6
Nikeshocks,detheroc,239,shaman,elemental,5,3,2
Liamus,amanthul,239,shaman,elemental,5,3,2
Spunjie,frostmourne,239,shaman,elemental,5,3,2
Ladash,ragnaros,192,shaman,elemental,6,2,4
Trizzeh,moon-guard,192,shaman,elemental,6,2,4
Zugharder,illidan,192,shaman,elemental,6,2,4
Beazel,moon-guard,192,shaman,elemental,6,2,4
Naextramus,ragnaros,192,shaman,elemental,6,2,4
Piffzorz,tichondrius,192,shaman,elemental,6,2,4
Oriyani,sargeras,192,shaman,elemental,6,2,4
Matzahmeal,skywall,192,shaman,elemental,6,2,4
Wrestleman,drakthul,192,shaman,elemental,6,2,4
Ínfected,azralon,192,shaman,elemental,6,2,4
Flappygooch,illidan,192,shaman,elemental,6,2,4
Snoocher,kelthuzad,192,shaman,elemental,6,2,4
Oppaswag,tichondrius,192,shaman,elemental,6,2,4
Tartar,lightbringer,192,shaman,elemental,6,2,4
Killtotem,illidan,192,shaman,elemental,6,2,4
Shockbot,stormscale,192,shaman,elemental,6,2,4
Yellowfev,thrall,192,shaman,elemental,6,2,4
Lividelemnts,area-52,192,shaman,elemental,6,2,4
Aiggiggigne,sargeras,192,shaman,elemental,6,2,4
Whitecake,frostmourne,192,shaman,elemental,6,2,4
Ric,malganis,192,shaman,elemental,6,2,4
Jbahr,hyjal,192,shaman,elemental,6,2,4
Dantheman,twisting-nether,192,shaman,elemental,6,2,4
Chadious,illidan,192,shaman,elemental,6,2,4
Bigbadbolt,malganis,192,shaman,elemental,6,2,4
Zaxibow,area-52,192,shaman,elemental,6,2,4
Smellyogre,area-52,192,shaman,elemental,6,2,4
Dadadabang,frostmourne,192,shaman,elemental,6,2,4
Artnatu,nemesis,192,shaman,elemental,6,2,4
Branasou,emerald-dream,192,shaman,elemental,6,2,4
Shåmwowz,sargeras,192,shaman,elemental,6,2,4
Gorillox,chogall,192,shaman,elemental,6,2,4
Yangsangchu,tichondrius,192,shaman,elemental,6,2,4
Wempa,moon-guard,192,shaman,elemental,6,2,4
Elîas,tichondrius,192,shaman,elemental,6,2,4
Krilick,blackrock,192,shaman,elemental,6,2,4
Drünk,hyjal,192,shaman,elemental,6,2,4
Alleys,tichondrius,192,shaman,elemental,6,2,4
Hruggol,bleeding-hollow,192,shaman,elemental,6,2,4
Blaiserpub,tichondrius,192,shaman,elemental,6,2,4
Praisegodx,stormrage,192,shaman,elemental,6,2,4
Grandmaster,frostmourne,192,shaman,elemental,6,2,4
Zeldrys,emerald-dream,192,shaman,elemental,6,2,4
Lenxd,dalaran,192,shaman,elemental,6,2,4
Shamsky,tichondrius,192,shaman,elemental,6,2,4
Yssyyds,illidan,192,shaman,elemental,6,2,4
Stickshaman,sargeras,192,shaman,elemental,6,2,4
Thormzz,tichondrius,192,shaman,elemental,6,2,4
Dxycollapse,illidan,192,shaman,elemental,6,2,4
Sid,frostmourne,192,shaman,elemental,6,2,4
Hehew,kelthuzad,192,shaman,elemental,6,2,4
Saltywap,proudmoore,192,shaman,elemental,6,2,4
Heniu,tichondrius,192,shaman,elemental,6,2,4
Blastj,tichondrius,192,shaman,elemental,6,2,4
Rokhnar,zuljin,192,shaman,elemental,6,2,4
Funeropolis,stormrage,192,shaman,elemental,6,2,4
Kanbar,emerald-dream,192,shaman,elemental,6,2,4
Britisy,stormrage,192,shaman,elemental,6,2,4
Puntress,barthilas,192,shaman,elemental,6,2,4
Zuroster,kiljaeden,192,shaman,elemental,7,2,5
Martisor,barthilas,192,shaman,elemental,16,3,13
Mega,azralon,192,shaman,elemental,12,2,10
Harrìson,tichondrius,192,shaman,elemental,12,2,10
Rìddles,malygos,192,shaman,elemental,12,2,10
Telryndas,hyjal,192,shaman,elemental,12,2,10
Electrïck,tichondrius,192,shaman,elemental,12,2,10
Fluffy,smolderthorn,192,shaman,elemental,12,2,10
Dodona,sargeras,192,shaman,elemental,12,2,10
Jazzblast,tichondrius,192,shaman,elemental,12,2,10
Thermopile,wildhammer,192,shaman,elemental,12,2,10
Jedley,azshara,192,shaman,elemental,12,2,10
Fulingyu,moon-guard,192,shaman,elemental,12,2,10
Azl,guldan,192,shaman,elemental,13,2,11
Eleveil,emerald-dream,191,shaman,elemental,9,2,7
Hakaskry,caelestrasz,191,shaman,elemental,12,2,10
Mentàl,baelgun,159,shaman,elemental,5,2,3
Hazzardttvz,illidan,159,shaman,elemental,5,2,3
Kidkovid,illidan,159,shaman,elemental,17,2,15
Noslol,bronzebeard,138,shaman,elemental,9,3,6
Uracemytotem,kiljaeden,138,shaman,elemental,10,3,7
Marduul,azralon,138,shaman,elemental,11,3,8
Mynigabob,zuljin,128,shaman,elemental,4,2,2
Rahloo,sargeras,127,shaman,elemental,8,2,6
Sinsar,illidan,96,shaman,elemental,6,1,5
Orruddon,thaurissan,96,shaman,elemental,6,1,5
Wonima,tichondrius,96,shaman,elemental,6,1,5
Nerfmytotemz,frostmourne,96,shaman,elemental,6,1,5
Ludacrìtz,stormrage,96,shaman,elemental,6,1,5
Bouje,frostmourne,96,shaman,elemental,6,1,5
Seanie,bleeding-hollow,96,shaman,elemental,6,1,5
Aegaeonlol,tichondrius,96,shaman,elemental,6,1,5
Drmn,frostmourne,96,shaman,elemental,6,1,5
Zorgen,anvilmar,96,shaman,elemental,6,1,5
Girafasuarx,korgath,96,shaman,elemental,6,1,5
Tatius,stormreaver,96,shaman,elemental,6,1,5
Crigga,dalaran,96,shaman,elemental,6,1,5
Juicemcroose,zuljin,96,shaman,elemental,6,1,5
Mcshockturds,tichondrius,96,shaman,elemental,6,1,5
Sàuron,tichondrius,96,shaman,elemental,6,1,5
Jalgago,tichondrius,96,shaman,elemental,6,1,5
Detair,malganis,96,shaman,elemental,6,1,5
Healsquish,area-52,96,shaman,elemental,6,1,5
Mugiwára,ragnaros,96,shaman,elemental,6,1,5
Ognerkish,black-dragonflight,96,shaman,elemental,6,1,5
Firevag,hakkar,96,shaman,elemental,6,1,5
Bullcowsby,darkspear,96,shaman,elemental,6,1,5
Gan,silvermoon,96,shaman,elemental,6,1,5
Mdawwg,kelthuzad,96,shaman,elemental,6,1,5
Ggsggs,akama,96,shaman,elemental,6,1,5
Teathin,ragnaros,96,shaman,elemental,6,1,5
Youngmulakek,area-52,96,shaman,elemental,6,1,5
Oldshammy,eldrethalas,96,shaman,elemental,6,1,5
Obiwonsamdi,illidan,96,shaman,elemental,6,1,5
Ravaburst,sargeras,96,shaman,elemental,6,1,5
Khoden,emerald-dream,96,shaman,elemental,6,1,5
Zral,emerald-dream,96,shaman,elemental,6,1,5
Akó,quelthalas,96,shaman,elemental,6,1,5
Succies,emerald-dream,96,shaman,elemental,6,1,5
Cathxy,kelthuzad,96,shaman,elemental,6,1,5
Toxidizetkö,azralon,96,shaman,elemental,6,1,5
Bigstormz,fenris,96,shaman,elemental,12,1,11
Bubbert,illidan,96,shaman,elemental,12,1,11
Shamofshame,garrosh,96,shaman,elemental,12,1,11
Staticshock,darkspear,96,shaman,elemental,12,1,11
Cyrah,azjolnerub,96,shaman,elemental,12,1,11
Ramonsanchez,ragnaros,96,shaman,elemental,12,1,11
Ëìê,tichondrius,96,shaman,elemental,18,1,17
Eleshamanz,tichondrius,79,shaman,elemental,5,1,4
Docadams,chogall,79,shaman,elemental,5,1,4
Camltotem,tichondrius,79,shaman,elemental,5,1,4
Esbet,echo-isles,79,shaman,elemental,11,1,10
Mcstop,tanaris,64,shaman,elemental,4,1,3
Gurdle,frostwolf,48,shaman,elemental,3,1,2
Hentaistorm,kiljaeden,48,shaman,elemental,3,1,2
Hothouse,malganis,31,shaman,elemental,2,1,1
Djskinflute,bleeding-hollow,16,shaman,elemental,1,1,0
Mítsurí,tichondrius,2244,shaman,enhancement,210,109,101
Saul,tichondrius,2218,shaman,enhancement,66,42,24
Aýanokoji,tichondrius,2201,shaman,enhancement,137,74,63
Alleys,tichondrius,2179,shaman,enhancement,171,88,83
Rauthgar,dalaran,2167,shaman,enhancement,102,58,44
Veggiess,emerald-dream,2162,shaman,enhancement,324,165,159
Opoy,sargeras,2142,shaman,enhancement,201,112,89
Stew,illidan,2138,shaman,enhancement,125,67,58
Crowns,tichondrius,2136,shaman,enhancement,114,59,55
Nopnopajnin,tichondrius,2135,shaman,enhancement,112,57,55
Skydre,area-52,2131,shaman,enhancement,89,54,35
Jimmyjobs,tichondrius,2129,shaman,enhancement,114,70,44
Pizzashaman,illidan,2128,shaman,enhancement,106,63,43
Zarktwo,azralon,2125,shaman,enhancement,132,70,62
Futeuncle,tichondrius,2123,shaman,enhancement,78,41,37
Ftyue,area-52,2116,shaman,enhancement,112,59,53
Rawdòggin,emerald-dream,2113,shaman,enhancement,71,45,26
Shapaman,tichondrius,2110,shaman,enhancement,77,53,24
Doomwìnds,stormrage,2108,shaman,enhancement,168,93,75
Wetdraenei,moon-guard,2102,shaman,enhancement,271,152,119
Lustingchery,area-52,2101,shaman,enhancement,63,41,22
Smxxn,tichondrius,2084,shaman,enhancement,84,42,42
Baseballcap,sargeras,2070,shaman,enhancement,96,58,38
Bjorengahr,emerald-dream,2054,shaman,enhancement,77,48,29
Peynful,shadowsong,2046,shaman,enhancement,75,48,27
Realypump,area-52,2034,shaman,enhancement,137,72,65
Shakeys,tichondrius,2032,shaman,enhancement,71,45,26
Shamsz,frostmourne,2028,shaman,enhancement,66,42,24
Tastydonut,blackrock,2026,shaman,enhancement,116,70,46
Xiaoxiboy,tichondrius,2024,shaman,enhancement,54,35,19
Musclebrain,tichondrius,2021,shaman,enhancement,138,67,71
Algresh,muradin,2018,shaman,enhancement,60,31,29
Stormnala,zuljin,2015,shaman,enhancement,89,51,38
Windshearbøt,tichondrius,2006,shaman,enhancement,77,47,30
Zarasvati,tichondrius,2004,shaman,enhancement,119,63,56
Swrdfsh,tichondrius,1995,shaman,enhancement,234,123,111
Dopeysimida,illidan,1976,shaman,enhancement,92,57,35
Shylabuffkin,area-52,1976,shaman,enhancement,112,67,45
Spippippin,illidan,1972,shaman,enhancement,80,42,38
Musclebrains,tichondrius,1969,shaman,enhancement,66,36,30
Windfury,chogall,1968,shaman,enhancement,96,51,45
Oosheratchet,illidan,1963,shaman,enhancement,58,41,17
Zootywild,tichondrius,1963,shaman,enhancement,123,69,54
Axegerd,quelthalas,1962,shaman,enhancement,183,96,87
Proctopus,moon-guard,1958,shaman,enhancement,142,77,65
Imchuckbass,tichondrius,1957,shaman,enhancement,104,55,49
Superchief,altar-of-storms,1954,shaman,enhancement,86,50,36
Musclebrainz,tichondrius,1952,shaman,enhancement,54,26,28
Balgron,emerald-dream,1949,shaman,enhancement,52,26,26
Tokyofresh,malganis,1944,shaman,enhancement,90,62,28
Ohmálley,tichondrius,1944,shaman,enhancement,62,40,22
Shk,illidan,1938,shaman,enhancement,60,36,24
Ogeezkush,zuljin,1935,shaman,enhancement,160,93,67
Kaediea,moon-guard,1932,shaman,enhancement,30,24,6
Rozboiclique,frostmourne,1929,shaman,enhancement,132,89,43
Gatorwaves,bleeding-hollow,1924,shaman,enhancement,42,27,15
Enhancex,frostwolf,1923,shaman,enhancement,62,30,32
Vanhalestorm,frostmourne,1922,shaman,enhancement,64,34,30
Beañ,barthilas,1922,shaman,enhancement,315,162,153
Typhe,bleeding-hollow,1919,shaman,enhancement,36,25,11
Eletastic,tichondrius,1918,shaman,enhancement,54,35,19
Eityhdz,tichondrius,1912,shaman,enhancement,401,207,194
Temar,sargeras,1905,shaman,enhancement,81,54,27
Earlainn,stormrage,1905,shaman,enhancement,84,48,36
Scaman,tichondrius,1904,shaman,enhancement,24,20,4
Cowaii,illidan,1904,shaman,enhancement,60,37,23
Greenydapooh,nerzhul,1903,shaman,enhancement,60,40,20
Rukagar,barthilas,1902,shaman,enhancement,72,42,30
Keyturn,tichondrius,1899,shaman,enhancement,78,36,42
Dano,tichondrius,1895,shaman,enhancement,108,57,51
Interruptbøt,tichondrius,1894,shaman,enhancement,41,27,14
Jayhastotems,area-52,1890,shaman,enhancement,96,69,27
Jazzlightnin,tichondrius,1888,shaman,enhancement,46,29,17
Fwwrs,illidan,1887,shaman,enhancement,61,41,20
Olxsixsm,illidan,1884,shaman,enhancement,74,48,26
Bestshamus,sargeras,1883,shaman,enhancement,71,42,29
Gìmli,tichondrius,1882,shaman,enhancement,65,37,28
Electricity,tichondrius,1880,shaman,enhancement,115,57,58
Plsnerfret,stormrage,1876,shaman,enhancement,48,33,15
Stormrageman,tichondrius,1875,shaman,enhancement,81,49,32
Antek,quelthalas,1868,shaman,enhancement,141,86,55
Shamikazi,crushridge,1866,shaman,enhancement,159,98,61
Zarrka,tichondrius,1864,shaman,enhancement,36,20,16
Ëxceeder,ragnaros,1861,shaman,enhancement,120,69,51
Shakeysham,tichondrius,1860,shaman,enhancement,30,22,8
Napski,cenarius,1859,shaman,enhancement,66,32,34
Ballinhance,illidan,1858,shaman,enhancement,48,28,20
Wonima,tichondrius,1858,shaman,enhancement,35,20,15
Watergirl,thaurissan,1857,shaman,enhancement,170,84,86
Taikø,area-52,1856,shaman,enhancement,42,25,17
Loabud,tichondrius,1855,shaman,enhancement,58,37,21
Lavitris,illidan,1854,shaman,enhancement,42,29,13
Kiddfurious,kelthuzad,1854,shaman,enhancement,78,40,38
Mcshockturds,tichondrius,1849,shaman,enhancement,143,82,61
Undertów,area-52,1847,shaman,enhancement,48,26,22
Xakaeri,hyjal,1844,shaman,enhancement,60,36,24
Koalakisses,shadow-council,1842,shaman,enhancement,54,32,22
Artenior,stormrage,1841,shaman,enhancement,89,44,45
Megalithic,moon-guard,1840,shaman,enhancement,62,44,18
Vonvulviln,emerald-dream,1839,shaman,enhancement,64,34,30
Ishano,area-52,1839,shaman,enhancement,48,23,25
Dcg,hyjal,1838,shaman,enhancement,65,33,32
Berxek,tichondrius,1835,shaman,enhancement,48,27,21
Thuntard,bleeding-hollow,1835,shaman,enhancement,66,33,33
Norlak,antonidas,1834,shaman,enhancement,84,42,42
Bøulderfist,tichondrius,1827,shaman,enhancement,36,28,8
Shamanabuser,illidan,1825,shaman,enhancement,60,27,33
Jokerxksx,tichondrius,1822,shaman,enhancement,72,43,29
Midwestern,emerald-dream,1822,shaman,enhancement,44,26,18
Hooftoface,moon-guard,1822,shaman,enhancement,78,43,35
Blueraccoon,tichondrius,1821,shaman,enhancement,57,35,22
Gladdorta,azralon,1821,shaman,enhancement,54,30,24
Btruez,tichondrius,1819,shaman,enhancement,63,35,28
Thunderlaw,area-52,1819,shaman,enhancement,82,44,38
Harrypotqueu,zuljin,1819,shaman,enhancement,60,32,28
Whírlwínd,area-52,1818,shaman,enhancement,30,19,11
Konfuzious,emerald-dream,1818,shaman,enhancement,129,74,55
Turdfergesen,destromath,1817,shaman,enhancement,70,37,33
Léxar,sargeras,1817,shaman,enhancement,72,33,39
Cunkinator,stormrage,1815,shaman,enhancement,115,74,41
Riptiedx,barthilas,1815,shaman,enhancement,48,29,19
Sarthuul,emerald-dream,1814,shaman,enhancement,48,30,18
Thrallas,frostmourne,1814,shaman,enhancement,54,33,21
Boombigshaq,ysera,1813,shaman,enhancement,38,25,13
Louiev,bleeding-hollow,1812,shaman,enhancement,48,28,20
Timzero,tichondrius,1812,shaman,enhancement,78,39,39
Tdlz,tichondrius,1811,shaman,enhancement,92,60,32
Legendslayar,area-52,1811,shaman,enhancement,42,27,15
Drakhe,proudmoore,1811,shaman,enhancement,232,128,104
Nygiants,tichondrius,1810,shaman,enhancement,24,19,5
Xibalba,khaz-modan,1810,shaman,enhancement,96,57,39
Sassyx,steamwheedle-cartel,1810,shaman,enhancement,48,27,21
Iamashaman,malganis,1810,shaman,enhancement,302,154,148
Cammeez,area-52,1809,shaman,enhancement,109,57,52
Bikboisteez,barthilas,1808,shaman,enhancement,92,47,45
Shamguards,tichondrius,1806,shaman,enhancement,24,19,5
Lashandtrash,tichondrius,1806,shaman,enhancement,30,19,11
Boboyaga,emerald-dream,1805,shaman,enhancement,54,29,25
Niuniudada,illidan,1805,shaman,enhancement,84,39,45
Kltz,sargeras,1804,shaman,enhancement,41,23,18
Mercó,bleeding-hollow,1803,shaman,enhancement,54,31,23
Madonion,zuljin,1803,shaman,enhancement,60,31,29
Flabby,lightbringer,1802,shaman,enhancement,48,25,23
Darkcnight,stormrage,1801,shaman,enhancement,63,39,24
Blakki,barthilas,1801,shaman,enhancement,66,40,26
Xiaoxiaoxi,tichondrius,1801,shaman,enhancement,48,28,20
Stronghit,tichondrius,1801,shaman,enhancement,36,19,17
Bodai,magtheridon,1800,shaman,enhancement,48,32,16
Turbowolf,sargeras,1800,shaman,enhancement,98,43,55
Doomberrie,thrall,1798,shaman,enhancement,114,63,51
Landlordxx,area-52,1795,shaman,enhancement,52,32,20
Lavamon,illidan,1787,shaman,enhancement,72,41,31
Chillpoppin,emerald-dream,1784,shaman,enhancement,30,23,7
Zanderpla,kelthuzad,1783,shaman,enhancement,84,44,40
Wautyriex,area-52,1783,shaman,enhancement,48,23,25
Yakora,stormrage,1781,shaman,enhancement,66,41,25
Heisna,stormrage,1781,shaman,enhancement,288,153,135
Adalid,thrall,1780,shaman,enhancement,54,39,15
Garai,emerald-dream,1775,shaman,enhancement,135,69,66
Krovn,stormrage,1772,shaman,enhancement,60,33,27
Nomoreswap,zuljin,1767,shaman,enhancement,42,30,12
Novedz,illidan,1767,shaman,enhancement,62,32,30
Stonetides,tichondrius,1765,shaman,enhancement,30,21,9
Muisor,quelthalas,1763,shaman,enhancement,60,33,27
Biubiuz,tichondrius,1757,shaman,enhancement,102,63,39
Grommi,proudmoore,1752,shaman,enhancement,255,120,135
Beaviis,frostmourne,1749,shaman,enhancement,48,29,19
Soshatsumi,tichondrius,1749,shaman,enhancement,76,42,34
Shocksrus,arthas,1747,shaman,enhancement,78,44,34
Kalvishdam,dalaran,1746,shaman,enhancement,36,25,11
Kushnations,chogall,1746,shaman,enhancement,38,20,18
Metako,sargeras,1737,shaman,enhancement,71,38,33
Shinian,tichondrius,1733,shaman,enhancement,51,31,20
Thromjin,ragnaros,1731,shaman,enhancement,65,39,26
Badshock,tichondrius,1730,shaman,enhancement,24,22,2
Xaltas,moon-guard,1727,shaman,enhancement,78,49,29
Meataballa,the-underbog,1727,shaman,enhancement,42,24,18
Hurrikaine,dalaran,1723,shaman,enhancement,140,77,63
Doex,thrall,1723,shaman,enhancement,48,26,22
Reflexsivx,malganis,1722,shaman,enhancement,48,29,19
Shearx,illidan,1722,shaman,enhancement,75,43,32
Poizele,tichondrius,1717,shaman,enhancement,294,164,130
Nibrax,moknathal,1716,shaman,enhancement,36,19,17
Hallofcost,illidan,1715,shaman,enhancement,54,34,20
Gorillahazed,tichondrius,1713,shaman,enhancement,132,69,63
Cwippin,tichondrius,1712,shaman,enhancement,134,77,57
Asumo,azralon,1712,shaman,enhancement,75,41,34
Døømsdáy,thrall,1709,shaman,enhancement,96,54,42
Slapnarp,wyrmrest-accord,1709,shaman,enhancement,84,42,42
Stewtwo,illidan,1705,shaman,enhancement,39,22,17
Wrathics,emerald-dream,1702,shaman,enhancement,60,32,28
Plzbuffme,dalaran,1700,shaman,enhancement,78,46,32
Geeblast,area-52,1699,shaman,enhancement,68,42,26
Bbshock,stormrage,1698,shaman,enhancement,84,50,34
Nøname,azshara,1698,shaman,enhancement,167,87,80
Halfzugzug,sargeras,1697,shaman,enhancement,30,21,9
Axelsteel,illidan,1697,shaman,enhancement,48,21,27
Bitsuey,frostmourne,1696,shaman,enhancement,84,46,38
Stonetrog,blackrock,1695,shaman,enhancement,24,19,5
Synivabyatch,eonar,1695,shaman,enhancement,78,44,34
Tkarfuno,exodar,1694,shaman,enhancement,66,34,32
Thiccsha,moon-guard,1694,shaman,enhancement,54,24,30
Miketideson,proudmoore,1693,shaman,enhancement,72,38,34
Valkriie,tichondrius,1692,shaman,enhancement,31,20,11
Seltheran,tichondrius,1691,shaman,enhancement,42,29,13
Zappithorus,stormrage,1691,shaman,enhancement,36,24,12
Shamezee,stormreaver,1689,shaman,enhancement,47,22,25
Nyckysh,illidan,1688,shaman,enhancement,106,56,50
Jàro,thrall,1688,shaman,enhancement,42,20,22
Elryl,sargeras,1686,shaman,enhancement,116,64,52
Gorgonash,magtheridon,1684,shaman,enhancement,42,22,20
Durozu,tichondrius,1682,shaman,enhancement,36,18,18
Vortexfury,area-52,1682,shaman,enhancement,42,20,22
Haishoe,stormrage,1677,shaman,enhancement,58,35,23
Pla,tichondrius,1669,shaman,enhancement,162,91,71
Volkuul,zuljin,1669,shaman,enhancement,72,40,32
Sonofabat,spirestone,1669,shaman,enhancement,188,99,89
Onlyshams,dalaran,1666,shaman,enhancement,36,22,14
Hecks,malorne,1664,shaman,enhancement,96,51,45
Tandrian,daggerspine,1662,shaman,enhancement,36,18,18
Windflex,emerald-dream,1651,shaman,enhancement,85,43,42
Roysoy,stormrage,1648,shaman,enhancement,72,45,27
Judgeesham,bleeding-hollow,1647,shaman,enhancement,45,23,22
Volsdeep,illidan,1644,shaman,enhancement,52,31,21
Platanos,proudmoore,1644,shaman,enhancement,122,65,57
Elemores,tichondrius,1642,shaman,enhancement,66,40,26
Struck,emerald-dream,1639,shaman,enhancement,143,88,55
Murig,bladefist,1638,shaman,enhancement,57,34,23
Dalianyen,bladefist,1638,shaman,enhancement,40,19,21
Ràntòn,bleeding-hollow,1637,shaman,enhancement,35,24,11
Bòómz,stormrage,1637,shaman,enhancement,216,105,111
Seanan,tichondrius,1635,shaman,enhancement,48,31,17
Askpuntee,sargeras,1635,shaman,enhancement,42,25,17
Anadal,kargath,1634,shaman,enhancement,48,22,26
Clappadactyl,frostmourne,1631,shaman,enhancement,117,64,53
Orkuss,illidan,1631,shaman,enhancement,48,25,23
Thunderchad,jubeithos,1631,shaman,enhancement,50,25,25
Tettnanger,azralon,1630,shaman,enhancement,31,19,12
Slashpity,stormrage,1630,shaman,enhancement,63,33,30
Shámdemons,area-52,1629,shaman,enhancement,96,58,38
Omaguap,tichondrius,1628,shaman,enhancement,50,29,21
Toobeastly,deathwing,1628,shaman,enhancement,42,24,18
Crownsx,tichondrius,1628,shaman,enhancement,37,17,20
Wingshaman,illidan,1626,shaman,enhancement,220,114,106
Hxzard,stormrage,1626,shaman,enhancement,36,17,19
Stormbash,ragnaros,1626,shaman,enhancement,54,23,31
Åvarice,shattered-halls,1626,shaman,enhancement,54,22,32
Alablast,malganis,1625,shaman,enhancement,36,21,15
Jyupaonaiwa,tichondrius,1625,shaman,enhancement,30,17,13
Addroi,tichondrius,1625,shaman,enhancement,30,17,13
Shockdome,daggerspine,1624,shaman,enhancement,33,23,10
Shamom,silver-hand,1624,shaman,enhancement,112,64,48
Täcti,tichondrius,1624,shaman,enhancement,87,46,41
Zapnclap,tichondrius,1623,shaman,enhancement,42,24,18
Smash,fenris,1623,shaman,enhancement,82,42,40
Ironaddictz,kiljaeden,1620,shaman,enhancement,51,30,21
Venmoo,illidan,1620,shaman,enhancement,42,20,22
Ceasebelief,tichondrius,1619,shaman,enhancement,30,21,9
Deyodin,illidan,1619,shaman,enhancement,26,18,8
Krûde,tichondrius,1617,shaman,enhancement,101,61,40
Shamgawd,illidan,1617,shaman,enhancement,36,20,16
Justkitettv,stormrage,1616,shaman,enhancement,30,20,10
Deww,sargeras,1616,shaman,enhancement,58,29,29
Keeba,wyrmrest-accord,1615,shaman,enhancement,48,27,21
Forksin,tichondrius,1615,shaman,enhancement,48,20,28
Stýlébéñdér,kelthuzad,1613,shaman,enhancement,24,17,7
Ryuuraix,area-52,1610,shaman,enhancement,27,18,9
Robdaman,tichondrius,1607,shaman,enhancement,24,18,6
Egirlshmu,stormrage,1606,shaman,enhancement,48,28,20
Kindaretro,tichondrius,1605,shaman,enhancement,42,27,15
Rêngoku,dalaran,1604,shaman,enhancement,30,22,8
Soupi,illidan,1602,shaman,enhancement,78,45,33
Totemnikiel,stormrage,1602,shaman,enhancement,84,39,45
Lenin,nathrezim,1600,shaman,enhancement,36,23,13
Hellamental,malganis,1598,shaman,enhancement,42,22,20
Revtide,thrall,1597,shaman,enhancement,30,19,11
Eliteshamann,tichondrius,1596,shaman,enhancement,54,30,24
Eyecandi,barthilas,1595,shaman,enhancement,151,76,75
Aibheit,area-52,1592,shaman,enhancement,24,22,2
Jerykco,drakkari,1591,shaman,enhancement,36,20,16
Furrybâstard,wyrmrest-accord,1587,shaman,enhancement,60,35,25
Dankthunda,stormrage,1586,shaman,enhancement,120,67,53
Mobiediqônú,skywall,1586,shaman,enhancement,36,19,17
Tootshock,illidan,1585,shaman,enhancement,42,21,21
Deemmorti,stormrage,1584,shaman,enhancement,46,26,20
Sinestario,illidan,1584,shaman,enhancement,94,53,41
Youngmulakek,area-52,1581,shaman,enhancement,42,31,11
Mixn,frostmourne,1581,shaman,enhancement,89,56,33
Zavar,tichondrius,1579,shaman,enhancement,77,40,37
Harrìson,tichondrius,1575,shaman,enhancement,29,17,12
Gambazzlok,terokkar,1574,shaman,enhancement,48,28,20
Thunda,black-dragonflight,1572,shaman,enhancement,30,21,9
Zeroshocks,kelthuzad,1572,shaman,enhancement,30,19,11
Shamanees,area-52,1572,shaman,enhancement,147,73,74
Nÿh,quelthalas,1569,shaman,enhancement,48,27,21
Ðr,earthen-ring,1569,shaman,enhancement,104,57,47
Mobi,tichondrius,1569,shaman,enhancement,36,17,19
Aoshiferuzz,ragnaros,1566,shaman,enhancement,78,43,35
Shmnsm,kiljaeden,1565,shaman,enhancement,42,18,24
Lyrzsa,blackwing-lair,1562,shaman,enhancement,74,46,28
Uracemytotem,kiljaeden,1562,shaman,enhancement,84,51,33
Heäven,malganis,1561,shaman,enhancement,163,88,75
Shakerina,azralon,1561,shaman,enhancement,62,26,36
Zmogon,quelthalas,1559,shaman,enhancement,38,19,19
ßurstmedaddy,bleeding-hollow,1557,shaman,enhancement,36,27,9
Cayed,stormscale,1553,shaman,enhancement,84,44,40
Dirtyunique,tichondrius,1549,shaman,enhancement,84,49,35
Speedrush,nagrand,1546,shaman,enhancement,38,25,13
Shockmehard,area-52,1545,shaman,enhancement,71,57,14
Lavawreckage,malganis,1544,shaman,enhancement,122,66,56
Thilv,ravenholdt,1543,shaman,enhancement,30,19,11
Udb,the-scryers,1542,shaman,enhancement,53,32,21
Mindfields,barthilas,1542,shaman,enhancement,73,42,31
Grx,tichondrius,1539,shaman,enhancement,41,22,19
Small,alleria,1538,shaman,enhancement,60,32,28
Wortwort,tichondrius,1537,shaman,enhancement,99,49,50
Pedaphil,frostmourne,1534,shaman,enhancement,24,16,8
Anzet,ragnaros,1534,shaman,enhancement,24,16,8
Shamgødx,dalaran,1533,shaman,enhancement,18,16,2
Derzwaz,draka,1532,shaman,enhancement,29,17,12
Killavicious,area-52,1531,shaman,enhancement,84,39,45
Khormac,moon-guard,1529,shaman,enhancement,64,43,21
Larrylardazz,tichondrius,1529,shaman,enhancement,85,51,34
Chaposz,tichondrius,1529,shaman,enhancement,73,40,33
Split,zuljin,1529,shaman,enhancement,172,93,79
Loadiez,frostmourne,1527,shaman,enhancement,30,21,9
Shamwows,dalaran,1527,shaman,enhancement,171,84,87
Gordonramsai,sargeras,1526,shaman,enhancement,30,21,9
Nonomori,frostmourne,1526,shaman,enhancement,36,17,19
Beaversniper,tichondrius,1523,shaman,enhancement,72,34,38
Vulcänyr,quelthalas,1522,shaman,enhancement,30,16,14
Thewindman,sargeras,1520,shaman,enhancement,60,27,33
Jamieslays,korgath,1519,shaman,enhancement,47,22,25
Solka,illidan,1518,shaman,enhancement,54,32,22
Tumble,frostmourne,1516,shaman,enhancement,97,53,44
Smartbunny,illidan,1516,shaman,enhancement,246,121,125
Flirstatic,nemesis,1512,shaman,enhancement,135,73,62
Deshamann,illidan,1507,shaman,enhancement,59,24,35
Maribain,barthilas,1505,shaman,enhancement,88,54,34
Elementin,kelthuzad,1503,shaman,enhancement,96,46,50
Yildiri,area-52,1501,shaman,enhancement,18,16,2
Kronkxd,malganis,1501,shaman,enhancement,30,16,14
Pingatronx,ragnaros,1500,shaman,enhancement,43,31,12
Pockethealer,emerald-dream,1497,shaman,enhancement,131,71,60
Justincasé,sargeras,1494,shaman,enhancement,66,31,35
Azumaa,tichondrius,1493,shaman,enhancement,30,16,14
Earthfirex,ragnaros,1493,shaman,enhancement,48,25,23
Hephron,area-52,1493,shaman,enhancement,72,32,40
Quakenbake,emerald-dream,1491,shaman,enhancement,33,20,13
Daddymacktv,malganis,1490,shaman,enhancement,50,23,27
Tyranitaur,frostmourne,1490,shaman,enhancement,60,24,36
Bräindëad,hyjal,1487,shaman,enhancement,84,46,38
Hungnuts,sargeras,1487,shaman,enhancement,124,67,57
Jäyp,thrall,1486,shaman,enhancement,52,30,22
Taowth,tichondrius,1486,shaman,enhancement,29,16,13
Shoresy,kaelthas,1485,shaman,enhancement,42,22,20
Çhïcagø,aegwynn,1484,shaman,enhancement,41,16,25
Konga,korialstrasz,1483,shaman,enhancement,38,22,16
Shalkahn,malganis,1480,shaman,enhancement,35,17,18
Ragnarocck,sargeras,1479,shaman,enhancement,75,36,39
Dashmmy,dalaran,1478,shaman,enhancement,54,26,28
Armønixx,ragnaros,1476,shaman,enhancement,120,65,55
Falasha,bloodscalp,1475,shaman,enhancement,46,27,19
Zugzugenh,stormrage,1475,shaman,enhancement,36,18,18
Abigdude,frostmourne,1474,shaman,enhancement,107,57,50
Lakindrentv,gorefiend,1467,shaman,enhancement,30,17,13
Dilfmaster,tichondrius,1467,shaman,enhancement,51,26,25
Mackandal,tichondrius,1466,shaman,enhancement,86,43,43
Skyzik,area-52,1465,shaman,enhancement,54,34,20
Woof,agamaggan,1464,shaman,enhancement,30,16,14
Earthlsflat,tichondrius,1463,shaman,enhancement,31,21,10
Daddyzap,stormrage,1462,shaman,enhancement,104,58,46
Somebozo,darkspear,1462,shaman,enhancement,109,52,57
Shockolatte,sargeras,1460,shaman,enhancement,55,20,35
Lavabone,dalaran,1459,shaman,enhancement,66,28,38
Arlikai,arthas,1459,shaman,enhancement,89,35,54
Sndhlp,tichondrius,1457,shaman,enhancement,46,29,17
Shabenn,proudmoore,1457,shaman,enhancement,60,26,34
Rexoss,hyjal,1454,shaman,enhancement,123,64,59
Iamurfather,magtheridon,1453,shaman,enhancement,107,55,52
Amasaei,bleeding-hollow,1453,shaman,enhancement,54,26,28
Usul,frostmane,1451,shaman,enhancement,60,34,26
Hehew,kelthuzad,1451,shaman,enhancement,48,27,21
Scrötotem,saurfang,1450,shaman,enhancement,83,47,36
Goribash,wyrmrest-accord,1449,shaman,enhancement,42,26,16
Calich,kelthuzad,1445,shaman,enhancement,38,23,15
Odïn,tichondrius,1444,shaman,enhancement,54,33,21
Makocc,tichondrius,1440,shaman,enhancement,74,33,41
Drakkaa,tichondrius,1439,shaman,enhancement,31,20,11
Sswf,auchindoun,1439,shaman,enhancement,24,15,9
Teeroll,frostmourne,1439,shaman,enhancement,41,25,16
Exxosenh,tichondrius,1438,shaman,enhancement,18,15,3
Tamtam,gorefiend,1438,shaman,enhancement,24,15,9
Gundar,chogall,1436,shaman,enhancement,56,31,25
Dimitrio,azralon,1436,shaman,enhancement,48,22,26
Qvibin,tichondrius,1435,shaman,enhancement,30,21,9
Arque,stormrage,1435,shaman,enhancement,78,49,29
Overpowered,korgath,1435,shaman,enhancement,24,15,9
Tungusk,tichondrius,1435,shaman,enhancement,24,15,9
Däbü,tichondrius,1435,shaman,enhancement,30,15,15
Friednocap,kelthuzad,1435,shaman,enhancement,48,21,27
Rojhaz,stormrage,1433,shaman,enhancement,48,28,20
Cuzcuz,tichondrius,1431,shaman,enhancement,24,15,9
Whydead,sargeras,1431,shaman,enhancement,72,40,32
Djasura,blackhand,1430,shaman,enhancement,53,29,24
Earfshock,thrall,1428,shaman,enhancement,74,41,33
Convolutedx,tichondrius,1427,shaman,enhancement,30,15,15
Grippysockz,dalaran,1424,shaman,enhancement,24,15,9
Killbro,blackrock,1424,shaman,enhancement,98,50,48
Cowely,madoran,1423,shaman,enhancement,30,17,13
Rtÿo,area-52,1422,shaman,enhancement,24,15,9
Raazzasham,moon-guard,1422,shaman,enhancement,65,34,31
Silyshamshyt,stormrage,1421,shaman,enhancement,24,15,9
Ginjij,thrall,1419,shaman,enhancement,24,15,9
Atthegates,illidan,1416,shaman,enhancement,96,38,58
Clownshòes,tichondrius,1415,shaman,enhancement,42,26,16
Tyven,tichondrius,1415,shaman,enhancement,42,17,25
Mudroller,moon-guard,1414,shaman,enhancement,52,24,28
Spacex,velen,1413,shaman,enhancement,36,16,20
Frëdstorm,kelthuzad,1410,shaman,enhancement,125,54,71
Raylord,ragnaros,1406,shaman,enhancement,131,72,59
Nankdug,tichondrius,1405,shaman,enhancement,47,25,22
Zzar,daggerspine,1404,shaman,enhancement,42,23,19
Prymalfury,illidan,1404,shaman,enhancement,96,46,50
Neyter,azralon,1403,shaman,enhancement,59,42,17
Surtel,tichondrius,1401,shaman,enhancement,66,28,38
Ventus,thrall,1399,shaman,enhancement,60,27,33
Clenlift,emerald-dream,1398,shaman,enhancement,162,83,79
Scrototëm,azralon,1398,shaman,enhancement,57,27,30
Gaelfury,malganis,1396,shaman,enhancement,48,23,25
Djelemental,darkspear,1394,shaman,enhancement,27,17,10
Shamann,azshara,1393,shaman,enhancement,57,29,28
Stickysham,illidan,1391,shaman,enhancement,42,26,16
Neyavv,tichondrius,1390,shaman,enhancement,97,48,49
Kohatan,moon-guard,1389,shaman,enhancement,50,26,24
Groundfaults,bleeding-hollow,1389,shaman,enhancement,35,15,20
Shipmatekev,sargeras,1386,shaman,enhancement,54,29,25
Zktz,warsong,1385,shaman,enhancement,31,17,14
Rbmx,frostmourne,1384,shaman,enhancement,70,41,29
Lazugga,area-52,1378,shaman,enhancement,80,42,38
Saphage,tichondrius,1376,shaman,enhancement,30,15,15
Tyzek,illidan,1375,shaman,enhancement,42,26,16
Fhenh,proudmoore,1375,shaman,enhancement,70,37,33
Stubbywayne,area-52,1374,shaman,enhancement,172,83,89
Gettatotem,frostmourne,1373,shaman,enhancement,30,17,13
Getacho,stormrage,1373,shaman,enhancement,108,48,60
Shamrockcawk,malganis,1372,shaman,enhancement,30,21,9
Lagroupie,ragnaros,1372,shaman,enhancement,23,15,8
Montí,moon-guard,1361,shaman,enhancement,83,51,32
Grohltusk,barthilas,1360,shaman,enhancement,42,24,18
Blasho,ragnaros,1360,shaman,enhancement,60,27,33
Borwald,dalaran,1359,shaman,enhancement,96,48,48
Johnwilke,area-52,1356,shaman,enhancement,119,59,60
Murlook,sargeras,1354,shaman,enhancement,67,44,23
Hagass,tichondrius,1354,shaman,enhancement,55,26,29
Isbabani,moon-guard,1353,shaman,enhancement,30,16,14
Argrax,sargeras,1350,shaman,enhancement,36,24,12
Chalked,stormrage,1348,shaman,enhancement,93,46,47
Orcshamen,tichondrius,1347,shaman,enhancement,42,24,18
Mybadshawty,tichondrius,1347,shaman,enhancement,72,32,40
Drumman,skullcrusher,1346,shaman,enhancement,70,39,31
Bessame,sargeras,1346,shaman,enhancement,94,48,46
Futeboy,tichondrius,1343,shaman,enhancement,24,14,10
Keyturns,tichondrius,1342,shaman,enhancement,18,14,4
Døømwinds,tichondrius,1342,shaman,enhancement,24,14,10
Dugomik,malganis,1342,shaman,enhancement,77,39,38
Tsaheylu,barthilas,1342,shaman,enhancement,48,22,26
Rngena,trollbane,1341,shaman,enhancement,24,14,10
Dashinra,stormrage,1341,shaman,enhancement,26,15,11
Clumpen,thunderhorn,1341,shaman,enhancement,29,16,13
Stormwolf,emerald-dream,1341,shaman,enhancement,42,23,19
Dä,tichondrius,1341,shaman,enhancement,30,14,16
Joeschno,bleeding-hollow,1341,shaman,enhancement,41,16,25
Crøwgød,tichondrius,1340,shaman,enhancement,24,14,10
Mairn,tichondrius,1338,shaman,enhancement,54,28,26
Stormgraves,moon-guard,1337,shaman,enhancement,24,14,10
Dorta,azralon,1337,shaman,enhancement,30,14,16
Leaning,wyrmrest-accord,1335,shaman,enhancement,24,14,10
Tuugo,mannoroth,1334,shaman,enhancement,24,14,10
Aldinatir,ragnaros,1332,shaman,enhancement,24,14,10
Atroll,moonrunner,1332,shaman,enhancement,66,30,36
Flaméy,stormrage,1332,shaman,enhancement,45,20,25
Chapope,quelthalas,1329,shaman,enhancement,46,30,16
Niteshammy,lothar,1328,shaman,enhancement,24,14,10
Cbomberz,tichondrius,1328,shaman,enhancement,61,31,30
Psilocypher,nazjatar,1327,shaman,enhancement,26,19,7
Shomani,madoran,1326,shaman,enhancement,41,17,24
Leschaises,skullcrusher,1325,shaman,enhancement,27,18,9
Zheúz,azralon,1324,shaman,enhancement,38,18,20
Baloneyfiveo,kiljaeden,1322,shaman,enhancement,56,31,25
Firevag,hakkar,1321,shaman,enhancement,72,38,34
Canabal,eonar,1315,shaman,enhancement,24,14,10
Zügz,illidan,1314,shaman,enhancement,37,22,15
Kungfuvoodoo,tichondrius,1314,shaman,enhancement,24,14,10
Rokogg,thrall,1312,shaman,enhancement,133,69,64
Kushgodd,kiljaeden,1312,shaman,enhancement,30,14,16
Shamorrhoids,frostmourne,1311,shaman,enhancement,118,62,56
Harvesting,azralon,1311,shaman,enhancement,30,14,16
Trashfarmer,tichondrius,1311,shaman,enhancement,102,46,56
Eze,tichondrius,1306,shaman,enhancement,58,36,22
Díesel,azralon,1306,shaman,enhancement,29,14,15
Obeilius,illidan,1303,shaman,enhancement,49,25,24
Whichdoctah,proudmoore,1302,shaman,enhancement,30,14,16
Lightnessx,stormrage,1301,shaman,enhancement,42,17,25
Microwavbakn,emerald-dream,1300,shaman,enhancement,70,38,32
Tizzl,kelthuzad,1300,shaman,enhancement,60,29,31
Astrò,illidan,1299,shaman,enhancement,18,14,4
Rongkhan,tichondrius,1296,shaman,enhancement,41,23,18
Vapus,area-52,1294,shaman,enhancement,89,47,42
Yâmz,area-52,1292,shaman,enhancement,51,21,30
Sigir,darrowmere,1290,shaman,enhancement,36,16,20
Pandashamnda,area-52,1288,shaman,enhancement,34,18,16
Lilpump,boulderfist,1286,shaman,enhancement,60,32,28
Dàfèng,wyrmrest-accord,1286,shaman,enhancement,41,14,27
Jackofstorms,veknilash,1285,shaman,enhancement,56,25,31
Sockittooya,bleeding-hollow,1282,shaman,enhancement,18,14,4
Piffenstien,malganis,1282,shaman,enhancement,54,25,29
Shometrin,tichondrius,1282,shaman,enhancement,35,15,20
Torgami,tichondrius,1274,shaman,enhancement,23,14,9
Lüca,wyrmrest-accord,1274,shaman,enhancement,148,73,75
Zechary,proudmoore,1273,shaman,enhancement,54,33,21
Fyahchaming,drakkari,1271,shaman,enhancement,46,24,22
Popsmoke,gnomeregan,1265,shaman,enhancement,23,14,9
Datblueboi,dalaran,1263,shaman,enhancement,76,39,37
Gorebog,feathermoon,1259,shaman,enhancement,42,23,19
Obrahma,burning-legion,1258,shaman,enhancement,24,16,8
Deathjoker,icecrown,1255,shaman,enhancement,66,34,32
Taò,tichondrius,1254,shaman,enhancement,75,37,38
Holosoul,bleeding-hollow,1254,shaman,enhancement,67,27,40
Rikswordfire,wyrmrest-accord,1251,shaman,enhancement,35,16,19
Beardcramps,tichondrius,1250,shaman,enhancement,57,20,37
Bigsquatzy,bleeding-hollow,1247,shaman,enhancement,24,13,11
Forgediniron,stormrage,1247,shaman,enhancement,36,17,19
Freyía,illidan,1246,shaman,enhancement,18,13,5
Hexoffnder,zuljin,1246,shaman,enhancement,18,13,5
Sin,bleeding-hollow,1246,shaman,enhancement,18,13,5
Yucasinmojo,illidan,1245,shaman,enhancement,19,13,6
Shamcowhah,frostmourne,1245,shaman,enhancement,24,13,11
Dalthragoz,tichondrius,1239,shaman,enhancement,24,13,11
Blackenergy,stormrage,1238,shaman,enhancement,24,13,11
Dalsun,turalyon,1237,shaman,enhancement,30,13,17
Githealed,kelthuzad,1234,shaman,enhancement,27,15,12
Vozs,proudmoore,1233,shaman,enhancement,60,34,26
Thromir,blackwing-lair,1233,shaman,enhancement,48,22,26
Willy,icecrown,1230,shaman,enhancement,23,13,10
Magmao,quelthalas,1228,shaman,enhancement,44,25,19
Lamagra,nemesis,1227,shaman,enhancement,18,13,5
Kasukaga,shadowmoon,1227,shaman,enhancement,54,23,31
Kamíhameha,stormrage,1226,shaman,enhancement,56,26,30
Lavalavalava,dentarg,1225,shaman,enhancement,18,13,5
Uglykunt,barthilas,1224,shaman,enhancement,111,62,49
Netherfury,illidan,1224,shaman,enhancement,51,28,23
Totesmagotes,scilla,1223,shaman,enhancement,18,13,5
Shamantwo,windrunner,1223,shaman,enhancement,24,13,11
Mullten,sargeras,1219,shaman,enhancement,36,15,21
Prasu,spirestone,1217,shaman,enhancement,34,14,20
Shamgoddam,illidan,1217,shaman,enhancement,48,19,29
Crigga,dalaran,1216,shaman,enhancement,24,13,11
Onezap,trollbane,1214,shaman,enhancement,43,17,26
Hammeredd,hyjal,1212,shaman,enhancement,36,18,18
Fireclaws,bleeding-hollow,1206,shaman,enhancement,36,16,20
Sheared,emerald-dream,1205,shaman,enhancement,26,14,12
Slowgrath,burning-legion,1202,shaman,enhancement,33,19,14
Sinsar,illidan,1200,shaman,enhancement,35,13,22
Trenbolone,maiev,1196,shaman,enhancement,49,27,22
Triní,ragnaros,1191,shaman,enhancement,39,22,17
Iamegirl,moon-guard,1191,shaman,enhancement,29,13,16
Mëister,stormrage,1191,shaman,enhancement,77,34,43
Gdiafplox,thunderhorn,1186,shaman,enhancement,54,27,27
Djshammy,barthilas,1183,shaman,enhancement,28,15,13
Àspec,aegwynn,1182,shaman,enhancement,16,13,3
Hanhze,quelthalas,1178,shaman,enhancement,48,28,20
Spiderjohn,sargeras,1177,shaman,enhancement,36,20,16
Enhancementz,azralon,1174,shaman,enhancement,68,37,31
Litchuckie,thrall,1169,shaman,enhancement,46,25,21
Mortzor,frostmourne,1166,shaman,enhancement,23,13,10
Meattoilet,tichondrius,1164,shaman,enhancement,17,13,4
Finnaburstt,tichondrius,1162,shaman,enhancement,54,29,25
Parallels,blackrock,1161,shaman,enhancement,52,20,32
Camdoc,destromath,1156,shaman,enhancement,41,19,22
Robis,thrall,1156,shaman,enhancement,84,38,46
Splendapapi,stormrage,1155,shaman,enhancement,38,13,25
Gangmember,shadowmoon,1152,shaman,enhancement,18,12,6
Cyclrin,sargeras,1152,shaman,enhancement,18,12,6
Jinxicle,illidan,1151,shaman,enhancement,18,12,6
Daysub,crushridge,1151,shaman,enhancement,18,12,6
Meiku,emerald-dream,1151,shaman,enhancement,24,12,12
Lutheran,dragonmaw,1151,shaman,enhancement,35,14,21
Nyknicks,tichondrius,1150,shaman,enhancement,18,12,6
Arázi,wyrmrest-accord,1150,shaman,enhancement,24,12,12
Dialtone,blackrock,1150,shaman,enhancement,30,12,18
Rainjig,emerald-dream,1149,shaman,enhancement,21,12,9
Olíndo,tichondrius,1146,shaman,enhancement,18,12,6
Goonxdz,illidan,1146,shaman,enhancement,24,12,12
Zèus,draka,1146,shaman,enhancement,24,12,12
Slapchainz,tichondrius,1146,shaman,enhancement,24,12,12
Katojune,tichondrius,1144,shaman,enhancement,21,13,8
Saraguthix,dalaran,1141,shaman,enhancement,18,12,6
Fourstorms,gundrak,1141,shaman,enhancement,37,19,18
Extraguacpls,tichondrius,1139,shaman,enhancement,18,12,6
Wagar,dawnbringer,1139,shaman,enhancement,30,12,18
Sydstorm,frostmourne,1137,shaman,enhancement,18,12,6
Popz,dark-iron,1128,shaman,enhancement,18,12,6
ßøn,altar-of-storms,1125,shaman,enhancement,33,16,17
Astroglyde,emerald-dream,1123,shaman,enhancement,24,12,12
Shøxic,perenolde,1118,shaman,enhancement,18,12,6
Drokron,azralon,1118,shaman,enhancement,36,17,19
Catiçero,azralon,1117,shaman,enhancement,30,12,18
Hazak,nemesis,1113,shaman,enhancement,66,34,32
Schlemiel,barthilas,1112,shaman,enhancement,82,36,46
Cseril,bonechewer,1111,shaman,enhancement,71,41,30
Lassoway,illidan,1110,shaman,enhancement,30,12,18
Golkork,quelthalas,1108,shaman,enhancement,24,13,11
Hordeymaori,jubeithos,1103,shaman,enhancement,110,58,52
Shaminism,chromaggus,1103,shaman,enhancement,23,12,11
Wigwog,hyjal,1102,shaman,enhancement,61,35,26
Ashida,stormrage,1086,shaman,enhancement,26,14,12
Oreahsham,tichondrius,1085,shaman,enhancement,30,12,18
Nîghtstalker,vashj,1081,shaman,enhancement,52,20,32
Svddëndëath,sargeras,1079,shaman,enhancement,60,22,38
Shamikkazee,illidan,1073,shaman,enhancement,31,14,17
Ctrlaltelite,burning-blade,1071,shaman,enhancement,48,17,31
Chesos,tichondrius,1066,shaman,enhancement,38,13,25
Tekashi,muradin,1060,shaman,enhancement,31,12,19
Gamergirlx,area-52,1056,shaman,enhancement,18,11,7
Jyster,area-52,1056,shaman,enhancement,65,27,38
Shamawolf,stormrage,1055,shaman,enhancement,12,11,1
Juliojones,trollbane,1055,shaman,enhancement,18,11,7
Shinydiglett,area-52,1055,shaman,enhancement,18,11,7
Enhance,bleeding-hollow,1055,shaman,enhancement,24,11,13
Shampowl,jaedenar,1055,shaman,enhancement,30,11,19
Möuthbläster,malganis,1054,shaman,enhancement,12,11,1
Syraak,elune,1054,shaman,enhancement,15,12,3
Jirig,tichondrius,1054,shaman,enhancement,18,11,7
Khorgan,emerald-dream,1054,shaman,enhancement,18,11,7
Balldo,stormrage,1054,shaman,enhancement,30,11,19
Buffdudé,illidan,1052,shaman,enhancement,24,11,13
Peepingtotem,tichondrius,1052,shaman,enhancement,24,11,13
Faminex,dragonmaw,1051,shaman,enhancement,12,11,1
Elementalïst,durotan,1051,shaman,enhancement,18,11,7
Swapxylee,tichondrius,1051,shaman,enhancement,24,11,13
Naesala,thunderlord,1050,shaman,enhancement,24,11,13
Dronesum,tichondrius,1050,shaman,enhancement,24,11,13
Totegoat,nazjatar,1050,shaman,enhancement,30,11,19
Scams,bleeding-hollow,1049,shaman,enhancement,30,18,12
Vöödooranger,stormrage,1048,shaman,enhancement,18,11,7
Spicyballs,coilfang,1048,shaman,enhancement,24,11,13
Grindl,stormrage,1047,shaman,enhancement,18,11,7
Sparkqt,sargeras,1047,shaman,enhancement,18,11,7
Emptyy,azralon,1047,shaman,enhancement,24,11,13
Johnnygeh,stormrage,1047,shaman,enhancement,30,11,19
Îvôry,bloodhoof,1046,shaman,enhancement,24,11,13
Stormwolf,azjolnerub,1045,shaman,enhancement,36,20,16
Jamblee,sargeras,1043,shaman,enhancement,18,11,7
Beanerburst,frostwolf,1042,shaman,enhancement,30,14,16
Trulos,stormrage,1041,shaman,enhancement,18,11,7
Bobaflexqt,korgath,1039,shaman,enhancement,18,11,7
Hannibol,tichondrius,1036,shaman,enhancement,72,25,47
Allmeatie,hyjal,1035,shaman,enhancement,18,11,7
Zalkran,area-52,1034,shaman,enhancement,24,15,9
Lovetides,area-52,1031,shaman,enhancement,24,14,10
Sevare,area-52,1023,shaman,enhancement,21,12,9
Tøtëm,tichondrius,1021,shaman,enhancement,28,12,16
Facebooksux,sargeras,1019,shaman,enhancement,18,13,5
Karlpoppa,thunderhorn,1019,shaman,enhancement,18,11,7
Raxabico,nemesis,1017,shaman,enhancement,32,12,20
Shayymann,exodar,1013,shaman,enhancement,48,19,29
Pùffball,anvilmar,1011,shaman,enhancement,57,29,28
Xapoxy,nemesis,1008,shaman,enhancement,20,12,8
Tukkutz,moon-guard,1006,shaman,enhancement,27,12,15
Dedlystorm,dalaran,1003,shaman,enhancement,18,12,6
Hoodfigga,tichondrius,1002,shaman,enhancement,23,11,12
Bigbólts,emerald-dream,1001,shaman,enhancement,18,12,6
Stroheim,warsong,1000,shaman,enhancement,21,12,9
Poseidonxd,lightbringer,1000,shaman,enhancement,23,13,10
Korgen,area-52,999,shaman,enhancement,25,12,13
Slaughterdog,coilfang,995,shaman,enhancement,22,13,9
Prinkipíssa,tichondrius,994,shaman,enhancement,36,16,20
Synshenrongt,thrall,990,shaman,enhancement,178,70,108
Pwnôgraphy,kelthuzad,989,shaman,enhancement,14,11,3
Zelzus,moon-guard,989,shaman,enhancement,22,11,11
Deckìn,proudmoore,987,shaman,enhancement,14,11,3
Dizzytotem,dalaran,987,shaman,enhancement,24,14,10
Shamvandám,kiljaeden,978,shaman,enhancement,30,13,17
Mudpwet,borean-tundra,974,shaman,enhancement,30,18,12
Shammybreakx,malganis,971,shaman,enhancement,35,20,15
Enhance,sargeras,960,shaman,enhancement,18,10,8
Mcb,barthilas,960,shaman,enhancement,18,10,8
Zatchbell,lightnings-blade,960,shaman,enhancement,30,13,17
Lokrath,zangarmarsh,959,shaman,enhancement,12,10,2
Pikachil,tichondrius,959,shaman,enhancement,15,11,4
Vonnsmallpp,area-52,959,shaman,enhancement,18,10,8
Kumboi,frostmourne,959,shaman,enhancement,24,10,14
Unezx,tichondrius,958,shaman,enhancement,12,10,2
Thoramgar,malganis,958,shaman,enhancement,18,10,8
Marginalized,tichondrius,958,shaman,enhancement,18,10,8
Ggsggs,akama,958,shaman,enhancement,18,10,8
Leotis,tichondrius,957,shaman,enhancement,18,10,8
Kandin,icecrown,957,shaman,enhancement,24,10,14
Keroh,blackrock,956,shaman,enhancement,18,10,8
Súrtr,sargeras,955,shaman,enhancement,18,10,8
ßigðåddy,ghostlands,955,shaman,enhancement,24,10,14
Aelpian,emerald-dream,954,shaman,enhancement,18,10,8
Ryntyntyn,blood-furnace,954,shaman,enhancement,24,10,14
Shomminn,tichondrius,953,shaman,enhancement,18,10,8
Pumpz,magtheridon,953,shaman,enhancement,24,10,14
Mcgraff,frostmourne,949,shaman,enhancement,18,10,8
Majhrakova,stormrage,946,shaman,enhancement,24,10,14
Bloodytotemz,emerald-dream,944,shaman,enhancement,18,10,8
Esko,magtheridon,943,shaman,enhancement,24,10,14
Thanwirn,ragnaros,924,shaman,enhancement,30,13,17
Wälee,sargeras,921,shaman,enhancement,18,10,8
Gammacide,sargeras,921,shaman,enhancement,29,10,19
Oct,thrall,912,shaman,enhancement,36,18,18
Grimlên,skullcrusher,910,shaman,enhancement,32,12,20
Duality,shattered-halls,909,shaman,enhancement,23,10,13
Orcmanshamn,moon-guard,902,shaman,enhancement,29,11,18
Ongruge,hyjal,895,shaman,enhancement,60,22,38
Orfelix,nemesis,889,shaman,enhancement,30,11,19
Poagrious,bonechewer,876,shaman,enhancement,40,17,23
ßlessedx,tichondrius,875,shaman,enhancement,17,10,7
Solbis,tichondrius,864,shaman,enhancement,12,9,3
Torvi,saurfang,864,shaman,enhancement,12,9,3
Raídyn,sargeras,864,shaman,enhancement,12,9,3
Conorfotm,tichondrius,864,shaman,enhancement,12,9,3
Deixw,tichondrius,864,shaman,enhancement,12,9,3
Frantìk,tichondrius,864,shaman,enhancement,12,9,3
Shlongers,illidan,864,shaman,enhancement,18,9,9
Purgegodryuu,area-52,864,shaman,enhancement,18,9,9
Sethbrogen,vashj,864,shaman,enhancement,24,9,15
Armîn,moon-guard,863,shaman,enhancement,12,9,3
Lickerman,stormreaver,863,shaman,enhancement,12,9,3
Flukz,nazjatar,863,shaman,enhancement,18,9,9
Massivebolts,stormrage,863,shaman,enhancement,18,9,9
Ephraalin,frostmourne,863,shaman,enhancement,18,9,9
Rubious,cenarius,863,shaman,enhancement,19,9,10
Okkoto,malfurion,862,shaman,enhancement,12,9,3
Tigtotem,malganis,861,shaman,enhancement,12,9,3
Gorgrom,thunderlord,861,shaman,enhancement,12,9,3
Shawkedu,tichondrius,861,shaman,enhancement,24,11,13
Dì,barthilas,859,shaman,enhancement,12,9,3
Vekku,ragnaros,858,shaman,enhancement,18,9,9
Denki,nesingwary,858,shaman,enhancement,18,9,9
Columan,frostmourne,858,shaman,enhancement,46,22,24
Hazorele,nagrand,857,shaman,enhancement,18,9,9
Bilbobaggenz,sargeras,854,shaman,enhancement,18,9,9
Cdont,zuljin,853,shaman,enhancement,18,9,9
Windfuryshm,emerald-dream,853,shaman,enhancement,18,9,9
Googurt,barthilas,831,shaman,enhancement,17,9,8
Taowth,area-52,831,shaman,enhancement,29,9,20
Grosgars,burning-blade,830,shaman,enhancement,20,10,10
Britisy,stormrage,825,shaman,enhancement,24,10,14
Garabashi,boulderfist,814,shaman,enhancement,21,9,12
Maicer,goldrinn,809,shaman,enhancement,29,9,20
Notglads,thrall,799,shaman,enhancement,14,9,5
Thorael,borean-tundra,798,shaman,enhancement,11,9,2
Forloren,zuljin,798,shaman,enhancement,22,9,13
Zêûs,moon-guard,768,shaman,enhancement,12,8,4
Clasm,tichondrius,768,shaman,enhancement,12,8,4
Cinderfury,magtheridon,768,shaman,enhancement,12,8,4
Movemaker,shattered-hand,768,shaman,enhancement,12,8,4
Totemclass,bleeding-hollow,768,shaman,enhancement,12,8,4
Onamakawash,black-dragonflight,768,shaman,enhancement,12,8,4
Blöw,tichondrius,768,shaman,enhancement,12,8,4
Ennoku,khadgar,768,shaman,enhancement,12,8,4
Plznostepmom,tichondrius,768,shaman,enhancement,12,8,4
Hagie,moon-guard,768,shaman,enhancement,15,8,7
Pinechanga,ragnaros,768,shaman,enhancement,18,8,10
Lindsanx,illidan,768,shaman,enhancement,18,8,10
Kinzle,tichondrius,768,shaman,enhancement,24,8,16
Elevatezxo,stormrage,767,shaman,enhancement,12,8,4
Faultline,khadgar,767,shaman,enhancement,12,8,4
Chavezlives,area-52,767,shaman,enhancement,12,8,4
Volrog,magtheridon,767,shaman,enhancement,18,8,10
Feroxture,frostmourne,767,shaman,enhancement,18,8,10
Cuban,kelthuzad,767,shaman,enhancement,18,8,10
Jags,baelgun,767,shaman,enhancement,18,8,10
Beast,mannoroth,767,shaman,enhancement,18,8,10
Finaplex,spirestone,767,shaman,enhancement,18,8,10
Loliqueenfae,illidan,767,shaman,enhancement,18,8,10
Reptimus,sargeras,767,shaman,enhancement,24,8,16
Pipers,frostmourne,767,shaman,enhancement,30,8,22
Chamxz,ragnaros,766,shaman,enhancement,12,8,4
Kulnash,auchindoun,766,shaman,enhancement,12,8,4
Xillas,moon-guard,766,shaman,enhancement,18,8,10
Adhdeeznuts,frostmourne,766,shaman,enhancement,18,8,10
Lazygemini,illidan,764,shaman,enhancement,18,8,10
Orendail,jubeithos,758,shaman,enhancement,24,8,16
Shimshak,destromath,756,shaman,enhancement,18,8,10
Kumu,stormscale,735,shaman,enhancement,11,8,3
Ryb,sargeras,735,shaman,enhancement,14,9,5
Töpg,garrosh,735,shaman,enhancement,16,8,8
Radan,kelthuzad,735,shaman,enhancement,17,8,9
Darshidarsh,emerald-dream,735,shaman,enhancement,22,8,14
Blackshami,quelthalas,718,shaman,enhancement,18,8,10
Pwnskillz,area-52,712,shaman,enhancement,17,8,9
Hammerdog,illidan,703,shaman,enhancement,16,8,8
Grìmlock,lightbringer,687,shaman,enhancement,13,8,5
Lavalinks,malganis,672,shaman,enhancement,12,7,5
Jofstrom,tichondrius,672,shaman,enhancement,12,7,5
Ftp,kelthuzad,672,shaman,enhancement,12,7,5
Battleimp,kelthuzad,672,shaman,enhancement,12,7,5
Yaytotems,sargeras,672,shaman,enhancement,12,7,5
Vásh,quelthalas,672,shaman,enhancement,12,7,5
Windführer,illidan,672,shaman,enhancement,12,7,5
Lividelement,area-52,672,shaman,enhancement,12,7,5
Vokxulsin,tichondrius,672,shaman,enhancement,12,7,5
Vlal,tichondrius,672,shaman,enhancement,12,7,5
Eimear,kelthuzad,672,shaman,enhancement,12,7,5
Oneripemango,illidan,672,shaman,enhancement,12,7,5
Asy,tichondrius,672,shaman,enhancement,12,7,5
Goondruka,area-52,672,shaman,enhancement,12,7,5
Mattzander,kiljaeden,672,shaman,enhancement,12,7,5
Pashå,norgannon,672,shaman,enhancement,12,7,5
Shockshack,illidan,672,shaman,enhancement,12,7,5
Zapstrike,stormrage,672,shaman,enhancement,12,7,5
Shokaria,frostwolf,672,shaman,enhancement,17,8,9
Kidkovid,illidan,672,shaman,enhancement,18,7,11
Stoneseed,steamwheedle-cartel,672,shaman,enhancement,18,7,11
Yungcreampie,bleeding-hollow,672,shaman,enhancement,18,7,11
Raywhiter,tichondrius,672,shaman,enhancement,22,8,14
Murm,burning-blade,671,shaman,enhancement,12,7,5
Checkmâte,emerald-dream,671,shaman,enhancement,12,7,5
Hexondabeach,barthilas,671,shaman,enhancement,12,7,5
Ayahuaska,darkspear,671,shaman,enhancement,12,7,5
Nondracil,ragnaros,671,shaman,enhancement,18,7,11
Gwyste,moon-guard,671,shaman,enhancement,18,7,11
Jëks,azjolnerub,671,shaman,enhancement,18,7,11
Zald,shattered-halls,671,shaman,enhancement,18,7,11
Hrotah,wyrmrest-accord,671,shaman,enhancement,18,7,11
Enhancee,bonechewer,671,shaman,enhancement,18,7,11
Azl,guldan,671,shaman,enhancement,21,8,13
Velekar,moon-guard,671,shaman,enhancement,21,8,13
Radiology,garithos,670,shaman,enhancement,12,7,5
Drewshammy,zuljin,670,shaman,enhancement,12,7,5
Morehammeerr,thunderlord,670,shaman,enhancement,12,7,5
Kigorami,nerzhul,670,shaman,enhancement,18,7,11
Orcgirth,kiljaeden,670,shaman,enhancement,21,8,13
Bhaelfury,moon-guard,669,shaman,enhancement,12,7,5
Halajo,thrall,669,shaman,enhancement,15,8,7
Vladd,hellscream,669,shaman,enhancement,18,7,11
Helljumper,illidan,669,shaman,enhancement,21,8,13
Thorre,the-scryers,666,shaman,enhancement,12,7,5
Blaçktide,thrall,665,shaman,enhancement,12,7,5
Shammich,vashj,655,shaman,enhancement,11,7,4
Speedmonster,hellscream,655,shaman,enhancement,19,8,11
Icedogg,malganis,652,shaman,enhancement,18,7,11
Relyts,tichondrius,638,shaman,enhancement,18,9,9
Rhagnar,warsong,623,shaman,enhancement,11,7,4
Thanen,the-scryers,608,shaman,enhancement,22,8,14
Intress,moon-guard,607,shaman,enhancement,10,7,3
Daikí,ragnaros,606,shaman,enhancement,16,7,9
Eanne,moon-guard,592,shaman,enhancement,19,7,12
Ftierspec,frostmourne,576,shaman,enhancement,6,6,0
Pikoom,tichondrius,576,shaman,enhancement,6,6,0
Nøtørious,thrall,576,shaman,enhancement,6,6,0
Shockpanda,zuljin,576,shaman,enhancement,6,6,0
Ambevsulfr,deathwing,576,shaman,enhancement,6,6,0
Angrymán,ragnaros,576,shaman,enhancement,6,6,0
Spotbeard,shadowsong,576,shaman,enhancement,6,6,0
Vuduü,stormrage,576,shaman,enhancement,6,6,0
Clear,darkspear,576,shaman,enhancement,6,6,0
Scarlo,bleeding-hollow,576,shaman,enhancement,12,6,6
Vultan,winterhoof,576,shaman,enhancement,12,6,6
Owtyobwol,area-52,576,shaman,enhancement,12,6,6
Vanklayser,ragnaros,576,shaman,enhancement,12,6,6
Kêtchpup,wyrmrest-accord,576,shaman,enhancement,12,6,6
Stnky,cairne,576,shaman,enhancement,12,6,6
Stormdancer,elune,576,shaman,enhancement,12,6,6
Nyvka,ragnaros,576,shaman,enhancement,12,6,6
Hruggol,bleeding-hollow,576,shaman,enhancement,12,6,6
Måståçåstå,bleeding-hollow,576,shaman,enhancement,12,6,6
Xaspen,skullcrusher,576,shaman,enhancement,12,6,6
Crucybletv,korgath,576,shaman,enhancement,12,6,6
Dreamers,anvilmar,576,shaman,enhancement,12,6,6
Gódsgíft,tichondrius,576,shaman,enhancement,12,6,6
Agpx,tichondrius,576,shaman,enhancement,12,6,6
Ayahuaskah,illidan,576,shaman,enhancement,12,6,6
Tosil,tichondrius,576,shaman,enhancement,12,6,6
Bussybutter,sargeras,576,shaman,enhancement,12,6,6
Cooperation,kelthuzad,576,shaman,enhancement,12,6,6
Orkshammy,illidan,576,shaman,enhancement,12,6,6
Uggoluga,dalaran,576,shaman,enhancement,12,6,6
Fischerman,barthilas,576,shaman,enhancement,12,6,6
Strønklesøn,drakthul,576,shaman,enhancement,12,6,6
Enhpower,area-52,576,shaman,enhancement,12,6,6
Shamwik,frostmourne,576,shaman,enhancement,12,6,6
Kyzen,tichondrius,576,shaman,enhancement,12,6,6
Groovesh,thrall,576,shaman,enhancement,14,6,8
Ikiteforlsd,zuljin,576,shaman,enhancement,14,6,8
Gluestick,shadowmoon,576,shaman,enhancement,18,6,12
Ferdashock,tichondrius,576,shaman,enhancement,18,6,12
Earthclap,tichondrius,576,shaman,enhancement,18,6,12
Argues,tichondrius,575,shaman,enhancement,12,6,6
Fevolution,dreadmaul,575,shaman,enhancement,12,6,6
Tumble,barthilas,575,shaman,enhancement,12,6,6
Naextramus,ragnaros,575,shaman,enhancement,12,6,6
Oaktar,bleeding-hollow,575,shaman,enhancement,12,6,6
Morderus,aegwynn,575,shaman,enhancement,12,6,6
Somethingdop,sargeras,575,shaman,enhancement,12,6,6
Gingeroo,stonemaul,575,shaman,enhancement,12,6,6
Eternalife,khazgoroth,575,shaman,enhancement,12,6,6
Darkvx,quelthalas,575,shaman,enhancement,12,6,6
Frèya,uldaman,575,shaman,enhancement,12,6,6
Nuofu,illidan,575,shaman,enhancement,16,7,9
Møp,spirestone,575,shaman,enhancement,18,6,12
Zeebouzy,illidan,575,shaman,enhancement,18,6,12
Talfur,area-52,575,shaman,enhancement,18,6,12
Okdopey,area-52,574,shaman,enhancement,18,6,12
Floon,barthilas,573,shaman,enhancement,24,6,18
Størmbreäker,tichondrius,572,shaman,enhancement,12,6,6
Hazreti,zuljin,572,shaman,enhancement,18,6,12
Fadesrp,moon-guard,571,shaman,enhancement,12,6,6
Charr,nemesis,571,shaman,enhancement,12,6,6
Ðg,tichondrius,569,shaman,enhancement,18,6,12
Maxsimiliano,emerald-dream,559,shaman,enhancement,18,6,12
Rykutu,lightbringer,544,shaman,enhancement,10,7,3
Gïrthquake,tichondrius,543,shaman,enhancement,8,7,1
Noveske,arthas,522,shaman,enhancement,15,7,8
Monadazs,ragnaros,511,shaman,enhancement,8,6,2
Slumb,stormrage,496,shaman,enhancement,13,6,7
Zaxibow,area-52,496,shaman,enhancement,19,6,13
Fiercegoblin,drakkari,493,shaman,enhancement,19,6,13
Zappiiboii,malganis,480,shaman,enhancement,6,5,1
Nekorii,bleeding-hollow,480,shaman,enhancement,6,5,1
Beatmán,blades-edge,480,shaman,enhancement,6,5,1
Mokho,stormrage,480,shaman,enhancement,6,5,1
Krunggar,azralon,480,shaman,enhancement,6,5,1
Mynigabob,zuljin,480,shaman,enhancement,6,5,1
Iava,dalaran,480,shaman,enhancement,6,5,1
Dörnèr,malganis,480,shaman,enhancement,6,5,1
Rokudo,dragonmaw,480,shaman,enhancement,6,5,1
Nakamora,tichondrius,480,shaman,enhancement,6,5,1
Bofah,draktharon,480,shaman,enhancement,6,5,1
Tactíc,chromaggus,480,shaman,enhancement,6,5,1
Thiccpedro,andorhal,480,shaman,enhancement,6,5,1
Slothycrit,emerald-dream,480,shaman,enhancement,6,5,1
Taintvapor,stormrage,480,shaman,enhancement,6,5,1
Wugmuk,illidan,480,shaman,enhancement,6,5,1
Tekdar,kiljaeden,480,shaman,enhancement,10,6,4
Sèktor,dalaran,480,shaman,enhancement,12,5,7
Tiostroke,stormrage,480,shaman,enhancement,12,5,7
Macumbolo,nemesis,480,shaman,enhancement,12,5,7
Stankydad,tichondrius,480,shaman,enhancement,12,5,7
Meatlog,dalaran,480,shaman,enhancement,12,5,7
Scrototæm,area-52,480,shaman,enhancement,12,5,7
Jonatasele,stormrage,480,shaman,enhancement,12,5,7
Matzahmeal,skywall,480,shaman,enhancement,12,5,7
Electrikz,moonrunner,480,shaman,enhancement,12,5,7
Capivarãão,stormrage,480,shaman,enhancement,12,5,7
Kuull,thunderlord,480,shaman,enhancement,12,5,7
Hroth,tanaris,480,shaman,enhancement,12,5,7
Indaka,kiljaeden,480,shaman,enhancement,12,5,7
Kamisenhance,illidan,480,shaman,enhancement,12,5,7
Sleepysham,anubarak,480,shaman,enhancement,12,5,7
Spencesham,sargeras,480,shaman,enhancement,12,5,7
Mustachex,kelthuzad,480,shaman,enhancement,12,5,7
Kultirio,quelthalas,480,shaman,enhancement,12,5,7
Azzula,tichondrius,480,shaman,enhancement,13,5,8
Gyokuken,stormrage,480,shaman,enhancement,18,5,13
Fíren,area-52,480,shaman,enhancement,18,5,13
Böc,tichondrius,479,shaman,enhancement,12,5,7
Dushkanar,barthilas,479,shaman,enhancement,12,5,7
Tugnar,ragnaros,479,shaman,enhancement,12,5,7
Aegaeonlol,tichondrius,479,shaman,enhancement,18,5,13
Paulenia,quelthalas,479,shaman,enhancement,21,5,16
Brorogan,aerie-peak,478,shaman,enhancement,12,5,7
Enkkiz,ragnaros,477,shaman,enhancement,12,5,7
Curtrex,amanthul,472,shaman,enhancement,19,8,11
Catchclause,eonar,463,shaman,enhancement,12,6,6
Flamestrife,illidan,426,shaman,enhancement,28,8,20
Megumi,aggramar,415,shaman,enhancement,8,5,3
Furiousnick,stormrage,415,shaman,enhancement,8,5,3
Lukora,stonemaul,384,shaman,enhancement,6,4,2
Tokyotimxxo,malganis,384,shaman,enhancement,6,4,2
Kylani,thrall,384,shaman,enhancement,6,4,2
Exsh,area-52,384,shaman,enhancement,6,4,2
Skipler,stormrage,384,shaman,enhancement,6,4,2
Utilitytotem,moon-guard,384,shaman,enhancement,6,4,2
Drugdòér,tichondrius,384,shaman,enhancement,6,4,2
Tarazhim,kelthuzad,384,shaman,enhancement,6,4,2
Ezzroz,guldan,384,shaman,enhancement,6,4,2
Garshok,tichondrius,384,shaman,enhancement,6,4,2
Firetrucks,area-52,384,shaman,enhancement,6,4,2
Bioshocked,korgath,384,shaman,enhancement,6,4,2
Dingfu,sargeras,384,shaman,enhancement,6,4,2
Wools,frostmourne,384,shaman,enhancement,6,4,2
Anlukla,gilneas,384,shaman,enhancement,6,4,2
Protoaster,tichondrius,384,shaman,enhancement,6,4,2
Aureal,malganis,384,shaman,enhancement,6,4,2
Mastrionilol,dragonmaw,384,shaman,enhancement,6,4,2
Grimwind,tichondrius,384,shaman,enhancement,6,4,2
Enanomka,drakkari,384,shaman,enhancement,6,4,2
Lizardhusk,barthilas,384,shaman,enhancement,6,4,2
Angrytotems,ragnaros,384,shaman,enhancement,6,4,2
Sorgal,area-52,384,shaman,enhancement,6,4,2
Meramin,illidan,384,shaman,enhancement,6,4,2
Kisseyfaçaí,kelthuzad,384,shaman,enhancement,6,4,2
Goldshîre,tichondrius,384,shaman,enhancement,6,4,2
Hooluu,frostmourne,384,shaman,enhancement,6,4,2
Jènova,whisperwind,384,shaman,enhancement,6,4,2
Slurslinger,area-52,384,shaman,enhancement,6,4,2
Eleshortal,azuremyst,384,shaman,enhancement,9,4,5
Smackzs,sargeras,384,shaman,enhancement,12,4,8
Wabfurrie,twisting-nether,384,shaman,enhancement,12,4,8
Piril,moon-guard,384,shaman,enhancement,12,4,8
Bloudabadee,emerald-dream,384,shaman,enhancement,12,4,8
Tictactotem,lothar,384,shaman,enhancement,12,4,8
Nìke,nazgrel,384,shaman,enhancement,12,4,8
Neeman,malganis,384,shaman,enhancement,12,4,8
Newele,thrall,384,shaman,enhancement,12,4,8
Gangdan,emerald-dream,384,shaman,enhancement,12,4,8
Emppege,tichondrius,384,shaman,enhancement,12,4,8
Kooj,frostmourne,384,shaman,enhancement,12,4,8
Nehrakgu,wyrmrest-accord,384,shaman,enhancement,12,4,8
Skizzymars,malganis,384,shaman,enhancement,12,4,8
Ironloins,kelthuzad,384,shaman,enhancement,12,4,8
Vertrág,malganis,384,shaman,enhancement,12,4,8
Omaboa,azgalor,384,shaman,enhancement,12,4,8
Kinnarlan,sargeras,384,shaman,enhancement,12,4,8
Gaurudon,zuljin,384,shaman,enhancement,12,4,8
Xoelement,borean-tundra,384,shaman,enhancement,18,4,14
Brenqt,nemesis,384,shaman,enhancement,18,4,14
Grimdil,quelthalas,384,shaman,enhancement,18,4,14
Jacniclstorm,frostmourne,383,shaman,enhancement,6,4,2
Ipponhim,saurfang,383,shaman,enhancement,6,4,2
Ghogann,bleeding-hollow,383,shaman,enhancement,6,4,2
Rhal,ragnaros,383,shaman,enhancement,6,4,2
Rocktor,alleria,383,shaman,enhancement,6,4,2
Toeto,darrowmere,383,shaman,enhancement,6,4,2
Ugaboogah,thrall,383,shaman,enhancement,6,4,2
Shambostik,thrall,383,shaman,enhancement,12,4,8
Kalashnikov,maiev,383,shaman,enhancement,12,4,8
Smolder,magtheridon,383,shaman,enhancement,12,4,8
Drokán,ragnaros,383,shaman,enhancement,20,5,15
Notahealz,zuljin,367,shaman,enhancement,11,4,7
Kyness,area-52,364,shaman,enhancement,13,5,8
Admetis,vashj,351,shaman,enhancement,17,4,13
Thorsén,ursin,335,shaman,enhancement,17,4,13
Jeaunoo,darkspear,330,shaman,enhancement,14,5,9
Totojar,alexstrasza,330,shaman,enhancement,16,5,11
Olani,nesingwary,319,shaman,enhancement,5,4,1
Sasageyo,tichondrius,319,shaman,enhancement,8,4,4
Habrith,proudmoore,319,shaman,enhancement,11,4,7
Xulangshammy,illidan,319,shaman,enhancement,11,4,7
Tempestsmash,tichondrius,304,shaman,enhancement,7,4,3
Bimbly,eitrigg,303,shaman,enhancement,13,4,9
Shammateur,malganis,288,shaman,enhancement,6,3,3
Defiant,azgalor,288,shaman,enhancement,6,3,3
Freshoranges,blood-furnace,288,shaman,enhancement,6,3,3
Gumballin,sargeras,288,shaman,enhancement,6,3,3
Shamaro,malganis,288,shaman,enhancement,6,3,3
Cluffatty,tichondrius,288,shaman,enhancement,6,3,3
Zeroshears,tichondrius,288,shaman,enhancement,6,3,3
Kubisham,warsong,288,shaman,enhancement,6,3,3
Drgreek,barthilas,288,shaman,enhancement,6,3,3
Slowdown,malganis,288,shaman,enhancement,6,3,3
Jumoma,thrall,288,shaman,enhancement,6,3,3
Arckos,thrall,288,shaman,enhancement,6,3,3
Gojiras,barthilas,288,shaman,enhancement,6,3,3
Totemtantrum,tichondrius,288,shaman,enhancement,6,3,3
Glexhex,tichondrius,288,shaman,enhancement,6,3,3
Swifteyy,area-52,288,shaman,enhancement,6,3,3
Aruçar,drakkari,288,shaman,enhancement,6,3,3
Yelpreviewer,dalaran,288,shaman,enhancement,6,3,3
Sourcreamqtx,stormrage,288,shaman,enhancement,6,3,3
Botu,malorne,288,shaman,enhancement,6,3,3
Spankì,kelthuzad,288,shaman,enhancement,6,3,3
Smokedemtree,stormrage,288,shaman,enhancement,6,3,3
Corkrain,sargeras,288,shaman,enhancement,6,3,3
Argena,bonechewer,288,shaman,enhancement,6,3,3
Owiez,sargeras,288,shaman,enhancement,6,3,3
Zapmavz,area-52,288,shaman,enhancement,6,3,3
Lennylemons,stormrage,288,shaman,enhancement,6,3,3
Morgoph,bleeding-hollow,288,shaman,enhancement,6,3,3
Haititnahtou,kaelthas,288,shaman,enhancement,6,3,3
Ulala,azshara,288,shaman,enhancement,6,3,3
Vanmaichet,azshara,288,shaman,enhancement,6,3,3
Getwetand,quelthalas,288,shaman,enhancement,6,3,3
Cars,jaedenar,288,shaman,enhancement,6,3,3
Bottlez,sargeras,288,shaman,enhancement,6,3,3
Electabuzz,arygos,288,shaman,enhancement,6,3,3
Dogcompany,tichondrius,288,shaman,enhancement,6,3,3
Jibbajabber,laughing-skull,288,shaman,enhancement,6,3,3
Zoma,elune,288,shaman,enhancement,6,3,3
Painfury,zuljin,288,shaman,enhancement,6,3,3
Luxenor,kelthuzad,288,shaman,enhancement,6,3,3
Xantíd,wyrmrest-accord,288,shaman,enhancement,6,3,3
Sleepysham,kelthuzad,288,shaman,enhancement,6,3,3
Stylebenderx,frostmourne,288,shaman,enhancement,6,3,3
Bovinefony,blackrock,288,shaman,enhancement,6,3,3
Thiccwater,frostmourne,288,shaman,enhancement,6,3,3
Suejitsue,malganis,288,shaman,enhancement,6,3,3
Redpocket,zuluhed,288,shaman,enhancement,6,3,3
Feesstt,malganis,288,shaman,enhancement,6,3,3
Toyletpaper,mugthol,288,shaman,enhancement,6,3,3
Ban,blackrock,288,shaman,enhancement,6,3,3
Vivean,kelthuzad,288,shaman,enhancement,6,3,3
Lïnc,sargeras,288,shaman,enhancement,6,3,3
Dwightjr,emerald-dream,288,shaman,enhancement,6,3,3
Smeeza,frostmourne,288,shaman,enhancement,6,3,3
Ceromental,frostmane,288,shaman,enhancement,6,3,3
Emtflakes,darkspear,288,shaman,enhancement,6,3,3
Slowkeeper,azralon,288,shaman,enhancement,6,3,3
Mundi,madoran,288,shaman,enhancement,6,3,3
Gimpanzee,kiljaeden,288,shaman,enhancement,6,3,3
Gorszu,proudmoore,288,shaman,enhancement,6,3,3
Jaftter,quelthalas,288,shaman,enhancement,9,4,5
Putinsdad,tichondrius,288,shaman,enhancement,10,4,6
Kakiscala,proudmoore,288,shaman,enhancement,11,3,8
Gudac,tichondrius,288,shaman,enhancement,12,3,9
Jireñ,area-52,288,shaman,enhancement,12,3,9
Çatastrophe,dalaran,288,shaman,enhancement,12,3,9
Regeneration,darkspear,288,shaman,enhancement,12,3,9
Faelzão,nemesis,288,shaman,enhancement,12,3,9
Fishmoley,zuljin,288,shaman,enhancement,12,3,9
Cvoa,bonechewer,288,shaman,enhancement,12,3,9
Shockfreak,stormrage,288,shaman,enhancement,12,3,9
Immunize,tichondrius,288,shaman,enhancement,12,3,9
Jajxshammy,rivendare,288,shaman,enhancement,12,3,9
Malsturm,stormrage,288,shaman,enhancement,12,3,9
Rockbass,sargeras,288,shaman,enhancement,12,3,9
Yaazz,frostmourne,288,shaman,enhancement,12,3,9
Azão,stormrage,288,shaman,enhancement,12,3,9
Thunderblood,nerzhul,288,shaman,enhancement,12,3,9
Hammaam,illidan,288,shaman,enhancement,12,3,9
Khazy,skullcrusher,288,shaman,enhancement,12,3,9
Smeagðl,tichondrius,288,shaman,enhancement,12,3,9
Drahlos,tichondrius,288,shaman,enhancement,12,3,9
Bobbymooshay,area-52,288,shaman,enhancement,12,3,9
Drekkhal,area-52,288,shaman,enhancement,12,3,9
Silverwolf,eredar,288,shaman,enhancement,12,3,9
Wickyz,moon-guard,288,shaman,enhancement,12,3,9
Drgiggleheim,tichondrius,288,shaman,enhancement,12,3,9
Jhivone,tichondrius,288,shaman,enhancement,12,3,9
Cydarta,ragnaros,287,shaman,enhancement,6,3,3
Xaryu,shuhalo,287,shaman,enhancement,12,3,9
Dnttazemebro,area-52,286,shaman,enhancement,6,3,3
ßodycount,area-52,240,shaman,enhancement,9,3,6
Caobuloso,azralon,239,shaman,enhancement,5,3,2
Sølbi,tichondrius,239,shaman,enhancement,5,3,2
Deeznuts,the-forgotten-coast,239,shaman,enhancement,5,3,2
Smooths,bloodscalp,234,shaman,enhancement,19,5,14
Forge,maelstrom,223,shaman,enhancement,8,3,5
Møostrom,thrall,192,shaman,enhancement,6,2,4
Sparklebunny,dark-iron,192,shaman,enhancement,6,2,4
Loused,shattered-hand,192,shaman,enhancement,6,2,4
Badjujubruh,thrall,192,shaman,enhancement,6,2,4
Olboy,thrall,192,shaman,enhancement,6,2,4
Skyten,quelthalas,192,shaman,enhancement,6,2,4
Shamnick,malganis,192,shaman,enhancement,6,2,4
Saltt,proudmoore,192,shaman,enhancement,6,2,4
Meatyball,tichondrius,192,shaman,enhancement,6,2,4
Totemzie,illidan,192,shaman,enhancement,6,2,4
Virô,sargeras,192,shaman,enhancement,6,2,4
Durogh,darkspear,192,shaman,enhancement,6,2,4
Scarshamxn,frostmourne,192,shaman,enhancement,6,2,4
Milkmeforhp,frostmourne,192,shaman,enhancement,6,2,4
Shaminja,kiljaeden,192,shaman,enhancement,6,2,4
Amzurs,area-52,192,shaman,enhancement,6,2,4
Dennwoop,sargeras,192,shaman,enhancement,6,2,4
Elecpod,frostmourne,192,shaman,enhancement,6,2,4
Ectomee,tichondrius,192,shaman,enhancement,6,2,4
Cutedraenei,destromath,192,shaman,enhancement,6,2,4
Shockedya,destromath,192,shaman,enhancement,6,2,4
Twistër,illidan,192,shaman,enhancement,6,2,4
Dadajuju,azralon,192,shaman,enhancement,6,2,4
Hothandxo,illidan,192,shaman,enhancement,6,2,4
Jasonnworb,tichondrius,192,shaman,enhancement,6,2,4
Víì,tichondrius,192,shaman,enhancement,6,2,4
Pandancement,thrall,192,shaman,enhancement,6,2,4
Bitxxnumber,tichondrius,192,shaman,enhancement,6,2,4
Szael,durotan,192,shaman,enhancement,6,2,4
Eraali,stormrage,192,shaman,enhancement,6,2,4
Blooddtears,stormrage,192,shaman,enhancement,6,2,4
Kelce,stormrage,192,shaman,enhancement,6,2,4
Contraponto,azralon,192,shaman,enhancement,6,2,4
Stormfronts,kelthuzad,192,shaman,enhancement,6,2,4
Vywolf,frostmourne,192,shaman,enhancement,6,2,4
Rayjamalblk,tichondrius,192,shaman,enhancement,6,2,4
Bootsix,area-52,192,shaman,enhancement,6,2,4
Ôprawindfury,mugthol,192,shaman,enhancement,6,2,4
Friedshammy,frostmourne,192,shaman,enhancement,6,2,4
Unhapintadaa,azralon,192,shaman,enhancement,6,2,4
Ceedlamb,kelthuzad,192,shaman,enhancement,6,2,4
Vitaminc,garona,192,shaman,enhancement,6,2,4
Beelzeburst,sargeras,192,shaman,enhancement,6,2,4
Bullcowsby,darkspear,192,shaman,enhancement,6,2,4
Zeldrys,emerald-dream,192,shaman,enhancement,6,2,4
Brofessor,frostwolf,192,shaman,enhancement,6,2,4
Quequin,quelthalas,192,shaman,enhancement,6,2,4
Vjeze,frostmourne,192,shaman,enhancement,6,2,4
Shamutari,sargeras,192,shaman,enhancement,6,2,4
Zenitsue,sargeras,192,shaman,enhancement,6,2,4
Detair,malganis,192,shaman,enhancement,6,2,4
Jahahahamon,arthas,192,shaman,enhancement,6,2,4
Electrica,quelthalas,192,shaman,enhancement,6,2,4
Bearmanshrek,tichondrius,192,shaman,enhancement,6,2,4
Kumer,tichondrius,192,shaman,enhancement,6,2,4
Daiablo,barthilas,192,shaman,enhancement,6,2,4
ßeesy,emerald-dream,192,shaman,enhancement,6,2,4
Thorlottie,stormrage,192,shaman,enhancement,6,2,4
Pericazo,sargeras,192,shaman,enhancement,6,2,4
Netflixnfeet,moonrunner,192,shaman,enhancement,6,2,4
Killamanjaro,alterac-mountains,192,shaman,enhancement,6,2,4
Ageegee,sargeras,192,shaman,enhancement,6,2,4
Tamzlol,the-forgotten-coast,192,shaman,enhancement,6,2,4
Freesolo,barthilas,192,shaman,enhancement,6,2,4
Boj,magtheridon,192,shaman,enhancement,6,2,4
Rinjio,zuljin,192,shaman,enhancement,6,2,4
Khuufu,fizzcrank,192,shaman,enhancement,6,2,4
Stallos,zuljin,192,shaman,enhancement,6,2,4
Valcannos,area-52,192,shaman,enhancement,6,2,4
Jammylol,frostmourne,192,shaman,enhancement,6,2,4
Shamanakin,emerald-dream,192,shaman,enhancement,6,2,4
Thrallzballz,firetree,192,shaman,enhancement,6,2,4
Soapmactavis,sargeras,192,shaman,enhancement,6,2,4
Fatluma,zuljin,192,shaman,enhancement,6,2,4
Whameradetu,suramar,192,shaman,enhancement,6,2,4
Mishalla,tichondrius,192,shaman,enhancement,6,2,4
Jbahr,hyjal,192,shaman,enhancement,6,2,4
Kaalyssia,moon-guard,192,shaman,enhancement,6,2,4
Wìzz,zuljin,192,shaman,enhancement,6,2,4
Hèllzpyro,sargeras,192,shaman,enhancement,6,2,4
Pissticles,bleeding-hollow,192,shaman,enhancement,6,2,4
Shamflu,tichondrius,192,shaman,enhancement,6,2,4
Kermut,frostmourne,192,shaman,enhancement,6,2,4
Sluggox,bleeding-hollow,192,shaman,enhancement,6,2,4
Amärök,area-52,192,shaman,enhancement,6,2,4
Zentius,thunderhorn,192,shaman,enhancement,6,2,4
Girthquake,agamaggan,192,shaman,enhancement,6,2,4
Nawoma,quelthalas,192,shaman,enhancement,8,2,6
Zarzlek,destromath,192,shaman,enhancement,12,2,10
Legendmatic,illidan,192,shaman,enhancement,12,2,10
Tarresh,azralon,192,shaman,enhancement,12,2,10
Zuljiba,illidan,192,shaman,enhancement,12,2,10
Gusgusgus,laughing-skull,192,shaman,enhancement,12,2,10
Chontu,area-52,192,shaman,enhancement,12,2,10
Shockszz,onyxia,192,shaman,enhancement,12,2,10
Ahzar,stormrage,192,shaman,enhancement,12,2,10
Stylebend,area-52,192,shaman,enhancement,12,2,10
Dahmerjr,area-52,191,shaman,enhancement,6,2,4
Calmconflict,daggerspine,191,shaman,enhancement,6,2,4
Skuffedx,spirestone,159,shaman,enhancement,5,2,3
Nuggitz,tichondrius,159,shaman,enhancement,5,2,3
Dønßlack,thunderhorn,159,shaman,enhancement,5,2,3
Shamto,zuljin,144,shaman,enhancement,3,3,0
Reavs,illidan,138,shaman,enhancement,16,3,13
Bogz,korgath,128,shaman,enhancement,4,2,2
Grogakk,moon-guard,128,shaman,enhancement,4,2,2
Flashyjoe,tichondrius,128,shaman,enhancement,4,2,2
Badgeshock,area-52,128,shaman,enhancement,4,2,2
Ludacrìtz,stormrage,112,shaman,enhancement,7,2,5
Shamcakes,kilrogg,96,shaman,enhancement,17,3,14
Ohtoro,zuljin,96,shaman,enhancement,6,1,5
Wangbangjr,mugthol,96,shaman,enhancement,6,1,5
Zapsquidzap,illidan,96,shaman,enhancement,6,1,5
Totemtîme,frostmourne,96,shaman,enhancement,6,1,5
Pileef,thrall,96,shaman,enhancement,6,1,5
Sureofname,frostmourne,96,shaman,enhancement,6,1,5
Kinjin,dragonmaw,96,shaman,enhancement,6,1,5
Feuerbart,dalaran,96,shaman,enhancement,6,1,5
Yudo,stormrage,96,shaman,enhancement,6,1,5
Zizö,barthilas,96,shaman,enhancement,6,1,5
Blackjackxx,frostmourne,96,shaman,enhancement,6,1,5
Zoeyzour,illidan,96,shaman,enhancement,6,1,5
Mawcus,zuljin,96,shaman,enhancement,6,1,5
Muyg,staghelm,96,shaman,enhancement,6,1,5
Geladoo,gallywix,96,shaman,enhancement,6,1,5
Hangellyca,azralon,96,shaman,enhancement,6,1,5
Volaarn,area-52,96,shaman,enhancement,6,1,5
Aerôv,area-52,96,shaman,enhancement,6,1,5
Saesenthesis,barthilas,96,shaman,enhancement,6,1,5
Aiggiggigne,sargeras,96,shaman,enhancement,6,1,5
Succies,emerald-dream,96,shaman,enhancement,6,1,5
Stormsanta,emerald-dream,96,shaman,enhancement,6,1,5
Littz,malganis,96,shaman,enhancement,6,1,5
Sweettooth,area-52,96,shaman,enhancement,6,1,5
Fourever,ragnaros,96,shaman,enhancement,6,1,5
Toyotatron,tichondrius,96,shaman,enhancement,6,1,5
Shamofshame,garrosh,96,shaman,enhancement,6,1,5
Kàrlx,tichondrius,96,shaman,enhancement,6,1,5
Beazel,moon-guard,96,shaman,enhancement,6,1,5
Ikora,crushridge,96,shaman,enhancement,6,1,5
Sandmanatee,crushridge,96,shaman,enhancement,6,1,5
Tictactotum,hyjal,96,shaman,enhancement,6,1,5
Axshaman,darkspear,96,shaman,enhancement,6,1,5
Kranif,tichondrius,96,shaman,enhancement,6,1,5
Globad,tichondrius,96,shaman,enhancement,6,1,5
Paramecium,sargeras,96,shaman,enhancement,6,1,5
Acéz,korgath,96,shaman,enhancement,6,1,5
Shrektar,cenarius,96,shaman,enhancement,6,1,5
Alferian,moon-guard,96,shaman,enhancement,6,1,5
Karmar,proudmoore,96,shaman,enhancement,6,1,5
Tritun,proudmoore,96,shaman,enhancement,6,1,5
Yungmeaty,tichondrius,96,shaman,enhancement,7,1,6
Threehandz,bleeding-hollow,96,shaman,enhancement,8,1,7
Immutef,tichondrius,96,shaman,enhancement,12,1,11
Thallor,stormrage,96,shaman,enhancement,12,1,11
Smokeymcpots,khazgoroth,95,shaman,enhancement,6,1,5
Artsha,tol-barad,79,shaman,enhancement,5,1,4
Dilldoughnut,sargeras,79,shaman,enhancement,5,1,4
Shablam,daggerspine,64,shaman,enhancement,10,1,9
Engorgdshock,tichondrius,63,shaman,enhancement,2,2,0
Zugxo,area-52,63,shaman,enhancement,2,2,0
Toastsshaman,tichondrius,48,shaman,enhancement,3,1,2
Ekatonkiro,ragnaros,48,shaman,enhancement,3,1,2
Totemlord,lightnings-blade,31,shaman,enhancement,2,1,1
Rykku,illidan,16,shaman,enhancement,1,1,0
Stumpyjoe,terokkar,16,shaman,enhancement,7,1,6
Wildimp,aerie-peak,2323,warlock,demonology,108,66,42
Mlx,proudmoore,2294,warlock,demonology,137,79,58
Btsfangirl,moon-guard,2263,warlock,demonology,104,60,44
Wildimpx,sargeras,2240,warlock,demonology,107,60,47
Wzxx,tichondrius,2222,warlock,demonology,84,46,38
Babyaga,illidan,2201,warlock,demonology,84,47,37
Beyourselff,tichondrius,2195,warlock,demonology,151,80,71
Mixtape,stormrage,2178,warlock,demonology,77,47,30
Bahamas,bleeding-hollow,2166,warlock,demonology,78,46,32
Jojofann,nemesis,2165,warlock,demonology,53,37,16
Bronzerl,tichondrius,2149,warlock,demonology,51,32,19
Gentleq,tichondrius,2149,warlock,demonology,99,53,46
Gianni,chogall,2149,warlock,demonology,107,57,50
Kaossqt,azralon,2144,warlock,demonology,114,62,52
Zuelu,tichondrius,2141,warlock,demonology,121,68,53
Erock,korgath,2138,warlock,demonology,60,47,13
Wesyane,anetheron,2135,warlock,demonology,124,66,58
Xadge,tichondrius,2128,warlock,demonology,79,43,36
Fishorz,tichondrius,2128,warlock,demonology,89,47,42
Ediya,tichondrius,2128,warlock,demonology,147,74,73
Harambê,sargeras,2127,warlock,demonology,36,27,9
Lemmefear,illidan,2127,warlock,demonology,47,32,15
Miredö,tichondrius,2121,warlock,demonology,60,35,25
Bigdaddylol,ragnaros,2120,warlock,demonology,83,45,38
Fatass,cairne,2114,warlock,demonology,66,38,28
Awdam,tichondrius,2114,warlock,demonology,96,50,46
Ensebado,azralon,2111,warlock,demonology,140,78,62
Falco,azshara,2110,warlock,demonology,66,38,28
Synkz,blood-furnace,2110,warlock,demonology,72,38,34
Cosmosxx,illidan,2110,warlock,demonology,112,58,54
Lilballz,tichondrius,2107,warlock,demonology,53,31,22
Ogchaos,tichondrius,2107,warlock,demonology,78,45,33
Tessarath,area-52,2106,warlock,demonology,59,38,21
Unhòólylck,ragnaros,2082,warlock,demonology,105,56,49
Erlandesher,tichondrius,2066,warlock,demonology,131,65,66
Spicyfingers,illidan,2056,warlock,demonology,72,41,31
Persistencss,tichondrius,2047,warlock,demonology,48,29,19
Oymmander,illidan,2046,warlock,demonology,56,37,19
Boltqt,tichondrius,2046,warlock,demonology,54,33,21
Vexxes,malganis,2042,warlock,demonology,168,89,79
Broccoleh,area-52,2033,warlock,demonology,59,36,23
Etuskaa,tichondrius,2032,warlock,demonology,167,83,84
Eazyw,stormrage,2024,warlock,demonology,95,47,48
Sslock,sargeras,2008,warlock,demonology,71,37,34
Ziffy,emerald-dream,2008,warlock,demonology,66,34,32
Nocrackrocks,stormrage,2007,warlock,demonology,117,66,51
Atheô,ragnaros,2004,warlock,demonology,106,57,49
Elbrujon,sargeras,2002,warlock,demonology,107,55,52
Xygg,tichondrius,2000,warlock,demonology,54,31,23
Ztlivid,area-52,2000,warlock,demonology,175,91,84
Awangdemon,tichondrius,1997,warlock,demonology,54,27,27
Bleachkk,tichondrius,1992,warlock,demonology,71,47,24
Maadhum,illidan,1992,warlock,demonology,69,37,32
Coèrce,tichondrius,1989,warlock,demonology,47,32,15
Megamindx,tichondrius,1981,warlock,demonology,24,21,3
Teivlol,mugthol,1980,warlock,demonology,96,51,45
Extreme,blackwing-lair,1978,warlock,demonology,78,53,25
Toiletghost,tichondrius,1973,warlock,demonology,56,35,21
Littlerod,tichondrius,1967,warlock,demonology,60,34,26
Procalypse,stormrage,1966,warlock,demonology,54,32,22
Patoquenn,azralon,1966,warlock,demonology,54,32,22
Ofc,malganis,1961,warlock,demonology,48,29,19
Snuufels,area-52,1950,warlock,demonology,60,37,23
Ketahole,warsong,1949,warlock,demonology,99,50,49
Ihaveapowers,maiev,1944,warlock,demonology,120,60,60
Naughtybolts,sargeras,1941,warlock,demonology,80,46,34
Amazingamez,sargeras,1940,warlock,demonology,137,66,71
Baka,moon-guard,1937,warlock,demonology,54,29,25
Stopdot,lightnings-blade,1934,warlock,demonology,76,38,38
Paygo,tichondrius,1930,warlock,demonology,57,32,25
Aramith,tichondrius,1922,warlock,demonology,64,37,27
Shadowmoonon,tichondrius,1921,warlock,demonology,43,21,22
Bronzel,tichondrius,1920,warlock,demonology,48,30,18
Invalid,frostmourne,1914,warlock,demonology,36,25,11
Ceeloftw,tichondrius,1914,warlock,demonology,113,60,53
Lilgigs,stormrage,1909,warlock,demonology,60,30,30
Inmøtion,tichondrius,1906,warlock,demonology,60,33,27
Sofan,dalaran,1905,warlock,demonology,58,33,25
Lockedinn,mannoroth,1904,warlock,demonology,91,54,37
Iselltacos,dalaran,1900,warlock,demonology,31,21,10
Daerde,malganis,1900,warlock,demonology,47,27,20
Siphoned,darkspear,1900,warlock,demonology,53,27,26
Deadlpoo,stormscale,1899,warlock,demonology,81,41,40
Xiyangpvp,tichondrius,1898,warlock,demonology,54,31,23
Bwonsamdijin,tichondrius,1898,warlock,demonology,95,44,51
Lemmepvponu,illidan,1896,warlock,demonology,48,30,18
Alisa,moon-guard,1896,warlock,demonology,60,28,32
Lrry,dalaran,1893,warlock,demonology,144,84,60
Shinyballz,tichondrius,1890,warlock,demonology,47,28,19
Rakshama,chogall,1885,warlock,demonology,42,25,17
Abrocket,alleria,1883,warlock,demonology,36,23,13
Debao,malganis,1881,warlock,demonology,60,29,31
Petattack,nerzhul,1878,warlock,demonology,125,60,65
Kimchiblast,tichondrius,1876,warlock,demonology,48,28,20
Demondisco,tichondrius,1873,warlock,demonology,95,45,50
Zydiva,sargeras,1872,warlock,demonology,118,62,56
Cosmosxi,illidan,1871,warlock,demonology,36,23,13
Sàill,tichondrius,1871,warlock,demonology,35,22,13
Dotman,tichondrius,1871,warlock,demonology,60,32,28
Thranlock,area-52,1862,warlock,demonology,132,65,67
Bbangtimo,tichondrius,1858,warlock,demonology,39,22,17
Mhael,lightninghoof,1856,warlock,demonology,54,32,22
Playtoy,moon-guard,1856,warlock,demonology,154,78,76
Atheø,ragnaros,1854,warlock,demonology,42,23,19
Lcomi,tichondrius,1850,warlock,demonology,42,26,16
Demyo,tichondrius,1849,warlock,demonology,38,21,17
Díablo,bleeding-hollow,1848,warlock,demonology,53,36,17
Redfish,tichondrius,1847,warlock,demonology,34,20,14
Phóbòs,tichondrius,1843,warlock,demonology,54,40,14
Percadu,barthilas,1843,warlock,demonology,85,43,42
Metic,firetree,1842,warlock,demonology,48,33,15
Kerrigan,the-venture-co,1842,warlock,demonology,66,38,28
Darkzell,azralon,1841,warlock,demonology,48,30,18
Dlhmlock,tichondrius,1840,warlock,demonology,41,25,16
Alndron,thrall,1837,warlock,demonology,78,38,40
Aoepump,tichondrius,1836,warlock,demonology,54,27,27
Ccona,tichondrius,1835,warlock,demonology,42,23,19
Speakeasy,malygos,1835,warlock,demonology,58,29,29
Beatinu,draenor,1834,warlock,demonology,54,32,22
Åmön,zuljin,1832,warlock,demonology,66,32,34
ßøßßÿßøûçhêr,tichondrius,1831,warlock,demonology,36,25,11
Drakatattwo,tichondrius,1831,warlock,demonology,42,23,19
Evildeath,tichondrius,1829,warlock,demonology,48,26,22
Bic,thrall,1828,warlock,demonology,66,45,21
Lowrcase,zuljin,1828,warlock,demonology,42,24,18
Juleno,quelthalas,1827,warlock,demonology,51,28,23
Xoboroz,moon-guard,1827,warlock,demonology,60,29,31
Maral,kelthuzad,1826,warlock,demonology,57,32,25
Cendit,malganis,1825,warlock,demonology,54,34,20
Jerclard,proudmoore,1825,warlock,demonology,90,51,39
Castingfear,barthilas,1825,warlock,demonology,48,27,21
Greasymario,area-52,1824,warlock,demonology,60,42,18
Axelrodx,tichondrius,1824,warlock,demonology,54,35,19
Dowal,whisperwind,1824,warlock,demonology,54,28,26
Cidkagenou,sargeras,1821,warlock,demonology,25,19,6
Idoovoodoo,burning-legion,1820,warlock,demonology,36,23,13
Sharaßha,moon-guard,1820,warlock,demonology,69,41,28
Dëvïl,ragnaros,1818,warlock,demonology,92,58,34
Dapete,malorne,1818,warlock,demonology,53,30,23
Villaìn,moon-guard,1818,warlock,demonology,117,55,62
Arcinian,kelthuzad,1817,warlock,demonology,66,39,27
Wls,frostmourne,1817,warlock,demonology,89,50,39
Hellbraive,queldorei,1817,warlock,demonology,54,30,24
Richards,thrall,1812,warlock,demonology,42,32,10
Ltr,moon-guard,1811,warlock,demonology,30,22,8
Kronii,jubeithos,1811,warlock,demonology,35,25,10
Voidxo,tichondrius,1811,warlock,demonology,36,22,14
Raegon,kiljaeden,1811,warlock,demonology,39,23,16
Errogant,area-52,1810,warlock,demonology,60,30,30
Nüts,blackrock,1810,warlock,demonology,50,23,27
Beckypls,zuljin,1809,warlock,demonology,36,27,9
Mcjoy,akama,1809,warlock,demonology,145,91,54
Dounutlock,area-52,1809,warlock,demonology,54,33,21
Saevitar,area-52,1809,warlock,demonology,45,24,21
Hadoukën,hyjal,1809,warlock,demonology,108,56,52
Chilipeppa,wyrmrest-accord,1808,warlock,demonology,60,34,26
Keylloggz,sargeras,1808,warlock,demonology,120,63,57
Mälwaré,tichondrius,1808,warlock,demonology,58,29,29
Chaosthekid,malganis,1807,warlock,demonology,40,25,15
Reneqtxo,jubeithos,1806,warlock,demonology,30,19,11
Evelyne,tichondrius,1805,warlock,demonology,30,19,11
Xacayth,ragnaros,1804,warlock,demonology,80,47,33
Rakudemon,ragnaros,1804,warlock,demonology,147,77,70
Scatach,area-52,1804,warlock,demonology,48,25,23
Darkborkain,tichondrius,1803,warlock,demonology,30,19,11
Lockeslock,sargeras,1801,warlock,demonology,118,62,56
Thelockzx,azralon,1801,warlock,demonology,60,28,32
Tarth,sargeras,1797,warlock,demonology,102,51,51
Hugebolt,tichondrius,1793,warlock,demonology,48,28,20
Precogfear,tichondrius,1793,warlock,demonology,60,29,31
Jaganshi,tichondrius,1791,warlock,demonology,52,29,23
Búmchúm,frostmourne,1788,warlock,demonology,54,34,20
Babydots,stormreaver,1786,warlock,demonology,136,67,69
Lockiator,moon-guard,1782,warlock,demonology,53,29,24
Zörkô,zuljin,1775,warlock,demonology,78,37,41
Flocka,agamaggan,1773,warlock,demonology,42,33,9
Amgs,frostmourne,1773,warlock,demonology,54,38,16
Qp,thrall,1771,warlock,demonology,38,28,10
Spreadlove,emerald-dream,1771,warlock,demonology,162,86,76
Gamecover,azralon,1768,warlock,demonology,86,50,36
Magë,ursin,1768,warlock,demonology,84,36,48
Döremi,tichondrius,1760,warlock,demonology,35,21,14
Aidadeshu,tichondrius,1750,warlock,demonology,72,33,39
Scarysherri,aggramar,1746,warlock,demonology,48,31,17
ßállin,illidan,1745,warlock,demonology,35,22,13
Mcpickls,illidan,1740,warlock,demonology,48,26,22
Michae,tichondrius,1740,warlock,demonology,48,25,23
Feldren,wyrmrest-accord,1739,warlock,demonology,59,33,26
Arityy,tichondrius,1738,warlock,demonology,33,23,10
Missalice,nesingwary,1738,warlock,demonology,42,23,19
Chanigay,tichondrius,1737,warlock,demonology,35,20,15
Dreadlõck,malganis,1737,warlock,demonology,78,39,39
Cinderwhip,moon-guard,1730,warlock,demonology,207,104,103
Ðëâthløck,tichondrius,1729,warlock,demonology,47,25,22
Overclocked,destromath,1726,warlock,demonology,24,18,6
Domenic,sentinels,1725,warlock,demonology,46,26,20
Lemmewin,illidan,1724,warlock,demonology,24,18,6
Playßøy,area-52,1724,warlock,demonology,30,18,12
Eriebos,area-52,1724,warlock,demonology,60,35,25
Canobio,tichondrius,1723,warlock,demonology,35,26,9
Ökïlôck,proudmoore,1722,warlock,demonology,36,18,18
Devilman,darkspear,1720,warlock,demonology,129,64,65
Hitwarlock,tichondrius,1718,warlock,demonology,36,19,17
Muchas,area-52,1717,warlock,demonology,30,18,12
Fadedemon,area-52,1716,warlock,demonology,42,32,10
Ciprýan,azralon,1715,warlock,demonology,76,35,41
Eastwitch,ragnaros,1712,warlock,demonology,90,39,51
Archibalding,area-52,1710,warlock,demonology,60,37,23
Dätura,tichondrius,1708,warlock,demonology,32,21,11
Sasaology,frostmourne,1706,warlock,demonology,78,41,37
Tazlock,blackrock,1706,warlock,demonology,52,25,27
Milkybøng,area-52,1705,warlock,demonology,99,61,38
Shooterg,tichondrius,1704,warlock,demonology,66,32,34
Larixpotanin,tichondrius,1703,warlock,demonology,66,35,31
Dìablo,area-52,1702,warlock,demonology,78,43,35
Nethron,the-venture-co,1700,warlock,demonology,72,35,37
Zver,drakkari,1698,warlock,demonology,90,49,41
Salaszar,illidan,1695,warlock,demonology,24,18,6
Ourlegacy,tichondrius,1695,warlock,demonology,40,24,16
Qwêrty,ursin,1693,warlock,demonology,29,20,9
Fksm,tichondrius,1692,warlock,demonology,36,20,16
Gengar,dalaran,1692,warlock,demonology,95,47,48
Stopdottroll,zuljin,1690,warlock,demonology,30,18,12
Hulkyy,illidan,1690,warlock,demonology,95,55,40
Metrow,area-52,1688,warlock,demonology,30,18,12
Houdneeznuts,tichondrius,1688,warlock,demonology,150,81,69
Melisândre,kiljaeden,1687,warlock,demonology,47,23,24
Leeka,tichondrius,1687,warlock,demonology,48,23,25
Gørb,wyrmrest-accord,1686,warlock,demonology,48,30,18
Notomorrow,tichondrius,1686,warlock,demonology,146,87,59
Dogegg,tichondrius,1685,warlock,demonology,66,28,38
Säbrine,zuljin,1679,warlock,demonology,73,35,38
Døtyou,area-52,1676,warlock,demonology,35,18,17
Juswannarock,tichondrius,1676,warlock,demonology,51,25,26
Jyhoona,chromaggus,1675,warlock,demonology,325,164,161
Spicyfingerx,illidan,1673,warlock,demonology,36,22,14
Yuengling,illidan,1671,warlock,demonology,42,22,20
Bigfatballz,tichondrius,1670,warlock,demonology,40,24,16
Wrathh,stormscale,1669,warlock,demonology,45,20,25
Narmazulnn,area-52,1666,warlock,demonology,41,25,16
Geauxst,tichondrius,1666,warlock,demonology,44,25,19
Gløcked,area-52,1666,warlock,demonology,48,26,22
Altairo,illidan,1666,warlock,demonology,76,39,37
Doties,bleeding-hollow,1663,warlock,demonology,42,23,19
Aroug,aggramar,1663,warlock,demonology,96,47,49
Mcpickl,illidan,1662,warlock,demonology,54,25,29
Funkminot,illidan,1658,warlock,demonology,235,123,112
Edzeá,frostmourne,1656,warlock,demonology,48,24,24
Skanckqt,malganis,1654,warlock,demonology,54,29,25
Rathul,bonechewer,1654,warlock,demonology,61,30,31
Vcain,stormrage,1652,warlock,demonology,66,31,35
Gimmeprecog,tichondrius,1651,warlock,demonology,30,21,9
Gihaewon,tichondrius,1650,warlock,demonology,30,20,10
Cappadonna,azralon,1650,warlock,demonology,82,45,37
Dlchem,tichondrius,1644,warlock,demonology,70,37,33
Phogy,bleeding-hollow,1644,warlock,demonology,71,35,36
Invisibles,barthilas,1642,warlock,demonology,35,20,15
Juxsr,nerzhul,1642,warlock,demonology,42,22,20
Huajianmanwu,tichondrius,1642,warlock,demonology,220,106,114
Saeph,burning-legion,1640,warlock,demonology,30,18,12
Blastfinger,tichondrius,1637,warlock,demonology,42,24,18
Suzüki,tichondrius,1635,warlock,demonology,36,19,17
Fearmebro,bleeding-hollow,1633,warlock,demonology,84,53,31
Oluluo,andorhal,1633,warlock,demonology,41,21,20
Fearedu,thunderhorn,1633,warlock,demonology,101,47,54
Innocentius,illidan,1631,warlock,demonology,76,40,36
Graendol,tichondrius,1630,warlock,demonology,30,17,13
Zzooxxqt,area-52,1630,warlock,demonology,30,17,13
Sickmade,zuljin,1628,warlock,demonology,76,47,29
Discordance,zuljin,1628,warlock,demonology,30,17,13
Voltshot,tichondrius,1626,warlock,demonology,295,153,142
Ggooudan,tichondrius,1625,warlock,demonology,29,21,8
Stonelocke,area-52,1624,warlock,demonology,71,37,34
Kreâtor,tichondrius,1622,warlock,demonology,71,40,31
Demonicsmoke,darrowmere,1622,warlock,demonology,104,56,48
Bagn,tichondrius,1620,warlock,demonology,42,23,19
Zehzet,area-52,1619,warlock,demonology,24,17,7
Mcpickles,illidan,1618,warlock,demonology,30,19,11
Epinetheus,stormrage,1617,warlock,demonology,54,23,31
Buymymixtåpe,ursin,1615,warlock,demonology,33,21,12
Soreanus,illidan,1615,warlock,demonology,48,30,18
Zantology,frostmourne,1615,warlock,demonology,54,31,23
Krýptizl,frostmourne,1615,warlock,demonology,81,45,36
Raisa,chogall,1615,warlock,demonology,48,23,25
Ministàff,ursin,1615,warlock,demonology,36,17,19
Xlilgee,kelthuzad,1614,warlock,demonology,30,17,13
Abismoarmdr,ragnaros,1613,warlock,demonology,115,66,49
Yükina,stormrage,1611,warlock,demonology,54,29,25
Hentry,sargeras,1608,warlock,demonology,47,25,22
Gulßad,tichondrius,1607,warlock,demonology,36,24,12
Diabolock,proudmoore,1607,warlock,demonology,48,26,22
Skullsoul,arthas,1607,warlock,demonology,44,23,21
Eternalsmile,tichondrius,1606,warlock,demonology,36,21,15
Rasildur,ragnaros,1606,warlock,demonology,49,21,28
Cambolts,tichondrius,1604,warlock,demonology,36,20,16
Ktlock,frostmourne,1603,warlock,demonology,114,65,49
Lamdyn,moon-guard,1602,warlock,demonology,78,46,32
Toestye,lightbringer,1600,warlock,demonology,108,56,52
Harrydotterr,bonechewer,1598,warlock,demonology,60,29,31
Lazymongoose,frostmourne,1597,warlock,demonology,126,67,59
Valkynaris,chogall,1594,warlock,demonology,30,20,10
Warlocklmao,malganis,1594,warlock,demonology,36,19,17
Yanlexx,stormrage,1592,warlock,demonology,86,44,42
Amour,wyrmrest-accord,1592,warlock,demonology,58,26,32
Doombaby,zuljin,1588,warlock,demonology,48,30,18
Theseance,dalaran,1587,warlock,demonology,42,20,22
Garcheros,ragnaros,1584,warlock,demonology,45,23,22
Raidspot,bleeding-hollow,1581,warlock,demonology,72,40,32
Goorock,area-52,1581,warlock,demonology,78,40,38
Tsunamibaby,anvilmar,1579,warlock,demonology,90,53,37
Curseifier,frostmourne,1579,warlock,demonology,62,33,29
Dreamsw,frostmourne,1578,warlock,demonology,36,18,18
Agertis,frostmourne,1578,warlock,demonology,42,18,24
Spookyfurry,area-52,1576,warlock,demonology,48,33,15
Smallj,zuljin,1576,warlock,demonology,54,27,27
Sadgellation,arthas,1574,warlock,demonology,42,27,15
Thelocker,stormrage,1573,warlock,demonology,35,22,13
Redbullsz,bleeding-hollow,1573,warlock,demonology,68,34,34
Davekoresh,dunemaul,1571,warlock,demonology,50,27,23
Empiratore,quelthalas,1569,warlock,demonology,59,26,33
Hers,vashj,1568,warlock,demonology,48,30,18
Bosongo,boulderfist,1567,warlock,demonology,36,20,16
Xephostwo,area-52,1567,warlock,demonology,42,20,22
Th,kiljaeden,1567,warlock,demonology,59,26,33
Kìllèrgf,area-52,1564,warlock,demonology,205,102,103
Caesaros,quelthalas,1563,warlock,demonology,87,40,47
Miryem,illidan,1556,warlock,demonology,67,36,31
Necronemesis,arthas,1556,warlock,demonology,60,27,33
Hoana,azralon,1555,warlock,demonology,105,59,46
Cilium,illidan,1554,warlock,demonology,41,23,18
Fullxd,quelthalas,1551,warlock,demonology,54,31,23
Paparoxy,illidan,1551,warlock,demonology,35,18,17
Spooknjuke,bleeding-hollow,1546,warlock,demonology,41,26,15
Wickdways,daggerspine,1546,warlock,demonology,54,32,22
Xitokaiba,tichondrius,1544,warlock,demonology,37,21,16
Exofilth,thrall,1543,warlock,demonology,35,22,13
Bauchalain,area-52,1541,warlock,demonology,36,21,15
Maldinath,sargeras,1535,warlock,demonology,24,16,8
Soulrulerxc,tichondrius,1534,warlock,demonology,30,16,14
Isometrics,barthilas,1534,warlock,demonology,30,16,14
Dárklórd,dalaran,1534,warlock,demonology,180,95,85
Heartpvp,tichondrius,1532,warlock,demonology,92,48,44
Forsâken,tichondrius,1531,warlock,demonology,95,42,53
Giantgobrin,zuljin,1529,warlock,demonology,30,16,14
Almostoogood,illidan,1526,warlock,demonology,24,16,8
Deathcyth,crushridge,1526,warlock,demonology,155,84,71
Wollylock,dark-iron,1520,warlock,demonology,52,25,27
Kandrus,moon-guard,1514,warlock,demonology,140,70,70
Fãttyqt,sargeras,1513,warlock,demonology,52,35,17
Smartpimp,tichondrius,1508,warlock,demonology,38,21,17
Xaryl,stormrage,1506,warlock,demonology,90,41,49
Krolczdots,tichondrius,1505,warlock,demonology,30,18,12
Proletariat,moon-guard,1503,warlock,demonology,64,38,26
Parmenides,tichondrius,1502,warlock,demonology,112,56,56
Bigdotenergi,tichondrius,1501,warlock,demonology,24,16,8
Icemanliddel,area-52,1500,warlock,demonology,35,16,19
Mindfulchimp,sargeras,1497,warlock,demonology,37,21,16
Krumlax,thrall,1496,warlock,demonology,24,16,8
Thekook,illidan,1495,warlock,demonology,43,21,22
Shigero,tichondrius,1494,warlock,demonology,30,19,11
Prägä,drakkari,1493,warlock,demonology,51,27,24
Damerus,illidan,1487,warlock,demonology,57,24,33
Eriand,nordrassil,1482,warlock,demonology,102,51,51
Zhoull,thrall,1479,warlock,demonology,48,23,25
Grixis,zuluhed,1478,warlock,demonology,36,23,13
Fabriziø,ragnaros,1472,warlock,demonology,31,21,10
Mssy,illidan,1470,warlock,demonology,29,16,13
Rotsndotss,thrall,1469,warlock,demonology,42,19,23
Lamo,dawnbringer,1468,warlock,demonology,154,76,78
Celestialock,tichondrius,1467,warlock,demonology,31,22,9
Tubarão,azralon,1467,warlock,demonology,42,26,16
Khanaan,illidan,1466,warlock,demonology,30,16,14
Blavindy,illidan,1461,warlock,demonology,54,26,28
Sugarwaffles,area-52,1460,warlock,demonology,60,33,27
Gigagnomer,kelthuzad,1459,warlock,demonology,37,16,21
Immortallock,tichondrius,1454,warlock,demonology,96,48,48
Malegnant,proudmoore,1442,warlock,demonology,42,20,22
Darkwîngduck,illidan,1439,warlock,demonology,24,15,9
Avery,mannoroth,1439,warlock,demonology,30,15,15
Dyenamik,stormrage,1438,warlock,demonology,18,15,3
Sosahawk,stormrage,1437,warlock,demonology,30,15,15
Dottcha,blackrock,1436,warlock,demonology,24,15,9
Chaosboltlol,tichondrius,1436,warlock,demonology,30,15,15
Valerik,azralon,1435,warlock,demonology,42,20,22
Helyana,illidan,1433,warlock,demonology,53,31,22
Dcpwns,arthas,1433,warlock,demonology,66,31,35
Synisterlock,moon-guard,1432,warlock,demonology,36,18,18
Voidwarlord,tichondrius,1427,warlock,demonology,73,39,34
Aomniloltv,zuljin,1426,warlock,demonology,24,15,9
Mothapucka,thrall,1426,warlock,demonology,47,21,26
Løcalplugxø,barthilas,1425,warlock,demonology,24,15,9
Tickleskin,windrunner,1419,warlock,demonology,87,47,40
Arlenna,sargeras,1419,warlock,demonology,128,60,68
Emperator,quelthalas,1413,warlock,demonology,28,16,12
Kuyog,illidan,1411,warlock,demonology,60,30,30
Laggyturbo,barthilas,1409,warlock,demonology,66,38,28
Adlfcritler,emerald-dream,1402,warlock,demonology,36,19,17
Monstir,sargeras,1396,warlock,demonology,31,16,15
Suminl,tichondrius,1392,warlock,demonology,24,15,9
Kuroyt,drakkari,1390,warlock,demonology,61,29,32
Gromy,lightnings-blade,1388,warlock,demonology,56,32,24
Guisls,azralon,1386,warlock,demonology,54,22,32
Tiná,tichondrius,1385,warlock,demonology,27,15,12
Silentfears,tichondrius,1381,warlock,demonology,27,20,7
Lemongillo,stormrage,1378,warlock,demonology,35,20,15
Guldorum,kiljaeden,1375,warlock,demonology,48,28,20
Nezsarek,sargeras,1373,warlock,demonology,41,22,19
Mysteryannie,tichondrius,1371,warlock,demonology,70,42,28
Narcan,arthas,1371,warlock,demonology,29,16,13
Memon,frostmane,1368,warlock,demonology,41,19,22
Destrokk,gorefiend,1364,warlock,demonology,24,16,8
Felorc,wyrmrest-accord,1358,warlock,demonology,63,39,24
Voidxx,tichondrius,1343,warlock,demonology,18,14,4
Ellynaria,nemesis,1343,warlock,demonology,18,14,4
Biubius,tichondrius,1343,warlock,demonology,24,14,10
Idotû,tichondrius,1343,warlock,demonology,30,14,16
Hrrpeuh,zuljin,1343,warlock,demonology,30,14,16
Joung,tichondrius,1342,warlock,demonology,24,14,10
Doomdm,zuljin,1342,warlock,demonology,24,14,10
Demonalien,malganis,1339,warlock,demonology,18,14,4
Douzz,frostmourne,1338,warlock,demonology,24,14,10
Antigotenent,sargeras,1336,warlock,demonology,24,14,10
Jamesiyah,moon-guard,1333,warlock,demonology,60,29,31
Smôkedsôul,area-52,1330,warlock,demonology,24,14,10
Ézman,tichondrius,1330,warlock,demonology,24,14,10
Bestwarlock,skywall,1328,warlock,demonology,30,14,16
Vawns,zuljin,1326,warlock,demonology,23,16,7
Eldriptch,kelthuzad,1325,warlock,demonology,27,15,12
Medallok,laughing-skull,1323,warlock,demonology,77,35,42
Seekma,gallywix,1322,warlock,demonology,24,14,10
Superjuno,sargeras,1319,warlock,demonology,18,14,4
Warlockluo,tichondrius,1319,warlock,demonology,24,14,10
Dawdrax,gallywix,1313,warlock,demonology,22,15,7
Jokerks,tichondrius,1310,warlock,demonology,23,14,9
Avoidence,tanaris,1308,warlock,demonology,24,14,10
Sû,stormrage,1301,warlock,demonology,82,39,43
Shadowflame,skullcrusher,1299,warlock,demonology,91,48,43
Salacia,chogall,1286,warlock,demonology,93,45,48
Gauul,illidan,1281,warlock,demonology,70,39,31
Heathncraig,illidan,1279,warlock,demonology,50,29,21
Screampied,sargeras,1279,warlock,demonology,53,24,29
Tizzy,malganis,1276,warlock,demonology,32,21,11
Valerilma,azralon,1276,warlock,demonology,36,16,20
Cornboil,tichondrius,1274,warlock,demonology,57,27,30
Yoyoling,illidan,1267,warlock,demonology,82,41,41
Willsayan,ragnaros,1266,warlock,demonology,42,16,26
Arcaangell,sargeras,1264,warlock,demonology,63,35,28
Bluffzlock,boulderfist,1260,warlock,demonology,23,14,9
Wazog,jubeithos,1250,warlock,demonology,30,16,14
Scalpelx,tichondrius,1248,warlock,demonology,18,13,5
Deathboltx,zuljin,1248,warlock,demonology,24,13,11
Drakatat,tichondrius,1248,warlock,demonology,24,13,11
Adonege,tichondrius,1248,warlock,demonology,24,13,11
Pfhear,area-52,1247,warlock,demonology,24,13,11
Mukkamuk,shadowmoon,1246,warlock,demonology,18,13,5
Feinnx,dalaran,1246,warlock,demonology,30,13,17
Evianne,skywall,1244,warlock,demonology,30,13,17
Thalsiani,moon-guard,1239,warlock,demonology,24,13,11
Esdreel,ragnaros,1236,warlock,demonology,24,13,11
Drain,proudmoore,1233,warlock,demonology,18,13,5
Lpharji,tichondrius,1231,warlock,demonology,24,13,11
Kymochaos,sargeras,1231,warlock,demonology,29,13,16
Alaren,korgath,1231,warlock,demonology,36,13,23
Gotfear,zuljin,1229,warlock,demonology,198,98,100
Brawndelock,stormrage,1228,warlock,demonology,24,13,11
Welendiock,malganis,1228,warlock,demonology,43,21,22
Kothoped,wyrmrest-accord,1227,warlock,demonology,30,13,17
Es,velen,1226,warlock,demonology,72,34,38
Jezzika,azralon,1211,warlock,demonology,45,17,28
Zeeref,stormrage,1206,warlock,demonology,30,13,17
Demophile,bleeding-hollow,1204,warlock,demonology,24,18,6
Lockdlhm,tichondrius,1197,warlock,demonology,23,13,10
Syndrielle,emerald-dream,1175,warlock,demonology,42,16,26
Artmaster,nordrassil,1174,warlock,demonology,30,20,10
Snuffer,detheroc,1164,warlock,demonology,30,13,17
Adistril,bleeding-hollow,1161,warlock,demonology,42,13,29
Zjxy,tichondrius,1152,warlock,demonology,18,12,6
Voidxz,tichondrius,1152,warlock,demonology,18,12,6
Medzor,tichondrius,1152,warlock,demonology,24,12,12
Blliizz,aegwynn,1151,warlock,demonology,18,12,6
Mongobros,illidan,1151,warlock,demonology,24,12,12
Tazerr,sargeras,1151,warlock,demonology,24,12,12
Demise,azuremyst,1151,warlock,demonology,24,12,12
Spectaclol,crushridge,1150,warlock,demonology,18,12,6
Emurog,icecrown,1150,warlock,demonology,18,12,6
Lentil,zuljin,1150,warlock,demonology,18,12,6
Daxxter,tichondrius,1149,warlock,demonology,24,12,12
Kotica,stormrage,1149,warlock,demonology,28,13,15
Chipt,kelthuzad,1149,warlock,demonology,30,12,18
Zrò,bleeding-hollow,1147,warlock,demonology,18,12,6
Nyhn,bleeding-hollow,1144,warlock,demonology,18,12,6
Critthis,illidan,1141,warlock,demonology,24,12,12
Wawrlock,stormrage,1140,warlock,demonology,18,12,6
Moryan,malfurion,1136,warlock,demonology,33,13,20
Saltiernuts,malganis,1128,warlock,demonology,48,22,26
Xtralyfe,hyjal,1117,warlock,demonology,22,12,10
Omertà,staghelm,1114,warlock,demonology,22,13,9
Warlockafk,darkspear,1109,warlock,demonology,18,12,6
Kronicdotz,bleeding-hollow,1102,warlock,demonology,26,13,13
Löksöflöve,sargeras,1101,warlock,demonology,60,25,35
Elipsis,bloodhoof,1086,warlock,demonology,23,12,11
Netherhigh,tichondrius,1085,warlock,demonology,42,21,21
Politepvperx,kelthuzad,1070,warlock,demonology,17,12,5
Lilmollyboy,demon-soul,1068,warlock,demonology,13,12,1
Bøltqt,tichondrius,1056,warlock,demonology,12,11,1
Igortrikadva,zuljin,1056,warlock,demonology,12,11,1
Waii,emerald-dream,1056,warlock,demonology,12,11,1
Voidbb,tichondrius,1056,warlock,demonology,24,11,13
Iordozzy,malganis,1055,warlock,demonology,18,11,7
Fearbarx,illidan,1055,warlock,demonology,18,11,7
Homeschooler,darkspear,1055,warlock,demonology,18,11,7
Betterone,azralon,1055,warlock,demonology,18,11,7
Fotmspec,area-52,1055,warlock,demonology,18,11,7
Comina,kelthuzad,1055,warlock,demonology,24,11,13
Minervini,kiljaeden,1054,warlock,demonology,12,11,1
Praemonium,dalaran,1054,warlock,demonology,18,11,7
Stormrift,sargeras,1052,warlock,demonology,30,11,19
Pollodelight,deathwing,1051,warlock,demonology,18,11,7
Zorah,quelthalas,1051,warlock,demonology,18,11,7
Menedemus,amanthul,1050,warlock,demonology,24,11,13
Mêdìvh,tichondrius,1050,warlock,demonology,24,11,13
Zinkro,quelthalas,1049,warlock,demonology,22,12,10
Tròll,moon-guard,1049,warlock,demonology,54,25,29
Tartamuda,ragnaros,1037,warlock,demonology,30,11,19
Yozzik,illidan,1036,warlock,demonology,29,11,18
Rickrock,gnomeregan,1034,warlock,demonology,18,11,7
Rannieck,dark-iron,1022,warlock,demonology,16,12,4
Tichondrus,ragnaros,1007,warlock,demonology,29,11,18
Stankidanky,illidan,1002,warlock,demonology,18,11,7
Minichompei,frostmourne,990,warlock,demonology,17,11,6
Lukelock,azralon,990,warlock,demonology,22,11,11
Mocreia,azralon,981,warlock,demonology,28,11,17
Uzag,mugthol,975,warlock,demonology,26,11,15
Meltlordqt,mannoroth,960,warlock,demonology,12,10,2
Phyxylock,stormrage,960,warlock,demonology,12,10,2
Séptima,illidan,960,warlock,demonology,12,10,2
Hecataeus,stormrage,960,warlock,demonology,12,10,2
Xyguoguo,tichondrius,960,warlock,demonology,18,10,8
Klol,proudmoore,960,warlock,demonology,18,10,8
Spacedots,illidan,960,warlock,demonology,18,10,8
Idiocy,stormrage,960,warlock,demonology,18,10,8
Felegance,proudmoore,960,warlock,demonology,18,10,8
Vexice,firetree,960,warlock,demonology,18,10,8
Millions,barthilas,960,warlock,demonology,24,10,14
Slothycrip,emerald-dream,960,warlock,demonology,30,10,20
Syraxi,illidan,959,warlock,demonology,18,10,8
Purraisa,tichondrius,959,warlock,demonology,18,10,8
Hâm,dalaran,959,warlock,demonology,36,10,26
Ötì,altar-of-storms,958,warlock,demonology,12,10,2
Daesire,moon-guard,957,warlock,demonology,18,10,8
Lockswagger,stormrage,956,warlock,demonology,18,10,8
Bizcochito,thrall,955,warlock,demonology,18,10,8
Zaintv,illidan,955,warlock,demonology,18,10,8
Musgrin,gallywix,955,warlock,demonology,24,10,14
Leine,proudmoore,955,warlock,demonology,24,10,14
Methrocks,emerald-dream,953,warlock,demonology,24,10,14
Sørceress,bonechewer,948,warlock,demonology,18,10,8
Sheara,silver-hand,905,warlock,demonology,24,10,14
Twinklockxx,mannoroth,895,warlock,demonology,23,10,13
Apples,ravencrest,894,warlock,demonology,17,10,7
Maxice,zuljin,864,warlock,demonology,12,9,3
Impenjoyer,tichondrius,864,warlock,demonology,12,9,3
Azrezzael,area-52,864,warlock,demonology,12,9,3
Peterdotz,whisperwind,864,warlock,demonology,13,9,4
Louu,emerald-dream,864,warlock,demonology,18,9,9
Bewær,deathwing,864,warlock,demonology,18,9,9
Evanylock,proudmoore,864,warlock,demonology,18,9,9
Dxhusky,tichondrius,864,warlock,demonology,18,9,9
Abomasnow,frostmourne,864,warlock,demonology,18,9,9
Deboltzaru,ragnaros,864,warlock,demonology,19,9,10
Ezgamejr,tichondrius,863,warlock,demonology,12,9,3
Fatals,thrall,863,warlock,demonology,12,9,3
Jorloz,ragnaros,863,warlock,demonology,12,9,3
Criticalpets,stormrage,863,warlock,demonology,18,9,9
Harleyjames,ravenholdt,862,warlock,demonology,12,9,3
Päpï,tichondrius,862,warlock,demonology,12,9,3
Oopsíe,nagrand,860,warlock,demonology,24,9,15
Varian,quelthalas,860,warlock,demonology,24,9,15
Easymac,thunderlord,860,warlock,demonology,24,9,15
Braylon,azuremyst,856,warlock,demonology,18,9,9
Orbvoid,sargeras,845,warlock,demonology,24,9,15
Demoniclily,kiljaeden,816,warlock,demonology,21,9,12
Cleavüs,stormrage,815,warlock,demonology,11,9,2
Moramont,stormrage,768,warlock,demonology,12,8,4
Xanetor,illidan,768,warlock,demonology,12,8,4
Bigboltkazar,tichondrius,768,warlock,demonology,12,8,4
Asmion,earthen-ring,768,warlock,demonology,12,8,4
Lockedlock,nemesis,768,warlock,demonology,12,8,4
Perfectíon,tichondrius,768,warlock,demonology,12,8,4
Marshyxd,tichondrius,768,warlock,demonology,12,8,4
Pvtpotato,tichondrius,768,warlock,demonology,12,8,4
Gnumbnutz,blades-edge,768,warlock,demonology,12,8,4
Westhofs,sargeras,768,warlock,demonology,12,8,4
Thefunk,tichondrius,768,warlock,demonology,12,8,4
Malatharr,quelthalas,768,warlock,demonology,12,8,4
Niava,tichondrius,768,warlock,demonology,18,8,10
Tinkerfell,sargeras,768,warlock,demonology,18,8,10
Dunni,area-52,768,warlock,demonology,18,8,10
Joseph,draktharon,768,warlock,demonology,18,8,10
Vasqu,stormrage,768,warlock,demonology,18,8,10
Nismo,trollbane,768,warlock,demonology,18,8,10
Bïcho,queldorei,768,warlock,demonology,18,8,10
Neutrinowal,tichondrius,768,warlock,demonology,24,8,16
Rosacrutian,tichondrius,767,warlock,demonology,12,8,4
Shâdowman,stormrage,767,warlock,demonology,12,8,4
Gibberishss,tichondrius,767,warlock,demonology,12,8,4
Regime,deathwing,767,warlock,demonology,12,8,4
Fullmelt,azjolnerub,767,warlock,demonology,18,8,10
Boltsfordays,dalaran,767,warlock,demonology,24,8,16
Bojàck,stormrage,766,warlock,demonology,12,8,4
Elioknight,area-52,766,warlock,demonology,18,8,10
Warlockdelux,thrall,766,warlock,demonology,24,8,16
Lustyclam,tichondrius,765,warlock,demonology,12,8,4
Cvntpvntcans,kelthuzad,764,warlock,demonology,18,8,10
Pulentinskin,quelthalas,764,warlock,demonology,24,8,16
Bâppo,antonidas,714,warlock,demonology,24,11,13
Eklypso,kelthuzad,714,warlock,demonology,20,9,11
Devilin,drakkari,672,warlock,demonology,12,7,5
Laiquisha,zuljin,672,warlock,demonology,12,7,5
Bestcookies,malganis,672,warlock,demonology,12,7,5
Sauronne,illidan,672,warlock,demonology,12,7,5
Actualjoke,frostmourne,672,warlock,demonology,12,7,5
Dadtired,tichondrius,672,warlock,demonology,12,7,5
Deammon,tichondrius,672,warlock,demonology,12,7,5
Djvetis,blackhand,672,warlock,demonology,12,7,5
Protomán,agamaggan,672,warlock,demonology,12,7,5
Isömetrics,barthilas,672,warlock,demonology,12,7,5
Fearmore,bleeding-hollow,672,warlock,demonology,12,7,5
Zeexi,illidan,672,warlock,demonology,12,7,5
Sorenbjerga,zuljin,672,warlock,demonology,12,7,5
Anjkh,skullcrusher,672,warlock,demonology,12,7,5
Aruotnof,nemesis,672,warlock,demonology,12,7,5
Demonmal,frostmourne,672,warlock,demonology,12,7,5
Løckyun,tichondrius,672,warlock,demonology,12,7,5
Ðamndaddy,sargeras,672,warlock,demonology,12,7,5
Expiredonion,bleeding-hollow,672,warlock,demonology,12,7,5
Agla,quelthalas,672,warlock,demonology,12,7,5
Lifeinsuranc,tichondrius,672,warlock,demonology,12,7,5
Jweezy,malganis,672,warlock,demonology,12,7,5
Staywrong,malganis,672,warlock,demonology,18,7,11
Ranil,mannoroth,672,warlock,demonology,18,7,11
Matrriixx,proudmoore,672,warlock,demonology,18,7,11
Evarona,gorefiend,672,warlock,demonology,18,7,11
Nëcrophil,area-52,671,warlock,demonology,12,7,5
Damagexx,the-underbog,671,warlock,demonology,12,7,5
Saldori,malganis,671,warlock,demonology,12,7,5
Glortheeb,spirestone,671,warlock,demonology,12,7,5
Celindeyn,stormrage,671,warlock,demonology,12,7,5
Dotsfired,crushridge,671,warlock,demonology,18,7,11
Bashel,sargeras,670,warlock,demonology,12,7,5
Deanwarlock,sargeras,670,warlock,demonology,12,7,5
Nostractus,azralon,667,warlock,demonology,12,7,5
Lokiiee,azuremyst,664,warlock,demonology,12,7,5
Tsmcfker,tichondrius,654,warlock,demonology,17,7,10
Voldamorte,tichondrius,639,warlock,demonology,17,7,10
Bänno,bleeding-hollow,623,warlock,demonology,11,7,4
Chlomakï,azralon,622,warlock,demonology,11,7,4
Chaosboltex,tichondrius,618,warlock,demonology,14,8,6
Ritzhul,nordrassil,576,warlock,demonology,6,6,0
Nðm,tichondrius,576,warlock,demonology,6,6,0
Lillpfudd,area-52,576,warlock,demonology,6,6,0
Eddybigbolts,tichondrius,576,warlock,demonology,12,6,6
Chaosblade,burning-blade,576,warlock,demonology,12,6,6
Sorath,blackrock,576,warlock,demonology,12,6,6
Kyralena,stormrage,576,warlock,demonology,12,6,6
Aboode,blackrock,576,warlock,demonology,12,6,6
Zoerina,fizzcrank,576,warlock,demonology,12,6,6
Jæja,wyrmrest-accord,576,warlock,demonology,12,6,6
Marothredd,nathrezim,576,warlock,demonology,12,6,6
Oniyooshi,kelthuzad,576,warlock,demonology,12,6,6
Epícburn,illidan,576,warlock,demonology,12,6,6
Davidofbowie,burning-legion,576,warlock,demonology,12,6,6
Dalah,illidan,576,warlock,demonology,12,6,6
Pumpkeenky,hyjal,576,warlock,demonology,12,6,6
Muchopower,ragnaros,576,warlock,demonology,12,6,6
Yaldin,nemesis,576,warlock,demonology,12,6,6
Imbooms,blackrock,576,warlock,demonology,12,6,6
Sytrick,bleeding-hollow,576,warlock,demonology,12,6,6
Westhofz,tichondrius,576,warlock,demonology,12,6,6
Bellath,azralon,576,warlock,demonology,12,6,6
Projectpump,kelthuzad,576,warlock,demonology,12,6,6
Scarletdemon,malganis,576,warlock,demonology,12,6,6
Destructio,tichondrius,576,warlock,demonology,12,6,6
Artzul,tichondrius,576,warlock,demonology,15,7,8
Yazonics,area-52,576,warlock,demonology,18,6,12
Dreadful,frostmourne,576,warlock,demonology,18,6,12
Puchador,sargeras,576,warlock,demonology,18,6,12
Shadowhax,area-52,576,warlock,demonology,18,6,12
Ragnalock,laughing-skull,576,warlock,demonology,20,6,14
Shadü,tichondrius,576,warlock,demonology,25,6,19
Bazeni,frostmourne,575,warlock,demonology,6,6,0
Griffoz,frostwolf,575,warlock,demonology,12,6,6
Ronacq,norgannon,575,warlock,demonology,12,6,6
Xenagos,antonidas,575,warlock,demonology,12,6,6
Twototheone,illidan,575,warlock,demonology,12,6,6
Sylvanes,emerald-dream,575,warlock,demonology,12,6,6
Szell,caelestrasz,575,warlock,demonology,12,6,6
Voidgown,moon-guard,575,warlock,demonology,12,6,6
Naydene,moon-guard,575,warlock,demonology,18,6,12
Canning,shuhalo,575,warlock,demonology,18,6,12
Nécromonster,illidan,574,warlock,demonology,18,6,12
Undeadcurse,frostmourne,574,warlock,demonology,24,6,18
Algard,emerald-dream,573,warlock,demonology,12,6,6
Keturáh,garrosh,566,warlock,demonology,12,6,6
Westhøf,sargeras,543,warlock,demonology,11,6,5
Jafi,coilfang,543,warlock,demonology,17,6,11
Penzer,stormrage,528,warlock,demonology,15,6,9
Creepydotman,mannoroth,511,warlock,demonology,14,6,8
Velrose,thrall,480,warlock,demonology,6,5,1
Necrotko,malganis,480,warlock,demonology,6,5,1
Tiatiatia,illidan,480,warlock,demonology,6,5,1
Owwie,malganis,480,warlock,demonology,6,5,1
Niadmer,gnomeregan,480,warlock,demonology,6,5,1
Khaozx,ragnaros,480,warlock,demonology,6,5,1
Aînzooalgown,ragnaros,480,warlock,demonology,6,5,1
Sinixx,tichondrius,480,warlock,demonology,6,5,1
Seutóóbinha,stormrage,480,warlock,demonology,6,5,1
Luku,kiljaeden,480,warlock,demonology,6,5,1
Igniz,tichondrius,480,warlock,demonology,6,5,1
Salsong,draka,480,warlock,demonology,6,5,1
Reneqtxo,frostmourne,480,warlock,demonology,6,5,1
Drainedd,blades-edge,480,warlock,demonology,6,5,1
Gavvi,frostmourne,480,warlock,demonology,6,5,1
Symplicìty,area-52,480,warlock,demonology,6,5,1
Dodgebolts,khaz-modan,480,warlock,demonology,6,5,1
Druzzaj,thrall,480,warlock,demonology,6,5,1
Charlieo,barthilas,480,warlock,demonology,6,5,1
Scalpelexis,stormrage,480,warlock,demonology,6,5,1
Floorlamp,anvilmar,480,warlock,demonology,6,5,1
Beerbolt,dalaran,480,warlock,demonology,6,5,1
Fshi,frostmourne,480,warlock,demonology,12,5,7
Meisy,quelthalas,480,warlock,demonology,12,5,7
Klumzey,tichondrius,480,warlock,demonology,12,5,7
Grandpapapa,tichondrius,480,warlock,demonology,12,5,7
Grineed,emerald-dream,480,warlock,demonology,12,5,7
Dapperdanxy,tichondrius,480,warlock,demonology,12,5,7
Wdc,illidan,480,warlock,demonology,12,5,7
Mânuel,akama,480,warlock,demonology,12,5,7
Rumpology,illidan,480,warlock,demonology,12,5,7
Rooms,sargeras,480,warlock,demonology,12,5,7
Breeak,sargeras,480,warlock,demonology,12,5,7
Alataar,sargeras,480,warlock,demonology,12,5,7
Tribulatiön,moon-guard,480,warlock,demonology,12,5,7
Ragdoll,illidan,480,warlock,demonology,12,5,7
Yungwilly,silvermoon,480,warlock,demonology,12,5,7
Dewandoritos,kelthuzad,480,warlock,demonology,12,5,7
Wheremyshoes,area-52,480,warlock,demonology,12,5,7
Liuh,tichondrius,480,warlock,demonology,12,5,7
Demic,thrall,480,warlock,demonology,12,5,7
Søcks,tichondrius,480,warlock,demonology,12,5,7
Aellorie,proudmoore,480,warlock,demonology,12,5,7
Zarinista,veknilash,480,warlock,demonology,12,5,7
Demonâ,ragnaros,480,warlock,demonology,12,5,7
Demonkiiller,kelthuzad,480,warlock,demonology,12,5,7
Sinápsís,ragnaros,480,warlock,demonology,12,5,7
Gandreleda,wyrmrest-accord,480,warlock,demonology,16,6,10
Paleontology,moon-guard,480,warlock,demonology,14,5,9
Arckádia,stormrage,480,warlock,demonology,18,5,13
Yury,scarlet-crusade,479,warlock,demonology,12,5,7
Stinkmeaner,chogall,479,warlock,demonology,12,5,7
Eflock,barthilas,479,warlock,demonology,12,5,7
Omegawarlock,quelthalas,479,warlock,demonology,18,5,13
Lockybalbowa,amanthul,479,warlock,demonology,18,5,13
Sathorastus,spirestone,448,warlock,demonology,10,6,4
Sicksick,tichondrius,426,warlock,demonology,15,6,9
Agaros,zuljin,426,warlock,demonology,17,6,11
Dôctor,tichondrius,400,warlock,demonology,13,5,8
Rosalynda,azralon,398,warlock,demonology,10,5,5
Catarina,kaelthas,384,warlock,demonology,6,4,2
Leleth,nordrassil,384,warlock,demonology,6,4,2
Hélà,sargeras,384,warlock,demonology,6,4,2
Il,nerzhul,384,warlock,demonology,6,4,2
Fokâi,sargeras,384,warlock,demonology,6,4,2
Mazzaleen,area-52,384,warlock,demonology,6,4,2
Ardam,cenarion-circle,384,warlock,demonology,6,4,2
Ahp,stormrage,384,warlock,demonology,6,4,2
Frezy,stormrage,384,warlock,demonology,6,4,2
Lizlock,stormrage,384,warlock,demonology,6,4,2
Deatthmoon,stormrage,384,warlock,demonology,6,4,2
Ethero,emerald-dream,384,warlock,demonology,6,4,2
Lockniel,skullcrusher,384,warlock,demonology,6,4,2
Hordefella,malganis,384,warlock,demonology,6,4,2
Coomerdoomer,stormrage,384,warlock,demonology,6,4,2
Frustration,darkspear,384,warlock,demonology,6,4,2
Vesaloth,zuljin,384,warlock,demonology,6,4,2
Drix,wyrmrest-accord,384,warlock,demonology,6,4,2
Menemies,malganis,384,warlock,demonology,6,4,2
Bellatriks,nemesis,384,warlock,demonology,6,4,2
Meep,madoran,384,warlock,demonology,6,4,2
Rodneyjones,emerald-dream,384,warlock,demonology,6,4,2
Kyrionn,azralon,384,warlock,demonology,6,4,2
Djdemolordx,bleeding-hollow,384,warlock,demonology,6,4,2
Crayonchewer,alleria,384,warlock,demonology,6,4,2
Lambe,tichondrius,384,warlock,demonology,6,4,2
Xekk,wyrmrest-accord,384,warlock,demonology,6,4,2
Viejitaa,quelthalas,384,warlock,demonology,6,4,2
Quonton,tichondrius,384,warlock,demonology,6,4,2
Curpt,the-scryers,384,warlock,demonology,6,4,2
Helheim,haomarush,384,warlock,demonology,6,4,2
Brujever,ragnaros,384,warlock,demonology,6,4,2
Vilebrute,illidan,384,warlock,demonology,6,4,2
Ptwo,illidan,384,warlock,demonology,6,4,2
Fanzhiyi,illidan,384,warlock,demonology,6,4,2
Kernlberton,tichondrius,384,warlock,demonology,6,4,2
Moräl,frostmourne,384,warlock,demonology,6,4,2
Jvilla,tichondrius,384,warlock,demonology,6,4,2
Alchan,tichondrius,384,warlock,demonology,6,4,2
Syndel,drakkari,384,warlock,demonology,6,4,2
Bigmancam,illidan,384,warlock,demonology,6,4,2
Conjur,barthilas,384,warlock,demonology,6,4,2
Meelady,tichondrius,384,warlock,demonology,6,4,2
Dashaad,illidan,384,warlock,demonology,6,4,2
Thanock,illidan,384,warlock,demonology,6,4,2
Famington,tichondrius,384,warlock,demonology,6,4,2
Sakuin,bonechewer,384,warlock,demonology,6,4,2
Nerolock,frostmourne,384,warlock,demonology,6,4,2
Retaruko,illidan,384,warlock,demonology,6,4,2
Logixo,sargeras,384,warlock,demonology,7,4,3
Warlooch,area-52,384,warlock,demonology,9,5,4
Woudini,malganis,384,warlock,demonology,10,5,5
Nazare,tichondrius,384,warlock,demonology,12,4,8
Xoxoxu,frostmourne,384,warlock,demonology,12,4,8
Tahmrin,quelthalas,384,warlock,demonology,12,4,8
Uarus,tichondrius,384,warlock,demonology,12,4,8
Soulrman,tichondrius,384,warlock,demonology,12,4,8
Demodar,tol-barad,384,warlock,demonology,12,4,8
Warlack,jubeithos,384,warlock,demonology,12,4,8
Arsaurelica,blackrock,384,warlock,demonology,12,4,8
Deatt,deathwing,384,warlock,demonology,12,4,8
Srz,stormrage,384,warlock,demonology,12,4,8
Pìnto,illidan,384,warlock,demonology,12,4,8
Ddorangmoon,tichondrius,384,warlock,demonology,12,4,8
Rylal,illidan,384,warlock,demonology,12,4,8
Picklecatz,barthilas,384,warlock,demonology,12,4,8
Diekast,tichondrius,384,warlock,demonology,12,4,8
Çheesestick,dalaran,384,warlock,demonology,12,4,8
Dogcookie,moon-guard,384,warlock,demonology,12,4,8
Ven,dalaran,384,warlock,demonology,12,4,8
Naz,shadowsong,384,warlock,demonology,12,4,8
Demonia,dathremar,384,warlock,demonology,12,4,8
Nefertarie,illidan,384,warlock,demonology,12,4,8
Tofulery,tichondrius,384,warlock,demonology,18,4,14
Dagadon,arathor,384,warlock,demonology,24,4,20
Lockman,frostwolf,383,warlock,demonology,6,4,2
Greems,tichondrius,383,warlock,demonology,6,4,2
Daggondai,tichondrius,383,warlock,demonology,12,4,8
Voodootidies,proudmoore,382,warlock,demonology,9,4,5
Mamabolts,kelthuzad,367,warlock,demonology,11,4,7
Freshimps,blood-furnace,367,warlock,demonology,11,4,7
Sharee,azuremyst,363,warlock,demonology,11,4,7
Ärminvßuurën,barthilas,351,warlock,demonology,11,4,7
Sumondeznuts,wyrmrest-accord,319,warlock,demonology,5,4,1
Rentacletape,kelthuzad,319,warlock,demonology,5,4,1
Gotty,stormrage,288,warlock,demonology,6,3,3
Iamfear,shuhalo,288,warlock,demonology,6,3,3
Naokishi,stormrage,288,warlock,demonology,6,3,3
Crtyodautr,skullcrusher,288,warlock,demonology,6,3,3
Archleon,smolderthorn,288,warlock,demonology,6,3,3
Superbroly,area-52,288,warlock,demonology,6,3,3
Yanned,hakkar,288,warlock,demonology,6,3,3
Hauntsin,hyjal,288,warlock,demonology,6,3,3
Keezus,area-52,288,warlock,demonology,6,3,3
Bral,hyjal,288,warlock,demonology,6,3,3
Feartool,stormrage,288,warlock,demonology,6,3,3
Domwarlock,uther,288,warlock,demonology,6,3,3
Areolaz,kelthuzad,288,warlock,demonology,6,3,3
Juankkii,bonechewer,288,warlock,demonology,6,3,3
Capslock,arthas,288,warlock,demonology,6,3,3
Shutupthug,illidan,288,warlock,demonology,6,3,3
Sooshi,malganis,288,warlock,demonology,6,3,3
Deadlylock,gilneas,288,warlock,demonology,6,3,3
Asiopdu,tichondrius,288,warlock,demonology,6,3,3
Faraday,laughing-skull,288,warlock,demonology,6,3,3
Molguzano,ragnaros,288,warlock,demonology,6,3,3
Criptix,bleeding-hollow,288,warlock,demonology,6,3,3
Aeonss,stormrage,288,warlock,demonology,6,3,3
Sangala,malganis,288,warlock,demonology,6,3,3
Shìnedown,eonar,288,warlock,demonology,6,3,3
Didntflush,blood-furnace,288,warlock,demonology,6,3,3
Disgustingfk,illidan,288,warlock,demonology,6,3,3
Drerrday,kelthuzad,288,warlock,demonology,6,3,3
Leonito,tichondrius,288,warlock,demonology,6,3,3
Dippndotz,bleeding-hollow,288,warlock,demonology,6,3,3
Ganknãmstyle,illidan,288,warlock,demonology,6,3,3
Volanti,bleeding-hollow,288,warlock,demonology,6,3,3
Impbiscuit,stormrage,288,warlock,demonology,6,3,3
Darthael,stormrage,288,warlock,demonology,6,3,3
Ðemented,bleeding-hollow,288,warlock,demonology,6,3,3
Tynks,mannoroth,288,warlock,demonology,6,3,3
Drelgun,aerie-peak,288,warlock,demonology,6,3,3
Asmodeun,malganis,288,warlock,demonology,6,3,3
Locksoul,area-52,288,warlock,demonology,6,3,3
Lhordeign,area-52,288,warlock,demonology,6,3,3
Viejita,quelthalas,288,warlock,demonology,6,3,3
Wiredftw,illidan,288,warlock,demonology,6,3,3
Zanlockos,dalaran,288,warlock,demonology,6,3,3
Psyløck,bleeding-hollow,288,warlock,demonology,6,3,3
Lefteexd,tichondrius,288,warlock,demonology,6,3,3
Dkdakìng,dalaran,288,warlock,demonology,6,3,3
Pikslol,bleeding-hollow,288,warlock,demonology,6,3,3
Agonie,tichondrius,288,warlock,demonology,6,3,3
Hgma,tichondrius,288,warlock,demonology,6,3,3
Poggun,tichondrius,288,warlock,demonology,6,3,3
Chaøsbolt,area-52,288,warlock,demonology,6,3,3
Fëlgibson,illidan,288,warlock,demonology,6,3,3
Chody,sargeras,288,warlock,demonology,6,3,3
Soulruler,tichondrius,288,warlock,demonology,6,3,3
Gulvandan,dathremar,288,warlock,demonology,6,3,3
Fancynuts,kiljaeden,288,warlock,demonology,6,3,3
Guldylox,kiljaeden,288,warlock,demonology,6,3,3
Kodyconner,darkspear,288,warlock,demonology,6,3,3
Idoturmum,frostmourne,288,warlock,demonology,6,3,3
Elementzero,malorne,288,warlock,demonology,6,3,3
Notprint,sargeras,288,warlock,demonology,6,3,3
Lockinha,azralon,288,warlock,demonology,6,3,3
Schrader,sargeras,288,warlock,demonology,6,3,3
Drsauce,sargeras,288,warlock,demonology,6,3,3
Graveland,frostwolf,288,warlock,demonology,6,3,3
Zhul,nerzhul,288,warlock,demonology,6,3,3
Rumjugs,barthilas,288,warlock,demonology,6,3,3
Symaitiel,azralon,288,warlock,demonology,6,3,3
Khamzatt,proudmoore,288,warlock,demonology,6,3,3
Teron,stonemaul,288,warlock,demonology,6,3,3
Fatuglyegirl,sargeras,288,warlock,demonology,6,3,3
Tesil,tichondrius,288,warlock,demonology,6,3,3
Munick,spirestone,288,warlock,demonology,6,3,3
Khatrat,azralon,288,warlock,demonology,6,3,3
Bertnasty,tichondrius,288,warlock,demonology,6,3,3
Azland,proudmoore,288,warlock,demonology,6,3,3
Jennifear,sargeras,288,warlock,demonology,6,3,3
Nockdreal,azralon,288,warlock,demonology,6,3,3
Blastyboat,terenas,288,warlock,demonology,6,3,3
Cyrillus,moon-guard,288,warlock,demonology,6,3,3
Saffuky,frostmourne,288,warlock,demonology,6,3,3
Itzlandox,emerald-dream,288,warlock,demonology,6,3,3
Nightterrour,frostmourne,288,warlock,demonology,6,3,3
Jèdi,drenden,288,warlock,demonology,6,3,3
Lilthicy,sargeras,288,warlock,demonology,6,3,3
Insanemids,tichondrius,288,warlock,demonology,6,3,3
Diebydots,blackrock,288,warlock,demonology,6,3,3
Okul,frostmourne,288,warlock,demonology,6,3,3
Neruvian,tichondrius,288,warlock,demonology,6,3,3
Whydemono,tichondrius,288,warlock,demonology,6,3,3
Nipz,korialstrasz,288,warlock,demonology,6,3,3
Alprazoläm,illidan,288,warlock,demonology,14,6,8
Constantine,exodar,288,warlock,demonology,12,3,9
Dàmagicman,drakthul,288,warlock,demonology,12,3,9
Pachips,zuljin,288,warlock,demonology,12,3,9
Wineburger,frostmourne,288,warlock,demonology,12,3,9
Strax,shattered-hand,288,warlock,demonology,12,3,9
Mementomøri,quelthalas,288,warlock,demonology,12,3,9
Tatemor,barthilas,288,warlock,demonology,12,3,9
Legïõn,uldaman,288,warlock,demonology,12,3,9
Albbanoo,tichondrius,288,warlock,demonology,12,3,9
Crispee,azuremyst,288,warlock,demonology,12,3,9
Overlard,illidan,288,warlock,demonology,12,3,9
Killvilock,kelthuzad,288,warlock,demonology,12,3,9
Kwrhitom,zuljin,288,warlock,demonology,12,3,9
Gbow,malygos,287,warlock,demonology,6,3,3
Ijustsharded,area-52,255,warlock,demonology,11,3,8
Slugworth,rivendare,239,warlock,demonology,5,3,2
Quetzâlcoâtl,sargeras,239,warlock,demonology,5,3,2
Ceeloww,illidan,239,warlock,demonology,5,3,2
Uwantpeach,tichondrius,239,warlock,demonology,5,3,2
Frankandbean,dawnbringer,234,warlock,demonology,7,4,3
Getavoided,azralon,234,warlock,demonology,7,4,3
Predictions,sargeras,234,warlock,demonology,10,5,5
Apøçàlÿpsè,firetree,234,warlock,demonology,11,5,6
Schofen,tichondrius,234,warlock,demonology,13,4,9
Annubyz,quelthalas,208,warlock,demonology,7,3,4
Cocoabuttâ,stormrage,192,warlock,demonology,4,3,1
Honne,sargeras,192,warlock,demonology,4,3,1
Javirr,ragnaros,192,warlock,demonology,15,5,10
Kaertis,emerald-dream,192,warlock,demonology,9,3,6
Wearelegionx,frostmourne,192,warlock,demonology,6,2,4
Promancer,drakkari,192,warlock,demonology,6,2,4
Vendareth,earthen-ring,192,warlock,demonology,6,2,4
Borudo,thrall,192,warlock,demonology,6,2,4
Ggaayyooii,anubarak,192,warlock,demonology,6,2,4
Réliok,quelthalas,192,warlock,demonology,6,2,4
Xuker,tichondrius,192,warlock,demonology,6,2,4
Umadbruhh,tichondrius,192,warlock,demonology,6,2,4
Pinkypay,ragnaros,192,warlock,demonology,6,2,4
Feardr,frostmourne,192,warlock,demonology,6,2,4
Greenbeanzs,tichondrius,192,warlock,demonology,6,2,4
Feldotz,illidan,192,warlock,demonology,6,2,4
Ziroken,crushridge,192,warlock,demonology,6,2,4
Destructo,illidan,192,warlock,demonology,6,2,4
Felforyouu,illidan,192,warlock,demonology,6,2,4
Qic,runetotem,192,warlock,demonology,6,2,4
Irene,nagrand,192,warlock,demonology,6,2,4
Zalissel,proudmoore,192,warlock,demonology,6,2,4
Draino,tichondrius,192,warlock,demonology,6,2,4
Warfeen,malganis,192,warlock,demonology,6,2,4
Nigthdeath,nemesis,192,warlock,demonology,6,2,4
Rôsé,tichondrius,192,warlock,demonology,6,2,4
Zevoc,tichondrius,192,warlock,demonology,6,2,4
Cozu,tichondrius,192,warlock,demonology,6,2,4
Psykana,barthilas,192,warlock,demonology,6,2,4
Caesis,illidan,192,warlock,demonology,6,2,4
Bagelandlock,tichondrius,192,warlock,demonology,6,2,4
Brough,illidan,192,warlock,demonology,6,2,4
Soorisoori,tichondrius,192,warlock,demonology,6,2,4
Hentailust,kiljaeden,192,warlock,demonology,6,2,4
Pulpfliction,kiljaeden,192,warlock,demonology,6,2,4
Doomtome,moon-guard,192,warlock,demonology,6,2,4
Xblessed,stormrage,192,warlock,demonology,6,2,4
Capïrota,nemesis,192,warlock,demonology,6,2,4
Kaosqt,nemesis,192,warlock,demonology,6,2,4
Aceej,nazgrel,192,warlock,demonology,6,2,4
Soulbane,tol-barad,192,warlock,demonology,6,2,4
Jkun,malganis,192,warlock,demonology,6,2,4
Boon,spirestone,192,warlock,demonology,6,2,4
Agamendoir,frostmane,192,warlock,demonology,6,2,4
Zerowarlock,stormrage,192,warlock,demonology,6,2,4
Lopenx,korgath,192,warlock,demonology,6,2,4
Barbieelf,sargeras,192,warlock,demonology,6,2,4
Shadow,frostwolf,192,warlock,demonology,6,2,4
Koffay,bleeding-hollow,192,warlock,demonology,6,2,4
Maroth,elune,192,warlock,demonology,6,2,4
Sinissa,ysondre,192,warlock,demonology,6,2,4
Stuffs,wyrmrest-accord,192,warlock,demonology,6,2,4
Sphîñx,sargeras,192,warlock,demonology,6,2,4
Firemike,kelthuzad,192,warlock,demonology,6,2,4
Tomathus,moon-guard,192,warlock,demonology,6,2,4
Ðeimøn,azralon,192,warlock,demonology,6,2,4
Erc,alterac-mountains,192,warlock,demonology,6,2,4
Wtb,blackrock,192,warlock,demonology,6,2,4
Evilempire,sargeras,192,warlock,demonology,6,2,4
Dotsandpot,malfurion,192,warlock,demonology,6,2,4
Infecçäo,stormrage,192,warlock,demonology,6,2,4
Sheshð,stormrage,192,warlock,demonology,6,2,4
Watchmeport,onyxia,192,warlock,demonology,6,2,4
Lilbiackguy,stormrage,192,warlock,demonology,6,2,4
Anukh,emerald-dream,192,warlock,demonology,6,2,4
Sakyameil,area-52,192,warlock,demonology,6,2,4
Nanicide,kelthuzad,192,warlock,demonology,6,2,4
Yuckytoetoe,emerald-dream,192,warlock,demonology,6,2,4
Leônidos,ghostlands,192,warlock,demonology,6,2,4
Draindeez,sargeras,192,warlock,demonology,6,2,4
Ceelowtf,sargeras,192,warlock,demonology,6,2,4
Caduz,stormrage,192,warlock,demonology,6,2,4
Wreckquiem,draka,192,warlock,demonology,6,2,4
Reckzet,stormrage,192,warlock,demonology,6,2,4
Trippednfel,stormrage,192,warlock,demonology,6,2,4
Cursedkash,stormrage,192,warlock,demonology,6,2,4
Rokdas,area-52,192,warlock,demonology,6,2,4
Knobbynobbas,stormrage,192,warlock,demonology,6,2,4
Darkboltz,area-52,192,warlock,demonology,6,2,4
Buboñic,area-52,192,warlock,demonology,6,2,4
Dedology,area-52,192,warlock,demonology,6,2,4
Daliadark,sargeras,192,warlock,demonology,9,2,7
Elyshia,illidan,192,warlock,demonology,15,3,12
Vielkä,ragnaros,192,warlock,demonology,12,2,10
Drkdestro,boulderfist,192,warlock,demonology,12,2,10
Sinful,darkspear,192,warlock,demonology,12,2,10
Timerad,maelstrom,192,warlock,demonology,14,2,12
Wårloçk,tichondrius,159,warlock,demonology,5,2,3
Tunacanthicc,moon-guard,159,warlock,demonology,5,2,3
Gartlarrey,daggerspine,158,warlock,demonology,14,3,11
Kogath,thunderlord,138,warlock,demonology,10,4,6
Cslice,magtheridon,128,warlock,demonology,4,2,2
Decrepticus,kargath,96,warlock,demonology,6,1,5
Starwitch,darkspear,96,warlock,demonology,6,1,5
Solöw,tichondrius,96,warlock,demonology,6,1,5
Shadococo,tichondrius,96,warlock,demonology,6,1,5
Ñinelyfe,frostmourne,96,warlock,demonology,6,1,5
Isthismeta,tichondrius,96,warlock,demonology,6,1,5
Nùts,frostmourne,96,warlock,demonology,6,1,5
Xalithra,moon-guard,96,warlock,demonology,6,1,5
Oreo,velen,96,warlock,demonology,6,1,5
Malzahard,ragnaros,96,warlock,demonology,6,1,5
Erimegara,ragnaros,96,warlock,demonology,6,1,5
Bmó,stormrage,96,warlock,demonology,6,1,5
Nameflagged,arathor,96,warlock,demonology,6,1,5
Glizzÿ,thrall,96,warlock,demonology,6,1,5
Borthrel,moon-guard,96,warlock,demonology,6,1,5
Amauder,moon-guard,96,warlock,demonology,6,1,5
Repláced,thrall,96,warlock,demonology,6,1,5
Sidiouss,dreadmaul,96,warlock,demonology,6,1,5
Bilidin,azralon,96,warlock,demonology,6,1,5
Osteogenesis,quelthalas,96,warlock,demonology,6,1,5
Yora,illidan,96,warlock,demonology,6,1,5
Perkz,moon-guard,96,warlock,demonology,6,1,5
Flangy,kiljaeden,96,warlock,demonology,6,1,5
Hâunted,khazgoroth,96,warlock,demonology,6,1,5
Badstepbro,sargeras,96,warlock,demonology,6,1,5
Skured,maiev,96,warlock,demonology,6,1,5
Halloweèn,kelthuzad,96,warlock,demonology,6,1,5
Hsxcx,stonemaul,96,warlock,demonology,6,1,5
Lazzarros,area-52,96,warlock,demonology,6,1,5
Somethingud,tichondrius,96,warlock,demonology,6,1,5
Quinsnyder,zuljin,96,warlock,demonology,6,1,5
Laklin,stormscale,96,warlock,demonology,6,1,5
Eriss,exodar,96,warlock,demonology,6,1,5
Kajayak,nazjatar,96,warlock,demonology,6,1,5
Uggaboogga,malganis,96,warlock,demonology,6,1,5
Fearedit,bleeding-hollow,96,warlock,demonology,6,1,5
Varvanta,proudmoore,96,warlock,demonology,6,1,5
Damdochael,bleeding-hollow,96,warlock,demonology,6,1,5
Tonyxx,tichondrius,96,warlock,demonology,6,1,5
Velondris,illidan,96,warlock,demonology,6,1,5
Hutchyw,tichondrius,96,warlock,demonology,6,1,5
Fashon,barthilas,96,warlock,demonology,6,1,5
Zíppen,proudmoore,96,warlock,demonology,6,1,5
Shortbuhz,tichondrius,96,warlock,demonology,6,1,5
Thugpenus,frostmane,96,warlock,demonology,6,1,5
Wakingdead,mugthol,96,warlock,demonology,6,1,5
Bfaclâssic,zuljin,96,warlock,demonology,6,1,5
Jazzycj,bleeding-hollow,96,warlock,demonology,6,1,5
Zerosix,sargeras,96,warlock,demonology,6,1,5
Thinkchair,sargeras,96,warlock,demonology,6,1,5
Fluximilian,azralon,96,warlock,demonology,7,1,6
Vèigarr,frostmourne,96,warlock,demonology,9,1,8
Resima,stormscale,96,warlock,demonology,13,1,12
Kecca,azralon,96,warlock,demonology,15,1,14
Hecataeus,proudmoore,63,warlock,demonology,8,2,6
Shaurial,zuljin,48,warlock,demonology,3,1,2
Eternitty,nemesis,42,warlock,demonology,11,3,8
Locksyy,tichondrius,31,warlock,demonology,2,1,1
Synysta,tichondrius,31,warlock,demonology,2,1,1
Warlow,mugthol,31,warlock,demonology,8,1,7
Camila,lightnings-blade,16,warlock,demonology,1,1,0
Voidchaos,whisperwind,2335,warlock,destruction,184,103,81
Drexia,tichondrius,2312,warlock,destruction,66,49,17
Nos,bleeding-hollow,2308,warlock,destruction,88,55,33
Reverence,tichondrius,2283,warlock,destruction,101,64,37
Nosw,bleeding-hollow,2275,warlock,destruction,102,61,41
Mengqil,tichondrius,2267,warlock,destruction,114,64,50
Hahahahahha,stormrage,2261,warlock,destruction,77,49,28
Singleaf,stormrage,2255,warlock,destruction,98,57,41
Butteredbun,stormrage,2239,warlock,destruction,186,110,76
Dannyl,tichondrius,2219,warlock,destruction,66,44,22
Ihavestds,tichondrius,2213,warlock,destruction,66,40,26
Diabolicalz,sargeras,2213,warlock,destruction,111,62,49
Mclovn,suramar,2199,warlock,destruction,155,85,70
Slantsix,tichondrius,2198,warlock,destruction,90,50,40
Mcdudebro,malganis,2192,warlock,destruction,72,45,27
Warzog,wyrmrest-accord,2186,warlock,destruction,78,49,29
Disgustingfk,illidan,2183,warlock,destruction,102,65,37
Demonicxs,area-52,2182,warlock,destruction,137,74,63
Kamohoalii,bleeding-hollow,2181,warlock,destruction,84,52,32
Usainboltzz,tichondrius,2176,warlock,destruction,66,48,18
Søülætër,bleeding-hollow,2161,warlock,destruction,66,42,24
Sourslock,shadowsong,2158,warlock,destruction,102,67,35
Impenjoyer,tichondrius,2154,warlock,destruction,66,41,25
Playßøy,area-52,2154,warlock,destruction,78,45,33
Luvana,kelthuzad,2147,warlock,destruction,119,72,47
Truetime,tichondrius,2147,warlock,destruction,84,46,38
Woahlock,thrall,2146,warlock,destruction,64,40,24
Ihatemyson,tichondrius,2144,warlock,destruction,59,33,26
Gimmeprecog,tichondrius,2143,warlock,destruction,74,45,29
Ellynaria,nemesis,2142,warlock,destruction,78,51,27
Slipnslide,malganis,2136,warlock,destruction,65,41,24
Tomatobob,thrall,2136,warlock,destruction,84,44,40
Igortrikadva,zuljin,2135,warlock,destruction,72,43,29
Thumperrz,frostmourne,2135,warlock,destruction,83,45,38
Leredi,stormrage,2135,warlock,destruction,146,78,68
Abrocket,alleria,2134,warlock,destruction,88,47,41
Yifaruhún,illidan,2132,warlock,destruction,78,58,20
Locean,tichondrius,2131,warlock,destruction,106,59,47
Deideimeow,illidan,2130,warlock,destruction,65,42,23
Darthael,stormrage,2130,warlock,destruction,188,112,76
Butterboyx,stormrage,2129,warlock,destruction,83,51,32
Etuskaa,tichondrius,2128,warlock,destruction,108,64,44
Drâkedog,illidan,2128,warlock,destruction,66,38,28
Medzor,tichondrius,2128,warlock,destruction,93,53,40
Turiggyjr,tichondrius,2127,warlock,destruction,83,45,38
Loopsy,stormrage,2126,warlock,destruction,115,64,51
Sockems,guldan,2125,warlock,destruction,90,51,39
Demonman,kirin-tor,2124,warlock,destruction,72,41,31
Dodgeykun,khaz-modan,2123,warlock,destruction,83,53,30
Rizzard,lightnings-blade,2123,warlock,destruction,107,64,43
Zyzx,malganis,2120,warlock,destruction,59,37,22
Hudwinx,illidan,2119,warlock,destruction,78,47,31
Drakedogee,illidan,2119,warlock,destruction,66,35,31
Bananapan,tichondrius,2116,warlock,destruction,66,44,22
Dyenamik,stormrage,2116,warlock,destruction,65,36,29
Minglocked,proudmoore,2114,warlock,destruction,54,37,17
Usurpest,bleeding-hollow,2114,warlock,destruction,79,50,29
Xavier,wyrmrest-accord,2112,warlock,destruction,99,56,43
Heckindoggø,tichondrius,2111,warlock,destruction,81,44,37
Dean,frostmourne,2111,warlock,destruction,66,33,33
Alucarduo,emerald-dream,2110,warlock,destruction,72,39,33
Ghoul,demon-soul,2109,warlock,destruction,60,35,25
Dxxz,tichondrius,2109,warlock,destruction,115,63,52
Mjn,tichondrius,2107,warlock,destruction,100,51,49
Stingzz,azralon,2106,warlock,destruction,61,38,23
Chaosboltex,tichondrius,2106,warlock,destruction,72,41,31
Jcm,hyjal,2104,warlock,destruction,59,41,18
Dottle,frostmourne,2104,warlock,destruction,66,39,27
Dae,burning-legion,2103,warlock,destruction,59,38,21
Bufflockmore,tichondrius,2103,warlock,destruction,112,62,50
Kaytoxic,tichondrius,2103,warlock,destruction,72,39,33
Babyaga,illidan,2103,warlock,destruction,97,48,49
Ohmend,thrall,2102,warlock,destruction,69,45,24
Disembolt,illidan,2102,warlock,destruction,66,41,25
Rainbowdate,tichondrius,2101,warlock,destruction,36,29,7
Implify,tichondrius,2101,warlock,destruction,142,73,69
Çxb,tichondrius,2092,warlock,destruction,72,45,27
Kaidow,tichondrius,2090,warlock,destruction,96,61,35
Sarcophagus,duskwood,2084,warlock,destruction,156,80,76
Cc,hellscream,2075,warlock,destruction,155,97,58
Thugonomicz,demon-soul,2071,warlock,destruction,54,37,17
Hàrrydotter,darkspear,2071,warlock,destruction,70,43,27
Quinsnyder,zuljin,2071,warlock,destruction,186,94,92
Horror,moon-guard,2069,warlock,destruction,81,39,42
Jonboyy,illidan,2068,warlock,destruction,144,72,72
Eggós,sargeras,2066,warlock,destruction,251,134,117
Babybolt,frostmourne,2066,warlock,destruction,90,46,44
Felfeels,area-52,2065,warlock,destruction,96,58,38
Nvlnx,tichondrius,2065,warlock,destruction,101,57,44
Insanetroll,stormrage,2064,warlock,destruction,72,49,23
Demofire,tichondrius,2063,warlock,destruction,63,39,24
Idotû,tichondrius,2063,warlock,destruction,161,87,74
Koitis,tichondrius,2061,warlock,destruction,68,43,25
Realization,illidan,2060,warlock,destruction,30,25,5
Vapeboi,bleeding-hollow,2060,warlock,destruction,54,33,21
Pillçosby,bleeding-hollow,2054,warlock,destruction,192,96,96
Revenid,tichondrius,2049,warlock,destruction,72,42,30
Rightwaylovê,illidan,2048,warlock,destruction,65,37,28
Breeped,tichondrius,2044,warlock,destruction,108,68,40
Foresthills,sargeras,2044,warlock,destruction,96,50,46
Uwantpeach,tichondrius,2043,warlock,destruction,46,34,12
Brainless,tichondrius,2040,warlock,destruction,109,66,43
Sinápsís,ragnaros,2035,warlock,destruction,54,36,18
Ðlrwêcïûj,stormrage,2034,warlock,destruction,60,41,19
Äran,azralon,2029,warlock,destruction,54,30,24
Instabilityx,tichondrius,2028,warlock,destruction,71,42,29
Mazewl,illidan,2027,warlock,destruction,105,68,37
Scørrgx,azralon,2021,warlock,destruction,84,43,41
Duukka,malganis,2015,warlock,destruction,96,53,43
Forestfruit,tichondrius,2012,warlock,destruction,42,28,14
Napiersdot,tichondrius,2009,warlock,destruction,72,39,33
Alchandil,tichondrius,1999,warlock,destruction,48,34,14
Nightmanx,sargeras,1999,warlock,destruction,83,43,40
Isodjdojk,sargeras,1998,warlock,destruction,64,37,27
Epícburn,illidan,1996,warlock,destruction,30,21,9
Darkmagicc,tichondrius,1995,warlock,destruction,96,48,48
Ribman,stormrage,1992,warlock,destruction,66,32,34
Neruvian,tichondrius,1991,warlock,destruction,42,28,14
Qp,thrall,1989,warlock,destruction,36,27,9
Kaytoxics,tichondrius,1988,warlock,destruction,24,21,3
Cvoaw,bonechewer,1987,warlock,destruction,72,41,31
Whodatman,illidan,1986,warlock,destruction,48,34,14
Hollowl,tichondrius,1986,warlock,destruction,83,55,28
Albbanoo,tichondrius,1986,warlock,destruction,143,76,67
Deadlpoo,stormscale,1984,warlock,destruction,154,81,73
Sitomey,emerald-dream,1982,warlock,destruction,66,38,28
Tacobelf,magtheridon,1980,warlock,destruction,129,73,56
Zhul,nerzhul,1979,warlock,destruction,63,40,23
Fotmspec,area-52,1976,warlock,destruction,66,46,20
Narila,firetree,1976,warlock,destruction,48,29,19
Zeari,sargeras,1972,warlock,destruction,109,55,54
Calvarr,bleeding-hollow,1970,warlock,destruction,77,45,32
Destroyy,greymane,1968,warlock,destruction,54,30,24
Payn,kiljaeden,1968,warlock,destruction,66,36,30
Nðm,tichondrius,1968,warlock,destruction,114,57,57
Pigii,tichondrius,1967,warlock,destruction,42,28,14
Kruxxqt,illidan,1967,warlock,destruction,274,142,132
Freddiewill,tichondrius,1966,warlock,destruction,101,63,38
Audition,ragnaros,1966,warlock,destruction,102,51,51
Salanzø,bleeding-hollow,1965,warlock,destruction,54,31,23
Dazu,illidan,1965,warlock,destruction,125,66,59
Mizmagius,moon-guard,1965,warlock,destruction,65,31,34
Realgodlock,proudmoore,1964,warlock,destruction,134,70,64
Boltsnhoes,illidan,1961,warlock,destruction,78,46,32
Chaosbolt,bloodhoof,1961,warlock,destruction,66,37,29
Hrrpeuh,zuljin,1961,warlock,destruction,82,41,41
Blackyeonnam,tichondrius,1959,warlock,destruction,86,46,40
Kyranu,tichondrius,1955,warlock,destruction,115,60,55
Seangnong,tichondrius,1953,warlock,destruction,54,34,20
Heresucacok,frostmourne,1947,warlock,destruction,36,22,14
Sweatystain,tichondrius,1945,warlock,destruction,70,45,25
Tichonkimc,tichondrius,1945,warlock,destruction,62,33,29
Rakshama,chogall,1944,warlock,destruction,45,26,19
Xertling,sargeras,1941,warlock,destruction,55,38,17
Zyltan,tichondrius,1938,warlock,destruction,36,25,11
Balveer,tichondrius,1937,warlock,destruction,35,21,14
Pernicious,bladefist,1937,warlock,destruction,197,95,102
Warlockwars,amanthul,1931,warlock,destruction,172,88,84
Beegbeechy,nesingwary,1929,warlock,destruction,72,41,31
Archimondee,rivendare,1928,warlock,destruction,84,42,42
Yuoalx,tichondrius,1922,warlock,destruction,72,38,34
Kaelith,kelthuzad,1920,warlock,destruction,103,53,50
Deathair,tichondrius,1918,warlock,destruction,54,31,23
Shadowhax,area-52,1918,warlock,destruction,90,47,43
Mayelinvail,moon-guard,1917,warlock,destruction,72,41,31
Truenatestes,proudmoore,1916,warlock,destruction,89,44,45
Wzxx,tichondrius,1914,warlock,destruction,141,78,63
Benafflockz,kelthuzad,1913,warlock,destruction,71,44,27
Ignorai,illidan,1913,warlock,destruction,148,82,66
Sereniaa,sargeras,1913,warlock,destruction,50,27,23
Salival,chogall,1912,warlock,destruction,39,29,10
Ztlivid,area-52,1911,warlock,destruction,93,56,37
Starta,tichondrius,1910,warlock,destruction,48,27,21
Grandmama,tichondrius,1909,warlock,destruction,53,33,20
Vileröze,zuljin,1909,warlock,destruction,78,43,35
Dreadful,frostmourne,1907,warlock,destruction,81,49,32
Reneqtxo,frostmourne,1906,warlock,destruction,92,60,32
Whatisthis,tichondrius,1906,warlock,destruction,36,20,16
Yoyoyosup,stormrage,1905,warlock,destruction,48,32,16
Coilsinfive,tichondrius,1904,warlock,destruction,42,27,15
Hellsparks,malganis,1903,warlock,destruction,48,29,19
Sosahawk,stormrage,1902,warlock,destruction,137,87,50
Laiquisha,zuljin,1900,warlock,destruction,49,29,20
Ozmat,spirestone,1900,warlock,destruction,36,20,16
Amez,grizzly-hills,1900,warlock,destruction,60,33,27
Tott,hellscream,1898,warlock,destruction,50,26,24
Scatz,sargeras,1897,warlock,destruction,36,33,3
Fingerslock,malganis,1897,warlock,destruction,102,52,50
Radicalz,ragnaros,1894,warlock,destruction,49,26,23
Maadhum,illidan,1894,warlock,destruction,72,32,40
Belandyr,stormrage,1893,warlock,destruction,36,20,16
Stilltrilly,tichondrius,1892,warlock,destruction,36,25,11
Amgs,frostmourne,1890,warlock,destruction,131,71,60
Genzy,tichondrius,1888,warlock,destruction,114,55,59
Sonlyc,tichondrius,1886,warlock,destruction,66,33,33
Naughtybolts,sargeras,1884,warlock,destruction,59,41,18
Toggafputuhs,illidan,1884,warlock,destruction,42,26,16
Madthelock,sargeras,1884,warlock,destruction,42,20,22
Eav,area-52,1883,warlock,destruction,54,34,20
Zettian,quelthalas,1883,warlock,destruction,54,30,24
Warcalk,stormrage,1882,warlock,destruction,60,37,23
Vexe,tichondrius,1880,warlock,destruction,38,29,9
Humanwarlock,spirestone,1879,warlock,destruction,57,32,25
Neverending,malganis,1878,warlock,destruction,49,28,21
Tommybahama,velen,1875,warlock,destruction,64,39,25
Roxmysox,darkspear,1875,warlock,destruction,84,43,41
Illinkin,illidan,1874,warlock,destruction,126,75,51
Pikslol,bleeding-hollow,1874,warlock,destruction,48,27,21
Lopenx,korgath,1874,warlock,destruction,146,73,73
Dottcha,blackrock,1873,warlock,destruction,90,48,42
Locodwarf,frostmourne,1873,warlock,destruction,274,136,138
Zarinista,veknilash,1872,warlock,destruction,91,47,44
Twinklockxx,mannoroth,1872,warlock,destruction,143,66,77
Hommer,tichondrius,1870,warlock,destruction,57,34,23
Bigdamege,tichondrius,1870,warlock,destruction,67,39,28
Ñpç,bleeding-hollow,1870,warlock,destruction,89,48,41
Amazingamez,sargeras,1867,warlock,destruction,78,42,36
Puchador,sargeras,1867,warlock,destruction,138,74,64
Dustywlx,area-52,1865,warlock,destruction,74,45,29
Pheadas,deathwing,1865,warlock,destruction,42,20,22
Palumorl,deathwing,1864,warlock,destruction,36,23,13
Scathey,area-52,1863,warlock,destruction,138,84,54
Colombø,gallywix,1863,warlock,destruction,145,75,70
Drakwlya,tichondrius,1859,warlock,destruction,48,30,18
Oopsprecog,tichondrius,1857,warlock,destruction,66,32,34
Dottx,frostmourne,1856,warlock,destruction,48,32,16
Luhgëek,tichondrius,1856,warlock,destruction,47,29,18
Zadelyn,whisperwind,1855,warlock,destruction,30,23,7
Snerp,frostmourne,1855,warlock,destruction,135,78,57
Soulrulerxc,tichondrius,1854,warlock,destruction,42,27,15
Mongobros,illidan,1853,warlock,destruction,54,35,19
Darksummoner,kaelthas,1853,warlock,destruction,84,46,38
Immolate,eitrigg,1852,warlock,destruction,48,29,19
Drugmuffin,tichondrius,1852,warlock,destruction,48,28,20
Milkdrunk,blackrock,1852,warlock,destruction,119,61,58
Eqx,illidan,1851,warlock,destruction,54,31,23
Warsmock,tichondrius,1850,warlock,destruction,41,22,19
Kissmybolts,frostmourne,1850,warlock,destruction,66,35,31
Mistrnesbitt,malganis,1850,warlock,destruction,48,25,23
Brujoalfa,ragnaros,1849,warlock,destruction,139,81,58
Synkz,blood-furnace,1849,warlock,destruction,42,24,18
Threeinches,kelthuzad,1848,warlock,destruction,170,100,70
Mycelium,greymane,1848,warlock,destruction,34,20,14
Dotorama,sargeras,1846,warlock,destruction,41,30,11
Brazlem,blackrock,1846,warlock,destruction,49,34,15
Verbzz,tichondrius,1846,warlock,destruction,36,23,13
Lemmepvponu,illidan,1846,warlock,destruction,59,28,31
Maureenn,mannoroth,1845,warlock,destruction,55,29,26
Omegapasta,illidan,1845,warlock,destruction,84,42,42
Boxtrolls,ragnaros,1843,warlock,destruction,48,28,20
Sithaholic,wildhammer,1843,warlock,destruction,72,39,33
Chilipeppa,wyrmrest-accord,1842,warlock,destruction,36,27,9
Jierd,tichondrius,1842,warlock,destruction,52,32,20
Herpalock,illidan,1842,warlock,destruction,78,34,44
Rocketman,hydraxis,1841,warlock,destruction,48,32,16
Urukái,dalaran,1841,warlock,destruction,111,65,46
Rizzofsparta,stormrage,1841,warlock,destruction,48,27,21
Benafflockzz,kelthuzad,1840,warlock,destruction,66,44,22
Millidots,bleeding-hollow,1840,warlock,destruction,54,31,23
Cosmosxx,illidan,1838,warlock,destruction,42,31,11
Enter,saurfang,1838,warlock,destruction,36,24,12
Jaspieno,illidan,1838,warlock,destruction,48,29,19
Naughtybôlts,sargeras,1837,warlock,destruction,45,33,12
Philsbad,lightbringer,1837,warlock,destruction,122,70,52
Dragonixs,ragnaros,1837,warlock,destruction,96,53,43
Kekbolt,tichondrius,1836,warlock,destruction,53,33,20
Wife,bleeding-hollow,1836,warlock,destruction,60,31,29
Sibëria,quelthalas,1835,warlock,destruction,48,35,13
Painful,mannoroth,1835,warlock,destruction,96,57,39
Badstep,tichondrius,1835,warlock,destruction,51,30,21
Tonyxx,tichondrius,1835,warlock,destruction,112,58,54
Panna,tichondrius,1835,warlock,destruction,237,118,119
Gigabiga,area-52,1834,warlock,destruction,24,20,4
Soragen,barthilas,1834,warlock,destruction,54,37,17
Løcalplugxø,barthilas,1834,warlock,destruction,119,78,41
Farathos,ragnaros,1834,warlock,destruction,120,74,46
Jfet,sargeras,1833,warlock,destruction,29,21,8
Gotthmog,nerzhul,1833,warlock,destruction,48,30,18
Cumbledor,bleeding-hollow,1831,warlock,destruction,44,23,21
Barovir,tichondrius,1830,warlock,destruction,54,33,21
Buu,veknilash,1830,warlock,destruction,54,33,21
Rhelialock,stormrage,1830,warlock,destruction,36,21,15
Demonicsnap,bleeding-hollow,1829,warlock,destruction,100,59,41
Suaveaye,tichondrius,1829,warlock,destruction,54,31,23
Brillina,windrunner,1829,warlock,destruction,60,30,30
Nezlock,moon-guard,1829,warlock,destruction,92,45,47
Dadtired,tichondrius,1826,warlock,destruction,36,29,7
Vyrecks,hyjal,1826,warlock,destruction,54,31,23
Shequita,stormrage,1825,warlock,destruction,48,37,11
Agaros,zuljin,1825,warlock,destruction,49,30,19
Necroboi,alterac-mountains,1825,warlock,destruction,52,29,23
Dàmagicman,drakthul,1824,warlock,destruction,48,32,16
Dipicrowcaw,tichondrius,1822,warlock,destruction,24,19,5
Hakai,bleeding-hollow,1822,warlock,destruction,80,51,29
Drazh,area-52,1821,warlock,destruction,57,32,25
Soulbane,jubeithos,1820,warlock,destruction,30,19,11
Róckroad,lightnings-blade,1820,warlock,destruction,42,26,16
Azaradx,sargeras,1819,warlock,destruction,84,54,30
Yipláw,stormrage,1819,warlock,destruction,36,23,13
Puginlock,illidan,1819,warlock,destruction,60,38,22
Chazzlock,area-52,1819,warlock,destruction,30,19,11
Slurpme,stormscale,1819,warlock,destruction,48,30,18
Vamprixlz,illidan,1818,warlock,destruction,49,34,15
Lamaso,area-52,1818,warlock,destruction,66,43,23
Haì,illidan,1818,warlock,destruction,60,37,23
Gucciflops,bleeding-hollow,1818,warlock,destruction,60,29,31
Bumbleebolt,azralon,1817,warlock,destruction,24,19,5
Nahalmaeim,tichondrius,1817,warlock,destruction,36,24,12
Firenzy,dalaran,1817,warlock,destruction,67,39,28
Antinurse,bleeding-hollow,1817,warlock,destruction,78,45,33
Lockonomicz,tichondrius,1817,warlock,destruction,42,24,18
Feinnx,dalaran,1817,warlock,destruction,70,38,32
Zehoc,thrall,1817,warlock,destruction,102,55,47
Wraithlord,chogall,1816,warlock,destruction,51,32,19
Reallymagic,malganis,1816,warlock,destruction,106,63,43
Doclove,destromath,1816,warlock,destruction,149,83,66
Bismorc,frostmourne,1816,warlock,destruction,42,23,19
Starwitch,darkspear,1816,warlock,destruction,77,35,42
Noxfear,azralon,1815,warlock,destruction,66,48,18
Leeroydots,area-52,1815,warlock,destruction,54,37,17
Dunnin,dalaran,1815,warlock,destruction,36,22,14
Savlonicsego,stormrage,1815,warlock,destruction,78,45,33
Frappucino,wyrmrest-accord,1814,warlock,destruction,30,23,7
Shinjuro,stormrage,1814,warlock,destruction,36,24,12
Slpxoxo,sargeras,1814,warlock,destruction,54,30,24
Crayonchewer,alleria,1814,warlock,destruction,60,31,29
Zaef,kelthuzad,1814,warlock,destruction,88,45,43
Evilclass,tichondrius,1813,warlock,destruction,42,31,11
Famerap,tichondrius,1813,warlock,destruction,36,25,11
Wiredftw,illidan,1813,warlock,destruction,30,19,11
Sacalawia,drakkari,1813,warlock,destruction,45,27,18
Monika,anetheron,1813,warlock,destruction,58,32,26
Zauber,magtheridon,1812,warlock,destruction,44,29,15
Destructio,tichondrius,1812,warlock,destruction,54,31,23
Marshyw,tichondrius,1812,warlock,destruction,36,19,17
Bellaswans,hyjal,1811,warlock,destruction,54,33,21
Naroy,malygos,1811,warlock,destruction,38,21,17
Thegodd,nemesis,1811,warlock,destruction,54,28,26
Dommön,ragnaros,1811,warlock,destruction,54,28,26
Tìdals,zuljin,1810,warlock,destruction,44,28,16
Venticm,tichondrius,1810,warlock,destruction,42,26,16
Alchan,tichondrius,1810,warlock,destruction,65,38,27
Fartymårty,tichondrius,1810,warlock,destruction,36,21,15
Omnireaper,tichondrius,1810,warlock,destruction,54,29,25
Berkz,stormrage,1810,warlock,destruction,66,33,33
Oof,dalaran,1809,warlock,destruction,30,22,8
Ashlet,kelthuzad,1809,warlock,destruction,48,30,18
Charlieo,barthilas,1809,warlock,destruction,96,55,41
Brutalsummon,frostmourne,1809,warlock,destruction,105,59,46
Il,nerzhul,1808,warlock,destruction,24,19,5
Emeraldflame,turalyon,1808,warlock,destruction,60,44,16
Fanzhiyi,illidan,1808,warlock,destruction,43,27,16
Blackchinese,zuljin,1808,warlock,destruction,138,73,65
Niava,tichondrius,1808,warlock,destruction,54,28,26
Kyrmax,malganis,1808,warlock,destruction,126,62,64
Drthiccbolts,malganis,1807,warlock,destruction,47,29,18
Drdoom,sargeras,1807,warlock,destruction,36,22,14
Cheqmate,moon-guard,1807,warlock,destruction,61,36,25
Symaitiel,azralon,1807,warlock,destruction,72,41,31
Aidadeshu,tichondrius,1807,warlock,destruction,60,32,28
Yeepzbytre,bleeding-hollow,1806,warlock,destruction,42,32,10
Almostoogood,illidan,1806,warlock,destruction,30,19,11
Elfwarlock,aerie-peak,1806,warlock,destruction,40,25,15
Belenas,tichondrius,1806,warlock,destruction,48,28,20
Rotshtëin,tichondrius,1806,warlock,destruction,173,91,82
Nigthdeath,nemesis,1806,warlock,destruction,173,91,82
Döremi,tichondrius,1805,warlock,destruction,48,28,20
Veleza,kiljaeden,1805,warlock,destruction,82,47,35
Vulcke,kelthuzad,1805,warlock,destruction,47,23,24
Curse,agamaggan,1804,warlock,destruction,114,65,49
Meatmanxtrem,sargeras,1804,warlock,destruction,60,33,27
Expiredfood,stormreaver,1803,warlock,destruction,42,26,16
Bod,bleeding-hollow,1803,warlock,destruction,42,24,18
Neghros,illidan,1803,warlock,destruction,101,52,49
Wwlock,area-52,1803,warlock,destruction,116,59,57
Scârecrow,stormrage,1802,warlock,destruction,72,46,26
Dxhusky,tichondrius,1802,warlock,destruction,48,26,22
Struggles,emerald-dream,1802,warlock,destruction,159,85,74
Mamosa,stormrage,1801,warlock,destruction,72,52,20
Geekmonster,tichondrius,1801,warlock,destruction,54,33,21
Rettek,bleeding-hollow,1801,warlock,destruction,48,27,21
Seltzi,illidan,1801,warlock,destruction,47,25,22
Dauntx,proudmoore,1801,warlock,destruction,66,33,33
Necrochemist,frostmane,1800,warlock,destruction,24,19,5
Xervas,frostmourne,1800,warlock,destruction,54,33,21
Soulbane,nemesis,1800,warlock,destruction,36,22,14
Notprint,sargeras,1800,warlock,destruction,36,22,14
Warmstreak,blackrock,1800,warlock,destruction,48,28,20
Lapidate,malganis,1800,warlock,destruction,59,33,26
Latchlock,malganis,1800,warlock,destruction,149,83,66
Sherlóck,duskwood,1798,warlock,destruction,54,28,26
Cróhns,bleeding-hollow,1797,warlock,destruction,139,86,53
Marcelium,greymane,1793,warlock,destruction,36,24,12
Aryoc,ragnaros,1793,warlock,destruction,84,51,33
Krikxy,tichondrius,1793,warlock,destruction,56,31,25
Kartharian,wyrmrest-accord,1793,warlock,destruction,142,70,72
Feardotjpg,stormrage,1791,warlock,destruction,42,29,13
Kogath,thunderlord,1791,warlock,destruction,98,57,41
Shadøwy,nemesis,1791,warlock,destruction,184,102,82
Kyleslock,illidan,1790,warlock,destruction,29,21,8
Barbieelf,sargeras,1790,warlock,destruction,186,98,88
Isoldmysoul,stormrage,1788,warlock,destruction,72,35,37
Marware,quelthalas,1787,warlock,destruction,42,22,20
Whitexzz,tichondrius,1786,warlock,destruction,42,24,18
Deathhawkz,ravencrest,1784,warlock,destruction,36,24,12
Espanyolo,zuljin,1783,warlock,destruction,48,37,11
Wreyz,mannoroth,1783,warlock,destruction,72,39,33
Eskyx,tichondrius,1783,warlock,destruction,42,22,20
Nevermindxd,barthilas,1783,warlock,destruction,66,32,34
Positivity,thunderhorn,1782,warlock,destruction,48,30,18
Tonnon,stormrage,1782,warlock,destruction,84,47,37
Ercaz,frostmourne,1781,warlock,destruction,42,20,22
Dupapad,stormrage,1780,warlock,destruction,65,31,34
Wineburger,frostmourne,1779,warlock,destruction,48,34,14
Feetsampler,stormrage,1779,warlock,destruction,52,26,26
Jakjub,kelthuzad,1778,warlock,destruction,54,31,23
Deathcoill,frostmourne,1778,warlock,destruction,48,27,21
Grq,stormrage,1775,warlock,destruction,69,43,26
Hellparks,malganis,1774,warlock,destruction,42,27,15
Spicywhite,tichondrius,1774,warlock,destruction,43,24,19
Screwed,tichondrius,1773,warlock,destruction,96,49,47
Cenich,darkspear,1772,warlock,destruction,49,33,16
Corkeý,azuremyst,1772,warlock,destruction,54,28,26
Tenaciousd,malganis,1772,warlock,destruction,42,21,21
Alùcärd,tichondrius,1772,warlock,destruction,54,25,29
Azlloa,tichondrius,1771,warlock,destruction,42,27,15
Plasticware,korgath,1771,warlock,destruction,48,29,19
Andelaylas,tichondrius,1771,warlock,destruction,95,57,38
Twilson,moon-guard,1771,warlock,destruction,54,29,25
Dxhusky,illidan,1771,warlock,destruction,54,28,26
Karimbenzema,tichondrius,1770,warlock,destruction,48,28,20
Bigjmmywiggl,illidan,1768,warlock,destruction,85,51,34
Doughnut,mugthol,1768,warlock,destruction,60,34,26
Lifeinsuranc,tichondrius,1767,warlock,destruction,30,19,11
Trundle,area-52,1766,warlock,destruction,29,21,8
Chaosjedi,stormrage,1764,warlock,destruction,99,49,50
Punstable,tichondrius,1763,warlock,destruction,121,65,56
Kakistocracy,kelthuzad,1761,warlock,destruction,30,23,7
Gottawiz,illidan,1758,warlock,destruction,60,32,28
Nick,llane,1757,warlock,destruction,36,23,13
Jussmollett,arygos,1756,warlock,destruction,83,49,34
Squishyboy,tichondrius,1755,warlock,destruction,57,30,27
Ravëncläw,quelthalas,1755,warlock,destruction,67,35,32
Flattsl,tichondrius,1755,warlock,destruction,84,39,45
Obliceress,crushridge,1754,warlock,destruction,42,26,16
Screampies,tichondrius,1754,warlock,destruction,46,27,19
Ibrroski,proudmoore,1753,warlock,destruction,24,20,4
Glôck,lightbringer,1752,warlock,destruction,86,41,45
Romdi,tichondrius,1750,warlock,destruction,46,29,17
Åbyssal,stormrage,1750,warlock,destruction,147,86,61
Homeboyardee,the-venture-co,1747,warlock,destruction,48,27,21
Darkwidow,sargeras,1746,warlock,destruction,182,89,93
Qualio,thrall,1746,warlock,destruction,123,59,64
Razlock,moon-guard,1744,warlock,destruction,192,104,88
Magnetix,arthas,1744,warlock,destruction,175,90,85
Thinktank,tichondrius,1743,warlock,destruction,42,25,17
Mjndewb,tichondrius,1741,warlock,destruction,36,28,8
Halloweèn,kelthuzad,1741,warlock,destruction,131,74,57
Pkzy,azralon,1741,warlock,destruction,36,19,17
Maggotworm,sargeras,1740,warlock,destruction,183,103,80
Keylloggz,sargeras,1740,warlock,destruction,96,54,42
Lockfaceguy,agamaggan,1738,warlock,destruction,72,37,35
Darkmagician,kelthuzad,1735,warlock,destruction,30,22,8
Hädes,frostwolf,1734,warlock,destruction,42,29,13
Mânuel,akama,1731,warlock,destruction,30,22,8
Midoolock,proudmoore,1729,warlock,destruction,60,40,20
Harmfuul,illidan,1728,warlock,destruction,45,28,17
Swapsfour,area-52,1727,warlock,destruction,30,19,11
Nasn,black-dragonflight,1726,warlock,destruction,50,31,19
Revenus,tichondrius,1724,warlock,destruction,100,52,48
Mindrekt,azralon,1723,warlock,destruction,60,44,16
Daylyt,sargeras,1723,warlock,destruction,27,19,8
Popdotdropit,frostwolf,1723,warlock,destruction,72,42,30
Daimonic,bronzebeard,1721,warlock,destruction,66,40,26
Xivra,thrall,1721,warlock,destruction,47,27,20
Inmøtion,tichondrius,1721,warlock,destruction,36,18,18
Chaoticchaos,kelthuzad,1719,warlock,destruction,29,19,10
Evanylock,proudmoore,1718,warlock,destruction,39,23,16
Agni,gurubashi,1718,warlock,destruction,126,66,60
Bigulinhos,nemesis,1717,warlock,destruction,30,18,12
Yidhra,aerie-peak,1717,warlock,destruction,99,55,44
Spooked,khadgar,1716,warlock,destruction,36,24,12
Loksoflove,tichondrius,1715,warlock,destruction,24,18,6
Lockfoxyy,tichondrius,1714,warlock,destruction,30,21,9
Podda,shuhalo,1713,warlock,destruction,47,29,18
Evatar,malganis,1712,warlock,destruction,36,21,15
Hehimx,bleeding-hollow,1711,warlock,destruction,24,18,6
Serveq,tichondrius,1710,warlock,destruction,103,58,45
Richãrd,area-52,1709,warlock,destruction,49,26,23
Destructo,illidan,1709,warlock,destruction,54,25,29
Juicestarr,barthilas,1708,warlock,destruction,84,41,43
Wårløck,stormrage,1707,warlock,destruction,24,18,6
Cocaineparty,tichondrius,1707,warlock,destruction,53,29,24
Terrorbytes,frostmourne,1705,warlock,destruction,74,42,32
Doombaby,zuljin,1703,warlock,destruction,88,56,32
Eggpower,tichondrius,1703,warlock,destruction,40,23,17
Uranusa,proudmoore,1700,warlock,destruction,84,40,44
Shutkax,sargeras,1699,warlock,destruction,30,23,7
Wolfstein,tichondrius,1699,warlock,destruction,24,18,6
Conradlenoir,illidan,1699,warlock,destruction,36,23,13
Giantgobrin,zuljin,1699,warlock,destruction,60,31,29
Frightbright,sargeras,1698,warlock,destruction,31,18,13
Cloudynightz,tichondrius,1698,warlock,destruction,149,81,68
Daartaru,quelthalas,1698,warlock,destruction,90,48,42
Azazil,malganis,1697,warlock,destruction,36,22,14
Tribulatiön,moon-guard,1697,warlock,destruction,292,157,135
Fredwinsta,laughing-skull,1697,warlock,destruction,54,29,25
Iskiplegday,illidan,1697,warlock,destruction,101,43,58
Sairic,azralon,1696,warlock,destruction,48,36,12
Hiddentech,saurfang,1696,warlock,destruction,36,20,16
Pigmahz,malganis,1696,warlock,destruction,59,32,27
Zírds,stormrage,1696,warlock,destruction,42,22,20
Teivlol,mugthol,1696,warlock,destruction,36,18,18
Covidmaster,frostmourne,1695,warlock,destruction,83,45,38
Chaosbôlt,proudmoore,1695,warlock,destruction,84,43,41
Koramoz,area-52,1695,warlock,destruction,152,75,77
Mchawi,tichondrius,1694,warlock,destruction,42,26,16
Scarified,illidan,1693,warlock,destruction,60,25,35
Pk,azralon,1691,warlock,destruction,24,18,6
Dotandforget,tichondrius,1691,warlock,destruction,36,24,12
Cbx,kelthuzad,1690,warlock,destruction,36,28,8
Aluaris,earthen-ring,1690,warlock,destruction,30,23,7
Chaosbeard,korgath,1690,warlock,destruction,62,36,26
Buboñic,area-52,1690,warlock,destruction,47,27,20
Vilebeing,frostmourne,1689,warlock,destruction,24,20,4
Deammon,tichondrius,1689,warlock,destruction,42,28,14
Jarasseck,malganis,1688,warlock,destruction,76,41,35
Kairiesmirk,illidan,1688,warlock,destruction,93,48,45
Paparoxy,illidan,1688,warlock,destruction,48,23,25
Hynnis,nemesis,1687,warlock,destruction,54,36,18
Tahmrin,quelthalas,1687,warlock,destruction,40,23,17
Dautenit,illidan,1687,warlock,destruction,66,32,34
Drain,proudmoore,1686,warlock,destruction,60,38,22
Bobbyshmurdå,frostmourne,1686,warlock,destruction,48,29,19
Contagion,dragonmaw,1685,warlock,destruction,36,20,16
Hellwish,tichondrius,1682,warlock,destruction,96,48,48
Muffîn,moon-guard,1681,warlock,destruction,103,62,41
Viralwashbrn,illidan,1681,warlock,destruction,36,19,17
Droptopp,malganis,1680,warlock,destruction,42,27,15
Gladyr,frostmourne,1680,warlock,destruction,36,21,15
Missmonday,tichondrius,1679,warlock,destruction,41,23,18
Yaresly,kelthuzad,1678,warlock,destruction,38,25,13
Gavrhin,area-52,1678,warlock,destruction,41,26,15
Exilegd,proudmoore,1678,warlock,destruction,59,37,22
Sakyameil,area-52,1678,warlock,destruction,42,25,17
Lïttle,stormrage,1678,warlock,destruction,81,48,33
Krokusx,illidan,1678,warlock,destruction,84,46,38
Breeak,sargeras,1676,warlock,destruction,48,31,17
Dipixd,tichondrius,1675,warlock,destruction,24,22,2
Gianni,chogall,1675,warlock,destruction,42,24,18
Feardadots,tichondrius,1674,warlock,destruction,69,46,23
Pyatpree,bleeding-hollow,1671,warlock,destruction,30,19,11
Intentionz,sargeras,1671,warlock,destruction,41,24,17
Lemonfire,area-52,1671,warlock,destruction,43,24,19
Sidgnosis,stormrage,1671,warlock,destruction,177,91,86
Mlxd,tichondrius,1670,warlock,destruction,24,19,5
Nocrackrocks,stormrage,1670,warlock,destruction,34,22,12
Bouldrlickr,dragonmaw,1669,warlock,destruction,42,25,17
Ðiêsel,malganis,1668,warlock,destruction,57,32,25
Manapouli,area-52,1667,warlock,destruction,33,21,12
Levantine,barthilas,1667,warlock,destruction,45,24,21
Ifearjoo,vashj,1666,warlock,destruction,48,25,23
Zimer,moon-guard,1665,warlock,destruction,60,34,26
Degred,tichondrius,1664,warlock,destruction,45,34,11
Evilempire,sargeras,1663,warlock,destruction,36,22,14
Ralerhard,kelthuzad,1663,warlock,destruction,46,27,19
Olgee,tortheldrin,1663,warlock,destruction,53,30,23
Chnos,mugthol,1663,warlock,destruction,41,23,18
Uarus,tichondrius,1662,warlock,destruction,30,19,11
Kossnen,shandris,1661,warlock,destruction,46,25,21
Dartthvader,azralon,1661,warlock,destruction,92,45,47
Booßiemiles,area-52,1659,warlock,destruction,127,77,50
Kâyn,area-52,1659,warlock,destruction,71,36,35
Bytezlk,area-52,1657,warlock,destruction,30,20,10
Sendnudez,nemesis,1657,warlock,destruction,53,30,23
Lønewølf,sargeras,1657,warlock,destruction,66,32,34
Denotate,zuljin,1656,warlock,destruction,44,26,18
Mephizar,moon-guard,1656,warlock,destruction,56,30,26
Deangood,tichondrius,1656,warlock,destruction,152,77,75
Mursay,tichondrius,1655,warlock,destruction,30,23,7
Steebi,tichondrius,1655,warlock,destruction,36,23,13
Nooko,frostmourne,1655,warlock,destruction,48,25,23
Fece,area-52,1652,warlock,destruction,38,24,14
Warmandei,dalaran,1652,warlock,destruction,72,42,30
Derok,bleeding-hollow,1652,warlock,destruction,235,117,118
Zoagen,ragnaros,1650,warlock,destruction,28,20,8
Lockniel,skullcrusher,1649,warlock,destruction,60,37,23
Absoluté,nemesis,1649,warlock,destruction,36,19,17
Getoffmedawg,illidan,1648,warlock,destruction,48,28,20
Royalmace,dethecus,1648,warlock,destruction,46,25,21
Zakhim,zuljin,1647,warlock,destruction,42,28,14
Noggét,frostmourne,1647,warlock,destruction,102,61,41
Vallàx,area-52,1647,warlock,destruction,114,57,57
Nt,burning-legion,1646,warlock,destruction,37,30,7
Agonie,tichondrius,1646,warlock,destruction,239,128,111
Cairo,emerald-dream,1646,warlock,destruction,219,115,104
Lhandus,drakkari,1646,warlock,destruction,56,28,28
Javirr,ragnaros,1645,warlock,destruction,65,39,26
Neverportx,kirin-tor,1645,warlock,destruction,36,21,15
Critthis,illidan,1644,warlock,destruction,35,25,10
Misolock,sargeras,1644,warlock,destruction,105,56,49
Revérence,sargeras,1644,warlock,destruction,41,21,20
Oblivious,firetree,1644,warlock,destruction,195,98,97
Ðemented,bleeding-hollow,1643,warlock,destruction,33,19,14
Carcøsa,malganis,1643,warlock,destruction,36,20,16
Devilman,darkspear,1643,warlock,destruction,109,57,52
Làsko,area-52,1643,warlock,destruction,84,41,43
Debigbolt,area-52,1642,warlock,destruction,30,22,8
Fiddlesticks,draka,1642,warlock,destruction,54,36,18
Galfear,malganis,1642,warlock,destruction,165,88,77
Katrisse,aegwynn,1642,warlock,destruction,60,32,28
Chaosage,sargeras,1640,warlock,destruction,42,28,14
Fearmebro,bleeding-hollow,1639,warlock,destruction,139,72,67
Dotgonewrong,malganis,1639,warlock,destruction,35,18,17
Sixv,barthilas,1638,warlock,destruction,30,22,8
Adelrinn,frostmourne,1638,warlock,destruction,125,72,53
Annereyn,stormrage,1638,warlock,destruction,72,39,33
Pyralock,malfurion,1638,warlock,destruction,48,25,23
Demonclock,sargeras,1637,warlock,destruction,39,24,15
Stocktonslap,saurfang,1637,warlock,destruction,133,75,58
Ardentia,malganis,1637,warlock,destruction,54,30,24
Reficul,frostmourne,1637,warlock,destruction,50,23,27
Parishiltoon,frostmourne,1637,warlock,destruction,52,22,30
Arenis,stormrage,1636,warlock,destruction,36,25,11
Xylâ,emerald-dream,1636,warlock,destruction,39,22,17
Dëstró,tichondrius,1636,warlock,destruction,41,23,18
Eyoeyo,tichondrius,1636,warlock,destruction,42,18,24
Flággedname,area-52,1635,warlock,destruction,36,21,15
Killabeesack,tichondrius,1635,warlock,destruction,43,25,18
Bénâfflock,area-52,1634,warlock,destruction,54,32,22
Bolsheivik,dentarg,1634,warlock,destruction,46,25,21
Iconicxo,thrall,1634,warlock,destruction,84,43,41
Spaceghóst,bleeding-hollow,1633,warlock,destruction,141,73,68
Zhaphrax,frostmourne,1633,warlock,destruction,85,43,42
Meraz,zuljin,1632,warlock,destruction,34,20,14
Evapilot,tichondrius,1632,warlock,destruction,54,31,23
Guldoom,tichondrius,1631,warlock,destruction,18,17,1
Demonista,illidan,1631,warlock,destruction,31,22,9
Sagatt,illidan,1631,warlock,destruction,68,37,31
Shendù,stormrage,1631,warlock,destruction,48,23,25
Ddorangmoon,tichondrius,1630,warlock,destruction,42,25,17
Dipixyz,tichondrius,1630,warlock,destruction,30,17,13
Tanskeeh,sargeras,1630,warlock,destruction,64,35,29
Holunging,illidan,1630,warlock,destruction,36,19,17
Wafflezcb,frostmourne,1630,warlock,destruction,37,18,19
Strykerliath,bleeding-hollow,1629,warlock,destruction,43,26,17
Psyløck,bleeding-hollow,1629,warlock,destruction,48,29,19
Dewandoritos,kelthuzad,1629,warlock,destruction,30,17,13
Stormrift,sargeras,1629,warlock,destruction,74,39,35
Ltoplaylock,area-52,1628,warlock,destruction,24,17,7
Soranpotter,tichondrius,1628,warlock,destruction,24,17,7
Cöpeñhagen,illidan,1627,warlock,destruction,48,26,22
Undeadzx,tichondrius,1627,warlock,destruction,36,19,17
Meep,madoran,1626,warlock,destruction,59,35,24
Nahz,tichondrius,1626,warlock,destruction,30,17,13
Katastrophïk,area-52,1626,warlock,destruction,36,20,16
Sîthfu,tichondrius,1626,warlock,destruction,183,98,85
Døomsday,hyjal,1626,warlock,destruction,42,21,21
Byndedlock,dragonmaw,1625,warlock,destruction,33,20,13
Vvivienx,tichondrius,1625,warlock,destruction,30,17,13
Dovahkini,stormrage,1625,warlock,destruction,47,23,24
Shadowsloc,tichondrius,1625,warlock,destruction,48,22,26
Stølo,deathwing,1624,warlock,destruction,112,73,39
Zandõx,jubeithos,1624,warlock,destruction,42,27,15
Matafé,kelthuzad,1623,warlock,destruction,30,20,10
Doomswitch,sargeras,1622,warlock,destruction,36,27,9
Thotblood,stormrage,1622,warlock,destruction,24,18,6
Friendd,frostmourne,1622,warlock,destruction,41,30,11
Maddotts,malganis,1622,warlock,destruction,36,26,10
Jerearderedo,thrall,1622,warlock,destruction,48,28,20
Permaslowed,kiljaeden,1622,warlock,destruction,40,22,18
Golock,tichondrius,1621,warlock,destruction,24,17,7
Richãrdjr,area-52,1621,warlock,destruction,24,17,7
Elmobolt,thrall,1620,warlock,destruction,37,27,10
Penzer,stormrage,1618,warlock,destruction,36,20,16
Dolut,azralon,1617,warlock,destruction,54,31,23
Restolock,destromath,1617,warlock,destruction,60,34,26
Infecçäo,stormrage,1616,warlock,destruction,72,43,29
Calidaze,tichondrius,1616,warlock,destruction,80,44,36
Plexwl,sargeras,1616,warlock,destruction,69,37,32
Esså,jaedenar,1616,warlock,destruction,42,18,24
Jpepps,perenolde,1615,warlock,destruction,41,28,13
Ðarkñess,burning-legion,1615,warlock,destruction,66,38,28
Birez,kelthuzad,1614,warlock,destruction,62,31,31
Leruss,zangarmarsh,1614,warlock,destruction,37,17,20
Saltiez,sargeras,1613,warlock,destruction,24,18,6
Shïrõ,tichondrius,1613,warlock,destruction,30,22,8
Anujy,moon-guard,1612,warlock,destruction,60,38,22
Thirdsol,stormrage,1612,warlock,destruction,29,18,11
Belzebud,area-52,1612,warlock,destruction,93,56,37
Ko,nordrassil,1612,warlock,destruction,66,34,32
Grandpa,daggerspine,1612,warlock,destruction,97,49,48
Razzakka,stormrage,1612,warlock,destruction,159,79,80
Hypnotikal,illidan,1611,warlock,destruction,30,22,8
Draenil,eredar,1611,warlock,destruction,24,17,7
Josaith,moon-guard,1610,warlock,destruction,89,51,38
Omleaf,malganis,1610,warlock,destruction,36,18,18
Gigabiga,tol-barad,1609,warlock,destruction,24,17,7
Horloc,moon-guard,1609,warlock,destruction,68,38,30
Zuyumin,ragnaros,1608,warlock,destruction,89,57,32
Ayrr,zuljin,1608,warlock,destruction,30,17,13
Gnomlette,smolderthorn,1608,warlock,destruction,98,53,45
Kály,azralon,1608,warlock,destruction,69,37,32
Notspeedy,tichondrius,1608,warlock,destruction,75,32,43
Lostanubis,tichondrius,1607,warlock,destruction,39,24,15
Trewlocke,sargeras,1607,warlock,destruction,36,22,14
Wayce,burning-blade,1607,warlock,destruction,98,52,46
Grindwald,echo-isles,1606,warlock,destruction,55,30,25
Bugha,ravencrest,1605,warlock,destruction,31,21,10
Macdeezylock,sargeras,1605,warlock,destruction,36,23,13
Vugaddi,illidan,1605,warlock,destruction,30,19,11
Hordeadlock,illidan,1604,warlock,destruction,60,31,29
Brickedx,malfurion,1604,warlock,destruction,101,50,51
Honchoe,illidan,1603,warlock,destruction,42,29,13
Nosferatu,arthas,1602,warlock,destruction,26,20,6
Sslock,sargeras,1602,warlock,destruction,46,26,20
Dippidydot,illidan,1602,warlock,destruction,60,31,29
Espyn,silvermoon,1602,warlock,destruction,105,51,54
Juswannarock,tichondrius,1601,warlock,destruction,33,22,11
Lyonesse,frostmourne,1601,warlock,destruction,34,21,13
Daenon,kiljaeden,1601,warlock,destruction,42,23,19
Lafourche,tichondrius,1601,warlock,destruction,54,28,26
Pauldiesel,ragnaros,1601,warlock,destruction,42,21,21
Hâm,dalaran,1601,warlock,destruction,96,46,50
Dapete,malorne,1600,warlock,destruction,36,26,10
Locknug,tichondrius,1600,warlock,destruction,132,74,58
Kurifodo,illidan,1600,warlock,destruction,59,33,26
Adouken,ragnaros,1600,warlock,destruction,36,19,17
Rxjr,sargeras,1599,warlock,destruction,81,39,42
Boltsnhoez,tichondrius,1598,warlock,destruction,34,20,14
Apøçàlÿpsè,firetree,1598,warlock,destruction,71,37,34
Belford,tichondrius,1598,warlock,destruction,49,25,24
Predictions,sargeras,1597,warlock,destruction,77,40,37
Closetslut,moon-guard,1596,warlock,destruction,24,20,4
Nefandous,malganis,1596,warlock,destruction,161,90,71
Guula,alexstrasza,1595,warlock,destruction,42,22,20
Dotcoin,tichondrius,1594,warlock,destruction,30,17,13
Lockforyou,frostmourne,1594,warlock,destruction,66,37,29
Rotfull,burning-legion,1594,warlock,destruction,39,18,21
Wheremyshoes,area-52,1593,warlock,destruction,141,68,73
Kernlberton,tichondrius,1592,warlock,destruction,48,25,23
Larryfisher,drenden,1591,warlock,destruction,30,19,11
Dots,haomarush,1591,warlock,destruction,60,31,29
Yisuschríst,quelthalas,1591,warlock,destruction,41,21,20
Demonkiiller,kelthuzad,1591,warlock,destruction,48,19,29
Caustikk,malganis,1587,warlock,destruction,44,25,19
Klumzey,tichondrius,1587,warlock,destruction,36,20,16
Buffwarlocks,senjin,1587,warlock,destruction,48,26,22
Tothegrave,sargeras,1585,warlock,destruction,35,22,13
Kuroyt,drakkari,1583,warlock,destruction,42,26,16
Gluestik,shadowmoon,1581,warlock,destruction,54,28,26
Gerthclas,aggramar,1579,warlock,destruction,35,24,11
Bbclover,thrall,1579,warlock,destruction,29,19,10
Matilla,tichondrius,1579,warlock,destruction,30,19,11
Korose,tichondrius,1579,warlock,destruction,142,72,70
Woezz,tichondrius,1577,warlock,destruction,93,49,44
Charnoob,kelthuzad,1577,warlock,destruction,54,26,28
Soreanus,illidan,1576,warlock,destruction,28,20,8
Xiyangpvp,tichondrius,1576,warlock,destruction,48,18,30
Brettmackson,area-52,1574,warlock,destruction,87,48,39
Borthrel,moon-guard,1573,warlock,destruction,132,75,57
Hootenanny,korialstrasz,1573,warlock,destruction,54,28,26
Leônidos,ghostlands,1573,warlock,destruction,102,52,50
Chachanoobx,sargeras,1572,warlock,destruction,114,72,42
Stankbigly,thrall,1571,warlock,destruction,38,23,15
Warlockmf,sargeras,1571,warlock,destruction,115,64,51
Carmelasin,moon-guard,1570,warlock,destruction,60,39,21
Melôck,area-52,1569,warlock,destruction,30,20,10
Mythdot,ragnaros,1569,warlock,destruction,88,45,43
Killvilock,kelthuzad,1569,warlock,destruction,61,30,31
Necrotic,mannoroth,1569,warlock,destruction,96,41,55
Babydots,stormreaver,1568,warlock,destruction,74,40,34
Burnzul,bleeding-hollow,1567,warlock,destruction,42,22,20
Khrom,illidan,1565,warlock,destruction,64,32,32
Whathurts,tichondrius,1564,warlock,destruction,86,42,44
Uow,stormrage,1564,warlock,destruction,42,20,22
Alfaflux,tol-barad,1563,warlock,destruction,53,24,29
Felnightz,area-52,1562,warlock,destruction,48,23,25
Watchmegate,darkspear,1561,warlock,destruction,60,38,22
Kevin,moon-guard,1560,warlock,destruction,58,34,24
Khurze,area-52,1558,warlock,destruction,57,29,28
Vasago,jubeithos,1558,warlock,destruction,71,36,35
Lustyclam,tichondrius,1557,warlock,destruction,59,38,21
Tuugadark,echo-isles,1557,warlock,destruction,51,32,19
Sauromann,sargeras,1557,warlock,destruction,72,42,30
Promethian,proudmoore,1556,warlock,destruction,59,26,33
Lilbiackguy,stormrage,1555,warlock,destruction,72,45,27
Niked,sargeras,1553,warlock,destruction,114,67,47
Funnysoxx,caelestrasz,1553,warlock,destruction,40,22,18
Hugechungusw,frostmourne,1552,warlock,destruction,32,21,11
Tunacangirth,mannoroth,1551,warlock,destruction,24,17,7
Wiildgoose,area-52,1551,warlock,destruction,36,24,12
Ændrew,darkspear,1551,warlock,destruction,29,18,11
Flake,kelthuzad,1550,warlock,destruction,36,18,18
Jaythuzad,stormrage,1549,warlock,destruction,92,48,44
Neph,malganis,1549,warlock,destruction,38,19,19
Loadybigbolt,dalaran,1548,warlock,destruction,59,30,29
Bayfayth,zuljin,1546,warlock,destruction,92,52,40
Jnxzlock,sargeras,1546,warlock,destruction,61,34,27
Bunnyhugs,gorefiend,1542,warlock,destruction,24,17,7
Remua,tichondrius,1540,warlock,destruction,29,18,11
Dragoska,kiljaeden,1540,warlock,destruction,30,17,13
Ioroselmi,illidan,1540,warlock,destruction,101,51,50
Nybeth,malganis,1539,warlock,destruction,80,39,41
Cryptos,kalecgos,1538,warlock,destruction,38,22,16
Flxmin,area-52,1538,warlock,destruction,58,29,29
Hadouh,stormrage,1537,warlock,destruction,29,17,12
Egirlgamer,sargeras,1537,warlock,destruction,36,21,15
Tharki,darkspear,1537,warlock,destruction,64,34,30
Gorontar,kelthuzad,1537,warlock,destruction,44,20,24
Manthos,sargeras,1537,warlock,destruction,63,24,39
Lockdogg,mannoroth,1536,warlock,destruction,30,18,12
Lockybalboah,turalyon,1536,warlock,destruction,108,58,50
Ezdagor,quelthalas,1535,warlock,destruction,140,76,64
Chadica,malganis,1534,warlock,destruction,18,16,2
Boodizz,frostmourne,1534,warlock,destruction,30,16,14
Sylrath,illidan,1534,warlock,destruction,36,17,19
Scarletdemon,malganis,1532,warlock,destruction,65,35,30
Captrollol,tichondrius,1531,warlock,destruction,60,30,30
Fearem,tichondrius,1530,warlock,destruction,27,17,10
Stonnerz,ragnaros,1530,warlock,destruction,47,29,18
Sdiaz,illidan,1529,warlock,destruction,24,16,8
Badmagic,area-52,1529,warlock,destruction,81,44,37
Malagas,tichondrius,1529,warlock,destruction,69,37,32
Beetlejoos,stormreaver,1529,warlock,destruction,30,16,14
Brucelock,proudmoore,1528,warlock,destruction,24,16,8
Zalord,mannoroth,1528,warlock,destruction,124,54,70
Somethingud,tichondrius,1527,warlock,destruction,77,31,46
Asetiks,tichondrius,1526,warlock,destruction,30,16,14
Dewars,aggramar,1525,warlock,destruction,90,49,41
Isarac,zuljin,1524,warlock,destruction,54,35,19
Sidious,jubeithos,1523,warlock,destruction,38,24,14
Dferreira,azralon,1523,warlock,destruction,99,56,43
Plaintive,moon-guard,1523,warlock,destruction,30,16,14
Conspiration,sargeras,1522,warlock,destruction,24,19,5
Gnomerky,stormrage,1522,warlock,destruction,30,18,12
Cesily,frostmourne,1522,warlock,destruction,30,16,14
Tunacanthicc,moon-guard,1522,warlock,destruction,136,70,66
Kascade,drakkari,1520,warlock,destruction,50,27,23
Resuah,tichondrius,1520,warlock,destruction,63,30,33
Xêlsnåp,steamwheedle-cartel,1519,warlock,destruction,91,53,38
Thravis,tichondrius,1518,warlock,destruction,36,20,16
Picklepuller,arthas,1517,warlock,destruction,42,28,14
Grammapatty,tichondrius,1517,warlock,destruction,30,16,14
Impdad,destromath,1515,warlock,destruction,60,42,18
Darknessgodd,goldrinn,1514,warlock,destruction,73,43,30
Austeeny,wyrmrest-accord,1513,warlock,destruction,31,21,10
Politex,malganis,1513,warlock,destruction,64,40,24
Kongal,tichondrius,1512,warlock,destruction,30,16,14
Xoxoxu,frostmourne,1511,warlock,destruction,32,18,14
Joseph,draktharon,1509,warlock,destruction,66,35,31
Guldåniel,tichondrius,1508,warlock,destruction,30,16,14
Obscurity,tichondrius,1507,warlock,destruction,48,23,25
Luckehlock,firetree,1506,warlock,destruction,53,23,30
Loçk,zuljin,1505,warlock,destruction,81,41,40
Shaneyxd,bleeding-hollow,1504,warlock,destruction,24,16,8
Squatchamp,sargeras,1503,warlock,destruction,48,28,20
Dinglerdots,tichondrius,1502,warlock,destruction,27,21,6
Jugaa,arthas,1502,warlock,destruction,41,29,12
Yaldin,nemesis,1502,warlock,destruction,149,83,66
Yükina,stormrage,1502,warlock,destruction,106,55,51
Bosongo,boulderfist,1501,warlock,destruction,65,37,28
Cbolt,tichondrius,1501,warlock,destruction,36,20,16
Deboltzaru,ragnaros,1501,warlock,destruction,91,45,46
Marcedlc,ragnaros,1500,warlock,destruction,66,38,28
Jennifear,sargeras,1499,warlock,destruction,50,28,22
Hellbòund,mugthol,1499,warlock,destruction,36,20,16
Odiums,area-52,1498,warlock,destruction,77,44,33
Kyoarnez,quelthalas,1498,warlock,destruction,48,24,24
Kalellock,azralon,1497,warlock,destruction,108,57,51
Firewõrks,moon-guard,1496,warlock,destruction,30,17,13
Darthðotspam,mugthol,1495,warlock,destruction,66,41,25
Memnøch,emerald-dream,1492,warlock,destruction,41,24,17
Teesolinia,stormrage,1491,warlock,destruction,36,22,14
Deathmask,alleria,1490,warlock,destruction,34,18,16
Darkÿoda,malganis,1490,warlock,destruction,44,22,22
Goomgoom,doomhammer,1489,warlock,destruction,114,50,64
Titusvorenus,runetotem,1488,warlock,destruction,50,30,20
Terrival,illidan,1487,warlock,destruction,41,22,19
Zetsu,zuljin,1487,warlock,destruction,235,120,115
Dotte,tichondrius,1486,warlock,destruction,59,31,28
Nytefels,skullcrusher,1485,warlock,destruction,30,20,10
Romminus,zuljin,1484,warlock,destruction,31,20,11
Dynamó,tichondrius,1483,warlock,destruction,74,37,37
Gingery,the-underbog,1483,warlock,destruction,71,34,37
Humanreapers,malganis,1482,warlock,destruction,31,22,9
Fshi,frostmourne,1482,warlock,destruction,102,58,44
Dercair,korgath,1480,warlock,destruction,30,18,12
Beyourselff,tichondrius,1479,warlock,destruction,35,16,19
Dloq,azgalor,1478,warlock,destruction,117,70,47
Chàõs,tichondrius,1477,warlock,destruction,54,27,27
Garbagefarts,aegwynn,1475,warlock,destruction,38,20,18
Tofulery,tichondrius,1475,warlock,destruction,50,23,27
Sickgurl,stormrage,1474,warlock,destruction,42,26,16
Bauchalain,area-52,1474,warlock,destruction,38,19,19
Gatewayoncd,frostmourne,1474,warlock,destruction,54,25,29
Glenfarclas,tichondrius,1471,warlock,destruction,43,19,24
Pestilocks,area-52,1469,warlock,destruction,44,28,16
Gharlock,tichondrius,1469,warlock,destruction,38,22,16
Demondots,sargeras,1469,warlock,destruction,54,31,23
Laylowl,tichondrius,1468,warlock,destruction,36,22,14
Shadowxlock,misha,1468,warlock,destruction,95,51,44
Magy,deathwing,1467,warlock,destruction,48,30,18
Flor,khadgar,1467,warlock,destruction,164,82,82
Pwz,azralon,1465,warlock,destruction,108,60,48
Noxdolor,stormreaver,1465,warlock,destruction,36,20,16
Zemphius,illidan,1463,warlock,destruction,55,27,28
Daremyth,azralon,1461,warlock,destruction,30,20,10
Morcegø,azralon,1460,warlock,destruction,42,20,22
Jakeyboii,frostmourne,1459,warlock,destruction,51,33,18
Falcorr,area-52,1459,warlock,destruction,34,19,15
Jezwazerox,area-52,1458,warlock,destruction,93,50,43
Covírus,azralon,1452,warlock,destruction,24,16,8
Hellcon,area-52,1452,warlock,destruction,58,38,20
Eriess,burning-blade,1447,warlock,destruction,54,24,30
Ptheven,area-52,1446,warlock,destruction,52,35,17
Stunresistin,tichondrius,1446,warlock,destruction,60,33,27
Avelmi,daggerspine,1446,warlock,destruction,72,34,38
Sickmade,zuljin,1445,warlock,destruction,24,16,8
Mcjoy,akama,1445,warlock,destruction,224,114,110
Demonicus,thunderlord,1445,warlock,destruction,51,24,27
Maleficmango,tichondrius,1444,warlock,destruction,36,23,13
Widdleywahh,area-52,1443,warlock,destruction,36,18,18
Munar,quelthalas,1442,warlock,destruction,93,47,46
Xbqss,illidan,1442,warlock,destruction,36,16,20
Jaboltz,tichondrius,1441,warlock,destruction,25,16,9
Mantis,proudmoore,1441,warlock,destruction,43,23,20
Nttslock,tichondrius,1441,warlock,destruction,42,22,20
Eldriptch,kelthuzad,1441,warlock,destruction,47,23,24
Atrofourth,tichondrius,1441,warlock,destruction,48,23,25
Discordant,trollbane,1439,warlock,destruction,36,23,13
Printwo,sargeras,1439,warlock,destruction,24,15,9
Janeciap,tichondrius,1439,warlock,destruction,24,15,9
Maldivà,tichondrius,1439,warlock,destruction,24,15,9
Indelock,drenden,1439,warlock,destruction,24,15,9
Chaosmorty,tichondrius,1439,warlock,destruction,39,24,15
Twototheone,illidan,1439,warlock,destruction,131,67,64
Danaowns,spirestone,1439,warlock,destruction,30,15,15
Selwitch,dalaran,1438,warlock,destruction,18,15,3
Spectro,laughing-skull,1438,warlock,destruction,18,15,3
Sâlâñzø,bleeding-hollow,1438,warlock,destruction,18,15,3
Mykiel,sargeras,1438,warlock,destruction,42,21,21
Goofycupcake,drakthul,1437,warlock,destruction,18,15,3
Deathmásk,ragnaros,1437,warlock,destruction,18,15,3
Krokodiil,tichondrius,1437,warlock,destruction,56,35,21
Imbooms,blackrock,1437,warlock,destruction,30,15,15
Pikme,bleeding-hollow,1436,warlock,destruction,18,15,3
Rzlrot,tichondrius,1436,warlock,destruction,30,18,12
Jämeson,tichondrius,1436,warlock,destruction,30,15,15
Artzul,tichondrius,1436,warlock,destruction,60,25,35
Bourrasq,illidan,1435,warlock,destruction,18,15,3
Rollup,turalyon,1435,warlock,destruction,24,15,9
Sonnagalook,sargeras,1435,warlock,destruction,42,24,18
Mastasnipah,illidan,1435,warlock,destruction,30,15,15
Stizzy,eredar,1434,warlock,destruction,24,15,9
Kuoma,boulderfist,1434,warlock,destruction,121,57,64
Felacid,tichondrius,1433,warlock,destruction,48,28,20
Mcrfan,illidan,1432,warlock,destruction,18,15,3
Wickedry,antonidas,1432,warlock,destruction,24,15,9
Sëcond,azralon,1432,warlock,destruction,24,15,9
Mldxd,undermine,1432,warlock,destruction,34,17,17
Kayersoul,tichondrius,1432,warlock,destruction,30,15,15
Dance,sargeras,1431,warlock,destruction,18,15,3
Dunbu,illidan,1431,warlock,destruction,133,71,62
Masefield,moon-guard,1431,warlock,destruction,68,33,35
Verminosa,nemesis,1429,warlock,destruction,24,15,9
Dotsyu,frostmourne,1429,warlock,destruction,50,28,22
Conorloco,tichondrius,1429,warlock,destruction,36,15,21
Naome,cenarius,1428,warlock,destruction,36,16,20
Demontos,darkspear,1427,warlock,destruction,48,24,24
Vexedconvex,area-52,1425,warlock,destruction,307,151,156
Shadowfork,illidan,1424,warlock,destruction,24,15,9
Thralord,blackrock,1424,warlock,destruction,30,18,12
Straightlock,sargeras,1424,warlock,destruction,53,22,31
Kanekiskid,mannoroth,1423,warlock,destruction,42,29,13
Balepyre,moon-guard,1423,warlock,destruction,24,15,9
Saddestboi,proudmoore,1423,warlock,destruction,66,40,26
Siellisele,illidan,1423,warlock,destruction,30,15,15
Gvvo,tichondrius,1423,warlock,destruction,30,15,15
Çrayoneater,tichondrius,1423,warlock,destruction,52,22,30
Soiedentaire,illidan,1422,warlock,destruction,36,30,6
Nueleth,frostmourne,1422,warlock,destruction,47,24,23
Tulu,muradin,1421,warlock,destruction,42,26,16
Yuh,moon-guard,1420,warlock,destruction,18,15,3
Fearloom,tichondrius,1420,warlock,destruction,151,78,73
Chéztér,proudmoore,1420,warlock,destruction,121,60,61
Soloart,tichondrius,1419,warlock,destruction,24,15,9
Decrepticus,kargath,1419,warlock,destruction,44,26,18
Jenda,blackrock,1419,warlock,destruction,30,15,15
Destruction,frostmourne,1418,warlock,destruction,45,25,20
Desconjuro,nemesis,1416,warlock,destruction,50,29,21
Deatthmoon,stormrage,1415,warlock,destruction,24,15,9
Kelifan,sargeras,1415,warlock,destruction,78,45,33
Evillyñ,tichondrius,1415,warlock,destruction,66,35,31
Locker,lightnings-blade,1414,warlock,destruction,30,18,12
Iceameri,tichondrius,1414,warlock,destruction,62,34,28
Alizondemdik,azralon,1414,warlock,destruction,45,23,22
Priiscilá,drakkari,1414,warlock,destruction,36,16,20
Exofilth,thrall,1414,warlock,destruction,58,25,33
Budgetkroozz,illidan,1413,warlock,destruction,30,15,15
Bilidin,azralon,1413,warlock,destruction,93,41,52
Doublebolt,illidan,1412,warlock,destruction,65,42,23
Baldandugly,illidan,1412,warlock,destruction,24,15,9
Yorchziel,ragnaros,1412,warlock,destruction,88,47,41
Aliciayd,andorhal,1411,warlock,destruction,24,15,9
Greedy,garrosh,1410,warlock,destruction,24,15,9
Thicclöcc,tichondrius,1410,warlock,destruction,30,15,15
Parmenides,tichondrius,1410,warlock,destruction,42,19,23
Johnnybegood,frostmourne,1409,warlock,destruction,24,15,9
Mongdot,frostmourne,1408,warlock,destruction,27,17,10
Lôrdslug,bleeding-hollow,1408,warlock,destruction,24,15,9
Blackguldan,illidan,1405,warlock,destruction,24,15,9
Meatybolts,nagrand,1405,warlock,destruction,78,43,35
Lightname,arthas,1404,warlock,destruction,24,17,7
Raizël,ragnaros,1404,warlock,destruction,49,28,21
Lockerdoo,aegwynn,1404,warlock,destruction,30,17,13
Fatals,thrall,1404,warlock,destruction,30,15,15
Bellanomikus,stormrage,1404,warlock,destruction,60,25,35
Drudotzz,hyjal,1403,warlock,destruction,30,16,14
Kecca,azralon,1402,warlock,destruction,96,52,44
Adderall,altar-of-storms,1402,warlock,destruction,42,20,22
Chuwhee,sargeras,1401,warlock,destruction,54,18,36
Antistar,barthilas,1400,warlock,destruction,43,27,16
Perples,dalaran,1399,warlock,destruction,60,30,30
Shadow,frostwolf,1399,warlock,destruction,44,17,27
Vindicated,azgalor,1397,warlock,destruction,31,22,9
Momshutup,sargeras,1397,warlock,destruction,23,15,8
Azöd,tichondrius,1397,warlock,destruction,93,57,36
Év,azralon,1397,warlock,destruction,42,20,22
Oldwing,illidan,1396,warlock,destruction,35,15,20
Iongestpp,bleeding-hollow,1395,warlock,destruction,42,22,20
Celash,barthilas,1394,warlock,destruction,42,20,22
Barathron,tichondrius,1394,warlock,destruction,54,22,32
Rotsndotss,thrall,1393,warlock,destruction,33,16,17
Shadococo,tichondrius,1393,warlock,destruction,36,16,20
Magiaoscurax,quelthalas,1392,warlock,destruction,66,34,32
Ganknãmstyle,illidan,1391,warlock,destruction,60,30,30
Adhauto,illidan,1390,warlock,destruction,113,62,51
Bustednut,nerzhul,1388,warlock,destruction,92,53,39
Tergale,illidan,1388,warlock,destruction,66,28,38
Castngcouch,tichondrius,1387,warlock,destruction,45,25,20
Nazzlock,lethon,1387,warlock,destruction,29,16,13
Yanned,hakkar,1387,warlock,destruction,147,78,69
Umdur,zuljin,1385,warlock,destruction,62,29,33
Rangmar,ragnaros,1385,warlock,destruction,39,18,21
Gorelami,tichondrius,1384,warlock,destruction,42,23,19
Neodron,thrall,1380,warlock,destruction,69,45,24
Necrotic,antonidas,1379,warlock,destruction,66,33,33
Warlo,moonrunner,1378,warlock,destruction,30,20,10
Coreleron,proudmoore,1378,warlock,destruction,61,29,32
Siccwidit,area-52,1378,warlock,destruction,74,34,40
Notchinese,kiljaeden,1377,warlock,destruction,41,19,22
Aksness,stormrage,1377,warlock,destruction,42,18,24
Blankdots,sargeras,1375,warlock,destruction,42,27,15
Zénth,kiljaeden,1375,warlock,destruction,28,17,11
Lockonthc,korgath,1375,warlock,destruction,32,16,16
Wasrenai,tichondrius,1375,warlock,destruction,47,21,26
Connect,borean-tundra,1371,warlock,destruction,35,18,17
Dessoft,ragnaros,1371,warlock,destruction,36,17,19
Foxfoxfel,thrall,1369,warlock,destruction,24,16,8
Warlockgomes,azralon,1368,warlock,destruction,145,69,76
Condevil,quelthalas,1367,warlock,destruction,83,47,36
Notäçultist,nagrand,1367,warlock,destruction,45,25,20
Verdoso,stormrage,1367,warlock,destruction,60,33,27
Gukky,misha,1366,warlock,destruction,101,62,39
Diabhlaí,tichondrius,1365,warlock,destruction,90,51,39
Getpissed,emerald-dream,1365,warlock,destruction,65,32,33
Critneyfearz,stormscale,1365,warlock,destruction,53,25,28
Blindingsun,kiljaeden,1365,warlock,destruction,72,27,45
Avae,frostmourne,1363,warlock,destruction,96,51,45
Luxenna,malganis,1363,warlock,destruction,84,40,44
Esteedees,moon-guard,1361,warlock,destruction,42,16,26
Wackykid,azralon,1360,warlock,destruction,86,39,47
Lockssy,tichondrius,1359,warlock,destruction,101,58,43
Freggen,shadowsong,1358,warlock,destruction,24,15,9
Lafuke,tichondrius,1358,warlock,destruction,25,15,10
Locksyy,tichondrius,1357,warlock,destruction,59,24,35
Matdamon,barthilas,1354,warlock,destruction,60,33,27
Nezsarek,sargeras,1352,warlock,destruction,169,73,96
Ørfna,zuljin,1351,warlock,destruction,66,33,33
Sauronne,illidan,1351,warlock,destruction,36,15,21
Jhop,sargeras,1349,warlock,destruction,72,40,32
Karadelice,stormrage,1349,warlock,destruction,54,29,25
Mèrlin,aerie-peak,1346,warlock,destruction,24,17,7
Razizzles,malganis,1345,warlock,destruction,72,42,30
Stallrooks,moon-guard,1345,warlock,destruction,29,16,13
Zinkro,quelthalas,1345,warlock,destruction,59,22,37
Retwarr,tichondrius,1344,warlock,destruction,18,14,4
Odjure,zuljin,1344,warlock,destruction,23,14,9
Soulruler,tichondrius,1344,warlock,destruction,24,14,10
Spreadnhiv,thrall,1344,warlock,destruction,42,18,24
Drwongmd,sargeras,1343,warlock,destruction,18,14,4
Súpersonic,tichondrius,1343,warlock,destruction,24,14,10
Kryl,kiljaeden,1343,warlock,destruction,24,14,10
Sktfäker,sargeras,1343,warlock,destruction,24,14,10
Naiyuan,tichondrius,1343,warlock,destruction,30,14,16
Austen,tichondrius,1343,warlock,destruction,55,24,31
Dobbythelock,zuljin,1340,warlock,destruction,24,14,10
Bobbygoulant,tichondrius,1340,warlock,destruction,259,128,131
Lladyyheartt,nesingwary,1339,warlock,destruction,54,28,26
Sunkuna,aerie-peak,1339,warlock,destruction,96,48,48
Aemma,proudmoore,1338,warlock,destruction,18,14,4
Extinção,azralon,1338,warlock,destruction,64,39,25
Pantypeeler,barthilas,1338,warlock,destruction,60,35,25
Knockknock,llane,1338,warlock,destruction,24,14,10
Sofan,dalaran,1338,warlock,destruction,24,14,10
Scãryz,jubeithos,1338,warlock,destruction,50,29,21
Veerdz,area-52,1338,warlock,destruction,30,14,16
Éx,jubeithos,1337,warlock,destruction,18,14,4
Xlilgee,kelthuzad,1337,warlock,destruction,18,14,4
Jackscar,windrunner,1337,warlock,destruction,23,16,7
Punishment,jubeithos,1337,warlock,destruction,23,15,8
Nattydots,sargeras,1337,warlock,destruction,59,28,31
Gingerspise,nathrezim,1337,warlock,destruction,30,14,16
Sugmabone,zuluhed,1336,warlock,destruction,24,17,7
Shipmatelock,stormrage,1336,warlock,destruction,24,17,7
Nazgal,tichondrius,1336,warlock,destruction,27,16,11
Memon,frostmane,1336,warlock,destruction,36,19,17
Fearsntears,stormrage,1336,warlock,destruction,36,14,22
Yarrz,kelthuzad,1335,warlock,destruction,24,16,8
Powertrîp,sargeras,1335,warlock,destruction,24,14,10
Theredwoman,emerald-dream,1335,warlock,destruction,30,14,16
Ozgwad,thunderhorn,1334,warlock,destruction,36,18,18
Lòthloria,mannoroth,1334,warlock,destruction,149,74,75
Majinbuû,malganis,1334,warlock,destruction,30,14,16
Wadoom,tichondrius,1332,warlock,destruction,54,27,27
Spongebobjrj,tichondrius,1331,warlock,destruction,36,20,16
Aomniloltv,zuljin,1331,warlock,destruction,47,24,23
Lefteexd,tichondrius,1330,warlock,destruction,24,14,10
Grandpapapa,tichondrius,1330,warlock,destruction,54,22,32
Darksolace,dalaran,1329,warlock,destruction,24,14,10
Laklin,stormscale,1329,warlock,destruction,110,51,59
Freestyle,blackwater-raiders,1328,warlock,destruction,54,34,20
Gingerlocky,barthilas,1328,warlock,destruction,106,50,56
Celeden,emerald-dream,1327,warlock,destruction,30,18,12
Cursedoll,ragnaros,1327,warlock,destruction,36,15,21
Salties,magtheridon,1326,warlock,destruction,24,14,10
Felpsychosis,illidan,1323,warlock,destruction,93,49,44
Drcameron,zuljin,1322,warlock,destruction,24,15,9
Lockednloade,tichondrius,1322,warlock,destruction,57,33,24
Zephee,queldorei,1322,warlock,destruction,54,31,23
Gòtti,frostmourne,1320,warlock,destruction,24,14,10
Jugerdotz,sargeras,1320,warlock,destruction,30,14,16
Addonic,hyjal,1318,warlock,destruction,24,14,10
Dialalock,frostmourne,1318,warlock,destruction,24,14,10
Jeramie,darkspear,1317,warlock,destruction,38,17,21
Undies,demon-soul,1314,warlock,destruction,72,39,33
Plagueîs,area-52,1313,warlock,destruction,27,15,12
Jecklez,tichondrius,1312,warlock,destruction,135,70,65
Shedara,ragnaros,1311,warlock,destruction,23,14,9
Kabroom,boulderfist,1311,warlock,destruction,24,14,10
Dotyoazz,tichondrius,1308,warlock,destruction,38,22,16
Rustý,illidan,1307,warlock,destruction,47,30,17
Dotsfired,crushridge,1307,warlock,destruction,24,15,9
Muchoprecogo,tichondrius,1306,warlock,destruction,24,14,10
Sû,stormrage,1306,warlock,destruction,72,31,41
Downbad,ysera,1305,warlock,destruction,37,16,21
Heathncraig,illidan,1305,warlock,destruction,50,20,30
Imprecátion,tichondrius,1304,warlock,destruction,53,19,34
Gscar,area-52,1303,warlock,destruction,48,28,20
Felqueenn,windrunner,1301,warlock,destruction,30,19,11
Voidchaos,korgath,1300,warlock,destruction,18,14,4
Tsmcfker,tichondrius,1298,warlock,destruction,24,14,10
Sylestrio,feathermoon,1297,warlock,destruction,48,22,26
Striga,staghelm,1297,warlock,destruction,51,20,31
Covenslave,nemesis,1295,warlock,destruction,264,130,134
Boltybarnes,area-52,1292,warlock,destruction,24,16,8
Rauwërrs,azralon,1292,warlock,destruction,55,26,29
Kombat,amanthul,1292,warlock,destruction,71,32,39
Bigdoinks,nagrand,1290,warlock,destruction,34,19,15
Killafornia,runetotem,1288,warlock,destruction,30,16,14
Stinkychef,hyjal,1287,warlock,destruction,18,14,4
Lolimalock,bleeding-hollow,1286,warlock,destruction,35,19,16
Ganosh,aggramar,1285,warlock,destruction,110,59,51
Identiti,tichondrius,1285,warlock,destruction,27,14,13
Haxlock,azralon,1282,warlock,destruction,34,15,19
Awfeelya,sargeras,1281,warlock,destruction,29,17,12
Zuldar,tichondrius,1281,warlock,destruction,36,21,15
Mickylock,tichondrius,1281,warlock,destruction,108,58,50
Dealcloud,tichondrius,1281,warlock,destruction,62,30,32
Zoluraan,proudmoore,1280,warlock,destruction,51,33,18
Hurriicane,stormrage,1280,warlock,destruction,92,48,44
Buildsuccess,tichondrius,1278,warlock,destruction,35,14,21
Ppoonlock,tichondrius,1277,warlock,destruction,28,14,14
Lilibe,tichondrius,1276,warlock,destruction,54,23,31
Ahrimus,area-52,1275,warlock,destruction,28,14,14
Aboode,blackrock,1274,warlock,destruction,47,23,24
Potatostew,dalaran,1273,warlock,destruction,36,14,22
Boltster,destromath,1271,warlock,destruction,30,18,12
Telvanni,sargeras,1270,warlock,destruction,43,24,19
Derfflinger,tichondrius,1270,warlock,destruction,118,49,69
Felryssa,kiljaeden,1269,warlock,destruction,60,29,31
Fearndot,draenor,1268,warlock,destruction,45,21,24
Prinzheinric,quelthalas,1267,warlock,destruction,33,21,12
Gwar,khazgoroth,1267,warlock,destruction,169,79,90
Kyle,shandris,1267,warlock,destruction,45,21,24
Theporkchunk,nordrassil,1265,warlock,destruction,52,35,17
Griget,runetotem,1265,warlock,destruction,59,28,31
Ehcsrop,doomhammer,1263,warlock,destruction,86,42,44
Gattsonn,kiljaeden,1259,warlock,destruction,42,15,27
Honne,sargeras,1258,warlock,destruction,26,14,12
Deseo,moon-guard,1257,warlock,destruction,18,14,4
Thizzmaa,area-52,1255,warlock,destruction,89,44,45
Mordekhay,tichondrius,1255,warlock,destruction,62,30,32
Felancholy,illidan,1254,warlock,destruction,32,22,10
Wizlox,illidan,1254,warlock,destruction,119,49,70
Ticktóck,ghostlands,1253,warlock,destruction,19,14,5
Kortinanga,tichondrius,1252,warlock,destruction,54,30,24
Eurygnomous,thrall,1252,warlock,destruction,30,14,16
Exupery,emerald-dream,1250,warlock,destruction,31,15,16
Xtwistedteas,tichondrius,1249,warlock,destruction,31,14,17
Beastsuper,tichondrius,1248,warlock,destruction,24,13,11
Pressurë,tichondrius,1247,warlock,destruction,18,13,5
Voqo,shandris,1247,warlock,destruction,18,13,5
Enkryption,dalaran,1247,warlock,destruction,18,13,5
Drakedog,ragnaros,1247,warlock,destruction,18,13,5
Cyrus,akama,1247,warlock,destruction,24,16,8
Kimsoul,zuljin,1247,warlock,destruction,24,13,11
Rèdrùm,tichondrius,1247,warlock,destruction,24,13,11
Oymmander,illidan,1247,warlock,destruction,24,13,11
Grenswood,arathor,1247,warlock,destruction,27,14,13
Medusaqn,tichondrius,1246,warlock,destruction,18,13,5
Lotussama,anetheron,1246,warlock,destruction,18,13,5
Inaane,thrall,1246,warlock,destruction,24,13,11
Skanckqt,malganis,1246,warlock,destruction,24,13,11
Hauntsin,hyjal,1246,warlock,destruction,30,13,17
Duckboji,tichondrius,1245,warlock,destruction,24,13,11
Sladez,tichondrius,1245,warlock,destruction,36,13,23
Toastwl,tichondrius,1244,warlock,destruction,18,13,5
Riptyler,illidan,1244,warlock,destruction,24,13,11
Mailerdaemön,proudmoore,1244,warlock,destruction,24,13,11
Wampeter,azshara,1243,warlock,destruction,30,13,17
Nigsy,nagrand,1242,warlock,destruction,24,13,11
Spòngwò,tichondrius,1242,warlock,destruction,24,13,11
Tirzah,frostmourne,1241,warlock,destruction,18,13,5
Mothmayhem,moon-guard,1241,warlock,destruction,24,13,11
Soulwipe,dethecus,1241,warlock,destruction,24,13,11
Shadü,tichondrius,1241,warlock,destruction,36,14,22
Ruknài,barthilas,1240,warlock,destruction,24,13,11
Jnzi,area-52,1239,warlock,destruction,18,13,5
Ciprýan,azralon,1238,warlock,destruction,24,13,11
Pruevolf,tichondrius,1236,warlock,destruction,80,35,45
Reppedlock,illidan,1234,warlock,destruction,24,13,11
Rainymood,frostmourne,1233,warlock,destruction,18,13,5
Munick,spirestone,1233,warlock,destruction,24,13,11
Blastyboat,terenas,1233,warlock,destruction,39,15,24
Dalruk,wyrmrest-accord,1232,warlock,destruction,18,13,5
Klatuu,stonemaul,1232,warlock,destruction,24,15,9
Chaotíc,zuljin,1231,warlock,destruction,24,13,11
Jelluz,ghostlands,1230,warlock,destruction,33,16,17
Wåbi,tichondrius,1228,warlock,destruction,30,13,17
Impieties,emerald-dream,1228,warlock,destruction,36,14,22
Ellneggro,zuljin,1226,warlock,destruction,18,13,5
Rickyspanish,malygos,1226,warlock,destruction,30,13,17
Kyrionn,azralon,1225,warlock,destruction,24,13,11
Dirtybóy,tichondrius,1224,warlock,destruction,24,13,11
Finnickk,blackrock,1221,warlock,destruction,30,13,17
Darkboltz,area-52,1218,warlock,destruction,18,13,5
Enaria,queldorei,1218,warlock,destruction,24,13,11
Sepültüra,quelthalas,1218,warlock,destruction,36,13,23
Iiferna,sargeras,1217,warlock,destruction,149,70,79
Cursedtool,quelthalas,1216,warlock,destruction,21,14,7
Schmok,terenas,1216,warlock,destruction,64,33,31
Blockk,moknathal,1216,warlock,destruction,62,26,36
Hawkstalker,thaurissan,1215,warlock,destruction,76,39,37
Zydaria,stormrage,1213,warlock,destruction,30,18,12
Erevas,area-52,1213,warlock,destruction,24,14,10
Prototyp,azralon,1212,warlock,destruction,18,13,5
Atrabiliario,quelthalas,1210,warlock,destruction,36,13,23
Repláced,thrall,1207,warlock,destruction,45,19,26
Felinå,hyjal,1206,warlock,destruction,39,24,15
Superbroly,area-52,1204,warlock,destruction,30,16,14
Daeykras,crushridge,1203,warlock,destruction,45,25,20
Patagucci,bleeding-hollow,1203,warlock,destruction,24,13,11
Luulloo,proudmoore,1203,warlock,destruction,60,32,28
Gouldon,sargeras,1202,warlock,destruction,40,20,20
Blew,bleeding-hollow,1200,warlock,destruction,15,14,1
Wodwarlock,thrall,1199,warlock,destruction,15,14,1
Tm,dalaran,1196,warlock,destruction,23,15,8
Jannus,wyrmrest-accord,1196,warlock,destruction,32,15,17
Boltsfordays,dalaran,1195,warlock,destruction,80,40,40
Zaeloc,ragnaros,1195,warlock,destruction,42,13,29
Goldieloc,sargeras,1192,warlock,destruction,42,26,16
Spookyfurry,area-52,1192,warlock,destruction,30,13,17
Bénn,moon-guard,1189,warlock,destruction,60,39,21
Cørruption,emerald-dream,1188,warlock,destruction,47,22,25
Pancakestack,stormrage,1187,warlock,destruction,73,38,35
Kemchaos,illidan,1187,warlock,destruction,82,38,44
Mocreia,azralon,1186,warlock,destruction,113,53,60
Kärên,proudmoore,1185,warlock,destruction,22,16,6
Sutra,tichondrius,1185,warlock,destruction,23,14,9
Sñeed,sargeras,1184,warlock,destruction,35,17,18
Chodetamer,lethon,1180,warlock,destruction,29,18,11
Necrodeath,malygos,1180,warlock,destruction,30,15,15
Maldíta,quelthalas,1180,warlock,destruction,117,52,65
Rodimus,hyjal,1179,warlock,destruction,129,72,57
Kidsoul,illidan,1178,warlock,destruction,97,46,51
Nanodingo,tichondrius,1176,warlock,destruction,59,30,29
Nhen,daggerspine,1169,warlock,destruction,119,65,54
Ilovedemons,aegwynn,1168,warlock,destruction,42,26,16
Bawldimort,stormrage,1165,warlock,destruction,89,46,43
Aerozyn,wyrmrest-accord,1161,warlock,destruction,30,16,14
Dudda,sargeras,1152,warlock,destruction,12,12,0
Osmatz,area-52,1152,warlock,destruction,18,12,6
Livinpink,zuljin,1152,warlock,destruction,18,12,6
Sphoo,tichondrius,1152,warlock,destruction,18,12,6
Phreekish,bleeding-hollow,1152,warlock,destruction,18,12,6
Blodrain,tichondrius,1152,warlock,destruction,18,12,6
Koei,tichondrius,1152,warlock,destruction,24,12,12
Shutupthug,illidan,1151,warlock,destruction,18,12,6
Blastamastah,tichondrius,1151,warlock,destruction,18,12,6
Oceangrownx,emerald-dream,1151,warlock,destruction,24,12,12
Shadowmoonon,tichondrius,1151,warlock,destruction,24,12,12
Pugnatwo,kelthuzad,1151,warlock,destruction,24,12,12
Keniiwood,quelthalas,1151,warlock,destruction,24,12,12
Lockdotsftw,illidan,1151,warlock,destruction,24,12,12
Flûké,tichondrius,1151,warlock,destruction,24,12,12
Asmit,firetree,1151,warlock,destruction,28,13,15
Zaiocian,tichondrius,1151,warlock,destruction,26,12,14
Dralok,area-52,1150,warlock,destruction,18,12,6
Mattypatty,the-forgotten-coast,1150,warlock,destruction,18,12,6
Dëception,ragnaros,1150,warlock,destruction,18,12,6
Ggooudan,tichondrius,1150,warlock,destruction,18,12,6
Ñigorshedøn,area-52,1150,warlock,destruction,18,12,6
Canobio,tichondrius,1150,warlock,destruction,24,12,12
Soulripped,area-52,1150,warlock,destruction,24,12,12
Iggyiggy,sargeras,1149,warlock,destruction,24,12,12
Ole,area-52,1149,warlock,destruction,27,13,14
Beldiinlock,khazgoroth,1149,warlock,destruction,75,36,39
Poock,goldrinn,1148,warlock,destruction,18,12,6
Kylaria,emerald-dream,1148,warlock,destruction,24,12,12
Omarlil,kelthuzad,1147,warlock,destruction,18,12,6
Nadirius,shadowmoon,1146,warlock,destruction,18,12,6
Soulicit,kelthuzad,1146,warlock,destruction,24,12,12
Superbvious,lothar,1145,warlock,destruction,83,40,43
Soulsurvivor,tichondrius,1144,warlock,destruction,30,12,18
Xiáoyan,tichondrius,1143,warlock,destruction,18,12,6
Gambel,duskwood,1143,warlock,destruction,30,13,17
Handler,earthen-ring,1142,warlock,destruction,42,28,14
Escro,azgalor,1142,warlock,destruction,80,47,33
Gridwild,drakkari,1142,warlock,destruction,24,12,12
Løvesick,zuljin,1141,warlock,destruction,30,12,18
Nadek,tichondrius,1140,warlock,destruction,24,12,12
Bmó,stormrage,1139,warlock,destruction,18,12,6
Lessance,dalaran,1138,warlock,destruction,24,12,12
Taylôr,proudmoore,1136,warlock,destruction,30,12,18
Nozyroh,emerald-dream,1134,warlock,destruction,23,12,11
Lagcursed,frostmourne,1133,warlock,destruction,18,12,6
Skullsoul,arthas,1132,warlock,destruction,24,12,12
Cælohin,tichondrius,1132,warlock,destruction,24,12,12
Mordror,azralon,1132,warlock,destruction,29,14,15
Dlchem,tichondrius,1126,warlock,destruction,18,12,6
Batär,area-52,1126,warlock,destruction,18,12,6
Rageraff,trollbane,1121,warlock,destruction,30,18,12
Dotdoctor,thrall,1120,warlock,destruction,27,12,15
Nocchi,amanthul,1119,warlock,destruction,22,12,10
Kracky,tichondrius,1115,warlock,destruction,162,87,75
Josemb,ragnaros,1114,warlock,destruction,26,14,12
Ðeãdman,bleeding-hollow,1112,warlock,destruction,20,13,7
Marvolö,darkspear,1112,warlock,destruction,24,15,9
Mshyde,gurubashi,1106,warlock,destruction,24,14,10
Dex,jubeithos,1105,warlock,destruction,107,37,70
Juniorsalanu,quelthalas,1104,warlock,destruction,36,19,17
Anstik,area-52,1103,warlock,destruction,15,13,2
Tempestzone,barthilas,1096,warlock,destruction,29,16,13
Darthlockz,illidan,1095,warlock,destruction,24,13,11
Madgettike,stormrage,1094,warlock,destruction,36,22,14
Varuuss,ragnaros,1092,warlock,destruction,21,12,9
Mindfulchimp,sargeras,1092,warlock,destruction,23,12,11
Cheiff,tichondrius,1092,warlock,destruction,42,16,26
Timmerstar,tichondrius,1091,warlock,destruction,48,22,26
Taìnted,lightbringer,1088,warlock,destruction,28,12,16
Medeia,tichondrius,1087,warlock,destruction,23,12,11
Skynflute,tichondrius,1087,warlock,destruction,28,12,16
Necrotiá,tichondrius,1085,warlock,destruction,17,12,5
Vafa,kelthuzad,1084,warlock,destruction,20,12,8
Spicý,sargeras,1084,warlock,destruction,63,31,32
Abracadavers,ragnaros,1081,warlock,destruction,23,12,11
Idrannell,illidan,1077,warlock,destruction,26,12,14
Valval,moon-guard,1074,warlock,destruction,72,22,50
Wolfib,tichondrius,1072,warlock,destruction,19,12,7
Phreaky,area-52,1072,warlock,destruction,36,17,19
Nøvah,tichondrius,1070,warlock,destruction,19,12,7
Toby,azralon,1066,warlock,destruction,25,12,13
Davnport,frostmourne,1065,warlock,destruction,38,12,26
Luke,lightnings-blade,1062,warlock,destruction,18,12,6
Krýstál,ragnaros,1057,warlock,destruction,25,13,12
Caesaros,quelthalas,1057,warlock,destruction,25,12,13
Bumbleebolts,azralon,1056,warlock,destruction,12,11,1
Xidothewitch,stormrage,1056,warlock,destruction,18,11,7
Lockâsf,tichondrius,1056,warlock,destruction,18,11,7
Søulswap,tichondrius,1056,warlock,destruction,18,11,7
Urukaix,sargeras,1056,warlock,destruction,18,11,7
Drböb,area-52,1056,warlock,destruction,18,11,7
Ghettobeluga,area-52,1056,warlock,destruction,18,11,7
Thragèqt,sargeras,1056,warlock,destruction,18,11,7
Drsmegmaz,dreadmaul,1056,warlock,destruction,24,11,13
Tacticalderp,bleeding-hollow,1056,warlock,destruction,24,11,13
Finalboss,tichondrius,1055,warlock,destruction,12,11,1
Edeklock,frostmourne,1055,warlock,destruction,12,11,1
Dreadxbolts,stormrage,1055,warlock,destruction,18,11,7
Feardotzrun,illidan,1055,warlock,destruction,18,11,7
Mindheist,stormrage,1055,warlock,destruction,18,11,7
Tuzadin,tichondrius,1055,warlock,destruction,18,11,7
Sahdude,illidan,1055,warlock,destruction,18,11,7
Fabiusbilex,tichondrius,1055,warlock,destruction,18,11,7
Alktrz,azralon,1055,warlock,destruction,18,11,7
Ðòt,nagrand,1055,warlock,destruction,18,11,7
Guldansbicep,illidan,1055,warlock,destruction,22,12,10
Itstista,proudmoore,1055,warlock,destruction,24,11,13
Aureboros,sargeras,1054,warlock,destruction,18,11,7
Vasqu,stormrage,1054,warlock,destruction,18,11,7
Dunkindots,dalaran,1054,warlock,destruction,18,11,7
Friggus,azralon,1054,warlock,destruction,18,11,7
Locksolo,tichondrius,1054,warlock,destruction,18,11,7
Vigius,dalaran,1054,warlock,destruction,24,11,13
Spudzies,bleeding-hollow,1054,warlock,destruction,24,11,13
Dipz,zuljin,1053,warlock,destruction,18,11,7
Faënn,zuljin,1053,warlock,destruction,18,11,7
Buffwarlockz,stormrage,1053,warlock,destruction,18,11,7
Nightshan,draenor,1053,warlock,destruction,24,11,13
Ranil,mannoroth,1052,warlock,destruction,18,11,7
Azrezzael,area-52,1052,warlock,destruction,18,11,7
Trastham,malganis,1052,warlock,destruction,24,11,13
Blanklee,tichondrius,1051,warlock,destruction,12,11,1
Domenic,sentinels,1051,warlock,destruction,16,12,4
Doobielock,kelthuzad,1051,warlock,destruction,18,11,7
Mateekabr,malganis,1051,warlock,destruction,18,11,7
Teahourse,tichondrius,1051,warlock,destruction,24,11,13
Microd,tichondrius,1050,warlock,destruction,18,11,7
Sathorastus,spirestone,1050,warlock,destruction,24,11,13
Unprønuncea,azralon,1050,warlock,destruction,25,11,14
Tirp,illidan,1048,warlock,destruction,24,11,13
Pokemebutt,hydraxis,1046,warlock,destruction,18,11,7
Mysophobia,frostmourne,1046,warlock,destruction,101,47,54
Altazor,thunderlord,1046,warlock,destruction,30,11,19
Ltr,moon-guard,1045,warlock,destruction,18,11,7
Haloren,moon-guard,1044,warlock,destruction,18,11,7
Xenagos,antonidas,1043,warlock,destruction,30,11,19
Seeword,sargeras,1039,warlock,destruction,18,11,7
Ktlock,frostmourne,1032,warlock,destruction,24,11,13
Baiss,tichondrius,1030,warlock,destruction,18,11,7
Lowkei,stonemaul,1030,warlock,destruction,30,11,19
Danoinfelizz,nemesis,1029,warlock,destruction,15,12,3
Noriaeradra,illidan,1025,warlock,destruction,24,13,11
Basicwitch,malganis,1023,warlock,destruction,17,11,6
Daddybolt,blackrock,1023,warlock,destruction,23,11,12
Getsmoked,moknathal,1023,warlock,destruction,23,11,12
Locksoul,area-52,1019,warlock,destruction,54,25,29
Cascades,icecrown,1019,warlock,destruction,96,38,58
Nathalyâ,drakkari,1018,warlock,destruction,60,28,32
Bobthedoc,sargeras,1011,warlock,destruction,23,11,12
Kklock,frostmourne,1007,warlock,destruction,45,26,19
Faliceu,sargeras,1006,warlock,destruction,26,11,15
Plagué,barthilas,1004,warlock,destruction,21,11,10
Panyc,tichondrius,1002,warlock,destruction,23,11,12
Ticklebolts,tichondrius,1001,warlock,destruction,34,12,22
Saraphina,maiev,1000,warlock,destruction,236,111,125
Valerilma,azralon,998,warlock,destruction,23,11,12
Rnicu,bonechewer,995,warlock,destruction,81,39,42
Wingzerø,tichondrius,988,warlock,destruction,23,11,12
Nevermorde,area-52,986,warlock,destruction,23,11,12
Wìckedelf,area-52,986,warlock,destruction,81,38,43
Mystikcloak,lightbringer,980,warlock,destruction,19,13,6
Hanoaa,tichondrius,975,warlock,destruction,11,11,0
Zíppen,proudmoore,970,warlock,destruction,61,30,31
Plagueis,zuluhed,969,warlock,destruction,25,11,14
Kimis,azralon,963,warlock,destruction,24,14,10
Lockbtw,altar-of-storms,960,warlock,destruction,12,10,2
Nino,barthilas,960,warlock,destruction,12,10,2
Letmecastpls,tichondrius,960,warlock,destruction,12,10,2
Jaboy,dragonmaw,960,warlock,destruction,12,10,2
Bodhisage,kelthuzad,960,warlock,destruction,12,10,2
Wanglock,blackrock,960,warlock,destruction,12,10,2
Fxckyuo,tichondrius,960,warlock,destruction,12,10,2
Mesw,tichondrius,960,warlock,destruction,12,10,2
Kammuany,sargeras,960,warlock,destruction,12,10,2
Lilshedon,kelthuzad,960,warlock,destruction,12,10,2
Renatis,malganis,960,warlock,destruction,15,11,4
Klol,proudmoore,960,warlock,destruction,18,10,8
Baka,moon-guard,960,warlock,destruction,18,10,8
Spicyfingerx,illidan,960,warlock,destruction,18,10,8
Yuvirayz,illidan,960,warlock,destruction,18,10,8
Busterbob,tichondrius,960,warlock,destruction,18,10,8
Dimanel,moon-guard,960,warlock,destruction,18,10,8
Teefgap,sargeras,960,warlock,destruction,18,10,8
Veryezgame,tichondrius,960,warlock,destruction,18,10,8
Areufearious,sargeras,960,warlock,destruction,18,10,8
Contägion,bleeding-hollow,960,warlock,destruction,24,10,14
Dampenedx,bleeding-hollow,960,warlock,destruction,28,11,17
Mixolydian,malganis,959,warlock,destruction,12,10,2
Dkdakìng,dalaran,959,warlock,destruction,12,10,2
Percaddict,illidan,959,warlock,destruction,12,10,2
Foxar,stormrage,959,warlock,destruction,12,10,2
Gregfearnrun,area-52,959,warlock,destruction,16,11,5
Maral,kelthuzad,959,warlock,destruction,18,10,8
Sixonenine,boulderfist,959,warlock,destruction,18,10,8
Years,moon-guard,959,warlock,destruction,18,10,8
Thânàtös,malganis,959,warlock,destruction,18,10,8
Juiçédaddy,aggramar,959,warlock,destruction,18,10,8
Notatryhard,emerald-dream,959,warlock,destruction,18,10,8
Pykorrg,ragnaros,959,warlock,destruction,24,10,14
Helraz,darkspear,958,warlock,destruction,12,10,2
Delarae,frostmourne,958,warlock,destruction,12,10,2
Trobgol,bleeding-hollow,958,warlock,destruction,12,10,2
Mørgoth,thrall,958,warlock,destruction,18,10,8
Wondon,tichondrius,958,warlock,destruction,18,10,8
Yibbel,area-52,958,warlock,destruction,18,10,8
Iockgodtkoz,tichondrius,958,warlock,destruction,18,10,8
Chrishasnen,moon-guard,958,warlock,destruction,24,10,14
Newty,zuljin,957,warlock,destruction,12,10,2
Kbolt,barthilas,957,warlock,destruction,18,10,8
Xerozus,tichondrius,957,warlock,destruction,18,10,8
Diabolous,malganis,957,warlock,destruction,18,10,8
Kåos,kelthuzad,957,warlock,destruction,18,10,8
Dercrow,quelthalas,957,warlock,destruction,18,10,8
Greasymario,area-52,957,warlock,destruction,22,11,11
Tromeo,sargeras,957,warlock,destruction,24,10,14
Ragnalock,laughing-skull,956,warlock,destruction,18,10,8
Dårkfyre,kiljaeden,956,warlock,destruction,18,10,8
Manã,wyrmrest-accord,956,warlock,destruction,18,10,8
Kkokko,tichondrius,956,warlock,destruction,18,10,8
Graced,dalaran,956,warlock,destruction,18,10,8
Forsâken,tichondrius,956,warlock,destruction,22,11,11
Raidspot,bleeding-hollow,956,warlock,destruction,24,10,14
Zaintv,illidan,955,warlock,destruction,18,10,8
Chaoticstorm,area-52,955,warlock,destruction,18,10,8
Hellslayer,frostmourne,955,warlock,destruction,24,10,14
Balfast,quelthalas,955,warlock,destruction,30,10,20
Dvorakk,frostmourne,954,warlock,destruction,15,11,4
Crashcrash,area-52,954,warlock,destruction,24,10,14
Harleyjames,ravenholdt,953,warlock,destruction,18,10,8
Siliconsnipe,tichondrius,952,warlock,destruction,12,10,2
Punjj,jubeithos,952,warlock,destruction,18,10,8
Huuchie,moon-guard,951,warlock,destruction,18,10,8
Puscifear,azralon,951,warlock,destruction,30,10,20
Sojupain,kaelthas,950,warlock,destruction,12,10,2
Moreedotss,malganis,947,warlock,destruction,30,10,20
Hamadan,azralon,946,warlock,destruction,24,10,14
Cursé,stormrage,944,warlock,destruction,18,10,8
Øutbreak,thrall,943,warlock,destruction,17,10,7
Nessro,stormrage,934,warlock,destruction,12,10,2
Mogran,twisting-nether,934,warlock,destruction,18,10,8
Imsupercool,bleeding-hollow,927,warlock,destruction,17,10,7
Goal,malganis,927,warlock,destruction,20,11,9
Astarõth,zuljin,926,warlock,destruction,26,11,15
Twohandedkil,stormrage,920,warlock,destruction,26,11,15
Keleiron,velen,916,warlock,destruction,18,10,8
Xekk,wyrmrest-accord,910,warlock,destruction,23,10,13
Wawfw,bleeding-hollow,909,warlock,destruction,15,11,4
Lockyy,khaz-modan,904,warlock,destruction,26,11,15
Fiennx,dalaran,894,warlock,destruction,17,10,7
Katsby,moon-guard,894,warlock,destruction,17,10,7
Rakudemon,ragnaros,894,warlock,destruction,20,10,10
Marlett,destromath,890,warlock,destruction,113,58,55
Savagetheron,korgath,887,warlock,destruction,18,10,8
Pyria,boulderfist,877,warlock,destruction,13,10,3
Nikôlas,stormrage,871,warlock,destruction,66,26,40
Bonita,garona,864,warlock,destruction,12,9,3
Lokiy,ragnaros,864,warlock,destruction,12,9,3
Whaad,tichondrius,864,warlock,destruction,12,9,3
Fenriakshog,zuljin,864,warlock,destruction,12,9,3
Matthewx,stormrage,864,warlock,destruction,12,9,3
Liuh,tichondrius,864,warlock,destruction,12,9,3
Baddummy,tichondrius,864,warlock,destruction,12,9,3
Voidsoda,whisperwind,864,warlock,destruction,12,9,3
Lysitheä,moon-guard,864,warlock,destruction,12,9,3
Quickzmaster,blackrock,864,warlock,destruction,12,9,3
Pengliyuaner,illidan,864,warlock,destruction,12,9,3
Demoabuser,lightnings-blade,864,warlock,destruction,12,9,3
Crnowarlock,area-52,864,warlock,destruction,12,9,3
Drezx,frostmourne,864,warlock,destruction,12,9,3
Raxxis,moon-guard,864,warlock,destruction,12,9,3
Rice,lothar,864,warlock,destruction,12,9,3
Shokran,frostmourne,864,warlock,destruction,12,9,3
Moóndust,bleeding-hollow,864,warlock,destruction,12,9,3
Frustration,darkspear,864,warlock,destruction,12,9,3
Biggbolts,tichondrius,864,warlock,destruction,18,9,9
Sonovabeech,winterhoof,864,warlock,destruction,18,9,9
Reflexlock,malganis,864,warlock,destruction,18,9,9
Stuffs,wyrmrest-accord,864,warlock,destruction,18,9,9
Bigolehogger,area-52,864,warlock,destruction,18,9,9
Rorvask,area-52,864,warlock,destruction,18,9,9
Voidxo,tichondrius,864,warlock,destruction,18,9,9
Miroir,illidan,864,warlock,destruction,18,9,9
Woopie,malfurion,864,warlock,destruction,18,9,9
Ahrimaan,illidan,863,warlock,destruction,12,9,3
Shooff,area-52,863,warlock,destruction,12,9,3
Hawklock,ragnaros,863,warlock,destruction,12,9,3
Zycas,tichondrius,863,warlock,destruction,12,9,3
Slicktrik,stormrage,863,warlock,destruction,12,9,3
Pacopico,illidan,863,warlock,destruction,12,9,3
Glergarby,stormscale,863,warlock,destruction,15,10,5
Cyio,zuljin,863,warlock,destruction,18,9,9
Rothmar,bleeding-hollow,863,warlock,destruction,18,9,9
Minzyw,illidan,863,warlock,destruction,18,9,9
Ðarkbat,ragnaros,863,warlock,destruction,18,9,9
Nethron,the-venture-co,863,warlock,destruction,18,9,9
Rhabdo,ravenholdt,863,warlock,destruction,18,9,9
Kymamd,sargeras,863,warlock,destruction,18,9,9
Dmox,darkspear,863,warlock,destruction,18,9,9
Goarage,tichondrius,863,warlock,destruction,22,10,12
Rokdas,area-52,863,warlock,destruction,24,9,15
Pyresworn,wyrmrest-accord,862,warlock,destruction,12,9,3
Namig,aerie-peak,862,warlock,destruction,12,9,3
Locklockdead,earthen-ring,862,warlock,destruction,12,9,3
Cvntpvntcans,kelthuzad,862,warlock,destruction,12,9,3
Cogitoergo,stormrage,862,warlock,destruction,12,9,3
Çhåos,destromath,862,warlock,destruction,12,9,3
Artheás,azralon,862,warlock,destruction,18,9,9
Sanzofunke,area-52,862,warlock,destruction,18,9,9
Nmelock,malganis,862,warlock,destruction,18,9,9
Youkeyoh,illidan,862,warlock,destruction,18,9,9
Breaad,tichondrius,862,warlock,destruction,24,9,15
Ravikk,dalaran,862,warlock,destruction,24,9,15
Tanathoz,thrall,862,warlock,destruction,28,10,18
Aveeda,malganis,861,warlock,destruction,12,9,3
Methandmmkay,illidan,861,warlock,destruction,15,10,5
Frdchickiana,tichondrius,861,warlock,destruction,18,9,9
Funnelcakies,area-52,861,warlock,destruction,18,9,9
Snapp,kelthuzad,861,warlock,destruction,24,9,15
Raebolts,area-52,860,warlock,destruction,18,9,9
Damdochael,bleeding-hollow,860,warlock,destruction,24,9,15
Githany,hyjal,859,warlock,destruction,18,9,9
Shivalx,tichondrius,859,warlock,destruction,18,9,9
Gorskij,frostwolf,859,warlock,destruction,19,9,10
Damerus,illidan,859,warlock,destruction,24,9,15
Cynwise,arathor,858,warlock,destruction,18,9,9
Lerooux,hyjal,857,warlock,destruction,18,9,9
Sykosenpai,zuljin,856,warlock,destruction,12,9,3
Hookslinger,barthilas,856,warlock,destruction,18,9,9
Scentient,jubeithos,855,warlock,destruction,12,9,3
Shadohz,lightnings-blade,855,warlock,destruction,12,9,3
Buttkins,tichondrius,855,warlock,destruction,24,9,15
Klummzy,tichondrius,850,warlock,destruction,18,9,9
Sitra,ragnaros,850,warlock,destruction,18,9,9
Vampir,hellscream,850,warlock,destruction,24,9,15
Juan,borean-tundra,850,warlock,destruction,24,9,15
Elyzier,gallywix,839,warlock,destruction,48,20,28
Freakdoa,blades-edge,834,warlock,destruction,53,20,33
Dazedl,stormrage,816,warlock,destruction,15,9,6
Ovosound,tichondrius,815,warlock,destruction,11,9,2
Chaospump,frostmourne,815,warlock,destruction,17,9,8
Cheêsyx,tichondrius,815,warlock,destruction,17,9,8
Metamòrph,malganis,810,warlock,destruction,16,10,6
Biubius,tichondrius,799,warlock,destruction,11,9,2
Taneverah,wyrmrest-accord,799,warlock,destruction,11,9,2
Conboii,tichondrius,768,warlock,destruction,10,9,1
Rebolting,tichondrius,768,warlock,destruction,12,8,4
Shatteroidz,darkspear,768,warlock,destruction,12,8,4
Falsaqt,area-52,768,warlock,destruction,12,8,4
Kápz,darkspear,768,warlock,destruction,12,8,4
Esolock,malganis,768,warlock,destruction,12,8,4
Shinagae,tichondrius,768,warlock,destruction,12,8,4
Harambê,sargeras,768,warlock,destruction,12,8,4
Slackjaww,kiljaeden,768,warlock,destruction,12,8,4
Searinox,scilla,768,warlock,destruction,12,8,4
Flackory,tichondrius,768,warlock,destruction,12,8,4
Dumbfknclass,malganis,768,warlock,destruction,12,8,4
Munje,bleeding-hollow,768,warlock,destruction,12,8,4
Roblockz,illidan,768,warlock,destruction,12,8,4
Cheylock,stormrage,768,warlock,destruction,12,8,4
Aptukk,archimonde,768,warlock,destruction,12,8,4
Warlocknroll,frostmourne,768,warlock,destruction,12,8,4
Clorvenna,zuljin,768,warlock,destruction,12,8,4
Narzhul,drakkari,768,warlock,destruction,12,8,4
Felegance,proudmoore,768,warlock,destruction,12,8,4
Zunexx,malganis,768,warlock,destruction,12,8,4
Yze,sargeras,768,warlock,destruction,12,8,4
Tatemor,barthilas,768,warlock,destruction,12,8,4
Diznei,nemesis,768,warlock,destruction,12,8,4
Flavakid,malganis,768,warlock,destruction,12,8,4
Chaoscoach,sargeras,768,warlock,destruction,12,8,4
Pandasrlegit,burning-blade,768,warlock,destruction,12,8,4
Djdemolordx,bleeding-hollow,768,warlock,destruction,12,8,4
Badhombre,tichondrius,768,warlock,destruction,12,8,4
Ayedss,dalaran,768,warlock,destruction,12,8,4
Arthyr,twisting-nether,768,warlock,destruction,12,8,4
Devi,executus,768,warlock,destruction,12,8,4
Elldiablo,darkspear,768,warlock,destruction,12,8,4
Fearsponce,dragonmaw,768,warlock,destruction,12,8,4
Idoovoodoo,burning-legion,768,warlock,destruction,12,8,4
Bopplock,tichondrius,768,warlock,destruction,12,8,4
Smeezles,frostmourne,768,warlock,destruction,12,8,4
Ceeloftw,tichondrius,768,warlock,destruction,12,8,4
Nyhn,bleeding-hollow,768,warlock,destruction,13,8,5
Westtung,tichondrius,768,warlock,destruction,13,8,5
Metic,firetree,768,warlock,destruction,16,9,7
Threk,quelthalas,768,warlock,destruction,18,8,10
Iniboltquity,tichondrius,768,warlock,destruction,18,8,10
Westhofxx,sargeras,768,warlock,destruction,18,8,10
Kallym,azralon,768,warlock,destruction,18,8,10
Pardoned,stormrage,768,warlock,destruction,18,8,10
Demfearslol,terokkar,768,warlock,destruction,18,8,10
Gneçro,area-52,768,warlock,destruction,18,8,10
Rashiko,bleeding-hollow,768,warlock,destruction,18,8,10
Bbangtimo,tichondrius,768,warlock,destruction,18,8,10
Dethknell,stormrage,768,warlock,destruction,18,8,10
Lynnilock,area-52,767,warlock,destruction,12,8,4
Darthtequila,stormrage,767,warlock,destruction,12,8,4
Ebølarot,tichondrius,767,warlock,destruction,12,8,4
Cursedstales,stormrage,767,warlock,destruction,12,8,4
Coil,kiljaeden,767,warlock,destruction,12,8,4
Yonz,area-52,767,warlock,destruction,12,8,4
Doman,thorium-brotherhood,767,warlock,destruction,12,8,4
Reportmenerd,tichondrius,767,warlock,destruction,12,8,4
Shadowlifts,kelthuzad,767,warlock,destruction,12,8,4
Accentuate,tichondrius,767,warlock,destruction,12,8,4
Daracon,thrall,767,warlock,destruction,12,8,4
Toxec,barthilas,767,warlock,destruction,12,8,4
Misscháos,malganis,767,warlock,destruction,18,8,10
Hargol,azralon,767,warlock,destruction,18,8,10
Aldaill,moon-guard,767,warlock,destruction,18,8,10
Shikyo,lightnings-blade,767,warlock,destruction,18,8,10
Katsurägi,tichondrius,767,warlock,destruction,18,8,10
Webrar,frostmourne,767,warlock,destruction,18,8,10
Mêdìvh,tichondrius,767,warlock,destruction,18,8,10
Oxylock,magtheridon,767,warlock,destruction,18,8,10
Plutö,thrall,767,warlock,destruction,18,8,10
Carcine,frostwolf,767,warlock,destruction,18,8,10
Windwolff,dalvengyr,767,warlock,destruction,18,8,10
Síkaría,malganis,767,warlock,destruction,18,8,10
Feoona,hyjal,767,warlock,destruction,24,8,16
Necrófear,tichondrius,767,warlock,destruction,24,8,16
Faldoras,kalecgos,766,warlock,destruction,12,8,4
Devdolittle,tichondrius,766,warlock,destruction,12,8,4
Doomers,frostmourne,766,warlock,destruction,12,8,4
Enur,malganis,766,warlock,destruction,12,8,4
Pocserlock,drakkari,766,warlock,destruction,12,8,4
Dmgcrit,destromath,766,warlock,destruction,12,8,4
Assaulttron,wyrmrest-accord,766,warlock,destruction,12,8,4
Dinkydeen,area-52,766,warlock,destruction,12,8,4
Raglans,amanthul,766,warlock,destruction,12,8,4
Staudt,mugthol,766,warlock,destruction,12,8,4
Seniorshneef,emerald-dream,766,warlock,destruction,18,8,10
Mandley,nazgrel,766,warlock,destruction,18,8,10
Spiritofodin,grizzly-hills,765,warlock,destruction,12,8,4
Zezkin,alexstrasza,765,warlock,destruction,22,9,13
Lilitht,drakkari,764,warlock,destruction,18,8,10
Guinegobbler,hyjal,764,warlock,destruction,20,8,12
Esoo,kul-tiras,763,warlock,destruction,12,8,4
Caryn,dalaran,763,warlock,destruction,18,8,10
Infortunium,sargeras,762,warlock,destruction,12,8,4
Disrespex,kelthuzad,762,warlock,destruction,18,8,10
Djfear,tichondrius,762,warlock,destruction,18,8,10
Degynlock,wyrmrest-accord,762,warlock,destruction,24,8,16
Shooterg,tichondrius,761,warlock,destruction,18,8,10
Feladrae,wyrmrest-accord,761,warlock,destruction,30,8,22
Thugpenus,frostmane,760,warlock,destruction,18,8,10
Myshadow,gorefiend,758,warlock,destruction,24,8,16
Jonuts,korgath,752,warlock,destruction,19,8,11
Valintine,khadgar,749,warlock,destruction,15,9,6
Nobuyori,tichondrius,745,warlock,destruction,24,9,15
Chaoticman,tichondrius,733,warlock,destruction,17,8,9
Fellraiser,bleeding-hollow,720,warlock,destruction,15,8,7
Notoriusmma,illidan,720,warlock,destruction,19,10,9
Sotera,bleeding-hollow,719,warlock,destruction,11,8,3
Rentblod,azralon,719,warlock,destruction,11,8,3
Lökdown,dalaran,714,warlock,destruction,15,11,4
Ihaveapowers,maiev,703,warlock,destruction,11,8,3
Tinyjo,sargeras,703,warlock,destruction,11,8,3
Bäbz,barthilas,703,warlock,destruction,11,8,3
Demotional,wyrmrest-accord,703,warlock,destruction,14,8,6
Liljamie,stormrage,703,warlock,destruction,17,8,9
Screampied,sargeras,699,warlock,destruction,20,8,12
Getfeared,emerald-dream,672,warlock,destruction,10,8,2
Hellfires,ragnaros,672,warlock,destruction,12,7,5
Thinkchair,sargeras,672,warlock,destruction,12,7,5
Mokfernal,tichondrius,672,warlock,destruction,12,7,5
Glizzÿ,thrall,672,warlock,destruction,12,7,5
Warpstar,area-52,672,warlock,destruction,12,7,5
Rothslock,tichondrius,672,warlock,destruction,12,7,5
Flicks,arthas,672,warlock,destruction,12,7,5
Callofzevoid,tichondrius,672,warlock,destruction,12,7,5
Kountdrakula,tichondrius,672,warlock,destruction,12,7,5
Méphisto,emerald-dream,672,warlock,destruction,12,7,5
Luciusvrenus,tichondrius,672,warlock,destruction,12,7,5
Lessthanjake,zuljin,672,warlock,destruction,12,7,5
Ztc,dalaran,672,warlock,destruction,12,7,5
Alterity,kelthuzad,672,warlock,destruction,12,7,5
Tamzin,kelthuzad,672,warlock,destruction,12,7,5
Hdys,tichondrius,672,warlock,destruction,12,7,5
Dotlockndrop,stormreaver,672,warlock,destruction,12,7,5
Sasaology,frostmourne,672,warlock,destruction,12,7,5
Dplexs,jubeithos,672,warlock,destruction,12,7,5
Spicytaters,malganis,672,warlock,destruction,12,7,5
Pillock,bleeding-hollow,672,warlock,destruction,12,7,5
Tatordotzz,tichondrius,672,warlock,destruction,12,7,5
Afflackxl,sargeras,672,warlock,destruction,12,7,5
Spliffxl,stormrage,672,warlock,destruction,12,7,5
Stîgz,stormrage,672,warlock,destruction,12,7,5
Insànity,bleeding-hollow,672,warlock,destruction,12,7,5
Schlutty,malganis,672,warlock,destruction,12,7,5
Aegywn,gorgonnash,672,warlock,destruction,12,7,5
Ðòm,tichondrius,672,warlock,destruction,12,7,5
Zelophobiaz,crushridge,672,warlock,destruction,12,7,5
Snikpan,silver-hand,672,warlock,destruction,12,7,5
Dötkill,illidan,672,warlock,destruction,12,7,5
Iboltudie,tichondrius,672,warlock,destruction,12,7,5
Says,gorefiend,672,warlock,destruction,12,7,5
Blair,wildhammer,672,warlock,destruction,12,7,5
Clingrita,tichondrius,672,warlock,destruction,12,7,5
Sylvarri,stormrage,672,warlock,destruction,12,7,5
Felforyouu,illidan,672,warlock,destruction,12,7,5
Suminl,tichondrius,672,warlock,destruction,12,7,5
Westhofz,sargeras,672,warlock,destruction,12,7,5
Furryfears,gurubashi,672,warlock,destruction,12,7,5
Deebeel,sargeras,672,warlock,destruction,12,7,5
Yikës,stormrage,672,warlock,destruction,12,7,5
Lokintots,darkspear,672,warlock,destruction,12,7,5
Uggaboogga,malganis,672,warlock,destruction,12,7,5
Thewkama,tichondrius,672,warlock,destruction,12,7,5
Dipgodx,bleeding-hollow,672,warlock,destruction,12,7,5
Puvvo,tichondrius,672,warlock,destruction,12,7,5
Blayzen,elune,672,warlock,destruction,12,7,5
Bosswarlock,tichondrius,672,warlock,destruction,13,7,6
Ahp,stormrage,672,warlock,destruction,15,8,7
Anasúi,quelthalas,672,warlock,destruction,18,7,11
Modot,tichondrius,672,warlock,destruction,18,7,11
Zantology,frostmourne,672,warlock,destruction,18,7,11
Dmacxl,tichondrius,672,warlock,destruction,18,7,11
Sourmilkz,zuljin,672,warlock,destruction,18,7,11
Brough,illidan,672,warlock,destruction,24,7,17
Bhupzy,barthilas,671,warlock,destruction,12,7,5
Mérli,quelthalas,671,warlock,destruction,12,7,5
Dotznfearz,zuljin,671,warlock,destruction,12,7,5
Briside,malganis,671,warlock,destruction,12,7,5
Grimzo,mugthol,671,warlock,destruction,12,7,5
Boltondahoes,sargeras,671,warlock,destruction,12,7,5
Strawberryz,boulderfist,671,warlock,destruction,12,7,5
Saicinxd,darkspear,671,warlock,destruction,12,7,5
Aroris,silver-hand,671,warlock,destruction,12,7,5
Zyraxx,moon-guard,671,warlock,destruction,12,7,5
Demosthenes,nazjatar,671,warlock,destruction,12,7,5
Shadowpainn,the-underbog,671,warlock,destruction,12,7,5
Irunaways,stormrage,671,warlock,destruction,12,7,5
Leroybrown,alterac-mountains,671,warlock,destruction,12,7,5
Azâziel,ragnaros,671,warlock,destruction,12,7,5
Naba,malorne,671,warlock,destruction,12,7,5
Hadit,malganis,671,warlock,destruction,15,8,7
Soulinite,fizzcrank,671,warlock,destruction,18,7,11
Jvilla,tichondrius,671,warlock,destruction,18,7,11
Vorituuray,moon-guard,671,warlock,destruction,18,7,11
Kachauwoo,kiljaeden,671,warlock,destruction,18,7,11
Vetislock,thrall,671,warlock,destruction,18,7,11
Yury,scarlet-crusade,671,warlock,destruction,18,7,11
Jhivtwo,tichondrius,671,warlock,destruction,18,7,11
Wollylock,dark-iron,671,warlock,destruction,18,7,11
Fearlord,shattered-hand,671,warlock,destruction,24,7,17
Doomtome,moon-guard,671,warlock,destruction,26,7,19
Amilkman,area-52,670,warlock,destruction,12,7,5
Noteko,korgath,670,warlock,destruction,12,7,5
Tørturë,tichondrius,670,warlock,destruction,12,7,5
Cazadorius,jubeithos,670,warlock,destruction,13,7,6
Heartpvp,tichondrius,670,warlock,destruction,18,7,11
Kristenßell,senjin,669,warlock,destruction,12,7,5
Otus,echo-isles,669,warlock,destruction,12,7,5
Revenancer,smolderthorn,669,warlock,destruction,12,7,5
Sumonníng,tichondrius,669,warlock,destruction,18,7,11
Sneakywarlok,dalaran,668,warlock,destruction,19,7,12
Deathjerky,thrall,667,warlock,destruction,12,7,5
Klapincheeks,malganis,659,warlock,destruction,44,10,34
Saltboi,azjolnerub,640,warlock,destruction,16,7,9
Voidxx,tichondrius,639,warlock,destruction,11,7,4
Greenwarlock,bleeding-hollow,639,warlock,destruction,14,8,6
Shendotigans,illidan,639,warlock,destruction,17,7,10
Demondan,magtheridon,638,warlock,destruction,23,7,16
Hobblefoòt,proudmoore,623,warlock,destruction,11,7,4
Seregå,skywall,623,warlock,destruction,11,7,4
Cassetes,tichondrius,622,warlock,destruction,11,7,4
Lazzarros,area-52,618,warlock,destruction,22,8,14
Pontoontim,mugthol,617,warlock,destruction,20,8,12
Fancynuts,kiljaeden,607,warlock,destruction,11,7,4
Perfsx,bleeding-hollow,607,warlock,destruction,14,7,7
Furrlokc,tichondrius,607,warlock,destruction,16,7,9
Surleshilla,malganis,592,warlock,destruction,13,7,6
Studathlete,tichondrius,592,warlock,destruction,13,7,6
Pandemik,turalyon,591,warlock,destruction,11,8,3
Freyanna,moon-guard,588,warlock,destruction,19,7,12
Baconmuffin,tichondrius,576,warlock,destruction,6,6,0
Winipuhmalo,quelthalas,576,warlock,destruction,6,6,0
Kòngal,tichondrius,576,warlock,destruction,6,6,0
Mitchosx,frostmourne,576,warlock,destruction,6,6,0
Gabbagoul,sargeras,576,warlock,destruction,6,6,0
Redsolojdc,tichondrius,576,warlock,destruction,6,6,0
Bronzel,tichondrius,576,warlock,destruction,6,6,0
Hypexis,area-52,576,warlock,destruction,6,6,0
Bakko,tichondrius,576,warlock,destruction,6,6,0
Drainerx,kelthuzad,576,warlock,destruction,6,6,0
Xhrine,frostmourne,576,warlock,destruction,6,6,0
Menggoth,tichondrius,576,warlock,destruction,6,6,0
Malevolent,velen,576,warlock,destruction,6,6,0
Joromojo,zuljin,576,warlock,destruction,6,6,0
Notstingz,azralon,576,warlock,destruction,6,6,0
Schrader,sargeras,576,warlock,destruction,6,6,0
Pndasrntlegt,burning-blade,576,warlock,destruction,6,6,0
Impbisqit,stormrage,576,warlock,destruction,6,6,0
Broovid,tichondrius,576,warlock,destruction,13,7,6
Imbadatpvp,tichondrius,576,warlock,destruction,12,6,6
Maèlstrom,area-52,576,warlock,destruction,12,6,6
Insanemids,tichondrius,576,warlock,destruction,12,6,6
Poxnhub,tichondrius,576,warlock,destruction,12,6,6
Truepain,tichondrius,576,warlock,destruction,12,6,6
Chabolt,tichondrius,576,warlock,destruction,12,6,6
Ronnietherat,tichondrius,576,warlock,destruction,12,6,6
Tinked,stormrage,576,warlock,destruction,12,6,6
Quadrillion,stormrage,576,warlock,destruction,12,6,6
Shigero,tichondrius,576,warlock,destruction,12,6,6
Badmir,area-52,576,warlock,destruction,12,6,6
Manethail,aegwynn,576,warlock,destruction,12,6,6
Sauzith,area-52,576,warlock,destruction,12,6,6
Betrili,tichondrius,576,warlock,destruction,12,6,6
Árkadiano,drakkari,576,warlock,destruction,12,6,6
Kmüz,drakkari,576,warlock,destruction,12,6,6
Kulgar,aerie-peak,576,warlock,destruction,12,6,6
Massivebolts,area-52,576,warlock,destruction,12,6,6
Girthlock,tichondrius,576,warlock,destruction,12,6,6
Donutd,stormrage,576,warlock,destruction,12,6,6
Justignoreme,tichondrius,576,warlock,destruction,12,6,6
Itsmeagain,area-52,576,warlock,destruction,12,6,6
Manalis,zuljin,576,warlock,destruction,12,6,6
Andrewpg,zuljin,576,warlock,destruction,12,6,6
Lucíela,ragnaros,576,warlock,destruction,12,6,6
Akolite,tichondrius,576,warlock,destruction,12,6,6
Eboknight,area-52,576,warlock,destruction,12,6,6
Aikus,quelthalas,576,warlock,destruction,12,6,6
Jessewheels,tichondrius,576,warlock,destruction,12,6,6
Metafin,quelthalas,576,warlock,destruction,12,6,6
Kreemy,ysera,576,warlock,destruction,12,6,6
Salentsia,malganis,576,warlock,destruction,12,6,6
Lambe,tichondrius,576,warlock,destruction,12,6,6
Peeberson,tichondrius,576,warlock,destruction,12,6,6
Souldrain,malganis,576,warlock,destruction,12,6,6
Graingrippin,malganis,576,warlock,destruction,12,6,6
Coffeezx,malganis,576,warlock,destruction,12,6,6
Geegas,malganis,576,warlock,destruction,12,6,6
Bowltz,chogall,576,warlock,destruction,12,6,6
Ðáyshéll,kelthuzad,576,warlock,destruction,12,6,6
Vravras,kelthuzad,576,warlock,destruction,12,6,6
Ïmpdance,tichondrius,576,warlock,destruction,12,6,6
Liability,zuljin,576,warlock,destruction,12,6,6
Gagitha,black-dragonflight,576,warlock,destruction,12,6,6
Tjdotter,stormrage,576,warlock,destruction,12,6,6
Bhris,wildhammer,576,warlock,destruction,12,6,6
Bolèyn,moon-guard,576,warlock,destruction,12,6,6
Hiro,steamwheedle-cartel,576,warlock,destruction,12,6,6
Beamin,dentarg,576,warlock,destruction,12,6,6
Tlock,azjolnerub,576,warlock,destruction,12,6,6
Crimsonela,emerald-dream,576,warlock,destruction,12,6,6
Baconmarty,emerald-dream,576,warlock,destruction,12,6,6
Tonifortnite,emerald-dream,576,warlock,destruction,12,6,6
Tomato,azjolnerub,576,warlock,destruction,12,6,6
Riskydemon,azralon,576,warlock,destruction,12,6,6
Trixtah,illidan,576,warlock,destruction,12,6,6
Footyl,stormrage,576,warlock,destruction,12,6,6
Flu,darkspear,576,warlock,destruction,12,6,6
Zeromech,sargeras,576,warlock,destruction,12,6,6
Asamsbinladn,illidan,576,warlock,destruction,12,6,6
Iemonv,vashj,576,warlock,destruction,12,6,6
Draxxus,barthilas,576,warlock,destruction,12,6,6
Emptysoul,illidan,576,warlock,destruction,12,6,6
Lokkup,dalaran,576,warlock,destruction,12,6,6
Sumrule,dreadmaul,576,warlock,destruction,12,6,6
Limeriax,emerald-dream,576,warlock,destruction,12,6,6
Mangdaemon,silvermoon,576,warlock,destruction,12,6,6
Beerbolt,dalaran,576,warlock,destruction,12,6,6
Zedonius,dragonmaw,576,warlock,destruction,12,6,6
Taye,barthilas,576,warlock,destruction,12,6,6
Charmandfarm,nerzhul,576,warlock,destruction,12,6,6
Ritua,dragonmaw,576,warlock,destruction,12,6,6
Zephidel,thrall,576,warlock,destruction,12,6,6
Marinw,azralon,576,warlock,destruction,16,7,9
Indrah,tichondrius,576,warlock,destruction,14,6,8
Esoteríc,sargeras,576,warlock,destruction,18,6,12
Jinxdacat,shandris,576,warlock,destruction,18,6,12
Cigárillo,thrall,576,warlock,destruction,18,6,12
Bêlthazor,kelthuzad,576,warlock,destruction,18,6,12
Lenestus,stormrage,576,warlock,destruction,18,6,12
Tenletters,kirin-tor,576,warlock,destruction,18,6,12
Wzrdtrx,deathwing,576,warlock,destruction,18,6,12
Lamdyn,moon-guard,576,warlock,destruction,18,6,12
Familjia,nagrand,576,warlock,destruction,18,6,12
Plutheros,stormrage,576,warlock,destruction,18,6,12
Klisman,azralon,576,warlock,destruction,18,6,12
Xdta,frostmourne,576,warlock,destruction,18,6,12
Tharax,moon-guard,576,warlock,destruction,18,6,12
Spamfearftw,sargeras,575,warlock,destruction,6,6,0
Dipndøtz,illidan,575,warlock,destruction,6,6,0
Shadowy,dragonblight,575,warlock,destruction,12,6,6
Edielyth,proudmoore,575,warlock,destruction,12,6,6
Baphomët,tichondrius,575,warlock,destruction,12,6,6
Azracore,illidan,575,warlock,destruction,12,6,6
Cutewarlock,draktharon,575,warlock,destruction,12,6,6
Méhoe,bleeding-hollow,575,warlock,destruction,12,6,6
Daimon,kaelthas,575,warlock,destruction,12,6,6
Beelzibub,firetree,575,warlock,destruction,12,6,6
Naparima,stormreaver,575,warlock,destruction,12,6,6
Ifeludead,sargeras,575,warlock,destruction,12,6,6
Filthypumper,proudmoore,575,warlock,destruction,12,6,6
Rathianna,sargeras,575,warlock,destruction,12,6,6
Pactman,sargeras,575,warlock,destruction,12,6,6
Crankshaft,nordrassil,575,warlock,destruction,12,6,6
Lockswagger,stormrage,575,warlock,destruction,12,6,6
Oluluo,andorhal,575,warlock,destruction,18,6,12
Helpimdýing,sargeras,575,warlock,destruction,18,6,12
Leno,twisting-nether,575,warlock,destruction,18,6,12
Yetiaids,tichondrius,575,warlock,destruction,18,6,12
Pachips,zuljin,575,warlock,destruction,18,6,12
Xmochahollic,tichondrius,575,warlock,destruction,23,6,17
Ëliphas,tichondrius,575,warlock,destruction,24,6,18
Trayga,illidan,574,warlock,destruction,6,6,0
Persephoné,blackrock,574,warlock,destruction,12,6,6
Tesdeez,tichondrius,574,warlock,destruction,12,6,6
Totti,tol-barad,574,warlock,destruction,12,6,6
Ggumx,tichondrius,574,warlock,destruction,12,6,6
Hungovermate,barthilas,574,warlock,destruction,12,6,6
Träzyn,kiljaeden,574,warlock,destruction,18,6,12
Trïnîty,tichondrius,574,warlock,destruction,18,6,12
Zahba,stormrage,572,warlock,destruction,12,6,6
Supercracker,bleeding-hollow,572,warlock,destruction,18,6,12
Fidobiu,stormrage,571,warlock,destruction,12,6,6
Rôver,crushridge,568,warlock,destruction,12,6,6
Ledrlpxlx,bleeding-hollow,563,warlock,destruction,24,10,14
Expiredonion,bleeding-hollow,559,warlock,destruction,11,6,5
Friend,frostmourne,559,warlock,destruction,17,6,11
Drdotngo,tichondrius,543,warlock,destruction,8,7,1
Promancer,drakkari,528,warlock,destruction,9,6,3
Loch,destromath,527,warlock,destruction,11,6,5
Shardgodx,barthilas,527,warlock,destruction,11,6,5
Exillis,barthilas,527,warlock,destruction,17,6,11
Tesowenn,tichondrius,522,warlock,destruction,15,7,8
Locdup,sargeras,512,warlock,destruction,22,6,16
Cs,icecrown,511,warlock,destruction,9,7,2
Ðêcimatê,frostmourne,511,warlock,destruction,12,6,6
Glifosáto,quelthalas,510,warlock,destruction,10,8,2
Dixynormis,zuljin,510,warlock,destruction,11,6,5
Ràistlin,madoran,494,warlock,destruction,11,6,5
Babyvet,stormreaver,480,warlock,destruction,6,5,1
Ozric,quelthalas,480,warlock,destruction,6,5,1
Khaozx,ragnaros,480,warlock,destruction,6,5,1
Phyxylock,stormrage,480,warlock,destruction,6,5,1
Cytosine,medivh,480,warlock,destruction,6,5,1
Novah,balnazzar,480,warlock,destruction,6,5,1
Cloperry,area-52,480,warlock,destruction,6,5,1
Fapchat,silvermoon,480,warlock,destruction,6,5,1
Halftism,sargeras,480,warlock,destruction,6,5,1
Jalean,illidan,480,warlock,destruction,6,5,1
Kargos,bonechewer,480,warlock,destruction,6,5,1
Michae,tichondrius,480,warlock,destruction,6,5,1
Warwand,tichondrius,480,warlock,destruction,6,5,1
Onidium,area-52,480,warlock,destruction,6,5,1
Poonanifotm,gundrak,480,warlock,destruction,6,5,1
Halfmade,tichondrius,480,warlock,destruction,6,5,1
Destructium,stormrage,480,warlock,destruction,6,5,1
Elprup,tichondrius,480,warlock,destruction,6,5,1
Unicornspit,tichondrius,480,warlock,destruction,6,5,1
Zoljinn,frostwolf,480,warlock,destruction,6,5,1
Cozu,tichondrius,480,warlock,destruction,6,5,1
Ohthemisery,sargeras,480,warlock,destruction,6,5,1
Drossx,illidan,480,warlock,destruction,6,5,1
Meddsurgx,emerald-dream,480,warlock,destruction,6,5,1
Zerocastspec,tichondrius,480,warlock,destruction,6,5,1
Buypork,tichondrius,480,warlock,destruction,6,5,1
Evierine,zuljin,480,warlock,destruction,6,5,1
Pantubølt,stormrage,480,warlock,destruction,6,5,1
Stíngz,nemesis,480,warlock,destruction,6,5,1
Ikite,zuljin,480,warlock,destruction,6,5,1
Theovohn,thrall,480,warlock,destruction,6,5,1
Dippindotz,scilla,480,warlock,destruction,6,5,1
Malékíth,ragnaros,480,warlock,destruction,6,5,1
Mørøs,tichondrius,480,warlock,destruction,6,5,1
Balencinaga,frostmourne,480,warlock,destruction,6,5,1
Bâppo,antonidas,480,warlock,destruction,6,5,1
Púp,bleeding-hollow,480,warlock,destruction,6,5,1
Virûs,vashj,480,warlock,destruction,6,5,1
Goldielocks,eredar,480,warlock,destruction,6,5,1
Humblegodd,illidan,480,warlock,destruction,6,5,1
Leîa,tichondrius,480,warlock,destruction,6,5,1
Adonegege,tichondrius,480,warlock,destruction,6,5,1
Cheesëbolt,illidan,480,warlock,destruction,6,5,1
Chewybolt,illidan,480,warlock,destruction,6,5,1
Popnloc,tichondrius,480,warlock,destruction,6,5,1
Gritzixx,frostmourne,480,warlock,destruction,6,5,1
Foxbolt,tichondrius,480,warlock,destruction,6,5,1
Efuc,tichondrius,480,warlock,destruction,6,5,1
Pikolock,bleeding-hollow,480,warlock,destruction,6,5,1
Beranflakes,darkspear,480,warlock,destruction,6,5,1
Awdam,tichondrius,480,warlock,destruction,6,5,1
Yuckytoetoe,emerald-dream,480,warlock,destruction,6,5,1
Karmalock,malganis,480,warlock,destruction,6,5,1
Oreganow,icecrown,480,warlock,destruction,6,5,1
Arnan,korgath,480,warlock,destruction,6,5,1
Blorgaflob,thaurissan,480,warlock,destruction,7,5,2
Corruptblxck,tichondrius,480,warlock,destruction,9,6,3
Avoidahoe,sargeras,480,warlock,destruction,12,5,7
Zrok,bleeding-hollow,480,warlock,destruction,12,5,7
Thirsts,tichondrius,480,warlock,destruction,12,5,7
Souljäboy,bleeding-hollow,480,warlock,destruction,12,5,7
Gallynna,moon-guard,480,warlock,destruction,12,5,7
Bellgrande,shadowmoon,480,warlock,destruction,12,5,7
Macnab,malganis,480,warlock,destruction,12,5,7
Lockandload,malfurion,480,warlock,destruction,12,5,7
Marbuldan,frostmourne,480,warlock,destruction,12,5,7
Coviddotsrot,sargeras,480,warlock,destruction,12,5,7
Jankity,kelthuzad,480,warlock,destruction,12,5,7
Darezs,frostmourne,480,warlock,destruction,12,5,7
Yurick,frostmourne,480,warlock,destruction,12,5,7
Fearedit,bleeding-hollow,480,warlock,destruction,12,5,7
Totsdots,blackrock,480,warlock,destruction,12,5,7
Lockwell,tichondrius,480,warlock,destruction,12,5,7
Archleon,smolderthorn,480,warlock,destruction,12,5,7
Pveisboring,tichondrius,480,warlock,destruction,12,5,7
Justganmore,tichondrius,480,warlock,destruction,12,5,7
Seraphserius,laughing-skull,480,warlock,destruction,12,5,7
Lildottythot,malganis,480,warlock,destruction,12,5,7
Daemonixx,vashj,480,warlock,destruction,12,5,7
Pabloqlx,ragnaros,480,warlock,destruction,12,5,7
Ascendant,amanthul,480,warlock,destruction,12,5,7
Arkangel,dalvengyr,480,warlock,destruction,12,5,7
Imhereforrbg,moon-guard,480,warlock,destruction,12,5,7
Wombogombo,malganis,480,warlock,destruction,12,5,7
Marshyxd,tichondrius,480,warlock,destruction,12,5,7
Enmama,malganis,480,warlock,destruction,12,5,7
Locknes,kiljaeden,480,warlock,destruction,12,5,7
Excusey,tichondrius,480,warlock,destruction,12,5,7
Chaoz,aggramar,480,warlock,destruction,12,5,7
Oppaijuggler,tichondrius,480,warlock,destruction,12,5,7
Richards,thrall,480,warlock,destruction,12,5,7
Wediditjoe,kelthuzad,480,warlock,destruction,12,5,7
Zugzor,shadowmoon,480,warlock,destruction,12,5,7
Sylvine,korgath,480,warlock,destruction,12,5,7
Yungwilly,silvermoon,480,warlock,destruction,12,5,7
Hyjixy,stormrage,480,warlock,destruction,12,5,7
Topboypepito,tichondrius,480,warlock,destruction,12,5,7
Errogant,area-52,480,warlock,destruction,12,5,7
Pikvas,darkspear,480,warlock,destruction,12,5,7
Valrena,rivendare,480,warlock,destruction,12,5,7
Balden,fenris,480,warlock,destruction,12,5,7
Gameface,garrosh,480,warlock,destruction,12,5,7
Shadowflame,skullcrusher,480,warlock,destruction,12,5,7
Ensanaty,dalaran,480,warlock,destruction,12,5,7
Mitryc,illidan,480,warlock,destruction,12,5,7
Rytaint,emerald-dream,480,warlock,destruction,12,5,7
Rainali,tichondrius,480,warlock,destruction,12,5,7
Kubera,mannoroth,480,warlock,destruction,12,5,7
Zalurk,emerald-dream,480,warlock,destruction,12,5,7
Gnimms,sargeras,480,warlock,destruction,12,5,7
Sukmalock,proudmoore,480,warlock,destruction,15,6,9
Caplock,barthilas,480,warlock,destruction,18,5,13
Corezach,proudmoore,480,warlock,destruction,18,5,13
Kazam,quelthalas,479,warlock,destruction,6,5,1
Yelabanxtown,thaurissan,479,warlock,destruction,6,5,1
Skrillhex,dragonmaw,479,warlock,destruction,6,5,1
Dogetrash,tichondrius,479,warlock,destruction,11,8,3
Esmaldo,tichondrius,479,warlock,destruction,12,5,7
Dotess,illidan,479,warlock,destruction,12,5,7
Vordz,amanthul,479,warlock,destruction,12,5,7
Kelici,borean-tundra,479,warlock,destruction,12,5,7
Grix,uldaman,479,warlock,destruction,12,5,7
Aliceðupree,darkspear,479,warlock,destruction,12,5,7
Loccdawg,laughing-skull,479,warlock,destruction,12,5,7
Osteogenesis,quelthalas,479,warlock,destruction,12,5,7
Fazzlock,nagrand,479,warlock,destruction,16,6,10
Karkloc,stormrage,479,warlock,destruction,18,5,13
Daemonddred,hakkar,479,warlock,destruction,18,5,13
Giled,runetotem,478,warlock,destruction,12,5,7
Saintvil,drakkari,477,warlock,destruction,6,5,1
Warrogoblin,ragnaros,476,warlock,destruction,9,6,3
Casusita,area-52,472,warlock,destruction,12,5,7
Raven,baelgun,463,warlock,destruction,11,5,6
Viejitaa,quelthalas,447,warlock,destruction,10,6,4
Døtbomb,stormrage,447,warlock,destruction,11,5,6
Magniwl,zuljin,447,warlock,destruction,11,5,6
Britnyfears,korgath,447,warlock,destruction,16,5,11
Djvetis,blackhand,442,warlock,destruction,15,7,8
Heizx,area-52,432,warlock,destruction,15,5,10
Mcscrotie,tichondrius,431,warlock,destruction,11,5,6
Brútek,moon-guard,431,warlock,destruction,11,5,6
Stainn,gallywix,430,warlock,destruction,9,5,4
Empowerdlock,garrosh,416,warlock,destruction,10,5,5
Velsona,moon-guard,415,warlock,destruction,14,5,9
Krozu,bleeding-hollow,415,warlock,destruction,14,5,9
Pescador,tichondrius,400,warlock,destruction,7,5,2
Brokenaf,stormrage,384,warlock,destruction,6,4,2
Fearoshimá,thrall,384,warlock,destruction,6,4,2
Slappndemons,mugthol,384,warlock,destruction,6,4,2
Naginikill,zuljin,384,warlock,destruction,6,4,2
Necroferal,whisperwind,384,warlock,destruction,6,4,2
Lockiana,zuljin,384,warlock,destruction,6,4,2
Rickthelock,tichondrius,384,warlock,destruction,6,4,2
Mmrceo,azgalor,384,warlock,destruction,6,4,2
Xevari,zuljin,384,warlock,destruction,6,4,2
Bedtimes,tichondrius,384,warlock,destruction,6,4,2
Smallj,zuljin,384,warlock,destruction,6,4,2
Underchicken,blackrock,384,warlock,destruction,6,4,2
Asalaviik,illidan,384,warlock,destruction,6,4,2
Vilebrute,illidan,384,warlock,destruction,6,4,2
Pegorn,illidan,384,warlock,destruction,6,4,2
Fatherbolt,tichondrius,384,warlock,destruction,6,4,2
Damienn,wyrmrest-accord,384,warlock,destruction,6,4,2
Drgiggles,tichondrius,384,warlock,destruction,6,4,2
Toomanymind,stormrage,384,warlock,destruction,6,4,2
Moramont,stormrage,384,warlock,destruction,6,4,2
Saruon,proudmoore,384,warlock,destruction,6,4,2
Sheetzlock,azgalor,384,warlock,destruction,6,4,2
Maquedonia,quelthalas,384,warlock,destruction,6,4,2
Sprenn,bleeding-hollow,384,warlock,destruction,6,4,2
Yëët,wildhammer,384,warlock,destruction,6,4,2
Calcadius,zuljin,384,warlock,destruction,6,4,2
Ñever,winterhoof,384,warlock,destruction,6,4,2
Siltharious,senjin,384,warlock,destruction,6,4,2
Erock,korgath,384,warlock,destruction,6,4,2
Biger,nemesis,384,warlock,destruction,6,4,2
Eatmybeef,ravencrest,384,warlock,destruction,6,4,2
Eazyw,stormrage,384,warlock,destruction,6,4,2
Xijp,illidan,384,warlock,destruction,6,4,2
Asiopdu,tichondrius,384,warlock,destruction,6,4,2
Quetzâlcoâtl,sargeras,384,warlock,destruction,6,4,2
Arredivh,blackhand,384,warlock,destruction,6,4,2
Wallzz,stormrage,384,warlock,destruction,6,4,2
Carielict,sargeras,384,warlock,destruction,6,4,2
Souwantwar,kiljaeden,384,warlock,destruction,6,4,2
Ruination,cenarius,384,warlock,destruction,6,4,2
Laytome,stormreaver,384,warlock,destruction,6,4,2
Antagony,bleeding-hollow,384,warlock,destruction,6,4,2
Pendïng,area-52,384,warlock,destruction,6,4,2
Lîlý,bleeding-hollow,384,warlock,destruction,6,4,2
Hawtchili,illidan,384,warlock,destruction,6,4,2
Slurper,frostwolf,384,warlock,destruction,6,4,2
Alwysoom,aegwynn,384,warlock,destruction,6,4,2
Jerothia,lethon,384,warlock,destruction,6,4,2
Jxstinl,tichondrius,384,warlock,destruction,6,4,2
Zerfall,area-52,384,warlock,destruction,6,4,2
Dealindoug,bonechewer,384,warlock,destruction,6,4,2
Outkãst,illidan,384,warlock,destruction,6,4,2
Lunazz,tichondrius,384,warlock,destruction,6,4,2
Galtur,azralon,384,warlock,destruction,6,4,2
Chumbing,sargeras,384,warlock,destruction,6,4,2
Khaos,norgannon,384,warlock,destruction,6,4,2
Dottcom,laughing-skull,384,warlock,destruction,6,4,2
Thelynx,chogall,384,warlock,destruction,6,4,2
Woofbolt,malganis,384,warlock,destruction,6,4,2
Norastrum,area-52,384,warlock,destruction,6,4,2
Gordoxin,area-52,384,warlock,destruction,6,4,2
Zonss,tichondrius,384,warlock,destruction,6,4,2
Rodneyjones,emerald-dream,384,warlock,destruction,6,4,2
Wiredftwx,illidan,384,warlock,destruction,6,4,2
Drakatat,tichondrius,384,warlock,destruction,6,4,2
Cursebolt,tichondrius,384,warlock,destruction,6,4,2
Panicmode,darkspear,384,warlock,destruction,6,4,2
Dettocs,emerald-dream,384,warlock,destruction,6,4,2
Smnslock,emerald-dream,384,warlock,destruction,6,4,2
Anthaxel,dalaran,384,warlock,destruction,6,4,2
Necrotko,malganis,384,warlock,destruction,6,4,2
Stambye,ragnaros,384,warlock,destruction,6,4,2
Extreme,blackwing-lair,384,warlock,destruction,6,4,2
Deathtones,moon-guard,384,warlock,destruction,6,4,2
Wreckquiem,burning-blade,384,warlock,destruction,6,4,2
Moonsoaps,moon-guard,384,warlock,destruction,6,4,2
Espanol,magtheridon,384,warlock,destruction,6,4,2
Alliciia,area-52,384,warlock,destruction,6,4,2
Magvezx,kelthuzad,384,warlock,destruction,6,4,2
Qfear,tichondrius,384,warlock,destruction,6,4,2
Dottzie,malganis,384,warlock,destruction,6,4,2
Warfeen,malganis,384,warlock,destruction,6,4,2
Zzat,area-52,384,warlock,destruction,6,4,2
Menedemus,amanthul,384,warlock,destruction,6,4,2
Kroshuto,ragnaros,384,warlock,destruction,6,4,2
Ozidus,tichondrius,384,warlock,destruction,6,4,2
Geists,emerald-dream,384,warlock,destruction,6,4,2
Kidneystone,emerald-dream,384,warlock,destruction,6,4,2
Marrowsipper,tichondrius,384,warlock,destruction,6,4,2
Botoslap,dragonmaw,384,warlock,destruction,6,4,2
Crackhammer,sargeras,384,warlock,destruction,6,4,2
Wømanizer,azralon,384,warlock,destruction,6,4,2
Décalisse,eonar,384,warlock,destruction,6,4,2
Vicnutz,tichondrius,384,warlock,destruction,6,4,2
Zhing,frostmourne,384,warlock,destruction,6,4,2
Kractdlk,tichondrius,384,warlock,destruction,6,4,2
Mithlock,azralon,384,warlock,destruction,6,4,2
Cowboydann,malganis,384,warlock,destruction,6,4,2
Superspreadr,silvermoon,384,warlock,destruction,6,4,2
Tichondrus,ragnaros,384,warlock,destruction,6,4,2
Rendori,the-scryers,384,warlock,destruction,6,4,2
Iamfear,shuhalo,384,warlock,destruction,6,4,2
Demonchurch,area-52,384,warlock,destruction,6,4,2
Doubledigit,tichondrius,384,warlock,destruction,6,4,2
Elcidoo,tichondrius,384,warlock,destruction,6,4,2
Adøràßøltz,tichondrius,384,warlock,destruction,6,4,2
Litemeatlary,kelthuzad,384,warlock,destruction,6,4,2
Cønsfèáracy,sargeras,384,warlock,destruction,6,4,2
Bugbugg,tichondrius,384,warlock,destruction,6,4,2
Donttouchme,azralon,384,warlock,destruction,6,4,2
Roota,dalaran,384,warlock,destruction,6,4,2
Synisterlock,moon-guard,384,warlock,destruction,6,4,2
Ardamelech,quelthalas,384,warlock,destruction,6,4,2
Solöw,tichondrius,384,warlock,destruction,6,4,2
Zver,drakkari,384,warlock,destruction,6,4,2
Syraxi,illidan,384,warlock,destruction,6,4,2
Fearann,ragnaros,384,warlock,destruction,6,4,2
Rhelialock,icecrown,384,warlock,destruction,6,4,2
Moistpoodle,the-underbog,384,warlock,destruction,6,4,2
Methrocks,emerald-dream,384,warlock,destruction,6,4,2
Frem,eonar,384,warlock,destruction,6,4,2
Kerrigan,the-venture-co,384,warlock,destruction,6,4,2
Agla,quelthalas,384,warlock,destruction,6,4,2
Tizzy,malganis,384,warlock,destruction,6,4,2
Meathat,gorefiend,384,warlock,destruction,9,5,4
Deathboltx,zuljin,384,warlock,destruction,9,5,4
Chrönic,azralon,384,warlock,destruction,9,5,4
Soulfired,kiljaeden,384,warlock,destruction,11,5,6
Sumondeznuts,wyrmrest-accord,384,warlock,destruction,15,5,10
Fullmelt,azjolnerub,384,warlock,destruction,12,4,8
Antigotenent,sargeras,384,warlock,destruction,12,4,8
Perfidien,tichondrius,384,warlock,destruction,12,4,8
Persianloc,tichondrius,384,warlock,destruction,12,4,8
Alexmeister,jubeithos,384,warlock,destruction,12,4,8
Blumercricet,stormrage,384,warlock,destruction,12,4,8
Rumpology,illidan,384,warlock,destruction,12,4,8
Mostlyundead,darkspear,384,warlock,destruction,12,4,8
Ionithvia,tichondrius,384,warlock,destruction,12,4,8
Poisondeepnu,malganis,384,warlock,destruction,12,4,8
Kelthutard,area-52,384,warlock,destruction,12,4,8
Pitou,akama,384,warlock,destruction,12,4,8
Offendor,stormrage,384,warlock,destruction,12,4,8
Regent,nemesis,384,warlock,destruction,12,4,8
Sailuhh,frostwolf,384,warlock,destruction,12,4,8
Melodyh,laughing-skull,384,warlock,destruction,12,4,8
Syileria,frostmourne,384,warlock,destruction,12,4,8
Freezâ,stormrage,384,warlock,destruction,12,4,8
Dotsamoray,frostmourne,384,warlock,destruction,12,4,8
Jerclard,proudmoore,384,warlock,destruction,12,4,8
Darksòúl,stormrage,384,warlock,destruction,12,4,8
Letsfckingo,tichondrius,384,warlock,destruction,12,4,8
Fowll,frostwolf,384,warlock,destruction,12,4,8
Kholdstarev,thunderlord,384,warlock,destruction,12,4,8
Dotington,frostmourne,384,warlock,destruction,12,4,8
Nazrakin,malganis,384,warlock,destruction,12,4,8
Praemonium,dalaran,384,warlock,destruction,12,4,8
Mokushiroku,trollbane,384,warlock,destruction,12,4,8
Catastrophk,malganis,384,warlock,destruction,12,4,8
Stepmommie,moon-guard,384,warlock,destruction,12,4,8
Hateslocks,bladefist,384,warlock,destruction,12,4,8
Capslockfury,frostmourne,384,warlock,destruction,12,4,8
Daedayus,frostwolf,384,warlock,destruction,12,4,8
Giggideez,bleeding-hollow,384,warlock,destruction,12,4,8
Capïrota,nemesis,384,warlock,destruction,12,4,8
Spacedots,illidan,384,warlock,destruction,12,4,8
Tarth,sargeras,384,warlock,destruction,12,4,8
Overlard,illidan,384,warlock,destruction,12,4,8
Dotsandchill,dalaran,384,warlock,destruction,12,4,8
Flocka,agamaggan,384,warlock,destruction,12,4,8
Destructing,hyjal,384,warlock,destruction,12,4,8
Evarona,gorefiend,384,warlock,destruction,12,4,8
Veyra,malganis,384,warlock,destruction,12,4,8
Pãni,area-52,384,warlock,destruction,12,4,8
Skrublockz,area-52,384,warlock,destruction,12,4,8
Awangdemon,tichondrius,384,warlock,destruction,12,4,8
Jáws,zuljin,384,warlock,destruction,12,4,8
Puddulz,thrall,384,warlock,destruction,12,4,8
Medraut,wyrmrest-accord,384,warlock,destruction,12,4,8
Aededa,proudmoore,384,warlock,destruction,12,4,8
Mozbet,kiljaeden,384,warlock,destruction,13,4,9
Pvman,onyxia,384,warlock,destruction,18,4,14
Gorski,frostwolf,383,warlock,destruction,6,4,2
Destroyaz,stormreaver,383,warlock,destruction,6,4,2
Thulium,dawnbringer,383,warlock,destruction,6,4,2
Halkroz,nathrezim,383,warlock,destruction,6,4,2
Stonelocker,stormrage,383,warlock,destruction,6,4,2
Anahaldever,fenris,383,warlock,destruction,6,4,2
Fearanddots,moon-guard,383,warlock,destruction,12,4,8
Asheräh,stormrage,383,warlock,destruction,12,4,8
Loçkshow,hyjal,383,warlock,destruction,12,4,8
Coheatt,hyjal,383,warlock,destruction,12,4,8
Xargeras,emerald-dream,383,warlock,destruction,12,4,8
Downing,drakkari,383,warlock,destruction,12,4,8
Yesmistress,thrall,383,warlock,destruction,14,4,10
Necromaniac,nerzhul,383,warlock,destruction,18,4,14
Kurmenos,uldum,382,warlock,destruction,6,4,2
Mageline,thrall,382,warlock,destruction,18,4,14
Fartonomus,illidan,381,warlock,destruction,12,4,8
Vanvídd,ragnaros,351,warlock,destruction,11,4,7
Cyrillus,moon-guard,351,warlock,destruction,11,4,7
Gobbledeez,moknathal,349,warlock,destruction,19,5,14
Gyxx,exodar,336,warlock,destruction,9,4,5
Tangslock,skullcrusher,335,warlock,destruction,11,4,7
Sooshi,malganis,330,warlock,destruction,11,6,5
Lockazo,quelthalas,330,warlock,destruction,11,6,5
Redmil,quelthalas,330,warlock,destruction,29,5,24
Sojulord,sargeras,320,warlock,destruction,10,4,6
Saintläurent,bleeding-hollow,319,warlock,destruction,5,4,1
Lockedyaup,skullcrusher,319,warlock,destruction,8,4,4
Valkynaris,chogall,319,warlock,destruction,14,4,10
Xbendover,proudmoore,288,warlock,destruction,6,3,3
Rockalock,burning-blade,288,warlock,destruction,6,3,3
Vxms,barthilas,288,warlock,destruction,6,3,3
Sweetjezuz,barthilas,288,warlock,destruction,6,3,3
Voldamorte,tichondrius,288,warlock,destruction,6,3,3
Anastadora,proudmoore,288,warlock,destruction,6,3,3
Ärminvßuurën,barthilas,288,warlock,destruction,6,3,3
Picklecatz,barthilas,288,warlock,destruction,6,3,3
Signalnine,thrall,288,warlock,destruction,6,3,3
Borudo,thrall,288,warlock,destruction,6,3,3
Merlinsbeard,zuluhed,288,warlock,destruction,6,3,3
Crafterism,barthilas,288,warlock,destruction,6,3,3
Speakeasy,malygos,288,warlock,destruction,6,3,3
Kronman,zuluhed,288,warlock,destruction,6,3,3
Astarothe,proudmoore,288,warlock,destruction,6,3,3
Feeltheviibe,zuljin,288,warlock,destruction,6,3,3
Meltingface,bleeding-hollow,288,warlock,destruction,6,3,3
Papablasty,nagrand,288,warlock,destruction,6,3,3
Milkybøng,area-52,288,warlock,destruction,6,3,3
Souldotz,proudmoore,288,warlock,destruction,6,3,3
Embraces,tichondrius,288,warlock,destruction,6,3,3
Mamabolts,kelthuzad,288,warlock,destruction,6,3,3
Pennydrop,barthilas,288,warlock,destruction,6,3,3
Firemike,kelthuzad,288,warlock,destruction,6,3,3
Mylock,andorhal,288,warlock,destruction,6,3,3
Ijustsharded,area-52,288,warlock,destruction,6,3,3
Thisisturtle,area-52,288,warlock,destruction,6,3,3
Oleg,bleeding-hollow,288,warlock,destruction,6,3,3
Mastroguise,illidan,288,warlock,destruction,6,3,3
Crucifieds,tichondrius,288,warlock,destruction,6,3,3
Notdiesel,thrall,288,warlock,destruction,6,3,3
Odelgabiana,area-52,288,warlock,destruction,6,3,3
Æsidius,tichondrius,288,warlock,destruction,6,3,3
Shawzyy,tichondrius,288,warlock,destruction,6,3,3
Gurlock,illidan,288,warlock,destruction,6,3,3
Amuros,illidan,288,warlock,destruction,6,3,3
Rumplefust,thrall,288,warlock,destruction,6,3,3
Poggyjones,tichondrius,288,warlock,destruction,6,3,3
Dìpndots,wyrmrest-accord,288,warlock,destruction,6,3,3
Gotfear,zuljin,288,warlock,destruction,6,3,3
Héllboy,akama,288,warlock,destruction,6,3,3
Creedmore,sargeras,288,warlock,destruction,6,3,3
Warlooch,area-52,288,warlock,destruction,6,3,3
Gingerlock,stonemaul,288,warlock,destruction,6,3,3
Geofar,bleeding-hollow,288,warlock,destruction,6,3,3
Lillpfudd,area-52,288,warlock,destruction,6,3,3
Shädowflame,bleeding-hollow,288,warlock,destruction,6,3,3
Joung,tichondrius,288,warlock,destruction,6,3,3
Ovoíd,area-52,288,warlock,destruction,6,3,3
Dohmie,argent-dawn,288,warlock,destruction,6,3,3
Nutzosaurus,darkspear,288,warlock,destruction,6,3,3
Fungiforest,kelthuzad,288,warlock,destruction,6,3,3
Eliphas,bronzebeard,288,warlock,destruction,6,3,3
Phénom,tichondrius,288,warlock,destruction,6,3,3
Deejaye,frostmourne,288,warlock,destruction,6,3,3
Tiptonb,tichondrius,288,warlock,destruction,6,3,3
Dashaad,illidan,288,warlock,destruction,6,3,3
Pillçosby,tichondrius,288,warlock,destruction,6,3,3
Gümbÿ,illidan,288,warlock,destruction,6,3,3
Lübelock,illidan,288,warlock,destruction,6,3,3
Sàill,tichondrius,288,warlock,destruction,6,3,3
Hamdulla,tichondrius,288,warlock,destruction,6,3,3
Ökïlôck,proudmoore,288,warlock,destruction,6,3,3
Ragnorök,medivh,288,warlock,destruction,6,3,3
Maleficist,bleeding-hollow,288,warlock,destruction,6,3,3
Gildedknight,arthas,288,warlock,destruction,6,3,3
Famouslos,anetheron,288,warlock,destruction,6,3,3
Karter,anetheron,288,warlock,destruction,6,3,3
Zuelu,tichondrius,288,warlock,destruction,6,3,3
Cancer,bloodscalp,288,warlock,destruction,6,3,3
Hauntgød,tichondrius,288,warlock,destruction,6,3,3
Drskeeters,malganis,288,warlock,destruction,6,3,3
Vetadul,proudmoore,288,warlock,destruction,6,3,3
Nihilus,anvilmar,288,warlock,destruction,6,3,3
Avadakedavra,warsong,288,warlock,destruction,6,3,3
Felsgoodman,illidan,288,warlock,destruction,6,3,3
Famelol,tichondrius,288,warlock,destruction,6,3,3
Jishtructo,frostmourne,288,warlock,destruction,6,3,3
Neversoft,bleeding-hollow,288,warlock,destruction,6,3,3
Xephostwo,area-52,288,warlock,destruction,6,3,3
Lockabeesha,chogall,288,warlock,destruction,6,3,3
Siphoned,darkspear,288,warlock,destruction,6,3,3
Discordance,zuljin,288,warlock,destruction,6,3,3
Ðëâthløck,tichondrius,288,warlock,destruction,6,3,3
Bushmelded,tichondrius,288,warlock,destruction,6,3,3
Ratedtorgast,illidan,288,warlock,destruction,6,3,3
Babylung,bleeding-hollow,288,warlock,destruction,6,3,3
Velvalla,chogall,288,warlock,destruction,6,3,3
Imports,tichondrius,288,warlock,destruction,6,3,3
Hairydottr,malganis,288,warlock,destruction,6,3,3
Drelgun,aerie-peak,288,warlock,destruction,6,3,3
Sorath,blackrock,288,warlock,destruction,6,3,3
Darthzugzug,gorefiend,288,warlock,destruction,6,3,3
Tamzlock,the-forgotten-coast,288,warlock,destruction,6,3,3
Unquit,frostmourne,288,warlock,destruction,6,3,3
Dotbot,blades-edge,288,warlock,destruction,6,3,3
Ñevaeh,emerald-dream,288,warlock,destruction,6,3,3
Shâdowman,stormrage,288,warlock,destruction,6,3,3
Stretchmark,stormrage,288,warlock,destruction,6,3,3
Blakedogx,tichondrius,288,warlock,destruction,6,3,3
Tomathus,moon-guard,288,warlock,destruction,6,3,3
Mfcalamity,uldum,288,warlock,destruction,6,3,3
Cocoabuttâ,stormrage,288,warlock,destruction,6,3,3
Niétzsché,emerald-dream,288,warlock,destruction,6,3,3
Fearlok,malorne,288,warlock,destruction,6,3,3
Nergoul,stormrage,288,warlock,destruction,6,3,3
Nismo,trollbane,288,warlock,destruction,6,3,3
Dluttysots,emerald-dream,288,warlock,destruction,6,3,3
Carpedemon,malganis,288,warlock,destruction,6,3,3
Trainwreck,sargeras,288,warlock,destruction,6,3,3
Feardr,frostmourne,288,warlock,destruction,6,3,3
Porsimorgis,firetree,288,warlock,destruction,6,3,3
Hëctic,nerzhul,288,warlock,destruction,6,3,3
Noslock,aegwynn,288,warlock,destruction,6,3,3
Rerolledfotm,sargeras,288,warlock,destruction,6,3,3
Feartool,stormrage,288,warlock,destruction,6,3,3
Maledictivus,stormrage,288,warlock,destruction,6,3,3
Bazeni,frostmourne,288,warlock,destruction,6,3,3
Fatass,cairne,288,warlock,destruction,6,3,3
Devi,destromath,288,warlock,destruction,6,3,3
Shifulock,azralon,288,warlock,destruction,6,3,3
Aruotnof,nemesis,288,warlock,destruction,6,3,3
Ägnar,nemesis,288,warlock,destruction,6,3,3
Soulbane,tol-barad,288,warlock,destruction,6,3,3
Silkxy,frostwolf,288,warlock,destruction,6,3,3
Toxicatedz,azralon,288,warlock,destruction,6,3,3
Larsiezwei,spirestone,288,warlock,destruction,6,3,3
Tacolock,azshara,288,warlock,destruction,6,3,3
Slothdots,tichondrius,288,warlock,destruction,6,3,3
Saffuky,frostmourne,288,warlock,destruction,6,3,3
Reyaena,moon-guard,288,warlock,destruction,6,3,3
Atheô,ragnaros,288,warlock,destruction,6,3,3
Gasgrassnass,sargeras,288,warlock,destruction,6,3,3
Itsawarlock,thunderlord,288,warlock,destruction,6,3,3
Warlockluo,tichondrius,288,warlock,destruction,6,3,3
Eiram,ragnaros,288,warlock,destruction,6,3,3
Bunami,kiljaeden,288,warlock,destruction,6,3,3
Muchopower,ragnaros,288,warlock,destruction,6,3,3
Voldormort,uldaman,288,warlock,destruction,6,3,3
Blastindotz,frostmane,288,warlock,destruction,6,3,3
Xblessed,stormrage,288,warlock,destruction,6,3,3
Uwubolt,moon-guard,288,warlock,destruction,6,3,3
Háydn,azuremyst,288,warlock,destruction,6,3,3
Minos,tichondrius,288,warlock,destruction,6,3,3
Feldune,sargeras,288,warlock,destruction,6,3,3
Berszerk,quelthalas,288,warlock,destruction,6,3,3
Metaphors,stormrage,288,warlock,destruction,6,3,3
Nòpê,tichondrius,288,warlock,destruction,6,3,3
Bhalthazar,staghelm,288,warlock,destruction,6,3,3
Dogcookie,moon-guard,288,warlock,destruction,6,3,3
Reallygud,tichondrius,288,warlock,destruction,6,3,3
Mokulock,tichondrius,288,warlock,destruction,6,3,3
Shadøwcrits,quelthalas,288,warlock,destruction,6,3,3
Ÿoucantwin,kiljaeden,288,warlock,destruction,6,3,3
Pheríe,sargeras,288,warlock,destruction,6,3,3
Demtros,tichondrius,288,warlock,destruction,6,3,3
Ashtak,coilfang,288,warlock,destruction,6,3,3
Pennÿ,quelthalas,288,warlock,destruction,6,3,3
Peterdotz,whisperwind,288,warlock,destruction,6,3,3
Vampydark,quelthalas,288,warlock,destruction,6,3,3
Amauder,moon-guard,288,warlock,destruction,6,3,3
Blaxzlock,stormscale,288,warlock,destruction,6,3,3
Chesterfear,quelthalas,288,warlock,destruction,6,3,3
Liltoastii,illidan,288,warlock,destruction,7,3,4
Taldaroth,moon-guard,288,warlock,destruction,7,3,4
Ellipsispain,bleeding-hollow,288,warlock,destruction,7,3,4
Fluximilian,azralon,288,warlock,destruction,10,4,6
Prelick,illidan,288,warlock,destruction,12,3,9
Drwolfman,bonechewer,288,warlock,destruction,12,3,9
Shaddaj,illidan,288,warlock,destruction,12,3,9
Darkhadouken,sargeras,288,warlock,destruction,12,3,9
Gotty,stormrage,288,warlock,destruction,12,3,9
Reluxify,dalaran,288,warlock,destruction,12,3,9
Kkuldan,tichondrius,288,warlock,destruction,12,3,9
Zeeref,stormrage,288,warlock,destruction,12,3,9
Demondays,sargeras,288,warlock,destruction,12,3,9
Sankestones,burning-legion,288,warlock,destruction,12,3,9
Mireffect,auchindoun,288,warlock,destruction,12,3,9
Fearfactory,lethon,288,warlock,destruction,12,3,9
Rabiesdot,tichondrius,288,warlock,destruction,12,3,9
Gorgaron,zuljin,288,warlock,destruction,12,3,9
Wickedt,ragnaros,288,warlock,destruction,12,3,9
Demonâ,ragnaros,288,warlock,destruction,12,3,9
Trotndot,dragonmaw,288,warlock,destruction,12,3,9
Hachiui,galakrond,288,warlock,destruction,12,3,9
Markov,goldrinn,288,warlock,destruction,12,3,9
Wyrelock,hyjal,288,warlock,destruction,12,3,9
Gdpx,malganis,288,warlock,destruction,12,3,9
Cexdragon,tichondrius,288,warlock,destruction,14,3,11
Hulion,kiljaeden,288,warlock,destruction,18,3,15
Gulliftonan,zuljin,288,warlock,destruction,18,3,15
Izmadara,frostmane,287,warlock,destruction,6,3,3
Verybaked,sargeras,287,warlock,destruction,6,3,3
Brenmen,tichondrius,287,warlock,destruction,6,3,3
Deatthwish,ragnaros,287,warlock,destruction,6,3,3
Trrolling,jubeithos,287,warlock,destruction,12,5,7
Alvatio,tichondrius,287,warlock,destruction,12,3,9
Evilbacon,stormrage,287,warlock,destruction,12,3,9
Drunklockdot,tichondrius,271,warlock,destruction,11,3,8
Ainzeal,nagrand,256,warlock,destruction,10,4,6
Sophia,wildhammer,255,warlock,destruction,8,4,4
Mikejones,dawnbringer,255,warlock,destruction,14,4,10
Draisien,moon-guard,250,warlock,destruction,7,5,2
Warakaso,ragnaros,240,warlock,destruction,9,3,6
Infectionl,ragnaros,239,warlock,destruction,5,3,2
Thuglovex,sargeras,239,warlock,destruction,5,3,2
Blightbeast,area-52,239,warlock,destruction,5,3,2
Nawtychannel,aegwynn,239,warlock,destruction,5,3,2
Vialdkaseun,muradin,239,warlock,destruction,5,3,2
Azaradx,azralon,239,warlock,destruction,11,3,8
Nozixx,thrall,224,warlock,destruction,10,3,7
Wàtchmebolt,dalvengyr,223,warlock,destruction,8,3,5
Perfidious,altar-of-storms,192,warlock,destruction,4,3,1
Particles,proudmoore,192,warlock,destruction,4,3,1
Portalgun,tichondrius,192,warlock,destruction,4,3,1
Draindeez,sargeras,192,warlock,destruction,9,3,6
Konarik,nagrand,192,warlock,destruction,6,2,4
Erimegara,ragnaros,192,warlock,destruction,6,2,4
Maxice,zuljin,192,warlock,destruction,6,2,4
Oopsíe,nagrand,192,warlock,destruction,6,2,4
Iadminl,moon-guard,192,warlock,destruction,6,2,4
Ðuckworth,azralon,192,warlock,destruction,6,2,4
Biznam,tichondrius,192,warlock,destruction,6,2,4
Gløcked,area-52,192,warlock,destruction,6,2,4
Silverfire,ragnaros,192,warlock,destruction,6,2,4
Lazzie,thrall,192,warlock,destruction,6,2,4
Brawndelock,stormrage,192,warlock,destruction,6,2,4
Chipt,kelthuzad,192,warlock,destruction,6,2,4
Imindanger,frostmourne,192,warlock,destruction,6,2,4
Sn,dalaran,192,warlock,destruction,6,2,4
Doomhauzer,kiljaeden,192,warlock,destruction,6,2,4
Medusablood,area-52,192,warlock,destruction,6,2,4
Felpuppet,barthilas,192,warlock,destruction,6,2,4
Asaveyous,wyrmrest-accord,192,warlock,destruction,6,2,4
Abbyshapiro,kelthuzad,192,warlock,destruction,6,2,4
Disapoin,stormrage,192,warlock,destruction,6,2,4
Åchse,ragnaros,192,warlock,destruction,6,2,4
Diablox,silvermoon,192,warlock,destruction,6,2,4
Diabolock,proudmoore,192,warlock,destruction,6,2,4
Omegawarlock,quelthalas,192,warlock,destruction,6,2,4
Nightterrour,frostmourne,192,warlock,destruction,6,2,4
Leine,proudmoore,192,warlock,destruction,6,2,4
Checkit,zuljin,192,warlock,destruction,6,2,4
Zephiy,kelthuzad,192,warlock,destruction,6,2,4
Terminall,quelthalas,192,warlock,destruction,6,2,4
Daesire,moon-guard,192,warlock,destruction,6,2,4
Bleachkk,tichondrius,192,warlock,destruction,6,2,4
Dach,moon-guard,192,warlock,destruction,6,2,4
Raghog,kelthuzad,192,warlock,destruction,6,2,4
Dotsin,wyrmrest-accord,192,warlock,destruction,6,2,4
Nazug,dark-iron,192,warlock,destruction,6,2,4
Zoboo,zuljin,192,warlock,destruction,6,2,4
Hadés,aerie-peak,192,warlock,destruction,6,2,4
Lhorgainz,area-52,192,warlock,destruction,6,2,4
Xaraki,skullcrusher,192,warlock,destruction,6,2,4
Fstndantilus,moonrunner,192,warlock,destruction,6,2,4
Yordich,kelthuzad,192,warlock,destruction,6,2,4
Camila,lightnings-blade,192,warlock,destruction,6,2,4
Sulívan,azralon,192,warlock,destruction,6,2,4
Gvz,tichondrius,192,warlock,destruction,6,2,4
Deiformis,malganis,192,warlock,destruction,6,2,4
Darkbaron,khadgar,192,warlock,destruction,6,2,4
Hadeys,amanthul,192,warlock,destruction,6,2,4
Theyfearbuda,kelthuzad,192,warlock,destruction,6,2,4
Encanis,dalaran,192,warlock,destruction,6,2,4
Arthürr,thrall,192,warlock,destruction,6,2,4
Aksanaa,area-52,192,warlock,destruction,6,2,4
Gadalann,area-52,192,warlock,destruction,6,2,4
Mlx,proudmoore,192,warlock,destruction,6,2,4
Maniacal,shattered-halls,192,warlock,destruction,6,2,4
Toxik,zuljin,192,warlock,destruction,6,2,4
Cityswimmer,malganis,192,warlock,destruction,6,2,4
Theboss,arygos,192,warlock,destruction,6,2,4
Muffinlol,frostmourne,192,warlock,destruction,6,2,4
Thotorina,tichondrius,192,warlock,destruction,6,2,4
Mythh,hyjal,192,warlock,destruction,6,2,4
Guisls,azralon,192,warlock,destruction,6,2,4
Locksama,area-52,192,warlock,destruction,6,2,4
Dotnrunn,kelthuzad,192,warlock,destruction,6,2,4
Hollows,burning-blade,192,warlock,destruction,6,2,4
Dotcòm,illidan,192,warlock,destruction,6,2,4
Becà,stormrage,192,warlock,destruction,6,2,4
Seizuresauce,stormrage,192,warlock,destruction,6,2,4
Curaven,emerald-dream,192,warlock,destruction,6,2,4
Mutexlock,whisperwind,192,warlock,destruction,6,2,4
Mothapucka,thrall,192,warlock,destruction,6,2,4
Albuuss,daggerspine,192,warlock,destruction,6,2,4
Vorkaz,moon-guard,192,warlock,destruction,6,2,4
Ramone,turalyon,192,warlock,destruction,6,2,4
Amz,grizzly-hills,192,warlock,destruction,6,2,4
Bludlock,illidan,192,warlock,destruction,6,2,4
Cycaeria,moon-guard,192,warlock,destruction,6,2,4
Itzlandox,emerald-dream,192,warlock,destruction,6,2,4
Shanelle,korgath,192,warlock,destruction,6,2,4
Pinguswalrus,stormrage,192,warlock,destruction,6,2,4
Adalaya,emerald-dream,192,warlock,destruction,6,2,4
Fluffylockk,bloodscalp,192,warlock,destruction,6,2,4
Outlanderr,tichondrius,192,warlock,destruction,6,2,4
Qbl,wyrmrest-accord,192,warlock,destruction,6,2,4
Spicyfingers,illidan,192,warlock,destruction,6,2,4
Moistdank,tichondrius,192,warlock,destruction,6,2,4
Njunx,queldorei,192,warlock,destruction,6,2,4
Selitose,illidan,192,warlock,destruction,6,2,4
Theredwolf,zuljin,192,warlock,destruction,6,2,4
Musgrin,gallywix,192,warlock,destruction,6,2,4
Luciffer,windrunner,192,warlock,destruction,6,2,4
Sugarfire,nemesis,192,warlock,destruction,6,2,4
Actualjoke,frostmourne,192,warlock,destruction,6,2,4
Ibanez,bleeding-hollow,192,warlock,destruction,6,2,4
Nüts,blackrock,192,warlock,destruction,6,2,4
Apokálipse,frostmourne,192,warlock,destruction,6,2,4
Nameflagged,arathor,192,warlock,destruction,6,2,4
Poltergiiest,korgath,192,warlock,destruction,6,2,4
Dihva,malganis,192,warlock,destruction,6,2,4
Sinissa,ysondre,192,warlock,destruction,6,2,4
Kuaa,illidan,192,warlock,destruction,6,2,4
Dotzlol,jubeithos,192,warlock,destruction,6,2,4
Fantumz,illidan,192,warlock,destruction,6,2,4
Cholock,anubarak,192,warlock,destruction,6,2,4
Montaine,malganis,192,warlock,destruction,6,2,4
Rococo,emerald-dream,192,warlock,destruction,6,2,4
Fjklock,nemesis,192,warlock,destruction,6,2,4
Cthuga,frostmourne,192,warlock,destruction,6,2,4
Ricklock,aggramar,192,warlock,destruction,6,2,4
Reckzet,stormrage,192,warlock,destruction,6,2,4
Raisa,chogall,192,warlock,destruction,6,2,4
Sinnâcle,illidan,192,warlock,destruction,6,2,4
Vetic,area-52,192,warlock,destruction,6,2,4
Lexist,darkspear,192,warlock,destruction,6,2,4
Sinsky,darkspear,192,warlock,destruction,6,2,4
Tirisfel,tichondrius,192,warlock,destruction,6,2,4
Srz,stormrage,192,warlock,destruction,6,2,4
Morganith,ravenholdt,192,warlock,destruction,6,2,4
Sorenbjerga,zuljin,192,warlock,destruction,6,2,4
Dpz,darkspear,192,warlock,destruction,6,2,4
Nuradzec,illidan,192,warlock,destruction,6,2,4
Demonia,dathremar,192,warlock,destruction,6,2,4
Lolokayhaha,vashj,192,warlock,destruction,6,2,4
Scaryðreams,malganis,192,warlock,destruction,6,2,4
Ourlegacy,tichondrius,192,warlock,destruction,6,2,4
Cynnd,tichondrius,192,warlock,destruction,6,2,4
Infant,agamaggan,192,warlock,destruction,6,2,4
Gihaewon,tichondrius,192,warlock,destruction,6,2,4
Æonas,bladefist,192,warlock,destruction,6,2,4
Shredlock,tichondrius,192,warlock,destruction,6,2,4
Deathwishiz,tichondrius,192,warlock,destruction,6,2,4
Startx,tichondrius,192,warlock,destruction,6,2,4
Voltshot,tichondrius,192,warlock,destruction,6,2,4
Petez,sargeras,192,warlock,destruction,6,2,4
Savemykoalas,tichondrius,192,warlock,destruction,6,2,4
Pikkon,malorne,192,warlock,destruction,6,2,4
Lõck,tichondrius,192,warlock,destruction,6,2,4
Innerforce,tichondrius,192,warlock,destruction,6,2,4
Ðamndaddy,sargeras,192,warlock,destruction,6,2,4
Ballpain,sargeras,192,warlock,destruction,6,2,4
Dedremus,korialstrasz,192,warlock,destruction,6,2,4
Deanwarlock,sargeras,192,warlock,destruction,6,2,4
Geauxst,tichondrius,192,warlock,destruction,6,2,4
Cauldron,tichondrius,192,warlock,destruction,6,2,4
Xalcezar,sargeras,192,warlock,destruction,6,2,4
Deathteller,tichondrius,192,warlock,destruction,6,2,4
Whydemono,tichondrius,192,warlock,destruction,10,2,8
Asumi,nemesis,192,warlock,destruction,12,2,10
Moknuhg,emerald-dream,192,warlock,destruction,12,2,10
Bladebank,kirin-tor,192,warlock,destruction,12,2,10
Daggondai,tichondrius,192,warlock,destruction,12,2,10
Wizie,arthas,192,warlock,destruction,12,2,10
Luntrazz,arthas,192,warlock,destruction,12,2,10
Dapperdanxy,tichondrius,192,warlock,destruction,12,2,10
Kandrus,moon-guard,192,warlock,destruction,12,2,10
Abramerlin,tichondrius,192,warlock,destruction,12,2,10
Beamac,cenarius,192,warlock,destruction,14,2,12
Thediaz,quelthalas,191,warlock,destruction,6,2,4
Mystickittie,aerie-peak,191,warlock,destruction,6,2,4
Eldrien,spirestone,191,warlock,destruction,12,2,10
Mìrä,kelthuzad,175,warlock,destruction,11,2,9
Prds,illidan,159,warlock,destruction,5,2,3
Fearfeaster,tichondrius,159,warlock,destruction,5,2,3
Eatmyboltz,hyjal,159,warlock,destruction,5,2,3
Hayhatchie,nagrand,159,warlock,destruction,5,2,3
Dotyoazz,stormrage,159,warlock,destruction,5,2,3
Fengfeiss,tichondrius,144,warlock,destruction,3,3,0
Olsdead,aegwynn,138,warlock,destruction,6,3,3
Ganondolph,sargeras,138,warlock,destruction,9,3,6
Catarina,kaelthas,128,warlock,destruction,4,2,2
Miggazzizle,senjin,128,warlock,destruction,4,2,2
Rosacrutian,tichondrius,128,warlock,destruction,4,2,2
Hentailust,kiljaeden,128,warlock,destruction,4,2,2
Thegoatmen,stormrage,128,warlock,destruction,4,2,2
Oreo,velen,112,warlock,destruction,7,2,5
Willsayan,ragnaros,96,warlock,destruction,3,2,1
Ministàff,ursin,96,warlock,destruction,3,2,1
Crankak,zuljin,96,warlock,destruction,3,2,1
Goodforyou,stormscale,96,warlock,destruction,3,2,1
Flemball,aegwynn,96,warlock,destruction,9,2,7
Niubeelol,tichondrius,96,warlock,destruction,6,1,5
Darkmatter,frostmourne,96,warlock,destruction,6,1,5
Chilevael,sargeras,96,warlock,destruction,6,1,5
Demonellea,frostmourne,96,warlock,destruction,6,1,5
Charlîe,vashj,96,warlock,destruction,6,1,5
Juwi,frostmourne,96,warlock,destruction,6,1,5
Lazymongoose,frostmourne,96,warlock,destruction,6,1,5
Mazip,vashj,96,warlock,destruction,6,1,5
Digylock,kelthuzad,96,warlock,destruction,6,1,5
Siinistuh,tichondrius,96,warlock,destruction,6,1,5
Demonist,moon-guard,96,warlock,destruction,6,1,5
Vexxes,malganis,96,warlock,destruction,6,1,5
Cornboil,tichondrius,96,warlock,destruction,6,1,5
Gibkii,tichondrius,96,warlock,destruction,6,1,5
Yallsdead,frostmourne,96,warlock,destruction,6,1,5
Alcorick,moon-guard,96,warlock,destruction,6,1,5
Saytiri,tichondrius,96,warlock,destruction,6,1,5
Mílkduds,zuljin,96,warlock,destruction,6,1,5
Amour,wyrmrest-accord,96,warlock,destruction,6,1,5
Bitrot,jubeithos,96,warlock,destruction,6,1,5
Biigdaddyy,kelthuzad,96,warlock,destruction,6,1,5
Mônkêy,kelthuzad,96,warlock,destruction,6,1,5
Acribal,quelthalas,96,warlock,destruction,6,1,5
Proletariat,moon-guard,96,warlock,destruction,6,1,5
Taddedlock,kelthuzad,96,warlock,destruction,6,1,5
Crushbucket,stormreaver,96,warlock,destruction,6,1,5
Gamecobra,greymane,96,warlock,destruction,6,1,5
Hinatasu,greymane,96,warlock,destruction,6,1,5
Xaryus,barthilas,96,warlock,destruction,6,1,5
Lawkdown,dark-iron,96,warlock,destruction,6,1,5
Kaotiq,area-52,96,warlock,destruction,6,1,5
Infear,area-52,96,warlock,destruction,6,1,5
Scatach,area-52,96,warlock,destruction,6,1,5
Erindevil,demon-soul,96,warlock,destruction,6,1,5
Druzzaj,thrall,96,warlock,destruction,6,1,5
Basticor,moon-guard,96,warlock,destruction,6,1,5
Stonelocke,area-52,96,warlock,destruction,6,1,5
Killulock,area-52,96,warlock,destruction,6,1,5
Däemön,area-52,96,warlock,destruction,6,1,5
Lokiiee,azuremyst,96,warlock,destruction,6,1,5
Elaïla,area-52,96,warlock,destruction,6,1,5
Lockedinn,mannoroth,96,warlock,destruction,6,1,5
Kuasta,shadowmoon,96,warlock,destruction,6,1,5
Shidded,lightbringer,96,warlock,destruction,6,1,5
Tartamuda,ragnaros,96,warlock,destruction,6,1,5
Mythsubpar,tichondrius,96,warlock,destruction,6,1,5
Plaguelnc,illidan,96,warlock,destruction,6,1,5
Wesyane,anetheron,96,warlock,destruction,6,1,5
Yuengling,illidan,96,warlock,destruction,6,1,5
Catdog,bleeding-hollow,96,warlock,destruction,6,1,5
Mcpickl,illidan,96,warlock,destruction,6,1,5
Ezgamejr,tichondrius,96,warlock,destruction,6,1,5
Wickedicky,alleria,96,warlock,destruction,6,1,5
Lilintrovert,illidan,96,warlock,destruction,6,1,5
Belfomént,ragnaros,96,warlock,destruction,6,1,5
Heffyboi,frostmourne,96,warlock,destruction,6,1,5
Fearxd,maiev,96,warlock,destruction,6,1,5
Medivhz,tichondrius,96,warlock,destruction,6,1,5
Kothoped,wyrmrest-accord,96,warlock,destruction,6,1,5
Rëappér,ragnaros,96,warlock,destruction,6,1,5
Karpawarlock,ragnaros,96,warlock,destruction,6,1,5
Gsr,bleeding-hollow,96,warlock,destruction,6,1,5
Pspot,kiljaeden,96,warlock,destruction,6,1,5
Koillock,bleeding-hollow,96,warlock,destruction,6,1,5
Resima,stormscale,96,warlock,destruction,6,1,5
Plaguedoctor,stormrage,96,warlock,destruction,6,1,5
Adlfcritler,emerald-dream,96,warlock,destruction,6,1,5
Ashlëen,ragnaros,96,warlock,destruction,6,1,5
Lilcarmy,emerald-dream,96,warlock,destruction,6,1,5
Badufin,azralon,96,warlock,destruction,6,1,5
Kurtcodrain,blackhand,96,warlock,destruction,6,1,5
Bfaclâssic,zuljin,96,warlock,destruction,6,1,5
Sheara,silver-hand,96,warlock,destruction,6,1,5
Brothadoinks,zuljin,96,warlock,destruction,6,1,5
Ãids,khadgar,96,warlock,destruction,6,1,5
Spellbøund,malorne,96,warlock,destruction,6,1,5
Tubarão,azralon,96,warlock,destruction,6,1,5
Kraguenöth,drakkari,96,warlock,destruction,6,1,5
Dotomizer,moonrunner,96,warlock,destruction,6,1,5
Vendareth,earthen-ring,96,warlock,destruction,6,1,5
Meinhundin,stormrage,96,warlock,destruction,6,1,5
Deadlockz,stormrage,96,warlock,destruction,6,1,5
Lucifuhrerr,tichondrius,96,warlock,destruction,6,1,5
Monstir,sargeras,96,warlock,destruction,6,1,5
Lokinzz,tichondrius,96,warlock,destruction,6,1,5
Jill,thunderhorn,96,warlock,destruction,6,1,5
Lizlock,stormrage,96,warlock,destruction,6,1,5
Cursenkill,sargeras,96,warlock,destruction,6,1,5
Vandenso,stormrage,96,warlock,destruction,6,1,5
Gulgrin,eldrethalas,96,warlock,destruction,6,1,5
Delaye,tichondrius,96,warlock,destruction,6,1,5
Seutóóbinha,stormrage,96,warlock,destruction,6,1,5
Radii,bladefist,96,warlock,destruction,6,1,5
Jiwonpark,goldrinn,96,warlock,destruction,6,1,5
Bosshoglock,whisperwind,96,warlock,destruction,6,1,5
Voky,whisperwind,96,warlock,destruction,6,1,5
Wherelock,area-52,96,warlock,destruction,7,1,6
Solrad,illidan,95,warlock,destruction,9,2,7
Anubís,vashj,79,warlock,destruction,5,1,4
Epicgaymer,zuljin,79,warlock,destruction,5,1,4
Felse,stormrage,64,warlock,destruction,10,1,9
Bagn,tichondrius,63,warlock,destruction,2,2,0
Thiccdoinkz,tichondrius,63,warlock,destruction,2,2,0
Brockdot,tichondrius,63,warlock,destruction,2,2,0
Cokelime,sargeras,63,warlock,destruction,2,2,0
Aoneandatwo,proudmoore,48,warlock,destruction,3,1,2
ßenafflock,wyrmrest-accord,48,warlock,destruction,3,1,2
Clevingert,frostmourne,48,warlock,destruction,3,1,2
Kosugi,kelthuzad,42,warlock,destruction,8,2,6
Amarexd,stormrage,31,warlock,destruction,2,1,1
Earllock,sargeras,31,warlock,destruction,2,1,1
Moräl,frostmourne,31,warlock,destruction,2,1,1
Emurog,icecrown,30,warlock,destruction,12,6,6
Goofhu,sargeras,2270,warlock,affliction,102,62,40
Exgenshinpro,proudmoore,2257,warlock,affliction,154,86,68
Goofgg,sargeras,2152,warlock,affliction,287,144,143
Yandhi,bronzebeard,2129,warlock,affliction,46,30,16
Dewandoritos,kelthuzad,2088,warlock,affliction,111,54,57
Dotdzdotdoze,tichondrius,2077,warlock,affliction,221,118,103
Rangrang,tichondrius,1995,warlock,affliction,72,37,35
Tcchiu,tichondrius,1982,warlock,affliction,35,24,11
Sphoo,tichondrius,1971,warlock,affliction,82,42,40
Exódia,tichondrius,1957,warlock,affliction,147,76,71
Boyahancook,tichondrius,1925,warlock,affliction,76,44,32
Diminish,sargeras,1923,warlock,affliction,78,39,39
Arityy,tichondrius,1919,warlock,affliction,78,41,37
Hiro,steamwheedle-cartel,1908,warlock,affliction,51,37,14
Dyenamik,stormrage,1891,warlock,affliction,60,33,27
Burtreynolds,shattered-hand,1884,warlock,affliction,54,30,24
Yellowfevr,thrall,1870,warlock,affliction,48,27,21
Limeriax,emerald-dream,1869,warlock,affliction,102,59,43
Jukethisxo,tichondrius,1863,warlock,affliction,99,59,40
Pardoned,stormrage,1859,warlock,affliction,41,20,21
Hyoozy,illidan,1846,warlock,affliction,94,52,42
Rangz,tichondrius,1842,warlock,affliction,54,31,23
Renosa,illidan,1818,warlock,affliction,57,32,25
Prnhbgødx,sargeras,1818,warlock,affliction,42,22,20
Lockhippo,illidan,1818,warlock,affliction,58,30,28
Bugbugg,tichondrius,1814,warlock,affliction,51,38,13
Fallenis,proudmoore,1812,warlock,affliction,36,24,12
Woopie,malfurion,1809,warlock,affliction,53,29,24
Hilzin,area-52,1808,warlock,affliction,66,40,26
Dotplaystyle,blackrock,1806,warlock,affliction,90,42,48
Widenose,agamaggan,1805,warlock,affliction,47,29,18
Octopus,nerzhul,1803,warlock,affliction,53,29,24
Warlocknroll,frostmourne,1803,warlock,affliction,47,21,26
Dröwzy,sargeras,1801,warlock,affliction,48,25,23
Phlares,stormrage,1798,warlock,affliction,71,30,41
Oymmander,illidan,1795,warlock,affliction,30,22,8
Lostlock,sargeras,1792,warlock,affliction,108,60,48
Vialdkaseun,muradin,1788,warlock,affliction,96,50,46
Eh,laughing-skull,1777,warlock,affliction,120,61,59
Lucyloux,sargeras,1775,warlock,affliction,40,23,17
Gry,malganis,1767,warlock,affliction,34,19,15
Duukka,malganis,1763,warlock,affliction,47,28,19
Ezgamejr,tichondrius,1740,warlock,affliction,52,30,22
Baxmoney,malganis,1740,warlock,affliction,48,19,29
Jimmyvagene,area-52,1736,warlock,affliction,59,26,33
Cumbledora,kelthuzad,1730,warlock,affliction,36,22,14
Beetlejoos,stormreaver,1727,warlock,affliction,86,46,40
Cocaineparty,tichondrius,1697,warlock,affliction,96,49,47
Locklist,frostmourne,1695,warlock,affliction,78,41,37
Fatals,thrall,1694,warlock,affliction,54,28,26
Cslice,magtheridon,1686,warlock,affliction,36,20,16
Beamin,dentarg,1683,warlock,affliction,42,27,15
Àfflìction,tichondrius,1683,warlock,affliction,101,54,47
Ticktickdoom,sargeras,1683,warlock,affliction,74,36,38
Liarz,tichondrius,1667,warlock,affliction,72,36,36
Mornnah,dalaran,1665,warlock,affliction,48,20,28
Kopium,tichondrius,1645,warlock,affliction,36,24,12
Dottcha,blackrock,1643,warlock,affliction,60,37,23
Wojii,kelthuzad,1636,warlock,affliction,44,24,20
Matrielan,azshara,1629,warlock,affliction,78,49,29
Unsee,sargeras,1623,warlock,affliction,54,33,21
Portalgun,tichondrius,1617,warlock,affliction,42,21,21
Strudelfears,tichondrius,1612,warlock,affliction,71,48,23
Fancynuts,kiljaeden,1609,warlock,affliction,30,17,13
Urwjoa,tichondrius,1609,warlock,affliction,74,39,35
Jkun,malganis,1608,warlock,affliction,126,70,56
Muffîn,moon-guard,1606,warlock,affliction,36,21,15
Slothycrip,emerald-dream,1606,warlock,affliction,59,33,26
Fasteddywow,arygos,1603,warlock,affliction,71,41,30
Tjdotter,stormrage,1600,warlock,affliction,30,19,11
Pykorrg,ragnaros,1600,warlock,affliction,47,23,24
Demonkiiller,kelthuzad,1597,warlock,affliction,49,25,24
Loodle,moon-guard,1594,warlock,affliction,36,21,15
Waifucandy,tichondrius,1588,warlock,affliction,60,29,31
Mechnite,sargeras,1586,warlock,affliction,67,31,36
Xentzor,auchindoun,1585,warlock,affliction,78,39,39
Parmenides,tichondrius,1584,warlock,affliction,210,110,100
Damage,khadgar,1584,warlock,affliction,66,33,33
Sventka,ragnaros,1578,warlock,affliction,231,116,115
Mitryc,illidan,1572,warlock,affliction,43,21,22
Gekku,ragnaros,1569,warlock,affliction,23,17,6
Sìnister,nazgrel,1569,warlock,affliction,77,49,28
Evarona,gorefiend,1565,warlock,affliction,49,23,26
Mørøs,tichondrius,1561,warlock,affliction,60,42,18
Aomniloltv,zuljin,1559,warlock,affliction,140,74,66
Hauntgød,tichondrius,1558,warlock,affliction,66,38,28
Stalezz,barthilas,1558,warlock,affliction,50,27,23
Stopdot,lightnings-blade,1548,warlock,affliction,65,36,29
Torowasabi,tichondrius,1548,warlock,affliction,36,19,17
Vaalac,tichondrius,1547,warlock,affliction,316,155,161
Dotte,tichondrius,1544,warlock,affliction,30,22,8
Dautenit,illidan,1544,warlock,affliction,54,27,27
Squirtwee,frostmourne,1543,warlock,affliction,54,24,30
Chilipeppa,wyrmrest-accord,1538,warlock,affliction,82,39,43
Elend,elune,1534,warlock,affliction,36,25,11
Ðåntë,thrall,1532,warlock,affliction,62,32,30
Methrocks,emerald-dream,1529,warlock,affliction,64,39,25
Knothy,proudmoore,1527,warlock,affliction,36,16,20
Zod,burning-legion,1525,warlock,affliction,36,17,19
Dirtydotting,nerzhul,1524,warlock,affliction,30,17,13
Thecat,shattered-hand,1523,warlock,affliction,18,16,2
Erolidra,blackrock,1519,warlock,affliction,30,16,14
Soulripped,area-52,1514,warlock,affliction,64,36,28
Yanned,hakkar,1514,warlock,affliction,99,51,48
Xoxoxoxoxo,lightnings-blade,1513,warlock,affliction,70,33,37
Tyicuslok,tichondrius,1510,warlock,affliction,60,31,29
Sheboy,moon-guard,1509,warlock,affliction,96,52,44
Laurela,aegwynn,1508,warlock,affliction,48,22,26
Forcedbeejay,sargeras,1502,warlock,affliction,48,24,24
Sillyrabbut,kelthuzad,1491,warlock,affliction,114,60,54
Adeadsaint,boulderfist,1475,warlock,affliction,35,19,16
Moräl,frostmourne,1470,warlock,affliction,51,25,26
Skoobler,tichondrius,1468,warlock,affliction,93,53,40
Blackchinese,zuljin,1467,warlock,affliction,53,30,23
Tizl,tichondrius,1465,warlock,affliction,102,50,52
Yisuschríst,quelthalas,1453,warlock,affliction,39,23,16
Captrollol,tichondrius,1450,warlock,affliction,37,26,11
Tsalagi,sargeras,1444,warlock,affliction,37,23,14
Dghuldahn,bleeding-hollow,1436,warlock,affliction,48,29,19
Sinápsís,ragnaros,1423,warlock,affliction,24,15,9
Maxcorrupted,sargeras,1420,warlock,affliction,24,16,8
Garthbrookz,bleeding-hollow,1418,warlock,affliction,63,29,34
Soulcore,area-52,1416,warlock,affliction,24,15,9
Marà,ragnaros,1409,warlock,affliction,45,18,27
Fowll,frostwolf,1407,warlock,affliction,85,54,31
Dårkfyre,kiljaeden,1406,warlock,affliction,24,15,9
Purp,vashj,1405,warlock,affliction,32,16,16
Elliarquet,akama,1404,warlock,affliction,106,52,54
Yuckytoetoe,emerald-dream,1400,warlock,affliction,42,24,18
Søül,tichondrius,1399,warlock,affliction,30,16,14
Cantibor,illidan,1398,warlock,affliction,112,60,52
Diosban,malganis,1391,warlock,affliction,48,20,28
Morgil,suramar,1389,warlock,affliction,39,20,19
Chachanoobx,sargeras,1387,warlock,affliction,48,23,25
Feoona,hyjal,1384,warlock,affliction,60,36,24
Winipuhmalo,quelthalas,1384,warlock,affliction,59,33,26
Sweetjuly,area-52,1378,warlock,affliction,48,31,17
Gordaroth,barthilas,1372,warlock,affliction,35,21,14
Hairydotter,doomhammer,1365,warlock,affliction,30,18,12
Munick,spirestone,1365,warlock,affliction,30,17,13
Crazikrix,area-52,1365,warlock,affliction,30,15,15
Snuffe,vashj,1364,warlock,affliction,38,24,14
Arillus,thrall,1364,warlock,affliction,53,29,24
Jumlock,illidan,1361,warlock,affliction,42,23,19
Kålêïðøsçøpê,sargeras,1343,warlock,affliction,18,14,4
Steven,firetree,1342,warlock,affliction,24,14,10
Hemmlock,moknathal,1342,warlock,affliction,39,19,20
Dotpocket,runetotem,1342,warlock,affliction,30,14,16
Irene,nagrand,1341,warlock,affliction,37,23,14
Mïer,tichondrius,1341,warlock,affliction,60,34,26
Uggaboogga,malganis,1338,warlock,affliction,30,14,16
Swath,firetree,1335,warlock,affliction,30,14,16
Karpawarlock,ragnaros,1334,warlock,affliction,66,36,30
Fatuglyegirl,sargeras,1331,warlock,affliction,57,27,30
Warakaso,ragnaros,1326,warlock,affliction,42,28,14
Dippindots,boulderfist,1324,warlock,affliction,104,49,55
Squasum,sargeras,1318,warlock,affliction,59,35,24
Dercrow,quelthalas,1314,warlock,affliction,38,21,17
Ialfizzle,dethecus,1309,warlock,affliction,60,26,34
Violentx,tichondrius,1301,warlock,affliction,45,20,25
Castngcouch,tichondrius,1296,warlock,affliction,117,62,55
Fluffylockk,bloodscalp,1295,warlock,affliction,52,26,26
Punished,arthas,1293,warlock,affliction,56,30,26
Cuteboy,tichondrius,1288,warlock,affliction,36,21,15
Mymmic,ragnaros,1288,warlock,affliction,64,30,34
Whathurts,tichondrius,1287,warlock,affliction,32,23,9
Zinkro,quelthalas,1286,warlock,affliction,82,47,35
Wallow,thunderhorn,1285,warlock,affliction,53,29,24
Aights,zuljin,1284,warlock,affliction,62,21,41
Lilpewpeww,bleeding-hollow,1282,warlock,affliction,105,56,49
Äffie,aerie-peak,1281,warlock,affliction,102,45,57
Gregg,laughing-skull,1280,warlock,affliction,138,74,64
Novichok,amanthul,1276,warlock,affliction,36,15,21
Aalkaid,dathremar,1273,warlock,affliction,54,31,23
Mindfulchimp,sargeras,1273,warlock,affliction,36,15,21
Zamorakk,nemesis,1272,warlock,affliction,58,33,25
Ragnalock,laughing-skull,1270,warlock,affliction,24,14,10
Volsace,moon-guard,1267,warlock,affliction,30,14,16
Lockneo,stormrage,1265,warlock,affliction,66,37,29
Lisaleda,stormrage,1263,warlock,affliction,30,16,14
Eyedot,stormscale,1257,warlock,affliction,18,14,4
Ysnou,nemesis,1251,warlock,affliction,24,15,9
Spi,chogall,1250,warlock,affliction,134,63,71
Xicó,tichondrius,1248,warlock,affliction,47,20,27
Barovir,tichondrius,1247,warlock,affliction,18,13,5
Imadotyasan,shandris,1246,warlock,affliction,18,13,5
Gurlock,illidan,1246,warlock,affliction,42,26,16
Quitxmanlm,tichondrius,1245,warlock,affliction,24,13,11
Eraticlock,illidan,1237,warlock,affliction,25,13,12
Reckzet,stormrage,1234,warlock,affliction,24,13,11
Cascades,icecrown,1228,warlock,affliction,37,19,18
Killernix,drakkari,1219,warlock,affliction,54,29,25
Juniorsalanu,quelthalas,1219,warlock,affliction,97,43,54
Kogath,thunderlord,1209,warlock,affliction,53,29,24
Phelly,frostmourne,1205,warlock,affliction,75,41,34
Beelzismurph,emerald-dream,1205,warlock,affliction,30,14,16
Yoyoling,illidan,1200,warlock,affliction,82,43,39
Atraedes,moon-guard,1200,warlock,affliction,45,22,23
Aeonss,stormrage,1196,warlock,affliction,36,16,20
Zaliki,hellscream,1191,warlock,affliction,30,20,10
Bashel,sargeras,1185,warlock,affliction,51,32,19
Coolwipp,demon-soul,1185,warlock,affliction,109,51,58
Valtimorh,ragnaros,1182,warlock,affliction,24,13,11
Eightyfall,barthilas,1180,warlock,affliction,40,17,23
Iainmbanks,barthilas,1178,warlock,affliction,202,94,108
Nedrien,moon-guard,1177,warlock,affliction,48,27,21
Pipeo,quelthalas,1177,warlock,affliction,90,50,40
Batär,area-52,1171,warlock,affliction,62,26,36
Poltergiiest,korgath,1164,warlock,affliction,24,13,11
Khatrat,azralon,1164,warlock,affliction,106,43,63
Promann,drakkari,1151,warlock,affliction,12,12,0
Háydn,azuremyst,1151,warlock,affliction,18,12,6
Slendyman,stormrage,1151,warlock,affliction,24,12,12
Dpz,spirestone,1150,warlock,affliction,18,12,6
Kruxxqt,illidan,1150,warlock,affliction,24,12,12
Kyugin,goldrinn,1148,warlock,affliction,18,12,6
Bigdammich,bleeding-hollow,1148,warlock,affliction,24,12,12
Studious,sargeras,1139,warlock,affliction,26,15,11
Skrufenjoyer,sargeras,1137,warlock,affliction,63,29,34
Moxz,garona,1136,warlock,affliction,30,12,18
Sugarwaffles,area-52,1135,warlock,affliction,18,12,6
Azâziel,ragnaros,1128,warlock,affliction,35,17,18
Flangy,kiljaeden,1123,warlock,affliction,84,33,51
Sinesta,bleeding-hollow,1122,warlock,affliction,24,12,12
Drskeeters,malganis,1116,warlock,affliction,26,13,13
Zrx,proudmoore,1115,warlock,affliction,69,27,42
Beetlegiese,doomhammer,1114,warlock,affliction,40,19,21
Auntzhang,tichondrius,1101,warlock,affliction,29,12,17
Phøbøs,hyjal,1099,warlock,affliction,24,13,11
Dipdip,illidan,1097,warlock,affliction,63,25,38
Dirtydeikan,stormrage,1082,warlock,affliction,54,26,28
Yosuljaengi,stormrage,1076,warlock,affliction,42,16,26
Elander,azuremyst,1067,warlock,affliction,30,17,13
Finnek,moon-guard,1064,warlock,affliction,24,12,12
Päinoth,wyrmrest-accord,1059,warlock,affliction,24,15,9
Swinefrommud,zuljin,1056,warlock,affliction,24,11,13
Varvanta,proudmoore,1051,warlock,affliction,30,11,19
Beitrice,barthilas,1050,warlock,affliction,30,11,19
Naburn,tichondrius,1049,warlock,affliction,24,11,13
Guacamolock,drakkari,1045,warlock,affliction,24,11,13
Cozu,tichondrius,1045,warlock,affliction,30,11,19
Nazrakin,malganis,1042,warlock,affliction,24,11,13
Mangku,frostmourne,1042,warlock,affliction,46,19,27
Kimis,proudmoore,1042,warlock,affliction,30,11,19
Teaset,hellscream,1039,warlock,affliction,66,33,33
Rorrlex,muradin,1037,warlock,affliction,42,20,22
Kokoto,azralon,1030,warlock,affliction,54,31,23
Basticor,moon-guard,1024,warlock,affliction,42,18,24
Aerozyn,wyrmrest-accord,1013,warlock,affliction,30,17,13
Corvos,garrosh,1001,warlock,affliction,32,12,20
Wizlox,illidan,996,warlock,affliction,33,11,22
Miredö,tichondrius,991,warlock,affliction,17,11,6
Whydemono,tichondrius,982,warlock,affliction,26,11,15
Sîthfu,tichondrius,969,warlock,affliction,29,11,18
Medran,azralon,966,warlock,affliction,56,30,26
Avelmi,daggerspine,964,warlock,affliction,31,11,20
Niubeelol,tichondrius,959,warlock,affliction,24,10,14
Shadowhax,area-52,959,warlock,affliction,24,10,14
Wtb,blackrock,958,warlock,affliction,18,10,8
Makumbeiro,sargeras,958,warlock,affliction,18,10,8
Downing,drakkari,958,warlock,affliction,71,26,45
Xdq,malganis,957,warlock,affliction,27,12,15
Mothapucka,thrall,955,warlock,affliction,24,10,14
Mysoultotake,sargeras,954,warlock,affliction,18,10,8
Acceptdeath,stormrage,954,warlock,affliction,18,10,8
Munch,khadgar,954,warlock,affliction,24,10,14
Jennifear,sargeras,952,warlock,affliction,18,10,8
Doombaby,zuljin,952,warlock,affliction,18,10,8
Shadöwdancer,uldum,943,warlock,affliction,18,12,6
Avadakedávra,darkspear,941,warlock,affliction,18,10,8
Donnellus,frostmane,916,warlock,affliction,18,10,8
Popdotdropit,frostwolf,895,warlock,affliction,17,10,7
Britainwl,azshara,892,warlock,affliction,30,13,17
Sammythebull,frostwolf,880,warlock,affliction,20,10,10
Quitxman,tichondrius,864,warlock,affliction,12,9,3
Nöxïöüs,sargeras,864,warlock,affliction,12,9,3
Crayonchewer,alleria,864,warlock,affliction,18,9,9
Minglocked,proudmoore,864,warlock,affliction,18,9,9
Jfet,sargeras,864,warlock,affliction,18,9,9
Demonycc,archimonde,863,warlock,affliction,12,9,3
Halloweèn,kelthuzad,863,warlock,affliction,12,9,3
Sslock,sargeras,863,warlock,affliction,18,9,9
Twilson,moon-guard,863,warlock,affliction,18,9,9
Búmchúm,frostmourne,863,warlock,affliction,18,9,9
Gateor,zuljin,863,warlock,affliction,18,9,9
Onmyioji,dalaran,862,warlock,affliction,12,9,3
Curaven,emerald-dream,862,warlock,affliction,18,9,9
Scarysherri,aggramar,862,warlock,affliction,24,9,15
Vardros,moon-guard,862,warlock,affliction,24,9,15
Thisist,kiljaeden,861,warlock,affliction,12,9,3
Nestpas,tichondrius,861,warlock,affliction,18,9,9
Côp,tichondrius,861,warlock,affliction,18,9,9
Vyntras,kelthuzad,861,warlock,affliction,18,9,9
Bignoselock,illidan,861,warlock,affliction,18,9,9
Avatar,uldum,861,warlock,affliction,24,9,15
Abyssisle,malygos,860,warlock,affliction,20,10,10
Holloch,bonechewer,860,warlock,affliction,18,9,9
Sylencia,demon-soul,859,warlock,affliction,24,9,15
Yratiprocs,ysera,853,warlock,affliction,18,9,9
Hungovermate,barthilas,851,warlock,affliction,12,9,3
Obertito,kelthuzad,828,warlock,affliction,16,9,7
Rickrock,gnomeregan,806,warlock,affliction,26,10,16
Buccs,barthilas,799,warlock,affliction,11,9,2
Hexxüs,area-52,784,warlock,affliction,19,9,10
Slothdots,tichondrius,768,warlock,affliction,12,8,4
Kåléïðøsçøpè,sargeras,768,warlock,affliction,12,8,4
Sadoldman,malganis,768,warlock,affliction,12,8,4
Hutchyw,tichondrius,768,warlock,affliction,12,8,4
Guldåniel,tichondrius,768,warlock,affliction,12,8,4
Wreckquiem,draka,767,warlock,affliction,12,8,4
Herladytha,aegwynn,767,warlock,affliction,12,8,4
Juleno,quelthalas,767,warlock,affliction,12,8,4
Necroñomicon,malganis,767,warlock,affliction,12,8,4
Livingdead,dreadmaul,767,warlock,affliction,12,8,4
Losecontrol,illidan,767,warlock,affliction,12,8,4
Mattypatty,the-forgotten-coast,767,warlock,affliction,18,8,10
Eastwitch,ragnaros,767,warlock,affliction,18,8,10
Yeepzbytre,bleeding-hollow,767,warlock,affliction,18,8,10
Oblivious,firetree,767,warlock,affliction,18,8,10
Arkterris,doomhammer,766,warlock,affliction,18,8,10
Flixon,tichondrius,765,warlock,affliction,12,8,4
Çheesestick,dalaran,765,warlock,affliction,18,8,10
Oreo,velen,765,warlock,affliction,24,8,16
Aksness,stormrage,765,warlock,affliction,24,8,16
Dowglips,area-52,763,warlock,affliction,18,8,10
Fearocity,argent-dawn,763,warlock,affliction,18,8,10
Cássandra,ragnaros,761,warlock,affliction,12,8,4
Covidkillerr,tichondrius,759,warlock,affliction,13,8,5
Rotfull,burning-legion,751,warlock,affliction,17,8,9
Hiddentech,saurfang,719,warlock,affliction,11,8,3
Darkestholy,illidan,719,warlock,affliction,17,8,9
Apéx,frostmourne,716,warlock,affliction,17,8,9
Amgs,frostmourne,714,warlock,affliction,23,11,12
Nuckz,whisperwind,687,warlock,affliction,14,9,5
Modot,tichondrius,685,warlock,affliction,23,9,14
Ellneggro,zuljin,672,warlock,affliction,12,7,5
Nightkiss,sargeras,672,warlock,affliction,12,7,5
Bakko,tichondrius,672,warlock,affliction,12,7,5
Înfy,sargeras,672,warlock,affliction,12,7,5
Grimdreams,malganis,672,warlock,affliction,13,7,6
Necromâncer,stormreaver,672,warlock,affliction,18,7,11
Soloart,tichondrius,672,warlock,affliction,18,7,11
Killhorde,thunderlord,671,warlock,affliction,12,7,5
Zurp,wyrmrest-accord,671,warlock,affliction,12,7,5
Benafflock,kaelthas,671,warlock,affliction,18,7,11
Jìbril,stormrage,671,warlock,affliction,18,7,11
Skyvre,tichondrius,670,warlock,affliction,12,7,5
Kuoma,boulderfist,670,warlock,affliction,12,7,5
Deusita,kelthuzad,670,warlock,affliction,18,7,11
Magicbones,tichondrius,669,warlock,affliction,15,8,7
Larlock,black-dragonflight,667,warlock,affliction,12,7,5
Ikis,cenarion-circle,666,warlock,affliction,12,7,5
Balmir,tichondrius,658,warlock,affliction,18,7,11
Paparoxy,illidan,623,warlock,affliction,15,8,7
Mustacheguy,tichondrius,620,warlock,affliction,23,7,16
Radiscul,dragonmaw,619,warlock,affliction,17,7,10
Cezarz,tichondrius,592,warlock,affliction,13,7,6
Dlarenn,kelthuzad,576,warlock,affliction,12,6,6
Shadøwy,nemesis,576,warlock,affliction,12,6,6
Løcalplugxø,barthilas,576,warlock,affliction,12,6,6
Sluglishphsh,stormrage,576,warlock,affliction,12,6,6
Justganmore,tichondrius,576,warlock,affliction,12,6,6
Lilcarmy,emerald-dream,576,warlock,affliction,12,6,6
Khil,darkspear,576,warlock,affliction,12,6,6
Arcziz,tichondrius,576,warlock,affliction,12,6,6
Rakshama,chogall,576,warlock,affliction,12,6,6
Nihilus,anvilmar,576,warlock,affliction,12,6,6
Biubius,tichondrius,576,warlock,affliction,12,6,6
Chrishasnen,moon-guard,576,warlock,affliction,12,6,6
Parishiltoon,frostmourne,576,warlock,affliction,12,6,6
Daëmön,stormrage,576,warlock,affliction,12,6,6
Brunemon,proudmoore,576,warlock,affliction,12,6,6
Lokkup,dalaran,576,warlock,affliction,12,6,6
Neevius,barthilas,576,warlock,affliction,12,6,6
Malagas,tichondrius,576,warlock,affliction,12,6,6
Smockalock,proudmoore,575,warlock,affliction,12,6,6
Shadowbo,aggramar,575,warlock,affliction,12,6,6
Gødmôde,tichondrius,575,warlock,affliction,12,6,6
Deatthmoon,stormrage,575,warlock,affliction,12,6,6
Jhop,sargeras,575,warlock,affliction,12,6,6
Valvravé,malganis,575,warlock,affliction,12,6,6
Leroybrown,alterac-mountains,575,warlock,affliction,12,6,6
Infortunium,sargeras,575,warlock,affliction,12,6,6
Kunozonbi,malganis,575,warlock,affliction,12,6,6
Holdmybeard,senjin,575,warlock,affliction,18,6,12
Zuldar,tichondrius,575,warlock,affliction,18,6,12
Bloodybooger,area-52,574,warlock,affliction,12,6,6
Conrii,burning-blade,574,warlock,affliction,18,6,12
Fyahwalka,aggramar,574,warlock,affliction,18,6,12
Sind,garona,573,warlock,affliction,12,6,6
Hâunted,khazgoroth,571,warlock,affliction,12,6,6
Dreadloxx,whisperwind,570,warlock,affliction,12,6,6
Justero,kelthuzad,569,warlock,affliction,12,6,6
Kflexxpt,hydraxis,569,warlock,affliction,12,6,6
Socketriver,bleeding-hollow,568,warlock,affliction,18,6,12
Medallok,laughing-skull,566,warlock,affliction,18,6,12
Gnock,garona,543,warlock,affliction,11,6,5
Markuss,boulderfist,511,warlock,affliction,14,6,8
Dotdoctor,thrall,511,warlock,affliction,16,6,10
Oluluo,andorhal,510,warlock,affliction,8,6,2
Beexy,sargeras,510,warlock,affliction,14,6,8
Satunir,shadowsong,480,warlock,affliction,6,5,1
Ttub,stormrage,480,warlock,affliction,6,5,1
Freddiewill,tichondrius,480,warlock,affliction,6,5,1
Antigotenent,sargeras,480,warlock,affliction,6,5,1
Flòwstate,tichondrius,480,warlock,affliction,6,5,1
Bigdamege,tichondrius,480,warlock,affliction,6,5,1
Albright,azralon,480,warlock,affliction,6,5,1
Ribman,stormrage,480,warlock,affliction,6,5,1
Lunazz,tichondrius,480,warlock,affliction,6,5,1
Berszerk,quelthalas,480,warlock,affliction,12,5,7
Artzul,tichondrius,480,warlock,affliction,12,5,7
Bwup,tichondrius,480,warlock,affliction,12,5,7
Itsmedirt,malganis,480,warlock,affliction,12,5,7
Perfectwar,tichondrius,480,warlock,affliction,12,5,7
Tvfazedorito,kelthuzad,480,warlock,affliction,12,5,7
Buboñic,area-52,480,warlock,affliction,12,5,7
Astralrunner,moon-guard,480,warlock,affliction,12,5,7
Chaoz,aggramar,480,warlock,affliction,12,5,7
Yogurtslingr,tichondrius,480,warlock,affliction,12,5,7
Cryolock,nagrand,480,warlock,affliction,12,5,7
Tsmcfker,tichondrius,480,warlock,affliction,12,5,7
Balveer,tichondrius,480,warlock,affliction,12,5,7
Disneytoon,moon-guard,480,warlock,affliction,12,5,7
Idotû,tichondrius,480,warlock,affliction,12,5,7
Necrosith,ragnaros,480,warlock,affliction,15,6,9
Lockring,zuljin,480,warlock,affliction,18,5,13
Lockboxx,stormscale,480,warlock,affliction,18,5,13
Daesire,moon-guard,480,warlock,affliction,18,5,13
Pruevolf,tichondrius,479,warlock,affliction,12,5,7
Morepetss,saurfang,479,warlock,affliction,12,5,7
Hélà,sargeras,479,warlock,affliction,18,5,13
Whitchpoison,nagrand,479,warlock,affliction,30,5,25
Dravin,alleria,478,warlock,affliction,12,5,7
Cityswimmer,malganis,478,warlock,affliction,12,5,7
Skellisama,moon-guard,478,warlock,affliction,12,5,7
Fearfactory,lethon,478,warlock,affliction,12,5,7
Redbro,darkspear,478,warlock,affliction,12,5,7
Suzüki,tichondrius,463,warlock,affliction,11,5,6
Demfearslol,terokkar,447,warlock,affliction,11,5,6
Baiano,nagrand,447,warlock,affliction,22,5,17
Verrøkel,sargeras,426,warlock,affliction,11,7,4
Felegance,proudmoore,426,warlock,affliction,19,6,13
Fublizz,black-dragonflight,416,warlock,affliction,10,5,5
Khaozx,ragnaros,416,warlock,affliction,10,5,5
Onlytoez,tichondrius,416,warlock,affliction,16,5,11
Åbyssal,stormrage,384,warlock,affliction,6,4,2
Rbnz,kiljaeden,384,warlock,affliction,6,4,2
Demoiceman,bleeding-hollow,384,warlock,affliction,6,4,2
Djminuterice,bleeding-hollow,384,warlock,affliction,6,4,2
Omegapasta,illidan,384,warlock,affliction,6,4,2
Plsdontcrit,tichondrius,384,warlock,affliction,6,4,2
Bliztivision,proudmoore,384,warlock,affliction,6,4,2
Hypnotikal,illidan,384,warlock,affliction,6,4,2
Methrocks,tichondrius,384,warlock,affliction,6,4,2
Jessndistres,stormrage,384,warlock,affliction,6,4,2
Locker,darkspear,384,warlock,affliction,6,4,2
Tylandér,nordrassil,384,warlock,affliction,6,4,2
Mèsut,malganis,384,warlock,affliction,6,4,2
Superbroly,area-52,384,warlock,affliction,6,4,2
Aroug,aggramar,384,warlock,affliction,6,4,2
Blliizz,aegwynn,384,warlock,affliction,6,4,2
Soulrman,tichondrius,384,warlock,affliction,6,4,2
Bänno,bleeding-hollow,384,warlock,affliction,6,4,2
Kryllua,tichondrius,384,warlock,affliction,6,4,2
Eupheriia,thaurissan,384,warlock,affliction,6,4,2
Astarõth,zuljin,384,warlock,affliction,6,4,2
Celin,rivendare,384,warlock,affliction,6,4,2
Tonickush,area-52,384,warlock,affliction,6,4,2
Ãids,khadgar,384,warlock,affliction,6,4,2
Gasgrassnass,sargeras,384,warlock,affliction,6,4,2
Infecçäo,stormrage,384,warlock,affliction,6,4,2
Jotkbe,ragnaros,384,warlock,affliction,6,4,2
Omleaf,malganis,384,warlock,affliction,6,4,2
Cowboydann,malganis,384,warlock,affliction,6,4,2
Walterrør,nemesis,384,warlock,affliction,6,4,2
Necroraise,boulderfist,384,warlock,affliction,9,5,4
Bmó,stormrage,384,warlock,affliction,12,4,8
Emptyx,tichondrius,384,warlock,affliction,12,4,8
Promancer,drakkari,384,warlock,affliction,12,4,8
Fksm,tichondrius,384,warlock,affliction,12,4,8
Nethron,the-venture-co,384,warlock,affliction,12,4,8
Fearedit,bleeding-hollow,384,warlock,affliction,12,4,8
Pauldiesel,ragnaros,384,warlock,affliction,12,4,8
Bharim,quelthalas,384,warlock,affliction,12,4,8
Dotsfìred,tichondrius,384,warlock,affliction,12,4,8
Emptysoul,illidan,384,warlock,affliction,12,4,8
Yagumi,crushridge,384,warlock,affliction,12,4,8
Punstable,tichondrius,384,warlock,affliction,12,4,8
Tichonkimc,tichondrius,384,warlock,affliction,12,4,8
Bïcho,queldorei,384,warlock,affliction,12,4,8
Lockie,skywall,384,warlock,affliction,12,4,8
Duckboji,tichondrius,384,warlock,affliction,12,4,8
Asetiks,tichondrius,384,warlock,affliction,12,4,8
Necromaniac,nerzhul,384,warlock,affliction,18,4,14
Saltyfries,wildhammer,384,warlock,affliction,18,4,14
Lockazo,quelthalas,383,warlock,affliction,6,4,2
Krïttzïe,proudmoore,383,warlock,affliction,6,4,2
Mefound,nerzhul,383,warlock,affliction,6,4,2
Wirthless,area-52,383,warlock,affliction,12,4,8
Luciffer,windrunner,383,warlock,affliction,12,4,8
Persianloc,tichondrius,383,warlock,affliction,12,4,8
Darkdestine,emerald-dream,382,warlock,affliction,12,4,8
Chadre,feathermoon,351,warlock,affliction,11,4,7
Damint,sargeras,351,warlock,affliction,11,4,7
Gattsonn,kiljaeden,350,warlock,affliction,12,5,7
Yury,scarlet-crusade,334,warlock,affliction,11,4,7
Maelganis,thrall,319,warlock,affliction,11,4,7
Devdolittle,tichondrius,288,warlock,affliction,6,3,3
Yanlexx,stormrage,288,warlock,affliction,6,3,3
Crucifieds,tichondrius,288,warlock,affliction,6,3,3
Impbiscuit,stormrage,288,warlock,affliction,6,3,3
Fatherbolt,tichondrius,288,warlock,affliction,6,3,3
Dotfearspam,alterac-mountains,288,warlock,affliction,6,3,3
Abrocket,alleria,288,warlock,affliction,6,3,3
Dotymania,aegwynn,288,warlock,affliction,6,3,3
Chåndler,nemesis,288,warlock,affliction,6,3,3
Redsolojdc,tichondrius,288,warlock,affliction,6,3,3
Berathelok,aerie-peak,288,warlock,affliction,6,3,3
Schofen,tichondrius,288,warlock,affliction,6,3,3
Blockk,moknathal,288,warlock,affliction,6,3,3
Diablox,silvermoon,288,warlock,affliction,6,3,3
Warlockmf,sargeras,288,warlock,affliction,6,3,3
Phishdots,tichondrius,288,warlock,affliction,6,3,3
Chaôtic,daggerspine,288,warlock,affliction,6,3,3
Lockfold,illidan,288,warlock,affliction,6,3,3
Kamai,frostwolf,288,warlock,affliction,6,3,3
Leônidos,ghostlands,288,warlock,affliction,6,3,3
Knäbue,tichondrius,288,warlock,affliction,6,3,3
Voltshot,tichondrius,288,warlock,affliction,6,3,3
Datazdotcom,illidan,288,warlock,affliction,6,3,3
Hauntu,stormreaver,288,warlock,affliction,6,3,3
Róckroad,lightnings-blade,288,warlock,affliction,6,3,3
Stepzxo,sargeras,288,warlock,affliction,6,3,3
Emurog,icecrown,288,warlock,affliction,6,3,3
Drdoom,sargeras,288,warlock,affliction,6,3,3
Dötsonurpp,stormrage,288,warlock,affliction,6,3,3
Capïrota,nemesis,288,warlock,affliction,6,3,3
Nutzosaurus,darkspear,288,warlock,affliction,6,3,3
Oogren,korgath,288,warlock,affliction,6,3,3
Nozyroh,emerald-dream,288,warlock,affliction,6,3,3
Hauntx,bonechewer,288,warlock,affliction,6,3,3
Freseate,quelthalas,288,warlock,affliction,6,3,3
Dodgebolts,khaz-modan,288,warlock,affliction,6,3,3
Lockinha,azralon,288,warlock,affliction,6,3,3
Sidiouss,dreadmaul,288,warlock,affliction,6,3,3
Bajheerafan,illidan,288,warlock,affliction,6,3,3
Arnan,korgath,288,warlock,affliction,6,3,3
Muchø,emerald-dream,288,warlock,affliction,6,3,3
Warfeen,malganis,288,warlock,affliction,6,3,3
Harleyjames,ravenholdt,288,warlock,affliction,6,3,3
Alarauca,nerzhul,288,warlock,affliction,6,3,3
Sinaman,barthilas,288,warlock,affliction,6,3,3
Wizie,arthas,288,warlock,affliction,6,3,3
Eilethen,cenarion-circle,288,warlock,affliction,6,3,3
Goldface,frostmourne,288,warlock,affliction,6,3,3
Kokushu,burning-legion,288,warlock,affliction,6,3,3
Brujoalfa,ragnaros,288,warlock,affliction,6,3,3
Imien,moknathal,288,warlock,affliction,9,3,6
Camila,lightnings-blade,288,warlock,affliction,12,3,9
Miermortal,tichondrius,288,warlock,affliction,12,3,9
Grendaldots,tichondrius,288,warlock,affliction,12,3,9
Mynerve,velen,288,warlock,affliction,12,3,9
Ezzako,area-52,288,warlock,affliction,12,3,9
Aluridan,azralon,288,warlock,affliction,12,3,9
Felno,emerald-dream,288,warlock,affliction,12,3,9
Ÿoucantwin,kiljaeden,288,warlock,affliction,12,3,9
Lithani,ragnaros,288,warlock,affliction,12,3,9
Castshadow,nordrassil,288,warlock,affliction,18,3,15
Nhen,daggerspine,287,warlock,affliction,6,3,3
Lowkei,stonemaul,286,warlock,affliction,6,3,3
Lilthicy,sargeras,271,warlock,affliction,14,3,11
Kentus,moonrunner,255,warlock,affliction,14,4,10
Niava,tichondrius,239,warlock,affliction,5,3,2
Matzoball,zuljin,234,warlock,affliction,14,4,10
Hoana,azralon,233,warlock,affliction,8,4,4
Lifelock,auchindoun,223,warlock,affliction,8,3,5
Spookytrev,stormrage,223,warlock,affliction,14,3,11
Kuroyt,drakkari,192,warlock,affliction,4,3,1
Leruss,zangarmarsh,192,warlock,affliction,6,2,4
Nerolock,frostmourne,192,warlock,affliction,6,2,4
Nightterrour,frostmourne,192,warlock,affliction,6,2,4
Yurick,frostmourne,192,warlock,affliction,6,2,4
Sâltylôck,tichondrius,192,warlock,affliction,6,2,4
Karmalock,malganis,192,warlock,affliction,6,2,4
Jèdi,drenden,192,warlock,affliction,6,2,4
Scepti,area-52,192,warlock,affliction,6,2,4
Dawaatisme,zuljin,192,warlock,affliction,6,2,4
Ministàff,ursin,192,warlock,affliction,6,2,4
Sylorelol,stormreaver,192,warlock,affliction,6,2,4
Døtyou,area-52,192,warlock,affliction,6,2,4
Anastadora,proudmoore,192,warlock,affliction,6,2,4
Xoxoxu,frostmourne,192,warlock,affliction,6,2,4
Abomasnow,frostmourne,192,warlock,affliction,6,2,4
Apolodys,garona,192,warlock,affliction,6,2,4
Glifosáto,quelthalas,192,warlock,affliction,6,2,4
Meelady,tichondrius,192,warlock,affliction,6,2,4
Zörkô,zuljin,192,warlock,affliction,6,2,4
Yyoyo,tichondrius,192,warlock,affliction,6,2,4
Critthis,illidan,192,warlock,affliction,6,2,4
Sosomaa,kelthuzad,192,warlock,affliction,6,2,4
Trillas,illidan,192,warlock,affliction,6,2,4
Bigheadjr,gorgonnash,192,warlock,affliction,6,2,4
Charmandfarm,nerzhul,192,warlock,affliction,6,2,4
Yolandahadid,gilneas,192,warlock,affliction,6,2,4
Es,velen,192,warlock,affliction,6,2,4
Gianni,chogall,192,warlock,affliction,6,2,4
Vorlos,bonechewer,192,warlock,affliction,6,2,4
Cheesëbolt,illidan,192,warlock,affliction,6,2,4
Pk,azralon,192,warlock,affliction,6,2,4
Dotdottgoose,kiljaeden,192,warlock,affliction,6,2,4
Salival,chogall,192,warlock,affliction,6,2,4
Jacorian,illidan,192,warlock,affliction,6,2,4
Catarina,kaelthas,192,warlock,affliction,6,2,4
Grixis,zuluhed,192,warlock,affliction,6,2,4
Thralord,blackrock,192,warlock,affliction,6,2,4
Dejagu,tichondrius,192,warlock,affliction,6,2,4
Plaguedoctor,stormrage,192,warlock,affliction,6,2,4
Willogan,gurubashi,192,warlock,affliction,6,2,4
Ðeãdman,bleeding-hollow,192,warlock,affliction,6,2,4
Zeraedify,bleeding-hollow,192,warlock,affliction,6,2,4
Sebss,proudmoore,192,warlock,affliction,6,2,4
Lockednloade,tichondrius,192,warlock,affliction,6,2,4
Vessires,darkspear,192,warlock,affliction,6,2,4
Damerus,illidan,192,warlock,affliction,6,2,4
Khurze,area-52,192,warlock,affliction,6,2,4
Screwed,tichondrius,192,warlock,affliction,6,2,4
Destructo,illidan,192,warlock,affliction,6,2,4
Fearanddots,moon-guard,192,warlock,affliction,6,2,4
Carcine,frostwolf,192,warlock,affliction,6,2,4
Asmodeun,malganis,192,warlock,affliction,6,2,4
Kreatur,ragnaros,192,warlock,affliction,6,2,4
Avii,drakthul,192,warlock,affliction,6,2,4
Thoxy,barthilas,192,warlock,affliction,6,2,4
Deanwarlock,sargeras,192,warlock,affliction,6,2,4
Fondlemydot,stormscale,192,warlock,affliction,6,2,4
Tribulatiön,moon-guard,192,warlock,affliction,12,2,10
Leviathen,shattered-hand,192,warlock,affliction,12,2,10
Tormentedcat,nazjatar,192,warlock,affliction,12,2,10
Refîk,sargeras,192,warlock,affliction,12,2,10
Dloq,azgalor,192,warlock,affliction,12,2,10
Rurnt,bloodhoof,192,warlock,affliction,13,2,11
Lilliara,korgath,159,warlock,affliction,5,2,3
Ramone,turalyon,159,warlock,affliction,5,2,3
Babydots,stormreaver,159,warlock,affliction,5,2,3
Dotlockndrop,stormreaver,159,warlock,affliction,5,2,3
Volturnus,wildhammer,96,warlock,affliction,6,1,5
Efg,illidan,96,warlock,affliction,6,1,5
Drainedd,blades-edge,96,warlock,affliction,6,1,5
Sikmagic,kelthuzad,96,warlock,affliction,6,1,5
Fabiusbilex,tichondrius,96,warlock,affliction,6,1,5
Tatemor,barthilas,96,warlock,affliction,6,1,5
Malignant,tichondrius,96,warlock,affliction,6,1,5
Imhereforrbg,moon-guard,96,warlock,affliction,6,1,5
Conspiration,sargeras,96,warlock,affliction,6,1,5
Aerumna,barthilas,96,warlock,affliction,6,1,5
Xylõck,sargeras,96,warlock,affliction,6,1,5
Menedemus,amanthul,96,warlock,affliction,6,1,5
Bluffzlock,boulderfist,96,warlock,affliction,6,1,5
Gamecobra,greymane,96,warlock,affliction,6,1,5
Pinkypay,ragnaros,96,warlock,affliction,6,1,5
Sunkuna,aerie-peak,96,warlock,affliction,6,1,5
Feár,emerald-dream,96,warlock,affliction,6,1,5
Apocryphh,stormrage,96,warlock,affliction,6,1,5
Malchiev,area-52,96,warlock,affliction,6,1,5
Superbvious,lothar,96,warlock,affliction,6,1,5
Shennaniganz,bleeding-hollow,96,warlock,affliction,6,1,5
Frem,eonar,96,warlock,affliction,6,1,5
Frdchickiana,tichondrius,96,warlock,affliction,6,1,5
Mickylock,tichondrius,96,warlock,affliction,6,1,5
Kammuany,sargeras,96,warlock,affliction,6,1,5
Cornboil,tichondrius,96,warlock,affliction,6,1,5
Aedarine,uldum,96,warlock,affliction,6,1,5
Joseph,draktharon,96,warlock,affliction,6,1,5
Carabelois,aegwynn,96,warlock,affliction,6,1,5
Smôkedsôul,area-52,96,warlock,affliction,6,1,5
Chaøsbolt,area-52,96,warlock,affliction,6,1,5
Brujildå,area-52,96,warlock,affliction,6,1,5
Guinegobbler,hyjal,96,warlock,affliction,6,1,5
Olgreg,daggerspine,96,warlock,affliction,6,1,5
Fenrinozil,tichondrius,96,warlock,affliction,12,1,11
Shendù,stormrage,79,warlock,affliction,5,1,4
Zuelu,tichondrius,64,warlock,affliction,4,1,3
Mìrä,kelthuzad,48,warlock,affliction,3,1,2
Delete,greymane,16,warlock,affliction,1,1,0
Marinw,azralon,16,warlock,affliction,1,1,0
Ttvdjrio,area-52,2200,warrior,fury,84,54,30
Grimgrip,frostmane,2131,warrior,fury,92,53,39
Joshiman,area-52,2124,warrior,fury,78,42,36
Cabelastwo,tichondrius,2124,warrior,fury,87,46,41
Americanbull,moon-guard,2119,warrior,fury,253,134,119
Cabelas,tichondrius,2112,warrior,fury,89,45,44
Thrator,wyrmrest-accord,2110,warrior,fury,108,55,53
Riproarin,stormrage,2105,warrior,fury,92,53,39
Gazzef,thrall,2041,warrior,fury,102,57,45
Coldlòve,akama,2039,warrior,fury,76,45,31
Veevz,proudmoore,2037,warrior,fury,78,35,43
Braxxínn,tichondrius,2023,warrior,fury,42,34,8
Sworda,sargeras,2017,warrior,fury,77,48,29
Taras,blackhand,2006,warrior,fury,93,43,50
Warqt,kelthuzad,1983,warrior,fury,89,49,40
Lahired,drakkari,1967,warrior,fury,185,91,94
Wienertoes,tichondrius,1963,warrior,fury,114,63,51
Ragwreck,bleeding-hollow,1959,warrior,fury,68,35,33
Sandronb,illidan,1938,warrior,fury,83,41,42
Eno,ragnaros,1937,warrior,fury,69,46,23
Alabamá,sargeras,1925,warrior,fury,36,21,15
Furrytakeda,kelthuzad,1925,warrior,fury,72,39,33
Biaa,tichondrius,1922,warrior,fury,60,28,32
Vèév,proudmoore,1894,warrior,fury,62,41,21
Mphx,tichondrius,1888,warrior,fury,48,30,18
Rôxi,malganis,1884,warrior,fury,142,74,68
Brodestar,sargeras,1874,warrior,fury,48,31,17
Badvelic,tichondrius,1874,warrior,fury,46,28,18
Zanzaa,sargeras,1870,warrior,fury,85,47,38
Hlt,tichondrius,1869,warrior,fury,66,38,28
Shîzu,moon-guard,1868,warrior,fury,102,67,35
Cannabiddies,illidan,1860,warrior,fury,48,23,25
Damonadrann,proudmoore,1859,warrior,fury,66,34,32
Dowser,goldrinn,1852,warrior,fury,131,69,62
Okme,tichondrius,1849,warrior,fury,60,34,26
Kevy,arygos,1848,warrior,fury,42,30,12
Ragemane,illidan,1841,warrior,fury,72,39,33
Larrybiscuit,moon-guard,1839,warrior,fury,156,95,61
Esilox,area-52,1836,warrior,fury,42,28,14
Ethyrie,ragnaros,1836,warrior,fury,61,34,27
Jenjang,proudmoore,1834,warrior,fury,83,52,31
Brainhaze,tichondrius,1829,warrior,fury,36,21,15
Ragwreckz,bleeding-hollow,1826,warrior,fury,52,32,20
Soymong,frostmourne,1825,warrior,fury,116,74,42
Mty,tichondrius,1824,warrior,fury,54,35,19
Szauren,stormrage,1824,warrior,fury,63,31,32
Apocalyptist,stormrage,1821,warrior,fury,99,58,41
Thadamaja,kiljaeden,1821,warrior,fury,48,26,22
Bosswin,tichondrius,1820,warrior,fury,53,28,25
Skyja,quelthalas,1820,warrior,fury,42,22,20
Gorehardt,illidan,1820,warrior,fury,48,22,26
Veyrin,stormrage,1818,warrior,fury,138,81,57
Isahri,moon-guard,1818,warrior,fury,110,64,46
Orchilles,illidan,1817,warrior,fury,60,35,25
Damiansuv,moon-guard,1817,warrior,fury,154,89,65
Jírky,ragnaros,1816,warrior,fury,240,134,106
Zujuzo,moon-guard,1815,warrior,fury,111,64,47
Neôn,frostmourne,1815,warrior,fury,66,37,29
Onionsauce,frostmourne,1815,warrior,fury,161,90,71
Slughorn,moon-guard,1814,warrior,fury,102,53,49
Kazora,zuljin,1813,warrior,fury,48,33,15
Darkduke,tichondrius,1813,warrior,fury,33,21,12
Donutwar,proudmoore,1813,warrior,fury,54,30,24
Duxor,sargeras,1811,warrior,fury,70,41,29
Barafang,wyrmrest-accord,1811,warrior,fury,234,125,109
Kennäy,azralon,1810,warrior,fury,46,28,18
Psychogenic,barthilas,1810,warrior,fury,102,60,42
Zyzz,scarlet-crusade,1807,warrior,fury,72,41,31
Killuall,sargeras,1807,warrior,fury,42,23,19
Yawdamper,illidan,1805,warrior,fury,51,32,19
Starshattr,bleeding-hollow,1805,warrior,fury,108,64,44
Seoní,wyrmrest-accord,1805,warrior,fury,76,43,33
Girioo,thrall,1802,warrior,fury,24,19,5
Franticlol,tichondrius,1802,warrior,fury,90,59,31
Cubie,malganis,1802,warrior,fury,75,40,35
Tøpg,sargeras,1801,warrior,fury,55,32,23
Burger,the-underbog,1800,warrior,fury,24,19,5
Gooberbear,frostmourne,1791,warrior,fury,139,78,61
Melifehorde,tichondrius,1790,warrior,fury,222,111,111
Jimjinjin,tichondrius,1784,warrior,fury,78,39,39
Rekatron,area-52,1783,warrior,fury,49,25,24
Sàndman,malganis,1775,warrior,fury,39,23,16
ßdm,illidan,1775,warrior,fury,42,21,21
Choppiechop,area-52,1763,warrior,fury,42,26,16
Rynkae,moon-guard,1762,warrior,fury,36,20,16
Guerreraa,ragnaros,1755,warrior,fury,65,34,31
Chopped,wyrmrest-accord,1750,warrior,fury,93,43,50
Bulgrim,moon-guard,1748,warrior,fury,78,41,37
Alarìon,malganis,1745,warrior,fury,45,31,14
Velarrine,illidan,1745,warrior,fury,103,58,45
Eazyc,tichondrius,1741,warrior,fury,60,28,32
Illaedan,quelthalas,1740,warrior,fury,65,32,33
Käggai,khadgar,1739,warrior,fury,83,46,37
Coldshots,stormreaver,1736,warrior,fury,66,41,25
Dripgodx,malganis,1736,warrior,fury,54,30,24
Ágsgøðx,bleeding-hollow,1736,warrior,fury,126,67,59
Blgjb,tichondrius,1733,warrior,fury,72,32,40
Ðåddý,stormrage,1732,warrior,fury,131,68,63
Mchamstring,stormrage,1731,warrior,fury,39,22,17
Invinciblé,tichondrius,1730,warrior,fury,36,22,14
Beanstrom,tichondrius,1729,warrior,fury,77,39,38
Escånor,moon-guard,1728,warrior,fury,25,19,6
Akaínu,area-52,1728,warrior,fury,48,27,21
Daedrion,dalaran,1726,warrior,fury,66,37,29
Splasch,kelthuzad,1725,warrior,fury,59,26,33
Bigdude,frostwolf,1721,warrior,fury,48,24,24
Slamurai,moon-guard,1719,warrior,fury,24,18,6
Duochuanjun,illidan,1719,warrior,fury,48,26,22
Cleavxy,sargeras,1715,warrior,fury,42,27,15
Maximad,moon-guard,1714,warrior,fury,84,43,41
Bigfatork,area-52,1712,warrior,fury,88,43,45
Zuggrok,zuljin,1708,warrior,fury,148,75,73
Riggs,stonemaul,1706,warrior,fury,59,32,27
Oddyseey,moon-guard,1706,warrior,fury,54,27,27
Warroiser,quelthalas,1705,warrior,fury,135,73,62
Shadax,bleeding-hollow,1703,warrior,fury,146,77,69
Mochigome,moon-guard,1696,warrior,fury,97,49,48
Scolpi,stormrage,1695,warrior,fury,76,42,34
Kholusia,kul-tiras,1695,warrior,fury,136,67,69
Killbørn,azralon,1694,warrior,fury,30,20,10
Onîkudakì,sargeras,1689,warrior,fury,91,55,36
Eggroll,emerald-dream,1689,warrior,fury,144,80,64
Mulish,frostmourne,1681,warrior,fury,67,40,27
Ðowser,area-52,1680,warrior,fury,24,18,6
Scrotedog,area-52,1680,warrior,fury,55,24,31
Tyroe,thunderhorn,1679,warrior,fury,36,22,14
Ashwalker,malganis,1677,warrior,fury,38,24,14
Chillawigs,kelthuzad,1676,warrior,fury,42,26,16
Torbajhorn,moon-guard,1676,warrior,fury,66,34,32
Fearless,moon-guard,1675,warrior,fury,126,68,58
Thugdorr,sargeras,1675,warrior,fury,102,53,49
Aotha,moon-guard,1674,warrior,fury,26,18,8
Morfoggore,ragnaros,1673,warrior,fury,55,25,30
Sayjaki,stormrage,1671,warrior,fury,60,35,25
Youaredafeds,moon-guard,1669,warrior,fury,131,75,56
Noramed,moon-guard,1669,warrior,fury,90,50,40
Rendwarchief,garrosh,1668,warrior,fury,145,76,69
Festergrin,area-52,1665,warrior,fury,60,32,28
Drashi,nazjatar,1663,warrior,fury,48,31,17
Moistt,nesingwary,1660,warrior,fury,32,22,10
Alteryx,sargeras,1658,warrior,fury,238,129,109
Gladheateher,bonechewer,1658,warrior,fury,60,28,32
Berawar,tichondrius,1656,warrior,fury,60,31,29
Calder,malganis,1656,warrior,fury,72,36,36
Ggull,tichondrius,1654,warrior,fury,35,19,16
Gnomageddon,anetheron,1653,warrior,fury,82,39,43
Jarheadz,bleeding-hollow,1649,warrior,fury,48,32,16
Baeowar,area-52,1648,warrior,fury,57,28,29
Eggdoubles,sargeras,1647,warrior,fury,33,19,14
Eregor,sargeras,1647,warrior,fury,54,27,27
Ssamba,shattered-hand,1643,warrior,fury,36,20,16
Faren,agamaggan,1643,warrior,fury,167,91,76
Traka,stormrage,1642,warrior,fury,36,19,17
Basedaf,frostmourne,1642,warrior,fury,117,61,56
Mandragorn,kelthuzad,1642,warrior,fury,71,37,34
Lowz,hyjal,1641,warrior,fury,32,23,9
Tádakatsu,sargeras,1640,warrior,fury,147,79,68
Saîyanroyce,barthilas,1638,warrior,fury,36,21,15
Budgetclap,nordrassil,1636,warrior,fury,36,18,18
Dardash,ragnaros,1634,warrior,fury,30,21,9
Getthechoppa,aegwynn,1629,warrior,fury,33,22,11
Kellyboitv,frostmourne,1628,warrior,fury,42,20,22
Hellamoist,tichondrius,1627,warrior,fury,30,18,12
Gûard,stormrage,1627,warrior,fury,85,46,39
Wagù,moon-guard,1626,warrior,fury,30,21,9
Colorx,sargeras,1625,warrior,fury,52,30,22
Ugriker,skullcrusher,1623,warrior,fury,42,26,16
Illmindofpoo,kelthuzad,1620,warrior,fury,24,17,7
Nordama,stormrage,1619,warrior,fury,42,27,15
Ediann,elune,1619,warrior,fury,77,45,32
Keltanas,quelthalas,1618,warrior,fury,89,45,44
Rinima,tichondrius,1616,warrior,fury,72,37,35
Hìm,tichondrius,1616,warrior,fury,36,17,19
Hârambe,kiljaeden,1614,warrior,fury,41,25,16
Ruuthless,sargeras,1614,warrior,fury,75,42,33
Takeda,sargeras,1613,warrior,fury,41,21,20
Zangetsy,sargeras,1612,warrior,fury,87,47,40
Damburga,tichondrius,1609,warrior,fury,48,30,18
Khrull,khazgoroth,1609,warrior,fury,74,40,34
Wrniss,tichondrius,1608,warrior,fury,48,31,17
Leviqt,moon-guard,1606,warrior,fury,36,21,15
Hairygrundel,area-52,1605,warrior,fury,60,34,26
Lilgucci,stonemaul,1602,warrior,fury,36,20,16
Ianprime,the-scryers,1602,warrior,fury,42,23,19
Sperow,malygos,1601,warrior,fury,38,23,15
Soulfang,stormscale,1600,warrior,fury,36,20,16
Brutality,kirin-tor,1598,warrior,fury,107,57,50
Gaazhel,quelthalas,1598,warrior,fury,97,49,48
Wangjianguo,illidan,1597,warrior,fury,35,19,16
Cupper,tichondrius,1597,warrior,fury,41,22,19
Sigiswald,cenarion-circle,1597,warrior,fury,36,19,17
Darkbunny,thaurissan,1597,warrior,fury,78,40,38
Flexid,tichondrius,1597,warrior,fury,80,41,39
Neurötic,ragnaros,1594,warrior,fury,30,20,10
Gigatroll,tichondrius,1592,warrior,fury,59,30,29
Påpi,sargeras,1591,warrior,fury,72,43,29
Nogèt,frostmourne,1591,warrior,fury,41,24,17
Wampzug,azshara,1591,warrior,fury,78,37,41
Koffray,malfurion,1590,warrior,fury,51,26,25
Furíous,thunderhorn,1588,warrior,fury,54,25,29
Hammerock,ragnaros,1587,warrior,fury,35,18,17
Igoboom,bleeding-hollow,1585,warrior,fury,46,25,21
Scrümp,illidan,1583,warrior,fury,37,25,12
Kolosaltwo,tichondrius,1583,warrior,fury,53,27,26
Tanorai,area-52,1582,warrior,fury,42,27,15
Nilah,tichondrius,1582,warrior,fury,36,21,15
Sithlõrd,moon-guard,1580,warrior,fury,60,30,30
Bigßiceps,tichondrius,1579,warrior,fury,36,21,15
Trôca,ragnaros,1575,warrior,fury,48,25,23
Wolfcultist,moon-guard,1572,warrior,fury,117,54,63
Mers,garrosh,1571,warrior,fury,42,24,18
Dann,ragnaros,1569,warrior,fury,59,35,24
Ohdang,dark-iron,1567,warrior,fury,102,58,44
Dwarlan,stormrage,1563,warrior,fury,71,44,27
Romus,spirestone,1562,warrior,fury,42,26,16
Khargrok,ragnaros,1561,warrior,fury,93,53,40
Swiftslaýer,vashj,1558,warrior,fury,53,27,26
Rikbielo,dragonmaw,1554,warrior,fury,67,37,30
Garobber,stormrage,1552,warrior,fury,36,17,19
Stavsie,tichondrius,1548,warrior,fury,35,18,17
Wöûlöû,trollbane,1546,warrior,fury,91,48,43
Morguez,tichondrius,1545,warrior,fury,78,43,35
Sugmad,area-52,1545,warrior,fury,48,22,26
Zuggyboi,moon-guard,1544,warrior,fury,48,25,23
Raggnarsøøn,ragnaros,1543,warrior,fury,101,47,54
Easons,tichondrius,1540,warrior,fury,59,25,34
Pootyspootz,warsong,1536,warrior,fury,47,28,19
Iceice,dalaran,1535,warrior,fury,70,35,35
Impalle,nazjatar,1531,warrior,fury,54,33,21
Philsbbqnow,dark-iron,1525,warrior,fury,24,16,8
Tctc,emerald-dream,1524,warrior,fury,41,22,19
Cohëëd,kelthuzad,1523,warrior,fury,119,64,55
Daelganis,blood-furnace,1523,warrior,fury,42,21,21
Zombad,azralon,1522,warrior,fury,30,18,12
Warrmachine,mannoroth,1520,warrior,fury,132,75,57
Crohdey,madoran,1519,warrior,fury,120,65,55
Abomlnatlon,tichondrius,1517,warrior,fury,60,34,26
Invdeath,azralon,1517,warrior,fury,46,23,23
Zitfrlt,wildhammer,1515,warrior,fury,87,39,48
Playbox,area-52,1514,warrior,fury,83,37,46
Fearlessxq,tichondrius,1512,warrior,fury,106,59,47
Mytharion,sargeras,1511,warrior,fury,30,18,12
Linker,ragnaros,1511,warrior,fury,42,25,17
Shibaraku,tichondrius,1511,warrior,fury,263,125,138
Hoodlark,lightbringer,1509,warrior,fury,42,24,18
Machomanran,zuljin,1509,warrior,fury,89,47,42
Jorked,drakkari,1509,warrior,fury,68,35,33
Mayonnaise,ragnaros,1509,warrior,fury,36,18,18
Dcashmoney,moon-guard,1508,warrior,fury,59,33,26
Benchpress,bleeding-hollow,1508,warrior,fury,60,30,30
Rücküs,tichondrius,1506,warrior,fury,74,45,29
Tinyexcute,tichondrius,1506,warrior,fury,30,16,14
Bestgrunt,tichondrius,1504,warrior,fury,96,45,51
Fearlessly,moon-guard,1503,warrior,fury,130,69,61
Anandamide,frostwolf,1503,warrior,fury,51,27,24
Gorrtog,stormrage,1502,warrior,fury,147,71,76
Grômm,tichondrius,1500,warrior,fury,63,33,30
Brøsk,azralon,1500,warrior,fury,48,24,24
Nimna,moon-guard,1499,warrior,fury,59,29,30
Andorane,bleeding-hollow,1499,warrior,fury,42,19,23
Stoopkid,uldum,1494,warrior,fury,52,26,26
Varith,sargeras,1493,warrior,fury,54,26,28
Arágorn,sargeras,1490,warrior,fury,30,18,12
Albinosword,azralon,1488,warrior,fury,74,37,37
Commandó,proudmoore,1487,warrior,fury,59,37,22
Viagraliker,tichondrius,1487,warrior,fury,63,37,26
Shádo,darkspear,1485,warrior,fury,36,23,13
Rafurk,area-52,1483,warrior,fury,30,18,12
Ronok,ghostlands,1481,warrior,fury,42,26,16
Know,anetheron,1480,warrior,fury,39,25,14
Ikoré,saurfang,1480,warrior,fury,81,44,37
Ragnararagor,ragnaros,1480,warrior,fury,251,124,127
Genrÿuusai,azralon,1478,warrior,fury,35,19,16
Lavablood,moon-guard,1478,warrior,fury,48,22,26
Himiko,kaelthas,1476,warrior,fury,45,23,22
Zareshi,sargeras,1474,warrior,fury,134,70,64
Karusuke,stormrage,1472,warrior,fury,36,21,15
Shaøkahn,azralon,1471,warrior,fury,38,21,17
Sensho,azralon,1467,warrior,fury,52,29,23
Badoosh,kaelthas,1466,warrior,fury,40,26,14
Hôdû,tichondrius,1466,warrior,fury,58,32,26
Jubeithos,draktharon,1466,warrior,fury,60,28,32
Venirith,moon-guard,1465,warrior,fury,76,39,37
Nixe,caelestrasz,1465,warrior,fury,80,38,42
Axesage,tichondrius,1465,warrior,fury,48,22,26
Xenogears,boulderfist,1463,warrior,fury,36,16,20
Cliveswife,frostmourne,1462,warrior,fury,23,16,7
Teyroporah,azralon,1462,warrior,fury,63,34,29
Violençe,malganis,1462,warrior,fury,42,19,23
Timer,nagrand,1459,warrior,fury,18,17,1
Jimseung,tichondrius,1459,warrior,fury,36,16,20
Bigbungus,frostmourne,1458,warrior,fury,30,16,14
Celere,azralon,1458,warrior,fury,54,23,31
Mandremin,moon-guard,1456,warrior,fury,24,17,7
Rhann,kelthuzad,1454,warrior,fury,44,23,21
Calzonez,bloodscalp,1449,warrior,fury,53,31,22
Kortera,malganis,1449,warrior,fury,59,33,26
Chounshiryu,drakkari,1449,warrior,fury,245,126,119
Wazy,ragnaros,1448,warrior,fury,60,28,32
Lujzika,stormreaver,1439,warrior,fury,24,17,7
Smexxin,tichondrius,1439,warrior,fury,24,15,9
Wurrukattezz,tichondrius,1435,warrior,fury,38,22,16
Elken,haomarush,1434,warrior,fury,48,26,22
Azázyel,quelthalas,1433,warrior,fury,48,19,29
Mankus,tichondrius,1432,warrior,fury,90,45,45
Giannï,chogall,1431,warrior,fury,24,15,9
Vnw,illidan,1427,warrior,fury,24,15,9
Tenger,velen,1422,warrior,fury,101,56,45
Maciste,exodar,1422,warrior,fury,30,15,15
Murderwalk,shadowmoon,1422,warrior,fury,39,19,20
Attractive,silvermoon,1420,warrior,fury,103,57,46
Heenguer,azralon,1420,warrior,fury,60,31,29
Majindoom,illidan,1418,warrior,fury,47,27,20
Gromarth,wyrmrest-accord,1418,warrior,fury,70,38,32
Lechonk,suramar,1415,warrior,fury,30,16,14
Modì,sargeras,1415,warrior,fury,36,16,20
Johnnysnowx,sargeras,1412,warrior,fury,89,47,42
Aarmii,ragnaros,1410,warrior,fury,59,29,30
Warsongwolf,tichondrius,1409,warrior,fury,78,36,42
Burtiera,wyrmrest-accord,1407,warrior,fury,54,33,21
Errejota,illidan,1406,warrior,fury,54,26,28
Whitetaure,arthas,1405,warrior,fury,30,15,15
Biggbudzz,sargeras,1404,warrior,fury,30,16,14
Exëqt,area-52,1404,warrior,fury,60,25,35
Apeal,skullcrusher,1403,warrior,fury,84,44,40
Sálieri,ragnaros,1403,warrior,fury,42,22,20
Hêllseeker,ragnaros,1403,warrior,fury,46,22,24
Braxtön,moon-guard,1401,warrior,fury,45,20,25
Sindarin,eitrigg,1400,warrior,fury,54,32,22
Xurug,zuljin,1400,warrior,fury,30,15,15
Moriax,azralon,1398,warrior,fury,83,43,40
Fluffytaco,illidan,1395,warrior,fury,60,32,28
Slaggdad,illidan,1395,warrior,fury,74,33,41
Lyonele,moon-guard,1394,warrior,fury,50,28,22
Ourhero,malganis,1392,warrior,fury,27,16,11
Gokkuu,dragonblight,1392,warrior,fury,36,20,16
Zekken,blades-edge,1392,warrior,fury,77,39,38
Aladrynne,dalaran,1390,warrior,fury,96,44,52
Sïxsnacks,stormrage,1389,warrior,fury,26,16,10
Bigjier,proudmoore,1386,warrior,fury,38,18,20
Zerríck,moon-guard,1385,warrior,fury,78,38,40
Reesse,eonar,1384,warrior,fury,24,16,8
Noten,thunderlord,1383,warrior,fury,72,39,33
Rageinc,jubeithos,1383,warrior,fury,62,28,34
Kratøz,tichondrius,1382,warrior,fury,36,18,18
Thywub,proudmoore,1380,warrior,fury,36,17,19
Fendimonster,tichondrius,1379,warrior,fury,136,74,62
Weesten,aerie-peak,1378,warrior,fury,178,99,79
Cenanuandra,gnomeregan,1377,warrior,fury,58,31,27
Swiffy,stormrage,1375,warrior,fury,46,29,17
Zootonius,bloodscalp,1368,warrior,fury,36,20,16
Firmware,illidan,1368,warrior,fury,34,15,19
Crushanater,tichondrius,1364,warrior,fury,33,17,16
Dissx,illidan,1363,warrior,fury,42,19,23
Trco,quelthalas,1361,warrior,fury,42,22,20
Nebgleb,bleeding-hollow,1360,warrior,fury,24,16,8
Emotionaldps,malygos,1360,warrior,fury,141,74,67
Ivanzaytsev,ragnaros,1360,warrior,fury,78,40,38
Iskandr,amanthul,1357,warrior,fury,87,40,47
Matthegreat,area-52,1354,warrior,fury,51,25,26
Cougaloo,sargeras,1348,warrior,fury,54,26,28
Thiccyb,area-52,1344,warrior,fury,18,14,4
Rerollrogue,thrall,1344,warrior,fury,95,42,53
Arfzz,zangarmarsh,1343,warrior,fury,36,16,20
Kaladbolg,tichondrius,1340,warrior,fury,42,23,19
Rekill,emerald-dream,1337,warrior,fury,24,14,10
Michaela,moon-guard,1336,warrior,fury,24,14,10
Ensïs,moon-guard,1335,warrior,fury,54,22,32
Kombatwombat,kaelthas,1334,warrior,fury,18,14,4
Ciellë,proudmoore,1334,warrior,fury,27,17,10
Krovikân,area-52,1333,warrior,fury,24,14,10
Ciege,illidan,1333,warrior,fury,24,14,10
Lighttaker,proudmoore,1332,warrior,fury,90,49,41
Râvik,illidan,1332,warrior,fury,30,14,16
Zartren,khazgoroth,1331,warrior,fury,24,14,10
Breaker,undermine,1331,warrior,fury,30,14,16
Washim,area-52,1329,warrior,fury,41,24,17
Alysson,moon-guard,1329,warrior,fury,24,14,10
Wouili,zuljin,1329,warrior,fury,24,14,10
Screwz,blackrock,1328,warrior,fury,78,43,35
Crøm,tichondrius,1327,warrior,fury,36,14,22
Youserg,khazgoroth,1325,warrior,fury,82,39,43
Bondeye,stormrage,1325,warrior,fury,83,38,45
Metalstorms,firetree,1321,warrior,fury,30,16,14
Galaxarr,bonechewer,1319,warrior,fury,65,32,33
Mäjka,dalaran,1316,warrior,fury,30,14,16
Zenrrei,ragnaros,1315,warrior,fury,31,15,16
Destructör,nagrand,1315,warrior,fury,36,15,21
Hellframe,ysondre,1315,warrior,fury,42,17,25
Selathiel,burning-blade,1313,warrior,fury,24,14,10
Warföx,stormrage,1310,warrior,fury,36,15,21
Thyssara,moon-guard,1309,warrior,fury,81,38,43
Áres,spinebreaker,1308,warrior,fury,42,19,23
Varlekt,frostmourne,1307,warrior,fury,59,30,29
Ironpanzer,thrall,1306,warrior,fury,50,25,25
Tüssèll,khazgoroth,1306,warrior,fury,97,48,49
Brugo,area-52,1301,warrior,fury,50,33,17
Osannd,tichondrius,1301,warrior,fury,66,31,35
Uggtrick,zuljin,1301,warrior,fury,72,33,39
Contradict,thrall,1301,warrior,fury,36,16,20
Goleus,emerald-dream,1299,warrior,fury,42,17,25
Assaulttank,drenden,1298,warrior,fury,42,17,25
Mikejustice,kelthuzad,1297,warrior,fury,124,57,67
Xeto,ragnaros,1296,warrior,fury,34,20,14
Fabian,kelthuzad,1296,warrior,fury,76,40,36
Joxer,nordrassil,1293,warrior,fury,48,25,23
Eatmyblade,wyrmrest-accord,1293,warrior,fury,187,83,104
Kelandrin,illidan,1292,warrior,fury,24,15,9
Vapyr,moon-guard,1291,warrior,fury,23,14,9
Orrof,antonidas,1291,warrior,fury,111,50,61
Maytrix,bleeding-hollow,1290,warrior,fury,48,24,24
Wuushang,area-52,1288,warrior,fury,62,31,31
Zweihänder,nemesis,1284,warrior,fury,23,14,9
Dhaemom,azralon,1282,warrior,fury,90,43,47
Tupacsback,stormrage,1281,warrior,fury,36,22,14
Rsage,lightbringer,1274,warrior,fury,116,59,57
Spaceguybro,whisperwind,1272,warrior,fury,47,20,27
Grumok,tichondrius,1267,warrior,fury,26,14,12
Ivoryana,kelthuzad,1266,warrior,fury,48,25,23
Paí,nemesis,1265,warrior,fury,24,15,9
Akusenshi,dragonblight,1263,warrior,fury,48,24,24
Elbetoques,ragnaros,1261,warrior,fury,30,18,12
Lilcha,stormrage,1258,warrior,fury,36,15,21
Savikk,earthen-ring,1256,warrior,fury,42,23,19
Garce,aerie-peak,1253,warrior,fury,31,16,15
Vandrad,stormrage,1252,warrior,fury,123,56,67
Kurishjadar,tichondrius,1251,warrior,fury,66,31,35
Elonownesme,zuljin,1251,warrior,fury,44,20,24
Wariorphilip,moon-guard,1250,warrior,fury,30,18,12
Wakkawar,stormrage,1248,warrior,fury,48,24,24
Agragar,zuljin,1247,warrior,fury,18,13,5
Blackpro,sargeras,1247,warrior,fury,42,26,16
Vuraxx,area-52,1246,warrior,fury,18,13,5
Carnemontana,shadowsong,1246,warrior,fury,24,17,7
Smache,tichondrius,1244,warrior,fury,18,13,5
Verigan,barthilas,1244,warrior,fury,18,13,5
Islik,stormrage,1243,warrior,fury,24,13,11
Torkscreww,bleeding-hollow,1243,warrior,fury,24,13,11
Taiine,moon-guard,1243,warrior,fury,24,13,11
Grommasth,jubeithos,1242,warrior,fury,24,14,10
Buckleboot,illidan,1242,warrior,fury,24,13,11
Rendard,sargeras,1242,warrior,fury,24,13,11
Tdaddy,lightbringer,1242,warrior,fury,121,61,60
Cheiftain,dalaran,1241,warrior,fury,30,13,17
Bopwar,malganis,1240,warrior,fury,24,13,11
Robocöp,quelthalas,1239,warrior,fury,24,13,11
Evilkorean,tichondrius,1237,warrior,fury,24,13,11
Skipowawa,area-52,1237,warrior,fury,30,16,14
Atracasöl,ragnaros,1236,warrior,fury,24,13,11
Wishayzka,drakkari,1234,warrior,fury,24,13,11
Zephyron,moonrunner,1231,warrior,fury,38,18,20
Renseven,frostmourne,1230,warrior,fury,36,19,17
Cjay,bleeding-hollow,1229,warrior,fury,30,13,17
Kyle,kargath,1227,warrior,fury,34,21,13
Groggam,illidan,1226,warrior,fury,24,13,11
Furiousangel,area-52,1223,warrior,fury,36,19,17
Vornicar,moon-guard,1221,warrior,fury,32,14,18
Thänatøs,nemesis,1219,warrior,fury,32,17,15
Thorfjin,stormrage,1218,warrior,fury,24,13,11
Wraithvlad,moon-guard,1215,warrior,fury,50,20,30
Grosjambes,turalyon,1214,warrior,fury,30,18,12
Tenebrocity,stormrage,1213,warrior,fury,42,19,23
Breinan,ragnaros,1205,warrior,fury,51,26,25
Kaíroz,quelthalas,1203,warrior,fury,42,24,18
Rendus,hyjal,1198,warrior,fury,54,21,33
Bigglyjoobs,tichondrius,1195,warrior,fury,23,13,10
Lidia,windrunner,1194,warrior,fury,38,14,24
Tinycutty,frostmourne,1189,warrior,fury,23,13,10
Koraciá,illidan,1188,warrior,fury,42,19,23
Nemesioh,tichondrius,1184,warrior,fury,59,25,34
Honduranhary,sargeras,1183,warrior,fury,34,17,17
Serviettski,zuljin,1181,warrior,fury,36,19,17
Ragemarley,dalaran,1180,warrior,fury,41,19,22
Furyknight,velen,1177,warrior,fury,73,38,35
Akarì,emerald-dream,1176,warrior,fury,30,15,15
Antei,thunderlord,1171,warrior,fury,23,13,10
Zèldris,gallywix,1171,warrior,fury,109,61,48
Warkinit,proudmoore,1167,warrior,fury,34,15,19
Liljon,windrunner,1166,warrior,fury,36,17,19
Zorhn,skywall,1161,warrior,fury,24,18,6
Markodarko,gilneas,1161,warrior,fury,24,13,11
Starplatinum,aerie-peak,1158,warrior,fury,36,16,20
Darthwarr,bleeding-hollow,1156,warrior,fury,35,23,12
Ðêed,area-52,1152,warrior,fury,18,12,6
Arrad,sargeras,1152,warrior,fury,42,17,25
Yepkorean,tichondrius,1151,warrior,fury,18,12,6
Líliúm,ragnaros,1151,warrior,fury,31,19,12
Slughörn,moon-guard,1151,warrior,fury,24,12,12
Ganzi,tichondrius,1150,warrior,fury,24,12,12
Ganzism,tichondrius,1150,warrior,fury,24,12,12
Notcoverage,tichondrius,1150,warrior,fury,24,12,12
Ganzar,nesingwary,1148,warrior,fury,30,12,18
Sonyanalogue,frostmourne,1148,warrior,fury,30,12,18
Justicwar,area-52,1147,warrior,fury,24,12,12
Zarxc,quelthalas,1147,warrior,fury,24,12,12
Synalia,sargeras,1147,warrior,fury,24,12,12
Galigiggs,emerald-dream,1146,warrior,fury,18,12,6
Lòrdnasher,tichondrius,1146,warrior,fury,21,13,8
Setseno,stormrage,1145,warrior,fury,24,12,12
Faywarsong,area-52,1145,warrior,fury,24,12,12
Midweststuna,kul-tiras,1144,warrior,fury,18,12,6
Jingson,moon-guard,1143,warrior,fury,21,13,8
Kanekhy,ragnaros,1143,warrior,fury,28,13,15
Casmier,tichondrius,1141,warrior,fury,18,12,6
Mezmer,sargeras,1139,warrior,fury,18,12,6
Balbyo,shattered-hand,1139,warrior,fury,30,12,18
Sansãocore,nemesis,1138,warrior,fury,28,13,15
Originalkhan,stormrage,1138,warrior,fury,30,12,18
Droun,rexxar,1137,warrior,fury,59,30,29
Talismantate,quelthalas,1135,warrior,fury,18,12,6
Kaladïn,ragnaros,1135,warrior,fury,18,12,6
Sarovek,thrall,1134,warrior,fury,24,12,12
Makcumba,ragnaros,1132,warrior,fury,24,12,12
Zoldian,tichondrius,1132,warrior,fury,29,14,15
Stinkyfuq,area-52,1128,warrior,fury,18,12,6
Chahta,shadowsong,1125,warrior,fury,18,12,6
Roxon,hellscream,1125,warrior,fury,89,45,44
Rekitralph,tichondrius,1116,warrior,fury,30,13,17
Filamon,dentarg,1116,warrior,fury,35,12,23
Irontarkus,garrosh,1112,warrior,fury,18,12,6
Sphílly,thrall,1107,warrior,fury,36,19,17
Tyraelius,kiljaeden,1103,warrior,fury,39,24,15
Rocketcayton,veknilash,1096,warrior,fury,54,30,24
Madaroy,stormrage,1096,warrior,fury,24,12,12
Goinberserk,tichondrius,1093,warrior,fury,34,16,18
Smallestwar,zuljin,1093,warrior,fury,47,18,29
Xfootman,quelthalas,1092,warrior,fury,42,25,17
Dodiru,azralon,1084,warrior,fury,27,13,14
Brodîn,tichondrius,1083,warrior,fury,54,30,24
Elsee,drakkari,1080,warrior,fury,26,12,14
Undmyaxe,shattered-halls,1078,warrior,fury,24,13,11
Fatguy,tichondrius,1076,warrior,fury,60,29,31
Nezzarek,sargeras,1075,warrior,fury,34,12,22
Assmut,stormrage,1074,warrior,fury,35,15,20
Garmeg,nemesis,1073,warrior,fury,60,26,34
Lucymay,kelthuzad,1072,warrior,fury,36,19,17
Creedz,dreadmaul,1064,warrior,fury,42,18,24
Orclog,illidan,1056,warrior,fury,18,11,7
Cryposlice,malganis,1056,warrior,fury,24,11,13
Xcuses,area-52,1055,warrior,fury,18,11,7
Nicfury,alterac-mountains,1055,warrior,fury,18,11,7
Ragingboner,aggramar,1055,warrior,fury,18,11,7
Ásúrá,quelthalas,1055,warrior,fury,18,11,7
Flaco,tichondrius,1055,warrior,fury,21,12,9
Gorbagglúk,azralon,1055,warrior,fury,30,15,15
Uhtred,moonrunner,1055,warrior,fury,24,12,12
Chlord,proudmoore,1055,warrior,fury,24,11,13
Bearlornan,frostmourne,1054,warrior,fury,18,11,7
Claymation,tichondrius,1054,warrior,fury,18,11,7
Bloodfist,tichondrius,1054,warrior,fury,18,11,7
Sulze,tichondrius,1054,warrior,fury,21,12,9
Hjomura,quelthalas,1053,warrior,fury,18,11,7
Zerkxi,kelthuzad,1053,warrior,fury,18,11,7
Beryrn,farstriders,1053,warrior,fury,23,13,10
Berthibar,dalaran,1053,warrior,fury,30,11,19
Radisa,sargeras,1051,warrior,fury,30,11,19
Koppo,kelthuzad,1050,warrior,fury,30,11,19
Shrekshomie,zuljin,1049,warrior,fury,18,11,7
Ráionshin,quelthalas,1049,warrior,fury,24,11,13
Limpninny,dalaran,1049,warrior,fury,27,11,16
Wolurog,emerald-dream,1048,warrior,fury,18,11,7
Studsrus,aegwynn,1048,warrior,fury,42,21,21
Bhutjolokia,ragnaros,1048,warrior,fury,24,11,13
Tayne,ragnaros,1046,warrior,fury,24,11,13
Ghostwalker,akama,1045,warrior,fury,24,11,13
Marcuss,bonechewer,1043,warrior,fury,18,11,7
Cåfe,tichondrius,1043,warrior,fury,18,11,7
Djfredsd,tichondrius,1041,warrior,fury,24,11,13
Offthecharts,mannoroth,1033,warrior,fury,41,20,21
Jellyjamz,zuljin,1032,warrior,fury,30,14,16
Owwycowwy,area-52,1032,warrior,fury,36,15,21
Learila,moon-guard,1027,warrior,fury,30,14,16
Munanio,stormrage,1024,warrior,fury,24,11,13
Lykon,echo-isles,1020,warrior,fury,18,11,7
Cannan,the-underbog,1019,warrior,fury,51,15,36
Rumka,draktharon,1015,warrior,fury,65,26,39
Lodog,proudmoore,1012,warrior,fury,28,12,16
Éeu,anubarak,1008,warrior,fury,112,58,54
Moelolita,illidan,1007,warrior,fury,23,11,12
Crazysharpz,thaurissan,1001,warrior,fury,29,12,17
Leturen,emerald-dream,999,warrior,fury,25,12,13
Painfulangel,nesingwary,994,warrior,fury,20,15,5
Warchine,malganis,994,warrior,fury,27,12,15
Shoteiotoshi,ragnaros,993,warrior,fury,41,21,20
Splurger,thrall,991,warrior,fury,17,11,6
Udmwarrior,zuljin,991,warrior,fury,22,11,11
Yêawen,tichondrius,990,warrior,fury,20,11,9
Jimmfro,zuljin,990,warrior,fury,22,11,11
Tyranatusk,malganis,989,warrior,fury,18,12,6
Jonÿ,sargeras,989,warrior,fury,84,44,40
Muufasa,nerzhul,988,warrior,fury,24,13,11
Curacao,dark-iron,987,warrior,fury,26,11,15
Bèèfcake,shattered-hand,984,warrior,fury,20,11,9
Wyrmscream,moon-guard,981,warrior,fury,90,42,48
Pulp,sargeras,976,warrior,fury,19,11,8
Judessi,kiljaeden,971,warrior,fury,20,11,9
Youngmoneyd,illidan,960,warrior,fury,12,10,2
Dawx,thrall,960,warrior,fury,18,10,8
Hasbullaa,proudmoore,959,warrior,fury,18,10,8
Turboboy,tichondrius,959,warrior,fury,18,10,8
Chopemupp,area-52,959,warrior,fury,18,10,8
Orrkky,jubeithos,959,warrior,fury,18,10,8
Toberino,illidan,959,warrior,fury,18,10,8
Coalpit,emerald-dream,959,warrior,fury,24,10,14
Sixtydolla,kelthuzad,959,warrior,fury,24,10,14
Ymìr,moon-guard,959,warrior,fury,24,10,14
Gahenk,chogall,958,warrior,fury,12,10,2
Strëngth,aggramar,958,warrior,fury,18,10,8
Blxckbeard,hyjal,958,warrior,fury,24,10,14
Semiru,zuljin,957,warrior,fury,12,10,2
Quuavo,tichondrius,957,warrior,fury,18,10,8
Farklesnarf,tichondrius,957,warrior,fury,18,10,8
Venóm,moon-guard,957,warrior,fury,18,10,8
Dabier,bleeding-hollow,956,warrior,fury,24,10,14
Harlow,spirestone,955,warrior,fury,24,10,14
Tacomeat,malorne,954,warrior,fury,22,11,11
Icon,tichondrius,954,warrior,fury,24,10,14
Äléx,frostmourne,953,warrior,fury,18,10,8
Nordrages,stormrage,953,warrior,fury,18,10,8
Rakshata,destromath,953,warrior,fury,18,10,8
Brutalpløx,illidan,953,warrior,fury,30,10,20
Ísrafel,ragnaros,952,warrior,fury,18,10,8
Maytrixx,stormrage,950,warrior,fury,12,10,2
Jellybomb,sargeras,950,warrior,fury,24,10,14
Tlâloque,quelthalas,943,warrior,fury,24,10,14
Trendxx,stormrage,941,warrior,fury,30,10,20
Darkarus,drakkari,925,warrior,fury,36,14,22
Hùlksmâsh,zuljin,924,warrior,fury,23,13,10
Ghostlyedge,turalyon,918,warrior,fury,72,25,47
Obiwun,azgalor,910,warrior,fury,17,10,7
Harkeigh,wyrmrest-accord,909,warrior,fury,17,10,7
Dolsorae,malganis,905,warrior,fury,28,11,17
Pigonhae,zuljin,904,warrior,fury,25,12,13
Samdarkblade,kilrogg,898,warrior,fury,33,10,23
Joog,kalecgos,895,warrior,fury,22,10,12
Grievouz,nemesis,894,warrior,fury,17,10,7
Snugglebuggs,stormrage,894,warrior,fury,23,10,13
Copinhodagua,azralon,889,warrior,fury,19,11,8
Elmosmash,thrall,879,warrior,fury,19,10,9
Zambonibob,eonar,876,warrior,fury,24,12,12
Notacop,malygos,864,warrior,fury,12,9,3
Tastý,moon-guard,864,warrior,fury,12,9,3
Shadowstingg,tichondrius,864,warrior,fury,12,9,3
Gbrz,stormrage,864,warrior,fury,12,9,3
Lindsanv,illidan,864,warrior,fury,18,9,9
Riftgar,hyjal,864,warrior,fury,18,9,9
Naelynh,quelthalas,864,warrior,fury,18,9,9
Bornclueless,illidan,864,warrior,fury,18,9,9
Astrëa,quelthalas,864,warrior,fury,18,9,9
Baylîfe,illidan,864,warrior,fury,18,9,9
Progesterone,bleeding-hollow,864,warrior,fury,18,9,9
Lootacris,illidan,864,warrior,fury,24,9,15
Shimizuken,tichondrius,864,warrior,fury,24,9,15
Likelygood,tichondrius,863,warrior,fury,12,9,3
Squonks,kelthuzad,863,warrior,fury,12,9,3
Okkin,cairne,863,warrior,fury,12,9,3
Liltom,sargeras,863,warrior,fury,18,9,9
Zastrow,dalaran,863,warrior,fury,18,9,9
Xakp,tichondrius,863,warrior,fury,18,9,9
Tyrannus,chogall,863,warrior,fury,18,9,9
Klieterious,bleeding-hollow,863,warrior,fury,18,9,9
Gzilla,queldorei,863,warrior,fury,24,9,15
Youjumpijump,frostmourne,863,warrior,fury,24,9,15
Tylerdurdenx,dalaran,862,warrior,fury,12,9,3
Lurtras,exodar,862,warrior,fury,18,9,9
Gurukakko,ragnaros,862,warrior,fury,18,9,9
Nowarriororc,thrall,862,warrior,fury,18,9,9
Conflíct,illidan,862,warrior,fury,18,9,9
Saabre,tichondrius,862,warrior,fury,18,9,9
Kåyotix,proudmoore,862,warrior,fury,18,9,9
Kreigër,area-52,862,warrior,fury,18,9,9
Cannonballz,sargeras,861,warrior,fury,18,9,9
Nornogin,tichondrius,861,warrior,fury,24,9,15
Rageraz,trollbane,860,warrior,fury,12,9,3
Maddzspin,tichondrius,860,warrior,fury,18,9,9
Asuna,burning-blade,860,warrior,fury,18,9,9
Rodorn,frostmourne,860,warrior,fury,22,10,12
Groguu,windrunner,859,warrior,fury,18,9,9
Stunninchaos,shattered-hand,859,warrior,fury,24,9,15
Lovehandlez,proudmoore,858,warrior,fury,18,9,9
Melankoma,sargeras,856,warrior,fury,18,9,9
Kræzee,kelthuzad,856,warrior,fury,24,9,15
Trufsoturi,bleeding-hollow,845,warrior,fury,23,9,14
Kajing,boulderfist,836,warrior,fury,19,10,9
Cønan,stormrage,830,warrior,fury,14,10,4
Machâ,illidan,830,warrior,fury,17,9,8
Kessahh,moon-guard,820,warrior,fury,18,9,9
Magdar,daggerspine,813,warrior,fury,28,9,19
Futtmebuck,emerald-dream,810,warrior,fury,18,10,8
Damnge,zuljin,806,warrior,fury,21,10,11
Rediger,aggramar,805,warrior,fury,40,16,24
Bargorengar,skullcrusher,797,warrior,fury,108,48,60
Liquidbagel,frostmourne,794,warrior,fury,22,9,13
Haelerostus,moon-guard,785,warrior,fury,42,16,26
Klim,grizzly-hills,781,warrior,fury,25,9,16
Nïckböï,misha,780,warrior,fury,17,9,8
Cüba,nemesis,770,warrior,fury,24,9,15
Rimshotts,sargeras,768,warrior,fury,12,8,4
Kruma,stormscale,768,warrior,fury,12,8,4
Beforever,kiljaeden,768,warrior,fury,12,8,4
Swìll,illidan,768,warrior,fury,12,8,4
Bbcapitalist,blackrock,768,warrior,fury,12,8,4
Angryexe,zuljin,768,warrior,fury,12,8,4
Perserve,thunderlord,768,warrior,fury,12,8,4
Stimm,blood-furnace,768,warrior,fury,12,8,4
Humanlog,illidan,768,warrior,fury,12,8,4
Volgarr,zuljin,768,warrior,fury,12,8,4
Collosalx,stormrage,768,warrior,fury,12,8,4
Ramseyx,dalaran,768,warrior,fury,12,8,4
Dahakawar,malganis,768,warrior,fury,12,8,4
Akenox,area-52,768,warrior,fury,12,8,4
Ryse,aegwynn,768,warrior,fury,12,8,4
Idranel,nordrassil,768,warrior,fury,12,8,4
Colonclogger,proudmoore,768,warrior,fury,12,8,4
Bamag,dethecus,768,warrior,fury,12,8,4
Stånnis,moon-guard,768,warrior,fury,12,8,4
Doczz,malganis,768,warrior,fury,18,8,10
Oohsht,tichondrius,768,warrior,fury,18,8,10
Asstastic,bonechewer,768,warrior,fury,18,8,10
Coltyn,illidan,768,warrior,fury,18,8,10
Icebringer,frostmourne,768,warrior,fury,24,8,16
Drunkwarriôr,malygos,767,warrior,fury,12,8,4
Dagrone,drakkari,767,warrior,fury,12,8,4
Hydrolisk,area-52,767,warrior,fury,12,8,4
Moggos,firetree,767,warrior,fury,12,8,4
Rodahn,emerald-dream,767,warrior,fury,12,8,4
Mittyroar,khazgoroth,767,warrior,fury,12,8,4
Kyres,moon-guard,767,warrior,fury,12,8,4
Ungabunga,frostwolf,767,warrior,fury,18,8,10
Wíldcat,illidan,767,warrior,fury,18,8,10
Maintarget,malganis,767,warrior,fury,18,8,10
Dtrumpo,moon-guard,767,warrior,fury,18,8,10
Funk,illidan,767,warrior,fury,18,8,10
Gízzmo,tichondrius,767,warrior,fury,18,8,10
Zêtt,drakkari,767,warrior,fury,18,8,10
Gorethrax,tichondrius,767,warrior,fury,18,8,10
Darkirondadi,frostmourne,766,warrior,fury,12,8,4
Maarilayne,wyrmrest-accord,766,warrior,fury,12,8,4
Droggo,cenarius,766,warrior,fury,12,8,4
Drumann,hyjal,766,warrior,fury,12,8,4
Theßull,frostmourne,766,warrior,fury,12,8,4
Ryukendo,stormrage,766,warrior,fury,12,8,4
Alrekur,moon-guard,766,warrior,fury,12,8,4
Arågòrn,stormrage,766,warrior,fury,18,8,10
Sheerwill,wyrmrest-accord,766,warrior,fury,18,8,10
Gromtalin,sargeras,766,warrior,fury,18,8,10
Ayn,llane,766,warrior,fury,18,8,10
Shééylias,moon-guard,766,warrior,fury,24,8,16
Corbray,frostmourne,766,warrior,fury,24,8,16
Syaon,moon-guard,765,warrior,fury,12,8,4
Hellsinga,stormrage,764,warrior,fury,18,8,10
Huri,nemesis,763,warrior,fury,30,8,22
Frettyhooman,blood-furnace,762,warrior,fury,12,8,4
Çampbêll,area-52,762,warrior,fury,24,8,16
Villäïness,daggerspine,760,warrior,fury,12,8,4
Alandris,icecrown,760,warrior,fury,18,10,8
Axekill,bleeding-hollow,760,warrior,fury,24,8,16
Kilp,thrall,751,warrior,fury,17,8,9
Marleau,bleeding-hollow,742,warrior,fury,21,9,12
Urnitemare,hyjal,742,warrior,fury,42,9,33
Tankieone,aggramar,740,warrior,fury,39,11,28
Arngrimm,area-52,735,warrior,fury,14,9,5
Gushee,medivh,735,warrior,fury,17,10,7
Azmael,sargeras,735,warrior,fury,17,8,9
Extremerogu,tichondrius,734,warrior,fury,17,8,9
Alexthar,drakkari,726,warrior,fury,36,10,26
Shapur,tichondrius,719,warrior,fury,11,8,3
Onionlord,wyrmrest-accord,719,warrior,fury,11,8,3
Eleronogoth,draka,704,warrior,fury,16,8,8
Zaraki,moon-guard,704,warrior,fury,16,8,8
Chippurrz,illidan,685,warrior,fury,11,8,3
Krunas,quelthalas,672,warrior,fury,12,7,5
Eino,llane,672,warrior,fury,12,7,5
Ðrëäd,area-52,672,warrior,fury,12,7,5
Maar,lightbringer,672,warrior,fury,12,7,5
Sypii,malganis,672,warrior,fury,12,7,5
Cjz,tichondrius,672,warrior,fury,12,7,5
Kolgrim,hyjal,672,warrior,fury,12,7,5
Canduin,queldorei,672,warrior,fury,12,7,5
Ðow,burning-blade,672,warrior,fury,12,7,5
Unbreakkable,tichondrius,672,warrior,fury,12,7,5
Funsyze,garona,672,warrior,fury,12,7,5
Xårren,stormrage,672,warrior,fury,12,7,5
Kryptonite,illidan,672,warrior,fury,12,7,5
Dós,emerald-dream,672,warrior,fury,12,7,5
Draxxarlol,zuljin,672,warrior,fury,12,7,5
Ladderx,area-52,672,warrior,fury,12,7,5
Ankhxiety,sargeras,672,warrior,fury,12,7,5
Ruckw,stormrage,672,warrior,fury,12,7,5
Prestico,ragnaros,672,warrior,fury,18,7,11
Mardrex,korgath,672,warrior,fury,18,7,11
Warhand,frostmourne,672,warrior,fury,18,7,11
Endlesskilla,destromath,672,warrior,fury,18,7,11
Goaco,drakkari,672,warrior,fury,18,7,11
Potjiekos,lightninghoof,671,warrior,fury,12,7,5
Pelikanesis,arthas,671,warrior,fury,12,7,5
Quintonious,dark-iron,671,warrior,fury,12,7,5
Pancárcho,quelthalas,671,warrior,fury,12,7,5
Lucicicia,bronzebeard,671,warrior,fury,12,7,5
Mág,burning-legion,671,warrior,fury,12,7,5
Seksyme,darkspear,671,warrior,fury,12,7,5
Ahmorok,moon-guard,671,warrior,fury,12,7,5
Iorak,queldorei,671,warrior,fury,12,7,5
Hewman,aerie-peak,671,warrior,fury,12,7,5
Yagluth,illidan,671,warrior,fury,12,7,5
Nokak,borean-tundra,671,warrior,fury,12,7,5
Zikeno,dalaran,671,warrior,fury,12,7,5
Vedrikk,ragnaros,671,warrior,fury,12,7,5
Mullf,stormrage,671,warrior,fury,12,7,5
Remudan,tichondrius,671,warrior,fury,18,7,11
Ghurrk,hyjal,671,warrior,fury,18,7,11
Nondracio,ragnaros,671,warrior,fury,18,7,11
Xochicotzin,mugthol,671,warrior,fury,18,7,11
Ragnir,kelthuzad,671,warrior,fury,18,7,11
Aggravation,bleeding-hollow,671,warrior,fury,18,7,11
Chacca,suramar,671,warrior,fury,18,7,11
Xiosè,ragnaros,671,warrior,fury,24,7,17
Ganon,garrosh,670,warrior,fury,12,7,5
Dragnol,quelthalas,670,warrior,fury,12,7,5
Tiqokz,sargeras,670,warrior,fury,12,7,5
Xauce,queldorei,670,warrior,fury,24,7,17
Rafaeldantas,azralon,669,warrior,fury,12,7,5
Gamoosh,illidan,669,warrior,fury,20,7,13
Deáthwing,steamwheedle-cartel,669,warrior,fury,24,7,17
Shadowtitanx,korgath,669,warrior,fury,30,7,23
Misgnomer,farstriders,667,warrior,fury,12,7,5
Warbane,barthilas,667,warrior,fury,18,7,11
Siiss,stormrage,665,warrior,fury,21,9,12
Keateane,frostmourne,662,warrior,fury,12,7,5
Crashacorn,stormrage,659,warrior,fury,18,7,11
Jendal,ragnaros,658,warrior,fury,12,7,5
Lourdadmiwal,aegwynn,655,warrior,fury,18,7,11
Naughtytwat,tichondrius,639,warrior,fury,14,8,6
Zovudo,area-52,638,warrior,fury,14,8,6
Wintz,dreadmaul,638,warrior,fury,14,8,6
Donjuan,skullcrusher,637,warrior,fury,20,8,12
Nanor,zuljin,635,warrior,fury,14,8,6
Hyperdevil,ragnaros,618,warrior,fury,18,9,9
Furryhorv,frostmourne,608,warrior,fury,22,7,15
Vorthax,korgath,607,warrior,fury,14,7,7
Rohkvan,illidan,607,warrior,fury,14,7,7
Splints,nesingwary,604,warrior,fury,14,7,7
Noktyn,haomarush,591,warrior,fury,11,7,4
Monreale,area-52,576,warrior,fury,6,6,0
Zak,feathermoon,576,warrior,fury,6,6,0
Grïnk,stormrage,576,warrior,fury,6,6,0
Flaapjack,malganis,576,warrior,fury,6,6,0
Contented,illidan,576,warrior,fury,9,7,2
Gtrain,barthilas,576,warrior,fury,12,6,6
Ezeji,area-52,576,warrior,fury,12,6,6
Ggludan,area-52,576,warrior,fury,12,6,6
Endurefen,sargeras,576,warrior,fury,12,6,6
Snowflakee,jaedenar,576,warrior,fury,12,6,6
Serzull,area-52,576,warrior,fury,12,6,6
Disarmed,proudmoore,576,warrior,fury,12,6,6
Vinvivenna,emerald-dream,576,warrior,fury,12,6,6
Gamelagged,area-52,576,warrior,fury,12,6,6
Bestseason,kelthuzad,576,warrior,fury,12,6,6
Skoll,illidan,576,warrior,fury,12,6,6
Rigil,the-forgotten-coast,576,warrior,fury,12,6,6
Carnemølida,thrall,576,warrior,fury,12,6,6
Jcßot,exodar,576,warrior,fury,12,6,6
Whateverzhan,tichondrius,576,warrior,fury,12,6,6
Maydie,illidan,576,warrior,fury,12,6,6
Dëåth,azgalor,576,warrior,fury,12,6,6
Kaivax,tichondrius,576,warrior,fury,12,6,6
Yükana,quelthalas,576,warrior,fury,12,6,6
Ezcharger,kelthuzad,576,warrior,fury,12,6,6
Strongerjaw,tichondrius,576,warrior,fury,12,6,6
Mordoo,zuljin,576,warrior,fury,12,6,6
Faytful,thrall,576,warrior,fury,12,6,6
Ðrënch,tichondrius,576,warrior,fury,12,6,6
Benieswar,frostmourne,576,warrior,fury,12,6,6
Marfas,hyjal,576,warrior,fury,12,6,6
Modzilla,aerie-peak,576,warrior,fury,12,6,6
Gromkhor,tichondrius,576,warrior,fury,12,6,6
Xiaoheihei,tichondrius,576,warrior,fury,12,6,6
Whittyxc,tichondrius,576,warrior,fury,12,6,6
Bonafidesimp,stormrage,576,warrior,fury,12,6,6
Nertharul,zuljin,576,warrior,fury,12,6,6
Yadiig,illidan,576,warrior,fury,12,6,6
Tacrolimus,thrall,576,warrior,fury,12,6,6
Digitaldj,frostmourne,576,warrior,fury,18,6,12
Décapitator,area-52,576,warrior,fury,18,6,12
Hup,dethecus,576,warrior,fury,18,6,12
Cogsbixby,aerie-peak,575,warrior,fury,6,6,0
Boneskull,zuljin,575,warrior,fury,6,6,0
Kratthos,azralon,575,warrior,fury,12,6,6
Isitorganic,nesingwary,575,warrior,fury,12,6,6
Luckychaos,bleeding-hollow,575,warrior,fury,12,6,6
Plidan,shuhalo,575,warrior,fury,12,6,6
Lorelie,malganis,575,warrior,fury,12,6,6
Xenyn,malganis,575,warrior,fury,12,6,6
Kârzâ,dawnbringer,575,warrior,fury,12,6,6
Trackhawk,moon-guard,575,warrior,fury,12,6,6
Greenugly,tichondrius,575,warrior,fury,12,6,6
Chash,frostmourne,575,warrior,fury,12,6,6
Elleaux,bloodscalp,575,warrior,fury,12,6,6
Ironbark,elune,575,warrior,fury,12,6,6
Berario,garrosh,575,warrior,fury,12,6,6
Burninated,tichondrius,575,warrior,fury,12,6,6
Bloodhârdt,area-52,575,warrior,fury,18,6,12
Redblade,bleeding-hollow,575,warrior,fury,18,6,12
Honorloxo,bleeding-hollow,575,warrior,fury,24,6,18
Badairplane,gilneas,574,warrior,fury,12,6,6
Rageroni,tichondrius,574,warrior,fury,12,6,6
Siegeshatter,moon-guard,574,warrior,fury,24,6,18
Deltong,bonechewer,569,warrior,fury,12,6,6
Shiddoshi,ragnaros,569,warrior,fury,12,6,6
Vlark,eredar,568,warrior,fury,12,6,6
Tochixchaos,illidan,543,warrior,fury,14,7,7
Alaricck,quelthalas,543,warrior,fury,14,7,7
Freakin,ragnaros,543,warrior,fury,16,6,10
Ghonad,windrunner,541,warrior,fury,17,6,11
Thorkéll,proudmoore,541,warrior,fury,23,6,17
Sinbãd,sargeras,527,warrior,fury,11,6,5
Agarto,illidan,526,warrior,fury,11,6,5
Cornmaster,darkspear,522,warrior,fury,18,10,8
Onyx,auchindoun,480,warrior,fury,6,5,1
Falconheart,wyrmrest-accord,480,warrior,fury,6,5,1
Tryhardr,sargeras,480,warrior,fury,6,5,1
Timbermack,moon-guard,480,warrior,fury,6,5,1
Swingretzky,zuljin,480,warrior,fury,6,5,1
Korsarro,frostmourne,480,warrior,fury,6,5,1
Kiritarokila,area-52,480,warrior,fury,6,5,1
Goon,frostmourne,480,warrior,fury,6,5,1
Thecollector,borean-tundra,480,warrior,fury,6,5,1
Balrog,firetree,480,warrior,fury,6,5,1
Statistical,area-52,480,warrior,fury,6,5,1
Orkussw,illidan,480,warrior,fury,6,5,1
Finnin,nathrezim,480,warrior,fury,6,5,1
Deseroth,illidan,480,warrior,fury,6,5,1
Kaitlanzhan,malganis,480,warrior,fury,6,5,1
Tazmanianfur,akama,480,warrior,fury,6,5,1
Flanrych,illidan,480,warrior,fury,6,5,1
Devaya,ragnaros,480,warrior,fury,6,5,1
Beleña,dalaran,480,warrior,fury,6,5,1
Smorc,stormrage,480,warrior,fury,6,5,1
Ramranch,dawnbringer,480,warrior,fury,8,5,3
Victoriaöus,emerald-dream,480,warrior,fury,9,5,4
Taurenosaur,illidan,480,warrior,fury,12,5,7
Dtherockj,kiljaeden,480,warrior,fury,12,5,7
Ðìbs,moon-guard,480,warrior,fury,12,5,7
Chop,khadgar,480,warrior,fury,12,5,7
Trekk,azralon,480,warrior,fury,12,5,7
Axesomebody,tichondrius,480,warrior,fury,12,5,7
Marimadelene,aegwynn,480,warrior,fury,12,5,7
Pingolona,nemesis,480,warrior,fury,12,5,7
Lilsweet,moon-guard,480,warrior,fury,12,5,7
Hexmaul,zuljin,480,warrior,fury,12,5,7
Nukemdown,darkspear,480,warrior,fury,12,5,7
Lingho,illidan,480,warrior,fury,12,5,7
Vallkÿria,goldrinn,480,warrior,fury,12,5,7
Archibaldo,darkspear,480,warrior,fury,12,5,7
Clansy,moon-guard,480,warrior,fury,12,5,7
Chainsa,stormrage,480,warrior,fury,12,5,7
Izhansheni,illidan,480,warrior,fury,12,5,7
Kritsg,azgalor,480,warrior,fury,12,5,7
Vvârriôr,barthilas,480,warrior,fury,12,5,7
Warkaiser,ragnaros,480,warrior,fury,12,5,7
Smeshyou,kelthuzad,480,warrior,fury,12,5,7
Còlòssal,moknathal,480,warrior,fury,12,5,7
Sabers,mannoroth,480,warrior,fury,12,5,7
Iwillcrushyo,darkspear,480,warrior,fury,12,5,7
Noteko,tichondrius,480,warrior,fury,12,5,7
Maltrate,hyjal,480,warrior,fury,12,5,7
Cubanßûrst,stormrage,480,warrior,fury,12,5,7
Buhurt,sargeras,480,warrior,fury,12,5,7
Slamuëladams,bleeding-hollow,480,warrior,fury,12,5,7
Tinyterror,sargeras,480,warrior,fury,12,5,7
Pápý,ragnaros,480,warrior,fury,12,5,7
Ironsavage,frostmourne,480,warrior,fury,12,5,7
Carnith,arthas,480,warrior,fury,12,5,7
Sleazedog,kelthuzad,480,warrior,fury,12,5,7
Dalinare,area-52,480,warrior,fury,12,5,7
Orcveinz,tichondrius,480,warrior,fury,17,7,10
Gadlfuerte,ragnaros,480,warrior,fury,14,5,9
Warborn,agamaggan,480,warrior,fury,18,5,13
Spinspin,borean-tundra,480,warrior,fury,18,5,13
Georgedubya,illidan,480,warrior,fury,18,5,13
Dragonrage,tanaris,480,warrior,fury,18,5,13
Thiccsauce,wyrmrest-accord,480,warrior,fury,18,5,13
Zirtag,proudmoore,479,warrior,fury,6,5,1
Vonkinky,sargeras,479,warrior,fury,6,5,1
Morshaz,drakkari,479,warrior,fury,6,5,1
Morasar,area-52,479,warrior,fury,12,5,7
Gros,exodar,479,warrior,fury,12,5,7
Buckets,chogall,479,warrior,fury,12,5,7
Guantid,sargeras,479,warrior,fury,12,5,7
Warsero,tichondrius,479,warrior,fury,12,5,7
Lawyer,quelthalas,479,warrior,fury,12,5,7
Yasser,ragnaros,479,warrior,fury,12,5,7
Olegg,laughing-skull,479,warrior,fury,12,5,7
Ksubîî,frostmourne,479,warrior,fury,12,5,7
Supersquish,moon-guard,479,warrior,fury,18,5,13
Evergardens,saurfang,478,warrior,fury,12,5,7
Welgo,moon-guard,478,warrior,fury,12,5,7
Drovik,malygos,477,warrior,fury,18,5,13
Shhiraq,zuljin,477,warrior,fury,24,5,19
Fabszord,nemesis,476,warrior,fury,12,5,7
Veganwarrior,quelthalas,469,warrior,fury,18,5,13
Torv,frostmourne,447,warrior,fury,8,6,2
Oiledman,emerald-dream,447,warrior,fury,11,5,6
Erdnase,ragnaros,447,warrior,fury,11,5,6
Rageverd,malganis,432,warrior,fury,9,5,4
Chiffonade,kelthuzad,432,warrior,fury,11,6,5
Avatarl,ragnaros,432,warrior,fury,15,5,10
Thalloom,thaurissan,432,warrior,fury,15,5,10
Hugz,thrall,431,warrior,fury,11,5,6
Leónard,moon-guard,431,warrior,fury,11,5,6
Sukstofuk,frostmourne,431,warrior,fury,11,5,6
Glaros,blood-furnace,431,warrior,fury,11,5,6
Panterra,azralon,426,warrior,fury,16,7,9
Israelelel,azralon,416,warrior,fury,10,5,5
Forerunner,tichondrius,416,warrior,fury,10,5,5
Stompgnomes,malganis,414,warrior,fury,14,5,9
Husyuzhi,tichondrius,400,warrior,fury,7,5,2
Painedd,stormrage,384,warrior,fury,6,4,2
Ymirock,area-52,384,warrior,fury,6,4,2
Varkiren,moon-guard,384,warrior,fury,6,4,2
Machutron,quelthalas,384,warrior,fury,6,4,2
Methodicaly,aerie-peak,384,warrior,fury,6,4,2
Alerish,quelthalas,384,warrior,fury,6,4,2
Mortalstrike,chogall,384,warrior,fury,6,4,2
Breké,moon-guard,384,warrior,fury,6,4,2
Drengarusk,area-52,384,warrior,fury,6,4,2
Fornido,quelthalas,384,warrior,fury,6,4,2
Olaqwarraso,sargeras,384,warrior,fury,6,4,2
Phandrosa,ragnaros,384,warrior,fury,6,4,2
Gorgoz,area-52,384,warrior,fury,6,4,2
Sarachnis,area-52,384,warrior,fury,6,4,2
Techanina,aerie-peak,384,warrior,fury,6,4,2
Pepétí,azralon,384,warrior,fury,6,4,2
Nunu,firetree,384,warrior,fury,6,4,2
Amphyctionis,zuljin,384,warrior,fury,6,4,2
Mommystrasza,kelthuzad,384,warrior,fury,6,4,2
Slashen,sargeras,384,warrior,fury,6,4,2
Inocencius,ragnaros,384,warrior,fury,6,4,2
Murghol,malganis,384,warrior,fury,6,4,2
Spraten,bonechewer,384,warrior,fury,6,4,2
Carfal,spirestone,384,warrior,fury,6,4,2
Affeine,malganis,384,warrior,fury,6,4,2
Pz,ravencrest,384,warrior,fury,6,4,2
Hasbullá,ragnaros,384,warrior,fury,6,4,2
Nikomasked,kelthuzad,384,warrior,fury,6,4,2
Brogdar,moon-guard,384,warrior,fury,6,4,2
Squishmello,hyjal,384,warrior,fury,6,4,2
Unpaused,kelthuzad,384,warrior,fury,6,4,2
Rezhan,area-52,384,warrior,fury,6,4,2
Psyrush,area-52,384,warrior,fury,6,4,2
Alecsten,tichondrius,384,warrior,fury,6,4,2
Cidrick,stormrage,384,warrior,fury,6,4,2
Willcharge,tichondrius,384,warrior,fury,6,4,2
Heyzulnut,whisperwind,384,warrior,fury,6,4,2
Boryndin,caelestrasz,384,warrior,fury,6,4,2
Jàmiè,wyrmrest-accord,384,warrior,fury,6,4,2
Nerjinzul,bloodscalp,384,warrior,fury,6,4,2
Mcfatstuffs,boulderfist,384,warrior,fury,6,4,2
Testees,senjin,384,warrior,fury,6,4,2
Suzushi,tichondrius,384,warrior,fury,6,4,2
Braxxinn,tichondrius,384,warrior,fury,6,4,2
Darkoil,illidan,384,warrior,fury,6,4,2
Tomatogodx,sargeras,384,warrior,fury,6,4,2
Qram,illidan,384,warrior,fury,6,4,2
Youdumbaut,tichondrius,384,warrior,fury,6,4,2
Bakadoom,illidan,384,warrior,fury,6,4,2
Blackbaba,illidan,384,warrior,fury,6,4,2
Gorcker,hellscream,384,warrior,fury,6,4,2
Lísterfiend,illidan,384,warrior,fury,6,4,2
Samuluo,tichondrius,384,warrior,fury,6,4,2
Kamidaren,tichondrius,384,warrior,fury,6,4,2
Jutank,sargeras,384,warrior,fury,6,4,2
Negrus,sargeras,384,warrior,fury,11,4,7
Beetcoyne,azuremyst,384,warrior,fury,12,4,8
Sîn,sargeras,384,warrior,fury,12,4,8
Wanderlie,zangarmarsh,384,warrior,fury,12,4,8
Goremack,hellscream,384,warrior,fury,12,4,8
Flexo,moon-guard,384,warrior,fury,12,4,8
Brolgo,quelthalas,384,warrior,fury,12,4,8
Yahnjee,stormrage,384,warrior,fury,12,4,8
Quinntis,anvilmar,384,warrior,fury,12,4,8
Rezzett,wyrmrest-accord,384,warrior,fury,12,4,8
Skrot,stormrage,384,warrior,fury,12,4,8
Eamonvalda,dalaran,384,warrior,fury,12,4,8
Neak,kelthuzad,384,warrior,fury,12,4,8
Choppin,sargeras,384,warrior,fury,12,4,8
Worgasum,black-dragonflight,384,warrior,fury,12,4,8
Goatmanee,tichondrius,384,warrior,fury,12,4,8
Smasher,garona,384,warrior,fury,12,4,8
Dotlom,wyrmrest-accord,384,warrior,fury,12,4,8
Wårrior,kelthuzad,384,warrior,fury,12,4,8
Potan,thrall,384,warrior,fury,12,4,8
Aislistraee,moon-guard,384,warrior,fury,12,4,8
Agonistes,emerald-dream,384,warrior,fury,12,4,8
Zibby,malganis,384,warrior,fury,12,4,8
Luosifen,tichondrius,384,warrior,fury,12,4,8
Truegit,illidan,384,warrior,fury,12,4,8
Metalhaed,thrall,384,warrior,fury,12,4,8
Gorm,greymane,384,warrior,fury,12,4,8
Krodah,quelthalas,384,warrior,fury,12,4,8
Shinshido,tichondrius,384,warrior,fury,12,4,8
Cýnzz,frostmourne,384,warrior,fury,12,4,8
Muradinpica,stormrage,384,warrior,fury,12,4,8
Connero,stormrage,384,warrior,fury,12,4,8
Pigblind,azralon,384,warrior,fury,12,4,8
Rägnarök,stormrage,384,warrior,fury,12,4,8
Corazondleón,ragnaros,384,warrior,fury,12,4,8
Hukzula,illidan,384,warrior,fury,12,4,8
Bladetko,tichondrius,384,warrior,fury,12,4,8
Lsays,tichondrius,384,warrior,fury,18,4,14
Awell,azralon,383,warrior,fury,6,4,2
Mercurial,mugthol,383,warrior,fury,6,4,2
Nelissa,runetotem,383,warrior,fury,6,4,2
Greggor,frostmourne,383,warrior,fury,12,4,8
Galadon,amanthul,383,warrior,fury,12,4,8
Rahmholz,bonechewer,383,warrior,fury,12,4,8
Hæmomancy,moon-guard,383,warrior,fury,12,4,8
Anger,zuljin,383,warrior,fury,24,4,20
Ünö,proudmoore,382,warrior,fury,6,4,2
Fangerbiter,destromath,382,warrior,fury,6,4,2
Solveighelga,drakkari,381,warrior,fury,12,4,8
Bonebreakr,tichondrius,381,warrior,fury,24,4,20
Glennyballs,dalaran,379,warrior,fury,12,4,8
Baxel,arthas,367,warrior,fury,11,4,7
Gotrekson,azralon,351,warrior,fury,11,4,7
Ghazzghkull,illidan,351,warrior,fury,11,4,7
Orangerzze,hyjal,350,warrior,fury,20,5,15
Darkrevel,dalvengyr,335,warrior,fury,11,4,7
Boonn,frostmourne,330,warrior,fury,13,7,6
Kíngkaisér,azralon,330,warrior,fury,15,6,9
Huleo,tichondrius,330,warrior,fury,14,5,9
Mataviejitos,ragnaros,329,warrior,fury,16,7,9
Gentlehugs,illidan,319,warrior,fury,5,4,1
Ángron,ragnaros,319,warrior,fury,5,4,1
Rohde,nemesis,319,warrior,fury,8,4,4
Wallzar,sargeras,304,warrior,fury,13,4,9
Decimateme,tichondrius,288,warrior,fury,6,3,3
Chubw,tichondrius,288,warrior,fury,6,3,3
Instakill,garrosh,288,warrior,fury,6,3,3
Hazknar,azralon,288,warrior,fury,6,3,3
Linara,shandris,288,warrior,fury,6,3,3
Thaann,illidan,288,warrior,fury,6,3,3
Zangre,stormrage,288,warrior,fury,6,3,3
Lechee,silvermoon,288,warrior,fury,6,3,3
Aùstin,moon-guard,288,warrior,fury,6,3,3
Säbeër,ragnaros,288,warrior,fury,6,3,3
Vongrave,moonrunner,288,warrior,fury,6,3,3
Calmebigfeet,tichondrius,288,warrior,fury,6,3,3
Wisslogia,ragnaros,288,warrior,fury,6,3,3
Chapublin,ragnaros,288,warrior,fury,6,3,3
Hithen,quelthalas,288,warrior,fury,6,3,3
Malystik,ragnaros,288,warrior,fury,6,3,3
Worclin,illidan,288,warrior,fury,6,3,3
Wargasms,alterac-mountains,288,warrior,fury,6,3,3
Magnis,stormrage,288,warrior,fury,6,3,3
Slãmpiece,stormrage,288,warrior,fury,6,3,3
Kurowar,drakkari,288,warrior,fury,6,3,3
Riechst,quelthalas,288,warrior,fury,6,3,3
Unng,emerald-dream,288,warrior,fury,6,3,3
Madblackcat,illidan,288,warrior,fury,6,3,3
Kénblock,tichondrius,288,warrior,fury,6,3,3
Rockadoodle,tichondrius,288,warrior,fury,6,3,3
Demobox,malganis,288,warrior,fury,6,3,3
Cocó,sargeras,288,warrior,fury,6,3,3
Razzik,emerald-dream,288,warrior,fury,6,3,3
Twilightrain,tichondrius,288,warrior,fury,6,3,3
Fartden,tichondrius,288,warrior,fury,6,3,3
Painfulsin,tichondrius,288,warrior,fury,6,3,3
Oprampage,illidan,288,warrior,fury,6,3,3
Kujø,wyrmrest-accord,288,warrior,fury,6,3,3
Heavydoody,moon-guard,288,warrior,fury,6,3,3
Bruzerk,ragnaros,288,warrior,fury,6,3,3
Vodak,daggerspine,288,warrior,fury,6,3,3
Swíshersweét,kelthuzad,288,warrior,fury,6,3,3
Thren,tichondrius,288,warrior,fury,6,3,3
Lightswords,stormrage,288,warrior,fury,6,3,3
Santhvel,jubeithos,288,warrior,fury,6,3,3
Klen,kelthuzad,288,warrior,fury,6,3,3
Wwesheamus,frostmourne,288,warrior,fury,6,3,3
Mcdowëll,moon-guard,288,warrior,fury,6,3,3
Milkmebby,bleeding-hollow,288,warrior,fury,6,3,3
Warriorbrain,wyrmrest-accord,288,warrior,fury,6,3,3
Vicegripp,misha,288,warrior,fury,6,3,3
Govosh,thrall,288,warrior,fury,6,3,3
Jethrix,kelthuzad,288,warrior,fury,6,3,3
Seymourbot,illidan,288,warrior,fury,6,3,3
Zerrekarr,wyrmrest-accord,288,warrior,fury,6,3,3
Demøletiøn,stormrage,288,warrior,fury,6,3,3
Nylissia,blood-furnace,288,warrior,fury,6,3,3
Kreamyumyums,tichondrius,288,warrior,fury,6,3,3
Morelz,stormrage,288,warrior,fury,6,3,3
Cassetto,icecrown,288,warrior,fury,6,3,3
Wescer,frostmourne,288,warrior,fury,6,3,3
Barbarìan,bleeding-hollow,288,warrior,fury,6,3,3
Daddyd,sargeras,288,warrior,fury,6,3,3
Beârz,the-underbog,288,warrior,fury,6,3,3
Kahn,andorhal,288,warrior,fury,6,3,3
Ruffless,skullcrusher,288,warrior,fury,6,3,3
Boitoróh,azralon,288,warrior,fury,6,3,3
Resize,wyrmrest-accord,288,warrior,fury,6,3,3
Galachad,jubeithos,288,warrior,fury,6,3,3
Uncritable,dalaran,288,warrior,fury,6,3,3
Tâlos,magtheridon,288,warrior,fury,6,3,3
Taywar,sargeras,288,warrior,fury,6,3,3
Glexecute,sargeras,288,warrior,fury,6,3,3
Rí,moon-guard,288,warrior,fury,6,3,3
Wolfsbanne,khadgar,288,warrior,fury,6,3,3
Gryl,stormrage,288,warrior,fury,6,3,3
Youngmop,eitrigg,288,warrior,fury,6,3,3
Nginx,queldorei,288,warrior,fury,6,3,3
Executie,duskwood,288,warrior,fury,6,3,3
Terazova,tichondrius,288,warrior,fury,6,3,3
Swiftÿ,gurubashi,288,warrior,fury,6,3,3
Carborr,frostmourne,288,warrior,fury,6,3,3
Smxrf,hyjal,288,warrior,fury,6,3,3
Guillotinè,area-52,288,warrior,fury,6,3,3
Gläedr,dalaran,288,warrior,fury,6,3,3
Corvesio,wyrmrest-accord,288,warrior,fury,6,3,3
Scylall,area-52,288,warrior,fury,6,3,3
Arthurston,tichondrius,288,warrior,fury,6,3,3
Skynitez,area-52,288,warrior,fury,6,3,3
Xragnar,area-52,288,warrior,fury,6,3,3
Bothar,sargeras,288,warrior,fury,6,3,3
Scran,sargeras,288,warrior,fury,6,3,3
Herkja,barthilas,288,warrior,fury,6,3,3
Rowdyanders,area-52,288,warrior,fury,6,3,3
Makeranbing,barthilas,288,warrior,fury,6,3,3
Stonksi,shadowmoon,288,warrior,fury,6,3,3
Crowsfall,aggramar,288,warrior,fury,6,3,3
Joarmyman,proudmoore,288,warrior,fury,6,3,3
Tobyrendrson,area-52,288,warrior,fury,6,3,3
Vengxdor,stormrage,288,warrior,fury,6,3,3
Anticiðe,zuljin,288,warrior,fury,6,3,3
Pongk,tichondrius,288,warrior,fury,6,3,3
Júmmy,area-52,288,warrior,fury,6,3,3
Colössal,moon-guard,288,warrior,fury,6,3,3
Orcly,kilrogg,288,warrior,fury,6,3,3
Kimed,nordrassil,288,warrior,fury,6,3,3
Martrek,amanthul,288,warrior,fury,6,3,3
Aeros,winterhoof,288,warrior,fury,6,3,3
Kàli,kiljaeden,288,warrior,fury,6,3,3
Corgii,khaz-modan,288,warrior,fury,6,3,3
Akj,sargeras,288,warrior,fury,6,3,3
Brøly,sargeras,288,warrior,fury,6,3,3
Bled,quelthalas,288,warrior,fury,10,4,6
Kromgrall,tichondrius,288,warrior,fury,12,3,9
Pastorpeen,thrall,288,warrior,fury,12,3,9
Flexìn,tichondrius,288,warrior,fury,12,3,9
Lynn,zangarmarsh,288,warrior,fury,12,3,9
Blackscale,grizzly-hills,288,warrior,fury,12,3,9
Krilles,tichondrius,288,warrior,fury,12,3,9
Kimuraa,hyjal,288,warrior,fury,12,3,9
Kuragdem,trollbane,288,warrior,fury,12,3,9
Leonz,undermine,288,warrior,fury,12,3,9
Seanpaiuwu,zuljin,288,warrior,fury,12,3,9
Forks,malganis,288,warrior,fury,12,3,9
Warseed,ragnaros,288,warrior,fury,12,3,9
Mfgodofwar,kelthuzad,288,warrior,fury,12,3,9
Krimmjðw,sargeras,288,warrior,fury,12,3,9
Apolio,magtheridon,288,warrior,fury,12,3,9
Shínkicker,area-52,288,warrior,fury,12,3,9
Rólex,tichondrius,288,warrior,fury,12,3,9
Banggo,frostmourne,288,warrior,fury,12,3,9
Barcëlð,frostmourne,288,warrior,fury,12,3,9
Zelekron,emerald-dream,288,warrior,fury,12,3,9
Gristly,sargeras,288,warrior,fury,12,3,9
Tríxman,moon-guard,288,warrior,fury,12,3,9
Ratface,frostmourne,288,warrior,fury,12,3,9
Jujuassgeter,darkspear,288,warrior,fury,18,3,15
Eadsmasher,jubeithos,287,warrior,fury,6,3,3
Disclone,tichondrius,287,warrior,fury,6,3,3
Worc,aggramar,287,warrior,fury,6,3,3
Monsterpepe,tichondrius,287,warrior,fury,12,3,9
Boothtowolf,the-forgotten-coast,286,warrior,fury,6,3,3
Bigdaddyzees,bleeding-hollow,255,warrior,fury,11,3,8
Kitiará,area-52,240,warrior,fury,9,4,5
Chupelo,tichondrius,239,warrior,fury,5,3,2
Reagzy,stormrage,234,warrior,fury,10,4,6
Schlosh,laughing-skull,223,warrior,fury,8,3,5
Heirel,kelthuzad,208,warrior,fury,7,3,4
Datneck,tichondrius,192,warrior,fury,4,3,1
Mightypikel,illidan,192,warrior,fury,4,3,1
Çórý,area-52,192,warrior,fury,4,3,1
Drefnor,thunderhorn,192,warrior,fury,9,3,6
Ballinx,illidan,192,warrior,fury,6,2,4
Kokixz,tichondrius,192,warrior,fury,6,2,4
Clerond,tichondrius,192,warrior,fury,6,2,4
Aisinbro,illidan,192,warrior,fury,6,2,4
Brewstrike,dalaran,192,warrior,fury,6,2,4
Shrexecute,tichondrius,192,warrior,fury,6,2,4
Nebraskapete,wyrmrest-accord,192,warrior,fury,6,2,4
Kaniks,dalaran,192,warrior,fury,6,2,4
Tickletickle,illidan,192,warrior,fury,6,2,4
Neifle,tichondrius,192,warrior,fury,6,2,4
Cartmain,illidan,192,warrior,fury,6,2,4
Mortaldznuts,tichondrius,192,warrior,fury,6,2,4
Bighamm,tichondrius,192,warrior,fury,6,2,4
Iapologiz,illidan,192,warrior,fury,6,2,4
Reäl,dalaran,192,warrior,fury,6,2,4
Linios,tichondrius,192,warrior,fury,6,2,4
Gangelx,illidan,192,warrior,fury,6,2,4
Shandrar,frostmourne,192,warrior,fury,6,2,4
Chieef,illidan,192,warrior,fury,6,2,4
Matahorda,darkspear,192,warrior,fury,6,2,4
Tempusbane,proudmoore,192,warrior,fury,6,2,4
Wqnmlgbd,tichondrius,192,warrior,fury,6,2,4
Melithiae,barthilas,192,warrior,fury,6,2,4
Aqee,illidan,192,warrior,fury,6,2,4
Zdokk,sargeras,192,warrior,fury,6,2,4
Skollyd,tichondrius,192,warrior,fury,6,2,4
Wariorwang,tichondrius,192,warrior,fury,6,2,4
Noor,tichondrius,192,warrior,fury,6,2,4
Painstake,illidan,192,warrior,fury,6,2,4
Xorjak,tichondrius,192,warrior,fury,6,2,4
Gakatarc,thrall,192,warrior,fury,6,2,4
Ultraa,lightbringer,192,warrior,fury,6,2,4
Cellyndia,area-52,192,warrior,fury,6,2,4
Daymancometh,proudmoore,192,warrior,fury,6,2,4
Hadowar,thrall,192,warrior,fury,6,2,4
Dragmös,nemesis,192,warrior,fury,6,2,4
Halò,thrall,192,warrior,fury,6,2,4
Bigbadaxe,sargeras,192,warrior,fury,6,2,4
Exsolacyst,sargeras,192,warrior,fury,6,2,4
Supersteak,tichondrius,192,warrior,fury,6,2,4
Bobisyourmom,tichondrius,192,warrior,fury,6,2,4
Swinkyzug,tichondrius,192,warrior,fury,6,2,4
Ragetide,illidan,192,warrior,fury,6,2,4
Assamith,nemesis,192,warrior,fury,6,2,4
Torimzor,nemesis,192,warrior,fury,6,2,4
Sako,amanthul,192,warrior,fury,6,2,4
Kross,illidan,192,warrior,fury,6,2,4
Kachigas,sargeras,192,warrior,fury,6,2,4
Blademaw,stormreaver,192,warrior,fury,6,2,4
Helder,destromath,192,warrior,fury,6,2,4
Saltyniples,aegwynn,192,warrior,fury,6,2,4
Fooko,lethon,192,warrior,fury,6,2,4
Itzyourmom,nazjatar,192,warrior,fury,6,2,4
Oledcktwist,garrosh,192,warrior,fury,6,2,4
Saltyareolas,destromath,192,warrior,fury,6,2,4
Zareos,azralon,192,warrior,fury,6,2,4
Estrozo,sargeras,192,warrior,fury,6,2,4
Containerbox,korgath,192,warrior,fury,6,2,4
Koast,aerie-peak,192,warrior,fury,6,2,4
Peekyblinder,kiljaeden,192,warrior,fury,6,2,4
Erikx,ragnaros,192,warrior,fury,6,2,4
Illicitiri,sargeras,192,warrior,fury,6,2,4
Ghostkin,ragnaros,192,warrior,fury,6,2,4
Horahloux,ragnaros,192,warrior,fury,6,2,4
Twilightzza,sargeras,192,warrior,fury,6,2,4
Amberlym,ragnaros,192,warrior,fury,6,2,4
Xanåtos,moon-guard,192,warrior,fury,6,2,4
Andrexion,moon-guard,192,warrior,fury,6,2,4
Bernardes,stormrage,192,warrior,fury,6,2,4
Gistid,frostmourne,192,warrior,fury,6,2,4
Jeyvil,stormrage,192,warrior,fury,6,2,4
Xtargaryen,stormrage,192,warrior,fury,6,2,4
Beatmeat,frostmourne,192,warrior,fury,6,2,4
Gomachi,moon-guard,192,warrior,fury,6,2,4
Impaling,moon-guard,192,warrior,fury,6,2,4
Elchacál,ragnaros,192,warrior,fury,6,2,4
Tepaste,ragnaros,192,warrior,fury,6,2,4
Azrailz,stormrage,192,warrior,fury,6,2,4
Bachyr,stormrage,192,warrior,fury,6,2,4
Veyronn,stormrage,192,warrior,fury,6,2,4
Hughmungús,frostmourne,192,warrior,fury,6,2,4
Tarkvs,ragnaros,192,warrior,fury,6,2,4
Jägernaught,stormrage,192,warrior,fury,6,2,4
Deafwarrior,sargeras,192,warrior,fury,6,2,4
Twoironfist,azralon,192,warrior,fury,6,2,4
Yeèzy,stormrage,192,warrior,fury,6,2,4
Eîghtysîx,sargeras,192,warrior,fury,6,2,4
Appleleon,ragnaros,192,warrior,fury,6,2,4
Outo,stormrage,192,warrior,fury,6,2,4
ßoris,grizzly-hills,192,warrior,fury,6,2,4
Thrawb,bleeding-hollow,192,warrior,fury,6,2,4
Youdeadx,aegwynn,192,warrior,fury,6,2,4
Vaclein,quelthalas,192,warrior,fury,6,2,4
Warmul,bleeding-hollow,192,warrior,fury,6,2,4
Zultråk,quelthalas,192,warrior,fury,6,2,4
Druckerz,lightnings-blade,192,warrior,fury,6,2,4
Freÿdis,zuljin,192,warrior,fury,6,2,4
Jäëgër,moon-guard,192,warrior,fury,6,2,4
Boombop,zuljin,192,warrior,fury,6,2,4
Rundai,zuljin,192,warrior,fury,6,2,4
Therealflex,zuljin,192,warrior,fury,6,2,4
Tortag,malganis,192,warrior,fury,6,2,4
Drugdilla,zuljin,192,warrior,fury,6,2,4
Stugwar,moon-guard,192,warrior,fury,6,2,4
Sustantus,emerald-dream,192,warrior,fury,6,2,4
Jayynorthyy,malganis,192,warrior,fury,6,2,4
Sveenn,area-52,192,warrior,fury,6,2,4
Ëdwärd,moon-guard,192,warrior,fury,6,2,4
Tigas,icecrown,192,warrior,fury,6,2,4
Lox,blades-edge,192,warrior,fury,6,2,4
Docmoriarty,malygos,192,warrior,fury,6,2,4
Tappyz,area-52,192,warrior,fury,6,2,4
Lepzed,area-52,192,warrior,fury,6,2,4
Slamspam,the-underbog,192,warrior,fury,6,2,4
Arx,frostwolf,192,warrior,fury,6,2,4
Browngusher,sargeras,192,warrior,fury,6,2,4
Onlyslams,sargeras,192,warrior,fury,6,2,4
Aboveaverage,arthas,192,warrior,fury,6,2,4
Rageroidz,area-52,192,warrior,fury,6,2,4
Good,garona,192,warrior,fury,6,2,4
Bariotyr,the-underbog,192,warrior,fury,6,2,4
Franc,kiljaeden,192,warrior,fury,6,2,4
Bonesheild,ursin,192,warrior,fury,11,2,9
Mickyplate,tichondrius,192,warrior,fury,12,2,10
Mnoga,azralon,192,warrior,fury,12,2,10
Doappy,darkspear,192,warrior,fury,12,2,10
Queterompo,ragnaros,192,warrior,fury,12,2,10
Beilian,quelthalas,192,warrior,fury,12,2,10
Norru,moon-guard,192,warrior,fury,12,2,10
Gymnopolar,barthilas,192,warrior,fury,12,2,10
Danastus,icecrown,192,warrior,fury,15,2,13
Naabii,moon-guard,191,warrior,fury,6,2,4
Werrewolf,kul-tiras,191,warrior,fury,6,2,4
Wayne,kargath,160,warrior,fury,16,2,14
Sheluh,illidan,159,warrior,fury,5,2,3
Loosypoosy,magtheridon,159,warrior,fury,5,2,3
Crankyhorn,stormrage,159,warrior,fury,5,2,3
Mariò,area-52,159,warrior,fury,5,2,3
Ngu,eldrethalas,159,warrior,fury,5,2,3
Dräxxär,sargeras,138,warrior,fury,10,3,7
Rhohan,ysera,128,warrior,fury,4,2,2
Fatbarstard,jubeithos,128,warrior,fury,4,2,2
Bootskrapp,azgalor,112,warrior,fury,7,2,5
Bradockqt,azralon,96,warrior,fury,3,2,1
Dabdaddyy,dawnbringer,96,warrior,fury,6,1,5
Largegayman,sargeras,96,warrior,fury,6,1,5
Freanor,azralon,96,warrior,fury,6,1,5
Srze,azralon,96,warrior,fury,6,1,5
Play,dark-iron,96,warrior,fury,6,1,5
Girthyslaps,frostmourne,96,warrior,fury,6,1,5
Kevinersaa,frostmourne,96,warrior,fury,6,1,5
Spartacam,frostmourne,96,warrior,fury,6,1,5
Genesisxp,barthilas,96,warrior,fury,6,1,5
Warriorlee,jubeithos,96,warrior,fury,6,1,5
ßallinjr,illidan,96,warrior,fury,6,1,5
Polox,ragnaros,96,warrior,fury,6,1,5
Wapistun,thrall,96,warrior,fury,6,1,5
Pcprincipal,khadgar,96,warrior,fury,6,1,5
Lifaen,zangarmarsh,96,warrior,fury,6,1,5
Aiforix,gorefiend,96,warrior,fury,6,1,5
Draann,kirin-tor,96,warrior,fury,6,1,5
Alitalia,thunderlord,96,warrior,fury,6,1,5
Swollenbicep,tichondrius,96,warrior,fury,6,1,5
Nerdturd,mannoroth,96,warrior,fury,6,1,5
Ridemepapi,tichondrius,96,warrior,fury,6,1,5
Loveføx,stormrage,96,warrior,fury,6,1,5
Lawlstørm,stormrage,96,warrior,fury,6,1,5
Igmif,stormrage,96,warrior,fury,6,1,5
Grândmâ,zuljin,96,warrior,fury,6,1,5
Dokoba,bleeding-hollow,96,warrior,fury,6,1,5
Andro,arthas,96,warrior,fury,6,1,5
Warrbull,spirestone,96,warrior,fury,6,1,5
Carnagè,area-52,96,warrior,fury,6,1,5
Furyofbeans,area-52,96,warrior,fury,6,1,5
Broxar,area-52,96,warrior,fury,6,1,5
Ustadbaba,area-52,96,warrior,fury,6,1,5
Flabergaster,skullcrusher,96,warrior,fury,6,1,5
Smashkuntz,lightnings-blade,96,warrior,fury,6,1,5
Neotico,quelthalas,96,warrior,fury,6,1,5
Xehm,tichondrius,96,warrior,fury,6,1,5
Vvengencezz,the-underbog,96,warrior,fury,6,1,5
Warritha,ragnaros,96,warrior,fury,6,1,5
Warrdawg,tichondrius,96,warrior,fury,6,1,5
Orsex,ragnaros,96,warrior,fury,6,1,5
Freesubs,sargeras,96,warrior,fury,6,1,5
Aftershóck,daggerspine,96,warrior,fury,6,1,5
Trollchopo,kiljaeden,96,warrior,fury,6,1,5
Kaikah,aegwynn,96,warrior,fury,6,1,5
Keirina,bonechewer,96,warrior,fury,6,1,5
Rexxous,hyjal,96,warrior,fury,6,1,5
Nasrôth,korialstrasz,96,warrior,fury,6,1,5
Bigwarrior,stonemaul,96,warrior,fury,6,1,5
Flywar,nesingwary,96,warrior,fury,6,1,5
Bigk,korgath,96,warrior,fury,6,1,5
Xut,moon-guard,96,warrior,fury,6,1,5
Bbyè,tichondrius,96,warrior,fury,6,1,5
Augutra,moon-guard,96,warrior,fury,6,1,5
Xiaohuzi,tichondrius,96,warrior,fury,6,1,5
Philbert,alexstrasza,96,warrior,fury,6,1,5
Arkayla,moon-guard,96,warrior,fury,6,1,5
Bumrushed,tichondrius,96,warrior,fury,6,1,5
Aladarith,moon-guard,96,warrior,fury,6,1,5
Tamagoshi,kiljaeden,96,warrior,fury,6,1,5
Murrdock,nesingwary,96,warrior,fury,6,1,5
Trén,hydraxis,96,warrior,fury,6,1,5
Magarrior,shadowsong,96,warrior,fury,6,1,5
Osselan,moon-guard,96,warrior,fury,6,1,5
Horabad,terenas,96,warrior,fury,6,1,5
Fletçhér,sargeras,96,warrior,fury,7,1,6
Zaxari,gurubashi,96,warrior,fury,12,1,11
Mamalonic,ragnaros,96,warrior,fury,12,1,11
Mawdryn,destromath,96,warrior,fury,12,1,11
Cremosö,azralon,64,warrior,fury,4,1,3
Gigglamesh,muradin,64,warrior,fury,4,1,3
Coverage,frostmourne,63,warrior,fury,2,2,0
Kirikash,illidan,42,warrior,fury,6,2,4
Husurnanny,dalaran,42,warrior,fury,7,2,5
Lokiullr,tichondrius,42,warrior,fury,9,2,7
Ztg,tichondrius,42,warrior,fury,11,2,9
Vioar,hyjal,31,warrior,fury,2,1,1
Racknon,ragnaros,16,warrior,fury,1,1,0
Sanduin,drakkari,16,warrior,fury,1,1,0
Río,area-52,2216,warrior,arms,136,72,64
Hapigirl,tichondrius,2193,warrior,arms,60,43,17
Exzistance,area-52,2168,warrior,arms,110,58,52
Thiccbiscuit,area-52,2168,warrior,arms,133,67,66
Zhanwudix,tichondrius,2162,warrior,arms,111,62,49
Killbørn,azralon,2156,warrior,arms,90,47,43
Turtleboy,feathermoon,2141,warrior,arms,79,45,34
Todory,moon-guard,2137,warrior,arms,155,78,77
Ðêed,area-52,2133,warrior,arms,81,46,35
Dpoy,tichondrius,2128,warrior,arms,108,54,54
Kraftyx,bleeding-hollow,2125,warrior,arms,72,44,28
Ssamök,ragnaros,2125,warrior,arms,329,168,161
Huzha,tichondrius,2114,warrior,arms,117,64,53
Warried,sargeras,2113,warrior,arms,66,37,29
Tyranitar,proudmoore,2113,warrior,arms,90,50,40
Strife,sargeras,2112,warrior,arms,56,32,24
Buckwar,zuljin,2110,warrior,arms,72,39,33
Vituu,sargeras,2104,warrior,arms,104,54,50
Killborn,tichondrius,2104,warrior,arms,145,73,72
Edgarllama,sargeras,2103,warrior,arms,87,48,39
ßallinjr,illidan,2103,warrior,arms,90,46,44
Huuzha,tichondrius,2102,warrior,arms,95,55,40
Récksus,tichondrius,2101,warrior,arms,74,43,31
Nikomasked,kelthuzad,2100,warrior,arms,66,37,29
Schonkopf,moon-guard,2100,warrior,arms,90,46,44
Vø,agamaggan,2097,warrior,arms,141,73,68
Menethíl,tichondrius,2075,warrior,arms,88,48,40
Leans,sargeras,2048,warrior,arms,143,78,65
Exespamtwo,area-52,2044,warrior,arms,194,106,88
Abswar,tichondrius,2043,warrior,arms,84,54,30
Recksus,tichondrius,2041,warrior,arms,101,63,38
Grantlol,illidan,2033,warrior,arms,96,55,41
Orclog,illidan,2033,warrior,arms,72,37,35
Perfs,bleeding-hollow,2031,warrior,arms,90,48,42
Kimchikick,tichondrius,2019,warrior,arms,173,92,81
Gyracide,area-52,2016,warrior,arms,101,49,52
Tryhardr,sargeras,2004,warrior,arms,194,107,87
Bacchanal,illidan,2003,warrior,arms,120,62,58
Foxxfighter,thrall,2000,warrior,arms,77,40,37
Nuqipq,tichondrius,1997,warrior,arms,54,31,23
Cloudxxy,kiljaeden,1988,warrior,arms,69,38,31
Ikkyuo,proudmoore,1984,warrior,arms,96,48,48
Zankets,area-52,1981,warrior,arms,144,74,70
Veilsidewar,kelthuzad,1980,warrior,arms,324,176,148
Boblennon,tichondrius,1977,warrior,arms,72,33,39
Ironbad,sargeras,1975,warrior,arms,94,50,44
Exëqt,nemesis,1974,warrior,arms,114,61,53
Lyrics,tichondrius,1969,warrior,arms,62,32,30
Pdbq,tichondrius,1968,warrior,arms,108,56,52
Icarryrats,tichondrius,1967,warrior,arms,81,39,42
Fanglerondz,area-52,1966,warrior,arms,42,25,17
Bighamm,tichondrius,1965,warrior,arms,71,40,31
Ælilblessedñ,azralon,1964,warrior,arms,154,81,73
Massacretko,area-52,1962,warrior,arms,88,50,38
Og,shattered-hand,1958,warrior,arms,47,29,18
Foraken,dragonmaw,1948,warrior,arms,59,36,23
Belàriá,tichondrius,1948,warrior,arms,66,36,30
Bhaldur,sargeras,1945,warrior,arms,128,72,56
Islonely,tichondrius,1944,warrior,arms,138,63,75
Yermalx,tichondrius,1941,warrior,arms,54,30,24
Barrbarossa,stormrage,1932,warrior,arms,139,73,66
Toutie,tichondrius,1932,warrior,arms,48,24,24
Marsshine,tichondrius,1930,warrior,arms,72,33,39
Trezturbo,tichondrius,1929,warrior,arms,129,70,59
Kalpok,tichondrius,1928,warrior,arms,58,30,28
Ricorecklezz,korgath,1925,warrior,arms,66,32,34
Marfas,hyjal,1924,warrior,arms,157,86,71
Sziw,tichondrius,1924,warrior,arms,186,98,88
Eqztw,tichondrius,1923,warrior,arms,137,86,51
Jgillz,sargeras,1922,warrior,arms,72,39,33
Gormag,sargeras,1917,warrior,arms,60,35,25
Smorc,stormrage,1917,warrior,arms,60,31,29
Granzelion,tichondrius,1912,warrior,arms,120,61,59
Bigbait,hyjal,1912,warrior,arms,72,36,36
Tankypandazd,stormrage,1910,warrior,arms,198,97,101
Cosmicsteel,tichondrius,1908,warrior,arms,88,51,37
Solastro,malganis,1906,warrior,arms,74,35,39
Destrey,emerald-dream,1905,warrior,arms,71,41,30
Yermalt,tichondrius,1905,warrior,arms,80,41,39
Arivok,hyjal,1905,warrior,arms,143,73,70
Mítos,quelthalas,1904,warrior,arms,198,101,97
Painqt,area-52,1903,warrior,arms,24,20,4
Cutgirl,quelthalas,1903,warrior,arms,74,38,36
Madblackcat,illidan,1902,warrior,arms,58,34,24
Isnlonely,tichondrius,1901,warrior,arms,42,26,16
Rageroidz,area-52,1901,warrior,arms,72,40,32
Azaks,drakkari,1900,warrior,arms,52,28,24
Jadeemerald,kelthuzad,1897,warrior,arms,66,37,29
Míasma,ragnaros,1895,warrior,arms,72,34,38
Salgadoryan,stormrage,1894,warrior,arms,196,95,101
Lícketysplít,ysondre,1893,warrior,arms,52,29,23
Kydrav,khadgar,1891,warrior,arms,52,28,24
Zindawg,frostmourne,1891,warrior,arms,247,123,124
Paoxiaolol,tichondrius,1890,warrior,arms,73,47,26
Jdubz,frostmourne,1889,warrior,arms,66,36,30
Joshiguy,area-52,1889,warrior,arms,78,36,42
Etchiasoko,gurubashi,1888,warrior,arms,48,33,15
Betterthanu,azralon,1885,warrior,arms,174,91,83
Facefïster,malganis,1883,warrior,arms,48,28,20
Baitson,hyjal,1882,warrior,arms,60,30,30
Masumura,kaelthas,1877,warrior,arms,62,31,31
Bùbbájr,emerald-dream,1874,warrior,arms,66,31,35
Dishonorkill,dentarg,1873,warrior,arms,37,25,12
Xîonorc,ragnaros,1872,warrior,arms,189,96,93
Leoneceo,azralon,1871,warrior,arms,90,56,34
Shadowstingg,tichondrius,1871,warrior,arms,71,33,38
Ignid,tichondrius,1871,warrior,arms,108,49,59
Executeqt,azralon,1870,warrior,arms,149,82,67
Huugg,skullcrusher,1870,warrior,arms,99,52,47
Dawx,thrall,1862,warrior,arms,65,32,33
Pezy,frostmourne,1858,warrior,arms,120,59,61
Spìke,thrall,1856,warrior,arms,149,75,74
Pooshshi,illidan,1855,warrior,arms,60,29,31
Falindrah,moon-guard,1854,warrior,arms,66,32,34
Archosaurs,illidan,1854,warrior,arms,48,23,25
Evnine,illidan,1853,warrior,arms,39,29,10
Bakadoom,illidan,1853,warrior,arms,90,53,37
Rafheeki,tichondrius,1853,warrior,arms,90,49,41
Ruzoc,frostmourne,1851,warrior,arms,112,50,62
Demetor,skywall,1850,warrior,arms,53,27,26
Jikith,proudmoore,1847,warrior,arms,48,23,25
Icon,tichondrius,1846,warrior,arms,46,35,11
Blozar,illidan,1846,warrior,arms,60,30,30
Blackpînk,tichondrius,1845,warrior,arms,54,32,22
Randydanger,illidan,1845,warrior,arms,66,32,34
Battousai,kiljaeden,1844,warrior,arms,54,27,27
Sukonamí,draka,1842,warrior,arms,60,33,27
Madwolf,tichondrius,1842,warrior,arms,103,51,52
Krunnknator,azralon,1840,warrior,arms,41,26,15
Kigame,tichondrius,1840,warrior,arms,96,53,43
Narwhål,tichondrius,1840,warrior,arms,90,44,46
Orçaos,ragnaros,1839,warrior,arms,126,73,53
Warney,tichondrius,1838,warrior,arms,53,31,22
Uzza,stormrage,1838,warrior,arms,60,34,26
Draus,nemesis,1838,warrior,arms,119,67,52
Kylewalker,tichondrius,1838,warrior,arms,71,32,39
Adaana,kargath,1836,warrior,arms,119,70,49
Mantrà,skullcrusher,1836,warrior,arms,42,24,18
Szw,tichondrius,1836,warrior,arms,221,124,97
Vatix,sargeras,1836,warrior,arms,50,28,22
Ânticide,darkspear,1836,warrior,arms,78,40,38
Zacharyx,tichondrius,1836,warrior,arms,242,118,124
Croc,frostmourne,1834,warrior,arms,32,21,11
Fleegugeegu,malganis,1834,warrior,arms,90,45,45
Yossarrion,frostwolf,1833,warrior,arms,48,25,23
Arthurjlol,tichondrius,1833,warrior,arms,54,24,30
Brilliance,suramar,1832,warrior,arms,60,30,30
Hildemir,tichondrius,1831,warrior,arms,88,52,36
Darrowshire,moon-guard,1831,warrior,arms,41,23,18
Frëdsmite,kelthuzad,1831,warrior,arms,144,77,67
Zira,thrall,1831,warrior,arms,133,69,64
Damage,malganis,1829,warrior,arms,48,23,25
Bahlahkay,proudmoore,1829,warrior,arms,48,23,25
Ruinenlust,zuljin,1828,warrior,arms,60,28,32
Elpappa,tichondrius,1827,warrior,arms,48,42,6
Sanquelme,ragnaros,1827,warrior,arms,63,32,31
Jonathann,suramar,1827,warrior,arms,132,65,67
Samuluo,tichondrius,1827,warrior,arms,66,30,36
Blaíze,ragnaros,1826,warrior,arms,44,24,20
Grayview,sargeras,1826,warrior,arms,77,41,36
Seblleddo,drakkari,1826,warrior,arms,66,34,32
Rebied,ragnaros,1826,warrior,arms,96,43,53
Warriorbloo,sargeras,1825,warrior,arms,72,39,33
Lebanesemvp,tichondrius,1825,warrior,arms,85,45,40
Sandycrack,blackrock,1825,warrior,arms,60,30,30
Coby,wildhammer,1823,warrior,arms,65,36,29
Gbar,azralon,1823,warrior,arms,79,42,37
Bigdaddyxo,whisperwind,1823,warrior,arms,47,24,23
Cyster,proudmoore,1822,warrior,arms,42,24,18
Kiggs,tichondrius,1822,warrior,arms,48,27,21
Soultarius,area-52,1822,warrior,arms,69,36,33
Kurï,duskwood,1822,warrior,arms,51,24,27
Pkkcrisis,archimonde,1822,warrior,arms,60,28,32
Kamoo,bonechewer,1820,warrior,arms,48,27,21
Meccsecute,tichondrius,1820,warrior,arms,102,54,48
Anautumnday,tichondrius,1820,warrior,arms,48,24,24
Aggnilia,proudmoore,1820,warrior,arms,102,50,52
Honock,ragnaros,1820,warrior,arms,72,34,38
Boomergodx,stormrage,1819,warrior,arms,96,56,40
Badboyjan,tichondrius,1818,warrior,arms,30,19,11
Nilah,tichondrius,1818,warrior,arms,46,26,20
Yeawen,tichondrius,1818,warrior,arms,42,23,19
Nozmok,proudmoore,1818,warrior,arms,65,33,32
Wutains,tichondrius,1818,warrior,arms,65,33,32
Thugdorr,sargeras,1818,warrior,arms,70,33,37
Smashxx,area-52,1816,warrior,arms,95,55,40
Deadhate,sargeras,1816,warrior,arms,54,28,26
Missrend,hyjal,1816,warrior,arms,114,57,57
Strongbaby,tichondrius,1816,warrior,arms,60,30,30
Berzek,area-52,1816,warrior,arms,59,23,36
Destram,kelthuzad,1815,warrior,arms,107,57,50
Icanfixher,moon-guard,1815,warrior,arms,451,222,229
Cammerz,area-52,1815,warrior,arms,78,36,42
Anti,nerzhul,1814,warrior,arms,57,30,27
Dissector,ragnaros,1814,warrior,arms,54,28,26
Zapatín,quelthalas,1814,warrior,arms,67,32,35
Mäddôx,tichondrius,1814,warrior,arms,126,60,66
Slaten,barthilas,1813,warrior,arms,119,63,56
Ðìbs,moon-guard,1813,warrior,arms,59,31,28
Utxpia,azralon,1812,warrior,arms,53,26,27
Onebraincell,stormrage,1811,warrior,arms,48,34,14
Gohrgroc,quelthalas,1811,warrior,arms,48,30,18
Glocç,sargeras,1811,warrior,arms,112,59,53
Knuklez,tichondrius,1811,warrior,arms,64,33,31
Dangerousd,kiljaeden,1811,warrior,arms,60,30,30
Vergerak,tichondrius,1811,warrior,arms,58,29,29
Kaimedran,moon-guard,1810,warrior,arms,48,30,18
Kriloth,frostmourne,1810,warrior,arms,50,30,20
Bussupshut,kelthuzad,1810,warrior,arms,64,32,32
Ürürææae,sargeras,1810,warrior,arms,189,94,95
Darkduet,tichondrius,1810,warrior,arms,70,33,37
Møcat,illidan,1809,warrior,arms,90,52,38
Gryffith,bleeding-hollow,1809,warrior,arms,81,36,45
Vâlôr,tichondrius,1808,warrior,arms,45,30,15
Ciz,emerald-dream,1808,warrior,arms,64,34,30
Spartus,kelthuzad,1808,warrior,arms,78,32,46
Crøm,tichondrius,1807,warrior,arms,48,29,19
Crowsfall,aggramar,1807,warrior,arms,268,141,127
Xiaoheihei,tichondrius,1806,warrior,arms,174,88,86
Sickwidit,kiljaeden,1805,warrior,arms,49,28,21
Noblewinter,sargeras,1805,warrior,arms,36,19,17
Tenskj,proudmoore,1805,warrior,arms,57,30,27
Wootzu,zuljin,1805,warrior,arms,54,27,27
Mildlol,tichondrius,1804,warrior,arms,42,25,17
Rookìe,illidan,1804,warrior,arms,119,67,52
Peinx,ragnaros,1804,warrior,arms,59,31,28
Blackpinkx,tichondrius,1804,warrior,arms,42,19,23
Vascoes,alleria,1803,warrior,arms,168,92,76
Ollena,wyrmrest-accord,1803,warrior,arms,78,40,38
Cgelangdula,tichondrius,1802,warrior,arms,54,28,26
Matesan,jubeithos,1801,warrior,arms,48,28,20
Hìm,tichondrius,1801,warrior,arms,54,28,26
Chakø,tichondrius,1800,warrior,arms,78,42,36
Këther,tichondrius,1800,warrior,arms,66,33,33
Kustybuckets,korgath,1798,warrior,arms,46,27,19
Comehnrfce,illidan,1798,warrior,arms,122,55,67
Überwältigen,thrall,1796,warrior,arms,48,22,26
Stáclin,ragnaros,1795,warrior,arms,392,217,175
Brahmo,kelthuzad,1794,warrior,arms,60,33,27
Ksharer,tichondrius,1793,warrior,arms,83,38,45
Tehfury,area-52,1792,warrior,arms,51,24,27
Sponsored,argent-dawn,1792,warrior,arms,59,26,33
Kruma,stormscale,1791,warrior,arms,37,22,15
Debbie,bleeding-hollow,1790,warrior,arms,60,31,29
Beanbags,zangarmarsh,1790,warrior,arms,72,36,36
Nuvola,tichondrius,1789,warrior,arms,60,33,27
Melifehorde,tichondrius,1787,warrior,arms,48,25,23
Bigglyjoobs,tichondrius,1787,warrior,arms,78,38,40
Forakenna,dragonmaw,1785,warrior,arms,41,27,14
Musclehead,moon-guard,1785,warrior,arms,69,45,24
Wulouzhan,tichondrius,1785,warrior,arms,89,52,37
Nïcowo,ragnaros,1783,warrior,arms,134,67,67
Dabdaddyy,dawnbringer,1783,warrior,arms,99,47,52
Ígnatius,malganis,1781,warrior,arms,48,31,17
Samwolok,tichondrius,1780,warrior,arms,36,19,17
Mecc,tichondrius,1780,warrior,arms,60,29,31
Nanchobo,tichondrius,1778,warrior,arms,66,28,38
Bladebuster,stormrage,1777,warrior,arms,42,23,19
Hoboedd,area-52,1776,warrior,arms,40,22,18
Ariést,bleeding-hollow,1776,warrior,arms,66,30,36
Longzhan,tichondrius,1776,warrior,arms,84,37,47
Sayîon,zuljin,1773,warrior,arms,108,57,51
Undefied,moon-guard,1772,warrior,arms,51,29,22
Cushman,tichondrius,1772,warrior,arms,132,73,59
Picarus,thunderhorn,1772,warrior,arms,60,32,28
Sharer,tichondrius,1772,warrior,arms,36,19,17
Noodlezz,moon-guard,1772,warrior,arms,65,31,34
Skolltonxoxo,tichondrius,1772,warrior,arms,42,20,22
Kaÿip,tichondrius,1771,warrior,arms,66,34,32
Asstastic,bonechewer,1771,warrior,arms,137,64,73
Evach,kelthuzad,1770,warrior,arms,40,21,19
Tùngrâu,frostmourne,1769,warrior,arms,172,89,83
Thlam,muradin,1768,warrior,arms,131,69,62
Dalan,korgath,1766,warrior,arms,48,30,18
Rólex,tichondrius,1766,warrior,arms,54,25,29
Støne,draktharon,1764,warrior,arms,74,41,33
Krbigcow,tichondrius,1764,warrior,arms,96,49,47
Goodlikeplay,ragnaros,1762,warrior,arms,48,25,23
Okita,bleeding-hollow,1761,warrior,arms,118,60,58
Invalidoath,tichondrius,1760,warrior,arms,54,27,27
Dawxw,thrall,1759,warrior,arms,41,24,17
Everchosen,proudmoore,1758,warrior,arms,111,57,54
Yonkerss,garrosh,1756,warrior,arms,95,51,44
Marchdream,tichondrius,1756,warrior,arms,60,32,28
Mirado,tichondrius,1755,warrior,arms,72,38,34
Hbrandy,tichondrius,1752,warrior,arms,71,35,36
Ddaÿ,tichondrius,1752,warrior,arms,53,24,29
Tutifrutiø,azralon,1750,warrior,arms,108,49,59
Warfuse,illidan,1749,warrior,arms,126,63,63
Nànchobo,tichondrius,1749,warrior,arms,72,31,41
Bigdude,frostwolf,1748,warrior,arms,66,38,28
Goonassassin,tichondrius,1748,warrior,arms,48,24,24
Polydopam,tichondrius,1746,warrior,arms,104,53,51
Coldlòve,akama,1744,warrior,arms,36,22,14
Kurodia,quelthalas,1744,warrior,arms,84,35,49
Ogrelurd,malygos,1743,warrior,arms,42,22,20
Brendanshwab,bleeding-hollow,1743,warrior,arms,89,44,45
Iwillcrushyo,darkspear,1743,warrior,arms,54,26,28
Razw,frostmourne,1742,warrior,arms,36,23,13
Dogmar,staghelm,1739,warrior,arms,110,54,56
Wartruë,tichondrius,1738,warrior,arms,256,136,120
Doublezuglol,tichondrius,1737,warrior,arms,162,83,79
Danceylol,barthilas,1736,warrior,arms,78,37,41
Lvlthreemage,fizzcrank,1733,warrior,arms,72,34,38
Nightheller,stormrage,1733,warrior,arms,78,33,45
Hoobaz,area-52,1732,warrior,arms,34,19,15
Slaught,kelthuzad,1731,warrior,arms,76,37,39
Tiredkev,tichondrius,1726,warrior,arms,60,32,28
Mantistabogn,zuluhed,1726,warrior,arms,82,43,39
Swifty,anvilmar,1725,warrior,arms,30,18,12
Crushedlol,bleeding-hollow,1725,warrior,arms,42,22,20
Athalen,nemesis,1724,warrior,arms,67,33,34
Relerocker,area-52,1722,warrior,arms,101,53,48
Swordborne,moon-guard,1722,warrior,arms,94,43,51
Itsfall,tichondrius,1721,warrior,arms,42,21,21
Sick,azralon,1720,warrior,arms,52,27,25
Abbastanza,tichondrius,1720,warrior,arms,77,32,45
Zenrrei,ragnaros,1718,warrior,arms,133,74,59
Afrikunt,tichondrius,1717,warrior,arms,72,38,34
Cåfe,tichondrius,1715,warrior,arms,119,66,53
Mezdrì,quelthalas,1714,warrior,arms,54,33,21
Milough,nesingwary,1714,warrior,arms,124,71,53
Línfert,stormrage,1714,warrior,arms,172,94,78
Smokes,sargeras,1714,warrior,arms,114,55,59
Bigladmike,sargeras,1714,warrior,arms,48,21,27
Odiseo,ragnaros,1713,warrior,arms,38,22,16
Basedaf,frostmourne,1713,warrior,arms,84,45,39
Kilgorath,area-52,1713,warrior,arms,78,37,41
Murderbell,tichondrius,1711,warrior,arms,90,45,45
Alëwar,quelthalas,1711,warrior,arms,60,28,32
Warginger,malygos,1710,warrior,arms,41,23,18
Partyx,tichondrius,1710,warrior,arms,229,117,112
Ggtk,tichondrius,1709,warrior,arms,48,24,24
Pachacutecxx,ragnaros,1708,warrior,arms,75,40,35
Smashies,kelthuzad,1708,warrior,arms,47,24,23
Gromkhor,tichondrius,1708,warrior,arms,72,30,42
Chaytin,bleeding-hollow,1707,warrior,arms,50,27,23
Paoxiaoevs,tichondrius,1707,warrior,arms,36,18,18
Joebo,thrall,1706,warrior,arms,24,20,4
Unhòólyshy,ragnaros,1704,warrior,arms,42,27,15
Cokeroom,tichondrius,1704,warrior,arms,79,46,33
Niubzs,tichondrius,1704,warrior,arms,53,27,26
Tepaste,ragnaros,1704,warrior,arms,54,27,27
Battlestance,shadowsong,1704,warrior,arms,53,22,31
Ðíablø,tichondrius,1703,warrior,arms,71,40,31
Maddawgg,mugthol,1702,warrior,arms,46,23,23
Nuccî,azralon,1702,warrior,arms,47,23,24
Misakizs,illidan,1701,warrior,arms,61,26,35
Zarrdune,darkspear,1700,warrior,arms,30,21,9
Thrator,wyrmrest-accord,1699,warrior,arms,42,23,19
Rocta,tichondrius,1698,warrior,arms,86,47,39
Johnburns,tichondrius,1698,warrior,arms,36,19,17
Urdem,moon-guard,1697,warrior,arms,120,63,57
Warkingx,tichondrius,1696,warrior,arms,36,18,18
Hariban,shuhalo,1695,warrior,arms,65,31,34
Ashtonx,sargeras,1694,warrior,arms,36,24,12
Jubeithos,draktharon,1694,warrior,arms,47,27,20
Genghiz,azralon,1694,warrior,arms,66,36,30
Arx,frostwolf,1694,warrior,arms,153,82,71
Hoodrch,azralon,1694,warrior,arms,65,32,33
Lôwkeyfix,illidan,1694,warrior,arms,96,46,50
Tastý,moon-guard,1694,warrior,arms,54,22,32
Delphont,stormrage,1693,warrior,arms,107,59,48
Wargasmx,tichondrius,1693,warrior,arms,58,27,31
Wolfcultist,moon-guard,1693,warrior,arms,72,32,40
Endstorm,proudmoore,1692,warrior,arms,56,27,29
Zaÿne,moon-guard,1692,warrior,arms,87,41,46
Hookahboss,area-52,1692,warrior,arms,52,24,28
Soloqandy,moon-guard,1692,warrior,arms,72,29,43
Wolfsbanne,khadgar,1690,warrior,arms,138,76,62
Kolosal,tichondrius,1690,warrior,arms,45,22,23
Bozzy,illidan,1690,warrior,arms,77,34,43
Kâdé,malganis,1689,warrior,arms,30,18,12
Lostsummer,frostmourne,1689,warrior,arms,58,31,27
Rflexxo,tichondrius,1688,warrior,arms,48,24,24
Bigbrick,stormrage,1688,warrior,arms,90,44,46
Vargoth,frostmourne,1687,warrior,arms,48,24,24
Raph,barthilas,1686,warrior,arms,42,25,17
Zastrow,dalaran,1686,warrior,arms,84,33,51
Meowdaa,proudmoore,1686,warrior,arms,72,24,48
Pipedoctor,kelthuzad,1685,warrior,arms,36,23,13
Bbyè,tichondrius,1685,warrior,arms,234,121,113
Jdubzr,frostmourne,1685,warrior,arms,54,27,27
Sindevelor,tichondrius,1684,warrior,arms,89,50,39
Bebob,tichondrius,1684,warrior,arms,62,33,29
Bmo,chogall,1684,warrior,arms,87,44,43
Chimbrila,azralon,1684,warrior,arms,102,44,58
Patwong,frostmourne,1683,warrior,arms,90,51,39
Nazraill,aggramar,1683,warrior,arms,75,42,33
Kralo,moon-guard,1683,warrior,arms,51,26,25
Shinigamix,steamwheedle-cartel,1682,warrior,arms,48,29,19
Janjannodie,tichondrius,1682,warrior,arms,41,20,21
Sherrywalken,azralon,1681,warrior,arms,67,36,31
Bloodbath,kiljaeden,1680,warrior,arms,41,21,20
Stonesoup,kelthuzad,1680,warrior,arms,83,33,50
Gtr,illidan,1679,warrior,arms,48,31,17
Gravewurm,twisting-nether,1679,warrior,arms,42,24,18
Dramalas,lightbringer,1679,warrior,arms,269,136,133
Killimanjaro,aggramar,1679,warrior,arms,53,22,31
Twilightrain,tichondrius,1678,warrior,arms,352,187,165
Swagramarr,area-52,1677,warrior,arms,93,51,42
Hèphæstús,sargeras,1677,warrior,arms,120,62,58
Mynameyaff,tichondrius,1676,warrior,arms,133,75,58
Ochinching,tichondrius,1676,warrior,arms,60,24,36
Heater,stormrage,1675,warrior,arms,95,46,49
Matrias,tichondrius,1674,warrior,arms,159,89,70
Bajheera,sargeras,1674,warrior,arms,35,18,17
Fartazz,zuljin,1673,warrior,arms,84,40,44
Franziskaner,frostmourne,1673,warrior,arms,126,59,67
Indominate,tichondrius,1671,warrior,arms,152,72,80
Pusspeepers,kelthuzad,1671,warrior,arms,39,18,21
Heylol,blackhand,1671,warrior,arms,58,25,33
Trágus,azralon,1670,warrior,arms,95,56,39
Qingmei,illidan,1670,warrior,arms,60,26,34
Winota,frostmourne,1669,warrior,arms,30,22,8
Sakutarou,lightbringer,1669,warrior,arms,271,134,137
Axazel,drakkari,1669,warrior,arms,88,43,45
Zenchi,nerzhul,1669,warrior,arms,76,36,40
Brøly,sargeras,1669,warrior,arms,84,38,46
Amlahj,stormrage,1668,warrior,arms,53,30,23
Rarefxck,tichondrius,1668,warrior,arms,84,37,47
Izugyou,thrall,1666,warrior,arms,75,40,35
Bilboswagins,agamaggan,1665,warrior,arms,47,25,22
Marcellùs,proudmoore,1664,warrior,arms,52,29,23
Legoyoda,zuljin,1663,warrior,arms,54,29,25
Edgárllama,sargeras,1663,warrior,arms,38,20,18
Colössal,moon-guard,1663,warrior,arms,94,48,46
Infernae,emerald-dream,1662,warrior,arms,48,30,18
Ystkk,tichondrius,1662,warrior,arms,42,25,17
Warbeshar,area-52,1662,warrior,arms,42,21,21
Hydranoid,ragnaros,1662,warrior,arms,110,54,56
Khørnë,ragnaros,1661,warrior,arms,54,30,24
Tyránny,stormrage,1661,warrior,arms,53,22,31
Killbórn,azralon,1660,warrior,arms,30,19,11
Armamortal,kelthuzad,1659,warrior,arms,239,127,112
Bugsberserk,tichondrius,1658,warrior,arms,107,57,50
Twshizgd,proudmoore,1657,warrior,arms,157,77,80
Kames,garrosh,1657,warrior,arms,107,49,58
Zalakan,malganis,1656,warrior,arms,36,24,12
Golem,frostmourne,1655,warrior,arms,54,27,27
Rogôsh,tichondrius,1655,warrior,arms,54,22,32
Sineatér,frostmourne,1654,warrior,arms,61,30,31
Maktarax,zuljin,1654,warrior,arms,40,18,22
Purrava,tichondrius,1653,warrior,arms,44,23,21
Jehocc,tichondrius,1653,warrior,arms,44,21,23
Rynrak,tichondrius,1653,warrior,arms,41,19,22
Creøn,silvermoon,1650,warrior,arms,68,35,33
Bøek,area-52,1650,warrior,arms,98,45,53
Phabian,frostmourne,1648,warrior,arms,41,22,19
Crowncrumpah,illidan,1647,warrior,arms,36,22,14
Hickorie,sargeras,1646,warrior,arms,96,49,47
Droguernaut,tichondrius,1646,warrior,arms,59,30,29
Sulze,tichondrius,1645,warrior,arms,227,110,117
Xwarz,drakkari,1645,warrior,arms,42,19,23
Morfoggore,ragnaros,1644,warrior,arms,66,34,32
Rainingblooð,blackrock,1644,warrior,arms,103,53,50
Arkkaine,sargeras,1644,warrior,arms,87,44,43
Rhynehardt,scilla,1644,warrior,arms,48,24,24
Kekbyemmr,illidan,1644,warrior,arms,48,22,26
Kpc,tichondrius,1644,warrior,arms,66,25,41
Kromgrall,tichondrius,1643,warrior,arms,161,75,86
Garrmash,hyjal,1642,warrior,arms,199,102,97
Tatsuu,tichondrius,1640,warrior,arms,264,131,133
Sonjeba,malganis,1640,warrior,arms,70,32,38
Fulaixiong,illidan,1639,warrior,arms,51,34,17
Morioso,boulderfist,1639,warrior,arms,66,30,36
Blaiize,ragnaros,1638,warrior,arms,54,22,32
Painsoul,illidan,1636,warrior,arms,53,27,26
Ngu,eldrethalas,1636,warrior,arms,53,26,27
Mavrus,malganis,1634,warrior,arms,36,19,17
Yueren,tichondrius,1634,warrior,arms,54,21,33
Trapbois,tichondrius,1633,warrior,arms,36,22,14
Wingaling,malganis,1633,warrior,arms,54,24,30
Xunxie,tichondrius,1632,warrior,arms,89,49,40
Anukhar,emerald-dream,1632,warrior,arms,84,46,38
Lexíbelle,korgath,1631,warrior,arms,36,21,15
Tatsuujin,sargeras,1631,warrior,arms,50,26,24
Raveve,area-52,1631,warrior,arms,71,36,35
Allyer,darkspear,1630,warrior,arms,66,34,32
Montibello,moon-guard,1630,warrior,arms,78,39,39
Shazbøt,tichondrius,1630,warrior,arms,45,19,26
Delakos,frostmourne,1629,warrior,arms,78,43,35
Groundpound,sargeras,1629,warrior,arms,90,46,44
Furykets,proudmoore,1629,warrior,arms,38,19,19
Evoltoad,illidan,1629,warrior,arms,53,21,32
Draugus,azralon,1628,warrior,arms,52,29,23
Yabahdabah,stormrage,1628,warrior,arms,81,45,36
Bûm,sargeras,1628,warrior,arms,42,23,19
Tatërs,zuljin,1628,warrior,arms,42,22,20
Alteryx,sargeras,1628,warrior,arms,75,36,39
Hõdõnsin,tichondrius,1628,warrior,arms,57,26,31
Mokron,moon-guard,1628,warrior,arms,56,25,31
Ikaikasan,illidan,1627,warrior,arms,32,22,10
Magicalol,tichondrius,1627,warrior,arms,36,21,15
Sosimi,tichondrius,1627,warrior,arms,78,44,34
Wârtorn,darkspear,1627,warrior,arms,42,22,20
Iwillcrushu,tichondrius,1627,warrior,arms,89,45,44
Coollelex,proudmoore,1626,warrior,arms,56,29,27
Zeroskill,cenarius,1626,warrior,arms,60,28,32
Kazecap,proudmoore,1626,warrior,arms,66,29,37
Orgnosh,tichondrius,1625,warrior,arms,96,52,44
Gutting,moon-guard,1625,warrior,arms,36,18,18
Unitsven,barthilas,1625,warrior,arms,54,26,28
Potero,ragnaros,1625,warrior,arms,53,25,28
Duxor,sargeras,1625,warrior,arms,54,24,30
Ironboar,proudmoore,1625,warrior,arms,48,21,27
Faelash,stormrage,1624,warrior,arms,67,32,35
Bddg,tichondrius,1623,warrior,arms,30,18,12
Testflight,tichondrius,1623,warrior,arms,54,30,24
Ryängosling,azralon,1623,warrior,arms,168,92,76
Dotlom,wyrmrest-accord,1623,warrior,arms,144,73,71
Bwandøn,moon-guard,1623,warrior,arms,76,38,38
Lindsanv,illidan,1622,warrior,arms,110,59,51
Larrylurker,proudmoore,1622,warrior,arms,119,62,57
Ciskokido,illidan,1622,warrior,arms,47,24,23
Raahjz,sargeras,1622,warrior,arms,84,38,46
Ðrex,nagrand,1621,warrior,arms,75,42,33
Chadwarr,tichondrius,1621,warrior,arms,31,17,14
Bigbadaxe,sargeras,1621,warrior,arms,36,18,18
Kirown,quelthalas,1621,warrior,arms,98,45,53
Stooklol,tichondrius,1621,warrior,arms,54,22,32
Warrgawd,illidan,1620,warrior,arms,71,38,33
Illing,tichondrius,1620,warrior,arms,214,110,104
Mcluffin,proudmoore,1618,warrior,arms,57,35,22
Timbermack,moon-guard,1618,warrior,arms,96,52,44
Szeo,tichondrius,1617,warrior,arms,24,17,7
Achilex,sargeras,1617,warrior,arms,127,66,61
Brocky,malorne,1617,warrior,arms,485,243,242
Flexìn,tichondrius,1617,warrior,arms,42,21,21
Bromro,tichondrius,1617,warrior,arms,116,55,61
Necroticism,bleeding-hollow,1616,warrior,arms,36,17,19
Slamuëladams,bleeding-hollow,1616,warrior,arms,48,20,28
Ichirisw,tichondrius,1615,warrior,arms,47,23,24
Axellent,gilneas,1614,warrior,arms,70,44,26
Rittylord,frostmourne,1614,warrior,arms,68,37,31
Michaelrossx,bloodhoof,1614,warrior,arms,192,98,94
Metalchileno,ragnaros,1614,warrior,arms,48,20,28
Willcharge,tichondrius,1614,warrior,arms,49,17,32
Myndon,area-52,1613,warrior,arms,37,27,10
Soupwar,moon-guard,1612,warrior,arms,125,63,62
Fluffyarm,sargeras,1612,warrior,arms,198,98,100
Hofukumizuki,tichondrius,1612,warrior,arms,54,21,33
Shaõkahn,nemesis,1611,warrior,arms,46,23,23
Mindgoblin,smolderthorn,1611,warrior,arms,59,29,30
Hugeflopper,malganis,1610,warrior,arms,32,19,13
Scrümp,illidan,1610,warrior,arms,79,44,35
Stormlørd,frostmourne,1610,warrior,arms,76,41,35
Ramzeé,kelthuzad,1609,warrior,arms,78,47,31
Thebigsmash,tichondrius,1609,warrior,arms,42,23,19
Banhaezzi,tichondrius,1609,warrior,arms,154,80,74
Gannïcûs,drakkari,1608,warrior,arms,71,30,41
Liltop,moon-guard,1607,warrior,arms,75,41,34
Furydudz,tichondrius,1607,warrior,arms,42,21,21
Wartrue,tichondrius,1607,warrior,arms,156,71,85
Dokgö,tichondrius,1607,warrior,arms,60,27,33
Asgér,quelthalas,1607,warrior,arms,48,21,27
Ottø,area-52,1606,warrior,arms,72,40,32
Bobu,area-52,1606,warrior,arms,52,28,24
Stick,tichondrius,1606,warrior,arms,119,62,57
Aventajadu,ragnaros,1606,warrior,arms,42,20,22
Brainhaze,tichondrius,1606,warrior,arms,48,21,27
Vanexx,tichondrius,1605,warrior,arms,37,22,15
Maraudertko,area-52,1605,warrior,arms,30,17,13
Dre,anubarak,1605,warrior,arms,53,28,25
Mitigated,bleeding-hollow,1605,warrior,arms,42,22,20
Myxz,barthilas,1605,warrior,arms,120,59,61
Ethuil,azshara,1605,warrior,arms,65,29,36
Jottman,tichondrius,1605,warrior,arms,93,41,52
Morboo,illidan,1604,warrior,arms,48,27,21
Kakamallo,black-dragonflight,1604,warrior,arms,201,109,92
Bìgpoppapump,tichondrius,1604,warrior,arms,114,57,57
Blodreìna,hyjal,1604,warrior,arms,109,53,56
Wurua,tichondrius,1604,warrior,arms,42,20,22
Sayyaf,moon-guard,1604,warrior,arms,57,20,37
Kamoo,gurubashi,1603,warrior,arms,54,41,13
Bleedx,bleeding-hollow,1603,warrior,arms,51,30,21
Yamadaflash,tichondrius,1603,warrior,arms,37,21,16
Zaràki,area-52,1603,warrior,arms,186,95,91
Mahoogler,hakkar,1603,warrior,arms,66,31,35
Malerick,illidan,1603,warrior,arms,63,27,36
Reave,wyrmrest-accord,1602,warrior,arms,42,24,18
Aumni,illidan,1601,warrior,arms,92,43,49
Sheriff,eldrethalas,1600,warrior,arms,54,31,23
Ramparts,moon-guard,1600,warrior,arms,36,17,19
Kilgrah,emerald-dream,1599,warrior,arms,40,21,19
Flavor,aegwynn,1599,warrior,arms,42,20,22
Koberos,queldorei,1599,warrior,arms,66,26,40
Shiv,illidan,1598,warrior,arms,116,60,56
Memorylane,proudmoore,1598,warrior,arms,42,20,22
Yolo,dunemaul,1597,warrior,arms,63,37,26
Benjiprice,sargeras,1597,warrior,arms,35,19,16
Vauquelin,tichondrius,1594,warrior,arms,78,41,37
Rapcherawr,illidan,1593,warrior,arms,33,20,13
Áres,malganis,1593,warrior,arms,268,146,122
Hydrolisk,area-52,1591,warrior,arms,126,63,63
Marvachi,moon-guard,1591,warrior,arms,110,53,57
Theokos,dalaran,1590,warrior,arms,84,41,43
Meatbone,emerald-dream,1589,warrior,arms,84,48,36
Mistrpower,bleeding-hollow,1589,warrior,arms,78,44,34
Gorgan,ragnaros,1589,warrior,arms,90,46,44
Lootacris,illidan,1588,warrior,arms,67,34,33
Ghianna,quelthalas,1586,warrior,arms,65,34,31
Dewbae,whisperwind,1586,warrior,arms,72,37,35
Homebody,uldaman,1585,warrior,arms,38,25,13
Hyperdevil,ragnaros,1585,warrior,arms,35,19,16
Brokthard,ragnaros,1585,warrior,arms,36,18,18
Sheetss,tichondrius,1585,warrior,arms,48,23,25
Dukà,hyjal,1584,warrior,arms,54,30,24
Destructör,nagrand,1584,warrior,arms,93,49,44
Lyliumn,frostmourne,1583,warrior,arms,66,34,32
Ävdol,emerald-dream,1582,warrior,arms,77,37,40
Unkultom,stormrage,1581,warrior,arms,81,46,35
Torzzen,azralon,1581,warrior,arms,99,53,46
Lsays,tichondrius,1581,warrior,arms,127,67,60
Slamedi,frostmourne,1581,warrior,arms,48,20,28
Çrusha,thrall,1581,warrior,arms,42,17,25
Wydstepwar,malganis,1580,warrior,arms,60,38,22
Rongor,drakkari,1580,warrior,arms,54,26,28
Dashballer,sargeras,1578,warrior,arms,42,22,20
Drjuicce,tichondrius,1577,warrior,arms,24,17,7
Bestseason,kelthuzad,1577,warrior,arms,87,48,39
Ragetodef,illidan,1577,warrior,arms,91,45,46
Därkzh,stormrage,1576,warrior,arms,30,20,10
Møønnlight,quelthalas,1576,warrior,arms,77,33,44
Anticiðe,zuljin,1575,warrior,arms,30,18,12
Juuz,frostmourne,1575,warrior,arms,114,56,58
Lunartime,sargeras,1575,warrior,arms,42,20,22
Ferozan,azralon,1575,warrior,arms,42,20,22
Durres,tichondrius,1575,warrior,arms,42,19,23
Vadio,area-52,1575,warrior,arms,40,17,23
Aranacn,tichondrius,1574,warrior,arms,36,22,14
Skronkar,illidan,1574,warrior,arms,126,64,62
Exorbit,sargeras,1573,warrior,arms,30,19,11
Darthbleezy,malygos,1573,warrior,arms,42,22,20
Sinbãd,sargeras,1573,warrior,arms,65,29,36
Ashantia,stormrage,1571,warrior,arms,90,48,42
Yarock,malganis,1571,warrior,arms,84,38,46
Ÿüñí,tichondrius,1570,warrior,arms,42,19,23
Spartiguss,emerald-dream,1569,warrior,arms,35,18,17
Okanos,tichondrius,1569,warrior,arms,42,17,25
Juicylumpia,moon-guard,1568,warrior,arms,48,31,17
PlayerRNKMRN,korgath,1567,warrior,arms,55,35,20
Habakkos,firetree,1567,warrior,arms,60,35,25
Jaybers,malganis,1567,warrior,arms,59,31,28
Gulgosh,stormscale,1566,warrior,arms,59,30,29
Riggragg,tichondrius,1565,warrior,arms,48,28,20
Stickybladez,frostmourne,1565,warrior,arms,130,67,63
Ryank,bonechewer,1565,warrior,arms,48,24,24
Orahard,illidan,1565,warrior,arms,176,86,90
Xkickaxes,tichondrius,1565,warrior,arms,95,46,49
Enzoh,zuljin,1565,warrior,arms,80,25,55
Pigzig,nagrand,1564,warrior,arms,36,18,18
Endurefen,sargeras,1563,warrior,arms,24,17,7
Nyle,zuljin,1563,warrior,arms,84,44,40
Kenshín,ragnaros,1563,warrior,arms,65,27,38
Ohanaglad,illidan,1562,warrior,arms,120,64,56
Chogar,proudmoore,1562,warrior,arms,64,34,30
Chañ,tichondrius,1562,warrior,arms,36,19,17
Executie,duskwood,1562,warrior,arms,73,36,37
Nerdstompêr,illidan,1561,warrior,arms,66,29,37
Hônor,ragnaros,1558,warrior,arms,54,24,30
Claymation,tichondrius,1558,warrior,arms,48,18,30
Kénjar,tichondrius,1556,warrior,arms,30,20,10
Alator,gorgonnash,1556,warrior,arms,36,21,15
Firesx,tichondrius,1555,warrior,arms,36,20,16
Devildriver,malganis,1555,warrior,arms,78,43,35
Gorez,ragnaros,1555,warrior,arms,42,21,21
Arctures,stormrage,1554,warrior,arms,72,45,27
Azindar,gilneas,1554,warrior,arms,42,21,21
Jenkin,korgath,1554,warrior,arms,36,18,18
Naejwar,ragnaros,1552,warrior,arms,164,85,79
Lilreese,tichondrius,1552,warrior,arms,66,34,32
Soez,tichondrius,1551,warrior,arms,28,20,8
Blíding,ragnaros,1551,warrior,arms,75,28,47
Ghóstx,alleria,1550,warrior,arms,53,37,16
Aragorn,mannoroth,1550,warrior,arms,36,19,17
Titanzz,quelthalas,1550,warrior,arms,71,35,36
Pachacutec,area-52,1550,warrior,arms,80,36,44
Rèckit,thrall,1550,warrior,arms,48,21,27
Zzchocolate,illidan,1549,warrior,arms,84,36,48
Itskel,stormreaver,1546,warrior,arms,44,23,21
Johnnysmizle,kelthuzad,1546,warrior,arms,84,38,46
Brostormftw,shattered-halls,1544,warrior,arms,72,43,29
Kowboy,stormrage,1544,warrior,arms,120,62,58
Radox,tichondrius,1544,warrior,arms,54,27,27
Hanadaddy,frostmourne,1544,warrior,arms,175,86,89
Zyppz,sargeras,1543,warrior,arms,38,26,12
Lykemore,moon-guard,1542,warrior,arms,74,41,33
Know,anetheron,1542,warrior,arms,98,45,53
Bozwar,tichondrius,1541,warrior,arms,60,33,27
Wingedknight,malganis,1541,warrior,arms,98,47,51
Galehna,ragnaros,1541,warrior,arms,41,17,24
Uhttercow,tichondrius,1539,warrior,arms,66,33,33
Flexeçute,moon-guard,1539,warrior,arms,72,34,38
Slitt,azralon,1538,warrior,arms,78,42,36
Perrin,burning-blade,1538,warrior,arms,43,21,22
Cowtipin,illidan,1538,warrior,arms,110,50,60
Ôn,tichondrius,1537,warrior,arms,159,76,83
Underbite,area-52,1536,warrior,arms,54,33,21
Akkar,gilneas,1536,warrior,arms,69,40,29
Aloregorey,malganis,1536,warrior,arms,96,45,51
Nitron,dawnbringer,1535,warrior,arms,24,16,8
Amputate,akama,1535,warrior,arms,53,20,33
Trackstarz,llane,1534,warrior,arms,201,103,98
Nornogin,tichondrius,1534,warrior,arms,66,31,35
Rohta,kiljaeden,1533,warrior,arms,77,36,41
Rokgral,tichondrius,1531,warrior,arms,56,29,27
Chillimus,tichondrius,1530,warrior,arms,48,23,25
Maddorlon,thrall,1530,warrior,arms,53,24,29
Hanzmat,illidan,1529,warrior,arms,30,16,14
Ratfang,zuljin,1528,warrior,arms,28,17,11
Stinkyw,tichondrius,1528,warrior,arms,49,27,22
Tkazo,tichondrius,1527,warrior,arms,35,17,18
Yiplaw,stormrage,1526,warrior,arms,30,16,14
Zaddybear,aerie-peak,1526,warrior,arms,45,23,22
Yawdamper,illidan,1525,warrior,arms,30,21,9
Flynnstone,tichondrius,1524,warrior,arms,30,19,11
Chinamonk,tichondrius,1524,warrior,arms,101,49,52
Hannibalkng,zangarmarsh,1524,warrior,arms,52,20,32
Lokityr,tichondrius,1523,warrior,arms,108,67,41
Lionbuster,ragnaros,1523,warrior,arms,36,22,14
Ewenki,tichondrius,1523,warrior,arms,159,83,76
Monstersynde,nemesis,1523,warrior,arms,108,54,54
Gwlade,sargeras,1522,warrior,arms,198,104,94
Traumaj,bleeding-hollow,1521,warrior,arms,129,68,61
Joesbàr,tichondrius,1521,warrior,arms,54,24,30
Kimed,nordrassil,1520,warrior,arms,30,16,14
Unstàble,frostmourne,1520,warrior,arms,66,34,32
Metalwarr,illidan,1520,warrior,arms,53,27,26
Spartacam,frostmourne,1520,warrior,arms,166,83,83
Elchacál,ragnaros,1520,warrior,arms,66,27,39
Randysnapper,zuljin,1519,warrior,arms,24,16,8
Ichigö,gundrak,1519,warrior,arms,51,25,26
Rukittenme,area-52,1519,warrior,arms,72,29,43
Cosmosz,illidan,1518,warrior,arms,60,35,25
Powerbucks,tichondrius,1518,warrior,arms,32,17,15
Noyel,tichondrius,1518,warrior,arms,40,18,22
Sigfir,ragnaros,1517,warrior,arms,58,31,27
Malakaimapk,korgath,1517,warrior,arms,30,16,14
Warriordanim,tichondrius,1517,warrior,arms,150,67,83
Bainian,tichondrius,1516,warrior,arms,49,25,24
Pelonna,drakkari,1516,warrior,arms,126,61,65
Damiansuv,moon-guard,1516,warrior,arms,153,73,80
Jimjinjin,tichondrius,1515,warrior,arms,30,16,14
Grumtak,azralon,1515,warrior,arms,41,20,21
Cronguin,bleeding-hollow,1515,warrior,arms,36,17,19
Rads,stormscale,1514,warrior,arms,69,39,30
Brayitann,illidan,1514,warrior,arms,49,27,22
Chupelo,tichondrius,1513,warrior,arms,24,18,6
Dtrumpo,moon-guard,1513,warrior,arms,52,27,25
Ginormous,rivendare,1513,warrior,arms,63,31,32
Elevate,whisperwind,1513,warrior,arms,36,16,20
Tuvia,malganis,1511,warrior,arms,177,89,88
Wmf,frostmourne,1511,warrior,arms,90,42,48
Warthok,turalyon,1511,warrior,arms,46,21,25
Raala,cenarius,1510,warrior,arms,51,34,17
Cathillex,eonar,1510,warrior,arms,24,16,8
Tríxman,moon-guard,1510,warrior,arms,106,61,45
Draganovich,aerie-peak,1509,warrior,arms,54,30,24
Karrosh,agamaggan,1509,warrior,arms,42,18,24
Doomreaper,hellscream,1508,warrior,arms,71,40,31
Punknicanor,quelthalas,1508,warrior,arms,66,33,33
Hotdadparty,frostmourne,1508,warrior,arms,103,51,52
Cagrekk,wyrmrest-accord,1507,warrior,arms,53,28,25
Machete,nemesis,1507,warrior,arms,76,40,36
Wilric,ragnaros,1507,warrior,arms,36,16,20
Dysensor,illidan,1506,warrior,arms,60,33,27
Geñeralguap,tichondrius,1506,warrior,arms,192,102,90
Ogeezus,crushridge,1506,warrior,arms,42,20,22
Legbreaker,tichondrius,1504,warrior,arms,70,37,33
Lilmerman,laughing-skull,1504,warrior,arms,59,30,29
Pocserwar,drakkari,1504,warrior,arms,36,16,20
Wouili,zuljin,1503,warrior,arms,97,59,38
Bottlecaps,shadowmoon,1502,warrior,arms,51,25,26
Nagaboner,frostmourne,1501,warrior,arms,77,45,32
Neotico,quelthalas,1501,warrior,arms,50,22,28
Swólepetrol,tichondrius,1499,warrior,arms,30,16,14
Marsoc,burning-legion,1499,warrior,arms,36,17,19
Lehzera,frostmourne,1499,warrior,arms,74,34,40
Boypartz,onyxia,1499,warrior,arms,42,16,26
Auzery,emerald-dream,1498,warrior,arms,42,17,25
Tcchmm,akama,1497,warrior,arms,64,28,36
Enilaw,proudmoore,1496,warrior,arms,62,36,26
Crustyfella,stormrage,1496,warrior,arms,52,28,24
Danield,illidan,1496,warrior,arms,42,16,26
Flintish,moon-guard,1495,warrior,arms,48,30,18
Ralphy,lightnings-blade,1495,warrior,arms,88,48,40
Achillescool,tichondrius,1495,warrior,arms,60,28,32
Dajva,ragnaros,1495,warrior,arms,48,20,28
Oppressor,darkspear,1494,warrior,arms,77,37,40
Gorenay,nemesis,1494,warrior,arms,36,17,19
Datneck,tichondrius,1493,warrior,arms,30,16,14
Kastenz,frostmourne,1493,warrior,arms,55,25,30
Horsekok,tichondrius,1492,warrior,arms,30,19,11
Pepétí,azralon,1492,warrior,arms,148,68,80
Aggorak,illidan,1492,warrior,arms,36,16,20
Sáítámá,tichondrius,1491,warrior,arms,58,30,28
Fraannky,windrunner,1490,warrior,arms,90,47,43
Roidraging,thunderlord,1490,warrior,arms,149,66,83
Garadiels,tichondrius,1490,warrior,arms,73,31,42
Sinsinatra,azralon,1489,warrior,arms,174,85,89
Rockstedy,area-52,1489,warrior,arms,68,31,37
Taywar,sargeras,1488,warrior,arms,60,29,31
Casablancas,azralon,1488,warrior,arms,42,16,26
Dragvovar,thrall,1488,warrior,arms,42,16,26
Zänn,dalaran,1486,warrior,arms,60,38,22
Painfulsin,tichondrius,1486,warrior,arms,42,19,23
Krimgar,quelthalas,1485,warrior,arms,76,32,44
Karnakk,thrall,1485,warrior,arms,41,16,25
Elyll,tichondrius,1484,warrior,arms,30,16,14
Peacemake,tichondrius,1484,warrior,arms,39,20,19
Braxin,dalaran,1483,warrior,arms,77,42,35
Earlsiriuz,tichondrius,1483,warrior,arms,51,23,28
Kolossux,ragnaros,1482,warrior,arms,66,35,31
Jäÿ,proudmoore,1482,warrior,arms,63,31,32
Islik,stormrage,1482,warrior,arms,73,35,38
Frankoiz,quelthalas,1482,warrior,arms,42,19,23
Visenyä,mannoroth,1481,warrior,arms,52,21,31
Kissmyaxê,tichondrius,1480,warrior,arms,57,24,33
Brutallicus,kelthuzad,1479,warrior,arms,33,17,16
Tommytimbo,destromath,1479,warrior,arms,37,16,21
Volstraya,frostmourne,1478,warrior,arms,36,18,18
Shortgoofy,sargeras,1477,warrior,arms,129,61,68
Crystaríum,stormrage,1477,warrior,arms,79,37,42
Rainzy,stormrage,1476,warrior,arms,36,16,20
Andrès,sargeras,1475,warrior,arms,54,21,33
Weedow,proudmoore,1474,warrior,arms,29,16,13
Themudcrab,frostmourne,1474,warrior,arms,303,146,157
Himer,tichondrius,1474,warrior,arms,42,17,25
Saîyanroyce,barthilas,1473,warrior,arms,137,69,68
Armsprotfury,tichondrius,1472,warrior,arms,48,30,18
Furyass,bleeding-hollow,1472,warrior,arms,120,65,55
Fatnfurious,dunemaul,1472,warrior,arms,88,46,42
Rimz,sargeras,1472,warrior,arms,39,20,19
Naughtytwat,tichondrius,1472,warrior,arms,183,90,93
Dann,ragnaros,1472,warrior,arms,84,39,45
Radagøn,drakkari,1472,warrior,arms,36,16,20
Malvadin,stormrage,1472,warrior,arms,48,19,29
Lòrdnasher,tichondrius,1471,warrior,arms,53,29,24
Ninefingers,madoran,1471,warrior,arms,48,26,22
Arthwarf,proudmoore,1470,warrior,arms,60,29,31
Baul,area-52,1469,warrior,arms,59,31,28
Gerztok,aggramar,1469,warrior,arms,34,17,17
Dáinsleif,frostmourne,1469,warrior,arms,36,17,19
Mardrex,korgath,1469,warrior,arms,36,16,20
Smokedaperc,illidan,1468,warrior,arms,84,44,40
Jeffo,amanthul,1468,warrior,arms,38,18,20
Thurman,spirestone,1467,warrior,arms,44,26,18
Theisius,tichondrius,1466,warrior,arms,51,19,32
Barbatenaz,ragnaros,1465,warrior,arms,48,18,30
Eggroll,emerald-dream,1465,warrior,arms,47,17,30
Torimzor,nemesis,1464,warrior,arms,138,74,64
Toughguts,saurfang,1464,warrior,arms,60,29,31
Bricksquad,mannoroth,1464,warrior,arms,57,25,32
Frashes,darkspear,1463,warrior,arms,55,26,29
Bigdingus,frostwolf,1463,warrior,arms,60,28,32
Moonär,emerald-dream,1463,warrior,arms,60,27,33
Tekaiatsu,tichondrius,1462,warrior,arms,107,61,46
Duroxzee,area-52,1462,warrior,arms,187,100,87
Tzumugi,ragnaros,1462,warrior,arms,277,142,135
Paddyj,illidan,1462,warrior,arms,45,23,22
Skollyd,tichondrius,1462,warrior,arms,38,17,21
Sertss,proudmoore,1462,warrior,arms,71,30,41
Druckerz,lightnings-blade,1462,warrior,arms,60,23,37
Golkän,goldrinn,1461,warrior,arms,66,34,32
Ihadnochoice,barthilas,1461,warrior,arms,256,126,130
Muskratz,tichondrius,1461,warrior,arms,147,72,75
Brewstrike,dalaran,1461,warrior,arms,42,20,22
Supersquish,moon-guard,1460,warrior,arms,54,29,25
Slyith,shadow-council,1460,warrior,arms,77,38,39
Nabiouscx,malganis,1460,warrior,arms,101,47,54
Asgaurdius,thunderlord,1459,warrior,arms,60,31,29
Raves,quelthalas,1459,warrior,arms,60,22,38
Riskydevil,azralon,1458,warrior,arms,58,32,26
Dennlss,quelthalas,1458,warrior,arms,84,39,45
Warlow,korgath,1458,warrior,arms,64,29,35
Mommysharky,illidan,1457,warrior,arms,36,26,10
Dathalidus,area-52,1457,warrior,arms,50,32,18
Zizwe,proudmoore,1457,warrior,arms,65,35,30
Creepi,sargeras,1457,warrior,arms,56,30,26
Zeerohkool,malganis,1457,warrior,arms,68,31,37
Bullmastic,deathwing,1456,warrior,arms,46,21,25
Warsongwolf,tichondrius,1456,warrior,arms,38,16,22
Pongk,tichondrius,1456,warrior,arms,57,17,40
Amaragos,tichondrius,1455,warrior,arms,62,37,25
Jotto,zuljin,1455,warrior,arms,36,18,18
Jrod,boulderfist,1455,warrior,arms,192,95,97
Xaka,tichondrius,1455,warrior,arms,42,19,23
Dou,barthilas,1454,warrior,arms,29,18,11
Bryk,korgath,1454,warrior,arms,30,17,13
Zhânshen,tichondrius,1454,warrior,arms,48,24,24
Seukkang,tichondrius,1454,warrior,arms,36,16,20
Lionssong,bleeding-hollow,1454,warrior,arms,71,31,40
Doves,tichondrius,1453,warrior,arms,33,16,17
Mailløche,bleeding-hollow,1452,warrior,arms,60,32,28
Xenogears,boulderfist,1452,warrior,arms,96,51,45
Luosifen,tichondrius,1452,warrior,arms,185,93,92
Banggo,frostmourne,1450,warrior,arms,60,36,24
Biznizwar,sargeras,1450,warrior,arms,124,61,63
Isarat,illidan,1450,warrior,arms,48,23,25
Qetimporta,quelthalas,1449,warrior,arms,96,54,42
Erple,eldrethalas,1449,warrior,arms,116,54,62
Haxzors,sargeras,1448,warrior,arms,54,24,30
Wellowarr,moon-guard,1448,warrior,arms,78,34,44
Dcashmoney,moon-guard,1448,warrior,arms,66,28,38
Balroge,illidan,1447,warrior,arms,48,22,26
Radamäntthys,nemesis,1447,warrior,arms,93,39,54
Gtatewarr,azjolnerub,1446,warrior,arms,26,16,10
Overswing,tichondrius,1446,warrior,arms,78,32,46
Rárict,moon-guard,1445,warrior,arms,46,26,20
Shawnemd,proudmoore,1445,warrior,arms,54,29,25
Streetdog,stormrage,1445,warrior,arms,48,23,25
Belldor,barthilas,1445,warrior,arms,72,28,44
Iigotu,tichondrius,1444,warrior,arms,220,108,112
Coisini,tichondrius,1443,warrior,arms,79,41,38
Aoste,tichondrius,1442,warrior,arms,61,33,28
Ashbringera,proudmoore,1442,warrior,arms,120,57,63
Kréix,sargeras,1442,warrior,arms,59,27,32
Destoryhamer,illidan,1441,warrior,arms,96,51,45
Lisande,sargeras,1440,warrior,arms,70,40,30
Ðêad,area-52,1439,warrior,arms,24,15,9
Bigjbs,tichondrius,1439,warrior,arms,24,15,9
Rekatron,area-52,1439,warrior,arms,30,15,15
Crownzz,tichondrius,1439,warrior,arms,30,15,15
Yunnkel,ragnaros,1439,warrior,arms,110,53,57
Darkfang,icecrown,1438,warrior,arms,48,26,22
Jichelei,tichondrius,1438,warrior,arms,72,35,37
Loosz,stormrage,1438,warrior,arms,36,15,21
Brotu,nemesis,1437,warrior,arms,151,85,66
Themessiah,stormrage,1437,warrior,arms,59,33,26
Graelus,terenas,1437,warrior,arms,43,24,19
Jellybomb,sargeras,1437,warrior,arms,186,92,94
Volkz,ragnaros,1437,warrior,arms,47,19,28
Stufit,emerald-dream,1436,warrior,arms,34,20,14
Slamix,area-52,1436,warrior,arms,63,33,30
Bigbadbaka,thaurissan,1435,warrior,arms,36,15,21
Nikon,bleeding-hollow,1435,warrior,arms,42,16,26
Vainamóinen,kelthuzad,1433,warrior,arms,24,15,9
Gooshin,sargeras,1433,warrior,arms,109,58,51
Monowarx,frostmourne,1433,warrior,arms,46,22,24
Helrise,sargeras,1432,warrior,arms,30,15,15
Ushouldnome,tichondrius,1432,warrior,arms,30,15,15
Ôxluck,ragnaros,1432,warrior,arms,92,34,58
Maywarro,ragnaros,1431,warrior,arms,42,23,19
Badguys,illidan,1431,warrior,arms,36,15,21
Kushhy,illidan,1429,warrior,arms,45,19,26
Destroid,zuljin,1428,warrior,arms,24,15,9
Klouddraft,tichondrius,1428,warrior,arms,39,22,17
Laintimee,tichondrius,1428,warrior,arms,56,30,26
Ginthril,magtheridon,1428,warrior,arms,108,46,62
Dorianfrost,ravenholdt,1428,warrior,arms,66,24,42
Shiiftybuga,frostmourne,1427,warrior,arms,50,27,23
Shishokun,quelthalas,1427,warrior,arms,76,35,41
Hulkbuster,ragnaros,1427,warrior,arms,42,18,24
Kadira,stormrage,1427,warrior,arms,90,37,53
Calmebigfeet,tichondrius,1426,warrior,arms,30,15,15
Donivan,illidan,1425,warrior,arms,30,15,15
Robodad,illidan,1425,warrior,arms,30,15,15
Dinogc,barthilas,1424,warrior,arms,32,17,15
Aesom,wyrmrest-accord,1423,warrior,arms,133,73,60
Ángron,ragnaros,1423,warrior,arms,74,37,37
Tergll,illidan,1423,warrior,arms,51,23,28
Cjz,tichondrius,1422,warrior,arms,42,25,17
Ooze,darkspear,1422,warrior,arms,81,46,35
Automator,proudmoore,1422,warrior,arms,36,15,21
Beaerboy,darkspear,1421,warrior,arms,113,50,63
Mahkrash,quelthalas,1420,warrior,arms,47,22,25
Sleazedog,kelthuzad,1420,warrior,arms,48,21,27
Waraze,tichondrius,1420,warrior,arms,42,17,25
Orctiddy,emerald-dream,1419,warrior,arms,32,16,16
Erradic,sargeras,1419,warrior,arms,30,15,15
Mopwarrior,sargeras,1419,warrior,arms,30,15,15
Karrok,zuluhed,1418,warrior,arms,210,99,111
Dreadedbeef,area-52,1417,warrior,arms,24,15,9
Alexitwo,ragnaros,1416,warrior,arms,66,36,30
Cheeriozz,thrall,1416,warrior,arms,48,26,22
Ártorius,sargeras,1416,warrior,arms,108,53,55
Aaryn,caelestrasz,1415,warrior,arms,104,56,48
Ughh,bleeding-hollow,1415,warrior,arms,42,21,21
Ukris,area-52,1414,warrior,arms,89,48,41
Bestid,tichondrius,1414,warrior,arms,36,19,17
Kahuwuna,tichondrius,1414,warrior,arms,30,15,15
Scumrat,frostmourne,1414,warrior,arms,66,32,34
Bâlthor,quelthalas,1413,warrior,arms,120,59,61
Korboc,malganis,1413,warrior,arms,60,29,31
Slickpapi,area-52,1413,warrior,arms,93,44,49
Muertededios,quelthalas,1412,warrior,arms,141,70,71
Ëssex,tichondrius,1412,warrior,arms,83,38,45
Shadderaz,sargeras,1411,warrior,arms,66,30,36
Dropopen,tichondrius,1411,warrior,arms,54,17,37
Tusktrollmon,illidan,1410,warrior,arms,104,53,51
Áustin,sargeras,1409,warrior,arms,24,15,9
Atróx,quelthalas,1409,warrior,arms,30,15,15
Utgarde,stormrage,1408,warrior,arms,200,101,99
Warthorns,malganis,1408,warrior,arms,49,17,32
Rägar,quelthalas,1407,warrior,arms,49,25,24
Ponchetas,quelthalas,1407,warrior,arms,60,28,32
Kannzox,quelthalas,1406,warrior,arms,79,40,39
Solano,illidan,1405,warrior,arms,48,30,18
Blokz,arthas,1405,warrior,arms,42,26,16
Bruttallis,frostmane,1405,warrior,arms,51,25,26
Hoodlark,lightbringer,1405,warrior,arms,78,30,48
Baix,frostmourne,1404,warrior,arms,63,35,28
Tithousand,tichondrius,1404,warrior,arms,45,24,21
Broodthorne,tichondrius,1404,warrior,arms,30,15,15
Rhohan,ysera,1404,warrior,arms,77,38,39
Yummysushi,gorgonnash,1404,warrior,arms,76,31,45
Leapgodx,drenden,1403,warrior,arms,24,15,9
Mortalstrike,chogall,1403,warrior,arms,52,25,27
Aloloco,ragnaros,1403,warrior,arms,66,30,36
Arot,bloodhoof,1403,warrior,arms,117,52,65
Zareos,azralon,1403,warrior,arms,40,17,23
Bløødy,lethon,1402,warrior,arms,26,17,9
Roughknuckle,kelthuzad,1402,warrior,arms,29,15,14
Supremegalek,tichondrius,1401,warrior,arms,88,46,42
Aión,nemesis,1400,warrior,arms,24,17,7
Thaisyta,tichondrius,1400,warrior,arms,30,19,11
Dubstoob,illidan,1400,warrior,arms,148,77,71
Buntpunt,mannoroth,1400,warrior,arms,109,53,56
Blightscream,bleeding-hollow,1400,warrior,arms,130,60,70
Kappis,illidan,1399,warrior,arms,41,23,18
Peeb,tichondrius,1399,warrior,arms,30,15,15
Hêllseeker,ragnaros,1399,warrior,arms,78,37,41
Tern,emerald-dream,1398,warrior,arms,82,42,40
Ikrad,quelthalas,1398,warrior,arms,84,42,42
Coolade,thunderhorn,1398,warrior,arms,70,33,37
Tenebrous,nemesis,1397,warrior,arms,48,20,28
Rokó,illidan,1396,warrior,arms,72,34,38
Edwiddin,frostmourne,1396,warrior,arms,68,31,37
Varith,sargeras,1394,warrior,arms,36,20,16
Vayper,illidan,1394,warrior,arms,48,23,25
Allenwrite,frostmourne,1394,warrior,arms,36,17,19
Ghostmourne,ragnaros,1393,warrior,arms,181,88,93
Disarmiea,cairne,1393,warrior,arms,69,31,38
Magnar,zuljin,1392,warrior,arms,42,25,17
Vanglorio,azralon,1392,warrior,arms,81,44,37
Gusbus,malganis,1392,warrior,arms,112,60,52
Märkdî,quelthalas,1392,warrior,arms,30,16,14
Zaurka,sargeras,1391,warrior,arms,30,18,12
Bigster,malganis,1391,warrior,arms,30,16,14
Nicegirl,sargeras,1391,warrior,arms,69,36,33
Martyferrari,black-dragonflight,1391,warrior,arms,60,30,30
Thorado,nemesis,1391,warrior,arms,104,51,53
Warrgodlol,illidan,1391,warrior,arms,33,15,18
Zeerohkool,tichondrius,1391,warrior,arms,102,46,56
Wapistun,thrall,1390,warrior,arms,42,21,21
Saleem,tichondrius,1390,warrior,arms,205,100,105
Khargrok,ragnaros,1389,warrior,arms,30,15,15
Túrin,quelthalas,1389,warrior,arms,75,34,41
Apallô,tichondrius,1388,warrior,arms,89,40,49
Saltyundies,tichondrius,1387,warrior,arms,117,54,63
Momojojo,daggerspine,1385,warrior,arms,26,18,8
Morhgath,bonechewer,1385,warrior,arms,49,26,23
Kilrosao,nordrassil,1385,warrior,arms,83,43,40
Chanchoswar,ragnaros,1385,warrior,arms,93,41,52
Soltrain,stormrage,1385,warrior,arms,68,29,39
Yirko,quelthalas,1385,warrior,arms,74,31,43
Sludgthwaps,stormrage,1383,warrior,arms,59,29,30
Kanamechan,area-52,1383,warrior,arms,65,24,41
Holddapoop,area-52,1382,warrior,arms,36,19,17
Ghostss,tichondrius,1382,warrior,arms,67,29,38
Eîghtysîx,sargeras,1382,warrior,arms,100,43,57
Rivenz,moon-guard,1382,warrior,arms,57,20,37
Verain,thrall,1381,warrior,arms,36,17,19
Bagur,ragnaros,1380,warrior,arms,114,61,53
Typhön,tichondrius,1380,warrior,arms,77,31,46
Drekzul,azralon,1379,warrior,arms,24,15,9
Grimus,bleeding-hollow,1379,warrior,arms,70,38,32
Weepingdeath,burning-legion,1379,warrior,arms,60,30,30
Killtarget,tichondrius,1377,warrior,arms,76,42,34
Gwendolynl,hyjal,1377,warrior,arms,73,35,38
Tdestroy,ragnaros,1376,warrior,arms,33,17,16
Luckyw,draktharon,1375,warrior,arms,42,23,19
Beowúlf,burning-blade,1375,warrior,arms,41,16,25
Dolkal,tichondrius,1375,warrior,arms,57,21,36
Asc,barthilas,1374,warrior,arms,171,89,82
Danzohh,dalaran,1374,warrior,arms,33,15,18
Nightshauyia,kelthuzad,1373,warrior,arms,51,27,24
Machineofwar,zuluhed,1373,warrior,arms,138,65,73
Rushour,quelthalas,1372,warrior,arms,32,15,17
Storkos,moon-guard,1371,warrior,arms,107,57,50
Kinzi,quelthalas,1371,warrior,arms,94,38,56
Xradull,dawnbringer,1370,warrior,arms,44,25,19
Ðarkstar,zuljin,1370,warrior,arms,140,62,78
Justfair,barthilas,1368,warrior,arms,51,28,23
Budzie,frostwolf,1368,warrior,arms,34,18,16
Powerhard,area-52,1368,warrior,arms,57,26,31
Fatty,mugthol,1367,warrior,arms,24,16,8
Dhaemom,azralon,1366,warrior,arms,133,69,64
Evilkorean,tichondrius,1366,warrior,arms,59,29,30
Durko,whisperwind,1365,warrior,arms,36,16,20
Danzael,quelthalas,1364,warrior,arms,42,18,24
Xampuu,ragnaros,1363,warrior,arms,34,20,14
Rayks,tichondrius,1363,warrior,arms,60,34,26
Theragar,kilrogg,1363,warrior,arms,36,20,16
Sevala,spinebreaker,1363,warrior,arms,58,32,26
Juicey,burning-blade,1363,warrior,arms,43,22,21
Gritrog,thrall,1362,warrior,arms,50,37,13
Neozsmash,thrall,1362,warrior,arms,58,29,29
Mjorn,sargeras,1362,warrior,arms,64,30,34
Yummybumbum,barthilas,1362,warrior,arms,60,26,34
Hopar,illidan,1361,warrior,arms,39,23,16
Mervyn,aegwynn,1360,warrior,arms,48,29,19
Allgas,barthilas,1360,warrior,arms,107,58,49
Warsaínt,area-52,1360,warrior,arms,65,31,34
Lègèndáry,dark-iron,1359,warrior,arms,48,21,27
Tigo,khaz-modan,1358,warrior,arms,81,44,37
Davidorco,drakkari,1358,warrior,arms,41,19,22
Rikuduo,quelthalas,1358,warrior,arms,102,46,56
Estivador,kelthuzad,1358,warrior,arms,50,21,29
Drygen,tichondrius,1357,warrior,arms,36,22,14
Toagrim,azralon,1357,warrior,arms,36,17,19
Caupølican,ragnaros,1356,warrior,arms,60,28,32
Bùlk,barthilas,1355,warrior,arms,77,33,44
Kratosxx,quelthalas,1355,warrior,arms,35,15,20
Doomreaprr,hellscream,1354,warrior,arms,28,18,10
Rapralph,barthilas,1354,warrior,arms,30,15,15
Lowlow,lightbringer,1354,warrior,arms,36,16,20
Rockadoodle,tichondrius,1353,warrior,arms,48,22,26
Silverkiller,drakkari,1352,warrior,arms,51,26,25
Týrodar,moon-guard,1352,warrior,arms,36,16,20
Browneyed,area-52,1352,warrior,arms,36,15,21
Nviv,proudmoore,1351,warrior,arms,90,40,50
Kror,garona,1350,warrior,arms,59,27,32
Swordmasters,icecrown,1350,warrior,arms,42,18,24
Rampage,azralon,1349,warrior,arms,125,59,66
Ximzhao,quelthalas,1348,warrior,arms,42,21,21
Cauldrin,bleeding-hollow,1348,warrior,arms,60,29,31
Jsolucky,thrall,1348,warrior,arms,36,15,21
Thegoochgoon,malorne,1347,warrior,arms,57,31,26
Dimus,area-52,1347,warrior,arms,36,15,21
Zaexx,stormrage,1346,warrior,arms,59,29,30
Scrapx,malganis,1346,warrior,arms,107,51,56
Rasgriz,moon-guard,1346,warrior,arms,43,20,23
Tasesino,quelthalas,1345,warrior,arms,40,21,19
ßaldbornë,stormrage,1344,warrior,arms,94,47,47
Jeffe,khadgar,1344,warrior,arms,74,30,44
Warraaxx,stonemaul,1343,warrior,arms,48,25,23
Notmagnusz,zuljin,1343,warrior,arms,30,14,16
Legday,stormrage,1343,warrior,arms,30,14,16
Wtssap,ragnaros,1342,warrior,arms,24,14,10
Twobyfuor,sargeras,1342,warrior,arms,48,23,25
Niudazhuang,tichondrius,1341,warrior,arms,76,43,33
Handkerchief,bleeding-hollow,1341,warrior,arms,31,15,16
Gentlehugs,illidan,1340,warrior,arms,36,14,22
Sunamys,illidan,1340,warrior,arms,36,14,22
Tamagoshi,kiljaeden,1339,warrior,arms,102,53,49
Gáren,quelthalas,1338,warrior,arms,24,14,10
Kelidar,kaelthas,1338,warrior,arms,42,22,20
Juggerboo,frostmourne,1338,warrior,arms,55,25,30
Verigislena,moon-guard,1337,warrior,arms,38,20,18
Byung,terenas,1337,warrior,arms,90,38,52
Tÿÿr,azralon,1337,warrior,arms,54,22,32
Govosh,thrall,1336,warrior,arms,24,14,10
Swamis,stormreaver,1336,warrior,arms,36,19,17
Azog,bleeding-hollow,1336,warrior,arms,48,25,23
Omnïslash,tichondrius,1336,warrior,arms,30,14,16
Viagraliker,tichondrius,1336,warrior,arms,44,19,25
Rhorix,korialstrasz,1336,warrior,arms,36,14,22
Wesih,ragnaros,1336,warrior,arms,60,22,38
Xenoblade,wildhammer,1335,warrior,arms,48,21,27
Xenowar,alleria,1335,warrior,arms,96,41,55
Dicedup,stormrage,1335,warrior,arms,36,14,22
Rageinice,tichondrius,1334,warrior,arms,42,21,21
Vemue,tichondrius,1334,warrior,arms,160,79,81
Slammshady,tichondrius,1333,warrior,arms,21,15,6
Ybo,illidan,1333,warrior,arms,63,39,24
Torkus,ragnaros,1333,warrior,arms,52,26,26
Barricade,velen,1333,warrior,arms,131,64,67
Konraad,amanthul,1333,warrior,arms,36,15,21
Jijiyeya,tichondrius,1332,warrior,arms,36,17,19
Odrath,tichondrius,1332,warrior,arms,75,35,40
Blackwulff,korgath,1332,warrior,arms,66,29,37
Varekai,frostmourne,1331,warrior,arms,62,32,30
Loothar,goldrinn,1331,warrior,arms,75,37,38
Warb,aggramar,1331,warrior,arms,72,35,37
Erdres,kelthuzad,1331,warrior,arms,63,22,41
Lexxsteele,mugthol,1330,warrior,arms,24,14,10
Carken,kiljaeden,1330,warrior,arms,36,20,16
Thulsan,emerald-dream,1329,warrior,arms,30,14,16
Kilroywar,tichondrius,1329,warrior,arms,30,14,16
Marraneitor,quelthalas,1328,warrior,arms,30,16,14
Fixafflock,bleeding-hollow,1327,warrior,arms,24,14,10
Chilicezo,durotan,1327,warrior,arms,65,37,28
Kalnor,dark-iron,1327,warrior,arms,50,26,24
Kantorowicz,goldrinn,1327,warrior,arms,66,32,34
Retros,kelthuzad,1327,warrior,arms,66,32,34
Ketasshi,kelthuzad,1327,warrior,arms,36,14,22
Suprslayer,spirestone,1326,warrior,arms,24,14,10
Twistwarr,area-52,1326,warrior,arms,24,14,10
Zuljikan,illidan,1326,warrior,arms,47,16,31
Handain,malganis,1324,warrior,arms,30,14,16
Kiayla,quelthalas,1324,warrior,arms,40,16,24
Mitered,tichondrius,1323,warrior,arms,39,19,20
Aparentlynot,shattered-hand,1323,warrior,arms,30,14,16
Hiddensquidd,stormrage,1322,warrior,arms,51,31,20
Overfury,azralon,1322,warrior,arms,36,18,18
Venecus,stormrage,1321,warrior,arms,30,14,16
Sharpen,terokkar,1320,warrior,arms,24,14,10
Rekem,malganis,1320,warrior,arms,60,27,33
Macsen,zuljin,1319,warrior,arms,36,18,18
Thrawb,bleeding-hollow,1319,warrior,arms,33,15,18
Grimreáper,bleeding-hollow,1319,warrior,arms,42,14,28
Gï,fizzcrank,1318,warrior,arms,24,14,10
Chargeback,zuljin,1318,warrior,arms,63,34,29
Arkayko,quelthalas,1318,warrior,arms,28,15,13
Zroz,ragnaros,1318,warrior,arms,54,28,26
Lujzika,stormreaver,1318,warrior,arms,39,17,22
Calmaah,frostmourne,1317,warrior,arms,63,33,30
Orcaine,ursin,1315,warrior,arms,41,27,14
Emaree,thrall,1315,warrior,arms,64,34,30
Valder,akama,1315,warrior,arms,30,15,15
Fuller,kelthuzad,1314,warrior,arms,36,18,18
Säbeër,ragnaros,1314,warrior,arms,30,14,16
Qtcrow,frostmourne,1310,warrior,arms,78,39,39
Fòntaine,shandris,1310,warrior,arms,30,15,15
Sseobeon,tichondrius,1310,warrior,arms,28,14,14
Irix,tichondrius,1310,warrior,arms,123,61,62
Tunasurprize,stormrage,1310,warrior,arms,33,16,17
Korsarro,frostmourne,1310,warrior,arms,86,40,46
Doomtree,zuljin,1309,warrior,arms,18,14,4
Makcumba,ragnaros,1309,warrior,arms,54,29,25
Northhill,tichondrius,1309,warrior,arms,59,30,29
Arm,stormscale,1309,warrior,arms,56,26,30
Yoruba,burning-blade,1309,warrior,arms,49,18,31
Ightdoex,zuljin,1308,warrior,arms,26,18,8
Mussashí,stormrage,1308,warrior,arms,56,35,21
Daymiian,blackrock,1308,warrior,arms,42,17,25
Mickyplate,tichondrius,1307,warrior,arms,78,39,39
Aldérmach,zuljin,1306,warrior,arms,112,57,55
Velarrine,illidan,1306,warrior,arms,89,39,50
Knghtofseven,nemesis,1305,warrior,arms,72,39,33
Tikkò,tichondrius,1305,warrior,arms,50,25,25
Rhagnael,malganis,1305,warrior,arms,72,30,42
Raekor,tichondrius,1304,warrior,arms,42,25,17
Zuggarnaught,tichondrius,1304,warrior,arms,82,44,38
Brontok,darkspear,1304,warrior,arms,52,25,27
Bersorcker,ragnaros,1304,warrior,arms,60,24,36
Deadee,aerie-peak,1302,warrior,arms,100,48,52
Akj,sargeras,1302,warrior,arms,54,23,31
Ludicrous,dreadmaul,1302,warrior,arms,85,36,49
Kittybang,quelthalas,1302,warrior,arms,54,19,35
Donhoolio,illidan,1301,warrior,arms,24,14,10
Legolant,uther,1301,warrior,arms,30,14,16
Filthyrandy,proudmoore,1301,warrior,arms,36,15,21
Skornnd,malganis,1301,warrior,arms,56,23,33
Dúmßlòwn,tichondrius,1300,warrior,arms,162,75,87
Pvpheart,tichondrius,1299,warrior,arms,47,27,20
Krostyx,ragnaros,1299,warrior,arms,72,40,32
Chawp,emerald-dream,1299,warrior,arms,47,24,23
Warrdawg,tichondrius,1298,warrior,arms,36,20,16
Nuclearfury,khadgar,1298,warrior,arms,48,24,24
Fuknazum,gundrak,1298,warrior,arms,120,55,65
Xufoxpikmin,gurubashi,1297,warrior,arms,100,43,57
Kitonic,proudmoore,1296,warrior,arms,29,18,11
Guitter,nazjatar,1296,warrior,arms,48,20,28
Greywo,tichondrius,1295,warrior,arms,61,34,27
Beeny,tichondrius,1295,warrior,arms,33,14,19
Blacksmiff,malganis,1294,warrior,arms,78,44,34
Iyamii,hyjal,1294,warrior,arms,29,16,13
Superpot,bleeding-hollow,1294,warrior,arms,48,22,26
Xl,quelthalas,1294,warrior,arms,55,24,31
Crú,stormrage,1293,warrior,arms,30,14,16
Noobslayr,wyrmrest-accord,1290,warrior,arms,30,18,12
Golîath,mannoroth,1290,warrior,arms,79,35,44
Ønì,tichondrius,1289,warrior,arms,48,35,13
Grumok,tichondrius,1289,warrior,arms,57,24,33
Pangpou,tichondrius,1288,warrior,arms,108,56,52
Bifilar,frostmourne,1288,warrior,arms,36,18,18
Devilsbane,khaz-modan,1287,warrior,arms,54,26,28
Walterwhîte,tichondrius,1287,warrior,arms,30,14,16
Swiftui,nemesis,1287,warrior,arms,69,30,39
Rockystyle,tichondrius,1286,warrior,arms,54,30,24
Hôdû,tichondrius,1286,warrior,arms,75,36,39
Egargiss,malygos,1285,warrior,arms,24,14,10
Sllvrbck,tichondrius,1284,warrior,arms,28,17,11
Valde,stormrage,1284,warrior,arms,27,14,13
Logi,alexstrasza,1284,warrior,arms,36,15,21
Munchiesxqc,exodar,1284,warrior,arms,50,19,31
Dualip,tichondrius,1283,warrior,arms,75,38,37
Excaliburz,frostmourne,1283,warrior,arms,101,48,53
Rnkman,quelthalas,1282,warrior,arms,25,16,9
Putong,tichondrius,1282,warrior,arms,41,23,18
Kagerou,ragnaros,1282,warrior,arms,62,28,34
Marvél,quelthalas,1278,warrior,arms,69,36,33
Nervoxztwo,ragnaros,1278,warrior,arms,81,39,42
Bfrenzy,dalaran,1278,warrior,arms,42,18,24
Mogtash,blackrock,1278,warrior,arms,41,16,25
Jhave,ragnaros,1277,warrior,arms,38,17,21
Kourny,frostmourne,1276,warrior,arms,75,36,39
Aintou,aegwynn,1276,warrior,arms,42,20,22
Ragnarwar,azralon,1275,warrior,arms,40,21,19
Chrosis,norgannon,1275,warrior,arms,65,25,40
Dieselsauce,stormscale,1273,warrior,arms,24,18,6
Swám,quelthalas,1273,warrior,arms,36,16,20
Amrap,dentarg,1273,warrior,arms,37,16,21
Krazyguerra,bleeding-hollow,1272,warrior,arms,48,26,22
Arox,ghostlands,1272,warrior,arms,60,30,30
Warnick,illidan,1272,warrior,arms,60,28,32
Dëkm,quelthalas,1272,warrior,arms,41,18,23
Unbeatablezs,tichondrius,1271,warrior,arms,48,25,23
Papaming,tichondrius,1270,warrior,arms,60,25,35
Thorablade,barthilas,1268,warrior,arms,96,44,52
Loucha,nagrand,1268,warrior,arms,75,32,43
Eudora,stormrage,1267,warrior,arms,66,35,31
Athin,azralon,1267,warrior,arms,29,14,15
Catastrophie,mugthol,1266,warrior,arms,87,39,48
Spartaner,shadowsong,1265,warrior,arms,36,14,22
Babybears,tichondrius,1265,warrior,arms,38,14,24
Spitfired,kiljaeden,1264,warrior,arms,36,19,17
Ygucheng,emerald-dream,1264,warrior,arms,55,26,29
Datsongz,proudmoore,1264,warrior,arms,90,42,48
Vyndronor,illidan,1264,warrior,arms,54,24,30
Timotheapple,stormrage,1264,warrior,arms,32,14,18
Winjerrywin,frostwolf,1263,warrior,arms,34,22,12
Krimmjðw,sargeras,1263,warrior,arms,36,14,22
Babyguns,tichondrius,1262,warrior,arms,66,29,37
ßloodshed,frostmourne,1261,warrior,arms,19,14,5
Ivanovh,quelthalas,1261,warrior,arms,180,90,90
Kuchikilla,borean-tundra,1261,warrior,arms,82,40,42
Laynarri,hyjal,1260,warrior,arms,60,28,32
Wrathena,khadgar,1258,warrior,arms,55,26,29
Gorash,gundrak,1257,warrior,arms,87,43,44
Superdah,kiljaeden,1257,warrior,arms,60,26,34
Bootstraps,hyjal,1256,warrior,arms,54,25,29
Selathiel,burning-blade,1256,warrior,arms,40,16,24
Queterompo,ragnaros,1255,warrior,arms,66,36,30
Aleniá,tichondrius,1255,warrior,arms,79,37,42
Croxxs,aegwynn,1253,warrior,arms,50,17,33
Cbum,quelthalas,1251,warrior,arms,30,14,16
Brynjah,azralon,1249,warrior,arms,90,40,50
Lagzistance,area-52,1248,warrior,arms,24,13,11
Bloodwish,stormrage,1247,warrior,arms,46,26,20
Areaves,moon-guard,1247,warrior,arms,24,13,11
Wtbfriends,malganis,1247,warrior,arms,24,13,11
Belàrià,tichondrius,1247,warrior,arms,24,13,11
Groxxigore,chogall,1247,warrior,arms,72,38,34
Scotteh,eredar,1247,warrior,arms,30,13,17
Xvett,drakkari,1246,warrior,arms,36,20,16
Callad,tichondrius,1246,warrior,arms,47,22,25
Schizogeist,malganis,1246,warrior,arms,40,18,22
Betterwar,zuljin,1246,warrior,arms,30,13,17
Vamtoro,illidan,1244,warrior,arms,34,19,15
Bigdumborc,tichondrius,1244,warrior,arms,24,13,11
Thelgrath,quelthalas,1244,warrior,arms,125,60,65
Småckin,frostmourne,1243,warrior,arms,36,20,16
Andorane,bleeding-hollow,1243,warrior,arms,24,13,11
Qookymonster,zuljin,1243,warrior,arms,66,33,33
Flexinbooty,kelthuzad,1243,warrior,arms,36,13,23
Dånkers,sargeras,1243,warrior,arms,36,13,23
Dodgestrikes,khaz-modan,1242,warrior,arms,18,13,5
Ystk,tichondrius,1242,warrior,arms,24,13,11
Exxic,zuljin,1242,warrior,arms,26,14,12
Gíal,ragnaros,1242,warrior,arms,64,26,38
Titanika,wyrmrest-accord,1242,warrior,arms,72,28,44
Deadhawk,wyrmrest-accord,1242,warrior,arms,72,28,44
Guerra,goldrinn,1241,warrior,arms,24,13,11
Ragedump,shadowsong,1241,warrior,arms,26,13,13
Juff,hakkar,1241,warrior,arms,36,15,21
Methwitch,moon-guard,1240,warrior,arms,24,13,11
Chadblade,tichondrius,1240,warrior,arms,24,13,11
Qtxd,malganis,1240,warrior,arms,24,13,11
Grimjouw,sargeras,1240,warrior,arms,24,13,11
Deamonkiller,kelthuzad,1240,warrior,arms,103,45,58
Jaminos,frostmourne,1240,warrior,arms,51,22,29
Ðhrâgøn,ragnaros,1239,warrior,arms,18,15,3
Tämuros,thrall,1239,warrior,arms,36,17,19
Mitigation,hyjal,1239,warrior,arms,34,15,19
Noitrak,azralon,1239,warrior,arms,33,14,19
Demonsláyer,illidan,1238,warrior,arms,24,13,11
Retrostorm,illidan,1238,warrior,arms,24,13,11
Depthsii,lightbringer,1238,warrior,arms,30,14,16
Deathengine,area-52,1237,warrior,arms,29,14,15
Squeekzz,frostmane,1236,warrior,arms,50,24,26
Macray,proudmoore,1235,warrior,arms,24,13,11
Moozz,dreadmaul,1235,warrior,arms,30,13,17
Rahgnarson,kelthuzad,1235,warrior,arms,36,13,23
Lokiilloo,drakkari,1234,warrior,arms,61,30,31
Naxxiki,wyrmrest-accord,1234,warrior,arms,120,57,63
Hoodlord,tichondrius,1234,warrior,arms,54,24,30
Beatmeat,frostmourne,1234,warrior,arms,30,13,17
Nosfuratuzod,frostmourne,1233,warrior,arms,49,22,27
Standsonkegs,illidan,1233,warrior,arms,30,13,17
Bananae,stormrage,1232,warrior,arms,21,14,7
Pandaniela,area-52,1232,warrior,arms,30,18,12
Goldbêrg,malganis,1232,warrior,arms,24,13,11
Gale,kelthuzad,1232,warrior,arms,24,13,11
Tansozzi,tichondrius,1232,warrior,arms,24,13,11
Aqee,illidan,1231,warrior,arms,36,21,15
Wankcelot,kiljaeden,1231,warrior,arms,48,21,27
Moonsworn,moon-guard,1231,warrior,arms,30,13,17
Eternalwill,rexxar,1229,warrior,arms,24,13,11
Awkagar,hyjal,1228,warrior,arms,23,13,10
Dji,tichondrius,1228,warrior,arms,215,102,113
Dhano,drakkari,1228,warrior,arms,30,14,16
Prodigál,dalaran,1228,warrior,arms,30,13,17
Malystik,ragnaros,1225,warrior,arms,93,49,44
Monardaid,uldum,1225,warrior,arms,36,14,22
Tunchi,runetotem,1224,warrior,arms,90,47,43
Armorlancer,stormrage,1223,warrior,arms,24,13,11
Mortawar,tichondrius,1222,warrior,arms,24,13,11
Boocawkeyy,illidan,1222,warrior,arms,36,13,23
Diamict,wyrmrest-accord,1221,warrior,arms,18,13,5
Kannerhus,quelthalas,1221,warrior,arms,47,22,25
Notsi,ragnaros,1219,warrior,arms,36,15,21
Slivers,stormrage,1218,warrior,arms,30,16,14
Ðwârf,tichondrius,1218,warrior,arms,46,17,29
Rekcd,sargeras,1217,warrior,arms,18,13,5
Lilboytroy,korgath,1217,warrior,arms,30,13,17
Zeldrissx,quelthalas,1217,warrior,arms,50,19,31
Urscrewed,frostmane,1217,warrior,arms,35,13,22
Akunaswar,dalaran,1215,warrior,arms,89,41,48
Dsz,nemesis,1215,warrior,arms,53,24,29
Southmariner,malganis,1214,warrior,arms,42,22,20
Hikikomori,goldrinn,1214,warrior,arms,41,20,21
Vâìn,tichondrius,1214,warrior,arms,34,15,19
Dippindabz,area-52,1213,warrior,arms,47,26,21
Truongx,kiljaeden,1212,warrior,arms,24,14,10
Franc,kiljaeden,1212,warrior,arms,29,14,15
Calynn,frostmourne,1212,warrior,arms,114,55,59
Ediict,illidan,1212,warrior,arms,29,13,16
Hatedßyßlízz,area-52,1212,warrior,arms,30,13,17
Jalaskâ,azralon,1212,warrior,arms,64,27,37
Deomer,quelthalas,1211,warrior,arms,30,14,16
Avoraçado,nemesis,1210,warrior,arms,115,46,69
Aelrog,malganis,1209,warrior,arms,106,55,51
Geoorg,ragnaros,1209,warrior,arms,53,24,29
Brozown,wildhammer,1209,warrior,arms,32,14,18
Rageloading,amanthul,1208,warrior,arms,36,18,18
Mezi,tichondrius,1208,warrior,arms,35,17,18
Baadomishram,ragnaros,1208,warrior,arms,30,14,16
Tenchuu,azralon,1208,warrior,arms,100,43,57
Rageoverdose,burning-legion,1208,warrior,arms,42,18,24
Yiffathon,wyrmrest-accord,1207,warrior,arms,87,37,50
Deadhofe,azuremyst,1205,warrior,arms,33,16,17
Carralee,azralon,1203,warrior,arms,30,19,11
Fkndog,tichondrius,1203,warrior,arms,66,31,35
Vapòr,frostmourne,1201,warrior,arms,24,14,10
Rawlur,zuljin,1201,warrior,arms,35,14,21
Kapalua,darkspear,1200,warrior,arms,45,21,24
Rebelzudo,azralon,1199,warrior,arms,42,25,17
Dreweth,altar-of-storms,1199,warrior,arms,24,13,11
Friendnoodle,frostmourne,1199,warrior,arms,59,28,31
Kiddoe,rivendare,1199,warrior,arms,84,39,45
Swamphell,barthilas,1199,warrior,arms,43,13,30
Aclipse,nagrand,1197,warrior,arms,65,34,31
Warrshield,ragnaros,1197,warrior,arms,61,26,35
Flexakute,malganis,1196,warrior,arms,24,14,10
Darkhorv,frostmourne,1196,warrior,arms,23,13,10
Dazfotm,tichondrius,1196,warrior,arms,35,13,22
Thebruce,nemesis,1194,warrior,arms,112,55,57
Franticlol,tichondrius,1193,warrior,arms,37,17,20
Babamama,tichondrius,1192,warrior,arms,23,13,10
Buliwyff,wyrmrest-accord,1192,warrior,arms,36,17,19
Bazironbeard,ravencrest,1190,warrior,arms,17,13,4
Annaliyah,wyrmrest-accord,1190,warrior,arms,66,36,30
Areiden,sargeras,1190,warrior,arms,48,16,32
Axharafuji,dalvengyr,1188,warrior,arms,48,20,28
Gohawn,hyjal,1186,warrior,arms,37,20,17
Lazyclap,nagrand,1185,warrior,arms,41,21,20
Broxhar,ragnaros,1185,warrior,arms,39,18,21
Aràthor,stormrage,1185,warrior,arms,93,41,52
Helandas,moknathal,1184,warrior,arms,127,65,62
Hadesz,nazjatar,1183,warrior,arms,71,34,37
Cowbøycrytoo,azralon,1182,warrior,arms,88,46,42
Yagura,emerald-dream,1182,warrior,arms,28,13,15
Sherway,quelthalas,1180,warrior,arms,203,100,103
Twoone,illidan,1178,warrior,arms,32,13,19
Archonian,stormscale,1177,warrior,arms,34,21,13
Skumwarr,moon-guard,1177,warrior,arms,58,22,36
Orsex,ragnaros,1176,warrior,arms,26,13,13
Orcbreaker,quelthalas,1176,warrior,arms,38,18,20
Ragebladë,tichondrius,1175,warrior,arms,54,34,20
Robotríp,illidan,1175,warrior,arms,42,18,24
Zarrock,emerald-dream,1174,warrior,arms,26,14,12
Süspicious,malfurion,1174,warrior,arms,35,14,21
Rhydonero,azralon,1173,warrior,arms,27,16,11
Tÿ,haomarush,1172,warrior,arms,25,14,11
Bigolpeen,sargeras,1172,warrior,arms,36,19,17
Droogust,tichondrius,1172,warrior,arms,30,15,15
Rauh,emerald-dream,1171,warrior,arms,22,13,9
Thedargz,trollbane,1170,warrior,arms,110,58,52
Stoul,illidan,1168,warrior,arms,30,22,8
Rockley,mugthol,1168,warrior,arms,48,19,29
Nosetackle,area-52,1166,warrior,arms,64,31,33
Medusaann,proudmoore,1166,warrior,arms,33,15,18
Adunken,ragnaros,1165,warrior,arms,30,17,13
Purplepiper,ragnaros,1165,warrior,arms,23,13,10
Grömäash,ragnaros,1165,warrior,arms,32,13,19
Looffy,saurfang,1165,warrior,arms,42,16,26
Puertorc,ragnaros,1163,warrior,arms,36,17,19
Daddymoist,moon-guard,1163,warrior,arms,54,24,30
Gongos,doomhammer,1161,warrior,arms,207,107,100
Joed,quelthalas,1160,warrior,arms,78,37,41
Mortilant,perenolde,1160,warrior,arms,75,34,41
Ãleister,stormrage,1160,warrior,arms,63,25,38
Stolz,dragonmaw,1157,warrior,arms,30,13,17
Tomatogodx,sargeras,1156,warrior,arms,31,15,16
Elpish,ragnaros,1154,warrior,arms,66,31,35
Magnuszx,zuljin,1152,warrior,arms,18,12,6
Pathelsonsus,stormrage,1152,warrior,arms,30,12,18
Wewladdie,malganis,1151,warrior,arms,18,12,6
Atomiclol,area-52,1151,warrior,arms,18,12,6
Noelglz,quelthalas,1151,warrior,arms,18,12,6
Moxxyy,tichondrius,1151,warrior,arms,24,12,12
Kroni,ragnaros,1151,warrior,arms,24,12,12
Gorek,illidan,1151,warrior,arms,24,12,12
Turecw,illidan,1151,warrior,arms,24,12,12
Mixx,bleeding-hollow,1151,warrior,arms,24,12,12
Tokugawaieya,nemesis,1151,warrior,arms,24,12,12
Onefourfifty,tichondrius,1150,warrior,arms,18,12,6
Hàru,illidan,1150,warrior,arms,18,12,6
Downblow,tichondrius,1150,warrior,arms,18,12,6
Einnarr,tichondrius,1150,warrior,arms,19,12,7
Nexgenwar,destromath,1150,warrior,arms,24,12,12
Recktko,sargeras,1150,warrior,arms,33,13,20
Nyloras,illidan,1150,warrior,arms,34,13,21
Jarheadz,bleeding-hollow,1150,warrior,arms,35,12,23
Gordofofo,azralon,1149,warrior,arms,18,12,6
Iblowloads,illidan,1149,warrior,arms,24,14,10
Scaredwarr,stormrage,1149,warrior,arms,45,24,21
Marzse,sargeras,1149,warrior,arms,24,12,12
Arixos,frostmourne,1149,warrior,arms,24,12,12
Cúdi,darkspear,1148,warrior,arms,18,12,6
Retrospex,black-dragonflight,1148,warrior,arms,24,12,12
Kamuwarr,azralon,1148,warrior,arms,24,12,12
Woth,deathwing,1148,warrior,arms,24,12,12
Suicider,stormrage,1148,warrior,arms,30,12,18
Omnismash,stormrage,1148,warrior,arms,32,12,20
Misclickëd,dalaran,1147,warrior,arms,24,12,12
Vodkagoblin,sargeras,1147,warrior,arms,24,12,12
Wo,alleria,1147,warrior,arms,24,12,12
Virillius,wyrmrest-accord,1147,warrior,arms,28,13,15
Jianhung,tichondrius,1147,warrior,arms,30,12,18
Hektar,tichondrius,1146,warrior,arms,18,12,6
Stompyocouch,mugthol,1146,warrior,arms,21,13,8
Furryhorv,frostmourne,1146,warrior,arms,24,12,12
Dâvo,area-52,1146,warrior,arms,24,12,12
Ikitee,zuljin,1146,warrior,arms,24,12,12
Alejandrica,ragnaros,1146,warrior,arms,30,12,18
Ragnarloðbró,tichondrius,1146,warrior,arms,36,12,24
Struka,drakkari,1145,warrior,arms,24,12,12
Staystrong,tichondrius,1144,warrior,arms,18,12,6
Skittlesxo,bleeding-hollow,1144,warrior,arms,24,12,12
Maintarget,malganis,1144,warrior,arms,35,12,23
Sartin,boulderfist,1144,warrior,arms,42,14,28
Invared,stormrage,1143,warrior,arms,18,12,6
Nibbzy,sargeras,1142,warrior,arms,18,12,6
Lucidx,malfurion,1142,warrior,arms,18,12,6
Haldeer,shadow-council,1142,warrior,arms,24,12,12
Realthiccbbw,tichondrius,1142,warrior,arms,24,12,12
Carnith,arthas,1142,warrior,arms,30,12,18
Yisunshin,azralon,1141,warrior,arms,24,12,12
Elmosmash,thrall,1141,warrior,arms,24,12,12
Saskouach,stormrage,1140,warrior,arms,26,12,14
Hblock,barthilas,1140,warrior,arms,30,12,18
Brocc,tichondrius,1139,warrior,arms,24,12,12
Tooto,kelthuzad,1138,warrior,arms,24,12,12
Sloppyglucks,moon-guard,1138,warrior,arms,24,12,12
Baloz,tichondrius,1138,warrior,arms,30,13,17
Warrimon,nemesis,1138,warrior,arms,36,12,24
Tappia,quelthalas,1138,warrior,arms,36,12,24
Dizgraceful,malganis,1137,warrior,arms,18,12,6
Soggynapkin,proudmoore,1136,warrior,arms,30,17,13
Purefury,whisperwind,1136,warrior,arms,99,46,53
Odinsglory,mugthol,1136,warrior,arms,112,48,64
Zulgadark,ragnaros,1136,warrior,arms,39,15,24
Theregulator,area-52,1135,warrior,arms,58,29,29
Anotee,kelthuzad,1134,warrior,arms,93,48,45
Shattering,fizzcrank,1134,warrior,arms,24,12,12
Drahconian,aggramar,1134,warrior,arms,24,12,12
Demðnslayer,kelthuzad,1134,warrior,arms,54,24,30
Cecchino,zuluhed,1133,warrior,arms,24,12,12
Angelsantos,sargeras,1133,warrior,arms,24,12,12
Varyanguard,quelthalas,1133,warrior,arms,24,12,12
Tripleblack,mugthol,1132,warrior,arms,18,12,6
Isildur,nerzhul,1132,warrior,arms,36,20,16
Sugarpanties,moon-guard,1132,warrior,arms,81,33,48
Âmânthul,alexstrasza,1131,warrior,arms,158,82,76
Bigsvit,trollbane,1131,warrior,arms,60,29,31
Spritez,malganis,1131,warrior,arms,70,27,43
Inunotaysho,quelthalas,1129,warrior,arms,54,22,32
Azeryan,azralon,1129,warrior,arms,35,12,23
Lunks,kelthuzad,1128,warrior,arms,18,12,6
Bulletfodder,tichondrius,1127,warrior,arms,24,12,12
Funderr,eonar,1126,warrior,arms,30,13,17
Arashikage,malganis,1126,warrior,arms,34,13,21
Angitu,quelthalas,1124,warrior,arms,24,14,10
Rodhin,proudmoore,1124,warrior,arms,24,12,12
Úmarth,azralon,1124,warrior,arms,60,29,31
Mfmuggz,thunderlord,1124,warrior,arms,35,14,21
Ambiss,azjolnerub,1120,warrior,arms,47,21,26
Slumdawgg,andorhal,1119,warrior,arms,59,32,27
Garìk,moon-guard,1119,warrior,arms,69,27,42
Swiftynifty,area-52,1118,warrior,arms,48,29,19
Clovê,ragnaros,1118,warrior,arms,36,21,15
Aersasi,tichondrius,1117,warrior,arms,24,13,11
Rahtahtas,area-52,1116,warrior,arms,24,12,12
Philbert,alexstrasza,1116,warrior,arms,57,28,29
Xyazhiro,ragnaros,1115,warrior,arms,66,29,37
Hemone,frostmourne,1114,warrior,arms,30,15,15
Thunderclapz,stormscale,1114,warrior,arms,24,12,12
Containerbox,korgath,1112,warrior,arms,42,18,24
Casteleiro,azralon,1112,warrior,arms,32,13,19
Alejandros,azgalor,1111,warrior,arms,23,12,11
Warriorlee,jubeithos,1111,warrior,arms,44,19,25
Brysontiller,frostmourne,1110,warrior,arms,23,12,11
Raygé,malygos,1109,warrior,arms,26,13,13
Huri,nemesis,1106,warrior,arms,32,17,15
Cocainiouz,dalaran,1106,warrior,arms,42,17,25
Youtank,kiljaeden,1105,warrior,arms,78,36,42
Dvhwec,tichondrius,1105,warrior,arms,28,12,16
Riga,tichondrius,1102,warrior,arms,48,24,24
Laint,wyrmrest-accord,1102,warrior,arms,140,68,72
Ðåddý,stormrage,1102,warrior,arms,29,12,17
Tipincider,perenolde,1100,warrior,arms,21,12,9
Bloodfx,darkspear,1100,warrior,arms,93,41,52
Vaclein,quelthalas,1100,warrior,arms,30,13,17
Raserei,moonrunner,1098,warrior,arms,75,35,40
Panzerian,area-52,1097,warrior,arms,37,14,23
Tyrantwolf,ragnaros,1097,warrior,arms,45,17,28
Forevercute,proudmoore,1096,warrior,arms,23,14,9
Theøcritus,korgath,1096,warrior,arms,42,25,17
Knocks,blackrock,1094,warrior,arms,21,13,8
Melankoma,sargeras,1094,warrior,arms,30,12,18
Arrogated,emerald-dream,1093,warrior,arms,90,44,46
Dissx,illidan,1092,warrior,arms,37,16,21
Njjszn,thrall,1091,warrior,arms,196,93,103
Ujumpijump,andorhal,1089,warrior,arms,78,29,49
Royye,blood-furnace,1088,warrior,arms,24,12,12
Jiszle,sargeras,1085,warrior,arms,34,12,22
Agresvnapkin,dalaran,1084,warrior,arms,20,12,8
Kempachii,ragnaros,1083,warrior,arms,82,40,42
Aquannas,bloodscalp,1082,warrior,arms,24,14,10
Pingorosho,quelthalas,1082,warrior,arms,36,16,20
Imcute,senjin,1082,warrior,arms,72,28,44
Malok,deathwing,1082,warrior,arms,57,20,37
Locotto,ragnaros,1082,warrior,arms,42,13,29
Rockedanger,stormrage,1080,warrior,arms,26,15,11
Riuk,goldrinn,1080,warrior,arms,29,16,13
Tribbally,silver-hand,1079,warrior,arms,20,13,7
Warrage,kiljaeden,1079,warrior,arms,68,32,36
Eihn,quelthalas,1079,warrior,arms,35,14,21
Raharon,chogall,1079,warrior,arms,52,20,32
Gorfin,spirestone,1077,warrior,arms,42,12,30
Sudavis,alleria,1075,warrior,arms,35,21,14
Repsey,zuljin,1073,warrior,arms,17,12,5
Several,whisperwind,1073,warrior,arms,39,23,16
Ødïñ,sargeras,1071,warrior,arms,75,37,38
Linçpin,tichondrius,1070,warrior,arms,26,12,14
Yuccaleaptus,area-52,1070,warrior,arms,77,31,46
Colosal,drakkari,1068,warrior,arms,21,14,7
Hippy,kiljaeden,1067,warrior,arms,22,12,10
Axedeity,caelestrasz,1063,warrior,arms,81,45,36
Ugrundan,zuljin,1061,warrior,arms,48,21,27
Hagud,tichondrius,1061,warrior,arms,29,12,17
Bussundas,azralon,1059,warrior,arms,72,32,40
Dackøzzt,quelthalas,1056,warrior,arms,18,11,7
Midorikwa,area-52,1056,warrior,arms,18,11,7
Benkenobi,khaz-modan,1056,warrior,arms,18,11,7
Wizcleavuh,area-52,1056,warrior,arms,24,11,13
Evanx,sargeras,1056,warrior,arms,24,11,13
Varenkä,drakkari,1056,warrior,arms,24,11,13
Pkgd,tichondrius,1055,warrior,arms,12,11,1
Hotshótz,kelthuzad,1055,warrior,arms,12,11,1
Dutchyy,frostmourne,1055,warrior,arms,18,11,7
Gladiator,azshara,1055,warrior,arms,18,11,7
Deathsteelw,zuljin,1055,warrior,arms,18,11,7
Sonwar,azralon,1055,warrior,arms,18,11,7
Tommygunns,area-52,1055,warrior,arms,18,11,7
Hashwar,area-52,1055,warrior,arms,18,11,7
Nerdstorm,tichondrius,1055,warrior,arms,18,11,7
Vicioustalol,proudmoore,1055,warrior,arms,18,11,7
Turtlestorm,tichondrius,1055,warrior,arms,18,11,7
Zugprime,dragonmaw,1055,warrior,arms,18,11,7
Breyns,garrosh,1055,warrior,arms,25,12,13
Carriney,illidan,1055,warrior,arms,77,36,41
Duckyuwu,tichondrius,1055,warrior,arms,24,11,13
Bigdad,whisperwind,1055,warrior,arms,24,11,13
Abomlnatlon,tichondrius,1055,warrior,arms,24,11,13
Laddèrx,area-52,1055,warrior,arms,24,11,13
Wheyprotein,illidan,1055,warrior,arms,24,11,13
Feedzz,area-52,1055,warrior,arms,24,11,13
Tankomode,area-52,1055,warrior,arms,24,11,13
Édton,area-52,1055,warrior,arms,42,18,24
Chopped,wyrmrest-accord,1054,warrior,arms,18,11,7
Vooné,tichondrius,1054,warrior,arms,18,11,7
Wargasms,alterac-mountains,1054,warrior,arms,24,11,13
Vexwar,bleeding-hollow,1054,warrior,arms,24,11,13
Wolfsrage,frostmourne,1054,warrior,arms,30,11,19
Kolossus,korgath,1054,warrior,arms,30,11,19
Ttl,dalaran,1053,warrior,arms,18,11,7
Mimiovo,tichondrius,1053,warrior,arms,18,11,7
Iwooglybool,icecrown,1053,warrior,arms,18,11,7
Awm,wyrmrest-accord,1053,warrior,arms,24,11,13
Mortalgodtko,ragnaros,1053,warrior,arms,28,12,16
Môrôdin,area-52,1053,warrior,arms,30,11,19
Adryina,zuljin,1052,warrior,arms,18,11,7
Carrange,moon-guard,1052,warrior,arms,24,11,13
Guguito,drakkari,1052,warrior,arms,24,11,13
Drillbit,wyrmrest-accord,1051,warrior,arms,30,11,19
Georgedubya,illidan,1051,warrior,arms,36,11,25
Warriorbod,area-52,1050,warrior,arms,18,11,7
Thecolor,tichondrius,1050,warrior,arms,30,11,19
Crul,gurubashi,1050,warrior,arms,31,11,20
Myceliumlog,frostmourne,1049,warrior,arms,18,11,7
Raahjv,sargeras,1049,warrior,arms,18,11,7
Halis,illidan,1049,warrior,arms,27,16,11
Plagueis,dark-iron,1049,warrior,arms,24,11,13
Gadderhammer,azgalor,1049,warrior,arms,42,17,25
Snewdawg,malganis,1048,warrior,arms,22,12,10
Jamil,illidan,1048,warrior,arms,156,75,81
Kanekhy,ragnaros,1048,warrior,arms,24,11,13
Genesisxp,barthilas,1048,warrior,arms,24,11,13
Pum,bleeding-hollow,1048,warrior,arms,24,11,13
Rathty,shadowsong,1048,warrior,arms,24,11,13
Noktyn,haomarush,1048,warrior,arms,24,11,13
Sako,amanthul,1048,warrior,arms,24,11,13
Irishhammer,malfurion,1048,warrior,arms,35,12,23
Bøgz,kelthuzad,1047,warrior,arms,18,11,7
Bouk,bloodscalp,1047,warrior,arms,18,11,7
Lololosda,quelthalas,1047,warrior,arms,36,17,19
Cptstarship,sargeras,1047,warrior,arms,24,11,13
Josephcrazy,tichondrius,1047,warrior,arms,24,11,13
Dwarfanage,tichondrius,1047,warrior,arms,28,12,16
Blaxst,gorgonnash,1046,warrior,arms,30,16,14
Prunebery,area-52,1046,warrior,arms,30,16,14
Fûry,tichondrius,1046,warrior,arms,124,59,65
Nirax,burning-legion,1046,warrior,arms,26,11,15
Jfordnever,area-52,1045,warrior,arms,18,11,7
Eiendira,proudmoore,1045,warrior,arms,30,11,19
Logsplitter,stormrage,1045,warrior,arms,36,11,25
Orphasmic,moon-guard,1044,warrior,arms,36,11,25
Homicideted,frostmourne,1043,warrior,arms,18,11,7
Racky,dragonmaw,1043,warrior,arms,24,11,13
Thedin,gorefiend,1043,warrior,arms,42,11,31
Tenserr,kiljaeden,1042,warrior,arms,24,11,13
Rineer,tichondrius,1042,warrior,arms,24,11,13
Marcolatus,ragnaros,1042,warrior,arms,54,24,30
Creator,dalaran,1041,warrior,arms,24,11,13
Irongummy,frostmourne,1041,warrior,arms,24,11,13
Hunnam,illidan,1041,warrior,arms,30,11,19
Dylaiin,kelthuzad,1038,warrior,arms,30,11,19
Wrekkshop,tichondrius,1037,warrior,arms,27,13,14
Wrrx,frostmourne,1037,warrior,arms,24,11,13
Thebeastwar,area-52,1036,warrior,arms,54,26,28
Regthar,illidan,1034,warrior,arms,23,11,12
Indoondabeat,azgalor,1034,warrior,arms,32,15,17
Nobowar,tichondrius,1032,warrior,arms,24,11,13
Potan,thrall,1030,warrior,arms,60,25,35
Janlei,quelthalas,1030,warrior,arms,29,11,18
Uglycubano,quelthalas,1029,warrior,arms,24,11,13
Märiä,ragnaros,1028,warrior,arms,52,27,25
Cronie,steamwheedle-cartel,1027,warrior,arms,36,16,20
Nøzerker,kelthuzad,1020,warrior,arms,26,12,14
Guanyúu,tichondrius,1017,warrior,arms,23,11,12
Stygïàn,draenor,1016,warrior,arms,80,45,35
Kì,moon-guard,1016,warrior,arms,30,13,17
Galuf,malygos,1014,warrior,arms,18,11,7
Coffetea,area-52,1011,warrior,arms,41,25,16
Psýchótic,tichondrius,1009,warrior,arms,23,11,12
Bionikus,nemesis,1009,warrior,arms,90,41,49
Fazeo,madoran,1007,warrior,arms,21,11,10
Blackstamp,tichondrius,1006,warrior,arms,35,18,17
Oppos,lightnings-blade,1006,warrior,arms,23,11,12
Hexenbæne,tichondrius,1006,warrior,arms,23,11,12
Flycosmos,tichondrius,1006,warrior,arms,67,31,36
Bingchilly,aegwynn,1004,warrior,arms,21,12,9
Titanrage,tichondrius,1004,warrior,arms,21,11,10
Starplatinum,aerie-peak,1004,warrior,arms,32,11,21
Wastenott,area-52,1003,warrior,arms,18,11,7
Vicor,ragnaros,1003,warrior,arms,24,14,10
Gorepig,sargeras,1002,warrior,arms,29,11,18
Deathsmirk,illidan,1001,warrior,arms,49,25,24
Kreeper,farstriders,1001,warrior,arms,23,11,12
Goofyahwok,doomhammer,998,warrior,arms,33,12,21
Altruiel,sargeras,995,warrior,arms,40,20,20
Joran,dathremar,995,warrior,arms,32,14,18
Slimmjim,malganis,994,warrior,arms,17,11,6
Kyritto,azralon,994,warrior,arms,35,18,17
Tyrantt,malganis,994,warrior,arms,48,21,27
Orkuduro,azralon,993,warrior,arms,77,37,40
Tmhinfen,tichondrius,991,warrior,arms,16,11,5
Szee,tichondrius,991,warrior,arms,17,11,6
Elsamok,ragnaros,991,warrior,arms,17,11,6
Jragonmaster,borean-tundra,991,warrior,arms,36,13,23
Aggripa,kelthuzad,990,warrior,arms,20,11,9
Neekka,tichondrius,990,warrior,arms,28,12,16
Kalaxe,quelthalas,990,warrior,arms,36,11,25
Brownman,saurfang,989,warrior,arms,30,12,18
Midge,proudmoore,988,warrior,arms,65,31,34
Târtàrûs,tichondrius,987,warrior,arms,36,17,19
Lokiullr,tichondrius,985,warrior,arms,35,11,24
Darkthok,drakkari,982,warrior,arms,34,15,19
Sneaknyoface,sargeras,982,warrior,arms,26,11,15
Tucô,skullcrusher,976,warrior,arms,49,22,27
Happywarrior,tichondrius,976,warrior,arms,30,11,19
Sudokubrain,tichondrius,974,warrior,arms,19,11,8
Pumpuup,bleeding-hollow,973,warrior,arms,36,16,20
Djfredsd,tichondrius,972,warrior,arms,13,11,2
Nitechaos,thrall,972,warrior,arms,19,12,7
Beardoff,sargeras,966,warrior,arms,16,11,5
Elfmonger,proudmoore,966,warrior,arms,19,11,8
Varrior,wyrmrest-accord,960,warrior,arms,18,10,8
Adios,tichondrius,960,warrior,arms,18,10,8
Szew,tichondrius,960,warrior,arms,18,10,8
Codyjones,illidan,960,warrior,arms,18,10,8
Sowavey,korgath,960,warrior,arms,18,10,8
Tigris,nesingwary,960,warrior,arms,18,10,8
Escanòr,malganis,960,warrior,arms,18,10,8
Nuqupq,tichondrius,960,warrior,arms,18,10,8
Battousäi,kiljaeden,960,warrior,arms,18,10,8
Zhangye,tichondrius,960,warrior,arms,18,10,8
ßdm,illidan,960,warrior,arms,24,10,14
Jethrix,kelthuzad,960,warrior,arms,24,10,14
Americanbull,moon-guard,960,warrior,arms,24,10,14
Bradockqt,azralon,960,warrior,arms,24,10,14
Choppin,sargeras,960,warrior,arms,24,10,14
Wargázm,thrall,960,warrior,arms,24,10,14
Benw,dawnbringer,960,warrior,arms,24,10,14
Iløveaysla,azralon,960,warrior,arms,30,10,20
Fatalian,proudmoore,960,warrior,arms,30,10,20
Tantei,moon-guard,959,warrior,arms,18,10,8
Akaius,ragnaros,959,warrior,arms,18,10,8
Sheyshey,quelthalas,959,warrior,arms,18,10,8
Blakeb,area-52,959,warrior,arms,18,10,8
Doucherocket,kelthuzad,959,warrior,arms,18,10,8
Bamxz,sargeras,959,warrior,arms,18,10,8
Tmjakeful,area-52,959,warrior,arms,18,10,8
Kaìju,dragonmaw,959,warrior,arms,18,10,8
Crysis,malorne,959,warrior,arms,24,10,14
Warfeno,malganis,959,warrior,arms,24,10,14
Drdelicious,tichondrius,959,warrior,arms,24,10,14
Elsee,drakkari,959,warrior,arms,42,10,32
Est,illidan,958,warrior,arms,12,10,2
Arrtorias,quelthalas,958,warrior,arms,12,10,2
Glacierrsz,sargeras,958,warrior,arms,18,10,8
Kolacut,tichondrius,958,warrior,arms,18,10,8
Icrìtmypants,dragonmaw,958,warrior,arms,18,10,8
Nickfurie,emerald-dream,958,warrior,arms,18,10,8
Zolotrollo,area-52,958,warrior,arms,18,10,8
Rallyingcry,illidan,958,warrior,arms,18,10,8
Kanchy,sargeras,958,warrior,arms,18,10,8
Bigdickfever,sargeras,958,warrior,arms,24,10,14
Magnis,stormrage,958,warrior,arms,24,10,14
Icestormray,illidan,958,warrior,arms,24,10,14
Kelmor,thunderhorn,958,warrior,arms,30,10,20
Farquahd,illidan,958,warrior,arms,30,10,20
Matutekz,ragnaros,958,warrior,arms,30,10,20
Babyweenis,sargeras,957,warrior,arms,12,10,2
Razakamx,tichondrius,957,warrior,arms,12,10,2
Ghostblood,stormscale,957,warrior,arms,12,10,2
Leapsalp,proudmoore,957,warrior,arms,18,10,8
Vecira,moon-guard,957,warrior,arms,18,10,8
Sìkarío,illidan,957,warrior,arms,18,10,8
Whórm,kelthuzad,957,warrior,arms,18,10,8
Lieutemajor,nemesis,957,warrior,arms,43,21,22
Targos,frostwolf,957,warrior,arms,24,10,14
Pootybeef,daggerspine,957,warrior,arms,24,10,14
Aberwarr,illidan,956,warrior,arms,18,10,8
Seshømaru,quelthalas,956,warrior,arms,18,10,8
Carrito,perenolde,956,warrior,arms,29,16,13
Numb,moon-guard,956,warrior,arms,26,11,15
Rottlingberg,kelthuzad,956,warrior,arms,24,10,14
Aisinbro,illidan,956,warrior,arms,24,10,14
Barøneza,stormrage,956,warrior,arms,24,10,14
Ermeji,ragnaros,956,warrior,arms,24,10,14
Torbajhorn,moon-guard,956,warrior,arms,24,10,14
Warrbull,spirestone,956,warrior,arms,30,10,20
Topmeoff,bleeding-hollow,955,warrior,arms,30,10,20
Sneeze,kul-tiras,954,warrior,arms,18,10,8
Theestallion,kiljaeden,954,warrior,arms,18,10,8
Biloni,ragnaros,954,warrior,arms,24,10,14
Xiosè,ragnaros,954,warrior,arms,24,10,14
Starshattr,bleeding-hollow,954,warrior,arms,30,10,20
Coffeebottom,wyrmrest-accord,953,warrior,arms,18,10,8
Zomars,ragnaros,953,warrior,arms,18,10,8
Roitty,proudmoore,953,warrior,arms,24,10,14
Toky,malganis,952,warrior,arms,18,10,8
Brianya,moon-guard,952,warrior,arms,24,10,14
Aaltara,barthilas,951,warrior,arms,18,10,8
Helaume,arathor,950,warrior,arms,18,10,8
Darroma,bleeding-hollow,950,warrior,arms,18,10,8
Spredforbred,area-52,950,warrior,arms,24,10,14
Discopogo,nemesis,950,warrior,arms,24,10,14
Waabi,emerald-dream,949,warrior,arms,18,10,8
Vobiscum,drakkari,949,warrior,arms,24,10,14
Ontull,emerald-dream,949,warrior,arms,36,10,26
Imgunnacrum,malganis,946,warrior,arms,18,10,8
Digitalpsyko,hyjal,946,warrior,arms,18,10,8
Meatdrps,frostmane,941,warrior,arms,26,11,15
Thing,gorgonnash,941,warrior,arms,24,10,14
Vezixx,dragonmaw,939,warrior,arms,18,10,8
Brutallypwnd,tichondrius,939,warrior,arms,35,19,16
Hkbdynamus,black-dragonflight,939,warrior,arms,30,10,20
Dragmös,nemesis,937,warrior,arms,12,10,2
Hunchless,detheroc,937,warrior,arms,28,10,18
Mariò,area-52,934,warrior,arms,18,10,8
Tramplehaste,barthilas,931,warrior,arms,18,10,8
Pocketaxe,blackwater-raiders,927,warrior,arms,83,40,43
Ragesimp,stormrage,926,warrior,arms,23,10,13
Gargameld,stormrage,925,warrior,arms,42,20,22
Wondaimon,drakkari,922,warrior,arms,24,10,14
Thråsh,area-52,916,warrior,arms,48,20,28
Velliena,tichondrius,916,warrior,arms,32,11,21
Rrawrr,bleeding-hollow,912,warrior,arms,20,11,9
Jindyn,boulderfist,912,warrior,arms,58,27,31
Skarkla,thrall,911,warrior,arms,29,10,19
Beyblade,jubeithos,910,warrior,arms,17,10,7
Nexie,moon-guard,910,warrior,arms,21,10,11
Jägernaught,stormrage,910,warrior,arms,23,10,13
Tandiko,wyrmrest-accord,908,warrior,arms,17,10,7
Spitts,frostmourne,904,warrior,arms,21,10,11
Tankdatt,frostmourne,899,warrior,arms,24,10,14
Atrocithy,ragnaros,896,warrior,arms,16,10,6
Girioo,thrall,895,warrior,arms,14,10,4
Krokgoldmane,drakkari,893,warrior,arms,36,17,19
Malathire,illidan,893,warrior,arms,22,10,12
Tsebaoth,quelthalas,890,warrior,arms,48,19,29
Wallzar,sargeras,887,warrior,arms,20,10,10
Tankadin,dragonmaw,885,warrior,arms,24,10,14
Bluthammer,wyrmrest-accord,884,warrior,arms,29,11,18
Mortalchop,tichondrius,880,warrior,arms,19,10,9
Hintofmint,tichondrius,878,warrior,arms,20,10,10
Sígmar,dreadmaul,869,warrior,arms,18,10,8
Skynitez,area-52,864,warrior,arms,12,9,3
Moonyxx,frostmourne,864,warrior,arms,12,9,3
Dripgodx,malganis,864,warrior,arms,12,9,3
Ådderall,thrall,864,warrior,arms,12,9,3
Dedgamesucks,darkspear,864,warrior,arms,12,9,3
Thuggyfresh,malganis,864,warrior,arms,12,9,3
Youngmoneyd,illidan,864,warrior,arms,12,9,3
Microraccoon,tichondrius,864,warrior,arms,12,9,3
Warronin,kaelthas,864,warrior,arms,12,9,3
Alchera,fizzcrank,864,warrior,arms,18,9,9
Miniraccoon,tichondrius,864,warrior,arms,18,9,9
Oxia,quelthalas,864,warrior,arms,18,9,9
Yamatoflash,tichondrius,864,warrior,arms,18,9,9
Natating,terenas,864,warrior,arms,18,9,9
Warwagon,the-underbog,864,warrior,arms,18,9,9
Ârmstrong,quelthalas,864,warrior,arms,18,9,9
Mlau,tichondrius,864,warrior,arms,18,9,9
Dreamonn,illidan,864,warrior,arms,18,9,9
Scoopdog,stormrage,864,warrior,arms,18,9,9
Hateuu,tichondrius,864,warrior,arms,18,9,9
Undeadbones,firetree,864,warrior,arms,18,9,9
Faronstompz,sargeras,864,warrior,arms,18,9,9
Stÿgian,blood-furnace,864,warrior,arms,18,9,9
Golodiso,mugthol,864,warrior,arms,18,9,9
Herey,moon-guard,864,warrior,arms,18,9,9
Dreadtøøth,tichondrius,864,warrior,arms,24,9,15
Sejac,moon-guard,864,warrior,arms,24,9,15
Pretending,dalaran,864,warrior,arms,24,9,15
Warrmoose,tichondrius,864,warrior,arms,24,9,15
Feiler,ragnaros,864,warrior,arms,24,9,15
Sabotender,suramar,864,warrior,arms,24,9,15
Furyslam,tichondrius,864,warrior,arms,24,9,15
Dustywx,area-52,864,warrior,arms,24,9,15
Eensy,sargeras,864,warrior,arms,24,9,15
Durist,tichondrius,864,warrior,arms,30,9,21
Hiness,tichondrius,864,warrior,arms,30,9,21
Boardslide,proudmoore,864,warrior,arms,30,9,21
Eggheadorc,area-52,863,warrior,arms,12,9,3
Grehk,sargeras,863,warrior,arms,12,9,3
Tinymooie,frostmourne,863,warrior,arms,12,9,3
Bowlingball,darkspear,863,warrior,arms,18,9,9
Fulreck,tichondrius,863,warrior,arms,18,9,9
Chrom,illidan,863,warrior,arms,18,9,9
Tâte,sargeras,863,warrior,arms,18,9,9
Suntore,malganis,863,warrior,arms,18,9,9
Illicitkillz,destromath,863,warrior,arms,18,9,9
Zaynafein,emerald-dream,863,warrior,arms,18,9,9
Trén,hydraxis,863,warrior,arms,18,9,9
Terneitor,ragnaros,863,warrior,arms,18,9,9
Shino,garona,863,warrior,arms,18,9,9
Theseuse,tichondrius,863,warrior,arms,18,9,9
Nosoraki,thrall,863,warrior,arms,18,9,9
Erdnase,ragnaros,863,warrior,arms,18,9,9
Bladeblade,burning-blade,863,warrior,arms,21,9,12
Spincycle,khadgar,863,warrior,arms,21,9,12
Touhen,illidan,863,warrior,arms,24,9,15
Flexid,tichondrius,863,warrior,arms,24,9,15
Wrecktang,tichondrius,863,warrior,arms,24,9,15
Ðirtyboy,tichondrius,863,warrior,arms,24,9,15
Notoxzy,tichondrius,863,warrior,arms,24,9,15
Abidis,tichondrius,863,warrior,arms,30,9,21
Warwslayer,tichondrius,863,warrior,arms,30,9,21
Xumæ,akama,863,warrior,arms,30,9,21
Kilrok,thunderlord,863,warrior,arms,30,9,21
Nyuk,tichondrius,862,warrior,arms,15,9,6
Tallix,smolderthorn,862,warrior,arms,18,9,9
Izârâk,frostmourne,862,warrior,arms,18,9,9
Cogsbixby,aerie-peak,862,warrior,arms,18,9,9
Um,moon-guard,862,warrior,arms,18,9,9
Linga,bleeding-hollow,862,warrior,arms,18,9,9
Xargosh,magtheridon,862,warrior,arms,18,9,9
Hazew,kelthuzad,862,warrior,arms,18,9,9
Thezboy,tichondrius,862,warrior,arms,18,9,9
Wargorin,bleeding-hollow,862,warrior,arms,18,9,9
Wárriór,tichondrius,862,warrior,arms,24,9,15
Xurc,gnomeregan,862,warrior,arms,24,9,15
Lögän,azralon,862,warrior,arms,24,9,15
Balakay,drenden,861,warrior,arms,12,9,3
Jodoro,malfurion,861,warrior,arms,18,9,9
Gunnaoffxans,sargeras,860,warrior,arms,18,9,9
Durtmcsmash,stormrage,860,warrior,arms,18,9,9
Stormit,illidan,860,warrior,arms,19,9,10
Marnan,quelthalas,860,warrior,arms,24,9,15
Umogarmac,draktharon,860,warrior,arms,24,9,15
Layllassa,moon-guard,860,warrior,arms,24,9,15
Nishtana,quelthalas,859,warrior,arms,18,9,9
Vio,mannoroth,859,warrior,arms,18,9,9
Ñors,spinebreaker,859,warrior,arms,24,9,15
Åres,wyrmrest-accord,858,warrior,arms,18,9,9
Féril,ragnaros,858,warrior,arms,18,9,9
Tolette,quelthalas,858,warrior,arms,18,9,9
Rickyxp,aggramar,858,warrior,arms,19,9,10
Tinyguysmall,eredar,857,warrior,arms,22,11,11
Arthknight,ragnaros,857,warrior,arms,18,9,9
Kaimana,zuljin,857,warrior,arms,18,9,9
Baroque,darkspear,857,warrior,arms,18,9,9
Gahii,barthilas,857,warrior,arms,18,9,9
Joshums,warsong,857,warrior,arms,26,10,16
Karusuke,stormrage,857,warrior,arms,24,9,15
Lilsweet,moon-guard,856,warrior,arms,12,9,3
Éllenor,azralon,856,warrior,arms,18,9,9
Sparkye,gallywix,856,warrior,arms,18,9,9
Eorik,stormrage,856,warrior,arms,36,9,27
Daytime,scilla,855,warrior,arms,18,9,9
Coldsnaps,azjolnerub,855,warrior,arms,18,9,9
Preschool,sargeras,854,warrior,arms,12,9,3
Wândêrer,wyrmrest-accord,854,warrior,arms,18,9,9
Garusok,thrall,853,warrior,arms,12,9,3
Asiyurekhans,borean-tundra,851,warrior,arms,12,9,3
Moosebeef,garrosh,851,warrior,arms,31,12,19
Jaimey,malganis,845,warrior,arms,23,9,14
Rainiki,stormrage,845,warrior,arms,24,9,15
Whiteclouds,blood-furnace,844,warrior,arms,42,17,25
Macdollibee,barthilas,834,warrior,arms,18,9,9
Soulcalibur,zuljin,830,warrior,arms,23,9,14
Brrzrrkrr,twisting-nether,827,warrior,arms,18,9,9
Seniorsherk,dalaran,827,warrior,arms,18,9,9
Xwoyer,malganis,825,warrior,arms,22,11,11
Eskama,hyjal,823,warrior,arms,23,9,14
Hjoz,illidan,822,warrior,arms,16,9,7
Dupaminichav,stormrage,814,warrior,arms,15,9,6
Bargorengar,skullcrusher,814,warrior,arms,78,34,44
Amberlym,ragnaros,814,warrior,arms,23,9,14
Khâi,tichondrius,811,warrior,arms,27,9,18
Scran,sargeras,809,warrior,arms,21,10,11
Paí,nemesis,808,warrior,arms,17,9,8
Fraccx,area-52,800,warrior,arms,22,9,13
Rahj,saurfang,799,warrior,arms,20,9,11
Gigazug,stormrage,799,warrior,arms,20,9,11
Fatmân,tichondrius,798,warrior,arms,22,9,13
Murrdock,nesingwary,794,warrior,arms,14,9,5
Ripstorm,emerald-dream,794,warrior,arms,20,9,11
Vandalizer,sargeras,788,warrior,arms,20,10,10
Klingensturm,thrall,784,warrior,arms,13,9,4
Joecules,kelthuzad,783,warrior,arms,17,9,8
Patékphilípe,area-52,768,warrior,arms,12,8,4
Chestbrook,icecrown,768,warrior,arms,12,8,4
Smallbrainx,tichondrius,768,warrior,arms,12,8,4
Traglos,ragnaros,768,warrior,arms,12,8,4
Dadslapper,illidan,768,warrior,arms,12,8,4
Príde,kiljaeden,768,warrior,arms,12,8,4
Åthos,illidan,768,warrior,arms,12,8,4
Piimpmaster,malganis,768,warrior,arms,12,8,4
Grüumsh,drenden,768,warrior,arms,12,8,4
Zdokk,sargeras,768,warrior,arms,12,8,4
Sweeped,darkspear,768,warrior,arms,12,8,4
Gladìus,area-52,768,warrior,arms,12,8,4
Spinspin,borean-tundra,768,warrior,arms,12,8,4
Executiepie,hyjal,768,warrior,arms,12,8,4
Msallsunday,nerzhul,768,warrior,arms,12,8,4
Slvrback,stormrage,768,warrior,arms,12,8,4
Huangatang,wyrmrest-accord,768,warrior,arms,12,8,4
Zleam,area-52,768,warrior,arms,12,8,4
Thornhardt,frostmourne,768,warrior,arms,12,8,4
Gabv,shadowmoon,768,warrior,arms,12,8,4
Saucebussin,emerald-dream,768,warrior,arms,12,8,4
Imakeupuddin,turalyon,768,warrior,arms,12,8,4
Stoneball,kiljaeden,768,warrior,arms,18,8,10
Chronek,sargeras,768,warrior,arms,18,8,10
Ricksanches,shadowmoon,768,warrior,arms,18,8,10
Orangesoda,tichondrius,768,warrior,arms,18,8,10
Elkz,tichondrius,768,warrior,arms,18,8,10
Elky,area-52,768,warrior,arms,18,8,10
Cuddlechamp,barthilas,768,warrior,arms,18,8,10
Onecho,tichondrius,768,warrior,arms,18,8,10
Elitistx,bleeding-hollow,768,warrior,arms,18,8,10
Ogre,magtheridon,768,warrior,arms,18,8,10
Dtitanzz,quelthalas,768,warrior,arms,18,8,10
Gízzmo,tichondrius,768,warrior,arms,18,8,10
Supermieo,illidan,768,warrior,arms,18,8,10
Imuti,illidan,768,warrior,arms,18,8,10
Rahj,caelestrasz,768,warrior,arms,18,8,10
Easylel,stormrage,768,warrior,arms,18,8,10
Tuggernaut,khadgar,768,warrior,arms,18,8,10
Toxxel,wyrmrest-accord,768,warrior,arms,18,8,10
Tádakatsu,sargeras,768,warrior,arms,18,8,10
Leunitas,shadow-council,768,warrior,arms,18,8,10
Soultarius,sargeras,768,warrior,arms,21,9,12
Dirkdallas,tichondrius,768,warrior,arms,24,8,16
Warhji,malganis,768,warrior,arms,24,8,16
Bornne,doomhammer,768,warrior,arms,30,8,22
Letsgosmokes,stormrage,767,warrior,arms,12,8,4
Executefreak,illidan,767,warrior,arms,12,8,4
Pigblind,azralon,767,warrior,arms,12,8,4
Alucardio,turalyon,767,warrior,arms,12,8,4
Rúz,illidan,767,warrior,arms,12,8,4
Rushee,argent-dawn,767,warrior,arms,12,8,4
Nãrax,area-52,767,warrior,arms,12,8,4
Domminux,darkspear,767,warrior,arms,12,8,4
Blazingguard,stormrage,767,warrior,arms,12,8,4
Skizoid,kiljaeden,767,warrior,arms,12,8,4
Warwagon,malganis,767,warrior,arms,12,8,4
Silac,drenden,767,warrior,arms,12,8,4
Angrybulky,illidan,767,warrior,arms,12,8,4
Wantor,lightnings-blade,767,warrior,arms,12,8,4
Gränd,frostmourne,767,warrior,arms,12,8,4
Kàkarot,illidan,767,warrior,arms,12,8,4
Kixxel,sargeras,767,warrior,arms,12,8,4
Itskinggrizz,thrall,767,warrior,arms,16,9,7
Zédelívery,azralon,767,warrior,arms,16,9,7
Empriux,quelthalas,767,warrior,arms,18,8,10
Moarbrainz,mannoroth,767,warrior,arms,18,8,10
Pípe,nemesis,767,warrior,arms,18,8,10
Karín,tichondrius,767,warrior,arms,18,8,10
Execute,kirin-tor,767,warrior,arms,18,8,10
Ihazlolstorm,area-52,767,warrior,arms,18,8,10
Zxlor,tichondrius,767,warrior,arms,18,8,10
Drusillaa,deathwing,767,warrior,arms,18,8,10
Dalinare,area-52,767,warrior,arms,18,8,10
Æwarrìor,tichondrius,767,warrior,arms,18,8,10
Cevadix,azralon,767,warrior,arms,18,8,10
Nogèt,frostmourne,767,warrior,arms,18,8,10
Nanor,zuljin,767,warrior,arms,18,8,10
Himurinha,nemesis,767,warrior,arms,18,8,10
Steelfist,grizzly-hills,767,warrior,arms,18,8,10
Calthi,moon-guard,767,warrior,arms,18,8,10
Onionion,stormrage,767,warrior,arms,18,8,10
Orgreshin,area-52,767,warrior,arms,21,9,12
Báhamut,area-52,767,warrior,arms,20,8,12
Brawnforce,shadowsong,767,warrior,arms,24,8,16
Techanina,aerie-peak,767,warrior,arms,24,8,16
Essofeit,frostmourne,767,warrior,arms,24,8,16
Krakitus,azralon,767,warrior,arms,24,8,16
Cajual,area-52,767,warrior,arms,24,8,16
Warriorc,laughing-skull,766,warrior,arms,12,8,4
Ragarok,jubeithos,766,warrior,arms,12,8,4
Horvv,frostmourne,766,warrior,arms,12,8,4
Diãbel,azralon,766,warrior,arms,12,8,4
Jackhanma,kelthuzad,766,warrior,arms,12,8,4
Zhasi,bonechewer,766,warrior,arms,12,8,4
Khrull,khazgoroth,766,warrior,arms,12,8,4
Donnacha,garona,766,warrior,arms,18,8,10
Edalthor,quelthalas,766,warrior,arms,18,8,10
Hemmyroidz,tichondrius,766,warrior,arms,18,8,10
Lobsterrj,emerald-dream,766,warrior,arms,18,8,10
Truecarnage,emerald-dream,766,warrior,arms,18,8,10
Sálieri,ragnaros,766,warrior,arms,18,8,10
Çleåvage,stormrage,766,warrior,arms,18,8,10
Syllana,sargeras,766,warrior,arms,18,8,10
Rezzett,wyrmrest-accord,766,warrior,arms,21,9,12
Aziz,kiljaeden,766,warrior,arms,19,8,11
Violençe,malganis,766,warrior,arms,24,8,16
Modzilla,aerie-peak,766,warrior,arms,30,8,22
Odrak,ragnaros,766,warrior,arms,30,8,22
Belladeom,azralon,765,warrior,arms,18,8,10
Ligerii,quelthalas,765,warrior,arms,18,8,10
Ulfioff,whisperwind,765,warrior,arms,18,8,10
Percthirty,blackrock,765,warrior,arms,18,8,10
Loktarrogar,illidan,765,warrior,arms,24,8,16
Maxprotein,area-52,764,warrior,arms,14,8,6
Pangean,sargeras,764,warrior,arms,18,8,10
Alexarchos,chogall,764,warrior,arms,18,8,10
Xarlon,stormrage,764,warrior,arms,18,8,10
Plssaveme,ysera,764,warrior,arms,24,8,16
Enthria,illidan,763,warrior,arms,12,8,4
Stalecrouton,doomhammer,763,warrior,arms,12,8,4
Märx,barthilas,763,warrior,arms,18,8,10
Baghatur,tichondrius,763,warrior,arms,18,8,10
Friends,azjolnerub,763,warrior,arms,18,8,10
Sygw,area-52,763,warrior,arms,24,8,16
Tarmer,moon-guard,762,warrior,arms,18,8,10
Buffalobob,bronzebeard,762,warrior,arms,18,8,10
Sweetdeé,zuljin,762,warrior,arms,18,8,10
Revenn,greymane,761,warrior,arms,12,8,4
Asarg,emerald-dream,761,warrior,arms,12,8,4
Vynfull,area-52,760,warrior,arms,18,8,10
Lumilis,draenor,760,warrior,arms,18,8,10
Padalouh,kelthuzad,760,warrior,arms,24,8,16
Rágnárr,ragnaros,759,warrior,arms,18,8,10
Rafaelwar,drakkari,758,warrior,arms,18,8,10
Badazzdad,thunderhorn,757,warrior,arms,18,8,10
Clortho,korialstrasz,756,warrior,arms,27,9,18
Trapwar,malganis,755,warrior,arms,12,8,4
Bilmuuri,illidan,754,warrior,arms,27,9,18
Fleshtuxedo,stormrage,752,warrior,arms,12,8,4
Gladiattor,tol-barad,749,warrior,arms,18,8,10
Ironwarr,hyjal,740,warrior,arms,23,8,15
Vetinari,nazjatar,735,warrior,arms,11,8,3
Outo,stormrage,735,warrior,arms,17,8,9
Lòvex,alterac-mountains,735,warrior,arms,18,8,10
Thistleberry,aegwynn,735,warrior,arms,23,8,15
Casmier,tichondrius,734,warrior,arms,17,8,9
Gorakis,barthilas,733,warrior,arms,20,9,11
Señor,barthilas,719,warrior,arms,15,8,7
Mêlo,area-52,719,warrior,arms,17,8,9
Kzw,illidan,719,warrior,arms,17,8,9
Layoon,azralon,718,warrior,arms,17,8,9
Wreckthis,area-52,718,warrior,arms,17,8,9
Alemão,bleeding-hollow,713,warrior,arms,23,9,14
Jurojin,tichondrius,703,warrior,arms,11,8,3
Ketaqt,illidan,702,warrior,arms,14,8,6
Tabadigbick,bleeding-hollow,698,warrior,arms,17,8,9
Olgran,drakkari,697,warrior,arms,28,8,20
Lishajr,malganis,687,warrior,arms,14,8,6
Psyrush,area-52,687,warrior,arms,19,8,11
Greenbrain,dunemaul,685,warrior,arms,19,8,11
Wreckerr,area-52,680,warrior,arms,20,10,10
Vids,aegwynn,672,warrior,arms,12,7,5
Bean,ragnaros,672,warrior,arms,12,7,5
Tkavalan,proudmoore,672,warrior,arms,12,7,5
Heojae,tichondrius,672,warrior,arms,12,7,5
Drashka,ragnaros,672,warrior,arms,12,7,5
Madmartiggan,tichondrius,672,warrior,arms,12,7,5
Jaysmom,tichondrius,672,warrior,arms,12,7,5
Zekkenx,azjolnerub,672,warrior,arms,12,7,5
Ryalaeth,moon-guard,672,warrior,arms,12,7,5
Rage,uther,672,warrior,arms,12,7,5
Kevy,arygos,672,warrior,arms,12,7,5
Reichbeast,area-52,672,warrior,arms,12,7,5
Xdoombringer,area-52,672,warrior,arms,12,7,5
Salthouse,sargeras,672,warrior,arms,12,7,5
Jesbar,ragnaros,672,warrior,arms,12,7,5
Slaughtér,tichondrius,672,warrior,arms,12,7,5
Solocon,tichondrius,672,warrior,arms,12,7,5
Papazugs,kelthuzad,672,warrior,arms,12,7,5
Toungy,kelthuzad,672,warrior,arms,12,7,5
Havocsmash,tichondrius,672,warrior,arms,12,7,5
Okayge,proudmoore,672,warrior,arms,12,7,5
Mõgorrin,area-52,672,warrior,arms,12,7,5
Yrz,malganis,672,warrior,arms,12,7,5
Baye,kargath,672,warrior,arms,12,7,5
Magnusz,zuljin,672,warrior,arms,12,7,5
Madamemarie,stormrage,672,warrior,arms,12,7,5
Dehumanized,greymane,672,warrior,arms,12,7,5
Püsspeepers,kelthuzad,672,warrior,arms,12,7,5
Roiboy,stormrage,672,warrior,arms,12,7,5
Jahrakál,thunderlord,672,warrior,arms,12,7,5
Furìous,stormrage,672,warrior,arms,12,7,5
Arsis,whisperwind,672,warrior,arms,12,7,5
Jypster,stormrage,672,warrior,arms,12,7,5
Bloodshêdz,stormrage,672,warrior,arms,12,7,5
Turtleofhope,barthilas,672,warrior,arms,12,7,5
Deathammer,stormrage,672,warrior,arms,12,7,5
Petuniä,zuljin,672,warrior,arms,12,7,5
Cugij,frostmourne,672,warrior,arms,12,7,5
Ousetadoidao,nemesis,672,warrior,arms,12,7,5
Studdythejet,zuljin,672,warrior,arms,12,7,5
Giv,frostmourne,672,warrior,arms,12,7,5
Grounyl,azralon,672,warrior,arms,12,7,5
Gbrz,stormrage,672,warrior,arms,12,7,5
Vxjohnson,proudmoore,672,warrior,arms,15,8,7
Soyu,tichondrius,672,warrior,arms,16,8,8
Imyourdaddy,chogall,672,warrior,arms,16,8,8
Kappiz,wyrmrest-accord,672,warrior,arms,14,7,7
Yamzprime,stormrage,672,warrior,arms,18,7,11
Ryänlord,mugthol,672,warrior,arms,18,7,11
Käggai,khadgar,672,warrior,arms,18,7,11
Gizzmo,bonechewer,672,warrior,arms,18,7,11
Raxek,stormrage,672,warrior,arms,18,7,11
Thètrùth,duskwood,672,warrior,arms,18,7,11
Ivory,emerald-dream,672,warrior,arms,18,7,11
Sayjaki,stormrage,672,warrior,arms,18,7,11
Rraw,demon-soul,672,warrior,arms,18,7,11
Jamajuicedx,thrall,672,warrior,arms,18,7,11
Ignorebrain,tichondrius,672,warrior,arms,18,7,11
Tbagg,area-52,672,warrior,arms,18,7,11
Tasilia,tichondrius,672,warrior,arms,18,7,11
Goyqqw,illidan,672,warrior,arms,18,7,11
Zerosends,kelthuzad,672,warrior,arms,18,7,11
Infâmous,proudmoore,672,warrior,arms,18,7,11
July,arthas,672,warrior,arms,18,7,11
Hazelbean,tichondrius,672,warrior,arms,18,7,11
Organge,zuljin,672,warrior,arms,18,7,11
Corevp,barthilas,672,warrior,arms,24,7,17
Festerclaws,wyrmrest-accord,672,warrior,arms,24,7,17
Pokeyobutt,hydraxis,672,warrior,arms,24,7,17
Tigima,tichondrius,672,warrior,arms,24,7,17
Baciless,illidan,672,warrior,arms,24,7,17
Omlas,azralon,672,warrior,arms,24,7,17
Swàgnáros,area-52,671,warrior,arms,12,7,5
Furiousangel,area-52,671,warrior,arms,12,7,5
Blazie,barthilas,671,warrior,arms,12,7,5
Glizzarms,dalaran,671,warrior,arms,12,7,5
Jedeva,stormrage,671,warrior,arms,12,7,5
Exceldoc,frostwolf,671,warrior,arms,12,7,5
Dêsêcratê,frostmourne,671,warrior,arms,12,7,5
Vijit,stormrage,671,warrior,arms,12,7,5
Rhuktar,azralon,671,warrior,arms,12,7,5
Dunkindots,tichondrius,671,warrior,arms,12,7,5
Shrikewing,moon-guard,671,warrior,arms,12,7,5
Pipeman,blackhand,671,warrior,arms,12,7,5
Nehpets,akama,671,warrior,arms,12,7,5
Vodkalol,bleeding-hollow,671,warrior,arms,12,7,5
Crnogorac,hakkar,671,warrior,arms,12,7,5
Maddzspin,tichondrius,671,warrior,arms,12,7,5
Ramborco,kelthuzad,671,warrior,arms,12,7,5
Gunnëy,malganis,671,warrior,arms,12,7,5
Saero,ragnaros,671,warrior,arms,12,7,5
Sneakyhand,draktharon,671,warrior,arms,12,7,5
Girthstick,eredar,671,warrior,arms,12,7,5
Qtrpndwcheez,area-52,671,warrior,arms,12,7,5
Orthopedic,tichondrius,671,warrior,arms,12,7,5
Riffralph,quelthalas,671,warrior,arms,12,7,5
Menestz,dreadmaul,671,warrior,arms,17,9,8
Mirandakerrx,frostmourne,671,warrior,arms,18,7,11
Timbajimba,silvermoon,671,warrior,arms,18,7,11
Tsurik,malfurion,671,warrior,arms,18,7,11
Andrexion,moon-guard,671,warrior,arms,18,7,11
Ironhide,malorne,671,warrior,arms,18,7,11
Paratech,thrall,671,warrior,arms,18,7,11
Stepzugger,illidan,671,warrior,arms,18,7,11
Nosferagc,frostmourne,671,warrior,arms,18,7,11
Elíte,kelthuzad,671,warrior,arms,18,7,11
Colnar,stormrage,671,warrior,arms,18,7,11
Layøut,azralon,671,warrior,arms,18,7,11
Bröstörm,bonechewer,671,warrior,arms,18,7,11
Kasheeka,spirestone,671,warrior,arms,18,7,11
Chumbinhu,stormrage,671,warrior,arms,18,7,11
Pharan,malganis,671,warrior,arms,18,7,11
Pneumasmash,tichondrius,671,warrior,arms,18,7,11
Brøxigár,quelthalas,671,warrior,arms,18,7,11
Grazellor,khaz-modan,671,warrior,arms,18,7,11
Xeniwar,tichondrius,671,warrior,arms,20,7,13
Tasërface,hakkar,671,warrior,arms,24,7,17
Winso,blood-furnace,671,warrior,arms,24,7,17
Powerjaw,stormrage,671,warrior,arms,24,7,17
Vandammage,cenarion-circle,671,warrior,arms,24,7,17
Babyreap,frostmourne,670,warrior,arms,12,7,5
Eniaan,khaz-modan,670,warrior,arms,12,7,5
Chacca,suramar,670,warrior,arms,12,7,5
Svantevit,tichondrius,670,warrior,arms,12,7,5
Draggo,tortheldrin,670,warrior,arms,12,7,5
Nraged,illidan,670,warrior,arms,12,7,5
Dizzygal,hyjal,670,warrior,arms,18,7,11
Notakîd,stormrage,670,warrior,arms,18,7,11
Gìraffe,illidan,670,warrior,arms,18,7,11
Reidahn,zuljin,670,warrior,arms,24,7,17
Torage,wyrmrest-accord,669,warrior,arms,12,7,5
Astrokreep,emerald-dream,669,warrior,arms,12,7,5
Harnor,garrosh,669,warrior,arms,18,7,11
Rollz,amanthul,669,warrior,arms,24,7,17
Teyliemond,amanthul,668,warrior,arms,12,7,5
Pandamoanman,moon-guard,668,warrior,arms,18,7,11
Hoshigaki,frostmourne,668,warrior,arms,18,7,11
Grokash,azralon,668,warrior,arms,18,7,11
Yerajmiel,proudmoore,667,warrior,arms,12,7,5
Yanïka,barthilas,667,warrior,arms,13,7,6
Aistine,alterac-mountains,667,warrior,arms,18,7,11
Moøster,aggramar,667,warrior,arms,18,7,11
Rogkhan,tichondrius,667,warrior,arms,18,7,11
Kevasaurr,sargeras,667,warrior,arms,24,7,17
Borgee,tichondrius,666,warrior,arms,18,7,11
Terribletom,stormrage,665,warrior,arms,18,7,11
Nepharia,kirin-tor,664,warrior,arms,18,7,11
Tanatos,the-venture-co,664,warrior,arms,24,7,17
Jötunn,dalaran,663,warrior,arms,12,7,5
Lilwarrior,blackrock,661,warrior,arms,12,7,5
Dierdris,gnomeregan,659,warrior,arms,13,7,6
Ruick,wyrmrest-accord,658,warrior,arms,12,7,5
Parmizan,hydraxis,639,warrior,arms,16,7,9
Agnesis,quelthalas,639,warrior,arms,16,7,9
Phoveros,sargeras,639,warrior,arms,17,7,10
Moostorm,darkspear,639,warrior,arms,17,7,10
Fewfingers,sargeras,638,warrior,arms,16,7,9
Punnisher,nerzhul,638,warrior,arms,17,7,10
Twinxin,thrall,637,warrior,arms,17,7,10
Jrodrick,nemesis,624,warrior,arms,21,8,13
Rexxous,hyjal,624,warrior,arms,21,7,14
Loudpee,tichondrius,623,warrior,arms,11,7,4
Allenwalker,dreadmaul,623,warrior,arms,13,7,6
Fidel,blackrock,623,warrior,arms,23,7,16
Ogpapabear,stormscale,623,warrior,arms,33,7,26
Bigboycandy,malganis,621,warrior,arms,11,7,4
Xunaco,quelthalas,620,warrior,arms,26,7,19
Xandrak,barthilas,618,warrior,arms,11,7,4
Ålbedo,malganis,616,warrior,arms,23,8,15
Bruze,hellscream,607,warrior,arms,14,7,7
Pkrage,hellscream,606,warrior,arms,11,7,4
Bullkathoss,bleeding-hollow,605,warrior,arms,22,7,15
Tyférious,tichondrius,602,warrior,arms,32,7,25
Elpresador,dragonmaw,576,warrior,arms,6,6,0
Baltusrol,hydraxis,576,warrior,arms,6,6,0
Stoneshield,senjin,576,warrior,arms,6,6,0
Dreadwarr,stormrage,576,warrior,arms,6,6,0
Darkoil,illidan,576,warrior,arms,6,6,0
Khalwar,ragnaros,576,warrior,arms,6,6,0
Dóminus,malfurion,576,warrior,arms,6,6,0
Iskandr,amanthul,576,warrior,arms,9,7,2
Dypnos,ragnaros,576,warrior,arms,12,6,6
Sodarzok,thaurissan,576,warrior,arms,12,6,6
Reflective,zuljin,576,warrior,arms,12,6,6
Dreamwarr,tichondrius,576,warrior,arms,12,6,6
Cassetto,icecrown,576,warrior,arms,12,6,6
Toegap,illidan,576,warrior,arms,12,6,6
Ratherfull,ragnaros,576,warrior,arms,12,6,6
Auxthas,tichondrius,576,warrior,arms,12,6,6
Prìscìlla,stormrage,576,warrior,arms,12,6,6
Novastormer,barthilas,576,warrior,arms,12,6,6
Targramu,emerald-dream,576,warrior,arms,12,6,6
Rargou,illidan,576,warrior,arms,12,6,6
Sunderstruck,boulderfist,576,warrior,arms,12,6,6
Bailu,ragnaros,576,warrior,arms,12,6,6
Feedmetren,tichondrius,576,warrior,arms,12,6,6
Musclecrowe,illidan,576,warrior,arms,12,6,6
Blazight,dunemaul,576,warrior,arms,12,6,6
Zzode,tichondrius,576,warrior,arms,12,6,6
Raime,sargeras,576,warrior,arms,12,6,6
Amortens,area-52,576,warrior,arms,12,6,6
Mcflury,skullcrusher,576,warrior,arms,12,6,6
Orkussw,illidan,576,warrior,arms,12,6,6
Painremaìns,dunemaul,576,warrior,arms,12,6,6
Rudakoff,ragnaros,576,warrior,arms,12,6,6
Lotsay,tichondrius,576,warrior,arms,12,6,6
Flanrych,illidan,576,warrior,arms,12,6,6
Malvicious,proudmoore,576,warrior,arms,12,6,6
Houdinix,stormrage,576,warrior,arms,12,6,6
Hololeave,tichondrius,576,warrior,arms,12,6,6
Zuans,azralon,576,warrior,arms,12,6,6
Areiana,stormrage,576,warrior,arms,12,6,6
Illmindofboo,tichondrius,576,warrior,arms,12,6,6
Grughak,kiljaeden,576,warrior,arms,12,6,6
Fatpoos,barthilas,576,warrior,arms,12,6,6
Luckychaos,bleeding-hollow,576,warrior,arms,12,6,6
Garysmalls,kelthuzad,576,warrior,arms,12,6,6
Aliminar,zuluhed,576,warrior,arms,12,6,6
Linjunfeng,tichondrius,576,warrior,arms,12,6,6
Raahj,sargeras,576,warrior,arms,12,6,6
Biorhn,area-52,576,warrior,arms,12,6,6
Monkeystrike,barthilas,576,warrior,arms,12,6,6
Bedman,tichondrius,576,warrior,arms,12,6,6
Aladarith,moon-guard,576,warrior,arms,12,6,6
Husyuzhi,tichondrius,576,warrior,arms,12,6,6
Griftustle,moon-guard,576,warrior,arms,12,6,6
Headsour,thunderhorn,576,warrior,arms,12,6,6
Jerebeloz,proudmoore,576,warrior,arms,12,6,6
Sigrik,moon-guard,576,warrior,arms,12,6,6
Rembrand,blackhand,576,warrior,arms,12,6,6
Roflcombo,illidan,576,warrior,arms,12,6,6
Flidumpling,tichondrius,576,warrior,arms,12,6,6
Warsongworg,tichondrius,576,warrior,arms,12,6,6
Aùstin,moon-guard,576,warrior,arms,12,6,6
Bamlin,sargeras,576,warrior,arms,12,6,6
Stÿgían,kelthuzad,576,warrior,arms,12,6,6
Gnomërcy,tichondrius,576,warrior,arms,12,6,6
Breaker,undermine,576,warrior,arms,12,6,6
Larrythelob,kelthuzad,576,warrior,arms,12,6,6
Flèx,stormrage,576,warrior,arms,12,6,6
Crusherr,earthen-ring,576,warrior,arms,12,6,6
Azrailz,stormrage,576,warrior,arms,12,6,6
Fraxxure,proudmoore,576,warrior,arms,12,6,6
Vãryan,frostmourne,576,warrior,arms,12,6,6
Arozay,illidan,576,warrior,arms,12,6,6
Ragehir,thrall,576,warrior,arms,12,6,6
Linios,tichondrius,576,warrior,arms,12,6,6
Glourfindel,quelthalas,576,warrior,arms,12,6,6
Rexquando,barthilas,576,warrior,arms,12,6,6
Tàlent,thrall,576,warrior,arms,12,6,6
Ankhxiety,sargeras,576,warrior,arms,12,6,6
Horcules,kiljaeden,576,warrior,arms,12,6,6
Hülkamanïa,sargeras,576,warrior,arms,12,6,6
Geubsalx,tichondrius,576,warrior,arms,12,6,6
Inkurushio,suramar,576,warrior,arms,12,6,6
Kazabare,tichondrius,576,warrior,arms,12,6,6
Armsofury,kelthuzad,576,warrior,arms,12,6,6
Invinciblé,tichondrius,576,warrior,arms,12,6,6
Luminiere,sargeras,576,warrior,arms,12,6,6
Maleap,moon-guard,576,warrior,arms,12,6,6
Gílly,borean-tundra,576,warrior,arms,12,6,6
Gladdz,moon-guard,576,warrior,arms,12,6,6
Bigdickgomez,frostmourne,576,warrior,arms,12,6,6
Averagewar,frostwolf,576,warrior,arms,12,6,6
Bonclay,nerzhul,576,warrior,arms,12,6,6
Bagginses,quelthalas,576,warrior,arms,12,6,6
Lacorte,ragnaros,576,warrior,arms,12,6,6
Róngor,ragnaros,576,warrior,arms,12,6,6
Fûry,barthilas,576,warrior,arms,12,6,6
Trexxen,stormrage,576,warrior,arms,12,6,6
Assamith,nemesis,576,warrior,arms,12,6,6
Unwarmas,ragnaros,576,warrior,arms,12,6,6
Marîn,stormrage,576,warrior,arms,12,6,6
Atuey,area-52,576,warrior,arms,12,6,6
Ganzism,tichondrius,576,warrior,arms,13,6,7
Mercystaling,tichondrius,576,warrior,arms,18,6,12
Robar,trollbane,576,warrior,arms,18,6,12
Kennäy,azralon,576,warrior,arms,18,6,12
Deathstrøke,illidan,576,warrior,arms,18,6,12
Stormwald,sargeras,576,warrior,arms,18,6,12
Natalieftm,tichondrius,576,warrior,arms,18,6,12
Grimspin,tichondrius,576,warrior,arms,18,6,12
Tonesman,tichondrius,576,warrior,arms,18,6,12
Swìll,illidan,576,warrior,arms,18,6,12
Egoist,malganis,576,warrior,arms,18,6,12
Dankdad,garrosh,576,warrior,arms,18,6,12
Ezgamelol,azralon,576,warrior,arms,18,6,12
Májorrobot,area-52,576,warrior,arms,18,6,12
Ooktanx,emerald-dream,576,warrior,arms,18,6,12
Cowboybeast,tanaris,576,warrior,arms,18,6,12
Psilly,sargeras,576,warrior,arms,18,6,12
Nillor,emerald-dream,576,warrior,arms,18,6,12
Eabywarrs,tichondrius,576,warrior,arms,18,6,12
Hugz,thrall,576,warrior,arms,18,6,12
Shöthetank,area-52,576,warrior,arms,18,6,12
Xgraves,sargeras,576,warrior,arms,18,6,12
Ronak,vashj,576,warrior,arms,18,6,12
Sõnics,tichondrius,576,warrior,arms,18,6,12
Geubsal,tichondrius,576,warrior,arms,18,6,12
Morphexo,quelthalas,576,warrior,arms,18,6,12
Pushh,thrall,576,warrior,arms,18,6,12
Ahkimih,ragnaros,576,warrior,arms,18,6,12
Cleavxy,sargeras,576,warrior,arms,18,6,12
Mahoneslice,thrall,576,warrior,arms,18,6,12
Lieofa,tichondrius,576,warrior,arms,19,6,13
Contentious,moon-guard,576,warrior,arms,24,6,18
Shîzu,moon-guard,576,warrior,arms,24,6,18
Fenømenoide,ragnaros,575,warrior,arms,6,6,0
Ragefested,tichondrius,575,warrior,arms,12,6,6
Bkdorbandit,illidan,575,warrior,arms,12,6,6
Teyrn,stormrage,575,warrior,arms,12,6,6
Zhyper,frostmourne,575,warrior,arms,12,6,6
Vioar,hyjal,575,warrior,arms,12,6,6
Ereborh,ragnaros,575,warrior,arms,12,6,6
Uragiri,shadowsong,575,warrior,arms,12,6,6
Rongkhunxyz,tichondrius,575,warrior,arms,12,6,6
Croton,moon-guard,575,warrior,arms,12,6,6
Orryn,proudmoore,575,warrior,arms,12,6,6
Pandatrue,azralon,575,warrior,arms,12,6,6
Redneckk,emerald-dream,575,warrior,arms,12,6,6
Theodere,moon-guard,575,warrior,arms,12,6,6
Obstruktíon,tichondrius,575,warrior,arms,12,6,6
Gimmiefood,emerald-dream,575,warrior,arms,12,6,6
Nospace,tichondrius,575,warrior,arms,12,6,6
Bolx,archimonde,575,warrior,arms,12,6,6
Desul,tichondrius,575,warrior,arms,12,6,6
Kurgos,quelthalas,575,warrior,arms,12,6,6
Jujuassgeter,darkspear,575,warrior,arms,12,6,6
Balthazãr,quelthalas,575,warrior,arms,12,6,6
Weewarrior,wyrmrest-accord,575,warrior,arms,12,6,6
Thornakh,stormrage,575,warrior,arms,12,6,6
Maltrate,hyjal,575,warrior,arms,15,7,8
Bärdock,ragnaros,575,warrior,arms,16,7,9
Corthíus,stormrage,575,warrior,arms,16,7,9
Gaydin,eldrethalas,575,warrior,arms,18,6,12
Chadler,dragonmaw,575,warrior,arms,18,6,12
Opalert,tichondrius,575,warrior,arms,18,6,12
Slamchowdy,tichondrius,575,warrior,arms,18,6,12
Babybiif,azralon,575,warrior,arms,24,6,18
Sarget,ragnaros,574,warrior,arms,12,6,6
Darkshrek,quelthalas,574,warrior,arms,12,6,6
Kenroc,illidan,574,warrior,arms,12,6,6
Nashallo,zuljin,574,warrior,arms,12,6,6
Ådolf,sargeras,574,warrior,arms,15,7,8
Masami,moon-guard,574,warrior,arms,18,6,12
Newtommi,barthilas,574,warrior,arms,18,6,12
Irgon,quelthalas,573,warrior,arms,12,6,6
Môgwai,kelthuzad,573,warrior,arms,12,6,6
Dúmp,stormrage,573,warrior,arms,12,6,6
Cizzik,emerald-dream,573,warrior,arms,12,6,6
Logohn,wyrmrest-accord,573,warrior,arms,12,6,6
Gfree,kiljaeden,573,warrior,arms,21,7,14
Brosèph,sargeras,573,warrior,arms,18,6,12
Faóra,moon-guard,572,warrior,arms,12,6,6
Azyxia,emerald-dream,572,warrior,arms,15,7,8
Bitiatus,scilla,572,warrior,arms,18,6,12
Tatsher,turalyon,571,warrior,arms,12,6,6
Rudiblade,dalaran,571,warrior,arms,12,6,6
Sezariùs,darkspear,559,warrior,arms,19,7,12
Conchalover,illidan,559,warrior,arms,17,6,11
Dadookibooty,area-52,552,warrior,arms,18,9,9
Ecopolis,azshara,544,warrior,arms,16,6,10
Ballzindeep,tichondrius,543,warrior,arms,8,7,1
Tâlos,ysondre,543,warrior,arms,11,6,5
Tastyskeet,illidan,543,warrior,arms,11,6,5
Uneasyw,tichondrius,543,warrior,arms,17,6,11
Randywar,tichondrius,528,warrior,arms,15,6,9
Vikkz,frostmourne,527,warrior,arms,11,6,5
Luckybrother,tichondrius,527,warrior,arms,15,6,9
Llewellenar,stormrage,527,warrior,arms,17,6,11
Warwik,stormscale,527,warrior,arms,17,6,11
Meadsweats,tichondrius,522,warrior,arms,17,10,7
Bersérk,area-52,522,warrior,arms,14,8,6
Tomcruz,bloodscalp,522,warrior,arms,16,7,9
Hrókr,kiljaeden,522,warrior,arms,19,8,11
Orz,sargeras,522,warrior,arms,25,7,18
Rhok,elune,515,warrior,arms,16,9,7
Illicitiri,sargeras,511,warrior,arms,10,6,4
Psychosicko,tichondrius,511,warrior,arms,11,6,5
Kvobash,area-52,511,warrior,arms,11,6,5
Ohjim,stormrage,511,warrior,arms,14,6,8
Jackjaeger,area-52,511,warrior,arms,16,6,10
Berzerc,stormrage,511,warrior,arms,18,6,12
Alzuga,quelthalas,511,warrior,arms,20,6,14
Ruiend,bonechewer,510,warrior,arms,14,6,8
Tyraelius,kiljaeden,510,warrior,arms,17,6,11
Magarrior,shadowsong,495,warrior,arms,13,7,6
Noreaga,tichondrius,480,warrior,arms,6,5,1
Rickywarx,illidan,480,warrior,arms,6,5,1
Bootypound,sargeras,480,warrior,arms,6,5,1
Thombelina,malganis,480,warrior,arms,6,5,1
Roadglide,korgath,480,warrior,arms,6,5,1
Tâlos,magtheridon,480,warrior,arms,6,5,1
Meatsweatx,stormrage,480,warrior,arms,6,5,1
Drippyjones,sargeras,480,warrior,arms,6,5,1
Gorva,emerald-dream,480,warrior,arms,6,5,1
Dukagã,tichondrius,480,warrior,arms,6,5,1
Madrak,greymane,480,warrior,arms,6,5,1
Millywhopz,thrall,480,warrior,arms,6,5,1
Xaenne,zuljin,480,warrior,arms,6,5,1
Vanlur,khaz-modan,480,warrior,arms,6,5,1
Houk,frostmourne,480,warrior,arms,6,5,1
Flexecute,area-52,480,warrior,arms,6,5,1
Cowstik,illidan,480,warrior,arms,6,5,1
Violence,icecrown,480,warrior,arms,6,5,1
Geàrbreaker,tichondrius,480,warrior,arms,6,5,1
Noor,tichondrius,480,warrior,arms,6,5,1
Biggesttoees,tichondrius,480,warrior,arms,6,5,1
Jackox,sargeras,480,warrior,arms,6,5,1
Billythunda,tichondrius,480,warrior,arms,6,5,1
Saladin,gnomeregan,480,warrior,arms,6,5,1
Armsupx,tichondrius,480,warrior,arms,6,5,1
Kushian,tichondrius,480,warrior,arms,6,5,1
Ryü,khaz-modan,480,warrior,arms,6,5,1
Mongosyco,proudmoore,480,warrior,arms,6,5,1
Tinymo,archimonde,480,warrior,arms,6,5,1
Jarlaix,dragonmaw,480,warrior,arms,6,5,1
Moè,frostmourne,480,warrior,arms,10,6,4
Warpenguin,kelthuzad,480,warrior,arms,10,6,4
Whittyxc,tichondrius,480,warrior,arms,9,5,4
Dynamiite,bleeding-hollow,480,warrior,arms,12,5,7
Huricas,arthas,480,warrior,arms,12,5,7
Orcimonde,arthas,480,warrior,arms,12,5,7
Ponygon,quelthalas,480,warrior,arms,12,5,7
Thehóund,area-52,480,warrior,arms,12,5,7
Drudw,moon-guard,480,warrior,arms,12,5,7
Cuantascopas,ragnaros,480,warrior,arms,12,5,7
Justicwar,area-52,480,warrior,arms,12,5,7
Zerevik,stormrage,480,warrior,arms,12,5,7
Kethsel,ragnaros,480,warrior,arms,12,5,7
Taürok,azralon,480,warrior,arms,12,5,7
Qwort,moon-guard,480,warrior,arms,12,5,7
Felorelea,moon-guard,480,warrior,arms,12,5,7
Meatspinner,sargeras,480,warrior,arms,12,5,7
Crogosh,quelthalas,480,warrior,arms,12,5,7
Kriegsheer,bleeding-hollow,480,warrior,arms,12,5,7
Fracked,sargeras,480,warrior,arms,12,5,7
Fayttful,area-52,480,warrior,arms,12,5,7
Peters,malfurion,480,warrior,arms,12,5,7
Originalpimp,bleeding-hollow,480,warrior,arms,12,5,7
Quinntis,anvilmar,480,warrior,arms,12,5,7
Biggiesmash,bleeding-hollow,480,warrior,arms,12,5,7
Ericthegreat,azuremyst,480,warrior,arms,12,5,7
Broxar,area-52,480,warrior,arms,12,5,7
Toddlovesu,kelthuzad,480,warrior,arms,12,5,7
Thaedes,kelthuzad,480,warrior,arms,12,5,7
Kð,zuljin,480,warrior,arms,12,5,7
Vãnth,kelthuzad,480,warrior,arms,12,5,7
Kluster,kelthuzad,480,warrior,arms,12,5,7
Beerstorm,stormrage,480,warrior,arms,12,5,7
Metalbiff,bleeding-hollow,480,warrior,arms,12,5,7
Mondëgo,stormrage,480,warrior,arms,12,5,7
Baaltica,ragnaros,480,warrior,arms,12,5,7
Crushingnews,sargeras,480,warrior,arms,12,5,7
Etothed,stormrage,480,warrior,arms,12,5,7
Coltronitis,kelthuzad,480,warrior,arms,12,5,7
Gävilar,sargeras,480,warrior,arms,12,5,7
Mustachelove,bleeding-hollow,480,warrior,arms,12,5,7
Secsecute,moon-guard,480,warrior,arms,12,5,7
Wonbin,moon-guard,480,warrior,arms,12,5,7
Hemkcus,zuluhed,480,warrior,arms,12,5,7
Dillý,area-52,480,warrior,arms,12,5,7
Wcb,sargeras,480,warrior,arms,12,5,7
Nipnipz,kelthuzad,480,warrior,arms,12,5,7
Sylvanos,arthas,480,warrior,arms,12,5,7
Tamajkaz,the-forgotten-coast,480,warrior,arms,12,5,7
Thalfor,emerald-dream,480,warrior,arms,12,5,7
Sideon,frostmourne,480,warrior,arms,12,5,7
Manbok,tichondrius,480,warrior,arms,12,5,7
Conviction,draka,480,warrior,arms,12,5,7
Ccmeharder,kiljaeden,480,warrior,arms,12,5,7
Loveføx,stormrage,480,warrior,arms,12,5,7
Schoolbuhs,tichondrius,480,warrior,arms,12,5,7
Gonzwold,drenden,480,warrior,arms,12,5,7
Takenotez,sargeras,480,warrior,arms,12,5,7
Sabers,mannoroth,480,warrior,arms,12,5,7
Martydom,proudmoore,480,warrior,arms,12,5,7
Buffwar,tichondrius,480,warrior,arms,12,5,7
Excalibruh,frostmourne,480,warrior,arms,12,5,7
Turlesoup,proudmoore,480,warrior,arms,12,5,7
Boxxyy,tichondrius,480,warrior,arms,12,5,7
Mayshowgunmo,tichondrius,480,warrior,arms,12,5,7
Greyknights,kiljaeden,480,warrior,arms,12,5,7
Bloodxfrenzy,silvermoon,480,warrior,arms,12,5,7
Scozziee,barthilas,480,warrior,arms,12,5,7
Astrálís,nemesis,480,warrior,arms,12,5,7
Shapur,tichondrius,480,warrior,arms,12,5,7
Arcâdio,cairne,480,warrior,arms,12,5,7
Maniel,greymane,480,warrior,arms,12,5,7
Lanlorash,barthilas,480,warrior,arms,12,5,7
Azkaosa,tichondrius,480,warrior,arms,12,5,7
Spirìt,illidan,480,warrior,arms,12,5,7
Stattic,illidan,480,warrior,arms,12,5,7
Angertooth,tichondrius,480,warrior,arms,12,5,7
Madhouse,tanaris,480,warrior,arms,12,5,7
Zewl,barthilas,480,warrior,arms,12,5,7
Cabi,frostmourne,480,warrior,arms,12,5,7
Flëët,tichondrius,480,warrior,arms,12,5,7
Bariotyr,the-underbog,480,warrior,arms,12,5,7
Huleo,tichondrius,480,warrior,arms,12,5,7
Empyrius,exodar,480,warrior,arms,12,5,7
Haowar,tichondrius,480,warrior,arms,12,5,7
Shwip,tichondrius,480,warrior,arms,12,5,7
Karik,proudmoore,480,warrior,arms,12,5,7
Orcbum,kiljaeden,480,warrior,arms,12,5,7
Slamoholic,turalyon,480,warrior,arms,12,5,7
Dondà,illidan,480,warrior,arms,12,5,7
Téry,dalaran,480,warrior,arms,12,5,7
Kaikah,aegwynn,480,warrior,arms,12,5,7
Clamjammed,thrall,480,warrior,arms,12,5,7
Kàli,kiljaeden,480,warrior,arms,12,5,7
Ahore,illidan,480,warrior,arms,12,5,7
Antoníuz,drakkari,480,warrior,arms,12,5,7
Lanco,kiljaeden,480,warrior,arms,12,5,7
Igoon,dentarg,480,warrior,arms,12,5,7
Zuiken,kiljaeden,480,warrior,arms,12,5,7
Draenøk,tichondrius,480,warrior,arms,12,5,7
Pandaxes,proudmoore,480,warrior,arms,12,5,7
Brickhouse,tichondrius,480,warrior,arms,12,5,7
Paulhëyman,sargeras,480,warrior,arms,12,5,7
Slasherman,illidan,480,warrior,arms,12,5,7
Shrëkslovaki,tichondrius,480,warrior,arms,12,5,7
Gläedr,dalaran,480,warrior,arms,12,5,7
Battosaì,bonechewer,480,warrior,arms,15,6,9
Grandtank,veknilash,480,warrior,arms,15,6,9
Mág,burning-legion,480,warrior,arms,13,5,8
Siegfriéd,bleeding-hollow,480,warrior,arms,14,5,9
Tigershárk,tichondrius,480,warrior,arms,16,5,11
Imprw,stormrage,480,warrior,arms,18,5,13
Goaco,drakkari,480,warrior,arms,18,5,13
Golinn,aerie-peak,480,warrior,arms,18,5,13
Kamigoroshi,crushridge,480,warrior,arms,18,5,13
Osannd,tichondrius,480,warrior,arms,18,5,13
Skyanidas,korgath,480,warrior,arms,18,5,13
Huacai,tichondrius,480,warrior,arms,18,5,13
Tsathoggua,kiljaeden,480,warrior,arms,18,5,13
Kkuzo,bleeding-hollow,480,warrior,arms,18,5,13
Øvrpwrd,frostmourne,480,warrior,arms,18,5,13
Eightydeuce,bonechewer,480,warrior,arms,18,5,13
Calto,tichondrius,480,warrior,arms,18,5,13
Aldathion,argent-dawn,480,warrior,arms,18,5,13
Shaynaynay,tichondrius,480,warrior,arms,18,5,13
Cyllyzie,emerald-dream,480,warrior,arms,18,5,13
Bornclueless,illidan,480,warrior,arms,21,5,16
Thunderbash,thrall,480,warrior,arms,24,5,19
Lorinzer,zuljin,480,warrior,arms,24,5,19
Tanger,korgath,479,warrior,arms,6,5,1
Rinngo,proudmoore,479,warrior,arms,6,5,1
Faiken,quelthalas,479,warrior,arms,6,5,1
Arrozkonlech,proudmoore,479,warrior,arms,10,6,4
Celt,uldum,479,warrior,arms,12,5,7
Maudlewis,bladefist,479,warrior,arms,12,5,7
Qqmachine,tichondrius,479,warrior,arms,12,5,7
Synestira,frostmourne,479,warrior,arms,12,5,7
Sienge,tortheldrin,479,warrior,arms,12,5,7
Têzeret,shadowmoon,479,warrior,arms,12,5,7
Josiah,frostmourne,479,warrior,arms,12,5,7
Spàcetìme,stormrage,479,warrior,arms,12,5,7
Cueromodel,ragnaros,479,warrior,arms,12,5,7
Loaksz,tichondrius,479,warrior,arms,12,5,7
Alderr,frostmourne,479,warrior,arms,12,5,7
Luneblade,tichondrius,479,warrior,arms,12,5,7
Bovisrex,shadow-council,479,warrior,arms,12,5,7
Azaeil,tanaris,479,warrior,arms,12,5,7
Liiberator,emerald-dream,479,warrior,arms,12,5,7
Rücküs,tichondrius,479,warrior,arms,12,5,7
Baloraj,barthilas,479,warrior,arms,12,5,7
Dirtyrandy,zuluhed,479,warrior,arms,12,5,7
Trufsoturi,bleeding-hollow,479,warrior,arms,12,5,7
Burgdur,sargeras,479,warrior,arms,18,5,13
Flexecute,senjin,479,warrior,arms,18,5,13
Helscreem,hyjal,479,warrior,arms,18,5,13
Gorrthrax,area-52,479,warrior,arms,24,5,19
Arooy,azralon,478,warrior,arms,6,5,1
Bloren,thrall,478,warrior,arms,12,5,7
Dirtywarrior,lightnings-blade,478,warrior,arms,12,5,7
Otyek,proudmoore,478,warrior,arms,12,5,7
Bennybrock,crushridge,478,warrior,arms,12,5,7
Wnunes,nemesis,478,warrior,arms,12,5,7
Tmible,ragnaros,477,warrior,arms,6,5,1
Bratomil,amanthul,476,warrior,arms,12,5,7
Acanof,azjolnerub,474,warrior,arms,9,6,3
Beepboop,malganis,473,warrior,arms,12,5,7
Inuyasha,korgath,473,warrior,arms,12,5,7
Raktrazbirt,dalaran,472,warrior,arms,12,5,7
Danalle,area-52,448,warrior,arms,10,6,4
Turboboy,tichondrius,448,warrior,arms,10,5,5
Mverstappen,azralon,448,warrior,arms,10,5,5
Broxigore,nerzhul,448,warrior,arms,22,5,17
Notcoverage,tichondrius,447,warrior,arms,11,5,6
Dontkiteme,frostmourne,447,warrior,arms,17,5,12
Cyllå,frostmourne,446,warrior,arms,9,6,3
Shotgunzx,tichondrius,432,warrior,arms,9,5,4
Esko,tichondrius,431,warrior,arms,11,5,6
Gurgak,illidan,431,warrior,arms,11,5,6
Jackedaniels,stormrage,431,warrior,arms,12,5,7
Bloodbottle,darkspear,426,warrior,arms,14,7,7
Boombasta,shuhalo,426,warrior,arms,15,6,9
Machutron,quelthalas,415,warrior,arms,8,5,3
Yarocktoo,kelthuzad,415,warrior,arms,8,5,3
Crackersmack,stormrage,415,warrior,arms,11,6,5
Thano,kiljaeden,415,warrior,arms,10,5,5
Nrico,frostmourne,415,warrior,arms,10,5,5
Warrihoe,stormrage,415,warrior,arms,11,5,6
Arroezze,earthen-ring,399,warrior,arms,13,5,8
Koraciá,illidan,399,warrior,arms,13,5,8
Gushyguts,tichondrius,399,warrior,arms,19,5,14
Swingyslammy,area-52,384,warrior,arms,6,4,2
Kahn,andorhal,384,warrior,arms,6,4,2
Gnasty,hyjal,384,warrior,arms,6,4,2
Hipower,lethon,384,warrior,arms,6,4,2
Bütch,stormrage,384,warrior,arms,6,4,2
Titanmax,kelthuzad,384,warrior,arms,6,4,2
Picpay,area-52,384,warrior,arms,6,4,2
Fròthy,emerald-dream,384,warrior,arms,6,4,2
Warcheif,dentarg,384,warrior,arms,6,4,2
Kimbö,quelthalas,384,warrior,arms,6,4,2
Nextquestion,sargeras,384,warrior,arms,6,4,2
Bruisebanner,area-52,384,warrior,arms,6,4,2
Alèx,tichondrius,384,warrior,arms,6,4,2
Hamburgezo,quelthalas,384,warrior,arms,6,4,2
Mòrgo,agamaggan,384,warrior,arms,6,4,2
Tsutsana,lightninghoof,384,warrior,arms,6,4,2
Wariorwang,tichondrius,384,warrior,arms,6,4,2
Neon,wildhammer,384,warrior,arms,6,4,2
Krokü,area-52,384,warrior,arms,6,4,2
Martiallawl,skullcrusher,384,warrior,arms,6,4,2
Odalp,tichondrius,384,warrior,arms,6,4,2
Braxxìnn,tichondrius,384,warrior,arms,6,4,2
Yivicus,sargeras,384,warrior,arms,6,4,2
Mortalhandx,tichondrius,384,warrior,arms,6,4,2
Ayath,hyjal,384,warrior,arms,6,4,2
Swaystko,sargeras,384,warrior,arms,6,4,2
Jersucristö,quelthalas,384,warrior,arms,6,4,2
Jakslasfa,aegwynn,384,warrior,arms,6,4,2
Appolyonn,hyjal,384,warrior,arms,6,4,2
Littlegengar,tichondrius,384,warrior,arms,6,4,2
Restoy,tichondrius,384,warrior,arms,6,4,2
Sokõ,tichondrius,384,warrior,arms,6,4,2
Malgoth,illidan,384,warrior,arms,6,4,2
Yêawen,tichondrius,384,warrior,arms,6,4,2
Blucollardad,bleeding-hollow,384,warrior,arms,6,4,2
Boomtacular,moon-guard,384,warrior,arms,6,4,2
Bajheeraz,tichondrius,384,warrior,arms,6,4,2
Swillzz,illidan,384,warrior,arms,6,4,2
Beleña,dalaran,384,warrior,arms,6,4,2
Thiccyb,area-52,384,warrior,arms,6,4,2
Koalabear,shadow-council,384,warrior,arms,6,4,2
Daddydomtop,moon-guard,384,warrior,arms,6,4,2
Bailo,dathremar,384,warrior,arms,6,4,2
Afelhia,moon-guard,384,warrior,arms,6,4,2
Sayuri,frostmourne,384,warrior,arms,6,4,2
Ckoaw,dalaran,384,warrior,arms,6,4,2
Hitwkey,tichondrius,384,warrior,arms,6,4,2
Evergardens,saurfang,384,warrior,arms,6,4,2
Tickej,dragonmaw,384,warrior,arms,6,4,2
Còlòssal,moknathal,384,warrior,arms,6,4,2
Swordfighter,moon-guard,384,warrior,arms,6,4,2
Rinima,tichondrius,384,warrior,arms,6,4,2
Evencane,stormrage,384,warrior,arms,6,4,2
Potalot,draenor,384,warrior,arms,6,4,2
Thottprot,blackhand,384,warrior,arms,6,4,2
Gurneyhalec,proudmoore,384,warrior,arms,6,4,2
Sonoflaw,skullcrusher,384,warrior,arms,6,4,2
Zarttorius,quelthalas,384,warrior,arms,6,4,2
Brrazze,moon-guard,384,warrior,arms,6,4,2
Rõcky,frostmourne,384,warrior,arms,6,4,2
Dysazter,ravencrest,384,warrior,arms,6,4,2
Cheshe,area-52,384,warrior,arms,6,4,2
Sygurd,drakkari,384,warrior,arms,6,4,2
Termana,azjolnerub,384,warrior,arms,6,4,2
Pilgrimslays,tichondrius,384,warrior,arms,6,4,2
Skorgebt,thrall,384,warrior,arms,6,4,2
Zoldyak,ragnaros,384,warrior,arms,6,4,2
Hordrek,moon-guard,384,warrior,arms,6,4,2
Zuggernaut,shadowsong,384,warrior,arms,6,4,2
Sparts,area-52,384,warrior,arms,6,4,2
Mommystrasza,kelthuzad,384,warrior,arms,6,4,2
Murrderrface,azgalor,384,warrior,arms,6,4,2
Gomachi,moon-guard,384,warrior,arms,6,4,2
Keffdog,laughing-skull,384,warrior,arms,6,4,2
Slapywar,illidan,384,warrior,arms,6,4,2
Pineapplezz,kelthuzad,384,warrior,arms,6,4,2
Ziggeraut,cenarion-circle,384,warrior,arms,6,4,2
Míaguiulfo,ragnaros,384,warrior,arms,6,4,2
Irascible,stormrage,384,warrior,arms,6,4,2
Kufflinks,kelthuzad,384,warrior,arms,6,4,2
Elbelgon,ragnaros,384,warrior,arms,6,4,2
Trevmo,bloodscalp,384,warrior,arms,6,4,2
Hamur,azralon,384,warrior,arms,6,4,2
Fernzie,malganis,384,warrior,arms,6,4,2
Fancysin,malganis,384,warrior,arms,6,4,2
Mfgodofwar,kelthuzad,384,warrior,arms,6,4,2
Dazfury,barthilas,384,warrior,arms,6,4,2
Aægekaz,proudmoore,384,warrior,arms,6,4,2
Gangdan,sargeras,384,warrior,arms,6,4,2
Sakuraya,tichondrius,384,warrior,arms,6,4,2
Ragingboner,aggramar,384,warrior,arms,6,4,2
Helder,destromath,384,warrior,arms,6,4,2
Gamörä,illidan,384,warrior,arms,6,4,2
Misticstorm,barthilas,384,warrior,arms,6,4,2
Styiex,ragnaros,384,warrior,arms,6,4,2
Diesel,duskwood,384,warrior,arms,6,4,2
Bajheeraz,sargeras,384,warrior,arms,6,4,2
Frakt,illidan,384,warrior,arms,6,4,2
Veedrin,ysera,384,warrior,arms,6,4,2
Gozugurself,barthilas,384,warrior,arms,6,4,2
Takitó,ragnaros,384,warrior,arms,6,4,2
Ummso,nerzhul,384,warrior,arms,6,4,2
Airhood,frostmourne,384,warrior,arms,6,4,2
Killaen,thrall,384,warrior,arms,6,4,2
Amérus,moon-guard,384,warrior,arms,6,4,2
Oddyseey,moon-guard,384,warrior,arms,6,4,2
Jire,shadowmoon,384,warrior,arms,7,4,3
Greenishfox,illidan,384,warrior,arms,9,5,4
Ragnarlbrok,goldrinn,384,warrior,arms,10,5,5
Kalisandra,undermine,384,warrior,arms,10,5,5
Ailes,hakkar,384,warrior,arms,11,4,7
Flabergaster,skullcrusher,384,warrior,arms,12,4,8
Meanface,malganis,384,warrior,arms,12,4,8
Tinydingo,sargeras,384,warrior,arms,12,4,8
Warriormikey,tichondrius,384,warrior,arms,12,4,8
Xdorkie,area-52,384,warrior,arms,12,4,8
Twoshoutz,stormrage,384,warrior,arms,12,4,8
Gnizzmo,sargeras,384,warrior,arms,12,4,8
Doully,proudmoore,384,warrior,arms,12,4,8
Durango,duskwood,384,warrior,arms,12,4,8
Chongos,malganis,384,warrior,arms,12,4,8
Grullhamer,ragnaros,384,warrior,arms,12,4,8
Estrasystole,sargeras,384,warrior,arms,12,4,8
Turkin,proudmoore,384,warrior,arms,12,4,8
Drewpqawk,tichondrius,384,warrior,arms,12,4,8
Sandrine,fizzcrank,384,warrior,arms,12,4,8
Mikejustice,kelthuzad,384,warrior,arms,12,4,8
Beifong,barthilas,384,warrior,arms,12,4,8
Cupper,tichondrius,384,warrior,arms,12,4,8
Warmachined,grizzly-hills,384,warrior,arms,12,4,8
Palumorw,deathwing,384,warrior,arms,12,4,8
Flexyx,arthas,384,warrior,arms,12,4,8
Nginx,queldorei,384,warrior,arms,12,4,8
Angrybrog,malfurion,384,warrior,arms,12,4,8
Raokao,senjin,384,warrior,arms,12,4,8
Kenedy,moon-guard,384,warrior,arms,12,4,8
Joekenshield,stonemaul,384,warrior,arms,12,4,8
Iden,vashj,384,warrior,arms,12,4,8
Runningatyou,area-52,384,warrior,arms,12,4,8
Redrumman,demon-soul,384,warrior,arms,12,4,8
Nxmabala,proudmoore,384,warrior,arms,12,4,8
Ladderx,area-52,384,warrior,arms,12,4,8
Amaus,queldorei,384,warrior,arms,12,4,8
Exist,kaelthas,384,warrior,arms,12,4,8
Guyllol,barthilas,384,warrior,arms,12,4,8
Yamato,skywall,384,warrior,arms,12,4,8
Grândmâ,zuljin,384,warrior,arms,12,4,8
Furyofrage,dalaran,384,warrior,arms,12,4,8
Iridikron,dalaran,384,warrior,arms,12,4,8
Dámöuse,stormrage,384,warrior,arms,12,4,8
Lui,the-forgotten-coast,384,warrior,arms,12,4,8
Handikap,stormrage,384,warrior,arms,12,4,8
Còsmico,trollbane,384,warrior,arms,12,4,8
Brendan,llane,384,warrior,arms,12,4,8
Warspartan,stormrage,384,warrior,arms,12,4,8
Iargestpp,bleeding-hollow,384,warrior,arms,12,4,8
Swingú,illidan,384,warrior,arms,12,4,8
Aldaøm,ragnaros,384,warrior,arms,12,4,8
Burstmacro,garrosh,384,warrior,arms,12,4,8
Heliza,ragnaros,384,warrior,arms,12,4,8
Draiken,dalaran,384,warrior,arms,12,4,8
Bewbeebangz,kelthuzad,384,warrior,arms,12,4,8
Barrocops,kiljaeden,384,warrior,arms,12,4,8
Snack,stormreaver,384,warrior,arms,12,4,8
Hameey,sargeras,384,warrior,arms,12,4,8
Moseshrute,zuljin,384,warrior,arms,12,4,8
Mefus,wyrmrest-accord,384,warrior,arms,12,4,8
Fortchin,area-52,384,warrior,arms,12,4,8
Renclave,wyrmrest-accord,384,warrior,arms,12,4,8
Nänchobo,tichondrius,384,warrior,arms,12,4,8
Augutra,moon-guard,384,warrior,arms,12,4,8
Ballsy,fenris,384,warrior,arms,12,4,8
Daduké,stormrage,384,warrior,arms,12,4,8
Koei,illidan,384,warrior,arms,12,4,8
Tappyc,tichondrius,384,warrior,arms,12,4,8
Hârambe,kiljaeden,384,warrior,arms,12,4,8
Sonicboom,whisperwind,384,warrior,arms,12,4,8
Licona,wyrmrest-accord,384,warrior,arms,12,4,8
Fatherkelso,tichondrius,384,warrior,arms,12,4,8
Naelynh,quelthalas,384,warrior,arms,12,4,8
Rocketbom,tichondrius,384,warrior,arms,12,4,8
Laokan,illidan,384,warrior,arms,12,4,8
Bigboy,icecrown,384,warrior,arms,12,4,8
Lørdvingådør,azralon,384,warrior,arms,12,4,8
Totenhammer,nathrezim,384,warrior,arms,12,4,8
Tharsìs,emerald-dream,384,warrior,arms,12,4,8
Verrynasty,area-52,384,warrior,arms,12,4,8
Xårren,stormrage,384,warrior,arms,12,4,8
Magmaheart,lightbringer,384,warrior,arms,12,4,8
Izhansheni,illidan,384,warrior,arms,12,4,8
Mindgoblin,bleeding-hollow,384,warrior,arms,12,4,8
Dessindir,quelthalas,384,warrior,arms,12,4,8
Stewwar,wyrmrest-accord,384,warrior,arms,12,4,8
Zugface,tichondrius,384,warrior,arms,12,4,8
Jasonsdady,illidan,384,warrior,arms,12,4,8
Skunkz,kelthuzad,384,warrior,arms,12,4,8
Porchorc,hyjal,384,warrior,arms,12,4,8
Crimsóñ,kelthuzad,384,warrior,arms,12,4,8
Narduk,emerald-dream,384,warrior,arms,12,4,8
Hamslamm,area-52,384,warrior,arms,12,4,8
Jaclksparrow,azralon,384,warrior,arms,12,4,8
Filth,tichondrius,384,warrior,arms,12,4,8
Metalhit,tichondrius,384,warrior,arms,12,4,8
Lundyswung,silver-hand,384,warrior,arms,12,4,8
Shínkicker,area-52,384,warrior,arms,12,4,8
Jathellum,stormrage,384,warrior,arms,12,4,8
Gazah,skullcrusher,384,warrior,arms,12,4,8
Gangaa,barthilas,384,warrior,arms,12,4,8
Bondadoso,stormrage,384,warrior,arms,13,4,9
Varkery,sargeras,384,warrior,arms,13,4,9
Kyres,moon-guard,384,warrior,arms,16,4,12
Cowsgomerr,tichondrius,384,warrior,arms,18,4,14
Bêelzebub,aerie-peak,384,warrior,arms,18,4,14
Asphyxiating,illidan,384,warrior,arms,18,4,14
Retiarius,tichondrius,384,warrior,arms,18,4,14
Draxxarlol,zuljin,384,warrior,arms,18,4,14
Noppô,tichondrius,384,warrior,arms,18,4,14
Dulapamore,tichondrius,384,warrior,arms,18,4,14
Gladicus,zuljin,384,warrior,arms,18,4,14
Yeit,tichondrius,383,warrior,arms,6,4,2
Ezaxe,tichondrius,383,warrior,arms,6,4,2
Chisum,gnomeregan,383,warrior,arms,6,4,2
Orcrist,stormreaver,383,warrior,arms,6,4,2
Shìromìzù,eredar,383,warrior,arms,6,4,2
Tookbeki,tichondrius,383,warrior,arms,6,4,2
Shabus,moon-guard,383,warrior,arms,12,4,8
Spitbeard,kargath,383,warrior,arms,12,4,8
Ajamu,aegwynn,383,warrior,arms,12,4,8
Svênd,ragnaros,383,warrior,arms,12,4,8
Kâyous,tichondrius,383,warrior,arms,12,4,8
Christellà,dalaran,383,warrior,arms,18,4,14
Blockcheese,illidan,383,warrior,arms,18,4,14
Såmmÿ,moon-guard,379,warrior,arms,12,4,8
Handdok,runetotem,379,warrior,arms,12,4,8
Dingoe,wyrmrest-accord,379,warrior,arms,12,4,8
Lightstrikes,sargeras,379,warrior,arms,12,4,8
Loomine,illidan,367,warrior,arms,11,4,7
Ayuko,greymane,367,warrior,arms,11,4,7
Warsins,bonechewer,367,warrior,arms,17,4,13
Tecnowar,quelthalas,352,warrior,arms,10,4,6
Bellonar,stormrage,351,warrior,arms,8,5,3
Thøros,moon-guard,351,warrior,arms,11,4,7
Vaetren,area-52,351,warrior,arms,11,4,7
Förkz,ragnaros,351,warrior,arms,11,4,7
Matasimio,drakkari,336,warrior,arms,9,4,5
Toir,bladefist,335,warrior,arms,11,4,7
Caynos,stormrage,335,warrior,arms,11,4,7
Ashrah,emerald-dream,330,warrior,arms,9,5,4
Rubbers,thrall,330,warrior,arms,17,6,11
Macray,zuljin,330,warrior,arms,18,5,13
Mnoga,azralon,330,warrior,arms,22,5,17
Machatlan,stormrage,324,warrior,arms,16,7,9
Slashcry,frostmourne,320,warrior,arms,10,4,6
Lildumptruck,emerald-dream,320,warrior,arms,10,4,6
Painstake,illidan,320,warrior,arms,19,5,14
Toetoeto,darrowmere,319,warrior,arms,5,4,1
Skollton,tichondrius,319,warrior,arms,5,4,1
Rauwers,azralon,319,warrior,arms,8,4,4
Armada,sargeras,319,warrior,arms,8,4,4
Cptdrako,alterac-mountains,319,warrior,arms,8,4,4
Knewty,stormrage,319,warrior,arms,8,4,4
Aerriz,area-52,319,warrior,arms,11,4,7
Edmaghar,ragnaros,319,warrior,arms,14,4,10
Kleavage,korgath,304,warrior,arms,13,4,9
Rezhan,area-52,304,warrior,arms,13,4,9
Syradar,ragnaros,304,warrior,arms,13,4,9
Nicolasrage,trollbane,303,warrior,arms,11,5,6
Faywarsong,area-52,288,warrior,arms,6,3,3
Larosfan,tichondrius,288,warrior,arms,6,3,3
Dronarmus,ragnaros,288,warrior,arms,6,3,3
Hanginaround,zuluhed,288,warrior,arms,6,3,3
Yasser,ragnaros,288,warrior,arms,6,3,3
Desertor,illidan,288,warrior,arms,6,3,3
Rockybâlboa,illidan,288,warrior,arms,6,3,3
Largegayman,sargeras,288,warrior,arms,6,3,3
Glowstick,tichondrius,288,warrior,arms,6,3,3
Seymourbot,illidan,288,warrior,arms,6,3,3
Wqnmlgbd,tichondrius,288,warrior,arms,6,3,3
Axeslaps,illidan,288,warrior,arms,6,3,3
Rankjuan,area-52,288,warrior,arms,6,3,3
Davien,tichondrius,288,warrior,arms,6,3,3
Ragemelon,icecrown,288,warrior,arms,6,3,3
Alondir,quelthalas,288,warrior,arms,6,3,3
Rockhardt,tichondrius,288,warrior,arms,6,3,3
Poppacd,stormrage,288,warrior,arms,6,3,3
Ragelol,icecrown,288,warrior,arms,6,3,3
Robio,tichondrius,288,warrior,arms,6,3,3
Kénblock,tichondrius,288,warrior,arms,6,3,3
Fivewarrior,tichondrius,288,warrior,arms,6,3,3
Corrum,shuhalo,288,warrior,arms,6,3,3
Akilosh,illidan,288,warrior,arms,6,3,3
Exdilla,zuljin,288,warrior,arms,6,3,3
Bachyr,stormrage,288,warrior,arms,6,3,3
Ghomory,quelthalas,288,warrior,arms,6,3,3
Nukehazard,bleeding-hollow,288,warrior,arms,6,3,3
Pezek,thrall,288,warrior,arms,6,3,3
Notawar,stormrage,288,warrior,arms,6,3,3
Shiromiya,tichondrius,288,warrior,arms,6,3,3
Brayven,area-52,288,warrior,arms,6,3,3
Consolidate,hyjal,288,warrior,arms,6,3,3
Drugdilla,zuljin,288,warrior,arms,6,3,3
Asäel,ragnaros,288,warrior,arms,6,3,3
Jerveen,quelthalas,288,warrior,arms,6,3,3
Dazuu,illidan,288,warrior,arms,6,3,3
Swifty,tichondrius,288,warrior,arms,6,3,3
Zenmore,illidan,288,warrior,arms,6,3,3
Robostergler,tichondrius,288,warrior,arms,6,3,3
Allmotor,zuljin,288,warrior,arms,6,3,3
Tiitlefight,bleeding-hollow,288,warrior,arms,6,3,3
Reishera,stormrage,288,warrior,arms,6,3,3
Spartanfury,tichondrius,288,warrior,arms,6,3,3
Vnw,illidan,288,warrior,arms,6,3,3
Fyle,stormrage,288,warrior,arms,6,3,3
Grapegush,bleeding-hollow,288,warrior,arms,6,3,3
Jabakas,tichondrius,288,warrior,arms,6,3,3
Toragorr,illidan,288,warrior,arms,6,3,3
Hitmypronoun,illidan,288,warrior,arms,6,3,3
Warbreaker,stormrage,288,warrior,arms,6,3,3
Serindel,quelthalas,288,warrior,arms,6,3,3
Orkwar,tichondrius,288,warrior,arms,6,3,3
Milbën,tichondrius,288,warrior,arms,6,3,3
Dunsker,stormrage,288,warrior,arms,6,3,3
Caalypso,stormrage,288,warrior,arms,6,3,3
Scottpilgrim,illidan,288,warrior,arms,6,3,3
Wrèckingball,tichondrius,288,warrior,arms,6,3,3
Pummels,area-52,288,warrior,arms,6,3,3
Cryptex,illidan,288,warrior,arms,6,3,3
Idarkshakra,illidan,288,warrior,arms,6,3,3
Ichigami,kelthuzad,288,warrior,arms,6,3,3
Udmwarrior,zuljin,288,warrior,arms,6,3,3
Huffzo,tichondrius,288,warrior,arms,6,3,3
Humanlog,illidan,288,warrior,arms,6,3,3
Zåzriel,tichondrius,288,warrior,arms,6,3,3
Críxus,sargeras,288,warrior,arms,6,3,3
Kuntahkintah,tichondrius,288,warrior,arms,6,3,3
Qutuz,illidan,288,warrior,arms,6,3,3
Hukzula,illidan,288,warrior,arms,6,3,3
Sambojüjü,stormrage,288,warrior,arms,6,3,3
Drakr,ragnaros,288,warrior,arms,6,3,3
Wingnut,zuluhed,288,warrior,arms,6,3,3
Bigshett,sargeras,288,warrior,arms,6,3,3
Warnuk,lightnings-blade,288,warrior,arms,6,3,3
Exequet,tichondrius,288,warrior,arms,6,3,3
Jutank,sargeras,288,warrior,arms,6,3,3
Assmut,stormrage,288,warrior,arms,6,3,3
Tnytank,burning-legion,288,warrior,arms,6,3,3
Mortaryon,malganis,288,warrior,arms,6,3,3
Zemi,sargeras,288,warrior,arms,6,3,3
Szar,stormrage,288,warrior,arms,6,3,3
Finndal,bleeding-hollow,288,warrior,arms,6,3,3
Yenør,stormrage,288,warrior,arms,6,3,3
Gypsypsycho,stormrage,288,warrior,arms,6,3,3
Swizzly,tichondrius,288,warrior,arms,6,3,3
Dublinn,llane,288,warrior,arms,6,3,3
Hìtchslap,tichondrius,288,warrior,arms,6,3,3
Clerond,tichondrius,288,warrior,arms,6,3,3
Noteko,tichondrius,288,warrior,arms,6,3,3
Evôlutiôn,kelthuzad,288,warrior,arms,6,3,3
Fakktwo,blackhand,288,warrior,arms,6,3,3
Daedrion,dalaran,288,warrior,arms,6,3,3
Zulataza,zuljin,288,warrior,arms,6,3,3
Magthor,warsong,288,warrior,arms,6,3,3
Topee,area-52,288,warrior,arms,6,3,3
Solembuumm,illidan,288,warrior,arms,6,3,3
Imperiial,stormrage,288,warrior,arms,6,3,3
Schlosh,laughing-skull,288,warrior,arms,6,3,3
Thunderess,illidan,288,warrior,arms,6,3,3
Éten,drakkari,288,warrior,arms,6,3,3
Mandofl,ragnaros,288,warrior,arms,6,3,3
Kokurawr,burning-legion,288,warrior,arms,6,3,3
Êraser,tichondrius,288,warrior,arms,6,3,3
Renning,malganis,288,warrior,arms,6,3,3
Claphub,malganis,288,warrior,arms,6,3,3
Smashndspin,sargeras,288,warrior,arms,6,3,3
Richenbach,kelthuzad,288,warrior,arms,6,3,3
Warreeper,area-52,288,warrior,arms,6,3,3
Rageroidz,sargeras,288,warrior,arms,6,3,3
Krïtzkreig,the-forgotten-coast,288,warrior,arms,6,3,3
Jackanape,sargeras,288,warrior,arms,6,3,3
Philipjoo,illidan,288,warrior,arms,6,3,3
Akhinoz,area-52,288,warrior,arms,6,3,3
Hungdiesel,area-52,288,warrior,arms,6,3,3
Zebel,tichondrius,288,warrior,arms,6,3,3
Tenderturtle,tichondrius,288,warrior,arms,6,3,3
Oxxelfer,tichondrius,288,warrior,arms,6,3,3
Hesch,thunderlord,288,warrior,arms,6,3,3
Ellx,sargeras,288,warrior,arms,6,3,3
Sunhands,emerald-dream,288,warrior,arms,6,3,3
Skullsplittr,illidan,288,warrior,arms,6,3,3
Grognäk,malganis,288,warrior,arms,6,3,3
Vistacleave,maiev,288,warrior,arms,6,3,3
Ambevsgunnar,tichondrius,288,warrior,arms,6,3,3
Runtasticx,tichondrius,288,warrior,arms,6,3,3
Najarath,barthilas,288,warrior,arms,6,3,3
Tothepain,thrall,288,warrior,arms,6,3,3
Duglug,malganis,288,warrior,arms,6,3,3
Bëowulf,malganis,288,warrior,arms,6,3,3
Temperament,area-52,288,warrior,arms,6,3,3
Deadlypsycho,moonrunner,288,warrior,arms,6,3,3
Polox,ragnaros,288,warrior,arms,6,3,3
Salveknight,ragnaros,288,warrior,arms,6,3,3
Zugmeov,barthilas,288,warrior,arms,6,3,3
Zugsok,thrall,288,warrior,arms,6,3,3
Uzy,proudmoore,288,warrior,arms,6,3,3
Tomcruizes,tichondrius,288,warrior,arms,6,3,3
Hopefulki,duskwood,288,warrior,arms,6,3,3
Outterspace,illidan,288,warrior,arms,6,3,3
Zibby,malganis,288,warrior,arms,6,3,3
Cabelas,tichondrius,288,warrior,arms,6,3,3
Exiledwarz,area-52,288,warrior,arms,6,3,3
Rezorc,stormrage,288,warrior,arms,6,3,3
Cheekclapps,tichondrius,288,warrior,arms,6,3,3
Tragictonka,stormrage,288,warrior,arms,6,3,3
Actio,stormrage,288,warrior,arms,6,3,3
Valför,ysera,288,warrior,arms,6,3,3
Aggor,trollbane,288,warrior,arms,6,3,3
Guille,skullcrusher,288,warrior,arms,6,3,3
Leonidas,barthilas,288,warrior,arms,6,3,3
Unhealbedam,area-52,288,warrior,arms,6,3,3
Iwishiknew,kargath,288,warrior,arms,6,3,3
Zeroaxx,ragnaros,288,warrior,arms,6,3,3
Nazakeen,tichondrius,288,warrior,arms,6,3,3
Biggieswords,madoran,288,warrior,arms,6,3,3
Skaaxx,barthilas,288,warrior,arms,6,3,3
Executing,emerald-dream,288,warrior,arms,6,3,3
Reckonting,moon-guard,288,warrior,arms,6,3,3
Shloope,barthilas,288,warrior,arms,6,3,3
Demetrïus,moon-guard,288,warrior,arms,6,3,3
Onisusu,frostmourne,288,warrior,arms,6,3,3
Elix,stormscale,288,warrior,arms,6,3,3
Retrô,uldum,288,warrior,arms,6,3,3
Batchat,frostmourne,288,warrior,arms,6,3,3
Tread,mugthol,288,warrior,arms,6,3,3
Smokezee,barthilas,288,warrior,arms,6,3,3
Fatalsfury,tichondrius,288,warrior,arms,6,3,3
Tôpanga,lightninghoof,288,warrior,arms,6,3,3
Ymìr,moon-guard,288,warrior,arms,6,3,3
Sweetmojito,vashj,288,warrior,arms,6,3,3
Mcrîb,stormscale,288,warrior,arms,6,3,3
Faelzerá,azralon,288,warrior,arms,6,3,3
Smash,frostmane,288,warrior,arms,6,3,3
Az,malorne,288,warrior,arms,6,3,3
Mewpaw,azralon,288,warrior,arms,6,3,3
Trashman,frostwolf,288,warrior,arms,6,3,3
Wulfgarn,frostwolf,288,warrior,arms,6,3,3
Småckêd,sargeras,288,warrior,arms,6,3,3
Leeth,azralon,288,warrior,arms,6,3,3
Doubleturbo,illidan,288,warrior,arms,6,3,3
Preceptron,azralon,288,warrior,arms,6,3,3
Prontera,illidan,288,warrior,arms,6,3,3
Saelaa,azralon,288,warrior,arms,6,3,3
Titanor,illidan,288,warrior,arms,6,3,3
Telynne,frostmourne,288,warrior,arms,6,3,3
Miarisa,moon-guard,288,warrior,arms,6,3,3
Hawkior,moon-guard,288,warrior,arms,6,3,3
Elessarr,moon-guard,288,warrior,arms,6,3,3
Warnazx,azralon,288,warrior,arms,6,3,3
Aalrua,moon-guard,288,warrior,arms,6,3,3
Gorkrog,frostmourne,288,warrior,arms,6,3,3
Readytoflee,moon-guard,288,warrior,arms,6,3,3
Valperion,frostmourne,288,warrior,arms,6,3,3
Kushe,moon-guard,288,warrior,arms,6,3,3
Fregory,moon-guard,288,warrior,arms,6,3,3
Finnagnome,sargeras,288,warrior,arms,6,3,3
Sauceslinga,frostmourne,288,warrior,arms,6,3,3
Awöl,jubeithos,288,warrior,arms,6,3,3
Mittyroar,khazgoroth,288,warrior,arms,6,3,3
Rendron,frostmourne,288,warrior,arms,6,3,3
Tinylimbs,frostmourne,288,warrior,arms,6,3,3
Nebraskapete,wyrmrest-accord,288,warrior,arms,6,3,3
Fumzxy,frostmourne,288,warrior,arms,6,3,3
Dolph,sargeras,288,warrior,arms,6,3,3
Scanlan,dalvengyr,288,warrior,arms,6,3,3
Benieswar,frostmourne,288,warrior,arms,6,3,3
Edokthong,frostmourne,288,warrior,arms,6,3,3
Trackhawk,moon-guard,288,warrior,arms,6,3,3
Ðuffman,jubeithos,288,warrior,arms,6,3,3
Kryptïç,moon-guard,288,warrior,arms,6,3,3
Mikero,terenas,288,warrior,arms,6,3,3
Liltotey,frostmourne,288,warrior,arms,6,3,3
Vinetic,kiljaeden,288,warrior,arms,6,3,3
Osselan,moon-guard,288,warrior,arms,6,3,3
Poonoxo,gundrak,288,warrior,arms,6,3,3
Capo,windrunner,288,warrior,arms,6,3,3
Carborr,frostmourne,288,warrior,arms,6,3,3
Ei,darrowmere,288,warrior,arms,6,3,3
Metaphoric,stormrage,288,warrior,arms,9,4,5
Maldre,stormrage,288,warrior,arms,9,4,5
Rageslayer,area-52,288,warrior,arms,9,4,5
Oledcktwist,garrosh,288,warrior,arms,7,3,4
Kwelve,proudmoore,288,warrior,arms,7,3,4
Ohdang,dark-iron,288,warrior,arms,8,3,5
Ennia,azralon,288,warrior,arms,9,3,6
Shewar,ragnaros,288,warrior,arms,9,3,6
Akil,ragnaros,288,warrior,arms,15,4,11
Wxxz,tichondrius,288,warrior,arms,12,3,9
Hrl,tichondrius,288,warrior,arms,12,3,9
Kaggorax,tichondrius,288,warrior,arms,12,3,9
Émerald,kilrogg,288,warrior,arms,12,3,9
Zaeyr,tichondrius,288,warrior,arms,12,3,9
Gosariw,tichondrius,288,warrior,arms,12,3,9
Dablao,tichondrius,288,warrior,arms,12,3,9
Gorrock,dreadmaul,288,warrior,arms,12,3,9
Ulamøg,proudmoore,288,warrior,arms,12,3,9
Melancalli,thorium-brotherhood,288,warrior,arms,12,3,9
Ledezma,proudmoore,288,warrior,arms,12,3,9
Mesw,illidan,288,warrior,arms,12,3,9
Staticego,dalaran,288,warrior,arms,12,3,9
Extremist,nagrand,288,warrior,arms,12,3,9
Lowdopamine,tichondrius,288,warrior,arms,12,3,9
Neltar,nagrand,288,warrior,arms,12,3,9
Kirikash,illidan,288,warrior,arms,12,3,9
Porori,proudmoore,288,warrior,arms,12,3,9
Scrubzwarr,barthilas,288,warrior,arms,12,3,9
Kintownhero,aegwynn,288,warrior,arms,12,3,9
Fupatwo,moon-guard,288,warrior,arms,12,3,9
Kigo,azralon,288,warrior,arms,12,3,9
Aræn,sargeras,288,warrior,arms,12,3,9
Basingsei,area-52,288,warrior,arms,12,3,9
Nightwing,bleeding-hollow,288,warrior,arms,12,3,9
Minnysota,area-52,288,warrior,arms,12,3,9
Roadpig,zuljin,288,warrior,arms,12,3,9
Aralla,area-52,288,warrior,arms,12,3,9
Snippy,garona,288,warrior,arms,12,3,9
Doomr,tichondrius,288,warrior,arms,12,3,9
Phargo,korgath,288,warrior,arms,12,3,9
Chardz,ragnaros,288,warrior,arms,12,3,9
Wasabiz,tichondrius,288,warrior,arms,12,3,9
Valestrike,moon-guard,288,warrior,arms,12,3,9
Mansin,tichondrius,288,warrior,arms,12,3,9
Bjjorm,malganis,288,warrior,arms,12,3,9
Kero,malganis,288,warrior,arms,12,3,9
Legnar,malganis,288,warrior,arms,12,3,9
Ggéz,stormrage,288,warrior,arms,12,3,9
Erzawälkër,quelthalas,288,warrior,arms,12,3,9
Alliancerulz,darrowmere,288,warrior,arms,12,3,9
Greenmachine,twisting-nether,288,warrior,arms,12,3,9
Äisemberg,quelthalas,288,warrior,arms,12,3,9
Guerreraa,ragnaros,288,warrior,arms,12,3,9
Smallraccoon,tichondrius,288,warrior,arms,12,3,9
Gnomas,destromath,288,warrior,arms,12,3,9
Grimthad,emerald-dream,288,warrior,arms,12,3,9
Sabini,nemesis,288,warrior,arms,12,3,9
Aztecvil,drakkari,288,warrior,arms,12,3,9
Kregnar,gundrak,288,warrior,arms,12,3,9
Darthfaith,azgalor,288,warrior,arms,12,3,9
Ichil,azshara,288,warrior,arms,12,3,9
Glamen,alleria,288,warrior,arms,12,3,9
Xdragonfirex,terenas,288,warrior,arms,12,3,9
Brütalize,wyrmrest-accord,288,warrior,arms,12,3,9
Morgithia,suramar,288,warrior,arms,12,3,9
Ammeh,draka,288,warrior,arms,12,3,9
Creannew,drakkari,288,warrior,arms,12,3,9
Enulimen,daggerspine,288,warrior,arms,12,3,9
Smashyu,fenris,288,warrior,arms,12,3,9
Kiillwar,smolderthorn,288,warrior,arms,12,3,9
Slamspam,the-underbog,288,warrior,arms,13,3,10
Khallell,illidan,288,warrior,arms,18,3,15
Drdrip,shuhalo,288,warrior,arms,18,3,15
Mathilan,moon-guard,288,warrior,arms,18,3,15
Macbride,blackrock,288,warrior,arms,24,3,21
Aiforix,gorefiend,287,warrior,arms,6,3,3
Yomaaln,blackrock,287,warrior,arms,6,3,3
Smashthings,area-52,287,warrior,arms,6,3,3
Magtharas,dunemaul,287,warrior,arms,6,3,3
Saintgeorge,thorium-brotherhood,287,warrior,arms,6,3,3
Angryskeever,garona,287,warrior,arms,12,3,9
Leosax,drakthul,287,warrior,arms,12,3,9
Brutekush,barthilas,287,warrior,arms,12,3,9
Clayske,gurubashi,287,warrior,arms,12,3,9
Dekromm,tol-barad,287,warrior,arms,12,3,9
Borgosa,wyrmrest-accord,287,warrior,arms,18,3,15
Hruum,moknathal,286,warrior,arms,6,3,3
Dazanor,moon-guard,271,warrior,arms,11,3,8
Nooy,blackrock,271,warrior,arms,17,3,14
Thorsën,sargeras,256,warrior,arms,8,4,4
Tánktop,sargeras,255,warrior,arms,8,4,4
Spicywagyu,tichondrius,255,warrior,arms,11,3,8
Nècroxious,hellscream,255,warrior,arms,11,3,8
Kholusia,kul-tiras,239,warrior,arms,5,3,2
Hakén,tichondrius,239,warrior,arms,5,3,2
Kalphok,tichondrius,239,warrior,arms,5,3,2
Busyguyw,kiljaeden,239,warrior,arms,5,3,2
Jÿp,tichondrius,239,warrior,arms,5,3,2
Likearock,thrall,239,warrior,arms,5,3,2
Omicripto,tichondrius,239,warrior,arms,5,3,2
ßlitzxkreig,tichondrius,239,warrior,arms,5,3,2
Baultenaz,draenor,239,warrior,arms,5,3,2
Hugewarrior,area-52,234,warrior,arms,9,4,5
Benchpress,bleeding-hollow,223,warrior,arms,8,3,5
Nayaqt,tichondrius,223,warrior,arms,8,3,5
Snikkles,frostmourne,223,warrior,arms,8,3,5
Condemnd,area-52,207,warrior,arms,8,3,5
Stickystorm,proudmoore,192,warrior,arms,4,3,1
Elyn,tichondrius,192,warrior,arms,4,3,1
Wonderjack,akama,192,warrior,arms,4,3,1
Berru,bleeding-hollow,192,warrior,arms,9,3,6
Arianarkw,sargeras,192,warrior,arms,9,3,6
Cugino,tichondrius,192,warrior,arms,9,3,6
Àyo,frostmourne,192,warrior,arms,6,2,4
Kostikk,tichondrius,192,warrior,arms,6,2,4
Flyaf,illidan,192,warrior,arms,6,2,4
Helminth,kirin-tor,192,warrior,arms,6,2,4
Düde,whisperwind,192,warrior,arms,6,2,4
Flakesskillz,darkspear,192,warrior,arms,6,2,4
Bearlornan,frostmourne,192,warrior,arms,6,2,4
Avansys,tichondrius,192,warrior,arms,6,2,4
Frankal,aegwynn,192,warrior,arms,6,2,4
Uldrath,hyjal,192,warrior,arms,6,2,4
Berario,garrosh,192,warrior,arms,6,2,4
Mututu,frostmourne,192,warrior,arms,6,2,4
Focalabbys,illidan,192,warrior,arms,6,2,4
Trigon,chromaggus,192,warrior,arms,6,2,4
Anabolicjim,frostmourne,192,warrior,arms,6,2,4
Kreits,drakkari,192,warrior,arms,6,2,4
Kvoth,bleeding-hollow,192,warrior,arms,6,2,4
Eleenoor,drakkari,192,warrior,arms,6,2,4
Endlesskilla,destromath,192,warrior,arms,6,2,4
Superbest,tichondrius,192,warrior,arms,6,2,4
Rendus,hyjal,192,warrior,arms,6,2,4
Orcly,kilrogg,192,warrior,arms,6,2,4
Sosaalmigh,tichondrius,192,warrior,arms,6,2,4
Eurthx,lightbringer,192,warrior,arms,6,2,4
Hugezs,tichondrius,192,warrior,arms,6,2,4
Kimuraa,hyjal,192,warrior,arms,6,2,4
Åmowarr,illidan,192,warrior,arms,6,2,4
Taigola,aggramar,192,warrior,arms,6,2,4
Krunchal,terenas,192,warrior,arms,6,2,4
Saabre,tichondrius,192,warrior,arms,6,2,4
Tatro,tichondrius,192,warrior,arms,6,2,4
Karlsabad,medivh,192,warrior,arms,6,2,4
Stellabear,aggramar,192,warrior,arms,6,2,4
Alitalia,thunderlord,192,warrior,arms,6,2,4
Thiccthôt,frostmourne,192,warrior,arms,6,2,4
Trouz,ragnaros,192,warrior,arms,6,2,4
Elimination,tichondrius,192,warrior,arms,6,2,4
Fabszord,nemesis,192,warrior,arms,6,2,4
Gigglamesh,muradin,192,warrior,arms,6,2,4
Xaviorn,illidan,192,warrior,arms,6,2,4
Derr,tichondrius,192,warrior,arms,6,2,4
Dustiezi,stormrage,192,warrior,arms,6,2,4
Warkaiser,ragnaros,192,warrior,arms,6,2,4
Chuck,zangarmarsh,192,warrior,arms,6,2,4
Doominus,tichondrius,192,warrior,arms,6,2,4
Ggrone,ragnaros,192,warrior,arms,6,2,4
Tobiwan,ragnaros,192,warrior,arms,6,2,4
Maleficous,tol-barad,192,warrior,arms,6,2,4
Wl,ragnaros,192,warrior,arms,6,2,4
Flexo,moon-guard,192,warrior,arms,6,2,4
Kraff,tichondrius,192,warrior,arms,6,2,4
Negrolas,nemesis,192,warrior,arms,6,2,4
Nabii,tichondrius,192,warrior,arms,6,2,4
Jírky,ragnaros,192,warrior,arms,6,2,4
Aquaknight,tortheldrin,192,warrior,arms,6,2,4
Bradic,bladefist,192,warrior,arms,6,2,4
Rekshor,wyrmrest-accord,192,warrior,arms,6,2,4
Jéshka,wyrmrest-accord,192,warrior,arms,6,2,4
Uprisèn,illidan,192,warrior,arms,6,2,4
Guroku,tichondrius,192,warrior,arms,6,2,4
Chapa,tichondrius,192,warrior,arms,6,2,4
Jessicajinn,illidan,192,warrior,arms,6,2,4
Hildibrawn,stormrage,192,warrior,arms,6,2,4
Wooglinx,stormrage,192,warrior,arms,6,2,4
Lhariza,stormrage,192,warrior,arms,6,2,4
Primørdíal,tichondrius,192,warrior,arms,6,2,4
Stinkdog,khazgoroth,192,warrior,arms,6,2,4
Tüssèll,khazgoroth,192,warrior,arms,6,2,4
Rambð,illidan,192,warrior,arms,6,2,4
Kvnñ,frostmourne,192,warrior,arms,6,2,4
Dalmor,stormrage,192,warrior,arms,6,2,4
Wakkawar,stormrage,192,warrior,arms,6,2,4
Smokingops,frostmourne,192,warrior,arms,6,2,4
Yeèzy,stormrage,192,warrior,arms,6,2,4
Tarkvs,ragnaros,192,warrior,arms,6,2,4
Pookythebear,tichondrius,192,warrior,arms,6,2,4
Stormbadge,tichondrius,192,warrior,arms,6,2,4
Agoge,stormrage,192,warrior,arms,6,2,4
Raldoron,thrall,192,warrior,arms,6,2,4
Reginato,ravenholdt,192,warrior,arms,6,2,4
Pisagnòmos,quelthalas,192,warrior,arms,6,2,4
Demonsterz,ravenholdt,192,warrior,arms,6,2,4
Hagger,quelthalas,192,warrior,arms,6,2,4
Bjorgsen,frostmourne,192,warrior,arms,6,2,4
Stebe,thunderlord,192,warrior,arms,6,2,4
Mongofiera,quelthalas,192,warrior,arms,6,2,4
Trenbopanda,tichondrius,192,warrior,arms,6,2,4
Pippysmallz,tichondrius,192,warrior,arms,6,2,4
Twinktop,tichondrius,192,warrior,arms,6,2,4
Dahakawar,malganis,192,warrior,arms,6,2,4
Ychazz,stormrage,192,warrior,arms,6,2,4
Kratøz,tichondrius,192,warrior,arms,6,2,4
Sypii,malganis,192,warrior,arms,6,2,4
Irondefense,thrall,192,warrior,arms,6,2,4
Enzothebaker,thrall,192,warrior,arms,6,2,4
Pép,malganis,192,warrior,arms,6,2,4
Shain,thrall,192,warrior,arms,6,2,4
Maxalyss,stormrage,192,warrior,arms,6,2,4
Jäëgër,moon-guard,192,warrior,arms,6,2,4
Brenrainn,thrall,192,warrior,arms,6,2,4
Risr,illidan,192,warrior,arms,6,2,4
Titanwarr,malganis,192,warrior,arms,6,2,4
Nachobeef,illidan,192,warrior,arms,6,2,4
Humansmash,thrall,192,warrior,arms,6,2,4
Digitalfear,malganis,192,warrior,arms,6,2,4
Icebringer,frostmourne,192,warrior,arms,6,2,4
Girei,ghostlands,192,warrior,arms,6,2,4
Threg,malganis,192,warrior,arms,6,2,4
Donni,kelthuzad,192,warrior,arms,6,2,4
Lazarenthus,stormrage,192,warrior,arms,6,2,4
Aavyrre,moon-guard,192,warrior,arms,6,2,4
Verwischen,zuljin,192,warrior,arms,6,2,4
Mahknut,moon-guard,192,warrior,arms,6,2,4
Suavay,executus,192,warrior,arms,6,2,4
Smeshyou,kelthuzad,192,warrior,arms,6,2,4
Chura,kiljaeden,192,warrior,arms,6,2,4
Squonks,kelthuzad,192,warrior,arms,6,2,4
Ronipastrami,kelthuzad,192,warrior,arms,6,2,4
Tinykong,zuljin,192,warrior,arms,6,2,4
Zerríck,moon-guard,192,warrior,arms,6,2,4
Lavablood,moon-guard,192,warrior,arms,6,2,4
Gageoddord,kiljaeden,192,warrior,arms,6,2,4
Rí,moon-guard,192,warrior,arms,6,2,4
Mochigome,moon-guard,192,warrior,arms,6,2,4
Braxxinn,tichondrius,192,warrior,arms,6,2,4
Fäey,dalaran,192,warrior,arms,6,2,4
Bonetotem,azralon,192,warrior,arms,6,2,4
Sylvannlee,tichondrius,192,warrior,arms,6,2,4
Lilfookur,dalaran,192,warrior,arms,6,2,4
Deloum,tichondrius,192,warrior,arms,6,2,4
Tanksbad,lightnings-blade,192,warrior,arms,6,2,4
Stavsie,tichondrius,192,warrior,arms,6,2,4
Adonis,burning-blade,192,warrior,arms,6,2,4
Xurug,zuljin,192,warrior,arms,6,2,4
Skalvi,moon-guard,192,warrior,arms,6,2,4
Disturbed,velen,192,warrior,arms,6,2,4
Hawaiianko,guldan,192,warrior,arms,6,2,4
Scrubwarrior,black-dragonflight,192,warrior,arms,6,2,4
Corazondleón,ragnaros,192,warrior,arms,6,2,4
Fùzzy,zuluhed,192,warrior,arms,6,2,4
Dodiru,azralon,192,warrior,arms,6,2,4
Ningz,tichondrius,192,warrior,arms,6,2,4
Papichoppyme,bleeding-hollow,192,warrior,arms,6,2,4
Orphenkaos,bleeding-hollow,192,warrior,arms,6,2,4
Dreadworld,bleeding-hollow,192,warrior,arms,6,2,4
Rekitralph,tichondrius,192,warrior,arms,6,2,4
Noblêsix,dalaran,192,warrior,arms,6,2,4
Shiestyzug,tichondrius,192,warrior,arms,6,2,4
Nerffrogues,stormrage,192,warrior,arms,6,2,4
Nordrages,stormrage,192,warrior,arms,6,2,4
Hellabandz,bleeding-hollow,192,warrior,arms,6,2,4
Burstful,bleeding-hollow,192,warrior,arms,6,2,4
Tormite,spirestone,192,warrior,arms,6,2,4
Iapologiz,illidan,192,warrior,arms,6,2,4
Pollere,firetree,192,warrior,arms,6,2,4
Befòx,tichondrius,192,warrior,arms,6,2,4
Shrexecute,tichondrius,192,warrior,arms,6,2,4
Saltycrakerz,area-52,192,warrior,arms,6,2,4
Danskmand,tichondrius,192,warrior,arms,6,2,4
Hookahmasta,area-52,192,warrior,arms,6,2,4
Loudnoise,frostwolf,192,warrior,arms,6,2,4
Katre,malorne,192,warrior,arms,6,2,4
Daechoochoo,frostwolf,192,warrior,arms,6,2,4
Moosoka,malorne,192,warrior,arms,6,2,4
Hbbaboy,nagrand,192,warrior,arms,6,2,4
Gátzú,ragnaros,192,warrior,arms,6,2,4
Passionjar,bleeding-hollow,192,warrior,arms,6,2,4
Overlordz,azralon,192,warrior,arms,6,2,4
Jakelope,proudmoore,192,warrior,arms,6,2,4
Deldramor,proudmoore,192,warrior,arms,6,2,4
Gâbríel,maiev,192,warrior,arms,6,2,4
Riggs,stonemaul,192,warrior,arms,6,2,4
Luchonamøm,ragnaros,192,warrior,arms,6,2,4
Hurricán,tichondrius,192,warrior,arms,6,2,4
Guanabacoa,area-52,192,warrior,arms,6,2,4
Akaínu,area-52,192,warrior,arms,6,2,4
Vamsx,barthilas,192,warrior,arms,6,2,4
Chrizo,area-52,192,warrior,arms,6,2,4
Vegr,queldorei,192,warrior,arms,6,2,4
Èxecutè,area-52,192,warrior,arms,6,2,4
Gtrain,barthilas,192,warrior,arms,6,2,4
Annubiis,tichondrius,192,warrior,arms,6,2,4
Swolthelas,tichondrius,192,warrior,arms,6,2,4
Joelyyonerr,barthilas,192,warrior,arms,6,2,4
Spaceshuttle,bleeding-hollow,192,warrior,arms,6,2,4
Drtbag,tichondrius,192,warrior,arms,6,2,4
Soldiër,proudmoore,192,warrior,arms,6,2,4
Relaxnerdlol,antonidas,192,warrior,arms,6,2,4
Airolol,tichondrius,192,warrior,arms,6,2,4
Fealix,moon-guard,192,warrior,arms,6,2,4
Smokinlean,chogall,192,warrior,arms,6,2,4
Pendrake,proudmoore,192,warrior,arms,6,2,4
Slamzftw,stormreaver,192,warrior,arms,6,2,4
Annihilataur,blackhand,192,warrior,arms,6,2,4
Obama,chogall,192,warrior,arms,6,2,4
Bogii,area-52,192,warrior,arms,6,2,4
Thresdan,emerald-dream,192,warrior,arms,6,2,4
Tnknspnk,magtheridon,192,warrior,arms,6,2,4
Lgnasty,area-52,192,warrior,arms,6,2,4
Çampbêll,area-52,192,warrior,arms,6,2,4
Playbox,area-52,192,warrior,arms,6,2,4
Sorty,emerald-dream,192,warrior,arms,6,2,4
Kinaed,durotan,192,warrior,arms,6,2,4
Krongarr,area-52,192,warrior,arms,6,2,4
Fetalalcohol,illidan,192,warrior,arms,6,2,4
Bbyzugga,kelthuzad,192,warrior,arms,6,2,4
Revinth,sargeras,192,warrior,arms,6,2,4
Yeicomoon,ragnaros,192,warrior,arms,6,2,4
Baynn,frostmourne,192,warrior,arms,6,2,4
Deseroth,sargeras,192,warrior,arms,6,2,4
Enelsita,sargeras,192,warrior,arms,6,2,4
Alppha,emerald-dream,192,warrior,arms,6,2,4
Xtrego,quelthalas,192,warrior,arms,6,2,4
Berserkchow,sargeras,192,warrior,arms,6,2,4
Oow,barthilas,192,warrior,arms,6,2,4
Fugmaface,sargeras,192,warrior,arms,6,2,4
Hellizzy,sargeras,192,warrior,arms,6,2,4
Donpepe,sargeras,192,warrior,arms,6,2,4
Plugz,sargeras,192,warrior,arms,6,2,4
Oðín,emerald-dream,192,warrior,arms,6,2,4
Lopotron,sargeras,192,warrior,arms,6,2,4
Zekken,blades-edge,192,warrior,arms,6,2,4
Valky,sargeras,192,warrior,arms,6,2,4
Rassius,sargeras,192,warrior,arms,6,2,4
Oneeyewille,sargeras,192,warrior,arms,6,2,4
Suhwoosh,bleeding-hollow,192,warrior,arms,10,3,7
Sinenrs,tichondrius,192,warrior,arms,8,2,6
Xavíerus,tichondrius,192,warrior,arms,9,2,7
Hiddensquids,laughing-skull,192,warrior,arms,11,2,9
Brutaltruth,dragonmaw,192,warrior,arms,12,2,10
Kaimera,echo-isles,192,warrior,arms,12,2,10
Connero,stormrage,192,warrior,arms,12,2,10
Loktaromoose,frostmourne,192,warrior,arms,12,2,10
Avondwella,undermine,192,warrior,arms,12,2,10
Erwin,kiljaeden,192,warrior,arms,12,2,10
Pennyonebutt,barthilas,192,warrior,arms,12,2,10
Twoironfist,azralon,192,warrior,arms,12,2,10
Rios,jubeithos,192,warrior,arms,12,2,10
Hellswine,barthilas,192,warrior,arms,12,2,10
Ragekilla,silvermoon,192,warrior,arms,12,2,10
Ohhgeekush,proudmoore,192,warrior,arms,12,2,10
Goretooth,moon-guard,192,warrior,arms,12,2,10
Gambii,moon-guard,192,warrior,arms,12,2,10
Haruq,tichondrius,192,warrior,arms,12,2,10
Cleaver,draka,192,warrior,arms,12,2,10
Aymadommy,illidan,192,warrior,arms,12,2,10
Item,nerzhul,192,warrior,arms,12,2,10
Arthurston,tichondrius,192,warrior,arms,12,2,10
Lawlstørm,stormrage,192,warrior,arms,12,2,10
Jsl,tichondrius,192,warrior,arms,12,2,10
Gornal,sargeras,192,warrior,arms,12,2,10
Léonwow,tichondrius,192,warrior,arms,12,2,10
Råging,area-52,192,warrior,arms,12,2,10
Loveliuna,illidan,192,warrior,arms,12,2,10
Warmachîne,area-52,192,warrior,arms,12,2,10
Spårtacus,illidan,192,warrior,arms,12,2,10
Bearyfresh,area-52,192,warrior,arms,12,2,10
Annyan,ragnaros,192,warrior,arms,12,2,10
Alvitr,kelthuzad,192,warrior,arms,12,2,10
Damadar,malganis,192,warrior,arms,12,2,10
Warhoofz,malganis,192,warrior,arms,12,2,10
Bronkyaf,hyjal,192,warrior,arms,12,2,10
Kurzix,crushridge,192,warrior,arms,12,2,10
Lawyer,quelthalas,192,warrior,arms,12,2,10
Humminity,quelthalas,192,warrior,arms,14,2,12
Schecterguy,stormrage,192,warrior,arms,14,2,12
Fallensoul,nazjatar,192,warrior,arms,14,2,12
Blackkcow,zuljin,191,warrior,arms,6,2,4
Deathhit,barthilas,191,warrior,arms,6,2,4
Edrelang,bronzebeard,191,warrior,arms,6,2,4
Hazell,gundrak,191,warrior,arms,6,2,4
Krátös,farstriders,191,warrior,arms,6,2,4
Bunedau,azgalor,191,warrior,arms,12,2,10
Nanaru,tichondrius,180,warrior,arms,20,6,14
Hornsolo,archimonde,175,warrior,arms,11,2,9
Hemmy,kilrogg,175,warrior,arms,11,2,9
Ybsorc,kelthuzad,160,warrior,arms,10,2,8
Swordblood,ragnaros,159,warrior,arms,5,2,3
Notoriousmmà,illidan,159,warrior,arms,5,2,3
Gontore,thrall,159,warrior,arms,5,2,3
Trevvel,proudmoore,159,warrior,arms,5,2,3
Kellsbro,hyjal,159,warrior,arms,5,2,3
Vapyr,moon-guard,159,warrior,arms,5,2,3
Wyerlyn,illidan,159,warrior,arms,5,2,3
Eatscrayons,barthilas,159,warrior,arms,11,2,9
Czartacus,dalaran,144,warrior,arms,3,3,0
Liftedgainz,stormreaver,144,warrior,arms,3,3,0
Fatbarstard,jubeithos,138,warrior,arms,10,3,7
Strongtall,tichondrius,138,warrior,arms,12,3,9
Scottie,cairne,136,warrior,arms,7,3,4
Clarityw,illidan,128,warrior,arms,4,2,2
Nosors,kelthuzad,128,warrior,arms,4,2,2
Stunahh,bleeding-hollow,128,warrior,arms,4,2,2
Eatmyblade,wyrmrest-accord,128,warrior,arms,10,2,8
Berserko,gurubashi,112,warrior,arms,7,2,5
Seariphim,lothar,105,warrior,arms,9,4,5
Ragemane,illidan,96,warrior,arms,3,2,1
Kevs,sargeras,96,warrior,arms,3,2,1
Ryuulion,proudmoore,96,warrior,arms,3,2,1
Biggieth,sargeras,96,warrior,arms,9,2,7
Deathislovê,moonrunner,96,warrior,arms,6,1,5
Ivadell,stormrage,96,warrior,arms,6,1,5
Faintswar,stormrage,96,warrior,arms,6,1,5
Elodié,stormrage,96,warrior,arms,6,1,5
Einoch,stormrage,96,warrior,arms,6,1,5
Galaxywar,stormrage,96,warrior,arms,6,1,5
Betsisword,stormrage,96,warrior,arms,6,1,5
Striphex,trollbane,96,warrior,arms,6,1,5
Meytuglin,stormrage,96,warrior,arms,6,1,5
Codey,stormrage,96,warrior,arms,6,1,5
Jimhoffa,bonechewer,96,warrior,arms,6,1,5
Shadowswar,tichondrius,96,warrior,arms,6,1,5
Myc,zuljin,96,warrior,arms,6,1,5
Luckstang,zuljin,96,warrior,arms,6,1,5
Charcharbinx,zuljin,96,warrior,arms,6,1,5
Skärz,azshara,96,warrior,arms,6,1,5
Klobnslob,mannoroth,96,warrior,arms,6,1,5
Zørg,bleeding-hollow,96,warrior,arms,6,1,5
Rarityw,tichondrius,96,warrior,arms,6,1,5
Bootysmelly,mannoroth,96,warrior,arms,6,1,5
Weechubber,bleeding-hollow,96,warrior,arms,6,1,5
Dokoba,bleeding-hollow,96,warrior,arms,6,1,5
Solsirrior,tichondrius,96,warrior,arms,6,1,5
Selockclap,bleeding-hollow,96,warrior,arms,6,1,5
Akoro,bleeding-hollow,96,warrior,arms,6,1,5
Kboyrage,sargeras,96,warrior,arms,6,1,5
Beastro,rexxar,96,warrior,arms,6,1,5
Cloudsmash,arthas,96,warrior,arms,6,1,5
Noctrelor,sargeras,96,warrior,arms,6,1,5
Adav,arthas,96,warrior,arms,6,1,5
Durseyturm,area-52,96,warrior,arms,6,1,5
Aidenwr,area-52,96,warrior,arms,6,1,5
Goywarr,illidan,96,warrior,arms,6,1,5
Dragginball,garrosh,96,warrior,arms,6,1,5
Roxesc,area-52,96,warrior,arms,6,1,5
Morotak,area-52,96,warrior,arms,6,1,5
Draann,kirin-tor,96,warrior,arms,6,1,5
Shagstrike,azralon,96,warrior,arms,6,1,5
Gordurin,akama,96,warrior,arms,6,1,5
Doriax,sentinels,96,warrior,arms,6,1,5
Ghaladir,area-52,96,warrior,arms,6,1,5
Gromhell,azralon,96,warrior,arms,6,1,5
Soymong,frostmourne,96,warrior,arms,6,1,5
Kado,zuluhed,96,warrior,arms,6,1,5
Immortal,icecrown,96,warrior,arms,6,1,5
Notacop,malygos,96,warrior,arms,6,1,5
Warrmachine,scarlet-crusade,96,warrior,arms,6,1,5
Airwick,kelthuzad,96,warrior,arms,6,1,5
Xeno,steamwheedle-cartel,96,warrior,arms,6,1,5
Heyzulnut,whisperwind,96,warrior,arms,6,1,5
Ästen,kargath,96,warrior,arms,6,1,5
Beatstickz,malganis,96,warrior,arms,6,1,5
Wàrrðèémzý,frostmourne,96,warrior,arms,6,1,5
Nibones,malganis,96,warrior,arms,6,1,5
Uub,malganis,96,warrior,arms,6,1,5
Nerolanast,wyrmrest-accord,96,warrior,arms,6,1,5
Paralyzed,malganis,96,warrior,arms,6,1,5
Darkromel,quelthalas,96,warrior,arms,6,1,5
Jimpepega,quelthalas,96,warrior,arms,6,1,5
Lifaen,zangarmarsh,96,warrior,arms,6,1,5
Joetempest,azralon,96,warrior,arms,6,1,5
Áres,spinebreaker,96,warrior,arms,6,1,5
Morlu,alleria,96,warrior,arms,6,1,5
Rasazghal,darrowmere,96,warrior,arms,6,1,5
Nyaner,quelthalas,96,warrior,arms,6,1,5
Horahloux,ragnaros,96,warrior,arms,6,1,5
Facekilla,nordrassil,96,warrior,arms,6,1,5
Darkmagno,ragnaros,96,warrior,arms,6,1,5
Silverdeadl,ragnaros,96,warrior,arms,6,1,5
Kevinersaa,frostmourne,96,warrior,arms,6,1,5
Mikachero,ragnaros,96,warrior,arms,6,1,5
Racsorr,ragnaros,96,warrior,arms,6,1,5
Däger,ragnaros,96,warrior,arms,6,1,5
Gärroshh,ragnaros,96,warrior,arms,6,1,5
Fréäkk,ragnaros,96,warrior,arms,6,1,5
Flexxinpapi,exodar,96,warrior,arms,6,1,5
Sweetlove,akama,96,warrior,arms,6,1,5
Mauler,medivh,96,warrior,arms,6,1,5
Shelbyqt,azralon,96,warrior,arms,6,1,5
Meleth,darkspear,96,warrior,arms,6,1,5
Hergo,spirestone,96,warrior,arms,6,1,5
Õctane,thrall,96,warrior,arms,6,1,5
Beenbag,aerie-peak,96,warrior,arms,6,1,5
Grosjambes,turalyon,96,warrior,arms,6,1,5
Hadrum,turalyon,96,warrior,arms,6,1,5
Geontage,drakkari,96,warrior,arms,6,1,5
Blitzkrieegz,drakkari,96,warrior,arms,6,1,5
Jazz,frostwolf,96,warrior,arms,6,1,5
Nelfmoehawk,barthilas,96,warrior,arms,6,1,5
Abaton,wyrmrest-accord,96,warrior,arms,6,1,5
Rage,tanaris,96,warrior,arms,6,1,5
Warbomb,thrall,96,warrior,arms,6,1,5
Nicrose,hyjal,96,warrior,arms,6,1,5
Regax,thrall,96,warrior,arms,6,1,5
Kargan,thrall,96,warrior,arms,6,1,5
Maxtavius,baelgun,96,warrior,arms,6,1,5
Gouzizhang,proudmoore,96,warrior,arms,6,1,5
Ghostierip,illidan,96,warrior,arms,6,1,5
Brigandier,shattered-hand,96,warrior,arms,6,1,5
Dikesrus,tichondrius,96,warrior,arms,6,1,5
Bobisyourmom,tichondrius,96,warrior,arms,6,1,5
Dogmar,moon-guard,96,warrior,arms,6,1,5
Zépileque,azralon,96,warrior,arms,6,1,5
Yongvi,tichondrius,96,warrior,arms,6,1,5
Wartrué,tichondrius,96,warrior,arms,6,1,5
Xalë,tichondrius,96,warrior,arms,6,1,5
Wolurog,emerald-dream,96,warrior,arms,6,1,5
Soughloe,illidan,96,warrior,arms,6,1,5
Atomicboxer,tichondrius,96,warrior,arms,6,1,5
Blacken,tichondrius,96,warrior,arms,6,1,5
Erhue,sargeras,96,warrior,arms,6,1,5
Jiva,emerald-dream,96,warrior,arms,6,1,5
Smoogzz,tichondrius,96,warrior,arms,6,1,5
Glonzito,tichondrius,96,warrior,arms,6,1,5
Cursedogre,tichondrius,96,warrior,arms,6,1,5
Sosaw,moon-guard,96,warrior,arms,6,1,5
Vhagaar,emerald-dream,96,warrior,arms,6,1,5
Mezw,tichondrius,96,warrior,arms,6,1,5
Tfd,tichondrius,96,warrior,arms,6,1,5
Rambovix,tichondrius,96,warrior,arms,6,1,5
Wienertoes,tichondrius,96,warrior,arms,6,1,5
Bigwarrior,stonemaul,96,warrior,arms,6,1,5
Bestgrunt,tichondrius,96,warrior,arms,6,1,5
Jennatolls,boulderfist,96,warrior,arms,6,1,5
Sver,dalaran,96,warrior,arms,6,1,5
Vlix,korgath,96,warrior,arms,6,1,5
Dezeran,tichondrius,96,warrior,arms,6,1,5
Berawar,tichondrius,96,warrior,arms,6,1,5
Edariana,dalaran,96,warrior,arms,6,1,5
Droggo,cenarius,96,warrior,arms,6,1,5
Cindabotica,sargeras,96,warrior,arms,6,1,5
Eightballerz,barthilas,96,warrior,arms,6,1,5
Mechagodzila,kiljaeden,96,warrior,arms,6,1,5
Nukefrmorbit,dalaran,96,warrior,arms,6,1,5
Cainne,proudmoore,96,warrior,arms,6,1,5
Kåyotix,proudmoore,96,warrior,arms,6,1,5
Tangö,barthilas,96,warrior,arms,6,1,5
Olavson,proudmoore,96,warrior,arms,6,1,5
Braygar,barthilas,96,warrior,arms,6,1,5
Bhuppzz,barthilas,96,warrior,arms,6,1,5
Äléx,frostmourne,96,warrior,arms,7,1,6
Sangettsu,stormrage,96,warrior,arms,8,1,7
Maat,blood-furnace,96,warrior,arms,8,1,7
Ruinsteel,area-52,96,warrior,arms,8,1,7
Ogrimir,moon-guard,96,warrior,arms,9,1,8
Baozz,frostmourne,96,warrior,arms,12,1,11
Njalulfhild,korgath,96,warrior,arms,12,1,11
Babyfelix,tichondrius,96,warrior,arms,12,1,11
Integrâl,tichondrius,96,warrior,arms,12,1,11
Falkur,amanthul,96,warrior,arms,12,1,11
Drdalidou,zuljin,96,warrior,arms,12,1,11
Cartou,stormscale,96,warrior,arms,12,1,11
Meelehard,zuljin,96,warrior,arms,12,1,11
Drarn,norgannon,96,warrior,arms,12,1,11
Wmuuzh,quelthalas,96,warrior,arms,12,1,11
Odyssey,vashj,96,warrior,arms,12,1,11
Berzerk,dentarg,96,warrior,arms,12,1,11
Semyus,ragnaros,96,warrior,arms,12,1,11
Bushwook,emerald-dream,96,warrior,arms,12,1,11
Roxon,hellscream,79,warrior,arms,5,1,4
Psykd,arathor,79,warrior,arms,5,1,4
Rokmok,frostmane,79,warrior,arms,5,1,4
Keringan,stormrage,79,warrior,arms,5,1,4
Naindejardin,sargeras,79,warrior,arms,5,1,4
Savagetko,illidan,79,warrior,arms,5,1,4
Hexenwolf,moon-guard,79,warrior,arms,5,1,4
Sniperbeer,sargeras,64,warrior,arms,4,1,3
Garrossh,thunderhorn,64,warrior,arms,4,1,3
Boorabill,stormrage,63,warrior,arms,2,2,0
Warriorba,tichondrius,48,warrior,arms,3,1,2
Thewarrior,tichondrius,48,warrior,arms,3,1,2
Haveya,ghostlands,48,warrior,arms,3,1,2
Foldrak,quelthalas,48,warrior,arms,3,1,2
Critnectar,aggramar,48,warrior,arms,3,1,2
Rumka,draktharon,42,warrior,arms,6,2,4
Ghostkin,ragnaros,42,warrior,arms,7,2,5
Reignwolf,azralon,42,warrior,arms,7,2,5
Trôca,ragnaros,42,warrior,arms,8,2,6
Danielss,ragnaros,42,warrior,arms,12,2,10
Flandiz,sargeras,31,warrior,arms,2,1,1
Nicked,azralon,31,warrior,arms,2,1,1
Billy,area-52,31,warrior,arms,2,1,1
Mantiflash,stormrage,31,warrior,arms,2,1,1
Valuxia,sargeras,16,warrior,arms,1,1,0
Zachw,stormrage,16,warrior,arms,1,1,0
Shwutty,stormrage,16,warrior,arms,1,1,0
Goodidea,mannoroth,16,warrior,arms,1,1,0
Americanbull,moon-guard,1455,warrior,protection,62,34,28
Percaderp,barthilas,1242,warrior,protection,33,18,15
Graventhal,tichondrius,1192,warrior,protection,53,25,28
Thororan,whisperwind,845,warrior,protection,27,10,17
Appolyonn,hyjal,836,warrior,protection,43,17,26
Logan,twisting-nether,705,warrior,protection,44,12,32
Nansitao,kelthuzad,668,warrior,protection,24,7,17
Ghostoffury,thrall,574,warrior,protection,12,6,6
Stophitingme,bloodscalp,469,warrior,protection,18,5,13
Ksubîî,frostmourne,448,warrior,protection,16,5,11
Smelldrglove,frostmourne,443,warrior,protection,11,5,6
Dabdaddyy,dawnbringer,384,warrior,protection,6,4,2
Kidkolby,moon-guard,384,warrior,protection,12,4,8
Rhuk,drakkari,383,warrior,protection,24,4,20
Manthraxx,sargeras,288,warrior,protection,6,3,3
Chàrr,crushridge,288,warrior,protection,15,4,11
Meadier,windrunner,286,warrior,protection,6,3,3
Toothnnailz,destromath,284,warrior,protection,12,3,9
Tåra,area-52,256,warrior,protection,22,3,19
Stowdace,bladefist,239,warrior,protection,5,3,2
Lagurtz,ragnaros,192,warrior,protection,6,2,4
Executespam,madoran,192,warrior,protection,6,2,4
Loonycity,arygos,192,warrior,protection,12,2,10
Littlefatman,terokkar,192,warrior,protection,12,2,10
Fearless,moon-guard,96,warrior,protection,6,1,5
Varith,sargeras,96,warrior,protection,12,1,11
Jindyn,boulderfist,95,warrior,protection,6,1,5
Axiyum,tichondrius,79,warrior,protection,5,1,4
Juicey,burning-blade,31,warrior,protection,2,1,1
